	coreid	status	nwords_original	nwords_result	nwords_recovered	nwords_omitted	nwords_created	prop_recovered	common_words	original_only	result_only
0	wfo-0001025636	success	208	91	72	136	19	0.346	0.1-0.3,1,1-10,1-2,1-5.5,1.4-3.5,10-45,2,2-4,2.5-6,6.5-10,abaxially,absent,adaxially,anther,apart,blue,broadly,brownish,chartaceous,ciliate,clavate,cm,condition,corolla,diameter,drying,edge,elliptic,filament,flat,fresh,fruit,glabrous,globose,green,green-white,greenish,herb,long,margin,membranous,minute,minutely,mm,mottled,mucilaginous,odd-pinnate,ovate,ovoid,pedicel,peduncle,petiole,petiolule,plant,puberulent,purple,ripe,rosette-forming,rotate,rotate-pentagonal,scale-like,seed,slightly,stem,stigma,style,throughout,tip,unforked,wet,whitish	0-2,0-5,0.1,0.6-2.8,1-2.2,1-3,1-3.5,1-4,1-5,1.1-6.1,1.7-5.2,1.7-9.2,1.8,2.6-8.3,3-5,3-6,5-merou,9.5-29.5,acumen,acuminate,acute,ag,along,alyx,apex,apparently,articulated,axe,base,berry,blade,capitat,cell,clearly,connivent,contracted,covering,cuneate,decurrent,digestion,distal,dorsally,eaf,eed,end,enzyme,especially,exceeding,except,flower,folded,geminat,generally,glabrou,greatly,hair,hair-like,hal,half,high,highly,homostylous,honeycomb-shaped,interjected,lanceolate,larger,lateral,leaflet,lengthening,like,living,lobe,longer,lower,make,midrib,moderately,multicellular,near,nflorescence,oblique,obovate,obtuse,often,orbicular,orne,orolla,pair,perfect,petiolulate,plurifoliate,pore,poricidal,proximal,pubescent,reduced,removed,rounded,ruit,semierec,sessile,seudostipule,short,singly,size,slit,sometimes,spaced,specimen,stamen,ste,stolo,straight,subequal,subglabrous,tall,tamen,tem,terminal,testal,thick,tri-,truncate,tube,tuber,typically,unequal,unit,unwinged,uppermost,vary,wall,wide,x,yellow,ympodial	0.1-1.8,arrangement,capitate,color,form,growth,height,history,inflorescence,leaf,length,life,mucilage,pseudostipule,semierect,shape,spacing,surface,texture
1	wfo-0001025637	success	193	88	70	123	18	0.363	0-0.3,0.2-0.9,1-12,1-2,14-38,2-7,2.8-4.2,3-10,3-4,3-5,4-6,5-7,acuminate,acute,anther,apex,attenuate,base,blue,brownish,clavate,cm,coriaceous,corolla,dark,deep,diameter,dot,drying,edge,elliptic,filament,flat,forked,fruit,glabrescent,glabrous,globose,green,greenish,herb,interjected,lanceolate,leaf,leaflet,lilac,medium,mm,moniliform,mucilaginous,odd-pinnate,ovoid,pair,pedicel,peduncle,pentagonal,petiole,petiolulate,plant,rotate,rounded,seed,size,stigma,stripe,style,tiny,tuber,white,whitish	0-27,0.2-0.5,0.3-0.5,0.8-2.6,1-2.5,1-5,1.2-3.5,1.5-5,1.6-2.5,2-20,2-3,2.5-8,3-9,5-merou,abaxially,acumen,adaxiall,adaxially,ag,along,alyx,apart,apparently,arranged,articulated,axe,axillary,bead,berry,blade,bud,capitat,cell,condition,connivent,covering,cuneate,decreasing,decurrent,digestion,distal,dorsally,eaf,eed,enzyme,erec,exceeding,flower,folded,fresh,geminat,generally,glabrou,green-white,hair,hair-like,hal,half,high,homostylous,honeycomb-shaped,lateral,lengthening,light,like,linear,living,lobe,long,lower,make,mottled,multiple,necklace,nflorescence,onto,orolla,ovate,perfect,petiolule,plurifoliate,pore,poricidal,purple,rachi,removed,ripe,ruit,secondary,seudostipule,short,slit,sometimes,spaced,specimen,stamen,stolon,straight,subequal,subtending,symmetric,tall,tamen,tem,terminal,testal,thick,throughout,tip,toward,tri-,tube,typically,unit,unwinged,usually,vary,wall,wet,wide,x,yellow,ympodial	arrangement,capitate,color,form,growth,height,history,inflorescence,length,life,mucilage,present,pseudostipule,shape,spacing,stem,surface,texture
2	wfo-0001025639	success	154	90	66	88	24	0.429	1-2,1-3,2-3,2-3.5,2.8-3.2,20-35,3-6,3.5-7,4-10,4.5-8.5,5-10,5-8,6-8,8-12,8-9,branched,broadly,calyx,cm,corolla,cyme,diameter,dichasial,dichasially,distal,ebracteate,elliptic,flower,forked,globose,green,green-white,half,herbaceous,lateral,leaf,leaflet,long,medium,mm,monochasial,mucilaginous,obovate,ovate,ovoid,pair,pedicel,peduncle,perennial,perfect,petiole,plant,proximal,puberulent,pubescent,rotate,seed,size,straight,style,terminal,throughout,unit,wide,yellow,¼	1-4,10-21,3-4,3-5,3-6-foliat,5-1.,6-12,abaxially,acumen,acuminate,acute,adaxially,apex,apical,apically,articulate,base,belo,cell,connate,covering,cuneate,dark,dehiscent,digestion,diminishing,dorsally,eaf,edge,eed,elliptical,emoval,enzyme,exceeding,filament,flat,folded,frequently,generally,globo,gradually,hair-like,honeycomb,interjected,introrse,lobe,lon,long-attenuate,lower,lunat,make,maturing,nflorescence,nther,oblique,odd-pinnate,often,orolla,pattern,petiolule,plan,poricidally,present,produced,rare,reveal,ruit,seudostipule,short,slit,sometimes,stamen,stigma,tal,tem,testal,thick,throughou,top,toward,truncate,tuber-bearing,typically,vary,violet,wall,white,ympodial	3-6-foliate,anther,articulation,color,foliation,form,fruit,growth,height,history,inflorescence,length,life,location,lunate,number,ovary,pseudostipule,shape,stem,surface,sympodial,texture,type
3	wfo-0001025642	success	149	103	80	69	23	0.537	0.3-0.4,1-2.7,1-3.2,1-4,10-20,2-10,2-3,3-5,4-7.5,5-6,5.5-7,8-13,9-12,absent,acuminate,acute,apex,apically,apiculate,attenuate,base,branched,calyx,cm,connate,corolla,cyme,dehiscent,diameter,dichasial,dichasially,distal,dorsally,ebracteate,edge,elliptic,elliptic-lanceolate,filament,flat,flower,folded,forked,globose,green,green-white,half,herbaceous,interjected,lanceolate,lateral,leaf,leaflet,lunate,mm,monochasial,mucilaginous,oblique,obtuse,odd-pinnate,ovoid,pair,pedicel,peduncle,perennial,perfect,petiole,plant,poricidally,proximal,puberulent,seed,sessile,size,stellate,straight,style,terminal,throughout,yellow,¼	1,1-2,1-2.5,1-3,1.5-2.5,3,3-6-foliat,3.5-6,4.5-8,7-11.5,abaxially,absen,acumen,adaxially,apical,articulate,cell,covering,digestion,diminishing,eaf,eed,emoval,enzyme,exceeding,generally,globo,gradually,hair-like,honeycomb,introrse,lanceolat,living,lobe,lon,long,lower,make,maturing,nflorescence,nther,often,orolla,pattern,plan,present,reveal,ruit,seudostipule,short,slit,specimen,stamen,stigma,tal,tem,testal,thick,throughou,toward,tuber-bearing,typically,unit,vary,wall,whit,wide,without,ympodial	anther,arrangement,articulation,color,dehiscence,form,fruit,growth,height,history,inflorescence,length,life,location,number,ovary,pseudostipule,shape,stem,surface,texture,type,white
4	wfo-0001025644	success	204	89	70	134	19	0.343	0-5,1-10,1-2,1.3-2.1,10,10-11,2-3,2-4,2.5-6,25-50,3-5,3.3-8.2,4-19,4-6,6.5-13,abaxially,adaxially,anther,blue,cell,chartaceous,clavate,cm,corolla,diameter,edge,end,filament,flat,forked,fruit,glabrous,globose,green,greenish,herb,honeycomb-shaped,interjected,leaflet,membranous,minutely,mm,mucilaginous,odd-pinnate,one,ovoid,pair,pedicel,peduncle,pentagonal,petiole,petiolule,plant,plurifoliate,puberulent,pubescent,seed,size,stem,stigma,style,terminal,testal,tinged,tri-,tuber,unit,white,whitish,x	.3,0.8-1.5,12-28,13-21,2,2.4-4,2.5-11,3-10,3-4,4.5-9.5,5-merou,6-7,absent,acumen,acuminate,acute,ag,almost,along,always,alyx,apart,apex,apparently,articulated,attenuate,axe,axillary,base,berry,blade,broadly,brownish,bud,c.,capitat,ciliate,condition,connivent,cordate,covering,cuneate,denticulate,digestion,distal,dorsally,drying,eaf,eed,elliptic,enzyme,erec,especially,exceeding,except,finely,flower,folded,fresh,geminat,generally,glabrou,greatly,green-white,hair,hair-like,half,homostylous,invested,lanceolate,lateral,lengthening,like,living,lobe,long,lower,make,margin,middl,midrib,mottled,multicellular,nflorescence,non-glandular,oblique,often,orbicular,orolla,ovate,perfect,placed,pore,poricidal,proximal,purple,rarely,reduced,removed,rounded,ruit,sessile,seudostipule,shallowly,short,slit,spaced,specimen,stamen,ste,stolo,straight,subequal,subtending,tall,tamen,tem,thick,throughout,tip,trichome,truncate,tube,typically,uniseriate,usually,vary,wall,well-developed,wet,wing,winged,yellow,ympodial	arrangement,capitate,color,form,growth,height,history,inflorescence,leaf,length,life,placement,pseudostipule,shape,spacing,stolon,surface,sympodial,texture
5	wfo-0001025645	success	150	100	76	74	24	0.507	0.3-0.8,1-2,1-3.5,1-4,10-11,15-25,2-4.5,4-6,4-7,5-5.5,8-10,acuminate,acute,apex,apical,base,branched,cell,cm,corolla,covering,cuneate,cyme,dehiscent,diameter,dichasial,dichasially,diminishing,ebracteate,edge,elliptic-lanceolate,filament,flat,glabrous,globose,gradually,green,green-white,hair-like,herbaceous,honeycomb,interjected,introrse,lanceolate,lateral,leaf,leaflet,maturing,mm,monochasial,mucilaginous,oblique,odd-pinnate,ovoid,pattern,pedicel,peduncle,perennial,petiole,plant,poricidally,puberulent,seed,short,size,slit,stellate,stigma,style,terminal,testal,thick,throughout,toward,tuber-bearing,wall	0.5-1,0.8,10-16,12-17,2-3,2.5,3-5.5,3-6-foliat,4-12,4-5,5,abaxially,absen,acumen,adaxially,apically,articulate,calyx,connate,decurrent,digestion,distal,dorsally,eaf,eed,elliptic,emoval,enzyme,exceeding,flower,folded,forked,generally,globo,half,larger,living,lobe,lon,long,lower,lunat,make,mucronate,nflorescence,nther,oblong,often,orolla,pair,perfect,plan,proximal,rachi,reveal,ruit,second,sessile,seudostipule,specimen,stamen,straight,tal,tem,throughou,typically,unit,vary,whit,wide,without,yellow,ympodial,¼	absent,anther,arrangement,color,dehiscence,form,fruit,growth,height,history,inflorescence,length,life,lunate,maturation,mucilage,pseudostipule,shape,stem,surface,texture,wet,white,width
6	wfo-0001025646	success	136	95	71	65	24	0.522	0.25-0.4,0.7-3.5,1-7,1.1-4.5,1.2-7.0,2-3,2-4,3,3.2-6,3.5-7,4-10,4-5,7-8,acuminate,acute,apex,apically,attenuate,base,branched,calyx,cm,connate,corolla,cuneate,cyme,dehiscent,diameter,dichasial,dichasially,distal,dorsally,ebracteate,edge,elliptic,flat,flower,folded,forked,globose,half,herbaceous,interjected,leaf,leaflet,long,mm,monochasial,oblique,obovate,odd-pinnate,ovate,pedicel,peduncle,pentagonal,perennial,perfect,petiolule,plant,poricidally,proximal,puberulent,sessile,size,stigma,straight,strigose,style,terminal,yellow,¼	0-.,0.5-2.1,0.6-2.3,0.6-3,1-4,1.1-1.4,1.2,1.5-3,2.3-9.0,2.5-3,3-6-foliat,4-15.5,abaxially,abruptly,acumen,adaxially,apical,apiculate,articulate,ature,caudate,decurrent,diminishing,eaf,eed,exceeding,filament,fruit,generally,globo,gradually,introrse,lateral,like,lobe,lon,lower,lunat,maturing,nflorescence,nther,often,orolla,ovary,pair,petiole,plan,probably,seen,seudostipule,short,slightly,slit,sometimes,stamen,tal,tem,toward,tuber-bearing,typically,unit,vary,whit,wide,ympodial	0-4,anther,arrangement,articulation,attachment,color,dehiscence,form,growth,height,history,inflorescence,length,life,location,lunate,number,pseudostipule,shape,stem,surface,texture,type,white
7	wfo-0001025647	success	194	82	64	130	18	0.33	0.06-0.24,0.8-3,1-10,1-2,1.2-3,1.4-5,2,2-3,2-4,2-5,2.5-3,4-10,5-6,abaxially,adaxially,anther,blue,clavate,cm,corolla,densely,diameter,edge,elliptic,filament,flat,flower,forming,fruit,glabrous,globose,green,greenish,herb,homostylous,lanceolate,light,linear,minutely,mm,moderately,mucilaginous,narrowly,odd-pinnate,ovoid,pedicel,peduncle,petiole,plant,pore,poricidal,puberulent,pubescent,rosette,rotate,scale-like,seed,stem,stigma,straight,style,unbranched,whitish,yellow	0-4,0.4-1.5,0.6-3,1,1-3,1-5,1.3-2.9,1.5-5,1.5-5.5,3-6,4-6,5-merou,6.2-11,absent,acumen,acute,ag,along,alyx,apart,apex,apparently,articulated,attenuate,axe,axillary,base,berry,blade,borne,broadly,brownish,bud,capitat,cell,chartaceous,ciliate,condition,connivent,covering,decurrent,digestion,distal,dorsally,drying,eaf,eed,end,enzyme,erec,especially,exceeding,except,folded,frequently,fresh,geminat,glabrou,greatly,green-white,hair,hair-like,hal,half,high,honeycomb-shaped,interjected,lateral,leaflet,lengthening,like,living,lobe,long,lower,make,margin,membranous,midrib,multicellular,near,nflorescence,oblique,obtuse,often,orbicular,orolla,ovate,pair,perfect,petiolulate,plurifoliate,proximal,reduced,removed,ripe,ruit,sessile,seudostipule,short,singly,size,slit,sometimes,spaced,specimen,stamen,ste,stolo,subequal,subtending,tall,tamen,tem,terminal,testal,thick,throughout,tip,tri-,tube,tuber,typically,unit,unwinged,vary,wall,wet,x,ympodial	arrangement,capitate,color,erect,form,growth,height,history,inflorescence,leaf,length,life,number,pseudostipule,shape,spacing,surface,texture
8	wfo-0001025652	success	156	81	58	98	23	0.372	.3,0.5-1,1-1.5,1.5-2,15-17,2-3,2-5,2-6,4-6,4-7,acuminate,acute,anther,anthesi,apex,base,bilobed,closely,cm,corolla,elliptic,filament,fleshy,fruit,furcate,glabrous,growth,leaf,lobed,minutely,mm,nearly,occasionally,ovoid-reniform,pair,pale,papillose,parallel,pedicel,petiole,pitted,planar,plant,shape,shiny,shrub,simple,size,small,spaced,stem,stigma,style,surface,tan,tree,white,x	.5,1,10-20,15-19,20-50,3-3.5,3-5,3-5-flowered,4,9-11,abruptly,appearing,bark,blade,broad,calyx,campanulate,closed,completely,connate,decurrent,densely,dia,differing,difoliate,dry,eaf,edicel,eed,emerge,envelope,flower,free,geminat,glabrate,green,greyi,greyish,growing,irregular,lateral,like,live,lobe,lon,long,lower,main,major,margin,matte,middle,minor,minute,narrowing,new,nflorescence,older,one,onto,opposite,ovary,overlappin,ovoid,paler,papillae,papillo,pinkish-grey,pore,poricidal,portion,rather,red-papillose,ry,scar,shaped,soon,specimen,straight,strongly,tall,tapering,tear,tear-drop,thick,thicker,tightly,tip,tube,ud,unit,vein,wider,widest,wing,winged,ympodial,young	alternate,arrangement,color,diameter,edge,form,height,history,inflorescence,interjected,leaflet,length,life,mucilage,na,overlapping,peduncle,perennial,pseudostipule,seed,spacing,texture,tuber
9	wfo-0001025653	success	218	80	56	162	24	0.257	.0,.3,.5,.7,.8,.9,0.13,1.3,20,acuminate,anther,apex,bark,base,brown,calyx,chartaceous,cm,corolla,deltoid,densely,diameter,erect,globolunate,globose,leaf,least,lobed,long,margin,midpoint,mm,obtuse,ovate,pedicel,peduncle,petiole,pubescent,ray,reddish,rhizomatous,rounded,short,shrub,simple,sinuate,stellate,stem,stigma,style,subcordate,surface,transparent,truncate,unarmed,unbranched	.1,.2,.6,0.1,0.15,0.2–0.4,0.3–0.5,0.3–0.8,0.6–1.6,0.7–1.1,0.8,1.0–1.6,1.1–1.3,1.3–1.8,1.6,1.9–3.3,1–1.5,2.3–3.2,2.5–4.0,2.6,4–6,5-merou,6–8,6–9,7–12,8–11,90°,abaxially,absent,adaxiall,adaxially,adnate,aequilateral,ag,alyx,among,anthesi,apart,apical,apparently,appearing,around,articulate,attenuate,axe,ba,blade,broad,bud,channeled,clinate,congested,craspedodromous,cylindrical,developed,directed,distinct,dry,eaf,edge,eed,either,emerging,entire,extending,extra-axillary,ferruginous,fertile,filament,filiform,flower,free,fruit,glabrous,glandular,hair,heterostylous,increasing,intact,internode,interpetalar,intersepalar,know,known,lanceolate,lateral,layer,less,lobe,lon,longer,low,lower,mature,midrib,midvein,minute,much,nflorescence,noticeably,oblique,occasionally,opaque,opposed,orolla,persistent,plurifoliat,pore,porrect,porrect-stellate,portion,potentially,prickl,prickle,primary,raised,reduced,remaining,restricted,rigid,row,ruit,scarcely,secondary,see,seen,sessile,short-stipitate,shorter,shot-stipitate,side,sloughing,sparsely,splitting,spread,stamen,stellae,stellate-pubescent,stipe,stipitate,straight,suture,tamen,tem,time,tip,tissue,truncat,tube,two,ud,unarme,vary,vein,well,wide,yellow-ferruginous,ympodia,young,±equal,±erect,×	0.2-0.4,0.6-1.6,0.7-1.1,2.3-3.2,7-12,armament,arrangement,breadth,color,form,growth,height,history,inflorescence,length,life,number,ovary,plant,position,pseudostipule,shape,staman,texture
10	wfo-0001025654	success	140	90	67	73	23	0.479	1,1-2,15-22,2,2-2.5,4-5,5-6,abaxially,abortive,absent,acuminate,anther,apex,base,broadly,calyx,chartaceous,cm,cuneate,diameter,dull,elliptic,filament,flower,fruit,glabrous,glandular,globose,hair,hooked,inflorescence,leaf,margin,minute,minutely,mm,oblique,pale,pedicel,pedicellate,peduncle,petiole,pore,position,prickle,pubescent,purple,rachi,repand,shallowly,shortly,shrub,simple,slightly,solitary,stellate,stem,stigma,straw-coloured,style,sub-acuminate,sub-axillary,surface,tip,triangular,unknown,yellow	0,2-foliate,25-30,3/4,4,5,5-merous,6,7-8,?,abaxial,abundant,accrescen,acumen,adaxial,alyx,ape,apica,apparently,armed,articulated,axe,ba,blade,branched,eaf,eed,erect,flattened,frequently,fruiting,geminat,homostylou,juvenile,lanceolate,larger,later,less,lobe,long,lower,mainly,mature,midvein,mostly,narrowed,nflorescence,often,older,orolla,phase,retrorse,ruit,scarcely,scattered,sessile,several,single,size,slender,smaller,sparsely,tal,tamen,tem,toward,unarme,unit,unknow,vary,x,ympodial,young	apical,arrangement,color,corolla,edge,form,growth,height,history,length,life,na,number,orientation,perennial,plant,pseudostipule,red,seed,shape,spacing,texture,type
11	wfo-0001025655	success	226	118	87	139	31	0.385	-3-5-lobed,1-1.2,1-1.5,1-2,1.3-1.5,1.5-2,2,2-3.5,3-5,3-7,4-5,6-7,accrescent,acuminate,anther,apex,asymmetric,bark,base,beige,brown,calyx,canaliculate,clavate,cm,compressed,cordate,cordate-lanceolate,cyme,dark,densely,diameter,entire,ferruginous,ferruginous-pubescent,filament,flower,fruit,fruiting,glabrescent,glabrous,glandular-stellate,globose,helicoid,lanate,leaf,length,lilac,midrib,mm,multiangulate,oblong-urceolate,pedicel,peduncle,persistent,petiole,plant,prickle,prominent,rachi,recurved,reflexed,rounded,rugose,shrub,slightly,solitary,somewhat,splitting,stellate,stem,stigma,style,sub-capitate,subreniform,surface,terete,tomentose,tomentose-velutinous,vein,velutinous,villous,violet,viscid-velutinous,within,without,woolly	-8-17,0.3-0.4,0.6-0.8,1-3,1.4-2,11,2-2.5,2-3,2-5-celled,2.5-3,2.5-5-,3-,3-8-flowered,4,4-6,5-6-merous,5-7,6-8,8-10,abaxial,along,alyx,anthesi,armed,articulate,attenuate,ba,basal,blade,branch,branched,brow,central,cinereous,curved,deeply,di-,discolorous,distal,dry,eaf,eed,elongate,enlarged,epicarp,equal,erect,exceeding,ferruginous-tomentose,free,functional,fused,geminat,gland,glandular,glandular-tipped,gynoeci,held,hirsute-glandular,indument,leathery,linear-lanceolate,lobe,long,long-exserted,long-stalked,longer,lower,many-celled,maturit,minutely,mix,monoclinous,mucilaginous,multiangulate-stellate,multiseriate,nflorescence,numerous,older,one,orolla,papillo,part,parted,peduncl,perennia,persistently,petiol,porrect-stellate,primary,prolonged,ranch,ray,reddish,reduced,ruit,secondary,sepal,sessile,short,similar,slender,small,sparsely,stalk,stalked,stamen,staminate,stellae,stellate-glandular,straight,strongly,sub-globose,sub-quadrangular,sub-sessile,subcoriaceous,subsagittate,subterete,surrounded,tall,tamen,time,triangular-lanceolate,trichome,trifoliate,tube,unarmed,unbranched,uniseriate,unit,upright,vary,weakly,wide,yellowish,ympodial,young,¼,½	3-8,accrescence,arrangement,canaliculation,color,corolla,edge,form,growth,hair,height,history,inflorescence,life,margin,maturity,na,number,orientation,perennial,persistence,pore,position,prominence,pseudostipule,seed,shape,spacing,texture,tip,type
12	wfo-0001025656	invalid_json_followup	209	166	124	85	42	0.593	-10,0.2-,0.2-0.3,0.2-0.4,0.8-1,1-1.5,1-2,1-4,1.5-2,12-15,2.5-5,3,3-12,4-5,8-9,abaxially,acuminate,acute,adaxially,adult,almost,along,anther,anthesi,apart,apex,bark,basal,base,berry,blue,branched,brown,calyx,channelled,chartaceous,clavate-truncate,cm,congested,corolla,corymbose,cuneate,curved,cyme,diameter,distal,elliptic,elliptic-ovate,entire,evenly,exserted,filament,flattened,flower,foliaceous,fruiting,glabrous,globose,green,grey,growth,heterostylous,inflorescence,internodal,juvenile,lanate,linear-lanceolate,lobed,lobed-angulate,long-styled,loosely,margin,midrib,minutely,mm,near,ovary,ovate,partially,pedicel,peduncle,perfect,petiole,plant,pore,poricidal,prickle,purple,raised,reflexed,relatively,reniform,reticulate,rounded,rusty,scar,several,short-styled,shrub,simple,slightly,spaced,staminate,stellate,stem,stigma,style,subcoriaceous,subglobose,subreniform,subtuncate,surface,time,tip,tomentose-lanate,tomentose-velutinous,turbinate,vein,venation,viscid,whitish,x,yellow,young	-14,0.5-0.6,1.8-2,1/3,10-,10-15,2-2.5,3-3.5,3-7,30-40,4-4.5,4-6,5-,6,6-11,8-10,apical,apically,armed,cell,coriaceous,densely,denser,discolorous,eaf,eed,elongate,erect,flexuous,free,gland,glandular,gre,hirsute,inflorescenc,lengthening,like,lobe,long,long-stalked,longer,looser,lower,mature,midpoint,minute,mixed,multangulate,multicellular,new,nflorescence,ochraceous,older,papillat,pericarp,plurifoliat,porrect,portion,prickly,pubescence,pubescent,rugose,ruit,scandent,sessile,short-stalked,single,sparse,sparsely,stalk,straight,subscandent,tall,tapering,testa,tomentose,trichome,tube,ud,unit,upper,white,without,wood,ympodial	'',10-30-40,[,``,accrescence,arrangement,branching,bud,canaliculation,characteristic,color,edge,exsertion,form,fruit,hair,height,heterostyly,history,leaf,length,life,na,number,orientation,papillate,perennial,persistence,position,prominence,pseudostipule,rachi,seed,shape,spacing,splitting,texture,type,value,woolly,{,}
13	wfo-0001025657	success	239	143	107	132	36	0.448	0.1-0.4,0.2-0.4,0.5-2.5,1-1.6,1-3,1.3-2,1.5-1.8,1.7-1.9,2-10,2-3.5,2.7-4.3,25-60,3-4,3-6,4-4.4,5-16,7-9.5,8.3-12,abaxially,accrescent,acute,adaxially,also,anther,apart,apex,apparently,base,berry,bluish,branched,brown,bud,calyx,cm,conical,cordate,corolla,dark,deltoid,densely,diameter,dried,edge,elliptic,entire,evident,filament,fleshy,flower,fruit,fruiting,glabrous,hair,lanate-pubescent,lanceolate,leaf,length,lengthening,light,lobe,longitudinal,margin,midrib,mm,narrowly,oblong,open,ovate,pedicel,peduncle,perfect,persistent,petiole,pore,poricidal,pseudo-terminal,rachi,reportedly,reticulate-punctate,ripe,semi-ovate,shrub,simple,slit,somewhat,splitting,stellate,stellate-pubescent,stem,stigma,style,subcampanulate,suborbicular,surface,suture,tan,tip,tomentose-pubescent,tree,tube,vein,velutinous-pubescent,white,x,yellow,yellowish	-2,/3,1-1.1,1-1.3,1.2-1.5,12x,2.2-5.5,2.5-9.3,2/3,3-4.8,3.2-6,4-4.5,4-7,5-14,6-12,6-8,6.5-10,7-27,7-9,8-10.5,ag,anthesi,appearing,ark,around,articulated,ascending,axe,axillary,ba,blade,blunt-tipped,branch,broadly,capitat,central,chartaceous,closely,cylindrical,dendritic-multangulat,dendritic-multangulate,dense,directed,distally,due,eaf,earl,eed,especially,exerted,expanded,exserted,farinose,few-rayed,free,glandula,glandular,granular,green,half,inserted,lateral,lobed,long,long-stalked,lower,m.,magnification,main,minutely,mixed,multangulate,nearly,nflorescence,obtuse,occasional,often,older,orbicular,orolla,ovat,ovate-lanceolate,overlapping,pale,part,parted,partly,persistently,plurifoliate,porrect-stellate,present,pubescence,pubescent,ray,ruit,scented,sessile,short,short-,short-stalked,side,slightly,soft,spaced,stamen,stipitate-glandular,stipitate-multangulate,strongly,subcoriaceous,tall,tamen,terete,thick-stalked,thickened,thin-stalked,time,tomentose,tomentum,transparent,two-third,ud,unarme,unarmed,unit,upper,usually,vary,way,weakly,wide,ympodial,young	accrescence,age,arrangement,bark,canaliculation,capitate,color,early,form,growth,height,history,inflorescence,insertion,lanate,life,na,number,orientation,ovary,perennial,perfection,persistence,plant,position,prickle,prominence,pseudostipule,seed,shape,spacing,staman,texture,tomentose-velutinous,type,woolly
14	wfo-0001025666	success	217	126	90	127	36	0.415	0-0.7,0.2-0.3,0.2-0.35,0.3,0.5-1,0.5-1.5,1-1.5,1-1.7,1-2,1.5-2.5,2-8,3-5,3-7,4-5,5-6,6-20,6-7.5,abaxially,acicular,acute,adaxially,andromonoecious,anther,apex,attenuate,base,calyx,chartaceous,cm,cuneate,diameter,directed,elliptical,entire,extra-axillary,filament,finely,flattened,flower,fruit,fruiting,glabrous,globose,green,hair,inflorescence,leaf,length,lobe,lobed,margin,minute,mm,moderately,narrowly,obtuse,ovate,pale,pedicel,peduncle,perennial,petiole,pinkish,plant,pore,prickle,prostrate,pseudo-racemose,pseudo-umbellate,purple,rachi,reticulate,ridged,sessile,shallowly,shrub,simple,sparsely,stellate-pubescent,stigma,stoloniferous,style,surface,terete,triangular,tube,whitish,x,yellow,yellowish-green	%,.8,0-5,0.05-0.25,0.2-0.8,0.25-0.35,0.25-0.4,0.5-2,1,1-1.4,1-locular,1.5-1.8,1.5-3.5,1.6-2.3,10-30,14-29,2-3,2-4,2.8-4.5,20-60,21-30,25-65,3-3.5,3.5-4,4-6,5-merou,5.5-9.5,7-8,8-12,9-10,9-20,absen,absent,across,alyx,apart,armed,articulated,axe,ba,blade,brown,capitat,center,confined,connivent,cross-section,cylindrical,d.,densely,difoliate,distal,distall,eaf,eed,eglandular,elliptica,exocarp,finger,functional,geminate,gland-tipped,half,heterostylous,incomplete,index,interpetalar,juicy,lamina,lateral,less,lobing,long,longer,loosely,lower,mature,mesocarp,midpoint,midrib,midvein,moist,nflorescence,oblique,orolla,part,per,placenta,porrect,presen,present,probably,ray,ruit,septum,short,side,slightly,spaced,sparse,stage,stellae,stellate,straight,strongly,tal,tamen,tapered,tem,thick,throughout,time,tissu,tissue,transparent,unarme,unarmed,unbranched,unit,uvenile,vary,vein,weakly,white,wide,yellowish,ympodial	5-merous,accrescence,arrangement,bud,capitate,color,corolla,distally,edge,form,growth,height,history,insertion,lanate-pubescent,lengthening,life,na,number,orientation,ovary,perfection,persistence,position,pseudostipule,reproduction,seed,shape,spacing,splitting,staman,stem,suture,texture,tip,type
15	wfo-0001025669	success	216	90	73	143	17	0.338	.5,0-1,0-5,0.1-0.3,1,1-10,1-2,1-4,1.4-2.5,13-35,2-3,2-4,2.2-6.5,abaxially,absent,acumen,adaxially,along,anther,broadly,brownish,ciliate,clavate,cm,condition,corolla,diameter,drying,edge,elliptic,especially,filament,flat,fresh,fruit,glabrous,globose,green,greenish,herb,long,margin,midrib,minute,minutely,mm,moderately,monochasium,mucilaginous,odd-pinnate,ovate,ovoid,pedicel,peduncle,petiole,petiolule,plant,puberulent,pubescent,purple,scale-like,seed,slightly,stem,stigma,style,subglabrous,tinged,tip,tube,wet,whitish,x	'',0-7,0.8-2.4,1-2.2,1-3,1.3-4.2,1.6-4.4,2,2.2-6,2.4-7,3-5,3-7,4-6,5-merou,9-24.5,``,absen,acuminate,acute,ag,alyx,apart,apex,apparently,articulation,axe,base,berry,blade,blue,capitat,cell,chartaceous,clearly,connivent,contracted,covering,cuneate,decurrent,digestion,discussion,distal,distinct,dorsally,eaf,eed,end,enzyme,erec,exceeding,except,extra,flower,flowered,folded,forming,geminat,glabrou,greatly,green-white,hair,hair-like,half,highly,homostylous,honeycomb-shaped,interjected,lanceolate,larger,lateral,leaflet,lengthening,like,living,lobe,lower,make,membranous,mottled,multicellular,near,nflorescence,oblique,obovate,obtuse,often,one,orbicular,orolla,pair,perfect,petiolulate,placed,plurifoliate,pore,poricidal,proximal,rarely,reduced,removed,ripe,rosette,rotate,rounded,ruit,see,sessile,seudostipule,short,single,size,slit,sometimes,spaced,species,specimen,stamen,ste,stolo,straight,streaked,subequal,tall,tamen,tem,terminal,testal,thick,throughout,tri-,truncate,tuber,typically,unbranched,unequal,unit,unwinged,vary,wall,white,wide,yellow,ympodial	arrangement,capitate,color,form,growth,height,history,inflorescence,leaf,length,life,perennial,pseudostipule,shape,spacing,surface,texture
16	wfo-0001025685	success	222	110	90	132	20	0.405	-22,/3,0.3-1,10-15,12-13,2-2.2,2-5,2-7,3-10,3-3.5,4-5,6.5-9,7-8,8-10,abaxially,adaxially,anther,anthesi,apex,armed,basally,base,berry,branched,brown,calyx,chartaceous,clavate,cm,cordiforme,corolla,diameter,discolorous,filament,finely,flattened,flower,fruiting,glabrous,glandular,globose,green,growth,heavily,lanceolate,lobed,long-styled,minute,minutely,mm,orangish,ornamented,ovary,ovate-cordiforme,ovate-elliptic,pedicel,plant,prickle,prickly,pubescent,quadrate,recurved,red,reflexed,reniform,reticulate,scar,short-styled,shrub,simple,size,small,sparsely,stem,stigma,style,subcompressed,subglobose,subscabrous,subtruncate,tapering,tomentose-scabrous,tree,trichome,tube,velutinous-floccose,way,white,x,yellowish	-15,-30,/4,0.2-0.3,0.3-0.5,0.4-6,0.45-0.9,0.5-1,1-1.5,1-4,1-multicellular,1.4,1.5-2,1.5-2.5,1.8-2.5,2,2-3,2-4,2-6,3,3-4,3.5-10,4-4.5,50,7-18,<,acuminate,acute,adult,angulate,apart,apiculate,articulated,ascendin,bark,basal,caly,channelled,concav,cordate,coriaceous,cuneate,curved,dark,deciduous,deltate,dense,distal,eaf,eed,elongating,entire,erect,exserted,flowering,foliaceous,free,glabrescen,glandular-viscid,heterostylous,impressed,internodal,juvenile,larger,like,lobe,long,lower,margin,midpoint,mixed,multangulate,multicellular,new,nflorescence,oblique,oblong-lanceolate,obverse,older,ovate,papillo,partially,peduncle,per,perfect,pericarp,persistent,petiole,plurifoliat,pore,poricidal,porrect,portion,puberulent,pubescence,raised,ray,reduced,rest,ripe,ruit,scabrous,scandent,sessile,shallowly,slightly,slit,spaced,sparse,stalked,staminate,stellate,straight,subcordate,testa,thick,time,tip,tomentose-ferruginous,tomentose-floccose,tomentose-velutinous,triangular-lanceolate,truncate,turbinate,ud,uneven,unit,vein,venation,without,woody,ympodial	armament,arrangement,branching,color,edge,form,fruit,height,inflorescence,leaf,length,na,number,papillose,pricklines,pseudostipule,seed,shape,surface,texture
17	wfo-0001025688	success	218	120	70	148	50	0.321	1,1-celled,1/2,4-lobed,accrescent,acicular,acute,anther,apex,base,brown,calyx,cm,cylindrical,deeply,diameter,directed,distally,entire,erect,extra-axillary,filament,flower,fruit,fruiting,glabrous,gland-tipped,globose,hair,lanceolate,leaf,lobe,lobed,margin,minute,mm,nearly,ovate,pedicel,peduncle,per,pericarp,petiole,pilose,pore,prickle,rachi,shrub,simple,small,somewhat,sparsely,spreading,stellate,stem,stigma,style,suborbicular,surface,thickened,thin-textured,tip,truncate,tube,unbranched,way,white,yellow,yellow-green,yellowish-green	0.1,0.1–2,0.2,0.5,0.5–2,0.5–3,0.5–3.5,0.6–0.8,0.6–2,0.6–2.4,0.6–4,0.8,0–10,1.3–1.7,1.5–2,1.5–3,1.5–4,14155,15–25,1–1.5,1–1.6,1–1.8,1–2,1–3-celled,1–6-celled,1–8,2-foliate,25,2–3,2–3.5,2–4-celled,2–4–celled,3.2–3.6,3–10,3–4,4,40–75,4–15,4–5-rayed,4–6,4–9,5,59,5°,5–18,6–7,6–8,8–10,8–15,=,abaxially,abruptly,adaxiall,adaxially,also,angle,anthesi,armed,ascending,average,axe,blade,branch,coiling,conpsicuously,constricted,contiguou,curved,darker,dense,densely,developing,distall,eaf,eed,enlarged,except,fewer,flattened,flowering,free,fresh,geminate,gland,glutinous,grading,green,hyaline,lacking,larger,less,lon,long,lower,major,many,minor,mottling,n,narrowed,narrowly,nee,nflorescence,none,often,one,orolla,otherwise,puberulent,pubescence,rarely,rather,recurved,ripe,ruit,scarious,scattered,sessile,short,similar,single,size,slightly,sometimes,stellae,stipitate,straight,sulcate,tal,tamen,tapering,tem,thic,thick,thickene,triangular,truncat,twice,unit,upper,usually,vary,vein,wide,wing,x,ympodial,±	0.1-2,0.5-3,0.5-3.5,1-2,1.3-1.7,2-3.5,3-10,3-4,3.2-3.6,4-6,4-9,40-75,6-7,8-15,accrescence,arrangement,bud,color,contiguous,corolla,edge,form,growth,height,history,inflorescence,insertion,lanate-pubescent,length,lengthening,life,na,number,orientation,ovary,perennial,perfection,persistence,plant,position,pseudostipule,seed,shape,spacing,splitting,staman,suture,texture,thicknes,type
18	wfo-0001025694	success	199	76	62	137	14	0.312	0.2,0.2–0.3,0.5–1,0.5–3,1.5–3.5,1–3,2.5,20,2–15,2–3,2–5-branched,3–5,abaxial,absent,adaxial,brown,center,chartaceous,cm,dark,densely,diameter,drying,elliptic,erect,flattened,fruit,globose,green,hair,inflorescence,length,like,margin,mm,moderately,mottled,nearly,often,ovate,petiole,plant,porrect-stellate,pubescent,ray,reniform,rugose,rusty,scandent,shrub,simple,sparsely,stalk,stellate-pubescent,stem,still,surface,swollen,turning,white,whitish,×	0.3–0.6,0.5–1.5,1,1.5–2,10–15,10–25,1991,1–2,1–2.5,2.5–11,25–50,2–3.5,2–4,3–6,4–12,4–15,4–5,5-merous,5–10,6–10,6–20,8–12,abaxially,absen,accrescent,acute,adaxiall,adaxially,alyx,androgynoecious,andromonoecious,anther,apart,apex,apical,armed,articulated,asymmetrical,attenuate,axe,ba,base,becoming,berry,beyond,blade,calyx,capitat,completely,connivent,cordate,covering,cylindrical,discolorous,eaf,eed,entire,exerted,exserted,filament,flower,frui,fruiting,functionally,fused,glabrous,gland-tipped,glandular,hermaphroditic,heterostylou,interpetalar,little,lobe,long,lower,male,matur,membranaceous,midpoint,midrib,midvein,mixed,multicellular,multiseriate,narrowly,nflorescence,obtuse,occasionally,opening,orange,orolla,pedicel,peduncle,per,pinnate,plurifoliat,pore,prickle,rachi,recurved,reflexed,roselike,ruit,secondary,short,side,slit,spaced,sparse,specifically,spine,stamen,staminate,stellate,stigma,style,tal,tamen,tan,tem,tip,tissue,triangular,triangular-ovate,tube,unicellular,uniseriate,unit,vary,vein,venation,walker,whelan,wide,yellow,ympodial,young	arrangement,color,colour,form,growth,height,leaf,na,seed,shape,size,tall,texture,width
19	wfo-0001025697	success	181	82	62	119	20	0.343	0-14,0.15-0.75,0.6-3.5,1-1.7,1-2,1.7-8.6,10-26,2-10.5,2-2.6,2-4,2-6,25-35,3-10,3-4,3-5,3-6,4-7.5,anther,brownish,clavate,cm,coriaceous,corolla,deep,diameter,drying,elliptic,filament,flower,forked,fruit,glabrous,globose,green,greenish,herb,homostylous,interjected,leaf,leaflet,medium,mm,mucilaginous,odd-pinnate,ovate,ovoid,pair,pedicel,peduncle,pentagonal,petiole,plant,purple,rotate,seed,size,stigma,stripe,style,terminal,whitish,x	-9,0.8-2,1-3,1.5-1.8,3.3-11,5-merou,5.5-11.5,6.5-13.5,abaxially,acumen,acuminate,acute,adaxiall,adaxially,ag,alyx,apart,apex,apparently,articulated,asymmetric,attenuate,axe,axillary,base,basiscopic,berry,blade,blue,bud,capitat,cell,condition,connivent,covering,dark,decreasing,decurrent,digestion,distal,dorsally,eaf,edge,eed,enzyme,erec,exceeding,flat,folded,fresh,geminat,generally,glabrescent,glabrou,green-white,hair,hair-like,hal,half,high,honeycomb-shaped,lanceolate,lateral,lengthening,light,lilac,linear,living,lobe,long,lower,make,nflorescence,orbicular,orolla,perfect,petiolulate,plurifoliate,pore,poricidal,rachi,removed,ripe,rounded,ruit,sessile,seudostipule,short,side,slightly,slit,spaced,specimen,stamen,straight,subequal,subglabrou,subtending,tall,tamen,tem,testal,thick,throughout,tip,tissue,toward,tri-,tube,typically,unit,unwinged,usually,vary,wall,wet,wood,yellow,ympodial	arrangement,calyx,capitate,color,form,growth,height,history,inflorescence,length,life,number,perennial,pseudostipule,shape,spacing,staman,stem,surface,texture
20	wfo-0001025699	success	181	116	99	82	17	0.547	0.5,1-2,1-2.5,1-3,1.5-2,1/3,10,15-20,2-2.5,2cm,5-winged,8-9,absent,acute,adaxially,almost,anther,apart,apex,attenuate,bark,base,becoming,berry,branching,brown,calyx,capitate,cm,completely,conical,conspicuously,corolla,dark,darker,diameter,dry,ellipsoid,elliptic,entire,filament,glabrous,globose,green,grey-brown,growth,immature,inflorescence,irregularly,leaf,leaf-opposed,leafy,leaving,less,lobe,lobed,margin,markedly,midrib,minutely,mm,new,older,ovary,pale,papillose,pedicel,peduncle,peg,petiole,poricidal,red,reniform,reticulate-pitted,rounded,rounded-sagittate,scar,shoot,short,simple,slightly,small,somewhat,spaced,stem,stigma,strongly,style,surface,tangled,time,tip,tree,trichome,tube,way,white,young,½	.2,.5,1,1-1.5,1.5,2,2-6,3-15,3-3.5,3-5.5,3-8,4-5,499,5-8,5.5-14,abaxially,age,anthesi,apparently,appearing,articulating,c.,campanulate,continuing,corrugate,crystal,cup-shaped,deltate,densely,difoliate,dorsal,drying,eaf,eed,erect,exerted,face,fide,flower,free,fruiting,glabrou,included,inclusion,inflorescenc,lanceolate,lengthening,lower,narrowly,nflorescence,nodding,one,onto,oxalate,pair,papillat,penden,per,perfect,plurifoliate,pore,portion,primary,reddish,ruit,sand,slit,stearn,straight,thickened,triangular,ud,unit,vein,white-spotted,wide,wing,winged,woody,x,yellow,ympodial	arrangement,articulation,bud,canaliculation,color,corrugated,edge,form,fruit,length,orientation,papillate,position,seed,shape,spacing,texture
21	wfo-0001025700	success	189	81	64	125	17	0.339	0-16,0.30-2.0,0.7-2.7,0.8-2.6,1.1-2.3,10-40,10.5-12,15-40,2-12,2.5-4,3.5-10.5,3.7-8.6,5-15,5-20,5.3-17.5,5.5-8,anther,brownish,chartaceous,clavate,cm,condition,corolla,diameter,dot,drying,elliptic,flower,forked,fresh,fruit,glabrescent,glabrous,globose,green,greenish,herb,interjected,leaf,leaflet,lilac,mm,mucilaginous,odd-pinnate,ovate,ovoid,pedicel,peduncle,pentagonal,petiole,plant,purple,ripe,rotate-pentagonal,seed,size,sometimes,stigma,style,terminal,wet,white,whitish,x	0.5-2,0.8-4,1-2,1-3,1.5-2,2-7,3-4,3-8,4-5,5-merou,5.5-18,9-31,abaxially,acuman,acumen,acuminate,acute,adaxially,ag,alyx,apex,apiculate,apparently,articulated,asymmetric,attenuate,axe,axillary,basal,base,basiscopic,berry,blade,bud,capitat,cell,connivent,considerably,covering,decrease,decreasing,digestion,distal,dorsally,eaf,edge,eed,enzyme,erec,exceeding,except,filament,flat,folded,geminat,generally,glabrou,green-white,hair,hair-like,hal,half,high,homostylous,honeycomb-shaped,lanceolate,larger,lateral,lengthening,light,linear,living,lobe,long,lower,make,medium,narrowly,nflorescence,orbicular,orolla,pair,par,perfect,petiolulate,plurifoliate,pore,poricidal,proximal,removed,rounded,ruit,sessile,seudostipule,short,side,slightly,slit,specimen,stamen,straight,subequal,subglabrou,subtending,tall,tamen,tem,testal,thick,throughout,tip,tissue,toward,tri-,tube,typically,unit,unwinged,usually,vary,wall,whose,winged,yellow,ympodial	arrangement,capitate,color,form,growth,height,history,inflorescence,length,life,number,perennial,pseudostipule,shape,stem,surface,texture
22	wfo-0001025702	success	279	143	93	186	50	0.333	.0,2,2.2,2.3,3.2,5.4,abaxially,acute,adaxially,anther,apex,attachment,base,becoming,broadly,brochidodromous,bud,calyx,capitate,channeled,chartaceous,cm,completely,corolla,cuneate,deltoid,developed,diameter,distinct,edge,elliptic,entire,extra-axillary,filament,flattened-orbicular,flower,fruit,glabrous,globose,hair,intact,interpetalar,joining,lanceolate,lateral,lobe,margin,midvein,mm,moderately,notched,oblong,obtuse,ovate,pedicel,perforated,petiole,point,poorly,prickle,pseudo-intermarginal,pubescent,raised,red,remaining,retrorse,rounded,scandent,shrub,simple,smooth,sparsely,splitting,stellate,stem,stigma,strongly,style,sub-coriaceous,surface,suture,tip,tissue,toward,triangular,tube,vein,white,yellow-ferruginous,yellow-tan,±glabrous,×,–6	.1,.3,.5,.7,/2,0.04,0.3–0.4,0.3–2.2,0.4–2.3,0.5–0.6,0.5–0.8,0.5–1.3,0.6–0.9,0.6–1.0,0.7–1.4,1.2–1.6,1.3–1.8,1.3–2.8,1.4–1.6,1.4–2.2,1.4–2.8,1.6–1.7,1.6–1.8,1.6–2.0,1.6–2.1,1.6–2.3,1.7,1.7–2.3,1.7–9.2,1.9,1/3,1/4–1/3,2.0–3.2,2.2–2.9,2.3–6.6,2.3–7.8,2.5,2.6–7,2–14,3.6–3.9,4,4.3,4.5–5.2,4–16,5-merou,5.2–7.5,6.6,6.9–10.3,6–10,6–8,acuminate,adjacent,adnate,aequilateral,ag,alyx,anthesi,apart,apical,apiculate,apparently,appearing,appresse,around,articulate,attenuate,axe,ba,bark,based,berry,blade,branch,broad,broad-based,brown,congested,cream,curved,deciduous,deflexed,deltate,densely,dentate,difoliate,directed,distal,distally,dry,eaf,eed,either,emerging,endocarp,exocarp,extending,ferruginous,fertile,filiform,flexed,forked,free,geminat,glandular,glossy,gradually,gree,homostylous,hooked,hort,increasing,incurved,indistinct,internode,intersepalar,juic,laterally,lax,layer,limp,lon,long,longer,lower,m.,mature,midpoint,midrib,minute,nearly,nflorescence,oblique,occasionally,opaque,orolla,per,pore,porrect,portion,potentially,presen,primary,pseudo-peduncle,ray,reddish,reflexed,row,ruit,scattered,secondary,seen,sessile,shoot,side,sinus,sloughing,smoot,sometimes,somewhat,soon,spread,stamen,stellae,stellate-pubescent,straight,tamen,tem,thin,time,transparent,truncate,two,ud,unarmed,unbranched,upper,vary,wide,yellow,yellow-ferruginou,ympodia,young,±90,±90°,±connivent,±equal	0.3-0.4,0.3-2.2,0.5-0.8,1.2-1.6,1.3-2.8,1.4-2.8,1.6-2.0,1.6-2.3,1.7-9.2,2-14,2.0-3.2,4.5-5.2,5-merous,accrescence,age,arrangement,canaliculation,color,form,fruiting,growth,height,history,inflorescence,lanate,lanate-pubescent,leaf,length,lengthening,life,na,number,orientation,ovary,peduncle,perennial,perfection,persistence,plant,position,prominence,pseudostipule,rachi,seed,shape,spacing,texture,tomentose-velutinous,type,woolly
23	wfo-0001025704	success	248	129	115	133	14	0.464	0-3.5,0.1-0.5,0.7-1,1,1-3.5,1-4,1-6,1.2-3,1.5-3.2,1/2-4/5,1/5,2,2-3,3-10,4.5-6.5,5-merous,8-17,abaxial,abaxially,acute,adaxial,almost,anther,apart,apex,auriculate,bark,base,branched,cell,chartaceous,cm,cordate,curved,densely,diameter,discolorous,drying,ellipsoid,elliptic,evenly,filament,flattened,flattened-reniform,flower,fruit,glabrescent,gray,green,green-yellow,irregular,lateral,leaf,length,lobed,long,margin,maturity,mauve,midpoint,mm,multangulate,occasionally,often,orange,orange-brown,outline,ovate,pale,pedicel,peduncle,petiole,pit,plant,porrect,prickle,prickly,prominent,raised,rarely,ray,red-brown,red-green,round,sessile,shape,shorter,small,smooth,sometimes,somewhat,spherical,stalked,stellate-pubescent,stem,straight,strongly,style,surface,terete,terminal,trichome,truncate,unbranched,upper,variously,warty,way,white,white-gray,wide,yellow,yellow-green,yellowish,young	-10,-2,-3,-5,/6,0,0-100,0-2,0-5,0.1,0.1-0.3,0.15-0.8,0.3-0.8,0.5-1.5,1.5-2,1.5-4.5,1.8-3.5,1/4-3/4,2-10,2-4.5,2-5,2-7,2.5-4.5,2.7-4,3-15,3-5,3-6,4-12,4-5,5-20,6-12,6-15,8-12,8-15,age,alyx,andromonoecious,apar,apically,apiculate,apparently,articulated,axe,ba,berry,blade,broad-deltate,brow,calyx,connivent,covering,deltate,development,distal,distance,eaf,eed,elongating,end,equal,erect,extending,free,fruiting,glabrous,half,hermaphrodite,heterostylous,infructescence,less,lobe,lobing,long-styled,longer,lower,lowermost,mature,midvein,moderately,near,nflorescence,obtuse,older,one,open,orolla,oung,pair,pendulous,per,pericarp,plurifoliat,poricidal,portion,prickl,primary,recurved,reflexed,retaining,rounded,ruit,scar,secondary,short-styled,shrub,side,slender,spaced,sparsely,spreading,stalk,staminat,stellate,stellate-pubescen,stout,tamen,tapering,tertiary,throughout,time,tip,tree,tube,unarmed,unit,vary,vein,venation,visible,widening,woody,ympodial,×	arrangement,brown,color,corolla,height,inflorescence,ovary,position,seed,spacing,staman,texture,tomentose-velutinous,width
24	wfo-0001025714	success	249	130	74	175	56	0.297	100,2.8,>,abaxially,accrescent,acute,adaxially,anther,apart,apex,base,berry,broadly,calyx,cm,cylindrical,decidedly,diameter,extra-axillary,fertile,filament,flattened,flower,fruit,fruiting,glabrous,gland-tipped,glandular-pubescent,globose,hair,hyaline,light,lobe,lobed,long,longer,margin,maturity,minutely,mm,narrowly,nearly,orbicular,ovary,ovate,pedicel,peduncle,per,petiole,pilose,prickle,pubescence,rachi,rounded,short,shrub,similar,simple,stellate,stem,stigma,stipitate-glandular,straight,style,subcordate,subreniform,tan,triangular,truncate,tube,unbranched,white,yellow,yellowish	%,-5,-rayed,.2,0.1–0.8,0.2–0.8,0.5,0.5–0.6,0.5–1.3,0.5–2,0.8,0–0.4,1,1.2–2.4,1.3–3,1.5–2,1.5–2.5,1.5–3.5,1.6–2.3,1.8–,1/3,10–11,13,15,15–25,1–2,1–4,2,2-foliate,2.2–3,2.5,2.5–3.8,2–3,2–4-celled,2–7,2–8,3.7–5,3–16,3–9,4–18,4–6,5,5.9–7.5,50,5–25,5–6.5,6.2–6.8,6–16,7–18,7–8.5,8–13,9.2–10,9–22,absent,acicular,adaxiall,additional,always,anthesi,appearing,armed,around,articulated,ascending,asia,attenuate,axe,ba,blade,branch,capitat,caudate-tipped,completely,concealing,covering,curved,differing,dilated,dimorphic,directed,distall,eaf,eed,enlarged,entire-margined,erect,few-branched,few-rayed,forward,free,frui,geminat,glabrou,gland,gland–tipped,half,halfway,herbarium,horizontally,immediately,increasingly,lacking,larger,latter,less,lobing,longest,lower,lowermost,mainly,major,male,many-rayed,midrib,minor,minute,mixed,multangulate,nflorescence,numerous,obtuse,often,one,orolla,pair,perhaps,plane,pointing,pore,predominating,pubescent,rare,rarely,recurved,reflexed,ruit,scarcely,scattered,sessile,shorter,single,size,slender,slightly,small,smaller,sometimes,spaced,sparse,specimen,spine,spreading,stellae,stipitate,stouter,subglabrous,tal,tamen,tem,terete,thin-textured,time,toward,unequal,unit,upper,usually,various,vary,way,wide,x,ympodial,–1.25,–7–9	0-0.4,0-0.8,0.2-0.8,0.5-2,1.3-3,1.5-2.5,1.5-3.5,1.6-2.3,15-25,2-3,2-4-celled,2-7,2-8,3-9,5.9-7.5,6.2-6.8,7-8.5,9-22,accrescence,arrangement,bud,capitate,color,corolla,edge,form,growth,height,history,inflorescence,insertion,lanate-pubescent,leaf,length,lengthening,life,na,number,orientation,perennial,perfection,persistence,plant,position,pseudostipule,seed,shape,spacing,splitting,staman,surface,suture,texture,tip,type,ye
25	wfo-0001025726	success	158	93	72	86	21	0.456	-10,-16,-5,0.2,0.2-0.3,0.5,0.5-1.5,1-1.5,1-2.5,1-3,10-15,2.5,3-10,3-5,5,6-12,6-8,acute,anther,base,branched,brown,calyx,campanulate,chartaceous,cm,compound,diameter,entire,filament,flattened,foveolate,fruit,glabrous,globose,green,hair,imparipinnately,internode,light,long,margin,mm,narrowly,oblong,pedicel,peduncle,perennial,petiole,pinnate,pinnatifid,prickle,purple,rachi,rarely,recurved,shape,simple,size,slender,stellate,stigma,strongly,style,surface,unbranched,variable,variously,white,wide,x,yellow	0-1,1,2-,2-3,20-40,3-4,4,4-10,7-9,abaxially,accrescen,acuminate,adaxiall,adaxially,adjacent,ag,alyx,anthesi,apex,armed,articulated,axe,ba,becoming,blade,broadly,clustered,confluent,connivent,dr.,eaf,eed,elliptic,elongating,equal,fertile,flower,fruiting,geminat,lateral,leaflet,lengthening,lobe,lobed,major,midrib,nflorescence,oblon,occasionally,often,orolla,ovate,plurifoliate,pore,poricidal,present,puberulent,ranging,recurve,rounded,rugose,ruit,scandent,side,slit,spreading,stout,straight,subwoody,swollen,tamen,tem,terminal,terminally,time,tip,truncat,tube,ud,unit,usually,vary,vein,vin,woody,ympodial	2-10,abaxial,arrangement,bud,color,corolla,form,growth,history,inflorescence,leaf,length,life,ovary,seed,staman,stem,texture,truncate,type,vine
26	wfo-0001025729	success	177	103	67	110	36	0.379	.5,0.25-0.5,0.7-1.2,1-1.5,1-5,1.1-1.5,1.2-1.8,20,4-5,6-8,acute,anther,apex,bark,base,bud,calyx,cm,corolla,cyathiform,dirty,elliptic,filament,flattened-reniform,fruiting,furcate,glabrous,globose,green,greenish-yellow,greyish-brown,leaf,lobe,lobed,margin,minor,minutely,mm,opposite,ovary,pale,papillose,pedicel,petiole,pitted,plant,pore,pubescent,ripening,rounded,shaped,shiny,simple,sparsely,stem,stigma,style,surface,tear-drop,tip,tree,treelet,trichome,tube,uniseriate,white,yellow	-20,/4,1.5-2,1.75,2,2-3.5,3-6,4-8,5-50-flowered,7-8,9-17,abaxial,abaxially,abrupt,adaxially,along,anthesi,apar,apical,apiculate,appearing,axil,basal,berry,black,blackish,branched,bright,bristly,covered,covering,dark,deflexed,deltoid,densely,denser,dia,diam,differing,difoliate,drying,eaf,edicel,eed,enclosed,expanded,f,fleshy,free,geminat,gently,glabrou,growing,incrassate,lamina,lat,lateral,like,live,lon,long,lower,m.,main,mainly,major,member,middle,minute,nflorescence,oblique,occasionally,often,older,one,overlapping,overtopping,pair,papillo,partially,pit,poricidal,portion,prominent,quite,raised,reflexed,ruit,scar,short,size,stout,straight,tall,tapering,terminal,touching,tub,tuft,ud,unit,usually,vein,way,widening,widest,woody,x,ympodial,young	4-20,5-50,accrescence,alternate,arrangement,color,diameter,edge,flower,form,fruit,growth,hair,height,inflorescence,insertion,lanate-pubescent,length,lengthening,na,number,orientation,peduncle,perfection,persistence,position,pseudostipule,rachi,seed,shape,spacing,splitting,staman,suture,texture,type
27	wfo-0001025737	success	220	95	62	158	33	0.282	-branched,10,2,5-merous,abaxially,adaxially,angularly-cordate,anther,apex,attenuate,base,bright,broad-based,cm,densely,diameter,entire,extra-axillary,flattened-reniform,flower,fruit,glabrous,globose,green,growth,homostylous,internode,interpetalar,lance-ovoid,lateral,light,lighter-colored,linear-attenuate,loosely,margin,minutely,mm,narrow,obtuse,orange,ovate,ovate-lanceolate,petiole,pitted,prickle,rounded,seed,shrub,simple,stellate,stellate-tomentose,stem,stigma,straight,style,surface,tissue,tomentose,triangular-attenuate,turning,usually,yellow	0.2–0.3,0.3–0.7,0.3–2,0.6,0.6–0.9,0.7–1.3,0.8–1.1,0.9–1.1,1.4–1.8,1.5,1.5-2,1.5–2,1.5–3,1.5–5,1.5–6.5,1.7–2.2,10–12,1–,1–1.2,1–1.5,2.5–3,2.5–4.5,25–50,2–3,3,3.5–5,3.5–8,3–10,44599,47092,4–11,4–6,5,51,5–6,7–8,8–10,8–16,9-10,95,absent,accrescen,acute,adaxiall,age,alyx,apart,apical,apparently,appressed-tomentose,armed,articulated,axe,ba,becoming,blade,branch,capitat,deeply,difoliate,directed,distall,eaf,eed,except,fertile,filament,filiform,finely,free,geminat,glabrou,gland-tipped,greenish,hair,high,immature,juicy,juvenile,like,linear-lanceolate,lobe,lobed,lon,long,long-stipitate,lower,major,midpoint,midvein,midzone,minute,mixed,near,nee,nflorescence,northern,numerous,oblong,odorle,orolla,pale,part,pedicel,peduncle,per,perfect,persistently,pore,porrect,principal,range,rarely,ray,reflexed,ruit,scarcely,sessile,shallowly,shiny,short-,short-stipitate,shorter,side,sinus,slender,southern,spaced,sparsely,splitting,ste,stellae,stellate-pubescent,stipe,straigh,tamen,tem,thick-chartaceous,time,tinge,tomento,tube,ud,unarmed,vary,vein,vigorous,violet,white,whitish,wide,x,ympodia,×,–14,–20,–3,–4	-3,0-3,0.3-0.7,0.7-1.3,1-,1.5-3,1.5-5,10-12,25-50,3-10,4,arrangement,bud,calyx,capitate,color,corolla,form,height,history,inflorescence,leaf,length,life,number,ovary,perennial,plant,pseudostipule,shape,staman,texture,width
28	wfo-0001025741	success	231	134	115	116	19	0.498	.5,0.5–0.8,0.5–3,0–0.1,1.8–2.1,11–14,12–15,1–4,2–3,2–7.5,3–10,3–6,4–5,4–6,5-merous,5–17,5–6,6.5–9,abaxial,abundantly,acuminate,acute,adaxial,anther,apart,apex,armed,base,broad-based,brown,chartaceous,cm,cuneate,dark,deltoid,densely,diameter,either,entire,extraaxillary,fading,filament,flattened,flower,fruit,glabrous,glandular,globose,golden-tan,green,hair,heterstylous,inflorescence,juicy,lanceolate,leaf,length,light,lighter,lobed,long,lustrous,major,margin,maturity,midpoint,midvein,mm,moderately,multangulate,multiseriate,nearly,oblique,once-branched,orange,outline,ovate,pedicel,peduncle,petiole,plant,prickle,pubescent,rachi,ray,reniform,rotate-stellate,rugose,sessile,shallowly,sharp,short-cylindrical,short-stalked,side,simple,small,sparse,stellate,stem,stigma,strongly,style,surface,tree,tuft,unbranched,vein,violet,white,yellow,×,–12,–20,–30,–8	.2,0-0.1,1.1–2,1.2–1.5,1.7–2,10–35,15–45,1–2,1–2.5,2.5–3,2.5–3.5,2.5–8,20–23,29–36,2–3.2,2–4,30–120,4–7,6–7,8–15+,8–18,abaxially,abundant,adaxially,along,alyx,andromonoeciou,andromonoecious,anthesi,articulated,axe,ba,bark,becoming,berry,blade,calyx,capitat,column,congested,connivent,covered,curved,cylindrical,db,deltate,difoliate,directed,distall,dry,eaf,eed,eglandular,emergent,equal,flowering,free,fresh,frui,fruiting,functionally,geminat,half,hermaphroditic,included,inflated,interpetalar,knobby,like,lobe,lon,long-stalked,lower,membranaceous,nflorescence,one,orange-tan,orolla,part,pericarp,pore,porrect-stellate,present,remaining,ruit,runk,shiny,short,somewhat,spaced,sparsely,stalk,stalked,staminate,stellate-pubescent,stout,straight,subtending,tamen,tan,tapered,thi,thin,time,tissue,tube,unarmed,unit,vary,wide,within,ympodial,young,–28,–39,–6	arrangement,capitate,color,colour,corolla,dbh,form,growth,height,history,life,ovary,perennial,position,seed,shape,spacing,staman,texture
29	wfo-0001025743	success	157	131	98	59	33	0.624	%,.5,0-15,0-6,0.1-0.3,0.15-0.3,0.3-0.5,0.3-0.6,0.4-0.5,0.4-0.8,0.5-0.9,0.9-1.2,0.9-2.6,1.2-4,1.3-1.8,12-17,2-4,2.3-5,2.8-3.5,3-13,3-4,3.5-5.5,30-80,4.5-5.5,5-10,6-10,6-20,6-7,9-18,abaxially,absent,acicular,adaxially,apex,articulated,base,broadly,brown,chartaceous,cm,cordate,cuneate,cylindrical,decimetre,deeply,dense,diameter,directed,extra-axillary,finger,flower,fruit,glabrous,gland-tipped,globose,green,grey,hair,herbaceous,index,inflorescence,lamina,lateral,length,lobe,lobed,lobing,long,longer,margin,midvein,mm,obtuse,ovate,pale,pedicel,peduncle,per,petiole,plant,pore,present,prickle,prostrate,resprouter,sprawling,stage,stellate,straight,style,throughout,time,unbranched,vein,white,wide,x,yellow	1,1-6,11-25,2-3,2-4.5,3-6,4-8,5-20,5-merou,8-10,absen,adaxiall,adult,alyx,andromonoecious,apart,armed,axe,ba,blade,branche,calyx,deltate,distall,eaf,eed,fruiting,functional,half,heterostylous,less,lon,lower,mature,mid-point,minute,nflorescence,nther,oblique,onl,orolla,part,presen,ruit,short,side,simple,spaced,strongly,tal,tem,thick,tube,unit,unknow,uvenile,vary,yellowish-gree,ympodial	5-merous,abaxial,adaxial,anther,articulation,color,corolla,density,direction,distally,form,growth,height,history,juvenile,leaf,life,number,ovary,position,presence,relative,seed,shape,size,spacing,stem,surface,texture,thicknes,tip,width,yellowish-green
30	wfo-0001025749	success	217	120	97	120	23	0.447	-12,0.1-0.3,0.2-1.5,0.3-1.5,0.4-0.7,0.5-0.8,0.5-0.9,0.5-1.3,0.5-3,0.8-0.9,1-10,1-2,2-10,2.5-6,5-10,5-merous,abaxial,abaxially,acute,adaxial,anther,apart,apex,apparently,bark,base,berry,calyx,chartaceous,cm,concolorous,cuneate,dark,densely,diameter,discolorous,drying,dull,elongating,filament,filiform,flattened-reniform,flower,fruit,fruiting,glabrescent,glabrous,gray,green-brown,lateral,leaf,length,light,lobed,long-ovate,margin,markedly,maturity,mauve,midvein,mm,moderately,narrow-deltate,orange-brown,orange-red,orbicular,ovate,pale,pedicel,peduncle,petiole,porrect,prickle,prickly,purple,recurved,red-brown,rounded,scar,sessile,shrub,smooth,sometimes,sparsely,spherical,stalked,stellate-pubescent,stem,straight,strongly,style,surface,trichome,white,yellow,yellow-green,yellowish	-1,.5,/5,0-10,0-3,0-5,0-6,0-8,0.1,0.1-0.2,0.1-0.4,0.2,0.5,0.6-4.5,1,1-13,1-3,1-6,1-8.5,1-9,1.5,1.5-2,1.5-2.5,1/4-1/3,1/5-1/2,2-2.5,2/3,3-20,3-5,4-8,5-,5-20,6-8,acuminat,adaxially,adnate,almost,alyx,apar,apically,articulated,blade,branched,broad-deltate,curved,difoliate,distance,eaf,eed,equal,erect,extending,flattened,free,geminat,gently,herbaceous,indistinct,infructescence,lobe,lon,long,longer,lower,magnification,mature,midpoint,narrow-ovate,nflorescence,oblong,obtuse,occasionally,older,one,open,orange-brow,orolla,oung,pair,pendulous,per,perfec,pericarp,poricidal,portion,prickl,primary,procumbent,rarely,ray,reduced,ruit,shorter,side,spaced,spreading,stalk,stellate,straw-yellow,tamen,tapering,terete,tertiary,time,tip,toward,tube,unit,usually,variously,vary,vein,venation,visible,way,wide,without,yellow-orange,ympodial,½-2/	arrangement,color,colour,corolla,form,growth,height,history,inflorescence,life,na,ovary,perennial,plant,position,rachi,seed,shape,spacing,staman,stigma,texture,width
31	wfo-0001025754	success	164	134	105	59	29	0.64	-celled,.5,0.5-1,0.5-1.5,1,1-2,1-3,1.5,1.5-3,10-20,2-5-celled,2-7,4,4-6,5-15,absent,acuminate,acute,along,anther,apex,base,beyond,blade,branch,brown,center,chartaceous,ciliate,cm,cordate,cordiform,decumbent,densely,denser,diameter,dm,drying,edge,eglandular,entire,equal,erect,explosively,exserted,filament,fine,flat,flower,fruit,glabrous,globose,hair,held,herb,immature,leaf,leaving,linear-lanceolate,lobe,long,lying,main,margin,maturing,membranaceous,mesocarp,mm,moderately,nearly,oblong,palmately,parallel,pedicel,peduncle,petiole,pressure,probably,pubescent,rachi,radiating,raised,ridge,rotate,running,semitransparent,shallow,solitary,sparsely,stamen,stem,stigma,straight,style,surface,swollen,truncate,tube,unbranched,upright,vein,watery,white,x,yellow	0.1-0.2,1-3.5,1.5-4,10-35,2-4,2-foliate,3-10,3-5,3-6,5-12,abaxially,abundant,adaxiall,adaxially,asymmetrical,axe,barely,berry,calyx,connected,decurrent,dehiscing,dried,eaf,eed,emarginat,geminat,glandular,interpetalar,like,lower,material,maturit,mixed,much-branched,nfloresence,notch,often,orolla,penden,per,placenta,pubescen,ruit,short,slightly,small,sometimes,tal,tamen,tem,tissue,triangular,unit,vary,visible,wid,woody,ympodial	abaxial,adaxial,arrangement,color,colour,corolla,decument,dehiscence,emarginate,form,geminate,growth,height,history,inflorescence,length,life,maturity,na,ovary,perennial,plant,position,seed,shape,spacing,staman,texture,width
32	wfo-0001025760	success	210	128	103	107	25	0.49	-12,-6,.5,/3,0-0.5,0.1,0.15-0.3,0.3-1,0.45-0.9,0.5-1.5,0.5-2,0.7-2.5,0.8-1.8,1-4,2.3-4,3,3.5-17,abaxial,abaxially,acute,adaxial,almost,annual,anther,apex,apically,bark,base,black,broad-deltate,calyx,chartaceous,cm,cream,cultivar,cuneate,dark,diameter,dull,elliptic,erect,filament,flattened-reniform,flower,fruit,fruiting,glabrescent,glabrous,green,hair,herb,lateral,leaf,length,lobe,lobed,long,margin,marking,maturity,membranous,midpoint,minute,mm,moderately,often,orange,orange-brown,ovate,pale,pedicel,peduncle,pendulous,perennial,petiole,porrect,ray,red-brown,rounded,sessile,shape,shorter,shrub,side,simple,smooth,sometimes,spherical,stalked,stellate,stellate-pubescent,stem,style,surface,trichome,unbranched,various,way,white,woody,yellow,yellow-green,young	-10,-3,-5,0-100,0.1-0.2,0.2-0.35,0.4-0.8,1,1-,1-1.8,1-2,1.5,1.5-2.5,1.5-4.5,1.5-5,1/4,1/4-1/2,1/4-1/3,1/5,2-2.5,2-3,2.1-3.5,2.5-10,2.5-8,2/3,3-6,3.5-9,5-10-merous,5-18,8-10,acut,alyx,apar,apparently,articulated,berry,blade,brow,concolorous,connivent,curved,deltate,difoliate,discolorous,distance,drying,eaf,eed,elongating,equal,extending,free,geminat,geminate,gently,infructescence,lengt,longer,lower,mature,midvein,nflorescence,older,one,open,orolla,oung,pair,per,perfec,pericarp,poricidal,portion,primary,recurved,reflexe,ruit,scar,slender,spaced,spreading,stalk,stellate-pubescen,stout,straight,subentire,tamen,tapering,terete,tertiary,thick-stalked,time,tip,tube,unarme,unarmed,unit,upper,usually,variously,vary,vein,venation,visible,weakly,wide,ympodial	apart,apical,arrangement,brown,color,colour,corolla,form,growth,height,history,inflorescence,life,na,ovary,plant,position,rachi,reflexed,reflexion,seed,spacing,staman,stigma,texture
33	wfo-0001025782	success	200	109	88	112	21	0.44	0-5,0.1-0.15,0.1-0.25,0.3-1,0.5-1,0.55-0.75,0.9-1.3,1,1-2.5,1.2-6,1.3-1.6,1.5-3,2-5,2-7,20,3-5,4,4-4.5,5-merous,6-8,abaxial,acuminate,adaxial,anther,apex,apically,articulated,bark,base,brown,climbing,cm,conical,connivent,cuneate,curved,densely,diameter,dull,elliptic,evenly,filament,flattened,flattened-reniform,flower,fruit,gently,glabrescent,glabrous,green,lateral,leaf,length,lobed,margin,midpoint,mm,moderately,orange-brown,pair,pedicel,peduncle,petiole,plant,poricidal,prickle,prickly,primary,scar,shrub,sparsely,spherical,stellate-pubescent,stem,style,surface,tapering,terete,tertiary,tip,trichome,unbranched,vein,venation,visible,weakly,white,yellow	-2,.5,0-10,0.1-0.2,0.4-0.6,1-1.7,1-2,1-4,1/4-1/2,1/4-1/3,1/6,10-13,2-10,2-2.5,2-3,2.5-3.5,2/3-3/4,3-4,4.5-9,5-20,5-6.5,5-8,5.5-6,6-14,abaxially,acuminat,also,alyx,andromonoecious,apar,apart,apparently,berry,blade,calyx,chartaceous,concolorous,deltate,difoliate,discolorous,distal,distance,drying,eaf,eed,elongated,elongating,equal,extending,free,fruiting,geminat,geminate,green-brown,hair,hermaphrodite,heterostylous,infructescence,lengt,less,lobe,long,long-styled,longer,lower,lowermost,mature,maturity,membranous,midvein,minute,nflorescence,occasionally,older,one,open,orolla,oung,pendulous,per,pericarp,porrect,portion,prickl,ray,red-brow,reduced,ruit,sessile,short-styled,shorter,side,simple,smooth,spaced,spreading,staminat,stellate,stout,straight,tamen,time,toward,tube,unit,vary,way,wide,woody,yellow-green,ympodial,young	1.5,arrangement,articulation,color,corolla,curvature,form,growth,height,inflorescence,number,ovary,position,red-brown,seed,shape,spacing,staman,texture,visibility,width
34	wfo-0001025783	success	179	106	84	95	22	0.469	.5,0.5,0.5-1,0.5-1.5,1-1.2,1-3,2,2-3+,<,abaxially,anther,apart,apex,articulated,base,berry,branched,brown,bud,c.,cell,cluster,cm,coriaceous,corolla,dendritic,densely,diameter,ellipsoid,elliptic,erect,filiform,flattened,fleshy,flexuous,glabrous,globose,groove,growth,inserted,lateral,lax,less,lobed,long,long/tall,minutely,mm,narrowly,nodding,pale,pedicel,peduncle,pentagonal,petiole,pitted,pubescent,purple,reniform,ripe,sagittate,scar,shiny,shoot,short,shrub,simple,sleeve,somewhat,sparsely,stellate,stem,surface,terminal,testal,thin,time,trichome,uniseriate,vine,violet,way,weak,woody	0.8-3.5,1-1.5,1.8-2,2-5,2-6.5,3-4,5,5-merou,7-10,abaxiall,acute,adaxiall,adaxially,along,alyx,anthesi,ape,ark,axil,branching,calyx,completely,confined,conical,eaf,eed,entire,expanded,exposed,exserted,flower,free,fruiting,glabrou,green,greyish,hromosome,ilament,keeled,known,lobe,lower,margin,mature,midrib,midvein,minute,mmm,near,new,nflorescence,number,obscured,obtuse,occasionally,older,orolla,outlin,pair,penden,perfect,pericarp,plurifoliat,point,portion,possibly,primary,revolute,ruit,scarious,see,slightly,sometimes,spaced,sparse,stigma,strongly,style,suture,transparent,triangular,truncate,tube,tuft,twinin,type,ud,unit,upper,vary,vein,wide,within,yellowish,ympodial	3,abaxial,adaxial,arrangement,articulation,color,colour,filament,form,fruit,height,inflorescence,leaf,length,outline,ovary,plant,position,seed,shape,spacing,texture
35	wfo-0001025784	success	241	122	86	155	36	0.357	-3,.5,0.2-0.3,0.5,1-5,1/3,3.5,6,abaxially,accrescent,acicular,acute,always,anther,apart,apex,base,black,blade,calyx,cm,diameter,extra-axillary,filament,flower,fruit,fruiting,glabrous,glandular-pubescent,globose,green,greenish,greenish-yellow,irregularly,lanceolate,leaf,lobe,lobed,long,margin,mm,mostly,narrowly,nearly,numerous,ovate,pedicel,peduncle,petiole,pilose,prickle,pubescent,purple,rachi,reflexed,rounded,shallowly,sharp,shrub,similar,simple,slightly,smooth,somewhat,sparsely,stellate,stem,stigma,style,subcordate,subreniform,surface,thick,thicker,thin-textured,toward,triangular,truncate,tube,unbranched,unequal,white,x,yellow,yellow-brown,yellow-green	.2–0.4,0.2,0.2–1.1,0.3–0.5,0.4–2.5,0.5–1.8,0.5–2,0.5–3,0.6–0.8,0.7,0.8–1.1,0.8–1.2,0.9–1.2,0.9–1.4,1,1.2,1.2–2.5,1.3–1.8,1.6–2.2,10,10–15,15075,1709,1–,1–3,1–5,2,2-foliate,2.5–3.3,2/3,2–2.5,2–3,2–4,2–5-celled,2–7,3–4,3–4-rayed,4.5–5.5,5,5–6,6.5–8,6.5–8.5,=,adaxiall,adaxially,also,anthesi,articulated,asplund,ba,becoming,branched,brazil,cell,ciliate,completely,conical,curved,cylindrical,directed,distall,drying,eaf,eed,enclosing,enlarged,especially,et,exceeding,fertile,fide,flattened,free,frui,geminat,glabrescent,glabrou,gland,gland-tipped,hair,hyaline,insolated,irwin,longitudinal,lower,lowest,major,male,many,midpoint,midrib,minute,minutely,moderately,mottled,much,n,nflorescence,obtuse,offset,one,orolla,pair,per,pore,pubescence,raised,rarely,ray,recurved,reported,ripe,rudimentary,ruit,second,sessile,short,side,small,sometimes,spaced,spiny,sprawling,spreading-pilose,stamen,ste,stellae,stipitate,stout,straight,subcapitat,tal,tamen,tem,time,tip,unarmed,unit,upper,usually,variously,vary,vein,way,wid,wide,widest,without,ympodial,young,–2,–4,–5.5,–8,–9	0.2-0.4,0.5-3,0.8-1.1,0.8-1.2,0.9-1.2,0.9-1.4,10-15,2-7,4.5-5.5,8,abaxial,adaxial,arrangement,color,colour,corolla,form,growth,height,history,inflorescence,length,life,na,ovary,perennial,plant,position,reflexion,relative,seed,shape,spacing,staman,subcapitate,texture
36	wfo-0001025788	success	158	106	80	78	26	0.506	-8,0.5-2,1-4,1-5,1.8-2.7,1.8-3.9,15-30,2-13,2-3,2.8-9.5,3-,4-5.5,4.5-10.1,5-8,6-7,6.2-12.5,apical,apically,articulate,base,blue,branched,cm,conical,corolla,cyme,deep,dehiscent,diameter,dichasial,dichasially,diminishing,distal,ebracteate,elliptical,filament,finely,flower,gradually,green,green-white,half,herbaceous,interjected,introrse,lateral,leaf,leaflet,maturing,medium,mm,monochasial,mucilaginous,narrowly,odd-pinnate,often,ovate,ovoid,pair,pedicel,peduncle,perennial,petiole,plant,poricidally,proximal,pubescent,purple,rotate,seed,short,size,slit,stigma,style,subequal,terminal,toward,yellow,¼	0-6,10-24,14-48,2-10,2-5,2m,3-6-foliat,4-3.,4.5-12.5,8-38,abaxiall,abaxially,acumen,acuminate,acute,adaxially,apex,attenuate,calyx,cell,connate,covering,cuneate,digestion,dorsally,eaf,edge,eed,emoval,enzyme,exceeding,flat,folded,forked,generally,globo,hair-like,honeycomb,living,lobe,lon,long,long-attenuate,lower,lunat,make,nflorescence,nther,oblique,obtuse,orolla,pattern,perfect,petiolule,plan,reveal,rounded,ruit,sessile,seudostipule,specimen,stamen,straight,subsessile,tal,tem,testal,thick,throughou,throughout,tip,tuber-bearing,typically,unit,vary,wall,wide,ympodial	4-31,abaxial,adaxial,anther,arrangement,color,colour,dehiscence,form,fruit,globose,growth,height,history,inflorescence,length,life,na,ovary,position,shape,spacing,stem,surface,texture,width
37	wfo-0001025792	success	203	108	83	120	25	0.409	0.4-0.7,1-10,1-2,1-3,10-15,2.5-3.5,21-28,4-6,5,7.5-8,8-10,abaxially,adaxially,anther,articulation,auriculate,axillary,blue-mauve,blue-purple,brownish,bud,cell,cm,condition,corolla,covering,dark,densely,diameter,distinct,dorsally,drying,edge,elliptic,filament,flat,flower,folded,forked,fresh,fruit,glabrous,globose,green,greenish,hair-like,herb,indistinct,lanceolate,lateral,mauve,minute,minutely,mm,odd-pinnate,ovoid,pedicel,peduncle,petiole,plant,poricidal,puberulent,pubescent,purple,ripe,rotate-pentagonal,seed,slightly,stem,stigma,straight,streak,style,subtending,terminal,testal,thick,tinged,tip,wall,white,whitish,yellow	1-4,2-11,2-3,2-3.5,2.5-4,3-4,3-5,3.5-6,4-12,4.5-7,5-10,5-6,5-9,5-merou,7-10,9-12,acumen,acuminate,acute,ag,along,alyx,apart,apex,apparently,articulated,axe,base,basiscopic,berry,blade,broadly,capitat,chartaceous,ciliate,connivent,decurrent,developing,digestion,distal,distinctly,eaf,eed,enzyme,especially,exceeding,except,geminat,generally,glabrou,greatly,green-white,hair,hal,half,high,homostylous,honeycomb-shaped,interjected,leaflet,lengthening,like,living,lobe,long,lower,make,margin,membranous,midrib,mottle,mucilaginous,narrow,narrowly,nflorescence,oblique,often,onto,orolla,pair,papillose,perfect,petiolulate,plurifoliate,pore,proximal,rachi,reduced,removed,rounded,ruit,semi-erec,semi-rosette,sessile,seudostipule,short,shortly,side,size,slit,spaced,specimen,stamen,ste,sub-rosette,subequal,tall,tamen,tem,throughout,tri-,tube,unit,usually,vary,wet,wing,x,ympodial,young	abaxial,adaxial,arrangement,capitate,color,colour,folding,form,growth,height,history,inflorescence,leaf,length,life,ovary,perennial,porosity,position,pseudostipule,shape,spacing,staman,surface,texture
38	wfo-0001025804	success	155	119	85	70	34	0.548	.25,0.5-1,1-1.5,1-3,1.2-1.5,1.4-1.7,1.5-2,3-4.5,3.5-12,6-8,abaxially,acute,adaxially,age,anther,apex,attenuate,base,bilobed,branched,calyx,clavate,cm,corolla,cream,dark,decurrent,deflexed,dia,difoliate,ellipsoid,elliptic,erect,exserted,filament,flattened,flower,fruiting,glabrous,globose,green,incrassate,internodal,leaf,lengthening,light,lobed,long,many,margin,minutely,mm,nearly,obovate,occasionally,often,opposite,ovary,paler,papillate,papillose,pedicel,pitted,plurifoliate,poricidal,reddish-brown,regularly,reniform,scar,sessile,shrub,slit,somewhat,spaced,stem,stigma,strongly,style,surface,time,tip,tube,white,whitish-green,x	.5,10-20,11-20,16-35,2-2.5,2.5-4,4-10,5,7-10,?,anthesi,apar,ape,apiculate,ba,bark,berry,c.,conical,covered,cucullate,densely,differing,drying,eaf,edicel,eed,fleshy,free,geminat,glandular,later,lateral,lobe,lower,main,major,mere,middle,minor,minute,near,nflorescence,older,onto,pair,papillae,papillat,planar,pore,portion,projection,red,red-papillose,reddish-brow,rim,ruit,size,tall,thick,tub,ud,unit,vein,widest,wing,winged,woody,ympodial,young	abaxial,adaxial,apart,arrangement,branching,bud,color,colour,deflexion,diameter,exsertion,feature,form,fruit,geminate,growth,height,history,inflorescence,length,life,na,peduncle,perennial,petiole,plant,position,rachi,seed,shape,spacing,staman,texture,true
39	wfo-0001025813	invalid_json	197	112	82	115	30	0.416	'',1-10,1-2,1-4,1.5-1.8,15-30,3-3.5,3-4,3-5,6-7,``,abaxially,adaxially,along,anther,base,berry,blue,broadly,brownish,cell,chartaceous,ciliate,cm,condition,corolla,covering,dark,densely,diameter,drying,elliptic,especially,filament,flower,fresh,fruit,glabrous,globose,green,green-white,greenish,hair,herb,lateral,light,make,margin,membranous,midrib,minutely,mm,monochasium,mucilaginous,odd-pinnate,ovoid,pedicel,peduncle,petiole,pilose,plant,puberulent,pubescent,rachi,rarely,rotate,seed,stem,stigma,style,suborbicular,testal,thick,throughout,tip,typically,violet,wall,wet,white,whitish,yellow	0-2,0.7-1.7,1-1.5,1.2-4.5,1.3-7,1.5-2,1.5-6.5,2-3,2-4,2-5,3-6,3-7,5-18.5,5-6,5-merou,absent,acumen,acuminate,acute,ag,alyx,apart,apex,apparently,articulated,axe,blade,borne,connivent,contracted,cuneate,decreasing,decurrent,digestion,discussion,distal,distinct,dorsally,eaf,edge,eed,end,enzyme,exceeding,extra,flat,folded,geminat,glabrou,hair-like,half,highly,homostylous,honeycomb-shaped,interjected,lanceolate,larger,leaflet,lengthening,like,living,lobe,long,longer,lower,minute,near,nflorescence,obtuse,often,orbicular,orolla,ovate,ovoi,pair,perfect,petiolulate,plurifoliate,pore,poricidal,removed,rosette-formin,ruit,see,sessile,seudostipule,short,single-flowered,singly,size,slit,sometimes,spaced,species,specimen,stamen,ste,stolo,straight,strongly,tamen,tem,terminal,thir,toward,tri-,tube,tuber,unforked,unit,unwinged,vary,vein,x,ympodial	'extra,'hair-like,[,],abaxial,adaxial,arrangement,characteristic,color,colour,form,growth,height,history,inflorescence,leaf,length,life,na,ovary,perennial,position,shape,spacing,staman,surface,texture,value,{,}
40	wfo-0001025817	success	238	150	103	135	47	0.433	1-1.6,10,abaxially,acuminate,adaxially,anther,apart,apex,asymmetric,asymmetrically,base,bifurcate,black,blade,broad-based,broadly,brown,chartaceous,cm,conical,dark,deciduous,deeper,densely,diameter,dull,entire,eventually,expansion,extra-axillary,filament,flower,fruit,glabrate,glabrous,globose,green,impressed,juvenile,lacking,lanceolate,large,lateral,laterally,leaf,lenticular,major,margin,midpoint,midvein,minutely,mm,moderate,near,obtuse,occasionally,ovate,overlapping,pale,pedicel,peduncle,pedunculate,persistent,persistently,petiole,pitted,prickle,prickly,principal,pubescent,purple,rachi,rarely,rayed,recognizable,ripe,rounded,sessile,short,shrub,simple,sized,small,soon,stalked,stellae,stellate,stem,stigma,style,surface,time,tomentose,tree,turning,unequally,vein,violet,white,white-stellate,without,yellow,×	0.5–0.7,0.6–0.8,0.8–1.5,0–1.6,1.5–2.5,1.7-2.1,1.8–2.3,1.8–3,10–16,10–35,12–16,1–3,1–5,2–2.9,2–3,2–5,2–6.5,2–8,3.2–8,3.5–6,3–,3–13,3–6,3–8,4–5.5,4–6,4–7,5-merou,5–20,5–6,6–13,7–9,8–14,8–21,absent,accrescen,acute,age,along,although,alyx,amount,apiculate,apparently,armed,articulated,axe,ba,berry,bicolorous,branch,branched,calyx,campanulate,capitat,central,compresse,deltoid,dense,developing,difoliate,directed,distall,distally,eaf,eed,exceeding,except,expanded,fertile,fewer,filiform,flowering,forming,free,fruiting,geminat,glabrou,high,interpetalar,larger,like,linear-lanceolate,lobe,long,low,lower,minute,much,nerve,nflorescence,numerous,oblong,often,one,orolla,pinnatifi,pore,portion,present,pubescence,racemose,reaching,row,ruit,single,sinuate–repand,sinus,slender,slightly,sometimes,spaced,sparse,spreading,stout,strongly,tamen,tapering,tissue,trunk,tube,ultimate,unarmed,underside,unit,usually,variously,vary,velvety,weakly,well,wide,woolly,ympodial,young	0-1.6,0.5-0.7,0.6-0.8,1-5,1.5-2.5,10-16,2-2.9,2-8,3-8,3.2-8,4-5.5,4-7,5-20,5-6,5-merous,7-9,8-14,abaxial,adaxial,arrangement,capitate,color,colour,compressed,compression,corolla,form,growth,height,history,inflorescence,length,life,ovary,perennial,persistence,pinnatifid,plant,position,pricklines,seed,shape,sinuate-repand,size,spacing,staman,texture
41	wfo-0001025825	success	187	96	71	116	25	0.38	0-0.21,0.4-1,0.5-10.4,1-2,1-5.5,10-24,2-3.7,3-10,3-5,4-8,5-10,abaxially,adaxially,anther,axillary,berry,brownish,bud,cell,clavate,cm,condition,coriaceous,corolla,covering,dark,diameter,drying,elliptic,filament,flower,forked,fresh,fruit,glabrescent,glabrous,green,greenish,hair,hair-like,herb,homostylous,lanceolate,lateral,leaf,light,lilac,medium,mm,odd-pinnate,ovoid,pedicel,peduncle,pentagonal,petiole,plant,rotate-pentagonal,seed,shiny,short,stigma,streak,style,subtending,terminal,testal,thick,wall,white,whitish,yellow	0.4-3,0.5-0.8,0.7-2.2,0.9-2,0.9-4,1-3,1.1-1.4,10.5-26,14-85,2-5,22-86,3-8.5,3.7-6.5,4-9,5-7,5-merou,6-10,6.6-14,acumen,acuminate,acute,adaxiall,ag,alyx,apart,apex,apparently,articulated,asymmetric,attenuate,axe,back,base,basiscopic,blade,capitat,connivent,cuneate,decreasing,decurrent,digestion,distal,dorsally,eaf,edge,eed,enzyme,erec,exceeding,flat,folded,geminat,generally,glabrou,green-white,hal,half,high,honeycomb-shaped,increasing,interjected,leaflet,lengthening,living,lobe,long,lower,make,middle,mucilaginous,nflorescence,orbicular,orolla,ovate,pair,perfect,petiolulate,plurifoliate,pore,poricidal,rachi,removed,rounded,ruit,sessile,seudostipule,side,size,slightly,slit,smaller,spaced,specimen,stamen,straight,subequal,subglabrou,tall,tamen,tem,throughout,tip,tissue,toward,tri-,tube,unit,unwinged,usually,vary,wet,wide,wing,winged,x,ympodial	abaxial,adaxial,arrangement,capitate,color,colour,form,growth,height,history,inflorescence,length,life,ovary,perennial,position,pseudostipule,shape,spacing,staman,stem,subglabrous,surface,texture,width
42	wfo-0001025835	success	297	141	123	174	18	0.414	0.05-0.1,0.1,0.5-2.8,0.65-0.8,0.7-3,1,1-1.5,1-2,1-2.5,1-3,1-5,1-8,1.2-2,1.5-3,1.5-3.5,1/3-3/4,1/4-2/3,2-6,2.5-3,3-5,3-6,3-7,3.5-4,30-45°,4,9-11,abaxially,acuminate,acute,adaxially,almost,always,anther,apex,apparently,base,becoming,berry,black,bright,broad-deltate,brown,calyx,cell,clavate,cm,corolla,cupular,curved,diameter,divided,drying,dull,evenly,faint,filament,finely,flat,flattened-reniform,flower,fruit,glabrous,globose,green,greenish,lateral,leaf,length,less,lobe,lobed,longer,margin,maturity,mauve,midvein,mm,moderately,obconical,oblong,obtuse,one,open,orange-brown,outline,ovate,ovoid,pair,pale,petiole,pit,porrect,prickle,primary,raised,red,shiny,short,side,simple,small,smooth,sparsely,stellate,stellate-pubescent,stem,stigma,straw-yellow,style,surface,tertiary,thin,time,trichome,vein,venation,visible,white,wide,yellow,yellow-orange,young,×	.1,.3,/4,0.1-0.2,0.2-2,0.5,0.5-0.7,0.5-1,0.6-1.3,0.7-1.8,1-4,1-7,1-9,1.2-1.8,1.5-1.8,1.5-2,1/2,1/3,1/4-1/2,1/4-1/3,2.2-2.5,2.5-3.5,20,4-5,4-8,5,5-20,5-merou,6,6-8,7-9.5,8,accrescent,adaxial,ag,alyx,apar,apart,apically,apiculate,armed,articulated,axe,bark,beyond,blade,branche,branched,broad-based,chartaceous,concolorous,covering,dark,deep,deltate,developed,development,difoliate,distance,dorsal,eaf,eed,elongating,equal,erect,exserted,extending,finger-hair,flattened,foliaceous,free,fruiting,geminat,gently,glabrescent,gre,green-brown,infructescence,irregula,irregular,lamina,lengthening,lobing,long,long-deltate,longitudinal,lower,mature,midpoint,minute,mostly,network,nflorescence,occasional,often,older,opening,orange,orange-translucent,orolla,oung,ovoi,papillae,papillo,part,pedicel,peduncle,pendulous,per,perfect,pericarp,point,pore,poricidal,portion,pronounced,rachi,rarely,ray,reduced,reflexed,regular,rest,ribbed,ridged,rounded,ruit,scar,secondarily,secondary,sessile,shallow,shorter,shortly,shrub,significantly,sinus,slender,slightly,slit,sometimes,somewhat,spaced,spherical,spreading,stalk,stalked,straight,stump,tamen,tapering,terete,terminal,throughout,tip,toward,translucent,trifoliate,tube,ud,unarmed,unequal,unit,upper,usually,variously,vary,weakly,widest,wing,woody,x,yellowish,ympodial	angle,arrangement,color,curvature,division,height,inflorescence,number,ovary,papillose,plant,seed,shape,spacing,staman,texture,visibility,width
43	wfo-0001025838	success	217	129	107	110	22	0.493	-20,.5,0.5-1,0.7-2,1-1.2,1-1.5,1.5-1.7,1.5-3.5,1.5-5,1.8-2,10-15,2-5,2/3,20-40,4.5-5.5,6.5-7,acuminate,adaxial,anther,apart,apex,attenuate,base,berry,black,branched,brown,capitate,clavate,cm,corolla,dendritic,dense,densely,diameter,drying,elliptic,entire,filament,flattened,fleshy,flower,fruit,fruiting,glabrous,globose,greenish,growth,inflorescence,keeled,lanceolate,lateral,leaf,less,like,lobed,long,many,margin,membranous,midrib,minutely,mm,narrowly,occasionally,often,onto,pair,pale,pedicel,peduncle,per,petiole,pitted,pubescent,purple,reddish,reniform,revolute,ripe,seed,shiny,shrub,simple,slightly,sometimes,sparsely,stellate,stem,stigma,style,surface,terminal,thin,time,tinged,tree,trichome,tuft,vein,way,white,winged,x,yellow,yellowish,¾	0.5,1.2-5,1.5-2,1.5-2.5,10-60,2-2.5,2.5-3,3.5-,4-15,5,5-merou,6-15,abruptly,adaxially,ag,along,alyx,anthesi,apiculate,appearing,archin,ark,articulated,axil,basall,branch,broad,calyx,cell,clustered,connivent,cucullate,cup-shaped,dark,decurrent,denser,disintegrating,eaf,eed,ellipsoidal,erect,exserted,extending,free,glabrescent,hairy,ilament,inserted,insertion,irregularly,lamina,lengthening,lobe,loosely,lower,m.,minute,mostly,narrowing,never,new,nflorescence,nodding,older,orolla,ovoid,papillat,papillo,perfect,pericarp,platform,plurifoliat,point,pointed,pore,poricidal,portion,primary,quadrate,ruit,scar,shin,short,sinus,sleeve,slender,slit,small,spaced,spreading,square,strongly,tall,tem,testal,thi,tip,tube,turbinate,twinin,ud,uniseriate,unit,upper,vary,wall,weight,wing,woody,ympodial	5-merous,abaxial,arrangement,basally,branching,color,colour,form,height,history,length,life,na,number,ovary,plant,position,rachi,shape,spacing,staman,texture
44	wfo-0001025845	success	180	125	98	82	27	0.544	.5,0.3-0.5,0.4-1.5,0.5-11,0.5-2.5,1-4.5,1.5-2,2-3,2-5-lobed,3-13,3-4,4-5,4-6,5-6,6-6.5,6-9,abundantly,acuminate,acute,adaxial,aggregate,anther,apart,apex,apiculate,base,branch,brown,calyx,cell,chartaceous,cm,corolla,cuneate,cylindrical,deltate,diameter,eglandular,ellipsoidal,entire,extra-axillary,filament,flattened,flower,fork,fruit,glabrous,greenish,herb,leaf,light,lobe,lobed,located,major,margin,membranaceous,mesocarp,minutely,mm,narrowly,near,obtuse,orange,ovate,ovoid,patch,pedicel,peduncle,petiole,pinnately,puberulent,pubescent,rachi,radiu,rotate-stellate,rugose-verrucate,sand-punctate,shrub,side,simple,sparsely,stigma,stone,style,subcordate,tip,triangular,truncate,tube,unbranched,vein,veiny,white,wide,x,yellow,yellowish	1,1-1.8,1-2,1.5,1.5-13,1.5-2.5,1.5-7,2,2-15,2.5-4,3,3-6,3-foliat,7-10,abaxially,adaxially,along,around,articulated,ascending,axe,ba,blade,channe,compressed,connivent,dark,decurrent,diamete,directed,distall,distally,divided,eaf,eed,elliptic,especially,free,glabrou,green,inserted,lateral,laterally,long,longitudinal,lower,midrib,nearly,nflorescence,obovate,often,orolla,part,perfect,pore,purple,rarely,rounded,ruit,sagittate,shorter,sinus,small,spaced,stripe,strongly,tal,tamen,tapered,tem,terminal,thecae,thick,tightly,time,tomento,truncat,unit,unlobed,vary,ympodial,youn	abaxial,arrangement,color,colour,form,growth,height,history,inflorescence,length,life,na,number,ovary,perennial,plant,position,seed,shape,spacing,staman,stem,surface,texture,theca,tomentose,width
45	wfo-0001025850	success	197	119	98	99	21	0.497	.5,0.5,0.5-1,0.5-3,0.6-1,1,1-1.5,1.5,2-12,6-7,abaxial,acute,anther,apex,axi,base,berry,branched,broadly,brown,capitate,cell,cm,corolla,densely,diameter,divaricate,elliptic,entire,filament,flattened,fleshy,flower,glabrous,glandular,globose,green,growth,inflorescence,irregularly,later,lateral,lax,lobed,many,margin,membranous,midrib,minutely,mm,narrowly,nearly,node,occasionally,often,openly,orange,outline,pale,papillate-puberulent,pedicel,peduncle,petiole,pinnatifid,pitted,pubescent,reddish,reniform,rhomboid,rounded,scar,scattered,shallowly,shiny,shrub,simple,sinuate,slightly,spaced,stellate,stem,stigma,style,surface,tan,terminal,testal,thin,time,tip,trichome,truncate,uniseriate,vine,white,woody,x,yellow	-5,-7,.8,0.5-,1-3,1-celled,1.5-5,15-20,2,2-6.5,3-4,30,4-5,5-7,5-merou,ag,along,alyx,anthesi,apar,apparently,ark,articulated,basal,calyx,connivent,cupped,cyathiform,deciduous,deflexed,deltate,denser,divided,drying,eaf,eed,ellipsoid,elongate,em,erect,exserted,extending,free,fruiting,geminat,glabrou,gland,half,halfway,ilament,lamina,leaving,lengthening,less,lobe,long,loosely,lower,minute,new,nflorescence,nodding,older,orolla,pair,papillo,peg,per,perfect,planar,plurifoliate,pore,poricidal,portion,primary,puberulen,ripe,ruit,sinus,sleeve,slender,slit,small,sometimes,soon,splitting,spreadin,spreading,strongly,surfac,tiny,tube,twinin,ud,unit,vary,vein,ympodial,young	5-merous,adaxial,apart,arrangement,color,colour,form,fruit,height,leaf,length,na,ovary,plant,position,rachi,seed,shape,spacing,staman,texture
46	wfo-0001025856	success	185	110	84	101	26	0.454	0,0.3-1,0.5,1-3,1.5–2,10–15,1–,1–5,2,2.5–4,20,2–,2–4,3,3-10,3–5,4–10,5–10,5–15,5–7,acuminate,anther,apex,articulated,base,becoming,berry,branched,brown,bud,chartaceous,cm,compound,connivent,corolla,cuneate,diameter,ellipsoid,elliptic,entire,filament,flattened-reniform,flower,foveolate,fruiting,glabrescent,glabrous,globose,green,internode,lateral,leaflet,light,margin,mm,oblique,oblong,orange,pedicel,peduncle,perennial,petiole,petiolule,pinnately,pointed,prickle,rachi,recurved,rugose,slender,somewhat,spreading,stellate,stigma,streak,strongly,style,subwoody,surface,terminal,uniformly,white,yellow,×	.4,/4,0.3–0.5,10–,15–20,1–1.5,1–2,20–30,20–35,3–4,4–,4–6,5–,6–12,abaxially,acute,adaxially,ag,always,alyx,anthesi,apiculate,armed,axe,blade,c.,calcium,calyx,campanulate,commonly,corresponding,crystal,densely,difoliate,dr.,eaf,eed,equal,exserted,fifth,four,geminat,glabrou,herbaceous,larger,lengthening,lobe,lobed,long,long-styled,longer,lower,major,narrowly,nearly,nflorescence,often,one,opposite,orolla,outline,oxalate,pair,papillat,pericarp,petiolulate,plurifoliate,pore,poricidal,present,rarely,recurve,rounded,ruit,side,slightly,slit,soon,stout,straight,subopposite,subwood,tamen,tem,throughout,time,tip,triangular,truncat,tub,tube,unequal,unit,usually,vary,vein,vin,way,wide,widest,ympodial	abaxial,adaxial,arrangement,articulation,color,dry,form,fruit,growth,height,history,inflorescence,leaf,length,life,na,ovary,plant,position,seed,shape,staman,stem,texture,truncate,vine
47	wfo-0001025872	success	160	103	74	86	29	0.463	0.25-0.5,0.5,0.6-1,1-1.5,1-2,1.2-1.5,1.2-1.6,2-5,4-4.5,6-8,acute,anther,apart,apex,bark,base,becoming,branched,brownish,capitate,cm,corolla,crinkled,dark,deeply,deflexed,densely,dry,elliptic,filament,flattened-reniform,fleshy,flower,fruiting,glabrous,globose,green,greenish-tan,incrassate,later,lateral,leaf,live,lobed,margin,material,minutely,mm,narrowly,ovary,papillose,pedicel,petiole,pitted,planar,plant,pore,poricidal,pubescent,revolute,rounded,shaped,shrub,stem,stigma,straight,style,surface,tear-drop,terminal,tip,tube,white,x	.1,.5,0.5-1,1,1-1.3,1.7-3,10-25-flowered,2-2.5,2/3,3.5-4,4.5-13,6-10,along,anthesi,apically,auriculate,ba,beginning,beneath,berry,blade,bright,broadly,calyx,coriaceous,crowded,cup-shaped,decurrent,dense,dia,eaf,edicel,eed,exserted,flattened,free,glandular-resinous,grayish-brow,inflorescenc,irregularly,junction,lobe,lon,long,lower,main,midrib,nflorescence,occasionally,often,older,onto,opposite,pair,paler,papillae,papillo,plurifoliat,portion,prominent,red-papillose,rounded-triangular,ruit,scar,several,simple,somewhat,soon,spaced,specimen,tall,tapering,thick,thickened,time,trichome,tub,ud,uniseriate,unit,vein,visible,way,woody,ympodial,young	1.5,abaxial,adaxial,arrangement,color,colour,decurred,diameter,feature,form,fruit,grayish-brown,growth,height,history,inflorescence,length,life,na,peduncle,perennial,plurifoliate,position,rachi,seed,shape,spacing,staman,texture
48	wfo-0001025875	success	205	82	66	139	16	0.322	0.1-1.1,0.3-0.4,0.3-2,0.8-0.9,0.8-1.8,1-10,1.2-1.8,2.3-3,2.4-2.8,4.5-6.5,5-10,5-9,7-10,8-11,abaxially,adaxially,anther,chartaceous,cm,cylindrical,dark,decimetre,deeply,densely,diameter,extra-axillary,filament,flower,fruit,glabrous,globose,green,inflorescence,lanceolate,leaf,length,lobe,lobed,longer,mm,oblate,pale,pedicel,peduncle,per,petiole,plant,prickle,pseudo-racemose,purple,rotate,shallowly,simple,sparsely,stellate-pubescent,stigma,streak,style,surface,time,truncate,unbranched,white,wide,yellow,yellowish	%,.05,0-0.1,0-0.5,0-1.5,0-5,0.1-0.2,0.2-0.45,0.25-0.4,0.4-0.5,0.4-0.7,0.5-1,0.5-1.3,0.5-6,0.7-0.8,0.9-1.4,1-2,1-3,1-7,1.1-1.6,1.5-2.5,1.5-6,15-25,2-locular,2.5-4.5,3-5,3-6,4-10,5-11,5-14,5-15,5-merou,6-13,7-14,7-8,8-14,9-13,?,absen,absent,accrescent,acicular,across,acute,adaxiall,adult,alyx,andromonoecious,anvil-shape,apart,apex,articulated,attenuate,axe,ba,basal,base,blade,branchlet,calyx,cross-section,cuneate,deltate,directed,distally,dm,eaf,eed,eglandular,entire,erect,exocarp,finger,fruiting,functional,geminat,gland-tipped,grey,hair,half,hastate,heterostylous,juicy,juvenile,lamina,lateral,less,linear,long,lower,margin,mature,mesocarp,mid-point,midpoint,midvein,minute,moist,narrowly,nflorescence,oblique,obtuse,orolla,pair,part,perennial,placenta,plurifoliate,pore,porrect,possibly,present,ray,rhizomatous,ruit,sessile,short,shrub,spaced,stalk,stalked,stellae,stellate,straight,tal,tamen,tem,thick,throughout,transparent,tube,unarme,unarmed,unit,upper,vary,weakly,x,ympodial	abaxial,adaxial,arrangement,color,colour,corolla,density,height,ovary,position,seed,shape,staman,stem,texture,width
49	wfo-0001025888	success	256	125	90	166	35	0.352	.5,.6,0.2,1.5,1/3,2.1,2.6,3,abaxially,acute,adaxially,alveolate,anther,apart,apex,area,attachment,base,blade,branching,brochidodromous,central,channeled,chartaceous,cm,corolla,cuneate,deltoid,densely,diameter,distal,distinct,dry,endocarp,entire,exocarp,extra-axillary,filament,flattened-orbicular,flower,fruit,glabrous,globose,gradually,increasing,lateral,leaf,little,margin,midvein,mm,moderately,nearly,notched,oblique,orange-red,ovate,pedicel,peduncle,petiole,point,pubescent,raised,red,rounded,shinny,shrub,simple,sinuate,small,spaced,stellate,stigma,style,surface,swelling,thin,time,tree,unbranched,vein,weakly,well,white,yellow,yellow-tan,±aequilateral,±glabrous,±smooth,×	.05,.3,.4,0.04,0.1,0.3–0.5,0.4,0.4–0.6,0.4–0.7,0.5–0.7,0.6–1.2,0.7–0.8,0.7–1.5,0.8,0.8–1.0,0.9–1.1,0.9–1.2,0.9–1.3,1.0–1.8,1.2–2.3,1.4–1.8,1.5–1.9,1.5–2.0,1.5–2.1,1.5–4.0,1.7–2.1,1.8–2.3,1.8–3.5,1.9–2.2,1.9–3.4,1/2–2/3,2.2,2.5–2.6,2.7–3.0,3.0–11.1,3.1–4.2,3.2,3.8,3/4,4.2–5.5,4–8,4–9,5,5-merou,5.5–11.1,5–7,6–10,7.1–9.1,8.1–17.1,9.5,90°,across,adnate,along,alyx,anthesi,apiculate,apparently,appearing,appresse,arching,articulate,axe,ba,berry,branch,broad,bud,calyx,capitat,clinate,congested,dehiscen,denser,dentate,development,difoliate,eaf,eed,either,emerging,fertile,filiform,flexed,free,geminat,glabrescent,glandular,hair,homostylous,hooked,internode,interpetalar,intersepalar,juic,lamina,less,lobe,lon,long,longer,longitudinally,lower,major,many,mature,middle,midpoint,midrib,minor,minute,nflorescence,oblong,opaque,orolla,per,poorly-developed,porrect,portion,potentially,pubescen,pubescence,ray,reflexed,restricted,rigid,row,ruit,scattered,sessile,short-stipitate,shorter,side,sinus,smoot,sometimes,sparsely,splitting,spread,spreading,stellae,stellate-pubescent,stipe,straight,tamen,tardily,tem,though,tip,tissue,truncate,tube,two,typically,ud,unarmed,vary,wide,yellow-ferruginous,ympodia,young,±90°,±equal,±erect,±overlapping,±straight	0.7-0.8,0.9-1.2,1.5-2.0,1.5-2.1,1.5-4.0,2.5-2.6,3.0-11.1,abaxial,adaxial,arrangement,capitate,channelling,color,colour,form,growth,height,history,inflorescence,juicy,length,life,na,ovary,perennial,plant,position,rachi,raisednes,seed,shape,spacing,staman,stem,texture
50	wfo-0001025892	success	170	91	68	102	23	0.4	%,0-0.3,0-10,0.2-0.4,0.3-0.8,0.8-1.1,1.5-5,10-17,2.8-3,4.5-7.5,5-17,5-7,7-15,9-18,absent,adaxially,anther,apex,base,chartaceous,cm,cuneate,densely,entire,extra-axillary,fruit,globose,grey,grey-green,herbaceous,inflorescence,lamina,lanceolate,lateral,leaf-opposed,length,linear,long,longer,margin,midpoint,mm,narrowly,oblate,obtuse,pale,pedicel,peduncle,per,petiole,present,prickle,pseudo-racemose,purple,ray,resprouter,solitary,stellate,stellate-pubescent,stem,sticky-glandular,straight,time,unbranched,white,wide,yellow,yellowish-green	.3,0-0.1,0-1,0.05-0.1,0.1-0.2,0.2-0.5,0.2-0.8,0.3-0.5,0.3-0.7,0.4-0.6,0.4-0.8,0.7-0.9,1-2,2-7,2-locular,2.5-4,2.5-6,4-merou,6-10,8-10,8-11,8-11.5,8-13,abaxially,absen,adaxiall,alyx,apart,articulated,axe,ba,blade,broad-based,calyx,connivent,cross-section,curved,cylindrical,d.,deltate,dense,diameter,directed,distall,distributed,dult,eaf,eed,eglandular,erect,exocarp,finger,flower,fruiting,geminat,glabrous,gland-tipped,glandular,hair,half,juicy,less,lobe,lower,mature,mesocarp,mid-point,minute,moist,nflorescence,oblique,orolla,papillae,part,perfect,placenta,pore,porrect,ruit,sessil,sessile,short,simple,spaced,stage,stalk,stellae,stigma,style,tal,tamen,thick,throughout,triangular,truncat,tube,unarmed,unit,uvenile,vary,x,ympodial	abaxial,color,corolla,density,dm,form,growth,height,history,leaf,life,ovary,perennial,plant,position,presence,ratio,seed,shape,surface,texture,thicknes,width
51	wfo-0001025893	success	157	95	72	85	23	0.459	.25,.5,0.5-1.5,0.8-1,1-4,1.5-1.7,1.5-2,2-2.5,3-5,5-6,accrescent,along,anther,base,beneath,bi-lobed,branched,brownish-green,calyx,capitate,closely,cm,corolla,decurrent,ellipsoid,elliptic,filament,fruit,fruiting,glabrous,globose,golden-puberulent,green,internodal,leaf,lobe,lobed,minutely,mm,narrowly,nearly,obovate,occasionally,opposite,ovary,overlapping,ovoid-reniform,pale,papillose,pedicel,petiole,pitted,poricidal,red-papillose,shaped,shrub,slightly,sometimes,spaced,stigma,straight,style,surface,tear-drop,tip,tube,vein,white,winged,woody,x,yellowish	.4,1-1.2,1-1.5,1-2.5,11-20,2-3,6-10,anthesi,apex,attenuate,bank,barely,bark,bearing,beginning,berry,blade,broadly,cup-shaped,deflexed,deltoid,densely,dia,difoliate,dry,eaf,early,eed,erect,even,exserted,faintly,flower,free,geminate,glabrate,gravelly,greyish,growing,impressed,inflorescenc,lateral,lon,long,long-acuminate,longitudinally,lower,main,many,margin,material,middle,nflorescence,older,pair,papillo,planar,plurifoliat,pore,portion,puberulent,reflexed,river,rocky,ruit,sandy,scar,slender,specimen,stem,stream,striat,tall,tapering,thickened,time,trichome,ud,unicellular,unit,usually,visible,widest,ympodial,young	abaxial,adaxial,branching,bud,color,colour,diameter,form,growth,hair,height,history,inflorescence,length,life,na,perennial,plant,position,seed,shape,spacing,texture
52	wfo-0001025896	success	146	100	72	74	28	0.493	0.5,0.5-2,1-25,1-6.5,1-8,1.5-9,2-2.5,2.5-14,4-6,5-15,5-7,6-10,abaxial,acuminate,acute,angled,apex,articulated,base,brownish,chartaceous,cm,cuneate,cylindrical,deltate,densely,diameter,directed,elliptic-ovate,entire,flower,forked,fruit,glabrous,gland,globose,greenish,lobe,margin,membranaceous,mm,moderately,nearly,orange,ovate,pale,pedicel,peduncle,petiole,pore,present,pubescent,purple,rachi,red,rotate-stellate,rugose,shrub,simple,smooth,stem,stigma,style,subcordate,surface,tip,triangular-subulate,tube,unbranched,white,x,yellow	-3,-30,.5-2.5,1-1.5,1-3,1.5-2,10-15,10-25,2-14,2.5-5,4,4-12,4-23,4-5,6-13,7-,7743,abaxially,absen,acosta,adaxiall,adaxially,aggregate,also,apart,axe,ba,blade,branched,calyx,cell,connivent,constricted,dendritically,distall,eaf,eed,eglandular,especially,hair,inflated,like,long,lower,many-foliat,near,nflorescence,nther,obtuse,occasionally,often,orolla,perfect,puberulent,pubescen,radiu,ripe,ruit,short-stalked,solí,spaced,sparsely,stalked,stone,tal,tem,time,triangular-ovate,truncat,unit,vary,vein,wide,ympodial	2-3,adaxial,anther,arrangement,articulation,color,corolla,direction,distally,form,growth,height,history,inflorescence,leaf,length,life,na,ovary,perennial,plant,position,presence,seed,shape,spacing,texture,truncate
53	wfo-0001025902	success	211	105	80	131	25	0.379	.2,/2,0.1-0.5,0.5-2.5,1-1.5,1.5-2,11-15,1983,2-6,2.5-4,3-10,40,5-6,>,abaxially,adaxially,along,anther,base,becoming,black,cabrera,cell,circular,clavate,cm,corolla,densely,diameter,dull,ellipsoid,fide,filament,flattened-reniform,flower,glabrous,globose,green,growth,inflorescence,lanceolate,lateral,leaf,leaf-opposed,length,linear,lobed,mature,minute,minutely,mm,occasionally,ovary,pale,pedicel,peduncle,per,petiole,pitted,pubescent,rotate-stellate,rounded,scattered,simple,sometimes,stem,stigma,style,surface,terminal,testal,trichome,uniseriate,vine,violet,way,woody,x,yellow,yellowish	.5,0.5-2,1-1.2,1.2-1.5,1.5,1.5-3,1/3,4,4-13,4-5,4-6,5-merou,8-10,8-15,8-9,absent,accompanied,acute,ag,aid,always,alyx,anthesi,apar,apex,ark,articulated,attenuate,axi,bark,beginning,berr,berry,branch,branched,branching,broadly,c.,calyx,chartaceous,climbin,completely,conical,connivent,deciduou,deltate,eaf,eed,either,entire,except,exfoliatin,exserted,fleshy,free,fruiting,geminat,ilament,leaving,lengthening,less,lobe,long,loosely,low,lower,margin,markedly,midvei,new,nflorescence,obscured,often,older,one,orolla,pair,papillat,papillose,peg,pendant,perfect,pericarp,planar,plurifoliate,pore,poricidal,portion,primary,prominent,revolute,ridged,ruit,scar,scrambling,semi-aquati,semi-circular,shallow,sleeve,slender,slit,small,somewhat,soon,spaced,sparsely,spreading,strongly,tangled,tapering,tem,thin,time,tip,tube,twining,ud,ultimate,unit,usually,vary,vegetation,vein,water,weak,weight,whitish,widely,wing,ympodial,½	5-merous,abaxial,adaxial,apart,arrangement,color,colour,form,fruit,height,history,life,midvein,na,number,perennial,plant,position,rachi,seed,shape,size,spacing,staman,texture
54	wfo-0001025906	success	188	102	79	109	23	0.42	0.1-2,0.20-0.60,1-2,1.6-12.4,16-51,2-4.4,2-6,3-10,3-5,4-7,5-7,abaxially,adaxially,anther,axillary,blue,brownish,bud,cell,clavate,cm,condition,coriaceous,corolla,covering,dark,diameter,drying,filament,flower,forked,fresh,fruit,glabrous,globose,green,green-white,greenish,hair,hair-like,herb,homostylous,lanceolate,lateral,leaf,light,lilac,linear,make,mm,mucilaginous,odd-pinnate,ovoid,pedicel,peduncle,pentagonal,petiole,plant,pubescent,purple,ripe,rotate,seed,shiny,short,stigma,stripe,style,subglabrous,subtending,terminal,testal,thick,throughout,wall,wet,white,whitish,yellow	0-14,0.15-0.6,0.2-0.6,1-3,1-6,1.1-2,1.8-4.8,2.6-5.2,4-10,4-12,4-5,5-6,5-merou,5.2-9,8-16,8.5-12.5,acumen,acute,adaxiall,ag,alyx,apart,apex,apparently,articulated,axe,base,berry,blade,capitat,connivent,cuneate,decreasing,decurrency,decurrent,delimited,digestion,diminishing,distal,dorsally,eaf,edge,eed,enzyme,erec,exceeding,falcate,first,flat,folded,geminat,generally,glabrou,hal,half,high,honeycomb-shaped,interjected,leaflet,lengthening,living,lobe,long,lower,next,nflorescence,obtuse,orolla,pair,perfect,plurifoliate,pore,poricidal,rachi,removed,ruit,second,sessile,seudostipule,size,slightly,slit,smaller,spaced,sparsely,specimen,stamen,straight,sub-glabrous,subequal,subglabrou,tall,tamen,tem,third,tip,toward,tri-,tube,typically,unit,unwinged,usually,vary,well,width,wood,x,ympodial	abaxial,adaxial,arrangement,capitate,color,colour,form,growth,height,history,inflorescence,length,life,ovary,perennial,position,pseudostipule,shape,spacing,staman,stem,surface,texture
55	wfo-0001025907	success	148	123	98	50	25	0.662	-4,.05,.5,.5-1,0,0-60,0.8-1.8,1,1-3,1-5,1.5-2,1.5-2.2,12-45,2,2-3.5,2-8,2/3,3-,4-5,5-15,absent,acuminate,acute,anther,anticlinal,apex,appearing,attenuate,axil,axillary,base,beak,breaking,brown,c,cell,cm,conical,conspicuously,densely,diameter,elliptic,epidermal,filament,flattened,flower,fruit,fruiting,glabrous,globose,green,greenish,growth,highly,iquito,irregular,isolated,long,lower,minutely,mm,near,new,obovate,occasionally,ovary,ovoid-reniform,papillate,pedicel,per,petiole,plant,population,portion,projection,pubescent,raised,red-papillate,round,rugose,scar,scattered,seed,shrub,simple,sinuous,size,stigma,style,surface,thickening,trichome,truncate,uniseriate,white,white-lenticellate,without,x	1-1.2,1-2.3,10-15,3-4,3/2,along,anthesi,anthesis5-7,bearing,berry,calyx,clavat,deciduous,eaf,edicel,eed,erec,free,included,lamina,lobe,lobed,lon,margin,nearly,nflorescence,open,pair,papillose,poricidal,primary,reflexed,remaining,ruit,single-stemmed,slender,soon,sparsely,tal,tem,time,tip,tub,tube,ud,unifoliat,unit,variable,vein,ympodial	5-7,arrangement,clavate,color,corolla,erect,form,height,history,inflorescence,leaf,length,life,number,peduncle,perennial,position,presence,shape,spacing,staman,stem,texture,unifoliate,unknown
56	wfo-0001026203	success	197	141	114	83	27	0.579	0.06-0.86,0.38-11.3,0.4-3,1-13,1-2,1-4,1-9,2-4.9,3-10,3-11,3-5,7-47,abaxially,acuminate,acute,adaxially,along,anther,apex,arranged,asymmetric,attenuate,axillary,base,basiscopic,bead,berry,blue,brownish,bud,cell,clavate,cm,condition,coriaceous,corolla,covering,dark,decurrent,deep,diameter,digestion,drying,elliptic,enzyme,filament,flower,forked,fresh,fruit,glabrescent,glabrous,globose,green,green-white,greenish,hair,hair-like,herb,honeycomb-shaped,interjected,lateral,leaf,leaflet,light,like,lilac,medium,mm,moniliform,multiple,necklace,odd-pinnate,orbicular,ovate,ovoid,pair,pedicel,peduncle,pentagonal,petiole,plant,plurifoliate,rachi,removed,ripe,rotate,rounded,seed,sessile,short,side,size,slightly,sometimes,stigma,stolon,stripe,style,subglabrous,subtending,terminal,testal,thick,throughout,tissue,tri-,tuber,typically,unit,wall,wet,whitish,yellow	0-39,0-7,0.3-11,0.3-6,0.5-2.3,0.5-3.2,0.7-2.6,1-5,1.1-7.9,1.2-5.5,2-10,2-43,2-5,2-8.5,2.2-13.3,3.2-22,3.2-23,5-merou,acumen,ag,alyx,apart,apparently,articulated,axe,blade,capitat,connivent,decreasing,distal,dorsally,eaf,edge,eed,erect,exceeding,flat,folded,geminat,generally,glabrescen,glabrou,hal,half,high,homostylous,lanceolate,lengthening,linear,living,lobe,long,lower,make,middle,mucilaginous,nflorescence,orolla,perfect,pore,poricidal,rosett,ruit,seudostipule,slit,spaced,specimen,stamen,straight,subequal,tall,tamen,tem,tip,toward,tube,unwinged,usually,vary,white,wide,x,ympodial	abaxial,adaxial,arrangement,capitate,color,colour,decurrence,form,growth,height,history,inflorescence,length,life,mucilaginousnes,na,ovary,perennial,position,pseudostipule,shape,spacing,staman,stem,surface,sympodial,texture
57	wfo-0001026205	success	165	143	109	56	34	0.661	-14,-6,.5,.5-2,0.3-2,0.75-1,1,1-1.5,1-6,15-20,2-14,2-3,3,3/4,30-35,5-7.5,5-merous,5.5-6,7-9,8,abaxially,absent,acuminate,acute,anther,apex,apical,apparently,around,base,calyx,chartaceous,cm,cream,cuneate,deeply,densely,diameter,difoliate,distinct,divided,elliptic,entire,extra-axillary,filament,flattened,flower,four,fruit,fruiting,glabrous,glandular,globose,growth,hair,lateral,leaf,linear-lanceolate,lobe,major,margin,maturing,midpoint,minor,minute,minutely,mm,new,node,oblique,often,pedicel,peduncle,petiole,pore,prickle,pubescent,purple,rachi,rare,ray,seed,sessile,short,shortly,shrub,similar,simple,size,slightly,small,smaller,sparsely,stellate,stellate-pubescent,stem,stigma,straight,strongly,style,surface,third,tube,violet,white,wide,wing,x,yellow	-2.5,0.5-,1-2,1-3,1.5,4,accrescen,adaxially,alyx,armed,articulated,attenuate,axe,ba,blade,eaf,eed,enlarged,erect,exceeding,extror,geminat,globo,homostylous,including,long,lower,nflorescence,orolla,perfec,porrect,porrect-stellate,proximally,rarely,ruit,scarcely,slender,solitary,sparse,stellat,stellate-pubescen,summit,tall,tamen,tem,thickened,tip,toward,trichome,unarme,unarmed,unit,usually,vary,ympodial,zigza	0.5-2.5,abaxial,accrescent,adaxial,arrangement,branching,color,colour,corolla,extrorse,feature,form,frequency,geminate,height,history,inflorescence,length,life,na,orientation,ovary,perfect,perfection,plant,position,red,shape,similarity,spacing,staman,texture,vein,zigzag
58	wfo-0001026208	success	214	115	90	124	25	0.421	0.5-1.2,0.6-0.8,0.7-2,0.8-1.5,1-5,1.5-2.5,11-25,2-20,2-4,3.5-5,4-7,5-17,5-merous,abaxial,abaxially,acuminate,acute,adaxial,anther,apart,apex,bark,base,berry,bright,chartaceous,cm,cuneate,dark,densely,diameter,dull,elliptic,erect,evenly,filament,flattened-reniform,flower,fruit,glabrescent,glabrous,gray-greenish,green,green-brown,lateral,leaf,length,lobed,long,longer,margin,maturity,mauve,membranous,midpoint,midvein,mm,moderately,orange,orange-brown,ovate,pair,pale,pedicel,peduncle,petiole,primary,red,rounded,shrub,side,sometimes,sparsely,spherical,stellate,stellate-pubescent,stem,style,surface,terminal,tertiary,time,trichome,vein,venation,visible,white,wide,yellow,young	-1/2,-10,-3,-5,.5,/3,0,0-20,0-4,0-5,0-8,0.1,0.1-0.2,0.1-0.25,0.1-0.3,0.5-0.8,0.6-0.9,0.8-1.3,1-2,1-4,1.5,1.8-2.3,1.8-2.5,1/3,1/4-1/3,1/4-1/6,2,2-3,2.5-5,2.5-6,3-30,3-5,3-6,3/,4-9,5,5-,5-22,6-22,6-8,acut,alyx,apar,apically,apparently,articulated,becoming,blade,branched,broad-deltate,brown,calyx,conical,connivent,curved,deltate,difoliate,discolorous,distance,drying,eaf,eed,elongated,elongating,equal,extending,flattened,free,fruiting,geminat,geminate,infructescence,lobe,lower,mature,nflorescence,older,one,open,orolla,oung,pendulous,per,perfec,pericarp,poricidal,porrect,portion,prickle,prickly,pubescent,ray,recurved,red-brow,ruit,scar,sessile,shorter,slender,smooth,somewhat,spaced,spreading,stalk,stalked,stout,straight,straw-yellow,subentire,tamen,tapering,terete,tip,toward,tube,unarme,unarmed,unit,usually,variously,vary,way,woody,ympodial	arrangement,color,colour,corolla,feature,form,growth,height,inflorescence,na,ovary,pattern,plant,position,rachi,ratio,red-brown,secondary,seed,shape,size,spacing,staman,stigma,texture
59	wfo-0001026215	success	150	116	91	59	25	0.607	-3,.05,.5,0,1-3,1.5,13-35,15-2,2-3,2-4,4-15,4-5,7-8,abruptly,absent,acuminate,anther,anticlinal,apex,axillary,base,beak,brown,calyx,cell,clavate,cm,completely,conical,conspicuously,corolla,densely,diameter,elliptic,epidermal,exserted,filament,flattened-round,fruit,fruiting,glabrous,globose,green,greenish,herb,highly,horizontal,internode,irregular,kink,length,lobed,long,marked,markedly,minutely,mm,narrowing,occasionally,often,ovary,ovoid-reniform,papillae,papillate,pedicel,petiole,poricidal,projection,purple,red-papillose,rugose,scar,seed,shrub,simple,sinuous,stem,stigma,strongly,style,surface,thickening,tip,tube,usually,white,white-lenticellate,white-pubescent,winged,without,x	0.05,0.5-1,1,1.5-2,1.5-2.2,18-20,2,2-3.5,3/4,abaxially,along,anthesi,ape,axil,berry,bifi,broadly,continually,deltate,eaf,edicel,eed,enlarged,entire,erect,flower,free,less,lobe,lower,nearly,nflorescence,noddin,nodding,onto,pair,papillat,per,portion,primary,raised,reflexed,rounded,ruit,shortsympodial,single-stemmed,small,ste,tal,tem,time,tub,ud,unifoliat,unit,vein,way,wide,wing	abaxial,arrangement,bifid,bud,color,form,growth,height,history,inflorescence,leaf,lenticellate,life,na,perennial,plant,position,shape,short,size,spacing,tall,texture,unifoliate,variation
60	wfo-0001026220	success	158	137	90	68	47	0.57	/3,0.3-1.5,1.0-1.8,1.3-1.7,1.5-2.5,10-20,2.5-3.5,4-12,50-90,accrescent,acute,annual,anther,armed,band,base,bearded,becoming,berry,blade,brown,calyx,campanulate,cm,dark,developing,dry,essentially,foliaceous,foveolate,glabrous,glandular,glaucescent,hair,herb,internodal,interpetalar,invested,lacking,lanceolate,leaf,lobe,long,maturity,minutely,mm,near,obtuse,often,ovate,pentagonal,pentagonal-stellae,per,petiole,pigment,pinnatifid,pinnatisect,plant,plicate,portion,prickle,proximal,purple,red,reddish,reticulately,ridged,short,simple,spaced,spherical,splitting,stellate,stellate-pubescent,stem,straight,suffused,surface,surrounding,terminally,thrice,tightly,tissue,tube,ultimate,upon,ventral,well-developed,widely,yellow	.3-2.8,.5,0.2,1,4-10,5-10,6-10,7-11-flowere,8-12,across,along,alyx,anthesi,ape,back,closely,coarsely,conspicuous,dia,difoliate,divided,dryin,eaf,eed,flattened-ovo,geminat,heteromorphic,large,later,latter,lon,main,many,mostly,much,nearly,nflorescence,one,orolla,persistent,persisting,petal,prickly,ray,reduced,ruit,scattered,second,shorter,side,similar,slende,somewhat,stellae,tall,tamen,tigma,tub,twice,tyle,unexpande,unit,vary,vein,year,yello,ympodial,young	7-11-flowered,abaxial,adaxial,armament,arrangement,bearding,change,color,colour,corolla,development,diameter,drying,filament,flattened-ovoid,flower,flowering,form,fruit,glaucousnes,growth,height,history,inflorescence,investment,length,life,na,number,ovary,pedicel,peduncle,pinnation,position,presence,rachi,seed,shape,spacing,staman,stigma,style,suffusion,texture,type,unexpanded,width
61	wfo-0001026227	success	150	88	67	83	21	0.447	.3,.8,0,0-1,0-1.5,0-3,0.3-2.2,0.9-1.2,1-1.3,10-15,15-20,3-6,5-merous,absent,acicular,apex,base,chartaceous,cm,cuneate,densely,elliptical,entire,flower,fruit,globose,green,grey,herbaceous,index,inflorescence,lateral,leaf-opposed,length,lobed,lobing,long,longer,margin,mid-point,midvein,mm,moderately,oblique,obtuse,ovate,pale,part,pedicel,peduncle,petiole,prickle,pseudo-racemose,ray,resprouter,shallowly,solitary,sparsely,stellate,stellate-pubescent,straight,thick,time,unbranched,wide,yellow,yellowish	%,0-0.1,0.1-0.7,0.25-0.4,0.3-0.4,0.3-0.5,0.3-0.6,0.3-0.9,0.4-1.4,0.5-1,1,1-4,1.5-4,1.6-2,17-55,2-10,2-2.5,2-3,2.5-3,3-7.5,5-30,6-8,7-8,abaxially,absen,across,adaxially,apart,armed,articulated,axe,ba,blade,calyx,chartaceou,d.,deltate,diameter,distributed,eaf,eed,eglandular,finger,fruiting,gland-tipped,gree,hair,half,lamina,lobe,lon,lower,mature,midpoint,nflorescence,orolla,per,porrect,present,ruit,sessile,short,side,simple,spaced,sprawling,stage,stalk,stellae,stigma,style,tal,tamen,tem,throughout,transparent,tube,unit,unknow,uvenile,vary,x,ympodial	abaxial,adaxial,color,corolla,form,growth,height,history,leaf,life,na,perennial,plant,position,presence,seed,shape,spacing,stem,surface,texture
62	wfo-0001026229	success	299	119	86	213	33	0.288	1,1.8,5,abaxial,abaxially,adaxial,anther,base,berry,black,branching,brown,clavate,cm,corolla,cyme,dark,densely,diameter,discolorous,eglandular,elliptic,elongated,flattened,flower,fruit,glabrous,glandular-capitate,globose,golden,green,growth,hirsute,hyaline,immature,inflorescence,internodal,irregular,lateral,leaf,lobed,long,long-stalked,mature,membranaceous,mm,moderately,multangulate-stellate,multiseriate,narrowly,ovate-elliptic,pale,papillose,pedicel,peduncle,petiole,pit,porrect-stellate,pubescent,purple,rachi,reniform,sessile,shiny,short-,short-stalked,shrub,simple,sparsely,spreading,stalk,stellate,stem,stigma,style,subopposite,surface,terminal,trichome,type,unbranched,upper,weakly,white,yellow,¾	0.1–1.47,0.2–0.8,0.35,0.3–0.9,0.3–1.2,0.4,0.8–1.2,0.8–2,0.9,0.9–4.3,1-celled,1.2–4.8,1.3–1.5,1.3–1.7,1.4,1.7–11.8,1.7–2.3,1.8–5.5,1.9–2.5,1/3,13,1–1.4,1–2,1–4,2,2.3–3.4,2.8–4,2–3,2–3-celled,2–4-celled,3,35,3–4,3–5,4.5–6.5,4–6,5-merou,5–9,6–15,6–7,6–8,8.6–12,8–10,9–31,accrescent,acuminate,acute,adaxiall,adaxially,ag,almost,also,always,alyx,anthesi,apex,ark,articulated,associated,asymmetric,attenuate-caudate,axe,ba,barely,beneath,blade,branch,broadly,broken,calyx,camptodromous,capitate,celled,central,changing,commentary,commonly,completely,concentrated,connivent,cordate,covered,creating,cuneate,cylindrical,deltoid,develope,developed,differing,directed,di­,dried,drying,eaf,eed,ellipsoidal,entire,even,faces,few-rayed,found,free,frequently,fresh,fully,geminate,glabrescent,gland,glandular,hair,head,hispid,ilament,impressed,included,insertion,introrsely,involute,lamina,lanceolate,larger,less,like,lobe,longer,longitudinal,lower,mainly,margin,material,maturit,midpoint,midri,midvein,minute,mixed,much,multangulate,narrow-ovate,near,nearly,new,nflorescence,oblong,often,old,older,one,open,opening,orientation,orolla,other,oung,ovate,pair,paired,pedunculate,per,perfect,pink,plurifoliate,point,poorly,pore,poricidal,portion,primary,purplish,ra,raised,rarely,ray,remnant,revolute,rounded,ruit,secondary,see,shin,shorter,size,slightly,slit,small,smaller,solitary,sometimes,somewhat,spread,spreadin,strongly,subsessile,supported,surfac,three,tree,trifoliate,tube,tuft,ud,unequal,unit,usually,vary,vein,venation,vestiture,visible,whitish-green,wide,yellowish-white,ympodial	0.1-1.47,0.2-0.8,0.3-0.9,0.3-1.2,0.35-4.3,0.8-2,1.3-1.7,1.8-5.5,1.9-2.5,2-4-celled,2.8-4,5-merous,6-7,arrangement,color,colour,filament,form,height,history,length,life,na,ovary,perennial,plant,position,seed,shape,stalked,staman,texture,unstalked
63	wfo-0001026230	success	144	90	68	76	22	0.472	.25,.5,.8,0.3-1.5,0.75-1,0.9-2,1-1.4,1-1.5,1.8-2.3,1.9-4.1,12.6-20.8,2-4,2-5,3-4,4.6-9.3,5-20-flowered,anther,apart,area,bark,base,bud,calyx,cm,corolla,elliptic,filament,fruit,fruiting,glabrous,globose,green,grey,immature,large,leaf,lobe,lobed,long-acuminate,minor,minutely,mm,nearly,older,opposite,orbicular,ovary,ovoid,papillose,pedicel,petiole,rusty-papillose,shaped,shrub,simple,small,stem,stigma,strongly,style,surface,tear-drop,tree,tube,umbonate,unknown,white,x	0.5-3,1-4,1.1-1.8,5-10,acuminate,acute,anisomorphic,anisophyllou,anthesi,apex,apiculate,appears,back,beginning,beneath,berry,broadly,clavate,clu,completely,cordate,coroll,deflexed,deltoid,dia,difoliate,distal,eaf,edicel,eed,enclosing,erect,evenly,except,free,geminate,inflorescenc,lateral,lon,long,long-triangular,lower,main,major,margin,middle,nflorescence,obtuse,pair,pointed,pore,poricidal,portion,raised,reflexed,rounded,ruit,scar,sinus,slender,slightly,spaced,straight,tall,tapering,thickened,tip,ud,unit,vein,white-lenticellat,widest,winged,woody,ympodial,young	anisophyllous,arrangement,color,diameter,flower,form,growth,height,history,inflorescence,length,life,number,perennial,plant,position,seed,shape,spacing,texture,white-lenticellate,width
64	wfo-0001026233	success	165	95	76	89	19	0.461	-1,-1.9,-3.8,-5.5,-50,-8.1,.25,.75,0.3,0.5,0.7-0.8,0.8-1.55,0.8-4,1.1,1.2-2.7,1/2,2.1,2.3-7,2.4-3.5,2.6,2/3,3.5-4.5,5-30,6,acute,annual,annular,anther,apex,basal,broadly,calyx,campanulate,capitate,cm,conspicuous,densely,diameter,elliptic,embryo,entire,filament,glabrous,globose,herb,interlobular,leaf,less,lilac,longitudinally,margin,membrane,mm,moderately,narrowly,obtuse,ovate,pale,petiole,pinnatisect,pubescent,ridged,seed,slender,sparsely,stigma,style,subglobose,surface,trans-ovoidal,tube,tuberculate,unifoliate,winged,x,yellow	0.7-,0.8-1.3,1,1-,1.5,2,2-,3.2-3.7,3.2-4.7,4-,5-6.2,abundant,accrescent,ag,antrorse,articulated,ascending,base,bearing,berry,coat,cuneate-attenuate,curved,cylindrical,difoliat,dimorphic,eaf,eed,ellipsoidal,evident,few-,fruiting,hair,herbaceous,hig,investing,lamina,larger,lobe,lobed,long,longitudinal,lower,minutely,multicellular,near,non-glandular,occasionally,opening,orolla,other,outer,ovule,papery-scarious,partially,pinnatipartite,pore,poricidal,portion,present,protuberance,pubescen,ree,reticulate,rounded,ruit,scarcely,seede,serrate,shorter,simple,slightly,slit,small,smaller,striate,strongly,styl,tem,tip,trichome,unequal,uniseriate,unit,vary,venatio,verrucose,wider,ympodial	4-6.2,arrangement,color,corolla,difoliate,form,fruit,growth,height,history,length,life,ovary,plant,ridging,shape,size,stem,texture
65	wfo-0001026241	success	220	118	79	141	39	0.359	1-celled,109,anther,anthesi,apex,apical,basal,beak,black,brittle,broader,brown,capitate,cell,cm,conical,corolla,covered,curved,curving,dry,et,filament,flower,fruit,fruiting,galiano,gland,glandular-pubescent,globose,herb,inflorescence,internodal,intially,larger,leaf,lobed,long,longitudinal,mm,orangish,outline,ovary,ovate,ovoid,pedicel,peduncle,perennial,petiole,pinnatifid,pitted,pore,pubescent,pulp,rachi,remain,reniform,seed,shiny,sinuate,slightly,slit,stellate,stem,stigma,strongly,style,subshrub,surface,ternate,testa,thickened,triangular,trichome,truncate,uniseriate,usually,white,x	.2,.3,.5,0.1–0.15,0.2–,0.3–,0.3–0.4,0.3–0.6,0.3–1,0.5,0.5–0.7,0.5–0.8,0.5–1,0.7–1.1,1-,1.2–1.5,1.2–2,1.5–1.7,1.5–2.5,1.5–3.5,1.9–2.1,1/3–1/2,10-20,1–,1–1.1,1–1.4,1–1.5,1–2,2-flowered,2.5–3,2–2.1,2–3,3,3-,30–50,3–3.1,4-,4.5–5,5,5-celled,5-merous,6,abaxially,adaxially,always,appearing,appears,articulated,attenuate,ba,base,basiscopically,berry,branching,calyx,campanulate,center,connecting,cordate,cup,darker,decurrent,deflexe,dehiscing,deltate,densely,denser,depressed-globose,dia,difoliate,discrete,drying,dwarf,eaf,eglandular,elliptic,enclosed,entire,equal,erect,erose,extended,foliat,foliose,free,geminate,glabrous,glandular,irregularly,lateral,leaflet,like,lobe,lon,main,margin,midvein,mixture,much,near,nflorescence,oblique,one,onto,open,papillat,papillate,per,perfect,pericarp,portion,prolonged,pubescen,robust,ruit,shallowly,simple,small,smaller,sometimes,somewhat,spatulate,stamen,stout,succulent,sulcate,taproot,terminal,thick,tip,tissue,tube,tuberculate,ud,unit,vein,way,wide,wing,woody,ympodial	0.1-0.15,0.3-1,0.5-0.7,1-1.1,1-2,1.2-1.5,1.5-1.7,1.9-2.1,2-2.1,2.5-3,3-3.1,30-50,4.5-5,abaxial,adaxial,arrangement,color,colour,curvature,deflexed,dehiscence,diameter,form,growth,height,history,length,life,na,plant,position,shape,size,spacing,staman,texture,thicknes,type,width
66	wfo-0001026242	success	210	98	77	133	21	0.367	0-2,0.4-0.5,0.4-2,0.5-1,0.7-1.3,1-1.5,1.5-4,2.5-4.5,4-5-merous,5-7,6.5-8,abaxial,acute,anther,apart,apex,base,branched,bright,calyx,cm,cuneate,densely,diameter,dull,elliptic,elongating,erect,evenly,eye,filament,flattened-reniform,flower,fruit,fruiting,glabrescent,glabrous,green,lateral,leaf,length,lobe,lobed,margin,maturity,membranous,mm,moderately,naked,obtuse,orange-brown,pair,pedicel,peduncle,petiole,prickly,primary,red,red-brown,rounded,shrub,side,sometimes,sparsely,spherical,stellate-pubescent,stem,style,surface,terete,tertiary,vein,venation,visible,white,yellow,young	-0.9,-1.5,-2,-5,-6,/4,0,0.05-0.2,0.1,0.3-0.5,0.35-,0.4-0.55,0.5,0.5-0.7,0.55-0.9,0.7,1-2.5,1-3,1.2-2,1.5-3,1/2,1/5-1/3,1/6-1/4,10-,10-20,2-2.5,2-5,2.5-2.8,3-6.5,30-80,4-10,4-13,4.5-5.5,5-,5-18,7-17,8-20,abaxially,acut,almost,alyx,ame,apar,apically,apparently,articulated,bark,berry,blade,broad-deltate,c.,concolorous,connivent,curved,deltate,difoliate,distance,drying,eaf,eed,equal,extending,filiform,flattened,free,geminat,glabrou,glandular,green-gra,hair,infructescence,irregularly,largely,long,longer,lower,mature,midpoint,midvein,minute,multangulate,narrow-deltate,nflorescence,occasionally,older,one,open,orolla,oung,pale,pale-brown,per,perfec,pericarp,poricidal,porrect,portion,prickl,prickle,ray,recurved,reflexed,ruit,scar,sessile,shorte,shorter,simple,smooth,spaced,spreading,stalk,stalked,stellate,straight,subentire,tamen,tapering,time,tip,trichome,tube,unarme,unarmed,unit,upper,variously,vary,way,weakly,wide,woody,ympodial	0.35-0.9,adaxial,apical,arrangement,color,colour,corolla,form,growth,height,inflorescence,na,ovary,plant,position,pricklines,seed,shape,spacing,staman,texture
67	wfo-0001026259	success	233	91	78	155	13	0.335	.8,0.2–0.4,0.3–1.2,0.4–0.6,0.5–0.6,0–2,1.0–1.2,1.0–3.3,1.2–8.4,1.4–4.0,1.5,12–24,1–3-celled,2-ridged,2–17,3.0–3.4,5-merous,6,abaxial,abaxially,adaxial,anther,appressed,berry,broadly,brown,cm,concave-reniform,corolla,cylindrical,diameter,ellipsoid,filament,flower,fruit,glabrous,globose,green,green-orange,herb,inflorescence,leaf,length,less,lilac,mm,nearly,once-branched,ovary,ovate-lanceolate,pedicel,peduncle,petiole,plant,pubescent,rachi,rarely,ripe,shiny,shrub,simple,slightly,smooth,sparsely,stellate,stem,stigma,style,surface,translucent,trichome,tube,turning,uniseriate,white,winged,yellow,young	.1,.7,0.1–0.2,0.5,0.7–0.9,0404,1,1-celled,1.5–2.0,11–22,1m,1–2,1–2-celled,2/3,2–3-celled,35–45,4–5,5–14,5–7-celled,7–10,8–11,?,acuminate,acute,adaxially,affected,age,anthesi,apar,apex,arising,base,becoming,beyond,branch,branched,branching,calyx,cell,central,close,coloured,cone,congested,conical-ellipsoid,cream-coloured,decurrent,dehiscing,deltate,densely,difoliate,drop,eaf,eed,elongating,end,entire,especially,et,exerted,fleshy,free,fruiting,geminat,gradually,growt,halfway,hilum,individual,internodal,knapp,larger,lateral,leave,lengthening,like,live,lobe,lobed,lon,long,longer,lower,lowermost,margin,membranous,minutely,much,narrower,narrowly,near,nflorescence,node,occasionally,often,one,outline,pair,pale,papillate,pathogen,pentagonal,per,perfect,pericarp,pore,poricidal,portion,positioned,primary,purple,purple-black,purple-coloured,recurving,reduced,reflexed,relatively,remaining,rounded,ruit,scar,short,shorter,similar,slit,sometimes,somewhat,spaced,splitting,spreading,star,stone,stout,straight,strongly,sub-laterally,tall,tapering,tem,testal,thick,tightly,tinged,tip,together,toward,two,ud,unit,vein,wide,woody,yellow-green,ympodial,–15	apart,arrangement,color,form,growth,height,na,ridging,seed,shape,spacing,texture,width
68	wfo-0001026262	success	179	100	79	100	21	0.441	0.2-0.6,0.5,0.5-1,0.5-1.5,0.8-1.4,1-2,1-5,1.5,10-15,2-5,3,3-10,4-6,7-13,7-9,abaxial,abaxially,absent,adaxial,anther,base,brown,chartaceous,cm,cylindrical,dark,densely,diameter,extra-axillary,filament,flower,fruit,glabrous,globose,green,hair,immature,leaf,light,like,lobed,mature,midpoint,mm,moderately,mottling,multicellular,nearly,netlike,orange,ovate,pedicel,peduncle,petiole,pit,porrect-stellate,pubescent,rachi,raised,ray,reniform,ridge,rusty,separated,shrub,simple,stalk,stellate,stem,stigma,style,surface,tan,unbranched,unicellular,vine,white,x,yellow	0.25-0.5,0.5-1mm,0.75-1.5,1,1-.,1.5-2,2-2.5,2-3,3-6,30,4-10,4-15,4-7,4-8,5-8,5-merou,absen,accrescent,acute,adaxiall,adaxially,alyx,apar,apex,apical,apparently,armed,asymmetrical,attenuate,axe,berry,beyond,blade,calyx,connivent,contiguous,cordate,difoliate,directed,discolorous,distal,eaf,eed,either,em,end,expanded,exserted,filiform,frui,fruiting,geminate,glabrou,gree,interpetelar,intorsel,lacking,lobe,long,lower,major,midrib,midvein,multiseriate,narrowly,nflorescence,obscure,obtuse,occasionally,often,orolla,pair,per,perfect,pore,prickle,recurved,roselike,ruit,scandent,secondary,side,slightly,spaced,sparsely,stamen,ste,tamen,tapering,tissue,triangular,tube,unarmed,unequa,unit,unlobed,vary,vein,wide,ympodial	1-4,5-merous,apart,arrangement,color,colour,corolla,form,growth,height,inflorescence,length,ovary,plant,position,seed,shape,spacing,staman,texture,type
69	wfo-0001026267	success	162	143	108	54	35	0.667	.25,.5,0.1-1,0.6-1.7,0.7-1.1,1-1.2,1-1.5,1-2.6,1.5-2.3,2.5-3,20-30-flowered,3-15,5-7,acuminate,acute,anther,anthesi,apex,attenuate,axil,bark,base,beneath,body,bright,calyx,closely,cm,corolla,cuneate,decurrent,deflexed,densely,drying,except,exerted,filament,flattened-reniform,fruiting,glabrous,globose,green,greenish-white,greyish-green,hard,incrassate,larger,lateral,lavender,leaf,lobed,long,main,margin,maturity,minutely,mm,narrowly,nearly,occasionally,often,opposite,ovary,ovate,overlapping,pale,papillose,pedicel,petiole,pitted,pitting,pore,pubescent,quickly,remaining,ripening,rough,scar,shaped,shrub,simple,slender,slightly,small,softening,soon,spaced,sparsely,stem,stigma,straight,style,surface,tan,tapering,tear-drop,tinge,tree,trichome,tube,tuft,uniseriate,vein,white,wing,winged,x,yellow-green	0.5-1,1-4,1.5-2,3-6.1,3.2-8.6,4-8,8-10,8.5-15,ba,beginning,berry,blackish,broadly,crateriform,depressed,dia,differing,difoliate,distally,distinct,eaf,edicel,eed,free,geminat,inflorescenc,lobe,lon,longinflorescence,lower,major,middle,minor,older,one,pair,papillo,poricidal,portion,raised,reflexed,ruit,scarious,scattered,size,tall,tip,triangular,ud,unit,widest,woody,ympodial,young	abaxial,adaxial,arrangement,bud,color,colour,deflexion,diam,diameter,exertion,flower,form,fruit,growth,hardnes,height,history,inflorescence,length,life,na,number,papillae,peduncle,perennial,plant,position,rachi,seed,shape,spacing,staman,straightnes,texture,winging
70	wfo-0001026272	success	182	112	92	90	20	0.505	1,1-1.5,1-2,12-15,2-2.5,2-3,2-7,4-5,7-8,abaxial,adaxially,anther,apiculate,base,brown,celled,clavate,cm,coriaceous,corolla,corymbose,cream-colored,cyme,densely,denser,diameter,elliptic,erect,filament,flattened,form,glabrous,glandular,globose,green,growth,inflorescence,internodal,lanceolate,lobed,midpoint,minute,mm,obelliptic,ovary,ovoid,pedicel,peduncle,petiole,pitted,poricidal,porrect,pubescence,pubescent,reddish,reniform,reticulately,rugose,rusty,scabrous,scandent,scar,sessile,shrub,simple,slightly,somewhat,spaced,sparsely,stellate,stem,stigma,style,subconical,subglobose,surface,tapering,terete,thick,tip,trichome,tube,turbinate,unarmed,unevenly,velutinous,viscid-pubescent,way,white,x,yellowish,¾	0.2-0.3,1-1/5,1-2-celled,1.2-1.5,1.5-2,1/3,20,20-30,3-4,3-5,3.5-4,5-8,6-8,7-10,abaxially,age,anthesi,apex,armed,articulated,bark,basal,berry,beyond,branched,calyx,discolorous,distal,eaf,eed,epidermi,exserted,flower,free,fruiting,fused,heterostylous,lengthening,like,lobe,long,long-styled,lower,many,midpoin,mixed,multangulate,multicellular,new,nflorescence,numerous,oblong,older,partially,pendant,per,perfect,pericarp,plurifoliat,pore,porrect-stellate,portion,prickle,prickly,quarter,rachi,raise,recurved,reduced,ruit,short-styled,slit,sparse,stalked,staminate,sub-sessile,subcoriaceous,subtruncat,testa,time,triangular-lanceolate,ud,unarme,unicellular,unit,upper,venation,visible,woody,ympodial	adaxial,arrangement,bud,color,colour,fruit,height,history,leaf,length,life,na,plant,position,raised,seed,shape,spacing,subtruncate,texture
71	wfo-0001026279	success	248	121	99	149	22	0.399	-2.9,-34.3,-5.9,0.2-0.4,0.8-2.3,0.9-1.8,1-1.4,1-10,1-3.5,1.1-1.9,1.9-3.2,1/2,11.5-19.7,2/3,3-4,3.1-4.2,3.4-5.2,8,abaxially,accrescent,acuminate,adaxially,anther,apart,apex,base,black,branch,brown,bud,calyx,capitate,cm,conical,corolla,dark,deltoid,diameter,drying,elliptic,elongated,filament,flower,fruit,fruiting,glabrescent,globose,granular,grayish,grayish-green,green,immature,lanceolate,lavender,leaf,length,lilac,lobe,lobed,mature,mm,multangulate-pubescent,obovate,occasionally,orbicular,pale,pedicel,peduncle,petiole,plant,plurifoliate,porrect-stellate,pseudo-terminal,rachi,reticulate-punctate,rounded,scabridulous,scabrous,shrub,simple,slowly,somewhat,stellate,stem,stigma,style,subcampanulate,suborbicular,sulcate,surface,tomentose-pubescent,tree,way,white,whitish,x,yellow,yellowish,yellowish-tan	-11.4,-4,/14-1/8,0.25-0.4,0.9-1,1.1-1.6,1.5-1.8,1.5-3,1.7-2.3,1.9-3,14-27,2.4-3.2,2.5-3.2,2.6-4.8,3.1-3.6,3.5-7.8,3.8-5.1,4-7.5,5-200,5-8,8-11,8.5-10.5,9-22,acute,adaxiall,ag,anthesi,apparently,appearing,appressed,ark,around,articulated,attenuate,axe,axillary,ba,berry,blade,blunt-tipped,branched,chartaceous,closely,completely,covering,cuneate,cylindrical,dendritic-echinoi,dendritic-echinoid,dense,directed,distally,due,eaf,earl,echinoi,echinoid,edge,eed,entire,enveloping,equal,evident,exerted,expanded,farinose,few-rayed,fleshy,free,glabrescen,glabrous,hair,half,inserted,lateral,lengthening,long,long-stalked,longer,longitudinal,longitudinall,lower,m.,main,many,margin,midrib,minute,mixed,multangulate,multiseriate,narrowly,nflorescence,oblong,occasional,often,older,open,orolla,ovate-lanceolate,overlapping,partly,perfect,pore,poricidal,present,prominent,pubescence,ruit,scattered,secondary,semi-ovate,sessile,short,short-,short-decurrent,short-stalked,side,slightly,slit,spaced,splitting,stalk,stamen,subcoriaceous,subsessile,suture,tall,tamen,tertiary,thickened,thin,thin-stalked,time,tip,tomentose,tube,ud,unarme,unarmed,unit,unwinged,upper,usually,vary,vein,wide,ympodial,young	abaxial,adaxial,arrangement,bark,color,colour,form,growth,height,history,inflorescence,life,longitudinally,na,ovary,perennial,position,seed,shape,spacing,staman,texture
72	wfo-0001026292	success	190	128	103	87	25	0.542	0.5,0.5-1,0.5-2,0.75-1.25,1-1.5,1-3,1-5,1.5,1.5-8,1/3,10-15,12-16,2-3,2-6,2.5-3.5,20-25,3-5,5-10,abaxially,absent,acute,adaxial,anther,apex,armed,base,brown,chartaceous,cm,cut,dark,densely,diameter,either,extra-axillary,filament,flower,fruit,glabrous,globose,green,hair,immature,leaf,less,like,lobe,lobed,long,major,many,margin,mature,midrib,midvein,mm,moderately,nearly,netlike,obscure,obtuse,orange,orange-red,ovate,pedicel,peduncle,per,petiole,pit,porrect-stellate,prickle,pubescent,rachi,raised,recurved,reniform,ridge,roselike,secondary,separated,shrub,side,simple,sinus,slightly,small,sparsely,stalk,stellate,stem,stigma,style,surface,swollen,tan,unbranched,vein,way,white,whitish,wide,x,yellow	-13,0.25-0.5,0.5-1.5,1-2.5,1-8,1.5-2,1.5-2.5,13-17,2-4,3-15,3-8,3-9,30-40,4-8,5-merou,absen,accrescent,adaxiall,adaxially,alyx,apar,apical,apparently,asymmetrical,attenuate,axe,berry,beyond,blade,bud,calyx,connivent,cordate,curved,cylindrical,difoliate,directed,discolorous,distal,distally,eaf,eed,end,expanded,exserted,filiform,flattened,frui,fruiting,geminate,glabrou,gree,introrsel,lanceolate,lon,lower,midpoint,multicellular,multiseriate,nflorescence,occasionally,often,orolla,pair,perfect,pore,ray,reflexed,ruit,scandent,spaced,spreading,stamen,tamen,tapering,tem,thin-skinned,triangular,tube,unarmed,unequa,unicellular,unit,upward,vary,vegetatio,ympodial	5-merous,abaxial,apart,armament,arrangement,color,colour,corolla,form,growth,height,history,inflorescence,length,life,number,ovary,perennial,plant,position,seed,shape,spacing,staman,texture
73	wfo-0001026298	success	192	137	109	83	28	0.568	.5,0.1-0.3,0.2-4,0.25-0.5,0.3-2,0.4-1,0.5-3,0.6-1.5,1-1.5,1.5-2.5,1.5-4,2-3,2850,3-4,3-6,5-30-flowered,acuminate,acute,anther,anthesi,apex,appressed,area,auriculate,bark,base,broadened,calyx,caudate,closely,cm,corky,corolla,densely,dia,ellipsoid,fide,filament,flower,glabrate,glabrous,globose,golden,green,greyish,haught,inflorescence,later,leaf,length,lobe,lobed,long,long-styled,long-triangular,major,minor,minutely,mm,oblique,obovate,often,older,opposite,ovary,overlapping,ovoid-reniform,pale,papillose,pedicel,petiole,pitted,planar,plant,pore,puberulent,rarely,rather,red,reddish,reflexed,rhizomatous,rough,scar,shape,shaped,short-styled,shorter,shrub,simple,size,slender,somewhat,spaced,stem,stigma,style,surface,tapering,tear-drop,thick,tip,treelet,trichome,uniseriate,white,x,yellowish-tan,young	0.5-2,0.75-1,0.8-2,1.4-6,1.5-9,3/4,4-13,7-12,8-28,along,american,appearing,ba,bearing,beginning,beneath,berry,blade,bu,central,conical,costa,deflexed,deltoid,differing,difoliate,distal,dry,eaf,edicel,eed,elliptic,erect,even,exsertion,free,fruiting,geminat,impressed,inflorescenc,lateral,locality,lon,lower,main,margin,material,middle,midrib,minute,nflorescence,occasionally,one,orbicular,pair,papillo,peelin,poricidal,portion,prominent,rest,rican,rounded,ruit,scattered,single,sometimes,straight,tall,third,time,tube,two,ud,unicellular,unit,variable,varying,vein,way,widest,woody,ympodial	abaxial,adaxial,appearance,arrangement,bud,color,colour,deflexion,diameter,feature,form,fruit,glabration,growth,height,history,life,na,number,peduncle,peeling,position,pubescence,rachi,seed,spacing,staman,texture
74	wfo-0001026299	success	239	112	86	153	26	0.36	-3.5,0.1-0.25,0.1-0.4,0.1-0.5,0.25-0.5,0.4-0.5,0.5-1,0.5-2.5,0.8-1,1,1.1-1.7,1.8-2,7-12,acute,anther,apex,appendage,approximately,articulated,beneath,broadly,brown,calyx,capitate,cm,conical,corolla,dark,densely,diameter,distal,elliptic,entire,exserted,filament,flower,fruit,glabrous,glandular,globose,green,hair-like,half,herb,imparipinnate,inflorescence,interjected,interrupted,irregularly,leaf,leaflet,less,margin,middle,minutely,mm,narrowly,obovate,outgrowth,ovary,pale,pedicel,peduncle,pentagonal,perennial,petiole,pseudostipule,pubescent,rachi,short,simple,sparsely,stem,stigma,straight,stripe,style,surface,tall,tip,variously,velvety,way,white,winged,yellow	--,-0.8,-1,-10,-2.5,-5,.5,0-8,0.1-0.2,0.15-0.2,0.2-0.25,0.2-1,0.3-0.4,0.4-2,0.5,0.5-0.6,0.5-0.7,0.6-2,0.7-3.5,0.8-0.9,0.9-1,1-1.4,1-celled,1.2-1.6,1.2-5,1.5-,1.5-2.3,2-4,2-6,2-foliate,2-locular,2.2-3.2,2.5,2.5-7,25,3-,3.5-10,5,5-15,5-20,6-20,abaxially,absent,abundant,acroscopically,adaxially,almost,along,angled,anthesi,apical,appearance,axi,basal,base,basiscopically,berr,bract,bracteate,cell,change,chota,column,could,crenat,crenate-serrate,decurrent,developed,diamete,eaf,ebracteate,edicel,eed,eglandular,erect,fruiting,give,gree,hal,head,intermixed,internode,investing,jequetepeque,lacking,lanceolate,larger,lateral,like,lobe,lobed,lon,long,long-acuminate,longer,loosely,lower,marañón,maturity,minute,mixture,multicellular,nearly,nflorescence,node,oblique,occasionally,often,pair,patent,petiolule,population,present,primary,prostrate,pubescence,purple,reflexed,regularly,rest,ruit,scarcely,scattered,secondary,sessile,silky,size,sparse,spreading,staminal,sterile,stout,tem,terminal,tertiary,testa,thick,toward,trichome,truncate,tube,ud,unicellular,uniseriate,unit,usually,valley,vein,wall,weak-walled,wide,woody,ympodial	1.5-10,abaxial,adaxial,arrangement,articulation,bud,color,colour,crenate,decument,exsertion,form,growth,height,history,length,life,na,plant,position,seed,shape,staman,texture,width,wing
75	wfo-0001026305	success	135	115	86	49	29	0.637	.25,/4,0.2-1,0.25-0.5,0.5-2,0.6-1,0.7-1,1-1.5,1.3-1.5,2-2.5,5-7,6-9,abaxial,abaxially,acute,adaxially,anther,anthesi,apex,apical,area,attenuate,bark,base,beige-tan,closely,cm,conical,corolla,dark,deltate,dendritic,densely,difoliate,drying,elliptic,filament,free,fruiting,glabrous,globose,green,greenish-white,knob-like,leaf,leaf-opposed,lobe,lobed,long,margin,midrib,minute,minutely,mm,occasionally,ovary,ovoid-reniform,pale,papillose,pedicel,petiole,pitted,pore,portion,projection,pubescent,rounded,scar,shaped,shining,shrub,simple,spaced,sparsely,stem,stigma,style,surface,tan,tear-drop,tip,trichome,tube,unifoliate,way,x	2-6-flowered,2.5-3,3-8.5,4-4.5,7-16,7-9,along,ba,berry,calyx,congested,deflexed,dia,eaf,edicel,eed,exserted,geminat,glabrate,interlocking,lamina,lateral,like,lon,lower,main,middle,nflorescence,older,overlappin,pair,planar,poricidal,reddish-brow,ruit,scattered,slender,strongly,styl,tall,tub,ud,unit,vein,visible,widest,woody,ympodial,young	adaxial,arrangement,color,colour,diameter,flower,form,fruit,geminate,growth,height,history,inflorescence,length,life,na,overlapping,peduncle,perennial,plant,position,pubescence,rachi,reddish-brown,seed,shape,spacing,staman,texture
76	wfo-0001026307	success	193	95	68	125	27	0.352	5-merous,abaxial,abaxially,adaxial,anther,berry,black,broadly,cell,central,clavate,cm,corolla,densely,diameter,ellipsoid,end,eye,filament,flattened-reniform,flower,fruit,glabrous,glandular,globose,green,growth,herb,hilum,internodal,lateral,length,membranous,minutely,mm,narrower,outline,ovary,ovate,paler,pedicel,peduncle,pentagonal,petiole,positioned,pubescent,purple,purple-yellow,ripe,shape,shrub,simple,sparsely,stellate,stem,stigma,style,sub-laterally,surface,testal,tinged,toward,trichome,turning,uniseriate,white,yellow,yellow-green	.0–1.2,.3,.5,.5–4.0,.6,.8,0.2–0.5,0.2–1.5,0.4,0.5–0.6,0.5–0.7,0.5–5.0,0.6,0.8–0.9,0.8–2,0.8–5,1.0–1.2,1.0–1.5,1.0–2.0,1.0–2.4,1.0–2.5,1–3-celled,1–6-celled,2.0,2.0–3.0,2.0–3.5,2.6–13,2/3,3.0–4.0,3.5–7.0,35–45,3–8,3–8-celled,4–5.7,5–7,8–12,9,acute,acute-acuminate,adaxially,age,angled,anthesi,apar,apex,appressed,articulated,base,becoming,beyond,calyx,cone,cuneate,cylindrical,decurrent,difoliate,eaf,eed,entire,exerted,facing,free,fruiting,geminat,gradually,later,lengthening,like,lobe,lobed,long,longer,lower,margin,middle,narrowing,new,nflorescence,one,pair,papillat,per,perfect,pore,poricidal,portion,primary,recurved,reflexe,reflexed,restricted,ruit,scar,shallow,shallowly,shorter,side,slightly,slit,spaced,spreading,ste,stone,straight,strongly,tal,tem,three,tip,translucent,triangular,tube,two,ud,undulate,unequal,unevenly,unit,upper,variable,vein,vigorous,weak-stemmed,wide,ympodial	0.2-1.5,0.5-0.7,0.5-5.0,1.0-1.2,1.0-2.4,1.0-2.5,3.0-4.0,4-5.7,8-12,apart,arrangement,color,form,height,history,inflorescence,leaf,life,na,papillate,perennial,plant,position,seed,spacing,staman,texture
77	wfo-0001026317	success	169	110	90	79	20	0.533	0.25-1,0.3-1.2,0.5,0.5-0.6,0.8-1,1-1.2,10-12,2-2.5,2-4,3,4-5,acuminate,acute,anther,apart,apex,attenuate,bark,base,branched,bright,brown,capitate,clonal,closely,cm,conical,corolla,dark,dendritic,densely,diameter,distally,drying,elliptic,entire,extremely,filament,flattened,glabrous,globose,growth,inflorescence,internodal,lobed,longer,many,margin,minutely,mm,narrowly,often,orange,ovary,packed,pair,pale,papillate,pedicel,peduncle,petiole,pitted,plant,population,poricidal,primary,pubescence,pubescent,red,reniform,scar,shiny,shrub,simple,sparsely,stem,stigma,style,surface,terminal,thin,time,tip,toward,trichome,variable,vein,white,x,yellowish	.5,/4,0.5-0.8,0.5-1,0.6-,0.7-0.9,1-1.5,1-5.7,2-,2.5-10,3-3.5,3-foliate,3.5-15,50-200,6-8,6x,?,abaxially,absent,adaxially,age,anthesi,apically,approximately,berry,calyx,correlated,deltate,dense,eaf,eed,em,erec,erect,essentially,exerted,flower,found,free,fruiting,geminat,halfwa,lamina,lengthening,less,like,lobe,lower,maturity,new,nflorescence,nodding,occasionally,papillat,per,perfect,pericarp,planar,plane,pore,portion,pubescen,pulp,rachi,reflexed,ruit,slightly,slit,sticky,straight,swollen,triangular,tube,ud,uniseriate,unit,way,woody,ympodial	2,abaxial,adaxial,arrangement,bud,color,form,fruit,height,history,leaf,length,life,number,position,seed,shape,spacing,texture,variability
78	wfo-0001026321	success	213	147	123	90	24	0.577	0-0.2,0-2,0-3.5,0.1-0.4,0.4-0.7,0.5-0.6,1-1.2,1-1.5,1-2,1-3,1-4,1-5,1.2-3.5,1.5-3,2-4,2-5,2.5-5.5,3-10,3-4,3.5-8.5,4-,4.5-6,5-25,50-100,6-10,7-9,8-20,abaxially,absent,accrescent,acicular,across,adaxially,adult,andromonoecious,anther,apex,articulated,attenuate,base,bisexual,branchlet,broadly,brown,calyx,central,chartaceous,cm,cordate,decimetre,deltate,densely,diameter,entire,extra-axillary,flower,fruit,fruiting,glabrous,gland-tipped,glandular-puberulent,globose,green,hair,half,herbaceous,inflorescence,juvenile,lateral,leaf,leaf-opposed,length,less,lobe,lobed,long,margin,mature,mid-point,midvein,mm,moderately,oblique,obtuse,orbicular,ovate,pair,pale,part,pedicel,peduncle,per,petiole,plant,prickle,prostrate,pseudo-racemose,rachi,ray,resprouter,rostrate,rusty,shallowly,solitary,sprawling,stalk,stellate,stellate-pubescent,stigma,straight,style,surface,thick,throughout,time,transparent,tube,unbranched,weakly,white,x,yellow,yellowish-green	%,.5,0-0.1,0-0.25,0-0.3,0.1-0.2,0.1-0.3,0.3-0.6,0.4-0.6,0.6-0.9,1-locular,1.2-1.7,10-17,2-3,2-5.5,2-7,2.7-3.1,20-40,30-65,4.5,5-merou,6-11,7-10,8-11,adaxial,adaxiall,also,alyx,apart,armed,ascending,axe,ba,blade,capitat,connivent,cross-section,cylindrical,directed,distall,eaf,eed,eglandular,elliptica,exocarp,finger,frui,functional,glandular,greenish-white,grey-green,halfway,heterostylous,hig,incomplete,juicy,lanceolate,longer,lower,mesocarp,midpoint,midrib,minute,moist,nflorescence,orolla,placenta,pore,porrect,present,ruit,septum,sessile,shallowly-lobed,short,side,simple,spaced,sparse,stellae,tamen,tem,unarme,unarmed,unit,unknow,upper,vary,wide,ympodial	5-merous,articulation,branching,capitate,color,corolla,density,elliptical,filament,form,growth,height,history,life,ovary,position,reproduction,seed,shape,size,staman,stem,texture,thicknes
79	wfo-0001026325	success	216	136	107	109	29	0.495	.2,0.15–0.4,0.5,0.5–1.5,0.5–5,0.6–1.8,1,1.2–2,1.7–3.5,1.8–2.5,10–12,10–20,1–1.5,1–2,2,2.5–4,2–4,2–5,3,3.5,4–7,5-merous,6.5–15,7–10,7–8.5,abaxially,absent,acuminate,adaxially,anther,apart,apex,blue-violet,bud,calyx,caudate,cm,curved,darker,densely,diameter,downward,ellipsoid,elliptic,extra-axillary,filament,finely,flattened-reniform,flower,forked,foveolate,fruit,fruiting,glabrous,green,herb,heteromorphic,inflorescence,lanceolate,leaf,lenticular,less,light,linear,lobe,long,maturity,mm,mottling,narrowly,oblong,ovate-elliptic,ovoid,pale,pedicel,peduncle,perennial,petiole,prickle,producing,pubescent,root,rotate-stellate,simple,sometimes,sparsely,stellate,stellate-pentagonal,stellate-pubescent,stem,stigma,straight,style,subglobose-ovoid,surface,swelling,tapered,triangular,tube,tuber-like,unbranched,usually,white,yellow,yellow-orange,young,×	0.3,1.1–2,1.2–1.8,1.2–2.2,1.2–2.5,1.3–2.5,1.5,1.5–2.3,12–16,1–2.5,1–5,1–6,2-,2–10,2–6,3-foliate,3.3,4,4–8,5,5–9,accrescent,acute,adaxiall,alyx,andromonoecious,appearing,armed,articulated,axe,base,berry,blade,c.,capitat,central,chartaceous,completely,connivent,covering,cuneate,cylindrical,deltate,directed,directly,discolorous,distal,distall,eaf,eed,emerging,exserted,few-branched,formed,functionally,geminat,hair,hermaphorditi,hermaphroditic,lateral,like,lobed,lon,long-stuled,lower,lowermost,major,malae,margin,moderately,nflorescence,node,obtuse,often,one,orolla,outline,per,plurifoliate,pointed,pore,proximal,ray,rind,ruit,sessile,shallowly,shoot,short-styled,side,sinuate,somewhat,spaced,staminate,subentire,subtruncate,tall,tamen,tem,toug,unarmed,unequal,unit,upright,vary,vein,weakly,ympodial,–3	1–3,abaxial,adaxial,arrangement,branching,capitate,characteristic,color,colour,corolla,curvature,form,growth,height,history,length,life,na,ovary,plant,position,presence,pubescence,rachi,seed,shape,spacing,staman,texture
80	wfo-0001026335	success	157	106	78	79	28	0.497	.5,0.25-0.5,0.5-1,0.6-1,1-2,1-4,1.5-2,10-20,2-3,2-4,5-15,abaxially,adaxially,anther,apart,articulated,base,branched,chartaceous,cm,cylindrical,dense,densely,diameter,directed,distally,elliptic,elliptic-ovate,especially,filament,flattened,flower,forked,fruit,glabrescent,glabrous,globose,green,hair,large,leaf,leaf-opposed,like,longitudinal,mm,moderately,multangulate,oblong,opening,pedicel,peduncle,petiole,pore,probably,pubescence,pubescent,rachi,reticulate,ripe,scattered,sessile,shrub,simple,slit,stellate,stellate-pubescent,stem,stigma,style,surface,tip,toward,unripe,white,whitish,x,yellow,yellowish	.5-3.5,0.1-0.3,0.8-1.3,1,1-1.5,1-3,1.5-4,10-30,2,2-7.5,3-18,3-5,4-5,5-,5-7,7-8,accrescent,acuminate,acute,adaxiall,ag,apex,apparently,axe,ba,blade,calyx,capitat,connivent,covering,cuneate,curved,deltate,eaf,eed,entire,equal,erect,frui,fruiting,geminate,glandula,glandular,held,lanceolate,lobe,long,lower,many-foliate,margin,midpoint,much,nflorescence,often,orolla,paired,perfect,ray,rounded,ruit,slightly,smaller,sometimes,spaced,ste,straight,subtending,tal,tamen,tem,time,tube,unit,uprigh,usually,vary,vein,wide,ympodial	abaxial,adaxial,age,arrangement,articulation,capitate,color,colour,corolla,direction,form,growth,height,history,inflorescence,length,life,na,ovary,perennial,plant,position,seed,shape,size,spacing,staman,texture
81	wfo-0001026342	success	280	130	98	182	32	0.35	.3,0.08,1/3,4.7,4602,90°,abaxially,acuminate,acute,adaxially,aequilateral,anther,apex,attachment,attenuate,bark,base,blade,brochidodromous,brown,calyx,caudate,chartaceous,cm,corolla,densely,diameter,emerging,entire,extra-axillary,flattened-orbicular,flattened-reniform,flexed,fruit,glabrous,globose,inflorescence,internode,interpetalar,lateral,leaf,length,less,lobe,margin,markedly,mckee,midpoint,midvein,mm,nearly,notched,oblique,observed,occasionally,one,oval,ovate,pedicel,peduncle,petiole,point,porrect,pubescence,pubescent,raised,ray,red,reddish,rounded,sessile,simple,slightly,sparsely,speciman,stellae,stellate,stem,stigma,stipe,straight,style,surface,tip,tissue,trifurcating,truncate,tube,unbranched,upper,vein,weakly,well-developed,white,yellow,yellow-tan,±90°,×	.4–3.0,.6,.9,0.06,0.07,0.3–0.5,0.3–0.6,0.3–0.9,0.4–0.6,0.6–1.3,0.6–2.8,0.7–1.4,0.7–1.6,0.7–1.8,0.8,0.8–1.1,0.8–1.2,0.8–1.5,0.9–1.3,1.1–1.5,1.1–3.7,1.2,1.3–1.8,1.5–2.1,1.5–2.3,1.7–2.6,1.8–2.2,1.9–2.9,1/2–2/3,2.0,2.0–7.6,2.1,2.1–3.3,2.1–3.7,2.5,2.5–3.8,2.8–4.9,2.9,3.1–13.7,3.2–3.7,3.6–4.6,5-merou,5.1–6.6,5.2–7.7,5–8,6–12,7.7–11.2,7–8,8,8.5–9.5,8–13,9.5–14.2,absent,adaxial,adnate,ag,along,alyx,anthesi,apart,apical,apparently,appearing,arching,around,articulate,axe,ba,becoming,bent,berry,borne,branch,broad,bud,cancellate,capitat,channeled,climate,clinate,congested,connivent,deciduous,deltoid,dentate,development,difoliate,directed,distal,dorsally,dry,edge,eed,either,endocarp,erect,exocarp,extending,fertile,filament,filiform,flower,free,geminat,glandular,glossy,gradually,hair,homostylous,immature,increasing,individually,intact,intersepalar,juic,laxly,layer,lon,long,longer,lower,many,mature,midrib,minute,moderate,moderately,nflorescence,oblong,orolla,ove,per,perforated,pore,porrect-stellate,portion,potentially,reflexe,remaining,rigid,row,ruit,seen,short-stipitate,shorter,shrub,side,sinus,sloughing,smoot,soon,spaced,splitting,spread,stamen,stellate-pubescent,suture,tamen,tardily,tem,thin,time,toward,translucent,transparent,two,typically,ud,unarmed,various,vary,wide,yellow-ferruginous,ympodia,young,±densely,±equal,±evenly,±glabrous,–0.9,–19.0,–31.0	0.3-0.5,0.3-0.9,0.4-0.6,0.6-2.8,0.7-1.6,0.8-1.2,0.8-1.5,0.9,0.9-1.3,1.1-1.5,1.1-3.7,1.5-2.1,1.7-2.6,1.8-2.2,19.0,2.0-7.6,3.1-13.7,3.2-3.7,5.2-7.7,6-12,7.7-11.2,arrangement,breadth,capitate,color,number,ovary,position,seed,shape,size,texture
82	wfo-0001026343	success	221	115	91	130	24	0.412	-1.5,-4,.5,0-4,0.05-0.2,0.05-0.5,0.2-0.7,0.45-1,0.5-1.5,0.8-1.5,1-4,1.3-1.7,1.5-2,2-3,2-3.2,2-6,2.5-8,5-10,5-merous,7-12,abaxial,acute,adaxial,anther,apex,apparently,bark,berry,branched,broadly,calyx,chartaceous,cm,cream,curved,dark,densely,diameter,dull,elliptic,erect,filament,flattened,flattened-reniform,flower,fruit,fruiting,glabrescent,glabrous,green,green-brown,lateral,leaf,length,lobed,margin,marking,maturity,mauve,mm,moderately,orange,orange-brown,pale,pedicel,peduncle,pendulous,petiole,plant,porrect,prickle,purple,reddish,reflexed,rounded,sessile,shrub,small,sparsely,spherical,stalked,stellate,stellate-pubescent,stem,style,surface,tree,trichome,woody,yellow,young	-1,-15,-3.5,-7,/2,/5,0,0-10,0-2,0-40,0-5,0.1-0.2,0.15,0.2,0.2-0.3,0.3,0.5,1-2,1-3,1.5-2.5,1.8-2.2,1.8-3,1/,1/3,1/4-2/3,1/5,10-30,2-4,2-5,2-8,2.2-3.2,3-4,3-5,3.5-4.5,5.5-9,6-9,7-14,7-8,7-9,abaxially,acuminat,alyx,andromonoecious,apar,apart,apically,articulated,base,blade,brow,concolorous,connivent,cuneate,deltate,distal,distance,drying,eed,elongating,equal,extending,faint,free,hermaphrodite,heterostylous,infructescence,less,lobe,lobing,lon,long,long-styled,longer,lower,lowermost,mature,midpoint,midvein,multangulate,narrow-deltate,nflorescence,obtuse,older,one,open,orolla,oung,ovate,pair,per,pericarp,plurifoliat,poricidal,portion,prickl,prickly,primary,ray,reduced,ruit,scar,secondary,short-styled,side,smooth,sometimes,spaced,spreading,stalk,staminat,stout,tamen,tapering,terete,tertiary,time,tip,tube,unarmed,unit,upper,variously,vary,vein,venation,visible,way,weakly,wide,ympodial	arrangement,branching,brown,color,colour,corolla,form,growth,height,history,inflorescence,life,na,ovary,perennial,position,rachi,seed,shape,spacing,staman,stigma,texture,width
83	wfo-0001026351	success	199	125	102	97	23	0.513	0.5,0.5-1,0.5-1.0,0.5-1mm,0.75-1.0,1-1.5,1-3,10-15,2-3.5,2-4,2-5,3-10,3-6,4-7,4-9,8-15,abaxial,abaxially,accrescent,acute,adaxial,anther,apex,armed,asymmetrical,base,berry,beyond,brown,calyx,chartaceous,cm,corolla,dark,densely,diameter,distinct,entire,exserted,extra-axillary,filament,filiform,flattened,flower,fruit,fruiting,glabrous,globose,green,hair,heteromorphic,immature,leaf,leathery,length,lobed,long,long-styled,margin,mature,midpoint,mm,moderately,nearly,obtuse,occasionally,often,orane,orange,orange-red,ovary,ovate,pale,pedicel,peduncle,petiole,plant,porrect-stellate,prickle,pubescent,purple,rachi,recurved,red,reniform,revolute,roselike,seed,short-,simple,stamen,stellate,stem,stigma,style,surface,tan,vine,white,wide,x,yellow	0.25-0.5,0.5-1.5,1-.,1-2,1-2.5,1-4,10-18,12-16,15-50,3-9,4-6,40-80,5-15,5-merou,6-10,6-8,absent,adaxially,alyx,andromonoecious,apar,apical,apparently,attenuate,axe,blade,branch,branched,bud,commonly,connivent,cordate,coriaceous,cylindrical,difoliate,directed,discolorous,distally,eaf,eed,either,em,exseted,forming,frui,functionally,geminate,glabrou,gree,hermaphroditic,introrsel,like,lobe,lower,major,male,midrib,midvein,multicellular,multiseriate,narrowly,nflorescence,occasional,orolla,outer,pair,per,pore,proximally,ray,ruit,scrambling,side,siz,slightly,spaced,sparsely,spreading,stalk,ste,stellare,straight,subcoriaceous,surfac,swellin,tamen,tapering,triangular,tube,unarmed,unbranched,unequal,unicellular,unit,vary,vein,ympodial	1-6,accrescence,apart,armament,arrangement,color,colour,exsertion,filiformnes,form,growth,height,heteromorphism,inflorescence,na,position,pubescence,shape,size,spacing,staman,swelling,texture
84	wfo-0001026352	success	209	115	95	114	20	0.455	.5,0.5-0.8,0.5-1.5,0.5-3,0.7-2,0.9-1,1-1.5,1-10,1.2-1.7,3-15,4-4.5,5-6,abaxially,acuminate,acute,almost,angle,anther,antrorsely,apart,apex,bark,base,berry,blue,branching,brown,capitate-truncate,chartaceous,cm,cordate,corolla,curved,densely,diameter,ellipsoid,entire,evenly,filament,flattened,flower,fruiting,glabrous,globose,green,greenish,growth,inflorescence,irregularly,leafy,length,lobed,many,margin,membranous,minutely,mm,narrowly,nearly,ovate,pale,pedicel,peduncle,peg,petiole,pink,pubescent,rachi,reniform,right,scar,shallowly,shiny,shoot,short,simple,small,spaced,stellate,stem,stigma,style,surface,terminal,thin,time,trichome,truncate,tuberculate,uniseriate,unspecified,vine,white,woody,yellowish	.3,0.5,0.5-1,0.6-,1-,1-2-celled,1.5,1.5-2,1.5-4.6,10+,12-60,2,2-3-celled,3.5-9,5-merou,6-7,7-9,<,?,adaxiall,ag,alyx,anthesi,apparently,appearance,arising,articulated,articulation,axi,basal,bending,branch,broadly,calyx,cell,conical,deciduous,deltate,denser,discolorous,eaf,eed,eventually,expanded,exserted,few-celled,free,giving,half,heigh,herbarium,ilament,immature,impressed,inflorescenc,junction,lamina,large,largest,leave,leaving,lengthening,like,lobe,long,lower,mature,near,new,nflorescence,older,orolla,outline,pair,papillate,papillo,per,perfect,pericarp,plurifoliat,point,pore,poricidal,portion,primary,principal,reflexed,rest,revolute,ruit,seen,sleeve,slit,sparser,specimen,spreadin,spreading,straw-colored,strongly,tem,third,tip,tub,tube,ud,unit,upper,vary,vein,violet,weak,wide,widest,ympodial	abaxial,adaxial,arrangement,color,colour,form,fruit,height,history,leaf,life,na,ovary,plant,position,seed,shape,spacing,staman,texture
85	wfo-0001026352	success	214	127	107	107	20	0.5	.5,0.5-0.8,0.5-1.5,0.5-3,0.7-2,1-10,1.2-1.7,3-15,4-4.5,5-6,7-9,abaxially,acuminate,acute,adaxially,almost,angle,anther,apart,apex,articulated,articulation,basal,base,bending,berry,blue,branching,capitate-truncate,cell,chartaceous,cm,cordate,corolla,densely,denser,diameter,ellipsoid,entire,evenly,few-celled,filament,flattened-reniform,flower,form,glabrous,globose,green,growth,herbarium,impressed,inflorescence,irregularly,large,leaf,leafy,length,lobed,many,margin,membranous,mm,narrowly,near,nearly,ovate,pair,pale,pedicel,peduncle,petiole,pink,point,primary,pubescent,rachi,revolute,right,scar,shallowly,shiny,shoot,short,simple,sleeve,small,spaced,specimen,stellate,stem,stigma,style,surface,terminal,time,trichome,truncate,twining,uniseriate,unspecified,vein,vine,white,woody,x,yellow,yellowish	.3,0.5,0.5-1,0.6-,0.9-1,1-,1-1.5,1-2-celled,1.5,1.5-2,1.5-4.6,10+,12-60,2,2-3-celled,3.5-9,5-merou,6-7,<,?,ag,alyx,anthesi,antrorsely,apparently,appearance,arising,ark,axi,branch,broadly,brown,calyx,conical,connivent,curved,deciduous,deltate,discolorous,eaf,eed,eventually,expanded,exserted,free,fruiting,geminat,giving,greenish,half,heigh,ilament,immature,inflorescenc,junction,lamina,largest,leaving,lengthening,like,lobe,long,lower,mature,minutely,new,nflorescence,older,orolla,outline,papillate,papillo,peg,per,perfect,pericarp,plurifoliate,pore,poricidal,portion,principal,reflexed,rest,ruit,seen,slit,sparser,speciman,spreadin,spreading,straw-colored,strongly,tem,thin,third,tip,tub,tube,tuberculate,ud,unit,upper,vary,violet,weak,widest,ympodial	5-merous,abaxial,adaxial,arrangement,color,colour,fruit,height,history,life,na,ovary,plant,position,seed,shape,size,spacing,staman,texture
86	wfo-0001026357	success	206	120	97	109	23	0.471	0.1-0.3,0.11-0.29,0.2-0.7,0.4-1.6,0.6-1.5,0.8-1.2,0.9-1.2,1-6,1.5-2.2,1.5-2.5,1.5-2.8,1.7-2.9,2-2.8,2-3.3,2-6,2.3-4.2,3.9-6.2,4-5,4-6,4-7,5,5.8-13.6,abaxially,accrescent,acute,adaxially,anther,apart,asymmetrically,bark,branched,brown,calyx,chartaceous,cm,conical,corolla,dark,densely,diameter,ellipsoid,elliptic,ferrugineous-pubescent,filament,flower,foveolate,fruit,fruiting,glabrous,globose,green,hair,immature,lanceolate,leaf,length,lobe,many,mature,mm,multangulate-pubescent,narrowly,nearly,oblanceolate,obovoid,ovate,ovate-lanceolate,pale,pedicel,peduncle,persistently,petiole,porrect-stellate,pubescent,rachi,scabrous,semi-ovate,several,shrub,simple,small,smooth,somewhat,sparsely,stellate,stellate-pubescent,stelliform,stem,stigma,style,tan,time,tree,tube,white,x,yellow	0.8-1,1-1.2,1.1-1.7,1.4-2,1/2,10-11,10-17,2-3,2.5-3.3,30-68,6-7.5,7-10,7-15,absen,adaxiall,ag,along,anthesi,apex,apparently,around,articulated,axillary,ba,base,berry,blade,blunt-tipped,branch,capitat,closely,completely,conspicuous,coriaceous,covering,cylindrical,decurrent,directed,distally,eaf,edge,eed,entire,enveloping,exserted,farinose,fleshy,free,granular,half,hig,inserted,large,lateral,lengthening,line,lobed,long,long-attenuate,lower,m.,main,margin,midrib,minute,mostly,multangulat,multangulate,nflorescence,oblong,obtuse,older,orolla,perfect,plurifoliate,pore,poricidal,porrect-stellat,revolute,rough,ruit,runk,sessile,short-stalked,side,slightly,slit,spaced,sparse,stellate-pubescen,stellate-tomentose,suture,tamen,terete,testa,thick-stalked,tip,tomentose-pubescent,touching,ud,unit,vary,vein,way,weakly,whitish,within,ympodial,young	abaxial,adaxial,bud,capitate,color,colour,form,growth,height,history,inflorescence,life,na,ovary,perennial,plant,position,seed,shape,spacing,staman,surface,texture
87	wfo-0001026367	success	216	115	82	134	33	0.38	1.2-1.6,abaxial,abaxially,acicular,adaxial,adaxially,anther,apart,armed,asymmetric,attenuate,black-brown,blue,broadly,close,cm,colored,dense,densely,diameter,dried,erect,eventually,filament,finely,flower,fruit,glabrate,globose,green,growth,homostylous,immature,initially,internode,lance,lateral,lavender,leaf,lenticular,lighter,little,loosely,midpoint,minutely,mm,ovate,overtopped,pedicel,peduncle,pentagonal,petiole,pitted,plump,porrect,prickle,pubescence,pubescent,ray,rotate,shorter,shrub,simple,soon,sparsely,stellae,stellate,stellate-pubescent,stellate-tomentose,stem,stigma,style,surface,tan,tawny,terminal,tomentose,turning,unarmed,weakly,yellow,×	.5,0.2–0.5,0.4–0.6,0.4–0.7,0.5–0.7,0.7–1.5,1.8–2.5,10,10–15,10–18,15-20,15–30,1–2,1–3,2.5–4,2–3,2–3.5,2–4,2–4.5,2–5-branched,3–4,3–6,3–7,5-merou,5–7.5,5–9,6–8,7-9.7,7–11,8–10,acuminate,acute,adaxiall,age,along,alyx,apex,apparently,articulated,ascending,axe,ba,base,blade,branch,branched,capitat,caudate,center,closely,cordate,deeply,deltoid,denser,directed,distally,eaf,eed,entire,farinose,filiform,geminat,glabrous,hair,high,interpetalar,interwoven,irregularly,larger,later,like,lobe,lobed,lon,long,longer,looser,lower,margin,maturit,midvei,midvein,midzone,mostly,much,narrowly,near,nflorescence,oblong,often,orolla,ovoid,perfect,plurifoliate,pore,principal,rounded,ruit,sessile,shallowly,short,side,similar,sinuately,sinus,slightly,small,somewhat,some­what,spaced,splitting,spreadin,spreading,spreadingly,stalk,stalked,ste,tamen,tem,thick-chartaceous,time,tip,tissue,tomento,triangular,tube,ud,usually,vary,vein,well-developed,wide,ympodia,–20	0.2-0.5,0.4-0.6,0.5-0.7,1-2,1-3,10-18,2-3,2-4.5,2-5-branched,3-6,5-7.5,8-10,armament,arrangement,capitate,color,corolla,form,height,history,inflorescence,length,life,maturity,ovary,perennial,plant,position,seed,shape,spacing,staman,texture
88	wfo-0001026377	success	155	100	75	80	25	0.484	-8,0,0.5,1,12,16,2,2-3,3,3-,3-5,30,5-6,5-7,5-merous,7,7-7.5,8-13,abaxially,acute,adaxially,along,andromonoecious,anther,apex,articulated,base,blade,bright,broad,broadly,brownish,chartaceous,cm,densely,distinctly,filament,flower,forked,hermaphroditic,heterostylous,leaf,main,mainly,mm,narrow,often,ovate,pale,pedicel,peduncle,petiole,plant,polished,prickle,prickly,pubescent,purple,rachi,retrorse,shrub,simple,staminate,stellate,stellate-pubescent,stem,stigma,straight,style,surface,tapered,unbranched,unequal,vein,x	1/5-1/4,2.5,4,abaxiall,abundant,abundantly,acumen,apica,armed,axe,ba,belo,branched,calyx,cell,central,cut,distall,eaf,eed,ending,ermaphroditic,extra-axillary,fresh,geminat,hair,hermaphrodite,internode,lateral,like,linear,lobe,lon,long,lower,margin,midpoint,midrib,minor,nflorescence,oblique,orolla,pore,porrect,prickl,proximal,ray,reduced,repand,rounded,ruit,scattered,seen,shallow,sharp,short,side,single,sinus,smaller,sparsely,stipe,stou,straggly,structure,subcordate,subsagittate,tamen,taminate,tem,tipped,transition,triangular,tube,unknow,unknown,vary,vestigia,way,ympodial	3-6,abaxial,arrangement,articulation,branching,color,corolla,form,growth,height,history,inflorescence,length,life,number,ovary,perennial,reproduction,shape,size,staman,stout,texture,variation,vestigial
89	wfo-0001026379	success	219	112	87	132	25	0.397	-4.5,0.2-0.38,0.2-0.4,0.7-1,0.7-2.5,1-1.7,1-10,1-2,1-3.7,1.3-2.1,1.5-2.3,1.7-4.9,1.8-2.6,1.8-3.2,1.9-3.4,13,2-7,4.1-7,5.3-10.2,8.3-10,anther,apart,articulated,bark,base,blunt-tipped,branched,brown,calyx,cm,conical,corolla,dark,diameter,dried,echinoid-pubescent,ellipsoid,filament,finely,flower,fruit,globose,gray-brown,growth,leaf,length,lobe,many,minutely,mm,multangulate,multangulate-pubescent,nearly,oblong,obovate,ovate,pale,pedicel,peduncle,persistently,petiole,pitted,plant,porrect-stellate,rachi,reniform,scabrous,semi-ovate,shrub,simple,size,small,stellate,stellate-,stelliform,stem,stigma,style,time,tip,tomentose-pubescent,tree,tube,velutinous-pubescent,whitish,x,yellow	0.8-1.2,0.9-1.2,1.8-5,1/2,2-2.8,2.4-5.1,2.6-3.7,2.9-4,2/3,3-11,3/4,4-5,50-450,6-10.6,8-13,8-15,8-29,9-14,abaxially,accrescent,acute,adaxiall,adaxially,ag,along,anthesi,apex,apparently,around,attenuate,axillary,ba,basal,berry,blade,branch,capitat,chartaceous,closely,completely,covering,cylindrical,dendritic-echinoid,densely,directed,distal,distally,eaf,echinoi,echinoid,edge,eed,entire,enveloping,evident,farinose,few-rayed,fleshy,free,fruiting,glabrous,granular,grayish,hair,hig,included,inserted,lacking,large,lateral,lengthening,line,lobed,long,long-attenuate,lower,m.,main,margin,mature,midrib,minute,mostly,multangulat,nflorescence,obtuse,often,older,orolla,ovate-lanceolate,partly,perfect,plurifoliate,pore,poricidal,present,pubescen,rather,recent,rich,ruit,runk,scattered,sessile,short-stalked,side,slit,sometimes,somewhat,spaced,sparse,stellate-pubescent,stellate-tomentose,suture,tamen,terete,testa,thin,translucent,ud,uneven,unit,upper,usually,vary,vein,vestigial,violet,way,whitish-brown,ympodial,young	abaxial,adaxial,arrangement,articulation,bud,capitate,color,colour,form,height,history,inflorescence,life,na,ovary,perennial,position,pubescent,seed,shape,spacing,staman,surface,texture,width
90	wfo-0001026388	success	264	92	66	198	26	0.25	0.2-0.6,1.5-2,1.6,1.8,25,3,5,8.5,?,abaxially,acicular,adaxially,angle,anther,armed,base,bilobed,brown,cm,color,corolla,diameter,distinctly,enlarged,extra-axillary,filament,flower,fruit,glabrous,globose,glutinous,green,leaf,length,long,mm,moderately,ovate,pedicel,peduncle,petiole,pilose,plant,prickle,rachi,recurved,shape,simple,slightly,sometimes,sparsely,stellate,stem,stigma,straight,style,suborbicular,surface,thin-textured,tip,truncate,unbranched,wide,x,yellow-orange,yellowish	.2,.5,.7,0.15,0.2–1,0.2–2,0.4–1,0.5–1.7,0.5–2,0.5–4,0.8–1.5,0.8–2.5,1-2,1.4,1.4–1.6,1.5–2.2,1.5–3.5,108,10–20,12,1–2,1–2.5,1–6,2-foliate,2.5–4,20–,2–4,2–4-celled,2–9,3.2–3.7,45,4–10,4–5-rayed,4–6-celled,5–12,5–20,6,65–145,6–11,6–7,8-13,=,abundant,acuminate,acute,adaxiall,always,apar,apex,apiculate,apparent,appearance,ascending,attenuate,becoming,blade,bleaching,branch,bright,calyx,ciliate,closely,conduplicate,confined,covering,cylindrical,deeply,dense,developing,dilated,directed,distall,divided,division,dried,eaf,eed,entire,erect,especially,exceeding,except,exclusive,exserted,first,flowering,folded,forward,free,geminat,geminate,giving,gland,glistening,golden,grading,greenish,hair,halfway,hyaline,inserted,inside,lanceolate,larger,lateral,least,less,life,light,lighter,lobe,lobed,lon,lower,major,margin,midrib,minute,minutely,mostly,much,n,nearly,nflorescence,oblique,often,one,orolla,otherwise,outside,ovate-apiculate,pair,papillat,par,per,plane,pointing,pore,pressing,probably,purple-colored,ranging,rarely,reflexed,reported,rip,ripe,ruit,scarious,scattered,sessile,shallowly,shrub,sideway,similar,single,sinuate,sinus,size,small,smaller,somewhat,spaced,spreading,stamen,stellae,stipitate,straw,strongly,sunlight,tal,tamen,tem,thickened,triangular,tube,turning,twice,twisted,two,unarmed,unicellular,unit,upper,usually,various,variously,vary,vein,viewed,white,whole,wing,yellow,yellow-green,ympodial,±,–8	0.2-1,0.2-2,0.4-1,0.5-1.7,0.5-2,0.5-4,1.5,10-20,2-9,5-12,6-7,abaxial,adaxial,apart,arrangement,colour,height,inflorescence,na,ovary,position,seed,spacing,staman,texture,width
91	wfo-0001026397	success	202	125	101	101	24	0.5	0.5-1,1-2,1-3,1-9,10-14,10-20,13-18,2-5,2.5,3-4,3-9,4-16,4-8,5-15,5-8,absent,acute,adaxial,anther,apex,asymmetrical,base,berry,brown,chartaceous,cm,coriaceous,cylindrical,dark,densely,diameter,either,entire,extra-axillary,filament,flower,fruit,functionally,glabrous,globose,greem,green,hair,hermaphroditic,immature,leaf,leathery,like,line,lobed,major,male,many,margin,mature,midvein,mm,moderately,nearly,netlike,obscure,occasional,often,orange,ovate,pedicel,peduncle,petiole,pit,plant,porrect-stellate,prickle,pubescent,purple,rachi,raised,recurved,red,reniform,ridge,roselike,rusty,secondary,separated,side,simple,small,stellate,stem,stigma,style,surface,tan,unbranched,vein,vine,white,whitish,woody,x,yellow	0.5-1.5,1,1-.,1-2.5,1-6,1.5,1.5-3,1.5-3.5,12-15,12-16,2-10,2-2.5,3-3.5,3-5,5,5-merou,50-100,6-10,8-20,abaxially,absen,accrescent,adaxially,alyx,andromonoecious,anthesi,apar,apical,armed,attenuate,axe,beyond,blade,bud,calyx,connivent,cordate,difoliate,directed,discolorous,eaf,eed,em,expanding,exserted,filiform,flattened,frui,fruiting,geminate,glabrou,glandular,greatly,gree,heteromorphic,introrsel,lobe,long,long-styled,lower,midpoint,midrib,multicellular,multiseriate,narrowly,nflorescence,obtuse,older,orolla,pair,per,pore,present,ray,reflexed,ruit,short-and,siz,slightly,spaced,sparsely,spreading,stalk,stamen,ste,straight,tamen,tapering,thick,triangular,tube,unarmed,unequal,unicellular,unit,usually,vary,weakly,wide,ympodial,young	1-4,abaxial,apart,armature,arrangement,color,colour,corolla,form,growth,height,inflorescence,length,na,ovary,position,pubescence,seed,shape,size,spacing,staman,texture,venation
92	wfo-0001026400	success	187	102	78	109	24	0.417	0.2-0.8,0.4-1,0.5-1.2,1-10,1-2,10-28,3.4-4.8,30-55,4-7,5-7,6.5-20,9-13,acuminate,acute,anther,apex,asymmetric,attenuate,base,basiscopic,blue,brownish,clavate,cm,condition,corolla,dark,deep,diameter,drying,elliptic,filament,flower,forked,fresh,fruit,glabrescent,glabrous,globose,green,greenish,herb,homostylous,interjected,leaf,leaflet,light,lilac,mm,mucilaginous,odd-pinnate,orbicular,ovate,ovoid,pair,pedicel,peduncle,pentagonal,petiole,plant,purple,rounded,seed,semi-stellate,sessile,side,size,stigma,stripe,style,terminal,tip,tissue,typically,wet,white,whitish,yellow	0.5-1,0.7-1.1,1.3-2.6,1.7-2.2,10-18,12-27,13-30,2-6,2-8,2.4-5.9,3-6,3.5-5.9,5-merou,6-13,6-15,8-12,abaxially,acumen,adaxiall,adaxially,ag,alyx,apart,apparently,articulated,axe,axillary,berry,blade,bud,capitat,cell,connivent,coriaceous,covering,decreasing,decurrent,digestion,distal,dorsally,eaf,edge,eed,enzyme,erec,exceeding,finely,flat,folded,geminat,generally,glabrou,gree,green-white,hair,hair-like,hal,half,high,honeycomb-shaped,lanceolate,lateral,lengthening,linear,living,lobe,long,lower,make,moderately,nflorescence,orolla,perfect,petiolulate,plurifoliate,pore,poricidal,puberulent,pubescent,removed,ripe,ruit,seudostipule,short,simple,slightly,slit,spaced,specimen,stamen,straight,subequal,subtending,tall,tamen,tem,testal,thick,throughout,toward,tri-,tube,unit,unwinged,usually,vary,wall,x,ympodial	abaxial,adaxial,arrangement,asymmetry,capitate,color,colour,form,growth,height,history,inflorescence,length,life,ovary,perennial,position,pseudostipule,shape,spacing,staman,stem,surface,texture
93	wfo-0001026406	success	219	93	77	142	16	0.352	0.3-0.5,0.3-0.7,0.4-0.8,0.4-0.9,0.5-1.5,0.5-2.5,1-2,1.8-2.4,2-2.7,2-3,2.5-8,2.9-3.2,3-10.5,3.2-3.8,5-25,5-merous,6-12,6.5-7,9-15,abaxial,acute,anther,apart,apex,apparently,berry,branched,cm,cream,dark,densely,diameter,filament,flattened-reniform,flower,fruit,glabrous,green,lateral,leaf,length,lobed,long,long-styled,margin,marking,mature,mauve,midpoint,midvein,mm,orange-brown,pale,pedicel,peduncle,petiole,plant,porrect,purple,ray,red-brown,short-styled,spherical,stalk,stellate,stellate-pubescent,stem,style,surface,terete,terminal,trichome,velvety,white,wide,yellow,young	-1,.2,.5,0,0-3,0-30,0-5,0.3,0.5,0.8,00-200,1,1.3-1.5,1.5-2,1.5-5,1/,1/3,1/4,1/4-1/2,1/4-1/3,10-30,12-19,2-6,20-60,3-4,30-60,5,5-50,5-6,5-7,5-8,6-15,7-10,7-8,7-9,abaxially,adaxial,adaxially,alyx,ame,andromonoecious,apar,apically,articulated,bark,base,blade,broad-deltate,c.,calyx,chartaceous,conical,connivent,cordate,curved,deltate,dirty-whitish,discolorous,distal,distance,drying,eaf,eed,elongated,elongating,equal,erect,extending,flattened,foliaceous,free,fruiting,fully,gently,herb,hermaphrodite,heterostylous,infructescence,least,lobe,lon,longer,lower,lowermost,maturity,moderately,nflorescence,oblong,obtuse,older,one,open,opening,orolla,oung,ovate,pair,pendent,pendulous,per,pericarp,plurifoliat,poricidal,portion,prickl,prickle,prickly,primary,reflexed,rounded,ruit,scar,sessile,shrub,side,smooth,sometimes,spaced,sparsely,spreading,stalked,staminat,stout,straight,tamen,tapering,tertiary,time,tip,tube,unit,upper,variously,vary,vein,venation,visible,way,weakly,woody,yellow-brow,ympodial	0.3-0.8,1.5,3.5,7.2,branching,color,corolla,height,inflorescence,ovary,seed,shape,size,spacing,staman,texture
94	wfo-0001026407	success	221	150	124	97	26	0.561	.5,/3,0.5-0.6,0.5-2,1,1-1.2,1-10,1.2-1.5,1.3,1.5-1.7,1.5-2,2-2.5,2.5-3,20-30,3.5,4-5,5,7-8,abaxially,acute,adaxially,aid,anther,anthesi,apart,apex,basal,base,becoming,berry,black,brown,calyx,capitate,chartaceous,cm,conical,connivent,corolla,deep,deltate,dendritic,densely,diameter,elliptic,entire,erect,evenly,filament,flattened-reniform,fleshy,flower,free,fruiting,glabrous,globose,golden,growth,inflorescence,internodal,interpetalar,irregularly,lamina,lateral,lax,lengthening,lobe,lobed,loosely,margin,markedly,membranous,minutely,mixture,mm,narrowly,oblique,obscured,occasionally,papillate,pedicel,peduncle,per,petiole,pitted,planar,pore,portion,pubescence,pubescent,purple,purplish,reddish,revolute,ripe,scar,shiny,short,shrub,simple,sinus,slightly,slit,spaced,sparsely,spreading,stellate,stem,stigma,style,surface,terminal,tip,trichome,truncate,tube,twining,vein,vine,violet,way,woody,x,yellow	+,-11,-6,0.5,0.5-1,0.9-3,1.5-7,20-40,3.5-5.5,5-10,5-7,5-merou,7-10,ag,along,always,alyx,appearing,area,ark,around,articulated,axi,beneath,berr,blunt,branch,branched,broadly,brownish,cell,clear,climbin,congested,dense,denser,discolorous,eaf,eed,ellipsoid,exserted,geminat,glabrescen,glabrou,golden-pubescent,ilament,leafy,leaving,like,long,lower,many,midvein,near,new,nflorescence,numerous,often,older,open,orolla,outline,pair,pale,paler,papillat,pedice,peg,pentagonal,perfect,pericarp,persistent,plurifoliate,poricidal,primary,pubescenc,ruit,sleeve,small,sparser,stiff,stout,strongly,tangled,tem,testal,thin,time,transition,ud,undulate,unit,upper,usually,vary,weak,ympodial	5-merous,abaxial,adaxial,age,arrangement,climbing,color,colour,connivence,form,fruit,glabrousnes,height,leaf,length,na,ovary,plant,position,rachi,seed,shape,size,spacing,staman,texture
95	wfo-0001026422	success	273	104	73	200	31	0.267	.0,3.5,7.6,abaxially,acuminate,acute,adaxially,aequilateral,alveolate,anther,apex,apiculate,base,blade,brochidodromous,calyx,capitate,chartaceous,cm,corolla,cuneate,densely,diameter,distinct,dry,elliptic,evenly,extra-axillary,filament,flattened-irregular,flattened-reniform,flower,fruit,glabrous,globose,gray-brown,internode,lanceolate,lateral,length,lobe,midvein,mm,moderately,nearly,oblique,occasionally,ovate,pedicel,peduncle,petiole,pubescent,raised,red-brown,rounded,shrub,simple,sparsely,stellate,stellate-pubescent,stem,stigma,style,surface,tip,truncate,typically,vein,weakly,white,yellow,yellow-tan,yellowish-green	.04,.3,.6,.7,.9,/3,0.04,0.06,0.08,0.1–0.5,0.2,0.2–0.4,0.3–0.5,0.3–0.7,0.4–1.3,0.4–2.4,0.6–0.9,0.6–1.1,0.6–2.0,0.7–0.8,0.7–1.6,0.8,0.9–1.5,0.9–1.9,0.9–7.5,1.0,1.0–1.9,1.1–1.4,1.2–2.8,1.3–2.2,1.6–1.9,1.6–2.2,1.7–2.4,1.8–2.2,1.8–2.3,1/2–2/3,1/3,1/3–2/3,10,13.2–27.8,1–3,2.0–3.2,2.2–14.0,2.8–4.2,3.5–4.5,3.8–4.8,4.7,4–8,5-merou,5.0,5.8–7.4,5.8–8.3,56,5–7,6.8,6–8,7.7–9.2,7.8–26.9,8.4,absent,adnate,ag,alyx,anthesi,apart,apical,apparently,appearing,appresse,around,articulate,attenuate,axe,ba,bark,basal,becoming,bent,berry,borne,branch,branching,broad,bud,channeled,cream,darker,deciduous,deltoid,dentate,development,difoliate,directed,distal,distally,eaf,edge,eed,either,emerging,endocarp,entire,erect,especially,exocarp,extending,fertile,filiform,free,geminat,glandular,glossy,gradually,gree,green,hair,homostylous,immature,increasing,individually,intact,interpetalar,intersepalar,juic,layer,light,lon,long,longer,lower,many,many-flowered,margin,mature,midpoint,midrib,minute,much,nflorescence,oblong,observed,orolla,ove,per,perforated,pore,porrect,porrect-stellae,portion,potentially,presumably,pubescence,ray,reflexed,remaining,rigid,row,ruit,scarcely,sessile,short-stipitate,side,sinuate,sinus,sloughing,smoot,soon,splitting,spreading,stamen,stellae,stipe,straight,stripe,suture,tamen,tardily,tem,thin,time,tissue,translucent,transparent,tube,two,ud,unarmed,unbranched,upper,various,vary,well-developed,wide,yellow-ferruginous,ympodia,young,±congested,±erect,×,–5	0.3-0.7,0.4-1.3,0.4-2.4,0.6-2.0,0.7-0.8,1.3-2.2,2.8-4.2,3.5-4.5,5.8-7.4,7.8-26.9,abaxial,adaxial,arrangement,color,feature,form,growth,height,history,inflorescence,leaf,life,na,ovary,perennial,plant,position,seed,shape,staman,texture
96	wfo-0001026424	success	138	68	30	108	38	0.217	1-1.5,1.5-2,15,3-4,acuminate,acute,apex,axil,blush-violet,broadly,calyx,cm,corolla,cyme,elliptic,flower,fork,glabrous,leaf,obovate,pedicel,peduncle,petiole,pinnatisect,rachi,rotate-stellate,scorpioid,shrub,simple,stem	-25,-3.5,-4,0.75-1.5,1,1-,1-10,1-2,10,10-15,12-60,15-30,2,3-11,637/1,8-,acuman,acumen,age,angular,anthesi,aspect,ba,base,becoming,blunt,bluntly,broad,campanulate,cell,clonal,close,common,conspicuous,cuneate,cut,dia,distinct,downard,eaf,ellipsoid,erect,exceeding,except,exerted,facetted,facing,floral,forked,general,glandular,gree,growing,hair,interacuminal,lacking,lanceolate,lanceolate-elliptic,larger,lasting,lavender,line,lobe,lobed,lon,long,lower,midvein,minute,mm,nflorescence,oblique,often,part,pedicellate,plurifoliat,point,raised,rarely,rh,rounded,second,several,shallowly,short,sinus,slightly,soft-wooded,soon,stone,straggly,time,tip,tissue,toward,triangular,tub,ud,unit,unwinged,usually,violet,within,woody,x,year,ympodial,young	1-4,abaxial,adaxial,anther,arrangement,bark,branching,color,colour,diameter,filament,form,fruit,fruiting,green,growth,height,history,inflorescence,length,life,margin,na,ovary,perennial,plant,position,prickle,seed,shape,spacing,staman,stigma,style,surface,texture,trichome,width
97	wfo-0001026440	success	181	110	81	100	29	0.448	1-5,1.1-1.5,1.5-2.1,1/2,14-30,2.9-4.4,3-7,3-8,9,abaxially,acute,adaxially,anther,apex,appressed,articulated,bark,base,blunt-tipped,branched,broadly,brown,chartaceous,closely,cm,conical,corolla,diameter,directed,distal,distally,elliptic,filament,flower,globose,granular,green,greenish-yellow,hair,leaf,length,many,minutely,mm,multangulate-pubescent,oblong,obovate,obovoid-oblong,obtuse,often,ovate,pale,pedicel,peduncle,persistently,petiole,pitted,pore,porrect-stellate,reniform,scabrous,short-acuminate,shrub,simple,small,somewhat,spaced,sparse,stellate,stellate-pubescent,stem,stigma,style,time,tomentose,tomentose-pubescent,tree,truncate,turning,white,yellow	0-15,1.1-1.4,1.3-1.7,1.8-4.5,1.9-3.7,1/2-2/3,2-2.8,2-4,3-5,3.9-6.5,3/4,4-12,5-7,7-14,accrescent,adaxiall,ag,along,always,anthesi,apparently,axillary,ba,basal,berry,blade,bract-like,branch,branche,calyx,capitat,dendritic-echinoid,dense,developed,dichotomy,eaf,echinoi,echinoid,eed,entire,first,fleshy,free,fruiting,high,included,inserted,large,lengthening,lobe,lobed,long,long-attenuate,lower,m.,margin,minute,mostly,multangulat,multangulate,nearly,nflorescence,obscure,older,openly,orolla,pair,perfect,plurifoliate,poricidal,pubescen,rather,ripe,ruit,runk,semi-ovate,sessile,short-stalked,size,slit,sometimes,suture,tamen,terete,testa,thick,thin,tip,tomentum,translucent,tube,ud,uneven,unit,usually,vary,way,x,ympodial,young	abaxial,adaxial,arrangement,articulation,bud,capitate,color,colour,direction,form,fruit,growth,height,history,inflorescence,life,na,ovary,perennial,plant,position,pubescent,seed,shape,spacing,staman,surface,texture,width
98	wfo-0001026441	success	197	133	105	92	28	0.533	0.3-0.7,1-10,1-2,10,15-20,2-2.5,2-8,3-5,4.5-6.5,5,6-15,7-8,abaxially,acuminate,adaxially,anther,apart,apex,axillary,base,berry,brownish,bud,cell,chartaceous,ciliate,cm,condition,conical,corolla,covering,decreasing,diameter,drying,elliptic-lanceolate,end,filament,flower,forked,fresh,fruit,glabrous,gradually,green,green-white,greenish,hair,hair-like,herb,interjected,lateral,leaf,leaflet,light,like,long,make,margin,minute,minutely,mm,mottled,mucilaginous,odd-pinnate,one,orbicular,ovate,ovoid,pair,pale,pedicel,peduncle,petiole,placed,plant,plurifoliate,puberulent,pubescent,purple,ripe,rotate,seed,size,slightly,sparsely,stem,stigma,style,subequal,subtending,symmetrical,terminal,testal,thick,throughout,toward,tri-,tuber,typically,unit,violet,wall,wet,whitish,yellow	.5,0-2,0.4-3,0.5-1.5,0.8,1-1.5,1.5-2,1.5-2.5,10-14,2-5.5,4-6,4-8,4-8.5,5-10.5,5-merou,7-20,9-14,absent,acumen,ag,alyx,apparently,articulated,attenuate,axe,blade,capitat,connivent,digestion,distal,dorsally,eaf,edge,eed,enzyme,equal,erec,especially,exceeding,flat,folded,fourt,geminat,generally,glabrou,half,homostylous,honeycomb-shaped,internal,lanceolate,larger,lengthening,living,lobe,lower,middle,narrow,nflorescence,obtuse,orolla,perfect,petiolule,pore,poricidal,removed,rounded,ruit,secondary,semierect,seudostipule,short,slit,spaced,specimen,stamen,star,ste,stolo,straight,subsessile,tall,tamen,tem,tip,tube,usually,vary,white,wide,wing,x,ympodial	abaxial,adaxial,arrangement,capitate,color,colour,form,growth,height,history,inflorescence,length,life,na,ovary,perennial,placement,position,pseudostipule,shape,spacing,staman,stolon,surface,sympodial,texture,type,width
99	wfo-0001026453	success	211	97	76	135	21	0.36	.5,0.1-2.7,0.5,0.8-1.1,1-1.5,1-2,1.5-2,2-2.5,4m,5.5-8,7-9,<,acuminate,acute,adaxial,almost,anther,apart,apex,base,bright,brown,capitate,cm,corolla,densely,diameter,elliptic,filament,flattened,flower,glabrous,globose,growth,inflorescence,lateral,leaf,length,linear,lobed,minutely,mm,narrowly,nearly,opposite,pale,pedicel,peduncle,petiole,pitted,porrect,pubescent,red,reniform,scattered,sessile,shiny,shrub,simple,small,sometimes,sparsely,stellate,stem,stigma,style,surface,tan,thin,tree,trichome,violet,weak,white,x,yellowish	0.45-5.5,0.5-0.7,0.5-1,1,1-1.2,1.9-21.3,10-20,15,2,30,5-32,6-10,6-8,6376,abaxially,aberrant,absent,adaxially,along,anthesi,armed,articulated,attenuate,axi,bark,basal,based,beneath,bent,berry,branched,broad,calyx,cell,conical,deflexed,deltate-triangular,dense,denser,directed,distall,distally,eaf,easily,eed,enlarged,enmeshing,entire,equal,evenly,exceeding,exserted,filiform,free,fruiting,glabrescent,grayish,hanging,howard,internode,irregularly,lamina,lengthening,less,like,lobe,long,lower,margin,maturity,midpoint,midrib,midvein,new,nflorescence,oblique,occasionally,often,older,one,open,orange,outline,pair,papillo,parallel,per,perfect,pericarp,plurifoliat,pore,poricidal,portion,prickle,primary,pubescence,ray,reddish,rest,rounded,ruit,scar,shallowly,shorter,side,sinuate,slightly,slit,smaller,somewhat,sorter,spaced,sparse,sparser,spreading,straight,strongly,surfac,tangled,tapering,testal,time,tip,triangular,trunk,tube,ud,unarmed,unit,upper,usually,vein,visible,within,ympodial	abaxial,arrangement,color,colour,form,fruit,height,history,life,na,ovary,perennial,plant,position,rachi,seed,shape,spacing,staman,texture,width
100	wfo-0001026460	success	131	79	54	77	25	0.412	.5,0.5-1.5,1-1.5,1.5-2,1/2,6-7,7-9,acute-acuminate,anther,apex,base,brown,capitate,closely,cm,completely,corolla,dark,distal,elliptic,filament,flower,glabrous,globose,green,greenish,inflorescence,leaf,less,lobed,membraneous,minutely,mm,nearly,opposite,ovary,ovoid-reniform,pale,papillose,pedicel,pitted,puberulent,shaped,shrub,simple,spaced,stem,stigma,style,subshrub,surface,tear-drop,white,yellow	.1,10-15,13.5-21,2-2.5,2.5-3,4.5-5,5,513,6-9,8-10,abaxially,acut,adaxially,anthesi,axi,becoming,berry,branched,calyx,conical,deflexed,deltate,dia,do,drying,eaf,edicel,eed,erect,fide,filiform,floccose,free,frui,fruiting,inflorescenc,internodal,like,lobe,long,long-exserted,lower,major,middle,nflorescence,often,older,pair,papillo,pore,poricidal,portion,reddish,reddish-brow,reflexed,ruit,santo,scar,slightly,somewhat,soon,tall,tapering,tiny,tip,trichome,tub,tube,ud,unifoliat,unit,vein,widest,woody,x,ympodial,young	abaxial,adaxial,arrangement,color,colour,diameter,form,fruit,growth,height,history,length,life,na,petiole,plant,position,rachi,seed,shape,spacing,staman,texture,unifoliate,width
101	wfo-0001026485	success	188	110	89	99	21	0.473	-22,-35,.25,0.25-1,1-10,1-2,1-2.5,1-4,1.5,1.5-5,10-20,2,2-3,20-30,3-25,3-6,3.5-7,6-9,7-15,abaxially,acute,adaxially,anther,apart,apex,armed,attenuate,base,bright,brown,chartaceous,cm,compound,diameter,elliptic,entire,filament,flattened,flower,forked,foveolate,fruit,glabrous,globose,greenish-white,inflorescence,internode,lateral,leaf,leaflet,light,major,margin,mm,oblique,obovoid,opposite,orange,ovate,pair,pedicel,peduncle,perennial,petiole,plant,prickle,puberulent,pyriform,rachi,rarely,recurved,rugose,side,simple,sparsely,stellate,stigma,straight,strongly,style,subcoriaceous,surface,tapering,thickened,truncate,unbranched,vein,x,yellow	-1.5,10-25,2-4,2-6,2.3-5,2.5-5,20-40,20-50,3-4,3-7,4-9,4.5-9,45,5-20,5-7,5-merou,6-10,abaxiall,absen,accrescen,aggregate,alyx,andromonoecious,appearing,articulated,axe,blade,broadly,calyx,congested,connivent,cylindrical,developing,difoliate,directed,distall,dr.,eaf,eed,elongating,even,fertile,fruiting,geminat,glabrou,heterostylous,hollow,imparipinnate,lanceolate,leaving,like,lobe,long,long-attenuate,lower,lowermost,midvein,narrowly,nearly,nflorescence,occasionally,one,orolla,per,pore,pubescent,recurve,reflexed,ripe,robust,ruit,scandent,scar,slightly,small,sometimes,spaced,speciman,spreading,subopposite,swollen,tamen,tem,time,tip,tissue,tone-cell,toward,triangular,trichome,truncat,tube,unit,usually,vary,vin,wide,winged,ympodial	arrangement,color,corolla,dry,form,growth,height,history,length,life,na,ovary,position,seed,shape,spacing,staman,stem,texture,vine,width
102	wfo-0001026489	success	153	98	67	86	31	0.438	0.05-0.1,0.25-0.5,0.5-2,0.8-1.2,0.8-1.3,1-1.5,1.5-5,2-5,2.5-4,5-6,acute,anther,apex,area,bark,beneath,brown,closely,cm,corolla,dark,deflexed,densely,elliptic,filament,flattened,flattened-reniform,fleshy,fruiting,glabrous,globose,green,incrassate,leaf,lobed,margin,minutely,mm,opposite,ovary,paler,papillose,pedicel,perpendicular,petiole,pitted,planar,pore,pubescent,scar,shaped,shiny,shrub,simple,somewhat,spaced,stem,stigma,straight,style,surface,tear-drop,tip,tube,white,whitish,widened	.3,0.5,0.5-0.75,0.5-1,0.6-1.4,0.8-3.7,1.3-3,2-3,2-4,2-8-flowered,2.5-13,2/3,8-13,along,anthesi,appearing,axil,ba,base,berry,branched,broadly,calyx,cup-shaped,deltoid,dia,differing,difoliate,dry,eaf,edicel,eed,erect,exserted,extending,free,geminat,gra,lamina,later,lateral,lobe,lon,long,lower,main,major,middle,minor,nflorescence,occasionally,often,older,one,overlappin,pair,papillo,parallel,poricidal,portion,prominent,red-papillose,rhachi,ruit,size,slender,soon,specimen,strongly,tall,tapering,terminal,thickened,trichome,tub,ud,uniseriate,unit,usually,vein,way,widest,woody,x,ympodial,young	abaxial,adaxial,arrangement,bud,color,colour,diameter,flower,form,fruit,gray,growth,height,history,inflorescence,length,life,na,overlapping,peduncle,perennial,plant,position,rachi,seed,shape,spacing,staman,straightnes,texture,width
103	wfo-0001026490	success	272	132	98	174	34	0.36	1.5,2,3,6,7-pinnate,abaxially,acute,adaxially,along,anther,apart,apex,axillary,base,branched,brown,chartaceous,cm,contiguously,corolla,darker,densely,diameter,ellipsoidal,elliptic,extra-axillary,filament,flattened,flower,fruit,glabrous,green,immature,inflorescence,lacking,leaf,length,lenticular,light,lobe,long,lunate,main,margin,mature,medium,midvein,mm,moderately,mottled,near,nearly,oblique,obliquely,obtuse,obtusely,orange,ovate,pedicel,peduncle,pentagonal,petiole,pointed,pseudostipule,pubescent,punctate,rachi,radial,rounded,sand,seed,shape,shoot,short,simple,slender,slightly,smooth,sometimes,sparsely,spur,stem,stigma,striation,striping,style,surface,teardrop-shaped,terminal,tip,transparent,truncate,vine,violet,white,wing,yellow,yellowish-tan	.5,0.1–0.2,0.1–2.5,0.2–1,0.2–1.5,0.3–3.5,0.4–0.8,0.5–1,0.5–1.5,0.5–3.5,0.5–8,0.7–3,0.8–1.5,0.8–12,1.2–8,1.5–2,1.5–3.5,1.5–5,1.8–2.2,1.9,10–20,1–1.2,1–15,1–2.5,1–3,1–8,2.5–3.5,2–2.5,2–4,2–6,2–8,3–4.2,3–4.5,3–5,3–5-pinnate,3–8,4.6,4–4.5,4–5,5-merous,5–7,7,7–15,=,[,],absent,accrescent,acuminate,ag,alyx,anthesi,apical,apicall,apparently,around,articulated,axe,ba,becoming,blade,bract,bracteate,broadly,calyx,capitat,cauline,ciliate,climbing,commonly,completely,connivent,cordate,covered,crisped,cylindrical,decreasing,directed,distal,distally,eaf,eed,eglandular,entire,equal,exceeding,expanded,flat,free,fruiting,fused,geminat,ground,incurved,interjected,irregularly,large,lateral,latrorse-introrse,leaflet,lobed,longitudinal,lower,lowermost,markedly,match,mean,mean=,middle,minute,multicellular,nflorescence,node,obliqu,oblon,oblong,occasionally,one,opening,orolla,ovate-lanceolate,pair,papillose,part,per,perfec,perfect,petiolule,plurifoliate,pore,present,pubescen,pubescence,pur,reflexed,reniform,resulting,revolute,rooting,ruit,seudostipule,shorter,similar,size,slit,smaller,somewhat,spaced,stamen,strongly,tamen,tawny,tem,thickened,toward,trailing,trichome,trichomessympodial,tube,typically,unbranched,undulate,unit,vary,vegetation,wide,woody,youn,½,×,–4,–4.5,–8,–9.5	0.1-0.2,0.1-2.5,0.4-0.8,0.5-1,0.5-1.5,0.8-1.5,1-1.2,10-20,3-4.5,4.5,5-7,7-15,abaxial,adaxial,arrangement,capitate,color,colour,form,growth,height,history,life,na,ovary,perennial,plant,position,spacing,staman,texture,width,x,young
104	wfo-0001026491	success	165	97	65	100	32	0.394	.5,1,1.5-2.5,2.5-3.5,3,3-pinnate,5-6,5-8,abaxially,acuminate,acute,adaxially,anther,apex,base,branched,broadly,central,cm,crinkly,deep,diameter,elliptic-lanceolate,filament,flower,glistening,globose,green,hair,highly,inflorescence,lanceolate,leaf,less,light,mm,often,ovate-elliptic,ovoid,pale,pedicel,peduncle,petiole,present,pubescent,purple,rachi,rotate-pentagonal,rotate-substellate,rounded,row,sharp,shortly,shrub,simple,slender,spotted,stigma,straight,strigose,strong,suborbicular-ovate,surface,white,yellow	1-2,1.5-2,1.5-3.5,1.7,10-50,1977,2-3,2-4,2-celled,5-merou,6-8,7-8,abaxiall,absent,alyx,anderson,apparently,appressed,articulated,averaging,axe,ba,bayonet,bent,berry,blade,bract,branching,capitat,cellular-papillose,cellular-pilose,connivent,conspicuously,cuneate,deciduous,deltoid,densely,directed,distall,eaf,eed,entire,equal,first,geminat,greatly,growing,homostylous,interjected,lateral,leaflet,lobe,long,lower,lunulat,margin,mean,middle,minutely,near,nflorescence,oblong-elliptic,obtuse,orolla,ovate,perfect,pilose,plurifoliate,point,pore,poricidal,porrect-incurved,rarely,readily,reduced,ruit,scandent,seudostipule,similar,small,strigo,strongly,subacute,tal,tamen,tawny,tem,terminal,tightly,tip,tube,tyle,uniseriate,unit,upright,usually,ventral,whitish,x,ympodial	abaxial,adaxial,arrangement,capitate,color,colour,corolla,distally,feature,form,fruit,growth,height,history,length,life,lunulate,na,ovary,perennial,plant,position,presence,pseudostipule,seed,shape,spacing,staman,stem,style,texture,width
105	wfo-0001026501	success	195	89	74	121	15	0.379	.5,.6,/3,0.1,0.2-1.8,0.27-0.7,0.5,0.5-0.6,0.5-1,0.9-2.2,1-2,1-2.5,1/4,3-9,3.5-4,abaxially,acicular,anther,bark,base,berry,brown,brown-green,cm,color,densely,diameter,dull,elliptic,filament,flattened-reniform,flower,fruit,gray,leaf,length,lobed,mauve,midpoint,mm,moderately,orange-brown,orbicular,ovate,pale,pericarp,petiole,porrect,prickle,prickly,ray,reddish,shoot,short,simple,smooth,sparsely,spherical,spreading,stalk,stellate-pubescent,stem,straight,style,surface,tapering,terete,terminal,trichome,upper,way,white,yellow,yellow-green	-1.7,-3,.1,.35,.7,0,0-1,0-2,0.05-0.3,0.5-0.9,0.6-1,0.6-1.1,0.6-2,1,1.8-2.2,1/2-2/3,1/6-1/2,2-10,2.5-4,2.8-3,3-4,3-5,4-5,4-7,5-merous,6-9,7-9,?,acute,almost,alyx,apar,apart,apex,apically,apparently,articulated,becoming,blade,borne,branched,calyx,chartaceous,concolorous,cuneate,curved,deltate,discolorous,drying,eaf,eed,elongated,elongating,entire,equal,erect,eye,filiform,filiform-acuminat,flattened,free,fruiting,glabrou,glabrous,green,infructescence,known,light,lobe,long,longer,lower,margin,mature,naked,nflorescence,often,older,one,open,orolla,oung,pair,pedicel,peduncle,pendulous,per,perfec,plurifoliat,poricidal,portion,prickl,primary,rounded,ruit,scandent,scar,sessile,shorter,shrub,slender,small,sometimes,somewhat,spaced,stalked,stellate,subsessile,tamen,time,tip,tube,unarme,unarmed,unit,variously,vary,vein,visible,wide,ympodial	abaxial,adaxial,arrangement,corolla,height,inflorescence,na,number,ovary,plant,seed,shape,staman,texture,width
106	wfo-0001026503	success	269	95	70	199	25	0.26	3,acuminate,acute,adnate,anther,apex,apiculate,attachment,bark,brown,bud,calyx,capitate,central,chartaceous,cm,corolla,depression,diameter,dry,extra-axillary,flattened,flattened-orbicular,fruit,glabrous,globose,green,hair,internode,lacking,lanceolate,lateral,leaf,lobe,long,margin,mature,mm,nearly,notched,oblong,outline,oval,ovate,pale,pedicel,peduncle,petiole,portion,red,red-brown,reddish,rotate-stellate,shallow,shrub,simple,small,stellate,stem,stigma,style,subacute,surface,tip,tree,truncate,yellow,yellow-tan,yellowish,±smooth	.3,.5,.6,.9,0.03,0.3–,0.3–0.6,0.4–1.2,0.6–0.7,0.6–1.0,0.7,0.7–3.7,0.8–1.1,0.8–1.7,0.8–3.5,1.0–1.5,1.0–1.6,1.0–3.5,1.1–1.4,1.3,1.3–1.6,1.3–3.7,1.4–1.7,1.4–2.3,1.5–1.8,1.5–2.0,1.5–2.5,1.7,1.9–5.5,1/3,1/3–1/2,1/4–1/3,2.2–2.5,2.2–2.8,2.2–6.3,2.3–2.6,2.6–2.9,22,2–3,3.0–4.5,4.0–12.0,4.7,4.8,4.9–5.8,5,5-merou,5.0,6.0,6.9–10.3,7–10,8.2,9.0–1.0,90°,abaxially,adaxially,aequilateral,ag,always,alyx,anthesi,apart,apical,apparently,appearing,arching,around,articulate,attenuate,axe,ba,base,becoming,bent,berry,blade,branch,branching,brochidodromous,channeled,deltoid,dentate,developed,development,difoliate,directed,distal,distally,eaf,edge,eed,eglandular,either,emerging,endocarp,entire,exocarp,extending,fertile,filament,filiform,flattened-reniform,flexed,flower,free,geminat,glabrou,glandular,glossy,gradually,gree,homostylous,increasing,intact,interpetalar,intersepalar,irregularly,juic,lackin,layer,lon,lower,lying,major,many,midrib,midvein,minor,minute,moderate,moderately,near,nflorescence,oblique,obviously,ocasionally,occasionally,opaque,orolla,per,perforated,point,pore,potentially,present,pubescence,pubescent,raised,reflexe,remaining,rigid,rounded,row,ruit,scarcely,scattered,short,shortly,side,sinuate,sinus,slightly,sloughing,smoot,spaced,sparse,sparsely,splitting,spread,spreading,stamen,stipitate,straight,suture,tamen,tem,thin,though,time,tissue,transparent,tube,two,ud,unarmed,upper,usually,vary,vein,weakly,well,white,wide,without,yellow-ferruginous,ympodia,young,±equal,±straight,×	0.3-0.7,0.7-3.7,0.8-1.7,1.0-1.6,1.0-3.5,1.1-1.4,3.0-4.5,abaxial,adaxial,arrangement,color,colour,form,growth,height,inflorescence,length,na,ovary,plant,position,seed,shape,staman,texture
107	wfo-0001026513	success	138	75	46	92	29	0.333	0.8-2,1-1.5,1-3,4-5,6-8,acute,anther,apex,area,closely,cm,corolla,elliptic,filament,flower,fruit,glabrous,globose,green,lanceolate,leaf,lobed,long-styled,minute,mm,opposite,ovary,pale,papillose,pedicel,petiole,plant,shaped,short-styled,shrub,simple,slender,small,spaced,stem,stigma,style,surface,tear-drop,treelet,white	.1,.25,.3,.75,/3,2-2.2,2-5,3-5,3-6-flowered,7-9,8-16,anthesi,apiculate,ba,bark,base,berry,broadly,caly,calyx,completely,darkish,decurrent,deflexed,delicate,deltoid,dia,differentiated,dry,eaf,edicel,eed,erect,except,exserted,free,fruiting,gre,hirsute,immature,known,lateral,leave,less,live,lobe,long,longer,lower,main,mature,middle,minutely,much,nflorescence,obscure,older,overlappin,pair,pore,poricidal,portion,prominent,raised,reflexed,rest,ruit,scar,shiny,somewhat,soon,specimen,straight,styl,tall,tip,trichome,tube,ud,undersurface,unifoliat,uniseriate,unit,vein,venation,way,wide,widest,woody,x,ympodial,young	0.25,0.75,1,3,abaxial,adaxial,arrangement,color,colour,diameter,form,growth,height,history,inflorescence,length,life,na,overlapping,peduncle,position,rachi,seed,shape,spacing,staman,texture,unifoliate,width
108	wfo-0001026529	success	219	134	107	112	27	0.489	0-25,0.3-1,0.5-4.5,1-10,1-2,1.1-2.5,10,11-14,12-22,3-5,3-6,3-9.5,5-17,5-9,abaxially,acuminate,acute,adaxially,anther,apex,attenuate,base,blue,broadly,brownish,cell,chartaceous,clavate,cm,condition,cordate,corolla,covering,creamy,dark,deep,diameter,digestion,drying,elliptic,enzyme,faintly,filament,flower,forked,fresh,fruit,glabrous,globose,green,greenish,hair-like,herb,honeycomb-shaped,interjected,lateral,leaflet,length,light,lilac,long,lunate,medium,membranous,minutely,mm,moderately,mucilaginous,narrowly,oblique,odd-pinnate,orbicular,ovate,ovoid,pair,pedicel,peduncle,pentagonal,petiole,petiolule,plant,plurifoliate,puberulent,pubescent,pure,rarely,ripe,rounded,seed,shape,slightly,stem,stigma,style,substellate,terminal,testal,thick,tri-,typically,unit,wall,wet,white,whitish,yellow,yellowish	1,1-3,1-4.5,1.5-2.5,1.5-4,10-28,120-210,2,2-5,2-7.5,20-60,3-12,4-8,5-15,5-merou,50-70,6-20,600-950,?,acumen,ag,along,alyx,apart,apparently,articulated,axe,axillary,berry,blade,bud,capitat,ciliate,connivent,densely,distal,dorsally,dot,eaf,edge,eed,erec,especially,exceeding,except,flat,folded,geminat,generally,glabrou,gland,glandular,greatly,gree,green-white,hair,hal,half,head,homostylous,lanceolate,lengthening,like,living,lobe,longer,lower,make,margin,midrib,nflorescence,non-glandular,often,orolla,perfect,petiolulate,pore,poricidal,proximal,reduced,removed,ruit,scattered,sessile,seudostipule,short,size,slit,spaced,specimen,stamen,ste,straight,subequal,subsessile,subtending,tall,tamen,tem,tetralobulate,throughout,tip,trichome,tube,unwinged,usually,vary,varying,wide,wing,x,ympodial	abaxial,adaxial,arrangement,capitate,color,colour,form,growth,height,history,inflorescence,leaf,life,na,number,ovary,perennial,position,pseudostipule,rachi,spacing,staman,surface,sympodial,texture,type,width
109	wfo-0001026534	success	150	89	59	91	30	0.393	0.5-1,1-2,1-3,1.5-9,10-20,15-50,2-2.5,2-7,2-8,3-10,3-25,4.5-5,5-6,abaxially,acuminate,adaxially,apex,cm,connective,densely,diameter,distally,ellipsoidal,flattened,flower,fruit,glabrous,lanceolate,longitudinal,margin,mm,moderately,narrowly,orange,ovate,ovoid,pale,pedicel,peduncle,petiole,pinkish,pore,puberulent,pubescent,purple,rachi,red,remnant,simple,stellate,stigma,stripe,style,tree,triangular,truncate,white,x,yellow	-1.5,1-2.5,1.5-6,10-15,10-50,2-3,2.5-15,2.5-4,3-,3-4,3-5,3.5-4,4-10,4-foliat,6-35,7-12,7-40,absent,acute,aggregate,apart,ape,apiculate,articulated,auriculate,axe,basal,base,beyond,blade,branched,bright,calyx,cell,chartaceous,connivent,cordate,cylindrical,darker,deltate,directed,eaf,eed,eglandular,entire,equal,exserted,fleshy,glandular,hair,leaving,lemon-yello,lobe,lon,long,lower,m.,nflorescence,nther,obtuse,often,orolla,pedicellar,perfect,presen,puberulen,radiu,ruit,shorter,slightly,small,spaced,sparsely,stamen,stone,subcoriaceous,tal,tem,thecae,time,tip,tomento,truncat,tube,ud,unbranched,unit,vary,vein,wide,ympodial	abaxial,adaxial,anther,arrangement,color,colour,corolla,direction,form,growth,height,history,inflorescence,leaf,length,life,na,ovary,perennial,plant,position,present,seed,shape,spacing,stem,surface,texture,tomentose,width
110	wfo-0001026535	success	248	122	109	139	13	0.44	.5,0.7-1.5,1/3,2-5,2.5,3-5,5-7,5°,7-8,abaxial,abaxially,acute,adaxially,age,along,apex,base,becoming,berry,black,brachyblast,branch,branched,branching,brown,chartaceous,clavate,clustered,cm,concolorous,condensed,cuneate,curved,dark,dendritic,dendritic-pubescent,dense,developed,diameter,discolorous,distributed,drying,elliptic,elongated,entire,evenly,except,fine,flat,flexuous,fruit,glabrous,green-brown,leaf,length,liana,like,lobed,long,lower,margin,membranous,midvein,minutely,mm,network,number,obovate,older,ovate,ovoid,pair,partly,pedicel,peduncle,petiole,plant,primary,prominent,pubescent,rachi,raised,rarely,rounded,short,shrub,side,slender,sparsely,stem,stigma,style,surface,terminal,tertiary,thin,tissue,trichome,truncate,unarmed,unevenly,unlignified,vein,venation,visible,weakly,widely,young,youngest	.1,.2,.4,.8,0-0.5,0.1-0.2,0.15,0.2,0.2-0.3,0.2-1.5,0.5-1,1,1-2,1-3,1-5,1.2-2,1.3,1.5-2,1.5-3,1/2-2/3,2-3,3,3-4.5,3.5-4,4-15,5-10,absent,accrescent,almost,alternate,alyx,anther,anthesi,apar,apically,apparently,area,around,articulated,bark,broadly,calyx,clearly,conical,corolla,cup,cupular,deeply,delineate,delineated,deltoid,detaching,developing,dilated,divided,domatia,dorsal,dry,eaf,eed,ellipsoi,equal,eye,fertilisation,filament,flower,forming,free,frui,fruiting,increasing,inside,known,leave,lengthening,linear,lobe,lon,loop,loose,m.,main,marginal,minute,mostly,much,naked,nflorescence,nther,oblong,obscure,orange-brown,orolla,outside,papillo,pendulous,perfec,pericarp,plurifoliat,pointed,pore,poricidal,portion,protruding,ray,reaching,ridged,ruit,scar,secondary,see,simple,sinus,slightly,smaller,smooth,soon,spaced,spreading,stump,tearing,terete,tip,toward,translucent,tube,tufted,two,ud,uneven,unit,vary,violet,white,wide,wider,x,yellowish,ympodial	adaxial,angle,arrangement,color,colour,form,growth,inflorescence,papillose,position,shape,texture,ye
111	wfo-0001026538	success	226	132	105	121	27	0.465	0.3-1.5,0.8-1.2,0.8-2.2,1-1.9,1-3,1.2-2.6,1.3-2.8,1.7-2.5,1/2,2-5,2.1-3.2,2.1-3.4,3-4,3.5-4.6,3.5-5.8,3.7-5.8,5,abaxially,accrescent,acuminate,acute,adaxially,anther,apart,apex,around,bark,base,black,blunt-tipped,broadly,brown,brown-black,bud,calyx,cm,completely,corolla,covering,deltoid,diameter,directed,distally,drying,edge,elliptic,enveloping,farinose,filament,flower,fruit,fruiting,glabrous,globose,gray,green,lanceolate,leaf,length,lengthening,lobe,lobed,longitudinal,mm,obovate,obscured,ovate,ovate-lanceolate,pale,pedicel,peduncle,petiole,plurifoliate,pore,poricidal,porrect-stellate,pseudo-terminal,pubescent,rachi,reticulate-punctate,scabridulous,short,shrub,simple,slit,small,somewhat,stellate,stem,stigma,style,subcampanulate,subconical,suborbicular,surface,suture,tip,tomentose-pubescent,tree,tube,way,white,yellow,yellowish,yellowish-tan	-3.5,-5.8,.5-3,/15-1/9,0-160,0.1-0.3,0.4-,0.6-0.8,0.8-1.5,0.9-1.2,1-2.5,1.2-1.4,1.2-1.5,1.4-2.6,1.4-3,1.5-2.5mm,1.8-4.6,12-21.5,2-3.5,3.2-4.8,4-8,6-13,6.3-8.9,6.7-,8-10,8.1-14.8,[,],adaxiall,ag,along,anthesi,apparently,appearing,articulated,axe,axillary,ba,berry,blade,branch,branched,capitat,chartaceous,closely,constricted,cylindrical,decurrent,dense,densely,due,eaf,eed,entire,exserted,fleshy,free,frui,glabrescen,glabrou,hair,inserted,lackin,lateral,long,long-attenuate,long-stalked,longer,lower,main,many,margin,measured,midrib,mixed,mostly,multangulate,nearly,nflorescence,obtuse,occasionally,older,orolla,overlapping,perfect,porrect-stellat,pubescence,rarely,rather,ruit,runk,semi-ovate,sessile,short-stalked,side,slightly,sometimes,soon,spaced,stamen,tall,tamen,terete,thick,thickened,thin-textured,time,tomentu,touching,ud,unarme,unarmed,unit,usually,vary,vein,weakly,wide,x,ympodial,young	0.4-1.5,6.7-14.8,abaxial,adaxial,age,arrangement,capitate,color,direction,form,growth,height,history,inflorescence,life,na,ovary,perennial,plant,position,seed,shape,spacing,staman,texture,tomentum,width
112	wfo-0001026539	success	194	103	78	116	25	0.402	0,0.2,0.25,0.9,1.5–2,10–15,15–20,2.5–4,2–5,4–6,5–,5–10,6–15,abaxially,absent,acuminate,acute,adaxially,anther,apex,armed,base,branched,broadly,brown,clustered,cm,corolla,creamy,diameter,ellipsoid,filament,flattened-reniform,flower,fruit,glabrous,globose,growth,height,lance-elliptic,lateral,leaf,midrib,minutely,mm,narrowly,nearly,oblanceolate,occasionally,orange,pedicel,peduncle,perennial,petiole,pilosulose,pitted,pointed,present,prickle,puberulent,pustulate,rachi,recurved,red,rugose,staman,stellate,stem,stigma,strongly,style,surface,terminal,vine,white,winged,yellow,×	-6,.5,0.3-0.5,0.5,1,1-1.5,1-2-celled,10–28,1–2,2,2-4-celled,2.5,20,20–35,2–2.5,2–3,2–4,3,30,3–5,5,5.5,ag,always,alyx,anthesi,apiculate,approximately,articulated,axe,ba,basal,becoming,berry,blade,bud,calyx,campanulate,capitat,cell,chartaceous,connivent,cucullate,deltate,densely,dr.,eaf,early,eed,elongate,elongating,entire,equal,exserted,four,glabrou,hair,hooked,ine,interpetalar,larger,lengthening,lobe,lobed,long,long-attenuate,long-styled,longer,lower,major,margin,nflorescence,often,one,orolla,pair,pericarp,pore,poricidal,pubescent,recurve,robust,rounded,ruit,sessil,shallow,shoot,short,side,simple,sinuate,slender,slightly,slit,somewhat,spreading,stout,straight,subwoody,tamen,tapering,terminally,time,tip,tissue,triangular,trichome,tub,tube,unequal,usually,vary,vein,wide,woody,young	abaxial,adaxial,arrangement,axi,capitate,color,colour,dry,form,history,inflorescence,length,life,na,ovary,plant,position,presence,seed,sessile,shape,spacing,texture,width,wing
113	wfo-0001026604	success	192	113	102	90	11	0.531	.4,.5,0.8-0.9,1.2-1.7,1.5-9,2-2.3,2-2.5,2.3-3.5,4-4.5,5,acuminate,aid,along,anther,apart,apex,articulation,bark,base,berry,branching,brown,c.,calyx,capitate,cell,climbing,cm,conical,cordate,corolla,dark,diameter,distal,ellipsoid,entire,flattened,flexuous,fruit,glabrous,globose,growth,inflated,later,liana,lobed,margin,midrib,minute,minutely,mm,narrowly,new,oblique,outline,ovary,ovate,overall,ovoid,pale,pedicel,peduncle,petiole,pitted,poricidal,pubescent,purple,quarter,red,reddish,reniform,ripe,scar,shape,shiny,shrub,simple,sinuate,somewhat,spaced,stellate,stem,stigma,stout,style,support,surface,testal,thin,time,tip,trichome,truncate,tube,twisting,uniseriate,vining,violet,way,widely,woody,x	.75,0,0.1,0.4-0.6,0.8-1,1-1.2,1.1-1.3,1.5-2,10-30,3-3.5,3-5,3.5-4,4.5-7,5-7,50-100,<,?,absent,age,always,anthesi,appearing,articulated,atop,basal,brow,clearly,comical,cucullate,cupped,deflexed,densely,differentiated,distinct,drying,due,eaf,eed,elongate,expanding,exserted,filament,flower,free,fruiting,leaf-opposed,leaving,lengthening,lobe,lower,mere,nflorescence,nodding,occasionally,older,pair,papillo,papillose,part,particularly,peg,per,perfect,pericarp,planar,plurifoliat,poin,point,pore,portion,primary,receptacle-like,rim,ruit,series,slender,slightly,slit,strongly,structure,swolle,terminal,tub,ud,undulation,unit,upper,vein,ympodial,½	bud,color,flexibility,form,inflorescence,leaf,length,seed,spacing,texture,width
114	wfo-0001026606	success	213	139	97	116	42	0.455	0.4-0.8,0.5-1.6,1.3-1.9,1.7-2.1,2.4-3.6,3-6,abaxial,abaxially,absent,acute,adaxial,almost,apart,apex,armed,articulated,asymmetric,asymmetrically,base,based,berry,black,branched,broad,broadly,chartaceous,closely,cm,coarsely,compressed,cordate,diameter,expanded,extra-axillary,filament,flower,fruit,glabrate,glabrous,globose,golden,homostylous,internode,lateral,laterally,lenticular,margin,midpoint,minutely,mm,nearly,obsolete,obtuse,often,ovate,pedicel,peduncle,pentagonal,peripherally,petiole,pitted,prickle,puberulent,pubescent,rachi,rarely,ray,recurved,ripe,scabrous,short,shrub,simple,slightly,small,spaced,spreading,stellate,stellate-pubescent,stelliform,stem,stigma,style,subentire,surface,tan,toothed,tree,truncate,vein,weakly,white,widely,wider,woolly,x,yellow	0.5–0.8,1.4-2.1,10–20,12-17,12.5-22.5,15–20,15–25,1–1.5,1–3,2-3,2–2.5,2–4,3-4.6,3–10,3–4,3–5,3–6,4.2-5.2,4–20,4–7,5-merou,5.8-7.2,5–15,6–7,6–8,7.3-9.7,7–12,8–10,abaxiall,adaxially,along,alyx,an¬ther,apiculate,apparently,axe,ba,band,blade,blunt-tipped,capitat,central,concentrated,cylindrical,densely,developed,difoliate,directed,distally,eaf,eed,entire,eventually,forming,geminat,glabrou,hair,initially,interpetalar,lanceolate,larger,lighter,linear,lobe,lon,long,low,lower,main,midvein,moderately,much,nerve,nflorescence,occasionally,of¬ten,older,open,orolla,perfect,persistently,pore,present,prickly,pubescen,pubescence,rayed,reduced,rounded,ruit,scar,scattered,sessile,shortly,sometimes,sparingly,sparsely,stellae,stout,tall,tamen,tapering,tem,thick,thickened,three,tissue,tube,unarmed,usually,vary,warty,wide,yello,ympodia,young	0.5-0.8,1-3,15-20,2-4,3-10,3-4,3-5,4-20,5-15,5-merous,6-7,7-12,8-10,anther,armament,arrangement,articulation,branching,capitate,color,colour,corolla,expansion,form,growth,height,history,inflorescence,leaf,length,life,ovary,perennial,plant,position,presence,seed,shape,spacing,staman,texture,width
115	wfo-0001026607	success	204	99	76	128	23	0.373	0-3,0-4,0.1-0.3,0.8-3.4,0.8-4.5,1-10,1-2,1-8,1.5-4,10-30,2.5-3.8,4-6,6-10,abaxially,acute,adaxially,anther,apex,base,cell,chartaceous,clavate,cm,corolla,decurrent,deep,diameter,elliptic,filament,finely,flower,forked,fruit,glabrous,globose,green,greenish,herb,honeycomb,interjected,leaf,leaflet,medium,membranous,minute,minutely,mm,moderately,mucilaginous,obtuse,odd-pinnate,orbicular,ovate,ovoid,pair,pedicel,peduncle,pentagonal,petiole,plant,puberulent,pubescent,rachi,rounded,seed,sessile,size,stem,stigma,style,terminal,testal,typically,violet,whitish,yellow	0.3-1.8,0.5-5.8,0.8-5,1-3.8,1-5,2-10,2-2.5,2-3,2.4-5.8,2.7-19,3-8,4-10,5,5-merou,5.8-19.8,absent,acumen,ag,along,alyx,apart,apparently,articulated,attenuate,axe,axillary,basiscopic,berry,blade,brownish,bud,capitat,ciliate,clearly,coarse,condition,connivent,covering,decreasing,digestion,distal,dorsally,dot,drying,eaf,edge,eed,enzyme,especially,exceeding,flat,folded,forming,fresh,geminat,generally,glabrou,greatly,gree,green-white,hair,hair-like,hal,half,high,homostylous,lanceolate,larger,lateral,lengthening,like,living,lobe,long,lower,make,margin,marked,midrib,much,nflorescence,often,orolla,perfect,petiolulate,plurifoliate,pore,poricidal,present,rarely,removed,ripe,rosette,ruit,scattered,semierec,seudostipule,shaped,short,side,simple,slit,sometimes,spaced,specimen,stamen,ste,straight,subtending,tall,tamen,tem,thick,throughout,tip,toward,tri-,tube,unit,unwinged,usually,vary,wall,wet,white,without,x,ympodial	0-5,abaxial,adaxial,arrangement,capitate,color,colour,form,growth,height,history,inflorescence,length,life,ovary,perennial,position,pseudostipule,shape,spacing,staman,surface,texture
116	wfo-0001026613	success	159	94	67	92	27	0.421	0.6,1-10,1-2,2.3-8,2.5-2.8,3-10,3-5,5,5-6,5-7,6-12,8-18,8.5-10,8.5-9,abaxially,acuminate,adaxially,anther,apex,base,berry,chartaceous,ciliate,cm,cordate,corolla,densely,diameter,edge,especially,filament,flat,flower,forked,fruit,glabrous,green,herb,leaf,leaflet,lengthening,m-1.2,margin,membranous,minute,minutely,mm,odd-pinnate,ovate,pedicel,peduncle,petiole,petiolule,plant,pore,puberulent,pubescent,purple,rotate-pentagonal,size,slit,stem,stigma,style,terminal,tip,yellow	0.5-1,1.5-4,11-19.5,2-7.5,4-5,4.5-8.5,5-merou,5.5-7,6-8,6.2-9.5,9.5-13.5,absent,acumen,ag,along,alyx,apart,apparently,articulated,attenuate,axe,axillary,blade,borne,bud,capitat,conical,connivent,decreasing,distal,dorsally,eaf,eed,end,erec,folded,geminat,generally,greatly,hair,hal,half,homostylous,immature,interjected,lanceolate,larger,lateral,like,lobe,long,lower,mature,middle,midrib,mottled,nflorescence,orolla,pair,perfect,plurifoliate,poricidal,proximal,pubescen,ruit,secondary,semierect,seudostipule,singly,spaced,sparsely,ste,stolo,subequal,subtending,symmetrical,tall,tamen,tem,toward,tri-,tube,tuber,typically,unit,unknow,unknown,unwinged,usually,vary,x,ympodial	abaxial,adaxial,age,arrangement,capitate,color,colour,form,growth,height,history,inflorescence,length,life,na,ovary,perennial,position,pseudostipule,rachi,seed,shape,spacing,staman,surface,texture,width
117	wfo-0001026614	success	200	111	72	128	39	0.36	0.4-0.7,0.5,1.3-1.8,2.2-5.5,2.5,3.2-5.2,abaxially,absent,acuminate,acute,adaxially,anther,apart,apex,armed,black,brown,chartaceous,cm,dark,densely,diameter,dried,evenly,extra-axillary,filament,flattened-reniform,flower,foveolate,fruit,glabrous,globose,golden,hair,internode,interpetalar,leaf,midpoint,minutely,mm,mottled,orange,orange-red,ovate,pedicel,peduncle,petiole,prickle,pubescent,rachi,rarely,ray,ripe,rotate-pentagonal,sessile,shrub,simple,sparsely,stellate,stellate-pubescent,stem,stigma,style,surface,tissue,unarmed,usually,white,x,yellow,yellowish,–5	.8,0.2,0.2–0.3,0.5–2,1-,1.5–2,11-15,15–30,1–2,1–3,1–5,2.2,2.5–3,20–25,2–4,2–4-branched,2–6.5,3-foliate,3–10,4-7,4.5–11,4.5–5.5,5,5-merou,5.3-8.2,50,6.4-8.4,6–8,7.2-9.8,8–10,9–16,>,across,adaxiall,alyx,apparently,articulated,axe,ba,base,berry,blade,blunt-tipped,broad-based,calyx,campanulate,capitat,clavate,closely,commonly,concentrated,cylindrical,denser,developed,directed,distally,eaf,eed,entire,erect,especially,expanded,fleshy,fruiting,geminate,glabrescent,gland-tipped,globo,homostylous,irregularly,lanceolate-attenuate,lateral,less,linear,lobe,lobed,lon,long,lower,margin,midvein,minute,nearly,nflorescence,oblique,obtuse,often,orolla,ovate-lanceolate,ovoid,pair,per,perfect,pore,pubescence,reflexed,repand,rounded,ruit,scattered,shallowly,shin,side,similar,slightly,smaller,sometimes,somewhat,soon,spaced,spreading,stellae,tall,tamen,tapering,tem,time,tissu,tube,ud,unarme,vary,vein,weakly,well,wide,ympodia,young	0.2-0.3,0.5-2,1-2,1-3,1-5,2.5-3,20-25,4.5-5.5,6-8,8-10,9-16,abaxial,adaxial,armament,arrangement,capitate,color,colour,corolla,form,growth,height,history,inflorescence,length,life,na,number,ovary,perennial,plant,position,presence,seed,shape,shiny,spacing,staman,texture
118	wfo-0001026632	invalid_json_followup	108	95	53	55	42	0.491	.5,0,1-2,1.5,10-12,6,abaxially,acuminate,acute,adaxially,anther,apex,base,broadly,cm,condensed,cyme,densely,diameter,divided,elliptic,exposed,extra-axillary,filament,flattened,flower,halfway,height,leaf,lobe,long,margin,mm,moderately,ovate,pedicel,peduncle,petiole,prickle,prominent,pubescent,reddish-brown,scarcely,short,shrub,simple,stellate,stellate-pubescent,stigma,style,toward,triangular,unknown	3-4,5-merou,7,abundantly,acumen,alyx,armed,ba,blade,bu,capitat,cell,central,commonly,developed,eaf,eed,equal,erect,geminat,glandular,hair,interacuminal,lamina,lanceolat,lateral,less,little,lon,lower,minute,nflorescence,orolla,porrect-stellate,prickly,ray,rounded,ruit,sessile,shallow,sinus,straight,structure,tamen,tem,tissue,truncate,tube,unarme,unknow,vary,well,x,ympodial,young	'',5-merous,[,``,abaxial,adaxial,arrangement,bark,branching,bud,calyx,capitate,characteristic,color,colour,corolla,form,fruit,fruiting,growth,history,inflorescence,length,life,na,ovary,plant,position,rachi,seed,shape,spacing,staman,stem,surface,texture,trichome,unarmed,value,width,{,}
119	wfo-0001026642	success	193	100	62	131	38	0.321	.8,0.6,6,abaxial,abaxially,annual,anther,apex,axillary,bipinnate,black,blade,blue,brown,cell,clavate,cm,dark,densely,diameter,filament,flattened,flower,fruit,glabrous,glandular,globose,green-purple,herb,indumentum,lavender,leaf,length,lilac,mm,moderately,number,obtuse,ovate,pale,pedicel,peduncle,pentagonal,perennial,petiole,pinnate,pitted,present,pubescent,rounded,shallowly,sparsely,stigma,stone,style,subglabrous,surface,time,usually,violet,x,yellow	.05,.1,0.1,0.1–0.3,0.2,0.25,0.4,0.4–2.2,0.5,0.5–,0.5–0.7,0.5–1.7,0.5–2.0,0.5–3.5,0.6–1.0,0.75–1.0,0.75–2.0,0.7–1.6,0.8–1.2,1.0,1.0–2.0,1.2–1.7,1.2–2.0,1.2–3.5,1.2–6.2,1.6–8.0,1.9–3.0,12–30,1–10,1–3,2.0–4.0,2.5–3.5,2.5–4.0,2.8–3.0,3.0–5.1,3–5,4.0–6.0,4–7,5,5.0–7.0,50–100,<,acute,adaxiall,adaxially,ag,along,anthesi,apart,appressed,articulated,axe,ba,base,borne,branched,calyx,chartaceous,circular,connivent,cylindrical,decreasing,decumbent,denser,divided,eaf,eed,either,elliptic,equal,erect,fleshy,geminat,glabrescen,gland,hair,half,lobe,lon,long,longitudinal,lower,m.,multicellular,narrow,nflorescence,oblong,occasionally,often,opening,orolla,pair,perfect,pinnae,pore,poricidal,primary,probably,rapidly,ruit,secondary,sessile,shoot,side,simple,slit,sometimes,spaced,straight,tal,tamen,tem,tip,tube,unicellular,unifoliate,uniseriate,unit,vary,vein,white,wide,wing,woody,ympodial,–1.2,–11.0,–2.0,–4.5,–6,–7	0.4-2.2,0.5-3.5,0.75-2.0,0.8-1.2,1-10,1-3,1.2-1.7,1.2-3.5,2.8-3.0,3.0-5.1,5.0-7.0,50-100,adaxial,arrangement,branching,color,colour,corolla,feature,form,growth,height,history,inflorescence,life,na,ovary,plant,position,presence,seed,shape,size,spacing,staman,stem,texture,width
120	wfo-0001026651	success	222	127	91	131	36	0.41	-celled,1.8,2.8,3-plurifoliate,4,8,abaxially,acuminate,acute,adaxially,anisophyllous,anther,antrorse,apex,appressed,arcuate,berry,brochidodromous,brown,brownish-green,capitate,chartaceous,cm,cyme,dark,densely,diameter,drying,dull,entire,erect,filament,flattened,flower,fruit,geminate,glabrescent,glabrous,globose,green,herb,impressed,lanceolate,lateral,leaf,length,light,margin,matte,membranaceous,midrib,mm,moderate,mostly,narrowly-elliptic,ovate-reniform,pedicel,peduncle,pedunculate,petiole,plant,prominent,pubescent,revolute,ripe,secondary,seed,shape,shrub,simple,size,slightly,sometimes,stellate,stem,stigma,style,sub-opposite,surface,terminal,translucent,trichome,unbranched,undulate,uniseriate,unit,vein,venation,white,yellow,×	0.2–1.3,0.35–2.6,0.9–3,1,1–2,2.2–10,2–11.5,2–13,2–3,2–3.3,2–4,2–4.5,2–8,3,3–5,3–7,4–6,4–7.8,5-merou,6–10,6–14,absent,accrescent,adaxiall,along,alyx,antror,antrorsely,apar,ark,articulated,asymmetric,attenuate,axi,base,beneath,beyond,branch,broadly,calyx,capitat,cell,ciliate,circular,connivent,cordate,cylindrical,decumbent,decurrent,differing,directed,discolorous,eaf,eed,elliptic,emarginate,equal,exfoliating,exserted,eye,flexuous,frui,geniculate,glabrou,glandular,growt,hair,head,highly,hilum,hollow,introrsely,less,like,lobe,long,longitudinal,lower,lying,major,markedly,minor,moderately,much-branched,multicellular,naked,new,nflorescence,normally,oblong-ellipsoid,obtuse,older,one,onto,opening,orolla,ovate-deltate,ovate-lanceolate,parallel,per,perfect,pore,poricidal,pubescence,reduce,region,rounded,ruit,shiny,similar,single-celled,slit,small,smaller,spaced,stalk,stamen,straight,subapical,tall,tamen,tem,turning,upper,usually,vary,visible,wide,woody,ympodial,young	0.9-3,1-2,2-11.5,2-13,2-3,2-8,2.2-10,4-6,5-merous,6-10,6-14,abaxial,adaxial,apart,arrangement,bark,color,colour,corolla,form,growth,height,history,inflorescence,life,na,ovary,perennial,position,prominence,rachi,spacing,staman,sympodial,texture,width
121	wfo-0001026656	success	211	130	104	107	26	0.493	0-4,0.3-3,1-10,1-2,1-3.8,1.1-8.1,2-6,20-60,4-8,5-35,9-11,abaxially,acuminate,acute,adaxially,along,anther,apart,apex,blue,broadly,brownish,capitate,cell,chartaceous,ciliate,cm,condition,corolla,covering,dark,densely,diameter,dot,drying,elliptic,especially,filament,flower,forked,fresh,fruit,generally,glabrous,glaucous,globose,green,green-white,greenish,hair,hair-like,herb,interjected,lanceolate,lateral,leaflet,light,like,lunate,make,margin,membranous,midvein,minutely,mm,moderately,mucilaginous,narrowly,occasionally,odd-pinnate,often,ovate,ovoid,pair,pedicel,peduncle,pentagonal,petiole,plant,puberulent,pubescent,purple,rotate-pentagonal,scale-like,scattered,seed,sometimes,stem,stigma,style,subglabrous,terminal,testal,thick,throughout,tinged,tip,tuber,violet,wall,wet,white,whitish,yellow	0.3-4.2,0.4-6.5,0.7-10.5,0.9-13,1,1-1.8,1-4,1-5,1.5-7,10,2-8,2.5-17,4-10,4-13,5,5-18,5-merou,5.5-27,absent,acumen,ag,alyx,articulated,attenuate,base,bearing,blade,borne,bud,clavat,connate,connivent,cuneate,curved,decurrent,digestion,distal,dorsally,eaf,edge,eed,end,enzyme,erec,exceeding,flat,folded,geminat,greatly,greenish-yellow,half,homostylous,honeycomb-shaped,larger,lengthening,living,lobe,long,lower,middl,mottled,nflorescence,non-glandular,oblique,orolla,petiolulate,petiolule,plurifoliate,pore,poricidal,pubescen,rachi,ranging,removed,ruit,seudostipule,short,singly,slightly,slit,somewhat,spaced,specimen,stamen,star,ste,stolo,straight,subequal,subtending,symmetrical,tall,tamen,tem,tertiary,therefore,tri-,truncate,tube,typically,unit,unwinged,vary,wide,wing,without,ympodial	abaxial,adaxial,arrangement,clavate,color,colour,form,growth,height,history,inflorescence,leaf,length,life,na,number,ovary,perennial,position,pseudostipule,shape,spacing,staman,surface,texture,width
122	wfo-0001026663	success	251	96	78	173	18	0.311	-15,-2.9,0.2-0.6,0.3-0.8,0.4-2.2,1,1-3.2,1-5,1.2-2,1.4-3.1,1.6-2.3,10-26,10.3-13.2,2-12,2.1-2.6,24-45,31,4.7-25.9,abaxially,adaxially,along,anther,apart,bark,becoming,branch,branched,brown,bud,chartaceous,cm,conical,corolla,dark,diameter,drying,elongated,flower,fruit,globose,granular,green,greenish-brown,immature,lanceolate,leaf,length,less,light,many,mm,openly,ovate-lanceolate,pale,pedicel,peduncle,petiole,pseudo-terminal,pubescent,rachi,scabrous,short,simple,sparsely,stellate,stem,stigma,style,subglobose,time,tip,tomentose,tomentose-pubescent,usually,vein,whitish,x,yellow	-8,-9.7,.5-2.5,/25-1/15,/3,0-160,0.9-1.5,1-2.5,1.1,1.1-2.1,1.4-2.6,1.9-2.6,1/2,1/3,1/4-1/2,12-14,2.5-3.7,2.8-5.3,2.9-5,2/3,3-5,3.5-5,3.8-5.7,4.5-5.7,5-8,5.5-,5.5-8.8,7.5-9,8-17,accrescent,acuminate,acute,adaxiall,ag,angled,anthesi,apex,apparently,appressed,around,articulated,ascending,attenuate,axe,axillary,base,berry,blade,blunt-tipped,broadly,calyx,capitat,closely,completely,constricted,covering,cylindrical,densely,directed,distally,distributed,eaf,echinoi,echinoid,echinoid-pubescent,edge,eed,entire,enveloping,especially,evident,exserted,farinose,filament,flared,fleshy,free,fruiting,glabrescen,glabrescent,glabrous,granular-tomentose,grooved,hair,inserted,lateral,lengthening,line,lined,lobe,lobed,long,long-stalke,long-stalked,longer,longitudinal,longitudinally,lower,m.,main,margin,matur,midrib,midvein,minute,multangulate,multangulate-pubescent,nearly,nflorescence,obtuse,occasional,occuring,older,opening,orolla,ovate,ovate-lanceolat,perfect,persistent,plurifoliate,pore,poricidal,porrect-stellate,present,pubescence,rather,ray,rich,ridged,robust,ruit,runk,sessile,short-stalked,shrub,side,slightly,slit,small,sometimes,somewhat,soon,spaced,stalk,stalked,stamen,strongly,subcampanulate,subcoriaceous,subglabrous,suture,tall,tamen,tangled,terete,thick,thin,tomentum,touching,tree,tube,ud,unarme,unarmed,unit,upper,vary,violet,way,white,wide,ympodial,young	5.5-9,adaxial,arrangement,branching,capitate,color,colour,height,inflorescence,ovary,plant,position,seed,shape,size,spacing,surface,texture
123	wfo-0001026686	success	196	108	87	109	21	0.444	0.6-0.9,1-10,1-2,1.2-3.4,1.5-7,10-28,2-10,2-9,2.4-3.6,3-4,3.7-8,5,5-8,7-9,8-10,abaxially,adaxially,anther,berry,borne,brownish,cell,chartaceous,cm,condition,conical,corolla,covering,densely,diameter,drying,elliptic-lanceolate,end,filament,flower,forked,fresh,fruit,glabrous,green,greenish,hair,hair-like,herb,interjected,lanceolate,lateral,leaf,leaflet,light,like,long,minute,minutely,mm,mottled,odd-pinnate,orbicular,ovate,ovoid,pair,pedicel,peduncle,petiole,petiolule,plant,puberulent,pubescent,purple,purple-violet,ripe,rotate-stellate,seed,singly,sparsely,stigma,style,symmetrical,terminal,testal,thick,tuber,typically,wall,whitish,x,yellow	.4,0.2-0.5,1,1-2.5,1.2-3.6,1.7-2.5,2.5-8,3-5,4-6,5-16.5,5-merou,6.5-12.7,8-14,8-27,absent,acumen,acuminate,ag,along,alyx,apart,apex,apparently,articulated,axe,axillary,base,blade,bud,capitat,ciliate,connivent,decreasing,digestion,distal,dorsally,eaf,edge,eed,enzyme,equal,erec,especially,exceeding,flat,folded,geminat,generally,glabrou,gradually,green-white,half,homostylous,honeycomb-shaped,larger,lengthening,living,lobe,lower,make,margin,middle,midrib,mucilaginous,nflorescence,obtuse,often,orolla,perfect,plurifoliate,pore,poricidal,pubescen,removed,round,ruit,secondary,semierect,seudostipule,size,slightly,slit,spaced,specimen,stamen,star,ste,stolo,straight,stripe,subequal,subsessile,subtending,tall,tamen,tem,throughout,tip,toward,tri-,tube,unit,usually,vary,wet,white,wide,wing,ympodial	arrangement,capitate,color,form,growth,height,history,inflorescence,length,life,ovary,perennial,position,pseudostipule,shape,spacing,staman,stem,stolon,surface,texture
124	wfo-0001026695	success	128	81	55	73	26	0.43	0.6-8,1-2,1-4,1.6,2,2-6,2.5-5.2,2.5-7,4,4-5,6-7,6-8,6.5-13,acute,apex,articulate,base,branched,cm,corolla,cyme,diameter,dichasial,dichasially,distal,ebracteate,filament,flower,glabrescent,half,herbaceous,leaf,leaflet,mm,monochasial,oblique,odd-pinnate,ovate,ovate-lanceolate,pedicel,peduncle,perennial,petiole,plant,proximal,pubescent,short-acuminate,simple,stellate,stigma,style,terminal,unknown,yellow,¼	1-1.5,11-14,2-3,2.5-3,3-4,3-6-foliat,3-8,4-5.5,6-12,8-16,8-17.5,abaxially,absen,acumen,acuminate,adaxially,apical,apically,calyx,compound,connate,cordate,cuneate,decurrent,dehiscent,dorsally,eaf,edge,eed,exceeding,flat,folded,forked,generally,globo,interjected,introrse,lateral,lobe,lon,long,lower,lunat,maturing,nflorescence,nther,often,one,orolla,pair,perfect,plan,poricidally,rounded,ruit,sessile,seudostipule,short,slit,stamen,straight,tal,tem,triangular,tuber-bearing,typically,unit,unknow,vary,whit,wide,without,ympodial	abaxial,adaxial,anther,arrangement,color,colour,form,fruit,globose,growth,height,history,inflorescence,length,life,na,ovary,position,seed,shape,spacing,stem,surface,texture,white,width
125	wfo-0001026696	success	139	95	67	72	28	0.482	0.3-4.5,0.8-7,1,1-4,1.3-2.1,3-17,3-3.5,3-6,9,acute,apex,articulate,base,branched,broadly,cell,cm,corolla,covering,cyme,densely,diameter,dichasial,dichasially,digestion,distal,ebracteate,enzyme,filament,flower,globose,green,green-white,hair-like,half,herbaceous,honeycomb,lanceolate,lateral,light,linear,mm,monochasial,mucilaginous,obtuse,odd-pinnate,ovate,ovoid,pattern,pedicel,peduncle,perennial,petiole,plant,proximal,pubescent,seed,stellate,stigma,style,testal,thick,throughout,wall,white-cream,yellow,¼	0.9-7.2,1-1.3,1.5-3,2-17,2-3,3-6-foliat,3-8.5,4-16,5-35,abaxially,acumen,adaxially,apical,apically,apiculate,calyx,connate,cuneate,decurrent,dehiscent,dorsally,eaf,edge,eed,emoval,entire,exceeding,flat,folded,forked,generally,globo,introrse,light-yello,living,lobe,lon,long,lower,lunat,make,margin,maturing,nflorescence,nther,oblong,often,orolla,perfect,plan,poricidally,reveal,rounded,ruit,seudostipule,short,simple,sinuate,slit,specimen,stamen,straight,tal,tem,throughou,tuber-bearing,typically,unit,vary,wide,without,ympodial	abaxial,adaxial,anther,arrangement,color,colour,form,fruit,growth,height,history,inflorescence,leaf,length,life,light-yellow,na,ovary,position,removal,shape,spacing,staman,stem,surface,texture,wet,width
126	wfo-0001026706	success	232	125	101	131	24	0.435	0.6-2.2,0.8-2.8,0.9-2,1-2.2,1-5,1.5-3,1/2-2/3,12,3-4.6,4,4.5-5.5,5.3-6.4,6-8,abaxially,accrescent,acute,adaxially,anther,apart,apex,appearing,attenuate,bark,base,branch,branched,brown,bud,calyx,chartaceous,cm,corolla,crisped,cuneate,dark,diameter,entire,filament,flower,fruit,fruiting,glabrate,globose,golden,grayish,green,indument,leaf,length,lobe,lobed,many,margin,mm,oblong,obtuse,occasionally,often,ovate,ovate-elliptic,ovate-lanceolate,pale,pedicel,peduncle,petiole,pseudo-terminal,pubescence,pubescent,rachi,reddish,reticulate-punctate,shrub,simple,slightly,small,softly,sparsely,splitting,stellate,stem,stigma,strongly,style,subcampanulate,subconical,subglobose,suborbicular,sulcate,surface,tall,time,tomentose-pubescent,tree,unevenly,velutinous,wavy,way,white,whitish,yellow,yellowish-tan	-3.1,-4.4,-5.5,-6.1,.5,/14-1/6,0-240,0.2-0.3,0.2-0.5,0.8-1.2,0.8-1.5,0.9-1.9,1.1-4,10-15,14-32,2.2-3.3,2.3-3.8,2.5-3,2.7-4,2.9-6,2/3-3/4,3.1-3.8,3.6-5.7,4.2-12,5-6.5,6-10,6.1-,7-16,8-14,9.8-15.4,adaxiall,ag,anthesi,apparently,around,articulated,axe,axillary,ba,becoming,berry,blade,blunt-tipped,capitat,closely,completely,coriaceous,covering,cylindrical,dendritic-echinoid,dendritic-multangulate,densely,directed,distally,eaf,edge,eed,enveloping,exserted,farinose,fleshy,fourth,free,furfuraceou,glabrous,hair,herbarium,inserted,lackin,lacking,lanceolate,lateral,lengthening,long,long-stalked,longitudinal,lower,m.,main,matted,midrib,minute,mixed,multangulat,multangulate,nearly,nflorescence,obscured,older,orolla,perfect,persistent,plurifoliate,pore,poricidal,porrect-stellate,rather,ruit,runk,semi-ovate,sessile,short-,short-stalked,side,slit,somewhat,soon,spaced,specimen,stalked,stamen,suture,tamen,thin-walled,tip,tomentu,touching,translucent,transparent,tube,ud,unarme,unarmed,unit,upper,vary,vein,wide,x,ympodial,young	6.1-15.4,abaxial,adaxial,arrangement,capitate,color,colour,feature,form,growth,height,history,inflorescence,life,ovary,perennial,plant,position,seed,shape,spacing,staman,sulcation,texture
127	wfo-0001026707	success	196	124	97	99	27	0.495	-3,.5,0,0.05,0.5-1,0.5-3,0.6-0.7,0.7-1.4,1-5,1.6-2,1/3,1/3-1/2,11-16,2.5-6,3-4,4,5-10,5-merous,8-15,?,abaxially,acute,anther,apart,apex,attenuate,bark,base,berry,branched,broadly,calyx,clustered,cm,color,densely,diameter,entire,eye,filament,flattened-reniform,flower,foliaceous,fruit,fruiting,fused,glabrescent,glabrous,gray,green,lateral,leaf,length,less,lobe,long,margin,mauve,midpoint,mm,moderately,naked,narrow-deltate,narrow-oblong,orange-brown,pedicel,peduncle,petiole,porrect-lepidote,prickle,pubescent,ray,red-brown,rounded,shorter,shrub,small,sometimes,sparsely,spherical,stalk,stellate,stellate-pubescent,stem,style,surface,terete,terminal,tip,tree,trichome,unarmed,upper,venation,visible,white,yellow-green	-1/3,-5,.8,/3,0-20,0.05-0.15,0.1-0.2,0.3-0.8,0.6-0.8,0.7-1,0.7-1.5,1-1.7,1-3,1.5-1.8,1/3-3/4,1/4-1/3,1/8-1/4,2-10,2-2.3,2-6,2.5-3,2.5-4,3-4.5,3-7,3-8,5-25,5-7,5-8,alyx,apar,apically,apparently,articulated,blade,branche,broad-deltate,chartaceous,concolorous,connivent,curved,cuspidat,decurrent,discolorous,drying,eaf,eed,elongating,equal,erect,free,gently,glabrou,inflated,infructescence,juvenil,known,lobed,longer,lower,mature,nflorescence,obtuse,older,one,open,orolla,oung,per,perfec,pericarp,plurifoliat,poricidal,porrect,portion,prickly,reflexed,ruit,scar,sessile,simple,slender,smooth,spaced,spreading,stalked,stout,straight,tamen,tapering,time,tube,unit,variously,vary,way,weakly,wide,ympodial,¼	abaxial,adaxial,arrangement,branch,colour,corolla,form,fusion,growth,height,history,inflorescence,life,na,ovary,perennial,plant,position,range,seed,shape,spacing,staman,stigma,texture,visibility,width
128	wfo-0001026711	success	210	106	84	126	22	0.4	0.1,0.15,0.2-0.3,0.3-1,0.5-1.5,0.7-,0.75-1,0.8,0.9-1.1,1-2,1.5-2.2,1/2-2/3,2-3.5,2-6,3-5,4.5-7,acicular,acute,ame,anther,apex,apparently,bark,base,berry,branched,c.,calyx,cell,cm,connivent,densely,diameter,dull,elliptic,erect,flattened-reniform,flower,fruit,glabrous,lateral,leaf,length,less,lobed,midpoint,mm,moderately,narrow-deltate,obtuse,one,open,orange-brown,outline,perpendicular,petiole,pit,porrect,prickle,raised,ray,reflexed,shrub,small,smooth,somewhat,spherical,stalk,stellate,stellate-pubescent,stem,straight,style,surface,tapering,terete,terminal,time,trichome,uniform,way,weakly,yellow,yellow-green	-15,-2,-5,-6,-7,.2,.5,.8,0,0-0.2,0-25,0-4,0-6,0.7-0.9,0.7-1.4,0.8-2.2,0.9-1.5,1-,1-30,1.5-,1.7-4,1/,1/3,1/4,1/4-1/3,2-2.2,2-2.5,2-4,2.1-2.5,3-4,3-4.5,3-7,3.5-5.2,4-8,5-merous,7-8,abaxially,acuminat,alyx,apar,apart,apically,articulated,blade,brow,concolorous,cuneate,curved,deltate,difoliate,discolorous,distance,drying,eaf,eed,elongating,equal,evenly,extending,faint,filament,free,fruiting,geminat,green,infructescence,lobe,long,longer,lower,margin,mature,maturity,mauve,midvein,nflorescence,occasionally,older,orange,orolla,oung,pair,pale,pedicel,peduncle,pendulous,per,perfec,pericarp,poricidal,portion,prickl,prickly,primary,purple,red,reduced,rounded,ruit,scar,sessile,shallowly,shorter,side,slender,sometimes,spaced,spreading,stalked,tamen,tertiary,thick-chartaceous,tip,tube,unarmed,unit,upper,variously,vary,vein,venation,visible,wide,woody,ympodial,young	abaxial,adaxial,arrangement,branching,colour,corolla,form,growth,height,inflorescence,lobing,na,number,opening,orientation,ovary,plant,seed,shape,staman,texture,width
129	wfo-0001026717	success	207	91	66	141	25	0.319	0.6-1.5,1-10,1-2,1-3,13-28,2.5-4.5,2.5-5.5,3-6,3.3-11,4-6,5-11,abaxially,acuminate,adaxially,anther,apex,cell,chartaceous,cm,condition,conical,corolla,covering,dark,diameter,drying,elliptic,filament,flower,forked,fresh,fruit,glabrous,green,greenish,hair-like,herb,honeycomb-shaped,lanceolate,leaf,light,medium,membranous,minutely,mm,mucilaginous,odd-pinnate,ovoid,pedicel,peduncle,pentagonal,petiole,plant,puberulent,pubescent,purple,rotate,seed,sparsely,stigma,style,terminal,thick,violet,whitish,yellow	0.3-0.6,0.3-2.5,0.3-5,0.8,1-2.5,1.3-2.5,1.4-2.2,1.8-3,14-22,15-34,2.2-5,3-4,3-5,4-8,4-9,5,5-13.5,5-6,5-merou,5.3-9,7-11,acumen,ag,along,alyx,apart,apparently,articulated,attenuate,axe,axillary,base,berry,blade,borne,brownish,bud,capitat,ciliate,connivent,darker,decreasing,decurrent,digestion,distal,dorsally,eaf,edge,eed,end,enzyme,equal,erec,especially,exceeding,flat,folded,geminat,generally,glabrou,gradually,green-white,hair,half,homostylous,interjected,larger,lateral,leaflet,lengthening,like,living,lobe,long,lower,make,margin,middle,midrib,minute,mottled,narrow,nflorescence,obtuse,often,one-quarte,orbicular,orolla,ovate,pair,perfect,petiolule,plurifoliate,pore,poricidal,present,pubescen,removed,ripe,round,ruit,secondary,semierect,sessile,seudostipule,singly,size,slightly,slit,spaced,specimen,stamen,ste,stolo,straight,stripe,subequal,subglabrous,subsessile,subtending,symmetrical,tall,tamen,tem,testal,throughout,tip,toward,tri-,tube,tuber,typically,unit,usually,vary,wall,wet,wide,wing,x,ympodial	abaxial,adaxial,arrangement,capitate,color,colour,form,growth,height,history,inflorescence,length,life,na,ovary,perennial,position,rachi,shape,spacing,staman,stem,surface,texture,width
130	wfo-0001026725	success	166	122	91	75	31	0.548	.3,.5,0.2,0.7-1.2,1-1.2,1-4.5,1-5,1.2-1.7,1.5,1.5-2,1.6-2,5-6,accrescent,acute,anther,apart,apex,bark,becoming,beneath,black,bluish,broadly,brownish-papillose,calyx,capitate,cm,corolla,cup-shaped,dark,deflexed,dia,drying,ellipsoid,elliptic,extremely,filament,flattened-reniform,fruit,fruiting,glabrous,globose,green,greenish-white,incrassate,leaf,less,lobe,lobed,long,margin,minutely,mm,open,opposite,ovary,ovate,ovoid,pale,paler,papillose,pedicel,petiole,pitted,planar,pore,pubescent,reddish-brown,reflexed,rounded,scarious,shaped,short,shrub,simple,size,slender,slightly,split,stem,stigma,straight,stretching,style,surface,tan,tear-drop,tip,tube,white,x	/4,1-1.5,1/2,2,2.2-4,3.5-4,3.6-7.7,5-20-flowered,5-5.5,8-18.6,8-9,anthesi,attenuate,axil,base,berry,character,crackin,differing,difoliate,dry,eaf,edicel,eed,evenly,free,geminat,geographically,glandular-papillose,inflorescenc,interpetalar,large,lateral,lon,lower,main,major,margine,material,middle,minor,nflorescence,occasionally,often,older,one,onto,pair,papillo,poricidal,portion,prominent,proximal,ruit,scar,sinus,spaced,subshrub,tall,tapering,triangular,trichome,tuft,ud,uniseriate,unit,upper,varying,vein,way,widest,winged,woody,ympodial,young	abaxial,accrescence,adaxial,arrangement,bud,color,colour,cracking,deflexion,diameter,flower,form,growth,height,history,inflorescence,length,life,margined,na,peduncle,perennial,plant,position,rachi,seed,shape,spacing,staman,texture,width
131	wfo-0001026733	success	188	122	89	99	33	0.473	-11,-14,-4,-7,-8,0.3-0.5,0.5,0.5-1,0.5-2,0.5-4,1-1.5,1-2,1-7,1.5-14,1.5-2,1.5-2.5,10-20,2-2.5,2-3,2-6,4-5,4.5-5,5-8,7-10,acuminate,acute-acuminate,adaxially,apart,apex,base,calyx,chartaceous,cm,color,connective,deltate,densely,diameter,distally,eglandular-pilose,ellipsoidal,elliptic-ovate,flattened,flower,forked,fruit,fusiform,glabrate,glabrous,glandular-,glandular-puberulent,green,greyish,immature,linear-triangular,lobe,longitudinal,margin,membranaceous,mm,narrowly,ovate,ovoid,pedicel,peduncle,petiole,pilose,pore,pubescent-pilose,rachi,radiu,simple,stellate,stigma,stripe,style,submarginally,tree,triangular,truncate,tube,unbranched,unknown,villous,white,white-puberulent,x,yellow,yellowish	-1,-13,-15,-2,.5-3,0.3-2,1,1-3,15-,2-4,2.5-7.5,20-50,25-40,3-15,3-3.5,3-4-foliat,3-7,4,4-23,8-12,abaxially,acute,aggregate,ape,articulated,axe,basal,beyond,blade,capitat,cell,ciliat,connivent,cordate,curled,cylindrical,dense,dia,directed,eaf,eed,eglandular-pubescent,eglandular-villous,entire,equal,especially,exceeding,exserted,gland-tipped,glandula,glandular-tomentose,hair,hirsute,lanceolate,leaving,lon,long,lower,midrib,moderately,near,nflorescence,nther,oblique,orolla,ovum,pedicellar,perfect,present,pubescent,pubescent-pilo,remnant,ripe,round,ruit,shining,shorter,slightly,small,smooth,sometimes,spaced,sparsely,stamen,stone,swelling,tal,tem,thecae,time,toward,ud,unit,unknow,usually,vary,vein,wide,ympodial	1.5-3,abaxial,adaxial,anther,arrangement,bud,capitate,ciliate,colour,corolla,direction,filament,form,growth,height,history,inflorescence,leaf,length,life,na,ovary,perennial,plant,position,seed,shape,spacing,staman,stem,surface,texture,width
132	wfo-0001026734	invalid_json_followup	266	123	89	177	34	0.335	0.1,0.3,0.5,1,3,abaxial,abaxially,absent,acuminate,adaxial,always,anther,apex,barely,berry,broadly,brown,central,chartaceous,clavate,closely,cm,congested,corolla,cylindrical,cyme,densely,diameter,elliptic,flattened,flower,frequently,fruit,glabrescent,glabrous,globose,green,growth,immature,internodal,irregular,lateral,leaf,length,lobed,long,long-attenuate,maturity,membranaceous,minute,mm,moderately,multiseriate,ovary,pale,pedicel,peduncle,petiole,pit,porrect-stellate,pubescent,purple,rachi,ray,reaching,reniform,sessile,shape,shiny,short-stalked,shorter,shrub,simple,slightly,spaced,sparsely,stalk,stellate,stem,stigma,style,subopposite,surface,trichome,unbranched,unequal,visible,white,yellow	0.2,0.6,0.7–0.9,0.7–1,0.8–1,1.6–2,1.6–2.5,1.8–2.2,1.8–3,1/4,1–1.2,1–3,2.2–7,2.3–5,2.5–3,2–2.4,2–3,3.2–3.8,3–4,3–4-celled,3–8,4–6,4–7,4–8,4–9,5-merou,5–9,8,accrescent,acute,adaxiall,adaxially,ag,also,alyx,anthesi,apical,apice,archin,ark,articulated,associated,asymmetric,axi,base,becoming,beneat,beneath,blade,branch,branched,bright,caly,calyx,camptodromous,capitate,celled,commonly,connivent,covered,covering,cuneate,dark,dense,denser,differing,directed,discolorous,distally,downward,dried,drying,due,eaf,eed,eglandular,emergent,entire,erect,f.,fewer,flat,foliate,forked,found,free,geminate,glabrescen,glandular,gray,hair,held,ilament,initially,introrsely,j,lamina,lanceolate,large,less,lobe,longer,longitudinal,lower,lying,margin,material,mature,maturit,midpoint,midri,mostly,much,narrow,near,new,nflorescence,normally,oblong,obovate,observed,obtuse,often,old,older,one,one-celled,opening,orolla,other,oung,ovate,pair,paired,papillose,perfect,plane,pointing,pore,poricidal,porrect,portion,pubescence,purplish,raised,rarely,rayed,rounded,ruit,scandent,secondary,size,slit,smaller,sometimes,sparse,spread,spreading,still,subsessile,surfac,terminal,tube,tuft,ud,uniseriate,unit,upward,vary,vein,venation,vestiture,whole,wide,yellowish,ympodial,¾	'',0.8-1,1.6-2,1.8-3,2.3-5,3-8,5-9,5-merous,[,``,arrangement,characteristic,color,colour,compared,density,filament,form,height,history,inflorescence,life,na,perennial,plant,position,seed,spacing,staman,texture,value,width,{,}
133	wfo-0001026739	success	197	125	96	101	29	0.487	0.25-0.94,0.4-5,1-10,1-2,1-3,10-60,16-54,2-9,2.5-13.5,2.6-4.8,3-4,3.2-17.5,4-8,6-13,7-9,abaxially,acumen,acuminate,acute,adaxially,along,anther,apex,bead,brownish,clavate,cm,connivent,coriaceous,corolla,dark,densely,diameter,dorsally,drying,edge,filament,flat,flower,folded,forked,fruit,glabrous,globose,green,green-white,greenish,hair,herb,homostylous,lanceolate,leaf,lengthening,light,like,linear,lobe,margin,mm,moniliform,mucilaginous,necklace,oblanceolate,odd-pinnate,ovate,ovoid,pedicel,peduncle,pentagonal,petal,petiole,plant,pore,poricidal,pubescent,purple,rotate,seed,slit,sometimes,stem,stigma,stolon,stripe,style,sub-glabrous,terminal,throughout,tip,tube,tuber,wet,white,whitish,yellow,yellowish	0-0.34,0-38,0.5-1.2,1.2-2.1,1.4-3.5,2-4,2-5.3,2-6,2.7-6.9,3.8-8.5,5-merou,5.6-13.1,6.6-18,abaxiall,ag,alyx,apart,apparently,arranged,articulated,asymmetric,attenuate,axe,axillary,base,basiscopic,berry,blade,brown,bud,capitat,cell,condition,covering,decreasing,digestion,distal,eaf,eed,enzyme,erec,exceeding,fresh,geminat,generally,glabrou,hair-like,hal,half,high,honeycomb-shaped,interjected,larger,lateral,leaflet,living,long,lower,make,multiple,nflorescence,orbicular,orolla,pair,perfect,plurifoliate,removed,rest,ripe,rounded,ruit,sessile,seudostipule,short,side,simple,size,spaced,specimen,stamen,straight,subequal,subtending,tall,tamen,tem,testal,thick,tissue,toward,tri-,typically,unit,usually,vary,wall,wide,wing,winged,x,ympodial	5-merous,abaxial,adaxial,age,arrangement,calyx,capitate,color,colour,form,growth,height,history,inflorescence,length,life,na,number,ovary,perennial,position,pseudostipule,rachi,shape,spacing,staman,surface,texture,width
134	wfo-0001026740	success	171	97	67	104	30	0.392	0-10,1-10,1-12,1-2,1-5,10-20,2-3,2.5-27,2.5-6,5-8,6-10,abaxially,absent,acuminate,acute,aggregate,apex,basal,branched,cell,cm,curled,densely,diameter,eglandular,ellipsoidal,elliptic,entire,flattened,flower,fruit,glabrous,greenish,hair,lobe,margin,mm,moderately,ovate,pedicel,pedicellar,peduncle,petiole,pilose,present,puberulent,pubescent,purple,rachi,remnant,reticulate,scar,simple,sparsely,stellate,stigma,stone,style,tomentose,tree,truncate,unbranched,vein,violet,white-puberulent,whitish,yellow	-17,-2,0.5-1,1-3,1-4,10-30,2-4,2.5-3,2.5-4.5,20-50,3-15,3-3.5,3-5,3-foliat,3.5-40,4-5,4.5-10,5-40,8-19,absen,acute-acuminate,adaxially,also,apart,ape,apiculate,articulated,axe,base,beyond,blade,browni,calyx,ciliate,connective,connivent,cordate,corky,cylindrical,darker,deltate,directed,distally,eaf,eed,equal,especially,exceeding,exserted,fleshy,glabrate,glandular-puberulent,immature,lanceolate,leaving,lon,long,lower,mature,narrowly,near,nearly,nflorescence,nther,oblong,obtuse,often,orange,orolla,ovoid,perfect,pilo,pore,radiu,rarely,ruit,sessile,shorter,slightly,small,sometimes,spaced,stamen,stripe,subcoriaceous,swelling,tal,tems,thecae,time,toward,triangular,truncat,tube,ud,unit,unlobed,vary,villous,wide,woody,x,ympodial,young	abaxial,adaxial,anther,arrangement,color,colour,corolla,filament,form,growth,height,history,inflorescence,leaf,length,life,na,ovary,perennial,plant,position,presence,seed,shape,spacing,staman,stem,surface,texture,width
135	wfo-0001026752	success	169	100	72	97	28	0.426	-25,1-12,1-5,1-6,1.5-12,10-20,2-2.5,20-30,3-4,3-5,4-5,abaxially,abruptly,adaxially,also,apart,apex,black,branched,campanulate,cm,connective,coriaceous,cylindrical,darker,densely,diameter,ellipsoidal,elliptic-oblong,elliptic-ovate,flattened,fleshy,flower,forked,fruit,glabrous,globose,green,greenish-brown,immature,lanceolate,mm,moderately,narrowly,nearly,papillose,pedicel,peduncle,petiole,pilose,possibly,pubescent,pubescent-pilose,purplish,rachi,rarely,ripe,short-acuminate,simple,stellate,stigma,stripe,style,tree,triangular,truncate,unbranched,vein,violet,white,whitish,yellow	-3,-4,-50,0-,1,1-1.5,1-2,1-3,1.5-2,1.5-2.5,15-35,2,2-3,2-4,2.5-20,2.5-5,3,3-18,3-foliat,3.5-4,4-45,7-15,8-16,absent,acute,aggregate,ape,apiculate,articulated,axe,basal,base,beyond,blade,calyx,capitat,cell,chartaceous,connivent,cordate,cuneate,deltate,dilated,directed,distally,eaf,eed,entire,equal,exceeding,exserted,finely,hair,laterally,leaving,less,lobe,lon,long,lower,margin,near,nflorescence,nther,obtuse,orolla,ovoid,pedicellar,perfect,pilo,pore,presence,present,radiu,rather,remnant,ruit,slightly,small,somewhat,spaced,stamen,stone,tal,tem,thecae,time,tomento,tube,ud,unit,unknow,vary,wide,x,yello,ympodial	abaxial,adaxial,anther,arrangement,capitate,color,colour,corolla,form,growth,height,history,inflorescence,leaf,length,life,na,ovary,perennial,plant,position,seed,shape,spacing,stem,surface,texture,width
136	wfo-0001026754	success	176	98	78	98	20	0.443	-6+,0.9-1.1,1,1-,1.5-3,1/2,10,2,2-2.5,2/3,5,5-lobed,9,abaxially,acute,along,anther,apex,axi,base,berry,branched,clavate,cm,corolla,deeply,dendritic,densely,diameter,elliptic,entire,filament,flower,glabrous,globose,growth,inflorescence,irregularly,lamina,later,lateral,leaf,lobed,many,margin,membranous,minute,minutely,mixture,mm,narrowly,pedicel,peduncle,petiole,pubescent,scandent,simple,spaced,sparsely,stellate-rotate,stem,stigma,style,surface,terminal,time,transparent,trichome,tube,uniseriate,vein,vine,way,white,woody,x,yellow,yellowish	.5,0.5,0.5-1,198.,2-3,2-4,2.5-3.5,3-4-celled,30+,4-5,5-merou,5.5-9,7-9,9-11,adaxially,ag,alyx,anthesi,apar,apparently,ark,articulated,asymmetric,basal,broadly,brow,cabrera,calyx,complete,conical,connivent,cucullat,denser,distal,divided,eaf,ed,ellipsoid,especially,exerted,extending,fide,free,half,halfway,ilament,leaving,lengthening,like,lobe,long,loosely,lower,mature,midvein,mostly,new,nflorescence,oblique,older,orolla,outline,pair,papillo,peg,perfect,pinnate,planar,plurifoliat,pore,poricidal,portion,primary,puberulent,ruit,scar,seen,sleeve,slender,slit,small,sometimes,splitting,spreading,tangled,tem,tip,truncate,tub,twinin,twining,ud,unit,upper,vary,weak,within,ympodial	5-merous,abaxial,adaxial,apart,arrangement,bark,branching,brown,color,colour,form,fruit,length,na,ovary,seed,shape,spacing,texture,width
137	wfo-0001026756	success	147	95	70	77	25	0.476	.25,.5,0.5-1,0.5-3,1-2,1.5-10,1.8-3,3-4,5-10,abaxial,acute,along,anther,apex,attenuate,bark,base,bilobed,brown,closely,cm,corolla,dark,densely,denser,difoliate,elliptic,filament,glabrous,globose,green,hard,leaf,lobed,minutely,mm,nearly,opposite,ovary,ovate,ovoid-reniform,pale,pedicel,petiole,pinkish-white,pitted,pore,poricidal,pubescent,scar,shape,shaped,shrub,simple,spaced,sparsely,stem,stigma,style,surface,tear-drop,thick,tip,tree,trichome,tube,unifoliate,vein,white,woody	0-7-1.2,0.25-0.5,1-1.5,1.5-1.7,1.5-2,1.5-3,3.5-8.5,5-10-flowered,5-5.5,6-10,6-16,abaxially,adaxially,anthesi,apiculate,ba,berry,broadly,calyx,conical,corresponding,deflexed,deltate,dendritic,dia,differing,distal,eaf,edicel,eed,erect,exserted,fleshy,free,fruiting,geminat,glabrescent,grayish-brow,inflorescenc,irregular,lamina,lateral,lax,like,lobe,long,lower,main,major,middle,minor,nflorescence,occasionally,older,overlappin,pair,papillo,perhaps,pericarp,planar,portion,present,pubescence,rest,ruit,somewhat,soon,strongly,tall,tub,ud,uniseriate,unit,wide,widest,ympodial,young	adaxial,arrangement,bud,color,density,diameter,form,fruit,geminate,grayish-brown,growth,height,history,inflorescence,length,life,na,overlapping,papillose,plant,position,seed,spacing,texture,width
138	wfo-0001026777	success	168	103	76	92	27	0.452	0.25-0.5,0.5-1.5,0.5-5,1-1.3,1-10,1-4,1.2-1.8,2-4.5,3-3.5,5-7,acuminate,acute,anther,apart,apex,base,beneath,blue,branching,brown,calyx,capitate,cm,corolla,decurrent,deflexed,elliptic,exserted,fide,filament,filiform,flattened-reniform,flexuous,glabrous,globose,green,growth,incrassate,leaf,lobed,long,margin,mm,narrowly,nearly,occasionally,onto,opposite,outline,ovary,pedicel,petiole,pitted,pore,pubescent,russet,scar,seed,shaped,shiny,shrub,sinuate,slightly,smooth,soon,sparsely,stigma,style,surface,tear-drop,trichome,tube,tuft,uniseriate,vellozo,white	.25,.5,/3,0.5-1,0.9-3,1-1.5,1-2,1.5-3,1.5-5,2-4,2-5,4-8,5-14,5-50-flowered,anthesi,apiculate,axil,ba,beginning,berry,body,campanulate,cell,cup,dense,dia,differing,difoliate,distal,eaf,edicel,eed,end,flattened,free,fruiting,geminat,glabrate,greyi,hyaline,inflorescenc,irregularly,lateral,like,lobe,lon,lower,main,major,matted,middle,minor,minutely,near,new,nflorescence,often,older,one,overtopping,pair,papillo,papillose,planar,poricidal,portion,prominent,quadrate-deltoid,quite,rest,ruit,size,somewhat,spaced,stem,straight,tall,tapering,testa,thread-like,tip,ud,unit,vein,wall,way,widest,woody,x,yellowish,ympodial,young	0.25,abaxial,bud,color,decurrence,diameter,exsertion,feature,flower,form,fruit,height,history,inflorescence,length,life,na,peduncle,perennial,plant,position,rachi,shape,spacing,staman,texture,width
139	wfo-0001026782	success	206	117	90	116	27	0.437	-4,0.5-1,0–1,0–10,1,1-1.5,1.3,1.5,1.5–2.5,1/3–1/2,10–15,1–5,2-5,2–4,3.5–8.5,4–9,8-10,abaxially,acute,adaxially,annual,anther,anthesi,apex,blue,bluish,brown,cm,dark,darker,deltoid,densely,diameter,divided,filament,finely,flower,fruit,glabrous,globose,green,greenish,hair,herb,immature,internode,irregularly,length,light,lilac,lobe,margin,maturity,midpoint,midrib,mm,mottling,nearly,obtuse,ovate,pair,pedicel,peduncle,petiole,porrect-stellate,pubescent,purple,pustulate,rachi,ray,reniform,rotate-campanulate,sessile,shorter,simple,somewhat,sparsely,stellate-tomentose,stem,stigma,style,surface,thick-stalked,tomentose,unbranched,way,white,x,yellow,yellowish-brown	-10,-5,0.5,0.5-2,1.4–2,1.8–3,15,1–3,2,2-foliate,3,3-4,3–12,4,4–10-rayed,4–13,4–6-rayed,5,6,6-7,7,abundant,abundantly,accrescent,acicular,adaxiall,additional,apiculate,armed,articulate,axe,base,becoming,berr,blade,calyx,clavat,clustered,coarse,commonly,cordate,curved,dehiscent,dilated,eaf,eed,enclosing,exceeding,except,fertile,fruiting,geminat,glabrou,gland-tipped,gradually,interpetalar,larger,like,lon,long,lower,lowermost,main,male,minute,much,much-branched,narrowly,nflorescence,numerous,often,one,orolla,partially,perfect,pore,prickle,pubescence,radiu,rarely,ruit,shallow,short,slightly,small,smaller,spreading,stalk,staminate,ste,stellae,stellate,stellate-pubescent,stipitate,straight,strongly,tall,tamen,tapered,tem,terminal,thin-textured,tip,tissue,tooth,triangular,tube,two,upper,upward,vary,vein,woody,ympodia,–5,–6	3-10,abaxial,adaxial,arrangement,branching,clavate,color,colour,corolla,form,growth,height,history,inflorescence,leaf,life,na,ovary,plant,position,seed,shape,spacing,staman,texture,type,width
140	wfo-0001026788	success	291	111	81	210	30	0.278	1/3,2.0,2/3,4,4.0,abaxially,acute,adaxially,aequilateral,alveolate,anther,apex,attachment,base,blade,broadly,chartaceous,cm,corolla,densely,diameter,distal,entire,erect,extra-axillary,filament,flattened-orbicular,flattened-reniform,flexed,flower,fruit,glabrous,globose,lanceolate,lateral,leaf,margin,midpoint,mm,moderately,nearly,notched,oblique,orange,oval,ovate,pedicel,peduncle,petiole,point,prickle,proximal,pubescent,ray,retrorse,rounded,scandent,shrub,simple,sinuate,slightly,small,sometimes,sparsely,stellae,stellate,stem,stigma,style,subcoriaceous,surface,tree,triangular,white,yellow,yellow-ferruginous,yellow-tan,±90°,±dense,±glabrous,×	.0,.04,.05,.3,/3,0.2–0.3,0.3–0.4,0.3–0.5,0.4–0.6,0.4–0.7,0.5–0.7,0.5–0.8,0.6–1.0,0.6–1.3,0.6–1.9,0.8–1.1,0.8–1.8,0.9–1.2,0.9–1.3,0.9–2.0,0–,1.0–1.5,1.0–2.0,1.1–1.3,1.2–1.6,1.2–1.7,1.3–1.6,1.3–1.8,1.3–2.5,1.4–2.2,1.5–1.9,1.5–2.2,1.7,1.7–1.9,1/4–1/3,10.8,1–3,2.1–2.9,2.5–11.0,2.7–5.7,2.8–3.1,2.9–4.0,2/3s,2–3,3,3.0,3.4,3.8,3.8–4.9,4.6–6.0,4–7,4–8,5,5-merou,6.4,7.0–8.9,7.8–11.0,8,8.3–10.9,8.5,90°,absent,acuminate,adjacent,adnate,ag,alyx,anthesi,apart,apical,apparently,appearing,appressed,around,articulate,attenuate,axe,ba,bark,basal,based,becoming,berry,branch,branching,broad,broad-based,brochidodromous,brown,bud,calyx,capitat,channeled,clinate,connivent,curved,deciduous,deflexed,deltoid,dentate,developed,development,difoliate,directed,distally,distinct,distinctly,dry,eaf,edge,eed,either,emerging,evenly,exocarp,extending,fertile,filiform,flat,free,geminat,glandular,glossy,gradually,hair,homostylous,hort,increasing,incurved,intact,internode,interpetalar,intersepalar,juic,layer,laying,less,lobe,lobed,lon,long,longer,lower,many,markedly,mature,midrib,midvein,minute,nflorescence,occasionally,opaque,orolla,per,perforated,pore,porrect,porrect-stellate,portion,potentially,presen,primary,raised,reddish,reflexe,remaining,restricted,rigid,row,ruit,scarcely,scattered,sessile,shoot,side,sigmoid,sinus,sloughing,smoot,somewhat,soon,spaced,splitting,spread,stamen,stellate-pubescent,straight,suture,swelling,tamen,tem,thin,time,tissue,transparent,tube,two,ud,unarmed,unbranched,upper,vary,vein,weakly,well,wide,yellow-ferruginou,ympodia,young,±equal	0-2.5-11.0,0.6-1.9,1.0-1.5,1.2-1.6,1.7-1.9,3.8-4.9,7.8-11.0,abaxial,adaxial,arrangement,capitate,color,colour,form,growth,height,history,inflorescence,length,life,na,ovary,perennial,plant,position,seed,shape,staman,texture,width
141	wfo-0001026790	success	236	127	102	134	25	0.432	-1/2,-11,-19,-4,-40,0-10,0-5,0.2-0.4,0.2-0.6,0.2-1.5,0.2-2,0.5-2,0.5-4,0.6-10,0.7-3,0.8,1-1.5,1.8-4,1/4,1/4-1/2,2-3,2-7,2.5-4.5,3.5-17,4-9,6.5-9,abaxially,acute,anther,apart,apex,base,berry,blade,brown-green,cm,conical,cordate,cream,curved,dark,densely,diameter,distance,dull,elliptic,erect,filament,flattened,flattened-reniform,flower,fruit,glabrous,green,lanceolate,lateral,leaf,length,lobed,long,long-styled,marking,maturity,mauve,midpoint,midvein,mm,moderately,near,orange-brown,ovate,pale,pedicel,peduncle,petiole,plant,porrect,prickle,ray,red-brown,reduced,rounded,sessile,short-styled,shrub,sparsely,spherical,stalked,stellate,stellate-pubescent,stem,straight,style,surface,terminal,trichome,upper,way,wide,yellow,yellow-green,young	-1/3,-10,-2,-3,-6,-merous,0,0-150,0-20,0-30,0.2,0.7-1.5,1,1-2,1-3,1.5,1.5-2.5,1.5-3,1.5-4,1.5-5,1.9-2.6,1/2-3/,1/5-1/3,1/6-1/4,2,2-,2-11,2-30,2-5,2.7-3.2,4-,4-11,4-7,5,5-10,5-9,6-12,6-8,7-12,7-13,7-15,7-20,acuminat,adaxially,alyx,ame,andromonoecious,apar,apically,apparently,articulated,bark,becoming,branched,broad-deltate,c.,calyx,chartaceous,concolorous,connivent,deltate,discolorous,drying,eaf,eed,elongated,elongating,entire,equal,extending,free,fruiting,gently,glandular,green-brown,hair,heterostylous,inflorescenc,infructescence,lobe,longer,lower,margin,mature,minute,narrow-deltate,nflorescence,obtuse,older,one,open,orolla,oung,pair,pendulous,per,pericarp,plurifoliat,poricidal,portion,prickly,primary,red-brow,reflexed,ruit,scar,side,simple,smooth,sometimes,spaced,spreading,stalk,stout,tamen,tapering,terete,tertiary,time,tip,toward,tube,unarme,unarmed,unit,usually,variously,vary,vein,venation,visible,weakly,woody,ympodial	abaxial,adaxial,arrangement,color,colour,corolla,form,growth,height,history,inflorescence,life,na,ovary,perennial,plurifoliate,position,rachi,seed,shape,spacing,staman,stigma,texture,width
142	wfo-0001026818	success	252	119	95	157	24	0.377	-1.5,-15,-3,-4.5,0-1,0-1.5,0.3-1,0.3-2.5,0.5-1,0.7-2,1.8-3.5,2.5-4,5-12,5-15,6.5-9.5,7-15,8-11,abaxially,accrescent,acute,adaxially,anther,apart,apex,base,branched,broadly,calyx,closely,cm,covering,densely,density,diameter,elliptic,elliptic-ovate,erect,extra-axillary,felty-pubescent,filament,flower,fruit,fruiting,glabrous,globose,hair,inflorescence,lateral,leaf-opposed,length,lenticular,like,long,midpoint,minutely,mm,obtuse,orange,orange-red,outline,pedicel,peduncle,perennial,perfect,petiole,pitted,prickle,pubescent,rachi,ray,reniform-ovate,ripe,sessile,simple,size,somewhat,spaced,spreading-hirsute,spreadingly,stellae,stellate,stellate-pubescent,stem,stigma,style,surface,tan,thickened,thin-textured,truncate,unbranched,variable,white,x,yellow	-2,-2.5,-7,0.1-0.3,0.3-0.8,0.5-1.5,0.5-2.5,1,1-4,1.5-,1/3,2,2-15,2-3,2-4,2-4.5,2-foliate,2.5-5,2.7-4,3-5,4-10,4-6,4-7,5-11,5-20,5-9,6-10,7-30,7-50,8-15,abrupt,abundant,acute-,adaxiall,along,always,apparent,articulated,ascending,attenuate,average,axe,ba,becoming,blade,broad-based,campanulate,capitat,capitate-glandular,cast,cauline,class,coarsely,commonly,compresse,connivent,cordate,cream,cylindrical,deltoid,dentate,depressed-deltoid,directed,distal,distall,distinct,eaf,eed,elongate,entire,equaling,especially,essentially,female-sterile,foliar,frui,geminate,grading,inserted,interlobal,lanceolate,large-leaved,larger,largest,laterally,less,lignescent,lobe,longest,lower,major,margin,maturit,mesocarp,middle,midrib,mixture,mostly,multiseriate,nearly,nflorescence,numerous,oblique,obtuse-,occasionally,often,one,orolla,oung,ovate,ovate-lanceolate,per,persistent,pore,prickly,principal,prominent,pubescence,purplish,radiu,round-tipped,ruit,scattered,shallowly,short,shorter,side,similar,sinus,smaller,sometimes,sparse,sparsely,spreading,stalk,stalked,ste,stipitate,tal,tamen,termination,time,tooth-like,transition,trichome,tube,two,unarmed,unit,usually,vary,vein,vivo,weakly,wide,yellowish,ympodial	abaxial,adaxial,arrangement,capitate,color,colour,corolla,form,growth,height,history,leaf,life,na,ovary,plant,position,seed,shape,spacing,staman,stipulate,texture,width
143	wfo-0001026819	success	218	134	108	110	26	0.495	0-27,0.3-4.7,0.5-1.5,1-10,1-2,1.2-36,1.5-10,1.5-12,1.5-3.0,10-26,2.5-5,3-120,3-18,4-7,5-30,6-11,abaxially,adaxially,along,anther,apart,blue,broadly,brownish,bud,capitate,cell,chartaceous,ciliate,cm,condition,corolla,covering,dark,densely,diameter,dot,drying,elliptic,especially,filament,flower,forked,fresh,fruit,glabrous,glaucous,globose,green,green-white,greenish,hair,hair-like,herb,interjected,lanceolate,lateral,leaflet,light,like,lunate,make,margin,membranous,midvein,minutely,mm,moderately,mucilaginous,narrowly,odd-pinnate,ovate,ovoid,pedicel,peduncle,pentagonal,petiole,plant,puberulent,pubescent,purple,rotate-pentagonal,scale-like,scattered,seed,slightly,sometimes,stem,stigma,stripe,style,subglabrous,suborbicular,subtending,terminal,testal,thick,throughout,tinged,tip,tuber,usually,violet,wall,wet,white,whitish,yellow	1-2.3,1-5,1.5-3.3,1.5-3.5,1.6-3.5,10,2-5,2-6,3-20,3-35,3-38,4,4-10,5-merou,7,absent,acumen,acuminate,acute,ag,alyx,apex,articulated,ascending,attenuate,base,bearing,blade,borne,clavat,connate,connivent,cuneate,curved,decurrent,digestion,distal,dorsally,eaf,edge,eed,end,enzyme,erec,exceeding,flat,folded,geminat,generally,glabrou,greatly,greenish-yellow,half,homostylous,honeycomb-shaped,larger,lengthening,living,lobe,long,lower,middle,mottled,nflorescence,non-glandular,oblique,often,orolla,pair,pedice,petiolule,plurifoliate,pore,poricidal,rachi,ranging,removed,ruit,seudostipule,short,singly,slit,somewhat,spaced,specimen,stamen,star,ste,stolo,straight,subequal,subrosette,symmetrical,tall,tamen,tem,tertiary,therefore,tri-,truncate,tube,typically,unit,unwinged,vary,wide,wing,within,without,ympodial	2,abaxial,adaxial,arrangement,clavate,color,colour,form,growth,height,history,inflorescence,leaf,length,life,na,ovary,perennial,position,pseudostipule,shape,spacing,staman,surface,texture,width
144	wfo-0001026821	invalid_json_followup	204	124	88	116	36	0.431	.2,0.3-1.2,0.3-2.5,0.4-1.5,0.7-1.8,0.8-1,1-1.5,1-20,1-5,10-15,2-15,2-3.5,2-6,2.5-18,3-branched,4-4.5,5-10,5-12,abaxially,acuminate,adaxial,adaxially,angular,anther,apart,apex,appressed,auriculate,broadly,brown,chartaceous,cm,dark,diameter,due,ellipsoidal,elliptic,filament,flattened,flower,forked,fruit,gglobose,glabrous,green,herb,homostylous,lanceolate,lateral,leaf-opposed,length,light,long-attenuate,mature,mm,moderately,narrowly,obliquely,obtuse,odd-pinnate,pale,pedicel,peduncle,petiole,pilose,pubescent,rachi,rarely,remnant,reniform,slender,small,somewhat,sparsely,stellate,stigma,stripe,style,subglabrous,substellate,surface,thickening,unbranched,wall,white,winged,x,yellow	/3,0-20,0.2-1.5,0.5-1.2,0.5-3.5,1-2,1-3,1.2-1.5,1.5-2.5,17,1977,2-celled,3-11,3-18,3-6,3-7,3-celled,5-20,5-34,5-merou,acut,ag,alyx,anderson,apical,apically,apiculate,articulated,axe,ba,basal,base,bayonet,berry,blade,bract,cell,ciliat,cordate,cuneate,deltate,directed,distal,distally,eaf,eed,equal,especially,exceeding,frequent,fused,geminat,glabrou,gland-tipped,greatly,hair,incurved,interjected,interstaminal,large,leaflet,lobe,long,longitudinal,lower,lowermost,many,margin,mean,membrane,membranous,minute,minutely,much,nflorescence,oblique,oblong,occasional,occasionally,one-celled,opening,orolla,pair,paired,per,perfect,petiolule,plurifoliate,pore,present,pseudostipular,puberulent,pubescen,reduced,rounded,ruit,scandent,seudostipule,short,slightly,slit,smaller,spaced,stamen,subtended,tamen,tem,terminal,time,tri-,truncat,tube,unit,vary,wide,ympodial	'','puberulent,5-merous,[,],``,abaxial,arrangement,characteristic,color,colour,corolla,form,growth,height,history,inflorescence,leaf,life,na,ovary,perennial,plant,position,pseudostipule,seed,shape,spacing,staman,stem,texture,truncate,value,width,{,}
145	wfo-0001026827	success	143	101	85	58	16	0.594	.5,/3,0.2-0.5,0.4-0.6,0.5-2,1-1.1,1-1.5,1-2,1.3-1.6,1.5-2,2-2.2,5-6,7-9,abaxially,acute,age,anther,anthesi,apart,apex,attenuate,bark,base,branched,clavate,cm,conical,corolla,dendritic,densely,diameter,distally,ellipsoid,especially,filament,glabrous,growth,inflorescence,internodal,lanceolate,leaf,lengthening,less,like,lobed,margin,minutely,mm,narrowly,nodding,oblanceolate,ovary,pair,papillate,pedicel,peduncle,petiole,plane,pore,poricidal,primary,pubescent,rachi,reddish,revolute,scar,shrub,simple,sinus,slender,slit,sparsely,stem,stigma,stout,style,surface,tip,trichome,tube,uniseriate,vein,way,white,x	0.6-1,1-,1-2.1,2-2.5,2-4,3-9,?,adaxiall,and/or,appearing,arachnoid,branch,broadly,calyx,crowded,deciduou,deltate,dense,dry,drying,eaf,erect,exerted,fleshy,flower,free,glabrescent,irregularly,know,known,lamina,lobe,lower,near,new,nflorescence,ot,paler,papillat,perfect,planar,plurifoliat,portion,small,soon,straight,strongly,surfac,terminal,thick,thickened,third,tub,ud,unit,upper,widest,ympodial	abaxial,adaxial,adaxially,arrangement,bud,colour,form,height,length,na,number,plant,position,shape,spacing,texture
146	wfo-0001026830	success	198	112	84	114	28	0.424	0.3-1.3,0.4-1,0.5-1.0,1-10,1-11,1-2,1.5-4,10-57,2.5-5,4-7,4.5-17.5,6-13,7-18,abaxially,acuminate,acute,adaxially,along,anther,apart,apex,bead,cell,clavate,cm,condition,coriaceous,corolla,deep,diameter,distal,edge,elliptic,filament,flat,flower,forked,fruit,glabrescent,glabrous,globose,green,greenish,half,herb,homostylous,honeycomb,leaf,lengthening,light,like,medium,mm,moniliform,mucilaginous,necklace,odd-pinnate,ovate,ovoid,pedicel,peduncle,pentagonal,petiole,plant,poricidal,purple,rotate,seed,shaped,slit,stigma,stolon,stripe,style,subglabrous,terminal,testal,tip,tuber,wet,white,whitish,yellow,yellowish	0-10,0.5-1.2,0.9-1.9,1.1-2.7,1.4-4,2-4,2-6,2.5-4.4,2.7-8,3.5-8.5,4-10,4-14.5,4.4-14.5,5-11,5-merou,acumen,adaxiall,ag,alyx,apparently,arranged,articulated,asymmetric,attenuate,axe,axillary,base,basiscopic,berry,blade,brown,brownish,bud,capitat,ciliate,connivent,covering,decreasing,digestion,dorsally,drying,eaf,eed,enzyme,erec,exceeding,finely,folded,fresh,geminat,generally,glabrou,green-white,hair,hair-like,hal,high,interjected,lanceolate,lateral,leaflet,linear,living,lobe,long,lower,make,margin,moderately,multiple,nflorescence,orbicular,orolla,pair,perfect,petiolulate,plurifoliate,pore,puberulent,pubescent,removed,ripe,rounded,ruit,sessile,seudostipule,short,side,simple,size,spaced,specimen,stamen,straight,subequal,subglabrou,subtending,tall,tamen,tem,thick,throughout,tissue,toward,tri-,tube,typically,unit,unwinged,usually,vary,wall,x,ympodial	abaxial,adaxial,age,arrangement,capitate,color,colour,form,growth,height,history,inflorescence,length,life,na,number,ovary,perennial,position,pseudostipule,rachi,shape,spacing,staman,stem,surface,texture,width
147	wfo-0001026831	success	207	123	96	111	27	0.464	-5,.5,0-6,0.1,0.2-1,0.3-0.65,0.5-1.2,0.6,1-10,1-2,1-2.2,1-2.5,1-6,1/3,2-4,3-5,3-6,5-merous,abaxially,acute,anther,apart,apex,apparently,attenuate,bark,base,berry,branched,bright,cell,cm,cream,curved,dark,densely,diameter,dull,elliptic,erect,filament,flattened-reniform,flower,fruit,glabrescent,glabrous,gray-brown,green,lateral,leaf,length,lobed,long,margin,marking,maturity,mauve,mm,moderately,multangulate,narrow-cuneate,occasionally,orange,orange-brown,outline,pair,pale,pedicel,peduncle,petiole,porrect,prickle,raised,red-brown,rounded,scandent,scar,sessile,shiny,shrub,smooth,sometimes,spherical,stellate-pubescent,stem,style,subsessile,surface,trichome,upper,vein,white,white-gray,yellow,yellow-green,young	-0.25,-6.5,-9,/4,0-10,0-20,0-3,0.1-0.2,0.1-0.25,0.15-0.25,0.2-0.4,0.3-0.6,0.6-2,0.65-1,0.7-1.1,0.7-2,1-3,1-4,1.2-2,1.5-2.5,1/3-1/,1/3-2/3,1/5-1/4,2-2.5,2-3,2.3-2.9,2.5-4.5,3.5-10,7-10,7-8,alyx,apar,apically,articulated,blade,broad-deltate,brow,calyx,caudat,chartaceous,concolorous,connivent,deltate,difoliate,distance,drying,eaf,eed,elongating,equal,extending,eye,free,fruiting,fully,geminat,herbaceous,infructescence,less,lobe,longer,lower,mature,membranous,midpoint,midvein,naked,nflorescence,oblong,older,one,open,opening,orolla,oung,ovate,pendulous,per,perfec,pericarp,poricidal,portion,prickl,prickly,primary,ray,reduced,ruit,shorter,side,slender,spaced,sparsely,spreading,stalk,stellate,tamen,tapering,terete,tertiary,time,tip,tube,unit,usually,vary,venation,visible,way,wide,ympodial	abaxial,adaxial,arrangement,branching,brown,color,colour,corolla,form,growth,height,history,inflorescence,life,na,ovary,perennial,plant,position,rachi,seed,shape,spacing,staman,stigma,texture,width
148	wfo-0001026841	success	139	82	50	89	32	0.36	0.25-0.3,0.5-0.75,0.5-2,0.75-1,0.8-1,0.8-3,1.5,1.5-2,2-2.5,3.5-5,4-8,6-8,acute,anther,apart,apex,bark,bi-lobed,clavate,cm,corolla,curly-tipped,elliptic,filament,fruiting,glabrous,globose,green,inflorescence,leaf,lobed,margin,mm,opposite,ovary,pedicel,petiole,pubescent,shining,shrub,simple,sparsely,stem,stigma,style,trichome,uniseriate,white,woody,x	.25,.5,/4,0.05,0.25-0.5,0.5-1,0.6-1,3-6.5,5-8-flowered,7-9,9.2-18,along,anthesi,arch,axi,ba,base,beneath,berry,broadly,calyx,conical,coroll,decurrent,deflexed,deltoid,dia,eaf,edicel,eed,ellipsoid,exsertion,filiform,free,glabrate,greyish-gree,hyaline,immature,joined,known,later,lateral,like,lobe,lon,long,lower,main,middle,minutely,nflorescence,older,pair,paler,papillo,papillose,pore,poricidal,portion,prominent,raised,reddish,reflexed,rest,ruit,scar,series,shaped,slender,slightly,spaced,straight,tall,tapering,tear-drop,terminal,thickened,tip,tube,ud,unevenly,unifoliat,unit,vein,way,widest,winged,ympodial,young	0.5,abaxial,adaxial,arrangement,branching,color,colour,diameter,flower,form,fruit,greyish-green,growth,height,history,length,life,na,peduncle,perennial,plant,position,prickle,rachi,seed,shape,spacing,staman,surface,texture,unifoliate,width
149	wfo-0001026849	success	180	107	79	101	28	0.439	0-10,0.5-1,1,1-2,1-6,2-3,38/2,5,637/2,7-8,acute,anther,apex,aster,axil,brown,calyx,capitate,cm,colour,conical,corolla,cyme,discoidal,distinctly,ellipsoid,expanded,filament,filled,flower,flowered,fork,fruiting,glabrous,glandular,globose,granule,green,grey-brown,growth,hair,inflorescence,lavender,leaf,margin,mature,minute,minutely,mm,oblong-lanceolate,ovary,pale,pedicel,peduncle,petiole,preparation,reproducing,reticulate,rh,rotate,rounded,sea,seed,shed,short-lived,shrub,simple,slightly,stem,stigma,stony,style,surface,tip,undulate,vegetatively,violet,well,young	-50,1-1.5,1.5-2.5,1.75-2,100-130,11,2,30-,40,5-10,80-,adherent,adult,amongst,appearing,aspect,australian,base,berry,cell,composed,conspicuous,curved,cut,deflexed,developed,dia,distinct,eed,emarginate,enlarge,entire,erect,exceeding,except,exerted,facetted,flesh,floral,free,general,globular,greater,gree,half,interacuminal,large,leave,lengthening,less,linear-lanceolate,little,lobe,lon,long,long-cuneate,loosely,lower,maturity,mid-vein,native,nflorescence,oblong,occasionally,often,pal,pedicellate,petal,plurifoliat,pore,poricidal,pruinose,purple,rarely,relatively,rhachi,ruit,ruiting,shallow,sinus,slende,slit,soft-wooded,solanum,solitary,sometimes,somewhat,soon,stone,stout,thus,tissue,tub,tube,ud,unarmed,unit,uvenile,way,x,ympodial	abaxial,adaxial,arrangement,bark,branching,bud,color,diameter,enlarged,form,fruit,height,history,length,life,na,plant,plurifoliate,position,prickle,rachi,reproduction,shape,spacing,staman,texture,trichome,width
150	wfo-0001026851	success	267	128	89	178	39	0.333	-2,.8,4-5,5,5-merous,abaxial,acicular,acute,adaxial,almost,andromonoecious,anther,apex,armed,base,berry,bilobed,bright,broadly,capitate,circular,cm,conspicuous,dark,diameter,dot,entire,evenly,fading,filament,flattened,flower,fruit,glabrous,gland,globose,glossy,greenish,hair,heterostylous,hyaline,inside,irregularly,lateral,leaf,less,light,lighter,lobe,lobed,long,long-styled,matte,membranous,minute,mm,orange,outside,ovate,pedicel,peduncle,petiole,pilose,plant,prickle,pubescent,scattered,sessile,shrub,simple,slightly,sparsely,stellate,stipitate,straight,straw-colored,style,suborbicular,surface,tip,trichome,unbranched,uniform,way,white,wide,wing,winged,yellow	-celled,.4,0.3–1,0.8–1.5,0–1,1,1-7,1.5,1.5–2,1.5–2.8,10-15,15,175–415,1979,1–4.5,1–7,2,2.2–3.6,2.5–4,2/3,2–10,2–3,2–3.5,300,3–3.6,3–5,4–5-celled,4–6,4–6-celled,5–6.5,5–7-celled,6–11,7–12,8–10.5,8–15,=,abaxiall,abundant,alyx,apar,appearing,articulated,average,ba,becoming,blade,branched,c.,calyx,ciliate,coarse,coarsely,coil,complete,connivent,conspicuously,cordate,curve,densely,dentate,difoliate,directed,distall,distally,eaf,eed,elongating,endocarp,enlarged,equal,exceeding,except,eye,fertile,fide,fine,flexuous,free,fruiting,geminat,grading,gradually,green,heavily,infructescence,lacking,large,larger,lenticel,little,live,lower,major,making,margin,merely,midrib,minor,minutely,moderately,mostly,much,n,naked,narrowly,near,nearly,nee,nflorescence,occasionally,often,one,orolla,otherwise,oung,pair,papillo,pattern,per,pericarp,pore,poricidal,portion,preserved,prickly,pubescence,recurved,reflexed,rest,ruit,sap,scanden,scant,scar,scarious,shiny,short-styled,similar,size,slender,small,smaller,sometimes,somewhat,spaced,specimen,speckled,spongy,sprawling,spreading,stamen,staminat,stem,stipitate-glandular,tall,tamen,tapering,tasteles,terete,thick,thickened,tooth,tough,triangular,tube,twice,unarmed,unit,usually,vary,vein,visible,watery,well,yellowish,ympodial,–13,–2	-13,/4,0-1,0.3-1,0.8-1.5,1.5-2,1.5-2.8,2-10,2-3,2.2-3.6,4-5-celled,4-6,5-6.5,5-7-celled,abaxially,apart,arrangement,color,colour,corolla,form,growth,height,history,inflorescence,length,life,na,ovary,perennial,position,rachi,reproduction,seed,shape,spacing,staman,texture,width
151	wfo-0001026858	invalid_json_followup	153	103	66	87	37	0.431	0.8,1-11.5,1-4,1.3-1.5,1.5-4,3-4,6-10,6-7,abaxially,adaxially,apex,articulate,base,branched,cell,cm,corolla,covering,cyme,diameter,dichasial,dichasially,digestion,distal,ebracteate,enzyme,filament,flower,glabrescent,glabrous,globose,green,green-white,half,herbaceous,honeycomb,lateral,leaf,light,long,mm,monochasial,mucilaginous,odd-pinnate,ovate,ovate-lanceolate,ovoid,pattern,pedicel,peduncle,perennial,petiole,plant,proximal,seed,shiny,size,stellate,stigma,style,testal,thick,throughout,wall,yellow,¼	-30,-4,0-.,0.5,0.8-1,1-,1-10,1-5,2-2.5,2-3,2-4,2.5-3,3-,3-6-foliat,4-24,4.5-10.5,5-15,6-18,abruptly,acumen,acute,apical,apically,calyx,connate,cordate,cuneate,dehiscent,diminishing,dorsally,eaf,edge,eed,emoval,exceeding,flat,folded,forked,generally,globo,hair-like,interjected,introrse,leaflet,living,lobe,lon,lower,lunat,make,maturing,minute,mucronate,nflorescence,nther,oblique,oblong,obtuse,often,orolla,pair,perfect,plan,poricidally,reveal,rounded,ruit,seudostipule,short,slightly,slit,specimen,stamen,straight,tal,tem,throughou,toward,triangular,tuber-bearing,typically,unit,vary,white-crea,wide,without,ympodial	'','hair-like,[,],``,abaxial,adaxial,anther,arrangement,characteristic,color,colour,form,fruit,growth,height,history,inflorescence,length,life,na,ovary,position,rachi,removal,reproduction,shape,spacing,staman,surface,texture,value,wet,white-cream,width,{,}
152	wfo-0001026870	success	206	105	87	119	18	0.422	0.4-0.8,0.5-1,0.7-1.4,1-11,1.4-1.8,140-600,2-3,2-3.5,2-6,2.5-12,3-12,4-5,4-7,9.5-12,acicular,acute,anther,apex,articulated,base,black,broad-based,brown,brownish,chartaceous,cm,color,cuneate,deeply,densely,diameter,dioecious,elliptical,erect,extra-axillary,female,filament,finely,flower,forked,fruit,glabrous,globose,grey,grey-green,index,inflorescence,length,lobed,lobing,male,margin,mm,oblique,obtuse,ovate,ovate-reniform,part,pedicel,peduncle,per,perennial,petiole,plant,present,prickle,pseudo-racemose,purple,reticulate,rhizomatous,ridged,rotate,rotate-stellate,rusty,shrub,solitary,stellate-pubescent,stem,stigma,straight,style,surface,terete,throughout,unknown,white,yellow	%,.05,.5,0,0-0.1,0-1,0.05-0.15,0.2-0.35,0.2-1.2,0.25-0.4,0.25-0.5,0.3-0.4,0.7-2,1,1-4,1-5,1.5-2,1.9-3,10-14,11-14,12-28,15-25,18-30,2-5,2-7,2-foliate,3-10,3-5,300-600,4-9,5-7.5,5-merou,6-70,7-11,7-8,abaxially,absent,abundant,accrescent,adaxiall,adaxially,alyx,apart,armed,ascending,axe,ba,basal,blade,broadly,calyx,cylindrical,d.,deltate,diamete,directed,distal,distall,distributed,dult,eaf,eed,eglandular,enclosing,finger,flattened,fruiting,functional,geminat,glabrou,gland-tipped,hair,heterostylous,interpetalar,lamina,lanceolate,lateral,lobe,lon,long,longer,lower,mature,midpoint,midvein,minute,nflorescence,orolla,pore,porrect,presen,probably,ray,ruit,sessile,short,side,simple,spaced,stage,stalk,stellae,tal,tamen,thick,time,tissue,triangular,tube,unbranched,unit,unknow,uvenile,vary,vein,wide,x,yellowish,ympodial	abaxial,corolla,distribution,dm,form,growth,height,history,leaf,life,ovary,position,reproduction,seed,shape,spacing,staman,texture
153	wfo-0001026874	success	222	102	72	150	30	0.324	.5,0.5,15-20,2,acuminate,acute,anther,apex,asymmetric,attenuate,based,broad,broadly,cm,colored,compressed,connivent,dark,densely,diameter,drying,filament,flower,foveolate,fruit,glabrate,glabrous,glandular-pubescent,globose,green,growth,hair,internode,juvenile,lanceolate,larger,laterally,leaf,length,lenticular,lighter,like,midrib,mm,orange,ovate,petiole,pinnatifid,prickle,prickly,pubescent,recurved,reddish,ripe,scabrous,shiny,shrub,simple,slender,sparsely,stellate,stellate-pentagonal,stellate-tomentose,stem,stigma,style,surface,tan,thin-textured,upon,x,yellow	.3,0,0-1,0.2–0.6,1.5,1.5–2.5,1.5–4,1.5–5,12–20,1–,1–3,2-foliate,2–2.5,2–3,2–4,2–5,2–6,2–several-branched,3-5,4.5,4–7.5,5.5,5.5–7.5,5–15,6-7,6–12,6–9,8-12,8–20,9.5–11.5,abaxially,absent,across,adaxiall,adaxially,along,apar,apical,axe,basally,base,berry,beset,blade,calyx,capitate,caudate,clavat,deltoid,dense,depressed,developed,eaf,eed,entire,erect,except,filiform,finely,flowering,fruiting,geminat,generally,glabrou,gland,glandular,hermaphroditic,interpetalar,lance,lanceolat,lanceoloid,lateral,lobe,lon,long,lower,main,major,margin,midpoint,midvein,minute,moderately,narrowly,near,new,nflorescence,obtuse,often,orolla,ovoid,pedicel,peduncle,per,perfect,point,pore,portion,present,prominently,pubescen,pubescence,rachi,reduced,repand,rounded,ruit,scattered,sessile,short,side,similar,slightly,small,sometimes,somewhat,spaced,sparse,spreading,stalked,stellae,straight,subulate,swollen,tall,tamen,tem,tip,tipped,tissue,tooth,truncate,tube,ud,unarmed,usually,variable,vary,varying,vein,vestiture,warty,weakly,white,widely,widest,yello,ympodia,–5,–many	1-,1-3,1.5-4,2-3,2-6,2-several-branched,5,5-15,5.5-7.5,9.5-11.5,abaxial,adaxial,arrangement,clavate,color,corolla,form,height,history,inflorescence,life,many,number,ovary,perennial,plant,seed,shape,staman,texture
154	wfo-0001026895	success	166	101	75	91	26	0.452	0.5-1,0.5-1.2,0.5-1.5,0.5-2,0.8-1,1-1.5,1.4-2.1,1.5-2,2-2.3,2.5-3.2,4.5-5,abaxial,acute,adaxial,anther,anthesi,apex,attenuate,base,broadly,brown,campanulate,capitate,closely,cm,conical,corolla,dark,deflexed,deltoid,drying,elliptic,erect,filament,filiform,flattened,fruiting,glabrous,globose,green,hard,internodal,leaf,lobe,lobed,minutely,mm,mustard,narrowly,ovary,pale,pedicel,petiole,pitted,pore,pubescent,reniform,shape,shaped,shrub,shrublet,simple,somewhat,spaced,sparsely,stem,stigma,style,surface,tan,tear-drop,tube,white,woody,yellow	.5,0-0.5,1-5,2-2.5,2-3,2/3,3-12,5-6,5-8-flowered,along,apical,apically,appearing,ba,bark,berry,borne,broad,calyx,contracted,dendritic,denser,dia,differing,difoliate,eaf,edicel,eed,ellipsoid,elongate,free,geminat,glabrate,incrassate,lamina,lateral,like,lon,long,long-exserted,lower,main,major,margin,middle,minor,minute,nflorescence,obovate,often,older,overlappin,pair,papillo,pericarp,pointed,poricidal,portion,present,projection,reddish,reddish-brow,ruit,scar,scattered,shoot,short,side,size,small,soon,swollen,swollen-based,tall,thin,tip,toothed,trichome,tub,tuft,type,ud,uniseriate,unit,usually,vein,way,widest,x,ympodial,young	arrangement,color,colour,diameter,flower,form,fruit,growth,height,history,inflorescence,length,life,na,papillose,peduncle,perennial,plant,position,rachi,reproduction,seed,spacing,staman,texture,width
155	wfo-0001026905	success	204	150	126	78	24	0.618	-3,.5,0,0-2,0.15,0.2-0.5,0.4-0.9,0.4-1,0.5-0.7,0.5-1.5,0.6-0.7,0.7-1.4,0.9-1.3,1-2.5,1-20,1-3.7,1-4,1-6,1/2-3/4,1/3,2.5-3.5,3-8,5-6,5-merous,abaxially,acute,ame,anther,apart,apex,attenuate,bark,base,berry,blade,branched,c.,cell,chartaceous,cm,cream,curved,dark,densely,diameter,discolorous,drying,dull,erect,eye,filament,flattened-reniform,flower,fruit,fruiting,glabrous,gray-green,green,inflorescence,lateral,leaf,length,lobed,long,lower,margin,marking,maturity,mauve,midpoint,mm,moderately,naked,oblong,orange,orange-brown,outline,ovate,pair,pale,pedicel,peduncle,pendulous,petiole,pit,porrect,prickle,prickly,primary,raised,ray,red,reduced,rounded,sessile,shallowly,shrub,small,smooth,sometimes,sparsely,spherical,stalked,stellate-pubescent,stem,straight,style,subentire,surface,terete,tertiary,trichome,unarmed,usually,variously,vein,venation,visible,way,weakly,white,wide,woody,yellow,yellow-green,young	-1.5,-10,-2,-2/3,-4,.2,0-20,0-25,0.1,0.2-0.3,0.3-0.4,0.4,0.75-1.1,1,1-2,1.9-2.5,1/4,1/5-1/3,2-3,2.5-2.9,2/3-3/,3-5,6-8,7-8,acuminat,alyx,apar,apically,apparently,articulated,brow,calyx,connivent,deltate,difoliate,distance,eaf,eed,elongating,equal,extending,free,geminat,infructescence,lobe,longer,mature,midvein,older,one,open,orolla,oung,per,perfec,pericarp,poricidal,portion,prickl,ruit,scar,shorter,side,slender,somewhat,spaced,spreading,stalk,stellate,tamen,tapering,time,tip,tube,unit,upper,vary,ympodial	abaxial,adaxial,branching,brown,color,colour,corolla,form,growth,height,na,number,ovary,plant,position,reproduction,seed,shape,spacing,staman,stigma,texture,visibility,width
156	wfo-0001026923	success	177	116	90	87	26	0.508	.1-0.3,.5,0-5,0.25-0.5,0.5,0.5-1,0.6-0.8,1,1.5-4,2-6,3-5,5-10,5-15,abaxially,absent,acuminate,adaxially,anther,apart,apex,articulated,base,black,branched,brown,chartaceous,cm,cuneate,cylindrical,densely,denser,diameter,elliptic,elliptic-ovate,filament,flattened,flower,forked,fruit,glabrescent,glabrous,globose,green,hair,intermediate,lateral,leaf,leaf-opposed,light,long,midpoint,midvein,mm,moderately,nearly,orange,pedicel,peduncle,peltate,petiole,possibly,pubescence,pubescent,purple,rachi,ray,red,ripening,rounded,rugulose,scale,sessile,short,shrub,simple,small,sparsely,stellate,stem,stigma,strongly,style,surface,tree,trichome,usually,white,x,yellow,yellowish	-5,0.8-1,1-1.5,1-3,1-4,1-7,1.5-2,10,2,2-2.5,2-3,20-50,3-4,4-18,4-5-,5-6,5-9,accrescent,acute,adaxiall,ag,apparently,axe,ba,blade,calyx,capitat,center,connivent,covering,curved,deltate,directed,distally,eaf,eed,eglandular,entire,equal,erect,frui,fruiting,fused,geminate,gland-tippe,glandular,held,lanceolate,large,like,lobe,longitudinal,lower,many-foliate,margin,much,multangulate,nflorescence,oblong,opening,orolla,paired,perfect,pore,relatively,ruit,slightly,slit,smaller,sometimes,somewhat,spaced,ste,straight,subtending,tal,tamen,tem,time,tip,tube,unit,uprigh,vary,whitish,wide,ympodial	abaxial,adaxial,arrangement,capitate,color,colour,corolla,form,gland-tipped,growth,height,history,inflorescence,length,life,na,ovary,plant,position,reproduction,seed,shape,spacing,staman,texture,width
157	wfo-0001026924	success	190	99	73	117	26	0.384	-4,0-1.5,0-2.3,0.2-0.4,0.5-1.5,0.8-2.6,0.9-1.3,10-13,2-,3,4-7,4.3-6.2,5-7,8-9,acicular,acute,anther,apex,base,brown,chartaceous,cm,cordate,cuneate,densely,diameter,drab,drying,entire,extra-axillary,finally,flower,fruit,glabrous,globose,green,grey,grey-green,herbaceous,inflorescence,length,light,lobed,long,margin,minutely,mm,obtuse,ovate,pale,pedicel,peduncle,petiole,prickle,pseudo-racemose,purple,rachi,resprouter,rusty,shallowly,simple,stellate,stellate-pubescent,stem,stigma,style,surface,thicknes,truncate,undulate,white,yellow,yellowish	%,0-0.2,0-2,0.05-0.1,0.05-0.2,0.1-0.3,0.4-0.5,0.5-0.6,0.5-0.7,0.5-0.8,0.5-6,0.7-1.1,0.7-1.2,0.8-1.2,1-1.5,1-4,1-6,1.1-4.2,17-40,2-2.5,2-4,2-foliate,2.8-8.5,3-6,5,5-merou,6-8,7-10,7-8,abaxially,absen,absent,accrescent,across,adaxiall,adaxially,alyx,apart,apparently,appearance,axe,blade,calyx,capitat,connivent,curved,cylindrical,d.,directed,distall,distally,distributed,dult,eaf,eed,eglandular,erect,finger,first,fruiting,geminat,glabrou,gland-tipped,hair,half,lamina,lanceolate,lateral,less,lobe,longer,lower,markedly,mature,mid-poin,midpoint,minute,narrowly,nflorescence,oblique,orolla,part,per,perfect,pore,porrect,present,raisin-like,ray,rostrate,ruit,short,slightly,spaced,sparsely,stage,stalk,stellae,straight,tal,tamen,thick,thicker,throughout,time,triangular,tube,unarme,unarmed,unbranched,unit,unknow,uvenile,vary,wide,x,ympodial	5-merous,abaxial,adaxial,arrangement,capitate,color,colour,corolla,filament,form,growth,height,history,leaf,life,na,ovary,perennial,plant,position,reproduction,seed,shape,staman,texture,unknown
158	wfo-0001026925	success	215	90	74	141	16	0.344	0-5,0-7,0.1-0.3,0.2,0.5-1.5,0.9-1.8,1-1.3,1-1.4,1-25,1-3.5,1-4,2-5,2.4-3,3-7,5-merous,6-8,abaxially,ame,anther,apparently,branched,c.,cm,cream,dark,diameter,filament,flattened-reniform,flower,fruit,glabrescent,glabrous,green,green-brown,lateral,leaf,length,lobed,marking,maturity,mauve,midpoint,mm,moderately,orange-brown,pale,pedicel,peduncle,petiole,plant,porrect,prickly,rarely,ray,red-brown,reduced,scar,sessile,sometimes,sparsely,spherical,stalked,stellate,stellate-pubescent,stem,style,surface,terete,terminal,translucent,trichome,white,yellow,young	-2,.5,/6,0,0-10,0-20,0.1,0.1-0.2,0.5-4,0.7-1.8,00-200,1-3,1.5-2,1.5-2.5,1.5-4.5,1.8-2,1.8-2.5,1/3,1/3-1/2,1/4-2/3,1/6-1/3,2-4,2.4-2.6,2.5-6,2/,3-20,4-10,4-14,4-5,4-7,5-6,5-8,5.5-10,6-10,6-17,7-12,acuminat,acute,alyx,andromonoecious,apar,apart,apex,apically,articulated,attenuate,bark,base,berry,blade,broad-deltate,brow,calyx,chartaceous,concolorous,connivent,curved,deltate,distal,distance,drying,eaf,eed,elliptic,elongating,equal,erect,extending,flattened,free,fruiting,gently,hair,hermaphrodite,heterostylous,infructescence,lobe,lobing,long,long-styled,longer,lower,lowermost,margin,mature,membranous,midvein,minute,narrow-deltate,nflorescence,oblong,older,one,open,orolla,oung,ovate,pair,pendent,pendulous,per,pericarp,plurifoliat,poricidal,portion,prickl,prickle,primary,reflexed,rounded,ruit,secondary,short-styled,shrub,side,simple,smooth,spaced,spreading,stalk,staminat,stout,straight,tamen,tapering,tertiary,time,tip,tube,unarmed,unit,upper,vary,vein,venation,visible,way,wide,woody,yellow-orange,ympodial	abaxial,adaxial,branching,color,colour,corolla,height,inflorescence,number,ovary,pricklines,seed,shape,spacing,staman,texture
159	wfo-0001026946	success	205	126	98	107	28	0.478	0-5,0.5-2,1-10,1-2,1.6-3.7,12-23,2.5-10.5,3-20,4-7,5-7,8-15,abaxially,acuminate,acute,adaxially,anther,apex,axillary,base,broadly,brownish,bud,cell,chartaceous,clavate,cm,condition,corolla,covering,creamy,deeply,densely,diameter,drying,elliptic,filament,flower,forked,fresh,fruit,glabrous,globose,green,greenish,hair,hair-like,herb,interjected,lateral,leaflet,like,membranous,minutely,mm,narrowly,oblique,odd-pinnate,orbicular,ovate,ovoid,pair,pedicel,peduncle,pentagonal,petiole,petiolule,plant,plurifoliate,puberulent,pubescent,pure,purple,ripe,rounded,seed,short,short-pubescent,size,slightly,stellate,stem,stigma,streak,style,subtending,terminal,testal,thick,tri-,truncate,tuber,typically,unit,wall,white,whitish,yellow,yellow-white	0-20,0.9-3.5,0.9-4.3,1,1-4,1.5-2,10-39,2,2-15,2-5,2.7-9,3-5,3-6,3.5-10,4.1-9.4,5-merou,6-24,8-25,acumen,ag,along,alyx,apart,apparently,articulation,attenuate,axe,berry,blade,borne,capitat,ciliate,connivent,digestion,distal,dorsally,dot,eaf,edge,eed,end,enzyme,erec,especially,exceeding,except,extremely,flat,folded,geminat,generally,glabrou,greatly,green-white,half,homostylous,honeycomb-shaped,lanceolate,lengthening,living,lobe,long,lower,make,margin,midrib,mottled,mucilaginous,nflorescence,often,orolla,perfect,petiolulate,pore,poricidal,proximal,pubescen,reduced,removed,ruit,scattered,sessile,seudostipule,singly,slit,spaced,specimen,stamen,ste,stolo,straight,subequal,tall,tamen,tem,thir,throughout,tip,tube,unwinged,usually,variable,vary,wet,wing,x,ympodial	abaxial,adaxial,arrangement,capitate,color,colour,form,growth,height,history,inflorescence,leaf,length,life,na,ovary,perennial,position,pseudostipule,rachi,reproduction,shape,spacing,staman,surface,sympodial,texture,width
160	wfo-0001026962	success	205	105	81	124	24	0.395	.05,0.3-0.7,0.8-1,1-1.5,1-2,1-3,1-4.5,1.5-2,10-12,2-6,4-5,6-7,abaxially,adaxially,anther,bark,bud,calyx,cm,corolla,cylindrical,darker,densely,diameter,difoliate,dry,elliptic,evenly,filament,flattened-reniform,flower,fruit,glabrous,globose,green,incrassate,inflorescence,internodal,leaf,lobe,lobed,longitudinal,margin,material,minutely,mm,narrowly,obconic,occasionally,opening,opposite,ovate-lanceolate,pale,pedicel,peduncle,petiole,pitted,pore,pubescent,purplish,rachi,shaped,shrub,slit,small,sometimes,somewhat,stellate,stigma,style,surface,tear-drop,tinged,tree,tube,unbranched,unifoliate,white,x,yellow,yellowish	.5,0,0.5,0.5-0.8,0.5-1,0.5-1.5,1,1-1.2,1-6,1.5-17,1.5-3,1.5-5,10-20,15-22,2-2.5,2-5,2/3-3/4,3-3.5,3-6,9-12,9-17,abrupt,abruptly,accrescent,acute,ag,alyx,anthesi,apex,apparently,appearing,arising,articulated,axe,base,basebud,becoming,beneath,blade,brittle,broadly,capitat,cell,chartaceous,closely,composed,connivent,constricted,cucullat,deflexed,deltate,denser,differing,dimorphic,eaf,eed,elongate,entire,except,exerted,free,fruiting,geminat,glabrate,glabrou,ilament,later,lateral,like,long,main,major,minor,nflorescence,oblong,obovoid,often,older,one,orolla,oung,outline,overlapping,packed,pair,papillose,paten,pendent,perfect,portion,prominent,pubescen,raised,reflexed,remaining,rest,rounded,rounder,ruit,sagittate,simple,size,slender,slightly,soon,stem,straight,tal,tapering,tip,tooth,triangular,trichome,trunk,unarmed,uniseriate,unit,vary,vein,way,whit,woody,ympodial,young	abaxial,adaxial,age,arrangement,capitate,color,colour,form,geminate,growth,height,history,length,life,na,ovary,perennial,plant,position,reproduction,seed,shape,staman,texture
161	wfo-0001026963	success	151	124	92	59	32	0.609	.4,.5,0.2-0.6,0.5,1-1.5,1.2-1.5,1.5-6,2-2.5,2-4.5,3-5-rayed,4,6-7,abaxially,absent,acicular,acute,anther,anthesi,apex,apical,bark,base,c.,capitate,closely,cm,conical,coriaceous,corolla,dark,deep,densely,diameter,ellipsoid,elliptic,filament,flower,glabrous,growth,herb,heterostylous,inflorescence,internodal,lobed,long,long-styled,margin,markedly,mature,membranous,minute,minutely,mm,new,nodding,node,oblique,ovary,ovate,pedicel,peduncle,petiole,porrect,prickle,prickly,pubescent,reddish,rooting,rootstock,scar,sessile,shallowly,short-styled,simple,sometimes,spaced,sparsely,stellate,stem,stigma,style,subshrub,surface,tip,tooth,trichome,truncate,way,white,woody,x,yellowish	-5,0.5-0.6,0.8-3,1-2,1.1-1.4,1.5-4.5,3-5,4-5,5-6,<,abruptly,armed,articulated,brow,calyx,clustered,creeping,cup-shaped,curved,eaf,eed,elongate,elongating,free,included,inflorescenc,know,known,like,lobe,long-triangular,lower,midpoint,nflorescence,older,outline,pair,papillo,per,plurifoliat,pore,poricidal,portion,primary,prominent,ray,reflexed,ruit,scattered,side,slit,small,tapering,tube,ud,unarmed,unit,vein,ympodial	abaxial,adaxial,arrangement,branching,brown,bud,color,colour,form,fruit,habit,height,history,leaf,length,life,na,papillose,perennial,plant,position,pricklines,rachi,reproduction,seed,shape,spacing,staman,texture,timing,type,width
162	wfo-0001026964	success	128	81	57	71	24	0.445	.5,0.5,0.5-1,1-1.2,1-2.5,10-30,2-2.5,2-4,3-5,3.5-7,7-8,acuminate,acute,anther,apex,axillary,base,cm,conical,corolla,diameter,elliptic,filiform,fruiting,glabrous,green,greenish,herb,horizontal,leaflet,lightly,lobed,minutely,mm,nearly,obovate,ovary,papillate,pedicel,petiole,petiolule,pinnate,poricidal,purple,rugose,shape,simple,size,smooth,somewhat,stigma,style,surface,tip,winged,x,yellow	.2,0,10,4.5-8.5,?,along,anthesi,attenuate,basal,beak,bearing,berry,calyx,capitat,conspicuously,differentiated,distinct,eaf,edicel,equal,erec,exserted,filament,fleshy,flower,free,glabrou,globose,immature,known,lateral,lenticellate,line,lobe,long,long-attenuate,lower,margin,nflorescence,noddin,often,one,onto,open,ot,pair,portion,primary,pubescent,purpli,rachi,reflexed,ruit,scar,side,slender,small,sparsely,tal,tem,terminal,time,trichome,tub,tube,ud,unifoliat,uniseriate,unit,vein,ympodial	.5-1,arrangement,capitate,color,erect,form,fruit,growth,height,history,inflorescence,leaf,length,life,na,nodding,number,orientation,perennial,plant,position,reproduction,texture,width
163	wfo-0001026965	success	157	99	64	93	35	0.408	-2.5,.6,0.5-1.5,0.7-1.1,0.7-1.5,1.1-1.65,1.7-2,abaxially,abundant,accrescent,acute,adaxially,anther,antrorse,apex,appressed,berry,calyx,campanulate,capitate,cm,covering,diameter,elliptical,evident,filament,flexuose,fruiting,globose,herb,latitudinally,long,margin,mm,narrowly,non-glandular,obovate,outer,ovate,pale,papery-scarious,papillose,partially,petiole,pinnatifid,pinnatipartite,pubescent,reticulate,seed,simple,stigma,strongly,style,subglobose,surface,trans-ovoidal,trichome,tuberculate,uniseriate,venation,violet,white,x,yellow	.3,.5,0.2,0.4,0.5-,0.6-1.1,0.6-2,0.7-1,0.8-1.25,1.3-2,1.5-2,1.5-4,1.9-2.4,2.5-4,2/3,25,3-,3-4,3.5-6.2,3.5-9,5-15,6.4-12,8-17,ag,articulated,basal,base,broadly,c.,coat,coiled,connectival,cuneate-attenuate,cylindrical,difoliat,dorsal,eaf,eed,eglandular,ellipsoidal,elliptic,embryo,exserted,glabrous,glandular,herbaceous,hig,lobe,longer,longitudinal,longitudinally,lower,mixed,multi-seeded,noticeable,opening,opposite,orolla,ovat,pair,papillae,pore,poricidal,portion,procumbent,prolongation,prostrate,ree,ridged,rounded,ruit,segment,short,similar,slightly,slit,small,smooth,stem,straight,striate,styl,tem,time,tip,tube,unequal,unifoliate,unit,vary,wider,winged,ympodial	3-15,abaxial,adaxial,arrangement,bark,bud,color,colour,corolla,flower,form,fruit,growth,height,history,inflorescence,leaf,length,life,na,ovary,pedicel,peduncle,perennial,plant,position,preparation,prickle,rachi,reproduction,shape,spacing,staman,texture,width
164	wfo-0001026981	success	252	167	141	111	26	0.56	-0.8,-2.5,-35,-8,.2,0.1-0.3,0.3-0.5,0.3.6,0.4-2,0.45-1.3,0.5-0.3,0.5-30,0.6-2,0.8-6,0.9-1.5,1-2,1-3,1-3.3,1-4,1.5-5,1.8-2.8,1/3,2-3-branched,3-foliate,4,4-celled,6-10,abaxially,absent,abundant,acute,adaxially,adpressed,along,anther,apex,appearance,articulated,articulation,base,basiscopically,beak,brown,calyx,capitate,cell,citrus-like,cm,coastal,conical,corolla,dark,densely,diameter,distal,filament,flower,fruit,fruiting,giving,glabrescent,glandular,globose,green,hair-like,head,herb,imparipinnate,interjected,internode,interrupted,jointles,lateral,leaf,leaflet,like,lime,lobe,mainly,margin,maturity,minutely,mixed,mm,much,multicellular,narrowly,obovate,occasionally,orange,orbicular,outgrowth,ovary,ovate,pale,pedicel,peduncle,pentagonal,perennial,petiole,petiolule,plant,population,present,pronounced,proximal,pseudostipule,pubescent,rachi,rick,secondary,see,shaggy,silky,simple,smaller,sometimes,sparsely,sparser,stem,stigma,strong,style,surface,tangled,terminal,testa,transparent,trichome,uni-,uniseriate,unit,usually,variously,velvety,wall,winged,without,yellow,‘,’	-0.4,-14,-2,-4,.2-0.2,0-5,0.05-0.1,0.1-0.2,0.15-0.2,0.2,0.2-0.4,0.2-2,0.25-0.4,0.4-0.5,0.4-0.7,0.5,0.6-1.4,0.7-0.8,0.8-1.2,0.9-1.4,1,1-2-cellular,1-3-celled,1.5-2.0,1.5-8.5,11,196.,2-3,2-locular,3.5-14,4-8,7.5,<,absen,academy,accrescent,amongst,angled,anthesi,apical,appendage,appressed,asymmetric,axi,bay,becoming,bract,bracteole-like,column,composed,cone,cordate,d,deltate,eaf,ebracteate,edicel,eed,entire,erect,exserted,gree,half,halfway,included,initially,irregularly,larger,later,less,linear,lobed,lon,long,lower,nflorescence,pair,patent,per,primary,procumbent,pubescence,reflexed,robust,rounded,ruit,scen,sessile,several,shaped,short,shorter,slender,specimen,spreadin,staminal,sterile,straight,tem,tertiary,thick,tightly,tub,tube,type,unicellular,upto,villous,viny,wide,ympodial	1967,abaxial,adaxial,arrangement,color,colour,form,glandularity,growth,height,history,inflorescence,length,life,na,position,presence,reproduction,scent,seed,shape,spacing,staman,sympodial,texture,width
165	wfo-0001026987	success	214	117	93	121	24	0.435	0-0.2,0-1,0.2-1,0.4-1,0.5-2,0.5-2.5,1.1-6,1.5-2,2.5-11,3.5-5,4-6,4-7,5.5-7,7-10,absent,accrescent,acute,anther,apex,ascending,base,bent,calyx,chartaceous,cm,cordate,cuneate,densely,diameter,entire,extra-axillary,filament,finger,flower,fruit,fruiting,glabrous,gland-tipped,globose,grey,hair,half,hastate,homostylous,inflorescence,lateral,leaf,length,less,lilac,lobed,long,longer,margin,mature,midpoint,mm,obtuse,often,pale,pedicel,peduncle,perennial,petiole,porrect,present,prickle,purple,rachi,ray,red,rhizomatous,scarcely,shallowly,short,shrub,simple,sparsely,stalk,stellate,stellate-pubescent,stigma,style,surface,thin,time,twisted,unbranched,white,wide,x,yellow,yellowish	%,0-0.1,0-10,0-4,0.05-0.1,0.2-0.4,0.2-0.5,0.25-0.4,0.4-0.5,0.4-0.7,0.5-0.7,0.5-1,0.7-0.8,0.7-1,0.7-1.5,1-11,1-2,1-3,1-4,1.1-2.6,1.4-3,15-35,2-5,2-7,2.5-6.5,3.5-3.8,4.5-6,5-10,5-8,5-merou,6-20,8-10,8-11.5,8-12,8-13,abaxially,absen,abundant,across,adaxiall,adaxially,adult,alyx,apart,articulated,axe,ba,basal,berry,blade,branch,branche,broad-based,capitat,connivent,curved,cylindrical,decimetre,deflexed,deltate,directed,distall,distributed,dm,eaf,eed,eglandular,erect,glandular,glandular-hairy,green,interpetalar,juicy,juvenile,lacking,lamina,lanceolate,lobe,loosely,lower,mesocarp,mid-point,minute,narrowly,nflorescence,oblique,orolla,ovate,pair,part,per,perfect,pore,ruit,sessile,shallowly-lobed,slightly,spaced,sparse,stellae,straight,succulen,summit,tal,tamen,tem,thick,thickened,throughout,tissue,toward,triangular,tube,unarme,unarmed,unit,unknow,upper,upward,vary,ympodial	5-merous,abaxial,absence,adaxial,capitate,color,colour,corolla,form,growth,height,history,life,ovary,plant,position,reproduction,seed,shape,size,staman,stem,texture,width
166	wfo-0001026992	success	243	104	84	159	20	0.346	0.2-0.5,0.8-3.4,1-4,1.2-1.7,1.4-1.6,1.7-4.3,12-33,3-4,3.3-5.6,5-15,8,8-11,8-14,abaxially,acute,adaxially,angled,anther,bark,blunt-tipped,branch,branched,broadly,brown,calyx,cm,corolla,crown,dark,deltoid,diameter,drying,elliptic,filament,flat-topped,flower,fruit,globose,granular-tomentose,greenish,grooved,homostylous,lance-ovate,lanceolate,leaf,length,lobe,long,longitudinally,many,mm,orange-tan,ovate,petiole,plant,pubescence,reniform,reticulate-punctate,scabridulous-,semi-ovate,shrub,simple,size,small,spreading,stellate,stigma,style,subcampanulate,surface,tan,terete,terminal,time,tomentose,tree,tube,unequal,velutinous,whitish,wide,x,yellow,yellowish	-2.5,/7,0.25-0.45,0.5-1.2,0.6-1.5,00-170,1.2-1.4,1.3-2.6,1.3-4.3,1.4-1.9,1.5-3.4,1.7-1.9,1.7-2.4,1/2,10-12,2-10,2-5.6,2.3-3.3,2.6-4.6,2.8-4.6,2.8-4.7,3.3-5.5,4-8,5-merou,5.3-12.1,6-10,abaxial,abruptly,accrescent,acuminate,adaxiall,ag,along,alyx,anthesi,apart,apex,apparently,appressed,approximately,around,articulated,attenuate,axe,axillary,ba,base,berry,blade,capitat,chartaceous,completely,coriaceous,covering,cylindrical,densely,directed,distally,eaf,echinoi,echinoid,edge,eed,entire,enveloping,equal,evident,exserted,farinose,fleshy,forming,free,fruiting,geminate,glabrescen,glabrous,hair,high,immature,inserted,lacking,lateral,lengthening,less,line,lobed,long-stalked,longitudinal,lower,m.,main,margin,mature,maturity,midrib,minute,moderately,mostly,multangulate,nearly,nflorescence,oblong,obtuse,occasional,occasionally,often,older,orolla,ovate-lanceolate,overlapping,pedicel,peduncle,perfect,plurifoliate,pore,poricidal,porrect-stellate,pubescent,rachi,rare,rather,ripe,ruit,runk,sessile,short,short-,short-stalked,shorter,side,slit,sometimes,somewhat,spaced,sparingly,split,stalked,stamen,stem,stout-stalked,subglobose,suture,tamen,thin-textured,tip,ud,unarme,unarmed,unit,usually,vary,vein,violet,way,weakly,white,ympodial,young,½	100-170,2-2.5,5-merous,arrangement,capitate,color,form,growth,height,inflorescence,na,number,ovary,ratio,seed,shape,staman,texture,trunk,width
167	wfo-0001026994	success	266	115	93	173	22	0.35	.2,0.5,0.5-0.8,0.5-1.3,0.5-2,0.7-2.5,1,1-1.4,1-1.6,1-2,2-2.6,4,4-15,5,abaxially,acuminate,acute,anther,apex,articulate,base,beneath,bifurcate,branched,bright,broadly,brown,capitate,cell,cm,corolla,dark,darker,densely,diameter,distal,elliptic,filament,flower,fruit,globose,grayish,green,greenish,habitat,hair-like,half,herb,imparipinnate,inflorescence,interrupted,lateral,leaf,less,locule,margin,medial,midvein,mm,moderately,narrowly,obovate,occasionally,outgrowth,ovary,paler,pedicel,peduncle,perennial,petiole,pubescent,purple,rachi,regularly,ripe,rocky,rotate-stellate,simple,sparsely,spreading,stigma,stripe,style,surface,testa,trichome,uniseriate,usually,velvety,wall,weak-walled,white,yellow	-0.7,-10,-20,-30,-foliate,.5,0.05-0.1,0.05-0.2,0.1,0.1-0.2,0.1-0.3,0.15-0.2,0.2-0.4,0.2-0.5,0.25,0.3-0.4,0.4-0.5,0.4-1.2,0.5-0.6,0.5-0.7,0.5-0.9,0.5-1.2,0.9-1.2,0.9-1.3,1-1.2,1-1.5,1.2-1.6,1.2-3.5,1.4-2.1,10-20,12-,2,2-,2-4,2-5-locular,2.2-3.2,2.5-6.5,20-50,3,3-branched,4-celled,5-,5-7,6-20,7-13,8,8-12,absent,abundant,acroscopically,additional,adpressed,along,also,amongst,andscattered,anthesi,apical,apically,appearance,appendage,articulation,basal,basally,basiscopically,becoming,bent,berry,bifurcation,bract,bracteate,broader,calyx,celled,column,conical,crenat,crenate,crowded,decreasing,decumbent,decurrent,deeply,developed,eaf,ebracteate,edicel,eed,eglandular,erect,especially,essentially,exserted,fewer,fruiting,giving,glabrous,glandular,gree,hal,halfway,head,interjected,internode,investing,irregularly,lamina,lanceolate,large,larger,largest,leaflet,leave,like,lobe,lobed,lon,long,loosely,lower,markedly,minutely,much,narrower,narrowing,nearly,nflorescence,node,oblique,often,pair,papillate,petiolule,present,primary,pseudostipule,puberulent,rarely,reflexed,robust,secondary,sessile,set,shaggy,short,silky,sinus,size,slightly,sometimes,specimen,spreadin,staminal,stem,sterile,straight,tall,tem,terminal,tertiary,thick,tip,toward,tube,ud,unicellular,unit,well,wide,winged,woody,ympodial,young	abaxial,adaxial,arrangement,color,colour,form,growth,height,history,length,life,na,plant,position,reproduction,seed,shape,spacing,staman,texture,width,wing
168	wfo-0001026996	success	188	91	65	123	26	0.346	0.6-1,1-2,1.8-4.4,15-28,3-10,3-5,3.3-6,4-8,5-8,6-8,abaxially,acumen,adaxially,anther,blue,brownish,cell,clavate,cm,condition,coriaceous,corolla,covering,dark,deep,diameter,drying,elliptic,filament,flower,forked,fresh,fruit,glabrous,globose,green,greenish,hair-like,herb,homostylous,lateral,leaf,lilac,medium,mm,odd-pinnate,ovate,ovoid,pedicel,peduncle,pentagonal,petiole,plant,rotate,seed,stigma,stripe,style,terminal,testal,thick,wall,white,whitish,yellow	0-6,0.9-2.7,1-3,1-4,1-5,1.2-1.8,1.3-7.7,14-33,2-3,3-7,3.8-14.1,4-4.4,4.5-10.5,5-merou,6.9-10.9,8.7-18.6,abaxiall,acuminate,acute,ag,along,alyx,apart,apex,apparently,arranged,articulated,asymmetric,attenuate,axe,axillary,base,basiscopic,bead,berry,blade,bud,capitat,connivent,considerably,decreasing,digestion,distal,dorsally,eaf,edge,eed,enzyme,erec,exceeding,flat,folded,geminat,generally,glabrou,green-white,half,honeycomb-shaped,interjected,lanceolate,larger,leaflet,lengthening,like,linear,living,lobe,long,lower,make,middl,moniliform,mottled,mucilaginous,multiple,necklace,nflorescence,orbicular,orolla,pair,perfect,petiolulate,plurifoliate,pore,poricidal,purple,removed,ripe,rounded,ruit,sessile,seudostipule,side,size,slightly,slit,sometimes,spaced,specimen,stamen,stolon,straight,subglabrou,subtending,symmetric,tall,tamen,tem,throughout,tip,tissue,toward,tri-,tube,tuber,typically,unit,unwinged,usually,vary,wet,x,ympodial	5-merous,abaxial,adaxial,arrangement,capitate,color,colour,form,growth,height,history,inflorescence,length,life,na,ovary,perennial,position,pseudostipule,shape,spacing,staman,stem,subglabrous,surface,texture
169	wfo-0001027009	success	226	101	79	147	22	0.35	0-0.3,0-5,0.4-1,0.5-2,0.7-1.3,0.8-2.1,1-5,1-9,10-20,2-3,23-48,4-6.5,5-23,7-12.5,acicular,acute,adaxially,andromonoecious,anther,apex,base,black,broad-based,brown,capitate,chartaceous,cm,cuneate,cylindrical,deeply,densely,diameter,elliptical,erect,extra-axillary,filament,flower,fruit,glabrous,globose,green,grey,grey-green,index,inflorescence,lanceolate,length,lobed,margin,minutely,mm,obtuse,ovate,pale,pedicel,peduncle,perennial,petiole,plant,prickle,pseudo-racemose,purple,reticulate,rhizomatous,rotate,shallowly,shrub,slightly,stellate-pubescent,stigma,straight,style,surface,throughout,unbranched,white,yellow,yellowish,yellowish-green	%,0-0.2,0-0.5,0-1.2,0-1.5,0-15,0-8,0.1-0.2,0.15-0.3,0.7-0.9,0.7-1,0.8-1.2,0.8-1.3,1-1.5,1-1.8,1-2,1-2.5,1-3,1.3-2.2,1.4-4,1.6-3.5,10-15,2-4,2-6,2-foliate,2.3-3,20-30,3-10,3-3.5,3-5,3.3-3.6,35-400,4-9.5,40-125,5,5-7,5-merous,6-8,6-9,6.5-11,7-11,7-8,abaxially,absent,abundant,accrescent,adaxiall,alyx,apart,armed,articulated,ascending,attenuate,axe,ba,basal,bilobe,bisexual,blade,broadly,calyx,connivent,curved,d.,deflexed,deltate,dimorphic,directed,distal,distall,distributed,dult,eaf,eed,eglandular,entire,finger,fruiting,functional,geminate,gland-tipped,glandular,hair,half,heterostylous,incised,interpetalar,juic,lamina,larger,lateral,lobe,lobing,lon,long,longer,lower,male,markedly,mature,mesocarp,midpoint,midvein,minute,moist,nflorescence,oblique,orolla,part,per,pore,porrect,presen,present,pricklie,probably,rarely,ray,ridged,ripe,ruit,short,side,simple,spaced,stage,stalk,stellae,stem,strongly,tal,tamen,terete,thick,time,tip,tissue,tube,unarmed,unit,unknow,uvenile,vary,vein,wide,x,ympodial	abaxial,adaxial,bilobed,color,colour,corolla,form,growth,height,history,leaf,life,na,ovary,position,reproduction,seed,shape,spacing,staman,texture,thicknes
170	wfo-0001027010	success	198	110	84	114	26	0.424	0-2,0-2.5,0.4-5.1,0.5-1.5,1-10,1-2,1-4,14-46,2-9.4,2.1-15.3,2.1-4.3,2.2-12.9,3-10,3-5,4-8,abaxially,acuminate,acute,adaxially,along,anther,apex,base,bead,clavate,cm,coriaceous,corolla,decreasing,deep,diameter,elliptic,filament,flower,forked,fruit,glabrescent,glabrous,green,greenish,hair,herb,interjected,leaf,leaflet,light,like,mm,moniliform,mucilaginous,necklace,occasionally,odd-pinnate,orbicular,ovate,ovoid,pair,pedicel,peduncle,pentagonal,petiole,plant,plurifoliate,purple,rotate,scabrous,seed,short,size,stigma,stolon,stripe,style,terminal,toward,tri-,tuber,unit,usually,wet,white,whitish,x,yellow	0-3,1-7,1.2-1.7,1.2-1.9,1.4-6.9,10-60,2-6,3-6,3-8,3.5-13.6,4-12,4.4-29,4.9-31,5-13,5-14,5-merou,acumen,adaxiall,ag,alyx,apart,apparently,arranged,articulated,asymmetric,attenuate,axe,axillary,basiscopic,blade,brownish,bud,capitat,cell,coloration,condition,connivent,covering,digestion,distal,dorsally,drying,eaf,edge,eed,enzyme,erec,exceeding,flat,folded,fresh,geminat,generally,glabrescen,glabrou,green-white,hair-like,hal,half,high,homostylous,honeycomb-shaped,lanceolate,larger,lateral,lengthening,living,lobe,long,lower,make,multiple,narrow,nflorescence,orolla,perfect,petiolulate,pore,poricidal,present,removed,ripe,rounded,ruit,scabrou,sessile,seudostipule,side,slightly,slit,sometimes,spaced,specimen,spot,stamen,straight,subequal,subtending,tall,tamen,tem,testal,thick,throughout,tip,tissue,tube,typically,vary,wall,wide,wing,winged,ympodial	abaxial,adaxial,arrangement,capitate,color,colour,form,growth,height,history,inflorescence,length,life,na,ovary,perennial,position,pseudostipule,rachi,reproduction,shape,spacing,staman,surface,texture,width
171	wfo-0001027019	success	142	114	89	53	25	0.627	.5,0-0.5,1-1.5,1-2,1.5-2,1.5-3,1/2,10,2-8,4-5,abaxial,acute,anther,apex,apparent,bark,base,branched,bright,calyx,capitate,cm,constriction,corolla,cyathiform,deflexed,deltoid,densely,dia,distal,erect,even,filament,flattened,fleshy,free,fruiting,glabrate,glabrous,globose,golden,green,inflorescence,largely,leaf,like,lobe,lobed,long,minutely,mm,obovate,opposite,ovary,overlapping,ovoid-reniform,pale,papillose,pedicel,petiole,pitted,plant,pore,portion,pubescent,scar,shaped,shrub,small,somewhat,spaced,sparsely,stem,stigma,strongly,style,surface,tan,tapering,tear-drop,tree,trichome,tube,waxy,white,wing,winged,woody,x	/4,0.5-1,10-40-flowered,12-30,2-3,2-5,4-8.5,7-14,abaxially,abruptly,adaxially,along,anthesi,attenuate,ba,berry,difoliate,eaf,edicel,eed,ellipsoid,elliptic,exserted,geminat,inflorescenc,later,live,lon,lower,major,midrib,minor,narrowed,nflorescence,older,onto,papillo,planar,poricidal,reddish-brow,rest,ruit,straight,tall,third,tip,tub,ud,unit,way,widest,ympodial,young	bud,color,diameter,feature,flower,form,fruit,growth,height,history,length,life,na,peduncle,perennial,position,rachi,reddish-brown,reproduction,seed,shape,spacing,staman,texture,width
172	wfo-0001027030	success	234	130	107	127	23	0.457	-11,.2,.5,0.2,0.2-0.3,0.4-0.5,0.4-0.8,0.5-1,0.6-0.7,0.6-0.8,0.7-1,0.8-0.9,0.8-1,0.9-1.1,1,1-,1-1.2,1-1.3,1-3,1.2-1.6,1.5-,1.6-2,2-3,2-4,2-4.8,2.2-3.2,abaxial,abundant,acuminate,acute,anther,apex,articulation,branched,bright,brown,calyx,capitate,cm,column,conical,corolla,dark,densely,denser,diameter,distal,due,elliptic,evenly,filament,fruit,fruiting,globose,green,hair-like,half,herb,imparipinnate,inflorescence,interrupted,lamina,larger,lateral,leaflet,like,lobe,long,minutely,mm,narrowly,obovate,often,outgrowth,ovary,pair,pale,paler,papillate,pedicel,peduncle,perennial,petiole,primary,pseudostipule,pubescence,pubescent,rotate-stellate,simple,size,soft,sometimes,sparsely,spread,staminal,stem,stigma,style,surface,tall,terminal,trichome,uniseriate,vein,velvety,winged,yellow	-15,0-4,0.05-0.1,0.1-0.7,0.1-0.9,0.15-0.2,0.2-1,0.3-,0.3-0.5,0.3-0.7,0.4-1.5,0.5,0.5-,0.5-0.7,0.5-0.8,0.6-1.8,1-3.4,2-,2-6,2-7,2-foliate,2-locular,3-4-celled,3-8,3-9,4-celled,5-12,8-celled,abaxially,absent,adaxially,adpressed,angled,anthesi,apical,appearance,appendage,articulated,axi,basal,base,basiscopically,beneath,berry,beyond,bract,cell,crenat,crenate,crenation,darker,decurrent,deeper,deeply,diamete,eaf,edicel,eed,eglandular,entire,exserted,extremely,flower,giving,gland,glandular,grayish,gree,growt,hal,halfway,interjected,internode,interspersed,investing,irregularly,lanceolate,less,lon,longer,loosely,lower,margin,multicellular,near,nflorescence,node,oblique,occasionally,petiolule,present,reflexed,robust,ruit,secondary,sessile,silky,similar,slender,slightly,small,smaller,somewhat,spreadin,spreading,sterile,straight,stripe,tem,tertiary,testa,thick,tiny,trailing,truncate,tube,ud,unicellular,unit,usually,wall,weak,white,wide,woody,ympodial,young	2-9,adaxial,arrangement,bud,color,colour,dioecious,form,growth,height,history,leaf,length,life,plant,reproduction,seed,shape,staman,texture,thicknes,width,wingednes
173	wfo-0001027035	success	199	112	87	112	25	0.437	0-36,0.1-0.9,0.3-2.3,0.4-12.8,0.5-3.4,0.8-4.2,1-2,1-8,1.5-5.9,1.7-8,1.8-5.2,10-80,2-38,2-7,3-10,3-5,acuminate,acute,along,anther,apex,bead,blue,brownish,cell,clavate,cm,coloration,completely,condition,corolla,deep,diameter,drying,elliptic,filament,flower,forked,fruit,glabrescent,glabrous,globose,green,greenish,herb,honeycomb,interjected,leaf,leaflet,light,like,lilac,medium,mm,moniliform,mucilaginous,necklace,odd-pinnate,ovate,ovoid,pair,pedicel,peduncle,pentagonal,petiole,plant,plurifoliate,purple,rotate,seed,shape,shaped,size,sometimes,stigma,stolon,stripe,style,terminal,testal,tri-,tuber,unit,wet,whitish,x,yellow	0-7,0.5-5,0.5-7,0.8-3,0.9-3.1,1-3,1-3.4,2.8-10.3,4-18,4-18.5,4.9-23.5,5-merou,abaxially,acumen,adaxiall,adaxially,ag,alyx,apart,apparently,arranged,articulated,asymmetric,attenuate,axe,axillary,base,basiscopic,blade,bud,capitat,connivent,covering,decreasing,digestion,distal,dorsally,eaf,edge,eed,enzyme,erec,exceeding,flat,folded,fresh,geminat,generally,glabrescen,glabrou,green-white,hair,hair-like,hal,half,high,homostylous,lanceolate,larger,lateral,lengthening,living,lobe,long,lower,make,multiple,nflorescence,orbicular,orolla,perfect,petiolulate,pore,poricidal,present,removed,ripe,rounded,ruit,second,sessile,seudostipule,short,side,slightly,slit,smaller,spaced,specimen,stamen,straight,subequal,subglabrous,subtending,tall,tamen,tem,thick,throughout,tip,tissue,toward,tube,typically,unwinged,usually,variable,vary,wall,white,wide,ympodial	abaxial,adaxial,arrangement,capitate,color,colour,form,growth,height,history,inflorescence,length,life,na,ovary,perennial,position,pseudostipule,rachi,reproduction,spacing,staman,surface,texture,width
174	wfo-0001027050	success	244	129	108	136	21	0.443	-12,-9,/3,0-0.2,0.1-0.3,0.2-0.5,0.3-1.5,0.5-3,1-2,1.5-6,10-13.5,2-4,2-5,5,5-9,5-merous,6-8,abaxial,absent,acuminate,acute,adaxial,anther,apex,base,berry,branched,broad-based,brown,capitate,chartaceous,closely,cm,coarsely,conical,cordate,cuneate,curved,deeply,densely,diameter,drying,entire,ferruginous,filament,flattened-reniform,flower,fruit,glabrous,green,growth,inflorescence,lateral,leaf,leaf-opposed,length,lobed,margin,midpoint,minutely,mm,moderately,oblique,obtuse,often,pale,pedicel,peduncle,petiole,plant,porrect,present,prickle,pubescent,ray,ripe,rounded,scar,sessile,several,shallowly,short-stalked,shorter,shrub,slightly,small,spaced,sparsely,spherical,stellate,stellate-pubescent,stigma,straight,style,surface,time,toothed,touching,tree,trichome,truncate,unbranched,usually,way,white,whitish,yellow,yellowish-green	.2,.5,0-3,0.1-3,0.2-1,0.8,0.9-2.1,1,1-1.5,1.5-2,12-15,15-50+,2-2.5,2-3,2-8,2.5-3,3-5,4-20,4-8,5-10,5-6,5-7,50,7-30+,8-26,abaxially,absen,abundant,adaxiall,adult,alyx,andromonoeciou,apar,arme,articulated,axe,bark,basal,blade,branch,broad,broadly,brow,calyx,connivent,difoliate,directed,distal,distall,distally,eaf,eed,eglandular,elliptic,equal,erec,erect,except,flattened,free,fruiting,geminat,glandular-puberulent,hair,half,heterostylous,infructescence,inside,interpetalar,juicy,juvenile,lanceolate,larger,least,less,like,lobe,long,long-styled,longer,lower,markedly,mature,mid-way,midrib,midvein,minute,moist,mucilaginous,multiseriate,narrowly,near,nflorescence,numerous,occasionally,older,orolla,oung,ovate,ovate-lanceolate,papillat,per,pericarp,pore,poricidal,portion,pricklier,prickly,rest,ruit,scattered,secondary,shiny,short-styled,side,somewhat,stalk,stalked,stem,tall,tamen,terete,thicker,tip,tissue,triangular,tube,unarmed,unit,vary,weakly,wide,woody,ympodial,young,younger	apart,armed,color,colour,corolla,form,height,history,life,na,ovary,papillate,perennial,position,reproduction,seed,shape,spacing,staman,texture,width
175	wfo-0001027050	success	234	85	69	165	16	0.295	0-0.2,0.1-3,0.5-1,0.5-3,1-2,1-5,1.5-2,1.5-6,10-13.5,2-10,2-4,2-5,3-15,5,5-9,5-merous,6-8,anther,apart,branched,broadly,brown,chartaceous,cm,contiguous,densely,diameter,elliptic,extra-axillary,ferruginous,filament,flattened,flower,forked,globose,green,inflorescence,lateral,leaf,leaf-opposed,length,midpoint,minutely,mm,moderately,nearly,ovate,pale,pedicel,peduncle,petiole,pitted,plant,prickle,rachi,ray,simple,spaced,stellate,stellate-pubescent,stem,stigma,style,surface,unbranched,white,whitish,x,yellow	.2,0-0.5,0-1,0-3,0.2-0.6,0.2-1,0.3-0.6,0.4-1,0.5-0.8,0.8,1-1.5,10-30,11-21,12-15,14-20,15-50+,16-40,2-2.5,2-3,2-3-locular,2-6,2-8,2-foliate,2.5-3,23-40+,3-5,4-19,4-40,4-8,5-10,5-6,5-7,7-30+,8-26,8-40+,abaxially,absen,absent,abundant,accrescent,across,acuminate,acute,adaxiall,adaxially,adult,andromonoecious,anvil-shape,apex,armed,articulated,axe,ba,base,blade,branche,broad-based,calyx,capitat,coarsely,connivent,cordate,cross-section,cuneate,curved,cylindrical,deeply,directed,distall,distally,distributed,drying,eaf,eed,eglandular,entire,erect,except,exocarp,fruit,fruiting,functional,geminat,glabrous,glandular-puberulent,growth,hair,half,held,interpetalar,juicy,juvenile,lanceolate,less,like,lobe,lobed,long,longer,lower,margin,markedly,mature,mesocarp,midvein,minute,moist,mucilaginous,multiseriate,narrowly,nflorescence,oblique,obtuse,often,orolla,ovate-lanceolate,pair,per,pinnatifid,placenta,pore,porrect,present,rounded,ruit,scattered,sessile,shallowly,shorter,shrub,side,slightly,small,somewhat,sparsely,stalk,stalked,stellae,straight,tal,tamen,tem,thick,thicker,throughout,time,tip,tissue,toothed,tree,triangular,truncate,tube,unarme,unarmed,unit,upper,upright,usually,vary,weakly,wide,yellowish-green,ympodial,younger	abaxial,adaxial,arrangement,capitate,color,colour,corolla,height,ovary,position,seed,shape,spacing,staman,stella,texture
176	wfo-0001027067	success	228	94	73	155	21	0.32	0-1.8,0-6,0.3-1,0.5-2,1.7-3.3,11-16,15-60,2-3,3-10,4-5.5,6-10,7-16,abaxial,acute,anther,apex,black,broadly,brown,chartaceous,cm,dark,densely,diameter,extra-axillary,filament,flattened,fruit,glabrous,globose,green,grey,hair,inflorescence,lanceolate,leaf,length,longer,mm,obtuse,ovate,pale,pedicel,peduncle,per,perennial,petiole,pink,plant,prickle,pseudo-racemose,purple,rachi,rhizomatous,rotate,scattered,shrub,slightly,sparsely,stellate,stellate-pubescent,stem,stigma,streak,style,time,truncate,twisted,white,wide,yellow,yellowish,yellowish-green	%,.05,0-0.1,0-0.2,0-0.5,0-12,0-7,0.2-0.4,0.35-0.5,0.4-0.5,0.4-0.7,0.5-1,0.5-1.5,0.8-1,0.9-2.5,1-2,1-4,1-7,1.2-1.4,1.4-2.5,1.5-2,1.7-2.8,11-20,13-65,15-27,2-10,2-4.5,2-7,2-foliate,2-locular,2.5-3.8,2.5-4,2.7-5,2.9-3.7,20-45,20-50,20-65,3-4,3-5,3-6,3.5-5.5,3.5-9,4-9,5-12.5,5-6,5-9.5,5-merou,5.5-12.5,6-7,6-8,7-11,7-8,8-14,abaxially,absent,abundant,accrescent,acicular,across,adaxiall,adaxially,adult,alyx,andromonoecious,apart,armed,articulated,attenuate,axe,ba,base,bilobe,blade,broad-based,calyx,connivent,cuneate,curved,cylindrical,decimetr,deeply,directed,distall,dult,eaf,eed,eglandular,erect,exocarp,finally,finger,firm,flower,fruiting,functional,geminate,gland-tipped,half,heterostylous,hig,index,interpetalar,juic,juvenile,lateral,less,lobe,lobed,lobing,lon,long,lower,margin,mature,mesocarp,mid-point,midpoint,midvein,minute,moist,nflorescence,oblique,orolla,papery,part,pore,porrect,presen,present,ray,ruit,sessile,short,side,simple,skin,somewhat,spaced,sprawling,stalk,stellae,straight,tamen,thick,throughout,tissue,transparent,tube,unbranched,unit,vary,vein,weakly,x,ympodial	adaxial,bilobed,color,colour,corolla,decimetre,density,form,growth,height,history,life,ovary,position,reproduction,seed,shape,staman,surface,texture,width
177	wfo-0001027069	success	200	132	102	98	30	0.51	0-4,0.15-0.8,0.5-1.5,0.8-3.3,1-10,1-2.5,1-7.7,10-25,2.5-12,3.5-6,7-10,abaxially,acuminate,acute,adaxially,along,anther,apex,axillary,blotch,broadly,brown,brownish,bud,cell,chartaceous,ciliate,cm,condition,corolla,covering,darker,diameter,drying,elliptic,elliptical-conical,especially,filament,flower,forked,fresh,fruit,glabrescent,glabrous,green,green-white,greenish,hair,hair-like,herb,homostylous,interjected,lanceolate,lateral,leaflet,light,like,make,margin,membranous,midrib,minutely,mm,mucilaginous,narrowly,obtuse,odd-pinnate,ovate,ovoid,pair,pedicel,peduncle,petiole,plant,puberulent,pubescent,purple,rachi,rare,seed,short,simple,size,sparsely,stellate,stem,stigma,stripe,style,subtending,terminal,testal,thick,throughout,tip,tuber,vertical,wall,wet,white,whitish,yellow	0.2-3,0.5-5,0.5-5.5,1-2,1-5,1.5-12,1.5-3,1.5-5,1.5-6,2-5,2-6,3-11,3-19,4-8,4-9,5-merou,acumen,ag,alyx,apart,apparently,articulated,axe,base,berry,blade,borne,capitat,connivent,cordate,cuneate,decreasing,decurrent,digestion,distal,dorsally,eaf,edge,eed,end,enzyme,erect,exceeding,flat,folded,geminat,generally,glabrou,half,honeycomb-shaped,lax,lengthening,linear,living,lobe,long,lower,middl,nflorescence,orolla,perfect,petiolule,plurifoliate,pore,poricidal,pubescen,rarely,removed,ruit,seudostipule,singly,slightly,slit,sometimes,spaced,specimen,stamen,ste,stolo,straight,subequal,tall,talle,tamen,tem,toward,tri-,truncate,tube,typically,unequal,unit,unwinged,usually,vary,wide,x,ympodial	5-merous,abaxial,adaxial,arrangement,capitate,color,colour,form,frequency,growth,height,history,inflorescence,leaf,length,life,mucilaginousnes,na,ovary,perennial,position,pseudostipule,reproduction,shape,spacing,staman,stolon,surface,texture,width
178	wfo-0001027091	success	142	96	64	78	32	0.451	.3,1-1.6,1.1-1.6,1.8-2.6,1/2-2/3,2.5-3.5,3-8,3-9,5-11,8.5-11.5,9-13,acute-tipped,annual,anther,armed,blade,blue,bristly,broadly,brown,calyx,capitate-glandular,cauline,cm,dark,densely,dm,dry,glabrous,glandular,green,hair,herb,internodal,lenticular,linear-lanceolate,long,low,maturity,mm,mostly,oriented,ovate,pedicel,petiole,pinnatifid,prickly,radially,reticulately,ridge,simple,sparsely,spherical,splitting,stellate-pentagonal,stem,surface,tube,twice,undulate,variously,vestiture,violet,wrinkled	0.7,0.8,2.3-2.9,30-60,4-10,6-10,6-10-flowere,accrescent,across,along,alyx,anthesi,arcuate,base,beneath,berry,branched,campanulate,deltoid,developing,dia,difoliate,divided,eaf,eed,enveloped,extended,few-rayed,fully,geminat,gland,high,invested,lobe,lon,longer,main,narrowly,near,nflorescence,obtuse,occasionally,orolla,per,pinnatisect,rounded,ruit,scattered,sessile,short,short-stipitate,slende,sometimes,somewhat,spreadingly,ste,stellae,strait,suffused,tamen,tapering,taprooted,terete,terminally,tightly,tigma,tub,tyle,unexpande,uniseriate,unit,usually,vary,vein,wholly,yello,ympodial,younger	6-10-flowered,abaxial,adaxial,arrangement,color,colour,corolla,diameter,filament,flower,form,fruit,growth,height,history,inflorescence,leaf,length,life,na,number,ovary,plant,position,seed,shape,staman,stigma,style,texture,unexpanded,yellow
179	wfo-0001027102	success	167	103	81	86	22	0.485	.5,0.2-2,0.5,0.5-1,0.5-2,0.5-3,1-1.5,1-2,1-2.5,1-3,1-4,10-20,15-35,2-3,3,3-12,3-4,4-5,4-7,5-12,abaxially,acuman,adaxially,almost,anther,apart,articulated,base,broadly,calyx,chartaceous,cm,curved,deltate,diameter,dimorphic,elliptic,filament,flattened,flower,forked,fruit,glabrous,globose,lanceolate,leaf,leaf-opposed,lobe,major,minor,mm,moderately,narrowly,oblong,orange,pedicel,peduncle,petiole,pubescent,rachi,rarely,ripe,rugulose,shrub,simple,size,slender,small,somewhat,stellate,stigma,style,surface,tip,truncate,tube,unbranched,white,x,yellow,yellow-brown	.5-6,1-6,1.5-2,15,2-2.5,3-5,<,absen,absent,accrescent,acuminate,acute,adaxial,adaxiall,ag,aggregate,alyx,apex,appearance,axe,ba,blade,broad,cell,channe,ciliate,congested,connivent,corky,cuneate,cylindrical,densely,differing,difoliate,directed,distally,eaf,eed,entire,few-,free,fruiting,geminat,giving,hair,ilament,long,long-tapered,longitudinal,m.,margin,multiseriate,nflorescence,obtuse,often,one,opening,orolla,ovate,per,perfect,pore,portion,roughened,ruit,short,slit,spaced,sparsely,stem,stone,straight,subcoriaceous,tal,tem,time,tomentose,triangular,truncat,unarme,unit,usually,vary,wide,ympodial,young	arrangement,articulation,color,corolla,dimorphism,form,growth,height,history,inflorescence,length,life,na,ovary,perennial,plant,position,reproduction,seed,shape,spacing,texture
180	wfo-0001027104	invalid_json_followup	141	98	61	80	37	0.433	0.15-0.35,1-3,1-4,1.2-6,1.5-2.3,10-15,3-5.5,6-7.5,acuminate,acute,apex,articulate,base,branched,cell,cm,corolla,covering,cyme,diameter,dichasial,dichasially,distal,ebracteate,filament,finely,flower,globose,green,green-white,half,herbaceous,honeycomb,lateral,mm,monochasial,mucilaginous,odd-pinnate,ovate,ovoid,pattern,pedicel,peduncle,perennial,petiole,plant,proximal,pubescent,seed,stellate,stigma,style,testal,thick,throughout,tone,wall,white,yellow,yellow-green,¼	0.5-0.8,1-1.5,1.5-4.2,2-3,2-6,2.2-5,3-6-foliat,4-15,5-15,abaxially,acumen,adaxially,apical,apically,attenuate,calyx,condition,connate,cordate,dehiscent,digestion,dorsally,eaf,edge,eed,emoval,enzyme,epiphyti,epiphytic-like,exceeding,flat,folded,forked,generally,globo,growing,hair-like,introrse,linear,living,lobe,lon,long,lower,make,maturing,mos,mucronate,narrowly,nflorescence,nther,often,orolla,ovat,perfect,plan,poricidally,rarely,reveal,ruit,seudostipule,short,simple,slit,specimen,stamen,straight,tall,tem,terrestrial,throughou,truncate,tuber-bearing,typically,unit,vary,viole,wide,without,ympodial	'','hair-like,[,],``,abaxial,adaxial,anther,arrangement,characteristic,color,colour,form,fruit,growth,height,history,inflorescence,leaf,length,life,na,ovary,position,rachi,reproduction,shape,spacing,staman,surface,texture,value,violet,wet,width,{,}
181	wfo-0001027114	invalid_json_followup	154	130	89	65	41	0.578	-2,.5,1-1.1,1-2,1.5-1.7,1.5-2,1/2,2-3,20-40,3-4,3-7,5,6-8,abaxial,acute,along,anther,apex,appearing,bark,base,branched,bushy,calyx,capitate,cm,corolla,dark,dendritic,densely,drying,elliptic,exserted,filament,flattened-reniform,fruiting,glabrous,globose,green,halfway,inflorescence,lamina,lateral,leaf,lobe,lobed,long,main,many,margin,minute,minutely,mm,occasionally,opening,opposite,ovary,pedicel,petiole,pitted,poricidal,projection,pubescent,reddish,reddish-brown,scar,scattered,shoot-terminal,shrub,simple,slit,spaced,stem,stigma,style,surface,thickened,time,tip,triangular,trichome,tube,unevenly,uniseriate,vein,way,white,woody,yellowish	-17,-30,0.5-1,1-1.2,1-1.5,13-21,2-2.5,6-9,7-10,7-9,abaxially,adaxially,alternating,anthesi,apar,axillary,ba,berry,closely,commonly,conical,deltate,dia,differing,difoliate,due,eaf,edicel,eed,erect,flowered,free,geminate,glabrou,growt,inflorescenc,investing,like,lon,lower,major,minor,nflorescence,older,pair,papillo,planar,plurifoliate,pore,portion,rapid,rest,ruit,several,shoot,size,soft,tall,tapering,tub,ud,unit,wide,ympodial,young	'',[,``,adaxial,angle,apart,arrangement,branching,bud,characteristic,color,colour,diameter,exsertion,feature,flower,form,fruit,growth,height,history,length,life,na,number,papillose,peduncle,perennial,plant,position,rachi,reproduction,seed,shape,spacing,staman,texture,value,width,{,}
182	wfo-0001027117	success	235	107	77	158	30	0.328	-12,0-5,0.1,0.1-0.7,0.5,0.6-0.9,0.7-1.5,1-2,1-4,1.5-2.3,2-8,4-8,4.5-6.5,acicular,acute,almost,anther,apex,attenuate,bark,base,black,brown,cm,cordate,dark,densely,diameter,evenly,filament,flattened-reniform,flower,fruit,glabrescent,glabrous,green,herb,lateral,leaf,length,less,lobed,margin,mature,mauve,mm,moderately,pair,pale,pedicel,peduncle,petiole,porrect,prickle,primary,red-brown,rounded,sessile,shallowly,shiny,smooth,spherical,stalked,staman,stellate,stellate-pubescent,straight,style,surface,tertiary,trichome,vein,venation,visible,yellow,yellow-green,young	-1.5,-11,-2.8,-3/4,.5,/3,0-10,0-15,0-20,0-25,0-40,0.1-,0.15-0.25,0.15-0.35,0.2,0.2-0.45,0.5-1.5,0.7-0.9,0.7-1.3,0.8-,1-6,1.2,1.5-,1.5-6.5,1.7-2.5,1.8-2.5,1/,1/3,1/4,1/8-1/2,10-20,2-3,2-6,2.3-2.8,25-100,3-10,3-15,3-6,4-6.5,4-7,4.5-8,5-11,5-14,5-merous,6-10,6-9,7-,8,abaxially,accrescent,alyx,ame,apar,apart,apically,apparently,articulated,berry,beyond,blade,branched,brittle,c.,calyx,cell,chartaceous,concolorous,connivent,curved,deltate,discolorous,distance,drying,eaf,eed,elongating,enclosing,erect,extending,fifth,fine,four,free,fruiting,gently,gra,herbarium,infructescence,irregularly,lobe,lon,long,long-acuminat,longer,lower,maturity,membranous,midpoint,midvein,narrow-deltate,narrow-elliptic,narrow-lanceolate,nflorescence,oblong,obovate,older,one,open,orolla,oung,outline,ovate,pendulous,per,perfec,pericarp,perpendicular,pit,plurifoliat,poricidal,portion,prickl,prickly,raised,ray,reduced,reflexed,ruit,scar,shorter,side,small,sometimes,spaced,sparsely,specimen,spreading,stalk,stem,tamen,tapering,tearing,terete,time,tip,tissue,translucent,tube,unequal,unit,upper,variously,vary,way,weakly,wide,woody,ympodial	abaxial,adaxial,arrangement,color,colour,corolla,form,gray,growth,height,history,inflorescence,life,number,ovary,perennial,perfect,plant,plurifoliate,position,rachi,reproduction,seed,shape,spacing,stigma,texture,unknown,visibility,width
183	wfo-0001027123	success	181	107	86	95	21	0.475	0.5,0.8-1.3,1,1-1.2,1-1.5,1.5-2,2-2.6,2-5.5,2-lobed,2.5-4,5-6,abaxial,anther,apex,base,branched,bright,brown,calyx,cell,clavate,cm,commonly,conical,constricted,corolla,cup-shaped,dark,dendritic,densely,diameter,elliptic,exerted,filament,flattened,free,glabrous,globose,green,inflorescence,inserted,leaf,less,lobed,loosely,mauve-purple,minutely,mm,narrowly,outline,ovary,papillate,pedicel,peduncle,perfect,petiole,pitted,portion,pubescent,reddish,reniform,scar,shiny,short,simple,sinuate,sleeve,soon,spaced,sparsely,stigma,strongly,style,subshrub,surface,terminal,testal,trichome,tube,violet,way,white,widely,x,young,¾	-10,-20,.3,.5,0.3-1.6cm,0.5-0.8,0.7-3.5,0.9-1.3,2-2.2,2-2.5,2-3,2.5-10.4,2.5-6,3-15,3-4,4-5,4-6,5-10,acute,adaxial,adaxially,along,anthesi,appearing,attenuate,axe,axi,bark,broadly,campanulate,completely,coriaceous,darker,deltate,denser,drying,eaf,edge,eed,enlarged,erect,fide,flower,fruiting,glandular,lamina,lax,lewi,like,lobe,lon,long,loose,lower,margin,midvein,minute,monopodia,nflorescence,nodding,older,pair,papillae,perhaps,petal,planar,plurifoliate,primary,prominent,revolute,scatted,scattered,shin,shinin,shining,slightly,sometimes,stellate,stem,stoutish,straight,thick,time,tip,trailing,tub,turned,ud,unit,upper,usually,vein,warty,wood,ympodial	0.3-1.6,2,bud,color,colour,constriction,form,growth,hair,height,history,length,life,perennial,plant,position,reproduction,seed,shape,spacing,texture
184	wfo-0001027125	success	155	100	65	90	35	0.419	.5,0,3,4,5,abaxially,absent,acuminate,acute,adaxially,anther,anthesi,apex,armed,blue,branched,brown,clavate,cm,corolla,diameter,ellipsoid,elliptic,elongating,entire,filament,flattened,fleshy,flower,foveolate,fruit,glabrous,globose,green,internode,light,long,margin,mm,mostly,narrowly,oblong,pedicel,peduncle,petiole,prickle,rachi,recurved,rugose,simple,slender,somewhat,spreading,stem,stigma,strongly,style,surface,terminal,thick,time,vine,wide,yellow,×	/4,0.3,0.3-0.6,0.5,0.8,1,1.2-2,10–,10–15,12,12–17,1–,25–50,3–,3–10,3–5,3–7,4–6,50,5–10,5–7,6,6–,6–9,?,ag,alyx,apiculate,articulated,axe,ba,base,becoming,bilobe,blade,bud,calyx,campanulate,clustered,completely,connivent,coriaceous,cucullat,deeply,dr.,eaf,eed,equal,exserted,lateral,lengthening,lobe,lobed,long-styled,lower,major,middle,midrib,minutely,nflorescence,orolla,papillate,plurifoliat,pore,poricidal,recurve,robust,rounded,ruit,side,slit,stellate,stout,subwoody,tamen,terminally,thickened,tip,triangular,truncate,tube,unit,vary,vein,way,widest,woody,ympodial,youn,–9	0.3-0.8,1-7,10-50,3-10,3-5,4-6,6-17,9,abaxial,absence,arrangement,axi,bilobed,color,dry,elongation,form,growth,height,inflorescence,leaf,length,na,ovary,plant,position,ratio,reproduction,seed,shape,size,spacing,staman,texture,width
185	wfo-0001027131	success	186	95	69	117	26	0.371	0-5,0.9-2.5,1-1.5,1-4,1.5-3.3,1.7-3.5,12-20,4-10,4.5-8.5,5.5-6.5,9.5-11.5,acute,andromonoecious,anther,apex,attenuate,base,black,blade,broad-based,brown,calyx,cm,cordate,dark,densely,diameter,entire,extra-axillary,fruit,fruiting,globose,green,grey,inflorescence,length,margin,mm,obtuse,ovate,pale,pedicel,peduncle,per,perennial,petiole,plant,plurifoliate,possibly,prickle,pseudo-racemose,purple,ridged,rotate,rusty,shrub,simple,stellate-pubescent,stem,straight,streak,style,terete,unbranched,unit,white,yellow,yellowish,yellowish-green	%,.05,.7,0-0.1,0-0.3,0-2,0-3,0.2-2.2,0.4-0.8,0.4-1,0.5-0.8,0.5-1,0.7-2.5,1-1.2,1-2,1-3,1.4-2,17-35,2-5,2.3-2.7,2.6-3,3-4,3-9,4-7,4-8,4-locular,5-merou,7-11,7-8,7-9,abaxially,absen,absent,across,adaxiall,adaxially,alyx,anvil-shape,apart,articulated,ascending,axe,ba,chartaceous,circular,cross-section,cylindrical,d.,directed,distall,distally,distributed,dult,eaf,eed,eglandular,elliptical,erect,exocarp,finger,flower,functional,geminat,gland-tipped,hair,half,heterostylous,hig,juicy,lamina,lateral,less,lobe,long,longer,lower,markedly,mature,mesocarp,mid-point,midpoint,minute,moist,nflorescence,oblique,onl,orolla,part,placenta,pore,porrect,present,ray,rhizomatous,ruit,short,spaced,stage,stalk,stalked,stellae,tamen,thick,thicker,thicknes,throughout,time,tube,unarme,unarmed,unknow,uvenile,vary,weakly,wide,x,ympodial	abaxial,adaxial,arrangement,color,colour,corolla,density,dm,filament,form,growth,height,history,leaf,life,na,ovary,position,reproduction,seed,shape,staman,stigma,surface,texture,width
186	wfo-0001027146	success	213	121	93	120	28	0.437	0-11,0.3-2.2,1-10,1-2,1-9.5,10,13-36,2-4.2,2-5,3.3-6.1,4-12.5,6-10,abaxially,adaxially,along,anther,apex,attenuate,bead,brownish,cell,clavate,cm,coarsely,condition,conical,corolla,covering,dark,deep,diameter,drying,elliptic,filament,finely,flower,forked,fresh,fruit,glabrous,green,greenish,hair,hair-like,herb,interjected,lateral,leaf,leaflet,like,medium,minute,minutely,mm,moniliform,necklace,odd-pinnate,orbicular,ovate,ovoid,pair,pedicel,peduncle,pentagonal,petiole,petiolule,plant,plurifoliate,puberulent,pubescent,purple,ripe,rotate,seed,size,stem,stigma,stolon,style,subsessile,terminal,testal,thick,throughout,tinged,tri-,tuber,unit,violet,wall,white,whitish,yellow	0.5-3.2,0.6-3.3,0.7-2.4,0.8,0.8-3.1,0.8-5.8,1-2.5,1.9-10,2-12.2,2-13,3.5-22,4-11,4-38,4-8,5-merou,6,6-17.5,6.5-52,acumen,acuminate,ag,alyx,apart,apparently,arranged,articulated,asymmetrical,axe,axillary,base,basiscopic,berry,blade,bud,capitat,chartaceous,ciliate,commonly,connivent,darker,decreasing,digestion,distal,dorsally,eaf,edge,eed,enzyme,erec,especially,exceeding,flat,folded,fourt,fourth,geminat,generally,glabrou,gradually,green-white,half,homostylous,honeycomb-shaped,lanceolate,lengthening,living,lobe,long,lower,make,margin,membranous,midrib,mottled,mucilaginous,multiple,nflorescence,orolla,perfect,pore,poricidal,proximal,rarely,ray,removed,ruit,secondary,semierect,sessile,seudostipule,side,simple,slit,sometimes,spaced,specimen,stamen,ste,straight,subequal,subglabrou,subglabrous,subtending,symmetrical,tall,tamen,tem,tip,tissue,toward,tube,typically,unwinged,usually,vary,wet,wide,wing,x,ympodial	0-6,abaxial,adaxial,arrangement,capitate,color,colour,form,geminate,growth,height,history,inflorescence,length,life,na,ovary,perennial,position,pseudostipule,rachi,reproduction,shape,spacing,staman,surface,texture,width
187	wfo-0001027154	success	215	84	53	162	31	0.247	.5,0.2,2-6,5,anther,apex,attenuate,cm,color,cylindrical,densely,diameter,extra-axillary,filament,flower,foveolate,fruit,globose,green,immature,leaf,length,major,minutely,mm,ovate,pedicel,peduncle,petiole,plant,prickle,pubescent,rachi,reniform,rotate-pentagonal,rounded,shape,shrub,simple,sometimes,stellate-tomentose,stigma,straight,style,surface,tan,tomentose,underside,vein,white,yellow,yellowish,–4	-15,-16,.2,.6,0,0.3–0.6,0.4-0.5,1-1.3,1.5–2.5,1.5–3,1.9,17–19,1–2,2,2.5-5,2.9,23,26,2–2.5,2–4,3-7,35,3–10,4.5–5,4.5–8,4–8,6–8,6–9-rayed,7.5-11,7–20,8,8-11,abaxially,absent,accrescent,acute,adaxiall,adaxially,ag,alyx,ample,apart,armed,articulated,axe,ba,basal,base,berry,blade,branch,branched,broad,broad-based,calyx,capitat,chartaceous,clavate,connivent,curved,deltate,difoliate,directed,distally,eaf,eed,entire,evidently,except,ferruginous,finer,flattened,flowering,free,fruiting,geminat,glabrescen,glabrous,hair,highly,ilament,interpetalar,irregularly,juvenile,lanceolate,larger,less,lighter,like,linear,lobe,lobed,lognitudinal,long,m.,margin,mature,midpoint,midrib,minute,mostly,much,near,nearly,nflorescence,normally,oblique,often,older,opening,orolla,outline,paler,part,per,perfect,pinnately,pore,rarely,ray,reaching,recurved,reflexed,repand,ruit,sessile,shiny,side,sinus,size,slightly,slit,smaller,spaced,sprout,ste,stellae,stem,stipe,stipitate,stout,sulcate,tal,tardily,tem,third,three,tissue,truncate,tube,unarme,unarmed,uniform,unit,unknown,usually,variable,vary,within,x,ympodial,young	1-2,1.5-2.5,1.5-3,10-19,2-2.5,2-4,4-8,4.5-5,abaxial,adaxial,arrangement,capitate,colour,corolla,feature,form,growth,height,history,inflorescence,life,na,ovary,perennial,position,reproduction,seed,spacing,staman,texture,width
188	wfo-0001027157	success	207	128	100	107	28	0.483	0.15-0.3,0.9-2.8,1,1-10,1-2,1.5-6.5,10-30,2,2-3,3-12,4-5,9-12,abaxially,absent,acuminate,acute,adaxially,anther,apex,axillary,base,broadly,brownish,bud,cell,chartaceous,ciliate,clavate,cm,condition,conical,cordate,corolla,covering,deeply,densely,diameter,dorsally,drying,edge,elliptic,especially,filament,flat,flower,folded,forked,fresh,fruit,glabrous,green,greenish,hair,hair-like,herb,honeycomb-shaped,lateral,leaf,leaflet,like,long,margin,membranous,minutely,mm,narrowly,oblique,obtuse,odd-pinnate,ovate,ovoid,pedicel,peduncle,petiole,petiolule,plant,puberulent,pubescent,ripe,rounded,seed,sometimes,stellate,stem,stigma,style,subtending,terminal,testal,thick,tinged,tip,tuber,typically,violet,wall,wet,white,whitish,yellow	0-3,0.7-2,1-3,1-3.8,1-6,2-15,2-2.5,2-5,2.3-4,2.5-3,3-7,3.3-7.8,3.8-8.3,5-merou,6.5-14.5,acumen,ag,along,alyx,among,apart,apparently,articulated,attenuate,axe,berry,blade,capitat,connivent,cuneate,decreasing,decurrent,digestion,distal,eaf,eed,end,enzyme,erec,exceeding,geminat,generally,glabrou,grassland,greatly,green-white,half,homostylous,interjected,lanceolate,lengthening,living,lobe,low-growing,lower,make,markedly,middl,midrib,mucilaginous,nflorescence,one,orbicular,orolla,pair,perfect,petiolulate,placed,plurifoliate,pore,poricidal,rarely,removed,ruit,semi-rosette,sessile,seudostipule,shady,short,situation,size,slightly,slit,spaced,specimen,stamen,ste,stolo,straight,subsessile,sunny,tall,tamen,tem,throughout,toward,tri-,tube,unequal,unit,unwinged,usually,vary,wide,woodland,x,ympodial	abaxial,adaxial,arrangement,capitate,color,colour,form,growth,height,history,inflorescence,length,life,mucilaginousnes,na,ovary,perennial,position,pseudostipule,rachi,reproduction,shape,spacing,staman,stolon,surface,texture,width
189	wfo-0001027184	success	219	127	94	125	33	0.429	.3,.5,.7,0-0.2,0.2-0.4,0.4-2,0.5-2,0.8,1.5-5,2,4,5,adventitious,anther,appressed,blue,broad,brown,calyx,chartaceous,cm,covered,diameter,elliptic,epidermal,extension,fasciculate,filament,flattened,fleshy,fruit,glabrescent,glabrous,globose,hair,hairlike,herbaceous,imparipinnate,introrsely,lanceolate,leaf,leaflet,least,light,longitudinal,margin,membranous,meter,mm,mostly,narrowly,node,oblong,often,older,opening,opposite,orange,ovate,pedicel,peduncle,per,petiole,pilose,pore,prominently,pseudostipule,pubescent,rachi,red,reticulate,revolute,root,several,shape,size,slightly,slit,sparsely,stellate,stem,stigma,style,subopposite,sulcate,surface,tightly,unbranched,vine,wall,white,x,yellow,young	.8,0-,0.4–0.9,0.8–1.6,0–3,1-2,1.5,1.8–3.5,13–18,19,1–2,1–2.5,1–4,2.8–4.1,2–4-celled,3-4-,3-foliolate,3.5–8,3–,3–4-celled,4–12,5-7,7,9,abaxially,absent,accrescent,acute,adaxiall,adaxially,ag,along,always,alyx,apart,apex,articulated,axe,axi,axillary,ba,basal,base,blade,borne,bract-like,branch,broadly,cell,clavat,cluster,connivent,cordat,cylindrical,densely,directed,eaf,eed,entire,especially,flower,foliaceous,free,fruiting,geminat,generally,glabrou,grading,half,ilament,larger,largest,lateral,leafy,less,like,lobe,long,lower,m.,midrib,minutely,much,nearly,nflorescence,obtuse,orolla,ower,petiolule,plurifoliate,portion,prominent,puberulent,raised,rarely,ripe,ruit,scarcely,secondary,shoot,short,simple,small,soft-woody,somewhat,spaced,straight,terminal,tertiary,tip,tree,truncate,trunk,tube,unarme,unequal,uniform,unit,usually,vary,vein,visible,weak,ympodial,–9	0-3,1-2.5,1-4,13-18,3-9,3.5-8,4-12,abaxial,adaxial,age,appression,arrangement,attachment,branching,clavate,color,cordate,corolla,direction,form,growth,height,inflorescence,length,number,ovary,plant,seed,spacing,sulcation,texture,type,variation
190	wfo-0001027186	success	168	135	117	51	18	0.696	-6,.4,.5,0.5-1,1-2.5,1.4-1.6,1.5-2,15,2-6,2-lobed,3-4,3.5-4,30-40,4-9,5-10,6-7,9-10,abaxially,acute,adaxially,anther,anthesi,apart,apex,apparently,attenuate,bark,base,berry,branched,brown,calyx,clavate,cm,conical,corolla,dark,dbh,deflexed,dendritic,densely,diameter,dry,ellipsoid,elliptic,entire,exerted,filament,filiform,flower,fruit,glabrescent,glabrous,globose,golden,green,growth,irregularly,keeled,lamina,less,lobed,loose,margin,maturity,midrib,minutely,mm,narrowly,new,occasionally,ovary,ovoid,pair,pale,papillate,pedicel,peduncle,perfect,petiole,pitted,pointed,primary,pubescent,reddish,reniform,rough,scar,scattered,seed,shiny,simple,slightly,small,soon,spaced,sparsely,stem,stigma,strongly,style,surface,terminal,time,tip,tree,treelet,trichome,tube,uniseriate,variably,vein,way,white,woody,x,yellow	1-1.5,1.5,1.5-2.5,1.6-5,2.5-3,4-15,?,abaxial,age,always,axil,branch,broadly,deltate,denditic,denser,eaf,enlarging,free,fruiting,immature,incrassat,lengthening,like,lobe,longer,lower,m.,much,nflorescence,papillat,pendent,pericarp,planar,plane,plurifoliat,pore,poridical,portion,pubescen,rachi,ruit,short,slit,spreading,stalk,straight,tub,ud,unit,ympodial	arrangement,branching,bud,color,exertion,form,height,incrassate,inflorescence,leaf,length,na,number,plant,pubescence,shape,spacing,texture
191	wfo-0001027187	success	224	120	84	140	36	0.375	0.6,5-merous,5.4,9,accrescent,anther,apex,armed,axe,base,blue,branched,broadly,bud,calyx,cm,completely,cordate,covering,cuneate,darker,deltoid-ovate,densely,diameter,equal,extra-axillary,filament,finely,flattened-reniform,flower,forked,foveolate,fruit,fruiting,glabrous,globose,green,herb,hermaphroditic,irregularly,leaf,lenticular,light,lobed,long,margin,maturity,mm,moderately,mottling,node,obtuse,often,pedicel,peduncle,perennial,petiole,prickle,producing,rarely,root,rooting,rotate-stellate,rounded,serrate,shallowly,simple,sky,sparsely,stellate,stellate-pubescent,stem,stigma,strongly,style,subglobose,surface,truncate,unbranched,unequal,usually,vein,yellow,young	.5,0,0.05–0.1,0.15–0.4,0.2,0.3–1,0.4,0.5,0.5–1,0.5–1.5,0.8–2,1,1-celled,1.0,1.2,1.5–3.5,12,13–18,1–1.5,1–1.8,1–2,1–3,1–3-celled,2,2-,2.5–4,2.5–6,2–2.5,2–3,2–5,2–7,3-foliate,3.2,3.5–10,3–10,3–10.5,3–6,3–7,4,4.5–8,4–5,5,5.5,5–10,5–11,5–15,5–6,5–8,6,6–8,7,7–12,7–15,abaxially,acute,acute-acuminate,adaxiall,adaxially,alyx,andromonoecious,apart,articulated,berry,blade,capitat,central,chartaceous,connivent,continuum,cylindrical,decumbent,deflexed,deltate,deltate-lanceolate,directed,distal,distall,downward,eaf,eed,erect,exserted,geminat,glandular-puberulent,grading,hair,lanceolate,lateral,like,lobe,lon,long-stalked,lower,major,minutely,morphology,narrowly,nflorescence,offset,one,open,orolla,outline,perfect,plurifoliate,pore,prickle-like,proximal,pubescent,ray,rind,ruit,sessile,short-stalked,showing,side,sinus,small,sometimes,spaced,spreading,stalk,staminate,stout,straight,subequal,subsessile,tall,tamen,tapered,tem,toug,triangular,tube,unit,vary,weakly,wide,ympodial,×	0.5-1.5,0.8-2,1.5-3.5,2-3,2-7,3-7,3.5-10,7-12,abaxial,adaxial,arrangement,branching,capitate,color,colour,corolla,form,growth,height,history,inflorescence,length,life,na,ovary,plant,position,production,rachi,reproduction,seed,shape,spacing,staman,texture,width
192	wfo-0001027198	success	191	121	92	99	29	0.482	.5,0.05-1.0,0.5-0.75,0.8-1,1-1.5,1-10,1.5-10,1.5-2,3/4,5-6,abruptly,acuminate,acute,anther,anthesi,apart,apex,base,beneath,broadening,calyx,channeled,clavate,cm,corky,corolla,cyathiform,dendritic,densely,elliptic,erect,female,filament,flower,fruiting,furcate,glabrous,globose,golden,green,inflorescence,leaf,lobed,long,male,margin,minute,minutely,mm,obovate,often,opposite,ovary,ovoid,ovoid-reniform,pale,paler,papillose,pedicel,petiole,pitted,planar,plant,pore,puberulent,pubescence,pubescent,rather,reflexed,rest,shaped,shining,short,shrub,simple,slender,slightly,stem,stigma,style,surface,tannish-yellow,tear-drop,tip,tree,trichome,tube,uniseriate,vein,way,white,woody	.4,0.5-1,0.7-1,1-5,10-11,11-20,2-5.5,4-9,5-120-flowered,7.5-9,always,attenuate,axil,ba,beginning,berry,bushy,caly,closely,complex,constriction,corresponding,decurrent,deltoid,dia,differing,difoliate,dry,eaf,edge,edicel,eed,entire,evenly,exserted,extremely,eye,found,free,geminat,glabrate,impressed,inflorescenc,invisible,large,lateral,like,live,lobe,lon,lower,main,major,many,medium,meet,middle,minor,naked,nearly,nflorescence,older,overlapping,papillo,pendan,poricidal,portion,reddi,rounded,ruit,scar,sessile,set,size,small,soon,spaced,speciman,specimen,straight,strong,styled,tall,testae,thickened,thin,time,top,two,type,ud,undersurface,unit,usually,widest,x,yellowish,ympodial,young	abaxial,adaxial,alternate,arrangement,bud,color,colour,diameter,form,fruit,growth,height,history,length,life,na,orientation,peduncle,pendant,perennial,position,rachi,reproduction,seed,shape,spacing,staman,texture,width
193	wfo-0001027200	success	139	84	65	74	19	0.468	0.05-0.25,0.25-0.5,0.5-0.75,0.6-1,1-1.4,1-1.5,1.5-5,2-3,3-3.5,6-8,acute,anther,apex,bark,base,beneath,branch,brown,capitate,cm,corolla,dark,deeply,elliptic,filament,fruiting,glabrous,globose,golden,green,grey-brown,horizontally,inflorescence,leaf,lobe,lobed,minor,minutely,mm,nearly,ovary,ovoid-reniform,papillose,pedicel,petiole,pitted,puberulent,shaped,sparsely,spreading,stem,stigma,style,surface,tear-drop,tip,trichome,unicellular,unifoliate,uniseriate,vein,white,woody,x,yellowish	0.5-1,0.7-2.5,1.2-1.5,1.5-2,1.6-6,2.5-3,3.5-6,8-15,9-11,across,anthesi,aspec,ba,berry,branche,broadly,calyx,conical,converging,decurrent,deflexed,deltoid,densely,dia,differing,eaf,eed,except,flattened,free,geminate,giving,impressed,lateral,lightly,like,lon,long,lower,main,major,margin,middle,minute,near,node,non-reproductive,occasionally,older,onto,papillo,planar,pore,poricidal,portion,prominent,reflexed,rest,ruit,shrub,size,slightly,small,sparse,straight,tall,tree,tube,unit,widened,widest,winged,ympodial,young	abaxial,adaxial,arrangement,color,colour,diameter,flower,fruit,length,na,peduncle,position,rachi,seed,shape,spacing,staman,texture,width
194	wfo-0001027204	success	154	124	92	62	32	0.597	-40,.5-1,0.5-4,1,1-10,1-14,1-3.5,1-7,1.5-3.5,1.5-9,2-2.5,2-8,3-5,4-6,5-30,5-9,6-10,acuminate,acute,adaxial,aggregate,along,angled,apart,apex,articulated,base,branched,brown,calyx,cell,chartaceous,cm,cuneate,decurrent,dense,densely,diameter,distally,elliptic,entire,especially,expanded,flower,forked,fruit,glabrate,glabrous,globose,greenish,leaving,lobe,long,margin,membranaceous,mm,moderately,near,nearly,orange,pedicel,peduncle,peg,perfect,petiole,pink,present,pseudohair,pubescent,pubescent-pilose,purplish,rachi,radiu,reddish,rugose,scar,short,shrub,simple,stellate,stellate-campanulate,stigma,stone,style,triangular-deltate,twice,unbranched,violet,white,x,yellow,yellowish	-4.5,-8,.8-2,1.5-6.5,15-35,2-4,2-5,3-20,4-5-foliat,5-19,6-12,8-15,abaxially,absen,adaxially,axe,blade,channe,connivent,cylindrical,denser,directed,distall,eaf,eed,eglandular,except,glandular,hair,lanceolate,lon,lower,midrib,narrowed,narrowly,nflorescence,nther,obtuse,often,orolla,ovate,pore,puberulent,pubescen,ripe,ruit,spaced,sparsely,subacute,subcoriaceous,tal,tem,time,tip,triangular,truncat,tube,unit,vary,wide,x1-2,ympodial	1-2,abaxial,absent,anther,arrangement,color,colour,corolla,feature,filament,form,growth,height,history,inflorescence,leaf,length,life,na,ovary,perennial,plant,position,reproduction,seed,shape,spacing,staman,surface,texture,truncate,width
195	wfo-0001027213	success	231	133	104	127	29	0.45	-19,-3.3,-4.5,0-2.5,0.2-0.4,0.2-0.5,0.7-2.3,0.8-1.8,1-2,1-5,1.2-2.5,1.7-3.9,1.8-3.2,1/2-2/3,12.3-16.3,2-5,2.9-3.8,2.9-4.8,4-9.5,5-8,5.7-6.2,9-13,abaxially,accrescent,acute,adaxially,anther,apart,apex,attenuate,base,blade,branch,branched,broadly,brown,calyx,cm,conical,corolla,cuneate,dark,deltoid,diameter,drying,elliptic,entire,filament,flower,fruit,fruiting,glabrescent,glabrous,globose,granular,grayish-brown,green,lateral,leaf,length,lobe,lobed,main,margin,midrib,mm,oblanceolate,obovate,obscured,orbicular,pale,pedicel,peduncle,petiole,pubescent,rachi,reniform,reticulate-punctate,scabrous,short-attenuate,shrub,side,simple,sometimes,stellate,stigma,style,subcampanulate,surface,suture,terete,tomentose,tree,vein,violet,way,white,whitish,whitish-green,x,yellow,yellow-green,yellow-tan,yellowish	-230,/10,0-160,1.1-1.7,1.2-1.6,1.2-1.7,1.3-2.2,1.7-3.6,1.8-2.8,10-24,2.4-4.7,2.5-5.1,2/3,3.5-5,3.5-8,4.2-5.9,5-7.5,5-merou,8-24,8.2-10.5,acuminate,ag,along,alyx,anthesi,apparently,ark,around,articulated,axe,axillary,ba,basal,blunt-tipped,capitat,cell,completely,covering,cylindrical,decurrent,directed,distally,eaf,early,edge,eed,enveloping,epidermal,eventually,exserted,farinose,few-rayed,free,glabrescen,group,hair,high,homostylous,immature,inserted,lackin,lanceolate,lengthening,long,long-,long-stalked,longitudinal,lower,m.,many,mixed,moderately,mostly,multangulat,multangulate,nearly,nflorescence,obtuse,often,older,orolla,ovate,ovate-lanceolate,partly,perfect,plurifoliate,pore,poricidal,porrect-stellat,porrect-stellate,prominent,pseudo-terminal,pubescence,rather,relatively,ruit,sessile,short,short-,short-stalked,slit,somewhat,spaced,sparsely,stamen,stem,tamen,thick,thick-stalked,thin-stalked,ti,time,tip,tomentose-pubescent,tomentu,touching,tube,ud,unarme,unarmed,unit,unwinged,vary,vestigial-rayed,wide,ympodial,young	abaxial,adaxial,arrangement,bark,bud,capitate,color,colour,form,growth,height,history,inflorescence,life,na,ovary,perennial,plant,position,pseudoterminally,reproduction,seed,seedling,shape,spacing,staman,texture,tomentum,width
196	wfo-0001027214	success	181	88	62	119	26	0.343	0,0.3-1.5,0.5-0.8,1-1.5,1.5,10-13,2,2-9,abaxially,adaxially,anther,anticlinal,apex,cell,cm,conical,corolla,densely,diameter,elliptic,epidermal,filament,flattened-round,flower,fruit,glabrous,green,greenish,height,herb,inflorescence,irregular,length,lobed,long-acuminate,long-conical,margin,minutely,mm,occasionally,once-branched,ovary,papillate,pedicel,per,petiole,pinnate,pointed,pubescent,rachi,rugose,seed,sharply,simple,sinuous,stigma,style,surface,thickening,tip,white,x	-20,-38,-9,..,.25,.5,0-16,0.25,0.3-1.7,0.5-1,0.7-2,0.7-2.5,0.8-1,1-2.8,1.2-3,1.5-1.8,1.5-6,10-,12-17,15-25,3-,3-6,4-5,5-6,6-,6-12,7-12,8-9,absent,acuminate,acute,along,anthesi,apical,basal,base,berry,broadly,calyx,capitat,climbing,composed,conspicuously,decurrent,deltate,dr.,drying,eaf,edicel,eed,erect,exserted,extending,finely,free,fruiting,globose,groove,grown,horizontal,inflorescenc,lamina,lanceolate,lateral,leaflet,less,like,lobe,lon,long,lower,markedly,midrib,narrowly,nearly,nflorescence,noddin,nodding,oblique,obovate,often,onto,open,opposite,pair,paired,papilla,perfectly,petiolule,poricidal,portion,projection,reflexed,rest,rugosity,ruit,scar,scattered,scrambling,smaller,somewhat,tem,terminal,time,triangular,trichome,truncate,tub,tube,ud,unevenly,unifoliat,uniseriate,unit,vein,white-lenticellate,whitish,without,ympodial	.0,2.0,abaxial,adaxial,arrangement,capitate,color,colour,form,growth,history,leaf,life,na,number,peduncle,perennial,plant,position,reproduction,shape,size,spacing,staman,texture,width
197	wfo-0001027219	success	143	98	69	74	29	0.483	0.3,0.5,0.5-0.8,1-15,1.5-2,2,2-2.5,2-3,2-4,6-8,acuminate,acute,anther,apex,bark,berry,bright,broadly,brown,calyx,capitate,closely,cm,conical,corolla,densely,diameter,elliptic,entire,erect,filament,flower,fruiting,glabrescent,glabrous,globose,green,greyish,growth,leaf-opposed,lobed,long-conical,margin,mm,new,ovary,pale,papillose-pubescent,pedicel,peduncle,pendent,petiole,pubescent,purple,scar,shrub,simple,somewhat,spaced,stem,stigma,style,surface,trichome,uniseriate,violet,weight,white,woody	.5,/4,0.4-0.6,1,1-2,1-3,1.5-2.5,2-3.5,3-5,3-6,7-8,absent,age,anthesi,axillary,base,berr,c.,completely,cup-shaped,deltate,drying,eaf,edge,eed,exerte,exfoliatin,free,glabrou,hard,heterostylous,known,lengthening,less,lobe,long-styled,lower,maturity,minutely,nflorescence,overlappin,pair,papillo,pericarp,planar,plurifoliat,pointed,pore,poricidal,portion,primary,ruit,sharply,shoot,short,short-styled,slightly,slit,sometimes,soon,stout,terminal,thickened,tip,tube,tuft,ud,unit,vein,way,x,yellowish,ympodial,–1/3	abaxial,adaxial,arrangement,bud,color,colour,dense,form,fruit,height,history,inflorescence,leaf,length,life,na,overlapping,perennial,plant,position,prickle,rachi,reproduction,seed,shape,spacing,staman,texture,width
198	wfo-0001027221	success	261	98	63	198	35	0.241	-9.5,0.3-0.6,1,1-4,2.2-3.2,4,abaxial,acute,andromonoecious,anther,apart,apex,attenuate,base,blue,branched,bright,broad-based,cm,densely,diameter,entire,extra-axillary,filament,flattened-reniform,flower,fruit,glabrous,glandular-pubescent,globose,leaf,light,margin,minutely,mm,orange,outline,ovate,pale,pedicel,peduncle,petiole,pitted,plant,prickle,rachi,shrub,simple,sometimes,sparsely,stellate,stellate-pubescent,stellate-tomentose,stem,stigma,straight,style,surface,unbranched,variable,violet,x,yellow	.5,0,0.4,0.4–0.6,0.5–2,0.8–1,1.4-2,1.5-2,1.6–2,11-17,11–14,13–16,14–17,1–2,2,2.5–2.8,2.5–5,2.9–3.6,2/3,25-30,2–2.5,2–3,2–5,3.1-4.8,3–6,4.5–11,4–8-rayed,5-8,5-merou,6-8,6.5–7,8.5–18,9,abaxiall,abaxially,acicular,actually,acutely,adaxially,along,also,always,alyx,ample,apparent,apparently,appear,armed,aromatic,articulated,ba,becoming,berry,blade,blunt-tipped,bud,calyx,capitat,caudate,central,chartaceous,clavate,closely,common,contrasting,coroll,curved,cylindrical,darker,deeply,delicate,dense,development,difoliate,directed,discrete,distally,eaf,eed,equal,eventually,evidently,exceeding,expanded,fewer,frequently,fresh,fruiting,geminat,glabrescent,gland,hair,half,herbarium,hermaphrodite,homostylous,intensity,interpetalar,juic,lanceolate,lateral,least,like,likely,lobe,lobed,long,lower,main,major,material,microscope,midpoint,midrib,midvein,minor,mostly,much,nearly,nerve,nflorescence,obtuse,often,older,orolla,ovate-oblong,ovate-triangular,pair,paired,per,perfect,perhaps,peripherally,persistently,plurifoliate,pore,predominately,probably,rarely,ray,reflexed,repand,rounded,ruit,sessile,short-stalked,side,similar,sinus,size,slightly,smaller,somewhat,soon,source,spaced,specimen,splitting,sprout,stalk,stalked,stamen,stellae,subcordate,sulcate,tal,tapered,tem,thick-textured,thickened,time,tip,tissue,tomentose,toward,triangular-caudate,tube,unarmed,underside,unequal,unit,unpleasantly,usually,vary,vein,viscid,viscidity,way,weakly,white,wide,ympodial,youn,young,–11.5,–15,–3,–4	0.5-2,1-2,1.6-2,11-14,13-16,2-2.5,2-3,2-5,2.5-5,5-merous,6.5-7,adaxial,arrangement,capitate,color,colour,corolla,form,growth,height,history,inflorescence,length,life,na,ovary,perennial,position,reproduction,seed,shape,spacing,staman,texture,width
199	wfo-0001027223	success	189	130	98	91	32	0.519	0.19-0.75,0.3-1.2,1-2,1.5-3.5,1.8-3.5,16-41,3-10,3-5,3-5.2,3.5-7,3.7-9.3,4-6,5-21,5-8,abaxially,adaxially,anther,apex,attenuate,axillary,brownish,bud,cell,clavate,cm,condition,conical,corolla,covering,deep,densely,diameter,dot,drying,elliptic,end,filament,flower,forked,fresh,fruit,glabrous,green,green-white,greenish,hair,hair-like,herb,honeycomb-shaped,hyaline,interjected,lanceolate,lateral,leaf,leaflet,light,like,long,make,mm,mucilaginous,odd-pinnate,one,ovoid,pair,pedicel,peduncle,pentagonal,petiole,placed,plant,plurifoliate,pubescent,purple,ripe,rotate,rounded,seed,size,sometimes,stigma,stripe,style,subtending,terminal,testal,thick,throughout,tri-,tuber,typically,unit,wall,wet,white,whitish,x,yellow	.5,1-3,1.3-2,2-4,2-7,3-11,3.5-4,3.5-6,5-10,5-merou,5.9-12.2,9-15,9-22,9-35,acumen,acuminate,adaxiall,ag,alyx,apart,apparently,articulated,asymmetric,axe,base,basiscopic,berry,blade,capitat,connivent,decreasing,digestion,distal,dorsally,eaf,edge,eed,enzyme,erec,exceeding,flat,folded,geminat,generally,glabrou,hal,half,homostylous,larger,lengthening,living,lobe,lower,middle,nflorescence,orbicular,orolla,ovate,perfect,petiolulate,pore,poricidal,present,removed,ruit,sessile,seudostipule,short,shortly,side,slightly,slit,spaced,specimen,stamen,ste,stolo,straight,subequal,tall,tamen,tem,tip,tissue,toward,tube,unwinged,usually,vary,wide,ympodial	abaxial,adaxial,arrangement,capitate,color,colour,form,growth,height,history,inflorescence,length,life,na,number,ovary,perennial,placement,position,pseudostipule,rachi,reproduction,shape,spacing,staman,stem,stolon,surface,sympodial,texture,type,width
200	wfo-0001027229	success	206	93	67	139	26	0.325	0-8,0.1-0.6,0.1-3,1-1.5,1-8,1.1-1.2,1.5-3,1.8-2.7,3-6,3.5-5,30-300,4-7,5-6,acicular,acute,adaxially,anther,apart,apex,base,broadly,chartaceous,cm,cordate,decimetre,densely,diameter,extra-axillary,filament,flower,fruit,glabrous,globose,green,herbaceous,index,inflorescence,length,lilac,lobed,lobing,margin,minutely,mm,obtuse,ovate,pale,pedicel,peduncle,pentagonal,per,petiole,prickle,rachi,reniform,resprouter,reticulate,shallowly,simple,sparsely,stellate,stellate-pubescent,stigma,style,surface,tan,yellow	%,0-0.1,0-0.2,0.1-0.3,0.1-1,0.1-1.4,0.2-0.4,0.2-1.7,0.2-2,0.5-0.7,0.5-0.9,0.5-3,0.6-0.7,0.6-1,1-2,1-6,1-7,1.3-1.7,1.5-2.5,12-17,2-10,2-4,2-5,2-foliate,2-locular,2.5-6,20-65,25-35,3.5-6,30-145,4-10,4-5,4-6,40-55,5-15,5-9,5-merou,7-11,8-12,8.5-12,abaxially,absen,absent,abundant,accrescent,across,adaxiall,adult,alyx,armed,articulated,attenuate,axe,ba,blade,branche,calyx,capitat,circular,cross-section,cylindrical,directed,distall,eaf,eed,eglandular,elliptica,erect,especially,exceeding,exocarp,finger,flattened,fruiting,geminat,gland-tipped,glandular,hair,homostylous,interpetalar,juicy,lamina,lanceolate,lateral,lobe,lon,long,longer,lower,mature,mesocarp,mid-point,midpoint,midvein,minute,moderately,moist,nflorescence,oblique,orolla,part,perfect,placenta,pore,porrect,presen,present,prostrate,pseudo-racemose,ray,ruit,short,side,spaced,sprawling,stage,stalk,stalked,stellae,straight,tal,tamen,tem,thick,throughout,time,tissue,toward,transparent,triangular,tube,unbranched,unit,uvenile,vary,vein,wide,x,ympodial	abaxial,adaxial,arrangement,capitate,color,colour,corolla,form,growth,height,history,leaf,life,na,ovary,perennial,plant,position,pseudoracemose,reproduction,seed,shape,spacing,staman,texture,width
201	wfo-0001027232	success	195	141	111	84	30	0.569	0-7,0.3-0.4,0.3-0.5,0.4-0.8,0.5-0.8,0.7-1.5,1-10,1.5-2.5,1.5-3,1.8-3.9,14-18,2-25,2-3.4,3-5,350-800,4-10,4-5.5,4-6,4-8,4.5-6.5,5-merous,7-9,abaxially,absent,accrescent,acute,adaxially,adult,anther,apex,base,black,bluntly,broadly,brown,calyx,chartaceous,cm,cordate,decimetre,deeply,deltate,diameter,discoid,erect,extra-axillary,filament,finger,flattened,flower,forked,fruit,fruiting,glabrous,gland-tipped,globose,green,hair,index,inflorescence,irregularly,lancolate,lateral,length,lilac,lobe,lobed,lobing,long,longer,margin,mid-point,midpoint,minutely,mm,oblique,obtuse,orbicular,outline,ovate,pale,part,pedicel,peduncle,per,perennial,petiole,present,prickle,purple,ray,reticulate,rhizomatous,rostrate,shrub,side,sparse,sparsely,stellate,stellate-pubescent,stigma,style,surface,thick,throughout,time,triangular,tube,unbranched,wide,yellow	%,0-0.1,0.15-0.3,0.25-0.4,0.3-0.45,0.45-0.6,0.6-0.9,0.7-1.3,0.8-3.2,0.9-7.5,1-locular,1.1-1.5,10-30,14-30,15-100,2.1-2.8,2.5-3,25-35,3-9,3.5-10,5-11.5,5-8,6-8,absen,acicular,across,adaxiall,apart,apparen,armed,articulated,axe,ba,blade,branche,capitat,confined,cylindrical,directed,distall,distributed,eaf,eed,eglandular,exocarp,half,incomplete,juicy,lamina,less,lower,mature,mesocarp,midrib,midvein,minute,moderately,nflorescence,orolla,perfect,placenta,pore,porrect,ruit,septum,sessile,short,simple,spaced,stalk,stellae,straight,succulent,tal,tamen,tem,transparent,unarme,unit,unknow,vary,vein,x,ympodial	abaxial,adaxial,branch,capitate,color,colour,corolla,density,form,growth,height,history,leaf,life,na,number,ovary,plant,position,presence,reproduction,seed,shape,spacing,staman,stella,stem,texture,unknown,width
202	wfo-0001027234	success	206	116	95	111	21	0.461	-0.15,-6,0-4,0.1,0.1-2,0.15,0.2-1.3,0.3-1,0.5-0.7,0.5-3,0.8-0.9,0.9-1.6,1-2,1-4,2/3-4/5,3-5,4-5-merous,abaxially,absent,almost,anther,apart,apex,apparently,bark,base,berry,black,brown,cell,cm,concolorous,curved,dark,diameter,drying,erect,filament,filiform,flattened-reniform,flower,fruit,glabrescent,glabrous,gray,green,herb,lateral,leaf,length,lobed,long,maturity,mauve,membranous,mm,multangulate,narrowly,near,orbicular,outline,ovate,pedicel,peduncle,perpendicular,petiole,pit,prickle,prickly,purple,raised,red,reflexed,scandent,sessile,shrub,simple,slightly,smooth,sometimes,sparsely,spherical,stellate,stellate-pubescent,stem,straight,style,surface,terete,trichome,unarmed,way,wide,winged,yellowish	-1.5,-2,-3,-3.5,.5,0-20,0.05-0.1,0.3-0.4,0.5-2,0.6-0.8,0.7-1.3,0.7-1.5,1,1.2-2,1.5-2.2,1.5-3.5,1.5-4,1.8-3,1/3,1/4-1/3,12-18,2-4,3-10,3-6.5,8-15,8-16,acuminat,acute,alyx,apar,apically,articulated,attenuate,beyond,blac,blade,branched,broad-deltate,calyx,cordate,deltate,difoliate,dot,eaf,eed,elongating,entire,equal,eye,free,fruiting,geminat,glabrou,glan,gland,globular,herbaceous,infructescence,lobe,longer,lower,margin,mature,midpoint,moderately,naked,nflorescence,oblong,obtuse,older,one,open,orolla,oung,pair,pale,pendulous,per,perfec,pericarp,poricidal,porrect,portion,primary,protruding,ray,reduced,rounded,ruit,scar,scattered,shorter,spaced,spreading,stalk,stalked,tamen,tapering,tertiary,time,tip,tube,unarme,unit,vary,vein,venation,visible,white,yellow,ympodial	abaxial,adaxial,arrangement,color,colour,corolla,form,growth,height,inflorescence,orientation,ovary,plant,position,pricklines,seed,shape,spacing,staman,texture,width
203	wfo-0001027235	success	189	123	91	98	32	0.481	0.5,1,2,3,35,4,5,?,abaxial,accrescent,adaxial,adaxially,anther,apart,apex,armed,base,black,brown,calyx,chartaceous,chocolate-brown,cm,completely,covering,deeply,densely,diameter,difoliate,extra-axillary,filament,flower,fruit,fruiting,glabrous,gland-tipped,globose,green,hair,herb,irregularly,leaf,length,like,lobe,lobed,long,margin,midrib,midvein,mm,moderately,multicellular,obtuse,one,pedicel,peduncle,per,petiole,pinnate,pinnatifid,pinnatisect,prickle,pubescent,rachi,raised,reniform,ridge,rotate-stellate,rounded,secondary,shallowly,side,simple,sparsely,stellate,stem,stigma,strongly,style,surface,tan,turning,unbranched,undulate,uniseriate,vein,white,yellow,zygomorphic,×	.5,1.2,1.5,10,11,12,13,14,18,2.5,30,40,5-merous,6,8,9,abaxially,absent,abundant,acicular,acute,alternating,alyx,articulated,asymmetrical,axe,ba,berry,blade,burr-like,c.,cordate,creating,curved,cylindrical,dimorphic,directed,distally,dry,drying,eaf,eed,enantiostylou,four,geminate,glabrou,interpetalar,introrsely,invested,larger,left-handed,linear-lanceolate,lon,longitudinal,lower,lowermost,maturity,midpoint,multiseriate,narrowly,nearly,nflorescence,occasional,occasionally,often,opening,opposite,orolla,pair,pore,prickly,ray,right,ruit,slightly,slit,spaced,stalk,ste,straight,tamen,tapering,tearing,tem,tightly,tissue,triangular,tube,unequa,unicellular,unit,upper,upward,usually,vary,venation,wid,ympodial	0.5-3,1-2,10-14,10-18,2-2.5,2-3,4-10,6-12,9-11,arrangement,color,colour,corolla,enantiostylous,form,growth,height,history,inflorescence,life,na,ovary,plant,position,reproduction,seed,shape,spacing,staman,texture,wide,width
204	wfo-0001027236	success	199	134	109	90	25	0.548	-4.5,-82,0.2-0.3,1-1.5,1-2,1-2.5,1-3,10,10-20,2-,2-2.5,2-6,3-3.5,30-50,4-5,5-6,5-8,8-10,abaxially,acute,adaxially,anther,anthesi,apex,asymmetric,bark,base,becoming,berry,blue,branched,brown,chartaceous,clavate-truncate,closely,cm,cordate,corolla,dark,diameter,filament,flattened,flower,foveolate,fruit,fruiting,glabrescent,glabrous,glandular,globose,green,growth,internodal,length,light,like,lobe,lobed,lobed-angulate,long-styled,margin,mm,new,ochraceous,ovary,ovate-cordate,pedicel,peduncle,per,petiole,plant,prickle,prickly,pubescent,recurved,reniform,reticulate,ripe,rounded,runcinate,rusty,scar,short-styled,shrub,simple,slightly,smooth,somewhat,sparsely,stellate,stem,stigma,style,subcoriaceous,subglobose,suborbicular,subsagittate,surface,tip,unevenly,velutinous,villous,violet,viscid,woody,woolly,x,yellow,yellow-orange	-5,/6,0.6-0.7,1,1.2-1.5,1.5-2,2-3,2-5,2.5-,3-4,3-8,5-,5-9,7-14,armed,articulated,basal,brow,caly,calyx,compressed,densely,discolorous,distal,eaf,eed,eglandular,erect,exserted,free,fused,gland-tipped,glandular-hirsute,heterostylous,lanceolate,lateral,lengthening,long,lower,middle,midpoint,minute,minutely,mixed,multangulate,nearly,nflorescence,obverse,older,ovate-turbinate,papillo,partially,perfect,pericarp,plurifoliat,pore,poricidal,porrect,portion,pubescence,raise,ray,reflexe,ruit,scandent,sessile,slit,space,stalked,staminate,stellate-glandular,stellate-pilose,striped,tall,tapering,terete,testa,tiny,trichome,tube,ud,unarmed,unit,upper,villous-glandular,viscid-tomentose,ympodial,young,¼,½	abaxial,adaxial,arrangement,color,colour,form,height,history,inflorescence,leaf,life,na,number,perennial,position,rachi,raised,reflexed,reproduction,seed,shape,spaced,spacing,staman,texture
205	wfo-0001027237	success	122	90	59	63	31	0.484	.5,1-1.2,1.5-2.5,3-3.5,6-8,8,anther,anthesi,apart,bark,base,black,branched,brown,clavate,cm,corolla,cup-shaped,dark,deflexed,drying,erect,filament,flattened,fruiting,glabrous,globose,green,greenish-white,inflorescence,internodal,leaf,long,many,margin,minutely,mm,ovary,paler,part,pedicel,pitted,regularly,reniform,scar,shaped,shining,shrub,slender,small,stigma,style,surface,tear-drop,terminal,time,tree,upper,white	/4,0.5-1,1.5-2,2-3,3-4,30-100-flowered,5,6-11,apiculae,apiculate,appearing,ba,berry,blac,branc,broadly,calyx,completely,cucullate,deltoid,dia,difoliate,edicel,eed,ellipsoid,exsertion,free,geminate,greyi,later,lobe,lobed,lower,nflorescence,occasionally,older,papillate,papillo,papillose,plurifoliat,pore,poricidal,portion,reflexed,regulary,ruit,spaced,stem,straight,tall,tapering,tip,tube,ud,unit,usually,way,widely,woody,x,x.,ympodial,young	abaxial,adaxial,apex,arrangement,branch,bud,color,colour,diameter,flower,form,fruit,greyish,growth,height,history,length,life,na,peduncle,petiole,plant,position,rachi,reproduction,seed,shape,spacing,staman,texture,width
206	wfo-0001027238	success	204	133	104	100	29	0.51	.3,0-0.7,0-1,0.3-0.8,0.5-1,0.5-2,1-1.5,1.5-3,1.5-4,10,15-30,3-6,4-,5-15,abaxially,accrescent,acuminate,acute,adaxially,anther,apex,articulated,base,black,branch,brown,calyx,chartaceous,cm,contiguous,cuneate,dark,densely,diameter,elliptic,elliptic-ovate,entire,extra-axillary,filament,flattened,flower,fruit,fruiting,geminate,glabrescent,glabrous,gland,gland-tipped,globose,green,greenish,hair,homostylous,lavender,leaf,light,long,margin,membranaceous,midpoint,minutely,mm,multangulate,nearly,oblique,outline,pale,pedicel,peduncle,pericarp,petiole,pitted,plurifoliate,porrect-stellate,pubescent,purple,rachi,reniform,ripe,rounded,scandent,shiny,shrub,simple,small,sometimes,sparsely,sprawling,stellate,stellate-pubescent,stem,stigma,strongly,style,surface,tip,tree,unbranched,unit,white,whitish,x,yellow,yellowish	-25,-5,.5,0-1.5,0.3-0.5,0.3-1,0.3-5,0.5-16,1-2,1.5-7,2-3,2-4,3-4,3-5,4-10,4-16,4-5,4-8,5-7,5-merou,6-15,6-8,adaxiall,ag,alyx,apparently,axe,ba,berry,blade,capitat,connivent,covering,cylindrical,deltate,differentiated,directed,discolorous,distally,eaf,eed,equal,fleshy,foliaceous,fork,free,frui,growt,interpetalar,introrsely,juic,large,lighter,like,lobe,longitudinal,lower,major,minor,mixed,narrowly,near,new,nflorescence,oblong,obtuse,often,one,opening,orolla,paired,part,perfect,pore,ray,ruit,sessile,short-stalked,side,similar,slit,somewhat,sparse,ste,straight,subtending,tamen,tem,time,tissue,toward,triangular,tube,unarme,unequal,vary,vein,wide,without,ympodial	5-merous,abaxial,adaxial,arrangement,capitate,color,colour,corolla,form,growth,height,history,inflorescence,juicines,juicy,length,life,na,ovary,perennial,plant,position,presence,reproduction,seed,shape,spacing,staman,texture
207	wfo-0001027242	success	238	80	65	173	15	0.273	0-0.7,0.2-1,0.25-0.5,0.3-1.1,1.5-2,12-16,3-7,4-30,4-5.5,5.5-7,6-21,adult,anther,branch,chartaceous,cm,cylindrical,densely,diameter,dm,extra-axillary,filament,flattened,fruit,glabrous,globose,green,inflorescence,leaf,length,light,longer,minutely,mm,moderately,nearly,orange,ovate,pale,pedicel,peduncle,per,petiole,pink,prickle,pseudo-racemose,pseudo-umbellate,purple,rachi,red,reticulate,smooth,stellate,stellate-pubescent,stigma,style,subcoriaceous,surface,time,white,whitish,wide,x,yellow,yellowish	%,.05,.2,0-1.5,0-15,0-20,0-5,0.15-0.25,0.2-0.7,0.3-0.5,0.5-1,0.6-0.9,0.6-3,0.7-1.2,1-1.2,1-1.5,1-2,1-2.5,1-locular,1.5,1.5-3,1.9-5,10-22,15-25,2,2-2.9,2-3,2.5-3,2.8-3.7,3-12,3-4.5,3-6,3.5-4.5,4-7,4.5-10.5,4.5-11,5-merou,6-14,6-7,6-8,7-8,8-15,9-11,abaxially,absen,absent,accrescent,acicular,across,acute,adaxially,alyx,andromonoecious,apart,apex,apparen,articulated,axe,ba,base,blade,bract-like,branche,calyx,capitat,confined,connivent,contiguous,cuneate,deltate,directed,distall,eaf,eed,entire,erect,exocarp,finger,flower,forked,fruiting,geminate,gland-tipped,hair,half,heterostylous,incomplete,index,interpetalar,juicy,juvenile,lamina,lateral,less,lobe,lobed,lobing,long,loosely,lower,margin,mature,mesocarp,mid-point,midpoint,midrib,midvein,minute,mixed,much,narrowly,nflorescence,oblique,obtuse,occasionally,often,one,orolla,pair,part,perennial,perfect,placenta,plant,plurifoliate,pore,porrect,present,ray,rhizomatous,rooting,rostrate,rounde,ruit,septum,sessile,shallowly,short,shrub,side,simple,slightly,smaller,spaced,sparse,sparsely,sprawling,stellae,straight,strongly,succulent,tall,tamen,tapered,tem,thick,throughout,tip,tissu,tissue,toward,triangular,tube,unarme,unarmed,unbranched,unit,upper,usually,vary,vein,weakly,ympodial	abaxial,adaxial,capitate,color,colour,corolla,density,ovary,position,seed,shape,staman,stem,texture,width
208	wfo-0001027244	success	294	97	75	219	22	0.255	-12,-2,-3.2,0.15-0.2,0.2-1,0.45-0.6,0.5,0.7-1.5,0.9-1.7,1,1.1-1.3,1.5-2,1.5-2.4,2.1-8,acute,anther,apex,articulated,base,branched,broadly,brown,calyx,capitate,cm,conical,corolla,dark,densely,diameter,distal,elliptic,filament,flower,fruit,fruiting,glandular,globose,green,greenish,hair-like,half,herb,imparipinnate,inflorescence,interrupted,length,middle,mm,obovate,orbicular,outgrowth,ovary,pedicel,peduncle,perennial,petiole,pubescent,purple,rachi,rotate-stellate,rounded,simple,sparsely,stigma,stripe,style,surface,trichome,uniseriate,velvety,vivid,white,woody,yellow	-1.2,.5,0-,0.02-,0.04-,0.05,0.05-1,0.07-0.15,0.1-,0.1-0.3,0.1-0.5,0.1-0.6,0.2,0.2-,0.25-0.4,0.3,0.3-0.4,0.3-0.5,0.3-0.6,0.3-0.8,0.4-,0.4-0.6,0.4-1,0.5-0.8,0.5-1,0.6-0.9,0.6-09,0.7-1,0.7-2,0.7-3,0.8-1.2,0.9-1.3,1-2-celled,1-2.5,1-3.5,1-celled,1.2-1.6,1.5-2.1,1.5-6.5,1.7-3.0,1/2,2-,2-4,2-4-celled,2-9,2-foliate,2-locular,3-5,3.5-13,3/4,4-12,4-celled,5-,5-10,5-9-celled,7-12,8-16,8-celled,abaxially,absent,abundance,abundant,acroscopically,acuminate,adaxially,adpressed,alfway,along,also,always,amongst,angled,anthesi,apical,apparently,appearance,appendage,arequipa,around,articulatio,articulation,axi,basal,berr,berry,bifurcate,bract,bracteate,c.,cage,cell,column,common,cordate,crenate,curved,deciduous,decumbent,decurrent,deeper,deltate,dense,density,dentate,developed,diamete,eaf,edicel,eed,eglandular,either,elliptical,erect,exserted,extremely,flushed,forming,general,giving,glabrescent,glabrous,gland,gree,halfway,head,hyaline,interjected,internode,investing,irregularly,lamina,lanceolate,larger,largest,lateral,leaflet,leave,like,lobe,lobed,lobing,lon,long,longer,lower,margin,midvein,minute,mixed,mixture,multicellular,narrowly,near,node,oblique,occasionally,often,onto,pair,papillate-pubescent,patent,petiolule,population,present,primary,pseudostipule,reflexed,rest,ripe,ruit,scattered,secondary,sessile,shaggy,short,shorter,silky,sinus,size,slender,small,sometimes,somewhat,sparse,sparser,spreading,staminal,stem,sterile,stout,straight,strongly,tall,tem,terminal,tertiary,testa,thick,tiny,tip,tipped,toward,truncate,tube,two,ud,undulate,unicellular,unit,united,upper,usually,variable,variety,vein,wall,wide,winged,ympodial	abaxial,adaxial,arrangement,bud,color,colour,form,growth,height,history,leaf,life,na,plant,position,reproduction,seed,shape,spacing,staman,texture,width
209	wfo-0001027248	success	158	123	89	69	34	0.563	.5,0,0.5-1,0.7-1.2,1-2,1-5,3-4,6.5-8,abaxial,abaxially,acute,adaxially,anther,anthesi,apex,appearing,arachnoid,arachnoid-pubescent,area,bark,base,beige,beneath,broadened,brown,brownish,calyx,closely,cm,corolla,dark,deflexed,densely,difoliate,dirty,ellipsoid,elliptic,exserted,felty,filament,fleshy,fruit,geminate,glabrescent,glabrous,globose,green,later,leaf,lobed,margin,merely,minutely,mm,nearly,occasionally,opposite,ovary,ovoid-reniform,pale,papillose,patch,pedicel,per,petiole,pitted,pubescence,pubescent,scattered,shrub,simple,small,somewhat,soon,spaced,sparsely,stem,stigma,strongly,style,surface,thick,tip,top,tree,trichome,tube,unifoliate,white	0.5-2.5,1-1.5,1-3,2-2.5,2-4.5,3-7,3-7-flowered,3.5-4,4-8,5-5.5,6-13,7-9,along,ape,arachnoid-pubescen,berry,broadly,brownish-gra,conical,deltate,denser,dia,differing,eaf,edicel,eed,erect,free,fruiting,grayish-green,impressed,lamina,lateral,lightly,lobe,long,lower,main,major,minor,nflorescence,node,older,overlappin,pair,papillo,planar,pore,poricidal,portion,present,ruit,scar,shaped,shoot,size,specimen,tall,tear-drop,tub,ud,unit,vein,wid,wide,winged,woody,ympodial,young	adaxial,arrangement,brownish-gray,bud,color,colour,deflexion,diameter,exsertion,flower,form,growth,height,history,inflorescence,length,life,na,number,overlapping,peduncle,perennial,plant,position,rachi,reproduction,seed,shape,spacing,staman,texture,thicknes,variation,width
210	wfo-0001027258	success	178	92	61	117	31	0.343	.5,0.6-2,0.9-1.3,1-1.5,1.5-1.6,4-5,4.5-5,6-8,abaxially,acuminate,acute,adaxially,anther,apex,calyx,capitate,cm,corolla,ellipsoid,elliptic,filament,flattened-reniform,fruit,fruiting,glabrous,globose,green,greenish-yellow,internodal,leaf,length,lobed,minutely,mm,occasionally,opposite,ovary,ovate,pale,papillose,pedicel,petiole,pitted,pubescent,shrub,simple,sparsely,stem,stigma,strongly,style,surface,swollen,treelet,trichome,tuft,uniseriate,white,x,yellowish,yellowish-tan	.25,/4,0.25-0.5,0.5-1,1-2.3,1-4,1.2-2,2-2.5,2.5-8,3-4,3-6,3.5-4,5-10-flowered,7-13,7-9,abruptly,age,along,anthesi,apar,apical,apiculae,attenuate,axil,ba,bark,base,beneath,berry,broadly,crystal,darker,decurrent,deflexed,deltate,dense,densely,deposit,dia,differing,difoliate,dissecting,drying,eaf,edicel,eed,enlarge,entire,evenly,exserted,extending,fide,fragrant,free,geminat,glabrou,incrassate,lamina,large,lateral,lengthening,lenticel,lobe,long,lower,main,major,margin,microscope,middle,minor,minute,nee,nflorescence,often,older,onto,pair,papillo,planar,pore,poricidal,portion,projection,prominent,red-papillose,reddish,ruit,sand,scar,scattered,size,slender,slightly,slit,small,spaced,speck,straight,sweetly,tall,tiny,tip,tub,tube,ud,unit,urceolate,vein,visible,way,widening,widest,winged,woody,ympodial,young	abaxial,adaxial,alternate,apart,arrangement,bud,color,colour,diameter,enlarged,flower,form,growth,height,history,inflorescence,life,na,new,peduncle,perennial,plant,position,rachi,reproduction,seed,shape,spacing,staman,texture,width
211	wfo-0001027260	success	176	116	83	93	33	0.472	-17,0.25-1,0.5-3,0.5-6.5,1-2,1-4,1.5-13,1.5-2,10-25,2-18,3-10,3-4.5,3-6,4.5-14,5-merous,acuminate,acute-,age,aggregate,also,apart,apex,basal,base,branched,cell,chartaceous,clavate,cm,cordate,darker,densely,diameter,ellipsoidal,elliptic-ovate,entire,fading,flattened,flower,fruit,glabrate,glabrous,globose,greenish,lavender,lobe,longitudinal,margin,membranaceous,mm,moderately,often,ovate,pedicel,pedicellar,peduncle,petiole,pilose,pink,puberulent,pubescent,pubescent-pilose,purple,rachi,remnant,shrub,simple,small,sparsely,stellate,stigma,stone,stripe,style,tree,truncate,unbranched,unit,white,x,yellow,yellow-green,yellowish	-2,-60,-7,0.5-1,0.75-1,0.8-2,1-,1-3,1-6,1-7,15-30,2-,2-10,2-2.5,2.5-14,2.5-3.5,3-,3-11,3.5-25,4-25,4-32,4-5-foliat,4-6,5-,5-25,5-40,6-20,abaxially,absent,acute,adaxially,alyx,ape,articulated,axe,berry,beyond,blade,connective,connivent,cylindrical,diamete,directed,distally,eaf,eed,eglandular,elliptic,equal,exceeding,exserted,hair,lanceolate,leaving,lon,long,lower,narrowly,nearly,nflorescence,nther,obtuse,orolla,perfec,perfect,pilo,pore,presen,puberulent-pubescen,puberulent-pubescent,radiu,ruit,shorter,slightly,spaced,stamen,strongly,subcoriaceous,tal,tapered,tem,thecae,time,tomento,triangular,tube,ud,usually,vary,vein,wide,yellow-orang,ympodial	4-5-foliate,abaxial,adaxial,anther,arrangement,color,colour,corolla,filament,form,growth,height,history,inflorescence,leaf,length,life,na,ovary,plant,position,presence,present,reproduction,seed,shape,spacing,staman,stem,surface,sympodial,texture,width
212	wfo-0001027265	success	159	103	67	92	36	0.421	.2,0.2-0.4,0.5,0.5-1,1-3,1.2-2,2,acute,anther,apart,apex,articulated,base,broad,chartaceous,cm,cylindrical,dehiscent,diameter,extra-axillary,filament,flattened-reniform,flower,fruit,glabrous,globose,granule,herb,hermaphroditic,larger,leaf-opposed,light,mesocarp,minutely,mm,near,oblong,orange,ovate-lanceolate,paired,partially,pedicel,peduncle,petiole,pitted,pore,present,prominent,puberulent,purple,rachi,red,rotate-stellate,sclerotic,seed,simple,sometimes,sparsely,stigma,style,subcoriaceous,surface,tip,usually,white,x,yellow	-2.5,.3,.5,0.1–2,0.5–0.6,1-1.3,1-2.5,1.2-1.3,1.2–1.4,1.5-2.5,1.5–1.8,1.5–2,1.5–4,2-,2-3,2-4,2/3,20-30,2–2.5,2–3,3-,3-lobed,30–50,4-5,4.5–8,4–6,4–7-branched,5-merou,58409,abaxially,accrescent,adaxiall,adaxially,alyx,apparently,axe,ba,berry,blade,calyx,capitat,ciliate,connivent,covering,croat,eaf,eed,entire,erect,foliate,frui,fruiting,geminat,hair,juic,lobe,lon,long,long-attenuate,longitudinall,low,lower,margin,nearly,nflorescence,node,numerous,obtuse,orolla,pubescent,rarely,recurved,ripe,rooting,ruit,scarcely,slightly,somewhat,spaced,tall,tamen,tem,time,triangular,tube,unit,vary,weak,white-puberulent,wide,winged,ympodial	0.1-2,1.2-1.4,1.5-1.8,1.5-2,2-2.5,30-50,4-7-branched,abaxial,adaxial,arrangement,articulation,capitate,color,colour,corolla,dehiscence,form,growth,height,history,inflorescence,juicy,leaf,length,life,longitudinally,ovary,perennial,plant,position,reproduction,shape,size,spacing,staman,texture
213	wfo-0001027265	success	156	97	64	92	33	0.41	.2,0.2-0.4,0.5-1,1-3,2,acute,anther,apart,apex,articulated,base,broad,chartaceous,cm,cylindrical,dehiscent,diameter,extra-axillary,filament,flattened-reniform,flower,fruit,glabrous,globose,granule,herb,hermaphroditic,larger,leaf-opposed,light,long,mesocarp,minutely,mm,near,oblong,orange,ovate-lanceolate,paired,partially,pedicel,peduncle,petiole,pitted,pore,prominent,puberulent,purple,rachi,red,rotate-stellate,sclerotic,seed,simple,sometimes,sparsely,stigma,style,subcoriaceous,surface,tip,white,x,yellow	-2.5,.3,.5,0.1–2,0.5,0.5–0.6,1-1.3,1-2.5,1.2-1.3,1.2-2,1.2–1.4,1.5-2.5,1.5–1.8,1.5–2,1.5–4,2-,2-3,2-4,2/3,20-30,2–2.5,2–3,3-,3-lobed,30–50,4-5,4.5–8,4–6,4–7-branched,5-merou,58409,abaxially,accrescent,adaxiall,adaxially,alyx,apparently,axe,ba,blade,calyx,capitat,ciliate,connivent,covering,croat,eaf,eed,entire,erect,foliate,frui,fruiting,geminat,hair,juic,lobe,lon,long-attenuate,longitudinall,low,lower,margin,nearly,nflorescence,node,numerous,obtuse,orolla,pubescent,rarely,recurved,ripe,rooting,ruit,scarcely,slightly,somewhat,spaced,tall,tamen,tem,time,triangular,tube,unit,vary,weak,white-puberulent,wide,winged,ympodial	0.1-2,1.5-2,2-2.5,30-50,4-7-branched,abaxial,adaxial,arrangement,articulation,capitate,color,colour,corolla,dehiscence,form,growth,height,history,inflorescence,juicy,leaf,length,life,longitudinally,ovary,perennial,plant,position,reproduction,shape,spacing,staman,texture
214	wfo-0001027276	success	219	116	86	133	30	0.393	.5,1,10,2,5-merous,6,80,absent,acute,along,alternate,anther,apex,armed,base,bifid,black-green,broadly,brown,calyx,clonal,cm,conspicuously,corolla,covered,cyme,dark,dense,densely,diameter,drying,entire,even,filament,fine,flower,fruit,glabrous,globular,green,growth,indumentum,inflorescence,lanceolate,least,length,lighter,linear,lobed,long,margin,minutely,mm,new,ovary,pedicel,petiole,plant,poricidal,prickle,purple,rarely,reticulate,rotate,scabrous,scattered,short,slightly,small,sparsely,staman,stellate,stellate-pubescent,stem,stigma,straight,style,subshrub,surface,suture,tapering,throughout,tip,trichome,wavy,widened	-22,0,0.5,0.5–1,1.2–1.5,1.5,1.5–2,1–1.5,1–2,2–5,2–6,4–5,4–9,5,5–10,5–12mm,5–7,7,9–12,acuman,acumen,ale,alyx,anthesi,apparently,around,aspect,ba,becoming,beneath,berry,beyond,boht,borne,branche,c.,caly,central,cone,detaching,different,dioeciou,drop,eaf,eduncle,eed,ending,erect,eventually,except,expanding,exserted,extending,falling,female,filiform,following,functionally,fused,gra,gray-green,growt,hermaphrodite,inaperturate,including,ingle,largest,lobe,lon,loose,lower,mostly,mout,near,newer,next,oblong-lanceolate,older,open,opening,orphologically,petal,plurifoliat,pollen,porrect-stellate,prickly,producing,proportion,ra,red-tinged,remaining,resprout,retained,rickle,ruit,ruiting,scarcely-rooted,seaso,shed,shor,side,slender,solitary,somewhat,splitting,stalked,stamen,staminate,stellate-funnelform,stigmatic,stolon,successively,surrounding,taminate,tapered,tem,tending,time,toward,type,unarme,underground,unequal,unit,verall,vestigial,wide,without,woody,yellow-green,ympodial,×,–	-,0.5-1,1-1.5,1.5-2,2-5,4-5,5-12mm,5-7,abaxial,adaxial,arrangement,color,colour,dioecious,form,fruiting,height,history,leaf,life,na,peduncle,position,rachi,reproduction,seed,shape,spacing,texture,wided
215	wfo-0001027284	success	172	103	72	100	31	0.419	.3,4,5-merous,abaxially,acuminate,adaxially,anther,apex,axillary,base,branched,brownish,cm,cordate,densely,diameter,elliptic,entire,extra-axillary,filament,fine,flattened-reniform,flower,fruit,glabrous,globose,green,inflorescence,long,margin,maturity,midvein,minutely,mm,near,nearly,oblique,orangish,ovate,ovoid,pair,pale,pedicel,peduncle,petiole,pinnate,pubescence,pubescent,rachi,rarely,reticulate-rugulose,rounded,sand-punctate,scandent,secondary,shortly,shrub,sometimes,sparsely,stellate,stem-terminal,stigma,style,surface,tan,truncate,unbranched,vein,venation,vine,white,x	0.1–0.5,0.1–2,0.2–,0.7–0.9,0.7–1,1.2–1.5,1.5–2,1.5–2.5,1.5–5.5,1.5–8,1.8–2,1–1.5,1–2,1–3,2.5–3,2.5–3.5,2–16,2–2.2,3.5–14,3–4,4–12,4–6,5–7,5–8,9–18,accrescent,acute,alyx,anthesi,axe,berry,blade,branch,c.,calyx,capitat,ciliat,climbing,conspicuous,contiguousl,cylindrical,deflected,deltoid,distally,eaf,eed,enlarged,flattened,fleshy,fruiting,glabrescen,glabrou,gradually,herbaceous,immature,leafy,lobe,lower,m.,nflorescence,nternode,one,orolla,pendulou,perfec,pink,planar,plurifoliate,pointed,prominent,reduced,ruit,sand-punctat,scar,seen,side,simple,size,slightly,somewhat,soon,spaced,spreading,tamen,tem,thickened,thickly,time,tip,toward,tree,tube,understory,unifoliat,unit,vary,weakly,wide,woody,ympodial	0.1-0.5,0.1-2,0.2-,1-1.5,1-3,1.2-1.5,1.5-2,1.5-5.5,3-4,4-12,4-6,5-7,9-18,capitate,ciliate,color,corolla,form,growth,height,internode,leaf,length,ovary,perfect,plant,position,seed,shape,staman,texture
216	wfo-0001027289	success	194	91	66	128	25	0.34	0.3-1,0.5-1.4,0.8-2.6,1-5,1.1-1.5,10.5-12.5,12-17,30-160,4-11,5.5-7.5,acute,adaxially,andromonoecious,anther,apex,bark,base,black,broadly,brown,circular,cm,cordate,densely,diameter,dm,flower,fruit,furrowed,glabrous,globose,green,grey,inflorescence,leaf-opposed,length,lobed,midpoint,mm,obtuse,ovate,pedicel,peduncle,per,perennial,petiole,pink,placenta,plant,prickle,pseudo-racemose,purple,rusty,shallowly,shrub,solitary,stalked,stellate,stellate-pubescent,style,thick,unbranched,white,yellow,yellowish,yellowish-green	%,.05,0-0.7,0-1,0-3,0.05-0.1,0.25-0.7,0.3-0.9,0.4-0.8,0.5-0.7,1,1-2,1.2-2.5,1.3-1.5,1.4-1.8,1.5-2,1.5-2.3,1.5-3.5,10-16,16-35,2-foliate,2.4-3,2.5-2.8,3.5-5,3.5-7.5,4-7,4-locular,5-merou,6-8,6-9,7-10,7-13,7-8,abaxially,absen,absent,accrescent,acicular,across,adaxiall,alyx,apart,articulated,ascending,axe,ba,blade,calyx,chartaceous,connivent,cork,cross-section,cylindrical,deltate,directed,distall,distally,distributed,eaf,eed,eglandular,elliptica,entire,erect,exocarp,finger,fruiting,functional,geminate,glabrou,gland-tipped,hair,half,heterostylous,juicy,lamina,lanceolate,lateral,less,lobe,long,longer,lower,margin,markedly,mature,mesocarp,mid-point,minute,moist,nflorescence,oblique,orolla,part,pore,porrect,present,probably,ray,rhizomatous,ruit,short,simple,spaced,stage,stalk,stellae,straight,strongly,tal,tamen,tem,thicker,thicknes,throughout,time,transparent,tube,unarme,unarmed,unit,unknow,uvenile,vary,weakly,wide,x,ympodial	abaxial,color,corky,corolla,density,elliptical,filament,form,growth,height,history,leaf,life,na,ovary,position,reproduction,seed,shape,staman,stem,stigma,surface,texture,width
217	wfo-0001027290	success	165	81	51	114	30	0.309	.8,0-2.5,0-3,0.3-0.5,1.1-4.4,180-420,2-11,4-6,8-10,acicular,anther,apex,base,broadly,cm,cordate,densely,diameter,extra-axillary,flower,fruit,glabrous,globose,green,grey-green,inflorescence,length,lobed,mm,obtuse,ovate,pedicel,peduncle,per,perennial,petiole,prickle,pseudo-racemose,purple,rusty,shallowly,shrub,simple,sparsely,stellate-pubescent,straight,style,unknown,yellow,yellowish,yellowish-green	%,0-0.7,0-1,0.05-0.25,0.1-0.9,0.2-0.4,0.7-0.9,0.7-1.2,0.8-1.2,0.9-1.2,1-1.7,1-2,1-5,1.4-1.6,1.5-1.8,1.5-2,1.6-1.8,11-15,2-6,2.8-5.5,20-45,3-35,3-5,3-6,3.5-5,5-20,5-9.5,5-merou,50-70,6-8,7-8,8-9,abaxially,absent,across,adaxiall,adaxially,alyx,apart,armed,articulated,ascending,attenuate,axe,ba,blade,calyx,chartaceous,cylindrical,d.,directed,distall,distributed,eaf,eed,eglandular,entire,erect,finger,fruiting,functional,gland-tipped,hair,half,juic,lamina,lateral,lobe,lon,long,longer,lower,margin,mature,mesocarp,mid-point,midpoint,midvein,minute,moist,nflorescence,oblique,onl,orolla,part,pore,porrect,presen,present,ray,rhizomatous,ruit,short,spaced,stage,stalk,stellae,tal,tamen,tem,thick,throughout,time,tube,unbranched,unit,unknow,uvenile,vary,vein,white,wide,x,ympodial	5-merous,abaxial,adaxial,arrangement,color,colour,corolla,density,dm,filament,form,growth,height,history,leaf,life,na,ovary,plant,position,rachi,seed,shape,spacing,staman,stem,stigma,surface,texture,width
218	wfo-0001027299	success	237	85	54	183	31	0.228	abaxial,anther,asymmetric,cauline,cm,dense,densely,densest,developed,diameter,expanded,filament,flower,fruit,globose,hirsute,inflorescence,internode,interwoven,lanceolate,leaf,length,lenticular,midpoint,minutely,mm,often,ovate,ovoid,pedicel,peduncle,pentagonal,petiole,pitted,plump,prickle,pubescent,purplish,ray,reniform,rotate,stalked,stellae,stellate,stellate-tomentose,stem,stigma,style,surface,tan,violet,weakly,well,yellow	.5,0.2–3,0.3–0.8,0.5–1.5,0.8–1,0.8–1.2,0–10,1.2–1.5,1.3–1.7,1.5,1.5–3,1.5–4,11–17,15,15–19,1–2,1–3.5,1–4,2.5–4,2.5–5,2.7,25-30,2–13,2–2.7,3–3.5,4.5–13,4–10,5,5-merou,5.2,5–10,5–12,6,6–10,6–8,6–9,7–11,7–9,8–13,8–20,9–25,abaxially,accrescent,acicular,acuminate,adaxially,along,alyx,apart,apex,apiculate,apparently,appearing,articulated,ascending,axe,barely,base,becoming,blade,branch,branched,bristle,bristle-like,broadly,c.,calyx,campanulate,common,composed,conduplicate,contiguous,cordate,coriaceous,deciduou,delicate,deltate,deltoid,directed,distall,distally,eaf,eed,elongating,entire,equalling,erect,erry,exceeding,falcate,filiform,fruiting,geminat,glabrou,glabrous,hair,initially,intense,intergrading,intervening,lateral,like,linear,lobe,long,long-stalked,lower,margin,maturit,midvein,midzone,mixed,narrowly,nearly,nflorescence,obtuse,one,orange,orolla,overtopped,perfect,plurifoliate,pore,prickly,principal,pubescence,racemose,rachise,rarely,reaching,repand,ripe,secondary,short,short-stalked,shorter,shrub,side,similar,simple,slender,slightly,smaller,sometimes,somewhat,some­what,soon,spaced,sparse,spreading,spreadingly,stalk,stellate-pubescent,stipitate-stellate,straight,styl,sun,tall,tamen,tapering,tardily,tem,terminal,thick-textured,tippe,truncate,tube,ud,ultimate,unarme,unarmed,undulate,usually,vary,varying,vein,wooll,woolly,ympodia,young,×,–7,–9	0-10,0.2-3,0.3-0.8,0.8-1,1-2,1-4,1.3-1.7,1.5-3,1.5-4,15-19,2-13,2.5-4,5-10,5-12,7,7-11,7-9,9,color,corolla,density,development,height,ovary,plant,rachi,seed,shape,staman,texture,x
219	wfo-0001027302	success	188	129	97	91	32	0.516	.5,0.4-5,0.5,0.5-1,0.6-1,1-1.3,1-1.5,1-2,1.2-2.5,2.2,3.5-5,abaxial,acuminate,acute,adaxial,along,anther,anthesi,apex,apical,appearing,bark,basal,branching,bright,brownish-yellow,calyx,capitate,clavate,cm,corolla,deltoid,dendritic,densely,diameter,elliptic,entire,exserted,filament,flat-topped,flattened,flower,glabrous,globose,growth,later,lateral,leaf,length,lenticular,less,lobe,lobed,long,long-triangular,minutely,mm,monochasial,narrowly,nodding,occasionally,ovary,ovate,pale,pericarp,petiole,pitted,plant,plurifoliate,poridical,prominent,puberulent,pubescent,pyramidal,red,reddish-brown,scar,scattered,shrub,simple,sleeve,small,somewhat,stem,stigma,strongly,style,surface,tapering,terminal,thin,tip,tree,trichome,tube,violet,young	0.8-1,1,1-3,1.2-1.6,1.5-2,10,10-20,2,2-3,2-6,2.7-7.5,3/4,5-7,6-12,7,7/8,abaxially,adaxially,age,ba,base,becoming,berry,blade,broader,conical,cordate,crispate,cultivation,decurrent,deflexed,denser,dichasia,discussion,eaf,edicel,eed,especially,ew,fine,free,fruiting,growing,inserted,juvenile,larger,lax,like,lon,lower,m.,main,margin,nflorescence,older,otherwise,overtopping,pair,papillo,pedicle,per,planar,pore,portion,reflexed,ruit,scrambling,secondary,see,shade,shin,shoot,slit-like,sparsely,stamen,tall,time,tiny,truncate,tub,ud,undulate,unit,usually,vein,way,wide,winged,woody,x,ympodial	arrangement,bud,color,colour,dichasial,exsertion,form,fruit,height,history,inflorescence,insertion,life,na,new,papillose,pedicel,peduncle,perennial,poridicality,position,presence,prominence,rachi,reproduction,seed,shape,shiny,spacing,staman,texture,width
220	wfo-0001027310	success	215	122	102	113	20	0.474	/3,0-20,0-5,0.05,0.05-0.15,0.1-0.2,0.15-0.3,0.6-1,0.7-2,0.9-0.17,1-1.2,1-1.7,1-6,1/10-1/6,11-16,2-10,2-3.1,2-4,2-5,20-60,22-30,3-15,4-10,4-9,4.5-5.5,4.5-7,5-20,5-7,5-merous,6-8,7-10,abaxial,acute,adaxial,andromonoecious,anther,apart,apex,base,berry,branched,branching,chartaceous,cm,dark,densely,diameter,evenly,filament,flattened-reniform,flower,free,fruit,glabrous,glaucous,green,green-brown,inflated,lanceolate,lateral,leaf,length,less,lobe,lobed,long,longer,maturity,mauve,minutely,mm,moderately,orange-brown,pedicel,peduncle,petiole,pitted,plant,porrect-lepidote,prickle,primary,purple,ray,secondary,shallowly,shrub,spherical,stellate,stellate-pubescent,stem,style,surface,terete,terminal,time,tree,trichome,vein,way,wide,yellow,young	-2.2,-20,.8,0,0.1,1.1-1.5,1.5-2.2,1.5-5,1/3-1/2,1/3-3/4,2.2-2.5,2.8-3,2/3,5-10,8-10,9-13,abaxially,acut,alyx,apar,apically,apparently,articulated,bark,blade,broadly,calyx,connivent,cuneate,curved,deltate,discolorous,distal,drying,eaf,eed,elongating,entire,equal,erect,faint,flattened,foliaceous,fruiting,fused,gently,glabrescent,glabrou,gray,hair,hermaphrodite,heterostylous,infructescence,long-styled,lower,lowermost,margin,mature,midpoint,nflorescence,older,one,open,orolla,oung,pair,pale,pendulous,per,pericarp,plurifoliat,poricidal,porrect,portion,prickly,pubescent,red,reddi,reflexed,rounded,ruit,scar,sessile,short-styled,shorter,simple,smooth,sometimes,spaced,sparse,sparsely,spreading,stalk,stalked,staminat,stout,straight,strongly,tamen,tapering,tertiary,tip,toward,truncate,tube,unarme,unarmed,unit,vary,venation,visible,woody,ympodial	color,colour,corolla,form,growth,height,history,inflorescence,life,na,ovary,perennial,position,reproduction,seed,shape,spacing,staman,stigma,texture
221	wfo-0001027313	success	173	121	83	90	38	0.48	.5,.7,0.15,1.5,4,50,abaxially,acute,adaxially,anther,apex,atenuate,attenuate,base,broadbased,cm,cordate,densely,diameter,dull,entire,filament,flower,fruit,globose,green,hair,high,homostylous,internode,irregularly,lanceolate,lateral,leaf,lobe,long,loosely,margin,midpoint,minutely,mm,much,narrowly,nearly,obtuse,ovate,ovoid,persistently,petiole,pitted,prickle,purplish,ray,shorter,shrub,simple,sinuate,slender,small,sparse,stellae,stellate,stellate-pubescent,stellate-tomentose,stem,stigma,style,surface,thick-chartaceous,tomentose,tree,triangular,tube,unarmed,undulate,usually,violet,weak,whitish,whitish-tomentose,yellow,yellowish,×	0.1–0.3,0.5–0.6,0.8–1,1.2–1.3,1.2–1.4,1.5–2,1–1.3,1–2,1–4,2–3-branched,2–4.5,2–8.5,3–3.5,3–4,3–5.5,3–9,4.5–5,5,5-merou,5.5–16,5.5–7,5–6,6–11,6–8,adaxiall,along,alyx,apar,apical,apparently,articulated,axe,blade,branch,branched,capitat,dbh,difoliate,directed,distall,eaf,eed,filiform,finely,geminat,glabrous,half,immature,interpetalar,like,little,lon,lower,maturing,midvein,minute,nflorescence,orolla,pedicel,peduncle,perfect,pore,porrect,principal,rarely,ruit,scar,sessile-stellate,short-stalked,short-stipitate,side,similar,sinus,sometimes,splitting,stalk,stellate-tomento,tamen,tem,time,tissue,ud,unarme,vary,vein,vigorous,wide,ympodia,–12,–3	0.1-0.3,1-2,1-4,1.2-1.3,1.2-1.4,2-3-branched,2-8.5,3-4,3-5.5,4.5-5,5-merous,5.5-7,abaxial,adaxial,arrangement,bud,calyx,capitate,color,colour,corolla,form,growth,height,history,inflorescence,length,life,na,number,ovary,plant,reproduction,seed,shape,staman,texture,width
222	wfo-0001027315	success	217	105	80	137	25	0.369	0.15-0.2,0.3-0.6,0.3-1,0.5,0.6-0.6,0.6-0.8,2,2-2.5,2-5,3,acute,almost,along,anther,apex,bark,blue-green,brown,calyx,capitate,cm,conical,corolla,densely,diameter,dioecious,ellipsoid,elliptic,entire,exerted,flattened,flower,glabrous,globose,greyish-white,growth,inflorescence,internodal,length,margin,minutely,mm,ovary,packed,pale,paler,pedicel,peduncle,pentagonal,per,petiole,pitted,plant,porrect,pubescent,purple,reddish,reniform,rhachi,ripe,scar,shiny,shrub,simple,somewhat,stellate,stem,stigma,strongly,style,surface,thin,tightly,trichome,tube,unisexual,white,x,yellowish,young	.15,.5,.5x,.9,0.2,0.2-0.5,0.25-0.4,0.3-0.5,0.4-0.7,0.6-0.7,0365,1-1.3,1-1.5,1-2,1.3-3,1.5-1.7,1.5-2,1.5-3,10-20,2-7.5,2/3,3-3.5,3-5,3-7,5-7,8,<,?,abaxially,adaxially,age,anthesi,arching,armed,articulated,base,berry,broad-based,consisting,correlated,dark,deltate,dense,difoliate,discolorous,drying,eaf,echinoid,eed,ekman,especially,female,fide,filament,filiform,free,fruiting,fused,geminat,glabrescen,globular,half,hangin,highly,immature,impressed,lamina,lengthening,lepidote,like,lobe,lobed,long,lower,male,marginal,markedly,midpoint,midrib,minute,mixture,new,nflorescence,oblique,obscuring,occasionally,often,older,overlappin,pair,papillo,pericarp,pistillate,plan,planar,pore,poricidal,portion,present,prickle,pricklines,primary,prominent,ray,rest,rounded,ruit,scattered,sessile,shoot,short,short-stalked,shorter,similar,slit,smaller,solitary,sparse,sparsely,stalked,staminate,stellate-lepidote,straight,throughout,tip,ud,unarmed,unit,vein,venation,vestigial,visible,way,without,woody,ympodial,½	3.5,6,abaxial,bud,color,feature,form,fruit,glabrescent,height,history,leaf,life,na,number,overlapping,perennial,position,rachi,reproduction,seed,shape,spacing,texture,width
223	wfo-0001027317	success	144	97	68	76	29	0.472	0.1-0.2,0.4-1.5,1,1-1.5,1-2,1.4-1.6,1.5-2,3-3.5,4.5-5,?,abaxial,acuminate,acute,anther,apex,arch,base,bilobed,closely,cm,corolla,cucullate,densely,elliptic,erect,expanded,filament,filiform,fruit,fruiting,glabrous,globose,golden,green,leaf,like,lobed,long,margin,minute,mm,offset,opposite,ovary,papillose,pedicel,petiole,prominent,pubescent,rest,shaped,shrub,simple,slightly,spaced,sparsely,stem,stigma,style,surface,tear-drop,tip,trichome,uniseriate,vein,white,woody,x	.25,.5,0.3-1,0.5-1,0.5-3,0.8-3.5,1-5,2-3-flowered,2-9,7-9,adaxially,along,anthesi,apical,apically,ba,bark,beneath,berry,broadly,calyx,conical,deciduous,deflexed,deltoid,dia,differing,difoliate,drying,eaf,edicel,eed,ellipsoid,elongated,free,geminat,greyish-whit,immature,inflorescenc,joined,known,lateral,lobe,lon,long-exserted,lower,main,major,mature,minor,minutely,nearly,nflorescence,older,overlappin,pair,pale,papillo,pointed,pore,poricidal,portion,projection,reflexed,ruit,scar,series,size,soon,strongly,tall,tub,tube,ud,ympodia,young	0.25,adaxial,arrangement,color,colour,diameter,diphyllous,flower,form,growth,height,history,inflorescence,length,life,na,overlapping,peduncle,perennial,plant,position,rachi,reproduction,seed,shape,spacing,staman,texture,width
224	wfo-0001027323	success	175	105	76	99	29	0.434	0.5-1,1-1.5,1.2-1.5,2-3,2-6,2.5-3,5-7,acute,adaxial,anther,anthesi,apex,area,bark,berry,broadened,bud,closely,cm,corolla,deflexed,densely,elliptic,elongate,erect,erose,filament,fleshy,flopping,flower,fruit,fruiting,glabrate,glabrous,globose,grey,hood,hooded,leaf,lobed,matte,minutely,mm,opposite,ovary,overlapping,ovoid,ovoid-reniform,papillose,partially,pedicel,petiole,pinkish-grey,pitted,planar,plant,poricidal,red-papillose,reddish-grey,shaped,spaced,stem,stigma,straight,style,surface,tan,tear-drop,thin,tip,treelet,tube,visible,white,winged,x	.75,/3,1-2,10-15,14-21,20-45,3-5,5-20-flowered,6-11,7-9,along,apparent,appearing,arising,asymmetric,attenuate,ba,base,calyx,campanulate,character,closed,cork,decurrent,dia,differing,difoliate,dried,dry,eaf,edicel,eed,entire,exserted,five-pointed,free,furcate,geminat,growing,held,higher,immature,interpetalar,lateral,like,live,lobe,lon,long,long-triangular-deltoid,lower,main,major,margin,mature,measured,middle,minor,nflorescence,occasionally,older,one,onto,pair,papillae,papillo,persistent,pore,portion,prominent,proximal,rather,rest,ridge,ruit,scar,secondary,seen,sinus,size,slightly,small,smoot,soon,specimen,tall,thickened,tiny,trunk,two,ud,unit,upper,vein,way,widest,woody,ympodial,young	2,5,7,abaxial,alternate,arrangement,color,colour,diameter,form,growth,height,history,inflorescence,length,life,na,peduncle,position,rachi,reproduction,seed,shape,smooth,spacing,staman,straightnes,texture,width
225	wfo-0001027340	success	189	121	89	100	32	0.471	0.5-0.9,1-10,1-2,10-16,16-22,2-4,3.5-5,4-7.5,5-11,5-6,6-8.5,7-8,8-14,8-9.5,abaxially,absent,adaxially,anther,apex,auriculate,axillary,bud,cell,chartaceous,cm,connivent,cordate,corolla,covering,dark,diameter,edge,elliptic,especially,filament,flat,flower,forked,fruit,glabrous,globose,green,greenish,hair,hair-like,herb,homostylous,honeycomb-shaped,lanceolate,lateral,like,lilac-purple,lobe,membranous,minute,minutely,mm,mucilaginous,odd-pinnate,ovate,ovoid,pedicel,peduncle,petiole,plant,poricidal,puberulent,pubescent,purple,rotate,rounded,seed,sparsely,splotched,stem,stigma,style,subtending,terminal,testal,thick,tinged,tip,truncate,tube,wall,wet,whitish,yellow	1-3,1.5-2.7,2-3,2-3.5,2.5-4.5,2.7-4.5,3-4,3.5-9,4-6,5-merou,7-18,abruptly,acumen,acuminate,ag,along,alyx,apart,apparently,articulated,articulation,axe,base,berry,blade,brownish,capitat,ciliate,condition,decreasing,developing,digestion,distal,distinct,dorsally,drying,eaf,eed,enzyme,exceeding,folded,fresh,geminat,generally,glabrou,green-white,hal,half,high,indistinct,interjected,leaflet,lengthening,living,long,lower,make,margin,midrib,narrow,narrowed,nflorescence,orolla,pair,papillose,perfect,petiolulate,plurifoliate,pointed,pore,purpl,removed,ripe,ruit,semi-erec,semi-rosette,sessile,seudostipule,short,shortly,size,slightly,slit,spaced,specimen,stamen,ste,straight,tall,tamen,tem,throughout,tri-,unit,usually,vary,wing,x,ympodial,young	5-merous,abaxial,adaxial,arrangement,calyx,capitate,color,colour,form,growth,height,history,inflorescence,leaf,length,life,na,number,ovary,perennial,position,presence,property,pseudostipule,rachi,reproduction,shape,spacing,staman,surface,texture,width
226	wfo-0001027354	success	166	104	83	83	21	0.5	0.5,0.5-2,0.7-1.3,1,1-1.5,1-7,1.5-1.8,10,3.4-4,5-7,abaxial,abaxially,acute,adaxial,anther,anthesi,apex,apical,appearing,bark,basal,base,bi-lobed,branch,cm,corolla,dark,dendritic,densely,diameter,elliptic,erect,filament,flattened,flower,fork,fruit,fruiting,globose,golden,growth,later,lateral,leaf,length,lenticular,less,lobed,minutely,mm,narrowly,nodding,occasionally,ovary,pedicel,per,petiole,pitted,plurifoliate,pubescent,purplish-black,pyramidal,raised,reddish-brown,scar,shrub,slightly,small,somewhat,sparsely,stem,stigma,style,surface,tapering,terminal,tiny,tree,tree-like,trichome,violet,white,woody	.5,0,1-1.2,1.5-2,1.7-5,10-20,2.5-3.5,3-4,3/4,4-10,6.5-13,8-12,absent,age,along,ba,becoming,belo,berry,blade,branching,calyx,conical,covered,deltoid,denser,dichasia,drying,eaf,edicel,eed,entire,ew,exserted,free,glabrate,glabrous,inserted,like,lobe,long,loose,loosely,lower,m.,monochasial,mostly,near,nflorescence,older,pair,papillo,pericarp,planar,pore,poricidal,portion,pubescen,ruit,secondary,side,simple,sleeve,slit-like,stamen,strongly,tall,thecalyx,thin,time,tip,tub,tube,type,ud,unit,vein,way,wide,winged,x,ympodial,young	arrangement,color,colour,form,height,history,inflorescence,life,na,number,peduncle,plant,position,rachi,reproduction,seed,shape,spacing,staman,texture,width
227	wfo-0001027359	success	224	136	112	112	24	0.5	-2,.1,.5,/3,0-5,0-9,0.1-1.5,0.3-0.5,0.3-1.2,0.5-2,1-1.2,1-5,1.2-1.5,1.2-2,2-10,4-,4-5,5-6.5,5-merous,6-8,abaxially,acute,anther,apart,apex,apparently,bark,base,berry,branched,bright,cell,chartaceous,cm,cuneate,densely,diameter,dull,entire,erect,eye,filament,flattened-reniform,flower,fruit,fruiting,glabrescent,glabrous,gray,herbaceous,lateral,leaf,length,lobed,long,margin,maturity,membranous,minutely,mm,moderately,naked,obtuse,occasional,orange-brown,outline,ovate,pair,pale,pedicel,peduncle,petiole,pit,porrect,prickle,prickly,primary,purple,rachi,raised,red,reticulate,scandent,shallowly,shrub,small,smooth,sometimes,sparsely,spherical,stalked,stellate,stellate-pubescent,stem,style,surface,terete,terminal,tertiary,trichome,unarmed,undulate,usually,variously,vein,venation,visible,way,white,woody,yellow,yellow-brown	-0.25,-20,-3,-4,-7,-9,.2,/4,0,0-2,0-3,0.1,0.1-0.2,0.5,0.5-1,0.6-0.8,0.6-1,1-2,1-3,1-4,1.5-2,1.5-2.5,1.8-3.2,1/5-1/4,2-3,2-4,2.5-3.5,2.5-5.5,3-10,5-,7-8,acut,alyx,apar,apically,articulated,ba,blade,brow,calyx,concolorous,coroll,cream,curved,dark,deltate,difoliate,distinctive,drying,eaf,eed,elongate,elongating,equal,filiform,flattened,free,geminat,green,infructescence,less,like,lobe,longer,lower,marking,mature,midpoint,narrow-deltate,narrow-ovate,near,nflorescence,often,older,one,open,orolla,oung,ovoid,per,perfec,pericarp,poricidal,portion,rarely,ray,reflexed,ruit,scar,sessile,shorter,simple,slender,slightly,spaced,spreading,stalk,stump,tamen,tapering,time,tinge,tip,tube,ud,unarme,unit,vary,weakly,wide,ympodial,young	abaxial,adaxial,brown,color,colour,corolla,form,growth,height,inflorescence,na,ovary,pattern,perfect,plant,position,reproduction,seed,shape,spacing,staman,stigma,texture,width
228	wfo-0001027365	success	233	130	91	142	39	0.391	5-merous,abaxial,acuminate,acute,adaxial,andromonoecious,anther,apart,apex,apparently,bark,base,blue,branched,broad-based,brown,capitate,chartaceous,cm,column,cuneate,cylindrical,dark,densely,diameter,difoliate,either,elliptic,emergent,entire,extraaxillary,filament,flower,flowering,fruit,glabrous,globose,golden-tan,green,hair,inflorescence,juicy,lanceolate,leaf,length,light,lighter,major,margin,midvein,mm,multangulate,multangulate-stellate,oblique,orange,outline,pedicel,peduncle,pericarp,petiole,plant,prickle,pubescent,rachi,ray,reniform,repand,rotate-stellate,rugose,sessile,shallowly,sharp,short-stalked,side,simple,slightly,sparsely,stellate,stem,stigma,stout,style,subcoriaceous,surface,tan,tree,unbranched,unit,vein,violet,yellow	.1,.1–0.3,.2,.5,0,0.1–0.3,0.2–0.5,0–0.03,0–0.1,1,1.1–1.4,1.5–1.8,10–15,11–14,14–15,15–30,1–1.9,1–4,2,2.2–2.3,2.3–4.2,2.5–4.5,2.6–3,2.8,2–,2–5,3,3–10,3–3.5,3–3.9,4.5–5,4–4.5,4–5,5–5.5,5–8,6–7.5,7–1,7–15,8–15,8–9,abaxially,absent,adaxially,ag,along,alyx,andromonoeciou,anthesi,articulated,axe,ba,becoming,berry,bilobe,blade,broadly,calyx,central,congested,connivent,curved,db,directed,discolorous,distally,dried,eaf,eed,eglandular,equal,flattened,free,fresh,frui,fruiting,functionally,geminat,glandular,half,hermaphroditic,heterstylous,included,inflated,interpetalar,knobby,like,lobe,lobed,long,longitudinal,lower,maturity,membranaceous,midpoint,moderate,moderately,mostly,mpodial,multiseriate,multiseriate-stalked,nearly,nflorescence,obtuse,often,one,opening,orolla,part,pore,porrect-stellate,portion,pronounced,reduced-stellate,reflexed,ruit,runk,shiny,slit,somewhat,spaced,stalk,stalked,staminate,stellate-pubescent,straight,strongly,subtending,tamen,tapered,thi,time,tissue,truncate,tube,unarmed,vary,wide,within,young,×,–2,–20	0.1-0.3,1-4,1.5-1.8,10-15,13,14-15,2-5,2.3-4.2,20,3-10,4-5,4.5-5,7-10+,8-9,arrangement,bilobed,color,colour,corolla,form,geminate,growth,height,history,life,na,ovary,perennial,position,reproduction,seed,shape,spacing,staman,sympodial,texture,thicknes,thin,trunk
229	wfo-0001027366	success	136	110	76	60	34	0.559	.5,/2,0.25-0.5,0.5-1,0.7-1,1-1.5,1-2,1-3,1.5-2,11-21,2-2.5,4-5,5-7,6-19,acute,anther,anthesi,apex,bark,base,bright,broadly,brown,calyx,capitate,closely,cm,conical,corolla,dark,deflexed,deltate,drying,elliptic,exserted,filament,fruiting,glabrous,globose,golden,green,greenish-white,internodal,leaf,lobe,lobed,long-triangular,minutely,mm,opposite,orbicular,ovary,ovoid,ovoid-reniform,packed,pale,papillose,pedicel,petiole,pitted,pointed,pore,rounded,shaped,shining,shrub,simple,sometimes,somewhat,stem,stigma,style,surface,tear-drop,tip,tube	/4,3-10-flowered,3-9,4-4.5,603,abaxially,adaxially,ape,axe,ba,berry,conspicuously,dia,eaf,edicel,eed,erect,et,except,fide,free,lamina,lateral,less,lon,long,lower,main,margin,middle,nflorescence,older,overlappin,pair,papillo,parallel,planar,poridical,portion,ramo,reddish,ruit,scar,secondary,straight,tall,trichome,tub,ud,unifoliat,unit,vein,venation,way,wide,widest,woody,yellowish-gre,ympodial,young	abaxial,adaxial,arrangement,bud,color,colour,deflexion,diameter,exsertion,flower,form,fruit,growth,hair,height,history,inflorescence,length,life,na,overlapping,peduncle,plant,position,rachi,reproduction,seed,shape,spacing,staman,texture,unifoliate,width,yellowish-grey
230	wfo-0001027368	success	145	99	70	75	29	0.483	-15,-2,-20,-5,.5,0.3-2.5,0.5-3.5,1.5-2,2-3,2-4,2-9,3,4-6,5-10,5-15,5-6,8-13,acuminate,acute,apart,apex,articulated,base,calyx,chartaceous,cm,color,deltate,densely,diameter,ellipsiodal,elliptic,elliptic-ovate,forked,glabrous,globose,lanceolate,lenticular,lobe,margin,mm,moderately,narrowly,nearly,oblong,otherwise,ovoid-fusiform,pedicel,peduncle,petiole,puberulent,pubescent,purple,rachi,radiu,shrub,simple,sparsely,stellate,stigma,style,subcoriaceous,triangular,truncate,tube,unbranched,unknown,white,x,yellow	-10,0.5-5,0.8-2,1-15-flower,1-2,1-6,1.5-2.5,2,2-2.5,3-12.5,4-many-foliat,abaxially,abruptly,absen,adaxiall,adaxially,aggregate,also,axe,ba,blade,branched,cell,connivent,contiguous,cuneate,cylindrical,darker,decurrent,dendritically,denser,directed,distally,eaf,eed,entire,except,gland,hair,lighter,long,long-stalked,lower,midvein,narrowed,nflorescence,nther,obtuse,occasionally,often,orolla,pore,pubescen,ray,ruit,small,sometimes,spaced,stalked,star,stone,subcapitat,subhastate,tal,tem,terminal,three,time,tip,unit,usually,vary,vein,wide,ympodial	abaxial,adaxial,anther,arrangement,articulation,colour,corolla,form,fruit,growth,height,history,inflorescence,leaf,length,life,na,ovary,perennial,plant,position,reproduction,seed,shape,spacing,subcapitate,surface,texture,width
231	wfo-0001027369	success	191	100	73	118	27	0.382	-1,-10,.4,.5,0-1,0.2-0.5,0.5-0.8,0.6-0.8,1-2.5,1.5-2,2-3,3-10,4-8,5-merous,anther,apart,apex,bark,base,berry,branched,cm,color,cordate,densely,diameter,eye,filament,flower,fruit,fruiting,glabrous,glaucous,green,herbaceous,lateral,leaf,length,lobed,long,margin,mauve,membranous,mm,naked,orbicular,pale,pedicel,peduncle,pendulous,petiole,prickle,reflexed,reniform,rounded,scandent,shrub,simple,slightly,smooth,sparsely,spherical,stellate,stellate-pubescent,stem,straight,style,surface,terete,terminal,venation,visible,yellow	-11,-2,.1,.7,/4,0,0-15,0-3,0-5,0-6,0.05-0.15,0.1,0.1-0.2,0.1-0.3,0.25-0.4,0.3-1.5,0.5,0.5-1.5,1-,1-2,1-3,1-4,1.2-2.5,1.2-3,1/3,2-4,2-5,3,3-4,4-5,5,7-15,abaxially,acut,almost,alyx,ame,apar,apically,apparently,articulated,blade,broad-deltate,c.,calyx,concolorous,curved,deltate,difoliate,distance,drying,eaf,eed,elongating,equal,erect,extending,filiform,free,geminat,glabrou,gra,hair,infructescence,know,known,lanceolate,less,lobe,lon,lower,mature,midpoint,midvein,moderately,multangulate,narrowly,nflorescence,older,one,open,orolla,oung,per,perfec,pericarp,perpendicular,poricidal,porrect,portion,prickl,prickly,ray,ruit,scar,sessile,side,slender,spaced,spreading,stalk,stalked,strongly,tamen,tapering,time,tip,trichome,tube,unarmed,unequal,unit,vary,way,wide,wider,winged,ympodial	-5.5,abaxial,adaxial,arrangement,branching,colour,corolla,form,gray,growth,height,history,inflorescence,life,na,ovary,plant,position,rachi,reproduction,seed,shape,spacing,staman,stigma,texture,width
232	wfo-0001027378	success	149	97	60	89	37	0.403	.2,5-8,5-merous,abaxially,acuminate,adaxial,adaxially,anther,apex,base,blue,broadly,chartaceous,cm,color,cordate,deeply,diameter,extra-axillary,filament,fleshy,flower,fruit,glabrous,hair-tipped,herbaceous,leaf,light,margin,minutely,mm,ovate,ovoid,palmate,pedicel,peduncle,pentagonal,petiole,pubescent,rachi,revolute,rotate-stellate,sand-punctate,simple,small,somewhat,spaced,sparsely,stigma,style,terrestrial,tip,tooth,unbranched,unknown,vein,vine,white,widely,x	0.5–1,0.7–1,0.8–2.5,1.2–1.5,1.2–1.8,1.5–1.8,1.5–8,15–35,1–1.5,1–3,2.3–5,2.5–7,2–11,2–2.2,2–2.5,3–4.5,3–5,3–6,4–6,4–9,5–10,5–13,5–7,6–10,6–7,acute,alyx,apar,apicall,axe,berry,blade,c.,calyx,capitat,ciliate,clavate,climbin,cylindrical,deltoid,densely,eaf,eed,flattened,fruiting,glabrou,hair,half,lanceolate,like,lobe,lon,long,longer,lower,m.,markedly,membranous,moderately,narrowly,nflorescence,nternode,obscure,often,orolla,papillose,perfec,plurifoliat,pointed,primary,rounded,ruit,sand-punctat,scattered,short,side,slender,slightly,stem,tamen,tem,trichome,tube,unit,unknow,vary,venation,wide,ympodial	0.7-1,0.8-2.5,1.5-1.8,15-35,2-11,2-2.2,2.5-7,4-6,5-10,abaxial,arrangement,capitate,climbing,colour,corolla,feature,form,growth,height,history,inflorescence,internode,length,life,na,ovary,perfect,plant,position,reproduction,seed,shape,spacing,staman,surface,texture,width
233	wfo-0001027378	success	141	96	69	72	27	0.489	.2,0.7-1,0.8-2.5,1.5-1.8,15-35,2-11,2-2.2,2.5-7,4-6,5-8,acuminate,anther,apex,articulated,basally,base,blue,broadly,chartaceous,clavate,climbing,cm,cordate,cylindrical,deeply,diameter,extra-axillary,filament,fleshy,flower,glabrous,hair,hair-tipped,herb,leaf,light,margin,minutely,mm,moderately,oblong,obscure,often,ovate,pedicel,peduncle,perfect,petiole,pubescent,rachi,revolute,rotate-pentagonal,simple,small,somewhat,spaced,sparsely,stigma,style,terrestrial,tip,tooth,unbranched,unknown,vein,white,widely,x,yellow	1-1.5,1-3,1.2-1.5,1.5-8,2-4,2.3-5,3-4.5,3-5,3-6,4-9,5-13,5-merou,6-10,6-7,abaxially,acute,adaxially,ag,alyx,apart,apicall,apparently,axe,ba,blade,calyx,capitat,ciliate,connivent,deltoid,densely,directed,distally,eaf,eed,equal,fruit,fruiting,geminat,lanceolate,large,lobe,long,longer,longitudinal,lower,multicellular,narrowly,nflorescence,node,opening,orolla,plurifoliate,pore,pubescen,rooting,rounded,scattered,short,slender,slightly,slit,tamen,tem,trailing,tube,unit,unknow,vary,weakly,wide,ympodial	abaxial,adaxial,arrangement,articulation,capitate,color,colour,corolla,form,growth,height,history,inflorescence,length,life,na,ovary,plant,position,reproduction,seed,shape,spacing,staman,surface,texture,width
234	wfo-0001027380	success	134	80	59	75	21	0.44	.5,2-3,2-3.5,30-35,5,5-merous,?,abaxially,acuminate,adaxially,anther,apex,articulated,base,broadly,chartaceous,cm,conical,deeply,diameter,distally,entire,extra-axillary,filament,flattened,flower,forked,fruit,glabrous,globose,homostylous,leaf,margin,minutely,mm,oblique,orange-red,ovate-lanceolate,pedicel,peduncle,petiole,pubescent,rachi,red,reticulate,rounded,shrub,simple,slender,slightly,small,sparsely,stellate,stigma,style,thickening,tree,unbranched,white	0,1-1.5,11-17,1136.,2.5-3,3-4,4-6.5,5-8,9-10,accrescen,adaxiall,almost,alyx,apparently,armed,axe,ba,bark,berry,blade,brown,calyx,capitat,developed,drying,eaf,eed,erect,fruiting,geminate,greenish-brown,hair,hartley,hooked,len,lobe,lon,long,loose,lower,minute,mpodial,nflorescence,occasionally,open,orolla,oung,pair,paler,perfec,perfect,prickle,primary,rip,ruit,scarcely,scattered,scramblin,shallow,smooth,somewhat,sparse,stem,structure,tall,tamen,testa,triangular,truncate,unarmed,unknown,vary,vein,visible,x	abaxial,adaxial,arrangement,capitate,color,corolla,form,growth,height,inflorescence,length,ovary,plant,position,ripe,seed,shape,spacing,staman,surface,texture
235	wfo-0001027381	success	262	110	88	174	22	0.336	.3,.8,0-1,0-1.5,0.2,0.4-0.6,0.5,0.5-0.6,0.5-1,1-2.5,3.5-4,5-11,abaxially,almost,along,anther,apex,base,berry,blackish,brown,capitate,clavate,cm,cream,dark,density,diameter,distributed,drying,dull,elliptic,erect,evenly,filament,flower,fruit,glabrous,globose,green,higher,lateral,leaf,length,less,like,lobed,marking,maturity,mauve,midpoint,mm,oblong,obtuse,orange,orange-green,ovate,pale,part,pedicel,peduncle,petiole,plant,porrect,rachi,ray,rounded,sessile,shiny,shrub,side,simple,size,smooth,stalk,stellate-pubescent,stem,stigma,style,surface,thin,translucent,trichome,variable,white,yellow,yellow-green,young	.4,/5,0.1,0.3-0.5,0.5-0.7,0.6-0.7,0°,1-1.5,1-2,1.5-4,1/3-1/2,1/4-1/3,2,2-2.5,2-3,2-4,2-6,3-4,3-5,3-7.5,4-5,4-8,5-8,5-merou,7-8,8-10,absent,accrescent,acute,adaxially,age,alyx,angle,apically,apparently,area,articulated,attachment,bark,blade,branch,branched,calyx,chartaceous,clearly,concolorous,cordate,covering,curved,delineated,deltoid,densely,difoliate,dilated,distance,divided,eaf,eed,ellipsoi,elongated,elongating,epidermi,equal,even,exserted,extending,eye,faint,fertile,filiform,flat,flattened,free,fruiting,geminat,gland,grey,greyi,inconspicuous,indumentum,infructescence,irregula,known,lamina,lanceolate,lengthening,light,lobe,long,long-deltoid,longer,longitudinal,lower,main,margin,mature,midvein,minute,mostly,naked,never,nflorescence,obconical,oblique,obscuring,often,orolla,pair,papillose,pendulous,per,perfect,pericarp,point,pore,poricidal,portion,present,prickle,primary,prominently,protruding,puffy,raised,rarely,reduced,region,rest,right,ruit,scar,shallow,sinus,slender,slightly,slit,small,smoot,sometimes,sparse,sparsely,spreading,stellate,straight,striate,stump,surrounded,tamen,tapering,terminal,tertiary,time,tip,tissue,truncate,tube,ud,unarme,unarmed,unit,usually,variously,vary,vein,venation,visibl,visible,wide,widening,without,woody,x,yellowish,ympodial	0.1-0.2,5-merous,abaxial,adaxial,arrangement,color,colour,corolla,feature,form,greyish,growth,height,inflorescence,na,ovary,position,seed,shape,spacing,staman,texture
236	wfo-0001027384	success	155	96	70	85	26	0.452	.75,0.4-1.1,0.9-1,1-3,1-4,1.5-2,3/4,5-15-flowered,5-5.5,7.5-8,acute,anther,apart,apex,bark,base,breaking,brown,bud,calyx,capitate,clavate,cm,corolla,cuneate,deep,ellipsoid,flattened-reniform,glabrous,globose,green,hard,later,leaf,lobed,long-exserted,minutely,mm,narrowly,obovate,opposite,ovary,pale,papillose,pedicel,peeling,petiole,pitted,pseudo-terminal,reddish-purple,rounded,section,shaped,shining,shrub,simple,slender,small,stigma,style,sulcate,surface,tapering,tear-drop,transverse,tree,tube,way,white,young	.25,.5,/3,0.5-1,1-1.3,1-1.5,2.5-6.5,3-3.5,3-4,4-7,7-14,abov,anothe,anthesi,ba,beginning,beneath,berry,broadly,closely,dia,difoliate,distal,drying,eaf,edicel,eed,equal,erect,filament,free,fruiting,geminate,herbarium,incrassate,inflorescenc,lateral,lobe,long,lower,main,margin,member,middle,mustard,nflorescence,occasionally,older,overlapping,pair,paler,papillo,planar,pore,poricidal,portion,prominent,rarely,ruit,scar,siz,spaced,specimen,stem,straight,subcoriaceous-fleshy,tall,thick,tip,triangular,trichome,tub,tuft,ud,uniseriate,unit,vein,widely,widest,without,woody,x,yellow,yellowish,ympodial	abaxial,adaxial,color,colour,diameter,flower,form,fruit,growth,height,history,inflorescence,length,life,na,number,peduncle,perennial,plant,position,rachi,reproduction,seed,shape,spacing,texture
237	wfo-0001027389	success	154	85	63	91	22	0.409	.1,.5,0.6-1,1-2,3-3.5,5-7,acuminate,acute,along,anther,apart,apex,bark,base,beneath,broadening,brown,bud,cm,corolla,dark,elliptic,evenly,filiform,glabrous,globose,green,hispidulous,inflorescence,leaf,lobed,long,minutely,mm,opposite,ovary,ovate,ovoid-reniform,pedicel,petiole,pitted,puberulent,raised,reddish-golden,scar,shaped,shrub,slight,slightly,spaced,sparsely,stem,stigma,style,surface,tear-drop,thread-like,top,trichome,truncate,vein,white,winged	.25,0.25-0.3,0.25-0.5,0.5-0.75,0.5-1.5,1,1-1.5,1.8-1.9,11-14,2-2.5,3-4.5,4-5-flowered,7-8,anthesi,ba,berry,broadly,calyx,conical,decurrent,deflexed,deltoid,dia,dry,eaf,edicel,eed,ellipsoid,erect,except,expanded,exserted,filament,foetid,foliage,free,fruiting,geminate,lateral,like,lobe,lon,lower,main,making,margin,material,middle,nearly,nflorescence,node,non-reproductive,obovoi,occasionally,often,older,one,pair,paler,papillo,papillose,pore,poricidal,portion,prominent,prominently,proximal,raise,reflexed,rest,ruit,shin,side,simple,slender,soon,straight,tall,tapering,tip,tube,ud,unifoliat,uniseriate,unit,widest,woody,x,yellowish,ympodial,young	abaxial,adaxial,arrangement,color,colour,diameter,flower,form,fruit,growth,length,na,peduncle,position,rachi,seed,shape,shiny,spacing,texture,unifoliate,width
238	wfo-0001027395	success	153	105	79	74	26	0.516	.5,1-1.5,1-2,1.1-1.5,1.5-1.9,1.5-2.5,2-3,3.5-4,4-6,acute,anther,apex,apically,bark,base,beneath,berry,black,calyx,capitate,closely,cm,conical,constricted,corolla,deltoid,densely,drying,exfoliating,filament,fleshy,fruit,glabrous,globose,green,large,leaf,lobe,lobed,minutely,mm,narrowly,nearly,obovate,occasionally,once-furcate,opposite,ovary,overlapping,ovoid,papillose,pedicel,petiole,piece,pointed,pore,poricidal,primary,pubescent,scar,secondary,shaped,shrub,simple,small,spaced,stigma,straight,style,tear-drop,thick,tip,transverse,tube,vein,white,within,without,x	.25,0.25-0.5,0.6-1.1,0.75-1,1-5,1.6-2.9,10-20-flowered,11-15,12.5-17.3,2.2-7,5-6.5,8,anthesi,apiculate,attenuate,becoming,beginning,caly,cucullate,decurrent,deflexed,depressed,dia,differing,difoliate,eaf,edicel,eed,enlarging,erect,exserted,free,fruiting,geminat,immature,imperceptibly,inflorescenc,known,lateral,lon,long,lower,main,major,margin,midrib,minor,nflorescence,older,pair,papillo,partially,planar,portion,raised,restricted,robust,ruit,rusty-papillate,shining,shiny,size,somewhat,stem,tall,tapering,thickened,trichome,ud,uniseriate,unit,woody,ympodial,young	abaxial,adaxial,arrangement,bud,color,colour,diameter,form,growth,height,history,inflorescence,length,life,na,peduncle,plant,position,rachi,reproduction,seed,shape,spacing,surface,texture,width
239	wfo-0001027396	success	244	114	95	149	19	0.389	0-3,0-4,0.5-1,0.5-1.5,0.5-2,0.5-2.5,0.7-2.5,0.8-1.3,1.5-3.5,2-3,2-7,3.5-6,5-50,5.5-7.5,6.5-7.5,abaxial,abaxially,acute,adaxial,almost,andromonoecious,anther,apart,apex,attenuate,bark,base,black,brown,bulbous,chartaceous,cm,cream,cuneate,dark,densely,diameter,elliptic,elongate,filament,flattened,flattened-reniform,flower,fruit,glabrescent,glabrous,green,herb,lateral,leaf,length,lobed,long-styled,margin,marking,mature,mauve,midpoint,mm,moderately,obtuse,orange,pale,pedicel,peduncle,perpendicular,petiole,plant,porrect,prickle,pubescent,purple,ray,rotate,short-styled,shrub,sometimes,somewhat,sparsely,spherical,stellate-pubescent,stem,straight,style,surface,terete,tertiary,trichome,unbranched,venation,visible,white,yellow,yellowish,young	-2,-5,-6,/3,0-100,0-30,0-5,0.1-0.5,0.1-1,0.4-0.7,0.8,1,1-4,1.2-2,1.5-3,1.8-3,1/2-2/3,1/3,1/4-1/3,1/6,10-15,10-25,10-30,10-35,12-25,15-40,2-3.5,2.5-4,2.8-4.5,20-100,3-,3-9,4,4-5,4-6,4-7,5-10,5-20,5-30,5-8,5-merous,6-20,7-10,7-15,8-20,alyx,ame,apar,apically,apparently,articulated,ba,berry,blade,broad,broad-deltate,c.,calyx,concolorous,connivent,curved,decurrent,deltate,difoliate,discolorous,distal,distance,drying,eaf,eed,elongating,equal,erect,extending,extensive,fewer,free,fruiting,fully,geminat,glandular,gray-brow,hair,hermaphrodite,heterostylous,infructescence,less,lignified,lobe,lobing,lon,long,long-acuminat,longer,lower,lowermost,maturity,midvein,near,nflorescence,often,older,one,open,opening,orolla,oung,pair,pendulous,per,pericarp,poricidal,portion,prickl,prickly,primary,red-brown,reflexed,ruit,scar,secondary,sessile,side,simple,smooth,spaced,spreading,stalk,stalked,staminat,stout,tamen,tapering,tearing,time,tip,tube,unarmed,unit,upper,usually,variously,vary,vein,way,wide,woody,yellow-green,ympodial	/,color,corolla,form,gray-brown,growth,height,inflorescence,na,ovary,position,reproduction,seed,shape,spacing,staman,stigma,texture,width
240	wfo-0001027416	success	137	115	84	53	31	0.613	0.2-0.4,0.3-0.5,0.5-1.0,1.3-2.0,1.5-2.0,2.6-3.0,3-7,4-7,4-8,5-10,5.5-8.5,8-10,accrescent,acute,along,annual,anther,apically,appearance,blade,blue,branching,broadly,brown,calyx,campanulate,capitate,capitate-glandular,cm,dark,deltoid,dm,dry,erect,few-rayed,foveolate,glabrous,gland,hair,herb,internodal,lanceolate,lenticular,lobe,main,minutely,mm,much-dissected,narrowly,often,otherwise,ovary,ovate,pedicel,pentagonal-stellate,pinnatifid,prickle,prickly,quantity,reticulately,scattered,sessile,short-stipitate,slender,smooth,spherical,splitting,stellae,stem,straight,strait,terete,thrice,tube,twice,ultimate,uniseriate,varying,vein,villous,violet,viscid-villous,weakly,wrinkled	.5,1.0,1/2-2/3,4.0-5.5,5-9-flowere,across,alyx,anthesi,base,beneath,berry,borne,cauline,developing,dia,difoliate,divided,eaf,eed,enveloped,externally,fine,geminat,green,heteromorphic,incurved,invested,linear,lon,long,maturity,nflorescence,orolla,ruit,short,simple,slende,slightly,somewhat,spreading,strigulose,tall,tamen,taprooted,tightly,tigma,tub,tyle,unit,usually,wholly,yellow,ympodial	1.5,2,5-9-flowered,arrangement,color,corolla,diameter,filament,flower,form,fruit,growth,height,history,inflorescence,leaf,length,life,na,number,plant,reproduction,seed,shape,staman,stigma,style,surface,texture,type,wrinkling
241	wfo-0001027432	success	215	125	104	111	21	0.484	0.3-0.4,0.3-1.0,0.3-3.5,0.5-1,1-1.5,1-3,1.4-2,2-2.5,2-3-lobed,20-30,3-10,3-5,3-6,6-7,8-10,abaxially,acute,angulate,anther,apart,apex,attenuate,bark,base,berry,branching,brownish,c.,clavate,cm,corolla,cream,densely,diameter,entire,erect,ferruginous,filament,flattened,flower,fruit,fruiting,glabrescent,glabrous,glandular,glandular-pubescent,globose,green,greenish,growth,heterostylous,irregularly,leaf,lengthening,light,lobed,margin,maturing,mm,mucilaginous,new,ochraceous,ovary,ovate,ovate-elliptic,pedicel,peduncle,per,perfect,petiole,plant,prickle,pubescent,rarely,recurved,reniform,reticulate,scabrous,shrub,somewhat,spaced,sparsely,stellate,stellate-pubescent,stem,stigma,style,subglobose,surface,tan,terete,terminal,time,tomentose,trichome,unevenly,velutinous,way,white,woody,x,yellow,yellowish,young	-1.5,.5,0.1,0.2-0.3,0.5-0.1,0.8-1.0,1-multicellular,1.5-,1.5-2,1/3,1/4,10-22,3,3-4,3-7,3.5-4.5,30,4-5,4.5-,5-10,6-10,7-,8-16,acicular,adaxially,apical,armed,articulate,basal,blade,branched,brow,calyx,campanulate,chartaceous,confined,conical,coriaceous,curved,cuspidate,distal,eaf,eed,eglandular,epidermi,especially,exserte,fewer,free,hirsute,juvenile,laterally,leave,like,linear-lanceolate,lobe,long,long-styled,lower,many,many-celled,midpoint,minute,much,multangulate,multiangulate,near,nflorescence,older,one,partially,pericarp,plurifoliat,pore,poricidal,porrect,porrect-stellate,portion,prickly,prominent,puberulent,raise,ray,ruit,sessile,short-styled,similar,simple,slightly,staminate,stellate-pubescen,stellate-tomentose,stipitate,straight,sub-coriaceous,subsessile,tapering,testa,thick,tip,tomentose-floccose,tomentose-scabrous,tube,ud,unarmed,unicellular,unit,upper,villose,visible,ympodial	1.5-7,abaxial,adaxial,brown,color,form,height,history,inflorescence,lateral,length,life,number,perennial,position,reproduction,seed,shape,spacing,staman,texture
242	wfo-0001027437	success	193	129	101	92	28	0.523	0,0.2-0.4,1-1.5,1-4,2-2.5,2-2.5mm,2-4.5,2.5,4-5,6-8,abaxially,acuminate,acute,adaxially,anther,anthesi,apex,attenuate,bark,base,beige,beneath,berry,brown,calyx,clavate,cm,cordate,corolla,corymbose,cyme,dark,decurrent,diameter,elliptic,entire,erect,exceeding,filament,flower,fruit,fruiting,glabrous,glandular-viscous,globose,green,growth,heterostylous,impressed,internodal,lateral,lengthening,lenticulate,linear-lanceolate,lobed,margin,mixed,mm,oblanceolate,ovary,ovate,partially,pedicel,peduncle,perfect,petiole,pore,poricidal,porrect,prominent,pubescent,reddish,reticulate,rugose,scabrous,sessile,shrub,simple,slightly,slit,spaced,sparse,sparsely,stalked,stellate,stellate-rotate,stigma,style,subreniform,subspherical,surface,tip,tomentose,trichome,unevenly,velutinous,venation,white,woody,x,yellow	0.4-0.5,1,1-2,1-3,1.2-1.5,2-3,2-several,2.8-6,30,4,4-4.5,5-12,5-6,7-17,antrorse,armed,articulated,basal,branched,chartaceous,compressed,curved,densely,diamete,discolorous,distal,eaf,eed,egalndular,elongate,erec,free,glandular,hirsute,inserted,laterally,leaving,like,lobe,long,long-styled,lower,middle,midpoint,minute,mixture,near,nerve,new,nflorescence,oblong,older,one,pericarp,plurifoliat,portion,prickle,prickly,puberulent,pubescence,raise,ray,recurved,reduced,reflexed,ruit,rusty,scar,scarce,short-styled,staminate,stem,stipitate,straight,strongly,subcampanulate,tall,terete,testa,thick,three,time,tinge,triangular-lanceolate,tube,ud,unarmed,unicellular,unit,upper,within,ympodial	abaxial,adaxial,arrangement,bud,color,colour,decurrency,form,height,history,inflorescence,insertion,leaf,length,life,na,plant,plurifoliate,position,rachi,reproduction,seed,shape,spacing,staman,texture,type,width
243	wfo-0001027447	success	197	124	97	100	27	0.492	0-0.4,0-2.5,0.5-1.7,0.6-1,1-1.4,1-10,1-2.5,1.2-1.7,17-28,25-30,3-4.5,3-6,3.5-4.5,4-8,4-9,5-8,7-8,absent,acicular,acuminate,acute,adult,andromonoecious,anther,apart,apex,base,branch,chartaceous,cm,cuneate,decimetre,densely,diameter,dm,elliptical,entire,erect,exocarp,extra-axillary,flower,fruit,glabrous,globose,green,index,inflorescence,juicy,lateral,leaf,length,lobe,lobed,lobing,long,margin,mesocarp,midpoint,midrib,midvein,mm,moderately,oblique,obtuse,ovate,pale,part,pedicel,peduncle,per,perennial,petiole,placenta,plant,present,prickle,pseudo-racemose,ray,red,rhizomatous,sessile,shallowly,shrub,sparsely,stellate,stellate-pubescent,straight,style,succulent,surface,thick,time,unbranched,vein,weakly,white,yellow	%,.25,0-0.5,0-1,0-10,0-4,0.15-0.25,0.2-0.6,0.2-1,0.25-0.3,0.25-0.5,0.4-0.6,0.6-0.8,1-2,1-locular,1.3-1.7,1.5-3,10-20,13-18,2.1-3.2,2.3-5,2.5-4,3.8-4.3,4-6,5-13,5-merou,6-10,7-10,7-14,7-14.5,8-13,abaxially,absen,across,adaxiall,adaxially,alyx,articulated,axe,ba,blade,branche,brown,calyx,confined,cross-section,cylindrical,directed,distall,distally,eaf,eed,eglandular,elliptica,finger,fruiting,functional,gland-tipped,hair,half,heterostylous,incomplete,juvenile,lamina,less,longer,lower,markedly,mature,minute,nflorescence,orolla,pair,pore,porrect,pubescence,rostrate,ruit,septum,short,side,simple,spaced,stellae,tal,tamen,tem,thicker,throughout,transparent,tube,unarme,unarmed,unit,unknow,upper,vary,wide,x,ympodial	0-0.6,5-merous,abaxial,adaxial,color,colour,corolla,density,filament,form,growth,height,history,life,na,number,ovary,position,presence,reproduction,seed,shape,spacing,staman,stigma,texture,thicknes
244	wfo-0001027449	success	160	110	79	81	31	0.494	.4,.5,.75,0.5-1,0.8-1.5,0.9-1.1,1.4-1.5,1.5-2.5,2-4,3,3-3.5,5-6,acute,anther,anthesi,apex,bark,base,beneath,brown,bud,calyx,closely,cm,corolla,dark,deflexed,densely,ellipsoid,elliptic,exserted,filament,fruit,fruiting,glabrate,glabrous,globose,green,inflorescence,leaf,lobe,lobed,long-acuminate,minutely,mm,narrowly,often,opposite,ovary,overlapping,ovoid-reniform,packed,pale,papillose,pedicel,persistent,petiole,pitted,pointed,pore,pubescent,shaped,shrub,simple,size,small,soon,sparsely,stigma,straight,style,surface,tapering,tear-drop,tip,tree,tube,white,x	/3,0.5-1.5,1.2-1.5,10-15-flowered,2-3,3-7,4-6,8-15,acuminate,appearing,area,arising,around,axil,becoming,beginning,berry,cup,deciduous,dense,density,dia,differing,difoliate,dry,eaf,edicel,eed,erect,extreme,forming,free,frui,geminat,inflorescenc,lamina,later,lateral,like,lon,long,long-triangular,lower,main,major,material,minor,nflorescence,obconic,oblique,older,one,orangish,pair,poricidal,portion,prominent,raised,red-papillose,reddish-brow,reflexed,rest,ruit,scar,slender,sparse,stem,styl,tall,trichome,trunk,tuft,ud,uniseriate,unit,varying,vein,way,woody,ympodial,young	abaxial,adaxial,arrangement,color,colour,deflexion,diameter,exsertion,flower,form,growth,height,history,length,life,na,peduncle,perennial,persistence,plant,position,rachi,reddish-brown,reproduction,seed,shape,spacing,staman,straightnes,texture,width
245	wfo-0001027452	success	152	99	70	82	29	0.461	0.5-1,0.5-1.5,0.5-2,1,1-3,1.5-3,10-20,2-foliate,4,4-6,5-12,absent,acute,anther,apex,base,brown,cell,center,chartaceous,cm,connected,cordate,diameter,dm,drying,elliptic,elliptic-ovoid,filament,flower,fruit,glabrous,globose,herb,immature,large,long,margin,maturing,membranaceous,mm,moderately,nearly,notched,oblong,parallel,pedicel,peduncle,perpendicular,petiole,placenta,pubescent,rachi,raised,ridge,rotate,running,seed,semitransparent,significantly,smaller,smoother,sparsely,stigma,style,swollen,wall,white,x,yellow	.5,0.5-2.5,1-2,1-4.5,1-5,1.5,2-4,2-6,3-6,3-9,5-20,abaxially,abundant,adaxiall,adaxially,along,axe,berry,beyond,blade,branched,calyx,celled,ciliate,decurrent,dehiscing,densely,denser,eaf,eed,emarginat,entire,equal,explosively,exserted,flat,frui,geminat,growt,hair,held,interpetalar,linear-lanceolate,lobe,lower,lying,maturit,mesocarp,new,nfloresence,obtuse,often,one-,orolla,outer,per,pressure,pubescen,rounded,ruit,short,single,slightly,sometimes,stamen,straight,tal,tamen,tem,tissue,triangular,tube,two-celled,unbranched,unit,usually,vary,vein,watery,wid,woody,ympodial	abaxial,adaxial,arrangement,color,colour,corolla,emarginate,form,growth,height,history,inflorescence,leaf,length,life,na,notching,ovary,perennial,plant,position,reproduction,shape,spacing,staman,surface,texture,wide,width
246	wfo-0001027471	success	165	119	101	64	18	0.612	.5,/4,0.1-0.2,0.2-0.5,0.4-1,0.5-0.6,0.5-1.5,0.9-1,1-1.6,1.4-3,1.5-2,2-2.5,2-lobed,3-7,4-5,6-7,acute,anther,apex,appressed,ascending,bark,base,berry,bifid,branched,brittle,closely,cm,conical,corolla,dendritic,densely,desnsely,diameter,differing,drying,elliptic,entire,filament,flattened,furcate-dendritic,glabrous,globose,growth,herb,inflorescence,internodal,leaf,leaf-opposed,less,lobed,major,margin,maturity,minor,minutely,mm,new,ovary,ovate,overlapping,pair,pale,pedicel,peduncle,petiole,pitted,plane,poridical,primary,pubescent,pubscent,rachi,red-orange,reniform,scar,shape,shrub,similar,simple,size,small,somewhat,spaced,sparsely,stem,stigma,style,subshrub,surface,tan,thin,tip,trichome,uniseriate,vein,way,white,x,yellowish	0.2-0.4,0.5,0.5-0.7,0.7-0.9,1-1.2,1-1.5,2-3,3-4,abaxially,adaxially,age,along,anthesi,c.,calyx,deltate,difoliate,distant,eaf,eed,erec,erect,especially,flower,free,fruiting,geminate,included,lamina,lengthening,like,lobe,long-triangular,lower,midvein,mixture,nflorescence,nodding,node,occasionally,open-conical,orbicular,papillat,perfect,pericarp,petal,planar,pore,portion,reflexed,ruit,scattered,slender,slightly,slit,straight,thickened,trifoliat,tube,ud,unit,usually,woody,ympodial	abaxial,adaxial,arrangement,bud,color,form,fruit,height,length,number,papillate,plant,position,pubescence,seed,spacing,texture,type
247	wfo-0001027473	success	138	100	77	61	23	0.558	.25,0.25-0.5,0.5-1,1-1.5,1-2,3.5-5,5,6-9,?,acute,anther,apex,apparently,bark,base,brown,calyx,conical,corolla,deccurent,decurrent,deep,dendritic,densely,di-,empty,erect,filament,flattened-reniform,glabrous,globose,green,incrassate,lateral,leaf,like,lobe,lobed,long,long-triangular,main,margin,minutely,mm,obovate,occasionally,pair,pale,petiole,pitted,pointed,pubescent,pubesent,rootstock,rusty,sac,sessile,shape,shrub,somewhat,sparsely,stem,sterile,strongly,subshrub,surface,thick,trichome,trifoliate,tube,vein,white,wide,wing,winged,woody,young	/2,0.8-1,1.3-2,1.5-2,1.8-2,1/3,2-2.5,2.5-3,4.5-13,8.5-37,abaxially,absen,adaxially,along,anthesi,ape,berry,clavate,cm,deflexed,denser,dia,differing,drying,eaf,eed,free,fruiting,geminat,giving,later,less,lower,major,middle,minor,minute,near,older,ovary,overall,papillo,pedicel,planar,pore,poricidal,portion,ruit,shaped,stigma,style,tall,tear-drop,tip,unit,usually,way,widest,yellowish,yellowish-brow,ympodial	abaxial,absent,adaxial,arrangement,color,density,depth,flower,form,fruit,growth,height,history,length,life,na,plant,presence,seed,texture,thicknes,width,yellowish-brown
248	wfo-0001027483	success	164	129	102	62	27	0.622	0.2-1.9,0.6,1-4,1.2-2.5,1.5-2.6,1.5-3,2,2-4,2-4.5,3-15,3-6,5-6,abaxially,acute,adaxially,apex,apical,apically,articulate,base,branched,cell,cm,coarsely,corolla,covering,cuneate,cyme,decurrent,dehiscent,diameter,dichasial,dichasially,distal,dot,ebracteate,elliptical,filament,finely,flower,generally,globose,green,green-white,hair-like,half,herbaceous,interpetiolar,introrse,lateral,leaf,leaflet,light,lighter,long,maturing,medium,mm,monochasial,mucilaginous,obtuse,odd-pinnate,often,ovate,ovoid,pedicel,peduncle,perennial,petiole,petiolule,plant,poricidally,proximal,pubescent,purple,rachi,ray,rotate,rounded,seed,sessile,short,size,slit,smooth,sometimes,stigma,style,subsessile,terminal,testal,thick,throughout,tuber-bearing,uniform,violet,violet-purple,wall,white,wide,yellow,¼	0-1.,1,1-2,1-2.5,1-5,1.5-10,2-3,3-6-foliat,3.5-20,4.5-8,5-10,acumen,basal,calyx,connate,digestion,diminishing,dorsally,eaf,edge,eed,emoval,enzyme,erec,exceeding,flat,folded,forked,globo,gradually,honeycomb,interjected,living,lobe,lon,lower,lunat,make,minute,nflorescence,nther,orolla,pair,pattern,perfect,plan,reveal,rosette,ruit,seudostipule,specimen,stamen,straight,tall,tem,tissu,toward,typically,unit,vary,varying,ympodial	anther,arrangement,articulation,color,decurrency,dehiscence,form,fruit,growth,height,history,inflorescence,length,life,mucilaginousnes,ovary,position,reproduction,sessility,shape,stem,structure,subsessility,surface,texture,tissue,wet
249	wfo-0001027503	success	197	117	95	102	22	0.482	.5,0.4-0.7,0.5,0.5-0.6,0.5-0.7,0.8-1,1,1-3,4,8-11,acute,anther,apex,base,beige,berry,bluntly,branched,broad-based,calyx,clavate,cm,conical,corolla,deflexed,densely,diameter,dioecious,echinoid,elliptic,enclosing,entire,erect,expanding,flower,foliose,fruit,fruiting,glabrous,globose,greatly,greenish,growth,inflorescence,internodal,lamina,leaf,lepidote,less,lobe,lobed,long,margin,midrib,minutely,mixture,mm,narrowly,ovary,packed,pair,pale,partially,pedicel,peduncle,petiole,plant,porrect,prickle,primary,pubescent,shiny,shrub,small,somewhat,sparsely,stellate,stem,stigma,stout,straight,style,surface,tan,thin,tightly,tree,trichome,truncate,unisexual,vein,visible,white,x,yellowish	0.15-0.2,0.2,0.6-0.7,0.9-1.2,1-1.2,1.1-1.5,1.2-2.5,10,2-3,2.5-3,2.5-5.5,20-40,549,<,abaxially,adaxially,age,almost,along,anthesi,armed,articulated,bark,beneath,berr,broadly,common,consisting,coriaceous,deltate,dense,distally,due,eaf,eed,ellipsoid,elongate,female,fide,filament,free,glabrescen,grey,included,juvenile,known,lanceolate,large,lengthening,like,likely,lower,male,nearly,new,nflorescence,occasionally,often,older,overlappin,papillo,peguero,pericarp,pistillate,planar,plurifoliat,pore,poricidal,portion,prickly,prominent,pubescence,ray,rest,rhachi,ripe,rounded,rudimentary,ruit,scar,seen,shoot,short,similar,simple,slit,solitary,staminate,thick,time,tiny,tip,tube,tubular,ud,unarme,unarmed,underside,unit,without,ympodial,½	abaxial,adaxial,color,deflexion,expansion,feature,form,height,history,length,life,na,papillose,perennial,position,rachi,reproduction,seed,shape,spacing,texture,width
250	wfo-0001027506	success	215	113	96	119	17	0.447	/6,0-10,0.2,0.5-1.5,0.5-6,0.7-1.3,0.8-1.5,1-2,1-4,1.2-1.5,1.5-2.2,10-40,2-3.2,5-7,5-merous,6-13,acuminate,acute,andromonoecious,anther,apart,apex,bark,base,berry,branched,brown,calyx,cell,cm,cordate,cream,dark,densely,diameter,entire,erect,filament,fine,flattened-reniform,flower,fruit,fruiting,glabrescent,glabrous,green,lateral,leaf,length,lobe,lobed,margin,marking,maturity,mauve,mm,moderately,multangulate,occasionally,orange-brown,outline,ovate,pair,pale,pedicel,peduncle,petiole,pit,plant,porrect,primary,purple,raised,reddish,shrub,small,smooth,spherical,stellate,stellate-pubescent,stem,style,subentire,surface,terete,terminal,tertiary,tree,trichome,truncate,vein,venation,visible,way,yellow,young	-0.35,-1,-20,-3,-7,-7.5,.2,.5,/2,0,0-2,0-6,0-60,0.1-,0.1-0.3,0.2-0.3,0.25,1-3,1.8,1/3,1/6-1/4,2.2-3.5,2.5-5,2.5-8,3-10,3-5,3-6,3.5-5,5-10,6.5-10,7-8,7-9,8-10,9-13,abaxially,acuminat,alyx,ame,apar,apically,apparently,articulated,becoming,blade,brow,c.,chartaceous,concolorous,connivent,cuneate,curved,distal,dry,drying,eaf,eed,elongating,equal,flattened,free,hard,hermaphrodite,heterostylous,infructescence,lengt,long,long-styled,longer,lower,lowermost,mature,midpoint,narrow-deltate,nflorescence,older,one,open,orange,orolla,oung,pendulous,per,pericarp,plurifoliat,poricidal,portion,prickl,prickle,prickly,ray,reduced,reflexed,ruit,scar,sessile,short-styled,simple,sometimes,spaced,spreading,stalk,stalked,staminat,stout,tamen,tapering,time,tip,tube,twice,unarmed,unit,upper,variously,vary,wide,woody,yellow-green,ympodial	abaxial,color,corolla,form,growth,height,inflorescence,na,ovary,position,reproduction,seed,shape,spacing,staman,stigma,texture
251	wfo-0001027510	success	195	101	80	115	21	0.41	.5,0-0.4,0-2,0.4-0.9,0.5-0.6,0.7-1.5,0.9-3.4,1.5-4,1.6-2,2-2.2,2-3,2.5-3,4-6,4-9,6-7.5,absent,acute,adult,anther,apex,broadly,capitate,chartaceous,cm,densely,diameter,erect,extra-axillary,filament,finger,flower,fruit,gland-tipped,globose,green,grey,hair,inflorescence,juvenile,lanceolate,lateral,leaf,length,lobe,lobed,long,midpoint,minutely,mm,ovate,pair,pale,pedicel,peduncle,perennial,petiole,prickle,purple,rachi,ray,red,reticulate,rhizomatous,rotate-stellate,shallowly,shrub,simple,stalk,stellae,stellate-pubescent,stigma,style,succulent,surface,time,unbranched,usually,wide,x,yellow	%,.7,0-0.5,0-0.9,0-5,0.1-0.3,0.2-0.4,0.5-1.1,0.7-1.6,0.8-1.8,1-2,1-3,1-locular,1.5-2,1.5-2.5,1.5-3,10-12,10-13,10-15,17-35,2-5,2-foliate,2.6-5.5,2.6-6,3-5,3-6,4-5,4-5.5,4-8,5-10,5-merou,6,6-13,6-8,9-12,abaxially,absen,abundant,accrescent,across,adaxially,alyx,apart,apparen,articulated,axe,ba,base,blade,calyx,connivent,contiguous,cordate,cylindrical,deltate,directed,distall,distributed,eaf,eed,eglandular,elliptic,entire,exceeding,forke,fruiting,geminat,glabrous,homostylous,incomplete,interpetalar,juicy,lamina,leafy,lower,margin,mature,mesocarp,minute,nearly,nflorescence,oblique,obtuse,orolla,part,per,perfect,placenta,pore,porrect,pseudo-umbellate,pubescent,ruit,septum,sessile,short,soliary,spaced,stellate,tal,tamen,tem,thick,throughout,tissu,tissue,transparent,tube,unarme,unarmed,unit,upper,vary,without,ympodial	arrangement,color,colour,corolla,forked,form,growth,height,history,life,number,ovary,plant,position,presence,seed,shape,staman,stem,texture,thicknes
252	wfo-0001027536	success	200	98	74	126	24	0.37	-15,0.4-2.0,1-1.5,1-2,2-,2-10,2-2.5,2-5,3-5,3-forked,5-10,5-6,8-10,acute,adaxially,anther,apart,apex,articulated,base,brown,chartaceous,cm,densely,depressed-globose,diameter,eglandular,elliptic,epicarp,ferruginous,filament,fine,flower,fruit,gland-tipped,glandular,glandular-stellate,globose,hair,inflorescence,leaf,leathery,lenticular,linear-lanceolate,long,lower,mixed,mm,multiseriate-stalked,oblanceolate,ornamentation,pedicel,peduncle,perennial,persistently,petiole,pubescent,rachi,reticulated,short,shrub,similar,stellate,stigma,style,subreniform,surface,tomentose,unbranched,unisexual,velutinous,white,yellow,yellowish	-3,1.5-2,2-3,2-4,20,3-3.5,3-4,30-50,4,4-10,4-12,4-5,4-8,5-7,8-,abaxially,accrescent,adaxiall,alyx,ape,apical,apiculate,armed,asymmetric,axe,ba,basal,berry,bicolored,bisexua,blade,branch,branched,calyx,clavate-truncat,compressed,connivent,curved,dark,decurrent,distal,dry,eaf,eed,enlarged,entire,equal,erect,exceeding,ferruginous-tomentose,fleshy,free,fruiting,glabrous,gynoecia,held,impressed,introrse,laterally,like,lobe,longer,many-foliat,margin,maturit,midpoint,mostly,multiseriate,nflorescence,one,opening,orolla,part,per,perfect,persistent,pore,prickle,primary,prominent,recurved,reddish,reduced,reflexed,ruit,sessile,simple,single,slender,slightly,small,somewhat,spaced,sparsely,splitting,stalk,stamen,staminate,stem,straight,subcampanulate,subcoriaceous,subulate,surrounded,tal,tamen,tem,terete,thick,time,tip,trichome,tube,unarme,unarmed,unit,upper,upright,usually,vary,vein,villose,wide,x,ympodial,zygomorphic	abaxial,articulation,bisexual,clavate-truncate,color,corolla,form,growth,height,history,length,life,na,ovary,plant,position,reproduction,seed,shape,spacing,staman,texture,thicknes,width
253	wfo-0001027538	success	137	64	33	104	31	0.241	.9,0-1.5,0.05-0.15,0.4-0.85,4-5,anther,apart,apex,cm,cordate,densely,diameter,extra-axillary,flower,fruit,glabrous,grey-green,inflorescence,length,mm,obtuse,ovate,pedicel,peduncle,petiole,prostrate,simple,stellate,stellate-pubescent,unbranched,unknown,yellow,yellowish	%,.5,0-0.1,0-2,0.1-0.2,0.3-0.4,0.3-0.45,0.4-0.5,0.5,0.5-1,0.5-1.5,0.6-1,0.9-1,0.9-1.2,0.9-1.8,1,1-4,1.5-3.5,1.9-2.4,2-4,20-25,5-merou,7-12,8,8-13,?,abaxially,absen,absent,acicular,across,acute,adaxiall,adaxially,alyx,armed,articulated,attenuate,axe,ba,base,blade,brown,calyx,chartaceous,directed,distall,distributed,eaf,eed,eglandular,entire,finger,fruiting,gland-tipped,globo,hair,half,lamina,lateral,less,lobe,lon,long,lower,margin,mature,mid-point,midpoint,midvein,minute,nflorescence,oblique,orolla,part,per,pore,porrect,present,prickle,ray,ruit,rusty,sessile,short,shru,spaced,stage,stalk,stellae,straight,tamen,tem,thick,throughout,time,tube,unarmed,unit,unknow,uvenile,wide,x,ympodial	5-merous,abaxial,adaxial,arrangement,color,colour,corolla,filament,form,globose,growth,height,history,leaf,life,na,ovary,plant,position,rachi,reproduction,seed,shape,shrub,spacing,staman,stigma,style,surface,texture,width
254	wfo-0001027548	success	216	117	89	127	28	0.412	0.3-1.2,0.5-2,1,1-1.5,1-10,1.5-2,6-9,acuminate,acute,adaxially,almost,anther,apart,apex,articulation,bent,berry,black,branched,branching,brown,capitate,cm,corolla,dark,darker,densely,depressed-elliptic,diameter,drying,dull,elliptic,filament,flattened-reniform,flexuous,flower,fruiting,glabrous,globose,green,growth,herbarium,immature,inflorescence,irregularly,leaf,like,lilac,lobed,many,margin,matte,membranous,minutely,mm,narrowly,new,pale,papillate,pedicel,peduncle,petiole,pitted,point,prominent,pubescent,rachi,reddish,ripe,scar,simple,somewhat,spaced,sparsely,stellate,stem,stigma,style,surface,terminal,time,tinged,tip,vine,warty,white,woody,x,yellow	-11.5,.3,0.2,0.5,1-2.5,1-3.5,1.2,1.5,1.5-2.5,10-12,10-50,3-7,4-6,4-8,4.5,5-merou,7-10,8-9,abaxiall,ag,along,also,although,alyx,anthesi,apical,apparently,appearing,area,ark,articulated,attenuate,axi,basal,base,beneath,branch,bu,c.,calyx,cell,conical,connivent,deflexe,deltate,dendritic,denser,eaf,early,eed,ellipsoid,elongate,em,entire,exserted,extending,free,geminat,glabrescen,glandular,half,ilament,lamina,leaving,lengthening,less,lobe,lon,long,long-styled,loose,loosely,lower,minute,mixed,near,nflorescence,occasionally,older,orolla,outline,pair,papillae,papillo,per,perfect,pericarp,planar,plurifoliate,pore,poricidal,portion,primary,puberulent,rectangular,revolute,ruit,scattered,size,slender,slit,small,sometimes,sparse,specimen,spreading,strongly,swollen,tapering,testal,thickened,thin,tiny,transparent,trichome,tube,twinin,type,ud,uniseriate,unit,upper,usually,vary,vein,way,ympodial	1.2-2.5,8,abaxial,adaxial,arrangement,bark,color,colour,deflexed,form,fruit,glabrescent,height,history,length,life,na,ovary,plant,position,reproduction,seed,shape,spacing,speciman,staman,texture,width
255	wfo-0001027581	success	200	114	78	122	36	0.39	abaxial,acute,adaxial,anther,apex,base,berry,branched,branching,broadly,brown,c.,clavate,closely,cm,corolla,dark,densely,diameter,echinoid,elliptic,entire,evenly,filament,flattened-reniform,flower,fruiting,globose,golden,green,growth,inflorescence,leaf,length,like,lobed,many,margin,minutely,mm,moderately,multangulate,multiseriate,pair,pedicel,peduncle,petiole,pitted,plane,pubescent,purple,reddish,ripe,scar,sessile,short-stalked,shrub,simple,small,spaced,stalk,stellate,stem,stigma,style,surface,terminal,time,tree,trichome,undersurface,unevenly,unit,vein,way,woody,yellow,yellowish	0.2–0.3,0.3,0.3–1,0.5–1,0.5–1.5,1,1.2–1.5,1.3–1.5,1.5,1.5–2,1.5–3,10,100+,10–16,12,12–30,15–20,1–1.5,1–3-rayed,2.5–3,200,3.5–4.5,3–3.5,4.5–16,4–8,5-merou,6–7,7–10,7–9,8,8–10,9–11,9–9.5,>,abaxially,ag,along,alyx,anthesi,apar,ark,articulated,axe,beneath,brow,bulbous,calyx,clearly,connivent,cup-shaped,deltate,dichasia,discolorous,distally,drying,eaf,eed,ellipsoidal,erec,exserted,free,glabrescent,glabrous,gradually,greyish,ilament,lamina,largest,lengthening,less,lobe,long,longest,loosely,lower,midvei,minute,mixed,narrowing,near,new,nflorescence,nodding,older,orolla,papillo,part,per,perfect,pericarp,plurifoliate,pore,poricidal,porrect-stellate,portion,primary,ray,reflexed,rhachi,ruit,scarcely,shiny,size,slit,smaller,sparsely,spreading,stout,tall,tem,thin,tip,tube,ud,upper,vary,varying,visible,weak,whit,wide,ympodial	1-3-rayed,1.2-1.5,1.3-1.5,1.5-3,2.5-3,3-3.5,4-8,5-merous,7-10,7-9,9-11,9-9.5,apart,arrangement,bark,color,colour,dichasial,form,fruit,height,history,life,na,ovary,plant,position,rachi,reproduction,seed,shape,spacing,staman,sympodial,texture,width
256	wfo-0001027584	success	144	95	68	76	27	0.472	-2,0.5-1.5,0.9-1,0.9-2.5,1.5-2,10-15,2,2-10,3,3-.,4-6,4-7,acuminate,anther,apex,base,branched,cell,cm,conical,corolla,darker,densely,diameter,ellipsoid,elliptic,filament,flattened,flower,four,fruit,glabrous,green,herb,irregular,lobed,minutely,mm,nearly,outer,outline,ovary,ovate,pale,papillate,pedicel,peduncle,per,petiole,reddish,regularly,reniform,sinuate,smooth,sparse,stigma,striate,stripe,style,suffruticose,surface,tan,testal,thickening,time,wall,white,without	-16,..,.5,0.5-1,1-1.2,1.2-1.4,1.5-8,1.6-1.9,100,11.5-45,2.5-3,4.5-20,7-10,8-9,abruptly,absent,anthesi,apical,attenuate,bark,becoming,beginning,beneath,branch,brittle,broadly,brow,c.,calyx,capitat,cucullate,deflexe,deltate,dry,eaf,edicel,eed,erec,fruiting,lamina,lobe,long,lower,margin,markedly,narrowly,nflorescence,open,pair,pericarp,planar,plurifoliat,pointed,present,primary,ruit,scar,scattered,shrub,single,single-stemmed,small,sparsely,stem,thin,tip,triangular,trichome,tube,tuft,ud,uniseriate,unit,vein,x,ympdoial	abaxial,adaxial,arrangement,capitate,color,colour,form,growth,height,history,inflorescence,leaf,length,life,na,number,plant,plurifoliate,position,rachi,reproduction,seed,shape,spacing,staman,texture,width
257	wfo-0001027585	success	217	85	64	153	21	0.295	0,0-1,0.6-0.9,1,1-4,12-23,2-3,2-5,3-4,5-8,7-10,8-14,anther,branch,brown,chartaceous,cm,densely,diameter,dm,elliptic,erect,extra-axillary,flattened,flower,fruit,glabrous,globose,green,inflorescence,juvenile,lanceolate,leaf,length,longer,mm,oblate,ovate,pale,pedicel,peduncle,per,perennial,petiole,plant,prickle,rachi,rhizomatous,ripe,shrub,sparsely,sprawling,stellate-pubescent,stigma,style,surface,time,unbranched,unripe,vine,white,wide,yellow,yellowish	%,.05,0-0.5,0-15,0-2,0-4,0.15-0.25,0.2-0.3,0.2-0.4,0.25-0.35,0.5-1,0.7-4.5,0.9-1.8,1-3,1.9-2.5,10-25,11-15,13-18,15-20,15-30,2-6,2-foliate,2-locular,2.3-2.8,22-25,29-40,3-3.5,3-7,3.8-4.2,4-8,4.5-20,5-17,5-7,5-merou,6-7,6-8,7-14.5,7-9,8-10,abaxially,absen,absent,accrescent,acicular,across,acuminate,acute,adaxiall,adaxially,adult,alyx,andromonoecious,anvil-shape,apart,apex,articulated,axe,ba,base,blade,branche,broad-based,calyx,capitat,confined,connivent,cross-section,cuneate,curved,cylindrical,decimetre,deltate,directed,distall,distributed,eaf,eed,eglandular,entire,exocarp,finger,fruiting,functional,geminat,gland-tipped,hair,half,heterostylous,interpetalar,juicy,lamina,lateral,less,lilac,lobe,lobed,long,loosely,lower,margin,mature,mesocarp,mid-point,midpoint,midrib,midvein,minute,moist,narrowly,nflorescence,oblique,orolla,pair,part,placenta,pore,porrect,present,pubescent,purple,ray,rounded,ruit,scarcely,sessile,shallowly,short,side,simple,spaced,sparse,stalked,stellae,stellate,straight,tal,tamen,tem,thick,throughout,tissue,transparent,triangular,tube,unarme,unarmed,unit,upper,vary,vein,weakly,x,ympodial	5-merous,abaxial,adaxial,capitate,colour,corolla,density,form,growth,height,history,life,ovary,position,reproduction,seed,shape,stem,texture,thicknes,width
258	wfo-0001027594	success	168	103	68	100	35	0.405	0.3-1.2,0.7-1,1,1-2,1.5-2,3-4,4-5,acute,anther,apex,bark,base,becoming,berry,bright,brown,calyx,capitate,closely,cm,corolla,dark,dia,erect,filament,flattened-reniform,fleshy,fruiting,glabrous,globose,green,hard,immature,lavendar,leaf,lobed,margin,maroon,minutely,mm,oblanceolate,often,opposite,orange,ovary,pale,papillose,pedicel,petiole,pitted,ripe,scar,seed,shrub,simple,spaced,stem,stigma,style,surface,tinged,trichome,uniseriate,white,winged,woody,yellow-tan,young	.1,.2,.5,0.6-1.4,0.7-1.2,0.9-2.5,10-15,2-2.2,2-3,2-5,2.5,2.5-4,3/4,4.7-6.8,5-20-flowered,across,age,anthesi,attenuate,ba,bi-lobed,body,branch,constriction,curved,decurrent,deltoid,difoliate,distal,eaf,edicel,eed,elliptic,especially,extending,free,geminat,geminate,glandular,incrassate,interpetalar,junction,lateral,lenticellat,less,lobe,locule,lon,long,lower,main,major,middle,minor,minute,nflorescence,non-reproductive,oblong,obovate,obovoid,occasionally,older,one,ovate,overlappin,pair,paler,papillo,pore,poricidal,portion,prominent,puberulent,raised,reflexed,reproductive,rounded,ruit,shaped,shoot,sinus,slender,slightly,small,straggly,straight,tall,tapering,tear-drop,thin,tip,tube,two,ud,unit,vein,way,widest,x,ympodial	0.1,0.5,1.2,5,abaxial,adaxial,arrangement,bud,color,colour,diameter,flower,form,fruit,growth,height,history,inflorescence,length,lenticellate,life,na,new,peduncle,perennial,plant,position,prickle,rachi,reproduction,shape,spacing,staman,texture,width
259	wfo-0001027600	success	185	112	84	101	28	0.454	-10,1,1-14,1-4,1-5,1.5-2,2-11,2-3,2-3.5,2-4.5,2-5,2.5-6,3-5,3-6,4-6,abruptly,acuminate,acute,adaxial,apex,apical,basal,base,calyx,campanulate,cm,concave,connective,cordate,cuneate,deltate,densely,diameter,distally,ellipsoidal,elliptic,entire,fading,flattened,flower,forked,fruit,glabrescent,glabrous,gland,greenish-white,leaf,lobe,lobed,margin,minutely,mm,moderately,narrowed,obconical,older,orange,ovate,pedicel,peduncle,perfect,petiole,pinnately,puberulent,purple,purplish,rachi,radiu,rounded,simple,sparsely,stigma,style,surface,tree,truncate,tube,two,unbranched,white,x,yellow,yellow-green,young	-3,0.5-1,0.5-1.5,1-2,1.5-2.5,1/2-3/4,10-,10-20,15-25,2-18,2-4,2-6,2.5-21,20-30,3-15,3-5-lobed,4-foliat,5-13,8-17,abaxially,absen,absent,adaxially,adpressed,aggregate,along,apart,ape,apiculate,articulated,axe,beyond,blade,brow,cell,channe,collection,coriaceous,cream,dilated,directed,divided,eaf,eed,especially,exceeding,except,exserted,fleshy,glandular-puberulent,laterally,leaving,lon,long,lower,main,mature,midrib,nflorescence,nther,oblong,obtuse,occasionally,orolla,ovoid,papillose,pedicellar,pilo,pilose,pore,puberulen,puberulence,pubescent,rarely,remnant,ruit,shorter,sinus,slightly,small,somewhat,spaced,stamen,stone,strongly,subcoriaceous,tal,tem,thecae,time,tip,tomento,triangular,ud,unit,unlobed,vary,vein,wide,yellowish,ympodial	10-25,abaxial,anther,arrangement,color,colour,corolla,filament,form,growth,height,history,inflorescence,length,life,na,ovary,perennial,plant,position,reproduction,seed,shape,size,spacing,staman,texture,width
260	wfo-0001027601	success	204	124	98	106	26	0.48	0-3,0.2-0.4,0.25-0.4,0.4-2,0.5-0.8,0.5-1,0.5-2,1-1.3,1.5-2,10-16,13-25,2-15,2-6,2.5-6,acicular,acuminate,acute,adaxially,andromonoecious,angularly,anther,apex,articulated,base,brown,buff,calyx,chartaceous,cm,congested,contiguous,cuneate,deltate,densely,diameter,ellipsoidal,elliptical,entire,erect,extra-axillary,filament,flattened,flower,fruit,glabrous,globose,green,hair,index,inflorescence,lanceolate,lateral,leaf-opposed,length,lilac,lobe,lobed,lobing,long,longer,margin,midpoint,mm,nearly,oblique,ovate,pale,part,pedicel,peduncle,perennial,petiole,plant,prickle,pseudo-racemose,rachi,ray,red,reniform,reticulate,rhizomatous,shallowly,short,shrub,simple,sparsely,stellate,stellate-pubescent,stigma,straight,style,surface,time,toward,white,wide,yellow,yellowish	%,.05,0-0.1,0-10,0-7,0.1-0.5,0.2-0.8,0.3-0.5,0.4-0.5,0.5-1.5,1-1.4,1-2,1-locular,1.6-5,2.3-4.3,2.5-3,2.6-4,3-5,3-6,3-7,3-foliate,4-10,5-merou,6-8,7-18,7-20,7-8,8-9,abaxially,absen,absent,accrescent,across,adaxiall,adult,alyx,apart,apparen,around,axe,ba,blade,branche,capitat,confined,connivent,cylindrical,decimetre,directed,distall,eaf,eed,eglandular,exocarp,finger,fruiting,functional,geminate,gland-tipped,half,heterostylous,incomplete,juicy,lamina,less,lower,mature,mesocarp,midrib,midvein,minute,narrow,nflorescence,obtuse,orolla,outer,per,placenta,pore,porrect,present,ruit,septum,sessile,side,spaced,stalk,stellae,strongly,succulent,tal,tamen,tem,thick,throughout,tube,unarme,unarmed,unbranched,unit,vary,vein,weakly,wing,x,ympodial	5-merous,abaxial,arrangement,capitate,color,corolla,direction,distally,form,growth,height,history,leaf,life,na,ovary,position,reproduction,seed,shape,spacing,staman,stem,texture,thicknes,width
261	wfo-0001027606	success	192	100	74	118	26	0.385	0-0.2,0-1.5,0.3-0.8,0.3-1.2,0.5-0.75,0.5-1,1-1.5,1-5,10-19,2-4,2.5-4,3-10,4-6.5,6-8,7-10,absent,acicular,acute,anther,apart,apex,base,broadly,chartaceous,cm,cuneate,deeply,diameter,dm,entire,erect,extra-axillary,filament,flattened,flower,fruit,glabrous,globose,green,inflorescence,leaf,length,lilac,lobe,lobed,long,margin,mm,obtuse,ovate,pale,pedicel,peduncle,per,perennial,petiole,pinkish,present,prickle,pseudo-racemose,rachi,red,reniform,rhizomatous,shrub,side,simple,stellate,stigma,straight,style,surface,x,yellow	%,-10,0-4,0.2-0.3,0.2-2.5,0.2-4,0.4-0.5,0.7-0.9,1,1-2,1-2.5,1-7,1-locular,1.5-2.9,12-25,2,2-,2-3,2-5,2-5.5,2-7,3-4,3-4.1,3-foliate,4-11,5-merou,5.5-7,6-9,7-22,9-13,abaxially,absen,accrescent,adaxiall,adaxially,adult,alyx,apparen,apparently,articulated,axe,ba,blade,branch,branche,branched,brown,calyx,cylindrical,depression,directed,distall,distally,eaf,eed,exocarp,finger,fruiting,geminat,gland-tipped,grey,hair,half,incomplete,index,juicy,juvenile,lamina,lanceolate,less,lobing,longer,lower,markedly,mature,mesocarp,mid-point,midpoint,midvein,minute,narrowly,nflorescence,oblique,occasionally,orolla,pair,part,perfect,placenta,pore,pubescence,rostrate,ruit,scarcely,septum,short,spaced,succulent,tal,tamen,tem,thick,thicker,throughout,time,triangular,truncat,tube,unarme,unarmed,unbranched,unit,upper,usually,vary,vein,wide,ympodial	5-merous,abaxial,adaxial,arrangement,color,colour,corolla,form,growth,height,history,life,na,number,ovary,plant,position,presence,reproduction,seed,shape,spacing,staman,texture,truncate,width
262	wfo-0001027607	success	167	105	76	91	29	0.455	.25,.5,0.5,0.5-1,0.8-1,1-4,1.2-1.5,2-3,2-4,3-3.5,8-9,acuminate,age,anther,anthesi,apex,arching,bark,base,branch,brown,calyx,cm,corolla,dark,deflexed,dia,ellipsoid,elliptic,filament,filiform,flattened,fruiting,gently,glabrate,glabrous,globose,green,leaf,less,lobed,minute,minutely,mm,narrow,narrowly,obovoid,opposite,ovary,ovoid-reniform,papillose,pedicel,petiole,pitted,plant,pore,reddish-brown,shaped,shrub,simple,slender,stem,stigma,straight,style,surface,tan,tapering,tear-drop,tip,treelet,tube,unifoliate,white,winged,zig-zag	.1,0.25-0.5,1,1.5-3,2-2.5,2.5-3,3/4,4-10-flowered,5-10,5-7,acute,apar,area,aspect,ba,basal,becoming,berry,branche,corky,curling,decurrent,deltoid,densely,dry,eaf,edicel,eed,elongate,erect,evenly,except,exserted,f,free,geminate,giving,golden,lamina,lateral,lenticellat,like,lobe,lon,long,lower,m.,main,material,middle,midrib,nflorescence,non-reproductive,occasionally,older,pagoda-like,pair,poricidal,portion,present,prominent,pubescent,raised,rarely,reflexed,ruit,scar,short,slight,slightly,small,soon,spaced,strongly,styl,tall,trichome,tub,ud,uniseriate,unit,vein,way,widened,widening,widest,woody,x,yellowish,ympodial,young	abaxial,adaxial,apart,arrangement,bud,color,colour,diameter,flower,form,fruit,growth,height,history,inflorescence,length,life,na,peduncle,perennial,position,rachi,reproduction,seed,shape,spacing,staman,texture,width
263	wfo-0001027613	success	238	101	83	155	18	0.349	.5,0-0.1,0.1-0.6,0.1-0.7,0.2-1.6,0.3-0.4,0.4-1,0.5-0.6,0.7-1.5,0.8-1.7,1-7,1.5-2,10-17,2-2.5,2-5.6,3-4,4-5,5-18,5-8,80-180,9-10.5,absent,across,anther,apart,broadly,brown,campanulate,chartaceous,circular,cm,corolla,dark,decimetre,densely,diameter,extra-axillary,filament,finger,fruit,glabrous,gland-tipped,globose,green,hair,inflorescence,lateral,length,lilac,long,longer,midpoint,mm,nearly,ovate,pale,pedicel,peduncle,per,petiole,prickle,pubescent,purple,rachi,ray,reniform,rotate,short,simple,sparsely,stalk,stellae,stellate-pubescent,stigma,streak,style,surface,tan,time,wide,x,yellow,yellowish-green	%,0.3-1,0.4-0.5,0.4-1.2,0.4-1.5,0.5-0.7,1-1.5,1-1.7,1-10,1-2,1.2-1.4,1.2-2,1.3-1.8,1.5-3,12-15,15-100,15-28,2-2.2,2-3,2-5,2-7,2-8,2-foliate,2-locular,2.3-2.6,20-50,3-5,3-6,30-100,36-70,4-7,4-8,4.5-9.5,5,5-6,5-merou,6-12.5,7-12,7-8,9-17,abaxially,absen,abundant,accrescent,acicular,acute,adaxially,adult,alyx,and/or,andromonoecious,anvil-shape,apex,armed,articulated,attenuate,axe,ba,base,bitter,blade,branche,calyx,capitat,clear,connivent,contiguous,cordate,cross-section,curved,cylindrical,deltate,directed,distall,distally,distributed,eaf,eed,eglandular,exocarp,flattened,flower,fruiting,functional,geminat,glandular,half,herbaceous,heterostylous,index,inserted,interpetalar,juicy,lamina,less,lobe,lobed,lobing,lon,lonf,lower,margin,markedly,mature,mesocarp,mid-point,midvein,minute,minutely,moderately,moist,nflorescence,oblique,obtuse,orolla,part,placenta,plant,pore,porrect,presen,present,prostrate,resprouter,reticulate,ruit,sessile,shallowly,side,somewhat,spaced,sprawling,stage,stalked,stellate,straight,tal,tamen,tem,thick,thicker,throughout,tissu,tissue,transparent,triangular,tube,unbranched,unit,uvenile,vary,vein,watery,weakly,ympodial	abaxial,adaxial,arrangement,capitate,colour,density,leaf,ovary,position,pubescence,seed,shape,spacing,staman,stem,texture,thicknes,width
264	wfo-0001027618	success	202	101	73	129	28	0.361	1,1-13,1-14,1-23,1-5,2-11.5,3-5,4,5-7.5,5-merous,8-16,8-35,abaxially,adaxially,aggregate,apart,apex,articulated,base,branched,campanulate,capitate,cell,cm,compound,densely,diameter,ellipsoidal,flower,fruit,fusiform,glabrous,globose,greenish,leaf,length,less,long,mesocarp,minutely,mm,near,orange,papillose,pedicel,pedicellar,peduncle,per,petiole,pinnately,puberulent,puberulent-pubescent,pubescent-pilose,purple,rachi,remnant,reticulate,shrub,simple,stigma,stone,style,sympodial,tomentose,tree,truncate,unbranched,unit,urceolate,white,width,without,yellow	-10,-pubescent,0-10,0.5,0.5-1,0.5-6,1-,1-1.5,1-3,1-9,1.4-4,1.5-13,1.5-3,1.5-7,1.5-8.5,11-16,11-22,11-pinnate,12-27,15-30,15-35,2-11,2-12,2-27,2-5,2-8.5,2-9,2.5-6,3-18,3-30,3-7,3-7-pinnate,3.5-6,4-8,5-18,5-20,5-30,5.5-12,6-25,6-40,7-25,acuminat,acut,acute,also,alyx,ape,ascending,axe,basal,beyond,blade,bud,chartaceous,connective,cordate,cuneate,cylindrical,darker,deltate,dia,diamete,dilated,directed,distally,eaf,eed,elliptic,elliptic-ovate,entire,exceeding,exserted,fleshy,lateral,laterally,leaflet,leaving,lobe,lon,longitudinal,lower,margin,membranaceous,moderately,nflorescence,nther,oblong,obovate,obtu,obtuse,often,orolla,ovate,perfec,perfect,petiolule,pilo,pilose,pore,presen,puberulent-pilo,pubescent,radiu,ranch,ratio,ripe,rown,ruit,runk,shallowly,shorter,slightly,small,sometimes,somewhat,spaced,sparsely,spreading,stamen,stripe,tal,terminal,thecae,triangular,tube,uni,vary,wide,x	abaxial,acuminate,adaxial,anther,arrangement,color,colour,corolla,filament,form,growth,height,history,inflorescence,life,na,ovary,perennial,plant,position,puberulent-pilose,reproduction,seed,shape,spacing,staman,surface,texture
265	wfo-0001027622	invalid_json	203	113	77	126	36	0.379	0-14,0.3-10,1-10,1.5-3.5,2.5-3.5,3-4.5,3.5-11,6-7,abaxially,adaxially,along,anther,apex,blue,blue-purple,broadly,brownish,cell,ciliate,clavate,cm,condition,corolla,covering,diameter,drying,elliptical,especially,filament,flower,forked,fresh,fruit,glabrescent,glabrous,globose,green,green-white,greenish,herb,lateral,light,make,margin,middle,midrib,minutely,mm,mucilaginous,narrowly,odd-pinnate,ovate,ovoid,pale,pedicel,peduncle,pentagonal,petal,petiole,plant,puberulent,pubescent,seed,stellate,stigma,striped,style,subglabrous,terminal,testal,thick,throughout,tip,wall,wet,whitish,yellow	.5,0-16,1,1-2,1.5-4.2,1.6-4.5,1/,12-23,2-25,2-3,2-6,3-16,3-4,4-5,4-9.5,5-11,5-merou,6-17,8-16,8-20,acumen,acuminate,acute,ag,alyx,apart,apparently,articulated,axe,axillary,base,berry,blade,borne,bud,capitat,chartaceous,connivent,decumben,different,digestion,distal,dorsally,eaf,edge,eed,elliptic,end,enzyme,erect,exceeding,except,flat,folded,geminat,generally,glabrou,greatly,hair,hair-like,half,homostylous,honeycomb-shaped,interjected,lanceolate,leaflet,lengthening,like,living,lobe,long,lower,membranous,mottled,nflorescence,oblique,often,orolla,ovate-lanceolate,pair,perfect,petiolule,plurifoliate,population,pore,poricidal,proximal,purple,reduced,removed,rounded,ruit,seudostipule,shortly,singly,size,slightly,slit,sometimes,spaced,specimen,stamen,star,ste,stem,stolo,straight,subequal,subtending,tall,tamen,tem,tri-,truncate,tube,tuber,typically,unit,unwinged,usually,vary,varying,wide,wing,x,ympodial	'','hair-like,'star,[,],``,abaxial,adaxial,arrangement,capitate,characteristic,color,colour,form,growth,height,history,inflorescence,leaf,length,life,na,ovary,perennial,position,rachi,reproduction,shape,spacing,staman,surface,texture,value,width,{,}
266	wfo-0001027624	success	189	94	70	119	24	0.37	0.3-1,0.5-1.5,1-2,1.1-8.4,2.4-4.8,3-10,3-5,4-8,5-9,9-41,acumen,anther,apart,axillary,brownish,bud,cell,clavate,cm,condition,corolla,covering,deep,densely,diameter,drying,elliptic,filament,flower,forked,fresh,fruit,glabrous,globose,green,greenish,hair,hair-like,herb,homostylous,lanceolate,lateral,leaf,light,like,mm,odd-pinnate,ovoid,pedicel,peduncle,pentagonal,petiole,plant,pubescent,purple,rotate,seed,short,sometimes,stigma,style,subtending,terminal,testal,thick,usually,wall,white,whitish,yellow	0-3,0-7,0.1-0.9,0.4-3,0.8-5.6,1-3,1-5,1.2-2.6,1.3-2.9,1.5-6.6,2-20,2-5,2-7,2.9-12,3-11,3-4,4-15.2,4-7,5-merou,6-18.5,abaxially,acuman,acuminate,acute,adaxially,ag,along,alyx,apex,apparently,arranged,articulated,axe,base,bead,berry,blade,capitat,connivent,considerably,cuneate,decreasing,decumben,decurrent,digestion,distal,dorsally,eaf,edge,eed,entirely,enzyme,erect,exceeding,flat,folded,geminat,glabrou,green-white,half,honeycomb-shaped,interjected,larger,leaflet,leave,lengthening,living,lobe,long,lower,make,middl,moniliform,mottled,mucilaginous,multiple,necklace,nflorescence,onto,orbicular,orolla,ovate,pair,perfect,plurifoliate,pore,poricidal,present,rachi,removed,ruit,sessile,seudostipule,size,slightly,slit,spaced,specimen,stamen,stolon,straight,tall,tamen,tem,throughout,tip,toward,tri-,tube,tuber,typically,unit,unwinged,vary,wet,wide,widely,x,ympodial	abaxial,adaxial,arrangement,capitate,color,colour,form,growth,height,history,inflorescence,length,life,na,ovary,perennial,position,pseudostipule,reproduction,shape,spacing,staman,surface,texture
267	wfo-0001027626	success	152	109	85	67	24	0.559	.3,.5,0.1–0.2,0.2–0.6,0.5-1,0.7–1,0.7–2.8,1,1.5–8,13–14,2–49,2–5,3–4,3–55,5-merous,5–6,8,abaxially,acuminate,adaxially,along,anther,apex,arrangement,base,center,chartaceous,cm,color,cordate,coriaceous,diameter,distichous,distinct,elliptical,entire,extra-axillary,filament,fleshy,flower,frequently,fruit,glabrous,greenish-white,lamina,leaf-opposed,liana,line,margin,membranous,midvein,mm,moderately,nearly,oblique,ovate,pair,pedicel,peduncle,petal,petiole,pinnate,possibly,pubescent,rachi,rounded,sand-punctate,scandent,secondary,shrub,side,somewhat,spindle-shaped,stellate,stigma,style,terminal,trichome,truncate,unbranched,unknown,vein,venation,white,x	0.5–1,1.3–4.5,1.5–2,14–116,2–3,3–4.5,3–5,4.4–11,4–6,9–18,accrescen,acute,alyx,apar,axe,berry,blade,broadly,c.,calyx,capitat,ciliat,clavate,climbing,densely,distant,eaf,eed,fruiting,glabrou,immature,lanceolate,lobe,long,lower,m.,maturity,minutely,mor,nflorescence,nternode,orolla,perfec,plurifoliat,pointed,reflexed,ruit,sand-punctat,scar,seen,shortly,simple,slender,spaced,sparsely,ste,tamen,tem,time,tip,tube,two,unit,vary,wide,wiry-woody,ympodial	abaxial,apart,capitate,corolla,distance,form,frequency,growth,height,inflorescence,internode,leaf,length,number,ovary,plant,position,seed,shape,spacing,staman,stem,surface,texture
268	wfo-0001027627	success	245	145	102	143	43	0.416	.1,.5,2,3.5,abaxially,abundant,across,acuminate,adaxially,anther,apart,apex,ascending,band,base,based,bifurcate,branch,branched,briefly,broad,broadly,brown,bud,calyx,caudate,cm,corolla,densely,diameter,exposed,extensively,extra-axillary,filament,flattened-reniform,flower,fruit,glabrescent,glabrous,globose,green,interpetalar,juvenile,larger,lateral,lavender,leaf,lighter,linear-lanceolate,lobe,long,loosely,midpoint,minutely,mm,narrow,narrowly,near,occasionally,ovary,ovate,ovoid,pedicel,peduncle,petiole,pitted,portion,prickle,prominently,pubescent,purple,ray,recurved,reduced,short,shrub,simple,small,somewhat,sparsely,spreading,stalked,stellate,stellate-tomentose,stellate-velvety,stigma,stipe,style,subeaqually,surface,tardily,tip,tissue,tomentose,tree,triangular,tube,unequally,velvety,violet,yellow,×	0.05–0.25,0.1–1,0.3,0.4,0.6–1,0–,1.5,1.5–2,1.5–2.5,1.8–2.5,11–14,12–25,13–17,1–1.5,1–5,2.5–4,2–15,2–4,2–5,2–6,3–3.5,3–6,4–,4–12,5-angled,5-merou,5–7,6–,6–15,7–10,7–15,9,9–13,9–15,accrescent,along,alyx,ampliate,apparently,articulated,axe,ba,becoming,berry,blade,borne,c.,capitat,central,chartaceous,contiguous,cordate,dense,difoliate,distal,distally,eaf,eed,entire,erect,evident,except,fertile,filiform,flowering,free,geminat,grayish,growt,hair,half,high,homostylous,internode,interwoven,like,line,linear,longer,lower,major,margin,middle,midvein,minor,minute,mostly,much,nearly,nflorescence,numerous,oblong,obtuse,often,paired,par,present,principal,pubescence,rounded,ruit,scattered,shallowly,shorter,side,single,sinuate,sinus,slender,smaller,sometimes,spaced,sparse,splitting,stalk,stellae,stellate-pubescent,stellate-tomento,stem,stemmed,stout,tamen,tapering,tawny,thick,thickened,time,trunk,ud,unarmed,usually,vein,visible,weakly,wide,yello,ympodia,young,zone,×1.5–1.7,–2.5,–30,–5	0-2-15,0.05-0.25,0.1-1,0.6-1,1.5-2,13-17,2-4,2-5,2-6,2.5-4,3-6,4-12,5,7,7-10,7-15,9-13,abaxial,abundance,adaxial,arrangement,capitate,color,colour,form,growth,height,history,inflorescence,length,life,na,perennial,plant,position,rachi,reproduction,seed,shape,spacing,staman,texture,width
269	wfo-0001027630	success	149	89	69	80	20	0.463	0.5-1,0.5-1.2,0.5-2,1-1.5,1-5,1.4-1.7,1.5-2,2-6-flowered,3/4,4-6,5.5-11.2,8-9,anther,anthesi,apart,apex,base,branchlet,calyx,climbing,cm,corolla,deflexed,erose,extreme,filament,fruit,fruiting,glabrous,globose,golden,hirsute,internodal,irregularly,known,lanceolate,leaf,linear,lobed,long-acuminate,margin,minutely,mm,occasionally,opposite,ovary,papillose,pedicel,petiole,pore,poricidal,pubescent,scar,shaped,shrub,simple,slender,spaced,sparsely,stigma,style,tear-drop,tip,trichome,tube,uniseriate,way,white,winged	.1,.2,.5,0.05-0.1,2-3,6-10,acute,also,arising,bark,beginning,berry,blunt,broadly,ciliate,de,decurrent,deltoid,densely,dia,distinguishable,eaf,edicel,eed,elongat,except,free,glabrate,globo,green,immature,indistinct,inflorescenc,knob-like,lateral,lobe,lon,long,lower,main,middle,midrib,near,nflorescence,novo,older,pair,paler,partially,portion,prominent,proximal,puberulent,raised,reflexed,rest,rounded,ruit,seen,stem,straight,strongly,swollen,tall,tapering,terminal,thickened,ti,ud,ultimate,unifoliat,unit,vein,wide,widest,wing,x,yellowish,ympodial,young	bud,color,diameter,elongate,flower,form,growth,height,inflorescence,length,na,number,plant,position,seed,shape,spacing,surface,texture,width
270	wfo-0001027646	success	166	66	40	126	26	0.241	0-0.1,0.2-1.1,0.4-0.5,0.5-0.6,1-3,6-7,acuminate,acute,anther,apex,chartaceous,cm,densely,diameter,extra-axillary,flattened,flower,fruit,globose,green,inflorescence,length,midpoint,mm,ovate,pale,pedicel,peduncle,perennial,petiole,red,reniform,shrub,simple,stellate,stellate-pubescent,style,unbranched,yellow,yellowish	%,.4,0-0.2,0-1,0-10,0-2,0.1-0.25,0.15-0.25,0.4-0.6,0.6-0.7,0.7-1.2,0.7-1.5,0.7-2,1,1-2,1-6,1-locular,10-18,15-20,2-4,2-6,2-foliate,2.1-3.2,3.5-4,4-11,5-10,5-merou,6-13,6-8,abaxially,absen,absent,acicular,across,adaxiall,adaxially,adult,alyx,apart,articulated,axe,ba,base,blade,branche,brown,calyx,confined,cuneate,cylindrical,directed,distall,dm,eaf,eed,eglandular,entire,erect,finger,fruiting,functional,geminat,glabrous,gland-tipped,grey,hair,half,incomplete,juicy,lamina,lateral,less,lobe,long,longer,lower,margin,mature,mesocarp,midrib,midvein,minute,moderately,multiradiate,nflorescence,oblique,obtuse,onl,orolla,part,per,pore,porrect,present,prickle,probably,pseudo-umbellate,ray,rhizomatous,ruit,septum,short,solitary,spaced,sparsely,stage,stalk,stellae,straight,succulen,tal,tamen,tem,thick,throughout,time,transparent,unarme,unarmed,unit,unknow,uvenile,vary,wide,x,ympodial	5-merous,abaxial,adaxial,arrangement,color,colour,corolla,filament,form,growth,height,history,leaf,life,na,ovary,plant,position,reproduction,seed,shape,staman,surface,texture,thicknes,width
271	wfo-0001027661	success	222	107	86	136	21	0.387	+,-10,0.5-,0.5-2,1-,1-5,1-7,1.2-6,1.5-2,2.5-7,4-15,4.5-6,5-9,6-12,8-10,anther,apart,axi,base,branched,bright,capitate,cm,corolla,deeply,densely,diameter,ellipsoid,extremely,filament,flattened,glabrous,globose,growth,herbaceous,lateral,leaf,leaf-opposed,like,lobed,long,many,minute,minutely,mm,moderately,pale,papillate,pedicel,peduncle,perfect,petiole,pinnatifid,pitted,pubescent,purple,red,reniform,ripe,scar,shape,shiny,simple,size,sparsely,stellate,stem,stigma,style,surface,tan,terminal,ternately,thin,time,tube,turbinate,variable,vine,violet,way,white,wide,woody,yellow,¾	0.5,0.6-1.1,0.6-1.5,1-1.5,1.3,1.5,2,2.5-3,30,4-8-celled,40,5-merou,6-8,6-9,<,>,abaxially,acuminate,acute,adaxiall,ag,along,alyx,anthesi,apex,ark,articulate,basal,berry,branch,broadly,calyx,cell,column,commonly,conical,connivent,cordate,creeping,dendritic,denser,density,eaf,eed,elliptic,entire,even,flower,free,fruiting,fused,gre,green,grey,ground,hue,ilament,irregularly,lamina,leaving,lengthening,lobe,long-exserted,lower,margin,markedly,membraneous,mixture,narrowing,near,new,nflorescence,occasionally,often,older,open,orolla,outline,ovate,pair,papillat,papillo,peg,pentagonal,per,pericarp,plurifoliat,pointed,pore,poricidal,portion,primary,prominent,pubescen,pubescence,purplish,rachi,rarely,reflexed,ruit,short,single,sinus,sleeve,slender,slit,small,spaced,spot,spreadin,spreading,strongly,swollen,tangled,tem,testa,tightly,tip,trailing,triangular,trichome,truncate,two,type,ud,underground,unieriate,uniseriate,unit,upper,usually,vary,vein,yellowish,ympodial,zig-za	abaxial,adaxial,arrangement,branching,bud,color,form,fruit,height,history,inflorescence,length,life,ovary,plant,reproduction,seed,spacing,texture,width,zig-zag
272	wfo-0001027714	success	251	105	87	164	18	0.347	/3,0.5-0.7,1,1-1.6,1.5-3,1.5-5,14-16,3-3.5,4.5-5,5,5-10,abaxial,acuminate,adaxial,anther,apex,around,base,berry,branched,bright,brown,capitate,cell,cm,corolla,creating,deep,densely,diameter,elliptic,filament,flattened,flower,fruit,glabrous,globose,growth,hairy,immature,inflorescence,irregularly,juicy,lateral,leaf,lobed,many,mature,minutely,mm,obovate,ovary,pale,papillate,pedicel,peduncle,petiole,pitted,prominent,pubescent,purple,red,reddish,reniform,ripe,seed,shiny,simple,small,spaced,stellate-rotate,stigma,style,surface,terminal,testal,thin,time,uniformly,vine,violet,wall,way,wing,woody,x,yellow	+,.5,0,0.4,0.5,0.6-0.7,0.9-1.5,1-,1-1.5,1-2,1.5-2,1.5-2.5,2-,2-2.5,2-8,2.5-,2.5-4,2373.,4-10,4-5,5-6,5-merou,6-7,7-20,80,<,abaxially,acute,adaxially,age,aid,almost,along,alyx,angle,anthesi,apar,apice,appearance,ark,articulated,axi,basal,calyx,canop,channelled,climbin,confined,conical,connected,connivent,cordate,corky,cucullate,cupped,deflexed,dendritic,denser,drying,eaf,eed,ellipsoid,elongate,enlarged,entire,especially,exserted,fide,fleshy,free,fruiting,furcate,giving,glabrate,glabrou,groove,hanging,ilament,individual,inflated,lamina,large,leaving,lengthening,like,lobe,lon,long,longer,loosely,lower,margin,marginal,mere,minute,mpodial,nee,new,nflorescence,nodding,occasionally,often,older,orolla,otherwise,outline,pair,papillo,peg,per,perfect,pericarp,petal,petiolule,pinnatifid,plat,plurifoliat,pore,poricidal,portion,primary,pubescence,reaching,rectangular,rim,ruit,scar,showy,similar,sleeve,slender,slightly,slit,somewhat,sparsely,spreading,stem,strongly,tangled,tem,testa,thecae,thick,thickened,third,tiny,tip,tooth,trichome,truncate,tube,twining,ud,uniseriate,unit,upper,usually,vein,visible,weak,weight,widest,yellowish,younger	2-4,apart,arrangement,color,colour,form,greyish,hair,length,na,papillose,position,shape,spacing,staman,texture,white,width
273	wfo-0001027719	success	172	108	77	95	31	0.448	0-0.2,0-7,0.15-0.4,0.25-0.6,0.3-0.5,0.6-2.8,0.8-1,1-1.5,10-24,13-20,2-2.3,30-70,4-5,4-7,5-6,6-10,7-11,8-13,acute,andromonoecious,anther,apex,base,broadly,chartaceous,cm,cuneate,densely,diameter,entire,exocarp,extra-axillary,flower,fruit,globose,green,greenish-white,herbaceous,inflorescence,lateral,length,lilac,lobed,long,longer,margin,mesocarp,midpoint,mm,moist,oblique,obtuse,ovate,pale,part,pedicel,peduncle,per,petiole,plant,prickle,pseudo-racemose,ray,resprouter,shallowly,solitary,sparsely,stalk,stellate-pubescent,stem,strongly,style,thick,time,unbranched,wide,yellow	%,.25,0-0.15,0-1,0-20,0.25-0.4,0.3-0.7,0.4-1.7,0.6-0.8,0.9-1.1,1-2,1-3,1.1-2,1.6-1.9,13-25,3-5,3-7,3-7.5,4-6,4.5-12.5,5-8,5-merou,6-8,abaxially,absent,acicular,across,adaxiall,adaxially,alyx,apart,armed,articulated,attenuate,axe,ba,blade,brown,calyx,d.,difoliate,directed,distall,distributed,dult,eaf,eed,eglandular,erect,finger,fruiting,functional,geminat,gland-tipped,hair,half,heterostylous,hig,juic,lamina,less,lobe,lower,mature,mid-point,midvein,minute,nflorescence,orolla,pore,porrect,presen,present,ruit,sessile,short,simple,spaced,sprawling,stage,stellae,stellate,straight,tamen,throughout,tube,unarme,unit,unknow,uvenile,vary,vein,white,x,ympodial	5-merous,abaxial,adaxial,color,colour,corolla,density,dm,filament,form,growth,height,history,juicy,leaf,life,moisture,na,ovary,perennial,position,reproduction,seed,shape,spacing,staman,stigma,surface,texture,thicknes,width
274	wfo-0001027720	success	184	104	80	104	24	0.435	0.15-0.25,0.25-0.35,0.4-0.8,0.5-0.8,0.5-1,0.6-1.2,1-1.5,1-3.5,2-3,2-4,2-branched,4-,4-5.5,4-7,5-merous,6,7-8,7-9,absent,anther,apex,base,brown,calyx,chartaceous,cm,deltate,densely,diameter,elliptic,entire,erect,extra-axillary,filament,flower,fruit,fruiting,glabrous,globose,green,hair,inflorescence,intepetalar,lateral,leaf,length,lilac,lobe,long,margin,midpoint,mm,narrowly,ovate,pale,pedicel,peduncle,perennial,petiole,pubescent,rachi,ray,red,rhizomatous,scarce,shrub,sparsely,stellae,stellate,stellate-pubescent,stigma,style,subreniform,surface,time,tissue,toward,triangular,x,yellow	%,.25-0.3,0,0-15,0.3-5,0.4-0.7,0.8-1,1-2,1-locular,1.5-2,13-23,13-35,15-25,2-7,2-foliate,2.8-3.1,23-35,3-13,4.3-15,4.3-7.5,7-10,8-11,8-16,9-15,abaxially,absen,acute,adaxiall,adaxially,adult,alyx,apparently,articulated,axe,ba,berry,blade,capitat,confined,connivent,cuneate,cylindrical,directed,distall,distally,eaf,eed,eglandular,finger,flattened,geminat,gland-tipped,half,hig,homostylous,incomplete,juicy,juvenile,lamina,lanceolate,less,loosely,lower,markedly,mature,mesocarp,mid-point,midrib,minute,nflorescence,notched,oblique,orolla,part,per,perfec,perfect,pore,porrect,present,prickle,ruit,septum,sessile,short,simple,slightly,straight,succulen,tamen,tem,thick,thicker,tube,unarme,unarmed,unit,upper,vary,white,wide,without,yellowi,ympodial	abaxial,adaxial,capitate,color,corolla,form,growth,height,history,life,na,ovary,plant,position,presence,reproduction,scarcity,seed,shape,spacing,staman,stem,texture,width
275	wfo-0001027720	success	272	101	66	206	35	0.243	3.2,3.6,acuminate,acute,anther,apex,attachment,bilobed,broad-based,bud,cancellate,capitate,cm,conical,corolla,cream,densely,diameter,elliptic,extra-axillary,filament,flattened-irregular,flattened-orbicular,flattened-reniform,flower,fruit,glabrous,globose,growth,homostylous,lateral,lavender,leaf,mm,narrowly,notched,orange,ovate,pedicel,peduncle,petiole,point,porrect,prickle,pubescent,red,sessile,short,shrub,simple,slightly,small,sparsely,stellae,stellate,stellate-pubescent,stigma,style,subacute,surface,tree,triangular,violet,yellow,yellow-ferruginous,yellow-tan	.0,.04,.2,.3,.5,.9,0,0.1–0.6,0.2–0.4,0.3–0.4,0.7–0.9,0.7–1.1,0.7–1.2,0.8–1.3,0.8–1.9,0.8–2.0,0.9,1.4–1.9,1.5–1.7,1.5–2.0,1.5–2.5,1.5–3.3,1.5–9.0,1.7–1.8,1.7–2.0,1.7–2.5,1.8–2.0,1.9–2.2,1/2,1/3,1/3–1/2,10.0,10.8–18.2,12–16,13.0,19.7–30.0,2.0,2.5,2.5–2.8,2.5–2.9,2–3,3.7–5.7,3.9,4.0–12.6,4.0–18.0,4–5-merou,5.1–18.6,6.5–9.5,6–8,8.0,8.0–11.9,8.2–10.5,8.5–9.4,9.5–16.0,abaxially,adaxially,adnate,aequilateral,alyx,anthesi,apical,apiculate,apparently,appearing,armed,articulated,attenuate,axe,ba,base,becoming,berry,blade,branch,broad,brochidodromous,calyx,channel,channeled,colore,concave,congested,connivent,crisped,curved,deciduous,dehiscence,dentate,developed,difoliate,distally,dorsally,dry,eaf,eed,either,emerging,endocarp,entire,erect,especially,exocarp,fertile,filiform,free,geminat,glandular,glossy,gradually,hair,heavily,hooked,inclined,increasing,internode,interpetalar,intersepalar,juic,juvenile,lamina,large,least,like,line,lobe,lon,long,longer,lower,m.,major,margin,mature,midpoint,midrib,midvein,minor,minute,moderately,nearly,nflorescence,oblique,oblong,occasionally,often,orolla,part,per,perforate,poorly,pore,porrect-stellate,portion,potentially,presumably,proximal,raised,ray,reflexed,rigid,rip,row,ruit,scattered,shorter,side,sinus,soon,splitting,spread,stamen,stellate-pubescen,stem,straight,subcoriaceous,suture,tall,tamen,tem,thin,time,tip,tissue,toward,translucent,truncate,tube,twice-branched,two,ud,unarmed,upper,vary,vein,wavy,way,weakly,white,wide,yellow-ferruginou,ympodia,young,youngest,±equal,×,–4	0.04,0.8-1.9,1.5-9.0,1.8-2.0,2-4,3.7-5.7,4.0-12.6,5.1-18.6,6.5-9.5,abaxial,adaxial,arrangement,color,colored,colour,form,height,history,inflorescence,length,life,na,ovary,perennial,plant,position,rachi,reproduction,seed,shape,spacing,staman,texture,trichome,width
276	wfo-0001027735	success	166	101	69	97	32	0.416	.75,0-4,0-5,0.3-0.6,1.3-1.6,1.3-3.5,1.7-3.5,10-14,25-50,3-8,5,5-5.8,8-11,9-12,absent,acicular,acuminate,acute,anther,apex,base,brown,chartaceous,cm,diameter,dm,erect,extra-axillary,flower,fruit,green,index,inflorescence,lateral,length,lobe,lobing,long,longer,midpoint,mm,moderately,oblique,obtuse,ovate,pale,part,pedicel,peduncle,per,perennial,petiole,pinkish,present,prickle,pseudo-racemose,ray,rotate-stellate,shrub,sparsely,stellate,stellate-pubescent,straight,style,time,unbranched,white,wide,yellow	%,.7,0-0.1,0-1,0.15-0.2,0.25-0.5,0.4-0.8,0.5-0.8,0.5-3,1,1-2,1.9-2.2,11-17,12-15,2-2.5,2-3.5,2-8,2.5-3,20-35,3.5-5,30-50,4-5,4-6,4-8,5-merou,7-10.5,abaxially,abundant,across,adaxially,adult,alyx,apart,armed,articulated,attenuate,axe,ba,blade,branche,calyx,directed,distall,distributed,eaf,eed,eglandular,finger,fruiting,geminat,glabrou,gland-tipped,globo,hair,half,lamina,less,lobed,lower,margin,mature,mid-point,midvein,minute,nflorescence,orolla,pore,porrect,presen,purpl,rhizomatous,ruit,sessile,shallowly,short,side,simple,spaced,sparse,stage,stalk,stellae,tal,tamen,tem,thick,throughout,transparent,tube,unarme,unctional,unit,unknow,uvenile,vein,x,ympodial	5-merous,abaxial,adaxial,color,corolla,density,filament,form,glabrous,globose,growth,height,history,leaf,life,na,ovary,plant,position,purple,reproduction,seed,shape,spacing,staman,stem,stigma,surface,texture,thicknes,unknown,width
277	wfo-0001027742	success	239	99	83	156	16	0.347	-20,0-0.8,0.5-5,0.6-0.8,0.8-1.8,1-2,1-5,1-8,2-2.5,2-3,2.5-5,200-660,3-9,4-6,4-lobed,7-10,7-8,acicular,acute,adaxially,anther,apex,black,broadly,brown,chartaceous,cm,densely,depressed,diameter,drying,especially,extra-axillary,filament,finally,fruit,glabrous,globose,grey-green,inflorescence,ivory-green,lanceolate,lateral,length,lilac,long,margin,midpoint,minutely,mm,ovate,ovate-lancelate,pale,pedicel,peduncle,per,petiole,prickle,pseudo-racemose,purple,rachi,ray,reticulate,rusty,simple,somewhat,square,stalk,stellae,stellate-pentagonal,stellate-pubescent,stem,stigma,straight,style,surface,time,toward,truncate,white,yellow,yellowish,yellowish-green	%,-13,-8,-9,0-0.2,0-1.1,0-12,0-3.5,0-9,0.05-0.1,0.1-0.4,0.1-0.5,0.4-0.8,0.6-0.9,0.7-0.9,1-,1-1.1,1-1.2,1-1.5,1-1.8,1-3,1-4,1.7-2,10-18,10-20,2-,2-2.3,2-5,2-5.5,2-6,2-foliate,25-55,3-4,3-5,3-6,3.5-10,3.5-9.5,4-locular,5-12,5-merou,60-300,7-9,9-14,abaxially,absent,abundant,accrescent,adaxiall,alyx,annual,anthesi,anvil-shape,apart,armed,articulated,attenuate,axe,ba,base,bent,blade,broad,calyx,capitat,cone,connivent,cordate,cross-section,curved,cylindrical,decimetr,directed,distall,distally,distributed,dult,eaf,eed,eglandular,enclosing,entire,erect,exceeding,exocarp,finger,flower,fruiting,geminat,gland-tipped,hair,homostylous,index,interpetalar,juicy,lamina,lobe,lobed,lobing,lon,longer,loosely,lower,markedly,mature,mesocarp,mid-point,midvein,minute,moderately,moist,nflorescence,oblique,obtuse,one,orolla,outside,part,perennial,perfect,placenta,pore,porrect,presen,present,prostrate,rhizomatous,rostrate,rounded,ruit,shallowly,short,shrub,side,slightly,spaced,stage,stalked,strongly,tal,tamen,thick,thicker,thicknes,throughout,tip,tissue,tube,unbranched,unit,unknow,uvenile,vary,vein,wide,x,ympodial	abaxial,adaxial,arrangement,capitate,color,colour,corolla,decimetre,frequency,leaf,ovary,position,seed,shape,staman,texture
278	wfo-0001027757	success	186	96	61	125	35	0.328	abaxially,acute,anther,anthesi,apart,apex,axillary,base,blue,brown,campanulate,chartaceous,clavate,cm,colour,dark,decurrent,deeply,diameter,entire,erect,erose,filament,flattened,flower,fruit,glabrous,globose,irregularly,leaf,lilac,lobe,lobed,long,margin,mm,moderately,oblong,obtuse,occasionally,ovate,pale,pedicel,peduncle,perennial,petiole,pitted,pubescent,regularly,rotate,serrate,shrub,simple,sparsely,stigma,style,surface,unknown,violet,x,yellow	0.2,0.2–0.3,0.3–2.0,0.5,0.6,0.6–1.0,0.7,0–1.4,1.0–1.1,1.0–2.5,1.2–4.0,1.5–1.6,1.5–2.5,1.6–2.4,1.9–2.7,12,1–1.5,1–11,1–2,1–3,2,2.5,2.5–4,2.5–5.5,2.5–7,2–,2–10,3–12,3–5,4–9,5,5–,60–100,6–9,7–8,8–16,absen,accrescent,adaxiall,adaxially,ag,along,apical,arising,articulated,axe,ba,basal,blade,borne,branching,calyx,cell,concave,connivent,convex,cylindrical,densely,directed,distally,eaf,eed,elliptic,equal,fleshy,geminat,glabrescen,glabrou,hair,lanceolate,leafy,lon,longitudinal,lower,m.,multicellular,narrowly,nflorescence,often,opening,opposed,orolla,pair,perfect,plurifoliate,pore,poricidal,primary,probably,rootstock,ruit,secondary,shoot,side,slit,smaller,sometimes,spaced,stone,straight,tall,tamen,tem,thic,thickened,time,tip,toward,tube,unbranched,unicellular,uniseriate,unit,vary,white,wide,woody,ympodial,–19,–2.7,–3.2,–4.0,–5.5,–6,–9	0-1.4,0.2-0.3,1-1.5,1.5-2.5,19,2-10,2.5-4,2.5-5.5,3-12,3.2,60-100,8-16,abaxial,adaxial,arrangement,color,corolla,form,growth,height,history,inflorescence,length,life,na,ovary,plant,position,reproduction,seed,shape,spacing,staman,texture,width
279	wfo-0001027765	success	167	112	81	86	31	0.485	-44,0.8,1-10,1-11.5,1-4,1-5,10-13,2-2.5,2.5-4.2,20-30,5-6,7-20,abaxial,acuminate,acute,apex,articulate,base,branched,cm,cordate,corolla,cuneate,cyme,diameter,dichasial,dichasially,distal,ebracteate,elliptic-lanceolate,filament,flower,glandular,globose,green,green-white,hair,half,herbaceous,honeycomb,interjected,leaf,leaflet,light,long,mm,monochasial,mucilaginous,oblique,obtuse,odd-pinnate,ovate,ovate-elliptic,ovate-lanceolate,ovoid,pattern,pedicel,peduncle,perennial,petiole,pilose,plant,proximal,rounded,seed,simple,size,slightly,stellate,stigma,style,terminal,tone,truncate,tuber-bearing,unit,violet,white,wide,yellow,¼	-30,-4,0-.,1,1-,1-2,1.5-6,2-3,2-4,2.5-4,3-,3-12,3-20,3-6-foliat,5,5-15,5-8,abaxially,abruptly,acumen,apical,apically,apiculate,calyx,cell,connate,covering,dehiscent,digestion,diminishing,dorsally,eaf,edge,eed,elliptic,emoval,enzyme,exceeding,flat,folded,forked,generally,globo,hair-like,introrse,lateral,living,lobe,lon,lower,lunat,make,maturing,nflorescence,nther,often,orolla,pair,perfect,petiolate,petiolule,plan,poricidally,reveal,ruit,sessile,seudostipule,short,side,slit,specimen,stamen,straight,tal,tem,testal,thick,throughou,throughout,tip,toward,typically,vary,wall,without,ympodial	0-2,3-6-foliate,adaxial,anther,arrangement,color,colour,form,fruit,growth,height,history,inflorescence,length,life,lunate,na,ovary,position,present,pseudostipule,rachi,reproduction,shape,spacing,staman,surface,sympodial,texture,width,ye
280	wfo-0001027767	success	184	95	74	110	21	0.402	1-1.5,1-2,1.0-2,1.5-1.8,1.5-2,2-3,3.5-5,5-6,5-merous,7-8,abaxial,anther,apex,attenuate,beige,branch,brown,clavate,cm,coriaceous,cyme,dark,dark-green,diameter,equal,erect-branched,ferruginous,filament,flower,fruit,glabrous,globose,helicoid,hirsute-glandular,indument,lanuginose,leaf,minutely,mm,oblanceolate,oblong-lanceolate,oval-elliptic,pedicel,peduncle,persistently,petiole,plant,porrect-stellate,prickle,recurved,reniform,rugose,shiny,short,shrub,similar,solitary,stellate,stigma,style,sub-conic,sub-globose,sub-truncate,subreniform,terete,terminal,tomentose,trichome,villous,viscid-glandular,white,winged,within,yellowish	0.3-0.5,1,10-12,10-20,15-25,2-2.5,2.6-3,3,3-6-branched,30-many-flowered,4-5,4-many-celled,5-7,5-8,8-9,accrescent,across,acute,along,alyx,anthesi,armed,articulate,attenuat,base,bicolorous,blade,calyx,campanulate,central,curved,deeply,distal,eaf,eed,enlarged,entire,epicarp,exceeding,floral,free,fruiting,geminat,glandular,glandular-stalke,glandular-stalked,glandular-stellate,gynoeci,irregularly,lobe,lobed,long,long-exserted,longer,lower,many-celled,midrib,multiangulate,nflorescence,numerous,orolla,papillo,part,parted,peduncl,pendent,perennia,perfect,persistent,plurifoliate,primary,prominent,pubescent,rachi,ranch,ray,reduced,reflexed,ruit,secondary,sessile,small,somewhat,sparse,sparsely,stalked,stamen,staminate,stem,straight,sub-sessile,subcoriaceous,surfac,surrounded,tall,tamen,thick,tube,unarmed,uniseriate,unit,vary,vein,viscid-villous,wide,withi,without,yellow,ympodial,young	adaxial,arrangement,color,corolla,form,growth,height,history,inflorescence,length,life,ovary,papillose,perennial,position,reproduction,seed,shape,staman,surface,texture
281	wfo-0001027768	success	214	124	101	113	23	0.472	.5,0,0-0.1,0-0.2,0-0.3,0-2,0.1-0.3,0.1-0.4,0.25-1,1-2.5,1.5-2,15-50,3-15,4-,4-5,6-12,6-6.5,7-10,absent,acicular,adult,anther,apex,base,black,branchlet,brown,chartaceous,cm,contiguous,cuneate,dark,densely,diameter,dm,eglandular,elliptical,entire,filament,flattened,flower,fruit,glabrous,gland-tipped,globose,green,greenish-white,grey,grey-green,hair,inflorescence,juvenile,lateral,leaf,leaf-opposed,length,light,long,margin,midpoint,midvein,minutely,mm,nearly,obtuse,pale,pear-shaped,pedicel,peduncle,per,perennial,petiole,present,prickle,purple,rachi,reddish,reticulate,rhizomatous,sessile,short,shrub,smooth,solitary,sparsely,stellate,stellate-pubescent,stigma,straight,streak,style,subcoriaceous,surface,time,toward,turning,violet,white,x,yellow,yellowish	%,0.15-0.25,0.15-0.3,0.2-0.3,0.3-0.6,0.3-0.7,0.3-1.5,0.5-1.5,0.5-3.4,0.6-0.9,0.6-1.5,1,1-2,1.2-1.4,1.2-1.8,1.2-3.4,1.7-2.6,10-15,11-14,18-35,2-2.5,2-7,2-locular,2.9-3.7,3,3-4.5,5-7,5-merou,6-15,8-10,8-12,8-16,abaxiallly,abaxially,accrescent,across,adaxiall,adaxially,alyx,apart,articulated,attenuate,axe,ba,blade,calyx,capitat,confined,connivent,curved,cylindrical,deltate,difoliate,directed,distall,distributed,eaf,eed,erect,exocarp,finger,fruiting,geminat,half,hig,juicy,lamina,lanceolate,less,lobe,longer,loosely,lower,mature,mesocarp,mid-point,midrib,minute,moist,narrowly,nflorescence,oblique,orolla,part,perfect,placenta,pore,porrect,pseudo-racemose,pubescent,ray,ruit,semi-circula,simple,somewhat,spaced,spongy,sprawling,stellae,tamen,tem,thick,throughout,triangular,tube,unarme,unarmed,unbranched,unit,vary,wide,winged,ympodial	5-merous,abaxial,adaxial,capitate,color,colour,corolla,density,form,growth,height,history,life,ovary,plant,position,reproduction,seed,shape,spacing,staman,stem,texture
282	wfo-0001027770	success	242	81	67	175	14	0.277	0.1-0.15,0.1-0.3,0.2-2,0.5-2,0.6-1.2,0.8-1.5,0.8-2.5,1-3,2-3,2-6,2.5-3,4,5-merous,6,6-10,7-15,anther,apex,bark,base,brown,clavate,cm,cuneate,dark,densely,diameter,elliptic,entire,filament,flattened,flower,fruit,globose,gray,lateral,leaf,length,lobed,margin,midpoint,mm,narrowly,obtuse,orange,ovoid,pedicel,peduncle,petiole,plant,prickle,pubescent,reniform,rounded,shallowly,simple,spherical,stellate,stellate-pubescent,stem,stigma,style,surface,terete,terminal,trichome,yellow	0-45°,0.15,0.3,0.3-2,0.5,0.5-1,1-2,1-2.5,1-5,1.5,1.5-2,1/2-1/6,10-14,12,12-14,16,2,2-4,2/3,20,3,3-4,3-5,3-6,4-6,4-7,4-8,5-30,50,7,9,abaxially,acute,adaxially,ag,almost,alyx,anthesi,apart,apically,apparently,armed,articulated,berry,blade,branching,c.,calyx,concolorous,cuspidate,deltate,dense,difoliate,dilated,distance,drying,eaf,eed,elongating,equal,erect,extending,eye,filiform,flat,free,fruiting,geminat,glabrous,green,herbaceous,horizontal,infructescence,irregular,lanceolate,lengthening,less,like,lobe,lon,long,longer,lower,markedly,mature,maturity,midvein,mostly,naked,nflorescence,oblique,obscured,often,older,orange-brown,orolla,oung,ovate,pair,pale,papillate,papillo,pendulous,per,perfect,pericarp,pore,poricidal,porrect,portion,present,prickly,primary,prominent,pubescenc,raised,rare,rarely,ray,red,reduced,reduced-multangulat,reflexed,ruit,scar,sessile,short-styled,side,slightly,small,smooth,sometimes,somewhat,spaced,sparse,sparsely,spreading,stalk,staminat,stolon,straight,stump,subsessile,tall,tamen,tapering,tertiary,thin,throughout,time,tip,toward,tube,unarme,unarmed,underground,uniform,unit,usually,variously,vary,vein,venation,violet,visibl,visible,way,white,white-green,wide,woody,yellow-green,ympodial,young,½	1,2-5,20-50,arrangement,color,corolla,height,inflorescence,ovary,seed,shape,staman,texture,width
283	wfo-0001027807	success	116	91	74	42	17	0.638	0-0.2,0.1-1,0.2-0.9,15-30,2-5,2-6,acuminate,acute,adaxially,apex,attenuate,barely,bark,base,berry,brown,closely,cm,decurrent,dry,elliptic,flattened,flower,glabrous,globose,gray,grayish,green,growth,internodal,lanceolate,leaf,leaf-opposed,margin,material,maturity,midrib,minutely,narrowly,new,occasionally,overlapping,pair,pale,paler,papillate,parallel,pedicel,peduncle,petiole,pitted,plane,primary,rachi,reddish,reniform,revolute,scar,shrub,simple,slender,slightly,small,spaced,sparsely,stem,surface,thickened,tree,vein,visible,white,winged,yellowish	.5,0.2-0.3,0.3-0.4,0.9-1,0.9-2.5,1-1.5,3.5-9,abaxially,almost,brittle,bud,deflexe,deflexed,diameter,difoliate,drying,eaf,eed,ellipti,fruiting,geminat,know,known,mm,nflorescence,older,ot,papillae,prominent,reddi,reproductive,ruit,seemingly,shoot,somewhat,ud,unifoliate,unit,usually,x,ympodial,young	arrangement,color,form,fruit,height,inflorescence,length,na,number,plant,position,seed,shape,spacing,texture,trichome,visibility
284	wfo-0001027808	success	178	96	66	112	30	0.371	.5,0-7,0.6-1.2,1-2,1.1-1.3,1.6-3,12-18,2-4,23-28,5-7.5,5.5-6.5,70-90,8-12,9-14,acuminate,acute,andromonoecious,anther,apex,base,blade,broad-based,broadly,brown,chartaceous,cm,cuneate,curved,densely,diameter,extra-axillary,flower,fruit,globose,green,index,inflorescence,lavender,length,lobed,lobing,margin,mm,oblique,ovate,pale,part,pedicel,peduncle,per,perennial,petiole,plant,prickle,pseudo-racemose,shallowly,simple,sparsely,stellate,stellate-pubescent,stigma,style,vine,white,yellow,yellowish	%,.2,.7,0-0.1,0.05-0.2,0.2-0.3,0.2-0.35,0.25-0.35,0.3-0.6,0.4-0.8,0.4-1,0.5-0.6,0.5-1,0.5-3,0.6-1.4,1,1-1.3,1.4-1.8,1.9-2.4,15-30,2-foliate,2.5-3.5,2.5-4,20-30,3-11,40-120,5-7,5-merou,6-8,7-10,7-8,abaxially,absent,acicular,across,adaxiall,adaxially,alyx,apart,armed,articulated,axe,ba,calyx,capitat,d.,deltate,directed,distall,distributed,eaf,eed,eglandular,finger,fruiting,functional,geminat,gland-tipped,hair,half,heterostylous,lamina,lateral,less,lobe,long,longer,lower,mature,mid-point,midpoint,midvein,minute,nflorescence,orang,orolla,pore,porrect,presen,present,purple,ray,rostrate,ruit,sessile,short,side,spaced,sprawling,stage,stalk,stellae,straight,tal,tamen,tem,thick,throughout,time,tube,unarme,unarmed,unbranched,unit,unknow,uvenile,vary,vein,weakly,wide,x,ympodial	5-merous,abaxial,adaxial,arrangement,capitate,color,colour,corolla,density,dm,filament,form,growth,height,history,leaf,life,na,orange,ovary,position,reproduction,seed,shape,spacing,staman,stem,surface,texture,width
285	wfo-0001027816	success	187	131	105	82	26	0.561	.5,0.2,0.5-1,0.6-0.8,0.7-1,1,1-1.5,1-3,1-4,1.2-2,1.5-2,2/3,4-5,6-9,<,acuminate,acute,almost,along,anther,apex,attenuate,base,becoming,berry,bluish,branched,brown,capitate,cell,cm,confined,corolla,dark,dense,densely,diameter,drying,entire,filament,flattened,flower,fruiting,glabrous,globose,growth,inflorescence,irregularly,lanceolate,lateral,leaf,less,like,linear,lobed,margin,minutely,mm,nodding,orange,pair,patent,pedicel,peduncle,petiole,pitted,plant,primary,pubescent,purple,rectangular,red,reddish,reniform,ripe,scar,several,shiny,shrub,simple,small,spaced,sparse,sparsely,spreading,square,stellate,stem,stigma,style,surface,terminal,testal,thin,time,tip,trichome,uniformly,uniseriate,variable,vein,way,x,yellowish,½	..,0.5,0.5-2,1-1,1.8-6,12-14,2-2.5,2-4,3-3.5,3.5-4,5-30,5-merou,ag,alyx,anthesi,apar,ark,articulated,axi,calyx,conical,connivent,cupped,eaf,eed,ellipsoid,em,erect,exserted,filiform,fleshy,free,gland-tipped,glandular,half,ilament,leaving,lengthening,lobe,loosely,lower,m.,markedly,minute,new,nflorescence,occasionally,often,older,orolla,papillo,peg,per,perfect,perhaps,pericarp,plurifoliat,pore,poricidal,portion,prominen,pubescen,rounded,ruit,sleeve,slightly,slit,sometimes,somewhat,spreadin,triangular,tube,twinin,ud,ultimate,unit,upper,usually,vary,viscous,woody,ympodial	abaxial,adaxial,apart,arrangement,bark,color,colour,form,fruit,height,history,length,life,na,number,ovary,position,rachi,reproduction,seed,shape,size,spacing,staman,texture,width
286	wfo-0001027819	success	199	88	60	139	28	0.302	10-20,16-25,2-15,20-35,3-40,4-10,5-merous,8-10,9-12,acute,aggregate,apex,cell,cm,color,densely,diameter,ellipsoidal,fading,finely,fleshy,flower,forked,fruit,glabrous,globose,green,leaf,length,lobed,mesocarp,mm,moderately,narrowly,oblong,obtuse,pedicel,peduncle,perfect,petiole,puberulent,purple,purplish,rachi,rugose,simple,sparsely,stellate,stigma,stone,style,subcoriaceous,tree,umbrella-shaped,unbranched,unknown,unlobed,whitish,width,yellow	-100,0.5-1,1,1-,1-2,1-5,1.5-2,10-50,12-21,15-22,2,2-,2-3,20-25,20-40,22-35,25-35,3-5,3-5-lobed,4,4-15,4-25,4-5,5,5-6,abaxially,adaxially,also,alyx,apart,ape,apical,apiculat,articulated,axe,ba,basal,base,beyond,blade,branched,ciliate,concave,connective,cordate,cuneate,cylindrical,deeply,denser,dia,diamete,dilated,directed,distally,divided,eaf,eed,eglandular,eglandular-pilose,elliptic,elliptic-ovate,entire,equal,especially,exceeding,except,exserted,hair,halfway,leaving,lobe,lon,long,lower,main,margin,midrib,narrow,near,nflorescence,nther,oblique,obtu,occasionally,often,orolla,ovate,pedicellar,per,perfec,pilose,pinnately,pore,present,probably,prominent,protuberance,puberulen,puberulence,radiu,ranch,rarely,ratio,remnant,ripe,rounded,rown,ruit,runk,shallowly,short-acuminat,shorter,sinus,slightly,small,sometimes,spaced,stamen,strongly,swelling,sympodial,tal,thecae,toward,triangular,truncate,tube,two,ud,uni,unit,usually,vary,vein,villous,wide,without,x,young	abaxial,adaxial,anther,arrangement,branch,bud,colour,corolla,filament,form,growth,height,history,inflorescence,life,na,ovary,perennial,plant,position,reproduction,seed,shape,short-acuminate,spacing,staman,surface,texture
287	wfo-0001027829	invalid_json_followup	197	118	84	113	34	0.426	.5,0.1-0.8,0.6-0.9,0.7,1,1-3,1.5,1.7-2,5,5.5-6,6-6.5,abaxially,anther,bark,base,black,bright,brown,clavate,cm,commonly,corolla,dense,densely,denser,diameter,elliptic,elongate,equal,evenly,filament,flattened,flower,glabrous,globose,growth,inflorescence,larger,lateral,length,lobed,midpoint,minutely,mixed,mm,multicellular,narrowly,nearly,often,orange,ovary,pale,pedicel,peduncle,petiole,pitted,porect,porrect,prickle,pubescent,ray,reddish,reniform,scattered,sessile,shiny,short,short-stalked,shorter,shrub,simple,small,somewhat,stellate,stigma,style,surface,tan,tangled,thin,tree,trichome,white,yellowish	.1,0.5,0.6-0.7,0.7-0.8,1-,1-1.5,1.5-2,1.5-2.5,1/3,10-20,12,2,20-31,3-7,30,4-6,5-18,5-8,8-10,acuminate,acute,adaxially,along,anthesi,apar,apex,armed,articulated,axi,beneath,bent,berry,calyx,cell,conical,directed,distally,drying,eaf,eed,enmeshing,entire,erect,exceeding,exserted,filiform,free,fruiting,glabrescen,gland-tipped,hang,like,lobe,long,lower,margin,midrib,midvein,minute,mixture,new,nflorescence,nodding,oblique,older,one,open,pair,papillat,per,perfect,pericarp,plurifoliat,pointed,pore,poricidal,portion,primary,prominent,pubescence,rectangular,reflexed,regular,ripe,ruit,scar,sharply,side,sinuate,spaced,sparsely,stem,straight,strongly,tapering,testal,time,tip,triangular,truncate,tube,twice,ud,un,unarmed,unit,upper,usually,vein,weak,within,x,ympodial	'',[,``,abaxial,adaxial,apart,arrangement,characteristic,color,colour,density,feature,form,fruit,glabrescent,height,hermaphroditic,history,leaf,life,na,perennial,plant,position,rachi,reproduction,seed,shape,spacing,staman,texture,value,{,}
288	wfo-0001027834	success	236	121	93	143	28	0.394	-6.1,0.2-0.6,0.5-2,1-1.9,1-10,1.1-1.8,1.6-2.7,2-3.8,2-8,2.3-3.4,25,4-5.2,5-merous,6.9-18.1,abaxial,abaxially,accrescent,acuminate,acute,adaxial,angled,anther,apex,attenuate,bark,blunt-tipped,branch,branched,branching,brown,bud,calyx,cm,coriaceous,corolla,deltoid,dendritic-echinoid,diameter,echinoid,ellipsoid,filament,finely,flower,fruit,fruiting,globose,granular-tomentose,gray,grooved,leaf,lenticular,light,lobe,longitudinally,mm,ovate,ovate-elliptic,ovate-lanceolate,pedicel,peduncle,persistent,petiole,pubescence,rachi,reticulate-punctate,scabridulous,semi-ovate,semi-spherical,sessile,short,short-stalked,shrub,simple,small,soft,stellate,stigma,style,subcampanulate,surface,tomentum,tree,trichome,tube,turbinoid,velutinous-tomentose,white,whitish,whitish-tomentose,yellow,yellowish,yellowish-tan,yellowish-tomentose	.5-3,0-110,0.2-0.3,0.2-0.4,0.4-1.1,0.9-1.8,1-1.6,1-2.5,1.1-1.6,1.4-2,1.8-4.9,1/2,10-25,2.2-4.3,2.4-6.2,2.7-7.3,2.9-4.2,3-15,3-4.3,4-6,4.8-6.9,5-20,5.1-8,9-11.9,9-13,absent,adaxially,ag,alyx,anthesi,apar,apical,around,articulated,axillary,ba,base,becoming,berry,blade,capitat,closely,completely,concentrated,connivent,covering,crown,cylindrical,dendritic-echinoi,densely,dichasia,directed,discolorous,distally,drying,eaf,echinoi,edge,eed,enclosing,entire,enveloping,equal,erec,exserted,farinose,flat-topped,fleshy,forming,glabrescent,glabrous,hair,high,included,inserted,lengthening,less,lobed,long,long-stalked,longitudinal,lower,many,margin,mostly,multangulat,multangulate,near,nflorescence,numerous,obovate,obscured,obtuse,older,orbicular,orolla,pair,perfec,plurifoliate,pore,poricidal,porrect-stellate,primary,pseudo-terminal,pubescent,rarely,ray,ripe,rounded,ruit,runk,scar,slit,sometimes,somewhat,spaced,sparsely,spreading,stalked,stamen,stellate-pubescent,stem,subcoriaceous,suture,tamen,though,time,tip,tomentose,tomentu,toward,ud,unarme,unit,usually,vary,vein,villous,way,wide,x,ympodial,young	angle,apart,arrangement,capitate,color,colour,dichasial,form,growth,height,history,inflorescence,length,life,na,ovary,perennial,plant,position,pseudoterminally,reproduction,seed,shape,spacing,staman,texture,trunk,width
289	wfo-0001027843	success	154	81	68	86	13	0.442	.5,/3,0.5-0.75,0.5-1,0.8-3.5,1-1.5,1.2-2.5,3-15-flowered,6-9,anther,apart,base,beginning,clavate,cm,corolla,deflexed,densely,ellipsoid,erose,filament,flower,fruiting,glabrous,globose,green,irregularly,later,leaf,lobed,long,margin,minor,minutely,mm,nearly,orbicular,ovary,ovate,papillose,pedicel,petiole,pleated,pubescent,scar,shape,shaped,simple,sinus,size,slender,slightly,somewhat,spaced,stem,stigma,straight,style,surface,tear-drop,trichome,tube,uniseriate,way,white,winged,woody,x	.75,1-1.2,1-1.3,1.2-1.5,2-2.5,2-4,3-6,5-6,6-13,acute,along,anthesi,apex,apiculate,ba,bark,bearing,becoming,beneath,berry,broadly,calyx,conical,coroll,curly,deltoid,denser,dia,differing,difoliate,distally,eaf,edicel,eed,exsertion,free,geminat,glabrate,hairy,impressed,known,lamina,larger,lateral,like,lobe,lon,long-acuminate,lower,main,major,middle,near,nflorescence,occasionally,older,one,opposite,pair,papillo,pore,poricidal,portion,prominent,proximal,reddish-gre,reflexed,rounded,ruit,shrub,sparsely,sparser,stiff,strongly,tall,tapering,time,tip,tipped,two,ud,unit,vein,widest,ympodial,young	abaxial,adaxial,bud,color,fruit,height,inflorescence,length,number,position,pubescence,spacing,texture
290	wfo-0001027847	success	219	122	95	124	27	0.434	-0.8,-2.5,-6,0-2,0.15-0.2,0.2,0.4-1,0.5,0.8-1.2,1.5-2,1.5-5,2-2.8,2-4,3-5,5.5-8,abaxially,acute,ame,anther,apart,apex,bark,base,berry,branched,c.,cm,cordate,deltate,densely,diameter,dull,elliptic,erect,faint,filament,finely,flattened,flattened-reniform,flower,fruit,glabrescent,lateral,leaf,length,lobed,margin,maturity,mauve,midpoint,midvein,mm,moderately,orange,orange-brown,ovate,pair,pedicel,peduncle,perpendicular,petiole,pitted,porrect,prickle,primary,purple,ray,red,red-brown,reddish,retrorse,rounded,scandent,seed,sessile,shrub,simple,smooth,sometimes,sparsely,spherical,stalked,stellate,stellate-pubescent,stem,style,surface,terminal,tertiary,trichome,vein,venation,visible,white,yellow	-2,-3,-4,-5,.35,.7,/2,/3,0,0-7,0.1-0.4,0.5-1,0.8,0.8-0.9,1,1-2,1-2.5,1.5-2.5,1.9-2.3,1/2,1/4,1/6-1/3,2-3,2-5,2.2-3,2.5-3.5,2/,3-15,3-6,3.5-6,4-5-merous,5-25,5-6,6-11,6-8,7-10,almost,alyx,apar,apically,apparently,articulated,blade,broadly,brow,calyx,chartaceous,connivent,curved,dimorphic,discolorous,distance,drying,eaf,edge,eed,elongating,equal,evenly,extending,filiform,filiform-acuminat,free,fruiting,geminate,glabrous,gray,green,increasing,infructescence,lobe,lon,long,longer,lower,mature,middle,minor,narrow-deltate,nflorescence,older,one,open,orbicular,orolla,oung,pendulous,per,perfec,pericarp,pit,plurifoliat,poricidal,portion,prickl,prickly,ruit,scar,side,size,slender,spaced,spreading,stalk,straight,strongly,tamen,tapering,terete,time,tip,toward,tube,unarmed,unit,upper,usually,variously,vary,way,weakly,wide,ympodial,young	abaxial,adaxial,arrangement,brown,color,colour,corolla,form,growth,height,history,inflorescence,life,na,number,ovary,plant,position,rachi,reproduction,shape,spacing,staman,stigma,texture,visibility,width
291	wfo-0001027850	success	221	129	109	112	20	0.493	-4,-5,-6,0.2-0.5,0.6-1,1-3,1-4,1.5-2,2-2.5,2-4,3-7,4-5,6-7,8-10,abaxially,acuminate,acute,adaxially,adult,angled,anther,apart,apex,bark,base,berry,blue,branched,brown,clavate,cm,corolla,dark,diameter,dry,elliptic,entire,filament,flattened,flower,glabrescent,glabrous,glandular,globose,green,growth,heterostylous,inflorescence,internodal,juvenile,laxly,length,like,linear,lobed-angulate,long-styled,loosely,margin,material,mature,minute,minutely,mixture,mm,oblong,obovate,ornamented,ovary,ovate-lanceolate,pedicel,peduncle,petiole,plant,pubescence,purple,raised,reddish,reniform,reticulate,rugose,rusty-pubescent,sagittate,scar,sessile,short-styled,shrub,simple,slightly,spaced,stellate,stem,stigma,style,subglobose,subreniform,subsessile,subtruncate,surface,tapered,tomentose,trichome,tube,unevenly,velutinous,whitish,woody,x,yellow,yellowish	-10,-22,0.3-0.35,0.5-1,1,1-1.5,1-2,1-multicellular,2-3,2-5,2-6,2.5-3,3-4,3-6,3.5-13,4-6,50,6-10,7-18,<,>,almost,anthesi,armed,articulated,basal,brow,caly,calyx,cell,channelled,charataceous,coriaceous,curved,discolorous,distal,eaf,eed,eglandular,enclosed,erect,expanding,flowering,foliaceous,free,fruiting,hirsute,impressed,leaving,lengthening,lobe,lobed,long,longer,lower,midpoint,mixed,multicellular,new,nflorescence,obliqu,oblong-lanceolate,obverse,occasionally,older,one,papillo,partially,per,perfect,pericarp,persistent,plurifoliat,pore,poricidal,porrect,portion,prickle,prickly,prominent,pubescent,reduced,reflexed,rest,rounded,ruit,rusty,scabrous,scandent,single,slit,sparse,sparsely,stalked,staminate,stellate-apiculate,straight,strongly,tall,testa,time,tip,triangular-lanceolate,turbinate,ud,unit,upper,vein,venation,wood,ympodial,¼	abaxial,adaxial,angle,colour,form,fruit,height,history,leaf,life,oblique,papillose,perennial,position,reproduction,seed,shape,spacing,texture,width
292	wfo-0001027864	success	222	105	81	141	24	0.365	0-100,0-2,0.1-0.4,0.25-0.5,0.4-1.4,1-1.1,1-2,1-3,1-4,1.4-4,3-5,3.5-5,4,5-9,6-7,acicular,acute,anther,apex,base,broad-based,cm,cuneate,densely,diameter,ellipsoidal,entire,extra-axillary,filament,finely,flower,fruit,glabrous,globose,green,grey,grey-green,hair,herbaceous,index,inflorescence,lanceolate,length,lilac,linear,lobed,lobing,margin,mm,nearly,obtuse,pale,pedicel,peduncle,per,petiole,prickle,pseudo-racemose,purple,rachi,reniform,resprouter,reticulate,ridged,scattered,shallowly,side,smooth,stellate,stellate-pubescent,stem,stigma,straight,style,surface,terete,white,x,yellow,yellowish,yellowish-green	%,0-0.1,0-0.2,0-3,0.05-0.4,0.3-1,0.4-0.7,0.5-0.7,0.5-0.8,0.5-1,0.6-0.7,0.7-0.9,0.7-1,0.7-1.4,0.9-1.1,1-1.3,1-1.5,1-3.5,1.2-1.5,1.5-8,13-20,2-3,2-foliate,2-locular,2.5-3,3-10,3-4,3-4.2,3-5.5,3-6,3.8-14,4-,5-merou,6-12,6-8,6-9,7-10,7-20,8-12,8-13,8-14,abaxially,absen,absent,abundant,accrescent,adaxially,alyx,anvil-shape,apart,articulated,attenuate,axe,ba,blade,brown,calyx,capitat,chartaceous,connivent,cross-section,curved,cylindrical,decimetr,deflexed,deltate,directed,distall,distributed,dult,eaf,eed,eglandular,erect,exocarp,finger,flattened,fruiting,geminate,gland-tipped,half,homostylous,interpetalar,juicy,lamina,lateral,less,lobe,lon,long,longer,loosely,lower,mature,mesocarp,mid-point,midpoint,minute,moderately,moist,nflorescence,oblique,oblong,orolla,part,perfect,placenta,pore,porrect,present,ray,rostrate,ruit,rusty-brown,sessile,short,simple,slightly,spaced,sprawling,stage,stalk,stalked,stellae,tal,tamen,tapered,thick,throughout,time,tip,tissu,tissue,tube,unarmed,unbranched,unit,uvenile,vary,wide,ympodial	abaxial,adaxial,capitate,color,colour,corolla,decimetre,form,frequency,growth,height,history,leaf,life,na,ovary,perennial,plant,position,reproduction,seed,shape,staman,texture
293	wfo-0001027872	success	190	100	70	120	30	0.368	1,1-4,1-8,10,2,2.2-3.5,5-7,6-20,8-11,acuminate,acute,apex,articulate,base,branched,ca,cell,cm,covering,cyme,deep,densely,diameter,dichasial,dichasially,distal,ebracteate,elliptic,filament,flower,glabrescent,glandular-pubescent,globose,gray-green,green,green-white,hair-like,half,herbaceous,homogeneously,honeycomb,lanceolate,lateral,light,mm,moderately,monochasial,mucilaginous,narrowly,odd-pinnate,ovate,ovoid,pattern,pedicel,peduncle,perennial,plant,purple,rhizomatous,rotate,seed,shape,stigma,style,testal,thick,typically,wall,yellow,yellowish-green	0.5,1-1.2,1.0-1.3,1.5-4,12-35,15,2-3,2.8,20,3-6-foliat,35,4-6,5-10,5-8,5-lobed,abaxially,acumen,adaxially,angular,apical,apically,apiculate,b,ba,basal,becoming,calyx,caudate,celled,clasping,commonly,connate,cordate,cuneate,decreasing,dehiscent,digestion,eaf,eed,emoval,enzyme,erect,exceeding,externally,forked,four-celled,generally,gland,glandular,globo,interjected,introrse,leaflet,living,lobe,lon,long,longer,lower,make,maturing,middle,mottled,nearly,nflorescence,nther,obliquely,oblong,often,orolla,pair,pentagonal,perfect,petiolate,petiolulate,petiolule,poricidally,puberulent,pubescent,purpl,rarely,reduced,reveal,rhizome,rotate-,rounded,ruit,semi-lunate,sessile,seudostipule,short,single,size,slightly,slit,sometimes,somewhat,specimen,stamen,ste,straight,subequal,symmetrically,tem,terete,terminal,tinged,tip,trailing,type,unbranched,uniformly,unit,usually,vary,viole,wid,wide,wider,ympodial	abaxial,adaxial,anther,arrangement,color,colour,corolla,form,fruit,growth,height,history,inflorescence,leaf,length,life,na,ovary,petiole,position,rachi,reproduction,rotate-pentagonal,spacing,staman,surface,texture,violet,wet,width
294	wfo-0001027880	success	185	106	81	104	25	0.438	-3.5,.25,0.3-3,0.5-1.5,0.5-5,0.6-1.5,0.8-1.5,1-14,1-2,10-15,2-3,4-10,4-6,8,acuminate,acute,anther,apart,apex,apiculate,base,chartaceous,clavate,cm,contiguously,cordate,densely,diameter,distichous,entire,epiphytic,extra-axillary,filament,flower,fruit,glabrous,globose,greenish,inflorescence,internode,leaf,leaf-opposed,lower,margin,mm,nearly,oblique,oblong-ovate,often,ovate,ovoid,papillose,pedicel,peduncle,perfect,petiole,pink,pubescent,purple,rachi,red-brown,revolute,ripe,rounded,rugulose,shrub,size,sometimes,somewhat,stellate,stigma,style,surface,tan,truncate,unbranched,undulate,vine,white,x,yellow	-3,0.6-1,1-15,1-2.5,1-3,1.5-2,1.5-3,2-80,2/,3-4,5-11,5-8,5-merou,abaxially,absen,accrescen,adaxially,ag,aggregate,along,alyx,apparently,articulated,axe,ba,blade,branch,branching,calyx,cell,ciliat,conical,connivent,coriaceous,curled,cylindrical,deltate,dense,diminishing,directed,discolorous,distally,distinct,distinctly,eaf,eed,equal,flattened,fruiting,geminat,green,growing,hair,increasing,line,lobe,long,longer,longitudinal,midvein,minutely,multicellular,nflorescence,node,oblong,occasionally,opening,orolla,pair,pale,plurifoliate,point,pore,pubescen,reddish,rooting,ruit,scar,secondary,simple,slender,slightly,slit,spaced,sparsely,ste,stone,tamen,tem,thickened,time,tip,trailing,tree,trunk,tube,typically,uniseriate,unit,usually,vary,vein,wide,ympodial	2/3,abaxial,adaxial,arrangement,color,colour,corolla,form,growth,height,history,length,life,na,orientation,ovary,plant,position,reproduction,seed,shape,spacing,staman,texture,width
295	wfo-0001027880	success	170	128	99	71	29	0.582	.25,0.2-0.5,0.3–3,0.5,0.5–1.5,0.5–5,0.6–1.5,0.8–1.5,10–15,1–14,1–2,1–3,2–3,3–4,4–10,4–6,5-merous,8,abaxially,absent,acuminate,acute,adaxially,along,anther,apex,apiculate,arrangement,base,blade,bluish-purple,chartaceous,cm,contiguously,cordate,coriaceous,densely,diameter,distichous,distinct,entire,extra-axillary,filament,flower,fruit,glabrous,globose,greenish,hair,leaf,leaf-opposed,line,long,longer,margin,membranous,midvein,mm,mottled,nearly,oblong-ovate,occasionally,ovate,ovoid,pair,pedicel,peduncle,petiole,pink,pinnate,pubescent,rachi,red,reddish-brown,revolute,rounded,rugulose,sand-punctate,secondary,shrubby,sometimes,somewhat,stellate,stigma,style,surface,tan,time,trichome,truncate,unbranched,undulate,vein,venation,vine,white,wide,x,–3.5	0.6–1,1.5–2,1.5–3,1–15,1–2.5,2-80,2/3,5–11,5–8,accrescen,alyx,apar,axe,berry,c.,calyx,capitat,ciliat,clavate,climbing,conical,curled,cylindrical,deltate,dense,discolored,distinctly,eaf,eed,flattened,fruiting,green,lanceolate,lobe,lower,m.,minutely,nflorescence,nternode,oblique,often,orolla,pale,papillose,perfec,plurifoliat,reddish,rip,ruit,sand-punctat,scar,simple,slender,slightly,spaced,sparsely,ste,tamen,tem,thickened,tip,tree,trunk,tube,typically,uniseriate,unit,vary,vegetatio,woody,ympodial	abaxial,adaxial,apart,capitate,color,colour,corolla,form,growth,height,history,inflorescence,length,life,na,number,ovary,perfect,plant,position,reproduction,ripe,seed,shape,spacing,staman,stem,texture,width
296	wfo-0001027881	success	215	122	82	133	40	0.381	-3,absent,acute,almost,anther,apex,attenuate,base,berry,blackish,blade,camptodromous,chartaceous,ciliate,cm,contiguous,cordate,cordiform,densely,diameter,entire,erect,explosively,extra-axillary,filament,flattened,flower,fruit,glabrous,glandular,globose,greenish,groove,hair,held,herb,immature,lateral,leaf,light-brown,like,margin,maturity,membranaceous,mesocarp,mm,moderately,multicelled,ovate-elliptic,parallel,pedicel,peduncle,petiole,pressure,primary,projection,pubescence,pubescent,rachi,raised,reniform,rotate,secondary,seed,sessile,short,simple,sparsely,staman,stem,stigma,style,subopposite,surface,translucent,unbranched,vein,venation,watery,white,yellow,×	.3–0.5,0.5–2.2,0.8–1.5,1-celled,1.3–2,1.8–2.9,10–25,1–2,1–2-celled,1–2.5,1–2.6,1–3,1–3-celled,1–4,2.5–3.6,20–40,2–4,2–6,2–7,4–6,4–9.5,5,5-merous,6–10,7–14,7–9,8,abaxially,abundant,accrescent,acuminate,adaxiall,adaxially,alyx,appressed,articulated,asymmetric,axe,ba,barely,bulge,calyx,capitat,case,central,closely,commonly,connected,connivent,curved,cylindrical,decurrent,dehiscing,denser,difoliate,directed,dorsally,drying,eaf,ed,eglandular,emarginate,emerging,equal,exceeding,exclusively,eye,few-,fewer,forming,frequent,geminate,giving,half,hollow,impression,interpetalar,introrsely,larger,less,lobe,long,longer,longitudinal,lower,mainly,many-branched,maturit,mixed,much,multicellular,naked,near,netlike,nflorescence,normally,one,opening,orolla,other,pair,part,per,perfec,placenta,pore,prominent,ruit,side,similar,size,slightly,slit,small,smaller,solitary,sometimes,stalk,stamen,subapically,tal,tamen,tem,tissue,triangular,tube,two,unit,vary,visible,winged,woody,ympodial	0.3-0.5,0.5-2.2,1-2,1-2.5,1.3-2,20-40,4-6,6-10,7-14,7-9,abaxial,adaxial,arrangement,capitate,ciliation,color,colour,corolla,dehiscence,dried,form,growth,height,herbaceous,history,inflorescence,length,life,mature,na,ovary,perennial,plant,position,reproduction,shape,spacing,texture,type,width
297	wfo-0001027882	success	184	153	127	57	26	0.69	.25,0.1,0.5-1,1,1-1.5,1-5,1.5-2,1.5-2.2,1.5-6,2-6,2-lobed,2.1-2.6,2.5-3,3-4,3.5-5,6-9,9-13,acuminate,age,anther,anthesi,apart,apex,apparently,appearing,attenuate,bark,base,berry,branch,branched,broadly,brown,c.,calyx,clavate,cm,completely,conical,corolla,cucullate,dark,deltate,dense,densely,diameter,difoliate,drying,elliptic,entire,filament,flattened,fork,fruiting,fusiform,glabrous,globose,green,growth,hairy,hooked,inflorescence,irregularly,leaf-opposed,lengthening,less,lobe,lobed,margin,markedly,maturity,minutely,mm,new,occasionally,ovary,ovoid,pair,pale,papillate,pedicel,peduncle,petiole,pitted,planar,plane,pointed,pore,poricidal,primary,pulp,rachi,rarely,reddish,reniform,scar,shiny,shrub,simple,slit,small,sometimes,spaced,sparse,sparsely,stem,sticky,stigma,strongly,style,surface,swollen,thickened,time,tip,tree,trichome,tube,tuft,uniseriate,unit,vein,way,white,x,yellow,yellowish	.5,06a,1.5-,1.6-2.2,10-25,10-40,2-3,3.2-6,3.5-4,4-5,7-,abaxially,absent,adaxially,along,axil,branching,caly,dry,eaf,eed,erect,et,exerted,fide,flower,free,geminat,glabrou,hollow,junction,kallunki,lamina,lower,midrib,nflorescence,nodding,papillat,paulo,penden,perfect,population,portion,red-papillat,ruit,shattering,slender,specimen,stout,straight,structurally,sweet-scented,são,ud,usually,woody,ympodial	abaxial,adaxial,arrangement,bud,color,form,fruit,geminate,height,history,leaf,length,life,na,number,perennial,plant,position,red-papillate,reproduction,seed,shape,spacing,sympodial,texture,thicknes
298	wfo-0001027889	success	151	98	70	81	28	0.464	0.5-1,0.5-11,1,1-3,10-12,3-4,3-8,abaxially,acute-acuminate,adaxially,apex,articulated,base,chartaceous,cm,color,connective,cylindrical,densely,diameter,directed,eglandular-pubescent,elliptic,entire,extending,finely,flower,fruit,glabrous,glandular-,green,greenish,immature,introrse,laterally,length,light,mm,moderately,narrow,oblong,ovate,ovoid,pedicel,peduncle,petiole,pore,present,probably,puberulent,rachi,remnant,ripe,shrub,simple,stellate,stigma,style,subcoriaceous,swelling,thecae,tomentose,tree,truncate,unbranched,unknown,violet,white,x,yellowish	-2.5,-pubescent,.5,.5-2,0,0.7-2,1-10,1-3.5,1.5,1.5-2,10-20,10-30,2-20,2-3,3-9,4-foliat,5-10,acuminate,acute,aggregate,apart,ape,apiculate,axe,basal,beyond,blade,calyx,capitat,cell,connivent,darker,deltate,dilated,distally,eaf,eed,eglandular-puberulent,equal,exceeding,exserted,leaving,lobe,lon,long,longitudinal,lower,margin,nflorescence,nther,orolla,pedicellar,perfect,presen,puberulen,puberulent-pubescen,puberulent-pubescent,radiu,ruit,slightly,small,somewhat,spaced,sparsely,stamen,stone,stripe,subcordate,tal,tem,time,tip,tomento,triangular,tube,ud,unit,vary,wide,yello,ympodial	1-2.5,abaxial,adaxial,anther,arrangement,articulation,capitate,colour,corolla,direction,form,growth,height,history,inflorescence,leaf,life,na,ovary,plant,position,reproduction,seed,shape,spacing,surface,texture,width
299	wfo-0001027900	success	227	119	97	130	22	0.427	.1,.1–0.3,0.2–0.5,1.5–1.8,14–15,18–22,1–,1–3,1–4,2.8,2–8,3,3.5–4.5,3–5,4–10,5-merous,7–10+,abaxial,acute,adaxial,adaxially,andromonoecious,anther,apart,apex,bark,base,blue,broad-based,brown,capitate,cm,cordate,coriaceous,deeply,densely,diameter,entire,extraaxillary,falcate,filament,flower,fruit,globose,green,grey-brown,hair,inflorescence,lanceolate,leaf,length,light,lighter,likely,long-stalked,margin,maturity,midpoint,midvein,mm,moderately,multangulate-stellate,multiseriate,oblique,obtuse,pedicel,peduncle,petiole,plant,powdery,prickle,pubescent,rachi,ray,reddish-dark,repand,rotate-stellate,roughened,sharp,shrub,simple,slightly,small,smooth,stalk,stellate,stem,stigma,stout,style,surface,tree,unbranched,violet,yellow,×,–4	.1–0.2,.5,0,0.1–0.3,0.2–0.4,0–0.1,16–19,16–23,2,2–3,3.5–4,3–8,3–9.5,5–,5–10,5–6,5–7.5,6–8.2,7–10,7–15,7–17,7–8,8–15,9–25,abaxially,absent,abundant,abundantly,accrescent,age,alyx,anthesi,armed,articulated,axe,ba,becoming,beneath,berry,bilobe,blade,calyx,congested,connective,connivent,curved,cylindrical,db,deltate,difoliate,directed,discolorous,distally,dried,eaf,eed,either,enclosing,equal,flowering,free,fresh,frui,fruiting,functionally,geminat,glabrous,glandular,golden-tan,half,hermaphroditic,heterstylou,interpetalar,like,lobe,lobed,long,longitudinal,lower,major,membranaceous,mixed,multangulate,multiseriate-stalked,nearly,nflorescence,often,older,one,opening,orolla,part,pore,porrect-stellate,pronounced,pubescence,reflexed,ruit,runk,sessile,short,short-stalked,side,slit,spaced,sparsely,stalked,staminate,stellate-pubescen,stellate-pubescent,strongly,subtending,tamen,tan,tapered,thickened,time,tissue,tube,unarmed,unit,unknown,vary,vein,vestigial,wide,ympodial,young,–5,–6.2	5–7,arrangement,bilobed,color,colour,corolla,form,growth,height,heterstylous,history,life,na,ovary,position,reproduction,seed,shape,spacing,staman,texture,trunk
300	wfo-0001027901	success	156	94	69	87	25	0.442	0.3-1.2,0.8-1,1-2.5,2.5-3,4-5,abaxial,abaxially,acuminate,acute,adaxially,anther,anthesi,apex,area,attenuate,base,berry,bright,broadened,brown,closely,cm,corolla,dark,dry,elliptic,fresh,glabrous,globose,green,immature,inflorescence,leaf,lobe,lobed,material,minutely,mm,nearly,opposite,ovary,ovoid-reniform,papillose,pedicel,petiole,pitted,planar,pore,poricidal,pubescent,ripe,shape,shaped,shiny,shrub,simple,spaced,sparsely,stigma,style,surface,tear-drop,tip,translucent,trichome,uniseriate,white,x,yellow	.25,.5,0.5-1,0.8-2,0.9-2.3,1-1.5,1-2,1.5-1.8,1.8-4.5,3-5,4-10-flowered,4.7-12,6-7,?,ba,bark,beneath,brow,calyx,conical,curled,deflexed,densely,dia,differing,difoliate,direction,drying,eaf,edicel,eed,ellipsoid,exserted,filament,firm,fleshy,free,fruiting,geminat,imbedded,keeled,later,lateral,like,lon,long,lower,main,major,matrix,middle,midrib,minor,nflorescence,older,orbicular,oriented,overlappin,pair,papillo,portion,prominently,reddish,reflexed,rest,rounded,ruit,scar,single,size,slender,stem,straight,strongly,swollen,tall,triangular,tub,tube,ud,unit,usually,vein,widest,woody,ympodial,young	adaxial,arrangement,color,colour,diameter,flower,form,fruit,growth,height,history,length,life,na,overlapping,peduncle,perennial,plant,position,rachi,reproduction,seed,spacing,texture,width
301	wfo-0001027902	success	128	92	64	64	28	0.5	0.5-1,1-2,1-6,1.5-3,10-20,15-30,2-12,2-15,2-3,2-8,2-9,3-5,4-5,7-9,8-13,acute,angled,apex,branched,calyx,chartaceous,cm,color,densely,diameter,distally,forked,fruit,globose,lobe,margin,mm,moderately,narrowly,ovate,pedicel,pedicellar,peduncle,petiole,pore,puberulent,pubescent,purple,purplish,rachi,radiu,remnant,reticulate,shrub,simple,small,sparsely,stellate,stigma,style,subcoriaceous,tree,triangular,truncate,tube,unknown,whitish,x,yellow	-2.5,1-1.5,10-15,2,20-50,3-4,3-foliat,4-25,5-20,6-37,abaxially,absen,acuminate,adaxiall,adaxially,aggregate,apart,articulated,axe,base,blade,cell,connivent,cordate,cylindrical,deeply,directed,distall,eaf,eed,eglandular,entire,flower,glabrous,glandular,hair,inflated,leaving,like,lon,long,lower,nearly,nflorescence,nther,obtuse,orolla,pubescen,ripe,ruit,spaced,ste,stone,tal,tem,time,tip,truncat,unbranched,unit,usually,vary,wide,ympodial	2-2.5,abaxial,adaxial,anther,arrangement,colour,corolla,direction,form,growth,height,history,inflorescence,leaf,length,life,na,ovary,perennial,plant,position,reproduction,seed,shape,spacing,surface,texture,width
302	wfo-0001027920	success	228	120	96	132	24	0.421	-25,0.1-0.5,0.5-1,1-2,1-2.5,1-4,1.4-2.5,1.5-3,1/5-1/3,11-28,12-18,2-5,2-7,2-8,20-40,25-45,3-5,3.5-4,3.5-4.5,4-10,4-11,5-7,7-11,7-18,8-12,8-18,acicular,acute-tipped,almost,anther,apart,base,black,blade,bristly,bristly-hirsute,broadly,brown,campanulate,cauline,cm,dark,deltoid,densely,diameter,ellipsoidal,extra-axillary,flower,fruit,hair,hirsute,indument,inflorescence,lanceolate,lateral,leaf,length,lenticular,lobe,midpoint,minutely,mm,narrowly,oblong,obovoid,orange,outline,ovate,pedicel,peduncle,perennial,persistently,petiole,pitted,prickle,prickly,pubescent,rachi,ray,simple,singled-stemmed,small,smaller,stellate,stellate-pubescent,stem,stigma,style,surface,thin-textured,tree,tube,unbranched,white,x,yellow	-3,.1-1.4,0.1-0.2,0.2-0.8,12-25,17-25,2-,2-foliate,4-6,4-7,4-locular,4.5-7,8-30,abaxially,acute,acute-,adaxiall,adaxially,along,apex,appressed,approximately,articulated,ascending,attenuate,axe,ba,basally,bristle-like,broad-based,bulbou,calyx,capitat,class,close,coarsely,concealed,concentrated,connivent,cylindrical,dentate,depressed-deltoid,descending,directed,distal,distall,distinct,divergently,eaf,eed,elongate,enlarging,entire,equaling,erect,female-sterile,few-branched,flesh,frui,geminat,glabrous,green,inserted,interlobal,intermixed,large,larger,less,lignescent,locule,long,long-stalked,longitudinal,lower,major,margin,minute,much,multiseriate,nearly,nflorescence,obtuse,obtuse-tipped,occasionally,often,one,orolla,ovate-lanceolate,pair,per,persistent,pore,principal,proliferation,radiu,receptacular,recurved,rigid,ripe,ruit,scattered,section,sessile,short,side,similar,sinus,spaced,sparse,spreading,stalk,stalked,stella,stellae,swollen,tal,tamen,tawny,tem,termination,time,trichome,truncate,two,unit,usually,vary,vein,vestitur,weakly,wide,ympodial	abaxial,adaxial,arrangement,capitate,color,corolla,filament,form,growth,height,history,life,na,ovary,plant,position,reproduction,seed,shape,spacing,staman,texture,tip,width
303	wfo-0001027929	success	193	81	62	131	19	0.321	1,1-10,10,2.0-3.0,3.5-5,4-5,5-lobed,6-15,along,angular,branched,cm,color,corolla,cyme,deep,diameter,dichasial,dichasially,distal,ebracteate,elliptic,except,flower,glabrous,globose,green,green-white,hair,half,herbaceous,honeycomb,lanceolate,middle,mm,monochasial,mucilaginous,narrowly,occasional,odd-pinnate,ovate,ovoid,pattern,pedicel,peduncle,perennial,plant,puberulent,purple,rhizomatous,rotate,seed,shape,spot,stigma,style,symmetrically,terete,vein,violet,violet-blue,yellow	0.2-0.9,1-4,1-8,1.0-1.3,1.5-4,15,2,2-3,20,3-6-foliat,35,4-30,4-6,5-10,5-6,abaxially,acumen,acuminate,acute,adaxially,apex,apical,apically,apiculate,articulate,ba,basal,base,becoming,beyond,calyx,caudate,cell,cente,center,clasping,coat,connate,cordate,covering,cuneate,dark,darker-violet-blue,decreasing,dehiscent,digestion,eaf,eed,embryo,emoval,enzyme,erect,exceeding,filament,forked,formed,generally,globo,hair-like,included,interjected,introrse,lateral,leaflet,light,living,lobe,lon,long,lower,make,maturing,mostly,nearly,nflorescence,nther,obliquely,oblong,often,orolla,pair,pentagonal,perfect,petiolate,petiolulate,petiolule,poricidally,purpl,radiating,rarely,reduced,reveal,rhizome,rotate-,rounded,ruit,semi-lunate,sessile,seudostipule,short,size,slightly,slit,sometimes,somewhat,specimen,stamen,star,ste,straight,subequal,tem,terminal,testal,thick,tinged,tip,trailing,typically,unbranched,unit,usually,vary,visible,wall,white,wid,wide,wider,without,ympodial	anther,arrangement,form,fruit,growth,height,history,inflorescence,leaf,length,life,ovary,petiole,position,reproduction,rotate-pentagonal,stem,surface,texture
304	wfo-0001027930	success	210	86	68	142	18	0.324	-2,0,0-0.5,0-0.7,0.2-0.4,0.4-1,0.4-1.5,15-60,2-10,2-2.5,3-3.6,3.5-5.5,4.5-6.5,6-13,9-13,adult,anther,branch,brown,chartaceous,cm,decimetre,densely,diameter,dm,extra-axillary,filament,fruit,glabrous,gland-tipped,globose,green,grey,hair,inflorescence,juvenile,lanceolate,leaf,length,lilac,linear,linear-hastate,longer,mm,pale,pedicel,peduncle,per,petiole,plant,prickle,rachi,red,scattered,short,simple,sparsely,stellate,stellate-pubescent,stigma,style,time,unbranched,white,wide,x,yellow,yellowish	%,.1,.4,0-0.8,0-1,0-2,0-4,0.05-0.7,0.2-0.7,0.2-1.2,0.25-0.35,0.25-0.4,0.3-0.5,0.4-0.8,0.5-0.6,0.5-1,0.6-0.9,0.7-1.5,0.8-1.2,1-2,1-4,1-locular,13-16,2-3,2-6,2-9,2-foliate,3-12,3-7.5,4-,4-8,5-merou,6-12,6-8,7-12,7-8,8-20,9-26,abaxially,absen,absent,acicular,across,acute,adaxiall,adaxially,alyx,and/or,andromonoecious,apart,apex,apparen,articulated,axe,ba,basal,base,blade,branche,calyx,capitat,confined,connivent,cuneate,cylindrical,deltate,directed,distall,distributed,eaf,eed,eglandular,entire,erect,exocarp,finger,flower,fruiting,functional,geminat,half,hastate,heterostylous,homo-,incomplete,interpetalar,juicy,lamina,lateral,less,lobe,long,loosely,lower,margin,mature,mesocarp,mid-point,midpoint,midrib,midvein,minute,moderately,narrowly,nflorescence,oblique,obtuse,orolla,part,perennial,perfect,placenta,pore,porrect,present,ray,rhizomatous,rostrate,ruit,septum,sessile,shrub,spaced,sparse,stellae,straight,strongly,succulent,tal,tamen,tem,thick,throughout,tissue,triangular,tube,unarme,unarmed,unit,vary,weakly,ympodial	abaxial,adaxial,arrangement,capitate,colour,corolla,density,height,ovary,position,seed,shape,staman,stem,surface,texture,thicknes,width
305	wfo-0001027943	success	208	130	100	108	30	0.481	-4,0.2-2,0.5-1,0.5-1.5,0.5-4,1-1.5,1-3,1-4,1-5,2-10,2-3,2-3-lobed,3-15,5-9,7-10,abaxially,acute,adaxially,andromonoecious,anther,apex,base,broad-based,brown,brownish,cm,coarsely,curved,cylindrical,densely,diameter,elliptic,elliptic-ovate,entire,extra-axillary,ferruginous,filament,flattened,flower,forked,fruit,glabrescent,glabrous,glandular,globose,green,hair,inflorescence,interpetalar,leaf,major,margin,mature,membanaceous,midpoint,minutely,mm,moderately,nearly,oblique,often,outline,pedicel,peduncle,pericarp,petiole,plant,prickle,pubescent,rachi,rarely,ray,reniform,ripe,rounded,rugulose,shallowly,shrub,simple,smooth,somewhat,sparsely,stellate,stellate-pubescent,stigma,straight,strongly,style,surface,tan,tissue,truncate,turning,unbranched,vein,white,whitish,x,yellow,young	-1.5,.1,.5,0,0.3-0.5,0.5-6,0.8-1.5,1.5-3,10-15,2-14,2-2.5,2-4,3-20,3-8,4-20,4-6,4-7,5-8,5-merou,6-.,7-15,accrescent,ag,alyx,apart,armed,articulated,axe,ba,berry,blade,broad,calyx,capitat,chartaceous,connivent,covering,difoliate,directed,distally,eaf,eed,equal,erect,free,frui,fruiting,geminat,gland-tipped,half,heterostylous,homo-,initially,interspersed,interwoven,like,linear-acuminate,linear-apiculate,lobe,long,longitudinal,lower,midline,midrib,narrowly,nflorescence,numerous,obtuse,opening,orolla,part,perfect,pore,porrect-stellate,recurved,reflexed,ruit,sessile,short,short-stalked,side,sinus,slightly,slit,small,spaced,sparse,splitting,staminate,stem,subtending,tamen,tapered,tem,thi,time,tip,tissu,toward,triangular,tube,unarme,unarmed,unit,vary,wide,woody,ympodial	0.1,5,5-merous,6-8,abaxial,adaxial,arrangement,capitate,color,colour,corolla,form,growth,height,history,length,life,na,number,ovary,perennial,position,reproduction,seed,shape,spacing,staman,texture,thicknes,thin
306	wfo-0001027944	success	175	105	77	98	28	0.44	0-0.3,0-4,0.2-0.3,0.25-0.4,0.4-0.8,0.5-0.8,0.5-1.2,1-1.2,1-2,1.5-2,15-23,3-20,3-4.5,3-5,4-7,5-7,acicular,acute,anther,apex,articulated,base,brown,calyx,chartaceous,cm,cuneate,deltate,densely,diameter,dm,entire,extra-axillary,flower,fruit,fruiting,glabrous,globose,green,hair,half,index,inflorescence,lanceolate,lavender,length,less,lobe,lobed,lobing,margin,mature,mid-point,mm,ovate,pale,pedicel,peduncle,per,perennial,petiole,prickle,pseudo-racemose,red,rhizomatous,rusty,shallowly,shrub,stellate,stellate-pubescent,stigma,style,tube,unbranched,white,yellow,yellowish	%,.8,0.1-0.2,0.2-0.4,0.3-0.4,0.4-0.5,0.5-1,0.9-1.2,1-3,1-locular,13-16,2-3,2-4.5,2-6,2-foliate,2.5-5.2,3-3.5,3-4,3-7,5-merou,7-20,7-8,7.5-14,abaxially,absen,absent,across,adaxiall,adaxially,adult,alyx,apart,apparen,axe,ba,blade,branche,capitat,confined,cylindrical,directed,distall,eaf,eed,eglandular,erect,exocarp,finger,geminat,gland-tipped,incomplete,juicy,lamina,lateral,long,longer,lower,mesocarp,midpoint,midrib,minute,nflorescence,oblique,obtuse,orolla,part,perfect,placenta,pore,porrect,present,ray,ruit,septum,sessile,short,side,simple,spaced,stage,stellae,straight,succulent,tal,tamen,tem,thick,throughout,time,unarme,unarmed,unit,unknow,uvenile,vary,wide,x,ympodial	5-merous,abaxial,adaxial,articulation,capitate,color,colour,corolla,density,filament,form,growth,height,history,leaf,life,na,ovary,plant,position,reproduction,seed,shape,staman,stem,surface,texture,thicknes
307	wfo-0001027948	success	186	103	73	113	30	0.392	0.5-0.7,0.5-2,1-1.2,1.3-1.8,1.5-4.5,3.7-4,5-,7.5-10,8-celled,abaxially,abundant,acuminate,adaxially,aggregate,anther,antrorse,apex,attenuate,base,branch,calyx,campanulate,cell,cm,corolla,diameter,elliptical,filament,flexuous,fruiting,generally,glandular,globose,herb,herbaceous,lamina,leaf,length,light,long-stalked,margin,midvein,mm,narrow,narrowly,non-glandular,ovate,ovoid,patent,pericarp,petiole,pubescence,pubescent,purple,secondary,seed,serrulate,simple,sinus,slightly,small,stem,stigma,stone,style,sub-shrub,tip,trichome,unequal,vein,violet,viscid-pubescent,x	-15,-16,-6,.5,0-,0.4,0.6,0.8-,1-2,1.2-2.2,1.6,1/10,10-14,13,14,2-,2.2-,2.5-,3-8.2,3.2-5.2,3.5,5,6-celled,7,7-15,accrescen,ag,ape,articulate,ature,basal,berry,bicellular,c.,connectival,crushed,cuticle,dark,delicate,diamete,difoliate,directed,dorsally,eaf,edentate,ellipsoidal,erect,finely,fragrance,free,glabrous,head,hig,hollow,ill-smelling,inconspicuous,inserted,lobe,long,longer,longitudinal,longitudinally,lower,many-,near,occasionally,odorles,opening,orolla,pair,papillate,pore,poricidal,portion,prolongation,reduced,ree,ridged,ruit,saddle-shape,scarce,scarcely,seeded,seen,separated,short-stalked,shorter,single-celled,slit,smooth,solitary,spur-like,stalk,straight,striat,striate,sub-opposite,tem,thecae,thickened,time,tooth,triangular,tube,twice,unit,upward,vary,ventrifixed,verrucate,ympodial,¼,½	abaxial,accrescent,adaxial,arrangement,color,colour,flower,form,fruit,growth,height,history,inflorescence,life,na,ovary,pedicel,peduncle,perennial,plant,position,rachi,reproduction,saddle-shaped,shape,spacing,staman,surface,texture,width
308	wfo-0001027961	success	177	104	76	101	28	0.429	.5,0.5-1,1-1.5,1-5,2-2.5,2.3-2.5,3-3.5,4.5-5,7-9,8-10,?,abaxially,acute,adaxially,anther,apex,base,berry,branched,c.,clavate,cm,cordate,corolla,curling,densely,diameter,elliptic,fading,filament,flower,fruiting,glabrous,globose,green,growth,immature,inflorescence,lateral,lobed,long,many,midrib,mm,obovate,occasionally,pair,pedicel,peduncle,petiole,pinnatifid,pubescent,purple,reddish,rotate-stellate,simple,slightly,sparsely,stem,stigma,style,surface,terminal,time,triangular,truncate,twining,vein,vine,violet,way,white,white-pubescent,woody,x,yellow	0.25,0.25-0.5,0.9-1,1,1-3,1-4,1-9,10-50,2.5-9,5-8,5-merou,6-9,<,adaxiall,age,always,alyx,anthesi,apar,ark,articulated,asymmetric,axil,broadly,brow,calyx,clear,conical,connivent,deltate,distributed,eaf,early,eed,ellipsoid,entire,equalling,exserted,free,fusiform,geminat,ilament,irregularly,lamina,lengthening,lobe,lon,loosely,lower,margin,mature,maturity,membranous,minute,minutely,new,nflorescence,observed,often,older,one,orolla,other,papillo,pendan,perfect,pericarp,pinched,planar,plurifoliate,pore,poricidal,portion,present,primary,probably,pubescen,ruit,scar,shiny,sleeve,slender,slit,small,spaced,spreading,tem,thin,tip,transition,trichome,tube,tuft,twinin,ud,unequal,uniseriate,unit,upper,vary,ympodial	abaxial,adaxial,apart,arrangement,bark,brown,color,colour,form,fruit,height,history,leaf,length,life,na,ovary,pendant,plant,position,rachi,reproduction,seed,shape,spacing,staman,texture,width
309	wfo-0001027965	success	265	135	114	151	21	0.43	.2,.3,.9,0.1-0.2,0.4,0.5,0°,1.2,1.5-2,2-2.5,3.5,4-7,abaxial,abaxially,acuminate,acute,adaxial,adaxially,along,ame,anther,apex,armed,base,berry,branch,branched,brown-green,c.,capitate,chartaceous,clavate,clustered,cm,cordate,corolla,covered,densely,development,diameter,discolorous,distributed,drying,dull,equal,evenly,extending,fasciculate,filament,finely,flat,flattened,flower,fruit,fruiting,glabrous,green,grey-brown,indumentum,inside,lateral,leaf,length,liana,lobed,midpoint,midvein,mixture,mm,oblique,oblong,orange,orange-brown,outside,ovate,pair,pale,pedicel,peduncle,petiole,pitted,porrect,primary,pubescent,rachi,raised,ray,red-brown,reniform,rounded,scar,sessile,shiny,shrub,small,somewhat,spheroidal,stalked,stellate,stellate-pubescent,stigma,stump,style,surface,throughout,tip,toward,translucent,trichome,unequal,vein,white,wrinkled,x	-2,.1,.25,.5,.7,/3,0.15,0.15-0.3,0.2,0.3,0.4-0.5,0.5-3,0.6-0.9,0.8-1.6,1,1-2,1-8,1.5-2.5,1.5-3.2,1/3-1/4,1/3-2/3,1/4-1/3,2-3,2-3.5,2-4,2.2-2.6,2.8-3.3,3.5-10,4-merou,4.5,6-9,7-8,absent,accrescent,acicular,adjacent,age,almost,alternate,alyx,anthesi,apar,ape,apically,apparently,articulated,bark,becoming,beneath,brown,calyx,canaliculate,cupular,curved,deltoid,dense,density,detaching,divided,dry,eaf,early,eed,ellipsoi,elongated,entire,erect,even,except,fairly,filiform,fissure,flexuous,forming,free,glabrescent,increasing,leave,lengt,lengthening,less,like,lobe,long,loop,lower,m.,main,mature,maturity,minor,nflorescence,nther,obconical,occasional,often,orolla,papillose,patch,pendulous,perfect,pericarp,pit,plurifoliat,pore,poricidal,portion,present,prickle,protruding,reduced,regular,remnant,ridged,ruit,series,short,simple,sinus,smooth,sometimes,sparse,sparsely,spreading,stalk,stem,straight,strongly,tapering,tearing,terete,tertiary,thin,transverse,tube,ud,unarme,unarmed,underneath,uneven,unit,usually,variable,vary,venation,visible,wide,widening,ympodial,young,youngest	0.5-1.6,4-merous,angle,arrangement,color,colour,form,growth,height,inflorescence,na,number,ovary,plant,position,reproduction,seed,shape,spacing,staman,texture
310	wfo-0001027966	success	207	111	81	126	30	0.391	1-10,1-2,1-4.2,1-5,10,10-30,2.2-2.9,3-4,4,40-80,5-6,abaxially,absent,acuminate,adaxially,along,anther,apex,base,bead,blue-violet,cell,chartaceous,cm,conical,corolla,densely,diameter,elliptic,filament,flower,forked,fruit,glabrous,green,greenish,hair,herb,honeycomb-shaped,interjected,leaf,leaflet,lengthening,light,like,medium,membranous,minute,mm,moniliform,mucilaginous,necklace,odd-pinnate,ovate,ovoid,pedicel,peduncle,pentagonal,petiole,petiolule,plant,pore,pubescent,purple,rarely,rotate,seed,sessile,slightly,slit,stem,stigma,stolon,subsessile,terminal,testal,tuber,usually,wet,whitish,yellow	0.4-0.5,0.7-3,0.8,0.8-2.5,1-1.8,1-3,1.2-4.5,1.3-2.2,1.5-3,1.5-5.2,2.5-10.5,2.8-9,3-5,3-7,5-10,5-9.5,5-merou,5.5-14,6-11,acumen,ag,alyx,apart,apparently,arranged,articulated,asymmetrical,attenuate,axe,axillary,basiscopic,berry,blade,brownish,bud,capitat,ciliate,commonly,condition,connivent,covering,decreasing,digestion,distal,dorsally,drying,eaf,edge,eed,enzyme,erec,especially,exceeding,flat,folded,fresh,geminat,generally,glabrou,gradually,green-white,hair-like,half,homostylous,lanceolate,larger,lateral,less,living,lobe,long,lower,make,margin,middle,mottled,multiple,narrow,nflorescence,orbicular,orolla,pair,pale,perfect,plurifoliate,poricidal,proximal,ray,removed,ripe,ruit,secondary,semierect,seudostipule,shorter,side,size,somewhat,spaced,sparsely,specimen,stamen,ste,straight,subequal,subtending,symmetrical,tall,tamen,tem,thick,throughout,tip,tissue,tri-,tube,tyle,typically,unit,violet,wall,white,wide,wing,x,ympodial	abaxial,adaxial,age,arrangement,capitate,color,colour,form,growth,height,history,inflorescence,length,life,mucilaginousnes,na,ovary,perennial,position,presence,pseudostipule,rachi,reproduction,shape,spacing,staman,style,surface,texture,width
311	wfo-0001027978	success	197	120	106	91	14	0.538	0.2-0.5,0.5-1,0.5-1x,1-1.5,1-2,1-6,1.5-2.5,1/6,10-14,2-3,2.5-5.5,3-5,4-10,4-6,5-8,6,7-10,abaxial,abaxially,absent,acute,adaxial,anther,apex,asymmetrical,attenuate,base,becoming,brown,chartaceous,cm,connivent,cut,dark,densely,diameter,entire,extra-axillary,filament,flower,fruit,functionally,glabrous,globose,green,hair,hermaphroditic,immature,initially,leaf,length,less,lilac,lobe,lobed,major,male,many,margin,mature,midrib,midvein,mm,moderately,nearly,netlike,obtuse,occasionally,orange,orange-red,ovary,ovate,pedicel,peduncle,per,petiole,pit,porrect-stellate,prickle,pubescent,rachi,raised,recurved,ridge,roselike,round,scattered,separated,side,simple,sinus,small,stellate,stem,stigma,style,surface,tan,tapering,unbranched,vein,way,white,wide,x,yellow	1,1-3,1.5,11,2-2.5,2.5-3,20-40,3-6,4-5,4-8,6-10,7-9,8-12,absen,accrescent,adaxially,along,alyx,andormonoeciou,andromonoecious,apar,apical,apparently,armed,axe,berry,beyond,blade,calyx,cordate,cylindrical,difoliate,directed,discolorous,distal,eaf,eed,either,end,except,exserted,filiform,flattened,frui,fruiting,geminate,glabrou,gree,heteromorphic,introrsel,like,long,lower,midpoint,midvei,multicellular,multiseriate,narrowly,nflorescence,often,orolla,pair,plant,pore,proximal,ray,reflexed,ruit,scandent,short,shrub,slightly,spaced,sparsely,stalk,stamen,staminate,ste,straight,tamen,tem,thin-skinned,triangular,tube,unarmed,unequa,unicellular,unit,vary,vegetatio,ympodial	apart,armament,arrangement,color,colour,corolla,inflorescence,number,position,seed,shape,spacing,staman,texture
312	wfo-0001027997	success	174	117	87	87	30	0.5	.2,.5,.6,0.2-2,0.9-1,1-2,1-4,1.5-1.7,1.5-2,acute,anther,apex,attenuate,auriculate,bark,base,becoming,bi-lobed,black,bright,brittle,cm,corky,corolla,deltoid,dense,densely,dirty,dry,filament,glabrous,globose,green,greenish-yellow,inflorescence,later,leaf,live,lobe,lobed,long,long-acuminate-triangular,long-ellipsoid,minutely,mm,obovate,occasionally,onto,opposite,ovary,ovoid,ovoid-reniform,pale,pedicel,petiole,pitted,plant,pore,pubescent,raised,ripe,scar,scattered,shaped,shrub,simple,small,soft,somewhat,soon,sparsely,specimen,stem,stigma,strongly,style,surface,tan,tear-drop,tree,trichome,tube,ultimately,uniseriate,white,wing,winged	.1,0.1-0.7,0.1-0.8,1,1.5-1.8,10-20-flowered,10-23,2,3.5-10,7-10,7/8,abaxially,along,anthesi,apar,ba,beneath,berry,blade,breaking,calyx,consisting,decurrent,deflexed,denser,dia,distal,eaf,edicel,eed,entire,erect,even,evenly,exserted,free,fruiting,glabrate,impressed,inflorescenc,keel,keeled,lateral,like,living,lower,main,margin,middle,nflorescence,often,old,older,pair,papillose,partially,planar,poricidal,portion,prominent,pubesent,reddish-brown,remaining,rest,ribbed,ruit,sessile,short,slender,slightly,spaced,straight,tall,tapering,tip,trunk,ud,unifoliat,unit,vasculature,vein,way,widest,woody,x,ympodial,young	abaxial,adaxial,apart,arrangement,bud,color,colour,diameter,flower,form,fruit,growth,height,history,length,life,na,peduncle,perennial,position,pubescence,rachi,reproduction,seed,shape,spacing,staman,texture,unifoliate,width
313	wfo-0001028014	success	222	115	89	133	26	0.401	-15,-2.5,0.15,0.2-0.4,0.2-1,0.2-1.6,0.5-1,0.5-1.5,0.7-1,0.9-1.2,1-3,1-4,1.3-2.4,3-10,4.5-7,5-merous,abaxially,almost,anther,apart,apex,bark,base,berry,black,brown,brown-green,cell,cm,cordate,curved,densely,diameter,filament,flattened,flattened-reniform,flower,fruit,glabrous,gray,gray-green,lateral,leaf,length,lobed,margin,maturity,mauve,mm,moderately,obtuse,occasionally,orange,outline,ovate,pale,pedicel,peduncle,petiole,pit,porrect,prickle,purple,raised,red,reflexed,rough,rounded,seed,sessile,shiny,shrub,simple,smooth,spherical,stalked,stellate-pubescent,stem,straight,strongly,style,surface,terete,terminal,trichome,visibly,weakly,yellow,yellow-green	-0.5,-1,-1/2,-10,-3,-4,-5,-6,.5,/5,0,0.1-0.2,0.15-0.3,0.2,0.25,0.3-0.4,0.5,0.5-2,0.5-3,0.6-0.9,0.7-1.6,1-,1-10,1-2,1.5,1.5-2,1.8-3,1/4,1/4-2/3,2,2-20,2-3,2-4.5,2-6.5,2.5-4,4-10,6-10,6-11,acuminat,alyx,ame,apar,apically,apparently,around,articulated,blade,branched,broad-deltate,c.,calyx,chartaceous,concolorous,connivent,decurrent,deltate,difoliate,discolorous,distance,drying,eaf,edge,eed,elongating,equal,erect,extending,eye,free,fruiting,geminat,glabrescent,glabrou,gland,globular,herbaceous,infructescence,lobe,lon,long,longer,lower,mature,membranous,midpoint,midvein,naked,nflorescence,older,one,open,orange-gra,orolla,oung,outer,pair,pendulous,per,perfec,pericarp,poricidal,portion,prickl,prickly,primary,ray,reduced,ruit,scandent,scar,shorter,side,slender,sometimes,spaced,spreading,stalk,stellate,tamen,tapering,tertiary,time,tip,tube,unit,vary,vein,venation,visible,way,wide,winged,ympodial	abaxial,adaxial,arrangement,color,colour,corolla,form,growth,height,history,inflorescence,life,orange-gray,ovary,perennial,plant,position,rachi,reproduction,shape,spacing,staman,stigma,texture,unknown,width
314	wfo-0001028017	success	158	104	73	85	31	0.462	0.3-1,1-10,1-2,1-3,1.5-2,15-35,2-4,2.5-5,3-12,3-4,5-7,6-7,6-8,acuminate,acute,apex,brown,calyx,chartaceous,clavate,cm,connective,cream,densely,diameter,eglandular-puberulent,eglandular-pubescent,ellipsoidal,elliptic,flattened,forked,fruit,fusiform,glabrous,glandular-,glandular-puberulent,green,immature,lanceolate,margin,mm,moderately,narrowly,ovate,ovoid,pedicel,peduncle,perfect,petiole,purple,purplish,rachi,radiu,rarely,remnant,ripe,short-acuminate,simple,sparsely,stellate,stellate-campanulate,stigma,style,subcoriaceous,tan,thecae,tomentose,tree,truncate,unbranched,white,x,yellow	-2.5,1,10-22,13-40,15-50-flower,2,2-3,3,3-14,3-foliat,40-50,5,5-9,9-11,abaxially,absen,absent,adaxially,aggregate,apart,ape,apiculate,articulated,axe,basal,base,beyond,blade,cell,ciliat,connivent,cuneate,cylindrical,directed,distally,eaf,eed,eglandular,entire,exceeding,exserted,fleshy,flower,glandular,greenish,hair,introrse,leaving,lobe,lon,long,lower,near,nflorescence,nther,oblique,obtuse,orolla,pedicellar,pointed,pore,puberulen,pubescent,ruit,shorter,slightly,small,sometimes,spaced,stamen,stone,tal,tem,time,tip,triangular,truncat,tube,ud,unit,vary,vein,wide,without,ympodial	1-2.5,abaxial,adaxial,anther,arrangement,bud,ciliate,color,colour,corolla,form,growth,height,history,inflorescence,leaf,length,life,na,ovary,perennial,plant,position,puberulent,reproduction,seed,shape,spacing,surface,texture,width
315	wfo-0001028025	success	182	117	87	95	30	0.478	.8,0,0-0.5,0.1-2.2,0.15-0.25,1-1.4,1.1-1.4,1.6-3.5,10-140,12-17,16-23,2-2.3,2-6,2.5-4,4-10,5-11,7-13,absent,acicular,acute,adaxially,anther,apex,base,broad-based,chartaceous,cm,cordate,diameter,erect,exocarp,extra-axillary,flower,fruit,glabrous,globose,green,index,inflorescence,juicy,lateral,lavender,length,lobed,lobing,long,longer,margin,mesocarp,midpoint,mm,moderately,moist,obtuse,ovate,pale,part,pedicel,peduncle,per,perennial,petiole,placenta,porrect,present,prickle,pseudo-racemose,ray,rhizomatous,sessile,shallowly,shrub,sparsely,stalked,stellae,stellate,stellate-pubescent,stem,straight,style,throughout,time,unbranched,white,wide,yellow,yellowish-green	%,0-11,0.2-0.3,0.2-0.7,0.3-0.8,0.3-1,0.4-3,0.5-0.7,0.9-1.2,1-8,1.4-2.2,1.5-7,1.9-2.4,11-18,13-21,2-locular,3-5,3-6,3.5-4.5,4-8,5-,5-20,5-7,50-90,6-,6.5-10,7-8,7-9,9-14,abaxially,absen,across,adaxiall,alyx,anvil-shape,apart,armed,articulated,attenuate,axe,ba,blade,brown,calyx,cross-section,cylindrical,d.,directed,distall,distributed,dult,eaf,eed,eglandular,finger,fruiting,gland-tipped,hair,half,hig,lamina,less,lobe,lon,lower,mature,merou,mid-point,midvein,minute,nflorescence,oblique,onl,orolla,perfect,pore,ridged,ruit,short,side,simple,spaced,stage,tamen,thick,transparent,tube,unarmed,unit,unknow,uvenile,vary,vein,x,ympodial	abaxial,adaxial,anvil-shaped,color,corolla,density,dm,filament,form,growth,height,history,leaf,life,moisture,na,ovary,plant,position,reproduction,ridging,seed,shape,staman,stigma,surface,texture,thicknes,unknown,width
316	wfo-0001028033	success	157	93	71	86	22	0.452	.6,1.4–1.8,2–4,3,3–5,4–12,4–5,50,6–12,acuminate,acute,anther,apex,attenuate,brochidodromous,brown,calyx,cell,chartaceous,ciliate,cm,cylindrical,cyme,darker,deeply,densely,diameter,discolorous,drying,elliptic,entire,eye,few-branched,filament,flower,glabrescent,glabrous,green,growth,herb,hispid-pubescent,lateral,length,light,like,lobed,margin,membranaceous,midrib,mm,naked,oblong,pedicel,perfect,petiole,pubescence,rhizomatous,sessile,simple,slightly,solitary,stellate,stem,stigma,straight,style,surface,trichome,unbranched,venation,visible	1.5,1–4,1–5,2–3,2–foliate,3–11,3–4,5-merou,5–7,abaxially,adaxiall,adaxially,along,alyx,anthesi,ark,ascending,base,becoming,blade,branch,capitat,connivent,contiguou,cordate,decurrent,denser,directed,eaf,eed,emarginate,equal,florescence,fruit,geminat,greenish,high,introrsely,know,known,linear-lanceolate,lobe,long,longitudinal,lower,mainly,nearly,new,older,onto,opening,order,orolla,ovate-lanceolate,pore,poricidal,prominent,prostrat,pubescent,recurved,ruit,secondary,shin,shiny,shorter,shrub,slit,sparsely,spreading,strongly,subapical,tamen,tem,tube,uniseriate,unit,unknown,upright,vary,vein,white,wide,woody,yellow,ympodial,×	5-merous,arrangement,bark,branching,capitate,color,corolla,count,discoloration,form,height,history,inflorescence,leaf,life,ovary,plant,shape,staman,texture,visibility,width
317	wfo-0001028035	invalid_json_followup	172	92	49	123	43	0.285	1,1.3-1.8,1.5,1/4-1/3,3-6,4.2-5.5,annual,anther,blade,brown,calyx,capitate,cm,dark,deep,diameter,flattened-ovoid,flower,foveolate,fruit,glabrous,herb,hilum,internodal,leaf,long,minutely,mm,notch,oblong,ovate,pedicel,pentagonal,petiole,pinnatifid,prickle,reticulately,seed,slightly,spherical,stellate-pubescent,stem,stout,sunken,surface,twice,undulate,wrinkled,yellow	2,2.5-3.1,2.5-4,2/3,3,3.7-4.2,4-8,5,5-10,50-90,6-13,7-10,7-10-flowered,9-13,accrescent,acicular,across,almost,along,alyx,ample,anthesi,apically,armed,base,berry,bristle,bristly,broad,broad-based,broadly,campanulate,cauline,closely,confluent,congested,da,dark-based,densely,developing,dia,difoliate,distinct,divided,dry,eaf,erect,exceeding,externall,felty,flattened,geminat,hardly,incurved,interpetalar,invested,lanceolate,lobe,lon,long-rayed,m.,main,markedly,maturity,midpoint,n,narrowly,nflorescence,noticeably,numerous,often,one,orolla,other,per,pigmentation,plicate,prickly,prominent,purple,ray,reaching,recurved,red,rounded,ruit,scattered,short,shorter,slende,sometimes,somewhat,spaced,splitting,spreading,stalk,stellae,stellate,stellate-wooll,styl,suffused,symmetrically,tall,tamen,tapering,taprooted,terminal,tightly,tigma,tissue,tub,tube,tyle,ultimate,unit,upper,usually,vary,vein,well,wide,yello,ympodial	'',[,``,abaxial,adaxial,apex,arrangement,bark,bud,characteristic,color,colour,corolla,filament,form,fruiting,growth,height,history,inflorescence,length,life,margin,na,new,ovary,peduncle,plant,position,rachi,reproduction,scar,shape,spacing,staman,stigma,style,texture,trichome,value,width,{,}
318	wfo-0001028044	invalid_json_followup	195	120	86	109	34	0.441	-5,0.3,1.2-1.4,1.3-2.2,1.4-1.6,1.5-2,16,2-3,2-4,2.7-4,2.8-3.3,20-21,3-4,3-6,3.5-4.6,6-8,6.5-7.2,abaxial,anther,apex,attenuate,base,berry,black,branch,branched,calyx,cm,corolla,creamy,dark,diameter,drying,entire,filament,fleshy,flower,fruit,glabrous,globose,green,greenish,hair,lateral,leaf,length,lobe,lobed,long-attenuate,main,many,margin,midrib,mm,multangulate,oblong,obovate-elliptic,ovate-lanceolate,pale,pedicel,peduncle,petiole,porrect-stellate,pubescent,rachi,rough-granular,seed,shrub,side,simple,sparse,sparsely,stellate,stigma,style,subcampanulate,surface,terete,thin-textured,time,tube,vein,white,x,yellow,yellow-brown	-3.5,.6,.9,0.4-0.5,1/3-1/2,11-13,11-16,19-22,3.4-4.3,31-46,4-5,5-merou,50,7.5-9,9.5-13,abaxially,accrescent,acute,adaxiall,adaxially,ag,along,alyx,anthesi,apart,around,articulated,ature,axe,axillary,becoming,blade,blunt-tipped,brown,bud,bulbous-based,capitat,closely,concentrated,connivent,cylindrical,decurrent,dendritic,directed,distally,eaf,edge,except,exserted,few-rayed,frui,fruiting,geminate,glabrate,glabrescen,high,homostylous,immature,lackin,lengthening,long,long-stalked,longitudinal,lower,moderately,mostly,much,multangulat,nearly,nflorescence,obscured,obtuse,occur,orolla,plurifoliate,pore,poricidal,presumably,rather,resorption,ruit,runk,semi-obtuse,slender,slit,somewhat,spaced,stalked,stamen,suture,tamen,thick,thick-stalked,tip,tissue,tomentose,tomentu,unarme,unbranched,unit,unknown,vary,way,weakly,wide,winged,yellowish,ympodial,young	'',0.6,3,4.9,[,``,adaxial,arrangement,capitate,characteristic,color,colour,form,glabrescent,growth,height,history,inflorescence,life,na,ovary,perennial,plant,position,reproduction,shape,spacing,staman,texture,trunk,value,width,{,}
319	wfo-0001028046	success	186	99	76	110	23	0.409	0.2-0.3,0.3-0.5,0.5-1,1-1.3,1-1.5,1-7,10-15,12-13,2-3,2.5-3,3-12,4-5,8-9,abaxially,acute,anther,apex,attenuate,bark,berry,blue,brown,chartaceous,clavate,cm,compressed,corolla,dark-brown,densely,diameter,elliptic,filament,flower,fruiting,globose,grayish,green,growth,inflorescence,leaf,length,lilac,mm,new,obovate,opposite,ovary,pedicel,peduncle,per,petiole,prickle,pubescent,red,reniform,rusty,rusty-red,scabrous,scar,shrub,simple,slightly,spaced,sparse,stellate,stem,stigma,style,sub,subglobose,surface,tomentose,trichome,truncate,unevenly,yellow	0.4-0.5,1-multicellular,1.2-1.5,1.5-2,10,13-38,2-4,20,5-18,6-7,acuminate,adaxially,anthesi,approximately,armed,articulated,basal,base,c.,calyx,campanulate,coriaceous,cylindrical,decurrent,deflexe,denser,difoliat,distal,eaf,eed,entire,erect,exserted,flattened,foliaceous,foveolate,free,glabrescent,glabrous,gland-tipped,glandular,half,heterostylous,lanceolate-subulate,large,lengthening,lightly,like,lobe,lobed,long,long-styled,lower,margin,midpoint,minute,minutely,mixed,multangulate,multicellular,nearly,nflorescence,obverse,occasionally,older,ovoid,papillo,perfect,pericarp,pore,poricidal,porrect,portion,prickly,prominent,pubescence,raise,ray,reduced,reflexed,rest,rigid,ruit,sessile,short-styled,slit,somewhat,sparsely,stalked,staminate,subcordate,subhirsute,subscandent,subsessile,tall,tapering,testa,thick,tip,tomentose-scabrous,tube,ud,unarmed,unicellular,unit,upper,winged,x,ympodial,¼	abaxial,adaxial,arrangement,color,colour,form,fruit,height,history,life,na,number,plant,position,rachi,raised,reproduction,seed,shape,spacing,staman,texture,width
320	wfo-0001028059	success	221	96	83	138	13	0.376	-4.5,0-1.2,0-15,0.1-0.6,0.4-0.9,0.5-0.7,0.5-1.3,1,1-1.5,1.1-4.5,1.5-2,2-10,2-3,2.5-12,2.5-2.6,2.5-3.5,3-10,3-11.5,4-8,4.5-7,6-17,60-90,8.5-10,adaxially,adult,anther,apex,bark,branch,brownish,chartaceous,cm,corky,decimetre,densely,diameter,dm,elliptic,filament,flower,furrowed,glabrous,glandular,hair,inflorescence,juvenile,lateral,leaf,leaf-opposed,length,lilac,long,midpoint,mm,moderately,oblong,ovate,pale,pedicel,peduncle,per,petiole,prickle,pseudo-racemose,purple,rachi,ray,rusty,simple,sparsely,stalk,stellae,stellate,stellate-pubescent,style,surface,thick,time,toward,unbranched,x,yellow,yellowish	%,.4,0-0.2,0-0.3,0-2,0-7,0.1-0.3,0.1-0.7,0.4-0.7,0.4-0.8,0.5-0.8,0.6-0.8,0.6-1,1-2,1-3,1.1-12,1.5-2.1,1.5-3.5,15,2-2.6,2-5,2-foliate,2-locular,2.1-2.7,3-17,4-10,4-7,5-7,5-9,5-merou,8-18,9-12,9-17,abaxially,absen,absent,accrescent,acicular,across,acuminate,acute,adaxiall,alyx,andromonoecious,anvil-shape,apart,articulated,ascending,attenuate,axe,ba,base,blade,branche,brown,calyx,connivent,contiguous,cross-section,cuneate,cylindrical,deltate,directed,distall,distributed,eaf,eed,eglandular,entire,erect,exocarp,finger,fruit,fruiting,functional,geminat,gland-tipped,globose,green,half,heterostylous,interpetalar,juicy,lamina,less,lobe,lobed,longer,loosely,lower,margin,mature,mesocarp,mid-point,midvein,minute,moist,nearly,nflorescence,oblate,oblique,obtuse,often,orolla,pair,part,perennial,placenta,plant,pore,porrect,present,rhizomatous,ruit,shallowly,short,shrub,somewhat,spaced,sparse,stalked,straight,tal,tamen,tem,throughout,tissue,transparent,tube,unarme,unarmed,unit,upper,vary,weakly,wide,yellowish-green,ympodial	abaxial,adaxial,arrangement,color,corolla,density,ovary,position,seed,shape,staman,stem,texture
321	wfo-0001028067	success	139	95	68	71	27	0.489	-30,0.5-1,0.5-2,1,1-10,1-11,1-2,1-3,1-7,1.5-2.5,10-25,2-2.5,3-5,3-7,5-7,7-11-compound,7-9,acuminate,acute,aggregate,apart,apex,calyx,cell,chartaceous,cm,color,dark,diameter,elliptic-fusiform,elliptic-ovate,flattened,fruit,glabrous,leaf,lobe,long,mm,moderately,narrowly,pedicel,pedicellar,peduncle,petiole,pink,pinnately,puberulent,purple,rachi,radiu,rarely,remnant,shrub,simple,sparsely,stellate,stigma,stone,strongly,style,tomentulose,triangular,triangular-deltate,truncate,unbranched,unknown,x,yellow	0.5-1.5,2,2-3,2.5-3,3-17,3-4,4-foliat,6-12,6-18,7-20,8-13,abaxially,adaxiall,adaxially,along,articulated,axe,base,basiscopically,blade,compound,connivent,cuneate,cylindrical,decurrent,directed,distall,eaf,eed,entire,especially,flower,glabrou,hair,lateral,leaflet,leaving,lon,lower,margin,midrib,nearly,nflorescence,nther,obtuse,often,orolla,per,pore,puberulen,ripe,ruit,several,slightly,smal,spaced,subcoriaceous,tal,tem,time,tip,truncat,tube,unequal,unit,upper,usually,vary,wide,ympodial,zigzag	abaxial,adaxial,anther,arrangement,colour,corolla,form,growth,height,history,inflorescence,length,life,na,ovary,perennial,plant,position,reproduction,seed,shape,size,small,spacing,surface,texture,width
322	wfo-0001028069	success	253	110	84	169	26	0.332	0.2-0.3,0.3-0.45,0.4-0.5,0.4-0.8,0.5-1.8,0.6-4,0.8-1.2,1-2.7,1-3.5,1.5-2.0,1.6-3.2,2-3-branched,3,acute,along,anther,apex,articulated,bright,brown,cell,citru,cm,conical,corolla,deep,densely,diameter,eglandular,filament,flower,fruit,glabrescent,glandular,globose,green,hair-like,herb,imparipinnate,interrupted,lateral,leaf,leaflet,length,like,lime,long,midvein,minute,mm,obovate,occasionally,orange,outgrowth,ovary,ovate,pale,patent,pedicel,peduncle,pentagonal,perennial,petiole,plant,pseudostipule,pubescent,scent,simple,stem,stigma,strong,style,surface,tangled,terminal,testa,thick,transparent,trichome,uniseriate,wall,weak,wide,yellow	-0.4,-30,-6,.1,.1-0.2,.2,.5,0.05-0.1,0.1-0.15,0.1-0.2,0.1-0.3,0.1-0.5,0.1-0.6,0.2-0.5,0.3,0.3-0.4,0.3-0.6,0.3-0.7,0.3-1,0.4,0.4-1,0.5,0.5-0.7,0.5-2,0.6-1.1,0.7-1,0.7-1.3,0.7-1.5,1-2-celled,1-4.5,1.4,1.5-3.5,10,10-12,10-30,12,2-17,2-4,2-7,2-locular,3-,3-foliate,4-celled,5-22,5-25,6-,<,abaxially,absen,abundant,accrescent,adjacent,adpressed,alternate,always,among,anthesi,apical,appearance,appendage,appressed,axi,ba,basal,base,basioscopically,becoming,berry,bilaterally,bract,bracteole-like,calyx,column,composed,cone-shaped,cordate,cuneate,curving,decurrent,deeply,dense,due,eaf,ebracteate,edicel,eed,erect,exserted,forming,fruiting,fusion,giving,gland,gland-tippe,gland-tipped,glandular-villous,gree,half,halfway,head,included,initially,interjected,internode,larger,later,less,linear,lobe,lobed,lon,longer,longest,lower,margin,maturity,middl,minutely,multicellular,narrowly,nflorescence,oblique,often,one,pair,per,petiolule,population,present,primary,procumbent,pubescence,quaternary,rarely,reflexed,robust,rounded,ruit,scarcely,secondary,sessile,several,shaggy,short,shorter,silky,single-celled,size,slender,smaller,somewhat,staminal,sterile,straight,subopposite,symmetric,tem,tertiary,tightly,toward,tube,ud,unicellular,unit,usually,varying,viny,winged,ympodial	0.2,abaxial,absent,adaxial,arrangement,color,colour,form,growth,height,history,inflorescence,life,middle,na,position,presence,rachi,reproduction,seed,shape,spacing,staman,texture,thicknes,width
323	wfo-0001028070	success	185	98	76	109	22	0.411	.05,0-0.15,0-0.4,0-2,0.2-0.3,0.3-0.4,0.4-0.5,0.4-0.6,0.4-0.8,0.5-1.5,3-8,4-5.5,4-6,5-9,7-11,7-8,8-9.5,acicular,acute,adaxially,andromonoecious,anther,apart,apex,articulated,base,chartaceous,cm,cuneate,dark,densely,diameter,entire,erect,extra-axillary,flower,fruit,globose,green,inflorescence,lateral,lavender,length,linear,long,margin,midpoint,midvein,mm,moderately,obtuse,pale,pedicel,peduncle,perennial,petiole,plant,prickle,pseudo-racemose,pseudo-umbellate,ray,rhizomatous,shrub,sparsely,stalk,stellate,stellate-pubescent,stem,stigma,straight,streak,style,thick,time,white,yellow	%,0-0.1,0-6,0.15-0.4,0.25-0.35,0.3-0.6,0.35-0.5,0.5-0.9,0.5-1,0.6-1.4,0.7-1.3,1-1.5,1-2,1-4,1-locular,1.5-2.5,1.5-7,10-40,3-7,3.5-4,4-7,4-9,5-7,5-merou,8-13,8-9,8.5-17,abaxially,absen,absent,accrescent,across,adaxiall,alyx,axe,ba,blade,brown,calyx,connivent,cross-section,cylindrical,d.,deltate,directed,distall,distributed,dult,eaf,eed,eglandular,exocarp,finger,fruiting,functional,geminat,gland-tipped,hair,half,heterostylous,hig,incomplete,juicy,lamina,lanceolate,less,lobe,longer,lower,mature,mesocarp,mid-point,minute,moist,nflorescence,oblique,orolla,part,per,placenta,pore,porrect,present,purple,ruit,rusty,semi-circula,septum,sessile,short,simple,spaced,stage,stellae,tamen,throughout,truncat,tube,unarme,unarmed,unbranched,unit,unknow,uvenile,vary,weakly,wide,x,ympodial	abaxial,adaxial,color,corolla,filament,form,growth,height,history,leaf,life,na,ovary,position,reproduction,seed,shape,spacing,staman,surface,texture,truncate
324	wfo-0001028075	success	196	105	78	118	27	0.398	1-10,1-2.7,1-3,1.5-2.5,10-35,2-6,2.5-10,5-14,5-7,5-9,7-13,7-30,8-12,abaxially,acuminate,acute,adaxially,anther,apex,axillary,broadly,brownish,bud,cell,chartaceous,cm,condition,corolla,covering,dark,diameter,drying,elliptic-lanceolate,filament,flower,forked,fresh,fruit,glabrescent,glabrous,globose,green,greenish,hair-like,herb,lateral,leaf,leaflet,light,membranous,minutely,mm,obtuse,odd-pinnate,ovate,ovate-elliptic,ovoid,pedicel,peduncle,pentagonal,petiole,plant,puberulent,rotate,seed,size,stigma,style,subtending,terminal,testal,thick,tuber,wall,white,whitish,x,yellow	.5,1-2,1.5-7,1.6-2.7,2-3,2-4.5,3-11,3-23.5,4-12,4-7,5-12,5-17,5-8,5-merou,absent,acuman,acumen,ag,along,alyx,apart,apparently,articulated,axe,base,berry,blade,borne,capitat,ciliate,connivent,cuneate,decreasing,differentiated,digestion,distal,distally,distinctively,dorsally,dot,eaf,edge,eed,end,enzyme,erec,especially,exceeding,flat,folded,geminat,generally,glabrescen,green-white,half,homostylous,honeycomb-shaped,interjected,lanceolate,larger,lengthening,ligulate,living,lobe,long,lower,make,margin,middl,midrib,much,mucilaginous,narrow,nflorescence,oblique,often,orolla,pair,pale,perfect,petiolule,plurifoliate,pore,poricidal,purple,reflexed,removed,rounded,ruit,scattered,seudostipule,singly,slightly,slit,sometimes,spaced,specimen,stamen,star,stolo,straight,subcordate,tall,tamen,tem,throughout,tip,toward,tri-,tube,typically,unit,usually,vary,wet,wide,wing,ympodial	abaxial,adaxial,arrangement,capitate,color,colour,form,growth,height,history,inflorescence,length,life,na,ovary,perennial,position,pseudostipule,rachi,reproduction,shape,spacing,staman,stolon,surface,texture,width
325	wfo-0001028076	success	195	90	66	129	24	0.338	.5,1-10,1-2,110,12-22,2-5.4,2.2-2.6,2.5-4,4-5,5,5-20,5-6,7-8,abaxially,adaxially,anther,borne,cell,cm,conical,corolla,covering,densely,diameter,elliptic,end,filament,flower,fruit,glabrous,green,greenish,hair-like,herb,homostylous,lateral,leaf,less,light,medium,minute,mm,odd-pinnate,ovate,ovoid,pedicel,peduncle,pentagonal,petiole,plant,pubescent,purple,rarely,rotate,seed,singly,stem,stigma,style,terminal,testal,thick,tuber,wall,whitish,yellow	0.4-0.5,0.5,1-1.3,1-3,1.2-2.2,1.8-2.2,13-14,2-12,2-3,2.2-3.7,2.5-3,2.6-3.8,4.5-7,5-6.5,5-merou,?,absent,acumen,acuminate,ag,alyx,apart,apex,apparently,articulated,attenuate,axe,axillary,base,berry,blade,brownish,bud,capitat,chartaceous,ciliate,condition,connivent,decreasing,digestion,distal,dorsally,drying,eaf,edge,eed,enzyme,erec,especially,exceeding,flat,folded,forked,fresh,geminat,generally,glabrou,gradually,green-white,hair,half,honeycomb-shaped,interjected,lanceolate,larger,leaflet,lengthening,like,living,lobe,long,lower,make,margin,membranous,mucilaginous,nflorescence,obtuse,orolla,pair,perfect,petiolule,plurifoliate,pore,poricidal,proximal,pubescen,ray,removed,ripe,round,ruit,secondary,semierect,sessile,seudostipule,size,slightly,slit,spaced,specimen,stamen,ste,stolo,straight,subequal,subsessile,subtending,symmetrical,tall,tamen,tem,thir,throughout,tip,toward,tri-,tube,typically,unit,unwinged,usually,vary,wet,white,wide,wing,x,ympodial	abaxial,adaxial,arrangement,capitate,color,colour,form,growth,height,history,inflorescence,length,life,na,ovary,perennial,position,pseudostipule,shape,spacing,staman,stolon,surface,texture
326	wfo-0001028080	success	187	144	118	69	26	0.631	0.2-1.5,0.25-0.5,0.5-1.5,0.5-2,0.5-3,1,1-1.5,1-2,2-10,2-2.5,2-5,2-8,20-30,30-40,5-6,5-merous,6-7,8-10,abaxially,acuminate,acute,adaxially,andromonoecious,anther,apart,apex,armed,bark,base,branch,brown,brownish,calyx,chartaceous,clavate,cm,cylindrical,densely,diameter,distally,ellipsoidal,entire,extra-axillary,filament,fine,fissure,flattened,flower,form,formed,fruit,fruiting,glabrous,glandular,gradually,green,hair,lanceolate,lateral,leaf-opposed,like,linear-lanceolate,lobe,long,margin,midpoint,mm,moderately,narrowly,needle-like,outline,ovate,ovoid,pedicel,peduncle,pendent,perfect,persistent,petiole,plant,prickle,projection,puberulent,pubescent,rachi,ray,recurved,reniform,rugulose,scandent,short-stalked,shrub,simple,small,sometimes,sparsely,stellate,stellate-multangulate,stellate-pubescent,stem,stigma,straight,style,subcordate,surface,tapered,triangular,truncate,tube,unbranched,unequal,vertical,white,white-pubescent,whitish,wide,x,yellow	1-3,1.5-2,1.5-5,2-3,2.5-3,2.5-9,3-4,4-6,5-12,absent,accrescen,adaxiall,alyx,andromonoeciou,articulated,axe,ba,berry,blade,capitat,connivent,directed,eaf,eed,eglandular,equal,free,geminat,hermaphroditic,heteromorphic,interpetalar,long-,long-stalked,longitudinal,lower,lowering,major,midvein,multangulate,nflorescence,opening,orolla,part,pericarp,plurifoliate,pore,porrect-stellate,ruit,sessile,short-,short-styled,shorter,side,slit,spaced,staminate,strongly,tall,tamen,thi,time,tissue,unarmed,unit,vary,vein,weakly,without,ympodial	abaxial,accrescent,adaxial,arrangement,axi,capitate,color,colour,corolla,flowering,growth,height,history,inflorescence,leaf,length,life,na,ovary,position,reproduction,seed,shape,spacing,staman,texture
327	wfo-0001028105	success	150	89	62	88	27	0.413	.5,0.3-1.5,0.5,0.5-1,0.5-2,0.6-1,1-1.2,1.5-1.8,1.5-2,2-2.2,5-7-flowered,abaxially,acuminate,adaxially,anther,apex,attenuate,base,bilobed,calyx,clavate,cm,conical,corolla,dark,deflexed,elliptic,erect,filament,filiform,flattened-reniform,glabrous,globose,green,leaf,lobed,minutely,mm,olive-green,opposite,ovary,papillose,pedicel,petiole,pitted,pore,poricidal,pubescent,reddish-brown,shaped,shrub,simple,slightly,small,stigma,style,surface,tear-drop,tip,tree,tube,white	.1,.4,1-1.5,1-2.5,1.5,1.5-4.5,2,2-5,3-5-celled,3-6,3.5-4,6-7,9.5-15,acute,anthesi,apar,apical,axi,axil,ba,bark,berry,dense,dia,differing,difoliate,distinct,drying,eaf,edicel,eed,ellipsoid,evenly,exserted,free,fruiting,geminat,glandular,greenish-yello,incrassate,lamina,lateral,like,lobe,lon,long,lower,main,major,margin,middle,minor,nearly,nflorescence,occasionally,older,pair,pale,papillo,planar,portion,projection,quadrate,reflexed,ruit,scar,scattered,size,spaced,sparsely,spreading,stem,straight,strongly,tall,trichome,tub,tuft,ud,uniseriate,unit,vein,widest,woody,x,yellowish,ympodial,young	abaxial,adaxial,apart,arrangement,color,colour,diameter,flower,form,fruit,growth,height,history,inflorescence,length,life,na,number,perennial,plant,position,reproduction,seed,shape,spacing,texture,width
328	wfo-0001028109	success	205	131	105	100	26	0.512	/3,0.05-0.2,0.4-0.8,0.4-1.5,0.45-0.65,0.5-1.2,0.8-1.5,0.8-1.6,1.5-10,1.5-5.5,2-4,2.5-3,2.5-5,2/3-3/4,20-60,3-7,4-5-merous,8-12,abaxial,abaxially,acuminate,acute,adaxial,almost,anther,apart,apex,apparently,bark,base,berry,bright,calyx,chartaceous,cm,cuneate,deltate,densely,diameter,discolorous,drying,dull,elliptic,entire,evenly,filament,flattened-reniform,flower,fruit,fruiting,glabrescent,glabrous,gray-green,green,green-brown,lateral,leaf,length,light,lobed,margin,mature,maturity,mauve,mm,moderately,multangulate,orange-brown,pair,pedicel,peduncle,perpendicular,petiole,prickle,prickly,primary,red,red-brown,reflexed,shrub,simple,small,sometimes,spherical,stalked,stellate-pubescent,stem,strongly,style,surface,terete,terminal,tertiary,tree,trichome,unarmed,usually,vein,venation,visible,way,weakly,white,yellow,young	-20,-4,-7,.5,0.05-0.15,0.1,0.1-0.2,0.3,0.5-2.5,0.6-0.8,0.7,1.5-2.5,1/8-1/4,10-25,10-30,12-40,15-100,2-15,2.3-2.9,3-,3.5-6,3/4,30-150,4-13,5-13,5-30,8-15,8-25,acut,alyx,ame,apar,apically,articulated,blade,branching,brow,c.,connivent,curved,dimorphic,eaf,eed,elongating,equal,erect,free,fully,geminate,gently,glabrou,infructescence,lobe,long,long-styled,longer,lower,midpoint,minor,nflorescence,obtuse,occasionally,older,one,open,opening,orolla,oung,per,perfec,pericarp,plurifoliat,poricidal,porrect,portion,prickl,ray,recurved,ruit,scar,secondary,sessile,slender,smooth,spaced,spreading,stalk,stellate,straight,tamen,tapering,time,tip,tube,unarme,unit,vary,wide,woody,ympodial	arrangement,brown,color,colour,corolla,form,growth,height,history,inflorescence,life,na,orientation,ovary,perfect,plant,position,rachi,reproduction,seed,shape,spacing,staman,stigma,texture,width
329	wfo-0001028115	invalid_json_followup	165	107	66	99	41	0.4	-1.1,-2.5,0.7-0.8,1.1-1.8,2-3.2,5-15,6-10,abaxially,abundant,accrescent,acute,adaxially,amply,anther,antrorse,apex,berry,blue,calyx,campanulate,capitate,cm,diameter,ellipsoidal,elliptical,entire,evident,exceeding,filament,fruiting,glabrescent,globose,growing,herb,inflated,length,light,margin,mm,moderately,much,narrowly,ovate,pale,papery-scarious,petiole,pinnatifid,pinnatipartite,pinnatisect,prostrate,pubescent,rarely,reticulate,seed,slender,stem,stigma,strongly,style,trans-ovoidal,trichome,unifoliate,venation,violet,width,yellow	-5.2,.2,.6,0.2-0.3,0.42,0.5,0.6-0.7,0.8-,1-2.4,1-3,1.3-1.8,1.4-1.7,1.7-2.2,1.8-3.5,12-13.5,2-,2.5-,3-4.5,3-5,3-6.5,4.7-,5-8.5,7-7.5,9-17,acuminat,ag,alternate,annular,articulate,attenuate,basal,base,blade,coat,connectival,curved,difoliat,dorsal,eaf,eed,embryo,especially,glabrous,glandular,half,herbaceous,hig,linear,lobe,long,longer,longitudinal,longitudinally,lower,mixed,multi-seeded,near,nerve,non-glandular,oblong,one,opening,opposite,orolla,pair,papillo,pore,poricidal,portion,prolongation,ree,ridged,ruit,scarce,segment,similar,simple,slightly,slit,small,smooth,sometimes,styl,subsessil,tem,time,tip,triangular,tube,tuberculate,unequal,uniseriate,unit,vary,wide,wider,winged,x,ympodial	'',[,``,abaxial,adaxial,arrangement,bark,bud,characteristic,color,colour,corolla,difoliate,flower,form,fruit,growth,height,history,inflorescence,leaf,life,na,new,ovary,pedicel,peduncle,plant,position,prickle,rachi,reproduction,scar,shape,spacing,staman,surface,texture,value,{,}
330	wfo-0001028131	success	208	139	113	95	26	0.543	-1.2,.5,0-0.6,0-4,0.1-0.3,0.3-0.7,0.5-1.1,0.7-1.1,0.8-1.1,1-10,1-4,1.5-5,1/4-2/3,2-5,3-6,5-6.5,5-merous,abaxial,abaxially,adaxial,anther,apart,apex,apparently,attenuate,bark,base,berry,calyx,cell,chartaceous,cm,cream,curved,dark,diameter,dull,elongating,epidermi,eye,filament,flattened,flattened-reniform,flower,fruit,fruiting,glabrescent,glabrous,gland,green,herb,lateral,leaf,length,lobe,lobed,long,margin,marking,mature,maturity,mauve,membranous,midvein,mm,moderately,naked,narrow-obovate,narrow-ovate,obtuse,orange,orange-brown,outline,pair,pale,pale-brown,pedicel,peduncle,pendulous,petiole,pit,prickle,primary,purple,raised,red,reduced,reflexed,rounded,shiny,simple,small,smooth,spaced,sparsely,spherical,stellate-pubescent,stem,strongly,style,sunk,surface,terete,tertiary,unarmed,vein,venation,visible,wide,woody,yellow,yellow-green,young	.1,/5,0-2,0-3,0-30,0.05-0.2,0.1-0.15,0.2-1.5,0.4-0.8,0.8-1,1-3,1-5,1.5-3,1.8-2,1.8-2.2,1/5,2-2.8,2-4,2-6.5,2/3,4-6,5-8,6-7,7-8,absent,acuminat,alyx,apar,apically,articulated,blade,branched,broad-deltate,concolorous,connivent,deltate,densely,difoliate,distance,drying,eaf,eed,equal,erect,extending,filiform,free,geminat,infructescence,lanceolate,lengt,like,longer,lower,midpoint,nflorescence,oblong,often,older,one,open,orolla,oung,pale-gra,per,perfec,pericarp,poricidal,porrect,portion,prickl,prickly,ray,ruit,scar,sessil,sessile,shorter,side,sometimes,spreading,stellate,straight,tamen,tapering,time,tip,trichome,tube,unarme,unit,upper,vary,way,ympodial	arrangement,color,colour,corolla,feature,form,growth,height,history,inflorescence,life,na,ovary,pale-gray,perennial,plant,position,rachi,reproduction,seed,shape,spacing,staman,stigma,texture,width
331	wfo-0001028147	success	185	68	59	126	9	0.319	0.25,0.5,0.6,1.5–2,15–20,1–2,1–4,1–5,2–4,2–7,3–4,5–10,6–9,7–10,anther,berry,brown,bud,cm,corolla,dark,diameter,ellipsoid,flattened-reniform,flower,fruiting,globose,green,immature,internode,light,long,mature,minutely,mm,mottled,orange,ovoid,pale,pedicel,peduncle,petiole,pitted,rachi,seed,shape,somewhat,stellate,stigma,style,surface,turning,white,wide,x,yellow,yellow-green,yellowish-orange,×	.5,1.5–5.5,1.6–2.3,10–15,2–8,3-5,3.5–4.5,3.5–9,3–6,4-5,5–12,abaxially,absent,acuminate,acute,adaxially,ag,alyx,anthesi,apex,appearing,armed,articulated,axe,base,becoming,blade,branched,break,broadly,calyx,campanulate,cell,chartaceous,connivent,cuneate,deciduous,decurrent,deltate,dr.,dry,eaf,eed,elongate,elongating,entire,equal,except,exserted,fifth,filament,five,four,glabrous,hairy,herbaceous,interpetalar,lanceolate,larger,lateral,lengthening,lobe,lobed,long-styled,longer,lower,major,margin,midrib,narrowly,nearly,nflorescence,oblong,often,one,orange-red,orolla,outer,ovate,paired,pentagonal,pericarp,plurifoliat,pore,poricidal,prickle,puberulent,pulp,rarely,recurve,recurved,robust,rugose,ruit,season,seen,shallowly,short-styled,side,simple,slender,slightly,slit,spine,spreading,stem,stout,straight,subcaudate,tamen,terminal,testal,time,tip,tissue,truncat,tube,unequal,unit,vary,vein,vine,wall,wood,woody,ympodial	color,fruit,height,inflorescence,length,ovary,plant,texture,truncate
332	wfo-0001028148	success	157	113	78	79	35	0.497	0.25-0.5,1-15,1-3.5,1.5,12-15,2,2-7,2.5-4,5-7,5-8,abaxially,acute,aggregate,angled,apart,apex,apiculate,base,blue-black,branched,broadly,chartaceous,cm,dark,decurrent,densely,diameter,directed,elliptic,entire,flower,fruit,glaucous,globose,less,lobe,margin,mature,midrib,minute,mm,moderately,narrowly,obtuse,often,orange,pedicel,peduncle,petiole,pink,plicate,pore,puberulent,purple,rachi,rhizomatous,ridge,ripe,rotate-stellate,scalloped,shrub,simple,slender,slightly,smooth,stigma,style,surface,tapered,thickened,treelet,triangular,tube,violet,whitish,x,yellow,young	-6,.5-4,0.5-1.5,0.6-3.5,0.75-2,1.5-2.5,10-30,15,2-3,20-50,3.5-4,3.5-9,4-10,4.5-10,5,5-10,5-20,6-18,absen,adaxially,articulated,axe,ba,blade,calyx,cell,central,connivent,cylindrical,deltate,distal,distall,eaf,eed,especially,except,fleshy,fresh,glabrous,hair,highly,light-colored,long,lower,many-foliat,margi,material,nflorescence,nther,orolla,ovate,part,perfect,plicae,puberulence,puberulent-pubescent,radiu,rarely,ruit,smoot,sometimes,spaced,sparse,star,stone,succulent,tal,tem,time,tip,truncat,unbranched,unit,usually,vary,white,wide,winge,ympodial	0.5-4,abaxial,absent,adaxial,anther,arrangement,color,colour,corolla,direction,distally,filament,form,growth,height,history,inflorescence,leaf,length,life,na,ovary,plant,position,presence,reproduction,seed,shape,spacing,staman,texture,thicknes,truncate,width,winging
333	wfo-0001028161	success	124	78	56	68	22	0.452	.5,0.1-0.25,0.25-0.5,0.7-1.7,1-1.5,1-2,1-2.3,1.5-4.5,2-5-flowered,2-9,3-7,4-5,7.5-12,acuminate,acute,apex,attenuate,base,branch,branched,brown,cell,closely,cm,congested,dendritic,densely,elliptic,globose,green,lanceolate,leaf,major,minor,minutely,mm,narrowly,outline,ovoid-reniform,pale,pedicel,petiole,pitted,pubescent,shape,short,shrub,simple,sinuate,size,sparsely,surface,tapering,thin,trichome,x	1-1.3,1/3,2.5-3,3-4,6-9,9-11,abaxially,adaxially,along,anthesi,arising,ba,bark,berry,calyx,consisting,corolla,deflexed,denser,dia,differing,difoliate,distal,eaf,edicel,eed,exserted,fruiting,geminat,glabrescen,incrassate,inflorescenc,later,lateral,like,lon,long,main,margin,middle,nflorescence,obovoid,often,older,opposite,orbicular,overlappin,pair,probably,pubescence,reddish-brown,rest,rounded,ruit,scar,somewhat,spaced,stem,strongly,tall,tan,tub,ud,unit,vein,widest,ympodial,young	abaxial,adaxial,arrangement,color,density,diameter,flower,form,fruit,growth,height,history,inflorescence,length,life,na,number,perennial,plant,reproduction,seed,texture
334	wfo-0001028164	success	197	134	103	94	31	0.523	-1,/4,0.05-1.5,0.4-0.8,0.5-0.8,0.5-1,0.9-1.6,1,1-1.5,1-4.5,2.5-4,3-17,4-5-merous,6-8,abaxial,acuminate,acute,ame,anther,apex,attenuate,bark,base,berry,branched,bright,c.,cm,dark,densely,diameter,dull,elliptic,entire,erect,evenly,eye,filament,flattened-reniform,flower,fruit,glabrescent,glabrous,gray,green,lateral,leaf,length,less,lobed,margin,maturity,mauve,membranous,midpoint,midvein,mm,moderately,multangulate,naked,obtuse,often,orange-brown,pair,pale,pedicel,peduncle,petiole,primary,ray,red,red-brown,sessile,shallowly,shorter,shrub,side,simple,sometimes,sparsely,spherical,stalked,stellate,stellate-pubescent,stem,style,surface,terete,terminal,tertiary,trichome,unarmed,undulate,unit,variously,vein,venation,visible,way,white,yellow,yellow-green,young	-14,-6,-8,0-20,0.05-0.2,0.1,0.3-0.8,0.7-1.1,0.8-1.5,1.5-2.5,1.8-2.5,1/3,1/6-1/4,12-20,2-2.5,2.5-4.5,2.8-4,3-7,3.6-4.8,4-13,4-7,4-8,8-15,8-17,abaxially,almost,alyx,apar,apically,apparently,articulated,blade,calyx,concolorous,connivent,curved,deltate,difoliate,drying,eaf,eed,elongating,equal,filiform,free,fruiting,geminat,glabrescen,glabrou,glandular,hair,infructescence,lobe,long,long-acuminat,longer,lower,mature,minute,narrow-deltate,nflorescence,older,one,open,orolla,oung,per,perfec,pericarp,poricidal,porrect,portion,recurved,reflexe,ruit,scar,shorte,smooth,spaced,spreading,stalk,straight,tamen,tapering,time,tip,tube,unarme,upper,vary,wide,woody,yellow-gra,ympodial	adaxial,apart,arrangement,color,colour,corolla,difoliation,form,geminate,growth,height,history,inflorescence,life,na,number,ovary,plant,position,rachi,reproduction,seed,shape,spacing,staman,stigma,sympodial,texture,visibility,width,yellow-gray
335	wfo-0001028180	success	147	108	76	71	32	0.517	/2,0.7-1,1-1.5,1-1.8,1-3,1.5-5,15-28,20-30-flowered,3-10,4.5-5,5-6,5-8,7,acute,along,anther,apex,attenuate,bark,base,beginning,capitate,closely,cm,corolla,dark,densely,drying,elliptic,elongate,falcate,filament,glabrous,globose,gold,golden,green,leaf,lobed,major,margin,minor,minutely,mm,opposite,ovary,ovoid-reniform,pale,papillose,pedicel,petiole,pinkish-white,pitted,pubescent,scar,shaped,shiny,simple,size,small,somewhat,spaced,stigma,style,surface,tan,tear-drop,tree,trichome,underside,uniseriate,way,white,winged,x,yellow-gray	.05,.5,1-1.2,2-2.2,2-3,2.5-3,3-4,8-10,abaxially,adaxially,anthesi,ba,berry,c.,calyx,conical,cucullate,darker,deflexed,deltate,dia,differing,difoliate,distinctly,eaf,eed,erect,fleshy,four-angled,free,fruiting,geminat,glabrat,irregularly,know,larger,lateral,leathery,lobe,lon,long,lower,main,midrib,nearly,nflorescence,obscure,older,onto,overlappin,pair,planar,pore,poricidal,portion,puberulent,ruit,sparsely,stem,straight,styl,tall,thick,tip,tube,ud,unit,vein,woody,ympodial,young	abaxial,adaxial,arrangement,bud,color,colour,diameter,flower,form,fruit,glabrate,growth,height,history,inflorescence,length,life,na,number,peduncle,perennial,plant,position,rachi,reproduction,seed,shape,spacing,staman,texture,width,winging
336	wfo-0001028182	success	150	79	55	95	24	0.367	0-90,0.1-0.2,0.5-0.6,0.8-1,0.9-1,1-1.5,2-2.5,3-5,anther,apart,apex,bark,bending,capitate,ciliate,cm,corolla,ellipsoid,filament,filiform,flower,glabrous,globose,hemiepiphyte,inflorescence,internodal,later,leaf,lobed,minutely,mm,narrowly,obovoid,opposite,ovary,ovate,papillose,pedicel,petiole,poricidal,pubescent,scar,shaped,shiny,shrub,sparsely,stigma,style,surface,tear-drop,tip,tube,white,x,young	.5,0.5,0.5-1,2,2-6.5,3,4-6,5-15-flowered,5-ribbed,6-9,along,anthesi,apiculae,apiculate,arching,axi,base,beneath,black,blade,branch,brown,calyx,conical,cordate,deflexed,deltoid,densely,dia,dry,eaf,edicel,eed,evenly,except,extreme,free,gre,keeled,know,known,lateral,lax,less,like,lobe,long,long-acuminate,lower,main,margin,material,midrib,minute,nearly,nflorescence,older,pair,papillo,planar,pore,portion,present,prominent,proximal,purplish,reflexed,rib,rounded,ruit,sca,simple,slender,slightly,somewhat,spaced,sparser,specimen,spindly,stem,still,strongly,tapering,third,time,trichome,truncate,ud,unifoliat,uniseriate,unit,vein,widest,ympodial,zig-zag	abaxial,adaxial,arrangement,bud,color,colour,diameter,form,grey,growth,height,history,length,life,na,peduncle,plant,position,rachi,shape,spacing,texture,unifoliate,width
337	wfo-0001028183	success	237	137	113	124	24	0.477	-10,-5.3,0.1-0.9,0.2-0.3,0.2-0.5,0.5-2.5,0.7-2,0.8-1.4,0.8-3.1,1.1-1.8,1.4-2.8,1.5-3.4,1.7-2.7,1/3-1/2,2-4.2,2-5,2.2-5.7,2.5-4.1,2.8-4.2,3.2-,4.6-6.4,5-8,5.2-6.2,6.6-20,abaxial,abaxially,accrescent,adaxially,along,anther,apart,apex,attenuate,axi,bark,base,branch,branched,brown,bud,calyx,capitate,central,cm,corolla,dark,deltoid,dendritic-multangulate,diameter,drying,dull,elliptic,elongated,filament,flower,fruit,fruiting,glabrescent,glabrous,globose,granular-punctate,hair,half,lanceolate,leaf,lobe,lobed,many,mm,multangulate,narrowly,obovoid,orangish-tan,pedicel,peduncle,petiole,pseudoterminal,pubescence,pubescent,purple,rachi,relatively,reportedly,reticulate-punctate,ripe,scabrous,shrub,simple,small,somewhat,soon,spherical,stellate,stigma,streak,style,sub-lenticular,subcampanulate,surface,tan,terete,thin-textured,time,translucent,tree,upper,violet,way,white,whitish,x,yellow,yellowish	.5-3,0.1,0.1-0.2,0.1-0.4,0.2-0.4,0.5,0.6,0.7-1.2,1.2-1.4,1.3-1.4,1.3-1.7,1.6-2.3,1.9-3.7,10-15,11-30,2.6-4.4,3.5-6.6,4.5-9,5-8.5,50-400,7.5-23,8-9.1,9-13,acute,ag,alyx,anthesi,apparently,around,articulated,axillary,berry,blade,blunt-tipped,cell,chartaceous,closely,cuneate,cylindrical,directed,distally,distantly,eaf,earl,edge,eed,entire,epidermal,especially,evident,except,exserted,farinose,few-rayed,free,glabrescen,group,high,inserted,lackin,lateral,lengthening,lon,long,long-decurrent,longitudinal,lower,m.,main,margin,midrib,nearly,nflorescence,oblong,older,open,orolla,ovate-lanceolate,overlapping,perfec,plurifoliate,pore,poricidal,porrect-stellat,porrect-stellate,present,prominent,rarely,ruit,runk,sessile,short,short-,side,slit,spaced,sparingly,sparse,splitting,stage,stalk,stamen,stem,stipitate-glandular,stout,strongly,suture,tamen,thick,thin,tip,tomentose,touching,tube,ud,unarme,unit,usually,vary,vein,wide,yellowish-tomentose,ympodial,young	adaxial,arrangement,color,colour,form,growth,height,history,inflorescence,length,life,na,ovary,perennial,plant,position,reproduction,seed,shape,spacing,sparing,staman,texture,width
338	wfo-0001028226	success	185	101	73	112	28	0.395	0-0.1,0-1,0.15-0.3,0.15-0.45,0.3-1,1.5-3,15-27,2.5-9,3.5-4.5,5.5-8.5,9-14,9-15,accrescent,acicular,adaxially,andromonoecious,anther,apart,apex,base,calyx,chartaceous,cm,cuneate,cylindrical,deeply,densely,diameter,elliptical,extra-axillary,flower,fruit,fruiting,glabrous,globose,green,herbaceous,index,inflorescence,lavender,leaf-opposed,length,lobed,lobing,margin,mesocarp,mm,moderately,moist,obtuse,ovate,pale,pedicel,peduncle,petiole,plant,prickle,prostrate,pseudo-umbellate,resprouter,shallowly,simple,solitary,somewhat,sparsely,sprawling,stellate,stellate-pubescent,straight,strongly,style,unbranched,yellow	%,.5,0-2,0.1-0.3,0.2-0.3,0.25-0.4,0.25-0.5,0.3-0.7,0.4-0.6,0.4-0.7,0.5-1,0.5-1.2,0.6-1.3,0.7-0.9,1,1-2,1-3,1-5,1.2-2.6,1.5-5,1.6-2.4,10-16,10-45,13-22,18-50,2-3,2-5,2-5.5,2.5-3,2.7-3.2,5-8,5-merou,6-8,7-8,abaxially,absen,absent,across,adaxiall,adult,alyx,apparently,armed,articulated,axe,ba,blade,branche,brown,confined,deltate,directed,distall,distributed,dm,eaf,eed,eglandular,finger,functional,geminat,gland-tipped,hair,half,heterostylous,juic,lamina,lateral,less,lobe,lon,long,longer,lower,mature,midpoint,midrib,midvein,minute,nflorescence,oblique,onl,orolla,part,per,plurifoliate,pore,porrect,present,ray,rostrate,ruit,sessile,short,side,spaced,stage,stellae,tal,tamen,tem,thick,throughout,time,transparent,tube,unit,uvenile,vary,wide,x,ympodial	5-merous,abaxial,adaxial,arrangement,color,colour,corolla,filament,form,growth,height,history,juicy,leaf,life,moisture,na,ovary,position,reproduction,seed,shape,spacing,staman,stigma,surface,texture,width
339	wfo-0001028227	success	236	146	122	114	24	0.517	-6.2,0.2,0.2-0.3,0.2-0.4,0.2-0.5,0.4,0.7-2.1,0.8-1.4,0.9-1.4,1-4.2,1.1-3.1,1.2-2,1.3-4,1/2-3/4,2-12,3-4.9,3.7-7,4.8-7.6,6.7-15,abaxial,abaxially,acuminate,acute,adaxially,anther,apart,apex,appressed,around,attenuate,bark,base,branch,branched,brown,brownish,cm,corolla,cuneate,dark,deltoid,dendritic-echinoid,diameter,directed,distally,drying,echinoid,edge,elliptic,elongate,entire,farinose,filament,fleshy,flower,fruit,glabrescent,globose,granular-tomentose,gray,grayish,green,hair,leaf,lobe,long,many,margin,midvein,mm,multangulate,oblong-lanceolate,obtuse,occasionally,often,orangish-tan,ovate-lanceolate,pale,pedicel,peduncle,petiole,pore,poricidal,porrect-stellate,prominent,pseudoterminal,pubescent,purple,quarter,rachi,reticulate-punctate,ripe,scabridulous,sessile,shrub,simple,slightly,somewhat,sparsely,stalk,stellate,stem,stigma,style,sublenticular,subspherical,sulcate,surface,thick,thin,time,tip,tomentose,tree,upper,velutinous,violet,way,well,x,yellow,yellowish	-2/3,.5-4,0-250,0.1,0.3,0.5,0.8,0.9,0.9-1.2,1,1-1.7,1-2.5,1.4,1.4-2.6,1.5-2.3,1.7-2.8,1.9,1.9-4.2,1.9-5.8,1/2,10,10-24,11-15,2-3.8,2.5-7.8,2.6-5.9,2.9-4.7,3.7-6.3,4-13,5-7.5,6-16,8.1-18,8.5-22,accrescent,ag,age,along,alyx,anthesi,apparently,articulated,axillary,becoming,berry,blade,blunt-tippe,blunt-tipped,bud,c.,calyx,closely,cylindrical,decurrent,eaf,early,echinoi,eed,ength,exserted,free,fruiting,glabrous,high,inserted,lacking,lanceolate,lateral,lengthening,less,lobed,lon,longitudinal,lower,m.,main,midrib,mostly,nflorescence,oblong,obscured,older,orbicular,orolla,ovate-orbicula,overlapping,perfec,plurifoliate,present,pubescence,relatively,rounded,ruit,runk,side,slit,spaced,stamen,stout,subcampanulate,suture,tamen,thicker,tomentu,touching,tube,ud,unarme,unit,usually,vary,vein,wide,ympodial,young	adaxial,arrangement,color,colour,form,growth,height,history,inflorescence,length,life,na,ovary,perennial,plant,position,prominence,reproduction,seed,shape,spacing,staman,texture,width
340	wfo-0001028228	success	143	108	77	66	31	0.538	.5,0.1-1.7,0.75,1.1-1.2,1.2-1.8,1.5-2,1.8-3.4,2-8,3/4,6-7,abruptly,acute,age,anther,anthesi,apex,area,bark,base,becoming,brown,calyx,campanulate,closely,cm,corolla,dark,deflexed,dia,dry,elliptic,exserted,filament,fruiting,glabrous,globose,green,greenish-yellow,leaf,lobe,lobed,long,margin,material,minute,minutely,mm,narrowing,obovate,opposite,ovary,overlapping,ovoid,ovoid-reniform,pale,papillose,pedicel,petiole,reticulate,rounded,shining,shrub,simple,slender,small,spaced,stigma,style,surface,tapering,thickened,tip,tree,tube,way,white,young	1-1.5,1.1-2.5,10-30-flowered,2,2-5,2.1-4.2,2.8-6.5,6-8,7.5-12.5,ba,beginning,beneath,berry,caly,clavate,coriaceous,deltoid,difoliate,distal,eaf,edicel,eed,erect,fragrant,free,geminat,impressed,inflorescenc,lateral,lon,lower,main,major,middle,minor,nflorescence,occasionally,older,pair,planar,pore,poricidal,portion,prominent,ruit,scar,shaped,shinin,slightly,stem,straight,styl,sweetly,tall,tear-drop,terminal,thick-margined,ud,unit,usually,vein,weight,widest,woody,x,ympodial	abaxial,adaxial,arrangement,bud,color,colour,deflexion,diameter,exsertion,flower,form,fruit,growth,height,history,inflorescence,length,life,na,peduncle,perennial,plant,position,rachi,reproduction,seed,shape,spacing,staman,texture,width
341	wfo-0001028234	success	155	84	53	102	31	0.342	/3,0.15-0.35,1-2.5,1.0-1.8,15-30,3-10,5-11,accrescent,annual,anther,armed,blade,blue-tinged,broadly,brown,calyx,campanulate,capitate,cm,dark,density,dm,glabrous,green,hair,herb,internodal,leaf,linear-lanceolate,long,margin,mm,ovate,pedicel,per,petiole,pinnatifid,plump,prickly,purplish-tinged,radially,ridged,simple,spherical,stellate,stem,tube,unexpanded,unicellular,uniseriate,varying,vein,white	/2,0.25-0.5,0.5-1.0,2.6.3.2,3.5-7,4-10,5-20-flowere,520,8-11,acro,across,acute,along,alyx,and,anthesi,around,basally,base,beneath,berry,black,branched,caly,capitate-glandular,cauline,central,closely,deltoid,developing,dia,difoliate,dissected,divergently,divided,dry,eaf,earliest,eed,enveloped,erect,extended,few-rayed,fleshy,fully,geminat,gland,heteromorphic,high,invested,largest,later,lobe,lon,main,many,marking,maturity,mostly,narrowly,nflorescence,occasionally,often,one,orolla,persisting,prickle,purple,reduced,ruit,scattered,second,sessile,short,short-stipitate,slende,somewhat,spaced,splitting,starlike,ste,stellae,stipitate,stout,strait,subulate,tamen,taprooted,thrice,tightly,tigma,triangular,tub,twice,tyle,ultimate,unit,vary,wholly,year,yello,ympodial	abaxial,adaxial,arrangement,color,colour,corolla,diameter,filament,form,fruit,growth,height,history,inflorescence,length,life,na,ovary,peduncle,plant,position,rachi,reproduction,seed,shape,spacing,staman,stigma,style,surface,texture
342	wfo-0001028250	success	256	122	89	167	33	0.348	0.17,0.3–0.6,0.5–1.0,0.5–1.3,1,1.0–1.6,1.1–1.6,1.2–6.3,12.5,2.3–2.5,2.3–5.1,5.8–6.6,6–10,abaxially,acute,adaxially,aequilateral,anther,apex,apparently,attachment,base,blade,branched,brochidodromous,bud,calyx,chartaceous,cm,corolla,cuneate,deltate,densely,diameter,distinct,endocarp,entire,exocarp,extra-axillary,filament,flattened-orbicular,flower,fruit,glabrous,globose,glossy,homostylous,internode,interpetalar,lateral,leaf,lobed,margin,midvein,mm,notched,oblique,oblong,ovate,pedicel,peduncle,petiole,point,poorly-developed,pubescent,raised,ray,red,rounded,shrub,simple,sinuate,small,stellae,stellate,stellate-pubescent,stigma,style,surface,thin,tissue,tree,vein,weakly,white,yellow,yellow-tan,±smooth,–3	.2,.3,.4,.7,.8,0.08,0.13,0.2–0.6,0.3–0.5,0.3–3.9,0.4–0.8,0.6–0.7,0.7–0.8,0.8–1.0,0.8–1.3,0.9–1.3,1.0–2.0,1.2–1.7,1.3–1.6,1.3–2.0,1.5,1.5–3.4,1.6–1.8,1.7,1.7–2.5,1.8,1.8–2.2,1.9–2.2,1/3,1/4–3/4,1–3,2.1,2.2–2.9,2.7,2.8,3.9–12.2,4–11,4–6,4–8,5-merou,5.0,5.1–6.2,5.7–7.7,8.3–18.0,90°,95,adnate,alyx,anthesi,apart,apical,apically,apiculate,appearing,appressed,articulate,axe,ba,berry,branch,broad,caudate,channeled,climate,clinate,congested,continuing,curved,dentate,depression,development,difoliate,directed,disc-shape,dry,eaf,edge,eed,egandular,either,emerging,entir,erect,evenly,fertile,filiform,free,frui,geminate,glabrescent,glandular,growt,hair,hooked,increasing,intersepalar,juic,lanceolate,large,less,lobe,lon,long,longer,lower,major,mature,midpoint,midrib,minor,minute,moderately,nearly,new,nflorescence,occasionally,opaque,orolla,overlapping,per,pore,porrect,portion,potentially,restricted,rigid,row,ruit,sessile,shallow,short-stipitate,shorter,side,sinus,smoot,sparsely,split,splitting,spread,spreading,stamen,stella,stipe,straight,suture,tamen,tardily,tem,time,tip,toward,truncate,tube,two,typically,ud,unarmed,upper,upright,vary,wide,yellow-ferruginous,ympodia,young,±equal,×,–1.6	5-merous,abaxial,adaxial,arrangement,breadth,color,colour,disc-shaped,feature,form,growth,height,history,inflorescence,juicy,length,life,na,number,ovary,perennial,plant,position,rachi,reproduction,seed,shape,smooth,spacing,staman,stem,texture,width
343	wfo-0001028263	success	156	123	90	66	33	0.577	0.25,1-3,1-4,11-23,2-4,2.6,3.4,3.5-4.2,4-5,5-7,5-7.5,6,6-8,9,abaxially,acuminate,acute,adaxially,apex,articulate,base,branched,broadly,cell,cm,conical,cordate,corolla,covering,cuneate,cyme,darker,deep,diameter,dichasial,dichasially,distal,ebracteate,elliptical,filament,flower,green,green-white,hair-like,half,herbaceous,honeycomb,interjected,lateral,leaf,leaflet,light,long,medium,mm,monochasial,mucilaginous,oblique,odd-pinnate,ovate,ovoid,pair,pattern,pedicel,peduncle,perennial,petiole,plant,proximal,puberulent,pubescent,rotate,seed,size,stigma,strigose,style,terminal,testal,thick,throughout,truncate,tuber-bearing,typically,unit,violet,wall,wide,yellow,¼	1-2,11-13,14-44,2,2-3,3,3-6-foliat,4,8-1.,8-14,abaxiall,acumen,apical,apically,atenuate,calyx,connate,dehiscent,digestion,diminishing,dorsally,eaf,edge,eed,emoval,enzyme,equal,exceeding,first,flat,folded,forked,generally,globo,gradually,introrse,living,lobe,lon,lower,lunat,make,maturing,nflorescence,nther,often,orolla,perfect,plan,poricidally,reveal,ruit,sessile,seudostipule,short,slit,specimen,stamen,straight,tal,tem,throughou,toward,two,vary,ympodial	3-6-foliate,8-19,abaxial,adaxial,anther,arrangement,color,colour,form,fruit,globose,growth,height,history,inflorescence,length,life,lunate,na,ovary,position,pseudostipule,rachi,reproduction,shape,spacing,staman,surface,sympodial,texture,wet,width,ye
344	wfo-0001028273	success	225	113	98	127	15	0.436	-2,.5,0,0.1,0.2,0.5,0.5-1,0.6-0.8,1,1-2,2.3-3,2.5-6,4-7,4-7-lobed,6-8,<,abaxial,acicular,acute,adaxial,anther,apart,apex,armed,base,berry,branched,brown,cm,color,conical,coriaceous,corolla,densely,diameter,elliptic,equalling,filament,flattened,flower,fruit,globose,growth,height,holly-like,impressed,inflorescence,leaf,lobed,long-stalked,long-styled,longer,margin,midpoint,minute,minutely,mm,mucronate,multiseriate,orange,ovary,ovate,pair,pedicel,peduncle,petiole,pitted,prickle,primary,puberulent,pubescent,rachi,ray,reddish,reniform,sessile,shallowly,shiny,short,shrub,simple,sparsely,stellate,stigma,style,styled,surface,terminal,time,toothed,trichome,truncate,unknown,vein,way,white,x,½-2/3	-8,0.4,0.4-0.5,0.4-1,0.6-1,1-1.5,1-4,1.2,1.5-,1.5-2,2,2-3,2-6,2.5-,2.6-5,3-5,30,4,4-10,4-11,4-8.5,5-8,>,?,abaxially,abruptly,absent,adaxially,age,alfway,along,also,anthesi,articulated,bark,basal,beneath,broad-based,c.,calyx,cell,closer,deep,dense,discolorous,distall,eaf,eed,erect,evenly,exfoliatin,exserted,free,fruiting,glabrous,greyish,heterostylous,known,less,like,linear,lobe,lon,long,long-triangular,lower,major,markedly,midvein,mixture,multangulate,new,nflorescence,nodding,occasionally,often,older,papillae,per,pericarp,persisting,planar,plurifoliat,poricidal,porrect,portion,prickly,pubescence,rest,rim,ruit,scar,scattered,shorter,sinuate,size,slightly,small,smaller,sometimes,spaced,sparse,splitting,spreading-campanulate,stalk,stalked,stellate-pubescent,stem,stout,straight,tapering,terminating,testal,tip,together,tooth,truncat,tube,ud,unicellular,unit,urceolate,variable,widely,woody,yellow,ympodial	colour,form,history,length,life,na,plant,position,reproduction,seed,shape,spacing,staman,texture,width
345	wfo-0001028278	success	219	113	91	128	22	0.416	0-1,0.2-0.3,0.4-2.1,0.5-0.75,0.5-1.5,0.5-2.5,0.8-3,1,1-1.2,1-10,1-2,1.5,2-3,4.5-6,6-11,6-8,7-12,accrescent,acute,andromonoecious,anther,apex,base,broadly,brown,calyx,cm,cordate,cylindrical,densely,diameter,ellipsoidal,entire,exocarp,extra-axillary,filament,flower,fruit,fruiting,glabrous,green,grey-green,index,inflorescence,juicy,lateral,leaf,length,light,lobed,lobing,long,margin,mesocarp,midpoint,mm,obtuse,ovate,pale,pedicel,peduncle,perennial,perfect,petiole,pink,placenta,pseudo-racemose,purple,rachi,ray,red,reniform,rhizomatous,rugose,shallowly,shape,shrub,somewhat,stellate,stellate-pubescent,stigma,style,succulent,surface,time,triangular,truncate,weakly,white,x,yellow	%,.5,0-0.15,0-0.7,0-3,0.1-0.25,0.1-0.5,0.45-0.7,0.5-0.9,0.7-1,0.7-1.2,0.8-1.3,0.8-2,1-3,1-4,1-5,1-locular,1.2-1.6,1.4-1.9,1.5-2,1.5-3,11-15,17-30,2,2-4,2.2-7,2.5-3,2.5-9,2.7-2.9,3-4,3-5,3-7,4,4-,4-12,4-5,5-10,5-11,5-merou,7-10,7-15,7-8,8-10,abaxially,absen,absent,across,adaxially,adult,alyx,apart,apparen,articulated,ascending,axe,ba,bilobe,blade,chartaceous,connivent,dense,difoliate,directed,distall,eaf,eed,elliptic,erect,exceeding,finger,flattened,functional,geminat,gland-tipped,glandular,hair,heterostylous,incomplete,interpetalar,juvenile,lamina,lanceolate,leave,lobe,lower,mature,mid-point,midrib,minute,nflorescence,oblique,orolla,pair,part,per,pore,porrect,present,prickle,ruit,septum,shallowly-lobed,short,side,simple,spaced,sparse,sparsely,stalk,stellae,tal,tamen,tem,thick,throughout,tissu,tissue,transparent,tube,unarme,unarmed,unbranched,unit,upper,vary,wide,without,ympodial	abaxial,adaxial,apparent,bilobed,color,colour,corolla,form,growth,height,history,life,ovary,plant,position,reproduction,seed,spacing,staman,stem,texture,thicknes
346	wfo-0001028280	success	87	81	37	50	44	0.425	.5,1-2,1-2-flowered,2-2.5,2-3,acuminate,almost,apex,bark,base,ciliate,closely,cm,dark,elliptic,fruiting,glabrous,globose,green,lanceolate,leaf,margin,minutely,mm,narrowly,new,opposite,pedicel,pendant,petiole,scar,shrub,simple,spaced,stem,surface,woody	0.7-1,1.5-2.7,6-9,7-8,anthesi,ape,arching,attenuate,axil,berry,branch,brow,completely,decurrent,dia,eaf,eed,flattened,immature,know,known,lateral,lon,long,lower,main,middle,nflorescence,older,onto,pair,papillae,present,rounded,ruit,sessil,small,somewhat,tall,tip,ud,ultimate,unifoliat,unit,vein,widest,winged,x,ympodial,young	0.5,2,abaxial,adaxial,anther,arrangement,brown,bud,calyx,color,colour,corolla,diameter,filament,flower,form,fruit,growth,height,history,inflorescence,length,life,na,number,ovary,peduncle,perennial,plant,position,prickle,rachi,reproduction,seed,sessile,shape,spacing,staman,stigma,style,texture,trichome,unifoliate,width
347	wfo-0001028281	success	267	129	113	154	16	0.423	-0.9,-1,-10,-20,-3,-36,-45,-5,-7,0.2-0.5,0.2-0.7,0.3-0.5,0.3-1,0.5-0.6,0.5-0.7,0.5-1,0.5-1.1,0.5-1.2,0.7-2.5,0.75-1,1-1.5,1-3,1-5,1.0-1.6,1.1-1.4,1.1-2.4,1.2-1.6,1.4-4,1.7-2.5,10-30,2-4,2-6.5,2.1-3.0,20-30,3-16,3-8.5,6,7-30,abaxial,adaxial,anther,apical,appendage,articulation,base,broadly,calyx,capitate,cm,column,conical,corolla,dark,deep,densely,diameter,distal,doubly,elliptic,elongate,filament,flower,form,fruit,fruiting,globose,golden,green,hair-like,half,imparipinnate,inflorescence,interjected,interrupted,lateral,leaf,leaflet,lobe,long,margin,mm,narrowly,obovate,once-branched,outgrowth,ovary,paler,pedicel,peduncle,petiolule,primary,pseudostipule,pubescent,regularly,rotate,serrate,shrub,small,sparsely,staminal,stem,sterile,stigma,style,surface,terminal,three,trichome,type,unicellular,uniseriate,vine,yellow	+,-8,.2,.4,.5,0.05-0.4,0.1-0.15,0.15-0.2,0.2-0.3,0.5-,0.7-,0.7-1.2,0.8-1,1,1-,1.2-1.5,1.5-2,1.5-6,10-18,2-13,2-4-celled,2-locular,2.5-,3-5,3-foliate,5-8-celled,6-15,abaxially,absent,acuminate,acute,almost,alternate,anthesi,apex,appearance,appressed,arising,autogamous,axi,basiscopically,bent,berr,blade,bract,bracteate,branching,brown,cell,composed,covering,darker,decreasing,decurrent,developed,dry,eaf,edicel,eed,eglandular,either,elongate-triangular,enclosing,entire,exerted,exserted,extended,fragile,free,generally,giving,glabrous,gland,glandular,gree,hal,halfway,head,included,internode,large,largest,less,like,lon,longest,lower,material,medial,midvein,minute,mixture,multi-celled,multi-cellular,multicellular,nflorescence,node,oblique,occasionally,opposite,orbicular,other,ovate,pair,pale,patent,petiole,point,population,portion,present,primarily,probably,proximal,rachi,rest,ruit,secondary,serrat,sessile,set,shorter,silky,size,smaller,smooth,sometimes,sparser,sprawling,stiff,straight,stripe,strongly,subopposite,tem,tertiary,testa,thick,thin,tip,toward,transparent,tube,ud,unit,usually,vein,wall,weak,weak-walled,well,wide,winged,ympodial	1-2,2.5-6-15,arrangement,bud,color,colour,growth,height,length,number,plant,seed,shape,texture,thicknes,width
348	wfo-0001028294	success	222	114	88	134	26	0.396	%,0-1,0-6,0.5-0.6,0.5-2,1,1-2.5,1-3.5,1.5-3.5,1.5-7,1.9-7,17-25,2-2.5,2-3,30-40,4.5-6,5-12,50-100,50-140,8-10,8-18,acuminate,acute,adult,andromonoecious,anther,apex,base,broad-based,broadly,chartaceous,cm,cordate,cuneate,curved,decimetre,densely,diameter,dm,entire,extra-axillary,flower,fruit,glabrous,globose,green,grey-green,inflorescence,juvenile,lamina,leaf,length,lilac,lobed,longer,margin,mm,oblique,obtuse,ovate,pale,part,pedicel,peduncle,per,perennial,petiole,plant,prickle,rachi,repand,shallowly,simple,sparsely,stellate,stellate-pubescent,stigma,straight,style,surface,time,unbranched,vine,white,wide,yellow,yellowish,yellowish-green	0-0.2,0-0.4,0-10,0.1-0.15,0.2-0.3,0.25-0.4,0.25-0.5,0.3-0.4,0.3-0.5,0.5-1,0.7-1.2,0.7-1.5,0.8-1,0.8-1.2,1-2,1-6,1.3-1.5,1.7-2.4,11-15,11-22,18-22,18-40,2-3.5,2-5,2-foliate,2-locular,2.5-7,4-6,4-8,5-13,5-8,5-merou,6-8,7-10,7-8,9-13,9-15,abaxially,absent,accrescent,across,adaxiall,adaxially,alyx,anvil-shape,apart,armed,articulated,ascending,axe,ba,blade,branch,branche,brown,calyx,capitat,connivent,cross-section,cylindrical,deltate,directed,distall,distally,distributed,eaf,eed,eglandular,elliptic,erect,exocarp,finger,fruiting,functional,geminat,gland-tipped,grey,hair,half,heterostylous,juicy,lanceolate,lateral,less,lobe,long,loosely,lower,markedly,mature,mesocarp,mid-point,midpoint,midvein,minute,moist,nflorescence,orolla,pair,placenta,pore,porrect,presen,present,ray,ruit,rusty,scattered,scrambling,semi-circular,sessile,short,slightly,spaced,stalk,stalked,stellae,tal,tamen,tem,thick,thicker,throughout,toward,tube,unarme,unarmed,unit,upper,vary,vein,weakly,x,ympodial	5-merous,abaxial,adaxial,arrangement,capitate,color,colour,corolla,distribution,filament,form,growth,height,history,life,na,number,ovary,percentage,position,reproduction,seed,shape,spacing,staman,texture
349	wfo-0001028298	success	188	125	97	91	28	0.516	.5,0-0.1,0.3-0.4,0.5-1,0.6-0.7,0.7-1,0.8-1.7,1-1.5,1-3,1-4,10-11,2-3,2-7,2-foliate,2.5-3,3-7,4-5,5-8,7-8,8-11,abaxially,absent,accrescent,acute,adaxially,adult,anther,apex,base,calyx,chartaceous,cm,contiguous,cordate,densely,diameter,entire,exceeding,extra-axillary,filament,finger,flower,fruit,fruiting,glabrous,gland-tipped,globose,hair,inflorescence,juvenile,lateral,leaf,length,lilac,lobed,long,margin,mature,midpoint,mm,moderately,nearly,obtuse,ovate,pale,part,pedicel,peduncle,perennial,petiole,prickle,rachi,ray,red,reniform,reticulate,rhizomatous,rotate-stellate,sessile,shallowly,short,shrub,stalk,stellate-pubescent,stigma,style,surface,thick,throughout,time,truncate,unbranched,unit,white,x,yellow,yellowish	%,0.1-0.2,0.15-0.3,0.2-0.4,0.25-0.4,0.3-0.5,0.4-0.5,0.4-0.65,1-2,1-locular,1.5-2,1.5-3.5,1.9-2.5,17-25,2.2-2.5,3-5,4-9,4.5-8,5-6,5-7,5-merou,6-8,7-12,9-10,absen,across,acuminate,alyx,apart,apparen,articulated,axe,ba,blade,broadly,brown,capitat,connivent,cylindrical,deltate,directed,distall,distributed,eaf,eed,eglandular,elliptic,erect,exocarp,geminat,grey-green,incomplete,interpetalar,juicy,lamina,lanceolate,lobe,lower,mesocarp,minute,nflorescence,oblique,orolla,per,perfect,placenta,pore,porrect,present,probably,pseudo-umbellate,ruit,septum,simple,soliary,somewhat,spaced,stellae,succulent,tal,tamen,tem,tissu,tissue,transparent,tube,unarme,unarmed,vary,wide,ympodial	5-merous,abaxial,adaxial,branching,capitate,color,corolla,form,geminate,growth,height,history,life,na,number,ovary,plant,position,presence,reproduction,seed,shape,spacing,staman,stem,sympodial,texture,thicknes
350	wfo-0001028317	success	204	140	111	93	29	0.544	-1.5,-5,/5,0-1,0.1,0.1-0.3,0.3-1,0.5-3.5,0.6-1.2,0.6-1.5,0.8-1.1,1-1.3,1-3,1-4,1.4-2,2/3,3-10,3-4,3-5,4-5-merous,5-8,abaxially,absent,acute,almost,anther,apart,apex,articulated,bark,base,berry,branched,bright,brown,chartaceous,cm,cream,cuneate,curved,dark,densely,diameter,distance,dull,erect,eye,filament,filiform,flattened-reniform,flower,fruit,glabrous,gray,green,herb,lanceolate,lateral,leaf,length,lobed,margin,marking,maturity,mauve,midvein,mm,moderately,naked,obtuse,orange-brown,ovate,pair,pale,pedicel,peduncle,petiole,porrect,prickle,prickly,primary,purple,red,sessile,shrub,simple,sometimes,sparsely,spherical,stalked,stellate-pubescent,stem,straight,style,surface,terete,terminal,tertiary,tip,toward,trichome,truncate,variously,vein,venation,visible,way,white,yellow,yellow-green,young	0,0-5,0.1-0.25,0.1-0.4,0.3-0.4,0.6-0.8,0.8-2.5,1.1-1.9,1.8-2.5,1/,1/3-1/4,1/4-2/3,1/5,2-2.8,2-4,2-4.5,2.5-6.5,2.8-3.3,4-6,4-8,6-10,acuminat,alyx,apar,apically,apparently,blade,broad-deltate,brow,calyx,concolorous,deltate,difoliate,drying,eaf,eed,elongating,equal,extending,free,fruiting,geminat,hair,herbaceous,infructescence,lobe,long,longer,lower,mature,midpoint,minute,nflorescence,oblong,older,one,open,orolla,oung,pendulous,per,perfec,pericarp,poricidal,portion,prickl,ray,reduced,reflexed,rounded,ruit,scandent,scar,shorter,side,smooth,spaced,spreading,stalk,stellate,subsessile,tamen,tapering,time,translucent,tube,unarme,unarmed,unit,upper,vary,wide,ympodial	abaxial,adaxial,arrangement,color,colour,corolla,extension,form,growth,height,history,inflorescence,life,na,number,ovary,pattern,perennial,plant,position,rachi,reproduction,seed,shape,spacing,staman,stigma,texture,width
351	wfo-0001028323	success	164	131	104	60	27	0.634	-2,0.2-0.5,0.2-1,0.4-1.3,0.5,0.6-1,1-1.5,1.5-2.5,2-3,3,3-6,3.5-4,5-6,7.5-9,acute,anther,anthesi,apart,apex,appressed,articulated,attenuate,bark,base,blue-green,brown,c.,cell,cm,conical,corolla,dark,dendritic,densely,diameter,drying,ellipsoid,elliptic,entire,erect,fading,filament,fleshy,flower,fruiting,glabrescent,glabrous,globose,grey,growth,inflorescence,leaf-opposed,lengthening,lobed,margin,maturity,minute,minutely,mm,new,occasionally,ovary,ovoid,pair,pale,papillose,pedicel,peduncle,peg,perfect,petiole,pitted,poricidal,primary,pubescent,reddish,remaining,revolute,rounded,scar,shiny,shrub,simple,small,soft,sometimes,somewhat,sparsely,stem,stigma,straight,style,surface,testal,tip,trichome,uniseriate,vein,violet,wall,way,white,woody,x	0.5-1,0.8,0.9-1.2,1,1-1.2,1-2,1.1-4.5,1.5,2-9,3-5,abaxially,abscissio,absent,along,apparently,ba,berry,calyx,capiatate,coriaceous,cup-shaped,deltate,eaf,eed,free,glabrescen,included,internodal,lanceolate,less,like,lobe,longer,lower,main,nflorescence,ovate,papillat,pericarp,planar,plurifoliat,pore,portion,proceed,ruit,scattered,shoot,short,sinus,soon,sparely,splitting,tearing,thick,thin,tube,tuft,ud,unit,ympodial	abaxial,abscission,arrangement,bud,capitate,color,colour,form,fruit,hair,height,history,inclusion,leaf,length,life,number,papillate,perennial,plant,position,reproduction,seed,shape,spacing,staman,texture
352	wfo-0001028328	success	215	128	106	109	22	0.493	-15,0-4,0.2-0.5,0.5-1,1,1-1.5,1-2,1-6,1-7,14,15-20,16-30,2-10,2-9,20-35,3-4,5-10,5-7,50,6-18,7-30,abaxially,absent,abundantly,adaxially,anther,apart,apparently,armed,articulated,base,blade,branched,broad-based,brown,chartaceous,cm,compressed,dark,densely,diameter,elliptic,elliptic-ovate,extra-axillary,filament,flattened,flower,flowering,forked,fruit,glabrous,globose,green,hair,inflorescence,juvenile,leaf,leaf-opposed,light,lighter,like,lobe,long,membanaceous,midpoint,minutely,mm,moderately,multangulate,nearly,outline,pedicel,peduncle,petiole,plant,porrect,prickle,rachi,reflexed,reniform,ripe,rugulose,sessile,sharp,shiny,short,short-stalked,simple,smooth,somewhat,stellate,stellate-pubescent,stem,stigma,straight,strongly,style,subcoriaceous,surface,tip,tomentose,unarmed,white,x,yellow,young	.2,.5-2,0-0.3,1.5-2,2-2.5,2-3,2-4,2-4-lobed,2.5-3,20-30,4-7,5-merou,6-8,7-.,7-10,7-14,7-9,8-18,accrescent,acuminate,acute,adaxiall,ag,alyx,andromonoecious,apex,apiculate,axe,ba,berry,calyx,capitat,coarsely,congested,connivent,covering,cylindrical,differentiated,difoliate,directed,discolorous,distally,eaf,eed,entire,equal,except,ferruginous,free,frui,fruiting,geminat,half,heterostylous,highly,interpetalar,leave,lobed,longitudinal,lower,major,margin,minor,narrowly,nflorescence,oblique,obtuse,often,one,opening,orolla,paired,part,perfect,perhaps,pericarp,pore,pubescent,ray,rounded,ruit,runk,shallowly,side,slightly,slit,small,spaced,sparse,stalk,staminate,subcuneate,subtending,tamen,tapered,thi,time,tissue,tree,triangular,truncate,tube,tubevery,unit,vary,vein,whitish,wide,ympodial	abaxial,adaxial,adult,armament,arrangement,capitate,color,colour,corolla,height,length,number,ovary,position,seed,shape,size,spacing,staman,texture,trunk,type
353	wfo-0001028329	success	215	115	89	126	26	0.414	0.2-0.3,0.8-1.4,0.9-1.3,1-6,1.5-3.5,1.5-8,10-34,12,2-3,3-14,3-8,4-15,5-10,6-11,6-8,7-19,abaxially,acuminate,acute,adaxially,angled,anther,apart,apex,asperous,bark,becoming,blunt-tipped,branch,brown,bud,calyx,cm,conical,corolla,deltoid,diameter,filament,finely,flower,fruit,granular,granular-tomentose,gray,green,growth,honeycombed,lateral,leaf,length,long,longitudinally,minutely,mm,mostly,obelliptic,oblong,orbicular,ovate,ovate-elliptic,pale,pedicel,peduncle,petiole,rachi,reniform,reticulate-punctate,ripe,shrub,simple,slightly,small,stellate-rotate,stelliform,stigma,style,subglobose,suborbicular,time,tomentose,tree,turning,velutinous,white,whitish,wide,x,yellow,yellowish	.5-3,.75-2,.75-5.75,/10-3/10,0-100,0.8-1.1,1.0-1.4,1.1-2.5,1.3-1.8,1.3-2,1.5-2.3,1.5-2.75,2-4,2.2-3.9,2.6-5,2.75-4.5,3.75-7,3/4,4-5,6-9,absen,ag,anthesi,apical-lateral,apparently,articulated,axe,axillary,ba,base,berry,blade,branched,chartaceous,closely,continued,cylindrical,dehiscing,dendritic-echinoi,dendritic-echinoid,dichotomously,distantly,distinct,due,eaf,echinoid,eed,entire,fleshy,free,glabrescen,glabrous,grooved,hair,high,inserted,introrse,large,lengthening,lobe,lobed,long-attenuate,lower,main,margin,midvein,moderately,multangulat,multangulate,nflorescence,obovate,obscured,obtuse,occasional,older,orolla,perfect,plurifoliate,pore,porrect-stellate,present,pseudo-terminal,pubescent,rather,receptacle,relatively,ruit,runk,sessil,sessile,several,short-,short-stalked,side,slit,sometimes,spaced,sparse,sparsely,stalked,stellat,stellate,stellate-pubescent,stem,subcapitat,suture,swollen,tamen,testa,thick,thickened,thin,tomentu,touching,toward,tube,unarme,unarmed,unit,usually,vary,vein,vestigial,way,ympodial,young	0.5-3,1.75-2,20-100,4.75-5.75,angle,arrangement,color,form,glabrescent,height,inflorescence,number,ovary,plant,pseudoterminal,ratio,seed,shape,spacing,staman,subcapitate,surface,texture,thicknes,tip,width
354	wfo-0001028337	success	195	124	103	92	21	0.528	.5,.8,0.05-1,0.3-0.5,0.4-0.8,0.7-1,1-1.8,1-2,1-3,1.5-4,15-50,2-4,4-5,5-6,5-8,5-merous,6-7,abaxial,abaxially,adaxial,anther,apex,bark,base,branched,calyx,chartaceous,cm,color,conical,cuneate,curved,dark,deltate,densely,diameter,entire,erect,evenly,filament,flattened-reniform,flower,free,fruit,gently,glabrescent,glabrous,glaucous,gray,gray-brown,green,green-brown,hair,inflorescence,lateral,leaf,length,lobe,long-styled,margin,marking,mauve,minutely,mm,moderately,narrow-oblong,one,open,orange-brown,pale,pedicel,petiole,pitted,poricidal,porrect-lepidote,portion,prickle,reddish,rounded,scar,sessile,shallowly,shrub,simple,smooth,sparse,spherical,stellate,stellate-pubescent,stem,stout,straight,style,surface,terete,terminal,time,tip,trichome,tube,unarmed,white,young	-2,-2.5,-4,-6,/3,0,0.05-0.15,0.1-0.3,0.4-0.7,0.7-0.9,1,1.5-3,1.8-2,1/2,1/3-2/3,1/4-1/3,1/8-1/4,11-16,2-2.2,3-4,5-25,8-10,8-14,acut,alyx,apar,apart,ape,apically,apparently,articulated,berry,blade,connivent,discolorous,drying,eaf,eed,elongating,equal,eye,fruiting,fused,glabrou,infructescence,juvenil,juvenile,known,lobed,long,longer,lower,mature,midpoint,naked,nflorescence,occasionally,older,orolla,oung,peduncle,per,perfect,pericarp,plurifoliat,porrect,prickly,primary,ray,reflexed,ruit,shoot,short,short-styled,shorter,slender,small,spaced,staminate,strongly,tamen,tapering,toward,unarme,unit,usually,vary,vein,visible,way,wide,ympodial	branching,colour,corolla,density,form,growth,height,na,number,opening,ovary,plant,position,reproduction,seed,shape,spacing,staman,stigma,texture,width
355	wfo-0001028339	success	195	134	106	89	28	0.544	.5,1-2,1-5,1.1-1.4,1.2-1.5,1.5-2,1.7-3.2,3.5-4,5-7,8182,acuminate,acute,anther,anthesi,apex,bark,base,becoming,beneath,berry,blue,brown,bud,calyx,capitate,closely,cm,corolla,cup-shaped,dark,decurrent,deflexed,dia,dried,dry,enclosed,erect,evenly,exserted,filament,first,flattened,flower,fruiting,glabrate,glabrous,globose,growth,later,leaf,like,little,lobe,lobed,long,long-triangular,margin,minutely,mm,mustard,nearly,opposite,ovary,ovate,ovoid,ovoid-reniform,papillate,papillose,pedicel,petiole,pitted,pulp,red-brown,reflexed,schwarz,shining,shrub,simple,slender,slightly,small,somewhat,spaced,sparsely,specimen,speckled,stem,stigma,style,surface,tapering,texture,tip,tree,trichome,tube,uniseriate,urceolate,vein,white,white-speckled,winged,woody,yellow,yellowish,young	0.05-0.1,0.8-1.2,1-1.2,1-1.5,1.5,10-30-flowered,10.2-18.5,2.5-5,3.4-5.5,43191,5-angled,5.8-7.9,7-11,8-10,across,almost,appearance,appearing,appressed,attenuate,broadly,carinate,carpel,connate,covered,crystalline,cuneate,densely,differing,difoliate,distinctly,eaf,edicel,eed,epidermi,fide,filiform,floccose,free,frui,geminat,grainy,greyish-brown,irregular,large-celled,lateral,leave,lon,lower,main,major,middle,minor,nee,nflorescence,oblique,obscure,occasionally,older,one,overlappin,papery,planar,pore,poricidal,portion,proximal,ruit,scar,secondary,septum,shaped,size,straight,strong,strongly,tall,tear-drop,tightly,tub,ud,unit,venation,white-lenticellat,white-papillo,wide,widest,x,ympodial	10-30,abaxial,adaxial,arrangement,color,colour,diameter,form,fruit,height,history,inflorescence,length,life,na,number,peduncle,perennial,plant,position,rachi,seed,shape,spacing,staman,white-lenticellate,white-papillose,width
356	wfo-0001028351	success	175	115	88	87	27	0.503	.2,.8,0,0.2,0.5,0–,1.0–2.0,1.0–2.5,2.0–2.5,2–4,3–4,40,5.0,5.0–5.5,5–7,8–15,abaxially,acute,adaxially,along,annual,anther,anthesi,apart,apex,articulated,base,blue,branching,brown,capitate,clavate,cm,colour,densely,diameter,erect,filament,flattened,flower,fruit,glabrous,glandular,globose,green,hair,herb,leaf,like,lobe,lobed,long,margin,midvein,mm,moderately,multicellular,number,obtuse,opposed,ovate,pair,pale,pedicel,peduncle,pentagonal,perennial,petiole,pitted,pubescent,regularly,serrate,shallowly,shiny,simple,stem,stigma,style,surface,truncate,unbranched,unicellular,uniseriate,unknown,velutinous,white,x,–3.0	.8–1.0,0.1,0.6,1.0–,1.0–1.6,1.4–1.5,1.5–4.0,1.6–,10,2,2.0–5.0,2.1–3.5,2/3,2–2.5,3,3.4–5.0,4,5,5.5–10.5,6.5–8.5,6–12,absent,adaxiall,ag,apical,axe,ba,basal,becoming,blade,calyx,cell,chartaceous,connivent,convex,cylindrical,directed,distally,eaf,eed,equal,fleshy,geminat,indumentum,lamin,lanceolate,lon,longitudinal,lower,m.,narrowly,nfloresence,oblong,occasionally,opening,orolla,perfect,plurifoliate,pore,present,probably,ruit,shaped,side,slender,slit,smaller,spaced,sparsely,stone,straight,tal,tamen,tardily,teardrop,tem,time,tube,unit,vary,wide,wing,winged,woody,ympodial,young,–	1.5,abaxial,adaxial,arrangement,axi,color,corolla,form,growth,height,history,inflorescence,lamina,length,life,na,ovary,plant,position,rachi,reproduction,seed,shape,spacing,staman,texture,width
357	wfo-0001028353	success	177	137	110	67	27	0.621	0.2-0.4,0.5,0.5-,1,1-2,1.4-2,1.5-2,2,2-3,2-4,3-5,6-8,7,abaxially,acute,along,anther,anthesi,apart,apex,becoming,beneath,bluntly,bright,calyx,campanulate,capitate,cell,centre,cm,conical,corolla,cup-shaped,dark,deep,deeply,densely,diameter,ellipsoid,elliptic,erect,exerted,filament,fleshy,flower,fracturing,fruiting,glabrous,globose,green,greenish,herb,hollow,honey-comb,internodal,leaf,less,like,lobe,long,margin,midrib,minute,minutely,mm,nodding,often,open,ovary,ovoid,pale,papery,papillate,papillose,pedicel,peduncle,pericarp,petiole,pitted,plant,plump,principal,pubescent,purple,rhomboid,ripe,scattered,simple,size,slender,somewhat,sparsely,stem,stigma,straight,strongly,style,surface,tan,testal,thin,tip,trichome,truncate,tube,uniseriate,vein,wall,x,yellow	.5,/3,0.9-1.2,1-4,1.5-5,3,4-7,8-10,accrescent,age,area,base,berry,ciliate,clasping,coarsely,cordate,curved,decreasing,decumben,difoliate,distally,dry,drying,eaf,edicel,eed,emarginated,free,frui,geminat,gree,growing,heteromorphic,horn,horned,inserted,lengthening,lon,lower,m.,material,nflorescence,outline,pair,point,pore,poricidal,portion,primary,reddish,ruit,scar,sessil,sessile,shallow,short,sleeve,slightly,slit,toothed,toward,ud,unit,way,wrinkled,ympodial	abaxial,adaxial,arrangement,bud,color,colour,form,fruit,growth,height,history,inflorescence,length,life,na,number,perennial,position,rachi,reproduction,seed,shape,spacing,staman,texture,thicknes,width
358	wfo-0001028367	success	178	110	67	111	43	0.376	0.5,1.5,60,abaxially,anther,anthesi,apex,base,black,blue,branched,brown,cm,colour,cuneate,dark,densely,diameter,filament,flattened,flower,fruit,glabrous,globose,grey-green,hair,leaf,lobe,lobed,longitudinal,margin,mm,moderately,multicellular,oblong,obtuse,opening,opposed,ovate,pair,pale,pedicel,peduncle,pentagonal,perennial,petiole,pore,pubescent,purple,regularly,rounded,shiny,shrub,simple,slit,stigma,style,surface,texture,time,tomentose,unicellular,uniseriate,unknown,white,x,yellow	0.2,0.2–0.4,0.4–2.3,0.5–3,0.8–0.9,1,1.0–1.8,1.2–3.0,1.3–9.0,1.4–2.0,1.5–1.7,1–,1–1.5,1–2,2.0–4.2,2.0–4.5,2.8–3.1,2–10,2–3,3.5–6.9,3–3.5,3–5,4–10,4–7,5,5–5.8,5–6,6.5–8.5,6–8,6–9,7–15,8.5–9.5,8–17,8–23,absen,accrescent,adaxiall,adaxially,ag,apart,apical,arising,articulated,axe,ba,basal,blade,calyx,cell,chartaceous,concave,connivent,cylindrical,deeply,diamete,directed,eaf,eed,equal,erect,geminat,glabrescen,half,lanceolate,laterally,lon,long,longer,lower,marking,narrowly,nflorescence,obliquely,orolla,perfect,pitted,poricidal,primary,probably,ruit,secondary,shorter,side,smaller,spaced,stone,straight,strongly,tal,tamen,tapering,tem,three,tip,toward,tube,two,unequal,unifoliate,unit,usually,vary,wide,width,woody,ympodial,–10.0,–25,–5.0,–5.5,–7	0.2-0.4,1.3-9.0,2-3,2.8-3.1,25,3-3.5,3-5,4-10,4-7,6-8,6.5-8.5,7,8-17,8.5-9.5,abaxial,absent,adaxial,age,arrangement,branching,color,corolla,direction,form,growth,height,history,inflorescence,lateral,length,life,number,ovary,plant,position,presence,reproduction,seed,shape,spacing,staman,stem,type
359	wfo-0001028370	success	147	93	69	78	24	0.469	-0.6,0.2-0.4,1.0-1.7,1.5-2.2,1/2-2/3,2-4,2-8,2.5-2.9,3-5,3-7,3.5-5.0,4-10,9-12,acicular,anther,armed,blade,blue,broadly,brown,bud,calyx,campanulate,capitate,cm,coarsely,dark,deltoid,densely,dm,eglandular,foveolate,glabrous,glandular,green,hair,internodal,lanceolate,lenticular,lobe,long,minutely,mm,obovoid,obtuse,ovate,pentagonal,petiole,pinnatifid,pinnatisect,prickle,prickly,purple-tinged,ridged,rounded,seed,sparsely,spherical,stem,subulate,terete,tube,twice,ultimate,usually,variously,violet,viscid,yellow	/3,0.8,4-11,40-70,5-9-flowere,accrescent,acro,across,along,alyx,ample,annual,anthesi,attenuate,ature,base,beneath,berry,branched,broad,developing,dia,difoliate,distinct,divided,dry,eaf,extended,few-rayed,fully,geminat,gland,gland-tipped,hardly,herb,high,incurved,interpetalar,invested,lon,main,markedly,maturity,narrowly,near,nflorescence,oblong,often,one,orolla,per,plicat,ruit,scattered,sessile,short,short-stipitate,simple,slende,slightly,somewhat,splitting,spreadingly,stellae,strait,surrounding,tamen,taprooted,terminal,tightly,tigma,tissue,tub,tyle,unti,vary,vein,ympodial	5-9-flowered,arrangement,color,colour,corolla,diameter,filament,flower,fruit,height,inflorescence,leaf,length,mature,number,ovary,plant,position,shape,staman,stigma,style,surface,texture
360	wfo-0001028390	success	147	96	67	80	29	0.456	-10,0,0.5,0.5-1,0.5-1.5,0.5-2.5,1-2.5,1-5,1.5-2,1.5-3.5,10-15,2,2.5,5-7,7,7-8,acute,angled,apart,apex,articulated,base,chartaceous,cm,curled,cylindrical,dendritically-branched,densely,diameter,elliptic,felty-pubescent,flower,forked,glabrous,globose,hair,lanceolate,lobe,mm,narrowly,near,orange,ovate,pedicel,peduncle,petiole,pseudohair,pubescent,rachi,rarely,shrub,simple,sparsely,stellate,stigma,style,subclavate,subcoriaceous,triangular,truncate,tube,unbranched,violet,white,white-pubescent,x,yellow	.5-3.3,1,1-3,1.5-5.5,3-4,3-5,4-11,4-5,6-many-foliat,9,abaxially,absen,adaxiall,adaxially,aggregate,apiculate,axe,blade,branched,calyx,cell,connivent,cuneate,deltate,dendritically,dense,directed,distall,divided,eaf,eed,eglandular,entire,gland,leaving,less,like,lon,long,lower,margin,midvein,mixed,moderately,mostly,nflorescence,nther,obtuse,occasionally,often,orolla,peg,perfect,pore,presen,puberulent,pubescen,radiu,ripe,ruit,scar,short,slightly,small,spaced,stalked,ste,stone,subcapitat,subcordate,tal,tem,time,tip,unequally,unit,usually,vary,wide,ympodial	abaxial,adaxial,anther,arrangement,color,colour,corolla,form,fruit,growth,height,history,inflorescence,leaf,length,life,na,number,ovary,perennial,plant,reproduction,seed,shape,spacing,subcapitate,surface,texture,width
361	wfo-0001028399	success	273	127	100	173	27	0.366	.3,.8,4.3,5.0,9.1,9.8,abaxially,acute,adaxially,aequilateral,age,anther,apart,apex,attachment,base,based,becoming,blade,broad,brochidodromous,bud,calyx,channeled,chartaceous,cm,corolla,cunate,densely,developed,diameter,distinct,dry,elliptic,emerging,entire,exocarp,extra-axillary,filament,flattened-orbicular,flattened-reniform,flower,fruit,glabrous,globose,glossy,internodal,internode,interpetalar,lateral,leaf,length,lobed,long,margin,mature,midvein,mm,moderately,narrowly,notched,oblique,orange,ovate,pedicel,peduncle,petiole,point,position,prickle,probably,pubescent,raised,red,reticulate,rounded,scattered,short,simple,sinuate,spaced,sparse,stellate,stellate-pubescent,stem,stigma,straight,style,surface,thin,tissue,toward,triangular,upper,vein,weakly,well,yellow-ferruginous,yellow-tan,young	.4,.5,.5–2.4,/3,0.04,0.06,0.13,0.2–0.3,0.3–0.4,0.3–0.5,0.3–0.6,0.4–0.5,0.4–0.6,0.4–0.7,0.4–0.9,0.5–1.1,0.5–1.3,0.7–1.0,0.7–2.3,0.8–2.5,0.9–1.9,1.0–5.5,1.1–1.4,1.1–1.7,1.2–1.5,1.2–1.7,1.2–2.0,1.3–2.0,1.4–2.4,1.5–2.1,1.6–2.3,1.6–2.5,1.7–2.7,1/2–2/3,1/3–1/2,1/4–1/3,2.0–3.9,2.2–2.6,2.2–2.8,2.2–2.9,2.4–3.2,2.5–11.2,2.8–3.0,3.1–3.8,3.2–3.8,3.4–3.6,4.0–5.4,4.2,4.4,5,5-merou,5.2–17.8,5.4,5–8,5–9,6.0–6.6,7.0,7–11,8–120,absent,adnate,alyx,anthe,anthesi,apiculate,apparently,appearing,appressed,arching,articulate,attenuate,axe,ba,bark,basal,berry,branch,branching,broad-based,brown,capitat,deciduous,dehiscent,deltoid,dentate,difoliate,distal,eaf,eed,either,erect,extending,fertile,filiform,flexed,free,geminat,glandular,gradually,hair,heterostylous,increasing,incurved,intersepalar,juic,lanceolate,large,layer,lobe,lon,longer,longitudinally,lower,major,many,midpoint,midrib,minor,minute,nearly,nflorescence,oblong,orolla,per,porrect,porrect-stellate,portion,potentially,primary,ray,red-orang,reddish,reflexe,restricted,ridge,rigid,row,ruit,secondary,sessile,shorter,shrub,side,sinus,slit,sloughing,somewhat,soon,splitting,spread,spreading,stamen,stellae,stipe,stipitate,tamen,tem,time,tip,translucent,transparent,truncate,tube,two,ud,unarmed,various,vary,wide,ympodia,±90°,±equal,×	0.5-1.3,0.7-2.3,1.0-5.5,1.1-1.4,1.2-1.7,1.2-2.0,1.5-2.1,1.6-2.5,2.2-2.9,5-merous,8-120,abaxial,adaxial,arrangement,capitate,color,feature,inflorescence,number,ovary,red-orange,ridged,seed,shape,spacing,staman,texture
362	wfo-0001028405	success	149	90	63	86	27	0.423	0.4-0.5,1-4,1-9,1.5-6.5,10-11,2,3-20,4-6,8-15,apex,articulate,branched,cell,cm,conical,corolla,covering,cyme,diameter,dichasial,dichasially,digestion,distal,ebracteate,elliptic-lanceolate,enzyme,filament,flower,green,green-white,hair-like,half,herbaceous,honeycomb,lanceolate,lateral,leaf,long,mm,monochasial,mucilaginous,odd-pinnate,ovoid,pattern,pedicel,peduncle,perennial,petiole,plant,proximal,puberulent,rachi,seed,size,stellate,stigma,style,testal,thick,throughout,wall,yellow,¼	0.5-3,1.3-8,2-2.5,2-3,2-4,3-4,3-6-foliat,3.5-10,3.5-6.5,4-11.5,6-7,7-14.5,9-15,abaxially,absen,acumen,acute,adaxially,apical,apically,apiculate,attenuate,base,calyx,connate,decurrent,dehiscent,diminishing,dorsally,eaf,edge,eed,elliptic,emoval,exceeding,flat,folded,forked,generally,globo,gradually,interjected,introrse,leaflet,living,lobe,lon,lower,lunat,make,maturing,nflorescence,nther,oblique,oblong,often,orolla,ovate-elliptic,pair,perfect,plan,poricidally,reveal,ruit,seudostipule,short,short-acuminate,short-petiolate,slit,specimen,stamen,straight,subsessile,tal,tem,terminal,throughou,toward,tuber-bearing,typically,unit,vary,whit,wide,without,ympodial	abaxial,adaxial,anther,arrangement,color,colour,form,fruit,globose,growth,height,history,inflorescence,length,life,na,number,ovary,position,reproduction,shape,spacing,staman,surface,texture,white,width
363	wfo-0001028424	success	253	121	106	147	15	0.419	-0.8,-3,-9,0-1,0.1-0.2,0.15-0.4,0.2-0.7,0.3-0.7,0.5,0.7-2,1,12-19,2-3,2-4,3,3-12,3-6,3-8,5-10,5.5-10,abaxially,acute-,adaxially,anther,attenuate,base,broadly,cauline,cm,coarsely,connivent,deeply,deltoid,deltoid-orbicular,densely,dentate,depressed-deltoid,diameter,diverging,elongate,elongate-lanceolate,extra-axillary,felty,filament,flower,fruit,globose,hair,inflorescence,inserted,lateral,leaf-opposed,length,lenticular,less,light,like,lobe,long,margin,midpoint,minutely,mm,narrower,obtuse-,occasionally,orange,outline,ovate,pentagonal-stellate,persistently,petiole,pitted,prickle,pubescent,ray,round-tipped,sessile,short,simple,size,small,somewhat,spreading-hirsute,stellae,stellate,stellate-puberulent,stellate-pubescent,stem,stigma,style,surface,tan,termination,thin-textured,trichome,truncate,unbranched,usually,vein,weakly,white,white-pubescent,wide,x,yellow	-1.2,-28,0-0.5,0.2-0.35,0.3-0.6,1-3,1-7,1.5-2.5,1.8-3,1/3-1/2,10-16,12,2,2-2.5,2-foliate,3-16,3-5,3-7,4-12,4-5,4-6,4-7,5-15,5-22,5-8,8-15,8-25,accrescent,acicular,acute,adaxiall,almost,along,and/or,apart,apex,articulated,ascending,axe,ba,blade,branched,broad-based,broader,calyx,campanulate,capitat,capitate-glandular,closely,commonly,conspicuously,convex,covering,curved,cylindrical,dense,diffusely,directed,distal,distally,distributed,divergently,eaf,eed,entire,equaling,exceeding,female-sterile,flexuous,fruiting,geminat,glabrous,gland-tipped,glandular,interlobal,larger,laterall,longer,lower,major,midrib,mixture,mostly,much,multiple-stemmed,multiseriate,nflorescence,numerous,obsolete,obtuse,often,orolla,ovate-lanceolate,pedicel,peduncle,per,perennial,perfect,pore,prickly,principal,puberulent,rachi,radiu,rarely,recurved,reduced,reflexe,resembling,ripe,ruit,scattered,section,short-styled,shorter,side,similar,single-,sinus,slender,smaller,sometimes,spaced,sparsely,species,stalk,stalked,ste,stout,strongly,subcordate,suffrutescent,tal,tamen,tem,thickened,time,tip,tube,typically,unarmed,unit,upward,variable,vary,widely,ympodial	abaxial,arrangement,capitate,color,corolla,height,leaf,ovary,plant,position,seed,shape,staman,texture,width
364	wfo-0001028429	success	162	125	92	70	33	0.568	0.2-0.4,1-4,1.5-3,10-11,2-3,2.5-12,2.5-7.5,2.7-3.6,4-14,6-18,6-28,7-7,abaxially,acuminate,acute,adaxially,apex,base,branched,broadly,cell,cm,cordate,corolla,covering,cuneate,cyme,darker,diameter,dichasial,dichasially,diminishing,distal,ebracteate,elliptical,filament,flower,forked,glabrescent,glabrous,globose,gradually,green,green-white,greenish,hair,hair-like,half,herbaceous,honeycomb,interjected,lateral,leaf,leaflet,light,make,medium,mm,monochasial,mucilaginous,narrowly,oblique,odd-pinnate,ovate,ovoid,pattern,pedicel,peduncle,pentagonal,perennial,petiole,petiolule,plant,rotate,scattered,seed,size,slightly,spot,stigma,style,testal,thick,throughout,toward,tuber-bearing,typically,unit,violet,wall,white,yellow	0.8-1.2,0.9-2.3,1-2.5,1.5-4,10-27,10.5-21,2-1.,2-4,2-8,2.5-4,3-6,3-6-foliat,5-12,abaxiall,acumen,apical,apically,articulate,calyx,connate,dehiscent,digestion,dorsally,eaf,edge,eed,emoval,enzyme,especially,exceeding,flat,folded,generally,globo,introrse,living,lobe,lon,long,long-attenuate,lower,lunat,maturing,nflorescence,nther,obovate,often,orolla,pair,perfect,plan,poricidally,proximal,reveal,ruit,seudostipule,short,slit,specimen,stamen,straight,tal,tem,terminal,throughou,vary,vein,wide,ympodial,¼	2-19,3-6-foliate,abaxial,adaxial,anther,arrangement,color,colour,form,fruit,growth,height,history,inflorescence,length,life,lunate,na,number,ovary,position,pseudostipule,rachi,reproduction,shape,spacing,staman,surface,sympodial,texture,wet,width,ye
365	wfo-0001028436	success	150	84	58	92	26	0.387	.5,0.2-0.4,0.5,0.5-1,1-3,1.5,1.5-2,10-20,2.5-3,4,5-10,5-8,8-12,absent,acute,anther,apex,brown,center,chartaceous,diameter,dm,dried,edge,elliptic,filament,fine,flower,fruit,glabrous,globose,leaf,linear,margin,membranaceous,mm,moderately,nearly,oblong,parallel,pedicel,peduncle,petiole,pubescent,rachi,radiating,raised,ridge,rotate,running,shallow,shrub,stigma,style,surface,unifoliate,white,x	0.8-1.5,1-2,1-2-celled,1.5-2.5,1st,2-3,2-4,2nd,5-12,5-15,7,abaxially,abundant,adaxiall,adaxially,along,apically,appearance,appearing,axe,base,berry,beyond,blade,calyx,cell,ciliate,cm,connected,cordat,decurrent,deflated,dehiscent,difficult,due,eaf,eed,entire,evaluat,explosively,exserted,flat,frui,fruiting,geniculate,glabrescen,hair,interpetalar,lengt,like,linear-lancolate,lobe,long,lower,lying,much-branched,nflorescence,notch,often,older,orolla,oung,per,placenta,pointing,presence,pubescen,reaching,rhizomatous,ruit,small,sparsely,stamen,stem,structure,swollen,tal,tamen,taproot,tear,thick,tissue,triangular,tube,two-celled,unbranched,unit,vary,wid,woody,wrinkled,ympodial	abaxial,adaxial,arrangement,color,colour,corolla,form,growth,height,history,inflorescence,length,life,na,number,ovary,perennial,plant,position,reproduction,seed,shape,spacing,staman,texture,width
366	wfo-0001028465	success	159	99	71	88	28	0.447	0.75,1-4,11-23,2-6,2-9.3,2.4-2.8,3-5,4.5-5.5,8-10,9-19,apex,articulate,base,branched,broadly,cell,cm,corolla,covering,cyme,diameter,dichasial,dichasially,digestion,distal,ebracteate,elliptical,enzyme,filament,flower,globose,green,green-white,hair-like,half,herbaceous,honeycomb,interpetalar,lateral,leaf,medium,mm,monochasial,mucilaginous,odd-pinnate,ovoid,pattern,pedicel,peduncle,perennial,petiole,plant,proximal,puberulent,pubescent,purple,rachi,reveal,rotate,seed,spot,stigma,strigose,style,testal,thick,throughout,wall,white,yellow,¼	1-2,1.2-2,1.5-2.9,10,10-24,2,2-3,2-4,2.5-4,3-4,3-6-foliat,3-8,3.8-7,4-1.,4-8,5-7,7-15,abaxially,acumen,acuminate,acute,adaxially,apical,apically,attenuate,calyx,connate,cuneate,decurrent,dehiscent,diminishing,dorsally,eaf,edge,eed,emoval,equal,exceeding,first,flat,folded,forked,generally,globo,gradually,interjected,introrse,leaflet,living,lobe,lon,long,lower,lunat,make,maturing,nflorescence,nther,oblique,often,orolla,pair,perfect,petiolule,plan,poricidally,rarely,ruit,sessile,seudostipule,short,size,slit,specimen,stamen,straight,tal,tem,terminal,tissu,toward,tuber-bearing,two,typically,unit,vary,wide,ympodial	abaxial,adaxial,anther,arrangement,color,colour,form,fruit,growth,height,history,inflorescence,length,life,na,number,ovary,position,reproduction,shape,spacing,staman,stem,surface,texture,tissue,wet,width
367	wfo-0001028468	success	255	127	97	158	30	0.38	-5.5,.3-0.4,0.2-0.3,0.4-4,0.5-3,0.5-8,0.6-1.2,0.7-2.5,0.8-3.5,1.2-1.5,16,20,4-6,5-9,6-9,acute,anther,apart,apex,attenuate,base,berry,blue,broad-based,brown,chartaceous,clavate,cm,corolla,dark,densely,density,diameter,extra-axillary,filament,flattened,flower,foveate,fruit,glabrescent,glabrous,gray,green,greenish,lateral,length,light,lobed,main,margin,midvein,mm,moderately,narrowly,oblique,oblong-conical,orange,orangish,pale,pedicel,peduncle,per,petiole,prickle,purple,rachi,recurved,reticulate,rhombic,rotate-stellate,shallowly,short,shrub,side,simple,slightly,somewhat,sparsely,stellate-pubescent,stem,stigma,straight,style,subcapitate,subcuneate,subelliptic,subglobose,sublenticular,subreniform,subshrub,surface,terete,unbranched,vein,x,yellow,yellowish	-1.3,-10,-3,-4,-7,.1-0.2,.1-0.3,.1-0.4,.2,.2-0.4,.3,.5,.5-1.5,.5-1.6,.6-1,/10-1/5,/4-1/3,0.05,0.1,0.2-0.6,0.2-1.5,0.4-1,0.5-2,0.5-3.3,0.5-3.5,0.6-2,1,1.3-2,1.5-2.2,1.5-3.1,1.6,1/3-1/2,1/5-1/2,2,2-9,2.2-3,2.5-4,2.8-4.1,2/3-3/4,3-4,4-9,5-21,6-10,abaxially,accrescent,acuminate,adaxially,along,appressed,ark,armed,articulated,axe,becoming,beyond,blade,broadly,bu,bud,c.,calyx,campanulate,cauline,central,commonly,compresse,compressed,connivent,d.,decreasing,directed,distal,distally,distantly,dry,eaf,eed,ellipsoid,equal,exserted,fruiting,geminat,gradually,hair,half,increasing,inserted,interpetalar,introrsel,lamin,laterally,lobe,long,longer,lower,m.,midpoint,minutely,mixed,mostly,multangulat,multangulate,nflorescence,oblong-lanceolate,obtuse,occasionally,older,orolla,ovate,overlapping,ovoid,pair,papillo,perfect,pore,porrect-stellate,proximal,pubescence,pubescent,ray,reduced,relatively,ruit,sessile,short-,short-stalked,similar,similarly,spaced,specimen,stalk,stamen,stelliform,subacuminate,subchartaceous,subsessile,tal,tamen,testa,thick,thick-stalked,thicknes,time,tissue,touching,toward,triangular,tube,unarmed,unifoliate,unit,upper,usually,vary,way,wide,ympodial,young	0-1.3,0.5-1.5,2-7,4-10,abaxial,adaxial,arrangement,bark,color,colour,dm,form,growth,height,history,inflorescence,leaf,life,na,number,orientation,ovary,plant,position,reproduction,seed,shape,spacing,staman,texture
368	wfo-0001028470	success	185	107	73	112	34	0.395	0-18,0.25-0.75,1-12.3,1-2,12-44,2-10,2.1-3.9,3-10,3-5,3.5-16,4-7,6-33,acute,anther,apex,base,berry,cell,chartaceous,clavate,cm,corolla,dark,decreasing,deep,diameter,dot,elliptic,end,filament,flower,forked,fruit,glabrous,green,greenish,herb,honeycomb-shaped,interjected,leaf,leaflet,light,medium,mm,mucilaginous,odd-pinnate,one,orbicular,ovate,ovoid,pair,pedicel,peduncle,pentagonal,petiole,plant,plurifoliate,rounded,seed,size,stigma,style,substellate,terminal,testal,toward,tri-,tuber,unit,wet,white,whitish,yellow	0.9-2.2,0.9-2.3,1-3,1.5-2.8,1.6-3.2,11.8-21,2-5,2-7,2-8,3.2-5.5,3.5-7,4-6,5-merou,5.5-11.6,abaxially,acumen,adaxiall,adaxially,ag,alyx,apart,apparently,articulated,asymmetric,attenuate,axe,axillary,basiscopic,blade,brownish,bud,capitat,condition,connivent,covering,digestion,distal,dorsally,drying,eaf,edge,eed,enzyme,erec,exceeding,flat,folded,fresh,geminat,generally,glabrescent,glabrou,green-white,hair,hair-like,hal,half,high,homostylous,lanceolate,lateral,lengthening,living,lobe,long,lower,make,mottled,nflorescence,orolla,perfect,petiolulate,placed,pore,poricidal,pubescent,purple,removed,ripe,ruit,scarce,sessile,seudostipule,short,side,slit,sometimes,spaced,specimen,stamen,stolo,straight,subequal,subglabrou,subtending,tall,tamen,tem,thick,throughout,tip,tissue,tube,typically,unwinged,usually,vary,wall,wide,wing,x,ympodial	abaxial,adaxial,arrangement,capitate,color,colour,form,growth,height,hermaphroditic,history,inflorescence,length,life,mucilaginousnes,na,number,ovary,perennial,placement,position,pseudostipule,rachi,reproduction,shape,spacing,staman,stolon,subglabrous,surface,sympodial,texture,type,width
369	wfo-0001028476	success	246	117	89	157	28	0.362	-1,-6,0.1-0.15,0.2-0.3,0.2-0.5,0.25-0.5,0.3-0.4,0.4-0.5,0.4-0.6,0.5,0.8-1.2,0.8-1.6,1,1-1.2,1-2-celled,1-4,1.8-2.5,2-6,5-15,7-10,8-30,absent,acuminate,acute,anther,apex,base,branched,bright,brown,calyx,capitate,cm,conical,corolla,dark,diameter,elliptic,filament,flower,fruit,globose,green,hair-like,herb,imparipinnate,inflorescence,internode,interrupted,lanceolate,leaf,less,lobe,long,minutely,mm,narrowly,obovate,outgrowth,ovary,pale,pedicel,peduncle,perennial,petiole,present,pseudostipule,puberulent,pubescent,purple,rachi,simple,sparsely,stellate,stem,stiff,stigma,stripe,style,surface,tall,trichome,tube,unicellular,uniformly,uniseriate,wide,winged,yellow	-16,-20,-8,.05-0.1,.5,0-,0-0.5,0.1-0.4,0.15-0.2,0.15-0.4,0.2-0.6,0.25-0.4,0.3-0.5,0.3-0.7,0.3-1.2,0.4-1.5,0.5-0.6,0.5-1.7,0.7-2.5,1-1.4,1-1.5,1-2,1-6,1-celled,1.1-1.5,1.1-1.6,1.2-2.5,12-30,2,2-foliate,2-locular,2.4-3,3-12,3-7,3-foliate,3.5-13,4-celled,6-,abaxially,abundant,acroscopically,age,almost,along,also,alternate,anthesi,ape,apical,appearance,appendage,articulated,axi,basal,basiscopically,becoming,bifurcate,bifurcation,bract,bracteate,cell,column,curved,decurrent,deeply,diamete,distal,eaf,ebracteate,edicel,eed,elongate,entire,especially,exserted,first,fortaleza,fruiting,give,glabrescent,glandular,gradually,gree,hal,half,head,hyaline,incurved,interjected,irregularly,largest,lateral,leaflet,like,lobed,lon,lower,main,margin,maturity,midvein,minute,mixed,nflorescence,node,numerous,oblique,occasionally,often,pair,petiolule,population,primary,prominent,pubescence,rarely,recurve,reflexed,regularly,rest,rounded,ruit,río,scattered,secondary,sessile,set,short,silky,sinus,slightly,smaller,sprawling,spreading,staminal,sterile,straight,subopposite,tem,terminal,tertiary,testa,thick,tip,toward,truncate,ud,unit,unpaired,usually,vein,wall,weak-walled,white,wid,woody,ympodial	0.05-0.1,6-30,abaxial,adaxial,arrangement,bud,color,colour,form,growth,height,history,length,life,na,number,plant,position,presence,reproduction,seed,shape,spacing,staman,texture,type,width,wing
370	wfo-0001028478	success	267	149	109	158	40	0.408	.2,.8,0.0,2,2.5,3.4,4.6,7,abaxially,adaxially,adjacent,anther,apart,apex,attachment,base,based,bilobed,broad,broadly,bud,calyx,cm,corolla,deeply,deflexed,deltate,densely,developed,diameter,directed,distally,dry,elliptic,emerging,entire,filament,flattened-orbicular,flower,fruit,glabrous,glandular,globose,hair,internode,interpetalar,lanceolate,lateral,leaf,length,long,mature,minute,mm,moderately,nearly,notched,obtuse,orange-red,ovate,pedicel,peduncle,per,perforated,petiole,pitted,point,poorly,pore,porrect,prickle,pubescent,retrorse,scattered,sessile,shallowly,shoot,short,shrub,side,simple,slightly,spaced,sparsely,stamen,stellae,stellate,stellate-pubescent,stem,stigma,stipitate,straight,style,sub-coriaceous,suborbicular,surface,suture,terminal,tissue,toward,triangular,two,unbranched,well,white,yellow,yellow-tan,young,×	.0,.04,.3,.5,.9,0.1,0.2,0.2–0.4,0.3–0.4,0.3–0.5,0.4,0.4–0.5,0.5–0.6,0.5–0.8,0.5–0.9,0.6–1.3,0.9–1.1,1.0–1.3,1.0–1.5,1.1–1.6,1.3–1.6,1.4–2.3,1.4–4.4,1.5–2.4,1.5–4,1.8–2.0,1/2–1/3,2.0–11.0,2.1–2.3,2.2–4.0,2.3,3.3–4.9,3–6,4,4.6–7.0,4.8,4–6,4–7,5-merou,5.5–6.6,7.7–9.2,acuminate,adnate,aequilateral,ag,alyx,anthesi,apical,apparently,appearing,appresse,around,articulate,attenuate,axe,ba,bark,berry,blade,borne,broad-based,brochidodromous,brown,capitat,channeled,clinate,connivent,deciduous,development,difoliate,distal,distinct,distinctly,eaf,edge,eed,either,endocarp,erect,exocarp,extending,fertile,filiform,flexed,free,geminat,glossy,gradually,hort,increasing,incurved,individually,intersepalar,juic,layer,lobe,lobed,lon,longer,lower,margin,markedly,midpoint,midrib,midvein,nflorescence,oblique,oblong,occasionally,opaque,orolla,porrect-stellate,portion,potentially,presen,probably,raised,ray,reddish,rigid,rounded,row,ruit,seen,sigmoid,sinuate,sinus,sloughing,smoot,somewhat,soon,spatulate,splitting,spread,stipe,strongly,sub-cordate,tamen,tem,thin,time,tip,transparent,truncate,tube,typically,ud,unarmed,various,vary,vein,wide,yellow-ferruginou,ympodia,±45°,±90°,±equal,–10	1.0-1.5,1.1-1.6,1.3-1.6,1.4-2.3,2.0-11.0,3-6,4.6-7.0,5-merous,7.7-9.2,abaxial,adaxial,arrangement,capitate,color,colour,deflexion,direction,form,growth,height,history,inflorescence,life,na,number,ovary,perennial,plant,position,pubescence,rachi,reproduction,seed,shape,smooth,spacing,staman,texture,width,yellow-ferruginous
371	wfo-0001028481	success	194	117	94	100	23	0.485	.1,.5,0-2,0.15,0.6-1,0°,1-2,1-4,1.8-2.5,1/2-2/3,3,3-4,3-6,8,acuminate,almost,along,anther,anthesi,apex,articulated,attenuate,bark,base,branch,branched,brown,chartaceous,clavate,cm,conical,corolla,cuneate,cupular,dendritic,dendritic-pubescent,diameter,discolorous,distributed,drying,elliptic,entire,equal,evenly,flaking,flower,glabrous,green,leaf,length,less,liana,lobed,long,longitudinally,main,margin,midvein,mm,oblique,oblong,occasional,often,orange-brown,pair,pedicel,peduncle,petiole,primary,pubescent,rachi,ray,reddish,ridged,shortly,shrub,slender,sparsely,stem,stigma,style,surface,terminal,tertiary,thickly,trichome,unarmed,unknown,vein,venation,visible,white,yellowish,young	.3,0.1-0.2,0.5-1,1-1.4,1-3,1.5,1.5-2,2-3,2.5-3,3-3.5,3-4.5,5.5-7.5,abaxially,absent,acute,adaxially,age,alyx,apar,apically,apparently,canaliculate,clearly,close,colour,deeply,delineated,deltoid,density,different,dilated,divided,domatia,dorsifixed,dry,eaf,eed,ellipsoi,erect,except,extending,extent,eye,faint,filament,flat,flexuous,free,increasing,know,known,lamina,lengthening,like,linear,lobe,lon,long-acuminate,longer,lower,m.,mostly,naked,narrowly,nflorescence,nther,orolla,ovate,perfec,plurifoliat,pore,poricidal,portion,protruding,raised,ribbed,ruit,scar,see,side,simple,sinus,size,small,smoot,smoothly,spreading,stump,tearing,tip,together,toward,tube,ud,uneven,unit,vary,wide,x,ympodial	abaxial,adaxial,angle,arrangement,branching,bud,calyx,color,ellipsoid,form,fruit,growth,inflorescence,na,number,ovary,position,seed,shape,smooth,spacing,texture,width
372	wfo-0001028482	success	224	172	143	81	29	0.638	.1,.5,0.2,0.5,0.5-1,0.5-5,00,1-11,1-2,1-4,1.1-5,1.5-3,10,2-3,2-celled,3-4,4-5,acuminate,acute,adaxially,age,alternate,anther,apex,apiculae,ascending,asymmetric,bark,basal,base,becoming,bilobed,bright,broadly,brochiodromous,brownish,bud,calyx,campanulate,capitate,circinate,closely,cm,constriction,corolla,creamy,cucullate,cymose,deciduous,deflexed,deltate,diameter,distally,distinct,dry,drying,ellipsoid,elliptic,emarginate,embryo,enlarged,entire,exerted,exfoliating,expanding,filament,flattened-reniform,flower,fresh,fruit,fruiting,glabrous,glandular,globose,grayish,green,growth,halfway,incrassate,internodal,keeled,leaf-opposed,less,lobe,lobed,margin,material,midvein,minutely,mm,new,obovate,ovary,pale,pedicel,peduncle,pentamerous,petiole,pitted,pore,primary,pubescent,reddish,revolute,row,shaped,simple,size,slightly,slit,small,sometimes,somewhat,soon,spaced,sparsely,stigma,style,subglobose,subpyramidal,surface,tan,tear-drop,tiny,tip,transparent,tree,trichome,truncate,tube,tuberculate,tuft,twice,two,uniseriate,vein,venation,white,woody,x,yellow,yellowish,µm	/3,0,0.7-1.1,1-1.5,1.2-1.6,1.5-2,3-12,5-25,6-50,7-14,abaxially,angled,anthesi,berr,berry,bifid,bifurcate,branched,channeled,chartaceous,coriaceous,corky,corrugated,curved,densely,diffusely,difoliate,discolorous,eaf,eed,fleshy,free,geminat,glabrou,golden,hard,heterostylous,impressed,individual,investing,irregular,lengthening,long,lower,markedly,materia,maturity,midrib,minute,nflorescence,nodding,occasionally,olive,overlappin,pair,papillat,per,pericarp,petal,poricidal,portion,ruit,scandent,scar,shiny,short,stem,stout,straight,subcoriaceous,tightly,transversely,tub,ud,unifoliate,unit,usually,vegetative,way,ympodial,young	abaxial,adaxial,arrangement,asymmetry,color,colour,deciduousnes,exertion,expansion,form,height,history,inflorescence,leaf,length,life,na,perennial,plant,position,presence,pubescence,reproduction,seed,shape,spacing,staman,texture,type
373	wfo-0001028487	success	195	133	105	90	28	0.538	0-9,0.3-0.7,0.9-3,1-2,10-4.3,10-41,15-28,2-4,2.5-3.5,3-10,3-19,3-5,5-6,abaxially,acuminate,acute,adaxially,along,anther,apex,articulated,attenuate,axillary,bead,berry,brownish,bud,cell,central,clavate,cm,condition,coriaceous,corolla,covering,dark,deep,diameter,distal,drying,elliptic,filament,flower,forked,fresh,fruit,glabrescent,glabrous,green,green-white,greenish,hair,hair-like,half,herb,high,interjected,lateral,leaf,leaflet,light,like,make,medium,mm,moniliform,mucilaginous,necklace,odd-pinnate,orbicular,ovate,ovoid,pair,pedicel,peduncle,pentagonal,petiole,plant,plurifoliate,purple,ripe,rounded,scabrous,scarce,seed,short,size,star,stigma,stolon,style,substellate,subtending,terminal,testal,thick,throughout,tri-,tuber,unit,wall,wet,white,whitish,yellow	0.4-1.5,1-3,1-3.2,1.1-1.5,1.4-1.7,1.7-7,2-4.8,2-6,3-4,3.4-7.8,4-7,4.6-13.6,5-merou,7.8-16.4,acumen,adaxiall,ag,alyx,apart,apparently,arranged,asymmetric,axe,base,basiscopic,blade,capitat,connivent,considerably,decreasing,digestion,dorsally,eaf,edge,eed,enzyme,erec,exceeding,flat,folded,geminat,generally,glabrou,hal,homostylous,honeycomb-shaped,lanceolate,lengthening,living,lobe,long,lower,multiple,narrow,nflorescence,orolla,perfect,petiolulate,pore,poricidal,removed,ruit,second,sessile,seudostipule,side,slit,smaller,sometimes,spaced,specimen,stamen,straight,subequal,subglabrou,tall,tamen,tem,tip,tissue,toward,tube,typically,unwinged,usually,vary,wide,wing,x,ympodial	abaxial,adaxial,arrangement,capitate,color,colour,form,growth,height,history,inflorescence,length,life,na,number,ovary,perennial,position,pseudostipule,rachi,reproduction,shape,spacing,staman,subglabrous,surface,texture,width
374	wfo-0001028489	success	224	146	118	106	28	0.527	-10,-2.5,-4,-5,/4,0-3,0.2-0.5,0.2-0.6,0.3-0.5,0.3-1,0.3-1.2,0.5-1,0.5-1.1,0.5-1.5,1-3,1-6,1-7,1.5-4,1/3,2-3,2-4,2-6,3.5-6,4-13,5-merous,abaxially,acicular,acute,anther,apart,apex,apparently,articulated,bark,base,berry,cell,chartaceous,cm,cordate,cream,cuneate,dark,densely,diameter,dull,elliptic,erect,eye,filament,flattened-reniform,flower,fruit,glabrous,gray,green,lateral,leaf,length,lobe,lobed,margin,marking,maturity,mauve,membranous,midvein,mm,moderately,naked,obtuse,orange,orange-brown,orange-green,outline,ovate,pair,pale,pedicel,peduncle,perpendicular,petiole,porrect,prickle,primary,purple,raised,red-brown,rounded,sessile,shiny,shrub,side,simple,smooth,sometimes,sparsely,spherical,stellate-pubescent,stem,straight,style,subsessile,surface,tertiary,trichome,truncate,upper,vein,venation,visible,way,weakly,white,yellow,yellow-green,yellow-orange,young	-0.6,-6,0-10,0-15,0-20,0-50,0.1,0.1-0.6,0.2,0.2-,0.2-0.4,0.2-0.7,0.3-0.7,0.4-0.8,0.5-0.8,0.6-1.2,0.7-3,1-4,1.5-3,1.8-2.2,1.8-4,1.8-5.5,1/3-1/2,1/4-1/2,2.1-3,3-7,4-10,4-8,5-25,5-8,7.5,alyx,apar,apically,ba,beyond,blade,branched,broad-deltate,calyx,caudat,concolorous,connivent,curved,deltate,difoliate,distance,drying,eaf,eed,elongating,equal,extending,free,fruiting,geminat,hair,herbaceous,infructescence,less,lon,long,longer,lower,mature,midpoint,minute,nflorescence,occasionally,often,older,one,open,orolla,oung,pendulous,per,perfec,pericarp,poricidal,portion,prickly,protruding,ray,ruit,scar,slender,spaced,spreading,stalk,stellate,tamen,tapering,terete,time,tip,toward,tube,unarme,unarmed,unit,vary,white-gra,wide,woody,ympodial	abaxial,adaxial,arrangement,color,colour,corolla,form,growth,height,history,inflorescence,life,na,number,ovary,perennial,plant,position,rachi,reproduction,seed,shape,spacing,staman,stigma,texture,white-gray,width
375	wfo-0001028492	success	130	106	73	57	33	0.562	0.2-2,0.5-1,1-2.5,1-4,1-5,1.5-2.5,1.5-6,2-2.5,2-3,3,3-6,5-15,5-8,6-11,8-15,angled,apart,apiculate,articulated,axi,base,calyx,chartaceous,cm,color,colored,connivent,cylindrical,dark,deltate,diameter,directed,elliptic-ovate,forked,fruit,glabrous,globose,herb,irregularly,leaving,lobe,mm,narrowly,pedicel,peduncle,petiole,pore,pubescent,purple,rachi,radiu,rarely,reticulate,ripe,sand-punctate,scar,shrub,simple,spaced,splitting,stellate,stigma,style,tip,triangular,triangular-ovate,tube,unbranched,unevenly,veiny,white-punctate,whitish,x	-5-foliat,1.5-3,1.75-3.5,15-20,2-4,2-5,2.5-9,4,5-25-flower,6-12,abaxially,absen,acute,adaxially,aggregate,apex,axe,blade,cell,ciliolate,containing,crystal,distall,eaf,eed,entire,except,glabrou,hair,long,lower,margin,nflorescence,nther,obtuse,orolla,punctate,rounded,ruit,san,somewhat,sparse,stone,subcordate,subcoriaceous,succulent,tal,tem,time,truncat,unit,unknown,vary,white,wide,x1-3,ympodial	5-25,abaxial,adaxial,anther,arrangement,articulation,colour,connivence,corolla,direction,distally,flower,form,growth,height,history,inflorescence,leaf,length,life,na,number,ovary,perennial,plant,position,reproduction,seed,shape,spacing,surface,texture,truncate
376	wfo-0001028501	success	195	128	100	95	28	0.513	0-3,0-3.2,0.3-0.7,1-2,1.8-10.7,13-41,2.8-18,2.8-4.9,3-10,3-5,4-8,8-34,abaxially,adaxially,along,anther,apart,axillary,base,bead,brownish,bud,cell,clavate,cm,condition,considerably,coriaceous,corolla,covering,dark,decreasing,diameter,distal,drying,elliptic,filament,flower,forked,fresh,fruit,glabrescent,glabrous,green,green-white,greenish,hair,hair-like,herb,larger,lateral,leaf,leaflet,light,like,make,medium,mm,moniliform,mucilaginous,necklace,odd-pinnate,ovate,ovoid,pair,pedicel,peduncle,petiole,plant,plurifoliate,present,pyriform,rachi,ripe,rotate,scarce,seed,short,simple,size,sometimes,spot,stigma,stolon,style,subtending,terminal,testal,thick,throughout,toward,tri-,tuber,unit,usually,wall,wet,white,whitish,yellow	0-4,0.3-3.3,0.6-5.8,0.8-1.6,0.8-1.7,1,1-3,1-8,2-4,2-5,3-7,3.1-10.4,3.1-12,4.8-18,5-merou,6.6-21.1,8-10,acumen,acuminate,acute,adaxiall,ag,alyx,apex,apparently,arranged,articulated,attenuate,axe,berry,blade,broadly,capitat,connivent,decurrent,digestion,dorsally,eaf,edge,eed,enzyme,erec,exceeding,flat,folded,geminat,generally,glabrou,hal,half,high,homostylous,honeycomb-shaped,interjected,lanceolate,lengthening,linear,living,lobe,long,lower,mottled,multiple,narrow,narrowly,nflorescence,onto,orbicular,orolla,perfect,pore,poricidal,purple,removed,ruit,sessile,seudostipule,slit,spaced,specimen,stamen,straight,subglabrou,tall,tamen,tem,tip,tube,typically,unwinged,vary,wide,wing,x,ympodial	abaxial,adaxial,arrangement,capitate,color,colour,form,geminate,growth,height,history,inflorescence,length,life,na,number,ovary,perennial,position,pseudostipule,reproduction,shape,spacing,staman,subglabrous,surface,texture,type
377	wfo-0001028502	success	158	105	75	83	30	0.475	0.5-1,1-2,1.5-2,1.5-2.5,1.6-2.4,2-2.5,2-7,2-8,3.5-4,5-15,abaxial,abaxially,acute,adaxially,along,anther,apex,bark,beige,body,brown,christmas-tree-like,clavate,cm,congested,corolla,dark,dendritic,densely,denser,elliptic,fawn,filament,flat,flattened-reniform,fleshy,flower,glabrous,globose,incrassate,inflorescence,later,lateral,leaf,light,lobed,margin,matted,minutely,mm,obovate,often,ovary,papillose,pedicel,petiole,pitted,prominent,pubescent,reddish-brown,scattered,seed,shining,shrub,small,stigma,style,surface,terminal,tree,tree-like,trichome,vein,white,woody	.5,/2,1.5-3,1.5-6,2-4,2-5,3.5-15,5-6,6-8,?,age,anthesi,apar,ba,base,blade,branch,branched,calyx,campanulate,cazalet,closely,cone,constricted,deltate,dia,eaf,edicel,eed,erect,exserted,fide,free,fruiting,glabrat,heteromorphic,impressed,included,inflorescenc,lengthening,like,lobe,lon,long,long-styled,lower,main,middle,narrower,nflorescence,older,packed,pair,papillo,planar,plurifoliat,pore,poricidal,portion,rest,ruit,scar,short-styled,slit,spaced,stem,structure,tall,thick,time,tip,tub,tube,ud,unclear,unevenly,warty,way,wide,widest,within,ympodia,young	4-6,adaxial,apart,arrangement,color,colour,diameter,feature,form,fruit,glabrate,growth,height,history,length,life,na,number,peduncle,perennial,plant,plurifoliate,position,rachi,reproduction,shape,spacing,staman,texture,width
378	wfo-0001028505	success	168	58	44	124	14	0.262	.5,0.8-1,0.8-1.5,acuminate,acute,anther,apex,black,bright,bud,cm,corolla,distinct,gently,glabrous,globose,green,leaf,lobed,minutely,mm,narrowly,opposite,ovary,ovate,ovoid-reniform,pair,papillose,pedicel,petiole,pitted,pubescent,scar,seed,shape,shaped,simple,stigma,style,surface,tan,tapering,tear-drop,white	.01,.1,.3,/3,0.25-0.5,1,1-3,1.2-2.5,1/3,10-14-flowered,10-15,2,2.5-4.5,3-5,3.5-5,7-8,anthesi,aspect,ba,barely,bark,basal,base,beneath,berry,blade,body,branch,broadly,calyx,characteristic,conical,darker,deciduous,decurrent,deflexed,delicate,deltoid,dia,differentiated,differing,difoliate,distance,dried,dry,drying,eaf,edicel,eed,elliptic,erect,expanded,exserted,exsertion,f,filament,flattened,free,fruiting,geminat,greatly,grey,incrassate,lateral,live,lobe,lon,long,lower,m.,main,major,margin,materia,material,member,minor,minute,nflorescence,obovoid,obvious,older,overlapping,pale,plant,pore,poricidal,portion,prominent,proximal,purple,reflexed,rounded,ruit,short,shrub,size,slightly,somewhat,soon,specimen,stem,straight,strongly,tall,tip,touching,trichome,truncate,tube,ud,unicellular,uniseriate,unit,usually,vein,way,whit,widest,woody,x,yellowish,ympodial,young	10-14,abaxial,adaxial,color,flower,fruit,inflorescence,length,na,number,position,spacing,texture,width
379	wfo-0001028513	success	240	164	140	100	24	0.583	-0.8,-17,-6,.3-0.5,0.1-0.15,0.1-0.4,0.2-0.8,0.3-0.5,0.5-0.6,0.5-2,1,1-2.5,1-3,1-4,15-40,2,2-4,2-5,3-4,30,4-8,5-10,5-6,5-9,8-11,8-15,8-16,abaxially,accrescent,acute,acute-,adaxially,anther,apart,apex,appressed,approximately,articulated,base,bristly,broad-based,broadly,brown,calyx,campanulate,close,cm,coarsely,commonly,deltoid,densely,dentate,depressed-deltoid,diameter,doubling,ellipsoidal,entire,erect,extra-axillary,filament,flexible,flower,fruit,fruiting,glabrous,globose,inflorescence,interlobal,larger,lateral,laterally,lavender,leaf,length,lenticular,less,light,lobe,long,major,margin,midpoint,mm,obtuse,obtuse-,often,orange,outline,ovate,pair,pedicel,peduncle,perennial,petiole,pitted,prickle,prickly,pubescent,purple,rachi,rarely,ray,reaching,recurved,rigid,ripe,round-tipped,rust-colored,scabrous,sessile,side,silvery-gray,simple,sinus,small,smaller,soft,somewhat,sparsely,stellae,stellate,stellate-pubescent,stigma,style,subcordate,surface,texture,thin-textured,tooth-like,tree,trichome,truncate,unbranched,usually,variable,vein,weakly,white,x,yellow	-0.7,-5,.1-1.3,.2,/3,0-0.4,1-2,1.5-5,1/5-1/3,2-4.5,2-6,2-foliate,2.75-3.25,20-35,25-45,3-4.5,3.5-4,4-6,4-locular,4.5-6,7-11,8-25,9-11,acute-tipped,adaxiall,along,apiculate,appearing,approaching,armed,attenuate,axe,ba,berr,blade,broad,bud,capitat,cauline,closely,compresse,connivent,cylindrical,deciduous,directed,distal,distall,eaf,eed,enclosing,exceeding,female-sterile,geminat,hair,horizontal,inserted,large,lignescent,linear-lanceolate,lower,many,mature,minute,near,nflorescence,numerous,one,oriented,orolla,ovate-lanceolate,partially,per,pericarp,persisting,plane,pore,present,prickl,principal,radiu,rounded,ruit,scattered,short,short-stalked,siz,spaced,stalk,tal,tamen,tem,termination,time,tube,unarmed,underdeveloped,unit,vary,wide,ympodial	abaxial,adaxial,arrangement,capitate,color,colour,compressed,corolla,form,growth,height,history,life,na,number,ovary,plant,position,reproduction,seed,shape,size,spacing,staman
380	wfo-0001028524	success	236	129	98	138	31	0.415	0.3-0.8,0.5-3.5,0.6-1.4,1-5,1.5-1.6,1.5-3,1/3-2/3,11,2-6,2.5-4,2.8-3.5,3-15,3-4.3,3.4-3.6,4-6,4-8,6-7,8-13,9-14,acuminate,acute,anther,apart,apex,bark,base,blade,branch,branched,brown,bud,calyx,chartaceous,cm,conical,corolla,cream,dark,deltoid,diameter,dm,echinoid,entire,ferrugineous,filament,flower,fruit,glabrescent,granular-tomentose,gray,green,greenish,growth,hair,honeycombed,indument,lanceolate,leaf,length,lobe,lobed,long,margin,mm,multangulate,obtuse,orbicular,ovate,pale,pedicel,peduncle,petiole,probably,rachi,reniform,reticulate-punctate,rounded,short,simple,slightly,small,stellate,stigma,style,subcoriaceous,subglobose,suborbicular,sulcate,terete,thick-stalked,tomentose,tree,tube,way,x,yellow,yellowish,yellowish-green	-2.7,-3,.5-1,/10-3/10,0-150,0.3,1.1-1.2,1.2-1.3,1.8-2.5,10-20,2-3.8,2.5-3.4,2.5-3.8,3-10,3.3-4,4.3-6,6-9,7-10,7-11,abaxially,accrescent,adaxially,ag,along,anthesi,apical-lateral,apparently,articulated,ascending,axe,axillary,ba,becoming,berry,blunt-tipped,capitat,closely,continued,dehiscing,densely,distal,due,eaf,echinoi,eed,elliptic,exserted,extend,few-,few-rayed,first,fleshy,free,fruiting,glabrescen,glabrous,half,high,inserted,interpetalar,introrse,lacking,lanceolat,large,late,later,lateral,longitudinal,lower,m.,main,many-rayed,matted,midvei,midvein,mixed,nearly,nflorescence,oblong,obscured,often,older,orolla,ovate-lanceolate,overlapping,partly,perfect,persistent,plurifoliate,pore,porrect-stellate,present,prominent,pseudo-terminal,pubescent,rather,ray,relatively,ripe,ruit,runk,scabridulous,sessile,short-stalked,side,slit,somewhat,spaced,sparingly,sparsely,stalked,stamen,stelliform,stem,stout-stalked,strongly,suture,tamen,testa,thick,thin,thin-stalked,time,tissue,tomentu,touching,translucent,unarme,unarmed,unit,usually,vary,vein,velutinous,warty,wide,ympodial,young	1/10-3/10,30-150,abaxial,adaxial,arrangement,capitate,color,colour,form,height,history,inflorescence,life,na,number,ovary,perennial,plant,position,pseudoterminally,ratio,reproduction,seed,shape,size,spacing,staman,surface,texture,thicknes,trunk
381	wfo-0001028525	success	257	163	143	114	20	0.556	.25,0.2-0.3,0.5,0.5-1.5,0.5-2.5,1-4,1.1-1.7,1.2-1.6,1/3-3/4,10,10-13,1mm,2,2-2.5,3,3-5,3-7,4-5,6,accrescent,acuminate,acute,almost,anther,anthesi,apart,apex,apically,around,articulated,attenuate,axil,bark,base,becoming,black,branch,branched,branching,broadly,brown,calyx,capitate,chartaceous,clavate,cm,conical,cordate,corolla,cup,dark,dendritic,dendritic-pubescent,density,developed,developing,diameter,dilated,domatia-like,drying,elongated,entire,erect,flattened,flexuous,form,formed,forming,frequently,fruit,glabrous,green-brown,grey,increasing,lamina,lateral,leaf,less,liana,light,like,lobe,lobed,long,longitudinally,loose,lumpy,main,margin,mature,mauve,membranous,midvein,mm,multicellular-dendritic,obconical,oblong,obscuring,orange-brown,ovate,ovoid,partly,pedicel,peduncle,petiole,primary,pubescent,pyriform,red-brown,ridged,scar,scattered,shrub,simple,size,slender,slightly,small,smaller,sometimes,sparsely,spheroidal,stem,stigma,structure,stump,style,surface,tangling,terete,terminal,toward,trichome,truncate,unarmed,vein,weakly,well-developed,white,whitish,wider,x,young	.4,0.2-0.6,0°,1-1.5,1-2,1-2.5,1.5,1.5-3,2-3,2.5-5,4,4-15,4-7,7,7-13,7.5,age,along,alternate,alyx,apar,apice,apparently,berry,brachyblast,centre,clearly,clum,clustered,curved,deeply,delineated,deltoid,densely,detaching,discolorous,divided,dorsal,dorsifixed,eaf,eed,ellipsoi,equal,eye,fertilisation,fewer,filament,fine,flat,flexible,flower,free,frui,fruiting,glabrescent,inside,known,laterally,leave,lengthening,linear,longer,loop,lower,m.,minute,much,naked,narrowly,nflorescence,nther,often,one,orolla,outside,overlapping,pair,pendulous,perfec,pericarp,plurifoliat,pore,poricidal,portion,prominent,protruding,puberulous,rachi,ray,rounded,ruit,sessile,side,sinus,smoot,smooth,somewhat,soon,spreading,stripe,tearing,tertiary,thick,thin,tip,tube,ud,uneven,unit,vary,venation,visible,wide,ympodial	abaxial,accrescence,adaxial,arrangement,articulation,bud,clump,color,dilatation,ellipsoid,formation,growth,inflorescence,length,ovary,position,shape,texture,width,ye
382	wfo-0001028528	success	155	119	83	72	36	0.535	0.9-1.2,1.8-2,2-3,2-4,2.5-3,3/4,4-6,6-10,8-9,abaxial,absent,acute,adaxial,age,anther,anthesi,apex,base,berry,bi-lobed,blackish,branch,branching,calyx,cm,conical,corolla,decurrent,dendritic,densely,diameter,elliptic,erect,exserted,filament,flattened,flower,fork,fruiting,glabrous,globose,growth,later,leaf,lobed,minutely,mm,narrowly,nodding,obovate,outline,ovary,pedicel,per,pericarp,petiole,pitted,plurifoliate,pore,poricidal,prominent,pubescent,pyramidal,reddish-brown,round,scar,shiny,shrub,slit-like,somewhat,stem,stigma,strongly,style,surface,terminal,thin,time,tip,trichome,tube,violet,way	.5,1-2,1.1-1.2,1.5,3.5-4,3.5-6,4-5,6-7,?,acuminate,adaxially,along,apical,attenuate,ba,bark,basal,becoming,coriaceous,denser,dichasia,eaf,edicel,eed,ew,except,free,glabrat,glandular,immature,impressed,inserted,leave,like,lobe,long,lower,m.,margin,midvein,minute,mucronate,nflorescence,occasionally,older,pair,papillo,petal,planar,portion,revolute,ruit,secondary,short,sleeve,sparsely,stamen,ste,tall,tapering,triangular,tub,ud,unit,vein,white,wide,winged,woody,x,ympodial,young	2,4.5,arrangement,bud,color,colour,dichasial,exsertion,form,frequency,fruit,glabrate,height,history,inflorescence,length,life,na,number,papillose,pattern,peduncle,perennial,plant,poricity,position,presence,prominence,rachi,reproduction,seed,shape,spacing,staman,texture,width
383	wfo-0001028529	success	164	97	71	93	26	0.433	0.1,0.5-2,0.8-1.3,1-1.2,1-1.5,1.5,2.5-3,5-6,acuminate,anther,anthesi,apart,apex,bark,base,bluish,brown,bud,capitate,cast,cm,corolla,dark,erect,exfoliating,filament,flower,fruiting,furcate,glabrous,globose,green,hyaline,internodal,lanceolate,leaf,less,lobed,metallic,minutely,mm,narrowly,nearly,oblanceolate,occasionally,opposite,ovary,ovoid-reniform,paler,papillose,pedicel,petiole,pitted,shape,shrub,simple,size,slender,smooth,somewhat,stem,stigma,style,subshrub,surface,tapering,white,winged,woody,x,yellowish	.2,0.5,0.8-3,0.8-3.2,1,2/3,3-40-flowered,3-5,6-9,7-8,8-14,across,acute,age,apiculate,attenuate,becoming,beginning,beneath,berry,calyx,close,cork,course,decurrent,deflexe,deltoid,dia,distal,eaf,edicel,eed,ellipsoi,elliptic,evenly,exserted,free,growing,heterostylous,hrub,immature,indistinct,inflorescenc,lateral,lenticellat,linear,lobe,lon,long,lower,main,major,middle,minor,minute,much,nflorescence,older,one,pair,papillae,papillo,planar,pore,poricidal,portion,present,prominent,range,reflexed,river,ruit,scar,scattered,shaped,short,slightly,small,soon,spaced,species,straight,tall,tear-drop,tip,tube,ud,umbonate,variable,vein,way,widest,young	3-40,abaxial,adaxial,color,colour,diameter,form,fruit,growth,height,history,inflorescence,length,life,na,number,peduncle,plant,position,rachi,reproduction,seed,spacing,staman,texture,width
384	wfo-0001028532	success	186	103	75	111	28	0.403	0-19,0.2-1,1-2,1-3,1.3-8.7,15-36,17-42,2.2-4.2,3-10,3-5,4-7,5-9,5.5-15,acuminate,acute,along,anther,apex,base,bead,chartaceous,clavate,cm,corolla,dark,decreasing,deep,diameter,filament,flower,forked,fruit,glabrous,globose,green,greenish,herb,interjected,leaf,leaflet,like,medium,mm,moniliform,mucilaginous,necklace,odd-pinnate,orbicular,ovate,ovate-lanceolate,ovoid,pair,pedicel,peduncle,pentagonal,petiole,plant,plurifoliate,rotate,seed,sessile,size,slightly,stigma,stolon,style,terminal,toward,tri-,tuber,unit,usually,white,whitish,yellow	1-1.6,1-1.7,1-5,1.4-1.6,2-3,2-6,2-8,3-7,3.3-4.4,3.9-5,5-merou,6.5-9.2,7.5-15.2,abaxiall,abaxially,acumen,adaxially,ag,alyx,apart,apparently,arranged,articulated,asymmetric,attenuate,axe,axillary,basiscopic,berry,blade,brownish,bud,capitat,cell,condition,connivent,covering,digestion,distal,dorsally,drying,eaf,edge,eed,enzyme,erec,exceeding,flat,folded,fresh,geminat,generally,glabrou,green-white,hair-like,half,homostylous,honeycomb-shaped,lanceolate,larger,lateral,lengthening,linear,living,lobe,long,lower,make,middl,mottled,multiple,nflorescence,orolla,perfect,petiolulate,pore,poricidal,purple,removed,ripe,rounded,ruit,second,seudostipule,side,slit,sometimes,spaced,specimen,spot,stamen,straight,subequal,subtending,symmetric,tall,tamen,tem,testal,thick,throughout,tip,tissue,tube,typically,unwinged,vary,wall,wet,x,ympodial	abaxial,adaxial,arrangement,capitate,color,colour,form,geminate,growth,height,history,inflorescence,length,life,na,number,ovary,perennial,position,pseudostipule,rachi,reproduction,shape,spacing,staman,surface,texture,width
385	wfo-0001028546	success	239	113	94	145	19	0.393	0-1,0-18,0.5-0.75,0.5-1,0.5-2,0.6-2,1-2,1-3.5,1-7,1.1-1.8,1.1-2.2,1.5-1.75,1.5-2,1.5-6,120-400,2-3.5,4.5-6,7-24,7.5-10,accrescent,acicular,acuminate,acute,anther,apex,articulated,base,branch,brown,calyx,capitate,chartaceous,cm,cuneate,cylindrical,diameter,distally,dm,ellipsoidal,elliptical,filament,flattened,flower,fruit,fruiting,globose,half,index,inflorescence,juvenile,leaf,length,less,lobed,margin,markedly,mature,midpoint,mm,moderately,obtuse,ovate,pale,pedicel,peduncle,per,perennial,petiole,pinkish,plant,prickle,pseudo-racemose,purple,rachi,red,rhizomatous,rotate,shallowly,shrub,slightly,somewhat,sparsely,stellate,stellate-pubescent,stigma,style,surface,tan,thicker,thicknes,throughout,white,x,yellow	%,0-0.1,0-0.5,0-9,0.15-0.25,0.3-0.5,0.3-1,0.4-0.5,0.5-1.3,0.5-1.5,0.8-1.4,1-3,1-4,1-locular,10-14,10-22,100-150,11-12,16-24,2-,2-4,2-9,2.3-2.7,2.5-3,2.6-3.4,26-38,3-,3-11,3-4,3-5,3-7,3.5-19,3.5-7.5,4-13,4-8,4-9,5-10,5-55,5-8,5-merou,6-10,8-15,8-40,9-16,9.5-19,9.5-24,abaxially,absen,absent,across,adaxially,adult,also,alyx,ample,andromonoecious,apart,apparen,attenuate,axe,ba,bilobe,blade,branche,connivent,deeply,directed,distall,distributed,eaf,eed,eglandular,erect,exocarp,extra-axillary,finely,finger,foliate,functional,geminat,glabrous,gland-tipped,green,hair,heterostylous,incomplete,interpetalar,juicy,lamina,lanceolate,lateral,lobe,lobing,long,longer,lower,main,mesocarp,mid-point,midvein,minute,nflorescence,oblique,often,orolla,pair,part,pendent,placenta,pore,porrect,present,ray,reticulate,ruit,septum,sessile,short,side,simple,spaced,stalk,stellae,straight,succulent,tal,tamen,tem,thick,time,tissu,tissue,triangular,tube,unarme,unarmed,unbranched,unit,upper,usually,vary,vein,weakly,wide,ympodial	5-merous,abaxial,adaxial,articulation,bilobed,color,corolla,form,growth,height,number,ovary,reproduction,seed,shape,spacing,staman,stem,texture
386	wfo-0001028547	success	224	118	92	132	26	0.411	.2,.5,.7,.8,/5,0-1,0.1-0.2,0.2-0.35,1-2.5,1-5,1.5-2.5,1.7-2,2-4,2-6,3-5,5-merous,abaxial,abaxially,absent,acute,adaxial,anther,apart,apex,articulated,bark,base,berry,branched,bright,bulbous,cell,cm,cuneate,curved,densely,diameter,dull,entire,erect,filament,flattened-reniform,flower,fruit,glabrescent,glabrous,inflorescence,lateral,leaf,length,lobed,long-acuminate,margin,maturity,mauve,midpoint,mm,moderately,orange,orange-brown,outline,ovate,pedicel,peduncle,petiole,pit,porrect,prickle,purple,raised,ray,red,reddish,scandent,shallowly,shrub,simple,small,smooth,somewhat,spherical,stellate,stellate-pubescent,style,subsessile,surface,terminal,trichome,truncate,way,yellow,yellow-green	-1/2,-13,-3,-6,/2,0,0-10,0-15,0-2,0-30,0-5,0.05-0.15,0.15,0.3-0.4,0.5-,0.7-1,0.8-1,1-2,1-4,1.2-1.4,1/3,1/5-1/4,10-12,2-1.5,2-2.5,2.5-2.8,2.8-3.2,3.5-4.5,4-5,4-6,6-8,7-10,7-9,alyx,apar,ape,apically,apparently,appearing,blade,branching,calyx,chartaceous,conical,connivent,cream,dark,deltate,discolorous,distance,drying,eaf,eed,elongate,elongating,equal,extending,faint,flattened,free,fruiting,gently,glabrou,gray-brow,green,infructescence,lobe,lon,long,long-styled,longer,lower,marking,mature,midvein,narrow-deltate,nflorescence,oblong,occasionally,often,older,one,open,orolla,oung,pair,pale,pendulous,per,perfect,pericarp,plurifoliat,poricidal,portion,prickl,prickly,primary,reflexed,rounded,ruit,scar,sessile,short-styled,side,slender,sometimes,spaced,spreading,stalk,stalked,staminate,stem,straight,tamen,tapering,terete,tertiary,thin-acuminat,time,tip,tube,unit,usually,vary,vein,venation,villous,wide,woody,yellow-orange,ympodial,young	arrangement,color,colour,corolla,form,gray-brown,growth,height,history,life,na,number,ovary,perennial,plant,position,rachi,reproduction,seed,shape,spacing,staman,stigma,texture,unknown,width
387	wfo-0001028548	success	266	101	69	197	32	0.259	.4,.7,.8,.9,0,0.06,3.1,4.9,5.6,acuminate,anther,apart,apex,attachment,bark,base,brown,calyx,chartaceous,cm,color,corolla,densely,developed,diameter,distal,dry,filament,flattened-orbicular,flower,fruit,glabrous,globose,gradually,growth,internode,lanceolate,lateral,leaf,length,long,mm,notched,ovate,pedicel,peduncle,petiole,point,poorly,porrect,portion,probably,pubescent,reddish,scarcely,short,shrub,simple,stellae,stellate,stem,stigma,straight,style,surface,swelling,unknown,white,yellow	.2,.6,.8–2.4,/3,0.3–0.8,0.4,0.4–0.5,0.4–0.6,0.4–0.7,0.6,0.7–0.8,0.7–1.7,0.8–1.2,0.8–1.9,0.8–2.0,0.8–2.9,0.9–1.2,1.0–4.1,1.1–1.2,1.1–1.4,1.1–1.5,1.3–1.6,1.4–2.3,1.6–2.7,1.7–2.1,1/3,1/3–1/2,2.0,2.2–2.8,2.3,2.4–2.7,2.8,3.1–3.8,3.6–8.1,3.7–4.0,3.8–4.6,4,4–8,5-merou,5.5–6.6,6.4–19.8,6–10,6–9,90°,abaxially,absent,acute,adaxially,adnate,aequilateral,ag,alyx,anthesi,apical,apiculate,apparently,appearing,arching,area,around,articulate,attenuate,axe,ba,berry,blade,branch,branching,broad,brochidodromous,bud,capitat,central,channeled,clinate,congested,cuneate,deciduous,deltoid,dentate,development,difolate,directed,distinct,eaf,edge,eed,either,elliptic,emerging,endocarp,entire,erect,exocarp,extending,extra-axillary,fertile,filiform,flexed,free,geminat,glandular,glossy,hair,heterostylous,increasing,incurved,intact,interpetalar,intersepalar,juic,juvenile,large,layer,less,lobe,lobed,lon,longer,lower,major,many,margin,mature,midpoint,midrib,midvein,minor,minute,moderately,nearly,nflorescence,oblique,oblong,occasionally,opaque,orolla,per,pitted,pore,porrect-stellate,potentially,pubescenc,raised,ray,reflexe,remaining,rigid,rounded,row,seen,sessile,short-stipitate,shorter,shortly,side,sinus,sloughing,smoot,smooth,somewhat,soon,sparsely,splitting,spread,spreading,stamen,stellate-pubescent,stipe,suture,tamen,tem,thin,time,tip,tissue,transparent,truncate,tube,two,ud,unarmed,unbranched,upper,various,vary,vein,wave,weakly,wide,yellow-ferruginous,ympodia,young,±90°,±equal,±glabrous,×	0.7-0.8,0.8-1.9,0.8-2.9,1.0-4.1,1.1-1.2,1.1-1.5,1/3-1/2,2.2-2.8,5-merous,abaxial,adaxial,arrangement,capitate,colour,form,height,history,inflorescence,life,na,number,ovary,perennial,plant,position,reproduction,seed,shape,spacing,staman,texture,width
388	wfo-0001028551	invalid_json_followup	243	137	106	137	31	0.436	.3–0.5,.5,.8,0.4–0.5,0.5–0.6,0.7–2.3,0.8–1.4,1.0–1.6,1.1–1.4,1.4–2.0,1.5–1.9,1.6–1.7,1.8–2.5,1/3,2,2.0–2.6,2.0–3.5,2.5,4.2–5.9,4.5–7.0,9.0,abaxially,acuminate,adaxially,alveolate,anther,apex,apiculate,area,armed,attachment,base,becoming,blade,broad-based,calyx,caudate,central,chartaceous,cm,corolla,dark,deltate,densely,diameter,distinctly,dry,elliptic,entire,extra-axillary,filament,flattened-suborbicular,flower,forking,fruit,glabrous,glandular,globose,green,hair,immature,internode,lanceolate,lateral,leaf,lilac,lobe,lobed,margin,maturing,minute,mm,narrowly,nearly,notched,oblong,occasionally,pedicel,petiole,point,prickle,pubescent,red,scattered,shiny,shrub,simple,slender,smooth,somewhat,stigma,style,subcoriaceous,tan,tip,toward,tree,triangular,unbranched,upper,violet,wavy,white,yellow,±globose,×	.0,.06,.1,.6,0,0.7–1.0,1.0,1.0–1.5,1.1,1.1–2.2,1.3,1.5–1.8,1.7,1.7–2.6,2.0–3.7,2.2–3.4,2.2–5.2,2.2–7.5,2.3–3.4,2.75–4.0,3/4,4–6-merou,5–11,7.5–10.5,8.0–11.4,8.0–12.0,8.5–20.5,adnate,aequilateral,almost,alyx,anthesi,apart,apical,apparently,appearing,articulated,attenuate,axe,ba,berry,branch,brochidodromous,bud,capitat,channeled,closely,conical,connivent,continuing,cuneate,dehiscence,dentate,development,difoliate,distally,dorsally,eaf,eed,either,endocarp,enlargement,entir,equal,exocarp,fertile,filiform,free,frui,geminat,glabrou,gradually,homostylous,inclined,increasing,interpetalar,juic,lacking,large,line,lon,long,longer,lower,major,markedly,mature,midrib,midvein,minor,nflorescence,numerous,oblique,orolla,outline,poorly-developed,pore,porrect,portion,potentially,prominent,pseudo-peduncle,ripe,row,ruit,side,sinus,spaced,split,splitting,spread,stamen,stellae,stellate,stellate-pubescent,straight,suture,tamen,tem,thin,time,tissue,tube,two,typically,ud,unarme,unarmed,vary,vein,weakly,wide,yellow-ferruginou,ympodia,young,±appressed,–4.8	'',[,``,abaxial,adaxial,alveolation,armament,arrangement,capitate,characteristic,color,form,growth,height,inflorescence,length,ovary,plant,position,seed,shape,smoothnes,staman,stem,surface,texture,value,width,yellow-ferruginous,{,}
389	wfo-0001028558	success	224	134	114	110	20	0.509	0-30,0.1-0.4,0.4-1.5,0.5-0.9,0.8-1.5,1,1-1.3,1-4,1-9,1.3-1.8,1.5-2.3,1.5-6,1/3-1/2,1/4,2-5,2.4-3,3-50,3-8,3-9,4.2-7,5-merous,6-7.5,abaxially,acute,adaxially,almost,ame,andromonoecious,anther,apart,apex,bark,base,berry,branched,c.,clearly,cm,conical,cordate,cream,curved,dark,densely,diameter,distance,dull,entire,extending,filament,flattened,flattened-reniform,flower,fruit,fruiting,glabrescent,glabrous,green,herb,leaf,length,lobed,long,long-styled,lower,margin,marking,maturity,mauve,midpoint,midvein,mm,moderately,multangulate,often,orange-brown,ovate,pair,pale,pedicel,peduncle,pendulous,petiole,plant,prickle,prickly,primary,ray,rounded,short-styled,shrub,spaced,sparsely,spherical,stalked,stellate,stellate-pubescent,stem,straight,style,surface,terete,tertiary,trichome,upper,variously,vein,venation,visible,way,wide,woody,yellow,young	-2,-5,.5,/6,0-10,0-4,0-5,0.1,0.1-0.3,0.15-0.5,0.2,0.5-2,0.6,00-200,1-3,1.5-2.5,1.5-3,1.8-2.3,1/3,1/4-1/3,15-60,2.2-2.8,2.5-3.5,2.5-5,3-,3/,4,4-15,4.5-8,5-10,5-60,5-7,6-10,6-20,6-22,6-9,7-10,8-12,alyx,apar,apically,apparently,articulated,blade,broad-deltate,calyx,chartaceous,concolorous,connivent,deltate,discolorous,distal,drying,eaf,eed,elongated,elongating,equal,erect,free,gently,gra,hermaphrodite,heterostylous,infructescence,lateral,least,lobe,longer,lowermost,mature,narrow-deltate,nflorescence,obtu,older,one,open,orolla,oung,pendent,per,pericarp,plurifoliat,poricidal,porrect,portion,prickl,reflexed,ruit,scar,sessile,side,simple,smooth,spreading,stalk,staminat,stout,tamen,tapering,terminal,time,tip,tube,unarmed,unit,vary,weakly,yellowish,ympodial	/,3/4,abaxial,color,corolla,extension,form,gray,growth,height,inflorescence,number,ovary,reproduction,seed,shape,spacing,staman,texture,width
390	wfo-0001028571	success	230	109	66	164	43	0.287	0.4,2,2.5,62,9,=,abaxially,absent,acute,anther,apex,average,base,broadly,brown,cm,dark,diameter,elongated,erect,extra-axillary,filament,finely,flattened,flower,fruit,glandular-puberulent,globose,highly,length,light,lobed,marginal,minutely,mm,n,nearly,ovate,pale,pedicel,peduncle,per,perhaps,petiole,pubescent,rachi,shrub,similar,simple,somewhat,sparsely,stellate,stem,stigma,style,surface,surrounded,terete,thin-textured,tip,unbranched,undulate,white,wing,x,yellow	'',.1,.2,.5,/3,0.2–0.4,0.3–0.4,0.3–0.6,0.4–0.8,0.5–1,0.6–0.8,0.6–1.4,0.75–4,0.9–1.7,0–,1,1.1-1.4,1.5–2.4,1.7–2.6,1/2,1/3,10–21,11–12,12,13–25,18,1–1.4,1–1.5,1–2,1–5,2-foliate,2.5–15,2–10,2–3.4,3,3.4–3.7,3.5–16,3–13,3–5-celled,3–7.5,3–8,4-rayed,40–80,4–10,4–15,5,5.2–9.2,5–15,5–8,7–16,8–12,8–14,8–15,``,accrescent,acicular,adaxially,almost,also,apical,axe,ba,bacca,blade,calyx,capitat,cell,compressed,contiguou,cordate,cover,curved,cylindrical,dense,densely,differing,dilated,dimorphic,directed,distall,divided,eaf,eed,enlarged,entire,especially,exclusively,extreme,fertile,fewer,free,fruiting,geminat,geminate,glabrou,gland,gland-tipped,glaziou,hair,half,hyaline,interlocking,lanceolate,larger,linear,lobe,long,longer,longest,lower,lutea,margin,matura,maturing,merely,minute,multangulate,narrowly,near,nflorescence,one,orolla,p,pair,pore,prickle,proportion,pubescence,ray,recurved,rounded,ruit,scattered,sessile,shallow,size,slender,small,smaller,spreading,stellae,stipitate,stout,straight,summit,tal,tamen,tem,time,tomentose,triangular,tube,unarmed,unit,usually,variable,vary,varying,vestigial,visible,wide,ympodial,–1.6,–19	0.3-0.6,0.75-4,1-1.4,1.7-2.6,11-12,13-25,19,3-8,3.4-3.7,4-15,40-80,5.2-9.2,8-15,abaxial,adaxial,arrangement,capitate,color,colour,contiguous,corolla,feature,form,glabrous,growth,height,history,inflorescence,leaf,life,na,number,ovary,perennial,plant,position,reproduction,seed,shape,spacing,staman,texture,width
391	wfo-0001028583	success	294	144	117	177	27	0.398	.0,.5,.9,0,0.8–1.2,1.0–1.2,1.1–7.7,1.2–1.9,1.4–1.9,1.4–4.7,1.8–2.3,1.9–2.6,2.0,2.2–3.1,2.3,2.6,4,5.7,6.5–16.0,7.0–1.4,abaxially,adaxially,anther,apart,apex,appressed,base,based,bent,branching,broad,bud,calyx,capitate,central,chartaceous,cm,congested,corolla,deeply,deltate,deltoid,densely,developed,diameter,dry,evenly,extra-axillary,ferruginous,filament,flattened-reniform,flower,fruit,glabrous,globose,green,interpetalar,lateral,leaf,lightly,lobe,long,margin,mature,mm,moderately,narrowly,nearly,oblong,orange,ovate,pedicel,peduncle,petiole,pitted,poorly,porrect,portion,prickle,pubescence,pubescent,purple,red,red-brown,reflexed,scattered,sessile,short,shot,shrub,simple,somewhat,spaced,stellae,stellate,stellate-pubescent,stem,stigma,stipitate,straight,style,subcoriaceous,surface,time,tip,tissue,toward,triangular,truncate,unbranched,vein,well,white,yellow,yellow-ferruginous,±90°,×	.2,.6,0.01,0.06,0.08,0.13,0.2–0.6,0.3–0.6,0.4,0.4–0.6,0.6,0.6–0.9,0.6–1.0,0.6–1.3,0.6–2.2,0.8–1.4,0.8–1.5,0.9–1.3,0.9–1.5,1.0–2.1,1.4,1.4–1.5,1.5–2.4,1.5–3.1,1.9–3.2,1/2,1/3,1/3–1/2,2.3–6.8,2.5–2.9,2.6–3.7,2.6–4.8,2/3,3.1–4.0,3.2–6.2,3.5–3.8,4.3,4–8,5-merou,5.1–15.4,5.2,5.2–6.3,5–9,6.3,6.9–9.2,6–8,absent,acute,adnate,aequilateral,ag,alyx,anthesi,ape,apical,apparently,appearing,around,articulate,attenuate,axe,ba,bark,basal,berry,blade,borne,branch,brown,channeled,craspedodromous,cuneate,deciduous,dentate,difoliate,directed,distal,distinct,eaf,edge,eed,either,emerging,endocarp,erect,exocarp,extending,fertile,filiform,flexed,free,geminate,glandular,glossy,gradually,gree,hair,heterostylous,immature,immediately,increasing,incurved,individually,intact,internode,intersepalar,juic,lanceolate,large,layer,lobed,lon,longer,lower,major,many,midpoint,midrib,midvein,minor,minute,nflorescence,oblique,occasionally,opaque,orolla,per,perforated,pore,porrect-stellate,potentially,present,primary,raised,ray,red-orang,reddish,remaining,restricted,ridge,rigid,rounded,row,ruit,secondary,semicraspedodromous,several,shorter,side,sinuate,sinus,slightly,sloughing,sparsely,splitting,spread,spreading,stamen,stipe,subacute,suture,tamen,tardily,tem,thin,transparent,tube,two,ud,unarmed,upper,vary,wide,ympodia,young,±equal,±erect	5-merous,abaxial,adaxial,arrangement,color,colour,form,growth,height,history,inflorescence,length,life,na,number,ovary,plant,position,rachi,red-orange,reproduction,seed,shape,spacing,staman,texture,width
392	wfo-0001028587	success	178	117	87	91	30	0.489	.4,.5,.75,0.3,0.3-1,0.8-1.6,0.8-1.8,1-1.3,1-1.5,1-2,1-4,2-5,6-8,8-10,abruptly,accrescent,acuminate,acute,anther,anthesi,apex,bark,base,becoming,brown,calyx,closely,cm,corolla,cracking,cup,deflexed,densely,dia,erect,filament,flower,fruit,fruiting,geminate,glabrous,globose,green,greenish-white,leaf,length,lobe,lobed,long,minute,minutely,mm,narrowing,nearly,obovate,often,open,opposite,ovary,ovate,ovoid-reniform,papillose,pedicel,peeling,petiole,pitted,puberulent,pubescent,pubesent,seed,short,shrub,slender,spaced,sparsely,stem,stiff,stigma,straw-colored,style,subumbellate,surface,triangular,trichome,tube,white,woody	0,0.5,0.5-1,0.7-1.2,0.8-2.9,1.3-5.1,1/4,2.1-6.9,2.5,3-8,6.5-17.7,8-10-flowered,across,baseflower,berry,ca,chartaceou,coat,degree,different,difoliate,distal,drying,eaf,edicel,eed,ellipsoid,forming,free,geminat,impressed,keeled,lamina,lateral,layer,like,lon,long-styled,lower,main,major,middle,midrib,minor,nflorescence,obe,obovoid,occasionally,older,outer,overlappin,pair,paler,papillo,per,persistent,pore,poricidal,portion,pubescence,reflexed,ruit,scar,scattered,simple,slightly,slit-like,straight,tall,terminal,thickened,thin,tip,transversel,two,type,ud,umbonate,unicellular,uniseriate,unit,upon,upper,usually,variable,vein,wide,widest,x,ympodial,young	abaxial,accrescence,adaxial,arrangement,chartaceous,color,colour,deflexion,diameter,form,growth,height,history,inflorescence,life,na,number,overlapping,peduncle,perennial,plant,position,rachi,reproduction,shape,spacing,staman,texture,transversely,width
393	wfo-0001028594	success	142	119	90	52	29	0.634	.5,0.3-1.0,0.8-1.8,1-1.2,1-1.5,1-2,1.5-9,12,12-14,2,3-4,3-6,6-7,abaxially,acuminate,acute,anther,apex,axillary,base,black,bottle-shaped,calyx,cm,conical,corolla,densely,diameter,drying,ellipsoid,elliptic,especially,exserted,filament,flattened-reniform,flower,fruit,fruiting,glabrous,globose,green,hair-like,herb,immature,inflorescence,leaf,length,lobe,long,margin,maturity,minute,minutely,mm,obtuse,orange-brown,ovary,ovate,pair,papillate,pedicel,pendent,petiole,planar,primary,projection,pubescent,purple,rectangular,reddish,reflexed,regular,rounded,simple,slightly,smooth,somewhat,sparsely,spreading,stigma,strongly,style,surface,tip,trichome,tube,uniseriate,vein,violet,x	0-100,1-1.3,1-3,3-9,5-6,6-20,adaxially,along,anthesi,axil,bearing,becoming,berry,capitat,cell,climbing,denser,eaf,edicel,eed,epidermal,floo,forest,free,glabrat,inflorescenc,lax,like,lon,lower,nflorescence,noddin,often,open,per,portion,quit,rest,ruit,scar,scattered,side,soft,strait,tem,time,trailing,tub,ud,unifoliat,unit,ympodial	abaxial,adaxial,arrangement,bud,capitate,color,colour,exsertion,form,growth,height,history,life,na,nodding,number,peduncle,perennial,plant,position,rachi,reproduction,seed,shape,spacing,staman,stem,texture,width
394	wfo-0001028660	success	204	109	79	125	30	0.387	0-5,0.2-1.1,0.3-1.1,0.5-2.8,0.5-5.5,0.7-4.2,0.9-2.5,1-10,1-2,1.5-2.8,2-11,2-6,2-9,3-30,3-9,4-6,7-10,abaxially,acute,adaxially,anther,apex,blue,brownish,clavate,cm,condition,corolla,diameter,drying,elliptic,entirely,filament,flower,forked,fresh,fruit,glabrous,globose,green,greenish,herb,interjected,leaflet,linear,minutely,mm,mucilaginous,narrowly,obtuse,odd-pinnate,orbicular,ovate,ovoid,pedicel,peduncle,pentagonal,petiole,petiolule,plant,plurifoliate,puberulent,pubescent,purple,rotate,seed,size,stigma,style,substellate,terminal,tinged,tri-,tuber,unit,wet,white,whitish,yellow	0.1-0.3,0.8-1,1.5-4,1.5-7.6,2-5,20,3-5,3-7,3.8-13,5-8,5-merou,6,absent,acumen,ag,along,alyx,apart,apparently,articulated,attenuate,axe,axillary,base,berry,blade,borne,broadly,bud,capitat,cell,chartaceous,ciliate,connivent,covering,decumbent,decurrent,densely,digestion,distal,dorsally,dot,eaf,edge,eed,end,enzyme,erec,especially,exceeding,except,flat,folded,geminat,generally,glabrou,greatly,green-white,hair,hair-like,half,homostylous,honeycomb-shaped,lanceolate,lateral,lengthening,less,like,living,lobe,long,lower,make,margin,membranous,middl,midrib,nflorescence,oblique,often,orolla,pair,perfect,petiolulate,pore,poricidal,proximal,rarely,reduced,removed,ripe,ruit,scabrous,scattered,sessile,seudostipule,short,singly,slit,spaced,sparsely,specimen,stamen,ste,stem,stolo,straight,subequal,subtending,sunny,tall,tamen,tem,testal,thick,throughout,tip,tube,typically,unwinged,usually,vary,wall,x,ympodial	abaxial,adaxial,arrangement,capitate,color,colour,form,growth,height,history,inflorescence,leaf,length,life,na,number,ovary,perennial,position,pseudostipule,rachi,reproduction,shape,spacing,staman,stolon,surface,sympodial,texture,width
395	wfo-0001028666	success	159	80	62	97	18	0.39	0.25-0.4,0.3-0.6,0.4-0.8,0.7-0.8,1-1.5,2.2-2.3,3-4,3-4.5,4-5,4-5.5,5-11,7-11,7-8,7-9,absent,anther,brown,calyx,cm,densely,diameter,ellipsoidal,elliptic,extra-axillary,finger,fruit,glabrous,gland-tipped,grey-green,hair,inflorescence,lanceolate,lateral,lavender,length,lobe,long,midpoint,mm,moderately,ovate,pale,pedicel,peduncle,petiole,prickle,purple,ray,red,scattered,short,stellae,stellate,stellate-pubescent,stigma,style,time,tube,unbranched,white,yellow,yellowish	%,0-0.1,0-2,0.05-0.1,0.1-0.15,0.2-0.25,0.2-0.3,0.3-0.45,0.8-2,1,1-2,1-locular,11-19,2.5-5,2.5-7,2.6-4.2,3-6,4-5-merou,abaxially,absen,accrescent,across,acute,adaxiall,adaxially,alyx,apart,apex,apparen,articulated,axe,ba,base,blade,capitat,chartaceous,connivent,cordate,cylindrical,directed,distall,distributed,eaf,eed,eglandular,entire,erect,exceeding,exocarp,flower,fruiting,incomplete,juicy,lamina,lower,margin,mature,mesocarp,minute,nflorescence,oblique,obtuse,orolla,part,per,perennial,perfect,placenta,pore,porrect,pseudo-umbellate,pubescent,rhizomatous,ruit,septum,sessile,shrub,simple,solitary,somewhat,spaced,stalk,succulent,tal,tamen,tem,thick,throughout,transparent,unarme,unarmed,unit,unknow,vary,wide,x,ympodial	abaxial,adaxial,capitate,colour,corolla,height,leaf,na,ovary,plant,position,presence,seed,shape,stem,surface,texture,thicknes
396	wfo-0001028667	success	129	110	78	51	32	0.605	-2.6,0.4-0.7,0.7-4,1-1.5,1-2-1.5,1-6,1.3-2,5,5-20,acute,aid,anthesi,apex,appearing,around,articulated,axillary,base,branch,branched,calyx,climbing,clustered,cm,completely,conical,corolla,curling,deciduous,diameter,dry,elliptic,exserted,flattened,flower,fragrant,fruiting,glabrous,growth,inflorescence,irregularly,leaf,lobe,minutely,mm,narrowly,other,pale,pedicel,peduncle,petiole,pitted,reniform,scar,shiny,shoot,short,simple,sleeve,slender,small,soon,spaced,straw-colored,strongly,support,surface,terminal,tip,triangular,tube,twice,twining,vine,white,woody,wrinkling,yellow	.5,1-4.5,3,3-11,5-merou,8-10,alyx,apar,ark,berry,cell,climbin,coriaceous,creamy,discolorous,eaf,eed,ellipsoid,entire,exfoliatin,exfoliating,fide,like,long,lower,margin,mentz,midrib,new,nflorescence,occasionally,older,orolla,outer,papilla,papillat,pendan,per,perfect,plurifoliat,primary,revolute,slightly,stem,tem,ud,unit,vein,visible,x,ympodial	abaxial,adaxial,anther,apart,arrangement,color,colour,deciduousnes,exsertion,filament,form,fragrance,fruit,height,history,length,life,na,number,ovary,plant,position,rachi,reproduction,seed,shape,spacing,staman,stigma,style,texture,width
397	wfo-0001028672	success	207	129	111	96	18	0.536	.5,/4,0-13,0-150,0.2,0.2-0.4,0.5-0.7,0.5-1,0.5-1.2,0.5-5,0.7-3,0.8-1,1,1-2,1-3,1.3-8,1.8-2.2,1.8-2.5,1/4,2-10,2.4-2.8,2.5-12,2.5-3.5,3-8,abaxially,acute,adaxially,almost,ame,andromonoecious,anther,apart,apex,articulated,bark,base,berry,black,blade,branched,broad,broad-deltate,c.,cm,connivent,cream,dark,diameter,elongated,erect,filament,flattened,flattened-reniform,flower,fruit,glabrescent,glabrous,gray,green,leaf,length,lobed,long,long-styled,margin,marking,maturity,mauve,midpoint,midvein,mm,moderately,obtuse,orange-brown,ovate,pale,pedicel,peduncle,per,petiole,plant,poricidal,porrect,prickle,ray,rotate,rounded,sessile,shrub,sometimes,sparsely,spherical,stalked,stellate-pubescent,straight,style,surface,tapering,tertiary,tip,trichome,truncate,upper,usually,venation,visible,way,wide,yellow,yellow-orange,young	-6,-merous,0,0-15,0-5,0.2-0.7,0.3-1,1.5-2.2,1.5-3,1/,1/4-1/3,2-20,2-3,2-30,3-5,4-6,4-8,5,5-10,5-8,6-12,9-15,acut,alyx,apar,apically,apparently,brow,calyx,chartaceous,concolorous,deltate,difoliate,discolorous,distal,distance,drying,eaf,eed,elongating,equal,extending,free,fruiting,geminat,hair,hermaphrodite,heterostylous,infructescence,lateral,lobe,longer,lower,lowermost,mature,minute,nflorescence,older,one,open,orolla,oung,pair,pendulous,pericarp,portion,prickl,prickly,primary,reflexed,ruit,scar,short-styled,side,simple,smooth,spaced,spreading,stalk,staminat,stem,tamen,terete,terminal,time,translucent,tube,unarmed,unit,variously,vary,vein,weakly,woody,yellow-green,ympodial	abaxial,adaxial,brown,color,corolla,form,growth,height,inflorescence,number,ovary,reproduction,seed,shape,spacing,staman,texture,width
398	wfo-0001028674	success	196	127	103	93	24	0.526	-1,0.1,0.2-0.25,0.5-0.7,0.5-0.8,0.7-1,1-2,1-3,1.5-3,10-15,10-30,2-2.5,2-3,2-5.5,3-11,3-4-lobed,5-7,abaxially,acuminate,acute,adaxial,angulate,anther,apex,apiculate,attenuate,bark,base,branching,brown,c.,calyx,chartaceous,cm,conical,corolla,cream,dark,densely,diameter,elliptic,entire,erect,exserted,filament,flattened,flower,fruit,fruiting,glabrescent,glabrous,glandular,glandular-pubescent,globose,green,greenish,growth,heterostylous,laterally,leaf,leaf-opposed,lenticular,lobed,margin,maturing,mm,ovary,partially,pedicel,peduncle,petiole,plant,prickle,recurved,reddish,reniform,reticulate,rounded,scattered,shrub,simple,sparsely,stellate,stem,stigma,style,subcapitate,subglobose,surface,terete,testa,time,tomentose,trichome,variegated,way,white,whitish,woody,x,yellow,yellowish,young	0.2-0.3,0.7-1.0,1-1.5,1/3,1/4,2.5-3,3-10,3-3.5,4-4.2,4-5,5-6,8-10,adaxially,armed,articulate,basal,berry,blade,branched,brow,caly,campanulate,confined,coriaceous,curved,directed,distal,distally,eaf,eed,eglandular,erec,especially,face,fewer,free,glandular-puberulent,hirsute,juvenile,larger,lateral,leave,lengthening,like,linear-lanceolate,lobe,long-styled,lower,midpoint,minute,much,mucilaginous,new,nflorescence,ochraceous,older,one,perfect,pericarp,plurifoliat,pore,poricidal,porrect,portion,prickly,pubescent,raise,ray,reduced,ruit,rusty,scar,sessile,shallowly,short-styled,similar,slightly,staminate,stellate-pubescent,stellate-tomentose,straight,subsessile,tapering,thick,tip,triangular-lanceolate,tube,ud,unarmed,unicellular,unit,upper,ympodial	abaxial,arrangement,bud,color,colour,exsertion,form,height,heterostyly,history,inflorescence,length,life,na,number,perennial,position,rachi,reproduction,seed,shape,spacing,staman,texture
399	wfo-0001028680	success	236	131	103	133	28	0.436	.0,.5,.8,0.2–0.3,0.3–2.1,0.9,0.9–1.0,1,1.2,1–2,3.8–4.6,6–8,abaxially,aequilateral,anther,apex,appearing,attachment,attenuate,bark,base,blade,brown,cm,coriaceous,corolla,deltoid,diameter,dry,elliptic,entire,extra-axillary,fast,filament,flattened-orbicular,flattened-reniform,flexed,flower,fruit,glabrous,globose,growth,hair,internode,isolated,lanceolate,lateral,long,margin,mature,midpoint,mm,notched,obtuse,occasionally,ovate,pedicel,petiole,pitted,point,porrect,prickle,pubescent,rachi,ray,reddish,retrorse,revolute,rounded,scattered,sessile,shoot,short,shorter,shortly,shrub,simple,sinuate,slightly,sometimes,sparsely,stellae,stellate,stem,stigma,style,sub-cordate,surface,terminal,toward,transparent,typically,unbranched,white,yellow,yellow-tan,young,±90°,±absent,±equal,×,–1.75,–3	.2,.3,0.4,0.5–0.8,0.5–2.3,0.9–1.2,1.1,1.1–6.5,1.2–2.2,1.4–1.8,1.6–2.5,1.7–2.1,1.7–2.2,1.9–2.4,1/2,1/3,1/4–1/3,2.1–3.0,2.2–2.5,2.2–3.0,2–3,3.2–3.5,4.3–5.9,4–5,4–5-merou,5.2–7.2,?,acuminate,adaxially,adnate,ag,alyx,anthesi,apical,apiculate,apparently,appresse,around,articulate,ba,based,berry,borne,broad,brochidodromous,calyx,capitat,channeled,connivent,dentate,developed,development,directed,distal,distally,distinct,eaf,edge,eed,either,emerging,endocarp,exocarp,extending,fertile,filiform,free,glandular,glossy,gradually,homostylous,hort,increasing,individually,intact,interpetalar,intersepalar,juic,layer,limp,lobe,lon,longer,lower,many,markedly,middle,midrib,midvein,minute,nearly,nflorescence,opaque,orolla,per,perforated,plurifoliate,poorly,pore,portion,potentially,presen,raised,remaining,ruit,see,side,sinus,sloughing,splitting,spread,stamen,straight,suture,tamen,tem,thin,time,tip,tissue,truncate,tube,ud,unarmed,vary,vein,weakly,wide,yellow-ferruginou,ympodia,±glabrous,±straight,–6	1.8–3.0,abaxial,adaxial,arrangement,capitate,color,colour,form,height,history,inflorescence,leaf,length,life,na,number,ovary,peduncle,plant,position,reproduction,seed,shape,spacing,staman,texture,width,yellow-ferruginous
400	wfo-0001028688	success	137	106	72	65	34	0.526	0.4-1,0.5-0.75,0.5-1,0.5-1.5,0.9-1,1-5,1.1-1.2,1.4-2.8,2-3,5-11,5-6,acuminate,acute,along,anther,anthesi,apex,area,bark,base,calyx,cm,corolla,curl-tipped,deflexed,densest,filament,furcate,glabrous,golden,interpetalar,lanceolate,leaf,lobed,membraneous,minutely,mm,near,opposite,ovary,overtopping,paler,papillose,pedicel,petiole,pilose,planar,pore,pubescent,reddish-brown,shaped,shiny,shoot,shrub,sinus,size,slender,slightly,stem,stigma,style,tapering,tear-drop,thickened,thin,tip,trichome,tube,uniseriate,vein,white,x	.5,0.5,1-1.5,1-1.8,1-3,2.2-4.8,across,apar,beneath,bi-cellular,branch,clavate,deciduous,decreasing,deltoid,densely,dia,differing,difoliate,eaf,edicel,eed,elliptic,exfoliatin,exserted,free,geminat,globose,irregularly,know,known,like,lobe,lon,long,lower,major,markedly,middle,minor,nearly,nflorescence,occasionally,often,older,poricidal,portion,proximal,ruit,scar,soon,spaced,sparsely,straight,styl,tall,terminal,tub,ud,unit,usually,wide,widest,ympodial,young	2.5,abaxial,apart,arrangement,color,deflexion,diameter,exfoliating,exfoliation,flower,form,fruit,growth,height,history,inflorescence,length,life,na,number,peduncle,perennial,pilosity,plant,position,rachi,reproduction,seed,shape,spacing,staman,surface,texture,width
401	wfo-0001028690	success	191	96	71	120	25	0.372	0-0.5,0-5,0.3-2.5,0.5-0.8,0.8-1,0.8-2,1-7,30-50,4-7,4-9,7-10,8-9,9-13,acute,adaxially,adult,andromonoecious,anther,apex,base,branch,chartaceous,cm,cuneate,densely,diameter,dm,erect,extra-axillary,flower,fruit,glabrous,globose,green,inflorescence,juvenile,lanceolate,leaf,length,lobed,longer,mm,moderately,oblique,obtuse,ovate,pale,part,pedicel,peduncle,per,perennial,petiole,plant,prickle,pseudo-racemose,pseudo-umbellate,purple,rhizomatous,shallowly,shrub,sparsely,stellate-pubescent,stigma,style,surface,time,weakly,white,wide,yellow	%,.3,0-0.1,0-0.2,0-7,0.05-0.1,0.1-0.2,0.15-0.25,0.2-0.6,0.25-0.4,0.3-0.5,0.3-0.7,0.4-0.6,0.5-1,0.5-6,1-2,1-5,1.3-6.5,1.5-1.7,2-3,2-7,2-locular,2.1-4.5,2.3-2.8,3-4.5,4-10,4-5.5.5,4.5-16.5,5-6,5-merou,5.5-6,6-8,7-30,7-8,9.5-14,abaxially,absen,absent,accrescent,across,adaxiall,alyx,apart,articulated,ascending,attenuate,axe,ba,blade,branche,broad-based,calyx,capitat,connivent,cross-section,cylindrical,directed,distall,distributed,eaf,eed,eglandular,entire,exocarp,finger,fruiting,functional,geminat,gland-tipped,grey-green,hair,half,heterostylous,juicy,lamina,lateral,less,linea,lobe,long,lower,margin,mature,mesocarp,mid-point,midpoint,minute,moist,nflorescence,orolla,pair,placenta,pore,porrect,present,ray,ruit,sessile,short,simple,somewhat,spaced,stalk,stellae,stellate,straight,tal,tamen,tem,thick,throughout,tube,unarme,unarmed,unbranched,unit,upper,vary,x,ympodial	4-5.5,5-merous,abaxial,adaxial,capitate,color,corolla,density,filament,form,growth,height,history,life,linear,ovary,position,reproduction,seed,shape,staman,stem,texture,thicknes,width
402	wfo-0001028696	success	224	97	52	172	45	0.232	abaxially,acicular,acuminate,adaxially,anther,apex,blue,cm,color,diameter,distally,filament,finely,flower,fruit,glabrous,globose,hirsute,lateral,lavender,length,lenticular,longitudinally,midpoint,mm,orange,ovate,ovoid,pedicel,peduncle,pericarp,petiole,pilose,pitted,plump,pore,prickle,ray,reniform,rotate-pentagonal,shrub,simple,splitting,stellate,stigma,style,subterminal,surface,tan,tipped,woolly,yellow	.5,0.8–,1.5–4,12–20,15–17,15–30,1–2,1–4,1–6,2.4,2.5,2.8–3.5,2–2.3,2–5,2–7,3.5–5.5,3–5,3–6.5,4–5,4–7,5,5-merou,5–15,6–13,6–8,7–8,7–9,8–13,8–20,9–10,9–12,accrescent,adaxiall,along,alyx,ample,anthesi,apart,apparently,armed,articulated,ascending,asymmetric,attenuate,axe,ba,base,bifi,blade,borne,branch,branched,bristle,bristle-like,bristly,broadly,calyx,chartaceous,coarsely,connivent,cordate,deltoid,densely,density,developed,difoliate,directed,diverse,drie,eaf,eed,elongate,entire,erect,fruiting,geminat,glabrou,gland,gland-tipped,glandular,hair,homostylous,intergrading,intermixed,internode,interpetalar,known,lamina,larger,like,linear-caudate,linear-lanceolate,lobe,lobed,lon,long,long-stipitate,lower,margin,mature,middle,midvein,midzone,moderately,narrowly,near,nflorescence,numerous,oblong,obtuse,occasionally,often,one,orolla,overtopped,per,perfect,prickly,principal,prominent,pubescence,pubescent,reflexed,repand,resembling,ruit,scattered,sessile,several-celled,shiny,short,short-,shorter,side,sinuate,slender,slightly,small,smaller,sometimes,somewhat,soon,spaced,sparser,spreading,stalked,stellae,stellate-hirsute,stellate-pilose,stellate-pubescent,stem,tall,tamen,tem,tippe,tissue,toothed,trichome,truncate,tube,ud,ultimate,vary,varying,vein,weakly,well,wide,widely,ympodia,young,×	0.5,0.8-2.5,1,1-6,1.5-4,12-20,15-30,2-2.3,2-7,3.5-5.5,4-7,5-15,6-8,7-8,9-10,abaxial,adaxial,arrangement,bifid,colour,corolla,direction,form,growth,height,history,inflorescence,leaf,life,na,number,ovary,plant,position,rachi,reproduction,seed,shape,spacing,staman,stipule,texture,tip,width,x
403	wfo-0001028698	success	166	107	80	86	27	0.482	0.3-0.75,1-4,1-9.8,1.9-4,13-25,2-10,3-17,5-6,8-10,acuminate,acute,apex,articulate,branched,broadly,cell,cm,conical,corolla,covering,cyme,dark,diameter,dichasial,dichasially,digestion,distal,dorsally,dot,ebracteate,ellipsoid,elliptical,enzyme,filament,flat,flower,folded,green,green-white,hair-like,half,herbaceous,honeycomb,lateral,leaf,light,medium,mm,monochasial,mucilaginous,odd-pinnate,ovate,ovoid,pattern,pedicel,peduncle,pentagonal,perennial,perfect,petiole,plant,proximal,puberulent,pubescent,rachi,raised,rotate,seed,smooth,stigma,strigose,style,testal,thick,throughout,violet,wall,white,yellow,¼	0-1.,1-2,1.8-5,2-3,2-4,3-5,3-6-foliat,3.5,4-14,5-15,5-8,6,6-13,6-27,9-35,abaxiall,abaxially,acumen,adaxially,apical,apically,base,calyx,commonly,connate,cuneate,darker,decurrent,dehiscent,diminishing,eaf,edge,eed,emoval,equal,exceeding,first,forked,generally,globo,gradually,interjected,introrse,leaflet,living,lobe,lon,long,long-attenuate,lower,lunat,make,maturing,minute,nflorescence,nther,oblique,often,orolla,pair,petiolule,plan,poricidally,rarely,reveal,ruit,sessile,seudostipule,short,size,slit,specimen,stamen,straight,tal,tem,terminal,toward,tuber-bearing,two,typically,unit,usually,vary,wide,ympodial	abaxial,adaxial,anther,arrangement,color,colour,form,fruit,globose,growth,height,history,inflorescence,length,life,na,number,ovary,position,reproduction,shape,spacing,staman,surface,texture,wet,width
404	wfo-0001028716	success	145	87	55	90	32	0.379	.2,.5,0.5,0.6-1.9,0.75,1-2,2.5-8,7-8,8-9,acuminate,anther,apart,apex,bark,brown,calyx,cm,corolla,dark,ellipsoid,filament,filiform,fruit,glabrous,glandular,hirsute,leaf,less,lobe,lobed,long-triangular,minutely,mm,node,opposite,ovary,ovate,papillose,pedicel,petiole,pointed,puberulent,shape,shaped,shrub,simple,stem,style,tear-drop,triangular,trichome,truncate,uniseriate,white,x	1.9-5.5,10-40-flowered,11-16.4,2-4,2.2-7.9,3.6-8.8,5-6,9-10,across,anisophyllou,anthesi,appearing,asymmetric,ba,base,becoming,beginning,beneath,bi-cellular,branched,cuneate,decurrent,deflexed,dia,differing,difoliate,eaf,edicel,eed,elliptic,evenly,except,fertilization,fifth,free,geminate,inflorescenc,intermediate,know,known,lateral,lengthening,lenticellat,like,lon,long,lower,main,major,markedly,middle,minor,much,nearly,nflorescence,often,older,one,orbicular,pair,pore,poricidal,portion,prominent,proximal,pubescent,raised,reflexed,remaining,rounded,ruit,scar,size,slightly,spaced,sparsely,stigm,straight,strongly,tall,tip,tube,two,ud,unit,vein,widening,widest,ympodial,young	10-40,abaxial,adaxial,arrangement,bud,color,colour,diameter,flower,form,growth,height,history,inflorescence,length,lenticellate,life,na,number,peduncle,perennial,plant,position,rachi,reproduction,seed,spacing,staman,stigma,surface,texture,width
405	wfo-0001028723	success	211	146	128	83	18	0.607	-1.5,0-0.5,0.2,0.8-1,0°,1,1-1.8,1-2.2,1/5-1/3,2-2.7,3.5-4,4,4-5,5,5-6,abaxially,acute,adaxially,almost,anther,anthesi,apex,apically,bark,base,becoming,brachyblast,branch,branched,branching,broadly,brown,calyx,capitate,clustered,cm,concolorous,conical,corolla,curved,dark,decurrent,dendritic,densely,density,developed,diameter,dilated,domatia,drying,elliptic,entire,except,faint,filament,fine,flat,flexuous,formed,frequent,glabrous,gradual,green,increasing,inner,leaf,length,less,liana,like,lobe,lobed,long,long-attenuate,longitudinally,margin,membranous,middle,midvein,minutely,mm,obconical,oblong,obovate,occasional,outer,overlapping,pair,pedicel,peduncle,petiole,poorly,primary,pubescent,raised,ridged,scar,short,shrub,side,simple,slender,small,smooth,sparsely,stem,stigma,stump,style,surface,surrounding,terminal,tertiary,tip,toward,transition,trichome,tube,tuft,unarmed,unevenly,vein,venation,white,widely,wrinkled,x,youngest	.3,.5,0.8-2,1-1.5,1-2.5,1/3-1/2,10-15,10-16,2-2.5,2-4,2.5,3-4,5-7,abaxial,age,alternate,alyx,another,apar,apice,apparently,articulated,clearly,common,delineated,deltoid,divided,dorsifixed,eaf,eed,ellipsoi,equal,ey,flower,free,junction,know,known,lengthening,lower,m.,main,mostly,much,multiply,naked,narrowly,nflorescence,nther,obtuse,one,orange-brown,orolla,ovate,pale,papillo,perfec,plurifoliat,pore,poricidal,portion,prominent,protruding,rachi,ray,region,regular,ruit,separated,sinus,smaller,spreading,tearing,tissu,ud,uneven,unit,vary,visible,wide,yellow,ympodial,young	angle,apart,arrangement,bud,color,ellipsoid,form,growth,inflorescence,na,number,ovary,papillose,shape,spacing,texture,tissue,width
406	wfo-0001028725	success	197	119	103	94	16	0.523	-10,0.1-0.2,0.2-0.5,0.6-1,1.5-1.7,1.5-2,1.5-4,10-12,2.5-8,3-6,4-12,4-5,5-10,7-8,acicular,anther,armed,base,berry,brown,bud,chartaceous,clavate-truncate,closely,cm,cordate,corolla,curved,densely,depressed,discolorous,elliptic-ovate,enlarged,filament,finely,flattened,flower,glandular,glandular-pubescent,glandular-tomentose,glandular-villose,globose,green,growth,inconspicuous,inflorescence,internodal,lanceolate-subulate,leaf,leathery,like,lobed,long-styled,lower,minute,minutely,mm,moderately,nearly,ovary,ovate,pedicel,peduncle,persistently,petiole,prickle,prickly,pubescent,reniform,rest,reticulate,rusty,rusty-tomentose,scar,short-styled,shrub,simple,size,slender,slightly,small,somewhat,sparsely,stellate,stem,stigma,style,surface,tapering,terete,terminal,tomentose,trichome,tube,turbinate,unarmed,undulate,unevenly,upper,velutinous,violet,x,yellowish	.1,0.3-0.4,1-1.5,1-2,1.2-1.5,1/4,2,2.5-3,3-4,3-plurifoliat,4-6-celled,4-locular,7,abaxially,acute,adaxially,anthesi,apex,articulated,bark,basal,calyx,clearly,connate,denser,diameter,distal,eaf,eed,eglandular,elongate,entire,exserted,free,fruiting,glabrescent,glabrous,gland-tipped,greatly,greyish,heterostylous,lengthening,linear-lanceolate,lobe,long,longer,margin,midpoint,midrib,mixed,multicellular,new,nflorescence,oblique,obverse,older,papillo,perfect,pericarp,pore,poricidal,porrect,portion,pubescence,ray,recurved,reduced,reflexe,reflexed,repand-angular,rounded,ruit,rusty-brown,sessile,short-talked,similar,slit,space,stalked,staminate,stellate-tomentose,straight,strongly,tall,testa,tip,ud,unit,varying,vein,viscid,whit,yellow,ympodial	arrangement,color,form,fruit,glandularity,height,length,number,papillose,plant,position,pricklines,seed,shape,spaced,texture
407	wfo-0001028736	success	180	135	109	71	26	0.606	0.5,0.5-1.5,0.5-2,1,1-2,1-3,1/6,10-15,2-4,2-5,2-7,3-5,3-6,3-8,3.5-5,4-6,4-9,5-10,5-15,abaxially,absent,accrescent,acute,anther,apex,base,brown,calyx,chartaceous,cm,created,cut,cylindrical,dark,densely,diameter,either,extra-axillary,filament,filiform,flower,fruit,fruiting,glabrous,globose,green,hair,immature,leaf,length,less,light,lobe,lobed,long,major,many,mature,midpoint,midrib,midvein,mm,moderately,mottled,narrowly,nearly,netlike,obtuse,occasional,orange,pedicel,peduncle,per,petiole,pit,porrect-stellate,prickle,pubescent,rachi,raised,recurved,red,reniform,rhombic,ridge,roselike,shrub,side,simple,sinus,small,sparsely,stalk,stellate,stem,stigma,style,surface,triangular,tube,unarmed,unbranched,unlobed,vein,way,white,x,yellow,yellow-white	0.2-0.4,0.5-1,0.5-1mm,1-1.5,1.5,1.5-3,4-12,40-70,5-merou,6-13x3-8,6-8,adaxiall,adaxially,alyx,apar,apical,apparently,armed,attenuate,axe,berry,beyond,blade,connivent,contiguous,cordate,decurrent,difoliate,directed,discolorous,eaf,eed,exserted,flattened,frui,geminate,glabrou,glandular,gree,introsel,like,lower,m.,multicellular,multiseriate,nflorescence,occasionally,onto,orolla,pair,perfect,pore,purple,ray,ruit,scanden,slightly,spaced,stamen,ste,tamen,tapering,tem,thin-skinned,unequa,unicellular,uniseriate,unit,vary,wide,ympodial	abaxial,adaxial,apart,arrangement,color,colour,corolla,form,growth,height,history,inflorescence,life,na,number,ovary,perennial,plant,position,reproduction,seed,shape,spacing,staman,texture,width
408	wfo-0001028737	success	151	86	59	92	27	0.391	0.2-0.5,1-4,1-6,1.5-3.5,12-14,16-30,2.8-3.5,4-10,6,acute,apex,articulate,branched,cm,corolla,cyme,diameter,dichasial,dichasially,digestion,distal,ebracteate,elliptic-lanceolate,enzyme,filament,flower,glandular,globose,green,green-white,hair-like,half,herbaceous,honeycomb,lanceolate,lateral,leaf,mm,monochasial,mucilaginous,odd-pinnate,ovoid,pattern,pedicel,peduncle,perennial,petiole,plant,proximal,rachi,reveal,seed,stellate,stigma,style,throughout,wall,yellow,¼	0.7-2,1,1-2.5,10,2-3,2-5,3-4,3-5,3-6-foliat,4-6.5,4-9,5-6,7-15,abaxially,absen,acumen,acuminate,adaxially,apical,apically,apiculate,attenuate,base,calyx,caudate,cell,connate,covering,decurrent,dehiscent,diminishing,dorsally,eaf,edge,eed,emoval,exceeding,flat,folded,forked,generally,glabrescent,globo,gradually,interjected,introrse,larger,leaflet,living,lobe,lon,long,lower,make,maturing,nflorescence,nther,oblique,oblong,often,orolla,pair,perfect,pinnatifi,plan,poricidally,ruit,second,sessile,seudostipule,short,size,slit,specimen,stamen,straight,strongly,tal,tem,terminal,testal,thick,throughou,toward,tuber-bearing,typically,unit,vary,whit,wide,without,ympodial	abaxial,adaxial,anther,arrangement,color,colour,form,fruit,growth,height,history,inflorescence,length,life,na,number,ovary,position,present,reproduction,shape,spacing,staman,surface,texture,white,width
409	wfo-0001028773	success	169	95	69	100	26	0.408	0-0.2,0-1,0.15-0.25,0.15-0.3,0.8-0.9,0.9-2.8,1-2,1-3,10-16,3-4.5,4-6.5,4-7,5-6.5,6-11,accrescent,adaxially,anther,apart,apex,articulated,base,broadly,calyx,cm,cordate,densely,diameter,elliptic,entire,erect,exceeding,extra-axillary,flower,fruit,fruiting,glabrous,globose,green,greenish-white,hair,inflorescence,leaf,length,lilac,lobe,margin,mature,midpoint,mm,obtuse,ovate,pale,pedicel,peduncle,perennial,petiole,porrect,red,rhizomatous,rotate,rotate-stellate,shrub,stellate-pubescent,style,surface,tube,unbranched,white,yellow	%,.7,0.1-0.2,0.15-0.35,0.3-0.4,0.3-0.5,0.3-0.6,0.4-0.5,0.5-0.58,1-4.3,1-locular,1.4-2,2,2-5,2-6,2-foliate,2.2-2.8,3-5,3.3-3.8,30-55,4.5-5.5,5-merou,7-8,7-9,abaxially,absen,absent,across,adaxiall,adult,alyx,apparen,axe,ba,blade,brown,chartaceous,directed,distall,distributed,eaf,eed,eglandular,exocarp,finger,geminate,gland-tipped,glandular,grey,homostylous,incomplete,juicy,juvenile,lamina,lateral,lobed,long,lower,mesocarp,minute,nflorescence,oblique,onl,orolla,pair,part,per,perfect,placenta,pore,prickle,probably,pseudo-racemose,ray,ruit,rusty,septum,sessile,shallowly,short,simple,solitary,spaced,stellae,succulent,tal,tamen,tem,thick,throughout,time,unarme,unarmed,unit,upper,vary,wide,without,x,ympodial	0.7,abaxial,adaxial,articulation,color,colour,corolla,filament,form,growth,height,history,life,na,number,ovary,plant,position,reproduction,seed,shape,spacing,staman,stigma,texture,thicknes
410	wfo-0001028774	success	141	58	37	104	21	0.262	0.4-0.7,1.4-1.8,1/2-2/3,10-20,2.5-4.0,3-8,4-8,8-12,anther,blade,bright,broadly,chocolate-brown,cm,dm,dry,elongate,foveolate,glabrous,hair,lenticular,long,maturity,minutely,mm,otherwise,ovate,pentagonal-stellate,petiole,smooth,spherical,splitting,stellate,stellate-pubescent,stem,surface,yellow	0.5-0.8,12-20-rayed,2.5-3.5,2.7-3.3,3-5,3-7,30-60,5-9,6-10-flowere,9-12,accrescent,acro,almost,along,alyx,annually,anthesi,appearance,arcuate,armed,base,beneath,berry,broad,calyx,campanulate,closely,deeply,density,developing,dia,difoliate,distinctive,divided,eaf,eed,emerging,erect,extended,externally,fine,fully,geminat,giving,grayish-green,herb,herbage,hetermorphic,internodal,invested,irregular,least,lengt,linear-lanceolate,lobe,lon,lowermost,margin,merely,midvein,nflorescence,numerous,often,orolla,per,perennial,pinnatifid,prickle,prickly,rounded,ruit,scattered,separated,short,short-stipitate,slende,somewhat,spaced,spreading,stellate-woolly,stout,straight,strait-yellow,surrounding,tall,tamen,thick,tightly,tigma,tub,tube,tyle,unarmed,undulate,unexpande,unit,vary,varying,velvety-farinaceous,vestiture,weakly,woody,ympodial,zygomorphic	6-10-flowered,color,corolla,diameter,filament,flower,fruit,height,inflorescence,leaf,length,ovary,plant,seed,shape,staman,stigma,style,texture,type,unexpanded
411	wfo-0001028777	invalid_json_followup	205	131	97	108	34	0.473	-10,-2.5,-4,.5,0-2,0.1-0.2,0.2,0.4-0.8,0.5-1.3,0.7-1.2,0.8-2.2,1,1-2.5,1-3,1.5-3,1.5-4,1.8-2.5,2-,3,3/4-4/5,4-5-merous,4.5-8,abaxially,anther,apex,articulated,attenuate,bark,base,berry,blade,cm,dark,diameter,entire,erect,filament,flattened-reniform,flower,fruit,glabrescent,glabrous,green,green-brown,inflorescence,leaf,length,less,lobed,long,margin,marking,maturity,mauve,midpoint,mm,moderately,multangulate,obovate,orange,orange-brown,ovate,pair,pale,pedicel,peduncle,petiole,primary,ray,red-brown,reflexed,retuse,rounded,sessile,shoot,short,shorter,shrub,simple,small,smooth,sometimes,spherical,stalked,stellate-pubescent,style,surface,terminal,tree,trichome,truncate,vein,way,white,wide,yellow-green,young	-12,-3,.8,.9,0-30,0.1-0.3,0.6-1,0.7-1.3,0.8-1,1-2,1.5,1/4,1/4-1/2,2.5,2.5-3,2.5-5,3.5-5,6-10,7-11,8,8-15,acuminat,acute,alyx,ame,apar,ape,apically,branched,briefly,c.,calyx,chartaceous,concolorous,connivent,curved,deciduou,deltate,discolorous,drying,eaf,eed,elongating,equal,faint,free,fruiting,glabrescen,infructescence,lengt,lobe,long-styled,longer,lower,mature,minute,narrow-deltate,nflorescence,occasionally,older,one,open,orolla,oung,per,perfect,pericarp,plurifoliat,poricidal,porrect,portion,present,recurved,reflexe,ruit,scar,short-styled,shorte,somewhat,soon,spaced,sparsely,spreading,stalk,staminate,stellate,stem,stout,strongly,tamen,tapering,terete,tertiary,time,tip,tube,unarme,unarmed,unit,usually,variously,vary,venation,visible,whole,wider,woody,ympodial	'',[,``,abaxial,adaxial,apart,arrangement,characteristic,color,colour,corolla,form,growth,height,history,life,na,number,ovary,perennial,plant,position,rachi,reproduction,seed,shape,spacing,staman,stigma,texture,value,width,{,}
412	wfo-0001028788	success	189	104	81	108	23	0.429	0-10,0-3.5,0.4-1.3,0.6-1.2,0.7-1.8,0.8-1.1,1-1.5,2-3,3-10,4.5-6.5,6-10,8-10,absent,acicular,acute,andromonoecious,anther,apex,ascending,base,black,broad-based,brown,cm,cordate,cylindrical,dark,densely,diameter,distally,eglandular,entire,extra-axillary,finger,fruit,gland-tipped,globose,green,hair,inflorescence,lanceolate,lateral,length,lilac,long,margin,markedly,midpoint,mm,obtuse,ovate,pale,pedicel,peduncle,per,perennial,petiole,placenta,plant,porrect,present,prickle,pseudo-racemose,purple,ray,rusty,shrub,stalked,stellate,stellate-pubescent,stem,straight,streak,style,thick,thicker,throughout,time,yellow,yellowish,yellowish-green	%,0-0.3,0-0.4,0.05-0.1,0.1-0.4,0.15-0.4,0.2-0.4,0.3-0.5,0.5-1,0.7-1.3,0.7-1.4,0.8-1.5,0.8=2.5,1,1-10,1-2,1.1-2.3,1.4-1.6,10-14,10-20,2-5,2.3-3.6,2.5-3.5,2.5-4.5,2.5-8.5,4-locular,5-15,5-merou,6-14,6-8,7-10,7-9,8-11,abaxially,absen,across,adaxiall,adaxially,alyx,anvil-shape,apart,articulated,attenuate,axe,ba,blade,calyx,chartaceous,cross-section,decimetr,directed,distall,distributed,dult,eaf,eed,erect,exocarp,flower,fruiting,functional,grey,grey-green,half,heterostylous,hig,juicy,lamina,less,lobe,longer,lower,mature,mesocarp,mid-point,minute,moist,multiradiate,nflorescence,oblique,onl,orolla,part,pore,rhizomatous,rostrate,ruit,sessile,short,simple,spaced,stage,stalk,stellae,tamen,tube,unarme,unarmed,unbranched,unit,unknow,uvenile,vary,weakly,white,wide,x,ympodial	abaxial,anvil-shaped,color,corolla,decimetre,filament,form,growth,height,history,leaf,life,na,ovary,position,presence,reproduction,seed,shape,staman,stigma,surface,texture
413	wfo-0001028791	success	257	106	90	167	16	0.35	+,0.05-0.2,0.4-0.65,0.6-0.8,0.8-1.3,1-1.5,1-2-celled,1.7-2.1,1.8-3.3,10,2-3.5,2-7,2.8-3.0,4-5+,5-15,8-10-celled,9-30,abaxially,absent,anther,articulated,border,branched,broadly,brown,capitate,clambering,cm,conical,corolla,dark,deciduous,densely,developed,diameter,dichotomously,elliptic,filament,flower,fruit,glabrous,glandular,globose,green,hair-like,imparipinnate,interrupted,leaf,liana,long,many,middle,mm,near,obovate,occasionally,outgrowth,ovary,pale,paler,pedicel,peduncle,petiole,plant,poorly,pseudostipule,pubescent,scandent,seed,short,simple,slightly,sparsely,stellate,stem,stigma,style,surface,thick,time,transparent,trichome,uniseriate,usually,vine,white,wide,winged,woody,yellow	-0.6,-1.5,-9,.5,0-6,0.05,0.2-0.3,0.2-0.4,0.2-0.8,0.25-0.3,0.3-0.4,0.3-0.5,0.3-0.6,0.3-0.8,0.4-0.5,0.4-0.6,0.4-1.1,0.45-0.55,0.5,0.6-0.9,0.7-1.5,0.8-1,1-2,1-3,1-3-celled,1-celled,1.5-,1.5-2,1.6-4.5,100,2-3,2-7-celled,2-locular,2.5-4.5,20-to,3-,3-4,4-11.5,4-15,4-celled,5-,5-10,5-22,5-plurifoliate,50-80,9-35,absen,abundant,acuminate,acute,adaxially,addition,ag,along,anthesi,apex,apical,appearance,appendage,articulation,basal,base,basiscopically,beneath,berr,breaking,bullate,calyx,cell,colo.,column,consistently,darker,deltate,densest,eaf,ebracteate,edicel,eed,eglandular,elongating,enlarged,entire,even,exserted,extended,free,fruiting,give,glabrescent,gree,grow,growing,half,halfway,head,interjected,internode,lamina,large,lateral,leaflet,leaving,less,like,lobe,lon,lower,margin,midvein,minutely,mixture,much,multicellular,nflorescence,oblique,often,pair,papillate,per,petiolule,present,primary,protuberance,pubescence,rachi,reflexed,rest,rough,round,ruit,sandpapery,secondary,sessile,shorter,silky,single,small,smaller,sometimes,somewhat,sparse,spreading,stamen,staminal,sterile,stiff,straight,tal,tem,terminal,tertiary,testa,thickened,tip,touch,truncate,tube,ud,unicellular,unit,upper,vegetation,vein,wall,ympodial,–1-2-celled	abaxial,adaxial,arrangement,color,colour,form,growth,height,inflorescence,length,shape,spacing,staman,texture,thicknes,width
414	wfo-0001028798	success	214	99	72	142	27	0.336	0-1,0.2-0.4,0.5-2,0.9-1.2,1-3,1-4.5,1-6,1.1-2,1.5-1.8,2-3.75,2-7,2.4-4.4,2.6-4,3-5,3.3-5.6,5-8,7-8,8.5-13,acute,anther,apex,articulated,base,blunt-tipped,chartaceous,cm,conical,corolla,diameter,dm,filament,flower,fruit,granular,green,greenish,growth,lanceolate,leaf,length,lobe,mm,oblanceolate,oblong,obovate,obtuse,orbicular,pale,pedicel,peduncle,petiole,probably,pseudo-terminal,rachi,ripe,rotate-stellate,rough,semi-ovate,short,shrub,simple,slightly,stigma,style,subcoriaceous,subglobose,tip,tomentose,tube,x,yellow,yellowish	.5-5,0-60,1/2-2/3,1/20,10,15-19,2-3,2-6,2.5-3.5,2/3,3-4,3.8-4.2,4-5.4,5.25-7.5,6-10,6-8,8-18,abaxially,accrescent,acuminate,adaxially,ag,anthesi,apart,apical-lateral,apparently,attenuate,axe,axillary,ba,becoming,berry,blade,boat-shaped,branch,branched,bud,calyx,capitat,continued,curved,cylindrical,decurrent,dehiscing,densely,distal,downward,due,eaf,echinoi,echinoid,eed,entire,exserted,extend,fleshy,free,fruiting,glabrous,granular-tomentose,hair,hal,high,included,inserted,introrse,irregularly,lacking,large,lateral,less,lined,lobed,long,longitudinal,lower,m.,main,many,margin,midvein,minutely,mixed,multangulat,multangulate,nearly,nflorescence,oblanceolat,obscured,often,orolla,oung,ovate-lanceolate,overlapping,perfect,persistent,persistently,plurifoliate,pore,porrect-stellate,present,prominent,pubescent,quite,rather,ray,rough-granular,ruit,sessile,short-stalked,side,slit,small,somewhat,spaced,sparingly,splitting,stalked,stamen,stellate-pubescent,stem,strongly,subcampanulate,sulcate,suture,tamen,thick,time,tomentu,tomentum,toward,translucent,unarme,unarmed,unit,unknow,vary,vein,velutinous,way,wide,ympodial	10-60,abaxial,adaxial,arrangement,articulation,capitate,color,colour,form,height,history,inflorescence,life,number,ovary,perennial,plant,position,reproduction,seed,shape,spacing,staman,surface,texture,thicknes,unknown
415	wfo-0001028803	success	204	140	125	79	15	0.613	.5,0.5,0.5–1,1,10,12–14,1–1.5,1–2,1–3,1–3.5,2,2–10,2–3,2–4,3–6,4–10,4–7,5,5-merous,5–8,8–12,8–14,abaxial,absent,actinomorphic,acute,adaxial,anther,apart,apex,appearing,armed,articulated,asymmetrical,attenuate,base,berry,branch,branched,brown,cm,connivent,curve,curved,curving,densely,diameter,difoliate,distal,downward,due,end,entire,field,filament,flower,fruit,functionally,glabrous,glandular,globose,green,hair,herbarium,hermaphroditic,leaf,length,light,like,lobed,long,main,male,margin,midpoint,midrib,midvein,mm,moderately,nearly,obtuse,occasional,often,older,ovate,pedicel,peduncle,petiole,pinnate,plant,prickle,proximally,pubescent,purple,rachi,ray,recurved,reniform,rounded,secondary,sheet,side,simple,slightly,small,sparsely,spreading,stalk,stellate,stellate-pubescent,stem,stigma,style,surface,tan,tapering,upward,vein,venation,violet,weakly,white,young,zygomorphic,×	0.5–3,14–20,1–1.2,2–3.5,3–10,3–4,6–10,75-120,8-12,ag,alyx,andromonoecious,anthesi,apical,apparently,axe,ba,bearing,becoming,blade,bud,calyx,chartaceous,cordate,cupular,cylindrical,darker,developed,eaf,early,eed,elongated,em,erect,exceeding,extra-axillary,flowering,fruiting,geminate,glabrou,held,infructescenc,lacking,late,liana,lobe,longitudinal,multiseriate,narrowly,nflorescence,opening,orolla,ower,pair,per,pore,ruit,scandent,shrub,slit,spaced,splitting,ste,surfac,tamen,tomentose,tree,triangula,triangular,typically,unarmed,unequa,unit,upright,usually,vary,wid,yellow,ympodial	1–20,armature,arrangement,color,corolla,height,inflorescence,number,ovary,seed,shape,spacing,staman,texture,wide
416	wfo-0001028815	success	196	121	94	102	27	0.48	0.4-0.8,1-10,1-2,1-5,10-15,2-4,22-35,3-4,3-5,5-6,5-7,6-8,7-16,abaxially,acute,adaxially,along,anther,apex,auriculate,axillary,broadly,brownish,bud,cell,ciliate,cm,condition,corolla,covering,dark,diameter,drying,elliptic,especially,filament,flower,forked,fresh,fruit,glabrous,globose,green,green-white,greenish,hair,hair-like,herb,interjected,lateral,leaflet,like,lilac-purple,make,margin,medium,midrib,minutely,mm,mucilaginous,obtuse,odd-pinnate,ovate,ovoid,pair,pedicel,peduncle,petiole,plant,puberulent,pubescent,purple,rachi,red-purple,ripe,rotate,rugose,seed,size,sparsely,stem,stigma,style,subtending,terminal,testal,thick,throughout,tinged,tip,wall,wet,whitish,yellow	0.5-1,1-3.5,1-4,14-28,2-4.5,2-9,2.5-6.5,3-7,4-10,5-merou,6-10,acumen,ag,alyx,apart,apparently,articulated,articulation,axe,base,basiscopic,berry,blade,capitat,chartaceous,connivent,cuneate,decreasing,decurrent,developing,digestion,distal,distinct,dorsally,eaf,edge,eed,elliptic-lanceolate,enzyme,exceeding,flat,folded,geminat,generally,glabrou,hal,half,high,homostylous,honeycomb-shaped,indistinct,lanceolate,lengthening,living,lobe,long,lower,membranous,narrowly,nflorescence,onto,orolla,papillose,perfect,petiolulate,plurifoliate,pointed,pore,poricidal,purpl,removed,rounded,ruit,semi-erec,semi-rosette,sessile,seudostipule,short,side,slightly,slit,spaced,specimen,splotched,stamen,ste,straight,tall,tamen,tem,terminated,tri-,triangular-lanceolate,tube,unit,unwinged,usually,vary,winged,x,ympodial,young	abaxial,adaxial,arrangement,capitate,color,colour,form,growth,height,history,inflorescence,leaf,length,life,na,number,ovary,perennial,position,pseudostipule,reproduction,shape,spacing,staman,surface,texture,width
417	wfo-0001028876	success	127	86	54	73	32	0.425	.5,0.4-1,0.5-2,1-2,1.5-2,2-2.3,3-5,4-5,5-6,abaxial,acute,anther,apex,calyx,capitate,closely,cm,conical,corolla,dendritic,densely,ellipsoid,elliptic,filament,flower,glabrous,internodal,leaf,lobed,minutely,mm,opposite,ovary,papillose,pedicel,petiole,pubescent,sagittate,scar,shining,shrub,simple,slender,small,spaced,sparsely,stem,stigma,style,subshrub,surface,trichome,white,x	/4,1.5-3,3-8,4-8,abaxially,adaxially,along,anthesi,attenuate,bark,base,branched,brown,dark,dia,difoliate,drying,eaf,edicel,eed,free,geminat,glabrat,golden,hroughout,included,inflorescenc,know,known,lamina,lateral,leave,like,lobe,long,long-triangular,lower,main,middle,midrib,nflorescence,nodding,occasionally,older,overlappin,pair,papillae,papillo,planar,pore,poricidal,portion,reddish,rest,rounded,ruti,shaped,speciman,straight,tall,tear-drop,tip,tub,tube,type,ud,uniseriate,unit,vein,way,widest,ympodial,young	adaxial,alternate,arrangement,bud,color,colour,diameter,form,fruit,fruiting,growth,height,history,inflorescence,length,life,na,new,number,overlapping,peduncle,perennial,plant,position,rachi,reproduction,seed,shape,spacing,staman,texture,width
418	wfo-0001028883	success	207	128	90	117	38	0.435	1,2,4,50,6,abaxially,absent,acute,adaxially,anther,apex,arched,articulated,ascending,attenuate,base,becoming,berry,blade,brochidodromous,calyx,capitate,chartaceous,cm,concolorous,coriaceous,cyme,dark,deltate,diameter,drying,dull,elliptic,entire,erect,exfoliating,filament,flower,fruit,glabrescent,glabrous,glandular,globose,green,greenish,growth,herb,impressed,lateral,leaf,length,light,margin,membranaceous,midrib,mm,moderately,narrowly,new,normally,pedicel,peduncle,petiole,prominent,pubescent,rachi,rarely,reniform,ripe,secondary,seed,simple,slightly,sparsely,stellate,stem,stigma,style,subopposite,surface,trichome,unbranched,undulate,uniseriate,vein,venation,white,whitish,woody,yellow	0.3–0.6,0.4–1.2,0.5–2,0.6,1.5–7,1–2,1–6,2–3,2–5,3–5,4–6,5,5-merou,6–10,6–12,accrescent,acuminate,adaxiall,almost,along,alyx,antrorse,antrorsely,apar,ark,axi,branch,brow,capitat,cell,ciliate,circular,common,completely,connivent,curved,cylindrical,decurrent,densely,differing,directed,eaf,eed,elliptic-ovate,emarginate,equal,eye,flattened,frui,geminate,geniculat,glabrou,head,hilum,hollow,introrsely,less,like,lobe,long,longitudinal,lower,lying,minor,multicellular,naked,nflorescence,notably,oblong,obtuse,often,older,onto,opening,orolla,ovate-lanceolate,parallel,pendan,per,perfect,plurifoliate,pore,poricidal,present,primarily,pubescence,region,rounded,ruit,sessile,shap,shiny,shrub,similar,single,single-celled,size,slit,small,sometimes,spaced,sparse,spreading,stalk,straight,subapical,subsessile,swollen,tall,tamen,tem,unit,vary,visible,wide,ympodial,×	1-2,1-6,2-5,3-5,4-6,5-merous,6-10,6-12,abaxial,adaxial,apart,arrangement,bark,brown,bud,color,colour,corolla,form,fruiting,height,history,inflorescence,life,na,number,ovary,pendant,perennial,plant,position,prominence,reproduction,shape,spacing,staman,texture,width
419	wfo-0001028885	success	214	119	93	121	26	0.435	0.5-5,0.7-2,1-1.2,1-2,1.5-3.5,10-20,2.3-2.5,2/3,3.5-4.5,7-8,9-11,abaxial,acute,adaxial,along,anther,apart,apex,apparently,attenuate,base,berry,black,branch,branched,brown,capitate,cm,collapsing,corolla,dark,densely,diameter,elliptic,entire,erect,filament,flower,furcate,glabrous,glandular,globose,golden,groove,growth,height,inflorescence,irregularly,lamina,lanceolate,lateral,leaf,like,lobed,margin,midvein,mm,narrowly,nodding,occasionally,pedicel,peduncle,petiole,plant,pubescent,purple,reddish,revolute,rhachi,ripe,scandent,scattered,shiny,shrub,simple,slender,smaller,sometimes,spaced,sparsely,stellate,stigma,style,surface,terminal,trichome,uniseriate,usually,vine,way,weak,woody,¾	-1,.5,0.3-0.5,0.5-1,1-1.5,1-3,1.5-1.7,2,2-,2-2.5,2.5-3.5,3-5,3.5-8.5,4-5,5-merou,7-9,9-12,?,adaxially,ag,alyx,anthesi,apiculate,archin,ark,articulated,basal,blackish,broadly,calyx,cell,connivent,cup-shaped,dark-pigmented,decurrent,deltate,dendriti,distal,dried,drying,eaf,eed,ellipsoid,exserted,extending,fleshy,free,fruiting,glabrescent,glabrou,gradually,groupe,ilament,immature,inserted,known,leaving,lengthening,less,live,lobe,long,loosely,lower,material,minute,minutely,mostly,multicellular,narrowing,new,nflorescence,noddin,often,older,orolla,pair,papillo,part,peg,perfect,pericarp,pigmentation,plurifoliat,pore,poricidal,portion,primary,quarter,recorded,retaining,ruit,scar,shin,short,sleeve,slightly,slit,small,spheroidal,spreading,stem,strongly,tangled,tem,thin,third,time,tip,tube,twinin,ud,unit,upper,vary,vein,wall,weak-walled,wide,winged,ympodial	5-merous,arching,arrangement,bark,color,colour,feature,form,fruit,grouped,history,length,life,na,number,ovary,plurifoliate,position,rachi,reproduction,seed,shape,spacing,staman,texture,width
420	wfo-0001028888	success	207	145	113	94	32	0.546	0-3.5,0-5,0-7,0.15-0.5,1-10,1-2,10-25,2.3-7,2.5-3.3,3-4,4-25,5-10,5-7,6-11,8-11,abaxially,acuminate,acute,adaxially,along,anther,apart,apex,articulated,axillary,base,broadly,brownish,bud,cell,center,ciliate,clavate,cm,condition,corolla,covering,diameter,dot,drying,elliptic,end,especially,filament,flower,forked,fresh,fruit,glabrous,globose,green,green-white,greenish,hair,hair-like,herb,interjected,lateral,leaflet,like,lobe,make,margin,middle,midrib,minutely,mm,mucilaginous,oblique,odd-pinnate,often,one,orbicular,ovate,ovoid,pair,pedicel,peduncle,pentagonal,petiole,placed,plant,plurifoliate,puberulent,pubescent,ripe,rounded,scattered,seed,size,sparsely,stem,stigma,streak,style,subglabrous,substellate,subtending,terminal,testal,thick,throughout,tip,tri-,tuber,typically,unit,violet,wall,wet,white,whitish,yellow	1,1-1.5,1-3,1.5-4,12.5-25,2-5,2-6,2.3-5,3-5,3.6-12.5,3.8-8.3,4-7,5-merou,8-13.5,acumen,ag,alyx,apiculate,apparently,axe,berry,blade,capitat,central,chartaceous,connivent,covered,cuneate,digestion,distal,dorsally,eaf,edge,eed,enzyme,erec,exceeding,except,flat,folded,geminat,generally,glabrou,glaucous,greatly,hal,half,homostylous,honeycomb-shaped,lanceolate,lengthening,less,living,long,low,lower,membranous,mottled,nflorescence,orolla,perfect,petiolulate,petiolule,pore,poricidal,proximal,purple,reduced,removed,ruit,sessile,seudostipule,short,slightly,slit,sometimes,spaced,specimen,stamen,ste,stolo,straight,subequal,tall,tamen,tem,truncate,tube,unwinged,usually,vary,wing,x,ympodial	abaxial,adaxial,arrangement,capitate,color,colour,form,growth,height,history,inflorescence,leaf,length,life,na,number,ovary,perennial,placement,position,pseudostipule,rachi,reproduction,shape,spacing,staman,stolon,surface,sympodial,texture,type,width
421	wfo-0001028905	success	210	119	92	118	27	0.438	-3.5,-5,1,1-,1-3,1.5-3,10,2-2.5,3-4,3-5,4,40-60,5,5-15,6-9,acuminate,anther,apex,appressed,axil,base,bilobed,blunt,bluntly,broadly,brown,bud,calyx,capitate,cell,cm,concentrically,conical,corolla,cuneate,cyme,deep,deeply,ellipsoid,enlarged,except,facetted,filament,flower,fork,form,glabrescent,glabrous,glandular,green,hair,lasting,later,leaf,line,minute,mm,narrowly,obovoid,orange-yellow,ovary,ovate,ovoid,paling,pedicel,peduncle,petiole,pinnatisect,plant,purple-blue,rarely,reddish,reticulate,rotate,rounded,rugose,scorpioid,several,shortly,shrub,size,soft-wooded,stem,stigma,style,succulent,suffused,surface,tube,x,year,yellow	-20,-4,-9,1.5,1.5-2,10-15,10-20,15-30,2,2-3,2.5-3,200-300,38/1-38/2,5-,7,acuman,acumen,adult,age,almost,also,appearing,aspect,aster,becoming,berry,broad,close,completely,continued,covering,developed,dia,distance,distinctly,eaf,eed,emarginate,entire,equal,even,exceeding,exerted,firming,first,floral,forked,free,frui,fruiting,general,growing,herbarium,inadequate,interacuminal,intermediate,lanceolate,lengthening,less,lobe,lobed,lobing,lon,long,lower,main,margin,may,midrib,mucronate,nflorescence,oblong,occur,often,pair,papillo,pedicellate,plurifoliat,pore,poricidal,purpli,range,reaching,readily,rh,rhachi,ripe,ruit,ruiting,scarious,seedling,shed,short,show,showy,simple,sinus,slende,slit,smaller,soon,sparse,specimen,spreading,stone,straggly,tall,tip,tissue,tub,ud,unit,usually,variable,violet,well,ympodial,young	abaxial,adaxial,arrangement,color,colour,diameter,fruit,growth,height,history,inflorescence,length,life,na,number,plurifoliate,position,purplish,rachi,reproduction,seed,shape,slender,spacing,staman,texture,width
422	wfo-0001028916	success	212	119	97	115	22	0.458	0-2,0.2-0.4,0.5-3,0.5-3.2,0.5-5,1-2,1-3,1-4,1-4.6,1-7,1.5-3,15-25,2-12,2-5,3-5,3.5-4.5,35-50,5-10,5-12,5-35,5-7.5,6-20,7-18,acicular,adaxially,andromonoecious,anther,apex,base,broad-based,chartaceous,cm,cuneate,cut,decimetre,deeply,densely,depressed-globose,diameter,ellipsoidal,elliptical,filament,flower,fruit,glabrous,globose,green,grey,hair,herbaceous,index,inflorescence,later,lateral,length,light,lilac,lobe,lobed,marbled,margin,midvein,minutely,mm,obtuse,ovate,pale,pedicel,peduncle,per,petiole,pitted,plant,present,prickle,prostrate,purple,rachi,resprouter,rotate,rotate-pentagonal,shallowly,side,sparsely,sprawling,stellate,stellate-pubescent,stigma,straight,style,surface,throughout,unbranched,vein,weakly,white,yellow	%,-8,0-0.4,0-0.5,0.05-0.1,0.2-0.3,0.25-0.3,0.25-0.35,0.3-0.4,0.4-0.8,0.4-1.3,0.5-3.5,0.9-1.1,1-1.5,1.5-2.5,1.8-2.2,10-16,14-21,2.5-5,3-4,35-55,4-,4-8,5-9,5-merou,7-10,7-8,8-10,8-9,abaxially,absen,absent,abundant,accrescent,across,adaxiall,adult,alyx,apart,armed,articulated,axe,ba,blade,branche,broadly,brown,calyx,connivent,cylindrical,deflexed,deltate,directed,distall,distributed,eaf,eed,eglandular,extra-axillary,finger,fruiting,functional,gland-tipped,half,heterostylous,interpetalar,lamina,less,lobing,lon,long,longer,loosely,lower,mature,mesocarp,midpoint,minute,moderately,nflorescence,notably,oblique,oblong-attenuate,orolla,part,pore,porrect,presen,ray,ruit,sessile,short,simple,somewhat,spaced,stage,stellae,succulen,tal,tamen,tem,thick,time,tissue,triangular,truncat,tube,unit,unknow,uvenile,vary,wide,winged,x,ympodial	abaxial,adaxial,color,corolla,form,growth,height,history,leaf,life,na,number,ovary,presence,reproduction,seed,shape,spacing,staman,stem,texture,truncate
423	wfo-0001028920	success	152	119	86	66	33	0.566	.5,0.2-1,0.5-1,0.8-1.1,1-1.2,1-1.5,1-3,3-3.5,6-6.5,abaxially,acuminate,acute,adaxially,anther,apex,arachnoid,arachnoid-pubescent,area,attenuate,bark,base,broadly,brown,brownish,closely,cm,congested,conical,corolla,dark,deflexed,dendritic,dense,densely,difoliate,ellipsoid,elliptic,felty,filament,flower,glabrate,glabrous,globose,green,later,leaf,lightly,lobed,long-styled,minutely,mm,nearly,obovate,obovoid,occasionally,opposite,ovary,ovoid-reniform,papillose,pedicel,petiole,pitted,pore,pubescence,pubescent,shape,shaped,short-styled,shrub,simple,small,spaced,sparsely,stem,stigma,style,surface,tapering,tear-drop,tree,trichome,tube,unifoliate,uniseriate,white,winged	.25,1-2.4,1.5-2,2-2.5,2-7,3-15-flowered,3-4,5-9,6-15,anthesi,axil,ba,berry,calyx,cucullate,decurrent,deltate,dia,differing,eaf,edicel,eed,erect,exserted,fleshy,free,fruiting,geminat,gray-brow,lateral,lobe,lon,long,lower,main,major,middle,minor,nflorescence,older,overlappin,pair,planar,poricidal,portion,present,ruit,scar,size,somewhat,soon,strongly,styl,tall,thick,tip,tub,tuft,ud,unit,vein,widest,woody,x,ympodial,young	3-15,abaxial,adaxial,arrangement,bud,color,colour,decurren,diameter,form,fruit,geminate,gray-brown,growth,height,history,inflorescence,length,life,na,number,overlapping,peduncle,perennial,plant,position,rachi,reproduction,seed,spacing,staman,texture,width
424	wfo-0001028929	success	210	127	110	100	17	0.524	.5,.7,.9,/5,0-3,0.1,0.2-0.8,0.4-0.8,0.5-1.5,0.5-2,0.7-1,0.7-2,1-1.1,2-3,2-4,2-6,2-9,3-20,3-4,4-6,5-6,5-merous,abaxial,abaxially,acicular,acute,adaxial,anther,apart,apex,apparently,bark,base,berry,cell,chartaceous,cm,concolorous,cuneate,densely,diameter,discolorous,drying,dull,elliptic,erect,filament,flattened-reniform,flower,fruit,glabrescent,glabrous,inflorescence,lateral,leaf,length,lobe,lobed,long,margin,maturity,midpoint,minutely,mm,obovate,obtuse,orange-brown,outline,pair,pale,patch,pedicel,peduncle,perpendicular,petiole,pit,porrect,prickle,prickly,primary,raised,red,red-brown,reticulate,sessile,shrub,side,simple,small,smooth,spaced,spherical,stalked,stellate-pubescent,stem,straight,style,surface,terete,tertiary,trichome,unarmed,variously,vein,venation,visible,way,white,wide,yellow	-2,-2/3,0,0-1,0-10,0-20,0.15-0.3,0.2-0.3,0.2-0.4,0.3-0.6,0.8-1,1,1-3,1.5-2.4,1/2,1/4-1/3,2.2-2.3,2.5-4,2.7-3,2/3-3/4,5-25,5-7.5,6-8,7-9,8-10,alyx,apar,ape,apically,articulated,blade,branched,calyx,connivent,curved,difoliate,distance,eaf,eed,elongating,equal,extending,foliaceous,free,fruiting,geminat,gently,glabrou,gra,hair,infructescence,lon,long-styled,longer,lower,mature,midvein,minute,narrow-deltate,narrow-ovate,nflorescence,oblong,obtu,occasionally,older,one,open,orolla,oung,pendulous,per,perfect,pericarp,poricidal,portion,prickl,ray,red-green,rounded,ruit,scar,short-styled,slender,sometimes,spreading,stalk,staminate,stellate,subsessile,tamen,tapering,time,tip,tube,unit,usually,vary,woody,yellow-green,ympodial	arrangement,color,corolla,form,gray,growth,height,number,ovary,plant,pricklines,seed,shape,spacing,staman,texture,width
425	wfo-0001028934	success	177	145	121	56	24	0.684	0.5,0.5-0.75,0.5-1,0.5-1.5,0.5-2,1,1-2,1-3,1.5-2,1.5-2.5,10-30,2-2.5,2-3,3-5,3-6,3-7,5-10,5-6,5-8,6-9,8-14,abaxially,absent,accrescent,acute,adaxially,anther,apex,apical,armed,asymmetrical,attenuate,base,brown,bud,calyx,chartaceous,cm,connivent,created,dark,densely,diameter,discolorous,either,extra-axillary,filament,flattened,flower,fruit,fruiting,glabrous,globose,green,hair,immature,lanceolate,leaf,light,like,lobe,lobed,long,major,many,margin,mature,midpoint,midrib,midvein,mm,moderately,multicellular,multiseriate,narrowly,nearly,netlike,obscure,often,orange,ovate,pedicel,peduncle,petiole,pit,pore,porrect-stellate,prickle,pubescent,rachi,raised,ray,recurved,red,reniform,ridge,roselike,secondary,side,simple,slightly,small,spreading,stalk,stellate,stem,stigma,style,surface,tan,tapering,triangular,unbranched,unicellular,unlobed,vein,vine,white,wide,x,yellow	1-.,1.5,15-25,2-4,5-15,5-merou,6-7,adaxiall,alyx,apar,apparently,axe,berry,beyond,blade,cordate,cylindrical,difoliate,directed,distally,eaf,eed,em,expanded,exserted,filiform,frui,geminate,glabrou,gree,introrsel,leathery,lower,m.,nflorescence,obtuse,orolla,pair,per,perfect,pirckle,reflexed,ruit,skinned,spaced,stamen,ste,tamen,thin,tube,unarmed,unequa,unit,vary,x1-3,ympodial	1-4,5-merous,apart,armature,arrangement,color,corolla,direction,form,growth,height,inflorescence,introrsely,length,ovary,plant,position,seed,shape,size,spacing,staman,texture,width
426	wfo-0001028944	success	212	127	101	111	26	0.476	0.5-1,0.8-5,1-1.5,1-3,1-3-lobed,1-4,1-5,1.5-7,10-20,2.5-10,2.5-4,20-50,5-10,6-15,6-8,8-13,abaxially,acute,adaxially,anther,apart,apex,articulated,base,branched,bright,broad,broad-based,brown,chartaceous,cm,coarsely,cordate,cuneate,dark,densely,diameter,elliptic,entire,especially,extra-axillary,ferruginous,filament,flattened,flower,forked,fruit,glabrescent,glabrous,globose,green,growth,hair,homostylous,leaf,light,long,margin,mature,midpoint,midrib,mm,multangulate,nearly,occasionally,outline,ovate,pedicel,peduncle,petiole,porrect-stellate,prickle,pubescent,purple,rachi,ray,recurved,reniform,ripe,rotate-stellate,rounded,shallowly,shorter,shrub,simple,small,smooth,stellate,stellate-pubescent,stigma,straight,strongly,style,surface,tree,unbranched,white,whitish,x,yellow,young	.5-2.5,0.5-0.75,0.5-1.5,0.75-1.25,0.8-1.5,1-2,2-15,2-2.5,2-3,3-4,4-5,4-6,4-8,5-25,5-merou,6-7,7-17,8-10,abundant,accrescent,ag,alyx,apparently,armed,axe,ba,berry,blade,brownish,calyx,capitat,connivent,covering,curved,cylindrical,deltate,denser,difoliate,directed,discolorous,distally,divided,eaf,eed,equal,erect,free,frui,fruiting,geminate,glabrou,halfway,highly,interpetalar,lanceolate,like,linear-acuminate,lobe,long-stalked,longitudinal,lower,main,major,membanaceous,moderately,mucilaginou,narrowly,nflorescence,numerous,oblique,obtuse,often,opening,orolla,part,perfect,pericarp,pore,ruit,sessile,short-,short-stalked,side,slightly,slit,sometimes,spaced,sparse,sparsely,stalk,stem,subtending,tal,tamen,tapered,tem,thin,time,tip,tissue,toward,triangular,tube,unarmed,unit,vary,vein,white-pubescent,wide,yellowish,ympodial	5-merous,abaxial,adaxial,arrangement,capitate,color,colour,corolla,form,height,history,inflorescence,length,life,na,number,ovary,plant,position,reproduction,seed,shape,spacing,staman,texture,width
427	wfo-0001028963	success	197	123	103	94	20	0.523	/2,0-0.4,0-2,0.1,0.1-0.25,0.3-0.6,0.3-1,0.3-1.5,0.45-0.6,0.6-0.9,0.6-1,0.9-1.5,1-4,1/5,2-4,2-9,3.5-4.2,4-10,4-8,5-merous,anther,apex,articulated,bark,base,berry,blade,bright,brown,cell,cm,connivent,curved,densely,diameter,dull,erect,evenly,filament,flattened-reniform,flower,glabrescent,glabrous,gray-green,green,herb,inflorescence,lanceolate,leaf,length,light,lobed,longer,lower,maturity,mauve,midpoint,mm,moderately,narrow-elliptic,narrowly,orange,outline,pale,pedicel,peduncle,petiole,pit,poricidal,porrect,purple,raised,ray,red,sessile,shorter,shrub,slender,slightly,small,smooth,spherical,stalked,stellate,stellate-pubescent,stem,straight,style,surface,tapering,terete,time,tip,trichome,unarmed,unbranched,upper,variously,way,wide,winged,yellow-orange,young	.5,0.1-0.2,0.15-0.3,0.3-0.7,0.8-1.8,1.5-2,1/,1/4-1/3,1/6,2-2.3,2-3,2-5,2.4-2.8,3-4.5,5-25,6-10,7-8,abaxially,acute,alyx,apar,ape,apically,apparently,attenuate,becoming,broad-deltate,calyx,chartaceous,concolorous,cuspidat,deltate,difoliate,discolorous,drying,eaf,eed,elongating,entire,equal,eye,free,frui,fruiting,geminat,gra,herbaceous,infructescence,lateral,less,lobe,long,long-styled,margin,mature,naked,narrow-cuneate,nflorescence,obtuse,occasionally,older,one,open,orolla,oung,pair,pendulous,per,perfect,pericarp,portion,primary,ruit,scar,short-styled,simple,spaced,spreading,stalk,staminate,subsessile,tamen,terminal,tertiary,tube,unarme,unit,usually,vary,vein,venation,visible,woody,ympodial	1/2,apart,color,corolla,form,fruit,gray,growth,height,number,ovary,plant,ratio,reproduction,seed,shape,spacing,staman,texture,width
428	wfo-0001028971	success	225	131	105	120	26	0.467	-0.8,.1-0.2,0.1-0.4,0.2-0.5,0.25-0.6,0.25-1.25,0.3-0.6,0.4-0.9,0.4-1.5,0.8-2.5,1-2,1.5-2.2,10-15,2.5-3.5,3-14,4-9,5-10,6-16,6-8.5,abaxially,acute,acute-,adaxially,along,anther,apart,apex,appearance,base,branched,broadly,cm,coarsely,deltoid,densely,dentate,diameter,entire,erect,essentially,extra-axillary,farinaceous,filament,flower,form,fruit,glabrous,globose,hair,inflorescence,interlobal,lateral,leaf,least,length,lenticular,lobe,margin,midpoint,midrib,minutely,mixture,mm,narrowly,obtuse,often,orange,outline,ovate,pedicel,peduncle,perennial,petiole,pitted,prickle,principal,pubescent,rachi,ray,reniform-ovate,round-tipped,sericeous,sessile,short-stalked,simple,sinus,smaller,spreading-hirsute,spreadingly,stellae,stellate,stellate-pubescent,stigma,stipitate,style,surface,tan,thin-textured,tooth-like,trichome,truncate,vein,white,x,yellow	-1.4,0.1-0.5,05-2.5,1-5,1.5-4,1.75-2.5,1/5-1/2,15-30,2-5,2-foliate,2.2-3.5,2.5-4.5,2.5-5,20-35,3-5,3-6,4-5,5-15,5-8,6-9,7-16,adaxiall,also,appearing,armed,articulated,ascending,attenuate,axe,ba,bearing,becoming,blade,broad-based,calyx,campanulate,capitat,cauline,close,compressed,connivent,cylindrical,delicate,directed,distal,distall,eaf,eed,elongate,elongate-deltoid,felty,felty-pubescent,female-sterile,frequently,geminat,grading,growt,inserted,invested,lanceolate,largest,later,laterally,lignescent,like,linear-lanceolate,lon,long,longer,longest,lower,major,manifestly,maturit,minute,much,multiseriate,nflorescence,numerous,occasionally,one,orolla,other,ovate-apiculate,ovate-lanceolate,pair,per,persistent,pore,prickly,reduced,ripe,ruit,scattered,short,shorter,side,similar,sometimes,spaced,sparse,stalk,ste,stem,tal,tamen,tem,termination,time,tube,unbranched,underdeveloped,unit,usually,variable,variously,vary,well-developed,wide,ympodial	abaxial,adaxial,arrangement,capitate,color,colour,corolla,fely-pubescent,frequency,growth,height,history,life,na,number,ovary,plant,position,reproduction,seed,shape,spacing,staman,texture,tip,width
429	wfo-0001028975	success	163	115	80	83	35	0.491	.2,.5,1-3,1-5,1.2-1.5,1.5-2,3-3.5,3-6.5,6-6.5,7.5-15,8-9,acuminate,acute,along,anther,apart,apex,area,bark,base,broad,brown,calyx,cm,conically,corolla,cup-shaped,dark,densely,denser,elliptic,filament,fruit,glabrous,globose,golden,green,lateral,leaf,length,lobe,lobed,main,margin,minutely,mm,once-furcate,opposite,ovary,ovoid-reniform,pair,pedicel,petiole,pitted,pore,pubescent,raised,reflexed,rib,shaped,shiny,short,shrub,simple,small,somewhat,sparsely,stigma,straight,style,surface,tapering,tear-drop,tip,tree,trichome,tube,uniseriate,vein,white	0.1-1,0.5-1,1,1.5-1.8,2.2-6,3-10-flowered,5-ribbed,5.5-10,?,anthesi,appearing,beneath,berry,closely,conical,corky,decurrent,deflexed,dia,differing,difoliate,eaf,edicel,eed,entire,epidermi,equal,erect,exserted,extension,free,fruiting,geminat,hyaline,immature,large-celled,late,like,lon,long,lower,mainly,major,member,mere,middle,minor,narrowly,nearly,nflorescence,obscured,occasionally,older,one,papillo,poricidal,portion,prominent,pubescenc,reddi,remaining,ruit,scar,sinus,size,slender,slightly,spaced,stem,strongly,tall,triangular,tub,ud,unit,upper,varying,wide,widest,woody,x,ympodial,young	3-10,9,abaxial,adaxial,arrangement,bud,color,colour,density,diameter,flower,form,glabrousnes,growth,height,history,inflorescence,life,na,number,papillae,papillose,peduncle,plant,position,rachi,reddish,reproduction,seed,shape,spacing,staman,straightnes,texture,width
430	wfo-0001028980	success	168	93	67	101	26	0.399	.5,1.2-1.8,1.5-1.8,1.5-2,1.5-6,4-5,5-6,6,acuminate,acute,anther,apart,apex,black,capitate,cm,coarsely,corky,corolla,elliptic,expanded,filament,flattened-reniform,fleshy,furcate,glabrate,glabrous,glandular,globose,green,leaf,minutely,mm,opposite,ovary,ovate,paler,pedicel,peduncle,petiole,pitted,planar,pore,poricidal,pubescent,reflexed,scar,seed,shaped,sharply,shrub,simple,slightly,small,soon,stigma,style,surface,tall,tear-drop,thick,tip,tree,tube,white,x,yellowish	.1,.75,/3,0.5-1.5,1-1.2,1.2-3,2.5,2.5-5,20-25-flowered,3-4,3/4,5-8,6-8,7-12,along,anthesi,axil,bark,basal,base,beginning,beneath,berry,broadly,calyx,clearly,conical,cucullate,deflexed,deltoid,densely,dia,differentiated,differing,difoliate,dry,drying,eaf,edicel,eed,exserted,extending,f,free,frui,fruiting,geminat,impressed,incrassate,inflorescenc,lamina,lateral,lenticellat,like,lobe,lobed,lon,long,lower,m.,main,major,margin,material,member,middle,minor,nflorescence,occasionally,older,one,ovoid,pair,pale,papillose,pit,portion,prominent,reddish,ruit,scarious,shining,size,sparsely,speciman,stem,strongly,tapering,ti,trichome,type,ud,uniseriate,unit,usually,vein,way,widest,woody,ympodial,young	20-25,abaxial,adaxial,arrangement,color,colour,diameter,flower,form,fruit,growth,height,history,inflorescence,length,life,na,number,plant,position,rachi,reproduction,shape,spacing,texture,width
431	wfo-0001028982	success	213	136	112	101	24	0.526	.5,0-0.2,0-2.5,0.2-0.3,0.3-0.6,0.4-1.1,0.5-1,1-1.5,1-2,1-3,1.5-2,13-18,15-30,3-4.5,35-50,4-6,5-9,8-18,abaxially,absent,acute,adaxially,adult,angled,anther,apex,articulated,basal,base,branch,chartaceous,cm,contiguous,cuneate,decimetre,diameter,dm,eglandular,entire,exocarp,extra-axillary,filament,flower,fruit,glabrous,gland-tipped,globose,green,hair,hastate,inflorescence,interpetalar,juicy,juvenile,lanceolate,lateral,leaf,length,lilac,lobe,lobed,long,longer,margin,mesocarp,midpoint,mm,moderately,narrowly,nearly,oblique,obtuse,pale,part,pedicel,peduncle,per,perennial,petiole,placenta,prickle,pseudo-umbellate,rachi,ray,red,reniform,rhizomatous,rugose,scattered,shallowly,shape,short,shrub,simple,solitary,sparsely,stellate,stellate-pubescent,stigma,straight,style,succulent,surface,tan,throughout,time,tissue,truncate,unbranched,wide,x,yellow	%,.3,0-3,0.2-0.4,0.25-0.5,0.3-0.7,0.3-0.8,0.3-2,0.35-0.5,0.4-0.65,0.5-0.6,0.5-1.3,0.8-1.5,0.8-2.5,1,1-locular,1.5-2.5,1.5-3,1.5-4.5,1.6-2.3,14-24,2-6,2.5-4.5,4-,4-5,4-7,4.5-7.5,5-6,5-merou,6-8,8-16,9-16,absen,accrescent,acicular,across,alyx,apart,apparen,armed,attemuate,axe,ba,blade,branche,calyx,capitat,confined,connivent,cylindrical,deeply,directed,distall,distributed,eaf,eed,erect,finger,fruiting,geminat,half,hig,homostylous,incomplete,lamina,less,linear-hastate,loosely,lower,mature,mid-point,midrib,midvein,minute,nflorescence,orolla,overall,pair,perfect,pore,porrect,present,ruit,septum,sessile,spaced,sparse,stellae,tamen,tem,thick,tissu,transparent,triangular,tube,unarme,unarmed,unit,upper,vary,ympodial	abaxial,adaxial,apparent,arrangement,capitate,color,colour,corolla,form,growth,height,history,life,number,ovary,plant,position,reproduction,seed,spacing,staman,texture,thicknes,width
432	wfo-0001028984	success	180	142	115	65	27	0.639	-14,-3,-6,-65,0.5-,1,1-,1-2.5,1-6,1-9,1.2-4,1.5,10-20,15-35,2,2-,2-2.5,2-3,2-4,20-40,3-10,3-26,3-6,4-30,4-5,4-6,5,5-10,7-14,abaxially,abruptly,acuminate,adaxially,age,almost,apart,apex,apical,articulated,base,broad,broadly,calyx,campanulate,chartaceous,cm,color,concave,connective,cordate,densely,diameter,dilated,distally,eglandular,ellipsoid-fusiform,entire,especially,flower,forked,fruit,glabrous,gland,glandular-puberulent,globose,greenish,lanceolate,leaving,lobe,long,margin,minutely,mm,moderately,narrowed,obconical,obtuse,often,ovate,ovoid,pale,papillose,pedicel,pedicellar,peduncle,petiole,pilose,puberulent,puberulent-pubescent,pubescent-pilose,purple,rachi,radiu,rarely,remnant,ripe,shrub,simple,small,spaced,sparsely,stigma,strongly,style,subcoriaceous,tomentose,toward,tree,turning,two,unbranched,unknown,violet,x,yellow	-2,-2.5,-9,1-1.7,1-2,12-20,2-16,3-28,4-6.3,4-7,4-foliat,8-15,absen,acute,adpressed,aggregate,also,ape,axe,basal,blade,cell,directed,eaf,eed,equalling,exceeding,fleshy,hair,laterally,lon,longer,lower,near,nflorescence,nther,orolla,perfect,pilo,pore,possibly,presence,present,pubescent-pilo,ruit,shorter,slightly,stamen,stone,swelling,tal,tem,thecae,time,tip,tomento,triangular,truncate,tube,ud,unit,unknow,vary,wide,ympodial	abaxial,adaxial,anther,arrangement,bud,colour,corolla,form,growth,height,history,inflorescence,leaf,length,life,na,number,ovary,plant,reproduction,seed,shape,spacing,surface,texture,theca,width
433	wfo-0001028997	success	136	97	71	65	26	0.522	0.5-0.7,0.5-1.5,0.8-1.1,1-1.2,1-1.5,20-50-flowered,3-4,4-10,5-6,6-10,abaxially,acute,adaxially,anther,apex,appearing,area,attenuate,bark,base,branched,broadened,cm,corolla,difoliate,dry,drying,elliptic-obovate,filiform,flattened-reniform,glabrous,globose,golden,green,height,leaf,lobed,many,matte,merely,middle,minutely,mm,mustard,nearly,opposite,ovary,pale,papillose,pedicel,pericarp,petiole,pitted,scar,shaped,shiny,shrub,stigma,style,surface,tan,tear-drop,terminal,thick,time,trifoliate,unknown,white,widest,x,yellow	.5,0.5-1,2-2.5,2-3.5,3.3.5,4-4.5,4-angled,6-7,anthesi,apar,ba,berry,calyx,conical,coriaceous,cucullate,deflexed,dia,eaf,edicel,eed,elliptic,erect,exserted,filament,fragrant,free,fruiting,geminat,glabrou,greenish-brow,incrassate,later,lateral,lobe,lon,long,lower,main,margin,nflorescence,older,pair,partially,pore,poricidal,portion,quadrate,revolute,ruit,spaced,specimen,stem,strongly,styl,thickened,tip,tub,tube,ud,unevenly,vein,woody,ympodia,young	abaxial,adaxial,apart,arrangement,color,colour,diameter,flower,form,fruit,greenish-brown,growth,history,inflorescence,length,life,na,number,plant,position,reproduction,seed,shape,spacing,sympodia,texture
434	wfo-0001029003	success	207	137	107	100	30	0.517	0-6,0.3-0.5,0.5,1-10,1-2,1.2-2.5,11-32,13-36,2.5-10,3,3-5,4-8,5,5-10.5,5-12.5,7-9,abaxially,acuminate,adaxially,anther,apart,apex,articulated,axillary,blue-violet,brownish,bud,cell,chartaceous,ciliate,cm,condition,conical,corolla,covering,diameter,drying,elliptic,end,filament,flower,forked,fourth,fresh,fruit,glabrous,green,greenish,hair,hair-like,herb,highly,honeycomb-shaped,interjected,lanceolate,lateral,leaf,leaflet,light,like,long,margin,medium,membranous,middle,minute,mm,obtuse,odd-pinnate,one,orbicular,ovate,ovoid,pair,pale,pedicel,peduncle,pentagonal,petiole,pigmentation,placed,plant,proximal,pubescent,purple,ripe,rotate,rounded,seed,size,sometimes,sparsely,stem,stigma,style,subcapitate,subtending,terminal,testal,thick,tuber,typically,violet,wall,wet,whitish,yellow	0.4-3,1,1-2.5,1-3,1-5,1.2-1.9,1.5-2.3,12.2-30,2-6,2.5-7.5,3-20,3.5-7.5,5-merou,7-15.5,9-14,absent,acumen,ag,alyx,apparently,attenuate,axe,base,berry,blade,capitat,connivent,decreasing,digestion,distal,dorsally,eaf,edge,eed,elongated,enzyme,equal,erec,especially,exceeding,flat,folded,geminat,generally,glabrou,gradually,green-white,hal,half,homostylous,larger,lengthening,living,lobe,lower,make,mottled,mucilaginous,nflorescence,orolla,perfect,petiolule,plurifoliate,pore,poricidal,prostrate,rarely,ray,removed,ruit,secondary,sessile,seudostipule,slightly,slit,spaced,specimen,stamen,ste,stolo,straight,subequal,subglabrous,symmetrical,tall,tamen,tem,throughout,tip,toward,tri-,tube,unit,usually,vary,white,wide,wing,x,ympodial	abaxial,adaxial,arrangement,capitate,color,colour,form,growth,height,history,inflorescence,length,life,mucilaginousnes,na,number,ovary,perennial,placement,position,pseudostipule,rachi,reproduction,shape,spacing,staman,stolon,surface,texture,width
435	wfo-0001029006	success	217	161	130	87	31	0.599	-+,.5,0.2,0.4-2.5,0.5,0.5-2,0.5-4,1,1-1.5,1-5,1.2-1.5,1.8-2.2,10,2-3,2-6,3.5-4,4-6,5,50,7-8,<,>,abaxially,acuminate,acute,adaxial,along,anther,anthesi,apex,area,asymmetrical,axil,base,berry,bilobed,blackish,branched,c.,cell,chartaceous,cm,corolla,dense,diameter,elliptic,entire,extending,filament,filiform,flattened,flower,fruiting,glabrous,globose,green,groove,growth,inflorescence,irregularly,keeled,lamina,later,lateral,lobe,lobed,long,many,margin,membranous,midrib,minutely,mm,narrowly,nearly,nodding,oblique,occasionally,often,pair,pale,papillate,pedicel,peduncle,pentagonal,petiole,pitted,primary,puberulent,pubescent,purple,purplish,reaching,reddish,reniform,ripe,rotate-stellate,shiny,simple,somewhat,spaced,sparsely,spreading,stem,stigma,strongly,style,surface,tan,terminal,testal,thin,time,tiny,tip,trichome,truncate,tuft,uniseriate,usually,variously,vein,vine,violet,way,white,woody,x,young,zig-zag	1-4,1/3,10-20,2.5,5-6,5-merou,7-9,adaxiall,ag,age,alyx,apar,ark,articulated,axi,basal,beyond,black,bright,broadest,calyx,clavat,conical,connivent,deeply,deltate,depending,drying,eaf,eed,ellipsoid,elongate,exserted,free,growing,ilament,inflated,intramarginal,irregular,leaving,lengthening,loosely,lower,markedly,minute,new,nflorescence,obvious,older,one,orolla,part,peg,pendan,per,perfect,pericarp,pinnatifid,planar,plurifoliat,pore,poricidal,portion,puberulen,ruit,sagittate,scar,size,sleeve,slit,small,smaller,sometimes,strong,sunligh,tem,tube,twinin,twining,ud,unit,upper,variable,vary,widest,within,ympodial	5-merous,abaxial,adaxially,apart,arrangement,bark,clavate,color,colour,feature,form,fruit,height,history,leaf,length,life,na,number,ovary,pendant,plant,position,rachi,reproduction,seed,shape,spacing,staman,texture,width
436	wfo-0001029021	success	161	127	97	64	30	0.602	0.5-1,0.8-1,1-1.5,1-2,1.1-1.3,1.5-3,1.8-2,2,3/4,5.5-6,8-10,abaxial,abaxially,absent,acute,adaxial,age,anther,anthesi,apex,apical,axi,bark,basal,base,becoming,bi-lobed,black,branching,broadly,calyx,caudate,cm,corolla,darker,decurrent,dendritic,densely,diameter,elliptic,exserted,filament,flattened,flower,fruit,glabrate,glabrous,globose,grey-brown,growth,inserted,leaf,lenticular,lobed,long,loose,loosely,margin,minutely,mm,nodding,ovary,ovate,pedicel,pericarp,petiole,pitted,pore,poricidal,prominently,pubescent,purple,raised,reddish-brown,revolute,scar,shiny,shrub,sleeve,slit-like,sparsely,stem,stigma,strongly,style,surface,tapering,terminal,thin,tiny,tip,trichome,tube,unit,violet,way,winged	0.8-1.2,0.8-2.1,1-3.4,1-4,1.5-2,2-2.5,3,3-6,3.5,adaxially,along,appearing,ba,berry,blade,conical,coriaceous,deciduous,deflexed,denser,eaf,edicel,eed,ew,fleshy,free,fruiting,im.,impressed,lamina,later,lateral,lax,lobe,long-triangular,lower,m.,monochasia,nflorescence,older,outline,overtopping,pair,papillo,per,planar,plurifoliate,portion,ruit,scattered,secondary,shoot,simple,stamen,ste,time,tub,ud,vein,wide,woody,x,ympodial,young	arrangement,bud,color,colour,exsertion,form,height,history,inflorescence,insertion,length,life,monochasial,na,new,number,peduncle,perennial,plant,position,presence,rachi,reproduction,seed,shape,spacing,staman,sympodial,texture,width
437	wfo-0001029031	success	213	139	115	98	24	0.54	-11.4,-12.3,-8,.5-1.2,0-5,0.1-0.5,0.5,0.5-1.5,0.5-4,0.6-1.2,1-1.5,1-5,1-9.4,10,13.5,2-3,2.5-5.5,20-150,3-10,5-17,6-12,abaxially,acuminate,acute,adaxially,angle,anther,apart,apex,articulated,base,becoming,black,bluish,branched,brown,capitate,chartaceous,cm,corolla,cuneate,densely,diameter,elliptic,elliptic-ovate,entire,erect,filament,flattened,flower,forked,fruit,glabrescent,glabrous,globose,green,hair,held,immature,impressed,lateral,leaf,leaf-opposed,length,light,like,major,margin,midpoint,mm,obtuse,occasionally,orange,outline,pedicel,peduncle,peltate,peltate-stellate,petiole,possibly,prominent,pseudoterminal,pubescent,rachi,rarely,ray,reniform,ripening,rounded,rugulose,sessile,short-stalked,shrub,silvery,simple,small,sparsely,stellate,stellate-pubescent,stem,stigma,strongly,style,suborbicular,surface,tree,trichome,unbranched,usually,vein,white,whitish,x,yellow,yellowish	-3.6,.1-0.3,0.7-1.1,1-2,1-2.5,1-2.6,1-3,1.3-3.3,1.5-2.8,1.5-3.5,1.8-2.7,1.8-4,1/3,2-10.7,2-3.3,2-5,2.5-5.6,4-5-,4-7.5,6-21,absent,accrescent,adaxiall,ag,apexacute,apparently,around,axe,ba,berry,bilobe,blade,calyx,center,connivent,covering,curved,cylindrical,deltate,denser,directed,distally,eaf,edge,eed,eglandula,eglandular,equal,farinose,fleshy,frui,fruiting,fused,geminate,inserted,lanceolate,large,least,lobe,long,longitudinal,lower,many-foliate,midvein,nearly,nflorescence,oblong,opening,orolla,paired,perfect,pore,porrect-stellate,pubescen,pubescence,ruit,short,side,slightly,slit,smaller,sometimes,somewhat,spaced,ste,straight,subtending,tall,tamen,tem,time,tip,tube,unarme,unit,vary,wide,ympodial	abaxial,adaxial,arrangement,bilobed,color,colour,form,growth,height,history,inflorescence,life,na,number,ovary,plant,position,reproduction,seed,shape,spacing,staman,texture,width
438	wfo-0001029047	success	168	108	78	90	30	0.464	.25,.5,0.5-2,0.7-1,0.7-3,1-4,1.25,3-5,4-5,5-9,6-7,acuminate,anther,apex,arching,bark,base,beginning,beneath,branch,broadly,brown,bud,campanulate,cm,corolla,elliptic,evenly,filament,filiform,flattened,flower,glabrous,globose,green,herbarium,leaf,lenticellate,lobed,minutely,mm,mustard,nearly,opposite,ovary,ovate,ovoid-reniform,papillose,part,pedicel,petiole,pitted,pore,pubescent,reddish-brown,scar,shape,shaped,shining,shrub,simple,slender,smooth,soft,spaced,sparsely,specimen,stigma,style,surface,tapering,tear-drop,trichome,tube,uniseriate,white,x,yellow	'',0-2,0.05-0.5,0.1-0.5,0.1-0.75,0.3-1.9,0.5-1,1,1-1.2,10-11,2.1-2.6,2.5,3.6-8.5,5-20-flowered,8365,9.5-19.6,``,across,acute,amd,anisophyllou,anthesi,aspec,ba,back,bearing,berry,calyx,deflexed,deltoid,dia,differing,difoliate,distinctly,eaf,edicel,eed,free,fruiting,geminate,giving,glabrou,herb,impressed,inflorescenc,kruckoff,lateral,like,lobe,lon,long,lower,main,major,margin,markedly,middle,midrib,minor,much-branched,nflorescence,occasionally,older,orbicular,pale,pically,poricidal,portion,principal,prominent,reflexed,rounded,ruit,shorter,smaller,somewhat,stem,strongly,styl,tall,thread-like,time,tip,ud,unit,vein,widest,woody,ympodial,young	5-20,abaxial,adaxial,arrangement,aspect,color,colour,diameter,form,fruit,growth,height,history,inflorescence,length,life,na,number,peduncle,perennial,plant,position,rachi,reproduction,seed,size,spacing,staman,texture,width
439	wfo-0001029048	success	162	100	81	81	19	0.5	.01,.2,.5,0.5-1.7,1,1-2,1-8,1.5-2,11,14,25,26,3-4,3-7,4-6,5-8,8-10,9-15,acuminate,anther,anthesi,apex,base,bicellular,blade,bright,broadly,calyx,cm,conical,corolla,elliptic,filiform,flower,glabrous,globose,golden,green,greenish-white,greenish-yellow,hanging,hispidulous,lateral,leaf,lobed,long,main,matte,minutely,mm,obovoid,obtuse,ovary,ovoid-reniform,pair,pale,papillose,pedicel,petiole,pitted,puberulent,scar,shaped,slender,slightly,small-capitate,stem,stigma,style,surface,tan,tear-drop,thread-like,trichome,tube,uni-,unifoliate,vein,winged,x,zig-zag	/3,0.5,0.5-1,0.8-1,2,3.5-4,angle,another,apar,apparent,arching,attenuate,basal,bearing,becoming,beneath,berry,branch,decurrent,dia,eaf,edicel,eed,elongated,except,expanded,f,filament,free,fruiting,geminate,glabrate,greatly,greenish-yello,incrassate,less,like,live,lobe,lower,margin,middle,midrib,minute,much,nflorescence,node,non-reproductive,older,one,opposite,papillo,parallel,planar,pore,poricidal,portion,reflexed,right,ripe,rounded,ruit,sharply,shrub,somewhat,spaced,specimen,straight,tall,tapering,time,tip,translucent,ud,unevenly,unit,way,widely,widest,ympodial,young	abaxial,apart,arrangement,bud,color,diameter,fruit,height,inflorescence,length,na,number,plant,seed,shape,spacing,texture,type,width
440	wfo-0001029053	success	275	185	136	139	49	0.495	0.2,1.5,1/3,2.5,21,3.5,4.9,abaxially,accrescent,across,acuminate,acute,adaxially,adnate,aequilateral,along,anther,anthesi,apart,apex,apiculate,appressed,around,attachment,bark,base,becoming,bent,blade,broad,brochidodromous,bud,calyx,caudate,cm,congested,corolla,densely,diameter,directed,distally,distinct,dry,edge,emerging,entire,extending,extra-axillary,filament,flattened-oval,flower,fruit,glabrous,glandular,glandular-pubescent,globose,hair,heterostylous,intact,internode,interpetalar,intersepalar,lacking,lanceolate,lateral,layer,length,lobe,long,main,margin,mature,midvein,minute,mm,moderately,nearly,notched,oblique,oblong,opaque,orange,ovate,overlapping,pedicel,peduncle,perforated,petiole,point,pore,porrect,probably,pubescence,pubescent,raised,ray,red,remaining,rigid,rounded,sessile,short,short-stipitate,shrub,simple,slightly,sloughing,smooth,sometimes,spread,stellae,stellate,stellate-pubescent,stem,stigma,stipe,straight,style,subopposite,surface,suture,tip,tissue,transparent,truncate,tube,upper,vein,weakly,well-developed,white,wide,yellow,yellow-tan,young,±90°	.04,.3,.7,.9,0.1,0.2–0.6,0.3–0.4,0.3–0.7,0.4–0.8,0.5–0.6,0.5–1.1,0.6–1.3,0.7–1.0,0.7–1.1,0.7–1.2,0.7–1.3,0.7–1.7,0.7–3.4,0.8–1.0,0.8–1.2,1.0–1.6,1.1–1.3,1.3–2.0,1.4–2.0,1.5–2.5,1.5–2.7,1.6–9.2,1.7–1.8,1/2–2/3,1/3–1/2,2.0–2.3,2.0–2.8,2.1–2.4,2.1–3.8,2.4–2.8,2.4–5.1,3.5–7.2,4.5–6.2,5-merou,5.4–7.1,5–8,6.6,6.8–15.2,6–12,7.1–9.7,7–8,8,8.0–14.5,8.5–15.8,90°,ag,alyx,apical,apparently,appearing,articulate,attenuate,axe,ba,basal,beneath,berry,borne,branch,capitat,channeled,clinate,coat,criss-cros,deciduous,deltoid,dentate,development,difoliate,distal,eaf,eed,either,endocarp,erect,exocarp,fertile,filiform,free,geminat,glossy,gradually,increasing,individually,juic,less,lon,longer,lower,many,markedly,midpoint,midrib,much,nflorescence,ove,pattern,per,portion,potentially,revealing,row,ruit,seen,semisucculent,shorter,side,sinus,smoot,soon,spaced,sparsely,splitting,spreading,stamen,tamen,tem,thin,time,twice-branched,two,ud,unarmed,unbranched,unit,various,vary,well,yellow-ferruginous,ympodial,±equal,±glabrous,×,–10	0.2-0.6,0.5-1.1,0.7-1.2,0.7-1.3,0.7-1.7,1.0-1.6,1.1-1.3,1.4-2.0,1.5-2.7,2.0-2.8,2.4-2.8,2.4-5.1,5-merous,5.4-7.1,6-12,6.8-15.2,8.0-14.5,8.5-15.8,abaxial,adaxial,adhesion,age,arrangement,capitate,color,colour,direction,feature,form,growth,height,history,inflorescence,leaf,life,na,number,ovary,perennial,perforation,plant,position,reproduction,seed,shape,spacing,staman,texture,transparency
441	wfo-0001029055	success	169	125	91	78	34	0.538	0.4-1.5,1-4,1-5,1.8-3.5,14-50,3-10,4-6,5-24,5.5-9,8-9,acuminate,acute,apex,articulate,attenuate,base,branched,cell,cm,cordate,corolla,covered,covering,cuneate,cyme,dark,densely,diameter,dichasial,dichasially,digestion,diminishing,distal,ebracteate,elliptcal,elliptical,enzyme,filament,flower,gland,green,green-white,hair-like,half,herbaceous,honeycomb,lateral,leaf,leaflet,longitudional,mm,monochasial,mucilaginous,oblique,odd-pinnate,outline,ovate,ovoid,pattern,pedicel,peduncle,pentagonal,perennial,petiole,pilose,plant,proximal,pubescent,purple,reveal,rotate,seed,short-stalked,size,sometimes,stigma,stripe,style,terminal,testal,thick,throughout,toward,triangular,tuber-bearing,type,typically,unit,wall,yellow,¼	1-2.6,1.6-3.5,1.7-2.2,2-1.,2-3,2-4,2.2-3,2.5-8,3,3-6,3-6-foliat,4-10,4-7,6-14,9-22,abaxially,acumen,adaxially,apical,apically,calyx,connate,decurrent,dehiscent,dorsally,eaf,edge,eed,emoval,exceeding,first,flat,folded,forked,generally,globo,hair,interjected,introrse,living,lobe,lon,long,long-attenuate,longer,lower,lunat,make,maturing,near,nflorescence,nther,often,orolla,pair,perfect,plan,poricidally,rarely,ruit,second,sessile,seudostipule,short,short-petiolate,slit,specimen,spreading,stamen,straight,tal,tem,time,vary,whit,wide,widest,ympodial	3-6-foliate,abaxial,adaxial,anther,arrangement,color,colour,form,fruit,globose,growth,height,history,inflorescence,length,life,lunate,na,number,ovary,position,pseudostipule,rachi,reproduction,shape,spacing,staman,surface,sympodial,texture,wet,white,width,ye
442	wfo-0001029056	invalid_json_followup	140	97	44	96	53	0.314	.2,.5,1/3-1/2,3-5-rayed,3-6,5-9,7-10,annual,anther,blade,broadly,calyx,capitate,cm,coarsely,densely,dentate,dm,externally,glabrous,glandular,green,hair,herb,irregularly,length,long,mm,often,ovate,petiole,prickle,purplish,scattered,sessile,simple,stellate,stellate-pubescent,stem,subulate,surface,terete,uniseriate,white	-5,0,0.3-0.5,0.7-1.0,3-5-lobed,4,6-10,6-8-flowere,across,acute,along,also,alyx,ample,anthesi,attenuate,basally,base,black,branched,campanulate,cauline,central,consisting,developing,dia,difoliate,divided,eaf,eed,elongated,erect,externall,flanking,geminat,gland,intermixed,internod,invested,know,known,lacking,large,linear-lanceolate,lobe,lon,lower,major,marking,midpoint,much,nflorescence,numerous,obtuse,occasional,one,orolla,pinnately,present,prickly,ray,reduced,ruit,separated,sharply,short-stipitate,shorte,side,slende,slender,somewhat,sparse,spreading,starlike,stellae,strait,strongly,swollen,tall,tamen,taprooted,terminally,tightly,tigma,tip,tub,tube,tyle,unit,upturned,vary,vein,vestiture,villous,yellow,ympodial	'',3-5,6-8,[,``,abaxial,adaxial,apex,arrangement,bark,bud,characteristic,color,colour,corolla,diameter,filament,flower,form,fruit,fruiting,growth,height,history,inflorescence,internodal,leaf,life,margin,na,new,number,ovary,pedicel,peduncle,pinnate,plant,position,rachi,reproduction,scar,seed,shape,spacing,staman,stigma,style,texture,trichome,value,width,{,}
443	wfo-0001029059	invalid_json_followup	199	131	94	105	37	0.472	.5,0.1-1,0.5-1,1-3,1-4,1-6,1.2-3,1.3-1.7,1.5-2.8,3.5-6,7-9,acute,along,anther,apex,apiculae,apiculate,arising,bark,base,berry,branched,bud,calyx,clavate,closely,cm,corolla,deep,dense,densely,dia,dirty,elliptic,extremely,filament,flattened-reniform,glabrous,globose,hispidulous,inflorescence,leaf,lobed,long,major,margin,member,minute,minutely,mm,nearly,occasionally,often,opposite,orange,orangish-yellow,ovary,pair,pale,papillose,pedicel,petiole,pitted,pointed,pubescence,pubescent,purplish,ripe,scar,shape,shrub,simple,slender,small,spaced,sparse,stigma,style,surface,tapering,tinge,tip,tree,trichome,tube,underside,uniseriate,variable,vein,waxy,white,yellowish-green,yellowish-tan,young	0.1-0.5,0.2,0.2-0.5,0.5,1-1.2,1-1.5,1.5-2,10-19,2.5,3-3.5,3-6.5,3.5-8,4-10.5,5,5-15-flowered,6-10,anisophyllou,anthesi,apar,ape,beneath,bout,coiba,connivent,cordate,covered,cuneate,de,deflexed,deltoid,differing,difoliate,eaf,edicel,eed,ellipsoid,expanded,exserted,extending,foetid,free,fruiting,geminate,glabrate,greatly,impressed,incrassate,interpetalar,isla,lamina,lateral,lobe,lon,longest,lower,main,membranous,middle,minor,narrowly,nflorescence,oblique,older,one,orbiculate,paler,panama,papillo,partially,planar,population,pore,poricidal,portion,prominent,reddish-gre,rest,rounded,ruit,shallowly,shaped,sinus,size,somewhat,soon,specimen,stem,straight,tall,tear-drop,terminal,thickened,ti,tightly,triangular,ud,unicellular,unit,usually,wide,widest,woody,x,yellowish,ympodial	'',5-15,[,``,abaxial,adaxial,apart,arrangement,characteristic,color,colour,diameter,flower,form,fruit,growth,height,history,length,life,na,number,peduncle,perennial,plant,position,rachi,reddish-grey,reproduction,seed,spacing,staman,texture,value,width,{,}
444	wfo-0001029065	success	202	110	91	111	19	0.45	0.5,0.5-1.5,0.5-1mm,0.5-4,1,1-2.5,1-5,1-6,1/3,2-3,2-4,2-5,3-6,3-7,4-8,5-15,8,abaxial,acute,adaxial,andromonoecious,anther,apex,armed,base,brown,chartaceous,cm,contiguous,cut,cylindrical,dark,densely,diameter,filament,flower,fruit,glabrous,globose,green,green-brown,leaf,less,light,lobe,lobed,margin,midpoint,midvein,mm,moderately,multicellular,multiseriate,nearly,netlike,obtuse,orange,ovary,ovate,pedicel,peduncle,per,petiole,plant,prickle,pubescent,rachi,ray,recurved,red,reniform,sessile,side,sinus,spaced,sparsely,stalk,stellate,stigma,style,surface,unbranched,unicellular,unlobed,vine,way,white,woody,x,yellow,¼	0.2-0.4,0.5-1,1-2,1-3,1.,1.5-2,1.5-2.5,1.5-3,10-20,2,2-15,2-2.5,2-ranke,30-60,4-7,5,5-10,5-7,7-10,8-12,8-20,abaxially,absent,accrescent,adaxiall,adaxially,alyx,apar,apical,asymmetrical,attenuate,axe,berry,beyond,blade,calyx,charteacous,connivent,cordate,difoliate,directed,discolorous,eaf,eed,either,em,exserted,extra-axillary,flattened,frui,fruiting,functionally,geminate,generally,glabrou,glandular,gree,hair,hermaphroditic,heteromorphic,immature,introsel,leathery,like,long,long-styeld,lower,m.,major,male,many,mature,merou,midrib,narrowly,nflorescence,often,older,orolla,pair,pit,pore,porrect-stellate,raised,ridge,roselike,ruit,separated,short-styled,simple,slightly,small,stamen,staminate,stem,straight,strongly,tamen,tapering,triangular,tube,unarmed,unequa,uniseriate,unit,usually,vary,vein,wide,ympodial,young	0-2,10,apart,armament,color,colour,corolla,form,growth,height,inflorescence,length,number,reproduction,seed,shape,spacing,staman,texture
445	wfo-0001029072	success	235	104	81	154	23	0.345	0.1-0.4,0.2-0.4,0.4-0.9,0.5-2,0.8-1.5,1-1.2,1-1.5,1-25,1.5-2.6,2-7,2-8,2.2-2.5,2.2-3.2,2.5-3.5,3-8,4.2-6.5,5-10,5-7,abaxial,acute,adaxial,andromonoecious,anther,apex,bark,base,bright,chartaceous,cm,cordate,cream,cuneate,dark,densely,diameter,dirty,dull,erect,filament,flattened-reniform,flower,fruit,glabrous,green,green-brown,herb,lateral,leaf,length,lobed,long-styled,margin,marking,mature,mauve,mm,orange-brown,ovate,pale,pedicel,peduncle,pendent,per,petiole,plant,porrect,rounded,short-styled,shrub,sometimes,spherical,stellate,stellate-pubescent,style,surface,terminal,trichome,white,whitish,yellow,young	-1/2,-15,-2.5,.5,/6,0,0-2,0-20,0-4,0-8,0.2-0.3,0.3,0.5-3,0.7,0.8,00-200,1,1-3,1.5-2.5,1.5-3.2,1/3,1/4-1/2,1/4-1/3,12-19,2-10,2-5,2.5-3.8,2.5-4.5,20-50,3-10,3-20,3-5,3-50,3.5-6,3/,4-,4-10,4.5-9,5-50,5-9,5-merous,7-10,7-15,8-20,8-27,abaxially,adaxially,alyx,ame,angled,apar,apart,apically,apparently,articulated,berry,blade,branched,broad-deltate,broadly,c.,calyx,clearly,conical,connivent,curved,deltate,discolorous,distal,distance,drying,eaf,eed,elongated,elongating,equal,extending,flattened,free,fruiting,gently,gra,hermaphrodite,heterostylous,infructescence,least,lobe,long,longer,longitudinal,lower,lowermost,maturity,midpoint,midvein,moderately,multangulate,narrow-deltate,nflorescence,obtu,older,one,open,orolla,oung,pair,pendulous,pericarp,plurifoliat,poricidal,portion,prickl,prickle,prickly,primary,raised,ray,reflexed,ridge,ruit,scar,sessile,side,simple,smooth,spaced,sparsely,spreading,stalk,stalked,staminat,stem,stout,straight,strongly,tamen,tapering,tertiary,time,tip,tube,unarmed,unit,upper,variously,vary,vein,venation,visible,way,weakly,wide,woody,ympodial	/,100-200,arrangement,color,corolla,form,gray,growth,height,inflorescence,na,number,ovary,position,rachi,reproduction,seed,shape,spacing,staman,stigma,texture,width
446	wfo-0001029073	success	211	123	96	115	27	0.455	.5,0.3-1,0.5-1,0.6-2,1-1.5,1-3,10-16,2,2-3,2-4,4-5,5-merous,7-10,8-14,acuminate,acute,adaxially,anther,apart,apex,bark,beneath,berry,brown,calyx,chartaceous,cm,corolla,curved,dark,darker,dense,densely,diameter,drying,elliptic,equal,exserted,flattened,flower,glabrous,globose,growth,hooked,inflorescence,internodal,interpetalar,lanceolate,leaf,length,lobed,long-styled,maturity,midpoint,minutely,mixture,mm,narrowly,orange,pale,paler,papillose,pedicel,peduncle,perfect,petiole,porrect,pubescent,purple,ray,reniform,reticulate,sessile,shiny,short-stalked,shrub,simple,stellate,stem,stigma,straight,strongly,style,surface,tan,tapering,thin,tip,tissue,trichome,unequally,unisexual,whitish,x,yellow,yellowish	.7,0.5,0.6-0.7,1-1.2,1-2.5,1.1-1.5,1.2-1.6,1.5-2,10-15,2/3,3.5-9,4-6,5-6,5-8,6-9,abaxially,along,another,anthesi,armed,articulated,away,awn-like,ba,basal,base,broad-based,cell,conical,cream,difoliate,dimorphic,discolorous,eaf,eed,enlarged,entire,erect,except,filament,four,free,frui,fruiting,geminat,golden,gre,lamina,lengthening,like,linear,lobe,long,lower,margin,midvein,multangulate,new,nflorescence,nodding,oblique,occasionally,older,one,opposite,pair,per,pericarp,planar,plurifoliate,pore,poricidal,portion,prickle,prickly,primary,pubescence,rectangular,ruit,scar,shallowly,short,shorter,sinuate,slightly,slit,sometimes,somewhat,spaced,sparsely,splitting,styled,testal,three,ti,triangular,truncate,tube,two,ud,unarmed,underside,unequal,unit,upper,upward,vein,visible,wall,way,wide,woody,ympodial,zygomorphic,½	0.7,abaxial,adaxial,arrangement,bud,color,colour,exsertion,form,fruit,grey,height,history,life,na,number,ovary,perennial,plant,position,rachi,reproduction,seed,shape,short-styled,spacing,texture
447	wfo-0001029074	invalid_json_followup	174	141	106	68	35	0.609	.1,0.2-1,0.3-0.8,0.5-1,0.5-1.2,0.7-0.8,1-1.5,1-2,1.4-1.8,1.5-2,11,2-4,3-6,3.5-5,5-7,abaxially,acute,adaxially,anther,apart,apex,apparently,bark,base,berry,black,broadly,calyx,capitate,cm,conical,corolla,cuneate,densely,diameter,ellipsoid,entire,exerted,filament,flattened,flower,glabrous,globose,green,grey,growth,herb,immature,internodal,leaf,less,like,lobe,lobed,margin,minutely,mixture,mm,new,opposite,ovary,ovate,pair,pale,pedicel,peduncle,petiole,pitted,poricidal,primary,prominent,pubescent,pulp,purplish,reniform,ripening,rounded,sagittate,sessile,simple,sparsely,stalked,stellate,stellate-pubescent,stem,stigma,strongly,style,subshrub,surface,thin,tip,triangular,trichome,truncate,tube,underside,uniformly,vein,watery,way,white,x,yellow,yellowish,¾	.5,0,0.3-0.4,0.7-0.95,1,1-,1-1.2,1.5-4,2-2.3,2-5,2-7,3-,5-6,absent,age,almost,along,anthesi,appearing,articulation,basa,deflexed,denser,eaf,eed,expanding,free,frui,fruiting,glabrescen,lacking,lengthening,lignescent,longest,lower,markedly,midpoint,midvein,nflorescence,obscuring,often,older,papillat,per,perfect,pericarp,petal,planar,plurifoliat,pore,portion,ray,reflexed,ruit,scar,scattered,slit,small,somewhat,stalk,swollen,tub,ud,uniseriate,unit,usually,woody,ympodial	'',[,``,abaxial,adaxial,arrangement,bud,characteristic,color,colour,form,fruit,glabrescent,height,history,inflorescence,length,life,na,number,papillate,plant,position,prominence,rachi,reproduction,seed,shape,spacing,staman,texture,value,width,{,}
448	wfo-0001029075	success	217	125	98	119	27	0.452	0-3,0.8-1.2,0.8-1.5,1-10,1-2,10-20,2-5,2.5-3,2.7-4.2,30-60,4-10,4-7,4.5-6.5,5-10,6-12,8-9,abaxially,adaxially,anther,apex,articulated,attenuate-acuminate,axillary,berry,brownish,bud,canescent,cell,cm,condition,corolla,covering,dark,densely,diameter,dot,drying,elliptic-lanceolate,filament,flecked,flower,forked,fresh,fruit,glabrescent,glabrous,glandular-pilose,glandular-puberulent,gray-green,green,greenish,hair,hair-like,herb,interjected,lanceolate,lateral,leaf,leaflet,like,minutely,mm,narrowly,odd-pinnate,orbicular,ovate,ovoid,pedicel,peduncle,pentagonal,petiole,petiolule,plant,pointed,puberulent,pubescent,rachi,seed,short,slightly,small,stem,stigma,style,subobtuse,substellate,subtending,terminal,testal,thick,tuber,wall,white,whitish,whitish-gray,yellow,yellow-green,yellowish-white	.3,.5,0-8,0.5-0.8,1-2.5,1-3,2-4,4-14,4-5,5-8,5-8.5,5-merou,7-17,7-9,abruptly,acumen,ag,along,alyx,apart,apparently,atypically,axe,base,blade,broadly,brown,ciliate,clavifor,connivent,cuneate,decreasing,decurrent,digestion,distal,dorsally,eaf,edge,eed,end,enzyme,erect,erect-ascendin,especially,etota,exceeding,flat,folded,geminat,generally,glabrou,gradually,greatly,green-white,half,homostylous,honeycomb-shaped,larger,lengthening,light,living,lobe,long,long-spatulate,lower,make,margin,middl,midrib,mucilaginous,narrowed,nflorescence,orne,orolla,pair,perfect,petal,petiolulate,plurifoliate,pore,poricidal,purple,removed,rounded,ruit,sec,sessile,seudostipule,singly,size,slit,sometimes,spaced,specimen,stamen,ste,stolo,straight,subequal,subquadrate,tall,tamen,tem,throughout,tip,toward,tri-,tube,typically,unit,unwinged,upper,usually,vary,wet,wide,woody,x,ympodial	abaxial,adaxial,arrangement,claviform,color,colour,form,growth,height,history,inflorescence,length,life,middle,na,number,ovary,perennial,position,pseudostipule,reproduction,shape,spacing,staman,surface,texture,width
449	wfo-0001029084	success	192	104	76	116	28	0.396	.5,1-10,1-2,1-4,10-50,2-3.5,3.5-7.5,4-17,4-7,4.5-6.5,5,7-9,8-23,abaxially,acuminate,adaxially,along,anther,apex,articulated,bead,cell,chartaceous,cm,conical,corolla,covering,diameter,filament,flower,forked,fruit,glabrous,green,greenish,hair-like,herb,honeycomb-shaped,lateral,leaf,leaflet,light,like,lilac,minute,minutely,mm,moniliform,necklace,odd-pinnate,ovate-lanceolate,ovoid,pedicel,peduncle,petiole,petiolule,plant,puberulent,pubescent,purple,rotate,seed,size,sparsely,stigma,stolon,style,subglabrous,terminal,testal,thick,tuber,wall,wet,whitish,yellow	0.8-2,0.8-2.1,1-3,1.1-2.2,1.5-2.5,2-4,2-5,3-6,3.5-8,4.5-10,5-7,5-merou,6-13,absent,acumen,ag,alyx,apart,apparently,arranged,axe,axillary,base,berry,blade,brownish,bud,capitat,ciliate,condition,connivent,darker,decreasing,digestion,distal,dorsally,drying,eaf,edge,eed,enzyme,especially,exceeding,flat,folded,fresh,geminat,generally,glabrou,gradually,green-white,half,homostylous,interjected,interpetalar,lanceolate,larger,lengthening,living,lobe,lon,long,lower,make,margin,middle,midrib,mottled,mucilaginous,multiple,narrow,nflorescence,obtuse,orolla,pair,perfect,pilose,plurifoliate,pore,poricidal,proximal,ray,removed,ripe,ruit,secondary,semierec,seudostipule,slit,spaced,specimen,stamen,subequal,subglabrou,subsessile,subtending,symmetrical,tall,tamen,tem,thir,throughout,tip,tissue,toward,tri-,tube,typically,unit,unwinged,usually,vary,wide,wing,x,ympodial	abaxial,adaxial,arrangement,capitate,color,colour,form,growth,height,history,inflorescence,length,life,mucilaginousnes,na,number,ovary,perennial,position,rachi,reproduction,shape,spacing,staman,stipule,surface,texture,width
450	wfo-0001029087	success	226	100	80	146	20	0.354	0-0.5,0.1-2,0.3-0.8,0.5-0.75,0.5-2.3,0.7-0.9,0.7-2.2,1-1.5,1-6,1.5-1.75,10-30,11-20,2-3,2-7,3.5-5.5,8-12,abaxially,absent,adaxially,anther,apex,base,chartaceous,cm,cylindrical,dark,densely,diameter,dm,extra-axillary,filament,finely,flattened,flower,fruit,glabrous,globose,green,grey,herbaceous,inflorescence,interpetalar,lanceolate,leaf,length,lobe,midvein,mm,moderately,obtuse,ovate,pale,pedicel,peduncle,per,petiole,placenta,plant,present,prickle,pseudo-racemose,purple,rachi,resprouter,reticulate,rhizomatous,rotate,rotate-stellate,rusty,sparsely,stellate-pubescent,stigma,streak,style,surface,tissue,white,x,yellow,yellowish	%,.05,.5,0-0.1,0-14,0-2,0-6,0-7,0.2-0.6,0.25-0.4,0.3-0.4,0.3-0.45,0.3-0.5,0.35-0.45,0.5-1,0.9-1.7,0.9-8,1-3,1-3.5,1-4,1.3-1.6,1.4-1.7,16-20,2-,2-locular,2.5-4,2.7-2.9,3,3-5,3-7,3-8,3-foliate,4.5-8,4.5-8.5,5-15,5-merou,6-7,6-8,6.5-13,7-10.5,7-8,7-9,8-20,8-30,8-9,9-15,absen,accrescent,acicular,across,acute,adult,alyx,ample,andromonoecious,anvil-shape,apart,articulated,attenuate,axe,ba,blade,branchlet,broadly,calyx,capitat,connivent,cross-section,deeply,deltate,directed,distall,distributed,eaf,eed,eglandular,entire,erect,exocarp,finger,fruiting,functional,geminat,gland-tipped,grey-green,hair,half,heterostylous,juicy,juvenile,lamina,lateral,less,lobed,long,longer,lower,margin,mature,mesocarp,mid-point,midpoint,minute,moist,narrowly,nflorescence,oblique,orolla,pair,part,pendent,pore,porrect,proximal,ray,ruit,sessile,shallowly,short,simple,slightly,spaced,stalk,stalked,stellae,stellate,straight,tal,tamen,tem,thick,throughout,time,tissu,transparent,triangular,tube,unarme,unarmed,unbranched,unit,upper,vary,weakly,wide,ympodial	5-merous,abaxial,adaxial,anvil-shaped,capitate,color,corolla,density,form,growth,height,ovary,position,presence,seed,shape,staman,stem,texture,thicknes
451	wfo-0001029088	success	149	108	84	65	24	0.564	.3,0.1,0.9–1.5,1.3–4.5,15–25,1–1.6,2.5–20,25–30,2–2.5,3–16,4–8,5,<,acuminate,anther,apex,base,bronze-brown,capitate,climbing,cm,cordate,diameter,entire,extra-axillary,filament,flattened,flavor,flower,fragrant,fruit,glabrous,greenish-brown,hair,heavy,herbaceous,immature,juicy,leaf,lenticular,light,margin,mature,membranous,minutely,mm,moderately,near,obtuse,ovoid-rhomboid,palmate,papillose,pedicel,peduncle,petiole,primary,pubescent,purplish,rachi,reddish-brown,revolute,rounded,rugose,sand-punctate,scent,shortly,simple,slightly,somewhat,sparsely,stellate,stigma,strongly,style,surface,sweet,terrestrial,unbranched,vein,venation,vine,white,x,–7	.2,0.6–3.2,1.5–2,1.5–3,1–1.2,1–1.5,1–3,2-lobe,2.5–4.2,2–3,3.5–7,3.5–8,5-merous,5–8,6-10,abaxially,accrescent,acute,adaxially,alyx,apar,apicall,axe,berry,blade,c.,calyx,ciliate,cylindrical,densely,eaf,eed,emarginate,fleshy,fruiting,glabrou,groun,half,lanceolate,lobe,long,lower,m.,narrowly,nflorescence,nternode,orolla,perfec,plurifoliat,ruit,slender,spaced,stout,straight,swee,tamen,tem,tip,truncate,truncate-acuminat,tube,unit,vary,wider,ympodial	2-lobed,apart,color,corolla,form,ground,growth,height,history,inflorescence,internode,juicines,length,life,ovary,perfect,plant,position,reproduction,seed,shape,spacing,staman,texture
452	wfo-0001029089	invalid_json_followup	177	135	99	78	36	0.559	.5,.75,/4,0.1-0.25,0.5-1,0.8-1,1-1.5,1.5-2,1.5-6,10-25,4.5-5,5-10,5-9,6-7,abrupt,acute,along,anther,apart,apex,axil,base,beneath,bilobed,branched,bud,calyx,campanulate,caniculate,cm,completely,corolla,covered,covering,dark,decurrent,deflexed,densely,dia,drying,either,elliptic,enclosed,entire,erect,filament,flattened-reniform,fruiting,furcate,glabrous,globose,golden,green,impressed,lamina,leaf,lobed,minutely,mm,occasionally,opposite,otherwise,ovary,papillose,pedicel,petiole,pitted,primary,prominent,pubescent,purplish,resinous,rounded,shiny,shrub,simple,slightly,small,somewhat,stigma,style,surface,tan,tapering,tip,tree,trichome,tube,underside,uniseriate,usually,varnish,vein,way,white,widening,woody,x,young	0.5-0.6,0.8-1.2,1,1/2,2.5-3.5,5-20-flowered,5-6,8-9,anthesi,apiculate,ba,bark,beginning,berry,closely,cracking,differing,difoliate,eaf,edicel,eed,expand,exserted,free,geminat,glabrou,incrassate,inflorescenc,later,lateral,like,lobe,lon,long,lower,main,major,margin,material,member,middle,minor,nflorescence,obovoid,older,one,overlapping,pair,papillo,part,peeling,persistent,pinkish,planar,pore,poricidal,portion,reddish-grey,resinou,rounded-deltoid,ruit,scar,secretion,shaped,size,smooth,spaced,stem,still,straight,tall,tear-drop,tub,ud,unit,varnished,widest,ympodial	'',5-20,[,``,abaxial,adaxial,arrangement,characteristic,color,colour,diameter,flower,form,fruit,growth,height,history,inflorescence,length,life,na,number,peduncle,plant,position,rachi,reproduction,seed,shape,spacing,staman,texture,value,width,{,}
453	wfo-0001029091	success	212	123	91	121	32	0.429	-4,-4.5,1-10,1-2,1.5-,10,2-2.5,2-3,2.5-,3,3-4,4,7-8,acuminate,acute,anther,apex,articulation,axil,base,broadly,buff,campanulate,capitate,cell,cm,colour,conspicuous,corolla,cuneate,cyme,discoidal,downward,elliptic,erect,filament,flower,flushed,fork,fruiting,glandular,globular,grey,intense,irregular,irregularly,larger,lateral,lavender,leaf,light,line,long,minutely,mm,obovate,obscure,ochre-yellow,ovate,overlain,ovoid,pale,pattern,pedicel,peduncle,pentagonal,petiole,pubescent,rachi,raised,reddish-purple,relatively,reticulate-concentric,ridge,ridged,shrub,slender,slightly,soft-wooded,speckled,stellate-rotate,stem,stigma,stone,style,subulate,surface,swollen,toward,transverse,violet-purple	-1,-15,0.3-,0.5-0.8,0.5-1,1,1.5-2,10-20,10-toothed,15-40,170-210,2-12,20-30,3-,3-11-lobed,46/1,5,5-7,635/1,age,appearing,aromatic,articulated,aspect,ba,becoming,berry,blunt,bluntly,brownish,calyx,clonal,close,common,cut,dark,deeply,develop,developed,dia,eed,effect,ellipsoid,emarginated,exceeding,exerted,flattened,floral,forked,fresh,general,giving,globose,gree,growing,hair,half,interacuminal,juvenile,lacking,lasting,later,lavende,lengthening,linear,linear-lanceolate,lobe,long-triangular,lower,may,mid-vein,mineral,narrowly,nflorescence,oblong,occasionally,ower,pedicellate,petiol,petiolate,plurifoliat,point,pore,poricidal,readily,rh,ripe,rounded,ruit,scarcely,separate,several,shallowly,shed,shortly,sigmoid,simple,sinus,slit,soft,soon,sparsely,straggly,succulent,tall,tip,tissue,triangular,tub,ud,unit,upper,usually,violet,well,winged,without,woody,x,year,ympodial	abaxial,adaxial,arrangement,color,diameter,feature,form,fruit,green,growth,habit,height,history,inflorescence,length,life,na,number,ovary,perennial,plant,plurifoliate,position,ratio,reproduction,seed,shape,spacing,staman,texture,width,woodines
454	wfo-0001029101	success	233	110	92	141	18	0.395	.5,0-2,0.4-1.5,1-1.5,1-3,1-4,1-8,1.3-2,1.3-2.6,1.4-2.2,2.5-6,3-,3-4,4-12,5-,5-7,5-9,5-merous,7-13,8-15,abaxial,adaxial,andromonoecious,anther,apex,apparently,bark,base,berry,blade,branched,calyx,cell,chartaceous,cm,cuneate,darker,diameter,dull,elliptic,erect,filament,flattened-reniform,flower,fruit,fruiting,glabrescent,glabrous,lateral,leaf,length,lobe,lobed,margin,maturity,mauve,mm,obovate,obtuse,one,open,orange-brown,outline,ovate,pair,pale,pedicel,peduncle,petiole,pit,plant,primary,raised,rarely,reflexed,rounded,shrub,small,smooth,sometimes,sparsely,spherical,stellate,stellate-pubescent,style,surface,tertiary,time,vein,venation,visible,yellow	-15,-3,/3,/4,0-100,0-20,0-5,0-8,0.1,0.1-0.4,0.1-0.5,0.1-0.7,0.1-1,0.2,0.5-1,0.7-,0.8-3.5,00-200,1,1.5-2,1.5-2.5,1.7,1.8-3,1/5-1/4,10-14,10-20,2-,2-20,2-6,2.5-3.5,2.8-3.3,2/3-3/4,3-10,3-7,30-100,4-7,5-20,5-6,5-8,5.5-8,6-8,abaxially,acute,almost,always,alyx,apar,apart,apically,articulated,broad-deltate,brown-green,concolorous,connivent,cream,dark,deltate,discolorous,distal,distance,drying,eaf,eed,elongating,equal,extending,flattened,free,green,green-brow,hermaphrodite,heterostylous,infructescence,lengt,like,lon,long,long-styled,longer,lower,lowermost,marking,mature,midpoint,midvein,moderately,multangulate,narrow-deltate,nflorescence,oblong,often,older,orolla,oung,pendulous,per,pericarp,plurifoliat,poricidal,porrect,portion,present,prickl,prickle,prickly,ray,reduced,rounde,ruit,scar,secondary,sessile,short-styled,side,simple,spaced,spreading,stalk,stalked,staminat,stem,straight,suborbicular,tamen,tapering,terete,thick,tip,trichome,tube,unit,variously,vary,way,well-developed,wide,woody,yellow-green,yellow-orange,ympodial,young	branching,color,corolla,form,green-brown,growth,height,inflorescence,number,opening,ovary,reproduction,seed,shape,spacing,staman,texture,width
455	wfo-0001029106	success	200	129	103	97	26	0.515	.5,/3,0.1,0.2-1,0.25-0.7,0.5-0.8,0.5-0.9,1-1.6,2-6,2-8,3-25,3-4,4-6,5-14,5-merous,abaxially,anther,apart,apex,apparently,articulated,bark,base,berry,calyx,cell,cm,concolorous,cuneate,densely,diameter,discolorous,drying,elliptic,elongating,erect,eye,filament,flattened-reniform,flower,fruit,fruiting,glabrescent,glabrous,lateral,leaf,length,light,lobed,long,margin,maturity,mauve,membranous,midvein,mm,naked,obtuse,orange,orange-brown,orbicular,outline,ovate,pale,pedicel,peduncle,pendulous,petiole,pit,porrect,prickly,raised,red,rounded,scandent,sessile,shiny,shrub,simple,small,smooth,sometimes,spaced,sparsely,spherical,stalked,stellate-pubescent,stem,style,subentire,surface,terete,tertiary,trichome,variously,venation,visible,way,weakly,white,woody,yellow-orange,yellowish-green	-6,.1,0,0-0.3,0-10,0-2,0-20,0-5,0-6,0.2-0.4,0.5,0.5-1,0.5-2.5,0.9-1.2,1-2,1-5,1.5-1.8,1.5-2,1.5-3.5,1/4,1/5-1/4,2-3.5,2-4,2-5.5,2.2-3,2/,3-3.5,4-8,5-8,6-8,acuminat,acute,alyx,ame,apar,apically,appearing,blade,branched,c.,curved,deltate,distance,eaf,eed,equal,extending,flattened,free,gently,infructescence,lobe,lon,longer,lower,mature,midpoint,nflorescence,older,one,open,orange-brow,orolla,oung,pair,per,perfec,pericarp,plurifoliat,poricidal,portion,prickl,prickle,primary,ray,reflexed,scar,shallow,shorter,side,size,slender,spreading,stalk,stellate,straight,tamen,tapering,time,tip,tube,uit,unit,vary,vein,wide,ympodial	abaxial,adaxial,arrangement,color,colour,corolla,form,growth,height,history,inflorescence,life,na,number,ovary,perfect,plant,position,reproduction,seed,shape,spacing,staman,stigma,texture,width
456	wfo-0001029112	success	190	101	73	117	28	0.384	1-10,1-2,1-4,10-17,10-21,2-3.5,2.5-4.5,2.6-3,2.7-5.7,20,3-6,3-7,3.5-4.5,3.5-7,5,acuminate,along,anther,apex,articulated,bead,cell,cm,condition,conical,corolla,densely,diameter,elliptic-lanceolate,filament,flower,forked,fruit,glabrous,green,greenish,hair,herb,honeycomb-shaped,interjected,leaf,leaflet,light,like,minute,mm,moniliform,mucilaginous,necklace,odd-pinnate,ovate,ovoid,pale,pedicel,peduncle,petiole,petiolule,plant,pubescent,rotate,seed,slightly,stigma,stolon,style,symmetrical,terminal,testal,tuber,violet,wet,whitish,yellow	0-2,0.5,0.9-1.7,1-3,1.4-2.5,1.5-1.8,1.5-2,2.7-3.5,2.7-4.2,3-4,3-5,5-8,5-merou,6.5-5.5,9.5-13,abaxially,acumen,adaxially,ag,alyx,apart,apparently,arranged,axe,axillary,base,berry,blade,brownish,bud,capitat,chartaceous,ciliate,connivent,covering,decreasing,digestion,distal,dorsally,drying,eaf,edge,eed,enzyme,equal,especially,exceeding,flat,folded,fresh,geminat,generally,glabrou,gradually,green-white,hair-like,half,homostylous,lanceolate,larger,lateral,lengthening,living,lobe,long,lower,make,margin,middle,mottled,multiple,narrow,nflorescence,obtuse,orolla,pair,perfect,plurifoliate,pore,poricidal,present,pubescen,purple,ray,removed,ripe,ruit,secondary,semierec,seudostipule,size,slit,spaced,specimen,stamen,ste,subequal,subtending,tall,tamen,tem,thick,thir,throughout,tip,toward,tri-,tube,typically,unit,usually,vary,wall,wide,wing,x,ympodial	abaxial,adaxial,arrangement,capitate,color,colour,form,growth,height,history,inflorescence,length,life,na,number,ovary,perennial,position,pseudostipule,rachi,reproduction,shape,spacing,staman,stem,surface,texture,width
457	wfo-0001029120	success	168	111	79	89	32	0.47	.5,0.1-0.5,0.5-1.5,0.7-1,1.1-1.5,1.1-2,3-3.5,6-8,acuminate,anther,apart,apex,bark,basal,base,beneath,bud,calyx,cm,corolla,dark,dia,erose,evenly,f,filament,fleshy,free,glabrous,globose,golden,greenish-brown,hirsute,infloresence,internodal,leaf,lobed,long-triangular,margin,minutely,mm,narrowly,nearly,opposite,ovary,ovate,pale,paler,papillose,pedicel,peduncle,petaloid,petiole,poricidal,pubescent,rest,scar,shaped,shrub,simple,slightly,spaced,sparsely,stigma,straight,style,surface,tapering,tear-drop,tip,trichome,tube,unifoliate,uniseriate,urceolate,vein,white,yellow,yellow-green	.05,.75,/2,1-1.5,2.5-3.5,2.6-7,5-10-flowered,5-8,6.5-16.5,8511,abrupt,acute,anthesi,beginning,black,bullate,cell,decurrent,deflexed,densely,difoliate,dry,drying,eaf,edicel,eed,epidermi,especially,fide,geminat,inflorescenc,know,known,lanceolate,large,larger,later,lateral,lehmann,like,lobe,lon,long,lower,main,middle,midrib,minor,narrow,narrower,nflorescence,occasionally,often,older,outer,pair,peduncl,point,pore,portion,present,prominently,proximal,raised,reproductive,ruit,scattered,slender,specimen,speckle,stem,sympodial,tall,terminal,thickened,tub,ud,unbranched,unit,upper,venation,way,white-papillo,wide,widening,widest,x,ympodial,young	5-10,abaxial,adaxial,arrangement,color,colour,decument,diameter,feature,flower,form,fruit,growth,height,history,inflorescence,length,life,na,number,perennial,plant,position,rachi,reproduction,seed,shape,spacing,staman,texture,white-papillose,width
458	wfo-0001029121	success	161	126	89	72	37	0.553	0,0.2-2,1-4,1-5,10,15-30,2-10,2-13,2-3,2-3-celled,3.8-11,4-5.5,5-8,8-16,acuminate,acute,apex,attenuate,base,blue,branched,cell,cm,commonly,conical,corolla,covering,cuneate,cyme,deep,diameter,dichasial,dichasially,diminishing,distal,ebracteate,elliptical,filament,flower,glabrous,gradually,green,green-white,hair,hair-like,half,herbaceous,honeycomb,lateral,leaf,leaflet,medium,mm,monochasial,narrowly,oblique,obtuse,odd-pinnate,ovate,ovoid,pair,pattern,pedicel,peduncle,perennial,petiole,petiolule,plant,purple,rarely,rotate,rounded,scattered,seed,short,size,stigma,style,subequal,terminal,testal,thick,tip,toward,tuber-bearing,typically,unit,wall,yellow	-6,0-2,1.1-3.9,1.2-2.5,1.2-3.3,2-,3-5,3-6-foliat,3.6-9,4-10,4.5-10.0,5-20,9-33,abaxiall,abaxially,acumen,adaxially,apical,apically,articulate,calyx,connate,dehiscent,digestion,dorsally,eaf,edge,eed,emoval,enzyme,exceeding,flat,folded,forked,generally,globo,interjected,introrse,living,lobe,lon,long,lower,lunat,make,maturing,mucilaginous,nflorescence,nther,often,orolla,perfect,plan,poricidally,proximal,reveal,ruit,sessile,seudostipule,short-attenuate,slit,specimen,stamen,straight,tal,tem,throughou,throughout,vary,wide,ympodial,¼	3-6-foliate,6,abaxial,adaxial,anther,arrangement,color,colour,form,frequency,fruit,globose,growth,height,history,inflorescence,interjection,length,life,lunate,mucilaginousnes,na,number,ovary,position,pseudostipule,rachi,shape,spacing,staman,stem,surface,sympodial,texture,wet,width,ye
459	wfo-0001029125	success	197	120	87	110	33	0.442	1,5-merous,6,abaxial,abaxially,acuminate,adaxial,adaxially,anther,anthesi,apex,appressed,base,berry,black,brownish,cell,central,closely,cm,concave-reniform,corolla,densely,diameter,ellipsoid,end,filament,flower,free,fruit,glabrous,globose,green,herb,hilum,internodal,lateral,leaf,live,lower,maturity,maximum,minutely,mm,narrower,orange,outline,ovary,ovate-lanceolate,pale,papillate,pedicel,peduncle,pentagonal,petiole,plant,portion,pubescent,purple,purplish,ripe,scar,scattered,seed,shiny,simple,small,spaced,sparsely,spreading,star,stellate,stigma,straight,style,subshrub,surface,testal,toward,trichome,tube,turning,uniseriate,white,woody,yellow,¼	.0–3.5,.1,.1–1.4,.2,.4,.5–2.0,.6,0.5,0.5–0.6,0.5–1.0,0.8–0.9,0.9,1.0–1.2,1.0–1.5,1.0–4.0,1.5–2.0,1.5–3.0,1.7-,1.8–3.5,1–2-celled,2.5–12.0,2/3,20–100,2–3-celled,2–4,3.0–3.4,3.5–4,35–45,3–5,3–5-celled,4–8,5–6,6–7,acute,age,along,apar,apparently,arising,articulated,attenuate,ba,beyond,branching,calyx,cone,conical,cuneate,delicate,deltate,difoliate,eaf,eed,entire,especially,exerted,fruiting,geminat,growt,later,lengthening,like,lobe,lobed,lon,long,margin,nearly,nflorescence,oblique,occasionally,often,one,pair,per,perfect,place,pore,poricidal,positioned,primary,purple-tinged,reflexe,reflexed,ridged,ruit,shorter,single,slightly,slit,stem,stemmed,stone,strongly,sub-lateral,tall,tem,terete,tinged,tip,traingular,ud,unequal,unit,usually,vein,whitewith,wide,ympodial,young	0.5-0.6,0.5-1.0,0.8-0.9,1-2-celled,1.0-1.2,1.0-1.5,1.1-1.4,1.5-3.0,1.7-3.4,2-3-celled,20-100,3-5,3-5-celled,3.5-4,5-6,apart,arrangement,colour,form,growth,height,history,inflorescence,length,life,na,number,position,reproduction,shape,spacing,texture,width
460	wfo-0001029138	success	170	85	57	113	28	0.335	0.15-0.3,0.5-0.9,0.9-1.2,2.4-5.5,3-4,3.5-4.5,3.5-6.7,4-6,6-6.5,7-10,acute,anther,apex,articulated,base,broadly,brown,chartaceous,cm,cylindrical,densely,diameter,distally,extra-axillary,flower,fruit,glabrous,green,grey-green,inflorescence,length,markedly,mesocarp,mid-point,mm,moist,oblate,ovate,pedicel,peduncle,perennial,petiole,prostrate,pseudo-racemose,purple,rhizomatous,rotate,shrub,simple,stellate-pubescent,style,thicker,thicknes,throughout,unknown,yellow,yellowish	%,0,0-0.1,0-0.6,0-1.5,0-5,0.25-0.5,0.6-0.7,0.6-0.8,0.6-1.1,0.8-1.5,1-1.5,1-1.8,1-2,1-2.5,1-5,1.6-2.1,1.7-4,2-foliate,2-locular,2.5-3.5,20-100,20-30,3-8,3-80,5-8,5-merou,6-10,6-8,65-115,7-8,abaxially,absen,absent,accrescent,acicular,adaxiall,adaxially,alyx,apart,apparently,armed,axe,ba,blade,broad-based,calyx,cuneate,d.,deltate,directed,distall,distributed,dult,eaf,eed,eglandular,enclosing,entire,finger,fruiting,functional,geminat,glabrou,gland-tipped,hair,juic,lamina,lateral,lobe,lon,long,longer,lower,margin,mature,midpoint,midvein,minute,nflorescence,oblique,obtuse,orolla,part,per,pore,porrect,present,prickle,ray,ruit,rusty,short,spaced,sparsely,stage,stalk,stellae,stem,straight,tal,tamen,thick,time,tube,unbranched,unit,unknow,uvenile,vary,wide,x,ympodial	abaxial,adaxial,arrangement,articulation,color,colour,corolla,filament,form,growth,height,history,juicy,leaf,life,moisture,na,number,ovary,plant,position,reproduction,seed,shape,staman,surface,texture,width
461	wfo-0001029150	success	177	121	97	80	24	0.548	0.3,0.3–0.5,0.8-1,0.8–1,0.8–1.5,1.2–1.5,1.5–2.2,15,1–11,1–2,1–5,1–6,2.5–3,2–10,3-5,3–10,5-merous,8-shaped,9–12,abaxially,accrescent,acute,adaxially,anther,apex,apically,apiculate,base,branched,calyx,ciliate,cm,color,conical,delicate,diameter,distant,ellipsoidal,elliptical,enlarged,entire,except,extra-axillary,filament,fleshy,flower,fruit,glabrous,leaf,light,margin,membranaceous,midvein,minutely,mm,moderately,nearly,oblique,opposed,ovate,pale,pedicel,peduncle,petiole,pinkish-white,pinnate,pubescent,rachi,rarely,rounded,rounded-deltoid,rugose,sand-punctate,shortly,simple,slender,slightly,somewhat,spaced,sparsely,stellate,stem,stigma,style,surface,tan,teardrop-shaped,thickened,tip,trichome,truncate,vein,venation,vine,white,woody,x	.5,0.3-0.5,0.5–1.1,0.8–3.5,1.5,1.5–2,1–1.5,2.5–5,2.5–8,2–2.5,2–3,3–4,3–50,6,7–8,across,adaxiall,alyx,apar,apicall,attenuate,axe,berry,blade,c.,canopy,capitat,climbing,cros,cylindrical,dried,eaf,eed,flattened,flush,fruiting,glabrou,inconspicuous,lamina,lanceolate,larger,living,lobe,lon,long,lower,m.,material,mor,nflorescence,nternode,older,orolla,pair,perfec,plurifoliat,pointed,reaching,ruit,scar,secondary,section,side,small,specimen,strong,tamen,tem,thick,time,translucent,tree,tube,understory,unit,vary,vegetation,wide,wiry,ympodial	abaxial,apart,arrangement,capitate,corolla,feature,form,growth,height,history,inflorescence,internode,length,life,ovary,perennial,perfect,plant,position,reproduction,seed,shape,staman,texture
462	wfo-0001029151	success	197	101	79	118	22	0.401	-10,0-0.5,0.1-0.3,0.2-0.6,0.25-0.5,0.5-1,1-1.5,1-2,1-5,10-15,15-20,2-2.5,2-3,2-8,3.5-5,5-10,7-10,8-10,8-15,abaxially,acicular,acute,adaxial,adaxially,annual,anther,apex,brown,calyx,cm,dark,densely,diameter,elliptic,filament,flattened,flower,forked,fruit,glabrous,globose,green,hair,herb,lateral,leaf,leaf-opposed,midpoint,minutely,mm,multangulate,narrowly,oblong,ovate,petiole,porrect,prickle,pubescent,purple,rarely,ray,reniform,reticulate,silvery,simple,stalk,stellate,stem,stigma,straight,style,surface,truncate,unbranched,white,whitish,x,yellow,yellowish	1-2.5,1-6,1.5-2,1.5-3,1.5-6,2-15,2-4,2-6,4-10,4.5-5,5,5-7,5-8,6-10,7-9,8,abundantly,accrescent,acro,acumen,apart,apparently,armed,articulated,axe,ba,base,blade,capitat,chartaceous,close,completely,cone,connivent,covered,covering,curved,cylindrical,deflexed,developed,difoliate,directed,discolorous,distall,downward,eaf,eed,eglandular,entire,equal,frui,fruiting,geminat,held,high,interpetalar,juic,juvenile,larger,like,lobe,lon,long,loosely,lower,main,margin,markedly,mesocarp,midrib,minute,moderately,moist,nearly,nflorescence,oblique,obtuse,orolla,outside,pale,pedicel,peduncle,perfect,pore,prickly,probably,rachi,rounded,ruit,scarcely,shallow,shorter,side,small,spaced,sparse,sparsely,sparser,spiny,sprawling,stellate-pubescent,subcordate,tamen,tem,time,tissu,tissue,triangular,tube,unarmed,undulate,unit,usually,vary,vein,vigorous,wide,ympodial	abaxial,arrangement,capitate,color,colour,corolla,form,growth,height,history,inflorescence,length,life,number,ovary,plant,position,seed,shape,staman,texture,width
463	wfo-0001029152	success	197	104	78	119	26	0.396	0.5-1,0.75-1,0.9-1.3,1-4,1.1-1.3,1.5-1.7,1.5-2,2-2.5,2-5,2.5-3,acuminate,acute,anther,apex,area,bark,base,branch,broadened,brown,bud,calyx,closely,cm,corky,corolla,dark,deep,elliptic,filament,flattened,floccose,flower,fruit,fruiting,glabrous,globose,green,greyish-red,hyaline,inflorescence,large-lenticellate,leaf,lightly,lobed,minutely,mm,nearly,obovate,often,opposite,ovary,overlapping,ovoid-reniform,pale,papillose,pedicel,petiole,pitted,plant,red,scar,shape,shiny,shrub,simple,slender,small,spaced,stigma,style,surface,tapering,tip,tree,tube,white,winged	.1,.5,0.25-0.5,0.8-1,1,1-1.5,1-2,1-3,2-3,2-4,3-5,3-8-flowered,4-6,6-8,61-25,8.5-16,anthesi,appearanc,appearing,appressed,attenuate,ba,beginning,beneath,berry,blade,broadly,citronella,completely,conical,cuneate,deciduous,decurrent,deflexed,deltoid,densely,dia,differing,difoliate,distal,dry,eaf,edicel,eed,ellipsoi,enclosing,erect,et,exsertion,fide,fragrance,free,geminat,giving,held,inflorescenc,keeled,late,lateral,live,lobe,lon,long,long-styled,longer,lower,main,major,margin,material,middle,midrib,minor,nflorescence,older,one,pair,per,planar,plane,pore,poricidal,portion,prominent,prominently,quite,red-floccose,reddish,reddish-floccose,reflexed,reminiscent,rounded,ruit,shaped,short-styled,single,size,slightly,somewhat,soon,stem,straight,styl,tall,tear-drop,terminal,third,tillett,trichome,ud,unit,usually,vein,weak,widest,woody,x,ympodial,young	1.5-6,3-8,abaxial,adaxial,arrangement,color,colour,diameter,form,growth,height,history,length,life,na,number,peduncle,perennial,position,rachi,reproduction,seed,spacing,staman,texture,width
464	wfo-0001029156	success	65	78	40	25	38	0.615	0.5,1.5-2,6,<,apex,bark,berry,cell,center,cm,deeply,diameter,fruiting,glabrous,golden,growth,liana,margin,minute,minutely,mm,multiseriate,new,pale,pedicel,pitted,rectangular,reniform,rib-like,seed,shiny,shreddy,sinuate,stem,surface,tan,thickening,trichome,vine,woody	-3,1,10-12,2,4-6,6-8,almost,apparently,completely,eed,epiphytic,exfoliating,fide,flattened,lateral,long,markedly,nee,noddin,occasionally,older,per,testal,wall,wide	abaxial,adaxial,anther,arrangement,bud,calyx,color,colour,corolla,filament,flower,form,fruit,height,history,inflorescence,leaf,length,life,na,nodding,number,ovary,peduncle,petiole,plant,position,prickle,rachi,reproduction,scar,shape,spacing,staman,stigma,style,texture,width
465	wfo-0001029156	success	65	58	40	25	18	0.615	0.5,1.5-2,10-12,<,almost,berry,cell,center,cm,completely,diameter,exfoliating,flattened,fruiting,glabrous,golden,growth,liana,margin,minutely,mm,multiseriate,new,pale,pedicel,per,pitted,rectangular,reniform,rib-like,seed,shiny,sinuate,stem,surface,tan,trichome,vine,wall,woody	-3,1,2,4-6,6-8,apex,apparently,ark,deeply,eed,em,epiphytic,fide,lateral,lon,markedly,minute,nee,noddin,occasionally,older,shreddy,testal,thickening,x	2-3,6,bark,color,form,height,history,length,life,material,na,nodding,number,plant,reproduction,shape,texture,thicknes
466	wfo-0001029160	success	150	108	67	83	41	0.447	/2,0.5,0.7,1.3-1.6,1.3-1.8,2-7,3-8,3.0-3.5,4-8,6-8,6.5-8.6,acicular,acute,annual,anther,beneath,blade,bristly,broadly,brown,calyx,capitate,cm,dark,deep,dia,dm,eglandular,erect,few-rayed,glabrous,gland,hair,herb,hilum,including,internodal,less,long,mm,narrowly,notch,occasionally,often,ovate,ovoid,petiole,plump,prickle,prickly,purple,radially,ridged,scattered,sessile,short-stipitate,sometimes,spherical,stellae,stellate,stem,strait,sunken,tinged,vestiture,whitish-tinged,yellow	0.35-0.50,1.11.4,1.8-2.2,20-40,4.5-6.0,5-13,5.6-7.5,6-10-flowered,accrescent,acro,across,adjacent,also,alyx,among,anthesi,appearance,armed,base,berry,branched,campanulate,deltoi,developing,difoliate,divergently,divided,dry,eaf,eed,enveloped,exceeding,extende,finer,fully,geminat,giving,heteromorphic,incurved,invested,linear-lanceolate,lobe,lon,lowermost,main,many,maturity,mostly,much,much-dissected,nflorescence,one,orolla,pair,pinnatifid,ruit,shorter,shortest,size,slende,somewhat,splitting,spreading,stout,straigh,tall,tamen,terminally,three,thrice,tightly,tigma,tub,tube,twice,tyle,ultimate,unit,uppermost,vary,vein,wholly,ympodial	6-10,abaxial,adaxial,apex,arrangement,color,colour,corolla,deltoid,diameter,filament,flower,form,fruit,fruiting,growth,height,history,inflorescence,leaf,length,life,margin,na,number,ovary,pedicel,peduncle,plant,position,rachi,reproduction,seed,shape,spacing,staman,stigma,style,surface,texture,width
467	wfo-0001029163	success	149	108	82	67	26	0.55	-25,0.3-2.5,0.5-1,1,1.5-2,1.5-2.5,1.5-3,10-,13-18,2,2-18,2-3,2-6,2.5-3,20-30,3-14,3-4,3-5,4-20,4-6,5-12,5-8,7-9,9-15,abaxial,acuminate,acute,apart,apex,articulated,band,base,calyx,cm,color,cylindrical,deltate,densely,diameter,elliptic,elliptic-ovate,flower,fruit,glabrous,globose,herb,lanceolate,lenticular,lobe,long,mm,moderately,narrowly,nearly,papillose,pedicel,peduncle,perennial,petiole,pseudohair,puberulent,puberulent-pubescent,pubescence,rachi,radiu,remnant,roughened,scale-like,shrub,simple,slightly,sparsely,stellate,stigma,style,surface,triangular,tube,unbranched,unknown,whitish,x	-4,-9,1-2,2-7,4-5-foliat,4.5-23,abaxially,absen,adaxiall,adaxially,aggregate,axe,blade,cell,chartaceous,connivent,cuneate,decurrent,denser,directed,distall,distally,eaf,eed,eglandular,entire,free,glandular,hair,leaving,like,lon,lower,margin,narrowed,nflorescence,nther,obtuse,orolla,pedicellar,pore,projection,puberulent-pubescen,purple,ripe,ruit,small,sometimes,spaced,stalked,stem,stone,subapical,subcoriaceous,tal,tem,thickened,time,tip,truncat,unit,vary,vein,white,wide,yellow,ympodial	adaxial,anther,arrangement,colour,corolla,form,growth,height,history,inflorescence,leaf,length,life,na,number,ovary,plant,position,reproduction,seed,shape,size,spacing,texture,truncate,width
468	wfo-0001029171	success	137	101	66	71	35	0.482	-10,-15,1-3,1-4.5,1-5,1.5-2,10-25,2-3,3-4,3.5-6.5,4-10,5-8,7-9,8-17,acuminate,acute,angled,apart,apex,branched,calyx,chartaceous,cm,deltate,densely,diameter,elliptic,flower,forked,fruit,glabrous,glandular,globose,lobe,midrib,mm,moderately,narrowly,orange,ovate-elliptic,pedicel,peduncle,petiole,puberulent,pubescent,purple,rachi,radiu,rarely,red,rugose,shrub,simple,smooth,sometimes,spaced,sparsely,stellate,stigma,style,tip,triangular,tube,unbranched,white,yellow	-,0.5,1.5-7.5,10-35,11-20,3.5-18,4-5,5-6,6-,abaxially,abruptly,absen,adaxially,aggregate,also,and/or,articulated,axe,ba,base,blade,cell,connivent,cuneate,cylindrical,decurrent,dendritically,dense,directed,distall,eaf,eed,eglandular,entire,except,gland,glandula,hair,lanceolate,like,long,lower,many-foliat,margin,narrowed,near,nearly,nflorescence,nther,obtuse,often,orolla,perfect,pore,ripe,ruit,shoot,short-stalked,slightly,ste,stone,tal,tem,time,truncat,unit,usually,vary,wide,x,ympodial	2-10,abaxial,adaxial,anther,arrangement,axi,color,colour,corolla,filament,form,growth,hairy,height,history,inflorescence,leaf,length,life,na,number,ovary,perennial,plant,position,reproduction,seed,shape,spacing,staman,stem,surface,texture,truncate,width
469	wfo-0001029215	success	49	78	33	16	45	0.673	-1.8-2.3,0.3-0.5,0.5-0.7,0.5-2.5,1,2.3-2.9,appearance,border,brown,calyx,cm,coarse,diameter,elongating,entire,fide,fruit,herb,markedly,mm,narrowly,obovate,pubescent,round,shrub,silky,small,strong,surface,weigend,winged,woody,xyledecor	.2,cell,eed,give,hair-like,lateral,lobe,long,outgrowth,smelling,spreadin,tall,testa,thick,wall,wide	0.2,abaxial,adaxial,anther,apex,color,colour,corolla,elongation,filament,flower,form,fruiting,growth,habit,height,history,inflorescence,leaf,length,life,na,number,origin,ovary,pedicel,peduncle,perennial,petiole,plant,position,rachi,reproduction,seed,shape,smell,spacing,spreading,staman,stigma,style,texture,thicknes,type,width
470	wfo-0001029216	success	243	94	69	174	25	0.284	0.3-0.4,0.4-0.5,0.5,0.5-0.8,0.5-1.5,0.6-1,1-1.2,1-2,1.2-6,1.5-2.3,10,2.5-3.3,3,4,acute,annual,anther,apex,articulated,attenuate,biennial,bright,brown,capitate,cm,conical,corolla,deep,diameter,distal,elliptic,filament,fruit,glabrescent,globose,green,hair-like,herb,imparipinnate,inflorescence,interrupted,lanceolate,length,less,long,minute,mm,narrowly,obovate,orange,outgrowth,ovary,ovate,pale,pedicel,peduncle,pentagonal,perennial,petiole,plant,pubescent,red,shape,simple,sparsely,stigma,style,surface,yellow	+,-0.5,-10,-5,.5,.8-1,0.1-0.3,0.1-0.5,0.1-0.6,0.1-0.8,0.2-0.25,0.2-0.3,0.2-0.4,0.2-0.8,0.3-0.5,0.3-2,0.4,0.5-2,0.6-0.8,0.8-2.5,1-3,1-4,1-6,1.5-2.5,1.5-3,1/,10-,10-14,2,2-4.5,2-locular,20-35,3-,3-4,3-5,3-7,3-foliate,5,5-15-flower,6-10,7-10,<,absen,absent,accrescent,acroscopically,adpressed,allogamous,always,and/or,angeld,anthesi,apical,appearance,appendage,articulation,axi,basal,base,basiscopically,becoming,branch,calyx,cell,cente,column,composed,cone,cordate,crenate,cultivar,decurrent,deeply,dentate,eaf,edicel,eed,entire,erect,exserted,extending,facultatively,fasciated,fruited,fruiting,giving,gland-tipped,glandular,gree,half,halfway,included,initially,interjected,internode,large,larger,later,lateral,leaflet,like,linear,lobe,lobulate,lon,longer,lower,mainly,margin,maturity,minutely,mixture,multicellular,multilocular,near,nflorescence,numerous,oblique,often,one,pair,particularly,petiolule,population,present,primary,procumbent,pseudostipule,rarely,reflexe,ruit,scen,secondary,sessile,shaggy,shaped,short,silky,sometimes,somewhat,sparse,spreading,staminal,stem,sterile,straight,strong,strongly,tangled,tem,terminal,tertiary,testa,thick,thickening,tip,total,toward,trichome,truncate,tube,ud,unicellular,uniseriate,unit,usually,variety,varying,villous,viny,wall,wide,winged,ympodial	1/3,5-15,abaxial,adaxial,arrangement,color,colour,flower,form,growth,height,history,leaf,life,na,number,position,rachi,reproduction,seed,spacing,staman,texture,thicknes,width
471	wfo-0001029226	success	206	121	92	114	29	0.447	-9,1-1.5,1-3,10-40+,2-6,2-9,2.5-10,3-3.5,5-7,7-11,8-13,acuminate,acute,anther,apart,apex,apparently,base,berry,black,blue,branched,bright,capitate,cell,cm,cordate,corolla,dark,densely,diameter,elongate,filament,flattened,flower,glabrous,globose,green,growth,hairy,herbaceous,irregularly,lateral,lavender,leaf,like,lobed,lyrate,many,minutely,mm,open,pale,pedicel,peduncle,perfect,petiole,pinnatifid,pitted,pubescent,red,reniform,ripe,seed,shiny,short-glandular,shrub,simple,slender,spaced,spreading,stellate,stem,stigma,style,surface,tan,terminal,testal,time,translucent,trichome,uniformly,uniseriate,vine,wall,way,weak,white,woody,yellowish,¾	-7,.5,.75,0-1,0.5,0.5-5,1-2,1-celled,2,2-3,3-6,30,4,4-6,5-merou,>,ag,alyx,anthesi,ark,articulated,ba,basal,breaking,calyx,completely,congested,conical,connivent,decurrent,deltate,distall,divided,dry,eaf,eed,ellipsoid,enation,entire,exserted,flexuous,free,fruiting,glabrescent,gland,glandular,ilament,juice,lengthening,lobe,long,longer,loosely,lower,margin,material,mature,membranous,mere,minute,new,nflorescence,occasionally,often,older,one,orolla,overtopping,pair,papillat,papillate,papillo,per,pinnate,plurifoliat,pore,poricidal,portion,primary,reflexed,remainin,rim,ruit,sagittate,scar,scarlet,shorter,sleeve,slit,small,sometimes,sparsely,spot,sprawling,spreadin,staining,strongly,tangled,tem,thin,third,tip,truncate,tube,twinin,ud,unit,usually,vary,vein,wide,widest,winged,ympodial	abaxial,adaxial,arrangement,color,colour,form,fruit,greyish,hair,hairines,height,hirsute,history,inflorescence,length,life,na,number,ovary,papillose,plant,position,rachi,reproduction,shape,spacing,staman,texture,width
472	wfo-0001029234	success	204	121	90	114	31	0.441	0-0.1,0-2,0-6,0.1-0.5,0.2-0.3,0.3-0.9,0.4-0.7,0.5-1,0.5-1.5,0.5-2,0.5-5,0.9-2.1,1-1.5,1-10,3-5,3-8,4-8,5.5-7,7-10,9-24,absent,acute,anther,apex,brown,capitate,chartaceous,cm,dense,diameter,dm,erect,filament,finger,flattened,flower,fruit,glabrous,gland-tipped,glandular-puberulent,globose,green,hair,inflorescence,lanceolate,lateral,leaf-opposed,length,long,longer,midpoint,mm,moderately,narrowly,ovate,pale,pedicel,peduncle,per,perennial,perfect,petiole,present,prickle,pseudo-racemose,pubescent,purple,rachi,ray,red,rhizomatous,rotate-stellate,rugose,shrub,simple,sparse,sparsely,stage,stalk,stellae,stellate,stigma,style,surface,thicknes,time,unbranched,wide,x,yellow	%,0-1,0-2.5,0-3,0-4,0.15-0.3,0.4-0.5,0.6-0.8,0.8-1.1,1-4,1-locular,1.1-1.5,1.5-2,1.5-2.5,11-23,18-24,2-2.5,2-3,2-6,20-,3-3.7,3-7,4-,4-7.5,4.7-7,5-9.5,5-merou,7-11,abaxially,absen,accrescent,acicular,across,adaxiall,adaxially,adult,alyx,apart,apparen,articulated,attenuate,axe,ba,base,bilobe,blade,branche,calyx,confined,connivent,cuneate,cylindrical,directed,distall,distally,eaf,eed,eglandular,entire,exocarp,few-,fruiting,geminat,half,incomplete,juicy,lamina,less,lobe,loosely,lower,margin,markedly,mature,mesocarp,mid-point,midrib,midvein,minute,nflorescence,oblique,orolla,part,placenta,plurifoliate,pore,porrect,ruit,seeded,septum,sessile,short,spaced,stellate-pubescent,straight,succulent,tal,tamen,tem,thick,thicker,throughout,tip,toward,triangular,tube,unarme,unarmed,unit,unknow,uvenile,vary,white,ympodial	abaxial,adaxial,arrangement,axi,bilobed,branch,color,colour,corolla,density,form,growth,height,history,juvenile,leaf,life,number,ovary,plant,position,presence,seed,shape,spacing,staman,stem,texture,type,unknown,width
473	wfo-0001029236	success	159	108	80	79	28	0.503	0.2-1,0.45-0.5,1-1.5,1-2,1.4-1.7,2-5,abaxially,absent,adaxial,anther,anthesi,apex,apically,axi,bark,branch,branching,branchlet,cm,compact,completely,corolla,deflexed,dendritic,densely,diameter,dichasial,elliptic,erect,except,filament,flattened,fleshy,flower,fruit,glabrous,globose,grey-brown,growth,leaf,lenticular,less,lobed,many,margin,minutely,mm,narrowly,nodding,obscurely,ovary,pale,pedicel,pericarp,petiole,pitted,plurifoliate,pointed,prominent,pubescent,purplish,purplish-black,reddish-brown,revolute,scar,shiny,short,shrub,slightly,sparsely,stem,stigma,style,surface,terminal,thin,trichome,unit,usually,violet	.5,0.2-0.7,0.5,0.5-1.5,0.9-2.3,1/2,2-4,3,6-9,age,apical,apparently,appearing,ba,basal,base,becoming,berry,bi-lobe,broadly,calyx,conical,coriaceous,cupulate,decurrent,deltate,eaf,edicel,eed,ew,exserted,free,fruiting,inserted,later,lateral,lobe,long,lower,m.,middle,midvein,near,nflorescence,obscure,occasionally,older,overtopping,packe,per,persistent,pore,poricidal,portion,ruit,scattered,secondary,shoot,simple,sleeve,slit-like,stamen,strongly,tall,tapering,time,tip,trongly,tub,tube,ud,venation,way,wide,winged,woody,x,ympodial,young	abaxial,arrangement,bi-lobed,color,colour,form,height,history,inflorescence,length,life,na,new,number,packed,peduncle,perennial,plant,position,rachi,reproduction,seed,shape,spacing,staman,sympodial,texture,width
474	wfo-0001029244	success	233	84	66	167	18	0.283	0-2.5,1-1.5,1-4,1.4-6,2-12,2-3,4-5.5,5-7,7-12,7-30,90-200,anther,branch,calyx,chartaceous,cm,cylindrical,deltate,densely,diameter,dm,elliptic,erect,extra-axillary,filament,flower,fruit,globose,green,inflorescence,juvenile,lanceolate,leaf,length,lilac,longer,minutely,mm,moderately,obovate,occasionally,orange,ovate,pale,per,perennial,petiole,plant,prickle,purple,red,reniform,rhizomatous,rostrate,rugose,shrub,sparsely,stellate,stellate-pubescent,stigma,style,surface,time,unbranched,wide,yellow	%,0-0.2,0-0.3,0-0.5,0-1,0-16,0-2,0-55,0-80,0-9,0.15-0.25,0.2-0.25,0.2-0.3,0.2-0.5,0.25-0.4,0.4-0.7,0.5-2,0.8-5,1-2,1.1-1.8,1.5-2.5,1.8-3.5,10-18,100-150,12-25,2-4,2-foliate,2-locular,2.1-3.2,2.5-3.6,22-31,3-10,3-5,3-7,3-7.5,3-8,4-7,4.7-5,5-10,5-merou,6-12,6-8,6-9,7-10,7-9,8-10,9-16,9-25,abaxially,absen,absent,accrescent,acicular,across,acuminate,acute,adaxiall,adaxially,adult,alyx,andromonoecious,anvil-shape,apart,apex,apiculate,articulated,axe,ba,base,blade,branche,brown,capitat,confined,connivent,contiguous,cross-section,cuneate,decimetre,directed,distall,distally,distributed,eaf,eed,eglandular,entire,especially,exocarp,finger,flattened,fruiting,functional,geminat,gland-tipped,hair,half,hetereostylous,juicy,lamina,lateral,less,lobe,lobed,long,loosely,lower,margin,markedly,mature,mesocarp,mid-point,midpoint,midrib,midvein,minute,moist,narrowly,nearly,nflorescence,oblique,obtuse,orolla,pair,part,pedicel,peduncle,placenta,pore,porrect,present,rachi,ray,ruit,rusty,scarcely,sessile,shallowly,short,side,simple,sometimes,spaced,stalked,stellae,straight,summit,tal,tamen,tem,thick,thicker,throughout,tip,toward,transparent,triangular,tube,unarme,unarmed,unit,upper,vary,vein,weakly,x,ympodial	abaxial,adaxial,capitate,color,corolla,density,form,growth,height,number,ovary,position,seed,shape,staman,stem,texture,width
475	wfo-0001029246	success	209	101	84	125	17	0.402	-1,-1.5,0,0.1-0.4,0.5,0.7-1.3,0.7-2,0.8-1.1,1-1.5,1-4,1.5-2.3,1.5-2.5,1/3,2,2.5-3.2,2.8-4,3-5,3.5-5,5-20,abaxial,abaxially,adaxial,almost,anther,apart,apparently,berry,chartaceous,cm,concolorous,connivent,curved,diameter,discolorous,drying,dull,elliptic,entire,erect,filament,flattened-reniform,flower,fruit,glabrescent,glabrous,leaf,length,less,lobed,margin,maturity,mauve,midvein,mm,moderately,orange-brown,orange-red,pale,pedicel,peduncle,per,petiole,poricidal,prickle,procumbent,purple,scar,shrub,smooth,sometimes,sparsely,spherical,stellate,stellate-pubescent,stout,straight,style,surface,tapering,tip,unbranched,upper,white,yellow	-4,/5,0-15,0-5,0.1-0.3,0.15-0.3,0.2-1.5,0.3-0.5,0.3-0.8,0.5-1.5,0.7-1.5,0.8-3,0.9-1.3,1-1.8,1-10,1-3,1-5,1-8,1.2-2,1.5-6,1.7-6,1.8-3,1/10-1/5,2-3,2-3.5,2-5,2/3,2/3-3/,3-20,4-6,5-,5-merous,6-10,6-8,7-12,8-16,acuminat,acuminate,acute,alyx,apar,apex,apically,articulated,bark,base,blade,broad-deltate,c.,calyx,cuneate,deltate,densely,distance,eaf,eed,elongating,equal,extending,eye,flattened,free,fruiting,infructescence,lateral,lobe,lon,long,longer,lower,mature,midpoint,naked,narrow-deltate,narrow-ovate,nflorescence,oblong,obtuse,older,one,open,orange-brow,orolla,oung,pair,pendulous,perfec,pericarp,plurifoliat,porrect,portion,prickl,prickly,primary,pubescent,ray,recurved,rounded,ruit,sessile,side,simple,spaced,spreading,stem,strongly,tamen,terete,tertiary,time,trichome,tube,unarmed,unit,usually,vary,vein,venation,visible,way,wide,woody,yellow-orange,ympodial,¼	color,corolla,form,growth,height,inflorescence,number,ovary,perfect,plant,reproduction,seed,shape,spacing,staman,texture,width
476	wfo-0001029263	success	211	124	96	115	28	0.455	0-2.5,0-5,0.3-1,0.5-1.5,0.6-1.5,1,1-10,1-4,1-7,1.2-2.5,2-3,3-5,3.5-5,30-60,4-7,5-merous,almost,andromonoecious,anther,apex,apically,attenuate,bark,base,berry,black,broad,broad-deltate,calyx,cell,chartaceous,cm,corolla,cream,cultivar,dark,deep,diameter,dull,elliptic,entire,erect,evenly,filament,flattened-reniform,flower,fruit,fruiting,glabrous,green,herb,lateral,leaf,length,lobe,lobed,long-styled,margin,marking,maturity,mauve,mm,obtuse,orange,orange-brown,outline,pale,pedicel,peduncle,pendulous,petiole,pit,plant,purple,raised,red-brown,rotate,rounded,short-styled,simple,small,smooth,spherical,stem,style,surface,terete,tertiary,unbranched,usually,venation,visible,white,woody,yellow,young	-2,0-100,0.5-1,1/2,1/3-2/3,1/3-3/4,1/4-1/3,1/6,10-20,10-35,12-35,2-4,2.2-3.2,2.8-3.8,4-10,4-6,5-10,5-8,6-20,6-30,7-10,acute,alyx,apar,apparently,articulated,ba,becoming,blade,concolorous,connivent,cuneate,curved,decurren,deltate,difoliate,distal,distance,drying,eaf,eed,elongating,equal,extending,extensive,foliaceou,free,fully,geminat,glabrescent,glandular,hair,hermaphrodite,heterostylous,infructescence,less,lobing,long,long-acuminat,longer,lower,lowermost,mature,midvein,minute,near,nflorescence,often,older,one,onl,open,opening,orolla,oung,ovoi,pair,part,per,pericarp,poricidal,portion,primary,reddi,reflexed,ruit,scar,secondary,side,sometimes,spaced,sparsely,spreading,staminat,stellate-pubescent,stout,straight,tamen,tapering,tearing,time,tip,trichome,tube,ud,unarme,unarmed,unit,upper,vary,vein,way,wide,wider,ympodial	/,abaxial,adaxial,apart,arrangement,color,colour,foliaceous,form,growth,height,history,inflorescence,life,na,number,ovary,pattern,perennial,position,reddish,reproduction,seed,shape,spacing,staman,stigma,texture
477	wfo-0001029286	invalid_json_followup	224	132	107	117	25	0.478	0-0.5,0.1,0.8,1-2,1.5-2,1.5-4,1/8,2.5-3,4-6,4.5-7,5-6,6-9,7-10,abaxial,abaxially,acute,adaxially,almost,altered,anther,anthesi,apex,apically,apiculate,attenuate,bark,base,branch,branching,broadly,brown,capitate,chartaceous,clustered,cm,concave,conical,corolla,curved,dendritic,density,diameter,dilated,distributed,domatia,drying,entire,faint,filament,flat,flexuous,formed,glabrescent,glabrous,green,grey,increasing,inside,lamina,leaf,length,less,liana,light,lilac,lobed,long,margin,mauve,membranous,midvein,minutely,mm,multicellular,obconical,oblong,obovate,outside,pair,pedicel,peduncle,petiole,primary,rachi,raised,simple,slender,smooth,sometimes,somewhat,sparsely,stem,stigma,style,surface,terminal,tertiary,toward,translucent-violet,trichome,tube,unarmed,vein,venation,widely,x,yellowish	.4,.5,0.15-0.4,0.4-1.2,0.6-1.2,0°,1-1.5,1.5-8,15-50,2-3,3-4,4-5,4.5,5,6-8,abscising,age,along,alyx,another,apar,apart,apice,apparently,arising,around,articulated,articulation,axil,becoming,branched,canaliculate,clearly,closer,concolorous,crenulate,cuspidate,delineated,deltoid,eaf,eed,equal,except,extending,fertilization,flower,forming,free,fresh,globo,hair,inflorescenc,isolated,junction,know,known,lengthening,lobe,lower,m.,main,margi,mas,meeting,middle,much,narrowly,nflorescence,nther,occasional,often,one,orolla,ovate,papillo,perfec,plurifoliat,pore,poricidal,portion,prominent,protruding,rarely,regular,rounded,ruit,scar,separated,shallowly,side,smaller,soon,specimen,spreading,stretchy,stump,tangled,tearing,terete,textur,thick,thickened,thinner,time,tip,tissue,together,translucent,tuft,ud,uneven,unit,vary,visible,wide,ympodial,young	'',[,``,adaxial,arrangement,calyx,characteristic,color,distribution,form,fruit,growth,inflorescence,na,ovary,papillose,position,seed,shape,spacing,texture,value,ye,{,}
478	wfo-0001029289	success	292	141	119	173	22	0.408	0.2-1.5,0.4-1.1,0.4-2,0.5,0.5-1,1-2,1-2.5,1-4,1.5-4,1.5-5,100,12,15,15-45,2-3,2.5,2.5-4,25,3-7,5-20,6-12,8,acuminate,acute,adaxial,almost,anther,apex,apically,bark,base,berry,black,branch,brown,calyx,capitate,clavate,cm,complex-dendritic,conical,corolla,cupular,deeply,delineated,dendritic,development,diameter,dilated,distributed,drying,erect,evenly,filament,finely,flattened,flower,forming,glabrescent,glabrous,globose,green,hard,honeycomb,inside,leaf,length,liana,light-coloured,lobed,longitudinally,margin,maturity,mm,obconical,oblong,obovate,orange,outside,pale,pattern,pedicel,peduncle,petiole,pili,pitted,point,prominent,puberulous,pubescent,rachi,reddish,reniform,ridged,scar,seed,shape,simple,size,smooth,sometimes,spheroidal,stigma,straight,stump,sturdy,style,surface,terminal,thick,trichome,undulate,unicellular,violet,white,widely,x,yellow,yellowish	.05,.2,.5,0-2,0.15-0.25,0.4-1,0.5-0.7,0.5-1.2,1-1.2,1.2,1.5-2,1/6-1/3,1mm,3,4-9,4.5,5-12,60-90°,abaxially,accrescent,adaxially,age,along,always,alyx,anthesi,apar,apice,apparently,appendage,arachnoid,arising,aristate,around,articulated,articulation,attenuate,becoming,boundary,branched,branching,broadly,canaliculate,chartaceous,clear,clearly,close,collapsing,complexity,concolorous,covering,crenulate,cuneate,curved,cuspidate,deltoid,dense,detaching,developing,discolorous,domatia,dorsally,eaf,eed,ellipsoi,elongated,entire,equal,eye,faint,fertilisation,flexuous,found,free,fruiting,hair,half,indumentum,inner,irregular,lamina,leave,lengthening,less,line,linear,lobe,long,loop,lower,m.,main,margi,may,middle,midvein,minute,minutely,mixture,multicellular,naked,narrowly,nflorescence,nther,often,one,orolla,outer,outline,pair,papillae,papillo,papillose,pendulous,perfec,pericarp,pit,plurifoliat,pointed,pore,poricidal,portion,primary,pronounced,protruding,raised,rarely,reveal,rising,rounded,ruit,see,shallow,shallowly,shiny,short,side,sinus,slightly,somewhat,soon,sparse,sparsely,spreading,stem,strongly,sunken,tearing,terete,tertiary,thickened,thin,thin-coriaceous,time,tip,together,toward,truncate,tube,tuft,ud,unarmed,unit,usually,variable,various,vary,vein,venation,visible,wide,ympodial,young	0.05,abaxial,apart,arrangement,bud,color,colour,ellipsoid,form,fruit,growth,height,inflorescence,na,number,ovary,plant,position,reproduction,spacing,staman,texture
479	wfo-0001029295	success	191	143	118	73	25	0.618	0.5,0.7-1,1,1-1.5,2,2-3,2/3,3/4,4-6,5-6,<,?,abaxial,acuminate,acute,along,anther,anthesi,apex,articulated,attenuate,bark,base,berry,calyx,capitate,closely,cm,continuous,corolla,crystal,dark,dense,diameter,drying,ellipsoid,elliptic,elongate,entire,exserted,fide,filament,flower,free,fruit,glabrescent,glabrous,globose,green,grey,height,herb,internodal,known,lateral,leaf,length,lengthen,lobed,margin,membranous,midrib,minute,minutely,mm,nodding,obtusely,opening,orientation,ovary,ovoid,pair,pale,papillate,pedicel,peduncle,petiole,pitted,pore,portion,primary,purple,red,reniform,rhomboidal,ripe,rounded,sand,scattered,shallowly,short,shrub,simple,sinuate,slit,small,spaced,stem,stigma,style,surface,tan,thin,tip,tissue,top,trichome,tube,uniseriate,urban,vein,way,whitish,wing,wiry,woody,x,yellowish	-5,-9,.5,0,1.2-3.5,2-4,2.5-3.5,2.5-6,4-4.5,4-5-celled,4-merous,6-8,apparently,appearing,become,cell,cup-shaped,deciduous,defined,defoliate,distal,eaf,eed,erect,essentially,fruiting,geminat,glabrou,half,irregular,lamina,lobe,lobe-lik,long,lower,narrowly,nflorescence,older,outline,papillat,peduncl,peelin,pentagonal,per,perfect,pericarp,pointed,prolonged,puberulent,pubescent,rim,rooting,ruit,scar,seen,sessile,slightly,soon,sparsely,splitting,sprawling,strongly,testal,ud,unarmed,undulation,unifoliate,unit,upper,usually,widest,ympodial,young	adaxial,bud,color,colour,exsertion,feature,form,growth,history,inflorescence,life,number,peeling,perennial,plant,position,rachi,reproduction,seed,shape,spacing,staman,texture,unknown,width
480	wfo-0001029299	success	201	123	92	109	31	0.458	0.5-1.5,1-10,1-2,10-16,10-21,2.3-3.3,3,3-12,3-4.5,3-7.5,4-16,5-15,7-8,abaxially,acuminate,acute,adaxially,along,anther,apart,apex,articulated,axillary,broadly,brownish,bud,cell,clavate,cm,condition,corolla,covering,diameter,drying,elliptic,especially,filament,flower,forked,fresh,fruit,glabrous,glandular,green,green-white,greenish,hair,hair-like,herb,interjected,lateral,leaf,leaflet,like,make,medium,midrib,minutely,mm,moderately,mucilaginous,multicellular,non-glandular,odd-pinnate,orbicular,ovate,ovoid,pedicel,peduncle,pentagonal,petiole,petiolule,plant,puberulent,pubescent,rotate,seed,stem,stigma,style,subtending,terminal,testal,thick,throughout,trichome,tuber,wall,wet,white,whitish,yellow	0-3,0-5,1-4,1.6-5,16-28.6,2-4,3-13,3-5,3.5-7.5,4-10,5-merou,6-5-15.3,8.5-19,acumen,ag,alyx,apparently,attenuate,axe,base,blade,borne,capitat,chartaceous,ciliate,connate,cordate,cuneate,decreasing,decurrent,dense,digestion,distal,dorsally,eaf,edge,eed,end,enzyme,erec,exceeding,flat,folded,geminat,generally,grading,gradually,half,homostylous,honeycomb-shaped,invested,lanceolate,lengthening,living,lobe,long,lower,margin,membranous,middl,mottled,nflorescence,oblique,orolla,pair,perfect,petiolulate,plurifoliate,pore,poricidal,pubescence,purple,removed,rounded,ruit,sessile,seudostipule,shallowly,short,singly,size,slightly,slit,spaced,specimen,spreading,stamen,ste,stolo,straight,subsessile,tall,tamen,tem,tip,tissue,toward,tri-,truncate,tube,typically,unit,unknow,usually,vary,wide,wing,x,ympodial	5-merous,abaxial,adaxial,arrangement,capitate,color,colour,form,growth,height,history,inflorescence,length,life,middle,na,number,ovary,perennial,position,pseudostipule,rachi,reproduction,shape,spacing,staman,stolon,surface,texture,unknown,width
481	wfo-0001029308	success	221	70	57	164	13	0.258	0.2-1.5,0.4-0.7,1-5,1.5-4,168,2-5,2-6,30-50,4-15,4-5,6-18,7-10,branch,brown,chartaceous,cm,densely,dm,elliptical,extra-axillary,flattened,flower,fruit,glabrous,globose,green,inflorescence,juvenile,leaf,length,longer,margin,minutely,mm,moderately,one,ovate,pale,pedicel,peduncle,per,petiole,prickle,rachi,reticulate,rusty,seed,simple,stellate-pubescent,surface,time,toward,unbranched,wide,yellow,yellowish,yellowish-green	%,0-10,0-25,0-4.5,0.05-0.3,0.2-0.3,0.25-0.3,0.25-0.35,0.25-0.4,0.25-1,1,1-4,1.2-2.5,1.5-2.5,1.5-2.7,1.5-3,1.5-5.5,19-30,1981,2-foliate,2-locular,2.2-2.7,2.5-3,2.7-3.1,20-40,3-4,3-6,3.5-4.5,4-6,4-8,4.3-15,4.5-6,5-merou,6-11,6-8,7-8,8-19,9-18,9.5-28,abaxially,absen,absent,acicular,across,acuminate,acute,adaxiall,adaxially,adult,alyx,andromonoecious,anther,anvil-shape,apart,apex,articulated,axe,ba,base,blade,branche,broad-based,broadly,calyx,capitat,confined,connivent,counted,cross-section,cuneate,cylindrical,decimetre,deltate,diameter,directed,distall,distributed,eaf,eed,eglandular,elliptic,entire,erect,exocarp,finger,fruiting,functional,furrowed,geminat,gland-tipped,hair,half,heterostylous,interpetalar,juicy,lamina,lanceolate,lateral,less,lilac,lobe,lobed,long,loosely,lower,margi,mature,mesocarp,mid-point,midpoint,midrib,midvein,minute,moist,nearly,nflorescence,oblique,orolla,pair,part,perennial,placenta,plant,pore,porrect,present,purple,ray,rhizomatous,rotate-stellate,ruit,sessile,shallowly,short,shrub,side,spaced,sparsely,stalked,star,stellae,stellate,stigma,straight,style,tal,tamen,tem,thick,thickened,throughout,tissue,triangular,tube,unarme,unarmed,unit,upper,vary,vein,weakly,x,ymon,ympodial	abaxial,adaxial,arrangement,colour,count,density,number,position,shape,stem,texture,thicknes,width
482	wfo-0001029310	success	216	127	106	110	21	0.491	-16,-25,.5,0.1-0.2,0.2-0.8,0.5-3,1-1.5,1-2,1-4,1.2-1.5,10-13,10-20,15-20,2-3.5,2-4,2.5-6,2/3-3/4,3-4,4-10,45-60,5-10,5-12,5-6,5-merous,accrescent,acute,andromonoecious,anther,apart,apex,bark,base,berry,beyond,calyx,cm,conical,connivent,cordate,deltate,diameter,distance,dull,enclosing,erect,filament,flattened-reniform,flower,fruit,fruiting,gently,glabrescent,glabrous,gray,hair,herb,lateral,leaf,length,lobed,margin,mature,mauve,membranous,midpoint,midvein,mm,orange-green,ornately,pair,pedicel,peduncle,pendent,petiole,pinnatifid,plant,poricidal,porrect,prickle,primary,ray,recurved,sessile,shorter,shrub,simple,smooth,spherical,stalked,stellate,stem,stout,straight,strongly,style,surface,tapering,terete,tertiary,tip,trichome,truncate,vein,venation,visible,yellow	.1,.6,/4,/6,0-20,0-5,0.2-0.3,0.5,0.6-1.1,00,1,1.8-3,1/,10,10-15,20-40,20-60,200-500,3-5,3.5,4-8,5,5-20,5-30,5-7,5-8,6-8,7-12,7-13,8,abaxially,alyx,ame,apar,apically,apparently,articulated,blade,branched,brown,c.,concolorous,dark,difoliate,distal,drying,eaf,eed,elliptic,elongating,equal,extending,filifor,free,geminat,hermaphrodite,heterostylous,inflated,infructescence,lobe,lobing,lon,long,long-styled,longer,lower,lowermost,maturity,minute,moderately,narrow-deltate,nflorescence,older,one,open,orolla,oung,pendulous,per,pericarp,perpendicular,portion,prickl,prickly,red-brow,retrorse,ruit,scar,secondary,short-styled,side,sometimes,spaced,sparsely,spreading,stalk,staminat,stellate-pubescent,tamen,time,tissue,toward,tube,unit,variously,vary,way,wide,woody,ympodial	abaxial,adaxial,color,colour,corolla,extension,form,growth,height,inflorescence,number,ovary,present,red-brown,reproduction,seed,shape,spacing,staman,texture,width
483	wfo-0001029317	success	151	99	69	82	30	0.457	0.25,0.5,0.8-1,1-1.5,10-16,2-3,2.5-5,7-8,8-9,acuminate,anther,anthesi,apex,area,attenuate,base,beneath,bud,calyx,channeled,closely,cm,corolla,deflexed,densely,filament,glabrous,globose,inflorescence,leaf,lobed,margin,minutely,mm,narrowly,opposite,ovary,ovate,overlapping,paler,papillose,pedicel,petiole,pore,prominent,pubescent,rachi,raised,rounded,shaped,shrub,simple,slender,slightly,spaced,sparsely,stigma,straight,style,tapering,tear-drop,thickened,tip,trichome,tube,uniseriate,vein,white,yellowish	.5,0.5-0.75,0.5-1,1,1.5-3.5,10-30-flowered,11-14,6-8,6.5-11,along,apar,barely,broadly,brow,ca,cup-like,deciduou,deltoid,denser,dia,differing,difoliate,dry,eaf,edicel,eed,ellipsoi,epidermi,erect,exserted,extreme,free,frui,fruiting,geminate,glabrate,grayish,immature,known,lateral,like,lobe,lon,long,lower,main,major,middle,minor,nearly,nflorescence,occasionally,often,older,one,otherwise,ovoid,pair,poricidal,portion,probably,proximal,reflexed,remaining,rest,ruit,scar,size,soft,soon,specimen,stem,styl,tall,tuft,ud,unit,visible,widest,x,ympodial,young	10-30,2,5,abaxial,adaxial,color,deflexion,diameter,flower,form,fruit,growth,height,history,length,life,na,number,peduncle,perennial,plant,position,seed,shape,spacing,staman,straightnes,surface,texture,width
484	wfo-0001029332	success	197	133	114	83	19	0.579	-5,/3,0,0-0.5,0.1,0.1-0.2,0.5-1,1-1.5,1-3,1-4,1.3-1.5,1.5-2,1/3,1/4,10-30,2,2-2.5,2-4,2.8-3.7,2/3-3/4,3-4,4-10,4-15,5-merous,8.5-9.5,abaxial,abaxially,adaxial,andromonoecious,anther,apart,apex,apically,articulated,bark,base,berry,broad-deltate,calyx,chartaceous,cm,concolorous,conical,connivent,cordate,curved,densely,diameter,distance,drying,elongating,erect,extending,filament,flattened,flattened-reniform,flower,fruit,fruiting,glabrescent,glabrous,leaf,length,lobed,long,lower,margin,mature,maturity,mauve,midvein,mm,moderately,orange-brown,ovate,pale,pedicel,peduncle,pendulous,petiole,plant,poricidal,porrect,prickle,prickly,pubescent,rounded,scandent,sessile,shrub,slender,smooth,spherical,spreading,stalked,stellate,stellate-pubescent,stem,style,surface,tapering,terete,tertiary,tip,trichome,unbranched,variously,venation,visible,way,weakly,yellow,yellow-green,yellow-orange	.5,0-100,0-2,0-20,0-4,0-5,0.15-0.2,0.15-0.25,0.8-1,1-2,1/2,1/4-1/3,2.5-3.5,2/,3-6,3.5-5,5-6,5-8,6-8,alyx,apar,apparently,becoming,blade,difoliate,distal,eaf,eed,equal,free,geminat,gland,globular,grayi,herbaceous,hermaphrodite,heterostylous,infructescence,lateral,less,lobe,long-acuminat,long-styled,longer,lowermost,midpoint,narrow-deltate,nflorescence,often,older,one,open,orolla,oung,pair,per,pericarp,portion,prickl,primary,ray,reduced,ruit,scar,short-styled,shorter,side,simple,spaced,stalk,staminat,subsessile,tamen,terminal,time,tube,unit,upper,vary,vein,wide,woody,ympodial	2/3,color,corolla,extension,form,grayish,growth,height,inflorescence,number,ovary,reproduction,seed,shape,spacing,staman,stigma,texture,width
485	wfo-0001029333	success	155	101	71	84	30	0.458	.25,.5,0.5,0.7-1,1-1.2,1-1.5,1-15,1-7,2-2.5,5-6,abaxial,abaxially,acuminate,acute,adaxially,anther,apex,bark,base,beige,clavate,cm,contracted,corolla,deflexed,dendritic,dendritic-pubescent,densely,dry,elliptic-obovate,erect,filament,flattened-reniform,flower,fresh,fruiting,glabrous,globose,golden,green,incrassate,leaf,lobed,long-styled,margin,minutely,mm,obovate,opposite,ovary,pale,paler,pedicel,petiole,pitted,pubescent,reddish-brown,shape,shining,short-styled,shrub,simple,somewhat,spaced,sparsely,stigma,strongly,style,surface,trichome,woody	/4,0.5-1,1-2,1-3,1.5-2,1.5-2.5,1.5-3,10-15-flowered,100,17-26,3-7,3-7.5,8-15,9-13,along,anisophyllou,anthesi,auriculate,ba,beneath,berry,broadly,calyx,conical,denser,dia,differing,difoliate,eaf,edicel,eed,exserted,free,geminate,heteromorphic,inflorescenc,lateral,like,lobe,lon,long,lower,main,major,minor,nflorescence,occasionally,older,orbicular,overlappin,pair,papillo,planar,pore,poricidal,portion,present,pubescence,rest,rounded,ruit,scar,sessile,shaped,size,slender,small,stem,tall,tear-drop,time,tip,tree,triangular,truncate,tube,type,ud,unit,vein,way,wide,ympodial,young	10-15,adaxial,arrangement,bud,color,colour,contraction,deflexion,diameter,form,fruit,growth,height,history,inflorescence,length,life,na,number,peduncle,perennial,plant,position,rachi,reproduction,seed,spacing,staman,texture,width
486	wfo-0001029334	success	211	107	77	134	30	0.365	0.15-0.3,1,1-10,1-2,1.3-4.5,1.5-6,1.8-2.9,2,2-8,4-5.5,5-10,8-30,9-12,abaxially,acute,adaxially,almost,anther,apex,brownish,cell,chartaceous,clavate,cm,condition,corolla,covering,diameter,drying,filament,flower,forked,fresh,fruit,glabrous,globose,green,greenish,hair-like,herb,lateral,membranous,minutely,mm,odd-pinnate,orbicular,ovate,ovoid,pedicel,peduncle,petiole,plant,plurifoliate,puberulent,pubescent,pure,ripe,rounded,seed,shady,situation,size,stellate,stigma,style,terminal,testal,thick,tinged,tri-,tuber,unit,violet,wall,white,whitish,yellow	.2,0-4,1-3,1-6,1.5-3.9,2-2.5,2-4,2-5,2.5-3,3-5,3-7,3.2-5.8,3.3-6.5,4-8.5,5-merou,7.5-15.5,absent,acumen,ag,along,alyx,among,apart,apparently,articulated,attenuate,axe,axillary,base,berry,blade,borne,broadly,bud,capitat,ciliate,connivent,cordate,cuneate,decreasing,decurrent,densely,digestion,distal,dorsally,eaf,edge,eed,elliptic,end,enzyme,erect,especially,exceeding,except,flat,folded,geminat,generally,glabrou,gradually,grassland,greatly,green-white,hair,half,homostylous,honeycomb-shaped,interjected,lanceolate,leaflet,lengthening,like,living,lobe,long,low-growin,lower,make,margin,middl,midrib,mucilaginous,narrowly,nflorescence,oblique,obtuse,often,orolla,pair,perfect,petiolulate,petiolule,pore,poricidal,proximal,rarely,reduced,removed,ruit,semi-rosette,sessile,seudostipule,short,singly,slightly,slit,spaced,specimen,stamen,ste,stem,stolo,straight,subequal,subsessile,subtending,sunny,tall,tamen,tem,throughout,tip,toward,tube,typically,unwinged,usually,vary,wet,wide,woodland,x,ympodial	abaxial,adaxial,arrangement,capitate,color,colour,form,growth,height,history,inflorescence,leaf,length,life,na,number,ovary,perennial,position,pseudostipule,rachi,reproduction,shape,spacing,staman,stolon,surface,sympodial,texture,width
487	wfo-0001029340	success	286	100	87	199	13	0.304	0.2–0.5,0.4,0.5–2.5,0.8–3.2,0–,1-2,1.4–1.8,1–1.2,1–2,1–2-celled,2,20,2–10,2–8,3–5-celled,3–6-celled,3–7,5–12,8–12.5,abaxial,absent,adaxial,anther,bluish,bright,brown,capitate,cm,conical,curved,densely,depressed-spherical,diameter,evenly,filament,flattened-reniform,flower,foveolate,fruit,glabrous,gland-tipped,glandular,glandular-puberulent,hair,hyaline,lateral,leaf,like,long,many,minutely,mm,orange-yellow,pale,pedicel,peduncle,petiole,pilose,prickle,prickly,purple,ray,sessile,shiny,simple,soft,soft-pilose,sparsely,spherical,spreading,spreading-pilose,stellate,stem,stigma,stout,straight,style,suborbicular,surface,tapering,terete,tough,trichome,unbranched,variously,yellow,yellowish	'',-celled,.05,.2,.2–1.6,0,0.15–0.6,0.5,0.5–2,1,1.2–2.0,1.2–2.2,1.5-3,1/2,1/4,10,100,13–15,1–,2.5,2–2.2,2–3,2–3.2,2–5-celled,3,3.5–5.5,3–3.5,3–5.3,4,4–4.5,4–8,5,5-merous,5°,8–17,9–20,>,``,abaxially,abruptly,acicular,acute,age,almost,alyx,angle,anthesi,apex,apical,apicall,armed,around,articulated,ba,basal,base,becoming,berry,bilobed,blade,branched,broad-based,calyx,coarse,column,compressed,concentrated,connivent,cordate,curving,cylindrical,darker,developin,difoliate,directed,duller,eaf,eed,elongate,embedded,equal,exceeding,exceptionally,expanded,expanding,extending,falling,fertile,free,frui,fruiting,geminat,geminate,gland,grading,gradually,greater,green,greenish,held,heterostylous,infructescence,irregularly,lanceolate,larger,largest,less,light,linea,lobe,lobed,lon,long-styled,lower,lowermost,main,major,margin,mature,maturity,mesocarp,midpoint,midrib,minute,mixture,mostly,much,narrowed,narrowly,near,nearly,nflorescence,nipple,occasionally,often,one,orange,orolla,oung,ovoid,pair,papillat,per,pericarp,perpendicular,pore,poricidal,portion,pulp,rarely,recurved,reflexed,ruit,secondary,senescent,sharp,short,short-styled,shorter,shrivelling,shrub,similar,single,size,slightly,small,smaller,smooth,somewhat,soon,spongy,ste,stipitate,stipitate-glandular,strongly,tall,tamen,thin,thin-textured,tinged,tip,tooth,triangular,tube,twice,two,unarme,unarmed,uniseriate,unit,usually,vary,vein,viciously,way,white,whole,wide,ympodial	arrangement,color,corolla,inflorescence,length,number,ovary,position,seed,shape,staman,texture,ye
488	wfo-0001029344	success	147	93	65	82	28	0.442	.5,0.4-1,0.5-1,0.5-1.5,1,1-5,1.5,1.5-3,1.5-4,10-20,4-6,5-15,absent,acute,anther,apex,base,brown,center,chartaceous,cm,cordate,diameter,dm,drying,edge,elliptic,elliptic-ovoid,filament,fine,flower,fruit,glabrous,globose,herb,immature,long,margin,maturing,membranaceous,mm,moderately,nearly,oblong,obtuse,parallel,pedicel,peduncle,petiole,pubescent,rachi,radiating,raised,ridge,rotate,running,semitransparent,shallow,sparsely,stigma,style,surface,white,x,yellow	0.5-3,1-2,1-3,1-6,10-35,2-3,2-3-celled,2-4,2-7,3-10,5-12,abaxially,abundant,adaxiall,adaxially,along,axe,berry,beyond,blade,calyx,ciliate,connected,decurrent,dehiscing,densely,denser,difoliate,eaf,eed,emarginat,entire,equal,explosively,exserted,flat,frui,geminat,hair,held,interpetalar,lacking,linear-lanceolate,lobe,lower,lying,maturit,mesocarp,nflorescence,notch,obvious,often,one-,orolla,per,placenta,pressure,pubescen,rhizomatous,rounded,ruit,short,slightly,sometimes,stamen,straight,swollen,tal,tamen,tem,tissue,triangular,tube,two-celled,unbranched,unit,vary,vein,watery,wid,woody,ympodial	abaxial,adaxial,arrangement,color,colour,corolla,emarginate,form,growth,height,history,inflorescence,leaf,length,life,na,number,ovary,perennial,plant,position,reproduction,seed,shape,spacing,staman,texture,wide
489	wfo-0001029363	success	152	106	78	74	28	0.513	.25,0-0.1,0.2-1.1,0.5-1,1,1-1.2,2-6,3-7,6-7,acuminate,acute,anther,apex,bark,base,becoming,beneath,bi-lobed,bud,calyx,capitate,closely,cm,corolla,cup-shaped,deep,densely,drying,edge,elliptic,filament,fruit,glabrous,globose,green,greyish,larger,leaf,maroon,meeting,minute,minutely,mm,much,narrowly,occasionally,opposite,ovary,overlapping,pale,papillose,pedicel,petiole,pore,poricidal,pubescent,shiny,shrub,simple,slender,slit-like,small,spaced,sparsely,stem,stigma,style,surface,tapering,tip,tree,trichome,tube,tuft,uniseriate,upon,white,yellowish	.75,/4,0.1-0.5,0.5,1.5-1.7,1.5-3.5,4-11,5-7-flowered,6-8,7-10,anthesi,axil,ba,beginning,berry,coroll,deflexed,deltoid,dia,eaf,edicel,eed,erect,except,exsertion,free,fruiting,immature,inflorescenc,internodal,known,lamina,later,lateral,lobe,lobed,lon,long,lower,main,margin,mature,middle,near,nflorescence,obtuse,often,older,pair,paler,papillo,portion,prominent,reflexed,ruit,scar,somewhat,sparse,straight,tall,terminal,thickened,ud,unifoliat,unit,usually,vein,way,white-papillose,wide,widest,woody,ympodial,young	5-7,abaxial,adaxial,arrangement,colour,diameter,flower,form,growth,height,history,inflorescence,length,life,na,number,peduncle,perennial,plant,position,rachi,reproduction,seed,shape,spacing,texture,unifoliate,width
490	wfo-0001029364	success	153	83	56	97	27	0.366	0.2-0.5,1-3,1-5,1.5-2,2,2-6,8-15,acuminate,anther,apex,base,calyx,chartaceous,cm,color,corolla,cream,cuneate,diameter,elliptic,entire,extra-axillary,filament,flower,fruit,glabrous,globose,green,greenish,herb,lobe,margin,minutely,mm,moderately,narrowly,nearly,ovate,perfect,petiole,puberulent,radiu,shrub,simple,sparsely,spot,stellate,stigma,style,triangular,tube,unbranched,unknown,white,x,yellow	-2,-3,-6,.5,1,1-,1-4,10-27,191.,2-,2-foliat,3-4,4-12,4-9,5-,5-11,5-9,6-8,7-9,8-10,?,abaxially,according,acute,adaxially,aggregate,apart,around,articulated,axe,ba,bitter,blade,blue,cell,center,connivent,curled,cylindrical,darker,deep,directed,distall,distally,eaf,ed,fide,finger,free,gland-tipped,glandular-puberulen,hair,immature,inserted,long,lower,major,membranaceous,mesocarp,nflorescence,obtuse,orolla,part,pedicel,peduncle,pore,presence,present,puberulen,pubescent,rachi,ripe,ruit,rusby,sagittate,shallow,short-tomentose,shorter,side,small,spaced,stone,strongly,tal,tamen,tapered,tem,thecae,tightly,time,tomento,truncat,unit,vary,vein,wide,ympodial	1-2,abaxial,adaxial,arrangement,colour,form,glandular-puberulent,growth,height,history,inflorescence,insertion,leaf,length,life,na,number,ovary,plant,position,reproduction,seed,shape,staman,surface,texture,truncate
491	wfo-0001029368	success	139	93	60	79	33	0.432	0.5-2,1.5-1.6,1.5-3,1.5-4,2-5,2.5-4,5-6,acuminate,anther,apex,bark,broadly,calyx,capitate,closely,cm,conical,corolla,deflexed,densely,elliptic,erect,filament,flower,fruit,fruiting,glabrous,globose,green,herb,indistinct,inflorescence,internodal,leaf,lobe,margin,minute,minutely,mm,obtuse,opposite,ovary,papillose,pedicel,petiole,pore,puberulent,reflexed,shaped,shrub,simple,somewhat,spaced,stigma,straight,style,tear-drop,tip,tube,white	.2,.25,.5,0,0.9-1,1.5-2,11-13,16-25,?,abaxially,acute,adaxially,along,anthesi,apparently,base,bearing,berry,bitter,borne,breaking,brow,coarse,crumpled,cup,dia,distal,eaf,edicel,eed,exserted,few-branched,fide,flattened,free,golden,half,inflorescenc,known,lamina,lanceolate,lateral,leaving,like,long,lower,main,margi,middle,midrib,nflorescence,non-flower,older,one,overlappin,pair,papillo,parallel,poricidal,portion,rest,ruit,scar,stem,strongly,tall,trichome,ud,unifoliat,uniseriate,unit,upper,vein,widest,winged,woody,x,ympodial,young	0.5,1,1.5,abaxial,adaxial,arrangement,brown,bud,color,colour,diameter,form,growth,height,history,length,life,na,number,peduncle,perennial,plant,position,rachi,reproduction,seed,shape,spacing,staman,surface,texture,unifoliate,width
492	wfo-0001029370	success	224	101	89	135	12	0.397	-32,0-35,0.1,0.2,0.5-2.2,1-2,1-3,1-4,1.5-6,3.5-8,5-12,5-merous,6-15,abaxial,adaxial,apex,articulated,bark,basal,base,berry,chartaceous,clearly,cm,cordate,cream,curved,dark,densely,erect,fine,flattened-reniform,flower,fruit,glabrous,green,greenish,heterostylous,lateral,leaf,length,lobe,lobed,margin,marking,mature,midpoint,mm,moderately,multangulate,obtuse,orange-brown,ornate,ovate,overlapping,pair,pale,pattern,pedicel,peduncle,petiole,plant,prickle,primary,ray,red-brown,reticulate,rounded,scar,shiny,slightly,smooth,sometimes,spherical,stalk,stellate-pubescent,stem,straight,style,surface,terete,tertiary,trichome,vein,venation,visible,whitish,yellow,young	-20,.1,.3,.5,/4,0-10,0-100,0-3,0.1-0.15,0.3,0.5-1,1,1.8-2.5,1.8-2.8,1/3-1/2,1/4-1/3,10-17,10-40,10-50,12-17,15-30,2-10,2-20,2-3,2-6,2.5-3.5,3-4,3.5-4,3/,4-6,4-7,4-9,5-10,5.5-7,7-11,7-13,8-14,8-20,8-23,abaxially,acut,almost,alyx,ame,andromonoecious,anther,apar,apart,apically,apparently,blade,branched,broad-deltate,c.,calyx,conical,connivent,diameter,discolorous,distal,distance,drying,eaf,eed,elongate,elongating,equal,extending,fewer,filament,flattened,free,fruiting,fully,gently,glabrescent,herb,hermaphrodite,infructescence,long,long-styled,longer,lower,lowermost,maturity,mauve,midvein,mixture,nflorescence,often,older,one,open,opening,orange,orolla,oung,pendulous,per,pericarp,perpendicular,plurifoliat,poricidal,porrect,portion,prickl,prickly,rotate,ruit,sessile,short-styled,shrub,side,simple,spaced,spreading,stalked,staminat,stout,strongly,tamen,tapering,time,tip,tube,unarmed,unit,variously,vary,way,white,white-gra,wide,woody,ympodial	/,color,colour,height,inflorescence,number,seed,shape,spacing,texture,visibility,width
493	wfo-0001029373	success	199	105	72	127	33	0.362	5-merous,abaxial,acute,adaxial,anther,anthesi,apex,appressed,bark,base,berry,bud,calyx,cell,clavate,cm,conical,corolla,densely,diameter,ellipsoid,enclosing,entire,exerted,flattened-reniform,flower,fruit,fruiting,glabrous,globose,green,grey-brown,growth,herb,hilum,internodal,lateral,leaf,lobe,margin,middle,minutely,mm,moderately,mouth,outline,ovary,ovate-lanceolate,pedicel,peduncle,pentagonal,petiole,pitted,plant,pubescent,rounded,shallowly,shape,simple,spreading,stellate,stem,stigma,style,surface,testal,tip,tube,white,yellow,yellow-green,yellowish	.0–1.2,.2,.3,.5,.5–2.0,0.3–0.5,0.4–1.6,0.5–1.2,0.5–1.8,0.6–0.7,1.0–1.2,1.0–1.6,1.2–1.5,1.3–2.2,1.4–3.5,1.5–2.0,1.5–2.5,1.5–2.7,1.8–2.0,1.8–2.3,180°,2-celled,2.0–2.5,2.7–3.0,20–30,2–4-celled,3,3.5–4.0,30–40,3–5,4–5,4–6,5,5–6,6.8,8–9,abaxially,accrescent,acuminate,adaxially,age,apar,appearanc,arising,articulated,basal,bayonet,beyond,broadly,capped,cone,curved,deltate,developing,distal,eaf,eed,elongate,enclosed,filament,finger,free,fully,geminat,glandular-tipped,hair,half,halfway,immature,individual,laterally,lengthening,less,like,live,lobed,lon,long,lower,mature,mesocarp,minute,new,nflorescence,node,obtuse,older,pair,papillate,per,perfect,plurifoliate,pore,poricidal,portion,positioned,primary,reflexed,resembling,root,ruit,scar,seen,seudostipule,short,slightly,slit,smoot,spaced,still,straight,tall,tem,terete,thicker-walled,trailing,trichome,tub,ud,uniseriate,unit,upper,vein,wide,woody,ympodial,–5	0.3-0.5,0.4-1.6,0.5-1.2,0.5-1.8,0.6-0.7,1.2-1.5,1.3-2.2,1.5-2.5,1.5-2.7,1.8-2.3,2.7-3.0,20-30,5-6,apart,appearance,color,exertion,form,height,herbaceous,history,inflorescence,length,life,perennial,position,pseudostipule,reproduction,resemblance,seed,smooth,spacing,texture
494	wfo-0001029402	success	113	99	70	43	29	0.619	0.5-1,0.5-2,1-2.5,11-17,15-30,2,2-10,2-3,3-5,4-6,4-7,5-25,6-16,7-8,7-9,8-15,abaxial,acuminate,acute,apex,articulated,band,base,blade,branched,calyx,ciliolate,cm,color,connivent,cylindrical,deltate,diameter,directed,elliptic,flower,free,glabrous,inrolled,lanceolate,leaving,margin,mm,moderately,narrowly,often,papillose,pedicel,peduncle,petiole,pore,pubescence,pubescent,rachi,radiu,roughened,scale-like,scar,shrub,simple,somewhat,sparsely,stellate,stigma,style,surface,thickened,tip,unknown,x	3-4,3-6,4-8,7-11,abaxially,adaxially,apart,axe,chartaceous,denser,distall,eaf,eed,fleshy,forked,glabrate,glabrou,hair,lobe,long,lower,many-foliat,narrowed,nearly,nflorescence,nther,orolla,rachise,ruit,spaced,tal,tapered,tem,time,triangular,truncat,tube,unit,unknow,vary,violet,wide,ympodial	adaxial,anther,arrangement,colour,connivence,corolla,direction,distally,form,fruit,growth,height,history,inflorescence,leaf,length,life,na,number,ovary,perennial,plant,seed,shape,spacing,texture,thicknes,truncate,width
495	wfo-0001029404	success	154	125	91	63	34	0.591	-10,-5,0.5-1,1,1-4,1.5-2,2,2-3,2-8,2.5-22,20-35,3-4,5-10,5-20,5-6,6-8,abaxially,absent,acuminate,adaxially,aggregate,anther,apart,apex,articulated,base,branched,cell,center,cm,connective,cream,cylindrical,dark,darker,densely,diameter,distally,eglandular,ellipsoidal,flattened,flower,fruit,glabrous,glandular,green,hair,leaving,lemon,less,light,long,longitudinal,margin,mm,moderately,mottling,narrowly,orange,ovate,pedicel,pedicellar,peduncle,petiole,pink,pore,puberulent,pubescent,purple,rachi,remnant,shorter,shrub,simple,slightly,somewhat,star,stellate,stigma,stone,style,subcoriaceous,thecae,toward,tree,triangular,unbranched,vein,white,x,yellow	-1.5,-3,0-60-flower,15-25,2-4,2-5,2.5-3,3-5,3-8.5,4-foliat,5-24,6-9,6.5-34,8-12,acute,ape,apiculate,auriculate,axe,basal,beyond,blade,calyx,chartaceous,connivent,cordate,deltate,directed,eaf,eed,entire,exserted,fleshy,glandular-puberulen,lanceolate,lobe,lon,lower,nflorescence,nther,obtuse,orang,orolla,ovoid,perfect,presen,radiu,ripe,ruit,small,spaced,sparsely,tal,tem,time,tomento,truncat,tube,ud,unit,vary,wide,ympodial	20-60,abaxial,adaxial,arrangement,color,colour,corolla,direction,filament,form,growth,height,history,inflorescence,leaf,length,life,na,number,ovary,plant,position,presence,present,reproduction,seed,shape,spacing,staman,surface,texture,tomentose,truncate,width
496	wfo-0001029406	success	136	78	49	87	29	0.36	0.3-1,0.5-1,0.6-1,0.7-1.5,1-10,1.5-2.2,1.5-2.5,4-6,acute,anther,apex,arachnoid,arachnoid-pubescent,brown,brownish,clavate,cm,corolla,dark,elliptic,filament,glabrous,globose,green,greenish-white,leaf,lobed,minor,minutely,mm,ovary,ovoid,ovoid-reniform,pedicel,petiole,pitted,pubescent,shiny,shrub,slightly,small,stigma,style,surface,tree,trichome,waxy,white,woody	.5,1-1.5,1-2,1.5-5,2,2-11,2-3,2.5-3.5,28,3-9,30,4-18,7-12,abaxially,adaxially,along,anthesi,ba,bark,base,berry,broadly,bullate,calyx,conical,conspicuously,deciduous,deflexed,deltate,densely,dia,differing,difoliate,dry,eaf,eed,felt-like,free,fruiting,geminat,grayish-brown,grayish-green,impressed,large,lateral,lenticel,lilac,lobe,lon,long,lower,main,major,margin,matted,maturity,middle,nearly,occasionally,often,older,pair,pale,papillo,papillose,planar,pointed,population,pore,poricidal,portion,ruit,shaped,size,soon,stem,tall,tear-drop,tinge,tip,tube,unit,vein,wide,widest,ympodial,young	abaxial,adaxial,arrangement,color,colour,diameter,flower,form,fruit,growth,height,history,inflorescence,length,life,na,number,peduncle,perennial,plant,position,rachi,reproduction,seed,shape,spacing,staman,texture,width
497	wfo-0001029407	success	208	121	101	107	20	0.486	-6,.5,/3,0.1-0.25,0.4-0.7,0.4-1,0.5-0.7,0.5-1.5,0.5-2,0.7-1.2,1-1.4,1-3,1-4,2-4,3-4,5-7,5-merous,6-20,abaxial,abaxially,acute,adaxial,anther,apex,articulated,bark,base,berry,bright-red,cm,cuneate,curved,dark,densely,diameter,dull,entire,erect,filament,flattened,flattened-reniform,flower,fruit,fruiting,glabrescent,glabrous,gray-greenish,green-brown,leaf,length,lobed,long,margin,maturity,mauve,midpoint,mm,moderately,obtuse,occasionally,orange,orange-brown,ovate,pair,pale,pedicel,peduncle,pendulous,petiole,porrect,prickle,prickly,primary,rarely,ray,rounded,sessile,shorter,shrub,side,sometimes,spherical,stalked,stellate-pubescent,stem,straw-yellow,style,surface,terete,tertiary,trichome,unbranched,vein,venation,visible,way,white,wide,woody,yellow,yellow-green	-10,-2,-25,-4,-7,0,0-15,0-2,0-4,0-5,0.1-0.2,0.15-0.4,0.2-0.3,0.6,0.6-0.9,1,1-2,1-4.5,1.5,1.8-2.5,1/3,1/3-1/2,1/5,1/8-1/5,2-3,2-5,2.5-3,3-6,3.5-4.5,4-15,4-9,4.5-6,6-13,7-8,acut,almost,alyx,apar,apart,apically,apparently,blade,brow,calyx,chartaceous,connivent,deltate,difoliate,discolorous,drying,eaf,eed,elliptic,elongating,equal,evenly,free,geminat,geminate,green,infructescence,lateral,lengt,lobe,longer,lower,mature,nflorescence,older,one,open,orolla,oung,per,perfec,pericarp,poricidal,portion,prickl,pubescent,recurved,reflexed,ruit,scar,simple,slender,smooth,spaced,sparsely,spreading,stalk,stellate,stout,straight,strongly,tamen,tapering,thick,time,tip,tube,unit,upper,vary,weakly,ympodial,young	brown,color,colour,corolla,form,growth,height,inflorescence,na,number,ovary,plant,reproduction,seed,shape,spacing,staman,stigma,texture,width
498	wfo-0001029408	success	244	139	113	131	26	0.463	0.2-0.3,0.3-5,0.5-2.5,0.7-1.2,0.9-1.6,1-8,1.1-1.5,1.8-3.5,2-12,2-5,2.2-3.7,3-5,3.5-5,4-20,5-24,5-6.5,abaxially,accrescent,acuminate,acute,adaxially,anther,apart,apex,bark,becoming,branch,branched,broadly,brown,bud,calyx,clavate,cm,conical,corolla,dark,deltoid,dendritic-multangulate,diameter,echinoid,elliptic,filament,flower,fruit,fruiting,glabrous,globose,gray,green,growth,hair,honeycombed,indument,lanate,lanceolate,lateral,leaf,length,lilac,lobe,long-,long-attenuate,mixed,mm,mostly,multangulate,oblong,obscured,orbicular,ovate,pale,partly,pedicel,peduncle,persistent,petiole,porrect-stellate,pseudo-terminal,purplish,rachi,rarely,reniform,reticulate-punctate,ripe,rotate-stellate,sessile,short-,short-stalked,shrub,simple,slightly,small,stelliform,stigma,style,subcampanulate,suborbicular,suture,terete,testa,thin-stalked,time,tomentose,tomentum,tree,turbinate,velutinous,white,whitish,x,yellow,yellowish	-1.5,-10.5,-4.5,.2-3.5,/10,0,0-100,0.9-1.3,1.4-1.9,1.5-3,1.6-2.8,1.7-2.4,1/2,1/2-3/4,1/4,11-31,2-3.5,2-4,2.5-7,2/3,4-14,4-7.5,5-6,5-8,5-merou,7-12,adaxiall,ag,alyx,anthesi,apical-lateral,articulated,axe,axillary,ba,barely,base,berry,blade,blunt-tipped,capitat,chartaceous,continued,cuneate,decurrent,dehiscing,dendritic-echinoi,densely,develope,directed,distal,distall,due,eaf,echinoi,eed,entire,exserted,extend,faintly,few-rayed,fleshy,free,high,homostylous,inserted,interpetalar,introrse,lacking,large,lobed,long,long-stalked,longitudinal,lower,m.,main,many,margin,midvein,moderately,near,nearly,nflorescence,obtuse,often,older,orolla,ovate-lanceolate,overlapping,part,perfect,plurifoliate,pore,present,pubescent,rather,ray,relatively,ribbed,ruit,runk,short-attenuate,side,slit,sometimes,spaced,stamen,stem,subovate,tamen,thick,thick-stalked,thick-textured,tissue,tomentu,top,touching,toward,tube,unarme,unarmed,unit,usually,vary,vein,way,well,wide,ympodial,young	20-100,abaxial,adaxial,arrangement,capitate,color,colour,form,height,history,inflorescence,life,na,number,ovary,perennial,persistence,plant,position,reproduction,seed,shape,spacing,staman,surface,texture
499	wfo-0001029417	success	213	157	129	84	28	0.606	0-7,0.2-0.6,0.7-3,1-10,1-2,1-4,1.3-8,1.5-8,12,2.5-10,2.8-3.5,4-7,5-15,8-9,abaxially,acuminate,acute,adaxially,along,anther,apart,apex,apiculate,articulated,axillary,base,basiscopic,blue,broadly,brownish,bud,cell,central,chartaceous,ciliate,clavate,cm,coarsely,condition,corolla,covering,dark,decurrent,deep,diameter,digestion,distal,dot,drying,enzyme,erect,especially,filament,flower,forked,fresh,fruit,glabrous,globose,green,green-white,greenish,hair-like,half,herb,honeycomb-shaped,interjected,lateral,leaflet,lunate,make,margin,medium,membranous,midrib,minute,minutely,mm,moderately,mucilaginous,narrowly,non-glandular,odd-pinnate,often,orbicular,ovate,ovoid,pair,pedicel,peduncle,pentagonal,petiole,pilose,plant,puberulent,pubescent,purple,rarely,removed,ripe,rotate,rounded,scattered,seed,sessile,short,short-petiolulate,side,slightly,sometimes,star,stigma,style,subtending,terminal,testal,thick,throughout,tinged,tip,trichome,typically,violet,wall,wet,white,whitish,widely,yellow	.5,0.4-8,1,1-1.5,1-8,1.5-1.8,1.5-10,2-4,3-14,3-5,5-merou,6-11,8-15,acumen,ag,alyx,apparently,attenuate,axe,berry,blade,borne,capitat,connivent,decreasing,dorsally,eaf,edge,eed,end,erec,exceeding,flat,folded,geminat,generally,glabrou,greatly,hair,hal,homostylous,lanceolate,lengthening,like,linear,living,lobe,long,lower,nflorescence,orolla,perfect,petiolulate,plurifoliate,pore,poricidal,rapidly,ruit,seudostipule,singly,size,slit,spaced,specimen,stamen,ste,stem,stolo,straight,subequal,tall,tamen,tem,tri-,tube,tuber,unit,unwinged,usually,vary,wide,wing,x,ympodial	abaxial,adaxial,arrangement,capitate,color,colour,form,growth,height,history,inflorescence,leaf,length,life,mucilaginousnes,na,number,ovary,perennial,position,pseudostipule,rachi,reproduction,shape,spacing,staman,surface,texture
500	wfo-0001029437	success	198	133	108	90	25	0.545	-10,.5,0.5-1,1,1-1.5,1-2,1-3,1.5-2,10-12,2-3,2.5-3.5,3-5,3-7,30-50,4-5,7-10,abaxially,acicular,acute,anther,apex,armed,bark,base,beige,berry,blue,branched,brownish,clavate-truncate,cm,compressed,cordate,corolla,cylindrical,dark-green,densely,diameter,eglandular,elliptic,elliptic-lanceolate,entire,filament,flattened,flower,fruiting,glabrescent,glandular,globose,golden,green,greyish,growth,inflorescence,internodal,irregularly,juvenile,lamina,leaf,lobed-angulate,long-styled,margin,maturity,midpoint,mm,new,orange,ovary,ovate,ovate-elliptic,pedicel,peduncle,per,persistently,petiole,plant,porrect,prickle,pubescence,pubescent,reniform,reticulate,rounded,rusty,short-styled,shrub,similar,simple,spaced,stellate,stem,stigma,style,subcordate,subglobose,suborbicular,subscabrous,surface,tomentose,trichome,unevenly,unicellular,velutinous,violet,visible,woody,x,yellow	1/3,2.5-5,3-3.5,5-9,6-8,9-13,adaxially,anthesi,antrorse,apar,apical,articulated,axi,basal,brow,c.,calyx,chartaceous,coriaceous,distal,eaf,eed,enclosed,erect,except,free,glabrous,gland,heterostylous,hirsute,leaving,lengthening,like,linear-oblong,lobe,lobed,long,loose,lower,membranous,minute,minutely,multangulate,multicellular,near,nearly,nflorescence,oblong,oblong-lanceolate,obverse,older,ovoid,packed,papillo,perfect,pericarp,plurifoliat,pore,poricidal,portion,prickly,recurved,rest,rotate,ruit,scar,sessile,slit,sparsely,stalked,staminate,stellate-pubescent,subscandent,subulate,tall,tapering,testa,thick,tip,triangular,tube,ud,unarmed,unit,upper,villous,whitish,without,ympodial,¼	abaxial,adaxial,apart,armament,arrangement,brown,color,colour,form,fruit,height,history,length,life,na,number,perennial,position,rachi,reproduction,seed,shape,spacing,staman,texture
501	wfo-0001029440	success	218	139	120	98	19	0.55	0.2-0.3,0.3-1,0.5-0.6,0.9-1,1,1-1.2,1-1.5,2-2.5,2-3,2-4,2-6,20,4-5,4-6,4-6-forked,4-8,5-6,5-merous,8-10,9-10,<,>,abaxial,accrescent,acicular,anther,apex,armed,bark,beige,bicolorous,branch,brown,calyx,canaliculate,clavate,cm,cyme,dark,dark-green,deciduous,deeply,diameter,enlarged,ferruginous,filament,finely,floral,flower,free,fruit,fruiting,glabrescent,glabrous,glandular-pubescent,glandular-stellate,glandular-tipped,globose,held,lanate,leaf,leathery,length,long,longer,minutely,mm,mucilaginous,numerous,oblong-elliptic,oval-elliptic,papillose,part,parted,pedicel,peduncle,perennial,perfect,persistent,petiole,plant,porrect-stellate,prickle,rachi,reddish,reticulated,rugose,scabrous,shiny,short,shrub,similar,slender,small,solitary,somewhat,sparse,staminate,stellate,stellate-glandular,stigma,strigose,style,sub-terete,sub-truncate,subcampanulate,subreniform,surface,terete,terminal,touch,trichome,upright,velutinous,white,wide,within,without,yellowish,young	-10,1-2,1-2-celled,1-nerved,1.5-2,2,2.5-7,30,5-15,5-5.5,6.5-8,9-12,across,acute,adpressed,along,alyx,anthesi,ape,apical,articulate,basal,base,blade,brow,caly,central,compressed,coriaceous,curved,distal,eaf,eed,elongate,enclosed,entire,epicarp,equal,erect,exceeding,exserted,functional,fused,geminat,gynoeci,indument,lanceolate-attenuate,leaving,lobe,lobed,lower,midrib,nflorescence,oblong-lanceolate,obver,older,orolla,partially,peg,petiol,plurifoliate,pore,primary,prominent,rarely,ray,recurved,reduced,reflexed,rounded,ruit,secondary,sepal,sessile,sparsely,stalked,stamen,stem,stiff,straight,strongly,sub-coriaceous,subsagittate,surfac,tall,tamen,testa,tomentose,tri-,triangular,tube,unarmed,unit,vary,vein,ympodial,¼,¾	adaxial,arrangement,color,colour,corolla,form,growth,height,history,inflorescence,life,na,number,ovary,seed,shape,staman,texture,width
502	wfo-0001029461	success	217	113	90	127	23	0.415	-1.5,-3,.5,0.1,0.1-0.25,0.6-1,0.8,1-1.6,1-6,2-2.8,4.5-7,5-10,5-merous,almost,andromonoecious,anther,apex,attenuate,bark,base,becoming,berry,black,brown,cell,chartaceous,cm,cuneate,curved,dark,densely,diameter,dull,elliptic,erect,evenly,filament,fine,flattened-reniform,flower,fruit,glabrescent,glabrous,green,leaf,length,lobed,margin,maturity,mauve,midpoint,mm,moderately,orange,outline,ovate,pedicel,petiole,pit,plant,porrect,prickle,raised,ray,reddish,rounded,sessile,shiny,shrub,slightly,small,smooth,sometimes,sparsely,spherical,stalked,staman,stellate,stellate-pubescent,stem,straight,style,subentire,surface,terete,trichome,weakly,yellow,young,zygomorphic	-14,-2,-3.2,-3/4,-4,-4.5,-5,0,0.15-0.25,0.7-1,0.8-1.5,1-,1-2,1-3,1-4,1.2-1.7,1.2-1.8,1.3-2.2,1.5-,1.5-2,1/3,1/3-2/3,1/4,1/4-1/2,2-2.4,2-3,2-4,2.5-3,3-20,3-6,4-10,4-6.5,4-7,4.7-7.2,5-25,7-10,7-12,8-9,abaxially,acuminat,alyx,ame,apart,apically,blade,breaking,brittle,broad-deltate,c.,calyx,concolorous,discolorous,distal,distance,drying,eaf,eed,elongating,extending,faint,fifth,flattened,four,free,fruiting,gra,hermaphrodite,heterostylous,infructescence,lengt,lobe,long,long-styled,longer,lower,lowermost,mature,midvein,oblong,obovate,obtuse,older,orolla,oung,pair,pendulous,per,pericarp,plurifoliat,poricidal,portion,prickl,prickly,primary,reduced,reflexed,ruit,shallow,short-styled,shorter,side,simple,slender,spaced,spreading,stalk,staminat,strongly,tamen,tertiary,time,tip,tube,unarme,unarmed,unequal,unit,upper,variously,vary,vein,venation,visible,way,wide,woody,ympodial	abaxial,adaxial,color,colour,corolla,form,gray,growth,height,inflorescence,na,number,ovary,peduncle,position,rachi,reproduction,seed,shape,spacing,stigma,texture,width
503	wfo-0001029462	success	166	108	81	85	27	0.488	-2,-30,-4,0.5-1,0.5-2,1,1-3,1-6,1.5-2,2-3,2-6.5,2.5-3.5,3-27,3-7,4-15,4-20,5-30,6-9,7-8,8-9,acuminate,acute,apex,articulated,base,broad,calyx,campanulate,chartaceous,cm,connective,cuneate,dark,densely,diameter,ellipsoidal,elliptic,entire,flattened,flower,fruit,glabrous,green,lanceolate,light,longitudinal,margin,membranaceous,minutely,mm,moderately,obtuse,occasionally,ovate,ovoid,pedicel,pedicellar,peduncle,perfect,petiole,puberulent,pubescent-pilose,purplish,rachi,radiu,remnant,reticulate,rounded,simple,sparsely,stellate-,stigma,stripe,style,thecae,tree,truncate,unbranched,white,x,yellow	-5,1-,1-2,1.5,1.5-3,1.5-7,10-,10-22,15-25,2.5-5.5,20-35,3,3-18,3-4,3-5,3-6,4-foliat,7-19,abaxially,abruptly,absent,adaxially,aggregate,apart,ape,axe,basal,beyond,blade,cell,ciliate,connivent,constricted,curled,cylindrical,dentate,directed,eaf,eed,eglandular,equal,exceeding,exserted,hair,laterally,leaving,lobe,lon,long,lower,m.,narrowly,near,nflorescence,nther,often,orolla,oval,pore,pubescent,pubescent-pilo,purpl,ruit,shorter,slightly,small,smooth,somewhat,spaced,stamen,stone,tal,tem,time,tip,tomentose,triangular,truncat,tube,ud,unit,vary,wide,without,ympodial	10-25,abaxial,adaxial,anther,arrangement,bud,color,corolla,form,growth,height,history,inflorescence,leaf,length,life,number,ovary,perennial,plant,reproduction,seed,shape,size,spacing,surface,texture
504	wfo-0001029464	success	235	148	125	110	23	0.532	.9,0-80,0.2,0.2-0.5,0.3-0.7,0.5,0.5-2,1,1-10,1-3,1/4,1/4-1/3,10-50,2-3,2-3.5,2.5-5,3-5,4-7,4-8-merous,5.5-7.5,6-15,abaxial,abaxially,acicular,acute,adaxial,ame,andromonoecious,annual,anther,apart,apex,apically,bark,base,black,branched,broad,brown,c.,chartaceous,cm,connivent,cordate,curved,dark,diameter,distance,ellipsoid,elongated,filament,flattened-reniform,flower,fruit,glabrescent,glabrous,glaucous,globular,green,green-brown,herb,lateral,leaf,length,less,lobed,lower,margin,maroon,maturity,mauve,midpoint,midvein,mm,moderately,mottled,oblong,obtuse,occasionally,orange-brown,ovate,ovoid,pair,pedicel,peduncle,petiole,pink,plant,poricidal,porrect,prickle,primary,purple,ray,red-brown,rounded,sessile,simple,sometimes,sparsely,stalked,stellate,stellate-pubescent,stem,straight,striped,style,surface,tapering,terete,terminal,tertiary,tip,translucent,trichome,upper,usually,variously,vein,venation,visible,white,yellow-green,yellow-orange,young	-2/3,-3,-30,-5,0,0-2,0.2-0.7,0.3-1,0.8-2,00-200,1-8,1.2-3,1.5-2,1/,1/4-1/2,10-15,10-23,10-40,12-50,2,2-4,2.2-2.5,2.4-4,2.5-8,2.9-3.2,3-20,3-7,3.5-5,4-8,5-17,5-8,5.5-6,7-10,8-13,8-15,9-15,alyx,apar,apparently,around,articulated,berry,blade,broad-deltate,brow,calyx,cultivar,cup-shaped,deltate,difoliate,discolorous,distal,drying,eaf,eed,elongating,equal,erect,extending,free,fruiting,fully,geminat,hair,hermaphrodite,heterostylous,infructescence,lobe,long,long-acuminat,long-styled,longer,lowermost,mature,minute,narrow-deltate,nflorescence,often,older,one,open,opening,orolla,oung,pendent,pendulous,per,pericarp,portion,prickl,prickly,ruit,scar,short-styled,side,smooth,spaced,spreading,stalk,staminat,tamen,time,tube,unarmed,unit,vary,way,wide,woody,ympodial	1/2,arrangement,color,colour,corolla,extension,form,growth,height,history,inflorescence,life,number,ovary,position,reproduction,seed,shape,spacing,staman,stigma,texture,width
505	wfo-0001029505	success	169	96	71	98	25	0.42	.1,0-0.3,0-10,0.15-0.2,0.3-0.5,0.5-1.1,0.8-1,1-6,2-7,2.4-3.2,22-25,4.5-5.5,5.5-7,6-18,6-8,7-12,8-10,absent,adaxially,adult,anther,brown,chartaceous,cm,decimetre,densely,diameter,elliptical,extra-axillary,finger,flower,fruit,glabrous,gland-tipped,globose,green,hair,heterostylous,inflorescence,lateral,length,longer,midpoint,mm,ovate,pale,pedicel,peduncle,per,perennial,petiole,plant,present,prickle,prostrate,pseudo-racemose,ray,rotate-stellate,solitary,stellae,stellate,stellate-pubescent,stoloniferous,style,throughout,time,unbranched,white,wide,yellow,yellowish	%,.05,0-3,0-3.5,0.15-0.25,0.2-0.3,1-1.2,1-3,1-locular,1.5-2.2,2-4,2-5,2.7-4,5-7.5,5-merou,7-20,7-8,abaxially,absen,acicular,across,adaxiall,alyx,andromonoecious,apart,apex,articulated,axe,ba,base,blade,branche,calyx,confined,cross-section,cuneateor,cylindrical,deltate,directed,distall,eaf,eed,elliptic,elliptica,entire,exocarp,fruiting,functional,half,incomplete,juicy,lamina,less,lobe,long,lower,margin,mature,mesocarp,midrib,midvein,minute,moderately,moist,nflorescence,oblique,obtuse,onl,orolla,part,placenta,pore,porrect,red,ruit,semi-circular,septum,sessile,short,shrub,simple,spaced,sparsely,straight,tal,tamen,tem,thick,transparent,tube,unarme,unarmed,unit,unknow,vary,weakly,x,ympodial	5-merous,abaxial,absence,adaxial,branch,colour,corolla,density,form,growth,height,history,leaf,life,number,ovary,position,presence,seed,shape,stem,surface,texture,thicknes,width
506	wfo-0001029524	success	212	170	141	71	29	0.665	-5,-6,-8,0.1-0.3,0.7-0.8,1-,1-1.5,1-2,1-3,1.2-1.5,1.5-2,2-,2-2.5,2-4,25,3-8,4-4.5,4-6,6-7,7-9,9-10,abaxially,acicular,acuminate,acute,adaxially,adult,angulate,anther,apex,bark,base,beige,berry,brown,calyx,campanulate,cm,congested,corolla,corymbose,cyme,decumbent,densely,diameter,doubling,eglandular,elongating,entire,filament,flattened,flexuous,flower,flowering,foliaceous,fruiting,glabrous,glandular,globose,green,grey,growth,impressed,internodal,lanate,light,lobe,lobed,long,long-styled,loosely,margin,maturity,minute,mixture,mm,new,oblique,oblong,oblong-lanceolate,obtuse,obverse,occasionally,ovary,ovate,ovate-elliptic,ovate-lanceolate,pedicel,peduncle,petiole,plant,pore,porrect,prickle,prickly,pubescence,reniform,reticulate,rounded,rugose,rusty,short-styled,shrub,size,slightly,slit,somewhat,spaced,sparsely,stellate,stellate-pilose,stellate-pubescent,stem,stigma,style,sub-cordate,subcordate,suborbicular,subscabrous,subspherical,surface,tiny,tomentose,triangular-lanceolate,trichome,tube,turbinate,unarmed,unevenly,velvety,venation,villous,viscid,way,white,woody,x,yellow,yellow-green,yellowish,¾	.5,0.2-0.3,0.9-1.2,10,12-25,2-3,3-,3-3.5,4-7,5-15,6,anthesi,articulated,basal,branched,cell,channelled,clavate-truncat,discolorous,distal,distall,eaf,eed,erec,erect,exceeding,exserted,filamentous,free,glabrescen,glandular-hirsute,heterostylous,leaving,like,linear-oblong,long-stalked,lower,m.,membranous,midpoint,multicellular,nflorescence,numerous,older,one,partially,perfect,pericarp,plurifoliat,poricidal,portion,pubescent,recurved,ruit,scar,sessile,single,stalked,staminate,subbsessile,subcoriaceous,tall,tapering,testa,time,tip,ud,unit,upper,vein,ympodial	abaxial,adaxial,arrangement,bud,clavate-truncate,color,colour,distally,form,fruit,glabrescent,height,history,inflorescence,leaf,length,life,na,number,perennial,plurifoliate,position,rachi,reproduction,seed,shape,spacing,staman,texture
507	wfo-0001029546	success	203	125	97	106	28	0.478	0-2,0.3-1,1-10,1-2,1-4.5,1.5-6.2,2.2-2.8,3-8,4-10,5-10,5-18,5-8,7-10,8,8-17,abaxially,absent,acuminate,acute,adaxially,anther,apart,apex,axillary,base,blue,broadly,brownish,bud,cell,clavate,cm,condition,cordate,corolla,covering,densely,diameter,drying,elliptic,elliptical,filament,flower,forked,fresh,fruit,glabrous,globose,green,greenish,hair,hair-like,herb,honeycomb-shaped,lateral,leaf,leaflet,like,lunate,minutely,mm,oblique,odd-pinnate,ovate,ovoid,pair,pedicel,peduncle,pentagonal,petiole,petiolule,plant,pubescent,rachi,rarely,regular,ripe,rotate-pentagonal,seed,simple,size,slightly,stem,stigma,style,subtending,terminal,testal,thick,tinged,typically,wall,wet,white,whitish,x,yellow	1-3.2,1-5,1.5-2,1.6-6.5,2-4,2-9,3.5-5,4.5-12.5,4.5-7,5,5-merou,6.3-19.5,8-19.5,acumen,adaxiall,ag,alyx,apiculate,apparently,articulated,attenuate,axe,berry,blade,capitat,chartaceous,connivent,covered,curved,decreasing,decumben,decurrent,digestion,distal,dorsally,dot,eaf,edge,eed,enzyme,erect,exceeding,flat,folded,frequently,geminat,generally,glabrou,glandular,greatly,green-white,half,homostylous,interjected,lanceolate,lengthening,living,lobe,long,longer,lower,make,membranous,middl,mottle,mucilaginous,nearly,nflorescence,non-glandular,often,orbicular,perfect,plurifoliate,pore,poricidal,purple,removed,ruit,sessile,seudostipule,short,slit,soft,sometimes,spaced,specimen,stamen,ste,straight,subequal,tall,tamen,tem,throughout,tip,tri-,trichome,truncate,tube,unit,unwinged,usually,vary,wide,wing,ympodial	abaxial,adaxial,arrangement,capitate,color,colour,form,growth,height,hermaphroditic,history,inflorescence,interjection,length,life,mucilaginousnes,na,number,ovary,perennial,position,pseudostipule,reproduction,shape,spacing,staman,surface,texture
508	wfo-0001029552	success	161	111	81	80	30	0.503	.5,0.6-1,1-1.3,1-1.5,1-2,1-3,1-5,12,2.5-3,abaxial,abaxially,abruptly,acuminate,acute,adaxially,along,anther,apex,area,bark,base,branched,broadened,calyx,closely,cm,contracted,corolla,deflexed,densely,elliptic,erect,filament,flattened-reniform,flower,fruiting,glabrous,globose,green,incrassate,inflorescence,leaf,lobed,long-styled,margin,minutely,mm,nearly,occasionally,opposite,ovary,pale,paler,pedicel,petiole,pitted,pubescent,rounded,shape,shining,short-styled,shrub,simple,slender,small,somewhat,spaced,sparsely,stigma,style,surface,tan,tip,tree,tree-like,trichome,tube,vein,white,woody,yellowish	.25,0.1-0.5,0.5,1.5-2,1.5-6.5,10-20,2-2.5,2-9,5-10-flowered,5.5-8,6-9,anthesi,berry,broadly,clavate,conical,decurrent,deltate,dendritic,denser,dia,differing,difoliate,drying,eaf,edicel,eed,exserted,free,geminat,greyish-brow,heteromorphic,inflorescenc,lamina,later,lateral,like,lobe,lon,long,lower,main,major,middle,minor,minute,nflorescence,older,onto,orbicular,overlappin,pair,papillo,persistent,planar,pore,poricidal,portion,present,reflexed,rest,ruit,scar,scattered,shaped,size,slightly,stem,strongly,swollen,tall,tear-drop,tub,ud,unit,wide,widest,x,ympodial,young	5-10,adaxial,arrangement,branching,color,colour,diameter,form,fruit,greyish-brown,growth,height,history,length,life,na,number,overlapping,papillose,peduncle,perennial,plant,position,rachi,reproduction,seed,spacing,staman,texture,width
509	wfo-0001029558	success	184	117	91	93	26	0.495	.5,0.05-0.1,0.1-0.2,0.1-0.9,0.4,0.5,1-1.1,1-1.5,1-3,1.5-2,2-4,4-merous,6-10,6-9,abaxially,anther,apex,bark,base,berry,capitate,cell,closely,cm,conical,corolla,densely,diameter,ellipsoid,entire,filament,filiform,flattened,flower,geminate,globose,growth,inflorescence,internodal,later,leaf,like,lobed,margin,mere,minutely,mixture,mm,narrowly,nearly,obovate,obspathulate,obtuse,ovary,overlapping,pale,pedicel,peduncle,petiole,pitted,porrect,prickle,pubescent,ray,red,reddish,reniform,rhombic,rounded,sessile,shape,shiny,short-stalked,shrub,simple,spaced,sparsely,square,stellate,stem,stigma,straight,style,surface,tan,thin,trichome,wall,white,widening,x	0.1-,0.15-0.2,0.2-,0.3-0.5,0.4-0.6,0.4-1.1,0.5-2,1,1-4,10-16,2,2-3,2.5-3.5,<,?,acute,adaxially,along,anthesi,armed,articulated,bearing,branched,calyx,deflexe,difoliate,divaricately,eaf,easily,eed,elliptic,elongate,enclosed,equal,erect,free,fruiting,geminat,glabrescent,glabrous,gre,highly,hyaline,including,interlocking,larger,leave,lengthening,lobe,long,long-triangular,lower,midpoint,midvein,new,nflorescence,node,occasionally,older,pair,paired,papillo,per,perfect,pericarp,planar,pore,poricidal,portion,prickly,primary,rest,rhachi,ruit,scar,shorter,sinus,size,slit,small,stalked,tapering,testal,tiny,tip,tube,ud,unit,upper,usually,vein,visible,ympodial	abaxial,adaxial,arrangement,bud,center,color,colour,form,fruit,grey,height,history,length,life,na,number,perennial,plant,position,rachi,reproduction,seed,spacing,staman,texture,width
510	wfo-0001029569	success	265	123	89	176	34	0.336	0.2,130,2,4.9,5.1,8.1,abaxially,across,acuminate,adaxially,aequilateral,along,anther,apart,apex,bark,base,blade,brochidodromous,cm,corolla,cuneate,densely,diameter,distinct,dry,elliptic,entire,evenly,extra-axillary,filament,flattened-reniform,flower,fruit,glabrous,globose,homostylous,internode,lacking,lamina,lateral,layer,length,light,margin,mature,midvein,mm,nearly,oblique,orange,ovate,pedicel,peduncle,petiole,porrect,porrect-stellate,probably,pubescent,raised,red,reticulate,rounded,sessile,short-stipitate,shrub,simple,sinuate,sloughing,spaced,sparsely,stellae,stellate,stem,stigma,stipe,stipitate,straight,style,surface,transparent,vein,weakly,white,yellow,yellow-ferruginous,yellow-tan,±glabrous,±well	.0,.2,.3,.4,.9,/2,/3,0.03,0.05,0.1,0.2–0.5,0.3–0.5,0.4–0.6,0.5–0.8,0.6–0.8,0.6–0.9,0.7–0.9,0.8–1.0,0.9,0.9–1.3,0.9–1.4,0.9–2.0,1.0–1.3,1.3–1.8,1.4–2.4,1.5–1.7,1.6,1.6–4.5,1.7–2.3,1.8–2.5,1/2–2/3,1/3,14.6–16.5,2.0–3.2,2.3–3.0,2.3–4.4,3.2,3.2–3.8,3.4–3.7,4.0,4.5,4–6,5-merou,5.0,5.3–16.6,5.7–6.6,6.3–18.5,6.8–7.8,6–12,6–8,7.4–9.1,7–10,90°,adnate,ag,alyx,anthesi,apical,apiculate,apparently,appearing,around,articulate,attenuate,axe,ba,basal,becoming,berry,branch,branching,broad,bud,calyx,capitat,channeled,chartaceous,clinate,deciduous,dentate,development,difoliate,directed,distal,distally,eaf,edge,eed,either,emerging,endocarp,exocarp,extending,fertile,filiform,flexed,free,geminat,glandular,glossy,gradually,hair,increasing,intact,interpetalar,intersepalar,juic,less,lobe,lon,long,longer,lower,many,middle,midpoint,midrib,minute,moderately,nflorescence,oblong,orolla,ove,per,perforated,pore,portion,potentially,ray,reduced,reflexe,remaining,restricted,rigid,row,ruit,scarcely,short,shorter,side,sinus,smoot,splitting,spread,spreading,stamen,stellate-pubescent,suture,tamen,tardily,tem,terete,thin,time,tip,tissue,toward,translucent,triangular,truncate,tube,two,ud,unarmed,unit,upper,various,vary,well,well-developed,wide,ympodial,young,±90°,±equal,×	0.9-1.3,0.9-2.0,1.0-1.3,1.5-1.7,3.2-3.8,5-merous,5.7-6.6,6.3-18.5,abaxial,adaxial,arrangement,capitate,color,colour,form,growth,height,history,inflorescence,leaf,life,na,number,ovary,perennial,plant,position,rachi,reproduction,seed,shape,spacing,staman,texture
511	wfo-0001029584	success	180	109	82	98	27	0.456	0-30,1,1-2,1-6,2-3,2-4,3-10,4-15,4-5,4.5-11.5,6-7,7-14,acuminate,acute,anther,apex,axillary,base,bud,cell,clavate,cm,considerably,coriaceous,corolla,covering,dark,densely,diameter,distal,elliptic,filament,flower,forked,glabrous,green,green-white,greenish,hair,hair-like,herb,homostylous,interjected,larger,lateral,leaf,leaflet,light,lobe,make,mm,mucilaginous,oblong-lanceolate,odd-pinnate,orbicular,ovate,ovoid,pair,pentagonal,petiole,plant,pubescent,purple,seed,short,simple,size,stigma,style,substellate,subtending,tall,terminal,testal,thick,throughout,toward,tube,wall,wet,white,whitish	1-3,1.5-6.5,16.2-33,2.4-6.3,3-5,3-7,4-14,5-merou,5.3-13.3,6.1-9.4,8-15,9.7-23.4,9.8-17,abaxially,acumen,adaxially,ag,alyx,apart,apparently,articulated,asymmetric,attenuate,axe,basiscopic,blade,borne,brownish,capitat,condition,connivent,decreasing,dense,digestion,dorsally,drying,eaf,edge,eed,end,enzyme,erry,finer,flat,folded,fresh,fruit,geminat,generally,glabrescent,hal,half,honeycomb-shaped,lengthening,linear,living,long,lower,margin,middle,nflorescence,orolla,pedicel,peduncle,perfect,petiolulate,plurifoliate,pore,poricidal,present,proximal,removed,second,semi-erec,sessile,seudostipule,side,singly,slit,spaced,specimen,stolo,straight,tamen,tem,tip,tissue,tri-,tuber,typically,unit,unknow,unwinged,usually,vary,x,yellow,ympodial	5-merous,abaxial,adaxial,arrangement,calyx,capitate,color,colour,decrease,form,growth,height,history,inflorescence,length,life,na,number,ovary,perennial,position,reproduction,shape,staman,surface,texture,width
512	wfo-0001029592	success	207	82	64	143	18	0.309	0.3-0.6,0.5-1.8,1-10,1.1-2.8,1.8-2.4,14-20,2-3-branched,2.1-4,240-1400,3-6,3.5-5.5,6.5-8.5,7-10,7-25,acicular,adaxially,adult,anther,black,branch,brown,chartaceous,cm,decimetre,densely,diameter,dm,extra-axillary,flower,fruit,glabrous,globose,green,inflorescence,juvenile,leaf,length,longer,midpoint,mm,moderately,ovate,pedicel,peduncle,per,petiole,prickle,purple,ridged,simple,sparsely,stellate,stellate-pubescent,straight,style,surface,terete,thick,thicknes,time,unbranched,white,wide,yellow	%,.05,.4,0,0-0.1,0-0.15,0-0.3,0-3.5,0.1-0.2,0.25-0.5,0.25-0.7,0.4-0.7,0.5-0.8,0.5-1,0.5-1.5,0.8-0.9,0.8-1.2,0.8-1.5,1-1.5,1-1.9,1-3,1-8,1-locular,1.5,1.5-3,1.8-6.5,1.8-8,18-30,2-10,2-3.5,2-foliate,3-4,4-8,5-8,5-merou,5.5-10.5,5.5-11.5,6-8,7-17,7-9,8,8-10,8-20,abaxially,absent,across,acute,adaxiall,alyx,apart,apex,apparen,apparently,armed,articulated,attenuate,axe,ba,base,blade,branche,calyx,cordate,deeply,deltate,depression,directed,distall,distally,distributed,eaf,eed,eglandular,entire,erect,exocarp,finger,fruiting,geminat,gland-tipped,hair,half,hemispherical,homostylous,incomplete,index,juicy,lamina,lateral,less,lobe,lobed,lobing,long,lower,margin,markedly,mature,mesocarp,mid-point,midvein,minute,nflorescence,oblique,obtuse,orolla,pair,part,perennial,perfect,placenta,pore,porrect,presen,present,ray,rhizomatous,ruit,septum,sessile,shallowly,short,shrub,side,spaced,sparse,stalk,stellae,succulent,tal,tamen,tem,thicker,throughout,transparent,tube,unarme,unit,upper,vary,vein,x,ympodial	abaxial,adaxial,arrangement,color,corolla,density,filament,height,number,ovary,plant,position,seed,shape,staman,stem,texture,width
513	wfo-0001029593	success	181	78	54	127	24	0.298	0.5-1,0.5-5,1,1-1.5,3-4,4-6,5-10,5-15,acuminate,acute,anther,anticlinal,apex,axillary,brown,capitate,cell,cm,conical,densely,diameter,elliptic,epidermal,filament,filiform,flower,fruit,glabrous,globose,green,irregular,leaf,mm,obovate,ovary,ovoid-reniform,pedicel,petiole,pinnate,plant,pubescent,purple,rachi,rarely,seed,shape,shrub,sinuous,slightly,smooth,stigma,style,surface,thickening	-10,0.05,0.8-1,0.8-1.2,1-1.2,1-2,1-8,1.6-2.3,10-50,100,2,2-14,2-3,2-5,2.3,2.3-3.0,3.5-8,35-60,7-25,7.5-15,9-15,abaxially,abruptly,adaxially,age,always,anthesi,apically,arising,attenuate,axil,basal,base,basiscopically,bearing,berry,broadly,calyx,cateniform,clavat,colony,cone,decurrent,deltate,dry,drying,eaf,edicel,eed,enlarged,entire,exserted,extremely,free,fruiting,glabrescent,growing,half,hollow,included,lamina,large,lateral,leaflet,lobe,long,lower,markedly,minutely,much,narrowing,nflorescence,noddin,oblique,occasionally,often,once-branched,onto,open,opposite,pair,papillose,per,perfectly,petiolule,place,pointed,poricidal,portion,primary,projection,pubescen,pubescence,reflecting,rest,ruit,scar,short-styled,similar,simple,single-stemmed,small,smaller,somewhat,sparsely,tall,tem,terminal,tip,trichome,tub,tube,ud,unifoliat,uniseriate,unit,usually,variable,vein,white,white-lenticellate,wider,winged,without,woody,x,ympodial	abaxial,adaxial,arrangement,clavate,color,colour,corolla,form,growth,height,history,inflorescence,length,life,na,nodding,number,peduncle,perennial,position,reproduction,staman,texture,width
514	wfo-0001029601	success	187	128	97	90	31	0.519	0-37,0.2-0.8,0.5-5.8,1-2,1-3,1-53,2-12,2-7,2.3-5.9,3-10,3-5,5-41,6-10,6.8-14.5,abaxially,adaxially,anther,apex,articulated,attenuate,axillary,base,berry,brownish,bud,cell,clavate,cm,condition,coriaceous,corolla,covering,dark,decreasing,diameter,digestion,dot,drying,elliptic,enzyme,filament,flower,forked,fresh,fruit,glabrous,globose,green,green-white,greenish,hair-like,herb,honeycomb-shaped,interjected,larger,lateral,leaf,leaflet,light,make,middle,mm,mucilaginous,odd-pinnate,orbicular,ovate,ovoid,pair,pedicel,peduncle,pentagonal,petiole,plant,puberulent,removed,ripe,rotate,rounded,seed,size,slightly,small,stigma,style,subequal,subtending,terminal,testal,thick,throughout,toward,tuber,wall,wet,white,whitish,yellow	0.5-8,1-4,1.1-2.7,1.2-2.3,1.7-6.5,2,2-3,2-9,2.2-4.5,2.8-10.5,3-7,4-13.5,5-merou,6.6-22,abaxiall,acumen,acuminate,acute,ag,alyx,apart,apparently,asymmetric,axe,basiscopic,blade,borne,capitat,connivent,distal,dorsally,eaf,edge,eed,end,erec,exceeding,flat,folded,geminat,generally,glabrescent,glabrou,hair,half,homostylous,lanceolate,lengthening,linear,living,lobe,long,lower,middl,narrow,nflorescence,orolla,perfect,petiolulate,plurifoliate,pore,poricidal,ruit,sessile,seudostipule,short,side,singly,slit,spaced,specimen,stamen,stolo,straight,subglabrou,tall,tamen,tem,tip,tissue,tri-,tube,typically,unit,unwinged,usually,vary,wing,x,ympodial	abaxial,adaxial,arrangement,capitate,color,colour,feature,form,growth,height,hermaphroditic,history,inflorescence,length,life,na,number,ovary,perennial,position,pseudostipule,rachi,reproduction,shape,spacing,staman,stolon,subglabrous,surface,texture,width
515	wfo-0001029606	invalid_json_followup	179	129	90	89	39	0.503	.5,/2,0.2-0.5,0.4-0.5,0.5-1,1,1.5-2,15,2-2.5,3,4.5-5,7,7-9,abaxially,acuminate,acute,adaxially,anther,apex,bark,base,beneath,berry,bilobed,broadly,brown,brownish,calyx,closely,cm,color,coriaceous,corolla,densely,diameter,ellipsoidal,elliptic,entire,filament,flattened,flower,form,fruiting,glabrous,globose,growth,inflorescence,internodal,leaf,lobed,long,long-styled,margin,minutely,mm,multangulate,narrowly,new,oblong,once-branched,orbicular,pedicel,peduncle,petiole,porrect,prickle,pubescent,red,reddish,reniform,revolute,shiny,shrub,simple,sometimes,stalked,stellate,stem,stigma,straight,style,surface,terminal,thin,trichome,unit,way,white,woody,x	0.5,1.5-3,1.5-3.5,1.8-2.5,2-3,3-9,4-5,4-6,4-8,5,5-6,aciculate,along,anthesi,apparently,arching,armed,articulated,cell,deciduous,defoliate,dense,eaf,eed,elongate,elongation,equalling,erect,especially,exerted,free,geminat,gre,herbarium,heterostylous,impressed,inshort-styled,known,lengthening,like,lobe,long-stalked,lower,m.,many,marginal,midpoint,midrib,mixture,multiseriate,nflorescence,nodding,older,pair,papillat,per,pericarp,pore,poricidal,portion,primary,prominent,pubescence,ray,redder,ruit,rusty,scar,sessile,slightly,slit,soon,space,specimen,stalk,stellate-pubescent,straggling,strongly,tapering,testal,tip,triangular,tube,ud,urceolate,usually,vein,yellowish,ympodial	'',[,``,abaxial,adaxial,arrangement,bud,characteristic,colour,defoliation,fruit,gemination,grey,height,history,length,life,na,number,ovary,papillate,perennial,plant,position,rachi,reproduction,seed,shape,short-styled,spaced,spacing,staman,sympodial,texture,value,width,ye,{,}
516	wfo-0001029619	success	188	116	95	93	21	0.505	0.25-0.75,0.5-1,0.5-1.5,0.5-2,1,1-2,1-2.5,1-3,1-3.5,1.5-2,10-12,2,2-3,2-5,3-4,3-8,4-6,5-20,6,7,abaxially,absent,adaxially,anther,apart,appearing,attenuate,base,brown,calyx,chartaceous,cm,dark,densely,diameter,extra-axillary,filament,flower,fruit,geminate,glabrous,gland-tipped,globose,green,hair,immature,leaf,leaf-opposed,length,like,lobed,many,mature,midpoint,mm,moderately,multicellular,nearly,netlike,occasionally,orange,ovate,pedicel,peduncle,petiole,pit,porrect-stellate,pubescent,rachi,raised,ray,reduced,reniform,ridge,rusty,scandent,separated,shrub,small,spaced,stalk,stellate,stem,stigma,style,surface,tan,tapering,triangular,unbranched,unicellular,usually,white,whitish,x	1-.,1-1.5,1-5,2-11,25-40,5-merou,6-10,6-8,7-10,7-12,8-12,accrescent,acute,adaxiall,alyx,andromonoecy,apar,apex,apical,apparently,armed,axe,berry,beyond,blade,bud,clavat,connivent,contiguous,cordate,cut,cylindrical,difoliate,directed,discolorous,eaf,eed,either,elongated,em,exserted,flattedned,frui,fruiting,glabrou,glandular,implying,introrsel,less,lobe,long,lower,m.,major,margin,midrib,midvein,multiseriate,narrowly,nflorescence,obtuse,often,orolla,pair,per,perfect,pore,prickle,recurved,roselike,ruit,side,simple,sinus,slightly,sparse,sparsely,spreading,stamen,ste,tamen,tube,unarmed,unequa,unit,unlobed,vary,vein,way,wide,yellow,ympodial,¼	abaxial,adaxial,arrangement,clavate,color,colour,corolla,form,growth,height,inflorescence,number,ovary,plant,position,seed,shape,spacing,staman,texture,width
517	wfo-0001029621	success	165	119	82	83	37	0.497	0.5-0.75,0.5-1.2,0.5-1.5,0.7-1.1,1-1.5,1-2,1.5-2,1.5-5,3.5-4.5,7-9,acute,anther,anthesi,apex,area,attenuate,bark,base,becoming,borne,branched,brown,calyx,cluster,cm,completely,corolla,cup-shaped,dark,decurrent,dry,ellipsoid,enclosed,erect,filament,fleshy,fruit,fruiting,glabrous,globose,green,irregularly,lanceolate,later,lateral,leaf,live,lobed,many,material,merely,minutely,mm,oblanceolate,often,ovary,ovoid-reniform,pale,pedicel,pitted,plant,puberulent,scar,sessile,shiny,shrub,somewhat,spaced,stem,stigma,style,surface,tan,tapering,terminal,thick,time,white,whorl-like,widened,woody,yellowish	.1,0.5-1,0.8-1,0.8-4.5,1.5-2.5,1/3,2.5-3,2/3,3-3.5,5-20-flowered,6-20,6-8,accrescent,along,apar,appearing,appressed,beneath,berry,caudate,constricted,course,deltoid,densely,dia,distal,eaf,edicel,eed,elongate,exsertio,free,geminate,glabrate,late,like,lobe,lon,long,lower,main,margin,middle,nflorescence,occasionally,older,onto,pair,papillate,papillo,papillose,planar,plurifoliat,pore,poricidal,portion,prominent,quite,rarely,reddish,reddish-gre,ripe,river,ruit,shaped,small,ste,straight,tall,tear-drop,tip,trichome,tube,ud,uniseriate,unit,vein,way,widest,x,yellow,ympodial,young	5-20,abaxial,adaxial,apart,arrangement,branching,bud,change,color,colour,diameter,exsertion,feature,flower,form,growth,height,history,inflorescence,length,life,na,number,pattern,peduncle,perennial,petiole,position,rachi,reddish-grey,reproduction,seed,shape,spacing,staman,texture,width
518	wfo-0001029622	success	182	97	70	112	27	0.385	.1,.5,0.5-1,0.8-1,1-1.5,1.5,2.5-3,3-4,3-5,30-35,4-6.5,abaxially,acute,adaxially,anther,apex,bark,brown,bud,calyx,chartaceous,cm,corolla,deflexed,diameter,elliptic,filament,flower,fruit,glabrous,globose,green,inflorescence,internodal,leaf,lobe,lobed,long-acuminate,long-triangular,longitudinal,mm,narrowly,obconic,occasionally,opening,opposite,ovate,pedicel,peduncle,petiole,pore,rachi,reddish,rounded,shaped,shiny,shrub,simple,single,slit,somewhat,stellate,stigma,style,tapering,tear-drop,tube,white,x,yellow	.2,/3,0.3,0.5,0.5-0.7,0.6-0.9,1-1.2,1-2.7,1-4,2-11,2-4,2-5,40,45-50,5-6,7-11,absent,accrescent,ag,alyx,anthesi,apparently,appearing,arising,attenuate,axe,axil,base,beneath,blade,capitat,connivent,consisting,cylindrical,deciduous,differing,difoliate,dimorphic,eaf,eed,elongate,entire,except,free,fruiting,geminate,glabrou,ilament,immature,included,interlaced,jointed,known,lamina,lateral,less,long,m.,main,major,margin,mature,measured,midrib,minor,minute,minutely,nflorescence,oblong,often,older,one,onto,orolla,oung,ovate-lanceolate,pair,papillose,pendent,portion,present,probably,raised,reflexed,remaining,ruit,sagittate,scar,second,size,slende,slender,slightly,stem,straight,tal,thin,thus,tip,trichome,tuft,ud,unarme,unifoliat,uniseriate,unit,vary,vein,way,within,ympodial,young	1,abaxial,adaxial,arrangement,capitate,color,colour,form,growth,height,history,length,life,na,number,ovary,perennial,plant,position,reproduction,seed,shape,spacing,staman,surface,texture,width
519	wfo-0001029625	invalid_json_followup	168	100	62	106	38	0.369	..,0.5-1.3,1-1.5,1-2,1.2-1.6,3-,3-3.5,4-4,4-9,5,5-6,5-8,abaxial,anther,bark,calyx,cell,cm,conical,corolla,darker,diameter,elliptic,filament,flattened,flower,four,fruit,fruiting,globose,green,greenish,growth,herb,inflorescence,lobed,long,margin,mm,new,ovary,ovate-reniform,pale,papillate,pedicel,peduncle,pointed,pubescent,reddish,scar,sinuate,smooth,stem,stigma,striate,stripe,style,surface,tan,trichome,uniseriate,white	-15,.1-0.2,.5,0.5-1,0.5-2,0.5-2mm,0.8-1.4,0.8-1.8,1-3,100,2,2.5-.,3,3-3,4-10,4-5-celled,4-7-celled,5-10,6-9,8-13,9-25,along,anthesi,apical,base,beneath,branc,branch,branched,brittle,brow,capitat,cel,cucullate,deflexe,deflexed,deltate,densely,denser,distinct,dry,eaf,edicel,eed,erect,frui,glabrescent,glabrous,gland,gland-tipped,glandular,hyaline,lamina,later,lighter,like,lobe,lower,markedly,middle,midline,minute,mixed,narrowly,nearly,nflorescence,occasionally,open,outer,outline,pair,per,pericarp,planar,plurifoliat,point,primary,purplish,rarely,regularly,ruit,scattered,shrub,single,single-stemmed,slightly,small,sparsely,strongly,testa,thin,time,tinged,tip,triangular,tube,tuft,ud,unit,vein,wall,weight,without,x,ympodial,young	'',[,``,adaxial,apex,arrangement,brown,bud,capitate,center,characteristic,color,colour,form,height,history,leaf,length,life,na,number,perennial,petiole,plant,plurifoliate,position,prickle,rachi,reproduction,seed,shape,spacing,staman,texture,value,width,{,}
520	wfo-0001029630	success	286	80	68	218	12	0.238	/6,0-5,0.1-0.2,0.2-0.3,0.2-0.4,0.3-0.5,0.4,0.5,0.5-1.5,0.5-4.5,1-3,1/3-1/5,12-17,2.5-3,3.5-5,5-9,6-8,7-10,abaxial,anther,apart,berry,branched,calyx,capitate,clavate,cm,corolla,densely,diameter,drying,dull-yellow,elliptic,filament,flattened-reniform,fruit,glaucous,globose,green-brown,leaf,length,lobed,maturity,mauve,midpoint,mm,orange,orange-brown,ovate,pedicel,peduncle,petiole,prickle,purple,rachi,red-brown,side,sometimes,stellate-pubescent,stem,stigma,style,suborbicular,surface,thin,trichome,yellow-brown,yellow-green	.1,.15,.5,.7,.8,/2,0,0-10,0-8,0.15-0.3,0.2-0.7,0.5-1,0.5-2,0.6-0.8,1,1.2-1.5,1.5-2,1.5-4,1/3,1/3-2/3,10-30,12-15,2-6,2.5,2.5-6,3-10,4-5,4-8,45-60°,5,5-20,5-merou,8,8-9,abaxially,accrescent,across,acuminate,acute,adaxially,age,almost,along,always,alyx,apar,apex,apically,apparently,area,armed,articulated,ascendant,attachment,bark,base,beyond,blade,brachyblast,branch,broadly,brown,cell,chartaceous,clearly,climber,coroll,cuneate,cupular,curved,dark,delineated,deltoid,development,difoliate,discolorous,distance,distributed,divided,downward,eaf,eed,ellpsoid,elongating,entire,equal,evenly,exserted,extending,eye,fertile,finely,flat,flattened,flower,free,fruiting,geminat,glabrescent,glabrous,grey-brown,greyi,hooked,infructescence,irregula,lateral,lengthening,less,lighter,like,lobe,lon,long,longer,longitudinal,lower,main,margin,mature,midvein,mostly,naked,narrow-ovate,nflorescence,oblique,often,orolla,outline,ovoid,pair,pale,papillo,papillose,patchily,pendulous,per,perfect,pericarp,pit,point,pore,poricidal,porrect,portion,primary,prominently,raised,ray,recurved,reduced,reflexe,relatively,rest,robust,rounded,ruit,scar,secondary,shiny,shorter,simple,sinus,slender,slit,small,smooth,somewhat,spaced,sparsely,species,spherical,spreading,stalk,stalked,stellate,stout,straight,strong,strongly,stump,sunk,tamen,tapering,terete,terminal,tertiary,thicker,throughout,time,tip,toward,translucent,tube,ud,undulate,unequal,unequal-deltoid,uniform,unit,usually,variously,vary,vein,venation,visibl,visible,visibly,weakly,white,white-translucent,wide,widest,woody,yellow,yellow-translucent,ympodial,young,×	adaxial,color,colour,inflorescence,ovary,seed,shape,spacing,staman,texture,thicknes,width
521	wfo-0001029632	success	202	120	81	121	39	0.401	.5,0.2,1.5–,abaxial,abaxially,acute,along,anther,anthesi,apart,apex,arising,articulated,associated,base,black,branching,brown,caudex,clavate,cm,dark,decurrent,deeply,densely,diameter,elliptic,filament,flattened,flower,fruit,glabrous,globose,green,hair,herb,leaf,like,lilac,lobe,lobed,margin,midrib,midway,mm,ovate,pair,pale,pedicel,peduncle,pentagonal,perennial,petiole,pitted,pubescent,purple,simple,slender,sometimes,sparsely,spheroidal,stigma,style,subentire,surface,swollen,unbranched,violet,white,whitish,x,yellow,–10,–11.5,–15,–19.0,–2.0,–4.5,–40,–5.2,–50	.0,0.3–2.0,0.4–1.0,0.5,0.5–0.7,0.5–1.4,0.6–1.1,0.7,0.8–,0.8–1.0,0.8–1.5,0.8–2.2,0.9,0–1.5,1,1.0–1.5,1.0–2.0,1.0–3.5,1.0–6.0,1.1–,1.2,1.2–1.4,1.2–2.5,1.5–2.6,1.7–8.5,10–30,11–25,2,2.0–11.5,2.0–2.2,2.7–3.5,2–3,3.5–5.0,3–8,4.5–6.0,4–8,5,5.5–9.5,5–10,6–13,7.5–13,75,absent,adaxiall,adaxially,ag,angular,appressed,axe,ba,blade,calyx,cell,chartaceous,connivent,cylindrical,eaf,eed,elongate,equal,especially,geminat,indistinct,lamin,lon,long,longitudinal,lower,m.,marking,midvein,moderately,multicellular,nflorescence,oblong,obtuse,occasionally,often,opening,orolla,particularly,perfect,pore,poricidal,present,prostrate,purplish,rapidly,rarely,ruit,scandent,semi-succulent,shaped,side,slit,spaced,stone,straight,subterranean,succulent,tall,tamen,tear-drop,tem,time,tip,tube,unicellular,unifoliate,uniseriate,unit,vary,vein,wide,wing,ympodial,–1.4,–11.0,–13.5,–2.2,–4.0	0-1.5,0.5-1.4,1.0-1.5,1.5-2.6,10-30,11-25,2-3,2.0-11.5,2.7-3.5,3-8,4-8,5-10,adaxial,arrangement,color,colour,corolla,form,growth,height,history,inflorescence,lamina,length,life,na,number,ovary,plant,position,rachi,reproduction,seed,shape,spacing,staman,stem,texture,width
522	wfo-0001029645	success	160	94	66	94	28	0.412	-1,0.2-0.5,0.3-0.5,0.5-2.5,0.5-7,1-1.5,1.3-7,2.5-17,2.5-4,3-7,3.5-4,337,750,acuminate,anther,apex,base,blue,brown,chartaceous,cm,corolla,diameter,et,extra-axillary,fide,filament,finger,flattened,flower,fruit,glabrous,gland-tipped,globose,green,greenish,hair,herb,kayap,line,membranaceous,minutely,mm,moderately,ovate,ovate-elliptic,petiole,puberulent,purple,rarely,red,rotate-stellate,rugose-verrucate,simple,smith,sparsely,stigma,style,triangular,truncate,unbranched,white,wide,x,yellow,±	.5-1,1,1-2,1-4,1.5,1.5-2,2-3-foliat,2-4,3-10,3-15,4-5,4-8,5,5-8,6-12,7-12,?,abaxially,abundantly,acute,adaxially,aggregate,along,apart,around,articulated,axe,ba,blade,calyx,cell,connivent,cuneate,cylindrical,decurrent,deltate,directed,distall,distally,eaf,eed,entire,except,free,glabrou,immature,inserted,knapp,lobe,long,lower,major,margin,mesocarp,nearly,nflorescence,obtuse,orolla,part,pedicel,peduncle,perfect,pore,puberulen,rachi,radiu,ruit,sagittate,sand-punctate,short,short-tomentose,shorter,shru,side,small,spaced,stone,strongly,subcordate,tal,tamen,tapered,tem,thecae,tightly,time,tomento,truncat,tube,unit,vary,vein,veiny,ympodial	abaxial,adaxial,arrangement,color,form,growth,height,history,inflorescence,leaf,length,life,na,number,ovary,perennial,plant,position,pubescence,seed,shape,shrub,size,staman,stem,surface,texture,width
523	wfo-0001029646	invalid_json_followup	141	105	67	74	38	0.475	0.1-0.6,0.7-2.2,1-4,1.5-2,10-15,4-5.5,6-8,7-15,acuminate,acute,apex,articulate,base,branched,cell,cm,corolla,covering,cyme,diameter,dichasial,dichasially,digestion,distal,ebracteate,elliptic,enzyme,filament,finely,flower,globose,green,green-white,hair-like,half,herbaceous,honeycomb,lateral,leaf,mm,monochasial,mucilaginous,narrowly,ovate,ovoid,pattern,pedicel,peduncle,perennial,petiole,plant,proximal,pubescent,seed,simple,stellate,stigma,style,testal,thick,throughout,tone,wall,white,yellow,yellow-green,¼	0.5,0.5-0.8,1.5-4.9,2-3,3-14,3-6-foliat,5-15,abaxially,acumen,adaxially,apical,apically,attenuate,calyx,commonly,dehiscent,dorsally,eaf,edge,eed,emoval,epiphytic,equaling,flat,folded,forked,free,generally,globo,ground,growing,introrse,linear,living,lobe,lon,long,lower,make,maturing,mos,mould,mucronate,nflorescence,nther,oak,often,orolla,ovat,perfect,pine,plan,poricidally,rarely,reveal,ruit,seudostipule,short,slit,specimen,stamen,straight,tall,tem,throughou,tree,tuber-bearing,typically,unit,vary,viole,wide,without,ympodial	'','hair-like,[,],``,abaxial,adaxial,anther,arrangement,characteristic,color,colour,form,fruit,growth,height,history,inflorescence,length,life,na,number,ovary,position,rachi,removal,reproduction,shape,spacing,staman,surface,texture,value,violet,wet,width,{,}
524	wfo-0001029652	success	160	99	70	90	29	0.438	.3,.5,0.5-4,0.75-1,0.8-1,1,1-3,1.5-2,2,2.5-3,3/4,4-4.5,abaxially,adaxially,along,anther,apex,base,cm,corolla,curling,deflexed,elliptic-ovate,filament,filiform,flower,glabrous,globose,golden,green,greenish-white,hard,leaf,lobed,long-acuminate,long-styled,maturity,middle,minor,minutely,mm,narrowly,occasionally,opposite,ovary,ovoid-reniform,pale,papillose,pedicel,petiole,pitted,pubescent,shaped,short-styled,shrub,simple,slender,stigma,style,surface,tan,tear-drop,tip,trichome,uniseriate,vein,way,white,widest,x	.25,0.5-1,1-2,2-2.5,2-4,25,3.5-4,6-15,7-9,anthesi,apar,ape,apical,arch,arching,attenuate,ba,bark,bearing,berry,broadly,calyx,cone,conical,deciduous,deltate,denser,dia,differing,difoliate,drying,eaf,edicel,eed,evenly,exserted,free,fruiting,geminat,golden-red,heteromorphic,hispid,included,joining,lamina,lateral,like,lobe,lon,long,lower,main,major,margin,midrib,minute,near,nflorescence,older,pair,papillo,pericarp,pore,poricidal,portion,projection,reddish-brown,reflexed,ruit,scar,series,size,slende,slightly,soon,spaced,sparsely,stem,swollen,tall,thickened,time,tub,tube,ud,undulate,unit,within,ympodial,young	abaxial,adaxial,apart,arrangement,color,colour,diameter,form,fruit,growth,height,history,inflorescence,length,life,na,number,peduncle,perennial,plant,position,rachi,reproduction,seed,shape,spacing,staman,texture,width
525	wfo-0001029662	success	181	133	99	82	34	0.547	.3,.5,0.5,1,1.5,12,15,20,4-rayed,5-6,6-7,7-14,abaxially,accrescent,adaxially,andromonecious,anther,apart,apex,articulated,base,calyx,campanulate,caudate,chartaceous,cm,color,cylindrical,diameter,distally,equal,expanded,extra-axillary,filament,flower,fragrant,fruit,fruiting,glabrous,hair,herb,leaf,lightly,like,linear-tapered,lobe,lobed,margin,mm,nearly,oblong-ovate,oblong-ovoid,obtuse,opposite,ovate,pedicel,peduncle,per,perhaps,petiole,pilose,plant,prickle,pubescent,rachi,recurved,reflexed,repand,rounded,sessile,shallowly,shape,side,simple,slender,slightly,small,somewhat,sparsely,stellae,stellate,stellate-pentagonal,stem,stigma,straight,style,subcordate,thickened,tip,tomentose,truncate,tube,unbranched,unequal,unknown,vine,white,x,yellow	0.7–1,0.7–3,1.4,1.7–3.5,1–3.5,2,2-,2–3,2–3-celled,3-foliate,3.2,3.5,3.5–6,3–4,4–5,5–7.5,9–11,absent,acicular,adaxiall,ag,armed,axe,ba,blade,capitat,connivent,creeping,curve,directed,eaf,eed,erect,fertile,free,geminat,glabrou,half,ilament,immature,including,lateral,less,long,longitudinal,lower,lowest,m.,major,midpoint,minute,nflorescence,node,offset,one,opening,orolla,pore,portion,probably,ray,ripe,rooting,ruit,shorter,size,slit,spaced,striaght,tal,tem,triangular,two,unarmed,uniform,unit,vary,vein,way,wide,widely,ympodial	0.7-1,0.7-3,1.7-3.5,2-3,3-4,9-11,abaxial,arrangement,articulation,branching,capitate,corolla,curved,expansion,form,fragrance,growth,height,history,inflorescence,length,life,number,obtusenes,ovary,perennial,position,reproduction,seed,spacing,surface,texture,variation,width
526	wfo-0001029673	success	159	115	95	64	20	0.597	0.5-1,0.7-1.1,0.75-1,1-10,1-2,1-5,1.2-3.5,1.5-2,2-2.5,2-3,2-4,3/4,4-6,5-25,5.5-15,abaxial,abaxially,acuminate,acute,adaxial,adaxially,age,anther,anthesi,apex,apical,appearing,basal,base,becoming,black,branch,branching,broadly,clavate,cm,corolla,deep,dendritic,densely,diameter,elliptic,filament,flower,fork,fruit,glabrous,globose,growth,lamina,later,lateral,leaf,length,lenticular,minutely,mm,narrowly,nodding,occasionally,ovary,overtopping,pedicel,pericarp,petal,petiole,pitted,planar,pore,poricidal,pubescent,purple,pyramidal,reddish-brown,reflexed,shoot,shrub,slightly,slit-like,small,sparsely,stigma,style,surface,tapering,terminal,thin,time,tip,tree,trichome,vein,violet,winged,x	.5,0.8-1,1.5-1.8,10-20,2.5,3-5,absent,accrescent,along,bark,berry,blade,calyx,conical,decurrent,deflexed,deltoid,denser,dichasia,eaf,edicel,eed,ew,exserted,free,fruiting,greyish,greyish-yello,greyish-yellow,individual,inserted,like,lobe,lon,long,longer,lower,m.,monochasial,nflorescence,older,pair,papillo,plurifoliate,portion,prominent,ruit,scar,secondary,sleeve,somewhat,stamen,stem,strongly,tall,triangular,tub,tube,ud,unit,wide,woody,ympodial,young	arrangement,color,form,height,history,inflorescence,life,na,number,papillose,perennial,plant,position,reproduction,seed,shape,size,staman,texture,width
527	wfo-0001029680	success	212	125	79	133	46	0.373	0.1,0.6,12,50,abaxially,acute,adaxially,annual,anther,anthesi,apart,apex,articulated,axillary,base,bipinnate,blue,branched,brown,clavate,cm,densely,diameter,filament,flattened,fleshy,flower,fruit,glabrous,globose,green,hair,herb,indistinct,leaf,length,light,long,midrib,mm,moderately,node,obovate,obtuse,pale,pedicel,peduncle,pentagonal,petiole,pinnae,pinnate,pitted,primary,pubescent,purple,rarely,red,ripe,rotate,secondary,shallowly,shoot,sometimes,sparsely,stem,stigma,style,subglabrous,surface,terminal,tertiary,time,tripinnate,turning,violet,white,winged,x,yellow	.0,0.4,0.5–1.5,0.6–1.2,0.6–2.0,0.9–1.0,1,1.0,1.0–1.1,1.0–1.5,1.0–1.8,1.1–1.2,1.4–2.5,1.4–7.5,1.5,1.6–2.7,1.7–7,1.8–3.8,10,11–16,11–25,1–2,1–3,1–6,1–8,2.2–4.2,2–20,3.0–4.2,3.3–5.5,3–22,3–6,4.0–16,4.0–6.5,4.5–20,4.5–7.0,4–10,4–30,5,5.5–8.5,5–11,7–10,8–32,absen,adaxiall,ag,along,appressed,arequipa,arranged,asymmetrically,axe,ba,becoming,beyond,blade,borne,calyx,cell,connivent,cylindrical,decreasing,decurrent,difoliate,divided,eaf,eed,entire,equal,erect,extending,flange,forming,geminat,irregularly,lobe,lon,longitudinal,lower,m.,margin,multicellular,narrow,nflorescence,oblong,occasionally,often,opening,orolla,ovate,pair,parallel,pendant,perfect,plurifoliate,pore,poricidal,prostrate,rapidly,ruit,running,shaped,side,simple,size,spaced,specimen,split,stone,straight,tacna,tal,tamen,tear-drop,tem,tip,tube,unicellular,uniseriate,unit,usually,vary,wide,wing,winge,woody,ympodial,–10,–12.5,–19,–3,–3.2,–46,–48	0.6-1.2,1-2,1-8,1.0-1.5,1.7-7,11-16,11-25,12.5,2-20,3,3-22,3.0-4.2,4-10,4-30,4.5-20,4.5-7.0,46,48,5-11,8-32,abaxial,adaxial,arrangement,color,colour,corolla,decurred,form,growth,height,history,inflorescence,life,na,number,ovary,plant,position,rachi,reproduction,seed,shape,spacing,staman,texture,width
528	wfo-0001029685	success	288	128	104	184	24	0.361	.5,0.5-1.5,1-2,1-4,1-5,1-7,1.3-1.5,1.5-5,1.5-6,1/3-4/5,10-20,2-3,3-5,3-7,3.5-4,30-60°,4-10,5.5-7,abaxially,acute,adaxially,anther,apex,armed,bark,base,berry,branched,bright,brown,cell,clavate,clearly,cm,corolla,cuneate,curved,densely,diameter,distance,drying,faint,filament,finely,flat,flattened-reniform,flower,fruit,glabrous,globose,lateral,leaf,length,lobe,lobed,longer,margin,maturity,mauve,midvein,mm,oblique,often,orange,orange-brown,outline,ovate,ovoid,pair,pedicel,peduncle,petiole,pit,prickle,primary,pubescent,rachi,raised,rarely,red-brown,rest,ridged,shiny,simple,slightly,small,smooth,sparsely,stellate,stellate-pubescent,stigma,straight,style,surface,terminal,tertiary,thin,truncate,unbranched,vein,venation,visible,yellow,yellow-green	.2,.4,.8,/3,0-15,0.1,0.1-0.2,0.1-0.3,0.2,0.2-0.8,0.5,0.5-1,0.7-1.5,0.7-1.8,1-1.3,1.5,1/2-2/3,1/3,1/3-2/3,1/6-1/3,10,2-6,2.1-3,2.5-3,2.5-3.7,20,3,3-20,3-6,3.5,3.5-16,3/4-1/2,4,4-7,4-9,4.5-6,5,5-11,5-20,5-merou,6-8,6.5-9,accrescent,age,almost,alyx,apar,apart,apically,apparently,articulated,axe,beyond,black,blade,breaking,brittle,broad-deltate,calyx,chartaceous,clump,covering,cupular,dark,deep,deltate,dense,development,difoliate,discolorous,divided,dorsal,downward,eaf,eed,elongating,equal,erect,exserted,extending,filiform,finger-hair,flattened,free,fruiting,geminat,glabrescent,grey-brow,growing,inflated,infructescence,irregula,irregular,lengthening,less,long,long-acuminate,long-deltate,longitudinal,lower,mature,midpoint,minute,mixture,moderately,much,nflorescence,obconical,obovate,older,one,open,opening,orange-translucent,orolla,oung,ovoi,papillae,papillo,partly,patch,per,perfect,pericarp,persisting,point,pore,poricidal,porrect,portion,pronounced,ray,reduced,reflexed,regular,ri,robust,rounded,ruit,scar,secondary,sessile,shrub,side,sinus,slender,slit,sometimes,somewhat,spaced,specimen,spherical,spreading,stalk,stalked,stem,stout,strongly,stump,tamen,tapering,terete,thick,throughout,time,tip,toward,translucent,trichome,tube,ud,unarmed,unit,upper,usually,variously,vary,well-developed,wide,widest,woody,x1.5-2,ympodial,×	5-merous,abaxial,adaxial,angle,arrangement,color,colour,extension,grey-brown,height,inflorescence,number,ovary,papillose,plant,position,reproduction,seed,shape,spacing,staman,texture,visibility,width
529	wfo-0001029691	success	223	136	110	113	26	0.493	%,0-6,0.2-0.4,0.25-0.45,0.3-0.45,0.3-0.7,0.4-0.5,0.5-0.8,0.8-2.5,1-1.1,1-5,1-6,1.2-1.7,1.4-2,1.5-4,1.7-2.7,11-14,13-25,140-320,18-23,2-3,2.5-4,2.5-8,3-4,36-50,6-10,6.5-8.5,8-14,absent,acicular,acute,adaxially,andromonoecious,anther,apart,apex,articulated,attenuate,base,broadly,calyx,chartaceous,cm,cuneate,decimetre,densely,diameter,eglandular,entire,extra-axillary,filament,finger,flower,fruit,glabrous,gland-tipped,globose,green,hair,herbaceous,index,inflorescence,lamina,lateral,length,lilac,lobed,long,margin,mid-point,midpoint,minutely,mm,moderately,obtuse,orbicular,ovate,pale,pedicel,peduncle,per,petiole,plant,porrect,present,prickle,prostrate,rachi,ray,resprouter,reticulate,rotate,shallowly,shape,short,sparsely,sprawling,stellate,stellate-pubescent,stigma,straight,style,surface,thick,time,unbranched,weakly,white,yellow,yellowish-green	-8,0-0.1,0.3-1.4,0.5-0.7,0.5-1,0.8-1.2,0.8-1.6,1-2,1-locular,1.1-2.1,1.6-2.1,10,100-400,13-18,13-20,3-6,3-7,3.3-3.5,4-8,40-250,5-,5-8,5-merou,5.5-9,6-8,6.5-10,abaxially,absen,abundant,accrescent,across,adaxiall,adult,alyx,armed,axe,ba,blade,branche,brown,bursting,cone,connivent,cross-section,curved,cylindrical,directed,distall,eaf,eed,elliptica,equalling,exocarp,fruiting,functional,half,heterostylous,included,incomplete,interpetalar,juicy,lanceolate,less,lobe,lobing,lon,longer,lower,mature,maturity,mesocarp,midvein,minute,moist,nflorescence,oblique,orolla,part,petal,placenta,pore,presen,readily,rounded,ruit,septum,sessile,side,simple,slightly,spaced,stage,stalk,stellae,summit,tal,tamen,tem,throughout,tip,tissue,toward,transparent,truncat,tube,unit,unknow,uvenile,vary,vein,wide,x,ympodial	5-merous,abaxial,adaxial,color,colour,corolla,elliptical,form,growth,height,history,leaf,life,number,ovary,percentage,position,reproduction,seed,spacing,staman,stem,texture,thicknes,truncate,width
530	wfo-0001029704	success	146	95	62	84	33	0.425	0-1.5,1,1.5,1.5-2.5,1.5-3,2-3,3-4-celled,3-5,4,7-10,acuminate,acute,anther,apex,blue,branch,broadly,brown,calyx,cell,cm,conical,corolla,dark,ellipsoid,extra-axillary,few-flowered,filament,flower,fork,fruiting,glabrous,globose,green,leaf,less,minutely,mm,mottled,obovate,obovoid,occasionally,ovary,pedicel,peduncle,petiole,pinnatisect,pubescent,purple,reddish,reticulate,shrub,simple,stellate,stigma,striped,style,subdiscoidal,surface,trichome,variable,white	-17,-3,.5,0.5,1-2,1-4,10-14,1000-1200,140-185,15-25,2-2.5,2-5,4-7,5,7-,9-20,acuman,along,also,anthesi,apparently,aspect,axi,base,berry,c.,composed,cunate,cuneate,cut,deeply,deflexed,dia,diam,eaf,eed,enlarged,erect,especially,exerted,flowering,gradually,halfway,lanceolate,lengthening,lobe,lobed,long,lower,midrib,minute,moderately,nflorescence,one,plurifoliat,pore,poricidal,record,rounded,ruit,shoot,short,single,sinus,slit,sombre,sprawling,stone,stout,straight,subglobo,swollen,tip,tub,tube,twig,ud,unit,variously,vein,within,x,ympodial,young	abaxial,adaxial,arrangement,bud,center,color,colour,diameter,form,fruit,growth,height,history,inflorescence,length,life,na,new,number,perennial,plant,position,rachi,reproduction,scar,seed,shape,spacing,staman,stem,subglobose,texture,width
531	wfo-0001029727	invalid_json_followup	260	138	114	146	24	0.438	-1/3,-10,-3,/3,0-2,0-30,0-4,0-40,0-8,0.1-5,0.15-0.3,0.4-1,0.5-3,0.7-0.9,1,1-1.2,1-4,1.5-2.5,1.5-5.5,1.6-3,1/8-1/5,2-5,2.5-5.5,2.8-4,3-11,3-6,3-7,4.5,5.5-7,abaxial,abaxially,acuminate,acute,adaxial,anther,apart,apex,apically,apparently,bark,base,berry,blade,chartaceous,clavate,climber,cm,cordate,corolla,cupular,curved,densely,diameter,erect,filament,filiform,finely,flattened-reniform,flower,free,leaf,length,less,lobe,lobed,long,margin,mauve,minutely,mm,moderately,narrow-deltate,obconical,oblong,orange-brown,ovate,pair,papillose,pedicel,peduncle,per,perfect,petiole,pitted,porrect,portion,prickle,primary,red-brown,rounded,scandent,seed,sessile,shallowly,shape,shrub,smooth,stalked,stellate-pubescent,stem,stigma,straight,style,subentire,surface,tertiary,trichome,tube,variously,vein,venation,visible,way,wide	.5,0-15,0-20,0-5,0.15-0.2,0.2,0.2-0.5,0.2-2.5,0.3,0.4,0.5,0.5-1.2,0.7-1,1-,1-2,1.2-2,1.5-2.3,1.5-3,1/2-2/3,1/3-1/2,1/4,2.5,2.5-3.2,3/,4-7,4-merou,4-merous,4.5-,5-12,5-8,5-9,6-11,7-10,acicular,age,almost,along,alternate,alyx,ame,anthesi,apar,articulated,branched,bristle,brown,c.,calyx,colourles,connivent,covered,darker,deltate,deltoid,developing,different,dimorphic,discolorous,divided,drying,eaf,edge,eed,elongating,equal,except,extending,ferrugineous,filiform-acuminat,fissure,geminate,glabrous,increasing,inside,lateral,lengthening,like,lon,longer,lower,m.,mature,middle,midpoint,midvein,minor,mixture,nflorescence,nther,occasional,older,one,open,orolla,oung,outside,papillo,perfec,pit,plurifoliat,pore,poricidal,prickl,prickly,protruding,pubescent,raised,rarely,ray,red-brow,reddish,reduced,regular,scar,series,short,simple,sinus,size,sometimes,spaced,spreading,stalk,stellate,strongly,tamen,tapering,tearing,terete,terminal,time,tip,toward,translucent,transverse,unarmed,uneven,unit,upper,variable,vary,violet,x,yellowish,ympodial,young	'',2.5-3,[,``,characteristic,color,form,fruit,growth,height,inflorescence,na,number,ovary,plant,relative,reproduction,spacing,texture,value,visibility,width,{,}
532	wfo-0001029728	success	238	118	81	157	37	0.34	.6,0.5-1.5,1.6,2,7,abaxially,abundantly,acicular,acute,anther,anthesi,apex,base,broadly,brownish,bud,cm,compressed,cylindrical,diameter,dimorphic,early,enlarged,extra-axillary,filament,flattened-reniform,flower,fruit,glabrous,glandular-pilose,globose,golden,green,late,leaf,length,light,lobed,long,margin,mature,maturity,minutely,mm,narrowly,nearly,numerous,ovate,pair,pedicel,peduncle,petiole,pilose,pitted,pubescent,rachi,sessile,shallowly,shrub,simple,slender,spine,stellae,stellate,stem,stigma,straight,style,subcordate,suborbicular,surface,tan,terete,thin-textured,triangular,truncate,unbranched,white,wide,yellow,yellowish	0.2,0.3,0.3–0.4,0.4–2,0.5–0.9,0.6–1.5,0.7–1.2,0.8,0.8–1.6,0.8–2.5,0–0.5,1.2–2.3,1.5–2,1.7–2.5,1/3,11,12–20,1–,1–2,1–2-celled,2-foliate,2.4–3.6,2.7-3.1,2.8,200-310,260,2–3,2–4,2–4-celled,3,3.4–4.5,3.5–5.5,3–18,3–5,4,4.5-5.5,4–10,4–14cm,4–15,4–6-rayed,5,6.2–8.1,7-10,7–12,7–14,7–15,8–10.5,9,=,absent,accrescent,adaxiall,adaxially,admixture,armed,around,ascending,auxiliary,axe,becoming,blade,branche,calyx,capitat,cell,column,contiguou,curled,curved,densely,differing,directed,distall,eaf,eed,erect,exceeding,fallen,fertile,fewer,free,frui,fruiting,geminate,generally,glabrou,gland-tipped,glandular,grading,hair,half,horizontally,hyaline,intermixed,lanceolate,larger,least,lobe,longer,lower,lowermost,main,major,many,midpoint,minute,mixed,much,n,nflorescence,obtuse,often,one,orolla,per,plane,pore,prickle,pubescence,ray,recurved,reflexed,relatively,ruit,scarcely,scattered,short-pilose,shorter,similar,similarly,single-stemmed,size,slightly,small,smaller,sparsely,spreading,stout,tall,tamen,tem,terminal,tip,triangular-lanceolate,tube,undulate,unit,usually,various,vary,vein,wid,withered,x,ympodial,–4,–5	0-0.5,0.5-0.9,0.6-1.5,1.7-2.5,12-20,2-4,3-5,4-10,4-6-rayed,6.2-8.1,7-12,abaxial,adaxial,arrangement,capitate,color,colour,contiguous,corolla,form,growth,height,history,inflorescence,life,na,number,ovary,perennial,plant,position,reproduction,seed,shape,spacing,staman,texture
533	wfo-0001029731	success	246	137	114	132	23	0.463	.5,.6,0.1-0.8,1,1-2,1-2.5,1.5,1.5-2.5,2.5,3,4,4-5,4-9,7-11,8-9,abaxially,accrescent,acquiring,acuminate,acute,adaxially,almost,along,anther,apex,apically,bark,base,becoming,black,boundary,branch,brown,bumpy,calyx,clavate,clearly,cm,conical,corolla,cuneate,delimited,diameter,dilated,distributed,drying,elliptic,enlarge,entire,epiphyte,erect,evenly,faint,finely,fruit,fruiting,glabrous,ground,lateral,leaf,less,liana,linear,lobed,long-ellipsoid,longitudinal,longitudinally,margin,mauve,midvein,mm,obconical,oblong,obovate,orange-brown,pair,papillose,pedicel,peduncle,pendulous,petiole,primary,prominent,pyriform,raised,rarely,reflexed,revolute,ribbed,ridge,ridged,rounded,scar,several,slender,sometimes,stem,stigma,stump,style,sunk,surface,terminal,thick,usually,vein,venation,visible,white,widely,winged,woody,x,yellow-green	0.05,0.25-0.3,1-1.5,1.5-3,1/3,10-20,1994,2,2-3,2-6,2.5-4.5,3-10,3-4,31,6,6-7,age,alyx,anthesi,apar,apparently,arcy,articulated,basal,basally,beak,berry,branched,branching,broadly,concolorous,connate,coriaceous,crinkled,darker,delineated,deltoid,dense,development,different,domatia,dorsal,dorsifixed,dry,dull,eaf,early,elongating,equal,even,exserted,filament,filiform,fine,flaring,flattened,fleshy,flower,free,hair,iscoid,lamina,large,later,lengthening,like,lobe,lon,long,lower,main,mature,maturity,much,narrowly,nflorescence,nther,obtuse,occasionally,often,orolla,papillae,part,perfec,pericarp,persisting,plurifoliat,pore,poricidal,portion,protruding,rachi,rakotozafy,reported,ruit,see,shallowly,shorter,simple,sinus,slightly,small,smaller,smoot,sparsely,straight,stretched,succulent,tearing,thickened,thinner,though,time,tip,toward,trichome,tub,tube,tuft,ud,unit,vary,ventral,visibl,well-developed,wide,wing,wrinkling,yellow,ympodial,young,’	abaxial,accrescence,adaxial,arrangement,colour,discoid,form,growth,height,inflorescence,length,na,ovary,plant,position,reflexion,ribbing,ridging,shape,spacing,texture,visibility,width
534	wfo-0001029741	success	137	107	68	69	39	0.496	1-3.5,1.1-1.3,1.5,1.5-4,1.5-6,2-2.5,3,?,accrescent,acute,age,anther,anthesi,apex,apiculate,base,calyx,capitate,closely,cm,corolla,dark,deflexed,deltoid,difoliate,early,elliptic,erect,exserted,filament,flower,fruit,fruiting,furcate,glabrous,globose,green,growth,inflorescence,leaf,lenticellate,lobe,lobed,minutely,mm,nearly,new,opposite,ovary,ovate,overlapping,papillose,pedicel,petiole,shrub,slender,slightly,spaced,stem,stigma,style,tapering,tree,tube,unit,variable,weak,white	.4,.5,0.5-1.5,0.8-3.5,0.9-1.2,1-1.5,10-50-flowered,2.2-9,2.5-7.8,9.5-22.5,attenuate,becoming,berry,black,branched,ca,caly,completely,dia,differing,divisio,dry,drying,eaf,edicel,eed,free,geminat,glabrou,immature,known,lateral,lighter,lon,long,lower,main,major,middle,minor,nflorescence,pair,papillo,planar,pore,poricidal,portion,produced,prominent,proximal,quite,raised,reddish-brown,ruit,scar,shaped,size,straight,tall,tear-drop,tip,ud,usually,vein,widest,wood,woody,x,ympodial	0.5,1,1.4,10-50,3.5,7.5,abaxial,accrescence,adaxial,arrangement,bud,color,colour,diameter,difoliation,exsertion,form,geminate,gemination,height,history,length,life,na,number,papillation,peduncle,plant,position,rachi,reproduction,seed,shape,spacing,staman,surface,sympodial,texture,width
535	wfo-0001029744	success	113	87	63	50	24	0.558	0.3-0.6,0.5-1,2-4,5-8,50,8-11,abaxially,acute,adaxially,apart,apex,bark,base,beginning,blunt,branch,cm,dendritic,densely,distinct,elliptic,entire,examined,flattened,form,fruit,glabrous,golden,incrassate,lanceolate,leaf,long-acuminate,looping,margin,marginal,mature,minutely,mm,narrowly,oblanceolate,opposite,ovoid-reniform,pair,pale,pedicel,petiole,pitted,primary,pubescent,revolute,scar,shape,shrub,similar,simple,single-celled,slightly,surface,thee,tip,trichome,uniseriate,vein	1,1.5,1.5-3.2,2,7-15,8-10-flowered,along,brow,calyx,deltate,denser,difoliate,eaf,eed,extreme,fide,flexuous,geminate,glabrescent,inflorescenc,lamina,leave,lobe,lower,major,minor,nflorescence,node,non-reproductive,oblique,occasionally,older,pubescence,see,small,smaller,smith,sometimes,somewhat,spaced,stem,thin,ud,unicellular,unifoliate,unit,white,x,ympodial,young	8-10,abaxial,adaxial,arrangement,brown,color,examination,flower,green,growth,hair,height,inflorescence,length,maturity,na,number,plant,position,seed,spacing,texture,variation,width
536	wfo-0001029746	success	179	109	93	86	16	0.52	0.3-2,0.7-1,1,1-1.3,1-1.5,1.5,2-7,2-8,3-4,3-6,4-9,8-11,acuminate,acute,anther,apex,base,berry,blackish,broadly,brown,calyx,capitate,centre,cm,color,conical,cordate,corolla,cup-shaped,dark,darker,densely,diameter,ellipsoid,entire,erect,exerted,flattened,fleshy,flower,fruit,glandular,globose,greenish,herb,heteromorphic,hollow,inflorescence,internodal,leaf,lobe,long,margin,minutely,mm,nodding,orange,ovary,ovate,ovoid,pale,papillose,pedicel,peduncle,petiole,pitted,principal,pubescent,purple,red,reddish,reflexed,shallowly,simple,slender,slightly,somewhat,sparse,stem,stigma,strongly,style,subshrub,surface,thin,tip,triangular,trichome,uniseriate,vein,x,–3	.5,0.5-1,1.2-1.5,2,2-2.5,2-4,3,3-4-pluri-foliate,3-4.5,6,6-7,8-10,abaxially,adaxially,age,anthesi,apart,bearing,becoming,c.,cell,ciliate,crenate,crowded,curved,eaf,edicel,eed,elliptic,enlarged,filament,flush,free,fruiting,glabrous,gland-tipped,growing,horn,irregularly,lamina,lengthening,less,lon,longer,longest,lower,markedly,mature,maturit,mid-length,mixed,narrowly,near,nflorescence,occasionally,pair,papillo,pericarp,plan,pore,poricidal,portion,primary,pubescen,rachi,ruit,scar,shortest,single,slit,spaced,sparsely,spreading,straight,testal,third,tube,ud,unit,upper,upward,wall,widely,widest,woody,ympodial	abaxial,adaxial,arrangement,bud,form,growth,height,length,na,number,plant,position,seed,shape,size,texture
537	wfo-0001029751	success	158	88	55	103	33	0.348	1.2,1.7,3,5-merous,acicular,anther,apex,apical,capitate,clavate,cm,compressed,corolla,covered,deltoid,diameter,enlarged,extra-axillary,fruit,geminate,glandular,globose,globose-ellipsoid,hair,leaf,length,membranaceous,mm,moderately,opening,orbicular,outside,ovary,pedicel,peduncle,petiole,pore,pubescent,scorpioid,shrub,simple,small,solitary,sometimes,sparsely,stellate,stigma,style,surface,toward,trichome,white,winged,yellow,±	.5,0.6–1.6,1,1.3–2.6,1.8–4,10–11,10–19,12–14,1–2,1–3,2,2.2–2.5,2.5–5,2–3,2–4-celled,2–5,3–9,4,4.5–6,5–10,5–25-flowered,6,8–9,9–18,also,armed,attenuate,base,blade,broad-based,broadly,calyx,celled,central,cuneate,di-,diam,eaf,eed,eglandular,elongate,equal,geminat,glabrous,gree,immature,inner,lanceolate,lateral,linear,linear-lanceolate,little,lobe,lon,long,longer,lower,midpoint,midvein,needlelike,nflorescence,one,pair,pedunculate,perfect,planar,prickle,prickly,ray,recurved,ripe,ruit,sessile,shallow,short,short-stalked,shorter,size,smaller,somewhat,spreading,stalked,straight,subcordate,subtended,tal,tem,tooth,triangular,trifoliate,truncate,twice,unarmed,unbranched,unequal,unit,upper,usually,variegated,whitish,wide,ympodial,×	1.8-4,10-11,2.2-2.5,3-5-25-flowered,3-9,8-9,abaxial,adaxial,arrangement,color,colour,filament,flower,form,green,growth,height,history,inflorescence,life,na,number,perennial,plant,position,rachi,reproduction,seed,shape,spacing,staman,texture,width
538	wfo-0001029758	success	261	96	70	191	26	0.268	.2,.5,0.2,5.8,7.6,acuminate,aequilateral,anther,apex,arcuate,attachment,attenuate,base,bud,capitate,chartaceous,cm,cordate,corolla,cylindrical,dark,deltoid,densely,diameter,entire,extra-axillary,filament,flattened-orbicular,flattened-reniform,flower,fruit,glabrous,globose,green,lateral,length,lobed,margin,markedly,mm,notched,obtuse,occasionally,orbicular,oval,ovate,pedicel,peduncle,petiole,point,porrect,pubescent,purple,ray,red-brown,rounded,simple,stellae,stellate,stellate-pubescent,stem,stigma,stipe,style,sub-coriaceous,surface,vein,white,yellow,yellow-brown	.3,/4,0.4–1.2,0.5–0.7,0.6–0.9,0.7–0.8,0.7–1.3,0.8–1.1,0.8–1.3,0.9–1.0,0.9–1.2,0.9–1.5,1.0–3.4,1.1–1.5,1.1–1.8,1.2–1.4,1.2–1.9,1.3–1.7,1.7–2.8,1.8,1.9–2.6,1.9–2.7,1/3,1/4–1/3,10.3–14.5,2.1–6.2,2.2–2.9,2.3–3.3,2.3–6.4,2.8–2.9,2.8–4.2,3.1–3.8,3.2–3.5,3.5–4.8,3.6,4.1–6.3,4.3–4.8,4.3–6.2,4–6,5-merou,5.7–7.8,7–17,7–9,8.0–33.1,8–11,abaxially,absent,adaxially,adnate,ag,alyx,anthesi,apart,apical,apparently,appearing,appresse,arching,around,articulate,axe,ba,basal,bent,berry,black,blade,broad,brochidodromous,bulge,calyx,channeled,cream,curved,dentate,development,directed,directly,distal,distally,distinct,dry,eaf,edge,eed,either,emerging,endocarp,equal,erect,evenly,exocarp,extending,fertile,filiform,flexed,free,geminat,glossy,gradually,gree,heterostylous,immature,increasing,intact,internode,interpetalar,intersepalar,juic,lanceolate,layer,least,lobe,lon,long,longer,lower,many,mature,midpoint,midrib,midvein,minute,moderately,nearly,nflorescence,observed,often,opaque,orolla,ove,per,perforated,persistent,petalar,pore,portion,potentially,presumably,prostrate,raised,remaining,reticulate,ridge,rigid,row,ruit,short,short-stipitate,shorter,shrub,side,sinus,sloughing,spaced,splitting,spread,spreading,stamen,stipitate,straight,suture,tamen,tem,tetrafoliate,thin,though,tip,tissue,toward,transparent,trifoliate,tube,two,ud,unarmed,unbranched,unit,various,vary,weakly,well,well-developed,wide,yellow-ferruginous,ympodial,young,±90°,±a,¼,×	0.5-0.7,0.6-0.9,0.7-1.3,0.8-1.3,0.9-1.0,1.0-3.4,1.1-1.8,1.2-1.9,1.3-1.7,10.3-14.5,2.2-2.9,2.8-2.9,7-17,7-9,arrangement,color,height,inflorescence,leaf,number,ovary,plant,seed,shape,staman,texture
539	wfo-0001029769	success	142	94	59	83	35	0.415	.25,.5,1-3,1.5-2,1.5-2.5,4,4-5,5-8,6-17,7-8,acuminate,anther,anthesi,apex,bark,base,branch,brown,calyx,capitate,cm,corolla,dark,deflexed,densely,elliptic,exserted,filament,filiform,flower,fruiting,glabrous,globose,green,horizontally,internodal,leaf,lobed,minutely,mm,opposite,ovary,ovoid-reniform,papillose,pedicel,petiole,pitted,pubescent,shaped,shrub,simple,smooth,sparsely,stigma,style,surface,tear-drop,tube,white	0.5-1.5,1-1.2,2.5-3,2.5-8,3.5-4,30-60-flowered,8-9,8.5-17,abaxially,acute,adaxially,along,apar,ape,archin,ba,bearing,berry,brochidodromu,cerro,conical,curl-tipped,cyathiform,deltoid,dia,eaf,edicel,eed,free,fresh,golden,hen,inglé,lateral,less,like,lobe,lon,long,lower,main,margin,midrib,nearly,nflorescence,older,onto,pair,papillo,pore,poricidal,portion,puberulent,reflexed,ried,ruit,scar,scattered,somewhat,spaced,stem,straight,swollen,tall,three,time,tip,trichome,tub,two,ud,unevenly,unifoliat,uniseriate,unit,vein,wide,widely,winged,woody,x,ympodial,young	30-60,abaxial,adaxial,apart,arching,arrangement,bud,color,colour,deflexion,diameter,exsertion,form,fruit,growth,height,history,inflorescence,length,life,na,number,peduncle,perennial,plant,position,rachi,reproduction,seed,shape,spacing,staman,texture,unifoliate,width
540	wfo-0001029771	success	196	93	75	121	18	0.383	.5,0-0.5,0-0.6,0-5,0.3-1,0.4-1.4,0.7-1.2,0.8-1.2,0.9-1,1-1.5,1-2,2-3,3-4,4-7,5.5-8,6-11,absent,anther,base,branch,chartaceous,cm,densely,diameter,dm,extra-axillary,filament,fruit,glabrous,gland-tipped,globose,green,grey,grey-green,hair,inflorescence,juvenile,lateral,leaf,length,lilac,long,mid-point,midpoint,mm,ovate,pale,pedicel,peduncle,per,petiole,present,prickle,pseudo-umbellate,purple,rachi,ray,red,reniform,reticulate,rotate,rotate-stellate,scattered,short,simple,stellate-pubescent,stigma,style,surface,time,unbranched,white,x,yellow,yellowish	%,0-0.25,0-3,0-4,0.05-0.15,0.1-0.3,0.2-0.25,0.2-0.4,0.3-0.6,0.4-0.7,0.4-1,0.45-0.9,0.5-0.7,0.5-1.2,0.7-1.8,1,1-5,1-locular,1.2-2.8,1.8-3,15-35,2,2-2.3,2-3-foliate,2.5-10,2.5-7,4-,4.5-12,5-10,5-9,5-merou,7-10,7-8,abaxially,absen,accrescent,across,acute,adaxially,adult,alyx,apart,apex,apparen,articulated,axe,ba,blade,calyx,capitat,connivent,contiguous,cordate,curved,cylindrical,deltate,directed,distall,distributed,eaf,eed,eglandular,elliptic,entire,erect,exceeding,exocarp,finger,flower,fruiting,geminate,incomplete,interpetalar,juicy,lamina,lanceolate,lobe,lon,lower,margin,mature,mesocarp,minute,nearly,nflorescence,oblique,obtuse,orolla,part,perennial,perfect,placenta,pore,porrect,pubescent,rhizomatous,ruit,septum,shrub,slightly,somewhat,spaced,stalk,stellae,straight,succulent,tal,tamen,tem,thick,throughout,tissu,tissue,tube,unarme,unarmed,unit,upper,vary,wide,ympodial	abaxial,adaxial,arrangement,capitate,color,colour,corolla,number,ovary,position,presence,seed,shape,staman,stella,stem,texture,thicknes
541	wfo-0001029775	success	54	63	38	16	25	0.704	0.25-1.5,0.5-4,2-6,2-8,3-4,4-5.5,6-16,aggregate,alveolate,base,brown,cm,diameter,flattened,glabrous,globose,hollow,internode,light,margin,mm,orange,perennial,prickle,puberulent,ripe,sparsely,straight,strongly,subshrub,surface,thickened,trichome,unbranched,unifoliate,vine,wide,yellow	absen,ecuador,eed,long,recurve,robust,ruit,shin,stigma,tal,tem,tone-cell,truncat,unit,x,ympodial	absent,arrangement,color,form,fruit,growth,height,history,hollownes,leaf,length,life,plant,presence,recurved,ripenes,seed,shape,shinines,shiny,stem,stone-cell,texture,thicknes,width
542	wfo-0001029780	success	204	111	85	119	26	0.417	1-10,1-2,120-210,15-22,15-45,2-12,2-2.8,2-3.5,2-5.5,20-60,3.5-7.3,4-6,5-7,50-70,600-950,8-12,?,abaxially,acute,adaxially,anther,apex,cell,cm,condition,cordate,corolla,dark,densely,diameter,filament,flower,forked,fruit,glabrous,glandular,globose,green,green-white,greenish,head,herb,honeycomb-shaped,interjected,invested,leaflet,length,minutely,mm,mucilaginous,non-glandular,obtuse,odd-pinnate,orbicular,ovate,ovoid,pair,pale,pedicel,peduncle,petiole,petiolule,pinkish,plant,puberulent,pubescent,rotate,seed,short,size,stem,stigma,streak,stripe,style,terminal,testal,throughout,tip,trichome,tuber,unwinged,white,whitish,yellow	1-1.2,1.4-1.9,1.5-2,11-24,2-2.5,2.4-4.2,3,3-6,4.5-6,5-merou,5.5,5.5-13,absent,acumen,ag,along,alyx,apart,apparently,articulated,attenuate,axe,axillary,base,berry,blade,borne,brownish,bud,capitat,chartaceous,ciliate,connivent,covering,cuneate,decumbent,digestion,distal,dorsally,drying,eaf,edge,eed,end,enzyme,erec,especially,exceeding,except,flat,folded,fresh,geminat,generally,glabrou,gland,greatly,hair,hair-like,hal,half,high,homostylous,lanceolate,lateral,lengthening,like,living,lobe,long,longer,lower,make,margin,membranous,midrib,minute,nflorescence,often,orolla,perfect,petiolulate,plurifoliate,pore,poricidal,proximal,rarely,reduced,removed,ripe,ruit,sessile,seudostipule,singly,slit,spaced,specimen,stamen,ste,stolo,straight,subequal,subtending,tall,tamen,tem,tetralobulate,thick,tri-,truncate,tube,typically,unit,usually,vary,wall,wet,x,ympodial	abaxial,adaxial,arrangement,capitate,color,colour,form,growth,height,history,inflorescence,leaf,life,na,number,ovary,perennial,position,rachi,reproduction,shape,spacing,staman,surface,texture,width
543	wfo-0001029784	success	237	107	83	154	24	0.35	-12,-5,.5,0.2-0.3,0.25-0.3,0.3-0.5,0.4-0.45,0.5-1.5,0.6-1,0.9-1.2,1-1.2,1-4,2,2-2.5,5-10,abaxial,acute,anther,apex,articulated,berry,broadly,brown,calyx,capitate,cm,conical,corolla,dark,densely,diameter,distal,due,eglandular,elliptic,enclosing,filament,flower,fruit,fruiting,globose,golden,green,hair-like,half,herb,imparipinnate,inflorescence,interrupted,like,long,loosely,mm,narrowly,obovate,often,outgrowth,ovary,pale,paler,pedicel,peduncle,pentagonal,perennial,petiole,plant,pubescence,pubescent,simple,soft,sparsely,stem,stigma,stripe,style,surface,trailing,trichome,uniseriate,unseriate,velvety,white,yellow	.1,.2,0-4,0.1-,0.1-0.15,0.1-0.5,0.2,0.2-,0.2-0.5,0.3-0.35,0.3-0.4,0.3-1,0.4-,0.4-0.5,0.4-0.6,0.5,0.5-,0.7-1.2,1,1-,1-1.1,1-1.5,1-2,1-2-celled,1.0-1.3,1.2-2.5,1.5-,1.7-2.6,1/3,2-,2-3-celled,2-4,2-4.5,2-foliate,2-locular,2.5-3.5,2/3,3-,3-5,5-14,5-8,abaxially,absent,abundant,acuminate,adaxially,adpressed,along,angled,anthesi,apical,appearance,appendage,arising,articulation,axi,basal,base,basicopically,beneath,bract,cell,column,crenate-serrate,crenation,decurrent,deeper,developed,distributed,eaf,edicel,eed,entire,evenly,exserted,giving,glabrescent,glabrous,glandular,gree,hal,halfway,head,included,interjected,internode,interspersed,irregularly,lamina,lanceolate,larger,lateral,leaflet,live,lobe,lon,long-acuminate,lower,margin,markedly,maturing,mostly,multicellular,nflorescence,node,northern,occasionally,orbicular,pair,patent,petiolule,population,present,primary,proximal,pseudostipule,rarely,reflexed,ripe,robust,ruit,scattered,secondary,sessile,silky,smaller,sometimes,somewhat,sparse,spreadin,staminal,sterile,stout,straight,strongly,tem,terminal,tertiary,testa,thick,truncate,tube,ud,undulate,unicellular,unit,usually,vein,wall,wide,winged,woody,x,ympodial	2-14,adaxial,arrangement,bud,color,colour,form,growth,height,history,leaf,length,life,na,number,prickle,reproduction,seed,shape,spacing,spreading,staman,texture,width
544	wfo-0001029785	success	223	148	121	102	27	0.543	0-3,0.1-0.5,1-10,1-2,1.2-3.2,1.5-3.6,1.8-3.5,10-26,3-8,3.5-5,5-9,6,8-11,abaxially,adaxially,along,anther,apart,apparently,articulation,axillary,base,broadly,brownish,bud,cell,chartaceous,clavate,cm,commonly,condition,cordate,corolla,covering,cuneate,dark,darker,denser,diameter,digestion,distal,drying,elliptic,enzyme,especially,filament,flower,forked,fresh,fruit,glabrous,globose,green,green-white,greenish,hair,hair-like,herb,honeycomb-shaped,interjected,lateral,leaf,leaflet,like,long,make,margin,medium,membranous,middle,midrib,minutely,mm,mucilaginous,oblique,obovate,odd-pinnate,orbicular,outer,ovate,ovoid,pair,pedicel,peduncle,pentagonal,perfect,petiole,plant,point,puberulent,pubescent,purple,purple-tinged,quite,removed,ripe,rotate,rounded,scale-like,seed,shallowly,slightly,sparsely,stem,stigma,style,subtending,terminal,testal,thick,throughout,truncate,tuber,typically,variable,vein,violet,wall,wet,whitish,yellow	0-2,0.3-2.2,0.4-4.9,0.8-1,1-1.2,1-5,1.8-7,2-4,3-4,3-6,3.8-7.2,4-10.5,5-16,5-merou,absent,acumen,acute,ag,alyx,apex,attenuate,axe,berry,blade,borne,capitat,connivent,decreasing,decumbent,dorsally,eaf,edge,eed,end,erec,exceeding,flat,folded,geminat,generally,glabrou,greatly,half,homostylous,invested,lanceolate,larger,lengthening,living,lobe,lower,markedly,minute,mottled,much,multiple-celled,nflorescence,non-glandular,obtuse,one-quarte,orolla,pale,petiolulate,petiolule,plurifoliate,pore,poricidal,present,rarely,ruit,sessile,seudostipule,short,singly,size,slit,sometimes,spaced,specimen,stamen,ste,stolo,straight,stripe,subglabrous,tall,tamen,tem,tip,toward,tri-,tube,unbranched,unequal,unit,unwinged,usually,vary,white,wide,x,ympodial	abaxial,adaxial,arrangement,capitate,color,colour,form,growth,height,history,inflorescence,length,life,na,number,one-quarter,ovary,perennial,position,pseudostipule,rachi,reproduction,shape,spacing,staman,surface,texture
545	wfo-0001029788	success	194	120	92	102	28	0.474	0-5,1-10,1-2,1.2-2,12-15,2-2.5,2-4,25-30,3.5-6,4-5,5,6.5-7,abaxially,absent,acuminate,adaxially,anther,apex,articulated,asymmetrical,base,basiscopic,berry,brownish,cell,chartaceous,cm,commonly,condition,conical,corolla,covering,densely,diameter,distal,drying,elliptic,elliptic-lanceolate,filament,flower,forked,fresh,glabrous,green,green-white,greenish,hair-like,half,herb,interjected,lateral,leaf,leaflet,light,long,make,minute,minutely,mm,mucilaginous,narrow,odd-pinnate,orbicular,ovoid,pedicel,peduncle,petiole,petiolule,plant,puberulent,pubescent,ripe,rotate,seed,side,size,slightly,sparsely,stigma,style,subsessile,symmetrical,terminal,testal,thick,throughout,tissue,violet,wall,wet,whitish,yellow	.4,.7,0.5,0.7-2,1.5-2,2.4-5.5,3-4,4,4-6,4.5-5,5-13,5-merou,6,7-21,acumen,ag,along,alyx,apart,attenuate,axe,axillary,blade,borne,bud,c.,capitat,ciliate,connivent,decreasing,digestion,dorsally,eaf,edge,eed,end,enzyme,equal,erec,especially,flat,folded,geminat,generally,glabrou,gradually,hal,homostylous,honeycomb-shaped,increasing,lanceolate,larger,lengthening,living,lobe,lon,lower,margin,middle,midrib,mottled,nflorescence,orolla,pair,pilo,plurifoliate,pore,poricidal,purple,ray,removed,ruit,secondary,semierect,sessile,seudostipule,singly,slit,spaced,specimen,stolo,straight,subequal,subtending,tall,tamen,tem,tip,toward,tri-,tube,tuber,typically,unit,unwinged,usually,vary,white,wide,wing,x,ympodial	abaxial,adaxial,arrangement,capitate,color,colour,form,fruit,growth,height,history,inflorescence,length,life,na,number,ovary,perennial,position,pseudostipule,rachi,reproduction,shape,spacing,staman,surface,texture,width
546	wfo-0001029789	success	167	115	86	81	29	0.515	0-2,0.2-0.5,1-10,1-2,1-3,12,2-25,2-6.5,2.7-4.7,3-8.5,4-13,5-7,6-7,7-21,8-9,abaxially,acuminate,acute,adaxially,anther,apex,apparently,attenuate,base,blue,broadly,clavate,cm,corolla,decreasing,decurrent,diameter,distal,filament,flower,forked,fruit,glabrous,green,half,herb,interjected,leaf,leaflet,lengthening,light,lilac,linear,long-attenuate,lunate,minute,minutely,mm,narrowly,odd-pinnate,orbicular,ovary,ovate,pair,pedicel,peduncle,pentagonal,perfect,petiole,plant,pore,poricidal,pubescent,rachi,rotate,sessile,short,size,slit,sparsely,sterile,stigma,style,subglabrous,terminal,tip,toward,tube,typically,white,yellow	0.5-2.8,0.8-3.5,1.5-2,1.7-8.5,1.8-6.5,2-3,2-6,3-5,4-10,5-merou,6,7-16.6,acumen,adaxiall,ag,alyx,apart,articulated,axe,axillary,basiscopic,blade,bud,capitat,chartaceous,connivent,dark,dorsally,eaf,edge,eed,erec,exceeding,flat,folded,formed,geminat,generally,greatly,hair,hal,homostylous,lanceolate,lant,lateral,like,lobe,long,lower,maturing,membranous,mottled,never,nflorescence,orolla,petiolulate,plurifoliate,pubescen,purpl,rarely,seudostipule,side,simple,slightly,spaced,stamen,star,ste,straight,subequal,subtending,tall,tamen,tem,tinged,tri-,unit,usually,vary,x,ympodial	abaxial,adaxial,age,arrangement,articulation,calyx,capitate,color,colour,form,growth,height,history,inflorescence,length,life,na,number,perennial,perfection,position,pseudostipule,reproduction,seed,shape,spacing,staman,surface,texture
547	wfo-0001029810	success	149	120	90	59	30	0.604	.5,0.5-3,1-1.5,1-10,1.1-2.3,1.5-3,2-5,3-3.5,4-10,5-6,acuminate,acute,adaxially,along,anther,apex,apically,arachnoid,attenuate,bark,base,brown,calyx,capitate,closely,cm,corolla,dark,dendritic,densely,dia,ellipsoid,elliptic,glabrous,globose,green,inflorescence,internodal,large,later,leaf,lenticel,like,lobed,long,margin,minor,minutely,mm,narrowly,nearly,occasionally,opposite,ovary,ovoid-reniform,pale,papillose,pedicel,petiole,pitted,pointed,pore,poricidal,pubescent,reddish-brown,rest,shaped,shining,shrub,simple,size,slender,small,spaced,sparsely,stigma,style,surface,tan,tapering,tear-drop,tip,tree,trichome,tube,vein,white,wide,yellowish,young	.25,0.5-1,1-1.3,1-2,1-3,2-3,2.5-3,3-4,3-6,5-15-flowered,5-16,8-12,abaxially,anthesi,ape,berry,compact,compressed,congested,conical,deflexed,deltate,differing,difoliate,drying,eaf,edicel,eed,exserted,filament,fleshy,free,fruiting,geminat,glabrou,lateral,less,lobe,lon,lower,main,major,middle,nflorescence,older,overlappin,papillo,planar,portion,ruit,scar,stem,tall,tub,ud,unit,widest,woody,ympodial	5-15,abaxial,adaxial,alternate,arrangement,bud,color,colour,flower,form,fruit,growth,height,history,length,life,na,number,overlapping,peduncle,perennial,plant,position,rachi,reproduction,seed,shape,spacing,texture,width
548	wfo-0001029811	success	225	97	83	142	14	0.369	-3,-6,-merous,0-35,0.1-0.4,0.3-1,0.3-1.5,1.3-1.7,1.5-2.5,1.5-6,2-2.5,2.5-3,2.8-3.2,3-5,3-5.5,3-7,4.5-5,5,5-11,5-9,6-12,7-9,8-12,abaxial,anther,apart,apex,apparently,bark,base,berry,cm,cordate,cuneate,dark,diameter,eye,faint,filament,flattened-reniform,flower,fruit,glabrous,lateral,leaf,length,lobed,long,margin,mauve,midpoint,mm,moderately,multangulate,naked,obtuse,orange-brown,ovate,pair,pedicel,peduncle,petiole,plant,porrect,prickle,primary,sessile,sometimes,spherical,stalked,stellate,stellate-pubescent,stem,style,surface,terete,tertiary,trichome,vein,venation,visible,wide,yellow	.5,/3,0,0-30,0.1-0.3,0.2,0.2-0.6,0.5-2,0.8-1.5,1,1-1.5,1-2.5,1-3,1/,1/2-2/3,1/3,1/3-2/3,10-22,13-20,15-23,15-50,2-5,2-5.5,20-100,3.5-4.5,4-8,5-17,5-40,7-18,8-18,abaxially,acicular,adaxial,alyx,andromonoecious,apar,apically,articulated,blade,broad-deltate,brown,calyx,cell,chartaceous,connivent,cream,densely,discolorous,distal,distance,drying,eaf,eed,elongate,elongating,equal,erect,extending,fewer,flattened,free,fruiting,glandular,green,green-brow,hair,herb,hermaphrodite,heterostylous,inflated,infructescence,less,lobe,lobing,long-acuminat,long-styled,longer,lower,lowermost,marking,mature,maturity,midvein,minute,narrow-deltate,nflorescence,often,older,one,open,orolla,oung,outline,pale,pendulous,per,pericarp,perpendicular,pit,plurifoliat,poricidal,portion,prickl,prickly,raised,ray,ruit,scandent,scar,secondary,short,short-styled,shorter,shrub,side,simple,slightly,small,smooth,spaced,sparsely,spreading,stalk,staminat,stout,straight,tamen,tapering,time,tip,tube,unarmed,unbranched,unit,upper,usually,vary,way,woody,yellow-green,ympodial,young	color,corolla,height,inflorescence,number,ovary,seed,shape,size,spacing,staman,texture,visibility,width
549	wfo-0001029938	success	179	99	73	106	26	0.408	0.7-1.2,1-1.5,1-4,1.5-2,10-20,2.5-3,3-7,6-8,abaxially,acute,anther,anthesi,apex,appearing,bark,base,becoming,berry,black,bright,capitate,clavate,cm,corolla,dendritic,densely,diameter,elliptic,filament,flattened,flower,fruit,glabrous,globose,greenish,grey,growth,later,lateral,leaf,length,lenticular,lobe,maturity,minutely,mm,narrowly,occasionally,ovary,pedicel,petiole,pitted,planar,plant,pubescent,pyramidal,raised,red,reddish-brown,scar,shrub,small,somewhat,stem,stigma,style,surface,tapering,terminal,tree,trichome,violet,white	.5,0,0.5,0.7-1,1,1-2.5,1-3,1.2-1.5,1.5-2.5,1/2,12,12-15,2-2.5,3/4,4,5,6-9,8-10,absent,accrescent,adaxially,along,apical,ba,basal,blade,branching,broader,calyx,conical,deciduous,deflexed,deltoid,denser,dichasia,discussion,drying,eaf,edicel,eed,elliptical,entire,ew,exserted,fine,free,fruiting,glabrate,glabrou,growing,horizontal,inserted,larger,lon,long,long-triangular,lower,m.,margin,monochasial,near,nflorescence,older,overtopping,pair,papillo,parallel,per,perhaps,pericarp,plane,plurifoliate,pore,poricidal,portion,prominent,ruit,secondary,see,shade,shoot,sleeve,slit-like,soon,sparsely,specimen,stamen,strongly,tall,thin,time,tip,tub,tube,ud,unit,upon,upper,vein,way,wide,winged,woody,x,ympodial,young	abaxial,adaxial,arrangement,color,colour,form,height,history,inflorescence,life,na,number,papillose,peduncle,perennial,position,pubescence,rachi,reproduction,seed,shape,spacing,staman,texture,type,width
550	wfo-0001029945	success	211	124	101	110	23	0.479	0-0.6,0-1,0.35-0.45,0.4-0.5,0.7-1.2,1-1.3,1-8,1.3-3.5,1.5-4,1.7-4,10-17,2-30,2.1-3.3,3-9,4-5.5,4-9,6-7,6-8,7-9,9-10,abaxial,absent,acicular,acute,adaxial,adaxially,andromonoecious,anther,apart,apex,base,broad-based,broadly,chartaceous,cm,cordate,cylindrical,dark,deeply,densely,diameter,distally,eglandular,extra-axillary,filament,flower,fruit,glabrous,gland-tipped,globose,green,hair,index,inflorescence,lateral,leaf,length,lobed,long,margin,markedly,midpoint,midvein,mixed,mm,obtuse,ovate,pale,pedicel,peduncle,per,perennial,petiole,plant,porrect,present,prickle,pseudo-racemose,purple,ray,rhizomatous,rotate,sessile,shallowly,short,shrub,stellate,stellate-pubescent,stigma,straight,streak,style,surface,thicker,throughout,time,triangular,vein,white,yellow,yellowish	%,.05,0,0-0.3,0-0.5,0-10,0-2,0.15-0.25,0.2-0.3,0.4-0.7,0.5,0.8-1,1-1.5,1-3,1.2-1.6,1.4-2.7,1.8-2.4,15-24,17-26,2-4,2-5,2-locular,2.5-2.8,3-17,3-5,3-6,4-10,4-7,5-8,5-merou,5.5-17,6-10,7-14,7-24,9-24,abaxially,absen,accrescent,across,adaxiall,adult,alyx,anvil-shape,armed,articulated,attenuate,ba,blade,calyx,connivent,cross-section,d.,directed,distall,dult,eaf,eed,erect,exocarp,finger,fruiting,functional,geminate,grey,half,heterostylous,hig,juicy,juvenile,lanceolate,less,lobe,lobing,lon,longer,lower,mature,mesocarp,mid-point,minute,moist,nflorescence,oblique,orolla,pair,part,placenta,pore,ruit,side,simple,sparsely,stalk,stalked,stellae,stem,tamen,thick,transparent,truncat,tube,unarmed,unbranched,unit,upper,vary,weakly,wide,x,ympodial	0.05,arrangement,color,colour,corolla,dm,form,growth,height,history,life,na,number,ovary,position,reproduction,seed,shape,spacing,staman,stylar,texture,truncate
551	wfo-0001029968	success	299	119	96	203	23	0.321	0.1-0.25,0.25-0.3,0.4,0.5,0.7-2,0.8-1.2,1.5-2.5,1.5-3,2.5-3.5,3-11,4,4-8,6-8,acuminate,anther,apex,apically,bark,berry,black,branched,brown,calyx,capitate,chartaceous,clavate,clustered,cm,corolla,cupular,curved,dark,deltoid,densely,diameter,dilated,drying,entire,fasciculate,filament,finely,flattened,flattened-reniform,flower,fruit,fruiting,glabrous,gray,grey-green,greyish,inflorescence,inside,lateral,leaf,length,less,margin,mixture,mm,obconical,oblong,orange,orange-brown,outside,ovate,ovoid,pale,paler,pedicel,peduncle,perfect,petiole,pitted,porrect,prickle,pubescent,rachi,red,reddish,rounded,seed,shiny,shrub,smooth,spheroidal,stellate,stellate-pubescent,stigma,straight,style,surface,terete,terminal,translucent,trichome,x	-2,-3,.2,.25,.5,.7,/3,0,0.15,0.2-0.4,0.25,0.3,0.3-0.4,0.3-1,0.4-0.6,0.7-0.9,0.7-1,0°,1,1-2.5,1-3,1.2-5.5,1.5,1/4-1/3,1/6-1/8,2-2.3,2-3,2.5-4,2.5-5.5,2.8-3,3-4,4-6,4-7,4-merou,7-9,abaxially,absent,accrescent,acicular,acute,adaxially,adjacent,age,almost,along,alternate,alyx,anthesi,apart,apparently,area,arising,armed,articulated,articulation,basally,base,becoming,brachyblast,branch,branching,ca,canaliculate,central,cordate,covered,cuneate,dehiscence,detaching,development,discolorous,distributed,divided,dry,eaf,early,edge,eed,ellipsoi,elongating,equal,erect,evenly,except,extending,filiform,flat,flexuous,forming,free,glabrescent,increasing,indumentum,invisible,irregular,irregularly,large,large-leaved,leave,leaved,lengt,lengthening,like,line,lobe,lobed,lobing,long,looping,lower,m.,main,mature,maturity,middle,midpoint,midvein,minor,network,nflorescence,nther,oblique,obscured,obscurely,occasionally,often,opposite,orolla,pair,papillose,patch,pendulous,per,pericarp,pit,plurifoliat,pore,poricidal,portion,present,primary,prior,prominent,protruding,raised,ray,reduced,regular,remnant,ridged,rounded-undulate,ruit,scar,secondary,seemingly,seen,sessile,shoot,shorter,simple,sinus,size,small,small-leaved,smoot,sometimes,somewhat,sparse,sparsely,specimen,spreading,stalk,stalked,stem,strongly,stump,tapering,tearing,tertiary,thicker,thin,tip,toward,tube,ud,unarme,unarmed,undulate,uneven,unit,usually,variable,vary,vein,venation,virtually,visible,white,wide,widening,wrinkled,ympodial,young	0.7,2.5,abaxial,adaxial,arrangement,bud,color,colour,ellipsoid,form,growth,height,na,number,ovary,plant,position,reproduction,shape,spacing,staman,texture,width
552	wfo-0001029978	success	208	125	97	111	28	0.466	0.5-0.6,0.7-1.9,0.9-2.3,1-10,1-2,1.5-3.1,1.8-5,11-19,15-27,3.2-2.5,3.7-8.1,4-7,4.2-5.2,5,8-10,abaxially,acuminate,adaxially,along,anther,apex,articulated,axillary,bead,berry,brownish,bud,cell,chartaceous,clavate,cm,coarsely,condition,conical,corolla,covering,dark,diameter,drying,elliptic,filament,finely,flower,forked,fresh,fruit,glabrous,green,greenish,hair,hair-like,herb,homostylous,honeycomb-shaped,lateral,leaf,leaflet,light,like,long,medium,membranous,minute,minutely,mm,moniliform,necklace,odd-pinnate,ovate,ovoid,pedicel,peduncle,pentagonal,petiole,petiolule,plant,puberulent,pubescent,purple,ripe,rotate,seed,size,stem,stigma,stolon,style,subtending,terminal,testal,thick,tuber,wall,wet,whitish,x,yellow	0.3-0.4,0.3-0.7,0.8,1.3-1.5,1.4-1.5,2-4,3-5,3-7,3.1-6.3,3.5-9.5,4-11,5-16.5,5-merou,acumen,ag,alyx,apart,apparently,arranged,asymmetrical,attenuate,axe,base,basiscopic,blade,capitat,ciliate,commonly,connivent,darker,decreasing,digestion,distal,dorsally,eaf,edge,eed,enzyme,erec,especially,exceeding,flat,folded,fourt,geminat,generally,glabrou,gradually,green-white,half,interjected,lanceolate,larger,lengthening,less,living,lobe,lower,make,margin,middle,midrib,mottled,mucilaginous,multiple,narrow,nflorescence,orbicular,orolla,pair,perfect,plurifoliate,pore,poricidal,pubescen,ray,removed,ruit,secondary,semierect,sessile,seudostipule,side,simple,slightly,slit,spaced,sparsely,specimen,stamen,ste,straight,subequal,subsessile,symmetrical,tall,tamen,tem,throughout,tip,tissue,toward,tri-,tube,typically,unit,usually,vary,wide,wing,ympodial	abaxial,adaxial,arrangement,capitate,color,colour,form,growth,height,history,inflorescence,length,life,mucilaginousnes,na,number,ovary,perennial,position,pseudostipule,rachi,reproduction,shape,spacing,staman,surface,texture,width
553	wfo-0001029980	invalid_json_followup	173	109	73	100	36	0.422	.5,0.1-0.25,0.5-1.2,0.5-2.5,0.5-5,0.7-1.3,1-1.5,1.2-2.5,2-5,2/3,acute,anther,apex,bark,base,bright,brown,bud,calyx,cm,conical,corolla,curved,dark,decurrent,elliptic,filament,flattened-reniform,glabrous,globose,gray,green,greenish-white,leaf,lobed,minutely,mm,node,opposite,ovary,ovate,pale,papillose,pedicel,petiole,pitted,plant,puberulent,rounded,shape,shaped,shiny,shrub,simple,slender,slightly,small-capitate,stem,stigma,straight,style,surface,tan,tapering,tear-drop,tip,trichome,tube,tuft,uniseriate,way,white,winged	.1,0.25-0.5,0.25-1,0.5-1,0.8-1.2,0.9-4.5,1-1.7,1.5-2,1.5-6,2-6,3-4,3-9,5-10,5-50-flowered,6.4-17,abaxially,adaxially,anthesi,apar,appearing,appressed,axil,ba,berry,black,closely,deflexed,deltoid,density,dia,differing,difoliate,dried,drying,eaf,edicel,eed,elevation,especially,exserted,five,free,fruiting,geminat,greatly,high,impressed,incrassate,knob,lateral,live,lobe,lon,long,lower,main,major,margin,material,middle,minor,near,nflorescence,often,older,one,onto,orbicular,overlapping,pair,paler,pore,poricidal,portion,prominent,proximal,race,reflexed,ruit,scar,side,size,somewhat,soon,spaced,specimen,tall,ud,unicellular,unit,varying,vein,venezuelan,whit,widest,woody,x,yellowish,ympodial,young	'',5-50,[,``,abaxial,adaxial,apart,arrangement,characteristic,color,colour,diameter,flower,form,fruit,growth,height,history,inflorescence,length,life,na,number,peduncle,perennial,position,rachi,reproduction,seed,spacing,staman,texture,value,width,{,}
554	wfo-0001029989	success	161	99	67	94	32	0.416	0.25-0.5,0.5-1,0.5-1.5,1-1.5,1-2,1-2.5,3-5,3-8,abaxial,abaxially,acute,adaxially,anther,apex,base,capitate,closely,cm,corolla,densely,difoliate,dimaeter,elliptic,filament,flattened,glabrous,globose,green,greenish-black,heteromorphic,incrassate,inflorescence,internodal,leaf,lenticular,lobed,margin,minutely,mm,nearly,nodding,occasionally,opposite,ovary,pedicel,petiole,pitted,pore,poricidal,pubescent,reddish-brown,shaped,shining,shrub,simple,small,spaced,sparsely,stigma,style,surface,tear-drop,tip,tree,tube,unifoliate,white	.2,.5,/2,1-4,1.3-2.3,1.5-2.5,10-14,2.5-3,3.5-8,4-4.5,5-10-flowered,5-6,7-20,anthesi,bark,berry,branch,branched,broadly,brownish-re,calyx,central,collection,congested,conical,deflexed,deltoid,dendritic,dense,described,dia,discussion,drying,due,eaf,edicel,eed,erect,exserted,fleshy,free,fruiting,geminat,golden,gray,inflorescenc,lamina,lateral,like,lobe,lon,long,lower,main,middle,nflorescence,northern,older,overlappin,pair,papillo,peru,peruvian,perú,petal,petaloid,planar,population,portion,probably,pubescence,reddish,rest,ruit,scar,scattered,see,short-style,somewhat,stem,tall,tree-like,trichome,ud,unit,vein,way,wide,widest,woody,x,yellow,ympodial,young	0.2,1,2.5-6,5-10,adaxial,arrangement,color,colour,diameter,flower,form,fruit,growth,height,history,length,life,na,number,overlapping,papillose,peduncle,perennial,plant,position,rachi,reproduction,seed,shape,spacing,texture,width
555	wfo-0001030000	success	155	115	87	68	28	0.561	-4,0.5-14,0.5-3,1,1-10,1-2,1.5-,10-,15-25,2-2.5,2-5,3-16,3-4,3.5-5,30-50,acute,adaxially,aggregate,also,apart,apex,apiculate,articulated,base,calyx,chartaceous,cm,connective,conspicuous,coriaceous,deltate,densely,diameter,dilated,distally,eglandular,ellipsoidal,flattened,flower,fruit,glabrous,globose,green,hair,immature,leaving,lobe,long,mature,mm,moderately,oblong,obtuse,occasionally,orange,ovoid,pedicel,pedicellar,peduncle,pilose,puberulent,pubescent,purplish,rachi,radiu,rarely,remnant,scar,shrub,small,sparsely,spotted,stellate,stigma,strongly,style,tinge,tip,tree,truncate,umbrella-shaped,unbranched,white,x,yellow,yellow-brown,yellowish	-5,-50,-7,-pilose,0.5-,0.5-1,1-,1.5-2,10-20,2-3,2-4,2.5-,2.5-3,2.5-3.5,25-30,3-,4,4-4.5,4-5,4-foliat,7-15,abaxially,absent,ape,axe,biglandula,cell,ciliat,connivent,creamy-whit,cucullate,dia,directed,eed,equal,exceeding,laterally,lon,lower,margin,narrowly,nflorescence,nther,orolla,perfect,pore,produced,pubescen,ruit,shorter,slightly,smal,spaced,stamen,stone,subcoriaceous,swelling,tal,tem,thecae,tomentose,triangular,tube,ud,unit,vary,wide,ympodial	4-foliate,anther,arrangement,biglandular,bud,color,corolla,form,growth,height,history,inflorescence,leaf,length,life,na,number,ovary,plant,reproduction,seed,shape,size,spacing,stem,surface,texture,theca
556	wfo-0001030000	success	178	131	99	79	32	0.556	-4,-5,-pilose,0.5-1,0.5-13,0.5-14,0.5-3,1,1-10,1-2,1.5-,1.5-2,15-25,2-2.5,2-5,3-16,30-50,4,4-5,abaxially,absent,acuminate,acute,adaxially,aggregate,also,apart,apex,apiculate,articulated,base,calyx,cell,chartaceous,cm,connective,conspicuous,coriaceous,deltate,densely,dia,diameter,ellipsoidal,flattened,flower,fruit,glabrescent,glabrous,globose,green,immature,leaving,lobe,long,mature,mm,moderately,oblong,obtuse,occasionally,orange,ovate,ovoid,pedicel,pedicellar,peduncle,petiole,pilose,produced,puberulent,pubescent,purplish,rachi,radiu,rarely,remnant,scar,shrub,simple,small,sparsely,spotted,stellate,stigma,stone,style,swelling,tinge,tip,tree,truncate,unbranched,vein,white,wide,x,yellow,yellow-brown,yellowish	-2,-50,-7,0.5-,1-,1-1.5,1-5,10-,10-20,2-,2-3,2-4,2.5-,2.5-3,2.5-3.5,25-30,3-,3-4,3.5-5,4-25,4-4.5,4-foliat,5-25,7-15,ape,axe,basal,biglandula,blade,ciliat,connivent,cordate,creamy-whit,cucullate,dilated,directed,distally,eaf,eed,eglandular,elliptic,entire,equal,exceeding,hair,laterally,lon,lower,margin,narrowly,nflorescence,nther,oblique,often,orolla,perfect,pilo,pore,pubescen,ruit,shorter,slightly,smal,spaced,stamen,strongly,subcoriaceous,tal,tem,thecae,time,tomentose,triangular,tube,ud,umbrella-shaped,unit,vary,ympodial	abaxial,adaxial,anther,arrangement,biglandular,bud,color,colour,corolla,creamy-white,filament,form,growth,height,history,inflorescence,leaf,length,life,na,number,ovary,plant,position,reproduction,seed,shape,spacing,staman,surface,texture,width
557	wfo-0001030004	success	177	115	85	92	30	0.48	0-0.5,0-1.5,0.2-1,1-1.5,1-2,1.2-2,15,2-20,3-4,5-25,abaxial,across,acuminate,acute,adaxially,anther,anthesi,apex,bark,base,branched,branching,calyx,capitate,cm,corolla,crotaloid,densely,elliptic,erect,exserted,filament,flattened-reniform,fleshy,glabrous,globose,green,hard,inflorescence,later,lateral,leaf,like,lobed,many,minutely,mm,nearly,obovate,obovoid,occasionally,onto,ovary,pale,pedicel,petiole,pitted,planar,plant,plurifoliate,pubescent,scar,seed,sessile,shrub,small,spaced,sparsely,stem,stigma,stout,strongly,style,surface,tan,terminal,time,tree,tube,unevenly,white,winged,woody,yellowish,yellowish-green	.3,0.3-1,0.8-1.1,1.5-2.5,15-20,20-200-flowered,3-3.5,3.5-5,4-15,9-30,abaxially,along,always,apar,appearanc,axillary,barely,basal,berry,blade,body,broadly,bushy,collection,cone,conical,decurrent,deltate,dendritic,dense,denser,dia,diamete,distal,drying,eaf,edicel,eed,especially,flat,free,fruiting,giving,greenish-yello,incrassate,juvenile,knob,lamina,large,lobe,long,loose,lower,main,margin,middle,much,nflorescence,often,older,pair,papillate,papillo,pericarp,pore,poricidal,portion,possessing,prominent,pubescence,rest,ruit,shaped,simple,surpassing,tall,tear-drop,thick,thin,tip,translucent,trichome,tub,tuft,ud,variously,vein,wide,widest,x,ympodia,young	20-200,adaxial,apart,arrangement,bud,color,colour,diameter,flower,form,frequency,fruit,greenish-yellow,growth,height,history,length,life,na,number,peduncle,perennial,position,rachi,reproduction,shape,spacing,staman,texture,width
558	wfo-0001030007	success	168	131	100	68	31	0.595	.05,.4,.5,0.1-0.5,0.2-1,0.8-1,1-1.5,1-15,1-2,1.6-2.2,2-4,3/4,4.5-5,7-9,acuminate,acute,along,anther,anthesi,apart,apex,bark,base,beneath,branched,brown,bud,calyx,clavate,cm,corolla,decurrent,densely,dia,dry,elliptic,erect,exserted,filament,flattened,fleshy,fruiting,glabrous,globose,golden,green,hooded,leaf,live,lobed,long,longer,material,midrib,minutely,mm,occasionally,one,opposite,ovary,pale,papillose,pedicel,petiole,pitted,planar,plant,pore,pubescent,reniform,rest,shaped,short,shrub,simple,slender,slightly,small,soft,soon,stem,stigma,straight,style,surface,tapering,tear-drop,thick,tip,tree,trichome,tube,type,uniseriate,way,white,winged,woody,x,young	0.5-1,1.5-5,15-20,2-7,3-5,6-10-flowered,7-10,abrupt,ba,becoming,berry,broadly,campanulate,closely,cork,dark,deltoid,difoliate,edicel,eed,free,geminateleaf,glabrate,golden-pubescent,gre,impressed,incrassate,inflorescenc,lateral,like,lobe,lon,lower,main,major,margin,middle,minor,nflorescence,oblique,obovoid,older,onto,outline,pair,papillo,poricidal,portion,prominent,raised,rounded,ruit,scar,shorter,spaced,sparsely,specimen,tall,thickened,trunk,tub,two,ud,unit,vein,widening,widest,ympodial	6-10,abaxial,adaxial,arrangement,color,colour,diameter,exsertion,flower,form,fruit,grey,growth,height,history,inflorescence,length,life,na,number,peduncle,perennial,position,rachi,reproduction,seed,shape,spacing,staman,texture,width
559	wfo-0001030010	success	156	82	60	96	22	0.385	.75,0.5-5,0.9-1.1,1.2-1.5,1.5-2,2-2.2,2-7,4-4.5,5-7,acuminate,acute,anther,apex,bark,brown,bud,closely,cm,corolla,dark,deflexed,fleshy,fruit,furcate,glabrous,globose,green,grey,hooded,leaf,lobed,margin,minutely,mm,nearly,obovate,opposite,ovary,ovoid-reniform,papillose,pedicel,petiole,pitted,shaped,shrub,simple,slightly,small,smooth,spaced,stigma,style,surface,tear-drop,tip,tree,white,winged,woody,x	.5,/4,0.7-1,1-1.3,1-1.5,1-2,10-15,10-50-flowered,11-12,2.5,20-40,3-5,7-10,anthesi,appearing,area,attenuate,basal,base,beneath,berry,calyx,cyathiform,deciduous,decurrent,deltate,dia,differing,difoliate,distal,dry,eaf,edicel,eed,ellipsoid,exserted,f,filament,free,fruiting,geminat,glabrate,lateral,lobe,lon,long,lower,m.,main,major,materia,material,middle,midrib,minor,minute,near,nflorescence,occasionally,often,older,one,orange,overlappin,pair,persistent,planar,pore,poricidal,portion,prominent,puberulent,rather,reddish,ruit,scar,shin,size,soon,stem,straight,styl,tall,tapering,tiny,trichome,trunk,tube,ud,uniseriate,unit,vein,way,widest,ympodial,young	10-50,abaxial,adaxial,color,diameter,flower,form,growth,height,inflorescence,length,na,number,overlapping,plant,position,seed,shape,shiny,spacing,texture,width
560	wfo-0001030023	success	171	108	74	97	34	0.433	1-2,1-8,1.5-7,10-25,11-40+,2-3,2.5-3.5,30-50+,4-10,4-12,6-7,7-9,abaxially,acute,adaxially,aggregate,apart,apex,apiculate,articulated,calyx,cell,ciliate,cm,color,connective,densely,diameter,ellipsoidal,elliptic,especially,finely,flattened,flower,fruit,glabrous,glandular-puberulent,globose,greenish-white,lanceolate,lobe,margin,mm,moderately,narrowly,oblong,ovate,pedicel,peduncle,peltiform,perfect,petiole,present,puberulent,pubescent,purplish-,rachi,radiu,short-acuminate,simple,sparsely,stellate,stigma,stone,style,tip,tree,triangular,truncate,tube,unknown,villous,yellowish,young	-,0-100+,0.5-1,1,1-,1.5-2,10-,12-18,13-20,2,20-30,3-4.5,3-5,4,4-foliat,5,5-,5-16,5-6,6-26,ape,axe,basal,base,beyond,blade,branched,capitat,connivent,cordate,cuneate,cylindrical,deeply,denser,dilated,directed,distally,eaf,eed,entire,exceeding,except,exserted,fleshy,forked,glandular-puberulen,hair,highly,leaving,lon,long,loosely,lower,main,membranaceous,narrow,near,nflorescence,nther,oblique,obtuse,occasionally,often,orolla,pedicellar,pore,presen,probably,prominent,pubescen,pubescence,pubescent-pilo,remnant,ripe,ruit,shorter,slightly,small,somewhat,spaced,stamen,subcoriaceous,swelling,tal,tem,thecae,time,ud,unbranched,unit,unknow,usually,vary,vein,wide,x,ympodial	50-100+,abaxial,adaxial,anther,arrangement,bud,capitate,colour,corolla,filament,form,growth,height,history,inflorescence,leaf,length,life,na,number,ovary,perennial,plant,position,presence,pubescent-pilose,reproduction,seed,shape,spacing,staman,surface,texture,width
561	wfo-0001030032	success	250	116	93	157	23	0.372	+,0.4-1.5,0.5,0.5-0.6,0.5-1.5,0.5-2,0.6-1.1,0.7-0.8,0.8-1.0,0.8-1.1,1-1.3,1-1.5,1-2-celled,1-3,1-celled,1.5-2,1.5-2.5,2-10,2-3-locular,2-3.5,2-4,2-5,2-60,2.4-3.5,3.0-3.5,3.5-12,30,4-6-celled,4.3-5.0,8-10,8-20,abaxially,adaxial,anther,apex,articulated,base,border,branched,bright,brown,capitate,cm,conical,corolla,densely,diameter,elliptic,filament,flower,fruit,glabrous,golden,green,hair-like,imparipinnate,interrupted,leaf,length,many,middle,mm,multicellular,oblanceolate,obovate,orbicular,outgrowth,ovary,pale,paler,pedicel,peduncle,petiole,petiolule,pseudostipule,pubescent,rachi,rotate,rotate-stellate,seed,simple,soft,stigma,style,surface,time,trichome,unicellular,uniseriate,vine,winged,woody,yellow	.05,.5,0.1-0.4,0.1-0.5,0.2,0.2-0.3,0.2-0.5,0.25-0.4,0.5-0.7,0.5-1,11-20,13-35,2,2-lobed,3,3-5,4-5,4-celled,5-plurifoliate,6-11,60-80,7-16,7.5-10,8-10-celled,absent,abundant,acuminate,acute,adaxially,along,also,anthesi,apical,appearance,appendage,articulation,basal,basally,basiscopically,bent,branche,breaking,calyx,cell,clambering,column,completely,conspicuou,dark,decurrent,deltate,densest,desne,dry,eaf,ebracteate,edicel,eed,entire,exserted,free,fruiting,give,glandular,gree,greenish-brown,halfway,hea,head,herbarium,interjected,internode,irregularly,lamina,large,larger,lateral,leaflet,leave,like,lobe,long,longest,lower,margin,markedly,midvein,mixed,moderately,much,nflorescence,node,oblique,occasionally,often,older,onto,opposite,pair,patent,pithy,present,primary,pubescence,reflexed,rest,rough,round,ruit,secondary,set,shorter,silky,slightly,smaller,sometimes,somewhat,sparsely,sparser,specimen,splitting,spreading,stamen,staminal,stem,sterile,straight,subopposite,swollen,tall,tangled,tem,terminal,tertiary,testa,thick,thickened,tiny,tip,touch,transparent,truncate,tube,ud,unit,usually,vegetatio,vein,venation,wall,weaker-walled,well-developed,white,wide,ympodial,younger,½-3/4	0.05,abaxial,arrangement,color,colour,form,growth,height,history,inflorescence,life,na,number,perennial,plant,position,reproduction,shape,spacing,staman,texture,thicknes,width
562	wfo-0001030048	success	156	100	71	85	29	0.455	0.5-1.5,1-2,1.2-2,1.3-1.6,2-5,3-5,5-8,abaxial,abaxially,acute,adaxially,anther,apex,apically,arachnoid,base,bi-colored,bi-lobed,blue,brown,clavate,closely,cm,corolla,deflexed,densely,difoliate,elliptic,felt-like,glabrous,globose,golden,green,internodal,leaf,lobed,matted,minutely,mm,nearly,opposite,ovary,ovoid-reniform,pale,papillose,pedicel,petiole,pitted,pointed,pore,poricidal,pubescent,reddish-brown,shaped,shiny,shrub,simple,small,spaced,sparsely,stigma,strongly,style,surface,tan,tear-drop,tip,tree,trichome,trifoliate,white	.5,1-1.5,1.5-3.5,1.5-7,10-16,2-3,3-3.5,4-15,4-4.5,5-10-flowered,5973,along,anthesi,ape,apparently,bark,becoming,berry,broadly,calyx,completely,conical,covered,decurrent,deltate,dia,drying,eaf,edicel,eed,ellipsoid,exserted,fide,filament,fleshy,four-angle,free,fruiting,geminat,glabrate,greyish,impressed,inflorescenc,lamina,lateral,lightly,like,lobe,lon,long,lower,main,margin,middle,nflorescence,occasionally,older,onto,overlappin,pair,papillo,planar,portion,prominent,rather,rest,ruit,scar,solomon,somewhat,stem,tall,thick,thickened,tub,tube,ud,unit,vein,wide,widest,woody,yellowish,ympodial,young	5-10,adaxial,arrangement,color,colour,diameter,flower,form,fruit,growth,height,history,inflorescence,length,life,na,number,overlapping,peduncle,perennial,plant,position,rachi,reproduction,seed,shape,spacing,texture,width
563	wfo-0001030053	success	141	86	59	82	27	0.418	0.5-1,1-1.3,1-13,1.3-3.5,1.8-2,100,2-2.5,abruptly,acuminate,acute,apex,apical,brown,calyx,cell,cm,corolla,cyathiform,diameter,elliptic,entire,exserted,far,filiform,flattened,flower,fragrant,glabrous,greenish,growth,inflorescence,irregularly,lobe,lobed,margin,minutely,mm,nipple,pale,pedicel,peduncle,petiole,pitted,rectangular,reniform,scar,shallowly,shiny,simple,spaced,surface,terminal,testal,tube,turbinate,vine,white,woody,yellowish	0.5,1.5-5.5,10-20,2.5-3,3.5-4,4-,5,5-merou,7-11,7-9,<,abscission,aiding,alyx,anthesi,apart,apiculae,ark,around,articulated,base,berry,bfeore,branch,branched,climbin,completely,coriaceous,decurrent,eaf,eed,fide,fine,frui,fruiting,hyaline,leaving,long,lower,many,mentz,near,new,nflorescence,older,orolla,pair,papilla,papillo,parallel,peg,pendant,per,perfect,plurifoliat,primary,revolute,rim,secondary,shin,shining,sleeve,slightly,small,spreadin,spreading,stem,strongly,support,tem,time,tiny,tip,truncate,twining,ud,unit,usually,vein,venation,x,ympodial	5-merous,abaxial,adaxial,arrangement,bark,bud,color,colour,exsertion,form,fragrance,height,history,leaf,length,life,na,number,plant,position,rachi,reproduction,seed,shape,spacing,texture,width
564	wfo-0001030057	success	141	72	41	100	31	0.291	1-10,2-4,2-4.5,2-6,20-30,20-80,4-10,apex,brownish,cell,cm,condition,diameter,drying,elliptic,flower,forked,fresh,fruit,globose,green,greenish,hair-like,herb,honeycomb-shaped,leaf,mm,mucilaginous,odd-pinnate,ovate,ovoid,pedicel,peduncle,petiole,plant,pubescent,seed,subglabrous,terminal,testal,whitish	-2,1-2,2-3-celled,2.1-4.1,3-5,3.5-8,4.3-8.2,5.5-12,7-14,8,8-19,abaxially,absent,acuminate,acute,adaxially,apart,apparently,articulated,axe,axillary,base,berry,blade,borne,broadly,bud,chartaceous,cordate,covering,cuneate,decreasing,digestion,distal,eaf,eed,end,enzyme,erec,extremely,geminat,generally,glabrou,greatly,green-white,hair,half,high,interjected,larger,lateral,leaflet,like,living,long,lunate,make,membranous,mottled,narrow,nflorescence,pair,perfect,petiolule,plurifoliate,purple,removed,ruit,scale-like,seudostipule,short,singly,size,small,sometimes,spaced,specimen,ste,stem,stolo,suborbicular,subtending,tall,tem,thick,thir,throughout,toward,tri-,truncate,tuber,typically,unit,unwinged,usually,wall,wet,wing,x,ympodial	abaxial,adaxial,anther,arrangement,color,colour,corolla,filament,form,glabrous,growth,height,history,inflorescence,length,life,na,number,ovary,perennial,position,rachi,reproduction,shape,spacing,staman,stigma,style,surface,texture,width
565	wfo-0001030057	success	197	108	77	120	31	0.391	-10,1-10,2-4,2-4.5,2-6,2.1-4.1,20-30,20-80,3-5,3.5-8,4-10,4.3-8.2,5-6,5.5-12,8,abaxially,adaxially,along,anther,apex,broadly,cell,cm,corolla,covering,diameter,edge,elliptic,especially,filament,flat,flower,forked,fruit,glabrous,globose,green,greenish,hair-like,herb,honeycomb-shaped,interjected,lateral,leaf,leaflet,lunate,midrib,minutely,mm,odd-pinnate,ovate,ovoid,pedicel,peduncle,pentagonal,petiole,petiolule,plant,puberulent,pubescent,rotate,scale-like,seed,stigma,style,subglabrous,suborbicular,terminal,testal,thick,tip,tuber,wall,wet,white,whitish,yellow	-2,.5-3.5,1-2,2-3,2-3-celled,2-5,5-10,5-merou,7-14,8-19,absent,acumen,acuminate,acute,ag,alyx,apart,apparently,articulated,axe,axillary,base,berry,blade,borne,brownish,bud,chartaceous,ciliate,condition,connivent,cordate,cuneate,decreasing,digestion,distal,dorsally,drying,eaf,eed,end,enzyme,erec,exceeding,extremely,folded,fresh,geminat,generally,glabrou,globo,greatly,green-white,greenish-yellow,hair,half,high,homostylous,lanceolate,larger,lengthening,like,linear,living,lobe,long,lower,make,margin,membranous,middle,mottled,mucilaginous,narrow,nflorescence,orolla,ovate-lanceolate,pair,perfect,petal,plurifoliate,pore,poricidal,purple,removed,ruit,seudostipule,short,singly,size,slit,small,sometimes,spaced,specimen,stamen,star,ste,stem,stolo,straight,striped,subtending,tall,tamen,tem,thir,throughout,toward,tri-,truncate,tube,typically,unit,unwinged,usually,vary,wing,x,ympodial	2.5-3.5,abaxial,adaxial,arrangement,ciliation,color,colour,form,growth,height,history,inflorescence,length,life,mucilaginousnes,na,number,ovary,perennial,position,pseudostipule,pubescence,rachi,reproduction,shape,spacing,staman,stolon,surface,texture,width
566	wfo-0001030067	success	206	105	81	125	24	0.393	.5,0-0.7,0-1,0-1.5,0.1-0.3,0.2-1,0.5-13,1-7,2-2.5,2.5-7,3.5-5.5,7-8,absent,acicular,anther,apex,basal,base,black,broad,broadly,brown,chartaceous,cm,cordate,cylindrical,densely,depressed-globose,diameter,eglandular,entire,extra-axillary,filament,finger,flower,fruit,glabrous,gland-tipped,globose,green,grey,hair,herbaceous,inflorescence,lateral,length,lobe,long,margin,midpoint,mm,obscure,obtuse,orbicular,ovate,pedicel,peduncle,perennial,petiole,present,prickle,pseudo-racemose,purple,rachi,ray,recurved,resprouter,rhizomatous,rotate,shallow,short,shrub,simple,stellate-pubescent,stigma,style,time,unbranched,undulate,white,yellow	%,.05,0-0.1,0-0.2,0-2,0-30,0.1-0.25,0.1-0.5,0.15-0.3,0.2-0.35,0.2-0.4,0.3-0.4,0.3-0.8,0.4-1.1,0.5-0.8,0.6-0.9,0.7-1.3,0.8-1.4,0.9-2.8,1-3,1-6,10-16,12-16,13-15,2-3,2-foliate,2.5-3.5,3-8,3.6-5.3,4.5-6,5-merou,6-18,8-11,9-18,?,abaxially,absen,abundant,accrescent,adaxiall,adaxially,alyx,apart,armed,articulated,axe,ba,blade,calyx,capitat,coating,connivent,decimetr,deltate,directed,distall,distinct,distributed,dult,eaf,eed,equal,erect,frequently,fruiting,functional,geminat,half,homostylous,interpetalar,juic,lamina,less,longer,loosely,lower,mature,mesocarp,mid-point,midvein,minute,moderately,moist,multiradiate,nflorescence,oblique,obscured,often,orolla,ovate-oblong,part,per,perfect,petal,pore,porrect,probably,pubescent,resinous,ruit,sessile,slightly,spaced,stage,stalk,stellae,stem,straight,tal,tamen,thick,thickened,throughout,tip,tissue,triangular,tube,unarmed,unit,unknow,uvenile,vary,wide,x,ympodial	abaxial,adaxial,arrangement,capitate,color,colour,corolla,form,growth,height,history,leaf,life,na,number,ovary,plant,position,reproduction,seed,shape,staman,surface,texture
567	wfo-0001030080	success	186	108	82	104	26	0.441	0.4-1.5,0.5-4,1-2,1.5-2.5,2-4,2.1-7.1,3-10,3-5,4-12,5-13.5,5-7,8-16,8-23,abaxially,absent,acuminate,adaxially,along,anther,apex,articulated,base,bead,cell,clavate,cm,coriaceous,corolla,cuneate,dark,decurrent,diameter,distal,elliptic,filament,flower,forked,fruit,glabrous,green,greenish,hair-like,half,herb,high,honeycomb-shaped,interjected,leaf,leaflet,light,like,mm,moniliform,mucilaginous,necklace,odd-pinnate,onto,ovate,ovoid,pair,pedicel,peduncle,petiole,plant,purple,pyriform,rachi,seed,size,stellate,stigma,stolon,style,terminal,testal,throughout,tuber,usually,wet,white,whitish,yellow	0.3-7,1-3,1.5-2,1.8-4.5,1999,2-3,3.3-7.7,4-7,5-merou,5.5-9.9,6.5-18.6,9.9-33,abaxiall,acumen,ag,alyx,apart,apparently,arranged,axe,axillary,berry,blade,brownish,bud,capitat,ccording,condition,connivent,covering,decreasing,digestion,dorsally,dot,drying,eaf,edge,eed,enzyme,erec,exceeding,flat,folded,fresh,geminat,generally,glabrescent,glabrou,green-white,hair,hal,homostylous,inconspicuous,lanceolate,larger,lateral,lengthening,linear,living,lobe,long,lower,make,medium,mottled,multiple,nflorescence,ochoa,orolla,perfect,plurifoliate,pore,poricidal,removed,second,seudostipule,slightly,slit,sometimes,spaced,specimen,stamen,straight,strongly,subequal,subtending,tall,tamen,tem,thick,tiny,tip,toward,tri-,tube,typically,unit,unknown,vary,wall,width,winged,x,ympodial	abaxial,adaxial,arrangement,capitate,color,colour,form,growth,height,history,inflorescence,length,life,na,number,ovary,perennial,position,presence,pseudostipule,reproduction,shape,spacing,staman,surface,texture
568	wfo-0001030081	success	157	95	67	90	28	0.427	.5,0.5-1,0.5-1.5,0.5-2.5,1,1-4,1-5,1.5,1.5-3,10-20,2-foliate,4-6,5-15,absent,acute,anther,apex,brown,center,chartaceous,cm,connected,diameter,dm,drying,edge,elliptic,elliptic-ovoid,filament,fine,flower,fruit,glabrous,globose,herb,immature,long,margin,membranaceous,mm,moderately,nearly,notch,oblong,parallel,pedicel,peduncle,petiole,placenta,pubescent,rachi,radiating,raised,ridge,rotate,running,semitransparent,shallow,small,sparsely,stigma,style,surface,swollen,white,x,yellow	0.25-0.5,1-2,1-2-celled,1-3,1.5-7,10-35,1st,2-4,2-7,2nd,3-10,3-6,5-12,abaxially,abundant,adaxiall,adaxially,along,apically,axe,base,berry,beyond,blade,calyx,cell,ciliate,cordate,decurrent,dehiscing,densely,denser,eaf,eed,emarginat,entire,equal,explosively,exserted,few-branched,flat,frui,geminat,geniculate,hair,held,interpetalar,linear-lanceolate,lobe,longer,lower,lying,maturing,maturit,mesocarp,nfloresence,obtuse,often,one,orolla,other,per,pointing,pressure,pubescen,rarely,rounded,ruit,short,single-,slightly,sometimes,stamen,straight,tal,tamen,tem,tissue,triangular,tube,two-celled,unbranched,unit,usually,vary,vein,watery,wid,woody,ympodial	abaxial,adaxial,arrangement,color,colour,corolla,form,growth,height,history,inflorescence,leaf,length,life,na,number,ovary,perennial,plant,position,reproduction,seed,shape,spacing,staman,texture,wide,width
569	wfo-0001030083	success	146	111	79	67	32	0.541	.75,0.25-0.5,0.5-1,0.5-2,0.8-1,0.8-3,1-2,1.5-3,2-3,3-4,3/4,4-6,accrescent,anther,apex,bark,base,beginning,broadly,calyx,closely,cm,corolla,cup-shaped,deeply,deltoid,dry,drying,elliptic,fleshy,flower,fruit,fruiting,glabrous,globose,green,greenish-white,hyaline,internodal,leaf,lobe,lobed,long-acuminate,minutely,mm,narrowly,near,opposite,ovary,ovate,overlapping,ovoid-reniform,pale,papillose,pedicel,petiole,pitted,poricidal,scar,shallowly,shrub,simple,slender,small-capitate,somewhat,spaced,specimen,stigma,straight,style,surface,tan,tapering,tip,translucent,tube,way,white,winged	.5,0.1,1-1.5,10-30,2,2-5-flowered,4-15,9-11,acute,anthesi,berry,dar,deciduous,decurrent,deflexed,dia,eaf,edicel,eed,elongate,exserted,greyish-re,inflorescenc,lateral,lon,long,long-styled,lower,main,membranous,middle,nflorescence,older,onto,pair,paler,papillae,pore,prominent,proximal,raised,red-papillose,reddish-gold,reflexed,ruit,shaped,short-styled,single-stemmed,slightly,soon,stem,strongly,tall,tear-drop,terminal,thickened,thin,tub,ud,unifoliat,unit,vein,widest,woody,x,ympodial,young	2-5,abaxial,accrescence,adaxial,arrangement,bud,color,colour,dark,diameter,form,greyish-red,growth,height,history,inflorescence,length,life,na,number,peduncle,perennial,plant,position,rachi,reproduction,seed,shape,spacing,texture,unifoliate,width
570	wfo-0001030093	success	181	119	88	93	31	0.486	0.1-0.3,0.2,0.5-1.1,0.6-1.5,0.75-1,1-1.5,1-12,1-5,2-2.5,4-6,8-9,acuminate,acute,anther,apex,attenuate,bark,base,beneath,brownish-tan,calyx,clavate,closely,cm,corolla,cuneate,densely,elliptic,erect,expanded,filament,flower,fruiting,furcate,glabrous,globose,golden,green,greenish-white,growth,hirsutulous,leaf,lobed,many,minutely,mm,nearly,obovate,occasionally,often,opposite,ovary,ovoid-reniform,pale,paler,pedicel,petiole,pitted,plant,puberulent,pubescent,scar,shiny,shrub,simple,slender,slightly,small,spaced,stem,stigma,style,surface,tapering,terminal,thickened,time,tiny,tree,trichome,tube,underside,uniseriate,vein,white,woody,x,yellowish	.2,.5,0,0.2-0.5,0.2-1,1.3-4.5,2.5-11,3-4,3.5-12,5-50-flowered,5-8,7-30,7-9,anthesi,apar,becoming,berry,branched,campanulate,case,collection,commonly,continues,deflexed,deltoid,dia,differing,difoliate,eaf,edicel,eed,ellipsoid,especially,evenly,except,exserted,forest,free,geminat,greyish-brow,guyanese,hyaline,impressed,inundated,lateral,like,lobe,lon,long,long-styled,lower,main,major,margin,member,middle,minor,narrowly,new,nflorescence,older,one,onto,open,orbicular,pair,papillo,persisting,population,pore,poricidal,portion,present,quite,reflexed,remaining,ruit,shaped,shoot,short-styled,size,soon,southern,straight,tall,tear-drop,tip,tub,ud,unit,widest,ympodial,young	1.5-4,5-50,abaxial,adaxial,apart,arrangement,color,colour,diameter,form,fruit,greyish-brown,height,history,inflorescence,length,life,na,number,papillose,peduncle,perennial,position,rachi,reproduction,seed,shape,spacing,staman,texture,width
571	wfo-0001030115	success	192	137	112	80	25	0.583	-100,.5,0.1,0.5,0.5-0.6,1,1-1.2,1.5-3,10,12,3-4,3.5-5,30-60,5-10,5-5.5,<,>,abaxially,acuminate,acute,adaxially,anther,apart,apex,bark,basal,base,berry,broad-based,c.,calyx,cm,completely,conical,cordate,corolla,dark,deep,densely,diameter,echinoid,echinoid-stellate,ellipsoid,elliptic,entire,erect,exserted,filament,flower,fruiting,glabrescent,glabrous,globose,green,growth,included,inflorescence,irregular,lanceolate-elliptic,later,leaf,lengthening,lobed,long,long-styled,margin,midpoint,minutely,mm,oblique,obvious,ovary,pale,pedicel,peduncle,pentagonal,petiole,pore,poricidal,pubescent,purple,ray,reddish,scattered,shallowly,shiny,shrub,simple,slightly,slit,small,somewhat,stellate,stem,stigma,stout,style,surface,tearing,terminal,thin,tip,tree,trichome,truncate,tube,undulate,violet,way,white,x,yellowish	-30,.2,0.2,1.5-2,10-,12-22,2.5-3,3,4,5-8,7,9-11,anthesi,armed,basall,beneath,branched,brow,closely,curved,discolorous,distant,drying,eaf,eed,equalling,free,glandular,heterostylous,impressed,irregularl,know,known,lamina,like,linear,lobe,long-triangular,lower,many,near,new,nflorescence,obscured,occasionally,often,older,pair,papillate,papillo,pericarp,planar,plurifoliat,portion,prickle,prickly,primary,prominent,ruit,scar,sessile,short-styled,sinus,spaced,sparsely,splitting,strongly,tapering,time,translucent,trichoem,ud,unarmed,underside,unit,upper,usually,vein,ympodial,young	abaxial,adaxial,arrangement,brown,bud,color,colour,depth,form,fruit,height,irregularly,length,na,number,papillose,plant,position,reproduction,seed,shape,spacing,staman,texture,width
572	wfo-0001030145	success	153	116	85	68	31	0.556	0.2-2,0.3-,0.5-1,1,1-2,1-2.5,1-3,1-5,1.5,1.5-2,1.5-4.5,2.5-6.5,3-10,3-4,3-5,4-5,6-40,abaxially,acute,adaxially,aggregate,also,apart,apex,articulated,base,calyx,campanulate,cell,cm,color,compound,connective,cylindrical,deltate,densely,diameter,directed,distally,ellipsoidal,elliptic-ovate,flower,forked,fruit,glabrous,globose,hair,herb,lanceolate,leaf,lobe,long,margin,mm,moderately,narrowly,near,obtuse,ovate-elliptic,pedicel,peduncle,petiole,pilose,puberulent,rachi,radiu,reddish,remnant,shrub,simple,slightly,sparsely,stigma,stone,style,ternately,thecae,toward,triangular,truncate,unbranched,unknown,violet,x,yellow	-2,-3,0.5,0.5-4,1-1.5,1.5-7,10-12,2-3,2-4,3,4-8,4-foliat,8-11,absent,adpressed,ape,axe,basal,beyond,blade,chartaceous,cuneate,dunal,eaf,eed,elliptic,entire,exceeding,exserted,fide,fleshy,glandular,larger,lateral,leaflet,leaving,less,lon,lower,nflorescence,nther,orolla,pedicellar,pore,presen,puberulen,ripe,ruit,shorter,sinuate,slender,somewhat,spaced,stamen,subcordate,subcoriaceous,tal,tem,terminal,time,tomento,truncat,tube,ud,unit,vary,wide,ympodial	abaxial,adaxial,anther,arrangement,bud,colour,corolla,direction,form,growth,height,history,inflorescence,length,life,na,number,ovary,perennial,plant,position,presence,present,reproduction,seed,shape,spacing,surface,texture,tomentose,width
573	wfo-0001030146	success	210	100	84	126	16	0.4	.5,0.2–0.4,0.5–1,0.6–2,1.2–1.5,16–20,1–1.5,2.5–9,20–30,3–4,3–6,5–8,8–15,9–9.5,abaxial,adaxial,anther,apex,base,berry,branched,branching,brown,brownish,capitate,center,cm,coriaceous,corolla,dark,deeply,densely,diameter,ellipsoidal,elliptic,filament,flattened-reniform,globose,golden,green,growth,impressed,inflorescence,leaf,length,lobed,many,minutely,mm,narrowly,new,olive,pair,pale,papillose,pedicel,peduncle,petiole,pitted,plant,primary,pubescence,pubescent,ray,reddish,scar,simple,small,stellate,stem,stigma,style,surface,tan,terminal,time,tree,treelet,trichome,tube,unevenly,vein,white,–18	.1,.2,0.5,0.6–0.7,0.9–1,1.5–2,1–1.1,20,2–5,40–50,4–30,4–4.5,5-merou,6.5–16,60+,6–7,>,abaxially,absent,acuminate,acute,ag,almost,along,alyx,anthesi,apar,appearing,ark,articulated,axe,beig,beneath,bright,c.,calyx,cell,closely,connivent,covered,cup-shaped,deltate,dense,dichasia,discolorous,drying,eaf,echinoid,edge,eed,elongate,entire,erec,exserted,flower,free,fresh,fruiting,fused,glabrous,gradually,halfway,ilament,lamina,layer,lengthening,less,like,lobe,long,loosely,lower,margin,midpoint,multangulate,narrowing,nflorescence,nodding,older,orolla,part,peltate,per,perfect,pericarp,persistent,plurifoliate,pore,poricidal,portion,projection,reflexed,regularly,revolute,rhachi,ripe,ruit,scurfy,sessile,shiny,short-stalked,slit,spaced,sparsely,stout,strongly,subtended,tall,tangled,tem,testal,thin,tiny,tip,ud,undersurface,unit,upper,vary,varying,visible,way,wide,woody,yellow,ympodial	apart,arrangement,bark,bud,color,form,fruit,height,impression,number,ovary,seed,shape,spacing,texture,width
574	wfo-0001030147	success	158	120	87	71	33	0.551	0.5-2,1-4,1-5,15-30,2,2-10,2-10.5,2-13,2-3,4-5.5,5-8,8-38,acuminate,acute,apex,articulate,attenuate,base,blue,branched,cell,cm,conical,corolla,covering,cuneate,cyme,deep,diameter,dichasial,dichasially,diminishing,distal,ebracteate,elliptical,filament,finely,flower,forked,gradually,green,green-white,hair-like,half,herbaceous,honeycomb,interjected,lateral,leaf,leaflet,medium,mm,monochasial,mucilaginous,narrowly,oblique,obtuse,odd-pinnate,ovate,ovoid,pair,pattern,pedicel,peduncle,perennial,petiole,petiolule,plant,proximal,pubescent,purple,rotate,rounded,seed,size,stigma,style,subequal,terminal,testal,thick,tip,toward,tuber-bearing,wall,yellow,¼	-8,0-5,1.0-2.0,1.0-2.2,10-19,14-35,2-5,2.5-7.5,3-,3-6-foliat,4-3.,4.2-7.5,4.5-10,5-7,abaxiall,abaxially,acumen,adaxially,apical,apically,calyx,connate,dehiscent,digestion,dorsally,eaf,edge,eed,emoval,enzyme,exceeding,flat,folded,generally,globo,introrse,living,lobe,lon,long,long-attenuate,lower,lunat,make,maturing,nflorescence,nther,often,orolla,perfect,plan,poricidally,reveal,ruit,sessile,seudostipule,short,slit,specimen,stamen,straight,subsessile,tal,tem,throughou,throughout,typically,unit,vary,wide,ympodial	4-31,abaxial,adaxial,anther,arrangement,color,colour,form,fruit,globose,growth,height,history,inflorescence,length,life,lunate,na,number,ovary,position,pseudostipule,rachi,reproduction,shape,spacing,staman,stem,surface,texture,wet,width,ye
575	wfo-0001030151	success	175	109	81	94	28	0.463	-50,0.2-0.5,0.3-0.5,0.5,0.5-1,1-1.5,1-17,1-3,1-5,1.5-2.5,10-25,15-35,2-11,2-3,2-6,2-7-compound,3-14,3-5,4-5,5-6,6-9,?,acuminate,acute,adaxial,apex,basal,blotch,calyx,chartaceous,cm,connective,cordate,cuneate,deltate,diameter,elliptic,flower,fruit,glabrous,globose,lanceolate,leaf,less,lilac-tinged,lobe,long,longitudinal,membranaceous,mm,narrowly,oblong,obovate,pedicel,peduncle,perfect,petiole,pinnately,puberulent,purplish,pyriform,rachi,radiu,shallowly,simple,slender,sometimes,sparsely,stellate,stigma,stripe,style,surface,tree,truncate,unbranched,white,whitish,x,yellow,yellow-green	-3,1,1-2,1.5-2,10-20,2-25,20-30,3.5-32,4-foliat,abaxially,absent,abundantly,adaxially,aggregate,apart,ape,apiculate,around,articulated,axe,base,beyond,blade,cell,channe,ciliat,compound,connate,cylindrical,decurrent,directed,distally,eaf,eed,eglandular,entire,exceeding,except,exserted,glabrate,glandular,glandular-puberulent,hair,leaflet,leaving,line,lon,lower,margin,near,nflorescence,nther,oblique,obtuse,often,orolla,pedicellar,pore,presence,probably,remnant,ring,ripe,ruit,sand-punctat,sand-punctate,scattered,short,shorter,slightly,small,somewhat,spaced,stalked,stamen,stone,tal,tem,thecae,time,tip,toward,triangular,truncat,tube,ud,unit,unknow,vary,vein,veiny,white-puberulent,wide,ympodial	abaxial,anther,arrangement,bud,color,colour,corolla,filament,form,growth,height,history,inflorescence,length,life,na,number,ovary,perennial,plant,position,reproduction,seed,shape,spacing,staman,texture,width
576	wfo-0001030153	success	147	122	103	44	19	0.701	.1,.2,/3,0.2-1,0.8-1.3,1-10,1-2,1-2.5,1.3-1.5,2-8,2-lobed,3-4,3-5,3-50,3.5-10.5,5-6,6-8,abaxially,acuminate,acute,adaxially,age,anther,anthesi,apart,apex,apparently,attenuate,bark,base,berry,branched,broadly,campanulate,clavate,cm,conical,corolla,dark,deltate,diameter,distinct,domatia,ellipsoid,elliptic,entire,erect,filament,flower,glabrous,globose,green,growth,impressed,internodal,irregularly,lanceolate,lengthening,less,lobe,lobed,margin,minutely,mm,narrowly,new,nodding,occasionally,older,ovary,pair,papillate,pedicel,peduncle,petiole,pit-like,plane,pore,poricidal,primary,rachi,revolute,ripe,scar,slightly,slit,small,spaced,stem,stigma,style,surface,terminal,time,tip,tree,treelet,vein,way,white,x,yellowish,young	0.8-0.9,1-1.2,1-1.5,1.3-1.9,1.5-2,2.5-4,absent,ape,apiculate,axil,brittle,caly,calyx,densely,dot,dry,eaf,enlarged,exerted,free,fruiting,glabrou,known,lower,markedly,membranous,nflorescence,ot,paler,papillat,perfect,plurifoliat,portion,resinous,ruit,simple,specimen,straight,strongly,thin,tube,ud,unit,ympodial	branching,bud,color,form,fruit,height,history,impression,inflorescence,leaf,length,life,na,number,plant,shape,size,spacing,texture
577	wfo-0001030155	success	183	123	108	75	15	0.59	0,0.2,0.4,0.5,0.5-0.6,0.5–1.2,0.7,1-1.2,1/2,12–20,2-4,2.5,2.5-3,2/3,2–,2–3,3.5,3–5,4,4–5,4–8,4–9,5–10,5–6,5–8,6–8,abaxially,acuminate,acute,anther,anthesi,apex,armed,articulated,basal,base,berry,branched,brown,cell,chartaceous,clustered,cm,corolla,deeply,diameter,ellipsoid,elongating,entire,filament,flattened,flower,fruit,glabrous,globose,immature,imparipinnately,internode,leaflet,light,lobe,lobed,long,long-styled,margin,mature,middle,midrib,minutely,mm,narrowly,oblong,papillate,pedicel,peduncle,pericarp,petiole,pinnatifid,pitted,prickle,purple,rachi,rectangular,recurved,rounded,slender,spreading,stellate,stem,stigma,strongly,style,subwoody,surface,tapering,terminal,terminally,testal,third,tip,ttriangular,vine,way,white,wide,widest,yellow,×	12–19,1–2,2,3,4–6,607,ag,alyx,ba,basally,becoming,blade,bud,calyx,campanulate,central,confluent,connecting,connivent,corresponding,decurrent,degree,deltate,densely,eaf,eed,equal,et,exserted,fresh,glabrou,green,knob,lateral,lengthening,lower,major,nflorescence,often,orolla,outline,part,petiolulate,plant,plurifoliat,pore,poricidal,present,prominent,protuberant,recurve,robust,rodriguez,rounde,ruit,side,size,slit,soon,stout,straight,tamen,time,tissue,truncat,tub,tube,unit,vary,vein,wing,woody,ympodial,–17,–27	arrangement,color,form,growth,inflorescence,leaf,length,number,ovary,seed,shape,staman,texture,truncate,width
578	wfo-0001030160	success	177	111	88	89	23	0.497	.5,.8,0.2,1,1-1.5,1-5,2,3,3-4,?,acuminate,acute,anther,apart,apex,bark,base,bluish-violet,broad-based,bud,calyx,closely,cm,conical,corolla,densely,diameter,dioecious,elliptic,entire,exserted,filament,flower,free,fruit,glabrous,globose,growth,height,inflorescence,internodal,irregularly,lobe,lobed,long,long-triangular,margin,midpoint,minute,minutely,mm,narrowly,nearly,occasionally,orange-red,ovary,pale,pedicel,peduncle,petiole,pitted,plant,portion,prickle,pubescent,ray,red,reniform,scattered,shiny,short-stalked,shrub,somewhat,spaced,sparsely,stellate,stem,stigma,style,surface,terete,thin,tiny,trichome,tube,undulate-toothed,unknown,yellow	.2,00,1-2,1-3,1.5-2,1.5-4.5,1030.,10300,2.5-3,3-11,3-3.5,4-rayed,5-6,7-10,8-9,absent,acicular,almost,amshoff,apparently,armed,beneath,berry,capitat,completely,consisting,conspicuous,coriaceous,dry,eaf,eed,ekman,elongate,female,fide,flattened,flowered,forming,fruiting,glabrescen,like,m.,male,marginal,markedly,mere,midrib,near,new,nflorescence,oblique,often,older,other,ower,pair,per,pericarp,plurifoliat,poricidal,primary,prominent,ruit,scar,several,shallow,simple,single,small,sometimes,stiff,strongly,stub,terminating,ti,tip,triangular,truncate,ud,unisexual,unit,usually,vein,vestigial,winged,woody,x,ympodial,young	abaxial,capitate,color,colour,exsertion,form,glabrescent,hair,history,leaf,length,life,na,number,position,rachi,reproduction,seed,shape,spacing,staman,texture,width
579	wfo-0001030161	success	179	104	86	93	18	0.48	.5,0.1-0.2,0.2-0.5,0.2-1.3,0.4-0.8,0.5,1,1.1-1.3,2.5-3,4,4-20,4-5,8-9,acuminate,acute,almost,anther,apex,broad-based,calyx,clavate,cm,conical,corolla,curved,densely,diameter,ellipsoid,elliptic,entire,exserted,flattened,flower,fruit,furcate,globose,growth,internodal,irregularly,leaf,lepidote,lobed,margin,midpoint,minutely,mm,narrowly,occasionally,orange,ovary,pedicel,peduncle,petiole,pitted,pore,poricidal,porrect,prickle,prickly,pubescent,ray,red,reddish,reniform,scar,scattered,sessile,shiny,shorter,slightly,somewhat,spaced,sparsely,stellate,stem,stigma,strongly,style,surface,tapering,tip,treelet,trichome,tube,undulate-toothed,white	.1,.2,.25,0,0.1,0.5-0.6,0.8-1,1.5-2,1.5-5,12-16,2-2.5,2-3,3-15,3-3.5,5197,9-10,<,?,abaxially,adaxially,anthesi,apar,apparently,articulated,bark,base,bearing,beneath,berry,breaking,cell,coriaceous,difoliate,eaf,eed,egger,erect,especially,fide,filament,filiform,free,fruiting,fused,geminat,glabrescent,glabrous,impressed,later,leave,lengthening,like,lobe,long,long-triangular,looping,lower,marginal,midvein,near,nearly,new,nflorescence,older,outline,pair,pale,papillo,per,perfect,pericarp,planar,portion,primary,prominent,rhomboid,ruit,simple,slit,small,stalked,straight,testal,thick,tooth,tub,ud,unit,vein,woody,x,yellowish,ympodial	apart,arrangement,bud,color,exsertion,form,height,inflorescence,length,number,papillose,plant,position,pricklines,seed,shape,spacing,texture
580	wfo-0001030167	success	141	92	51	90	41	0.362	.8,.9,0.6,12,5-merous,abaxially,acuminate,adaxially,anther,apex,chartaceous,cm,contiguously,densely,diameter,extra-axillary,filament,flattened,flower,fruit,glabrous,green,herbaceous,lanceolate,margin,membranaceous,membranous,mm,near,nearly,ovate,ovoid,pedicel,peduncle,petal,petiole,pointed,rachi,sand-punctate,simple,slender,somewhat,stellate,stigma,style,thinly,unbranched,unknown,vine,white,x	0.1–0.2,0.5–0.6,0.5–0.7,0.6–0.8,0.7–1.2,0.8–1,1.2–2.5,1.5–2,1.5–7,14–19,15–20,17–58,1–1.2,1–1.5,2–3,2–4.5,4.5–8,4–10,4–4.5,4–5,4–7,8–10,accrescent,acute,along,alyx,apar,apically,axe,base,berry,blade,branch,c.,calyx,ciliat,ciliate,clavate,climbing,eaf,eed,enlarged,entire,fertile,fruiting,gap,glabrou,immature,less,lobe,long,lower,m.,maturity,minutely,moderately,nflorescence,nternode,obtuse,orolla,pair,penden,perfec,pinnate,plurifoliat,reflexed,rounded,ruit,scar,secondary,seen,slightly,spaced,sparsely,subequal,symmetrical,tamen,tem,time,tip,truncat,tube,unit,vary,vegetation,vein,venation,weakly,wide,ympodial	0.1-0.2,0.7-1.2,0.8-1,1-1.5,1.5-2,1.5-7,15-20,2-4.5,4-10,4-4.5,8-10,abaxial,adaxial,apart,arrangement,color,colour,corolla,form,growth,height,history,inflorescence,internode,leaf,length,life,na,ovary,perfect,plant,position,reproduction,seed,shape,size,spacing,staman,surface,texture,truncate
581	wfo-0001030170	success	230	133	92	138	41	0.4	/2,0.1,2,4,8.5,accrescent,acicular,acute,anther,apart,apex,base,blue,calyx,cm,curved,densely,diameter,eventually,extra-axillary,falling,filament,flattened,flower,fruit,fruiting,glabrous,gland,gland-tipped,glandular-puberulent,globose,hair,leaf,less,lobe,lobed,long,major,maturity,minute,minutely,mm,nearly,numerous,oblong-apiculate,orbicular,pedicel,peduncle,perennial,petiole,prickle,puberulent,pubescent,rachi,rarely,reflexed,reniform,scattered,senescent,short-puberulent,shorter,shrub,similar,simple,slightly,smooth,somewhat,spreading,stellate,stem,stigma,stipitate,stipitate-glandular,stout,straight,strongly,style,subdeltoid,surface,thin-textured,toward,triangular,tube,unbranched,usually,vein,violet,way,white,x,yellow,yellowish	-6,.2,0,0.15–0.35,0.2–0.5,0.2–2,0.5–15,0.5–2,0–30,1,1.5,10–15,12.5,15–20,1–2-celled,1–2.5,1–4.5,2-foliate,2.5–3,20–25,20–30,2–3-celled,2–4,2–5,2–8,3,3.5–4,3.5–4.4,3–10,4–13-rayed,4–22,5,5–10,5–12,5–15,5–apiculate,abaxially,absent,adaxially,also,appearing,around,articulated,axe,ba,blade,bud,capitat,coarse,confined,connivent,conspicuously,cordate,cylindrical,directed,disappearing,distall,eaf,eed,enlarged,entire,erect,fertile,few-branched,few-rayed,flexuous,frui,geminat,geminate,glandular,ground,horizontal,hyaline,interpetalar,lanceolate,larger,like,lon,longer,longest,lower,lowest,male,many,margin,mesocarp,mostly,multangulate,near,nflorescence,oblique,obtuse,often,one,orolla,pair,perfect,pore,pubescence,ranging,rare,ray,rootstock,ruit,scarcely,sessile,shallow,single,size,small,solitary,sometimes,spaced,spongy,stella,stellae,sterile,stiffly,surfac,tall,tamen,tem,thic,thick,tissue,tooth,truncate,twice,ultimately,unit,upper,various,vary,vestigial,wide,without,ympodial,–4	0-30,0.2-0.5,0.2-2,0.5-2,1-2-celled,1-2.5,1-4.5,1.2,10,10-15,2-5,2-8,2.5-3,20-30,3-10,abaxial,adaxial,arrangement,capitate,color,colour,corolla,form,growth,height,history,inflorescence,length,life,na,number,ovary,plant,position,reproduction,seed,shape,spacing,staman,texture,width
582	wfo-0001030176	success	171	91	63	108	28	0.368	-6.25,.2,.7,0.4-1.5,0.5-2,0.7-1.4,0.7–0.8,1-5,1.2-2.5,1.6,2.25-3.25,3-5,3-lobed,3.75-5,4-9,6-8,anther,apart,articulated,base,bilobed,broadly,chartaceous,cm,cylindrical,depressed-globose,diameter,especially,few-branched,filament,flattened-reniform,flower,fruit,glabrous,herb,hermaphroditic,light,margin,mesocarp,mm,oblong,ovate,pale,pedicel,peduncle,petiole,plant,rachi,rarely,recurved,ripe,rotate-stellate,slightly,stigma,style,unbranched,violet,white,winged,x,yellow,yellow-orange,young	-1.4,-4.25,.75-1.5,0.5,0.6-0.9,1,1-2,1.2,1.5-2,1.5-2.5,1/3,1/6,2-3,2-foliate,2.5,2.5–7.5,2.5–9,2–3,5-merou,6–8,abaxially,accrescent,acute,adaxiall,adaxially,alyx,angulate,apex,apparently,asymmetrically,attenuate,axe,ba,basal,berry,bi-lobed,blade,branch,broad,calyx,capitat,ciliate,connivent,contact,covering,decumbent,dehiscent,downward,eaf,eed,erec,extra-axillary,forming,fruiting,geminat,hair,hold,interlobal,juic,lance-ovate,lanceolate-oblong,lateral,line,lobe,lon,long,longitudinall,lower,major,midrib,minutely,near,nearly,nflorescence,node,numerous,often,orolla,partially,patch,perfect,pore,prostrate,pubescent,recurve,rooting,round,ruit,simple,sinus,soil,sometimes,somewhat,spaced,sparsely,tamen,tem,terminal,time,tip,triangular,tube,unit,vary,vein,white-puberulent,wide,ympodial	abaxial,adaxial,articulation,capitate,color,corolla,form,growth,height,history,inflorescence,juicines,juicy,leaf,length,life,number,ovary,perennial,recurvature,reproduction,seed,shape,spacing,staman,surface,texture,winging
583	wfo-0001030180	success	135	87	59	76	28	0.437	0.05-1,0.5-1,0.8-2,1.1-1.2,3-8,4.5-5,6,abruptly,anther,apart,apex,bark,clavate,cm,corolla,dark,ellipsoid,fruit,furcate,glabrate,glabrous,globose,green,height,leaf,linear,lobed,minutely,mm,narrowing,opposite,ovary,overlapping,papillate,papillose,pedicel,petiole,planar,puberulent,raised,rounded,scar,shaped,shrub,slightly,spaced,sparsely,stem,stigma,style,surface,tear-drop,tip,trichome,unevenly,uniseriate,unknown,winged,x	.1,.5,.75,0.9-1.8,1-1.5,10-30-flowered,3-4,8-10,8.5-23,?,accrescent,anthesi,apiculate,appearing,attenuate,base,becoming,berry,calyx,clu,decurrent,deflexe,deltoid,dia,eaf,edicel,eed,erect,exserted,filament,free,fruiting,immature,inflorescenc,interpetalar,known,lateral,lenticellat,lobe,lon,long,long-acuminate,lower,main,middle,minute,nearly,nflorescence,occasionally,older,pair,peduncl,plurifoliat,pore,poricidal,portion,prominent,proximal,ruit,sinus,slender,soon,straight,terminal,thin,tube,ud,unit,vein,white,widely,widest,woody,yellowish,ympodial,young	10-30,abaxial,adaxial,arrangement,bud,colour,diameter,flower,form,growth,history,inflorescence,length,lenticellate,life,na,number,peduncle,plant,plurifoliate,position,rachi,reproduction,seed,shape,spacing,texture,width
584	wfo-0001030182	success	205	116	98	107	18	0.478	0.2-0.3,0.5-1,1,1-1.5,1-4.5,1.5-2,12-15,15-20,2-15,2-3,2-5,3-12,3-4,3-5,acute,angulate-lobed,anther,apex,armed,base,berry,blue,brown,brownish,calyx,cell,clavate-truncate,closely,cm,coriaceous,corolla,dark,diameter,elliptic,entire,filament,finely,flattened,flower,free,fruit,glandular,globose,green,growth,internodal,leaf,linear-lanceolate,margin,microscope,midpoint,midrib,mixed,mm,multicellular,oblique,obtuse,ovary,ovate,ovate-elliptic,papillose,pedicel,peduncle,pericarp,petiole,plant,portion,pubescent,red,reddish,repand,reticulate,rounded,rusty,seen,shrub,simple,stellate,stellate-glandular,stigma,style,subcoriaceous,subreniform,surface,tapering,terminal,testa,tomentose,treelet,triangular-lanceolate,trichome,tube,unarmed,vein,velutinous,violet,yellow,yellowish	-12,0.3-0.5,1-1.7,1-celle,1-celled,1-multicellular,1-nerved,1.2-1.5,1/4,2-2.2,2-8,2.4-2.5,3-8,4-10,4-5,abaxially,accrescent,adaxially,adult,anthesi,articulated,asymmetric,bark,basal,branched,den,discolorous,distal,e,eaf,eed,eglandular,erect,evident,exserted,ferruginous-tomentose,fruiting,glabrescent,heterostylous,hirsute,immature,juvenile,later,lengthening,like,lobe,lobed,long,long-styled,lower,many,minute,minutely,mixture,multangulat,nearly,new,nflorescence,older,one,ovoid,papillo,per,perfect,plurifoliat,pore,poricidal,porrect,porrect-,porrect-stellate,prickle,prickly,pubescence,ray,recurved,reduced,reflexed,ripe,ruit,scar,sessile,short,short-styled,similar,slightly,slit,space,sparse,sparsely,stalked,staminate,stem,strongly,subsessile,tall,tip,tub,turbinate,ud,uniseriate,unit,upper,variegated,wood,x,ympodial,¼	abaxial,adaxial,color,colour,form,height,inflorescence,length,number,position,reproduction,seed,shape,spaced,spacing,staman,texture,width
585	wfo-0001030185	success	206	143	114	92	29	0.553	1,1-10,1-4,1-8,10,15,2,2-3,2.0-3.0,20-65,25,4-7,5-7,8-11,9-18,acuminate,acute,angular,apex,basal,base,beyond,blue,blue-violet,branched,cell,center,clasping,cm,color,commonly,cordate,corolla,covering,cuneate,cyme,dark,darker,decreasing,deep,densely,diameter,dichasial,dichasially,distal,ebracteate,elliptic,filament,flower,forked,glabrous,glandular-pubescent,globose,green,green-white,hair,hair-like,half,herbaceous,interjected,lanceolate,lateral,leaflet,light,medium,middle,mm,moderately,monochasial,narrowly,nearly,obliquely,occasional,odd-pinnate,ovate,ovoid,pair,pedicel,peduncle,perennial,plant,puberulent,purple,reduced,rhizomatous,rhizome,rotate,rounded,scarcely,seed,semi-lunate,shape,size,slightly,sometimes,somewhat,spot,star,stem,stigma,style,subequal,terete,terminal,testal,thick,tinged,usually,violet,wall,white,wider,without,yellow	-0.5-1.3,0.2,1.0-1.3,1.5-4,1.7,21,3-6-foliat,3.5-4.2,35,4,5-10,5-lobed,abaxially,acumen,adaxially,apical,apically,apiculate,articulate,b,ba,becoming,calyx,caudate,cente,coat,collection,connate,dehiscent,digestion,eaf,eed,embryo,emoval,enzyme,erect,exceeding,formed,generally,glabrescent,gland,globo,honeycomb,introrse,living,lobe,lon,long,lower,make,maturing,mucilaginous,nflorescence,nther,oblong,often,one,orolla,pattern,pentagonal,perfect,petiolate,petiolulate,petiolule,poricidally,purpl,radiating,rare,reveal,rotate-,ruit,sessile,seudostipule,short,slit,specimen,stamen,ste,straight,symmetrically,tem,tip,trailing,type,typically,unbranched,unit,vary,visible,wid,wide,ympodial	abaxial,adaxial,anther,arrangement,branching,colour,form,fruit,growth,height,history,inflorescence,leaf,length,life,na,number,ovary,petiole,position,pseudostipule,rachi,reproduction,rotate-pentagonal,spacing,staman,surface,texture,width
586	wfo-0001030189	invalid_json_followup	188	117	83	105	34	0.441	-1/2,/3,0-1,0.1-0.2,0.2-0.3,0.2-0.5,0.5-1.6,0.9-1.1,1,1-2,1-4-cellular,1.3-4.2,1/6-1/3,2-3,2-5.5,2.5-4,5-6,5-merous,abaxially,anther,apparently,articulated,bark,base,berry,blade,chartaceous,cm,concolorous,connivent,curved,diameter,drying,dull,erect,filament,flattened-reniform,flower,fruit,glabrescent,glabrous,gland-tipped,gray,lateral,leaf,length,lobed,maturity,mauve,mm,moderately,oblong,often,orange,ovate,pedicel,peduncle,petiole,poricidal,porrect,purple,ray,red,scandent,sessile,shrub,simple,slender,sparsely,spherical,spreading,stalked,stellate,stellate-pubescent,style,surface,tapering,terminal,tip,trichome,way,yellow,yellow-green	-4,.2,0-15,0-30,0.1,1-1.5,1-3-cellular,1-4-cellula,1.1-2.7,1.5-2,1.5-4.5,1.5-5,1/,1/3,2,3-4,3.2-4.5,4-13,4-5.5,5-,5-10,6-10,6-12,8,8-10,8-18,acut,alyx,apar,apex,apically,appressed,branched,calyx,cordate,deltate,densely,eaf,eed,elliptic,elongating,entire,equal,evenly,faint,foliaceous,free,frui,fruiting,glabrescen,green,infructescence,lobe,long,longer,lower,margin,mature,midpoint,nflorescence,obtuse,older,one,open,orolla,oung,pair,per,perfec,pericarp,plurifoliat,portion,primary,recurved,red-brow,reflexed,rounded,ruit,scar,shorter,smooth,sometimes,somewhat,spaced,stalk,stem,strongly,tamen,terete,tertiary,time,tube,unarme,unarmed,unit,upper,variously,vary,vein,venation,visible,wide,woody,ympodial,young	'',[,``,abaxial,adaxial,apart,arrangement,characteristic,color,colour,corolla,form,growth,height,history,inflorescence,life,na,number,ovary,plant,proportion,rachi,red-brown,reproduction,seed,shape,spacing,staman,texture,value,width,{,}
587	wfo-0001030195	success	255	127	91	164	36	0.357	.5,1,1/3,2,2.3,abaxially,adaxially,adnate,aequilateral,anther,apex,around,articulate,bark,base,blade,broad-based,brown,bud,calyx,capitate,channeled,chartaceous,cm,corolla,cuneate,deltate,densely,diameter,directed,distally,edge,entire,evenly,extending,filament,flattened-orbicular,flower,fruit,glabrous,globose,green,internode,lateral,leaf,long,longer,lower,margin,middle,midpoint,mm,moderately,nodding,notched,oblique,obtuse,occasionally,ovate,pedicel,petiole,pitted,pore,prickle,pubescent,ray,red,reddish,rounded,scattered,sessile,shoot,short,shrub,spatulate,stamen,stellae,stellate,stellate-pubescent,stem,stigma,style,subcoriaceous,surface,terminal,unarmed,yellow,yellow-ferruginous,yellow-tan,±90°,±glabrous	.2,.3,.6,.7,/3,0.1–0.2,0.2–0.3,0.2–0.5,0.2–1.0,0.3–0.7,0.5,0.5–0.6,0.5–1.3,0.5–4.0,0.7–1.0,0.8,0.8–0.9,0.9–4.8,1.0,1.0–1.4,1.0–1.5,1.2–1.6,1.3–1.5,1.3–2.6,1.4–1.6,1.5–1.7,1.5–1.9,1.7–2.2,1.7–3.2,1.8–2.0,1.8–2.5,2.2–2.7,3.8–4.8,3–6,3–7.3,4-merou,4.9–7.0,5.5–6.5,6.3–7.7,6–8,6–9,acuminate,adaxial,ag,along,alyx,anthesi,apical,apiculate,apparently,appearing,appresse,attachment,attenuate,ba,based,berry,borne,broad,brochidodromous,connivent,dark,dentate,developed,distal,distinct,dry,eaf,eed,either,elliptic,emerging,endocarp,exocarp,extra-axillary,fertile,filiform,flat,flattened-irregular,flexed,free,glandular,glossy,gradually,gree,hair,homostylous,hort,immature,increasing,indistinct,individually,intact,interpetalar,intersepalar,isolated,juic,layer,laying,light,lobe,lon,m.,many,markedly,mature,midrib,midvein,minute,mottled,narrowly,nearly,nflorescence,oblong,opaque,orolla,per,perforated,plurifoliat,point,poorly,porrect,portion,potentially,presen,raised,reflexed,remaining,restricted,ruit,shot,side,simple,sinus,slightly,sloughing,smoot,sparsely,splitting,straight,striped,suture,tamen,tem,thin,time,tip,tissue,transparent,truncate,tube,typically,ud,unit,vary,vein,weakly,white,wide,yellow-ferruginou,ympodial,young,±equal,×	0.2-0.3,0.2-1.0,0.5-4.0,0.9-4.8,1.2-1.6,1.3-2.6,1.7,3.8-4.8,5.5-6.5,6-8,adhesion,angle,articulation,channelling,color,direction,extension,form,growth,height,history,inflorescence,length,life,number,ovary,perennial,plant,position,relative,seed,shape,smooth,staman,texture,width
588	wfo-0001030198	success	234	115	72	162	43	0.308	0.6,16,acute,ampliate,anther,apart,apex,articulated,attenuate,base,black,closely,cm,densely,diameter,distally,filament,flattened-reniform,flower,fruit,glabrate,glabrous,globose,gradually,green,homostylous,internode,interpetalar,lateral,leaf,lilac,minute,minutely,mm,nearly,orange,ovate,overtopped,ovoid,pedicel,peduncle,petiole,pitted,porrect,purple,reflexed,sessile,short-stalked,shrub,simple,soon,stalk,stellae,stellate,stellate-tomentose,stem,stigma,strongly,style,surface,tan,terminal,tissue,tomentose,triangular,turning,weak,well-developed,whitish,whitish-tomentose,yellow,yellowish	.2,0.7–,0.7–0.8,0.7–0.9,0.7–1.1,0.8,0.8–1.4,0.9–1.7,0.9–2,1,1.2,1.4–1.6,1.5–3.5,1.5–6.5,10–12,13–20,1–2.5,2,2.5,2.5–14,2.5–3.0,2–2.8,2–3,2–3-lobed,3.4–4.0,3.5–7,3–3.5,3–4,3–9,4,4.5,4–12-branched,5-merou,5.3–7,5.5–13,5–12,60–150,6–10,7.5–10,abaxially,acicular,adaxiall,adaxially,alyx,angulate,apical,apparently,appearing,axe,basal,berry,blade,branch,broad,broadly,calyx,capitat,caudate,contrasting,cordate,coroll,dark,darker,deeply,deltoid,directed,distall,drying,eaf,eed,entire,except,extra-axillary,fewer,filiform,finely,formed,free,frui,geminat,glabrescent,gland-tipped,hair,hal,high,immature,initially,interwoven,irregularly,larger,like,lobe,lobed,lon,long,lower,major,many,margin,midpoint,midri,midrib,midvein,midzone,much,near,nflorescence,oblong-lanceolate,often,one,orolla,part,perfect,persistently,plurifoliate,pore,prickle,principal,ray,recurved,relatively,rounded,ruit,shiny,shorter,side,sinuate,sinus,slightly,sometimes,somewhat,spaced,sparse,splitting,spreading,stella,stout,straight,tamen,tem,thickened,time,tip,truncate,tube,ud,unarmed,unit,upper,usually,vary,vein,white,white-tomentose,wide,ympodial,×,–17,–18,–20,–3,–3.5	0.2,0.7-1.5-3.5,0.8-1.4,0.9-2,1-2.5,1.5-6.5,10-12,2-2.8,20,3,3.5,5-12,5-merous,5.3-7,60-150,7.5-10,abaxial,adaxial,arrangement,capitate,color,colour,corolla,form,growth,height,history,inflorescence,length,life,na,number,ovary,perennial,plant,position,rachi,seed,shape,spacing,staman,texture,x
589	wfo-0001030212	success	188	89	67	121	22	0.356	0.2-0.4,0.5-0.6,0.5-1,1-1.5,1-15,1-3,1.5-2,2-2.5,2-5,2.1-3.4,2.4-3.3,3-5,3.5-5,4-23,4.5-6,7-11,abaxial,adaxial,andromonoecious,anther,apex,articulated,base,broadly,capitate,chartaceous,cm,compound,depressed-globose,diameter,filament,flower,fruit,glabrous,gland-tipped,green,hair,herbaceous,inflorescence,leaf-opposed,length,mm,ovate,pedicel,peduncle,petiole,pinnately,plant,prostrate,purple,rachi,resprouter,rotate,rotate-stellate,short,simple,slightly,sprawling,stigma,style,surface,unbranched,unknown,winged,x,yellow,yellowish-green	%,0-4,0.5-7,0.9-1.3,1-1.2,1-2,1-5,1-6,1.2-1.8,1.4-1.8,12-40,15-40,2-4,2.5-6,2.6-6.5,20-50,25-60,28-37,30-150,4-27,4-6,4-9,5-merou,6-9,8-9,9-10,abaxially,absen,absent,abundant,accrescent,acicular,acute,adaxiall,adaxially,alyx,apart,apparently,armed,attenuate,axe,ba,bilobe,blade,bristle-like,brown,calyx,center,connivent,cuneate,cylindrical,d.,deeply,deltate,directed,distall,divided,eaf,eed,finger,fruiting,functional,geminat,glandular-puberulent,half,heterostylous,index,interpetalar,juic,lamina,lateral,lobe,lobed,lobing,lon,long,lower,margin,mature,mesocarp,mid-point,midvein,minute,moist,narrowly,nflorescence,oblique,orolla,part,per,plurifoliate,pore,presen,present,pricke,prickle,ruit,side,spaced,sparse,sparsely,stage,straight,strongly,tal,tamen,tem,thick,throughout,time,tissue,toothed,triangular,tube,unit,uvenile,vary,vein,weakly,wide,ympodial	5-merous,arrangement,bilobed,color,colour,corolla,form,growth,height,history,leaf,life,number,ovary,position,reproduction,seed,shape,spacing,staman,texture,thicknes
590	wfo-0001030219	success	191	97	59	132	38	0.309	1.5,10,60,abaxially,acute,adaxially,anther,anthesi,apart,apex,articulated,base,black,blue,branched,brown,cm,densely,diameter,elliptic,filament,flattened,flower,fruit,glabrous,globose,green,lanceolate,leaf,lilac,marking,mm,moderately,number,oblong,olive,opposed,ovate,pale,paler,pedicel,peduncle,pentagonal,perennial,petiole,pitted,pubescent,purple,shallowly,shrub,size,sparsely,stigma,style,surface,velutinous,wide,x,yellow	0.1–0.3,0.2–2.3,0.4–1.0,0.5,0.5–,0.7–1.1,0.8–3.0,0–,1.0–1.2,1.0–1.5,1.0–2.0,1.0–2.2,1.3–2.9,1.4–2.8,1.6–,15,1–2.5,2.0–2.5,2.0–3.2,2.0–5.5,2.4–6.0,2–,2–2.5,2–3,2–4.5,3,4.5–5.5,4.8–11.5,4–5,4–7,5,5–,5–8,6–,6–10,6–8,7–11,8–18,9–10,9–12,abaxiall,acut,adaxiall,adnate,ag,along,anisophyllous,apical,apparently,appearing,arising,arranged,axe,ba,basal,blade,bract–like,calyx,cell,chartaceous,clavat,concave,connivent,convex,cylindrical,decreasing,decurrent,deeply,diamete,difoliate,directed,distally,eaf,eed,equal,erect,geminat,glabrescent,hair,incised,indistinct,internode,lobe,long,longitudinal,lower,margin,multicellular,nflorescence,opening,oppositely,orolla,pair,perfect,pore,present,procumbent,rapidly,red–purple,regularly,rounded,ruit,serrate,sessile,sid,side,simple,smaller,spaced,split,stone,straight,stripe,strongly,tal,tamen,tem,time,tube,two,unicellular,uniseriate,unit,vary,white,wing,winged,woody,ympodial,–3.0,–7.0,–9.5	0.2-2.3,0.5-2.2,1.6-3.2,2,2-2.5,4-9.5,4.5-5.5,5-11,6-10,6-8,9-10,abaxial,adaxial,arrangement,clavate,color,colour,corolla,form,growth,height,history,inflorescence,length,life,na,opposite,ovary,plant,position,rachi,reproduction,seed,shape,spacing,staman,texture,width
591	wfo-0001030224	success	191	135	108	83	27	0.565	.25,.5,0.5-1,0.5-1.5,0.5-3,1-1.5,1-2,1-3.5,1.5-9,10-20,12-14,14-17,2-10,2-3-celled,2-4,2-5,2.5-4.5,4-10,4-6,5-10,5-merous,6-10,6-15,7-10,8-12,abaxially,acuminate,acute,adaxially,andromonoecious,anther,apart,apex,armed,base,black,brown,calyx,cell,chartaceous,clavate,cm,dark,densely,diameter,directed,distally,elliptic,ferruginous,filament,flattened,flower,forked,form,fruit,fruiting,glabrous,globose,green,hair,lighter,like,linear-lanceolate,lobe,longitudinal,midpoint,midvein,mm,moderately,narrowly,occasionally,opening,orange,outline,pedicel,peduncle,petiole,pink,plant,pore,prickle,pseudohair,pubescent,purple,rachi,ray,red,reniform,scandent,shrub,side,slit,small,sparsely,stellate,stellate-pubescent,stem,stigma,style,subcoriaceous,suborbicular,surface,tan,triangular,tube,unbranched,x,yellow	-2.5,2.5-4,2.5-8,20-25,3-4-foliate,4-4.5,4.5-5,6-8,absent,accrescen,adaxiall,ag,alyx,andromonoeciou,articulated,axe,ba,bark,berry,blade,broad-based,capitat,connivent,cylindrical,deflexed,dry,eaf,eed,eglandular,equal,extra-axillary,finely,fissure,free,functionally,geminat,gradually,greyish,hermaphroditic,heteromorphic,interpetalar,lateral,long,long-,longer,lower,lowering,major,mature,maturit,nflorescence,one,orolla,other,part,perfect,pericarp,recurved,reddish-brown,reflexed,ruit,sessile,shiny,short-styled,simple,spaced,sparse,staminate,strongly,tamen,tapered,testal,tightly,time,tissue,unit,vary,vein,wall,wide,wtih,yellowish,ympodial	abaxial,accrescent,adaxial,age,armament,axi,capitate,color,colour,corolla,growth,height,history,inflorescence,leaf,length,life,number,ovary,reproduction,seed,shape,size,spacing,staman,texture,width
592	wfo-0001030225	success	155	104	77	78	27	0.497	-11,-30,-4,-45,-7,.5-2.5,0,0-20,0-5,1,1-4,1-6,1.5,1.5-2.5,10-15,10-30,2,2-2.5,2-6,3-11-compound,3-4,3-5,4-5,8-15,acuminate,acute,apart,apex,articulated,base,calyx,campanulate,cm,color,connective,coriaceous,cylindrical,deltate,densely,diameter,elliptic-ovate,fleshy,flower,forked,fruit,glabrous,globose,leaf,less,lobe,mm,moderately,narrowly,oblong,obtuse,pedicel,peduncle,petiole,pinnately,possibly,puberulent,purple,rachi,radiu,shrub,simple,small,stellate,stigma,style,tree,triangular,truncate,tube,unbranched,unknown,x	-1.5,.5,2-18,2-3,3-20,3-foliat,abaxially,absent,adaxially,ape,apical,apically,ature,axe,basal,beyond,bilobed,blade,compound,conivent,cordate,cuneate,dilated,directed,distally,eaf,eed,entire,equal,especially,exceeding,expanded,exserted,glabrate,gland,immature,laterally,leaflet,leaving,long,lower,margin,minutely,nflorescence,nther,one,orolla,papillose,perfect,pore,prominent,puberulen,scar,see,seen,shallowly,slightly,somewhat,spaced,sparsely,stalked,stamen,strongly,succulent,tal,tem,thecae,time,tip,tomento,toward,two,ud,unit,unknow,vary,wide,ympodial	abaxial,adaxial,anther,arrangement,bud,colour,corolla,form,growth,height,history,inflorescence,length,life,na,number,ovary,plant,position,reproduction,seed,shape,spacing,surface,texture,theca,width
593	wfo-0001030244	success	226	125	105	121	20	0.465	0-0.3,0-0.6,0-3,0.2-1,0.2-1.3,0.25-0.5,0.4-0.7,0.5-1,0.5-1.2,0.5-7,1-1.5,1-2,2.5-6.5,3.5-9,7-24,8-18,abaxially,accrescent,acicular,acute,adaxially,andromonoecious,anther,apex,base,blue,brown,calyx,cm,cuneate,densely,diameter,entire,erect,extra-axillary,filament,flower,fruit,fruiting,glabrous,globose,green,grey,hair,half,inflorescence,interpetalar,lanceolate,lateral,length,less,linear,long,longer,margin,mature,midpoint,midrib,mm,moderately,narrow,narrowly,oblique,oblong,obtuse,pale,part,pedicel,peduncle,perennial,petiole,plant,porrect,prickle,pseudo-racemose,purple,rachi,ray,red,reniform,reticulate,rhizomatous,rotate,scattered,sessile,shrub,slightly,solitary,sparsely,stellate,stellate-pubescent,stigma,straight,style,surface,tan,thicknes,time,tissue,unbranched,white,wide,x,yellow,yellowish	%,.05,.3,0-0.1,0-1,0.1-1.5,0.2,0.2-0.5,0.2-0.6,0.25-0.4,0.3-0.4,0.3-0.5,0.3-5,0.5-3.5,0.6-0.8,0.8-1.2,1-20,1-5,1-6,1-8,1-locular,1.5-,1.5-2,1.5-2.3,1.5-3,11-33,2-2.5,2-4,2-foliate,2.5-13.5,3.3-7.5,4-5,4-5-merou,4-6,5-6,6-8,7-15,7-16,7-8,7-9,absen,absent,across,alyx,apart,apparen,articulated,attenuate,axe,ba,blade,capitat,chartaceous,common,confined,connivent,cylindrical,decimetre,deltate,directed,distall,distally,distributed,eaf,eed,eglandular,exocarp,finger,geminat,gland-tipped,heterostylous,homostylous,incomplete,juicy,lamina,lobe,lower,markedly,mesocarp,mid-point,minute,nflorescence,orolla,per,perfect,placenta,plump,pore,present,pubescent,ruit,septum,short,simple,spaced,sparse,stage,stalk,stalked,stellae,strongly,succulent,tal,tamen,tem,thick,thicker,throughout,tissu,triangular,tube,unarme,unarmed,unit,unknow,usually,uvenile,vary,weakly,wid,ympodial	abaxial,capitate,color,corolla,form,growth,height,history,leaf,life,ovary,position,reproduction,seed,shape,spacing,staman,stem,texture,width
594	wfo-0001030250	success	169	102	69	100	33	0.408	0.5-1,1-3,1.1-1.2,1.4-1.5,1.7-7,1.9-2.6,2.5-3.25,5-6,anther,anthesi,apart,apex,bark,base,broadly,brown,capitate,carinate-hooded,cm,conical,corolla,cup-shaped,curved,dark,elliptic-ovate,filament,fruiting,glabrous,globose,green,greenish-white,greenish-yellow,inflorescence,leaf,lobed,long-acuminate,minutely,mm,node,opposite,ovary,ovoid-reniform,pale,papillose,pedicel,petiole,pitted,pore,reflexed,sea-green,seed,shape,shaped,shrub,simple,soon,stem,stigma,straight,style,surface,tan,tapering,tear-drop,tip,tube,white-lenticellate,winged,woody	.5,/4,0-seeded,1-1.5,1.1-3.5,1.25-1.5,11.2-22,11.3,2-2.5,2.1-6,25,3-5,3.4-6.6,3.5-4,4-7,5-50-flowered,6-8,across,appearing,arching,attenuate,beginning,beneath,berry,bullate,calyx,consisting,cuneate,decurrent,deflexed,dia,differing,difoliate,dry,eaf,edicel,eed,elliptic,exerted,five,free,fresh,geminat,glabrou,horizontally,inflorescenc,irregularly,lateral,lobe,lon,long,lower,main,major,maturity,middle,minor,n,nflorescence,occasionally,older,one,orbicular,orbiculate,pair,paler,papillo,pendulous,pit,poricidal,portion,projection,prominent,proximal,raised,rim,ruit,scar,shallow,size,slender,slightly,smooth,spaced,specimen,spreading,tall,translucent,translucent-green,two,ud,unit,usually,vein,way,white-lenticellat,wide,widest,x,ympodial	0.5,5-50,abaxial,adaxial,arrangement,branching,bud,color,colour,decument,diameter,exertion,feature,flower,form,fruit,growth,height,history,length,life,na,number,peduncle,perennial,plant,position,rachi,reproduction,spacing,staman,texture,width
595	wfo-0001030271	success	195	131	101	94	30	0.518	0-2,0.15-0.75,0.7-9.5,1-2,1.4-2.1,15-61,2-6,2.4-5.6,3-10,3-5,4-22,4-7,6-15,abaxially,acute,adaxially,along,anther,apex,articulated,attenuate,axillary,base,bead,berry,blue,brownish,bud,cell,clavate,cm,coloration,condition,considerably,coriaceous,corolla,covering,dark,decreasing,deep,diameter,distal,drying,elliptic,filament,flower,forked,fresh,fruit,glabrous,green,greenish,hair-like,herb,interjected,larger,lateral,leaf,leaflet,light,like,lilac,medium,mm,moniliform,necklace,odd-pinnate,orbicular,ovate,ovoid,pair,pedicel,peduncle,pentagonal,petiole,plant,plurifoliate,purple,rotate,rounded,seed,sessile,size,slightly,spot,stigma,stolon,style,subtending,terminal,testal,thick,toward,tri-,tuber,unit,usually,wall,white,whitish,yellow	0.5-1.2,0.9-2.5,0.9-3.6,1-2.5,1-3,1-4,1-6,1-7,1.9-6.6,2-2.7,2-3,2-4,3.4-7.5,5-8,5-merou,5.6-12.3,acumen,adaxiall,ag,alyx,apart,apparently,arranged,asymmetric,axe,basiscopic,blade,capitat,completely,connivent,digestion,dorsally,eaf,edge,eed,enzyme,erect,exceeding,flat,folded,geminat,generally,glabrou,green-white,habi,half,homostylous,honeycomb-shaped,lanceolate,lengthening,linear,living,lobe,long,lower,make,middl,mottled,mucilaginous,multiple,nflorescence,orolla,perfect,petiolulate,pore,poricidal,removed,ripe,rosette,ruit,seudostipule,side,slit,sometimes,spaced,specimen,stamen,straight,symmetric,tall,tamen,tem,throughout,tip,tissue,tube,typically,unwinged,vary,vein,wet,wide,x,ympodial	abaxial,adaxial,arrangement,attachment,capitate,color,colour,form,growth,height,history,inflorescence,length,life,middle,na,number,ovary,perennial,position,pseudostipule,rachi,reproduction,shape,spacing,staman,surface,sympodial,texture,width
596	wfo-0001030272	success	179	110	84	95	26	0.469	-6,.3,.5,/4,0.05-0.1,0.05-1.5,0.5-1.5,0.65-1,0.7-2.5,0.8-1.5,1,1-1.5,1.2-1.8,1.5-2.5,10-20,3.5-5,4-6,4-8,acute,anther,apex,base,bright,calyx,cm,densely,diameter,elliptic,elongating,entire,evenly,filament,flattened-reniform,flower,fruit,fruiting,glabrescent,glabrous,gland,green,leaf,length,less,lobe,lobed,long-attenuate,margin,mature,mauve,membranous,midpoint,mm,multangulate,obtuse,orange-brown,pair,pedicel,peduncle,petiole,primary,ray,red,red-brown,reduced,rounded,sessile,shallowly,shrub,sometimes,sparsely,spherical,stellate,stellate-pubescent,stem,style,surface,terete,tertiary,trichome,unbranched,undulate,vein,venation,visible	0-20,0.5-1,0.5-2,0.6-0.9,1-2.8,1.5-3,1/3,1/3-2/3,2-2.5,2-6.5,2.5-3,2.5-3.5,2.8-3.5,3-8,4-10,4-15,5-7,5-merous,abaxially,acut,almost,alyx,ame,apar,apically,apparently,articulated,ba,bark,berry,blade,c.,concolorous,connivent,deltate,difoliate,drying,eaf,eed,equal,erect,free,geminat,glabrescen,glandular,gra,hair,infructescence,lateral,long,longer,lower,maturity,minute,moderately,narrow-deltate,near,nflorescence,older,one,open,orolla,oung,per,perfec,pericarp,poricidal,porrect,portion,reflexe,ruit,scar,shorte,simple,slender,smooth,spaced,spreading,straight,tamen,tapering,terminal,time,tip,tube,unarme,unarmed,unit,upper,vary,way,wide,woody,ympodial,young	abaxial,adaxial,apart,color,colour,corolla,form,growth,height,history,inflorescence,life,number,ovary,perennial,plant,reflexed,reflexion,reproduction,seed,shape,spacing,staman,stigma,texture,unknown
597	wfo-0001030278	success	235	139	114	121	25	0.485	0-0.2,0-1,0.6-1,1-2,1-several,12-25,2,2-6,2-7,3-4,3-5,4-12,5-20,6-12,7-10,7-12,abaxially,achlorophyllous,acute,acute-,adaxial,adaxially,along,anther,apex,base,branched,broad-based,broadly,brown,closely,cm,coarsely,compressed,contiguous,corolla,dark,deltoid,densely,diameter,divergently,ellipsoid,elliptic,elongate,entire,erect,extra-axillary,filament,flexuous,flower,fruit,glabrous,hermaphroditic,hirsute,inflorescence,large,lateral,laterally,length,lenticular,lignescent,lobe,major,midpoint,minutely,mm,moderately,nearly,obtuse,obtuse-tipped,open-campanulate,orange,outline,ovate,pedicel,peduncle,perennial,petaloid,petiole,pitted,prickle,prickly,pubescent,rachi,recurved,ripe,sessile,side,simple,sinus,slender,smaller,somewhat,spaced,sparsely,spreading,spreading-hirsute,stellae,stellate,stigma,style,subequal,subglobose,surface,tan,thin-textured,toothlike,truncate,unbranched,usually,vein,white,x,yellow	0.1-0.3,1/3-1/2,10-20,10-30,15-20,2-4,2-foliate,2.5-3,3-7,3.5-5,3.5-7,4-8,4-locular,5-8,6-18,7-20,8-30,9-18,absent,accrescent,adaxiall,also,armed,articulated,ascending,attenuate,axe,ba,basally,blade,breaking,calyx,capitat,capitate-glandular,cauline,collection,commonly,completely,concentrated,connivent,cordate,covering,cylindrical,density,dentate,directed,distal,distall,eaf,eed,female-sterile,finally,fine,flesh,fruiting,geminat,glabrou,gland-tipped,glandular-puberulen,hair,immature,inserted,interlobal,intermixed,less,linear-lanceolate,long,longer,lower,margin,maturit,medium-sized,midrib,mixed,mostly,much,narrowly,nflorescence,numerous,occasionally,often,orolla,ovate-lanceolate,pale,per,pore,principal,prominent,ray,reduced,resembling,rigid,ruit,section,short-stalked,short-styled,similar,small,sometimes,stalked,ste,stem,straight,straighter,surrounding,tal,tamen,tem,termination,tip,trichome,tube,unarmed,uniseriate,unit,vary,varying,weakly,wide,widely,ympodial	abaxial,arrangement,capitate,color,colour,dense,form,glandular-puberulent,growth,height,history,leaf,life,na,number,ovary,plant,position,reproduction,seed,shape,spacing,staman,texture,width
598	wfo-0001030281	success	193	143	114	79	29	0.591	0.5-1.0,0.5-3,1,1-2,1-2.5,10-13,10-14,12-16,12-20,2-4.5,2.5-5,3-12,3-6,4-6,4-7,4-8,5-10,abaxial,abaxially,absent,accrescent,acute,adaxial,andromonoecious,anther,anthesi,apex,apical,armed,asymmetrical,attenuate,base,brown,calyx,capitate,chartaceous,cm,connivent,dark,densely,diameter,directed,either,extra-axillary,filament,flower,fruit,fruiting,functionally,glabrous,glandular,globose,green,hair,hermaphroditic,heteromorphic,interpetelar,lacking,leaf,like,lobe,lobed,major,male,many,midpoint,midvein,mm,moderately,narrowly,nearly,netlike,obtuse,orange,ovate,pedicel,peduncle,petiole,pit,plant,pore,prickle,pubescent,rachi,raised,recurved,red,reflexed,reniform,ridge,roselike,rusty,separated,short,side,slightly,small,sparsely,stellate,stem,stigma,style,surface,tan,tapering,tissue,triangular,unbranched,vein,vine,white,whitish-green,x,yellow	0.2-0.8,0.5,0.5-1,0.5-1.5,1-.,1.5,1.5-3,10-25,2-4,2-5,2.5-3,2.5-3.5,20-30,5-16,5-merou,6-8,absen,adaxiall,adaxially,alyx,apar,axe,berry,beyond,blade,cordate,curved,cylindrical,difoliate,discolorous,distally,eaf,eed,em,expanded,exserted,flattened,frui,geminate,glabrou,gree,introrsel,leathery,long,long-styeld,lower,mature,midrib,multicellular,multiseriate,nflorescence,often,older,orolla,pair,per,planst,porrect-stellate,ray,ruit,short0styled,simple,spaced,stalk,stamen,staminate,ste,tamen,tube,unarmed,unequa,unicellular,unit,unlobed,usually,vary,wide,ympodial,young	1-4,5-merous,absence,accrescence,apart,armament,axi,color,colour,corolla,direction,form,growth,height,heteromorphism,inflorescence,introrsely,length,number,ovary,position,pubescence,reflexion,reproduction,seed,shape,spacing,staman,texture
599	wfo-0001030285	success	279	158	132	147	26	0.473	.1,.6,0.3–0.7,0.7–1.3,1.6–5.0,1/3,10.8–12.3,13.5,2.2–4.8,3.5–6.0,3.7–5.4,4,4.3–11.8,45,5,9.2–15.2,9.9–14.9,abaxially,acuminate,adaxial,adaxially,age,alveolate,anther,anthesi,apart,apex,apparently,area,attenuate,basal,base,becoming,brochidodromous,bud,calyx,capitate,central,channel,chartaceous,cm,congested,conical,corolla,cuneate,densely,diameter,distally,dry,elliptic,entire,erect,extra-axillary,filament,flattened-irregular,flattened-orbicular,flattened-reniform,flexed,flower,fruit,glabrous,globose,gradually,green,growth,hair,homostylous,increasing,internode,interpetalar,lateral,lavender,leaf,long,many-flowered,margin,maturing,midpoint,midvein,mm,moderate,moderately,nearly,obovate,occasionally,ovoid,pedicel,peduncle,petiole,poorly-developed,porrect,porrect-stellate,pubescence,pubescent,purple,raised,red,restricted,rounded,sessile,shrub,simple,slightly,small,smooth,sparse,sparsely,spread,stellae,stellate,stellate-pubescent,stem,stigma,straight,style,surface,tall,tissue,tree,upper,vein,vigorous,wavy,weakly,white,wide,yellow,yellow-ferruginous,young,±90°,±glabrous,±overlapping	.04,.4,.8,0.1–1.1,0.2–0.3,0.3–0.4,0.3–0.6,0.4–0.5,0.4–0.6,0.5–0.7,0.6–0.9,0.7–1.1,0.7–1.5,0.7–1.7,0.9–1.5,1.0–1.3,1.0–2.2,1.2–2.1,1.2–2.3,1.3–1.8,1.4–1.9,1.4–2.0,1.6–2.3,1.9–4.0,10–14,15.0–25.5,1984,2.4–3.2,2.8–3.1,3/4,4.0–7.0,4.6–8.8,4–5-merou,5.7–6.5,6.0–9.0,6–10,6–8-ray,90°,adnate,aequilateral,alyx,apical,apiculate,appearing,appressed,armed,articulated,attached,attachment,axe,ba,berry,bilobe,blade,branch,bu,channeled,clinate,connivent,deciduous,dehiscence,dentate,difoliate,dorsally,eaf,eed,either,emerging,enclosing,endocarp,exocarp,fertile,filiform,flat,fork,forking,free,frui,fully,geminat,glandular,immature,inclined,intersepalar,juic,lanceolate,large,laying,less,line,lobe,lon,lower,major,mature,midrib,minor,minute,nflorescence,notched,oblique,often,orolla,peekel,per,perforate,point,pore,portion,potentially,prickle,protuberance,ray,reduced,reported,rigid,ripe,row,ruit,shiny,shorter,side,single,sinus,soon,splitting,suture,tamen,tem,thin,time,tip,toward,transparent,triangular,truncate,tube,two,ud,unarme,unarmed,unbranched,vary,ympodia,±90°and,±equal,×	4–5-merous,abaxial,arrangement,bilobed,color,colour,feature,form,height,history,inflorescence,length,life,na,number,ovary,perennial,plant,position,rachi,reproduction,seed,shape,spacing,staman,texture
600	wfo-0001030287	success	150	102	72	78	30	0.48	-11,-40,0-15,0.5-1,1-10,1-15,1-2,1-4,1-5.5,1.5-2.5,1966,2,2-,2-12,3-9,4-5,4.5-6,aggregate,apart,articulated,base,bluish,cell,chartaceous,cm,color,compound,dendritically,densely,diameter,down,ellipsoidal,elliptic-ovate,fide,flattened,flower,forked,glabrous,herb,lanceolate,leaf,lilac,membranaceous,mm,moderately,narrowly,oblong,ovoid,pedicel,peduncle,petiole,pinnately,puberulent,pubescent,purple,rachi,rugulose,shrub,simple,slightly,smith,stellate,stigma,stone,strongly,style,subcoriaceous,truncate,unbranched,unknown,x,yellow	-foliat,-many,.5-2.5,1,1-2.5,1-3,1.5-10,2-10,2-5,2.5-4,3,4-6,5-10,8-13,?,abaxially,acute,adaxiall,adaxially,apex,axe,basiscopically,blade,branched,calyx,connivent,cylindrical,decurrent,deltate,dendritic,dendritic-pubescen,directed,distall,eaf,eed,eglandular,entire,gland,glandular,hair,lateral,leaflet,leaving,lobe,lon,long,long-stalked,lower,margin,nflorescence,nther,obtuse,often,orolla,pedicellar,pore,presen,radiu,ruit,scar,scattered,spaced,sparsely,sparser,stalked,subcapitat,subcordate,tal,tem,time,tip,triangular,tube,unit,upper,vary,wide,ympodial	abaxial,adaxial,anther,arrangement,corolla,dendritic-pubescent,filament,form,fruit,growth,height,history,inflorescence,length,life,na,number,ovary,perennial,plant,present,reproduction,seed,shape,size,spacing,staman,subcapitate,surface,texture
601	wfo-0001030299	success	179	104	76	103	28	0.425	-40,-50,0.5-1,1-1.5,1-10,1-3,1.5-2,1.5-3,10-20,2-,2-10,2-20,2.5-12,25-50,3-13,3-9-compound,4-6,6-22,6-9,abaxially,acuminate,adaxially,apart,apex,articulated,base,campanulate,capitate,chartaceous,cm,color,connective,cylindrical,densely,diameter,ellipsoidal,flattened,flower,forked,fruit,glabrous,globose,leaf,mm,moderately,narrowly,obtuse,ovate,pedicel,pedicellar,peduncle,petiole,pink,pinnately,pubescent,pubescent-pilose,purple,rachi,remnant,rugose-reticulate,shrub,simple,small,sparsely,stigma,style,tomentose,tree,triangular,truncate,unbranched,urceolate-,violet,white,x,yellow	-2,-6,.5-2,1-2,1-5,1.5-4,10-16,2,2-4,20-30,3,3-30,3-4,3-5,4,4-5,4-8,4-foliat,5-10,5-40,5-8,?,absen,absent,acute,aggregate,also,ape,apiculate,axe,basal,basiscopically,beyond,blade,calyx,cell,compound,connivent,cordate,coriaceous,decurrent,diamete,dilated,directed,distally,eaf,eed,entire,equal,exceeding,expanded,exserted,fide,hair,lateral,laterally,leaflet,leaving,lobe,lon,long,lower,margin,midnerve,nflorescence,nther,often,orolla,pavón,perfect,perhaps,pilose-hirsute,pore,present,prominent,puberulent-pubescen,puberulent-pubescent,pubescent-pilo,radiu,ruit,ruiz,shorter,slightly,spaced,stamen,stone,tal,tem,thecae,thickened,time,tip,tomento,toward,tube,ud,unequal,unit,unknow,upper,vary,wide,ympodial	abaxial,adaxial,anther,arrangement,bud,colour,corolla,form,growth,height,history,inflorescence,length,life,na,number,ovary,plant,position,reproduction,seed,shape,spacing,surface,texture,theca,unknown,width
602	wfo-0001030300	success	235	99	78	157	21	0.332	-1,-7,0.4-0.5,0.5,0.5-1,0.5-4,0.6-0.8,0.7-1.5,0.9-1,1,1-2,1-4,2-2.1,4-11,6-15,9-12,abaxially,adaxial,anther,articulated,articulation,base,bifid,brittle,broadly,brown,capitate,cm,corolla,curved,densely,diameter,ellipsoidal,elliptical,elongate,filament,flower,fruit,globose,golden,green,hair-like,herb,imparipinnate,inflorescence,interrupted,large,less,mm,moderately,obovate,once-branched,orbicular,outgrowth,ovary,pale,pedicel,peduncle,pentagonal,perennial,petiole,pith,plant,present,pseudostipule,pubescence,pubescent,simple,slightly,sparsely,stem,stigma,strongly,style,surface,yellow,yellowish,zygomorphic	-0.9,.5,0.1,0.1-0.15,0.15-1,0.2,0.2-0.5,0.2-1.5,0.4-1.5,0.4-4.5,0.5-0.6,0.5-5,0.6-0.7,0.7-0.8,0.7-1.2,0.8-1,0.8-3,0.8-4,1-1.3,1-2-celled,1-6,1-celled,1.2-,1.4-2.4,1.5-,1.5-2.5,2-2.5,2-3,2-4,2-foliate,2-locular,2.2-7.5,3.5-13,3/4,4-celled,6-8-celled,absent,abundant,acute,adaxially,almost,although,always,anthesi,apex,apical,appearance,appendage,ba,basal,bent,beyond,bract,bracteate,calyx,cell,coherent,column,cordate,crenat,crenate,deltate,developed,diamete,distal,eaf,edicel,eed,eglandular,entire,even,exserted,face,finely,frequently,fruiting,give,glabrous,glandular,glutinous-viscose,gree,halfway,head,interjected,internode,introrse,irregularly,lamina,larger,lateral,leaflet,leave,like,lobe,lon,long,longer,margin,markedly,midvein,minute,multicellular,narrowly,nflorescence,node,oblique,occasionally,pair,papillae,partially,petal,petiolule,population,pore,primary,reflexed,rest,rounded,ruit,secondary,silky,spathulate,spreadin,spreading,staminal,sterile,straight,tall,tem,terminal,tertiary,testa,thick,tip,triangular,trichome,tube,two,ud,underlying,unicellular,uniseriate,unit,united,upper,usually,vein,velvety,wall,weak,well,wide,wider,winged,woody,yellowish-green,ympodial	abaxial,arrangement,brittlenes,bud,color,colour,curvature,form,growth,height,history,leaf,length,life,number,presence,seed,shape,staman,texture,width
603	wfo-0001030311	success	182	113	65	117	48	0.357	.2,0.1,5-pinnate,<,abaxially,accrescent,acuminate,acute,adaxial,adaxially,anther,apex,brown,calyx,chartaceous,ciliate,cm,color,deltoid,densely,diameter,extra-axillary,filament,flattened,flower,fruit,fruiting,glabrous,granular,green,herbaceous,lenticular,lobe,margin,membranaceous,membranous,minutely,mm,obtuse,orangish,ovoid-rhomboid,pedicel,peduncle,petiole,pubescent,purplish,rachi,rounded,sand-punctate,short,slender,slightly,sparsely,stellate,stigma,style,surface,tan,terrestrial,trichome,tube,unbranched,vine,white,x	.5,.5–1.8,0.1–0.2,0.3–1.5,0.4–2,0.5–0.8,0.5–1,0.5–2,0.5–2.5,0.6–1,0.6–2.4,0.8–1.2,0.8–4,0.8–4.5,1.2–7,1.5–2,1.5–3,1.5–5.5,1.5–6,1.5–8,1.8–2,15–22,1–1.2,1–1.5,1–2,1–2.5,1–3,2.2–2.5,2.2–3,2.5–9,2–10,2–2.5,2–6,3–5,3–7,5–10,along,alyx,apar,apical,appearance,axe,basal,base,berry,blade,c.,capitat,ciliat,clavate,cordate,cuneate,dense,distal,eaf,eed,elliptical,entire,especially,falcate,fallen,giving,glabrou,groov,groove,ground,hair,half,lanceolate,lateral,leaflet,like,log,lon,long,lower,m.,midvein,nflorescence,nternode,oblique,obovate,occasionally,orolla,pair,papillose,petiolulate,petiolule,plurifoliat,present,proximal,pubescence,rhomboid,ruit,scattered,sessile,shortly,side,smaller,spaced,stem,strongly,tamen,tem,thick,thickened,thinner,tip,trailing,unit,upper,vary,vein,wide,wide-diameter,widely,ympodial	.5-1.8,0.5-0.8,0.5-1,0.5-2.5,0.6-1,0.8-1.2,1-1.2,1-1.5,1-2,1-3,1.5-2,1.5-3,1.5-5.5,15-22,2-10,2-2.5,2-6,2.5-9,3-5,3-7,5-10,abaxial,apart,arrangement,capitate,colour,corolla,form,growth,height,history,inflorescence,internode,leaf,length,life,na,number,ovary,plant,position,reproduction,seed,shape,spacing,staman,texture,width
604	wfo-0001030311	success	203	112	84	119	28	0.414	.2,0-2.5,0.5-1,0.5-2,0.6-1,0.8-1.2,1-1.5,1-3,1.5-5.5,1.5-6,15-22,2-10,2-2.5,2-6,3-5,3-7,5-10,5-pinnate,abaxially,acuminate,acute,adaxial,adaxially,anther,apart,apex,apical,base,brown,chartaceous,cm,color,cordate,cuneate,densely,diameter,elliptical,filament,flattened,flower,fruit,glabrous,granular,green,herb,leaflet,lenticular,lower,membranaceous,minutely,mm,node,oblique,obovate,obtuse,orangish,ovoid-rhomboid,pair,pedicel,peduncle,petiole,petiolule,pubescent,purplish,rachi,rhomboid,rooting,rounded,shortly,side,slender,slightly,sparsely,stellate,stem,stigma,style,surface,tan,unbranched,upper,white,x,yellow	.5,.5-1.8,0.1,0.4-2,0.5-0.8,0.6-2.4,0.8-4,0.8-4.5,1-1.2,1-2.5,1.2-7,1.5-2,1.5-3,1.5-8,1.8-2,2.2-2.5,2.2-3,2224,5-merou,8031,<,[,],absen,absent,accrescent,ag,aggregate,along,alyx,apparently,appearance,articulated,axe,ba,basal,basally,blade,capitat,cell,ciliat,ciliate,clavate,connivent,deltoid,dense,dig,directed,distal,distally,eaf,eed,entire,equal,especially,falcate,fallen,formation,g,geminat,gh,giving,groov,groove,ground,hair,half,interjected,large,lateral,like,lobe,log,lon,long,longitudinal,m.,margin,midvein,nflorescence,oblong,occasionally,opening,orolla,papillose,perfect,petiolulate,pittier,plurifoliate,pore,present,proximal,ruit,scattered,sessile,short,simple,sinple,slit,smaller,spaced,stone,strongly,tamayo,tamen,tem,thick,thickened,thinner,tip,trailing,tube,uniseriate,unit,vary,vein,wide,widely,ympodial	5-merous,abaxial,arrangement,capitate,colour,corolla,form,growth,habit,height,history,inflorescence,leaf,length,life,na,number,ovary,plant,position,reproduction,seed,shape,spacing,staman,texture,unknown,width
605	wfo-0001030335	success	153	115	84	69	31	0.549	.1,.75,0-5,0.1-0.5,0.25-0.5,0.7-1,1-2,1.1-1.4,2-2.2,2-2.5,2-5,3/4,5-6,acute,along,anther,apex,bark,base,beneath,bi-lobed,branch,bud,calyx,cm,conical,corolla,dark,densely,dia,dry,elliptic,erect,filament,filiform,free,fruiting,glabrous,globose,green,greyish-red,horizontally,leaf,like,lobed,long,material,minutely,mm,narrowly,opposite,ovary,ovoid-reniform,pale,papillose,pedicel,petiole,pitted,portion,puberulent,pubescent,reflexed,shaped,shrub,simple,sparsely,spreading,stem,stigma,straight,strongly,style,surface,tan,tear-drop,tip,trichome,tube,uniseriate,vein,way,white,yellow,yellowish-green	.25,.5,0.05-0.2,0.5-1,1-1.5,1-3-flowered,1.1.5,2-4.5,2.5-3,5-7,7-13,acuminate,anthesi,aspec,ba,berry,deciduous,decurrent,deflexed,deltoid,eaf,edicel,eed,except,expanded,exserted,flattened,geminate,gently,giving,lamina,lateral,lenticellate,lightly,lobe,lon,lower,main,middle,minute,nflorescence,obovoid,occasionally,often,older,onto,pair,papillo,pore,poricidal,prominent,puberulen,raised,ripe,ruit,slightly,soon,tall,tapering,ud,underside,unifoliat,unit,widest,winged,woody,x,ympodial,young	1-3,abaxial,adaxial,arrangement,color,colour,diameter,flower,form,fruit,growth,height,history,inflorescence,length,life,na,number,peduncle,perennial,plant,position,rachi,reproduction,seed,shape,spacing,staman,texture,unifoliate,width
606	wfo-0001030336	success	266	87	70	196	17	0.263	0.5-0.7,0.5-1,0.8-1.3,1-1.5,1-3,1.7-2.3,3-5,4-10,8-20,acute,almost,anther,apex,articulated,bifurcate,bluntly,bright,brown,capitate,cell,cm,conical,corolla,dark,densely,diameter,elliptic,filament,flower,flushed,fruit,globose,grayish,green,greenish,hair-like,half,imparipinnate,inflorescence,interrupted,lateral,leaf,margin,mm,obovate,once-branched,orbicular,outgrowth,ovary,pedicel,peduncle,petiole,proximal,pubescent,purple,rotate,rounded,slightly,stellate,stem,stigma,style,surface,testa,tip,usually,velvety,wall,white,yellow	-1.5,-10,-19,-2,.5,0-,0.1-0.3,0.1-0.5,0.1-0.7,0.1-1,0.15-0.2,0.15-0.9,0.2,0.2-0.25,0.2-0.8,0.2-1,0.2-1.5,0.3-0.4,0.3-1.1,0.5,0.5-1.5,0.6-0.8,0.6-1.5,0.8-0.9,0.8-1.2,0.8-3,1,1-1.4,1-celled,1.0-1.4,1.5-,1.5-2,1.5-3.5,1.5-5,1.6-7,1.8-3.0,1/4-1/3,10,2-4,2-9,2-foliate,2-locular,2/3,4,4-,4-celled,6,8-16,8-celled,absent,adpressed,amongst,anthesi,apical,appearance,appearing,appendage,articulation,basal,base,basiscopically,bent,berry,bract,bracteate,branch,calyx,clavat,coat,column,completely,cordate,crenate,curved,darker,decurrent,deeply,developed,diamete,distal,divided,eaf,edicel,eed,eglandular,elongate,entir,entire,erect,essentially,exserted,extremely,first,fruiting,giving,glandula,glandular,halfway,head,herb,interjected,internode,investing,lanceolate,large,larger,largest,leaflet,leave,less,like,lobe,lobed,lon,long,longer,loosely,lower,markedly,maturity,mere,middl,midvein,minute,minutely,mixed,mostly,narrowing,narrowly,nflorescence,node,oblique,occasionally,often,pair,pale,papillate,part,perennial,petiolule,population,present,primary,pseudostipule,puberulent,rachi,range,reflexed,rest,ruit,scattered,secondary,sessile,shaggy,shorter,shrub,silky,simple,sinus,small,soft,sometimes,southern,sparse,spreadin,spreading,staminal,sterile,straight,stripe,strongly,surrounding,tall,tem,ten,terminal,tertiary,thick,trichome,truncate,tube,two,ud,unicellular,uniformly,uniseriate,unit,united,upper,way,weak-walled,wide,winged,woody,ympodial,young	1.5-4,abaxial,adaxial,arrangement,clavate,color,colour,height,length,middle,number,plant,seed,shape,spacing,staman,texture
607	wfo-0001030342	success	155	105	62	93	43	0.4	.2,1-6.5,3-pinnate,5-merous,abaxially,acuminate,adaxially,anther,apex,apiculate,base,blade,brown,chartaceous,cm,cordate,cuneate,dense,diameter,elliptical,entire,extra-axillary,filament,flower,fruit,glabrous,greenish,herbaceous,leaf,leaflet,lenticular,light,margin,membranous,mm,oblique,obtuse,ovoid-rhomboid,pedicel,peduncle,petiole,petiolule,pubescent,rachi,rarely,rounded,scattered,slender,smooth,stellate,stigma,style,surface,trichome,unbranched,undulate,vein,vine,white,widely,x,yellowish	.5,0.1–0.2,0.3–1.2,0.5–1,0.5–3,0.5–5,0.8–1.5,0.8–4,1-5,1.2–3,1.5,1.5–13,1.5–2,1.5–5,1.5–7.5,10–25,1–1.2,1–1.5,1–2.5,1–3,1–5.5,1–6,1–7,2–,2–2.5,2–4,3,3–12,4–5,4–8,6–7,abundant,accrescent,acute,along,alyx,apar,apical,axe,berry,broadly,c.,calyx,capitat,ciliat,cylindrical,deltoid,eaf,eed,flattened,fruiting,glabrou,lanceolate,lateral,like,lobe,lon,long,lower,m.,minutely,mottled,nflorescence,nternode,often,orolla,perfec,plurifoliat,pointed,proximal,pubescen,revolute,rhomboid,ruit,sand-punctate,side,slightly,spaced,sparsely,stem,tamen,tem,terrestria,tip,truncate,truncate-acuminat,tube,unit,vary,wide,wide-diameter,ympodial,–7	0.1-0.2,0.3-1.2,0.5-3,0.8-1.5,1-1.5,1-7,1.5-13,1.5-5,1.5-7.5,10-25,2-2.5,2-7,3-12,4-5,4-8,abaxial,abundance,adaxial,arrangement,capitate,color,corolla,form,growth,height,history,inflorescence,length,life,na,number,ovary,perfect,plant,position,reproduction,seed,shape,spacing,staman,terrestrial,texture,width
608	wfo-0001030342	success	153	103	75	78	28	0.49	-7,.2,0.5-3,1-1.5,1-6.5,1.5-13,1.5-5,10-25,2-2.5,2-3,3,3-12,3-pinnate,4-5,4-8,abaxially,acuminate,adaxially,anther,apart,apex,apiculate,base,brown,chartaceous,cm,cordate,cuneate,diameter,elliptical,entire,extra-axillary,filament,flower,fruit,glabrous,hair,herb,leaf,leaflet,lenticular,light,margin,membraceous,minutely,mm,oblique,obtuse,pedicel,peduncle,petiole,petiolule,pubescent,rachi,rarely,revolute,rounded,scattered,simple,slender,smooth,stellate,stigma,style,surface,terrestrial,trailing,unbranched,undulate,uniseriate,vein,white,widely,x,yellow	.5,0.5-1,0.5-5,0.8-4,1-1.2,1-3,1-5,1-5.5,1-6,1-7,1.2-3,1.5-2,1.5-7.5,2-,5-merou,6-7,absent,abundant,accrescent,acute,ag,along,alyx,apical,apparently,articulated,axe,ba,basally,blade,broadly,calyx,capitat,ciliat,connivent,cylindrical,deltoid,directed,distally,eaf,eed,equal,fruiting,geminat,interjected,lanceolate,lateral,lobe,long,longitudinal,lower,nflorescence,node,oblong,opening,orolla,perfect,plurifoliate,pore,proximal,pubescen,rhomboid,rooting,sagittate,side,slightly,slit,spaced,tamen,tem,tip,truncate,truncate-acuminat,tube,unit,vary,wide,ympodial	5-merous,abaxial,adaxial,arrangement,capitate,color,colour,corolla,form,growth,height,history,inflorescence,length,life,na,number,ovary,perennial,plant,position,reproduction,seed,shape,spacing,staman,texture,width
609	wfo-0001030353	success	227	146	124	103	22	0.546	-6,-merous,.7,0-6,0.5-0.9,0.8,0.8-1.2,1-2,1-6,1-7,1.2-1.8,1.8-3,1/2-2/3,1/3,1/5,2-7,2.5-4,3-5.5,3.5-4,4-,5,5-6,6-15,abaxial,abaxially,acute,adaxial,almost,andromonoecious,anther,apart,apex,apically,articulated,bark,base,berry,brown,calyx,chartaceous,cm,conical,connivent,cuneate,curved,densely,diameter,ellipsoid,elliptic,erect,evenly,filament,flattened,flattened-reniform,flower,fruit,fruiting,glabrescent,glabrous,green,leaf,length,lobe,lobed,long,long-styled,lower,margin,maturity,mauve,midpoint,mm,moderately,multangulate,narrow-deltate,orange-brown,pair,patch,pedicel,peduncle,petiole,plant,poricidal,prickle,prickly,primary,ray,red-brown,reddish-green,rounded,sessile,shape,short-styled,shrub,small,smooth,sometimes,stalked,stellate-pubescent,stem,stout,straight,style,subentire,surface,tapering,terete,tertiary,tip,tree,trichome,unarmed,unbranched,upper,vein,venation,visible,warty,way,weakly,white-gray,wide,yellow,young	-0.2,-1.5,-1/2,-2,-3,-5,.1,.2,.5,0,0-15,0-2,0.1-0.2,0.1-0.3,0.15-0.3,0.5,1,1-3,1.8-2.2,1/,1/6,1/6-1/4,10-15,11-16,2-10,2.8-3.7,20-200,3-4,4-4.5,4-5,6,6-8,7-10,8-15,alyx,apar,apiculat,apparently,blade,broad-deltate,c.,deltate,development,discolorous,distal,distance,drying,eaf,eed,elongating,equal,extending,free,half,hermaphrodite,heterostylous,infructescence,lateral,less,longer,lowermost,mature,midvein,nflorescence,older,one,open,orolla,oung,pendulous,per,pericarp,plurifoliat,pointed,porrect,portion,reflexed,retaining,ruit,scar,shorter,side,simple,somewhat,spaced,sparsely,spreading,stalk,staminat,stellate,strongly,tamen,terminal,throughout,time,tube,unarme,unit,vary,whit,wo,woody,ympodial	.1-0.2,apiculate,color,colour,corolla,form,growth,height,history,inflorescence,life,number,ovary,perennial,reproduction,seed,spacing,staman,stigma,texture,white,width
610	wfo-0001030407	success	182	97	71	111	26	0.39	.5,1-10,1-2,1-4,12-14,12-15,2-7,3-6.5,3.5-9.5,30-60,4-5,7-8,abaxially,acuminate,adaxially,anther,apex,articulated,berry,brownish,cell,cm,condition,conical,corolla,covering,densely,diameter,drying,edge,elliptic-lanceolate,filament,flat,flower,forked,fresh,fruit,glabrous,green,greenish,hair-like,herb,homostylous,honeycomb-shaped,lateral,leaf,light,long,mm,mucilaginous,odd-pinnate,ovate,ovoid,pedicel,peduncle,pentagonal,petiole,plant,pubescent,purple,ripe,seed,stigma,style,terminal,testal,thick,wall,wet,whitish,yellow	.2,0.7-3.2,1-3,1.5-5,2-2.5,2-5,2-6.7,3-10.5,3-4,3-9,5,5-merou,6-7,6.5-18.5,absent,acumen,ag,alyx,apart,apparently,axe,axillary,base,blade,bud,capitat,chartaceous,ciliate,connivent,decreasing,digestion,distal,dorsally,eaf,eed,end,enzyme,especially,exceeding,folded,geminat,generally,glabrou,gradually,green-white,hair,half,interjected,lanceolate,larger,leaflet,lengthening,like,living,lobe,lower,make,margin,middle,minute,mottled,nflorescence,obtuse,one,orolla,pair,perfect,petiolule,placed,plurifoliate,pore,poricidal,proximal,pubescen,ray,removed,round,ruit,secondary,semierec,seudostipule,size,slit,spaced,specimen,stamen,ste,stolo,subequal,subsessile,subtending,symmetrical,tall,tamen,tem,thir,throughout,tip,toward,tri-,tube,tuber,typically,unit,unwinged,usually,vary,white,wide,x,ympodial	abaxial,adaxial,arrangement,capitate,color,colour,form,growth,height,history,inflorescence,length,life,na,number,ovary,perennial,position,rachi,reproduction,shape,spacing,staman,surface,texture,width
611	wfo-0001030417	success	242	88	65	177	23	0.269	-5,0.3-0.4,0.5-0.7,0.5-0.8,0.5-1,0.7-1,1-1.3,1-2.3,1.2-3,2-3,4-25,7-30,acute,annual,anther,apex,base,biennial,bright,broadly,brown,capitate,cm,conical,corolla,densely,diameter,elliptic,filament,flower,fruit,glandular,globose,green,hair-like,herb,imparipinnate,inflorescence,interrupted,leaf,length,mm,narrowly,obovate,occasionally,once-branched,outgrowth,ovary,ovate,pale,pedicel,peduncle,perennial,petiole,pubescent,rachi,red,simple,sparsely,stellate,stigma,style,surface,winged,yellow	.5,0.05-0.1,0.1-0.25,0.2,0.2-0.4,0.2-0.7,0.25-0.4,0.25-0.5,0.5-1.2,0.5-2,0.8,1,1-1.2,1-1.5,1-2,1-2-celled,1-3.5,1-4,1.5-2,1.5-3.5,1.5-5,1.5-8,1/3,2-4,2-8,2-locular,2.5-5,2/3,3,3-foliate,3/4,4-12,8-11,abaxially,absen,absent,abundant,acuminate,along,also,anthesi,apical,appearance,appendage,articulation,basal,basiscopically,bent,branch,calyx,cell,cente,column,common,cordate,crenate,decreasing,decurrent,dentate,distal,eaf,ebracteate,edicel,eed,eglandular,elongate,entire,erect,exserted,extended,extending,extremely,free,fruiting,generally,giving,glabrous,gree,hal,head,hybrid,included,initially,interjected,internode,lanceolate,larger,largest,later,lateral,leaflet,like,lobe,lon,long,lower,margin,maturation,mature,minute,minutely,mixture,multicellular,nflorescence,northern,oblique,often,pair,parallel,part,patent,pedice,peruvian,petiolule,point,population,portion,primary,procumbent,proximal,pseudostipule,pubescence,putatively,range,rarely,reflexed,rest,ripe,robust,round-crenate,rounded,ruit,scattered,secondary,sessile,several,shaggy,short,silky,size,slightly,sometimes,somewhat,species,staminal,stem,sterile,straight,strongly,tem,terminal,tertiary,testa,theseadpressed,thick,thin,third,tip,toward,trichome,truncate,tube,type,ud,unicellular,uniseriate,unit,usually,variable,vein,velvety,viny,wall,way,white,wide,ympodial	0.8-5,abaxial,adaxial,arrangement,color,colour,form,growth,height,history,life,na,number,plant,position,reproduction,seed,shape,spacing,staman,texture,thicknes,width
612	wfo-0001030420	success	170	118	88	82	30	0.518	-20,-30,-9,-pubescent,0.5-1,0.5-4,0.5-8,1-,1-2,1-3,1-4,1-6,1.5-3,10-,15-25,2-,2-3,2-6,2-9,3-lobed,4-7,5-,5-15,5-6,6-7,abaxially,acuminate,adaxially,aggregate,also,apart,apex,articulated,base,cell,chartaceous,cm,color,connective,densely,diameter,eglandular,ellipsoidal,elongated,flower,forked,fruit,glabrate,glabrous,glandular-puberulent,hair,lanceolate,leaf,long,mm,moderately,narrowly,obtuse,often,pedicel,pedicellar,peduncle,petiole,pilose,pinnately,puberulent,pubescent-pilose,purple,rachi,rarely,remnant,shrub,simple,small,sparsely,stellate,stigma,stone,style,subcoriaceous,tree,triangular,truncate,unbranched,unknown,unlobed,x,yellow	-2,-35,-4,0.5-,1,1-1.5,1-7.5,1.5-5,1/2,10-25,2-14.5,2-5,3-7,4-foliat,7-19,7-22,7/8,absent,acute,ape,axe,basal,beyond,blade,calyx,connivent,cordate,cylindrical,dark,deltate,directed,distally,divided,eaf,eed,eglandular-pilo,eglandular-puberulent,elliptic-ovate,entire,equal,exserted,glandular-,leaving,lobe,lobed,lon,lower,margin,midrib,nearly,nflorescence,nther,orolla,ovate,perfect,pore,presen,puberulent-pubescent,pubescent,pubescent-pilo,radiu,ripe,ruit,shorter,sinus,spaced,stamen,tal,tem,thecae,time,tip,tomento,truncat,tube,ud,unit,vary,vein,wide,yello,ympodial	abaxial,adaxial,anther,arrangement,bud,colour,corolla,form,growth,height,history,inflorescence,length,life,na,number,ovary,plant,position,presence,present,reproduction,seed,shape,spacing,surface,texture,theca,tomentose,width
613	wfo-0001030426	success	158	87	62	96	25	0.392	-30,0.4-0.7,1-4.2,1.7-3.2,15-25,2-3,2.5-4,2.5-6,3-12,6-8,9,acute,apex,base,branched,cm,corolla,cyme,diameter,dichasial,dichasially,distal,ebracteate,elliptic-lanceolate,flower,glandular,globose,green,green-white,half,heart-shaped,herbaceous,lanceolate,leaf,leaflet,linear,linear-lanceolate,linear-oblong,mm,monochasial,mucilaginous,oblique,obtuse,odd-pinnate,ovoid,pair,pedicel,peduncle,perennial,petiole,pilose,plant,rounded,seed,size,spot,stellate,stigma,style,terminal,white,yellow	0.3-7,0.3-8,1-4,1.5-3,1.5-6.5,10,2,3-4,3-6,3-6-foliat,4-10,4-6.5,6-11.5,abaxially,absen,acumen,adaxially,apical,apically,apiculate,articulate,calyx,caudate,cell,connate,covering,decurrent,dehiscent,digestion,diminishing,dorsally,eaf,edge,eed,emoval,enzyme,exceeding,filament,flat,folded,forked,generally,globo,gradually,hair-like,honeycomb,interjected,introrse,larger,lateral,living,lobe,lon,long,lower,make,maturing,nflorescence,nther,oblong,often,orolla,pattern,perfect,pinnatifi,plan,poricidally,proximal,rachi,reveal,ruit,second,sessile,seudostipule,short,slit,specimen,stamen,straight,stripe,tal,tem,testal,thick,throughout,toward,tuber-bearing,typically,unit,vary,wall,whit,wide,without,ympodial,¼	abaxial,adaxial,anther,arrangement,color,colour,form,fruit,growth,height,history,inflorescence,length,life,na,number,ovary,pinnatifid,position,reproduction,shape,spacing,surface,texture,width
614	wfo-0001030430	success	171	106	62	109	44	0.363	0.25,abaxially,acute,anther,anthesi,apart,apex,articulated,axillary,base,blade,blue,branched,brown,capitate,clavate,cm,densely,diameter,elliptic,filament,flattened,fleshy,flower,fruit,glabrous,globose,green,hair,indumentum,leaf,lobe,long,mm,moderately,occasionally,ovate,pale,pedicel,peduncle,pentagonal,perennial,petiole,pitted,pubescent,purple,rounded,shallowly,shoot,shrub,simple,stigma,style,subglabrous,surface,terminal,time,unifoliate,violet,white,x,yellow	.2,.5,0.3,0.4,0.5,0.5–12,0.6,0.6–0.8,0.6–1.0,0.8–3.0,0.8–5.6,0.9–1.0,0–20,1.0–1.2,1.0–1.5,1.0–2.0,1.2–2.0,1.3–8.0,1.4–1.5,1.5–1.7,1.6–1.8,1.8–5.0,12–20,12–30,1–3,1–9,2.0–3.0,2.0–4.2,2–3,3.0–4.5,30–200,3–17,3–24,3–4,3–5,3–8,5,5.5–12,5–10,5–6,6–10,abundant,adaxiall,adaxially,ag,apical,appressed,axe,ba,basal,borne,brittle,bud,calyx,cell,chartaceous,connivent,convex,cylindrical,decurrent,dentate,diamete,eaf,eed,equal,erect,especially,few-seeded,geminat,lobed,lon,longitudinal,lower,m.,margin,multicellular,nflorescence,oblong,opening,orolla,pair,perfect,pore,poricidal,present,regularly,ruit,serrate,shaped,side,slit,spaced,stone,straight,tal,tamen,tear-drop,tem,tip,toward,tube,uniseriate,unit,vary,wide,woody,ympodial,–2.7,–40	0-20,0.5-12,1.0-1.2,1.4-1.5,1.6-1.8,12-20,12-30,2-3,3-17,3-5,3-8,3.0-4.5,30-200,40,5-10,5-6,abaxial,adaxial,arrangement,color,colour,corolla,form,growth,height,history,inflorescence,length,life,na,number,ovary,pitting,plant,position,rachi,reproduction,seed,shape,spacing,staman,stem,texture,width
615	wfo-0001030441	success	178	140	113	65	27	0.635	+,.5,0.5,0.5-0.75,0.5-1,0.5-3,1-1.4,1-2-celled,1.2-1.4,1.5-2,10-40,2,2-10,2-5.5,3-4,30,5-7.5,6-11,<,>,acuminate,acute,along,anther,anthesi,apart,apex,base,berry,branched,bright,c.,calyx,capitate,cell,closely,cm,corolla,diameter,elliptic,entire,exerted,filament,flattened,flexuous,flower,fruiting,glabrous,globose,green,growth,hair,irregularly,lateral,lengthening,lobe,lobed,long,many,margin,membranous,midvein,minutely,mm,narrowly,occasionally,open,pale,papillose,pedicel,peduncle,peg,per,perfect,petiole,plant,pore,poricidal,pubescent,red,reniform,ridged,scar,short,shrub,simple,slightly,slit,spaced,spot,spreading,stellate,stem,stigma,strongly,style,surface,thin,time,tip,trichome,tube,undulate,uniseriate,unit,usually,vine,violet,wall,way,white,woody,yellow	1,1-1.5,2-3,2.5,4-5,5-14,5-6,5-7,5-merou,ag,alyx,ark,articulated,attenuate,brow,decurrent,deltate,distall,eaf,eed,ellipsoid,eye,free,glabrou,glandula,glandular,ilament,impressed,juicy,leaving,lon,lower,making,markedly,new,nflorescence,older,onto,orolla,otherwise,pair,papillat,pericarp,plurifoliat,portion,primary,reflexed,ripe,ruit,scandent,shiny,shrubby,small,somewhat,spreadin,tem,terminal,trailing,triangular,ud,upper,vary,vein,wide,ympodial	abaxial,adaxial,age,bark,brown,color,distally,exertion,form,fruit,height,history,inflorescence,leaf,length,life,na,number,ovary,perennial,plurifoliate,reproduction,seed,shape,spacing,sympodial,texture
616	wfo-0001030444	success	196	105	78	118	27	0.398	0-24,0.15-0.8,0.8-2,1-10,1-2,1-5,11-45,2.4-3.8,3-10,3-5,4-17,4-39,4-7,7.1-17.5,along,anther,apex,base,bead,berry,blue,cell,clavate,cm,condition,coriaceous,corolla,dark,decreasing,deep,diameter,elliptic,filament,flower,forked,fruit,glabrous,green,greenish,herb,honeycomb-shaped,interjected,larger,lateral,leaf,leaflet,light,like,lilac,medium,mm,moniliform,mucilaginous,necklace,odd-pinnate,orbicular,ovate,ovoid,pair,pedicel,peduncle,pentagonal,petiole,plant,rotate,seed,size,sometimes,stigma,stolon,style,terminal,testal,toward,tuber,wet,whitish,yellow	1,1-4,1.1-2.7,1.2-1.8,2-3,2-6,2-8,2.3-3.6,3.7-6.8,5-merou,5.3-9,6.1-12.8,9.4-20.1,abaxiall,abaxially,acumen,acuminate,acute,adaxially,ag,alyx,apart,apparently,arranged,articulated,asymmetric,attenuate,axe,axillary,basiscopic,blade,brownish,bud,capitat,ciliate,connivent,covering,digestion,distal,dorsally,dot,drying,eaf,edge,eed,enzyme,erec,exceeding,flat,folded,fresh,geminat,general,generally,glabrou,green-white,hair-like,hal,half,high,homostylous,lanceolate,lengthening,linear,living,lobe,long,lower,make,margin,multiple,narrow,nflorescence,orolla,perfect,petiolulate,plurifoliate,pore,poricidal,purple,removed,ripe,rough,rounded,ruit,sessile,seudostipule,shortly,side,slit,spaced,specimen,stamen,straight,subequal,subtending,symmetric,tall,tamen,tem,thick,throughout,tip,tissue,touch,tri-,tube,typically,unit,unwinged,usually,vary,wall,white,wide,wing,x,ympodial	abaxial,adaxial,arrangement,capitate,color,colour,form,growth,height,history,inflorescence,length,life,na,number,ovary,perennial,position,pseudostipule,rachi,reproduction,shape,spacing,staman,surface,texture,width
617	wfo-0001030445	success	226	140	109	117	31	0.482	0.2-0.4,0.2-0.5,0.3,0.4,0.6-2.2,0.6-3.5,0.7,1-7,1.3,1.3-2,1.5-2.1,1.7-2.4,2.1-5.2,3.5-4.2,4.1-8.7,4.2-10,6.1-9.1,7.5-16,8.2-18,abaxial,abaxially,accrescent,acuminate,adaxially,along,anther,apart,apex,articulated,bark,base,black,blade,branch,branched,brown,calyx,capitate,cm,concentrated,corolla,deltoid-reniform,diameter,drying,elliptic,elliptical,elongated,ferruginous,ferruginous-granular,ferruginous-tomentose,filament,flower,fruit,fruiting,glabrate,globose,green,greyish-tan,hair,homostylous,leaf,lobe,long,many,mm,oblong-lanceolate,obovate,obscured,open,orange,orangish-tan,orbicular,pedicel,peduncle,petiole,porrect-stellate,pseudoterminal,pubescence,pubescent,rachi,reniform,reticulate-punctate,semi-spherical,shrub,simple,slightly,small,sparse,splitting,stalk,stellate,stigma,style,subcampanulate,sulcate,surface,suture,thick-textured,thin-,time,tomentose,tomentum,tree,vein,white,x,yellow,yellowish,yellowish-tan	.1,.5,/5-2/3,0.1-0.7,0.2,0.2-0.7,0.5,0.8,1,1-1.3,1.1-4.3,1.3-1.8,1.6-2,1.8-3.5,10-14,10-16,14,15-35,2.2-2.9,2.2-3.5,2.4-4.7,3-5.4,3.1-5,3.4-5.6,5-125,5-merou,5.2-7.1,5.9-15,5.9-8.3,8.1-10,acute,ag,alyx,appressed,around,axillary,berry,blunt-tippe,blunt-tipped,brownish-yellow,bud,bulbous-based,cylindrical,decurrent,directed,distally,eaf,earl,edge,eed,entire,erect,exserted,free,geminate,glabrescen,glabrous,high,inserted,intermediate,lackin,lateral,lengthening,lobed,lon,longitudinal,lower,m.,main,margin,midrib,midvein,mostly,multangulat,multangulate,nflorescence,oblong,obtuse,older,orolla,ovate,ovate-lanceolate,plurifoliate,pore,poricidal,porrect-stellat,ray,relatively,resorption,rounded,ruit,runk,sessile,side,slit,somewhat,soon,spaced,sparsely,stamen,stem,stout,tamen,thick,thicknes,thin,tip,tissue,tube,unarme,unit,vary,vestigial-rayed,way,wide,ympodial,young	5-merous,55-125,accrescence,adaxial,arrangement,color,colour,concentration,early,feature,form,glabrescent,growth,height,history,inflorescence,length,life,na,number,ovary,perennial,plant,position,reproduction,seed,shape,spacing,staman,sulcation,texture
618	wfo-0001030447	success	276	135	122	154	13	0.442	.2,.3,.5,/5,0,0.5-0.65,0.5-10,0.5-3,0.8-3.5,1,1-10,1.5,1.5-7,1.8-2.5,1/3,2-4,2.2-2.8,2.5-10,2.5-6.5,3,3-5,5-15,6-10,6-16,7-8,abaxially,acute,always,anther,apart,apex,apical,apparently,bark,berry,cell,clavate,cm,corolla,curved,densely,diameter,drying,erect,filament,finely,flat,flattened,flattened-reniform,flower,fruit,glabrescent,glabrous,globose,irregular,lateral,leaf,length,lobed,long,lower,margin,maturity,midvein,mm,moderately,oblong,often,older,opening,orange,orange-brown,orange-red,orange-translucent,outline,ovate,pale,pedicel,peduncle,per,persisting,petiole,pit,porrect,prickle,pubescent,purple,rachi,raised,red-brown,ridged,rounded,sessile,shallowly,shiny,shortly,side,small,smooth,sometimes,somewhat,spaced,sparse,sparsely,stalked,stellate,stellate-pubescent,stem,stigma,straight,straw-yellow,style,subsessile,surface,terete,thin,translucent,trichome,unarmed,unbranched,white,yellow	0.1,0.1-0.3,0.15-0.3,0.2,0.2-0.4,0.4-0.7,0.4-0.9,0.5,0.7-1,0.8-1.7,1-1.5,1-2,1-2.5,1-3,1-5,1-6,1.5-2.5,1/3-1/2,1/3-2/3,1/4-1/3,3-4.5,30-45°,4-8,5,5-merou,6,6-7,6-8,6-9,6.5-9,8,accrescent,adaxially,age,alyx,apar,apically,armed,articulated,axe,base,beyond,blade,branche,broad-deltate,c.,calyx,characteristically,chartaceous,covering,cuneate,cupular,dark,deltate,development,difoliate,discolorous,distance,divided,eaf,eed,elongating,equal,exserted,extending,filiform,fine,finger-hair,free,fruiting,geminat,gently,herbaceous,infructescence,irregula,lengthening,less,lobe,long-ovoi,long-styled,longer,longitudinal,mature,midpoint,minute,mostly,narrow-deltate,nflorescence,obconical,oblique,obtuse,one,open,orolla,oung,pair,papillo,pendulous,perfect,pericarp,point,pore,poricidal,portion,primary,pronounced,prostrate,ray,reduced,rest,ri,ridge,ruit,scar,shallow,short-styled,shorter,shrub,simple,sinus,slender,slit,spherical,spreading,stalk,stout,stump,tamen,tapering,terminal,tertiary,thick,throughout,time,tip,toward,tube,ud,unequal,unit,usually,variously,vary,vein,venation,visible,weakly,wide,widest,woody,x,yellow-orange,ympodial,×	5-merous,color,inflorescence,number,ovary,papillose,seed,shape,spacing,staman,texture,thicknes,width
619	wfo-0001030452	success	199	109	67	132	42	0.337	4,5,80,abaxially,absent,acuminate,acute,anther,apex,black,blade,broadly,cm,curved,diameter,dull,filament,flattened,flower,fruit,glabrous,glandular-puberulent,globose,hair,immature,internode,leaf,mature,mm,moderately,narrowly,nearly,opposite,orbicular,ovate,pedicel,petiole,pilose,prickle,pubescent,rachi,reddish,sessile,shape,shrub,similar,simple,size,slightly,smooth,somewhat,spreading,stellate,stem,stigma,straight,strongly,style,subopposite,surface,thin-textured,truncate,unit,white,x,yellow,yellowish	.5–4.5,.6,0.1–0.4,0.2–0.3,0.4,0.6,0.7,0.8,1.2,1.2–1.6,1.5–3,100,10–15,1–1.3,1–2,1–3-celled,1–4,2,2.5–3,2.5–4,2.5–6,20–30,2–2.5,2–4,2–5.5,2–foliate,3,3.7–5.2,4–5-rayed,5–6,5–7,6–12,8–11,911,accrescent,adaxially,also,apparently,appressed,attenuate,axe,base,broad,calyx,canthophora,capitat,central,collected,contiguou,cordate,counted,cylindrical,deflexed,dense,developing,directed,distall,drying,eaf,eed,eglandular,enlarged,enlarging,f,free,fruiting,fully,geminat,glabrou,gland-tipped,gland–tipped,gradually,half,herter,hig,hyaline,imple,initially,larger,less,lobe,lon,long,longer,lower,major,margin,matur,maturity,minutely,nflorescence,numerous,often,one,orolla,per,pore,probably,proximal,pubescence,ray,reflexed,ruit,sec,short,sinuate,small,sof,sometimes,sparse,sprawling,ste,stellae,sulcate,tamen,tem,terete,thin–textured,tip,toward,triangular,tube,ultimately,uniform,usual,various,vary,vein,wide,wing,ympodial,–9	-9,0.2-0.3,1-1.3,1-2,1-4,10-15,2-4,2-5.5,2-foliate,2.5-3,20-30,5-6,abaxial,adaxial,arrangement,capitate,color,colour,contiguous,corolla,form,geminate,growth,height,history,inflorescence,length,life,na,number,ovary,peduncle,perennial,plant,position,reproduction,seed,spacing,staman,sympodial,texture,width
620	wfo-0001030453	success	127	104	72	55	32	0.567	.25,/4,0.8-1.5,1-1.3,1.5-1.6,1.5-2.5,3-3.5,abaxially,acuminate,acute,adaxially,along,anther,anthesi,apex,arachnoid,arachnoid-pubescent,attenuate,bark,base,broadly,calyx,clavate,closely,cm,corolla,dark,deflexed,deltate,divided,ellipsoid,elliptic,especially,exserted,filament,glabrous,later,leaf,less,lobe,midrib,minute,minutely,mm,narrowly,opposite,ovary,pedicel,petiole,pore,pubescent,reddish,rounded,scar,shaped,shiny,shrub,simple,slender,spaced,sparsely,stigma,straight,strongly,style,surface,tear-drop,trichome,tube,way,white,young	.5,0.25-0.5,1-1.5,4-5,9-12,9-14,axi,cup-shaped,delicate,dendritic,densely,dia,eaf,edicel,eed,fine,flat,floccose,free,glabrate,know,known,lateral,lon,long,lower,main,margin,middle,near,nearly,nflorescence,occasionally,older,overlappin,pair,papillat,papillose,planar,poricidal,portion,reddish-brow,ruit,soon,stem,tall,tip,tub,ud,unifoliat,unit,vein,wide,widest,ympodial	abaxial,arrangement,bud,color,colour,diameter,exsertion,flower,form,fruit,growth,height,history,inflorescence,length,life,na,number,overlapping,papillate,peduncle,perennial,plant,position,rachi,reddish-brown,seed,shape,spacing,staman,texture,unifoliate
621	wfo-0001030486	success	141	104	71	70	33	0.504	.5,1-1.5,1-5,1.1-1.4,1.7-2,2-3,4.5-5,6-7,acute,anther,anthesi,apex,bark,basal,base,beneath,brown,calyx,clavate,closely,cm,corolla,dark,deflexed,dry,ellipsoid,elliptic,erect,exserted,filament,fleshy,fresh,fruiting,glabrous,globose,green,internodal,later,leaf,lobed,material,minutely,mm,opposite,ovary,overlapping,ovoid-reniform,pale,papillose,pedicel,petiole,pitted,reddish,shrub,simple,slightly,small,spaced,stem,stigma,stout,style,surface,tan,tapering,treelet,tube,white,woody,x,yellow-green	0.8-2.2,1.5-2,1/2,1/4,10-12,10-14.5,2-5.5,3-3.5,3-5,3/4,4-4.5,4-6.5,5-8-flowered,abaxially,adaxially,ba,berry,clustered,completely,conical,deltate,dia,differing,difoliate,distal,drying,eaf,edicel,eed,f,free,geminat,inflorescenc,lateral,lobe,lon,long,lower,m.,main,major,margin,middle,minor,nflorescence,older,pair,papillo,planar,pore,poricidal,portion,ruit,scar,shaped,shin,size,tall,tear-drop,thickened,tip,tub,ud,unit,usually,vein,way,widest,ympodial,young	5-8,abaxial,adaxial,arrangement,bud,color,colour,deflexion,diameter,exsertion,flower,form,fruit,growth,height,history,inflorescence,length,life,na,number,peduncle,plant,position,rachi,reproduction,seed,shape,shiny,spacing,staman,texture,width
622	wfo-0001030489	success	196	143	114	82	29	0.582	-6.5,.5-2.8,0.25-0.4,0.5-3,0.6-0.9,0.75-0.9,1-3,1.1-1.3,1.2-1.6,1.6-2.1,1.75-2,1/3-1/2,100,2.1-2.9,3-6,3-8,4-8,4.5-9,5,7-15,abaxially,abruptly,adaxially,anther,apart,apex,appressed,appressed-pubescent,articulated,attenuate,bark,base,blunt-tipped,branch,branched,broadly,brown,bud,calyx,chartaceous,cinereous,cm,conical,continued,corolla,deltoid,diameter,dichotomously,echinoid,elliptic,elongate,entire,filament,flower,fruit,glabrate,globose,greenish,growth,hair,high,honeycombed,leaf,length,lobe,lobed,long-acuminate,margin,minutely,mm,multangulate,narrowly,oblong,ovate,ovate-lanceolate,pale,pedicel,peduncle,petiole,porrect-stellate,probably,pubescent,pulverulent,rachi,reniform,reticulate-punctate,ripe,sessile,several,short,short-stalked,shrub,simple,small,smooth,somewhat,sparingly,stellate-pubescent,stellate-rotate,stem,stigma,style,subcampanulate,subglobose,suborbicular,time,toward,tree,tube,way,white,x,yellow,yellowish	.5-3,.75-5.25,0.9-1.1,1-1.3,1-3.75,1.2-1.5,1.7-2,1.9-2.6,1/5-1/2,12-24,5-6,6-8,absen,acuminate,acute,adaxiall,ag,anthesi,apical-lateral,apparently,axe,axillary,ba,becoming,berry,blade,closely,cylindrical,dehiscing,densely,due,eaf,echinoi,eed,fleshy,free,glabrous,inserted,introrse,large,lateral,long,long-exserted,longitudinal,lower,main,midvein,minute,mostly,nflorescence,obtuse,older,orolla,perfect,plurifoliate,pore,pseudo-terminal,puberulent,pulverulen,ruit,runk,side,slender,slit,spaced,sparse,subcapitat,tamen,terete,testa,thick,tomentose,turn,unarme,unarmed,unit,usually,vary,vein,wide,ympodial,young	abaxial,adaxial,arrangement,branching,color,colour,form,height,history,inflorescence,life,lobing,na,number,ovary,plant,position,pseudoterminally,reproduction,seed,shape,spacing,staman,subcapitate,surface,texture,thicknes,trunk,width
623	wfo-0001030492	success	221	138	114	107	24	0.516	0.1-0.5,0.25-0.5,0.3-0.5,0.5-1,1-1.5,1-8,1.5-2,1.5-6,10-35+,10-50+,15-20,2-2.5,2-3,2-5,25-50+,3-10,3-8,30-40+,5-30+,5-7,9-11,?,abaxially,acute,adaxially,anther,apart,apex,articulated,base,branched,brown,chartaceous,cm,coarsely,deeply,densely,diameter,elliptic,entire,erect,extra-axillary,ferruginous-pubescent,filament,flattened,flower,forked,fruit,fully,glabrous,glandular-puberulent,globose,green,hair,juvenile,lanceolate,larger,lateral,leaf,less,light,lobed,margin,maturity,midpoint,midvein,minutely,mm,moderately,oblique,often,ovate,pedicel,peduncle,perfect,perhaps,petiole,pinnatifid,pitted,plant,prickle,pubescent,rachi,ray,recurved,ripe,sessile,shape,short-stalked,shrub,simple,size,small,sometimes,somewhat,sparsely,stellate,stellate-pubescent,stem,stigma,straight,style,subcordate,surface,toothed,tree,truncate,unbranched,uniform,white,woody,x,yellow,yellowish	-2,.1,.5,0.1-1,1,1.5,10,12-25,2,2-4,3-5,3-7,4,4-6,4-7,4-8,5-6,7-18,accrescent,adaxiall,also,apparently,armed,axe,ba,blade,broad-based,calyx,capitat,caudate-acuminate,coarse,connivent,covering,cylindrical,difoliate,directed,distall,divided,eaf,eed,eglandular,emerging,female-sterile,ferruginous,first,frui,fruiting,geminat,gland,glandular,halfway,held,interpetalar,later,like,lobe,lon,long,longer,lower,lowering,major,midrib,mostly,much,narrow,near,nearly,nflorescence,occasionally,orolla,pair,part,pore,rectangular,ruit,rusty,scattered,short,shorter,similar,sinus,slightly,spaced,sparse,splitting,sprout,stalk,ste,stellae,tal,tamen,tapered,time,tip,tissue,tube,unarmed,unit,upper,uprigh,vary,vein,wide,ympodial,younger,youngest	abaxial,adaxial,arrangement,capitate,color,colour,corolla,form,growth,height,history,inflorescence,length,life,na,number,ovary,position,reproduction,seed,spacing,staman,texture,variation
624	wfo-0001030509	success	220	109	92	128	17	0.418	-6,0-0.3,0-5,0.1-0.2,0.2,0.3-2.5,0.5-1.5,0.8-1.2,1-1.5,1-2,1-6,1.3-2,2-2.5,2-3,2-4.2,2-4.5,2-6,2/3-3/4,4.5-8,abaxially,anther,apart,apex,bark,base,berry,cm,connivent,cream,curved,dark,densely,diameter,entire,erect,filament,flattened-reniform,flower,fruit,glabrescent,glabrous,gray,green,half,inflated,leaf,length,lobed,margin,marking,maturity,mauve,midpoint,mm,moderately,obtuse,occasionally,orange,orange-brown,ovate,pale,pedicel,peduncle,perpendicular,petiole,plant,poricidal,prickle,purple,ray,rounded,scar,shorter,sparsely,spherical,stellate,stellate-pubescent,stem,straight,style,surface,tapering,terete,tip,trichome,unbranched,upper,way,weakly,yellow,yellow-green,young	-10,-2,/3,0,0-100,0-15,0-3,0.1,0.1-0.25,0.1-0.3,0.6-1,0.8-4,1,1-3,1-4,1.5-2,1.7-2,1/,1/3-2/3,1/4,2.8-3,3-10,3-4,4.5-10,4.5-12,5-10,5-merous,7-15,7-9,8-16,alyx,andromonoecious,apar,apical,apically,apparently,articulated,becoming,blade,broad-deltate,brow,calyx,chartaceous,cordate,cuneate,difoliate,discolorous,distal,distance,drying,eaf,eed,elongating,equal,extending,eye,free,fruiting,geminat,gland,globular,herb,herbaceous,hermaphrodite,heterostylous,infructescence,lateral,lobe,long,long-acuminat,long-styled,longer,lower,lowermost,mature,midvein,naked,narrow-deltate,narrow-oblong,nflorescence,occasional,often,older,one,open,orolla,oung,pair,pendulous,per,pericarp,porrect,portion,prickly,primary,reduced,ruit,short-styled,shorte,shrub,side,simple,slender,smooth,sometimes,spaced,spreading,stalk,stalked,staminat,subsessile,tamen,terminal,tertiary,time,tube,unarme,unarmed,unit,usually,variously,vary,vein,venation,visible,wide,woody,ympodial	abaxial,adaxial,brown,color,colour,corolla,height,inflorescence,number,orientation,ovary,seed,shape,spacing,staman,texture,width
625	wfo-0001030511	success	166	111	88	78	23	0.53	-6,.5,0.1-0.15,0.4-0.5,0.5,0.5-0.6,0.8-1,1-2,1.5-4,4-merous,absent,almost,anther,anthesi,apex,base,berry,bright,calyx,closely,cm,conical,corolla,diameter,difoliate,ellipsoid,entire,exserted,filiform,flattened,flower,glabrous,globose,growth,inflorescence,internodal,lanceolate,leaf,like,linear,lobed,long,margin,minute,minutely,mm,nearly,nodding,ovary,pale,pedicel,peduncle,perfect,petiole,pitted,plant,poricidal,porrect,pubescent,red,reniform,ripe,rounded,scar,sessile,shiny,shrub,simple,sometimes,spaced,sparsely,stellate,stem,stigma,style,surface,tan,tapering,thin,tip,trichome,tube,unit,violet,white,x,½,¾	0.1,0.5-1,1,1.5,4-7,4-8,5-7,5-9,6-8,?,abaxially,acicular,adaxially,along,also,arising,articulated,attenuate,barely,bark,brow,cell,curved,deeply,deltate,densely,eaf,eed,either,erect,especially,filament,free,fruiting,geminat,leave,lengthening,less,lobe,lower,membranous,midpoint,midrib,midvein,new,nflorescence,noddin,older,overlappin,pair,papillo,per,pericarp,planar,pore,portion,prickle,prickly,primary,rarely,ray,rest,ruit,short-stalked,sinuate,strongly,tall,testal,toward,triangular,ud,upper,vein,visible,woody,yellow,yellowish,ympodial	abaxial,bud,color,exsertion,form,fruit,geminate,height,history,length,life,number,overlapping,papillose,perennial,position,reproduction,seed,shape,size,spacing,sympodial,texture
626	wfo-0001030516	success	172	113	81	91	32	0.471	0.4-1.5,1-4,1-7,1.8-2.4,2-12,3-6,3-8,4-22,4-6,4.2-10.7,8-9,9-32,acuminate,acute,apex,articulate,base,branched,cell,cm,cordate,corolla,covering,cuneate,cyme,darker,diameter,dichasial,dichasially,distal,ebracteate,elliptical,filament,flower,globose,green,green-white,hair-like,half,herbaceous,honeycomb,interjected,lateral,leaf,leaflet,light,long,mm,monochasial,oblique,odd-pinnate,outline,ovate,ovoid,pattern,pedicel,peduncle,pentagonal,perennial,petiole,pilose,plant,proximal,puberulent,pubescent,rotate,seed,size,slightly,sometimes,stigma,stripe,style,terminal,testal,thick,throughout,triangular,wall,yellow,¼	1-2.5,1.1-3.5,1.1-4.1,1.5-2,1.7,2-2.,2-3,2-4,3-6-foliat,3-9.8,4-4,4-7,6-15,9-22,abaxially,acumen,adaxially,apical,apically,calyx,connate,covered,decurrent,dehiscent,densely,digestion,diminished,dorsally,eaf,edge,eed,emoval,enzyme,exceeding,first,flat,folded,forked,generally,gland,globo,gradually,hair,introrse,less,living,lobe,lon,long-attenuate,longer,lower,lunat,make,maturing,mucilaginous,nflorescence,nther,often,orolla,pair,perfect,plan,poricidally,rarely,reveal,ruit,second,sessile,seudostipule,short,short-petiolate,short-stalked,slit,specimen,spreading,stamen,straight,tal,tem,time,toward,triangulat,tuber-bearing,type,typically,unit,vary,whit,wide,ympodial,’	2-21,abaxial,adaxial,anther,arrangement,color,colour,form,fruit,growth,height,history,inflorescence,length,life,lunate,mucilaginousnes,na,number,ovary,position,pseudostipule,rachi,reproduction,shape,spacing,staman,surface,texture,wet,white,width
627	wfo-0001030522	success	192	112	91	101	21	0.474	.7,0.3-0.7,0.5-0.6,0.5-1,0.7,1-1.4,1-5-2,1.5,2-lobed,20-30,3-4.5,3-5,4,abaxially,absent,acute,adaxially,anther,apart,apex,bark,base,berry,brown,calyx,cm,completely,cordate,corolla,cup-shaped,dark,densely,diameter,dioecious,ellipsoid,elliptic,entire,erect,filament,flattened,flower,fruit,fruiting,glabrous,globose,green,growth,included,inflorescence,internodal,irregularly,juvenile,leaf,less,lobe,lobed,margin,mature,minutely,mm,oblique,obtuse,often,orange,ovary,ovate,pedicel,petiole,pitted,plant,prickle,pubescent,reddish,reniform,ripening,shallowly,shrub,small,sparsely,stellate,stem,stigma,style,surface,thin,treelet,tube,upper,vein,vestigial,white	-4,-8,.2,.5,/4,0,0.05-0.15,0.3-0.4,0.5,0.9-1.3,1,1-1.5,1.7-3,2,2.5-2.8,2.5-6,3,3-4,4-10,4-9,5-10,6-7,7-10,almost,also,anthesi,armed,articulated,ba,bearing,broad-based,brow,cell,conical,consisting,darker,dense,diamete,difoliate,directed,eaf,eed,female,fleshy,free,geminat,impressed,lamina,le,like,lon,long,lower,male,membranous,midpoint,minute,mixture,new,nflorescence,notably,obscured,occasionally,orbicular,pair,per,pericarp,pistillate,planar,pollen-bearing,pore,poricidal,porrect,portion,primary,pubescence,ray,rounded,ruit,scar,sessile,short-stalked,single,somewhat,sparser,staminate,straight,testal,tip,toward,trichome,ud,unarmed,unisexual,unit,upwardly,usually,way,woody,x,ynpodial	abaxial,adaxial,bud,color,form,height,history,length,life,na,number,orientation,peduncle,position,rachi,reproduction,seed,shape,spacing,staman,texture
628	wfo-0001030551	success	167	121	90	77	31	0.539	-12,0.5-1,1-10,1-2,1-3.5,1-4,1-5,1.5-,1.5-2.5,10-20,10-40,2,2-3,2-6,2.5-5,3-,3-12,4-,4-5,4-7,5-6,abaxially,abruptly,acuminate,acute,adaxially,also,apart,apex,articulated,base,blue,broad,calyx,campanulate,clavate,cm,color,concave,connective,densely,diameter,dilated,distally,ellipsoidal,fading,flower,fruit,glabrous,glandular-puberulent,globose,lanceolate,laterally,lobe,margin,mm,moderately,narrow,narrowed,oblong-fusiform,obtuse,often,ovate,ovate-elliptic,ovoid,papillose,pedicel,pedicellar,peduncle,petiole,pore,puberulent,puberulent-pubescent,pubescent-pilose,rachi,radiu,remnant,shrub,simple,sparsely,stellate,stigma,style,triangular-elliptic,truncate,unbranched,unknown,violet,x,yellowish	-30,-5,0-2,0.6-1.5,1,1-,1-2.5,13.,2.5-4,20-25,3-5,3-8,4-foliat,5-17,9-20,absent,adpressed,aggregate,ape,axe,basal,beyond,bilobe,blade,cell,chartaceous,cordate,dia,directed,eaf,ed,entire,equal,et,exceeding,exserted,fleshy,hair,leaving,lon,long,lower,martinelli,narrowly,nflorescence,nther,orolla,perfect,pilose,puberulen,pubescent-pilo,ripe,round,ruit,seen,shorter,slightly,small,spaced,stamen,stone,subcoriaceous,tal,tem,thecae,time,tip,tomento,triangular,tube,ud,unit,unknow,vary,wide,widening,ympodial	abaxial,adaxial,anther,arrangement,bilobed,bud,colour,corolla,direction,form,growth,height,history,inflorescence,leaf,length,life,na,number,ovary,plant,position,reproduction,seed,shape,spacing,surface,texture,theca,tomentose,width
629	wfo-0001030570	success	173	139	102	71	37	0.59	0.3-0.5,0.5-1,1-1.5,1-2,1-3,1-4,1-5,1-8,10-25,15-35,2-3,2-7,2-7-lobed,2-8,3-10,3-6,3.5-5,4-5,abaxially,acuminate,acute,adaxially,aggregate,apart,apex,apiculate,articulated,base,calyx,campanulate,cell,cm,color,connective,cylindrical,diameter,dilated,distally,eglandular,ellipsoidal,exceeding,flattened,fleshy,flower,forked,fruit,glabrous,glandular-puberulent,globose,green,hair,leaf,leaving,lobe,long,margin,mm,narrowly,near,occasionally,often,ovoid,pedicel,pedicellar,peduncle,petiole,pilose,pinnately,pubescent,punctate,purplish,rachi,radiu,rarely,remnant,rounded,rugose,shorter,simple,slightly,sometimes,sparsely,stellate,stigma,stone,style,subcoriaceous,submarginally,thecae,tip,tree,triangular,truncate,unbranched,unequal,unit,unknown,unlobed,vein,white,x,yellow	-1,.3-0.5,0-,0.5-,1,1-,1.5,1.5-2.5,1/2,10-17,15-20,2-2.5,2-4,2-5,2.5-22,20-30,3-5,4-25,4-7,4-foliat,4/5,5-,8-,absent,ape,axe,basal,beyond,blade,connivent,cordate,directed,divided,eaf,eed,elliptic-oblong,entire,exserted,glabrat,lanceolate,lobed,lon,lower,midrib,nflorescence,nther,obtuse,orolla,ovate,perfect,pilo,pore,presen,purpl,ripe,ruit,sinus,small,somewhat,spaced,stamen,tal,tem,time,tomento,truncat,tube,ud,vary,wide,ympodial	4-foliate,abaxial,adaxial,anther,arrangement,bud,colour,corolla,filament,form,glabrate,growth,height,history,inflorescence,length,life,na,number,ovary,perennial,plant,position,presence,present,purple,reproduction,seed,shape,spacing,staman,stem,surface,sympodial,texture,tomentose,width
630	wfo-0001030580	success	230	114	80	150	34	0.348	.0,.5,.7,2,abaxially,acute,adaxially,anther,apex,arching,area,attachment,base,becoming,black,blade,brochidodromous,brown,bud,central,channeled,chartaceous,cm,corolla,densely,developed,diameter,distinct,elliptic,extra-axillary,ferruginous,filament,flattened-orbicular,flattened-reniform,flower,fruit,glabrous,globose,homostylous,indistinct,internode,interpetalar,lateral,leaf,margin,midvein,mm,moderately,nearly,notched,ovate,pedicel,petiole,pitted,point,porrect,pubescent,raised,rounded,sessile,shrub,simple,slightly,smooth,sparsely,stellae,stellate,stem,stigma,straight,style,surface,tissue,vein,weakly,well,white,yellow,young,±aequilateral	.0–6.2,.2,.3,/2,/3,0.2–0.3,0.3–0.4,0.3–0.7,0.4–0.5,0.4–0.7,0.6–1.1,0.6–2.1,0.7–0.8,0.9–1.2,1.2–1.5,1.3–1.5,1.3–3.0,1.5–,1.5–2.0,1.5–4.0,1.5–9.0,1.6–1.8,1.6–2.5,1.7–1.8,1/3,1–2,2.0–2.2,2.0–3.1,2.3–5.5,3,3.7–5.4,3–5,4–6,4–8,5-merou,5–5.4,6–8,8.3–10.0,adnate,ag,along,alyx,anthesi,apical,apparently,appearing,appresse,around,articulate,attenuate,ba,berry,broad,calyx,capitat,caudate,connivent,curved,deltoid,dentate,difoliate,directed,distal,distally,dramatically,dry,eaf,edge,eed,either,emerging,endocarp,entire,erect,exocarp,extending,fertile,filiform,flat,flexed,free,geminat,glabrescent,glossy,gradually,hair,increasing,inter-sepalar,intersepalar,juic,laying,lobe,lon,long,longer,lower,mainly,many,mature,middle,midpoint,midrib,minute,much,nflorescence,oblong,orolla,per,perforate,persistent,pore,portion,potentially,probably,ray,ruit,scattered,sepal,side,sinus,smoot,sometimes,splitting,spread,stamen,stellate-pubescent,strongly,suture,tamen,tardily,tem,thin,though,time,tip,toward,translucent,truncate,tube,typically,ud,unarmed,unit,vary,wide,ympodial,±90°,×,–2.5,–8	1-2,1.5-9.0,1.6-1.8,3.7-5.4,5-merous,abaxial,adaxial,age,arrangement,capitate,color,colour,form,growth,height,history,inflorescence,length,life,na,number,ovary,peduncle,perennial,plant,position,rachi,reproduction,seed,shape,spacing,staman,texture,width
631	wfo-0001030581	success	187	134	94	93	40	0.503	1,5-merous,9,abaxial,abaxially,acute,adaxial,aggregate,angle,angled,anther,anthesi,apex,base,becoming,berry,black,bright,calyx,capitate,cell,central,cm,conical,corolla,decurrent,densely,diameter,drop,elliptic,entire,exserted,filament,flattened-reniform,flower,fruit,fruiting,globose,green,growth,herb,inflorescence,intermodal,lacking,lateral,leaf,live,lobe,margin,markedly,maturity,minutely,mm,near,occasionally,once-branched,outline,ovary,ovate,pair,pedicel,peduncle,pentagonal,petiole,pitted,plant,portion,pubescent,purplish,rachi,remaining,ridge,ripe,shallow,shiny,simple,somewhat,sparsely,spreading,stellate,stem,stigma,stone,straight,style,surface,tube,turning,usually,vein,white,woody,yellow,yellowish	.3,.5,0.2–0.8,0.4–0.6,0.4–1.6,0.5,0.5–0.7,0.5–2.5,0.6–0.7,0.7–0.8,0.9–1,1-4-celled,1.2–1.5,1.8–8,1–2,1–2-celled,1–2.5,1–4-celled,2,20–50,2–3-celled,35–45,3–4,3–5,4.5–12,4–7,4–9,5–6,5–8,adaxially,along,apar,appressed,articulated,basal,beyond,branched,clustered,cone,denser,difoliate,eaf,eed,ellipsoid,florescence,free,geminat,glabrous,halfway,individual,later,leave,less,like,lobed,lon,long,lower,minute,narrowly,new,often,papillate,per,perfect,primary,reflexe,reflexed,rounded,ruit,scar,shorter,slightly,spaced,sprawlin,strongly,tall,tangled,tem,terete,testal,third,translucent,trichome,ud,uniseriate,unit,upper,wide,winged,ympodial,–15,–5	0.4-0.6,0.4-1.6,0.5-2.5,0.6-0.7,0.9-1,1-2.5,1.2-1.5,1.5,20-50,3-4,3-5,4-7,5,5-6,5-8,apart,arrangement,bud,color,colour,decurrence,exsertion,form,height,history,length,life,lobing,na,number,perennial,position,present,reproduction,seed,shape,spacing,staman,texture,width
632	wfo-0001030582	success	190	107	67	123	40	0.353	.1,.5,1.5,5,abaxially,acute,adaxially,anther,apart,apex,attenuate,blue,brown,cm,densely,diameter,evenly,filament,finely,flattened-reniform,flower,fruit,glabrous,globose,initially,internode,lateral,leaf,light,lighter-colored,lobe,long,margin,midpoint,minutely,mm,moderately,narrowly,nearly,orange,ovate-lanceolate,overtopped,pedicel,peduncle,petiole,pitted,red,ripe,short,shrub,simple,slender,soon,sparsely,stellate-pentagonal,stellate-tomentose,stem,stigma,style,surface,terminal,tomentose,triangular,truncate,tube,yellow,×	0,0.1,0.2,0.4,0.4–0.5,0.4–1,0.6,0.8–1,1.4–2,1.5–3,10,10–12,12,1–1.5,2.5–3,2–10-branched,2–2.5,2–4.5,3.5–9.5,3–3.2,3–3.5,3–5,4–4.5,4–9-rayed,5-merou,5–8,6–8-rayed,7–11,7–20,adaxiall,age,alyx,apparently,articulated,axe,ba,base,becoming,blade,branch,branched,broad,c.,capitat,caudate,closely,cordate,dark,dichotomously,directed,distall,eaf,eed,ellipsoid,entire,except,extra-axillary,filiform,free,geminat,glabrescent,gland-tipped,hair,homostylous,interpetalar,larger,later,lea,less,like,linear-attenuate,lon,lower,maturit,midzone,minute,nflorescence,numerous,obscurely,often,orolla,ovoid,part,per,perfect,plurifoliate,pore,principal,probably,rounded,ruit,sessile,shiny,short-stipitate,side,sinuate,sinus,somewhat,spaced,splitting,stellae,stellate-tomento,stipe,tall,taller,tamen,tardily,tem,thick-chartaceous,tip,tissue,ud,ultimate,unarme,unarmed,underside,vary,vein,visible,well-developed,wide,ympodia,young	0.4-1,1-1.5,1.4-2,1.5-3,10-12,2-2.5,2-4.5,3-3.5,3-5,7-11,abaxial,adaxial,arrangement,calyx,capitate,color,colour,corolla,form,growth,height,history,inflorescence,length,life,maturity,na,number,ovary,perennial,plant,position,rachi,reproduction,seed,shape,spacing,staman,texture,width
633	wfo-0001030583	success	166	129	103	63	26	0.62	.5,0.1-0.5,0.2-1,0.3-1,0.5-1,0.8-1,1-1.5,1-2,1-8,1/2,2.5,3-4,3/4,5-6,abaxial,acute,anther,apex,bark,base,berry,calyx,closely,cm,conical,corolla,crisped,cultivar,cultivated,dark,deep,deflexed,dendritic,densely,dia,ellipsoid,elliptic,erect,especially,filament,flattened-reniform,flower,form,fruit,fruiting,glabrous,globose,golden,green,immature,incrassate,irregular,leaf,like,live,lobed,long,long-rectangular,long-triangular,margin,minutely,mm,narrowly,occasionally,often,opposite,orange-red,outline,ovary,overlapping,pale,papery,papillose,pedicel,pericarp,petiole,pitted,plant,prostrate,pubescent,rest,ripe,rounded,shrub,simple,small-capitate,spaced,spathulate,stem,stigma,stout,style,surface,tan,thin,tip,trichome,tube,way,white,woody,x,yellow	.2,0.4-2.7,0.7-4.5,0.9-3.5,1,1.5-4,2.5-3,2.5-9,4-6,5-7,6-7,abaxially,adaxially,along,anthesi,ba,brow,cell,corky,differing,difoliate,dry,eaf,edicel,eed,enlarged,free,frui,geminat,included,lateral,leave,lobe,lon,lower,main,major,midvein,minor,nflorescence,older,pair,papillo,planar,pore,poricidal,portion,ruit,scar,shaped,size,small,soon,specimen,tall,tear-drop,testal,ud,uniseriate,unit,vein,ympodial,young	0.1-1,adaxial,arrangement,brown,bud,center,color,diameter,growth,height,history,inflorescence,length,life,na,number,peduncle,perennial,position,rachi,reproduction,seed,shape,spacing,texture,width
634	wfo-0001030605	success	144	131	101	43	30	0.701	.4,.5,0.1,0.3-0.5,1-4,1.5-2,1.7,1/3-1/2,2,2-3,2.5,7,acute,adaxially,almost,anther,apart,apex,apical,area,base,beginning,branch,branched,brown,cinereous,cm,commonly,coriaceous,corolla,covered,cylindrical,dark,deflexed,dendritic-echinoid,densely,dia,difoliate,ellipsoid,filament,fruiting,glabrate,glabrous,globose,gold,green,growth,inflorescence,internodal,leaf,less,light,lobed,long,minutely,mm,nearly,new,obovate,obtuse,occasionally,olive,opposite,ovary,ovate,overlapping,ovoid-reniform,pedicel,peduncle,petiole,pitted,pore,poricidal,pubescent,rarely,rounded,scar,scattered,shaped,shiny,shrub,simple,slender,slightly,smooth,somewhat,sparesly,sparsely,stigma,style,surface,tear-drop,thickened,tinged,tip,trichome,unifoliate,way,white,woody,x	1,1.5-5.5,12-19-flowered,5-12.5,abaxially,along,anthesi,ape,attenuate,beneath,berry,calyx,conical,dry,drying,eaf,edicel,eed,entire,exerted,free,geminat,inflorescenc,lobe,lower,margin,material,midrib,nflorescence,otherwise,papillate,papillosefruit,portion,reflexed,revolute,soon,tub,tube,ud,unit,vein,yellow,ympodial	12-19,abaxial,adaxial,arrangement,bud,color,colour,diameter,flower,form,fruit,geminate,height,history,length,life,na,number,papillose,perennial,plant,position,rachi,reproduction,seed,shape,spacing,staman,texture,width
635	wfo-0001030611	success	217	139	113	104	26	0.521	0,0-0.5,0.1-0.3,0.5,0.5-1.5,1,1.5-10,1.5-2,1.5-3,1mm,2-3.5,2-7,3,3-4,3.5-5.5,5-10,6-9,abaxially,acicular,acute,adaxially,along,anther,apart,apex,articulated,base,branched,broadly,cauline,cm,coarsely,commonly,deltoid,dentate,depressed-deltoid,development,diameter,divergently,elliptic,elongate,elongated,entire,erect,felty-pubescent,filament,flower,fruit,glabrous,globose,hair,inflorescence,interlobal,larger,lateral,leaf-opposed,length,lenticular,less,lobe,long,margin,midpoint,midrib,minutely,mm,obtuse,one,orange,outline,ovate,pedicel,peduncle,perennial,petiole,pitted,present,prickle,principal,pubescent,rachi,ray,resembling,ripe,round-tipped,sessile,short,simple,sinus,slightly,spaced,spreading,spreading-hirsute,stellae,stellate,stigma,style,suffrutescent,surface,tan,termination,thin-textured,truncate,unbranched,usually,vein,white,whitish,wide,widely,x,yellow,yellow-orange	-1.3,-35,0.5-2.5,0.7-1.5,1-2,1-3,1/4-1/3,12-10,12-15,15,2,2-4,2-6,2-foliate,2.2-2.5,3-5,4-5,4-6,4-8,5-15,5-8,7-25,9-30,abaxiall,adaxiall,appearing,attenuate,axe,ba,basally,blade,blunt-tipped,calyx,campanulate,capitat,composed,connate,connivent,crowded,cylindrical,densely,directed,distal,distally,eaf,eed,equaling,exceeding,female-sterile,finally,flesh,free,geminat,glabrou,glandula,hermaphroditic,inserted,interlaced,intermixed,lacking,light,lon,long-stalked,longer,longest,lower,main,midvein,much,nflorescence,numerous,oblong-tapering,often,orolla,ovate-lanceolate,part,per,pore,predominantly,prominent,radiu,reduced,ruit,section,short-stalked,short-styled,side,small,sometimes,somewhat,stalk,ste,stellate-pubescent,stellate-woolly,stipitate,tal,tamen,tem,time,tube,unarmed,unit,vary,ympodial	abaxial,adaxial,arrangement,capitate,color,colour,corolla,form,growth,height,history,leaf,life,na,number,ovary,plant,position,reproduction,seed,shape,spacing,staman,stem,texture,width
636	wfo-0001030624	success	170	93	59	111	34	0.347	0.5-1.5,0.9-1,1-3,1.2-1.8,1.5-2,2-10,3-3.5,acute,anther,anthesi,apart,apex,attenuate,bark,base,clavate,cm,corolla,elliptic,filament,flattened-reniform,fruiting,furcate,glabrous,glandular,globose,green,greyish,incrassate,leaf,lobed,longitudinally,margin,minutely,mm,narrowly,nearly,occasionally,opposite,ovary,pedicel,petiole,pitted,planar,puberulent,shining,shrub,simple,slender,small,stigma,style,surface,tip,tree,white,woody,yellowish,yellowish-green	.25,.5,0.5,0.5-1,1.2-2,2,2-3,2.5-5.5,25-40-flowered,3,3.5-4,4.5-8,6-13,7-9,apiculate,appearing,axil,ba,beginning,berry,branch,caly,calyx,cell,decurrent,deflexed,dia,differing,difoliate,dimorphic,distal,dry,eaf,edicel,eed,ellipsoid,end,erect,except,expanded,exserted,extreme,falcate,free,geminat,glabrate,hyaline,inflorescenc,large,later,lateral,like,lobe,lon,long,lower,main,major,material,middle,midrib,minor,near,nflorescence,older,one,outer,pair,pale,papillose,pore,poricidal,portion,prominent,raised,remaining,round,rugo,ruit,scar,short,size,slightly,somewhat,soon,spaced,square,stem,straight,tall,tapering,thickened,three,ti,trichome,trunk,tube,tuft,two,ud,unevenly,uniseriate,unit,vein,wall,widest,x,yellow,yellowish-grey,ympodial,young	1.5,25-40,7,abaxial,adaxial,arrangement,color,colour,diameter,feature,flower,form,fruit,growth,height,history,inflorescence,length,life,na,number,pattern,peduncle,plant,position,rachi,reproduction,rugose,seed,shape,spacing,staman,texture,width
637	wfo-0001030628	success	229	138	101	128	37	0.441	.1,.2,.5,5-merous,abaxial,acuminate,acute,adaxial,adaxially,andromonoecious,anther,apart,apex,bark,base,branched,broad-based,broadly,brown,capitate,chartaceous,cm,cordate,curved,cylindrical,dark,densely,diameter,discolorous,either,ellipsoidal,elliptical,entire,extra-axillary,filament,fissure,flattened,flower,fruit,glabrous,glandular,green,hair,heterstylous,inclusion,inflorescence,juicy,lanceolate,leaf,length,light,like,lobe,lobed,margin,maturity,midpoint,midvein,mm,moderately,oblique,ovary,ovate,pedicel,peduncle,pericarp,petiole,plant,porrect-stellate,pubescent,purple,rachi,reddish,reniform,rotate-stellate,rounded,rugose,sclerified,shallow,shallowly,side,simple,slightly,stalked,stellate,stem,stigma,stout,strongly,style,surface,thick,thin,tree,turbinate,violet,whitish-,whitish-golden,yellow,yellowish-green,young	.5–1.7,0.1–0.3,0.5–3,0.7–0.9,1,10+,10–20,10–40,10–55,11–16,12–20,16–18,1–1.5,1–10,1–2,2.5–8,20–35,2–10,2–3,3.5–4,3.5–5,4,4–4.4,4–6,4–6.5,4–8,5–,5–6,5–8.5,6–10,6–8,7–25,7–40,8–1,8–25,abaxially,age,along,alyx,andromoneciou,anthesi,articulated,axe,ba,becoming,berry,bilobe,blade,calyx,central,congested,connivent,db,difoliate,directed,distally,dried,eaf,eed,eglandular,flowering,free,fresh,frui,fruiting,functionally,geminat,half,hermaphroditic,inflated,interpetalar,knobby,long,longitudinal,lower,major,maturit,membranaceous,moderate,multangulate,multangulate-stellate,multiseriate,near,nearly,nflorescence,often,one,opening,orolla,part,point,pore,portion,prickle,ratio,ray,reddish-tan,remaining,ruit,runk,sessile,sharp,similar,slit,spaced,sparsely,stalk,staminate,stellate-pubescent,straight,subtending,tamen,tapered,tissue,tube,unarmed,unequal,unit,vary,vein,width,woody,ympodial,×,–30,–5,–50,–9	0.1-0.3,0.7-0.9,1-2,10-20,10-55,11-16,16-18,2-10,2.5-8,30,5,5-6,5-8.5,6-8,8-25,9,arrangement,bilobed,color,colour,corolla,form,growth,height,history,life,na,perennial,position,reproduction,seed,shape,spacing,staman,texture,trunk,x
638	wfo-0001030638	success	177	107	87	90	20	0.492	0.1,0.5-0.7,0.5-1.5,0.7-1.5,1-1.2,1.5-2,1.6-2.2,2-7-flowered,2.5-4,3-10,4-6,8,8-9,anther,apically,bark,beneath,branched,broadly,bud,closely,cm,corky,corolla,cup-shaped,deflexed,densely,elliptic,exfoliating,extending,flattened,fleshy,fruit,geminate,glabrate,glabrous,glandular,globose,green,inflorescence,lamina,large,later,leaf,less,lobed,minor,mm,obovate,occasionally,older,ovary,overlapping,pale,paler,papillose,pedicel,persistent,petiole,poricidal,red,red-glandular,roundish,rugose,scar,seed,shape,shrub,simple,size,soon,spaced,stem,stigma,style,surface,tapering,terminal,thickening,tip,transversely,tree,trichome,usually,white,x,young	0.5,0.5-1,0.5-2,1-1.5,1-2,1.4-1.7,2-3,2-5,3-13,8-11,acute,along,anthesi,apex,appear,appearing,axi,axil,ba,base,beginning,berry,blade,calyx,conspicuously,cucullate,deltoid,dia,differing,difoliate,dry,eaf,eed,entire,erect,filament,free,fruiting,geminat,gre,impressed,irregular,known,lateral,like,lobe,lon,long,lower,main,major,margin,material,middle,minutely,near,nearly,nflorescence,often,one,open,opposite,ovoi,pair,papillae,papillo,planar,pore,portion,present,prominent,rather,reddish,rest,ruit,shaped,speciman,straight,tall,tear-drop,thick,thickened,tube,uniseriate,unit,vein,wall,widest,woody,ympodial	abaxial,arrangement,branching,color,diameter,extension,flower,form,grey,growth,height,history,length,life,na,number,persistence,plant,spacing,texture
639	wfo-0001030661	success	183	130	102	81	28	0.557	-24,0,0.5-0.6,0.5-0.75,0.5-2,1-1.2,1-1.4,1-1.5,1.5-2,1.5-7,12-16,2-2.5,3-3.5,4-15,5-5.5,50-100+,acute,anther,anthesi,apex,attenuate,base,berry,branch,branched,brown,capitate,clustered,cm,corolla,densely,diameter,drying,elliptic,entire,erect,filament,flattened,flower,fruiting,glabrous,globose,growth,inflorescence,lateral,leaf,lobed,many,margin,mature,membranous,minutely,mm,narrowly,nodding,occasionally,pair,pale,pedicel,peduncle,per,petiole,pitted,platform,primary,pubescent,red,reddish,reniform,scar,shiny,shrub,simple,slender,slightly,small,sparsely,stellate,stem,stigma,strongly,style,surface,terminal,thin,time,tinged,tip,tree,trichome,uniseriate,usually,vein,violet,way,white,woody,x,yellow,yellowish,½,¾	.2,.5,0.7-0.8,1-,1-.,1-1.3,1.2-7,2-,3-20,3-4,4-6,5-10,5-merou,ag,along,alyx,ark,articulated,brow,calyx,cell,conical,connivent,dar,deltate,denser,eaf,eed,ellipsoid,em,erec,exserted,extending,free,glabrescent,glabrou,group,ilament,insertion,lamina,lengthening,lobe,lon,long,loosely,lower,midrib,minute,near,never,new,nflorescence,older,onto,orolla,otherwise,papillo,perfect,pericarp,planar,plurifoliat,point,pore,poricidal,portion,rectangular,ruit,scattered,sleeve,slit,spreading,tangled,testal,tube,twinin,ud,unit,upper,vary,winged,ympodial	1-5,5-merous,abaxial,adaxial,arrangement,bark,branching,color,colour,form,fruit,height,history,length,life,na,number,ovary,plant,position,rachi,reproduction,seed,shape,size,spacing,staman,texture
640	wfo-0001030665	success	191	106	81	110	25	0.424	0.2-0.4,0.2-0.6,0.4-0.6,0.5-11,0.5-2,0.7-1,1.5-2,1.5-2.5,10-200,2-16,2-3,2-5,2.5-3.5,3-3.8,3-5,5-8,6-8,absent,acute,adaxially,anther,apex,brown,campanulate,chartaceous,cm,cordate,decimetre,deeply,depressed-globose,diameter,elliptical,extra-axillary,filament,flower,flushed,fruit,glabrous,globose,green,greenish,grey,grey-green,herbaceous,inflorescence,leaf-opposed,length,light,lilac,lobe,lobed,longer,margin,minutely,mm,obtuse,ovate,pale,pedicel,peduncle,per,petiole,prickle,prostrate,puberulent,purple,rachi,resprouter,reticulate,rotate,simple,sparsely,sprawling,stage,stigma,style,surface,time,unbranched,wide,yellow	%,-5,-7,0.5-1,0.8-1.1,1-17,1-2,1-4,1.1-2.8,1.4-1.7,1.5-3,1.6-4.5,2-6,2-8,2.3-10,2.5-9,20-30,3-10,4-5,5-merou,abaxially,absen,abundant,accrescent,acicular,adaxiall,adult,alyx,appearance,appessed,armed,articulated,axe,ba,base,blade,branche,broad,broad-based,calyx,capitat,cut,cylindrical,deflexed,deltate,depression,directed,distall,dr.,eaf,eed,ellipoidal,finally,finger,folded,fruiting,geminat,give,gland-tipped,hair,half,homostylous,index,interpetalar,inward,lamina,lateral,less,lobing,lon,long,lower,mature,mesocarp,midvein,minute,nflorescence,oblique,orolla,papery,part,perfect,pore,present,rather,reflexed,rounded,ruit,scarcely,short,side,sinus,stellate-campanulate,straight,tal,tamen,tem,thick,thin,throughout,tissue,tube,unifoliate,unit,uvenile,vary,vein,x,ympodial,¾	abaxial,adaxial,arrangement,capitate,colour,corolla,form,growth,height,history,juvenile,leaf,life,na,number,ovary,plant,position,seed,shape,staman,stem,texture,thicknes,width
641	wfo-0001030676	success	220	107	80	140	27	0.364	1-1.2,1-3,1.1-1.4,11-14,14-17,2.2-5.7,3-5,3-6,4-6,7-10,7-8,8-10,abaxially,adaxially,anther,apart,apex,appressed-tomentose,articulated,base,becoming,blunt-tipped,branched,brown,chartaceous,cm,conical,corolla,deltoid,diameter,dichotomously,elongate,filament,finely,flower,fruit,glabrescent,globose,granular-tomentose,green,growth,honeycombed,lateral,leaf,length,lined,longitudinally,minutely,mm,oblong,oblong-elliptic,openly,pedicel,peduncle,petiole,probably,pseudo-terminal,pulverulent,rachi,reniform,reticulate-punctate,ridged,ripe,scabrous,short-attenuate,shrub,simple,small,somewhat,stellate,stigma,style,subglobose,suborbicular,tree,velutinous,white,whitish,yellow,yellowish	-1.6,-2.5,-3.9,-8.5,/10-1/5,0-100,0.4,0.6-1.2,1,1.1-1.9,1.2-1.3,1.3-1.5,1.7-2,1/4,16,19-35,2.1-2.3,2.1-2.6,2.4-3.1,2.5-5.5,2.75-3.25,3-3.5,4-6.5,7-9,8-12,abruptly,acute,along,angled,anthesi,apical-lateral,apparently,appearing,axillary,ba,bark,berry,blade,branch,bud,calyx,closely,continued,crown,cylindrical,dehiscing,densely,due,eaf,echinoi,echinoid,eed,entire,except,exserted,flat-topped,fleshy,forming,free,glabrescen,glabrous,greenish,grooved,hair,high,horizontal,initially,inserted,introrse,lackin,lamina,large,lengthen,lobe,lobed,long,longitudinal,lower,main,margin,midvei,midvein,minute,moderately,mostly,multangulate,nearly,nflorescence,oblique,obtuse,occasional,often,older,opening,orolla,ovate,ovate-lanceolate,parallel,perfect,plurifoliate,pore,pubescent,rather,ray,ruit,runk,scattered,sessile,short-stalked,side,slit,spaced,sparsely,spreading,stellate-pubescent,stem,strongly,subcampanulate,subcapitat,tamen,tending,terete,testa,thick,thin,time,tip,tomentose,tube,tuft,unarme,unit,usually,vary,vein,way,wide,x,ympodial,young	3-3.9,50-100,abaxial,adaxial,arrangement,color,colour,form,height,history,inflorescence,life,na,number,ovary,perennial,plant,position,reproduction,seed,shape,spacing,staman,subcapitate,surface,texture,thicknes
642	wfo-0001030686	invalid_json_followup	182	120	90	92	30	0.495	.5,.5-1,0.5-1,1-1.1,1-1.2,1-2,1.5-4.5,1.6-3,2-2.5,2.5-4,2.5-8,5-25,5-30,abruptly,acuminate,acute,age,anther,apart,apex,bark,base,bifid,black,branched,brittle,brown,cm,conical,corolla,cup-shaped,dark,deeply,densely,denser,diameter,elliptic,entire,erect,filament,flattened,flower,form,fruit,fruiting,glabrous,globose,height,internodal,lamina,leaf,leaf-opposed,lengthening,lepidote,lilac,lobed,margin,midrib,minutely,mm,orange,ovary,pale,paler,papillose,pedicel,peduncle,petiole,pitted,plant,pore,pubescent,purple,rachi,scar,seed,shallowly,shiny,simple,slit,sparsely,stem,stigma,style,surface,thin,tree,trichome,tube,yellow	.2,1-1.5,1.2-1.5,1.5-2,15,1972,2-3,2-6.5,3-3.5,5-12,5-6,8-9,?,abaxially,aborted,adam,adaxially,anthesi,basal,beneath,berry,breast,bu,c.,calyx,centre,closely,darker,different,difoliate,discolorous,dry,drying,eaf,edicel,eed,empty,exerted,fide,fragrant,free,geminat,glabrescen,golden,half,heteromorphic,less,lobe,long,lower,many,maturity,midvein,nflorescence,noddin,oblique,older,overlapping,pair,papillae,pericarp,planar,poricidal,portion,primary,pubescen,ruit,scarious,shallow,short,slightly,somewhat,space,spaced,spreading,stellate,strongly,styl,time,tip,tissue,ud,uniformly,unit,usually,vein,visible,way,woody,x,ympodial,–	'',2-2,[,``,abaxial,adaxial,arrangement,bud,characteristic,color,colour,glabrescent,growth,history,inflorescence,length,life,na,number,perennial,position,reproduction,shape,spacing,staman,texture,value,width,{,}
643	wfo-0001030696	success	202	92	69	133	23	0.342	0-3,0.1-0.3,0.8-1.8,1-3,1-9,10-50,12-18,2-4,2.3-4,3-4,3-6,4-4.5,7-10,absent,acicular,acute,adaxially,andromonoecious,anther,apex,base,chartaceous,cm,cuneate,decimetre,deeply,densely,diameter,eglandular,elliptical,extra-axillary,filament,flower,fruit,glabrous,globose,green,herbaceous,index,inflorescence,length,lobe,lobed,lobing,margin,mm,moderately,nearly,obtuse,ovate,pale,pedicel,peduncle,per,petiole,plant,prickle,prostrate,rachi,resprouter,sessile,sparsely,sprawling,stellate,stellate-pubescent,style,usuallu,white,yellow	%,.5,0-0.1,0.05-0.2,0.1-0.4,0.2-1,0.3-1.1,0.4-0.6,0.5-3,0.7-1,0.7-1.1,0.8-1.2,0.8-1.3,0.8-1.5,0.8-1.7,0.9-1.5,1,1-1.5,1-2.5,1-4,1.5-2,1.5-3,1.6-2.2,10-16,2-3-foliate,2-5.5,2-8,2-locular,2.5-6,20-35,3.8-4,4-17,4-7,4-8,5-merou,8-18,abaxially,absen,accrescent,across,adaxiall,adult,alyx,apart,armed,articulated,ascending,axe,ba,blade,branche,brown,calyx,contiguous,cross-section,cylindrical,deltate,directed,distall,distally,distributed,eaf,eed,exocarp,finger,frui,fruiting,functional,geminate,gland-tipped,hair,half,heterostylous,juicy,lamina,lanceolate,lateral,less,long,longer,lower,markedly,mature,mesocarp,mid-point,midpoint,midvein,minute,moist,nflorescence,oblique,onl,orolla,part,placenta,pore,porrect,present,probably,pseudo-umbellate,ray,ruit,semi-circula,short,side,simple,solitary,spaced,sparse,stage,stalk,stellae,straight,strongly,tal,tamen,tem,thick,thicker,thicknes,throughout,time,tube,unbranched,unit,uvenile,vary,vein,wide,winged,x,yellowish,ympodial	abaxial,adaxial,color,corolla,density,form,growth,height,history,leaf,life,number,ovary,position,reproduction,seed,shape,staman,stem,stigma,surface,texture,variable
644	wfo-0001030699	invalid_json_followup	195	124	92	103	32	0.472	0,0.5-0.7,1-1.5,1-2,12-15,2-4,2-5,2.5-3,3-10,3-5,3-6,4-5,4-7,8-10,acute,anther,apart,apex,apical,bark,base,berry,blue,brown,calyx,clavate,cm,compressed,corolla,corymbose,curved,cyme,diameter,entire,erect,filament,flower,fruiting,glandular-lanate,globose,golden,green,greenish,grey,growth,inflorescence,lanate,length,lobed,long-styled,margin,middle,midpoint,mm,multicellular,nearly,new,ovary,ovate,ovate-elliptic,ovate-lanceolate,ovoid,pedicel,peduncle,petiole,plant,porrect,prickle,purple,red,rusty,scar,sessile,short-styled,shrub,simple,spaced,stalked,stellate,stem,stigma,style,subscabrous,subscandent,surface,trichome,unevenly,velutinous,winged,x,yellow,¼	-13,-8.5,0.2-0.3,1.4-1,1.5-2,1/10,1/6,11-12,2-2.5,2-3,4-6,4-6-celled,5,5-6,6-,9-11,abaxially,adaxially,anthesi,antrorse,apically,armed,articulated,basal,branched,brow,cell,cordate,decurrent,densely,discolorous,distal,eaf,eed,elongate,exserted,foliaceous,free,glabrous,glandular,half,heterostylous,hirsute,immersed,induman,juvenile,known,lengthening,like,linear-lanceolate,lobe,lobed-angulate,long,lower,many,minute,mixed,multangulate,nflorescence,older,onto,papillat,partially,perfect,pericarp,plurifoliat,pore,poricidal,portion,prickly,pubescence,pubescent,rarely,ray,reduced,reflexed,rotate,ruit,single,slightly,slit,sparsely,staminate,stellate-puberulent,straight,subcoriaceous,subrounded,subsessile,tall,tapering,time,tip,tomentose-lanate,tube,ud,unit,upper,vein,villous,without,wood,yellowish,ympodial	'',[,``,abaxial,adaxial,arrangement,bud,center,characteristic,color,colour,form,fruit,height,history,leaf,life,na,number,papillate,position,rachi,reproduction,seed,shape,spacing,staman,texture,value,width,{,}
645	wfo-0001030709	success	217	136	111	106	25	0.512	0.1-0.2,0.2-0.5,0.3-1.5,0.4,0.7-1,1-1.6,1-4.5,1-6,1.3-1.4,1/3-1/2,1/4,2-6,2.3-3,4-5-merous,5-10,5-20,5-6,6-7,7-9,8-15,abaxially,acuminate,acute,adaxially,almost,ame,anther,apart,apex,articulated,bark,base,berry,branched,bright,c.,chartaceous,cm,conical,cordate,diameter,dull,edge,elliptic,erect,filament,finely,flattened-reniform,flower,fruit,glabrescent,increasing,inflorescence,lateral,leaf,length,lobed,long,margin,maturity,mauve,midpoint,mm,moderately,orange-brown,pair,pedicel,peduncle,perpendicular,petiole,pit,pitted,porrect,prickle,prickly,primary,purple,ray,red-green,red-orange,seed,shrub,simple,size,slender,smooth,sparsely,spherical,stalked,stellate,stellate-pubescent,stem,straight,style,surface,terete,terminal,tertiary,toward,trichome,truncate,upper,usually,variously,vein,venation,visible,way,wide,yellow,yellow-green	-2,-5,-9,0,0-,0-20,0-30,0.15-0.5,0.8-4,0.9-1.5,1-1.2,1.4-2,1.6-2.1,1.9-2.8,1/2-2/3,1/4-1/3,10-14,10-50,2-4,2-5,2-8,2/3-3/4,3-,5-7,5-9,6-10,6-21,6-8,7-8,8-11,alyx,apar,ape,apically,apparently,blade,broad-deltate,brow,calyx,connivent,cuspidate,deltate,discolorous,distance,drying,eaf,eed,elongating,equal,extending,free,fruiting,glabrous,infructescence,lanceolate,lengt,lobe,lobing,lon,long-acuminat,longer,lower,mature,middle,midvein,narrow-deltate,nflorescence,occasionally,often,older,one,open,orolla,oung,pendulous,per,perfect,pericarp,plurifoliat,poricidal,portion,prickl,reflexed,retrorse,rounded,ruit,scar,secondary,short-styled,shorter,side,sometimes,spaced,spreading,stalk,tamen,tapering,time,tip,tube,unarmed,unit,vary,weakly,woody,ympodial	abaxial,adaxial,arrangement,brown,color,colour,corolla,form,growth,height,history,life,na,number,ovary,perennial,plant,position,reproduction,shape,spacing,staman,texture,visibility,width
646	wfo-0001030714	success	178	135	120	58	15	0.674	-3,.2,/3,0.1-0.3,0.5,0.5-0.8,0.5-1.9,0.7-0.8,1-1.2,1-1.3,1-2.5,1.2-1.5,1.2-4,1/3,2-2.5,2-2.6,20,3-3.5,7-17,>,abaxial,adaxially,aid,along,anther,anthesi,apex,bark,basal,base,becoming,beneath,berry,blue,blue-black,branching,calyx,clavate,cm,conical,corolla,cup,dark,densely,diameter,ellipsoid,elliptic,entire,especially,except,exserted,flattened,flower,fruit,glabrous,globose,grading,gradually,greyish,growth,herbaceous,leaving,liana,lobe,lobed,long,many,margin,midrib,minute,minutely,mm,narrow,narrowly,new,nodding,ob-ellipsoid,ob-elliptic,ovary,overall,pale,paler,papillate,pedicel,peduncle,peg,per,petiole,pitted,pubescent,quadrate,reniform,ripe,scar,shape,simple,spaced,sparsely,stellate,stem,stigma,strongly,style,surface,tapering,thickened,time,tip,trichome,tube,twining,uniseriate,vein,vine,violet,way,widely,woody,x,yellow	.5,0.3-0.4,0.8-1,1-1.5,1.4-3.5,1.5-2,3-7,5-100,5-6,abaxially,acuminate,acute,age,apar,articulating,campanulate,climbin,cordate,denser,eaf,eed,fide,filament,free,gree,howard,joined,leaf-opposed,lengthening,like,lower,membranous,nflorescence,node,oblique,occasionally,older,pair,papillat,pedice,perfect,planar,plurifoliat,pore,poricidal,portion,primary,prominent,ruit,slightly,slit,submarginal,terminal,truncate,tub,ud,unit,ympodial	apart,articulation,bud,climbing,color,exsertion,form,green,inflorescence,leaf,length,number,seed,spacing,texture
647	wfo-0001030730	success	205	98	73	132	25	0.356	0.1-0.3,0.8-4.4,1-8,11-20,2-2.5,2-2.9,2-8,2.3-6,240-700,3-15,4-11,5.5-6.5,9-10.5,anther,cm,densely,depressed,diameter,filament,finally,flower,fruit,glabrous,globose,green,grey,herbaceous,inflorescence,lanceolate,later,length,light,lobed,longer,marbled,margin,minutely,mm,ovate,pale,pedicel,peduncle,per,perennial,petiole,pink,prickle,pseudo-racemose,purple,rachi,resprouter,rhizomatous,ridged,rugose,rusty,shallowly,shrub,simple,smooth,stellate,stellate-pubescent,stigma,style,surface,time,toward,white,wide,x,yellow,yellow-brown,yellowish,yellowish-green	%,0-0.8,0-1,0-1.2,0-1.6,0-6,0.05-0.1,0.05-0.2,0.5-0.9,0.5-1,0.6-1.2,0.7-1.2,0.8-1.2,1-1.2,1-1.7,1-10,1-3,1.1-1.9,1.5-4.5,1.7-2.3,10,11-17,15-60,2-4,2-5,2-foliate,2.5-7,3-20,4-7,4-locular,5-40,5-merou,5.5-14.5,7-8,9-15,abaxially,absent,accrescent,acicular,across,acute,adaxiall,adaxially,alyx,apart,apex,armed,articulated,ascending,attenuate,axe,ba,base,blade,bony,calyx,chartaceous,connivent,cuneate,curved,cylindrical,d.,deltate,directed,distall,distributed,drooping,eaf,eed,eglandular,entire,extra-axillary,finger,first,fruiting,geminate,glabrou,gland-tipped,hair,half,hard,lamina,lateral,less,lobe,lon,long,loosely,lower,mature,mid-point,midpoint,midvein,minute,nflorescence,oblique,obtuse,orolla,part,perfect,pore,porrect,presen,present,probably,ray,ruit,short,slightly,spaced,sprawling,spreading,stage,stalk,stellae,straight,subcordate,tal,tamen,tem,thick,throughout,truncat,tube,unarmed,unbranched,unit,unknow,uvenile,vary,vein,ympodial	5-merous,abaxial,arrangement,color,corolla,density,dm,form,growth,height,history,leaf,life,ovary,plant,reproduction,ridging,seed,shape,staman,stem,texture,truncate,unknown,width
648	wfo-0001030733	success	130	101	62	68	39	0.477	/4,0.5-1,1-1.2,1-1.5,1-2,3-5,4.5-5,6-7,abaxially,acuminate,acute,adaxially,anther,apex,base,bi-lobed,brown,calyx,capitate,closely,cm,corolla,dark,densely,ellipsoid,elliptic,erect,filament,fruiting,glabrous,globose,green,later,leaf,lobed,long,minutely,mm,moderately,narrowly,opposite,ovary,ovoid-reniform,pedicel,petiole,pubescent,scar,shaped,shrub,simple,smooth,spaced,stem,stigma,style,surface,tear-drop,treelet,trichome,uniseriate,way,white	.5,1.5-5,1.7-2.7,2-2.5,3-4,4-15,5-8-flowered,6-9,?,along,anthesi,ape,bark,berry,broadly,clearly,conical,coriaceous,decurrent,deltate,denser,dia,eaf,eed,elongate,embryo,exserted,free,grayish-brow,lamina,lateral,like,lobe,lon,lower,main,margin,middle,nflorescence,older,onto,overlappin,pair,papillo,planar,pore,poricidal,portion,rounded,ruit,somewhat,sparsely,strongly,tall,testa,thick,tip,tube,ud,unifoliat,unit,vein,visible,widest,woody,x,ympodial,young	0.5,5-8,abaxial,adaxial,arrangement,bud,cell,center,color,colour,diameter,flower,form,fruit,grayish-brown,growth,height,history,inflorescence,length,life,na,new,number,overlapping,papillose,peduncle,perennial,plant,position,rachi,reproduction,seed,shape,spacing,staman,texture,unifoliate,width
649	wfo-0001030751	success	226	133	107	119	26	0.473	-5,-7,.5,0,0-0.5,0-1,0.5-1.5,0.5-1mm,1,1-24,1-3,2,2-3,2-3.5,3-5,5-15,5-6,7-15,abaxially,acute,acute-,adaxially,anther,apart,apex,articulated,base,branched,broadly,closely,cm,coarsely,cordate,deltoid,densely,dentate,depressed-deltoid,diameter,divergently,elliptic,entire,erect,essentially,felty-pubescent,filament,flower,form,fruit,glabrous,globose,hair,inflorescence,interlobal,lateral,leaf-opposed,length,lenticular,light,lobe,major,margin,minutely,mixture,mm,obtuse-tipped,occasionally,orange,ovate,pedicel,peduncle,perennial,petiole,pitted,prickle,pubescent,rachi,ripe,sessile,shallowly,side,simple,sinus,small,smaller,somewhat,spaced,sparsely,spreading-hirsute,stellate,stellate-woolly,stem,stigma,stipitate,style,surface,tan,thin-textured,tooth-like,trichome,truncate,unbranched,usually,vein,white,x,yellow,young	.2,0.1-0.3,0.1-0.4,0.6-1.5,1-2,1-4,1/4-1/2,10-15,11-40,13-50,14-20,2-foliate,2.5-4,20-25,3-6.5,3.5-4.5,4-6,5-7,5-8,6-9,7-13,8-13,accrescent,adaxiall,along,also,among,attenuate,axe,ba,basally,blade,broad,calyx,campanulate,capitat,cast,cauline,clas,commonly,completely,connivent,covering,cylindrical,deciduou,directed,distal,distall,distinct,divergent,dominant,eaf,eed,elongate,equaling,especially,female-sterile,finally,flesh,foliar,frui,fruiting,geminat,green,inserted,interwoven,lanceolate,larger,less,lignescent,like,long,longest,lower,midpoint,mostly,multiseriate,nflorescence,numerous,often,one,orolla,ovate-lanceolate,per,petaloid,pore,present,prickl,prickly,principal,prolonged,pubescence,purplish,ray,recurve,ruit,scattered,short,shorter,spreading,stalk,stalked,stellae,stellate-pubescent,straight,tal,tamen,tem,termination,tip,tube,typically,unarmed,unit,variable,vary,vivo,wide,ympodial	abaxial,adaxial,arrangement,capitate,color,colour,corolla,feature,growth,height,history,leaf,life,na,number,ovary,plant,position,recurved,reproduction,seed,shape,spacing,staman,texture,width
650	wfo-0001030772	success	155	112	76	79	36	0.49	-2,0.2-0.8,0.25-0.5,0.75-1,0.9-1,1-2,1.5-2,2-7,3-3.5,3-5,5-6,acuminate,acute,anther,apex,bark,branch,bud,calyx,capitate,closely,cm,corolla,dark,ellipsoid,elliptic,filament,fruit,fruiting,gently,glabrous,globose,green,grey,large,leaf,lenticellate,lobed,long-acuminate,minor,minutely,mm,node,opposite,ovary,overlapping,ovoid-reniform,pale,paler,papillose,pedicel,per,petiole,pitted,rounded,shape,shaped,shrub,simple,size,slightly,spaced,stem,stigma,style,surface,swollen,tan,tapering,tear-drop,trichome,tube,uniseriate,white,x,young	.05,.2,.25,.5,0.5-1,0.9-3.1,1-2.5,1.2-5,1.4-1.6,4.2-6.5,5-10-flowered,8-10,9-15,anthesi,archin,attenuate,ba,base,becoming,beginning,beneath,berry,deflexed,dia,differing,difoliate,eaf,edicel,eed,erect,extreme,free,geminat,impressed,inflorescenc,later,lateral,lobe,lon,long,long-triangular,lower,main,major,margin,methyl,middle,nearly,nflorescence,occasionally,older,one,pair,papillo,pore,poricidal,portion,prominent,reflexed,ripe,ruit,salicylate,scar,shining,slender,smelling,soon,straight,strongly,tall,tip,ud,unit,usually,vein,widest,wintergreen,woody,ympodial	0.05,0.25,0.5,1.2,1.5,5-10,abaxial,adaxial,alternate,arching,arrangement,color,colour,diameter,flower,form,growth,height,history,inflorescence,length,life,na,number,peduncle,perennial,plant,position,rachi,reproduction,seed,spacing,staman,swelling,texture,width
651	wfo-0001030781	success	213	115	89	124	26	0.418	0.5-6,1-10,1-12,1-2,10-40,15-35,2.5-14,2.5-3.5,4-15,5-6,7.5-9,abaxially,adaxially,anther,apex,apiculate,axillary,brownish,bud,cell,chartaceous,cm,condition,corolla,covering,dark,deep,densely,diameter,dot,drying,filament,finely,flower,forked,fresh,fruit,glabrous,glandular,globose,gray-green,green,greenish,hair-like,herb,honeycomb-shaped,lateral,leaf,light,membranous,minutely,mm,mucilaginous,obovate,odd-pinnate,ovate,ovoid,pedicel,peduncle,pentagonal,petiole,pilose,plant,pointed,puberulent,pubescent,purple,rotate-pentagonal,rounded,scattered,seed,slightly,small,sometimes,somewhat,sparsely,stigma,style,subovoid,subtending,terminal,testal,thick,violet,wall,wet,white,whitish,yellow	0-5,0.2-4,0.5-8,1-1.5,1-4,1-8,1.5-12,1.5-2,1.5-9,1.6-2.2,2-20,2-3,3-4,3-6,5-7,5-8,5-merou,6-7,abruptly,acumen,ag,along,alyx,apart,apparently,articulated,axe,base,berry,blade,borne,broadly,brown,caly,capitat,ciliate,connivent,cuneate,decreasing,decurrent,digestion,distal,dorsally,eaf,edge,eed,elliptic,end,enzyme,erect,especially,exceeding,flat,folded,geminat,generally,glabrou,gradually,green-white,hair,half,high,homostylous,interjected,lanceolate,larger,leaflet,lengthening,like,living,lobe,long,low-growin,lower,make,margin,midrib,narrowed,nflorescence,orbicular,orolla,ovate-lanceolate,pair,papillose,perfect,petiolulate,plurifoliate,pore,poricidal,rachi,rarely,removed,ruit,sessile,seudostipule,short,simple,singly,size,slit,spaced,specimen,stamen,ste,stem,stolo,straight,tall,tamen,tem,throughout,tip,toward,tri-,tube,tuber,typically,unit,unwinged,usually,vary,wide,x,ympodial	abaxial,adaxial,arrangement,capitate,color,colour,form,growth,height,history,inflorescence,length,life,na,number,ovary,perennial,position,reproduction,shape,spacing,staman,surface,texture,width,ye
652	wfo-0001030782	success	198	121	95	103	26	0.48	0-7,0.4-1.5,1-2,1-6,1.5-7.5,12-30,13-22,2,2.2-4,3-10,3-5,5-20,6-8,7-15.6,abaxially,acuminate,acute,adaxially,along,anther,apex,arranged,attenuate,base,bead,brownish,cell,clavate,cm,condition,coriaceous,corolla,covering,cuneate,dark,decreasing,deep,diameter,drying,elliptic,filament,flower,forked,fresh,fruit,glabrous,globose,green,greenish,hair-like,herb,interjected,lateral,leaf,leaflet,light,like,lilac,medium,mm,moniliform,multiple,necklace,odd-pinnate,orbicular,ovate,ovoid,pair,pedicel,peduncle,pentagonal,petiole,petiolulate,plant,rachi,ripe,rotate,rounded,seed,sessile,short,size,stigma,stolon,style,terminal,testal,thick,toward,tuber,usually,wall,white,whitish,yellow	0-1,1-3,1-5,1.2-3.9,1.3-1.6,1.5-2,1.6-4.6,11-47,15,2-3,2.4-11.5,4-11.6,4-6,4.6-26,5-merou,abaxiall,acumen,ag,alyx,apart,apparently,articulated,asymmetric,axe,axillary,basiscopic,berry,blade,broadly,bud,capitat,connivent,digestion,distal,dorsally,eaf,edge,eed,enzyme,exceeding,flat,folded,geminat,generally,glabrescent,glabrou,green-white,hair,hal,half,high,homostylous,honeycomb-shaped,inconspicuous,lanceolate,lengthening,living,lobe,long,lower,make,mottled,mucilaginous,nflorescence,orolla,perfect,plurifoliate,pore,poricidal,prominently,purple,removed,ruit,scarce,second,seudostipule,side,slit,smaller,sometimes,spaced,specimen,stamen,straight,subequal,subtending,tal,tamen,tem,throughout,tip,tissue,totally,tri-,tube,typically,unit,vary,wet,wide,winged,x,ympodial	abaxial,adaxial,arrangement,capitate,color,colour,form,growth,height,history,inflorescence,length,life,na,number,ovary,perennial,position,pseudostipule,reproduction,shape,spacing,staman,surface,texture,width
653	wfo-0001030802	success	171	105	74	97	31	0.433	0.5-0.75,0.5-1,0.9-1,1,1-1.1,1-1.5,2-3,abaxially,anther,anthesi,bark,brown,bud,calyx,campanulate,cm,corolla,cucullate,deflexed,difoliate,ellipsoid,filament,flattened-reniform,fruit,fruiting,glabrous,glandular,globose,heart-shaped,internodal,irregularly,leaf,length,lobe,lobed,long-triangular,margin,minutely,mm,obconic,ovary,ovoid,pale,papillate,papillose,pedicel,persistently,petiole,pitted,plant,pore,pubescent,red,reddish,shaped,shrub,simple,somewhat,spaced,stem,stigma,straight,strongly,style,subshrub,surface,tear-drop,tip,tube,unifoliate,white,widely,yellow,yellowish	.3,.5,.5mm,0,0.25-0.4,0.5-1.5,0.7-1cm,0.75-1,1-1.2,2-2.5,2-5,2.5-3,3-3.5x,3-4,3-6,4-5mm,4-6,5-10-flowered,abrupt,acuminate,acute,adaxially,along,apex,appearing,basal,base,becoming,beginning,beneath,berry,cordate,deeply,densely,denser,dia,dry,eaf,edicel,eed,evenly,except,exerted,exudate,filiform,free,geminat,gland,glandurla,halfway,hanging,incrassate,inflorescenc,invest,lamina,later,lateral,line,live,long,lower,m.,main,markedly,material,midvein,near,nflorescence,older,pair,palmate,per,poricidal,portion,prominent,pubescen,raised,ruit,scar,single-celled,slender,soon,specimen,stigm,tapering,tipped,trichoem,trichome,ud,uniseriate,unit,variable,vein,woody,x,ympodial,young	0.3,0.5,0.7-1,3-3.5,4-5,5-10,abaxial,adaxial,arrangement,color,colour,diameter,flower,form,growth,height,history,inflorescence,life,na,number,peduncle,perennial,position,rachi,reproduction,seed,shape,spacing,staman,texture
654	wfo-0001030803	success	185	130	118	67	12	0.638	0.2,0.3,0.4,0.5,0.5–1.5,0.75–1,1-,1.5-,1.5-3,10–15,1–2.5,2.5,20–40,2–,3-6,3–10,3–4,3–5,4–10,5,6–12,6–8,abaxially,absent,acuminate,acute,adaxially,anther,anthesi,apex,armed,articulated,base,becoming,berry,branched,brown,bud,calyx,chartaceous,cm,connivent,corolla,diameter,elliptic,elongating,entire,exserted,flattened-reniform,flower,fruiting,glabrous,globose,green,hair,imparipinnately,internode,leaf,leaflet,light,lobed,long,margin,midrib,minute,minutely,mm,often,outline,ovate,papillae,pedicel,peduncle,pericarp,petiole,petiolule,pinnate,pinnatifid,pitted,pointed,poricidal,prickle,puberulent,rachi,ranging,rarely,recurved,rounded,rugose,shape,sharply,simple,size,slender,stellate,stem,stigma,stout,strongly,style,surface,tapering,terminal,tip,truncate,tube,turbinate,usually,variable,variously,vine,woody,yellow,yellowish,×,–10,–16,–5	.5,0.2–0.3,0.9–1.5,1,1.5,1/3,10967,1–3,7–9,?,adaxiall,adjacent,ag,almost,alyx,axe,basal,blade,broadly,campanulate,confluent,connecting,corresponding,dr.,eaf,eed,equal,filament,hinton,lanceolate,lateral,lengthening,lobe,long-styled,lower,major,middle,midri,narrowly,nflorescence,orolla,plurifoliat,pore,present,purple,recurve,ruit,side,slit,somewhat,spreading,straight,subwoody,swolle,tamen,time,tissue,triangular,truncat,unit,vary,vein,wide,widest,wing,wood,ympodial	abaxial,color,dry,form,fruit,growth,inflorescence,length,ovary,presence,seed,texture
655	wfo-0001030809	success	154	113	76	78	37	0.494	0.2,1.2-1.4,1.4-1.5,1.5-3.5,4.5-5,6-8,8,acute,anther,anthesi,apex,appearing,bark,base,beneath,branched,calyx,clavate,cm,corolla,densely,ellipsoid,elliptic,erect,exserted,falcate,filament,free,fruit,glabrous,globose,golden,green,large,leaf,lobed,long,long-papillose,minutely,mm,nearly,opposite,ovary,ovate,overtopping,pedicel,petiole,pore,poricidal,portion,pubescent,round,scattered,several,shining,shoot,simple,size,slender,small,soon,stem,stigma,style,tapering,terminal,time,tip,tomentose,tree,trichome,tube,unequal,uniseriate,white,yellow-brown	.5,0.5-1,1-1.25,1-1.5,1.5-2.4,2-2.5,2.3-5.5,20-60-flowered,5-8,9.9-12,across,along,also,apar,berry,broadly,caly,campanulate,curl-tipped,curved,dark-papillo,deciduous,deflexed,deltoid,dense,dia,difoliate,distally,eaf,edicel,eed,especially,evenly,fruiting,geminat,hair,hidden,interpetalar,known,lateral,leave,like,lobe,lon,lower,main,major,markedly,mature,membranous,middle,midrib,minor,nflorescence,older,one,planar,present,ruit,scar,shinin,sinus,slightly,spaced,straight,tall,three,triangular,two,ud,underside,unit,vein,wide,widest,x,ympodial,young	0.5,1.5,2,2.5,20-60,abaxial,adaxial,apart,arrangement,bud,color,colour,dark-papillose,diameter,exsertion,flower,form,growth,height,history,inflorescence,length,life,na,number,peduncle,plant,position,rachi,reproduction,seed,shape,spacing,staman,surface,texture,width
656	wfo-0001030810	success	191	144	90	101	54	0.471	0.2,1,abaxially,acute,adaxially,along,anther,apart,apex,articulated,axillary,base,bipinnate,blue,borne,branched,brown,calyx,clavate,cm,colour,cylindrical,dark,densely,denser,diameter,divided,elliptical,filament,flattened,fleshy,flower,fruit,glabrous,globose,green,greyish,hair,indumentum,leaf,leafy,lobe,long,longitudinal,margin,midrib,midvein,mm,moderately,narrow,oblong,occasionally,opening,pair,pale,pedicel,peduncle,pentagonal,petiole,pinnae,pinnate,pitted,primary,pubescent,rounded,shallowly,shiny,shoot,shrub,simple,slit,stem,stigma,straight,style,surface,tardily,time,tomentose,tube,unicellular,uniseriate,unknown,violet,white,wide,wing,woody,x,yellow	0.2–0.3,0.3,0.4,0.5–,0.5–0.8,0.6–1.0,0.7–1.4,0.8–5.5,0.95–2.0,0–,1.0–1.5,1.0–2.0,1.0–3.0,1.1–2.0,1.1–2.2,1.2–1.5,1.5–1.9,1–2,1–3,1–5,2.9–4.5,20–100,2–3,2–4,3.0–5.0,3.3–5.5,3.3–8.5,3.5–4.6,3–19,4–14,4–5,4–7,5,5–15,5–30,5–32,6–10,6–22,7–10,7–11,8–10,absen,accrescent,adaxiall,ag,anthesi,axe,ba,blade,cell,chartaceous,connivent,decreasing,eaf,eed,elliptic,equal,erect,especially,geminat,half,hig,irregular,lon,lower,m.,multicellular,nflorescence,obtu,older,opposed,orolla,oung,perfect,plurifoliate,pore,poricidal,rarely,reflexed,ruit,secondary,shaped,side,size,sometimes,spaced,sparsely,stone,subglabrous,tamen,tear-drop,tip,unit,vary,ympodial,–2.5,–3,–3.4,–4.5,–5.0,–8	0.2-0.3,0.6-1.0,0.7-1.4,1-2,1.0-1.5,1.0-2.0,1.0-3.0,1.1-2.2,2-3,2.5,2.9-4.5,20-100,3,3.3-5.5,3.4,3.5-4.6,4-14,4-5,5-15,5-32,5.0,6-10,6-22,7-10,7-11,8-10,abaxial,adaxial,age,arrangement,articulation,branching,color,corolla,form,glabrousnes,growth,height,history,inflorescence,length,life,na,number,ovary,perennial,plant,position,reproduction,seed,shape,spacing,staman,texture
657	wfo-0001030814	success	223	120	95	128	25	0.426	-3.5,.5,0-0.2,0-0.3,0.1-0.3,0.3-0.6,0.4,0.5-1.5,1-4,1.5,1.5-2,1.8-3.5,15-20,3-5,4-6,5-12,5-15,5.5,6-9,abaxially,acute,adaxially,almost,anther,apart,apex,appressed,articulated,ascending,base,branched,broadly,cm,densely,diameter,divergently,divided,elongating,essentially,extra-axillary,felty,filament,flower,form,fruit,glabrous,globose,immature,inflorescence,interwoven,lateral,length,lenticular,lignescent,long,major,midpoint,minutely,mm,narrower,obsolete,obtuse,oval,ovate,ovoid,pedicel,peduncle,perennial,petiole,pitted,pubescent,rachi,ray,ripe,sericeous,short,short-stalked,simple,slightly,somewhat,stellae,stellate,stellate-pubescent,stem,stigma,style,tan,thin-textured,truncate,vein,weakly,white,x,yellow,young	-0.5,-1.5,-4,.5-3,0.1-0.2,1-2,1/8-1/3,10-12,10-25,14-15,15-16,16-30,2-3,2-foliate,23-31,3-7,4-,4-5,5,5-8,5-9,6-15,6-locular,7-11,7.5-11,absent,acute-tipped,adaxiall,along,apiculate,asymmetric,attenuate,axe,ba,basal,become,becoming,blade,bulge,calyx,campanulate,capitat,capitate-glandular,coarsely,connivent,cultivated,cylindrical,dentate,depressed-deltoid,developed,diffusely,directly,distal,distall,eaf,eed,elongate,entire,female-sterile,geminat,glabrescent,hair,hirsute,inserted,interlobal,intermixed,invested,lanceolate,less,lobe,lon,lower,margin,mature,midvein,minute,much,nflorescence,obtuse-tipped,often,orolla,oung,ovate-lanceolate,per,pericarp,pore,prominent,pubescence,replaced,rip,rounded,ruit,scattered,sessile,shorter,side,similar,simple-,simple-haired,sinus,small,sometimes,soon,spaced,specimen,spreading,stalk,stellate-,stellate-pubescen,strongly,swollen,tal,tamen,termination,time,trichome,tube,unarme,unarmed,unbranched,uniseriate,unit,unknown,usually,vary,weak,wide,ympodial	abaxial,adaxial,arrangement,capitate,color,colour,corolla,growth,height,history,leaf,life,na,number,ovary,plant,position,reproduction,seed,shape,spacing,staman,surface,texture,width
658	wfo-0001030822	success	146	96	67	79	29	0.459	.2,0.4,0.5-1.5,0.9-1,1-1.2,1-1.5,2-2.5,2-5,3-3.5,3-5,5-6,acute,anther,apex,attenuate,base,calyx,clavate,closely,clustered,cm,corolla,deflexed,dia,elliptic-obovate,filament,filiform,flattened-reniform,flower,fruiting,glabrous,globose,green,inflorescence,internodal,leaf,lobed,margin,minutely,mm,near,nearly,occasionally,opposite,ovary,pale,pedicel,petiole,pitted,revolute,scar,shiny,shrub,simple,spaced,stem,stigma,style,surface,tan,tapering,tip,tube,usually,white,woody,x	0-0.5,0.1-0.2,0.4-1,0.8-1,1.5-2,11-15.5,2-3.8,3.5-7,5-7,8-9,abaxially,adaxially,anthesi,ba,beneath,berry,broadly,completely,cucullat,cucullate,cup,decurrent,deltate,differing,difoliate,eaf,edicel,eed,erect,exserted,fleshy,free,geminat,incrassate,inflorescenc,later,lateral,lobe,lon,long,long-ellipsoid,lower,main,major,middle,minor,minute,nflorescence,older,onto,open,pair,papillo,papillose,perhaps,planar,pore,poricidal,portion,present,red-papillose,ruit,shaped,size,slightly,somewhat,sparsely,strongly,tall,tear-drop,ud,unit,vein,widest,winged,yellowish,yellowish-brown,ympodial,young	abaxial,adaxial,alternate,arrangement,bud,color,colour,diameter,form,fruit,growth,height,history,length,life,na,number,peduncle,perennial,plant,position,rachi,reproduction,seed,shape,spacing,staman,texture,width
659	wfo-0001030846	invalid_json_followup	214	134	108	106	26	0.505	-0.8,0.2-0.5,0.5-0.7,1-1.5,1-2,1-2-celled,1-3,1-4,10-15,2-10,2-3,2.5-3,5-15,8-10,abaxial,abaxially,acute,anther,antrorse,apart,apex,apical,bark,base,beige,berry,branching,brown,brownish,clavate,cm,corolla,cream,cuneate,curved,dark-green,diameter,elliptic,entire,filament,flattened,flower,fruit,gland,glandular,glandular-viscous,golden,grey,growth,heterostylous,hirsute,inflorescence,leaf,like,lobed,many,margin,midpoint,midrib,mixture,mm,multicellular,nearly,oblanceolate,obovate,opposite,oval,ovary,ovate-elliptic,pedicel,peduncle,perfect,petiole,plant,porrect,prickle,prominent,pubescence,pubescent,rachi,ray,red,reddish,reniform,rhombic,rugose,rusty,scabrous,scar,shrub,simple,sparsely,stellate,stem,stigma,style,subglobose,surface,terete,time,tip,tomentose,tomentose-velutinous,trichome,undulate-reticulate,white,without,yellowish	-11,-4,.3,0.1,0.1-0.3,0.2-0.4,0.8-1,1-1.2,1-2.5,1-multicellular,1.5-2,3-,3-3.5,3/4,4-4.5,4-5,4-6,5-8,6-18,6-8,acuminate,adaxially,adult,angulate,anthesi,anthesisflower,armed,articulating,assymetric,basal,calyx,chartaceous,deciduous,decurrent,densely,discolorous,distal,eaf,eed,erect,exserted,ferruginous,free,fruiting,glabrescent,juvenile,lanceolate,larger,lateral,lengthening,linear,linear-lanceolate,lobe,long,long-styled,longer,lower,much-branched,multiangulate,near,new,nflorescence,obliqu,oblong,obverse,ochraceous,older,papillat,pendant,pericarp,persistent,plurifoliat,pore,poridical,portion,prickly,puberulent,raised,reflexed,relatively,rest,rotate,ruit,sessile,short,short-styled,similar,slightly,slit,sometimes,stalked,staminate,stipitate,straight,testa,thick,tube,ud,unarmed,unit,upper,wide,x,ympodial,young,¼	'',[,``,adaxial,characteristic,color,form,height,history,length,life,na,number,papillate,perennial,position,reproduction,seed,shape,spacing,staman,texture,value,width,{,}
660	wfo-0001030850	success	240	94	80	160	14	0.333	0-,1-2,1-2.5,1-8,1/2-3/4,2-15,2-25,2-3,3-10,3-15,3.5-6,4,6-11,8.5-11.5,abaxial,abaxially,acuminate,adaxial,andromonoecious,anther,apart,apex,apparently,articulated,base,berry,bright,cell,chartaceous,climber,cm,connivent,densely,diameter,elliptic,erect,filament,flattened-reniform,flower,fruit,glabrescent,glabrous,lateral,leaf,length,lobed,margin,mauve,mm,moderately,obtuse,orange,orange-brown,outline,ovate,pedicel,peduncle,petiole,pit,plant,poricidal,prickle,purple,raised,red-orange,scandent,shrub,small,smooth,sparsely,spherical,stellate,stellate-pubescent,style,surface,tapering,terminal,tip,way,yellow	-6,.5,/4,0-0.5,0-30,0-40,0.1-0.2,0.1-0.3,0.1-0.4,0.1-0.5,0.2,0.5-2,00,1-,1-10,1-20,1-3,1-4,1-5,1.2,1.5,1.5-2.5,1/2,1/2-1/5,1/3,1/3-3/,1/3-3/4,10-100,10-20,15-20,2-4,2-6,3-3.7,3-4,3-5,3-6,4-8,5-10,5-12,5-13,5-merous,6-8,7-15,7-22,8-20,acuminat,acute,alyx,apar,apically,bark,blade,branched,broad-deltate,broadly,brow,calyx,cordate,cream,cuneate,curved,dark,deltate,difoliate,discolorous,distal,distance,drying,eaf,eed,elongate,elongated,elongating,entire,equal,extending,flattened,free,fruiting,geminat,gently,gray,green,green-brown,hermaphrodite,heterostylous,infructescence,lobe,lobing,long,long-styled,longer,lower,lowermost,marking,mature,maturity,midpoint,midvein,nflorescence,oblong,obovate,often,older,one,open,orolla,oung,pair,pale,pendulous,per,pericarp,porrect,portion,prickl,prickly,primary,pubescent,ray,red-brown,red-green,reduced,rounded,ruit,scar,secondary,sessile,short-styled,shorter,side,simple,sometimes,somewhat,spaced,spreading,stalk,stalked,staminat,stem,stout,straight,tamen,terete,tertiary,time,trichome,truncate,tube,unit,upper,variously,vary,vein,venation,visible,wide,woody,ympodial,young	color,corolla,form,growth,height,inflorescence,number,ovary,reproduction,seed,shape,spacing,staman,texture
661	wfo-0001030867	success	259	136	121	138	15	0.467	.5,0-,0.6-1.5,1-1.5,1-2,1-2.5,1-5,1.5,1.5-4.5,10,12-15,2.5-3,5-6,6-7,abaxially,abundant,adaxially,anther,anthesi,apart,armed,articulated,band,bark,base,berry,branched,broad-based,brown,bud,cast,chartaceous,cm,concolorous,corolla,curved,dark,decurrent,densely,diameter,dry,either,ellipsoid,elliptic,elongate,expanded,filament,flower,fruit,glabrous,globose,green,greyish,growth,inflorescence,interpetalar,leaf,leathery,length,long,long-styled,margin,mature,maturing,membranous,midvein,mm,mottled,new,nodding,occasionally,outline,ovary,ovoid,pale,pedicel,peduncle,pentagonal,petal,petiole,plant,prickle,prickly,pubescent,reniform,sessile,short-stalked,short-styled,side,simple,sinuate,slightly,somewhat,spaced,sparsely,stellate,stellate-pubescent,stem,stigma,straight,style,surface,tan,thick,thickened,tip,tissue,translucent,trichome,type,unevenly,usually,varying,violet,white,whitish,wide,winged,x,yellow,yellowish	-1/3,-6,.25,.3,0.3,0.5,0.6,1,1/4,100,14,18,2-2.5,2-3,2-5,2-6,2.5-3.5,3-4,3-5,3.5-8.5,4,4-4.5,4-5,4-6,4.5-14,5-25,5-merous,6,<,>,acumen,acute,alyx,andromonoecious,apex,approximately,area,attenuate,bi-lobe,borne,calyx,cell,cup-shaped,curve,denser,difoliate,directed,distal,distall,distance,drying,eaf,easily,eed,equal,erect,exposed,exserted,flowering,free,fruiting,functionally,geminate,glabrescen,greatest,halfway,herbaceous,hermaphroditic,heterostylous,immature,infructescence,internodal,lamina,larger,lateral,less,like,lobe,lobed,lon,longer,lower,lowermost,mal,markedly,maturit,midpoint,midrib,narrowly,near,nflorescence,often,older,onto,opposite,orolla,pair,pendent,per,pericarp,planar,pore,poricidal,portion,primary,ray,re,reflexed,rest,ruit,scar,shallowly,shap,shrub,size,small,splitting,still,stouter,strongly,subshrub,tall,tamen,tapering,testal,thinne,triangular,tube,ud,unit,upper,vary,vein,visible,way,woody,ympodial,¼	abaxial,adaxial,armament,bi-lobed,color,colour,height,number,pricklines,pubescence,seed,shape,spacing,staman,texture
662	wfo-0001030871	success	248	124	101	147	23	0.407	0.2-0.4,0.3-4,0.4-1.8,0.6-1.5,1-1.3,1-18,1.3-2,1.5-6,2-8,2.8-4.5,3-32,3-4.4,3.5-14,30,4.5-6.5,5-33,6-40,abaxially,abruptly,acuminate,acute,adaxial,adaxially,anther,apart,apex,bark,becoming,berry,branch,brown,bud,calyx,campanulate,chartaceous,cm,conical,continued,corolla,dark,deltoid,diameter,due,early,elongate,evident,filament,fleshy,flower,fruit,glabrescent,granular-tomentose,grayish,green,greenish,growth,hair,honeycombed,lateral,leaf,length,mm,mostly,open,orbicular,ovate,pale,pedicel,peduncle,petiole,probably,purple,rachi,reniform,reticulate-punctate,ripe,rotate-stellate,scabridulous,short,shrub,simple,soon,splitting,stellate-tomentose,stem,stigma,style,suborbicular,sulcate,suture,terete,terminal,tomentose,tree,velutinous,violet,white,x,yellow,yellowish,young	.2-3,.8-3.5,.9-1.2,/30-1/5,0-120,0.7-1.3,0.7-2.5,1.3-3,1.4-2.7,1.5-3,1.8-2.6,1.8-3.5,1/2,1/2-3/4,1/4,1/4-1/3,11,2-3,3-5,3-6,4.8-9.5,5-7,7-12,9-13,accrescent,ag,along,anthesi,apical-lateral,apparently,appressed,appressed-tomentose,articulated,attenuate,axe,axillary,ba,base,blade,blunt-tipped,branched,capitat,closely,decurrent,dehiscing,dendritic-echinoi,dendritic-echinoid,dendritic-multangulate,densely,directed,distal,eaf,earl,echinoi,echinoid,eed,elliptic,entire,equal,erect,exserted,extend,free,fruiting,glabrescen,glabrous,held,high,inserted,introrse,large,lobe,lobed,long,long-,long-stalked,longer,longitudinal,lower,m.,main,margin,midvein,minute,mixed,multangulat,multangulate,narrowly,nearly,nflorescence,nodding,oblong,obtuse,occasionally,often,older,orbicula,orolla,ovate-lanceolate,overlapping,partly,perfect,plait,plurifoliate,pore,porrect-stellate,present,prominent,pubescent,rather,ray,reflexed,relatively,ruit,runk,sessile,short-,short-stalked,side,slit,small,sometimes,somewhat,spaced,sparingly,sparsely,stamen,striate,strongly,subglobose,tamen,testa,thick,thick-stalked,thin-stalked,time,toward,tube,unarme,unarmed,unit,usually,vary,vein,way,wide,ympodial	0.2-3,30-120,abaxial,arrangement,capitate,color,form,height,inflorescence,number,ovary,plant,seed,shape,size,spacing,staman,sulcation,surface,teretenes,texture,thicknes,trunk
663	wfo-0001030872	success	166	97	68	98	29	0.41	.5,0.8-1,1-1.5,1-2,1.5-2,1.5-5,2-5,4-6,5.5-7,acuminate,adaxial,anther,apex,area,bark,base,black,broadly,brown,closed,closely,cm,completely,corky,corolla,crateriform,dark,densely,ellipsoid-ovoid,elliptic,erect,fleshy,fruiting,glabrous,globose,green,leaf,lenticel,lenticellate,margin,mm,opposite,ovary,ovate,paler,papillose,pedicel,petiole,rather,scar,shaped,shining,simple,slightly,small,spaced,stem,stigma,style,tear-drop,thickened,tip,tree,treelet,white,woody,x,young	0.5,0.5-1,0.8-2,1-1.2,1.2-1.5,1.2-3,12-18,3-7,4-6-flowered,5-6,6-12.5,acute,age,along,anthesi,appearing,beginning,berry,caly,calyx,center,consisting,cucullate,darker,deflexed,deltoid,dia,difoliate,dry,eaf,edicel,eed,exserted,filament,free,full,geminat,glabrate,hooded,incurved,inflorescenc,known,large,less,like,live,lobe,lobed,lon,long,lower,major,material,middle,minor,minutely,nearly,nerve,nflorescence,oblique,older,one,overlapping,pair,pale,petal,planar,pore,poricidal,portion,primary,prominent,proximal,puberulent,raised,red-glandular-puberulent,reddish-glandular,reddish-glandular-puberulent,relative,rest,ridge,rounded,ruit,shorter,side,size,soon,specimen,straight,strongly,styl,tall,tapering,tube,ud,unit,widest,ympodial	abaxial,bud,color,colour,diameter,flower,form,fruit,growth,height,history,inflorescence,length,life,na,number,peduncle,perennial,plant,position,rachi,reproduction,seed,shape,spacing,state,surface,texture,width
664	wfo-0001030877	success	223	132	108	115	24	0.484	0-0.2,0-0.5,0-15,0-4,0-5,0.1-0.4,0.1-0.6,0.1-1,0.3-0.4,0.5-0.8,0.5-1,0.7-1.4,1-1.3,1-1.5,1-2,1.5-2,10-14,2-15,2-3,3-10,4-10,4-8,5-6,6-11,7.5-10,absent,acicular,acute,andromonoecious,anther,apart,apex,articulated,base,broadly,brown,chartaceous,cm,cuneate,cylindrical,densely,diameter,dm,entire,erect,extra-axillary,filament,finger,flattened,flower,fruit,glabrous,gland-tipped,globose,green,hair,index,inflorescence,lateral,leaf,length,lobed,long,longer,margin,midpoint,midvein,minutely,mm,obtuse,ovate,pale,pedicel,peduncle,per,perennial,petiole,plant,porrect,present,prickle,pseudo-racemose,purple,rachi,ray,reticulate,rhizomatous,rotate-stellate,rusty,shallowly,short,shrub,simple,stalk,stellate,stellate-pubescent,stigma,straight,style,surface,time,unbranched,weakly,wide,x,yellow,yellowish,yellowish-green	%,0-10,0.2-0.6,0.4-0.5,0.4-0.8,0.5-0.6,0.7-1.6,0.9-1.2,1-1.4,1-3,1.5-2.4,1.5-3,1.8-2.6,10-30,10-40,17-26,2,2-3-locular,2-foliate,2.2-2.7,2.9-4.8,2.9-8,4-6,5,5-11,5-merou,6-12,6-15,6-9,7-9,8-14,8-15,8-9,9-14,9-15,abaxially,absen,abundant,accrescent,across,adaxially,adult,alyx,anvil-shape,ascending,attenuate,axe,ba,blade,branch,branche,calyx,capitat,connivent,cross-section,directed,distall,distributed,dult,eaf,eed,eglandular,exocarp,fruiting,functional,geminat,half,heterostylous,interpetalar,juicy,juvenile,lamina,lanceolate,less,lobe,lobing,loosely,lower,mature,mesocarp,mid-point,midrib,minute,moderately,moist,nflorescence,oblique,orolla,pair,part,placenta,pore,pubescent,ruit,side,spaced,sparsely,stalked,stellae,stem,tal,tamen,thick,throughout,tissu,tissue,triangular,tube,unarme,unarmed,unit,upper,vary,vein,ympodial	5-merous,abaxial,adaxial,arrangement,capitate,color,colour,corolla,density,form,growth,height,history,life,number,ovary,position,reproduction,seed,shape,spacing,staman,texture,width
665	wfo-0001030882	success	144	101	71	73	30	0.493	.1,.5,0.5-0.75,0.5-1,0.5-1.1,0.9-1.1,1-1.3,1-1.5,1-4,1.6-2,3-3.5,accrescent,acuminate,anther,apex,attenuate,bark,base,calyx,capitate,closely,cm,corolla,crenulate,deflexed,elliptic,extreme,filament,free,fruit,fruiting,glabrous,globose,green,leaf,lobe,lobed,margin,minutely,mm,narrowly,occasionally,opposite,ovary,overlapping,ovoid-reniform,pale,papillose,pedicel,petiole,pitted,pore,portion,shaped,shrub,simple,small,spaced,stem,stigma,straight,style,surface,tan,tapering,tear-drop,tip,tree,tube,white,yellowish	0.75-1,0.8-1.1,0.8-2.4,2,2-5.4,2-6,2.2-4.6,3/4,6.5-15.6,8-12,?,anthesi,beginning,beneath,berry,conical,deltoid,dia,differing,difoliate,eaf,edicel,eed,erect,exserted,geminat,inflorescenc,lateral,lightly,lon,long,lower,main,major,middle,minor,nearly,nflorescence,older,one,ovoid,pair,paler,papillo,peelin,planar,poricidal,prominent,raised,ruguse,ruit,scar,short,size,slender,slightly,soon,tall,terminal,thick,thickened,transversely,truncate,tub,ud,unit,vein,way,widest,woody,x,ympodial,young	abaxial,adaxial,arrangement,color,colour,diameter,flower,form,growth,height,history,inflorescence,length,life,na,number,peduncle,perennial,plant,position,rachi,reproduction,rugose,seed,shape,sightly,spacing,staman,texture,width
666	wfo-0001030883	success	179	77	65	114	12	0.363	.05,.5,0.5-3,0.5-5,1-1.2,1-1.3,1.5-3.5,2-5,5-6,anther,apart,base,brown,calyx,clavate,cm,corolla,dia,dry,elliptic,fruit,glabrous,globose,green,hard,inflorescence,leaf,less,live,long,massive,material,minute,minutely,mm,narrowly,occasionally,opposite,ovary,ovate,ovoid-reniform,pale,papillate,pedicel,petiole,pitted,plant,puberulent,russet,seed,shaped,slender,stigma,stout,style,surface,tan,tapering,tear-drop,triangular,trichome,tube,uniseriate,white,woody	-3,.1,1-1.1,1-1.5,1-4,1.5-2,10-18,18-44.5,20-50-flowered,3-3.5,3-4,3/4,9.5-27.5,accrescent,across,acuminate,acute,anthesi,apex,appearing,approximatately,arching,bark,becoming,berry,branched,bu,cell,collapsed,collection,dark,deflexed,differing,difoliate,eaf,edicel,eed,epidermal,erect,evenly,filament,finely,fleshy,free,fruiting,furcate,geminat,geminate,glandular,hollow,imbedded,laminar,large,later,lateral,lenticellat,like,little,living,lobe,lobed,lon,long-acuminate,lower,main,malodorous,markedly,middle,midrib,nflorescence,oblique,older,pair,papillo,papillose,perpendicular,petaloid,placenta,pore,poricidal,portion,present,proximal,pulp,quite,rather,reflexed,reticulate,ruit,scar,shrub,size,slightly,sometimes,soon,spaced,stem,straight,strongly,tall,thick,time,tip,two,ud,unit,upper,vein,wall,way,widest,x,ympodial,young	20-50,abaxial,arrangement,color,diameter,flower,height,length,number,shape,spacing,texture
667	wfo-0001030884	success	218	133	104	114	29	0.477	0.4-3,0.5,0.5-1.2,0.8-1,0.9-5,1,1-1.5,1.5-2.5,2,2-5,4.5-5,5,5-30,5-merous,9-11,abaxial,abaxially,abruptly,acute,adaxial,anther,anthesi,apex,articulated,bark,base,berry,brown,c.,calyx,capitate,cm,conical,dark,decurrent,densely,diameter,elliptic,extend,filament,flower,fruiting,glabrous,gray-tinged,green,greenish,growth,heterostylous,inflorescence,lateral,leaf,leafy,length,lobe,lobed,long,long-stalked,margin,mature,minutely,mixture,mm,moderately,node,onto,ovary,ovoid-reniform,pale,pedicel,peduncle,petiole,plant,pubescent,red,reddish,reflexed,regularly,scar,shallowly,short,shrub,simple,slender,spaced,sparsely,spherical,spreading,stellate,stellate-pubescent,stem,stiff,stigma,strongly,style,surface,tannish,treelet,trichome,unicellular,way,weakly,white,wide,wing	.2,.5,.7,0.3,0.3-0.5,1-1.2,1-3,1.5,1.5-2,10,100,4-13,4-5,5-6,5.5-7,6-10,6-25,6-8,7-8,>,adaxiall,along,also,alyx,andromonoeciou,apar,arme,basal,blade,broad-based,connivent,curved,di-,differing,directed,discolorous,distal,eaf,eed,equal,extending,flowering,free,geminate,glandular,gree,half,herbaceous,infructescence,like,long-styled,long-triangular,lower,magnification,midpoint,midrib,minute,new,nflorescence,occasionally,older,one,open,orolla,oung,outlin,pair,papillat,per,pore,poricidal,porrect,portion,present,prickle,prickly,primary,principal,ray,reflexe,rest,ruit,sagittate,scattered,sessile,shap,short-stalked,short-styled,similar,size,still,tall,tamen,tapering,time,tip,trifoliate,tube,unarmed,uniformly,uniseriate,unit,upward,usually,vary,varying,vein,visible,winged,without,woody,yellow,ympodial,young	adaxially,andromonoecious,apart,armament,armed,arrangement,articulation,color,colour,corolla,density,form,fruit,height,history,life,na,number,papillate,perennial,position,reflexion,reproduction,seed,shape,spacing,staman,texture,width
668	wfo-0001030899	success	146	106	76	70	30	0.521	0.3-0.5,0.5-1,1,1-3,1-6,1.5-2,10-20,2,2-3,2-3.5,2.5-3.5,3-12,3-4,4-5,5-10,?,abaxially,acuminate,adaxially,apex,articulated,base,bronze,calyx,cm,connective,cordate,coriaceous,deeply,densely,diameter,ellipsoidal,end,entire,flattened,flower,fruit,glabrous,glandular-puberulent,globose,green,inside,less,light,margin,mm,obconical,oblong,obtuse,outside,ovate,ovoid,pedicel,pedicellar,peduncle,petiole,pore,puberulent,pubescent,purple,rachi,radiu,remnant,shrub,simple,splotch,stellate,stigma,stripe,style,thecae,unbranched,upward,white,x,yellow	-45,.5-2,0.5,1-1.5,1-2,10-13,20-25,3-5,3-foliate,3.5-4,5-6.5,6.5-31,7-27,8-11,absent,acute,aggregate,apart,ape,axe,basal,beyond,blade,cell,chartaceous,connivent,desc,dilated,directed,distally,eaf,eed,ex,exceeding,exserted,extrorse,leaving,lobe,lon,long,lower,mucronate,narrowly,nflorescence,nther,orang,orolla,peltifor,perfect,presen,puberulen,ruit,shorter,slightly,spaced,stamen,stone,strongly,tal,tem,time,tomento,triangular,tube,ud,unit,vary,vein,wide,ympodial	abaxial,adaxial,anther,arrangement,bud,color,colour,corolla,direction,form,growth,height,history,inflorescence,leaf,length,life,na,number,orange,ovary,peltiform,plant,reproduction,seed,shape,spacing,surface,texture,tomentose
669	wfo-0001030902	success	159	125	88	71	37	0.553	-20,0.6-1.5,1-2,1-6,1.5-13,1.5-2,1.5-2.5,10-15,15-50,2,2-3,2-5,2.5,3-13,3-20,3-4,3.5-4,4,4-22,4-6,5-7,6-24,8-14,acuminate,acute,aggregate,angled,apex,articulated,basal,blade,brown-pilose,calyx,cell,cm,connective,cordate,cylindrical,dark,deltate,densely,diameter,distally,ellipsoidal,flattened,fleshy,flower,forked,fruit,glabrescent,glabrous,globose,laterally,lobe,long,margin,mm,narrowly,oblong,obtuse,orange,ovate,pedicel,pedicellar,peduncle,petiole,pinkish,pore,present,purple,purplish,rachi,radiu,reddish,remnant,simple,stellate,stigma,style,subcoriaceous,tree,triangular,truncate,tube,unbranched,unit,x,yellow	-2,-5,0-15,1.5-,2.5-4,30-50,4-7,4-foliat,5-9,abaxially,absent,adaxially,along,apart,ape,apically,apiculate,axe,base,beyond,branched,brow,connivent,dilated,directed,eaf,eed,eglandular,entire,equalling,exceeding,except,exserted,glabrat,glandular,glandular-puberulen,hair,leaving,lon,lower,mature,nflorescence,nther,occasionally,orolla,perfect,presen,puberulence,rarely,ruit,shorter,slightly,small,somewhat,spaced,sparse,sparsely,stamen,stone,subcapitat,tal,tem,thecae,time,tip,tomento,ud,vary,vein,wide,ympodial	4-foliate,abaxial,adaxial,anther,arrangement,bud,color,colour,corolla,direction,filament,form,growth,height,history,inflorescence,leaf,length,life,na,number,ovary,perennial,plant,position,presence,reproduction,seed,shape,spacing,staman,subcapitate,surface,sympodial,texture,tomentose,width
670	wfo-0001030906	success	134	97	60	74	37	0.448	1,1-1.4,1.0-1.4,1.5-2.5,1/3-2/3,2.0-2.6,2.3-3.5,38,4-11,40-80,6-10,8-13,accrescent,annual,anther,ascending,bearing,berry,blade,branched,broadly,calyx,campanulate,cm,densely,dry,flattened-ovoid,foveolate,glabrous,herb,internodal,length,linear,long,maturity,minutely,mm,numerous,ovate,pedicel,pentagonal,per,petiole,pinnatifid,plicate,prickle,prickly,seed,slightly,sometimes,spherical,splitting,spreadingly,stellate-pubescent,stellate-tomentose,stem,strait,surface,tube,yellow	6-8,7-12-flowere,7-16,9-12,across,almost,along,alyx,ample,anthesi,arcuate,armed,base,bristly,broad-based,cauline,da,developing,dia,difoliate,divided,eaf,essentially,exceeding,externall,faces,flat,geminat,interpetalar,invested,lateral,lobe,long-stalked,main,n,near,nearly,nflorescence,obtuse,often,orolla,partly,pinnatisect,prickl,purple,purpli,red,rounded,ruit,sessil,short,slender,somewhat,stellae,subulate,suffused,tamen,taprooted,throughout,tightly,tigma,tissue,tub,twice,tyle,ultimate,undulate,unexpande,unit,usually,vary,vein,yello,ympodial	7-12,abaxial,adaxial,apex,arrangement,branching,color,colour,corolla,diameter,filament,flower,form,fruit,growth,height,history,inflorescence,leaf,life,na,number,ovary,peduncle,plant,position,pricklines,rachi,reproduction,shape,spacing,staman,stigma,style,texture,unexpanded,width
671	wfo-0001030914	success	186	136	107	79	29	0.575	.5,/4,0-0.25,0.1-0.5,0.5-1,0.7-1,0.8-1.3,1-1.5,1-2,1.2-1.5,1.5-3,1.5-8,2-10,2-2.5,2.5-3,3-4,7-8,acute,along,anther,anthesi,apex,bark,base,beneath,berry,bud,calyx,campanulate,capitate,closely,cm,constriction,corolla,dark,decurrent,deflexed,dia,elliptic,equal,erect,evenly,exserted,filament,flower,free,fruiting,furcate,glabrate,glabrous,globose,golden,green,inflorescence,leaf,lemon-yellow,length,lobed,long-styled,many,minutely,mm,narowly,obovate,occasionally,opposite,ovary,ovoid-reniform,pale,papillose,pedicel,petiole,pitted,planar,plant,portion,puberulent,reddish-brown,ripe,shape,short-styled,shrub,simple,slender,small,soon,spaced,sparsely,stigma,style,surface,tan,thick,time,tree,trichome,trunk,tube,uniseriate,usually,vein,way,white,winged,woody,x,yellow	.1,0.8-1,1.5-2,2.5-11,3.5-17,5-17,5-25-flowered,7-10,9-35,attenuate,blade,deltoid,densely,differing,difoliate,distal,dry,eaf,edicel,eed,ellipsoid,even,geminat,greyish-brow,individual,later,lateral,like,live,lobe,lon,long,lower,main,major,margin,middle,minor,nflorescence,often,older,one,onto,otherwise,overlappin,pair,papillo,pore,poricidal,prominent,pubescent,quite,raised,rest,rounded,ruit,scar,shaped,size,slightly,sometimes,specimen,stem,straight,tall,tapering,tear-drop,third,ti,tip,tub,ud,unit,variable,weight,widest,within,ympodial,young	5-25,abaxial,adaxial,arrangement,color,colour,diameter,exsertion,form,fruit,greyish-brown,growth,height,history,life,na,number,overlapping,peduncle,perennial,position,rachi,reproduction,seed,spacing,staman,texture,unripe,width
672	wfo-0001030918	success	230	115	93	137	22	0.404	-3.2,-4.5,-40,0.3-1.5,0.5-2,0.5-2.5,0.6-2.5,0.7-1.7,1,1-1.5,1.5-2.5,2-10,2-25,2-7,3-6.5,3-7,5-merous,5.5-7,abaxial,abaxially,acicular,acute,adaxial,anther,apex,articulated,bark,base,berry,cell,chartaceous,cm,cuneate,dark,deltate,diameter,discolorous,drying,dull,elliptic,erect,filament,flattened,flattened-reniform,flower,fruit,glabrescent,green-brown,lateral,leaf,length,lobed,lobing,long,margin,mauve,mm,moderately,oblong,obtuse,orange,orange-brown,outline,pedicel,peduncle,perpendicular,petiole,pit,prickle,purple,raised,red,red-brown,reflexed,scandent,secondary,seed,shrub,small,smooth,sometimes,somewhat,sparsely,spherical,stellate,stellate-pubescent,stem,strongly,style,surface,terete,terminal,yellow	-12,-2.3,-4,-5,-6,-9,.5,.7,0-10,0-20,0-25,0-4,0-6,0.1,0.1-0.25,0.2-0.4,0.25-0.45,0.5-0.7,0.6,0.7-1.2,1-1.8,1-2,1-4,1.5-2,1.5-5.5,1/2-2/3,1/2-3/4,1/3,1/3-,1/3-1/2,1/4-1/3,2-2.5,2-3,2-4,2-8,2.8-3,2/,3-15,3-4,3.5-6,4-7,5-7,5-8,6-8,7-10,alyx,ame,apar,apart,apically,apparently,blade,branched,brow,c.,calyx,caudat,connivent,curved,densely,difoliate,distance,eaf,elongated,elongating,equal,evenly,extending,faint,free,fruiting,geminat,glabrous,green,infructescence,lobe,longer,lower,mature,maturity,midpoint,midvein,mixture,narrow-deltate,nflorescence,occasionally,older,one,open,orolla,oung,pair,pale,pendulous,per,perfec,pericarp,poricidal,porrect,portion,prickl,prickly,primary,pubescent,ray,reduced,ruit,scar,sessile,side,simple,slender,spaced,spreading,stalk,stalked,straight,tamen,tapering,tertiary,time,tip,trichome,tube,unit,upper,usually,vary,vein,venation,visible,way,weakly,wide,woody,ympodial,young	brown,color,corolla,feature,form,growth,height,inflorescence,na,number,ovary,plant,position,present,rachi,reproduction,shape,spacing,staman,stigma,texture,width
673	wfo-0001030919	success	219	129	94	125	35	0.429	12,2,2.5,5-merous,abaxial,abaxially,acute,adaxial,adaxially,andromonoecious,anther,apart,apex,armed,asymmetrical,base,branched,brown,chartaceous,cm,coriaceous,densely,diameter,elliptic,entire,extra-axillary,filament,flattened,flower,fruit,glabrous,glandular,globose,green,hair,interpetalar,leaf,length,like,long,margin,midrib,midvein,mm,moderate,moderately,multicellular,notch,obtuse,occasionally,often,orange,ovate,pedicel,peduncle,petiole,pinnate,placenta,plant,porrect-stellate,prickle,protrusion,pubescent,rachi,recurved,reddish,reniform,roselike,rugose,rusty,scandent,secondary,shrub,side,small,sparsely,spine,stellate,stellate-pubescent,stem,stigma,style,subopposite,surface,tan,tissue,twice,unbranched,uniseriate,vein,venation,white,whitish,yellow	.2–0.4,.2–0.6,0.1–0.2,0.1–0.3,0.3–0.6,0.5–1,0.5–1.5,0.5–3,1.2–2,1.5,10–13,10–14,10–20,12–16,12–18,1971,1–2,1–3,25–50,2–3,2–4,2–8,3,3–4,3–6,3–8,4–7,4–8,5–10,5–7,5–8,7–10,7–11,8–12,absent,accrescent,alyx,anthesi,apparently,articulated,attenuate,axe,ba,berry,beyond,blade,calyx,capitat,connected,connivent,cordate,covering,cylindrical,directed,discolorous,distally,eaf,eed,exserted,festooning,frui,fruiting,functionally,fused,glabrou,hard,hermaphroditic,horizontal,incompletely,introrsely,lateral,linear-lanceolate,lobe,lobed,longitudinal,lower,male,maturity,midpoint,multiseriate,narrowly,nearly,nflorescence,older,opening,orolla,partially,per,perfec,petiolate,plurifoliat,pore,positioning,proximally,ray,reflexed,roe,ruit,see,shortly,simple,slightly,slit,spaced,stalk,stamen,ste,subsessile,swollen,tal,tamen,tapering,tem,terminology,triangular,triangular-ovate,tube,unarmed,unicellular,unit,vary,wide,ympodial,young,×	0.5-1,0.5-1.5,0.5-3,1-2,1-3,10-20,2-4,2-8,3-4,4-7,5-7,7-10,7-11,armament,capitate,color,colour,connection,corolla,form,growth,height,inflorescence,na,ovary,position,reproduction,seed,shape,size,spacing,staman,texture,type,x
674	wfo-0001030921	success	185	94	71	114	23	0.384	0,0.4-0.5,1-3,2-2.5,2-6,3-3.5,3-5,4-10,7-8,acuminate,acute,anther,apart,apex,base,berry,brown,cm,corolla,corymbose,cyme,deep,diameter,elliptic,filament,flattened,flower,fruit,globose,green,grey,growth,inflorescence,internodal,lanceolate-elliptic,liana,linear-lanceolate,lobed,many,minute,mm,nearly,ovary,ovoid-conical,pedicel,peduncle,petiole,pubescent,purple,reniform,reticulate-undulate,rugose,scabrous,scar,spaced,stellate,stellate-pubescent,stigma,style,subspherical,subtruncate,surface,tapering,tube,unevenly,velutinous,violet,white,woody,x,yellowish	.5,1-1.2,1-1.5,1-2,1/3,10,2-3,3-4,3.5-5,4-6,6-7,9-15,abaxially,adaxially,anthesi,antrorse,appressed,armed,articulated,asymmetric,bark,basal,branched,caly,calyx,campanulate,channelled,compressed,congested,coriaceous,curved,deeply,densely,diamete,discolorous,distal,eed,elongating,entire,erec,erect,exceeding,exserted,free,fruiting,glabrescent,glabrous,half,hermaphroditic,heterostylous,included,like,lobe,long,long-styled,longer,lower,margin,midpoint,multicellular,near,new,nflorescence,oblong,obverse,older,one,partially,perfect,pericarp,plurifoliateleaf,pore,poricidal,porrect,porrect-stellate,portion,prickle,prickly,puberulent,pubescence,raise,ray,recurved,reddish,reduced,reflexed,ruit,rusty,sessile,short-styled,shorter,shrub,slightly,slit,sparse,sparsely,staminate,stem,straight,strongly,subequal,terete,testa,time,tip,tomentose,triangular,trichome,ud,unicellular,unit,upper,ympodial,young	abaxial,adaxial,arrangement,bud,color,colour,form,height,history,leaf,length,life,na,number,plant,plurifoliate,position,reproduction,seed,shape,size,spacing,texture
675	wfo-0001030941	success	259	131	103	156	28	0.398	-1.5,0.1-0.3,0.5-1.5,0.8-1.3,1-1.4,1-9,1.1-2.8,1.2-2.2,1.3-2.5,1.4-1.6,1/3-1/2,2-3.2,2-5,3-4.5,4-6,6-22,7-23,9,abaxially,acuminate,acute,adaxially,along,anther,apart,apex,appressed-tomentose,articulated,base,becoming,brown,bud,calyx,cm,color,conical,corolla,decurrent,deltoid,densely,diameter,elliptic,entire,filament,flower,fruit,glabrescent,globose,growth,honeycombed,lateral,leaf,length,lobe,lobed,long,long-attenuate,margin,minutely,mm,moderately,mostly,narrowly,nearly,obovate,obscured,obtuse,occasionally,ovoidal,pedicel,peduncle,perfect,petiole,pubescent,rachi,reticulate-punctate,ripe,scabridulous,scabrous,short,shrub,simple,small,sometimes,sparingly,stelliform,stigma,stipitate-glandular,style,suborbicular,subreniform,suture,terminal,testa,tomentose,tree,triangular,tube,way,white,x,yellow,yellowish	-16,-4,-6,.01-0.3,.03-0.25,.04-0.1,.04-0.12,.04-0.22,.04-0.4,.2-0.8,.5-5,/50-1/15,0-100,0.01-0.22,0.02-0.04,0.02-0.06,0.02-0.25,0.02-0.3,0.02-0.4,0.03-0.05,0.03-0.06,0.03-0.6,0.04-0.08,0.04-0.1,0.04-0.35,0.04-0.5,0.04-0.6,0.06-0.35,0.06-0.42,0.07-0.4,0.08-0.35,0.08-0.5,0.8-1.1,1.1-1.3,1.1-1.7,1.2-2.1,1.3-4.5,1.4-3.5,1.5-3.5,1.5-4.5,10,10-25,2-3.3,3-5,3.5-10,3/4,4-12,4-8,4-9,5-9,5-merou,6-10,6-9,7-10,absen,accrescent,ag,alyx,anthesi,apical-lateral,apparently,axe,axillary,bark,berry,blade,blunt-tipped,branch,branched,campanulate,chartaceous,continued,darker,dehiscing,dense,directed,due,eaf,eed,ellipsoid,exserted,extend,few-rayed,fleshy,free,fruiting,glabrous,glandular,gray,hair,high,inserted,introrse,lanceolate,large,less,lon,longer,longitudinal,lower,m.,main,midpoint,midvein,mixed,multangulat,multangulate,multiseriate,nflorescence,oblong,often,older,orolla,ovate,pale,plurifoliate,pore,porrect-stellat,porrect-stellate,rarely,rather,ray,ruit,runk,sessile,short-stalked,side,slit,somewhat,spaced,sparse,sparsely,stalk,stamen,stem,strongly,subcapitat,subcoriaceous,tamen,terete,thick,thick-stalked,time,tomentu,touching,toward,unarme,unarmed,unit,usually,vary,vein,weakly,wide,ympodial,young	0.2-0.8,0.5-5,20-100,5-merous,abaxial,adaxial,arrangement,form,height,history,inflorescence,life,na,number,ovary,perennial,plant,position,reproduction,seed,shape,spacing,staman,subcapitate,surface,texture,tomentum,width
676	wfo-0001030943	success	167	117	85	82	32	0.509	1-1.2,1-1.5,1.5-2,1.8-2.2,1/2,10-25,12-15,2-6,3/4,4-4.5,abaxial,acuminate,acute,adaxial,along,anther,anthesi,apex,bark,base,becoming,bi-lobed,black,calyx,cm,corolla,dark,decurrent,densely,denser,diameter,drying,echinoid,elliptic,erect,exserted,filament,flattened,flower,fruiting,globose,golden,golden-yellow,growth,lateral,leaf,lenticular,lobed,minutely,mm,narrowly,nodding,ovary,pale,pedicel,pericarp,petiole,pitted,pubescent,purplish-black,raised,reddish-brown,scar,shrub,small,somewhat,sparsely,stem,stigma,strongly,style,surface,tapering,terminal,thin,tree,tree-like,trichome,tube,upper,vein,violet,way,woody,yellowish-white	.5,0,0.5-1,0.5-3,1.1,3,3-4,4-5,4-6,7-13.5,7-8,8-10,abaxially,absent,adaxially,age,apical,basal,belo,berry,branch,branching,conical,cupulate,deflexed,dendritic,eaf,edicel,eed,elongate,ew,fide,free,glabrat,glabrous,horizontal,im,inserted,large,lobe,lon,long,lower,m.,main,minute,monochasia,nflorescence,often,older,outline,overtopping,pair,papillo,pearce,per,planar,plurifoliate,pore,poricidal,portion,ruit,scattered,secondary,shoot,showy,sleeve,slightly,slit-like,stamen,tall,time,tip,triangular,tub,ud,unit,wide,x,yellow,ympodial,young	arrangement,color,colour,decurrence,density,exsertion,form,fruit,glabrate,height,history,inflorescence,length,life,lobing,na,number,papillation,papillose,peduncle,perennial,plant,position,rachi,reproduction,seed,shape,spacing,staman,texture,type,width
677	wfo-0001030959	success	164	112	82	82	30	0.5	.05,.2,.8,0.5-1.5,0.7-1.2,1-10,1-2,1-7,1.2-1.8,10-15,4-6,5-6,5-9,5-merous,abaxially,almost,anther,apart,apex,apparently,armed,bark,base,branched,brown,brown-green,cm,color,cuneate,densely,diameter,distributed,elliptic,erect,evenly,filament,flower,fresh,glabrous,hair,inflorescence,known,lateral,leaf,length,lobed,long,long-acuminate,margin,membranous,minute,mm,numerous,one,open,pedicel,peduncle,petiole,prickle,primary,prominent,secondary,shrub,simple,sparsely,stellate,stellate-pubescent,stem,straight,straw,style,subentire,surface,terete,tertiary,time,vein,venation,visible,whole,wide,yellow	/5,0.5,1.5-2,1.5-3.5,1/5-1/10,2-4,2.5-4,2.5-4.5,2.5-5,4-8,6-8,9-12,alyx,ame,apar,apically,articulated,blade,c.,concolorous,connivent,curved,deltate,difoliate,drying,eaf,eed,equal,free,geminat,gently,glabrescent,glabrou,glandular,green-brow,know,less,like,lobe,long-acuminat,longer,lower,midpoint,narrow-deltate,nflorescence,older,orolla,oung,pair,part,perfec,perpendicular,poricidal,porrect,portion,present,prickl,prickly,ray,ruit,scar,scrambling,sessile,several,short,side,slender,spaced,spreading,tamen,tapering,tip,toward,trichome,tube,unarmed,unit,usually,vary,way,ympodial,youngest	abaxial,adaxial,arrangement,branching,colour,corolla,distribution,feature,form,fruit,green-brown,growth,height,history,life,na,number,opening,ovary,plant,position,rachi,reproduction,seed,shape,spacing,staman,stigma,texture,width
678	wfo-0001030982	success	215	102	82	133	20	0.381	.1,.5,0.05-0.5,0.1-0.15,0.2-3,0.5-0.9,0.5-1,1,1.5,1.5-2,3-8,4-5,6-8,acuminate,acute,anther,anthesi,apex,broadly,brown,brownish,bud,calyx,capitate,closely,cm,conic,conical,corolla,cucullate,dark,diameter,dry,drying,ellipsoid,filament,flattened-reniform,fleshy,flower,form,fresh,fruit,glabrous,globose,green,greenish,growth,later,leaf,lobed,material,maturity,minutely,mm,opposite,ovary,packed,pale,papillate,pedicel,peduncle,petiole,pitted,planar,plant,pubescent,reddish,rhizomatous,sagittate,seed,simple,stigma,style,subshrub,surface,trichome,tube,uniseriate,white,x,yellowish,young	-2-2.5,.2,0.05,0.1,0.3-2,0.5,0.5-3,1-1.5,1-8,1.5-3,2/3,3-21,4-12,abaxially,adaxially,age,angular,anisophyllous,ape,appressed,ba,base,beneath,berry,caducous,central,channelled,chartaceous,ciliate,cream,cuneate,curved,deflexed,deltate,differing,difoliate,distall,distally,distichou,eaf,edicel,eed,elliptic,enlarged,entire,exerted,extension,external,foliage,free,fruiting,geminate,glabrescent,glandular,glandular-papillose,golden-green,hilum,impressed,inconspicuously,internal,isostylous,larger,lengthening,less,like,live,lobe,long,lower,major,margin,materia,midvein,minor,mostly,near,new,nflorescence,oblique,obovate,occasionally,often,olive,one,ovate,overlappin,pair,papillae,papillat,papillose,pore,poricidal,portion,primary,projection,prominent,prominently,puberulent,reflexed,rest,revolute,ruit,scar,separated,shoot,sigmoidally,sinuate,situated,size,slightly,slit,somewhat,sparsely,stamen,stem,straight,stripe,strongly,testa,tetramerous,tightly,time,tip,transverse,tub,ud,unit,vegetative,vein,veined,way,weakly,ympodial	abaxial,adaxial,arrangement,color,colour,height,history,inflorescence,length,life,na,number,position,rachi,reproduction,shape,spacing,staman,texture,width
679	wfo-0001030989	success	177	121	99	78	22	0.559	0.5-1,1-1.5,1-10,12-15,3-20,3-4,3-7.5,4-5,4-7,4-8,5,6-6.5,9-10,abaxially,acuminate,adaxially,anther,apart,apex,axillary,base,berry,brownish,bud,cell,chartaceous,ciliate,cm,condition,conical,connivent,corolla,covering,decreasing,densely,diameter,distal,drying,end,filament,flower,forked,fresh,fruit,generally,glabrous,gradually,green,greenish,hair,hair-like,half,herb,homostylous,interjected,lanceolate,lateral,leaf,leaflet,light,like,long,margin,minute,mm,occurring,odd-pinnate,orbicular,ovate,ovate-lanceolate,ovoid,pedicel,peduncle,petiole,petiolule,plant,pubescent,ripe,rotate,seed,singly,size,sparsely,stem,stigma,style,subequal,subtending,symmetrical,terminal,testal,thick,toward,tuber,typically,usually,violet,wall,whitish	.5,1-2,15-27.5,2-3.5,3-5.5,5-merou,5.5-7.9,6-13,ag,alyx,apparently,articulated,axe,blade,capitat,digestion,dorsally,eaf,edge,eed,enzyme,erec,especially,flat,folded,geminat,glabrou,green-white,honeycomb-shaped,larger,lengthening,living,lobe,lower,make,mucilaginous,nflorescence,obtuse,orolla,pair,pale,perfect,plurifoliate,pore,poricidal,present,proximal,pubescen,ray,removed,ruit,secondary,semierect,seudostipule,slit,spaced,specimen,ste,stolo,subsessile,tall,tamen,tem,thir,throughout,tip,tri-,triangular,tube,unit,unwinged,vary,wet,wide,wider,x,yellow,ympodial	5-merous,arrangement,capitate,color,form,growth,height,history,inflorescence,length,life,number,occurrence,ovary,perennial,pseudostipule,shape,spacing,staman,stolon,surface,texture
680	wfo-0001030991	success	204	129	100	104	29	0.49	0.5-1,0.5-1.5,0.7-1.2,1-1.5,1-1.6,1-2.2,1-2.5,3-5-lobed,4-10,9-11,abaxially,absent,acuminate,acute,along,angled,anther,apex,apparently,appressed,ascending,attenuate,base,berry,brown,bulbous,capitate,cm,color,corolla,densely,diameter,elliptic,enlarged,entire,filament,filiform,flattened,flower,fruiting,furcate,glabrous,globose,grey,growth,herb,inflorescence,lanceolate,lateral,leaf,leaf-opposed,lobed,margin,minutely,mm,narrowly,nearly,occasionally,packed,particularly,pedicel,peduncle,pendant,petiole,pinnatifid,pitted,pubescent,red,reniform,ripe,scar,scattered,shiny,short,shrub,simple,slightly,small,sparsely,stellate,stem,stigma,style,suffrutescent,surface,terminal,thin,tightly,tip,trichome,uniformly,uniseriate,variably,violet,weight,white,winged,woody,yellowish,young	.5,0,0.1,0.2,0.2-0.7,0.3-0.4,0.5,0.5-0.7,0.5-3.5,0.6-0.8,1-7,1.5,10-20,2-plurifoliat,2.5-10,2.5-3,2/3,3-,5-5.5,5-merou,<,adaxiall,adaxially,ag,alyx,anthesi,arising,ark,articulated,basal,calyx,cell,conical,connivent,different,distally,drying,eaf,eed,ellipsoid,ellipsoidal,elongate,exerted,eye,free,frui,fusiform,glabrescen,ilament,incised,leave,lengthening,less,like,lobe,long-triangular,loosely,lower,midrib,minute,new,nflorescence,nodding,often,older,orolla,outline,pair,papillo,part,per,perfect,pericarp,platfor,pointing,pore,poricidal,portion,primary,pseudoumbel,rectangular,reflexed,rest,rootstoc,ruit,shallowly,sleeve,slit,somewhat,spreading,strongly,tangled,tem,testal,tube,twinin,ud,unit,upper,vary,vein,weak,x,ympodial	3-5.5,5-merous,abaxial,adaxial,angle,arrangement,bark,colour,form,fruit,glabrescent,height,history,length,life,na,number,ovary,plant,platform,position,rachi,reproduction,seed,shape,spacing,staman,texture,width
681	wfo-0001031005	success	231	132	117	114	15	0.506	.5,/3-1/2,0.1,1-1.5,1-2,1-2.5,1-3,1.5-4,2-3.2,2.3-3,2.5,3-4,3-6.5,5-7,abaxial,abaxially,accrescent,acuminate,acute,adaxially,almost,anther,anthesi,apex,apically,attenuate,bark,base,berry,black,blue,branch,branching,brown,calyx,capitate,chartaceous,clearly,clustered,cm,common,conical,corolla,cupular,dendritic,detaching,diameter,dilated,domatia,drying,elliptic,elongated,evenly,eye,fertilisation,fine,flat,flattened,flexuous,form,fruit,fruiting,glabrous,greenish,lateral,leaf,length,liana,longitudinally,main,membranous,midvein,mm,naked,network,obovate,occasional,often,orange-brown,ovoid,pair,pedicel,peduncle,pendulous,pericarp,petiole,pointed,primary,prominent,pubescent,purple,rachi,raised,ridged,short,slender,sometimes,somewhat,soon,sparsely,stem,stigma,strongly,style,surface,terete,terminal,tertiary,thin,trichome,unarmed,usually,vein,venation,visible,white,x	.4,0-0.5,0.3-0.5,0.5-1.5,0.8,0.9,1,1.5-2.5,10,2.5-4,3-10,4-6,5,5-8,5°,6-12,age,along,alyx,apar,apparently,articulated,brachyblast,branched,clum,concolorous,curved,dark,datum,deeply,delineated,deltoid,dendritic-pubescent,denser,density,developing,discolorous,divided,eaf,ellipsoi,entire,equal,extending,filament,flower,forming,free,immature,increasing,inside,junction,known,leave,lengthening,like,linear,lobe,lobed,long,loop,lower,m.,margin,minute,much,nflorescence,nther,oblong,obscure,occasionally,older,onl,orolla,ou,outside,ovate,perfec,plurifoliat,pore,poricidal,portion,protruding,ray,region,rest,ruit,scar,secondary,seed,side,simple,smaller,smoot,smooth,spread,spreading,standing,stump,surrounding,tangling,tearing,thick-chartaceous,tip,toward,tube,ud,uneven,unit,vary,weakly,well-developed,wide,ympodial,young	accrescence,adaxial,apart,arrangement,color,growth,inflorescence,number,ovary,presence,shape,spacing,texture,thicknes,ye
682	wfo-0001031007	success	207	127	110	97	17	0.531	.5,0.2,0.5-10,1,1-1.5,1-3.5,1.2-1.5,1.5-2,1.6-2,1.9-3,15,4-6,4.5-5,5,6,7-10,<,alfway,almost,along,anther,base,berry,bifid,black,branched,brown,c.,calyx,capitate,cell,clustered,cm,completely,corolla,dark,dendritic,densely,diameter,drying,dull,elliptic,entire,extending,filament,flattened-reniform,flower,fruit,fruiting,glabrous,globose,growth,herbarium,inflorescence,irregularly,lamina,lax,lilac,lobe,lobed,long,loose,lower,many,margin,matte,minutely,mm,narrowly,new,occasionally,often,outline,papillate,pedicel,peduncle,peg,per,petiole,pitted,prominent,pubescent,reddish,revolute,round-rectangular,scar,shrub,sleeve,spaced,sparsely,specimen,stellate,stellate-pentagonal,stem,stigma,style,surface,tangled,testal,time,tip,trichome,tube,upper,usually,vein,vine,woody,x,yellow	0.5,0.5-1,0.75-1.5,1-1.2,1.3-,1/3,11-14,2.5-,2.5-5,3-4,4-7,5-12,5-merou,5.5-6,50-100,8-10,abaxiall,abruptly,acute,ag,alyx,anthesi,apar,apex,apparently,ark,articulated,becoming,beginning,branching,broad,broadly,campanulate,chartaceous,connivent,cuneate,cup-shaped,deltate,dilated,eaf,eed,ellipsoid,exserted,fleshy,free,geminat,glabrescen,glabrou,ilament,impressed,intramarginal,junction,leaving,lengthening,looping,loosely,m.,markedly,midvein,multi-celled,narrowing,near,nflorescence,nodding,older,orolla,pale,papillat,perfect,pericarp,planar,plurifoliate,pore,poricidal,portion,primary,rat,ruit,sagittate,shiny,simple,slender,slightly,slit,splitting,spreading,stout,strongly,terminal,thin,tiny,twining,ud,unit,vary,way,ympodial	5-merous,apart,bark,color,form,glabrescent,height,leaf,length,number,ovary,paler,plant,seed,shape,spacing,texture
683	wfo-0001031007	success	206	143	114	92	29	0.553	.5,0.5-1,0.5-10,0.75-1.5,1,1-1.2,1-1.5,1-3.5,1.2-1.5,1.6-2,1.9-3,15,4.5-5,5,50-100,6,7-10,acute,adaxial,alfway,along,anther,apex,bark,base,berry,bifid,black,branched,broad,brown,c.,calyx,capitate,cell,chartaceous,clustered,cm,corolla,cuneate,dendritic,densely,diameter,dull,elliptic,entire,extending,filament,flattened,fleshy,flower,fruit,fruiting,glabrous,globose,growth,impressed,inflorescence,irregularly,lamina,lax,lilac,lobe,lobed,long,loose,many,margin,matte,minutely,mm,narrowly,new,occasionally,often,outline,papillate,pedicel,peduncle,peg,petiole,pitted,prominent,pubescent,reddish,reniform,revolute,round-rectangular,scar,shrub,simple,sleeve,slender,spaced,sparsely,stellate,stellate-rotate,stem,stigma,stout,style,surface,tall,tangled,terminal,testal,thin,time,tip,trichome,usually,vein,vine,woody	0.2,0.5,1.3-,1.5-2,1/3,11-14,2.5-,2.5-5,3-4,4-6,4-7,5-12,5-merou,5.5-6,8-10,<,abaxially,abruptly,ag,almost,alyx,anthesi,apar,apparently,articulated,becoming,beginning,branching,broadly,campanulate,completely,cup-shaped,dark,deltate,dilated,drying,eaf,eed,ellipsoid,exserted,free,glabrescen,glabrou,herbarium,ilament,intramarginal,junction,leaving,lengthening,looping,lower,m.,markedly,midvein,multi-celled,narrowing,near,nflorescence,nodding,older,orolla,pale,papillat,per,perfect,pericarp,planar,plurifoliat,pore,poricidal,portion,primary,rat,ruit,sagittate,shiny,slightly,slit,specimen,splitting,spreading,strongly,tiny,tube,twinin,ud,unit,upper,vary,way,wide,ympodial	5-merous,abaxial,apart,arrangement,color,colour,feature,form,glabrescent,height,history,leaf,length,life,na,number,ovary,paler,perennial,plant,position,rachi,reproduction,seed,shape,spacing,staman,texture,width
684	wfo-0001031022	success	287	68	50	237	18	0.174	.04,12.9,14.9,anther,apiculate,appearing,base,black,calyx,capitate,caudate,cm,corolla,cream,diameter,dry,evenly,flattened-reniform,flower,fruit,glabrous,glandular,globose,green,hair,interpetalar,leaf,length,lobe,long,mature,mm,nearly,pedicel,peduncle,petiole,poorly,purple,short,stellate,stigma,style,tip,tissue,truncate,vein,well-developed,white,yellow,yellow-tan	0.1,0.2–0.3,0.2–0.9,0.3–0.6,0.3–0.8,0.4–0.5,0.4–1.2,0.4–1.3,0.5–1.4,0.5–1.5,0.5–2.2,0.5–5.8,0.6–1.0,0.6–1.2,0.6–1.6,0.6–2.4,0.6–2.6,0.7,0.7–1.7,0.8–1.2,0.8–1.3,0.8–2.9,0.8–3.4,0.9–1.9,1.0–2.6,1.0–4.5,1.1–3.4,1.1–8.3,1.2–2.3,1.2–2.6,1.4–4.0,1.5–2.5,1.6–4.8,1.8–12.1,1.9–2.8,1/3,1/4,1/4–1/3,10,10.5,17–145,2.3–3.1,2.8–6.3,2/3,3.2–4.9,3.2–7.0,3.8,3.9–6.5,4.5–21.9,4–6-merou,4–9,5.1–8.7,5.8–11.4,5–7,5–8,6.9,6–10,8.2,8.8,8.9,90°,abaxially,absent,acuminate,acute,adaxially,adnate,aequilateral,along,alyx,anthesi,apart,apex,apical,apparently,appressed,arching,arcuate,area,around,articulate,attenuate,axe,ba,bark,basal,becoming,bent,berry,blade,branch,broad,brochidodromous,brown,bud,bulge,central,channeled,chartaceous,clinate,crea,cuneate,deciduous,densely,dentate,development,difoliate,directed,directly,distal,distally,distinct,eaf,edge,eed,either,emerging,endocarp,entire,erect,exocarp,extending,extra-axillary,ferruginous,fertile,filament,filiform,forking,free,geminat,glossy,gradually,heterostylous,immature,increasing,intac,internode,intersepalar,juic,lanceolate,large,lateral,layer,less,lobed,lon,longer,lower,major,many,margin,markedly,midpoint,midrib,midvein,minor,minute,moderately,nflorescence,oblique,opaque,opposed,orolla,oval,ovate,ove,per,perforated,pore,porrect,portion,potentially,pubescent,raised,ray,reddish,reflexe,remaining,reticulate,ridge,rigid,rounded,row,ruit,semicraspedodromous,sessile,several,shorter,shrub,side,simple,sinus,sloughing,small,smooth,sometimes,spaced,sparsely,splitting,spread,spreading,stellae,stellate-pubescent,stem,stipe,stipitate,straight,surface,suture,tamen,tardily,tem,terete,thin,time,toward,transparent,tree,tube,two,ud,unarmed,unbranched,unit,upper,various,vary,weakly,well,wide,yellow-ferruginous,ympodial,young,±90°,±equal,±glabrous,×	0.3-0.6,0.5-5.8,0.6-1.0,0.6-1.6,0.6-2.4,0.8-1.2,0.8-3.4,0.9-1.9,1.1-8.3,1.2-2.3,1.4-4.0,1.9-2.8,2.3-3.1,color,inflorescence,ovary,seed,shape
685	wfo-0001031036	success	150	72	58	92	14	0.387	.25,0.8-1,0.8-1.2,1-2.5,1.2-1.5,1.5-3,10-20-flowered,2-2.5,3-5,5-6,acuminate,acute,anther,apex,base,bi-lobed,brown,cm,corolla,crisped,dark,decurrent,elliptic,filiform,flattened-reniform,glabrous,globose,green,greenish-white,leaf,lobed,margin,minor,minutely,mm,oblique,older,ovary,pedicel,petiole,pitted,pore,sagittate,shaped,shiny,simple,slightly,stem,stigma,style,surface,tapering,tear-drop,trichome,uniseriate,winged,x,young	.2,.5,0.5-1,1-1.3,12-15,2.2-3.7,3-4,3.5-5.5,4.5-6.5,7-8,abaxially,adaxially,along,angle,anthesi,arising,axil,ba,becoming,berry,broadly,calyx,closely,conical,deflexed,dia,differing,difoliate,dry,drying,eaf,edicel,eed,ellipsoid,enlarged,erect,exserted,filament,fleshy,free,fresh,fruiting,geminat,knob-like,lamina,lateral,lobe,lon,long,lower,main,major,material,middle,nearly,nflorescence,onto,opposite,overlappin,pair,papillo,papillose,perhaps,planar,pointed,poricidal,portion,rounded,ruit,scar,short,shrub,sinus,size,soon,spaced,spathulate,strongly,tall,thickened,tip,tub,tube,ud,unit,usually,vein,white,widest,woody,yellowish,ympodial	abaxial,adaxial,color,diameter,flower,fruit,height,inflorescence,length,number,plant,seed,shape,texture
686	wfo-0001031040	success	217	121	79	138	42	0.364	.5,6,abaxially,acuminate,acute,adaxially,age,anther,apart,apex,base,branch,broadly,cm,deeply,diameter,dull,entire,filament,flattened-reniform,flower,flowering,fruit,glabrous,globose,green,hair,inflorescence,lanceolate,lateral,lavender,leaf,lighter,longer,major,margin,midpoint,midvein,minutely,mm,narrowly,older,ovate,pedicel,peduncle,petiole,pinnatifid,pitted,plant,purple,rarely,ray,recurved,rounded,scabrous,sessile-stellate,shape,short,shrub,side,simple,slightly,small,somewhat,sparsely,sprout,stellate,stigma,straight,style,surface,tree,triangular,vein,vigorous,violet,white,yellow,yellow-brown	0.1–0.3,0.2–0.6,0.3–3,0.8–7.5,1.2–1.3,1.2–2.1,1.4–2.7,1.5–4,1.5–5,1.7,1.7–3.1,10,10–10.5,10–13,12–14,15–23,1–1.4,2,2.2–2.5,2.4–3,2.5–4,2.5–9,2–10,2–5-branched,3,3.5–5,3–26,3–4.5,3–5,4–6,5,5-merou,6.5–25,6–6.5,6–8,7–9,8–30,accrescent,adaxiall,also,alyx,anthesi,apical,apparently,articulated,attenuate,axe,ba,becoming,berry,blade,broad-based,calyx,capitat,contrasting,dark,densely,depending,difoliate,directed,distall,eaf,eed,either,especially,filiform,finely,free,geminat,glabrescent,glabrou,gland-tipped,glandular,highly,homostylous,immature,internode,interpetalar,larger,like,lobe,lobed,lon,long,lower,midzone,minute,much,nflorescence,numerous,orolla,outside,ovoid,pale,perfect,persistent,pore,porrect,prickle,principal,probably,ruit,scarcely,sessile,several-celled,similar,size,sometimes,soon,spaced,sparse,splitting,stellae,stellate-pubescent,stem,subcordate,subcoriaceous,tamen,tem,thickened,time,tissue,triangular-attenuate,tube,turning,ud,unarmed,unit,upward,usually,variable,vary,vigor,wide,yellowish-tawny,ympodial,×,–6	0.1-0.3,0.3-3,0.8-7.5,1.2-1.3,1.5-4,10-10.5,12-14,15-23,2-10,2-5-branched,2.4-3,3-5,4-6,5-merous,7-9,8-30,abaxial,adaxial,arrangement,capitate,color,colour,corolla,form,growth,height,history,length,life,na,number,ovary,perennial,position,rachi,reproduction,seed,spacing,staman,texture,width,x
687	wfo-0001031062	success	216	117	78	138	39	0.361	-5.5,0.5,1,2,2-3.5,20,3-8,?,absent,acute,anther,apart,apex,articulated,base,bud,chartaceous,cm,colored,cuneate,densely,diameter,entire,extra-axillary,ferruginous-tomentose,filament,flattened-reniform,flower,forked,foveolate,fruit,fully,glabrous,globose,green,hair,leaf,lighter,lobe,loosely,margin,midpoint,minutely,mm,ovate-lanceolate,partially,pedicel,pentagonal,per,perhaps,petiole,plant,rachi,ripe,rotate-stellate,sessile,shallow,shape,short-stalked,side,simple,sometimes,sparsely,stellate,stellate-tomentose,stem,stigma,style,surface,tomentose,treelet,truncate,unbranched,visible,white,wide,x,yellow	.5,0,0.3,0.5–0.6,0.7–0.8,1.2–1.4,1/3,13–15,15,16,17,1–2.5,1–4,2.5,22,2–3,2–5.5,3,3–10,4,4–10,4–4.5,5,5–7-rayed,7,7–15,7–8-rayed,9–11,abaxially,accrescent,adaxiall,adaxially,ag,ample,apiculate,appearing,armed,axe,ba,blade,bottom,branch,brownish,calyx,campanulate,capitat,clustered,connivent,count,curved,cylindrical,diamete,difoliate,directed,distally,eaf,eed,even,eventually,except,fertile,fragrance,fruiting,geminat,glabrou,grading,heavily,ilament,interpetalar,juvenile,larger,lateral,least,less,lobed,long,longitudinal,lower,m.,main,midrib,much,nearly,nflorescence,numerous,obscuring,obsolete,often,one,opening,orolla,overtopped,part,perfect,pore,prickle,pubescent,rarely,recurved,rest,ruit,scabrous,short,shub,size,slightly,slit,small,spaced,sprout,stellae,stipitate,straight,sweet,tall,tapered,tem,terminal,thick,thick-based,tip,tissue,toward,triangular,tube,unarme,unarmed,unifoliate,uniform,unit,uppermost,usually,vary,vigorous,ympodial,young,younger,–3	0.7-0.8,1-2.5,1-4,13-15,2-3,2-5.5,3-10,4-4.5,7-8-rayed,9-11,abaxial,adaxial,arrangement,capitate,color,colour,corolla,form,growth,height,history,inflorescence,length,life,na,number,ovary,peduncle,position,presence,present,reproduction,seed,shrub,spacing,staman,texture,visibility,width
688	wfo-0001031064	success	179	106	79	100	27	0.441	0,0.5,0.5-0.7,0.5-0.8,1-2,1-3,1.2,10-12,2.5-3,3.5-4,5-6,anther,anticlinal,apex,attenuate,bright,calyx,cell,cm,completely,conical,corolla,dark,densely,diameter,elongate,epidermal,exserted,filament,flower,fruit,glabrous,globose,green,highly,inflorescence,irregular,leaf,leaflet,lightly,lobed,minutely,mm,nodding,node,obovate,occasionally,ovary,ovate,ovoid-reniform,papillate,pedicel,per,petiole,petiolule,pinnate,projection,pubescent,purple,rachi,rugose,scattered,shrub,simple,sinuous,somewhat,sparsely,stem,stigma,strongly,style,surface,swollen,thickening,trichome,tube,uniseriate,white,without	.0-2.5,.05,.5,.5-1,0-15,1,1-1.2,1.5-2,1.7-4.2,10-12.5,10-17,2,3,3-5.5,3-7,4-5-celled,5-10.5,6-16,7-16,8-10-celled,abaxially,acroscopic,acuminate,adaxially,along,anthesi,arising,axil,basal,base,bearing,berry,blade,broader,clavat,commentary,conspicuous,deltate,denser,distal,dr.,eaf,edicel,eed,erec,fleshy,free,fruiting,half,irregularly,lamina,lateral,leave,lenticel,like,lobe,lon,long,lost,lower,margin,minute,narrower,near,nearly,nflorescence,often,open,pair,planar,poricidal,portion,prominent,pubescen,ruit,scar,see,short-pubescent,side,single,sinus,slender,smaller,splitting,tal,tem,terminal,time,tip,translucent,tub,ud,unifoliat,unit,usually,vein,wand-like,winged,x,ympodial	abaxial,adaxial,arrangement,axillary,bud,clavate,color,colour,form,growth,height,history,length,life,na,number,peduncle,perennial,plant,position,reproduction,seed,shape,spacing,staman,texture,width
689	wfo-0001031065	success	140	99	73	67	26	0.521	1-celled,2,4-merous,5-merous,acicular,aculeate,acuminate,acute,almost,anther,apex,asymmetrical,base,beyond,chestnut,cm,color,corolla,dense,eglandular,entire,extra-axillary,filament,flower,fruit,glabrous,glandular,green,green-striate,held,herb,indumentum,light,lilac,lobed,lower,margin,mm,non-glandular,nonglandular,occasionally,ovary,ovate-lanceolate,ovoid,pale,pedicel,peduncle,per,petiole,puberulous,rare,rarely,rough,rounded,scabrid,simple,slightly,sometimes,sparse,spheroid,spine,stellate,stem,stigma,style,subshrub,surface,terete,trichome,umbelliform,unit,upper,white	.1–0.3,.2,.3,.4,.5–2,.6,0.2–1.1,0.5–1.6,0.5–5,0–30,1,1-,1.8–7.8,4,accrescent,also,alyx,apical,apparently,armed,attenuate,berry,calyx,cell,celled,central,composed,concolorous,deltate,dia,difoliate,eaf,eed,either,erect,externally,ferruginous,frui,geminate,lamina,lateral,lobe,many,many-celled,midpoint,midvein,multi-celled,narrowly,nflorescence,orolla,perfec,perhaps,persistent,porrect-stellate,portion,radial,ruit,sessile,shor,short,short-pedunculate,solitary,tall,unifoliat,usually,x,ympodial	0.1-0.3,0.2,0.2-1.1,0.3,0.5-1.6,0.6,11,20-30,5,8,arrangement,composition,density,diameter,form,growth,height,inflorescence,leaf,length,number,plant,position,seed,shape,texture
690	wfo-0001031071	success	186	118	90	96	28	0.484	0-10,0.2-0.8,1-2,2-5,2.1-3,2.4-3.4,3-10,3-5,4-25,4-6,6-8,8-28,abaxially,acute,adaxially,along,anther,apex,attenuate,base,bead,blue,brownish,cell,clavate,cm,color,condition,coriaceous,corolla,covering,dark,decreasing,deep,diameter,drying,elliptic,filament,flower,forked,fresh,fruit,glabrous,globose,green,greenish,hair-like,herb,interjected,lateral,leaf,leaflet,like,lilac,medium,mm,moniliform,necklace,odd-pinnate,orbicular,ovate,ovoid,pair,pedicel,peduncle,pentagonal,petiole,plant,plurifoliate,purple,rotate,round,seed,size,spot,star,stigma,stolon,style,terminal,testal,thick,toward,tri-,tuber,unit,wall,white,whitish,yellow	0.4-2,1-1.5,1-3,1-7,1.5-2.2,2-3,2-8,3-6,3.8-5.4,5-9.4,5-merou,5.7-8.8,7-16.5,7-8,abaxiall,acumen,ag,alyx,apart,apparently,arranged,articulated,asymmetric,axe,axillary,basiscopic,berry,blade,bud,capitat,connivent,digestion,distal,dorsally,eaf,edge,eed,enzyme,erec,exceeding,flat,folded,geminat,generally,glabrou,green-white,half,homostylous,honeycomb-shaped,lanceolate,lengthening,living,lobe,long,lower,make,middl,mottled,mucilaginous,multiple,narrowly,nflorescence,orolla,perfect,petiolulate,pore,poricidal,removed,ripe,ruit,sessile,seudostipule,short,side,slightly,slit,spaced,specimen,stamen,straight,subequal,subtending,tall,tamen,tem,throughout,tip,tissue,tube,typically,usually,vary,wet,winged,x,ympodial	abaxial,adaxial,arrangement,capitate,colour,form,growth,height,history,inflorescence,length,life,na,number,ovary,perennial,position,pseudostipule,rachi,reproduction,shape,spacing,staman,surface,sympodial,texture,type,width
691	wfo-0001031097	success	174	135	104	70	31	0.598	0.45,1,1-4,1-4.5,1.6-5.5,1.8-2.6,13-30,2-3.3,2-4,3-5,3.5-6,3.7-8.4,4-6,4-7,5-11,8-11,abaxially,acuminate,acute,adaxially,apex,apical,articulate,base,branched,cell,cm,corolla,covering,cyme,darker,deep,diameter,dichasial,dichasially,digestion,diminishing,distal,dotted,ebracteate,elliptical,enzyme,exceeding,filament,flower,green,green-white,hair-like,half,herbaceous,honeycomb,interjected,introrse,lateral,leaf,leaflet,light,lighter,medium,mm,monochasial,mottled,mucilaginous,obovate,odd-pinnate,ovate,ovoid,pattern,pedicel,peduncle,pentagonal,perennial,petiole,plant,proximal,puberulent,pubescent,purple,rapidly,rarely,rotate,seed,short,size,slit,stamen,stigma,strigose,style,terminal,testal,thick,throughout,toward,tuber-bearing,typically,unit,vbase,violet,violet-blue,wall,wide,yellow,¼	0.5,1-3,1.5,1.8-2.5,2-3,3-6-foliat,5-12,5-9,9-21,abaxial,acumen,along,apically,calyx,connate,cuneate,decurrent,dehiscent,dorsally,eaf,edge,eed,emoval,flat,folded,forked,frequently,generally,globo,gree,highly,interpetalar,living,lobe,lon,long,lower,lunat,make,margin,maturing,narrow,nflorescence,noticeably,nther,oblique,often,orolla,pair,perfect,petal,petiolulate,petiolule,plan,poricidally,rachi,reveal,ruit,sessile,seudostipule,side,sometimes,specimen,straight,tal,tem,tissu,vary,without,ympodial	2,3-6-foliate,anther,arrangement,color,form,fruit,globose,growth,height,history,inflorescence,length,life,lunate,na,number,ovary,position,pseudostipule,removal,shape,spacing,staman,stem,surface,sympodial,texture,wet,width,ye
692	wfo-0001031101	success	197	135	108	89	27	0.548	-5,-8,/2,0.1-0.2,0.3-0.5,0.5-0.8,0.5-3,0.8-,1-2,1-2.3,1-3,1.3-2,1.3-2.5,1.4-1.7,1/4-1/2,10-30,2-6,3-15,3.5-4.5,4-5-merous,4.5-9,5-6,abaxial,abaxially,acuminate,adaxial,almost,anther,apex,apical,articulated,bark,base,berry,bright,calyx,cm,diameter,dull,elongating,entire,erect,filament,filiform,flattened-reniform,flower,fruiting,glabrescent,glabrous,glandular,green-brown,hair,herbaceous,lateral,leaf,length,lobe,lobed,long-acute,margin,maturity,mauve,membranous,minute,mm,moderately,multangulate,obtuse,orange-brown,orange-red,ovate,pair,pale,pedicel,peduncle,pendulous,petiole,porrect,primary,red,rounded,scandent,sessile,shrub,simple,sparsely,spherical,stalked,stellate,stellate-pubescent,stem,straight,style,surface,terete,terminal,tertiary,trichome,umbel,unarmed,variously,vein,venation,visible,way,white,yellow,yellow-green	-1,-16,-20,-30,/2-equal,0.05-0.2,0.1-0.3,0.6-0.8,0.7-0.8,1-,1.5-3,1/3-1/2,2-2.8,2-4,2-5,2.5-,2.5-3.5,2.5-3.8,3-10,3-8,4-10,4-7,5-20,6-10,8-15,alyx,ame,apar,apically,apparently,ba,blade,branched,c.,concolorous,connivent,deltate,difoliate,drying,eaf,eed,equal,evenly,free,frui,geminat,green,infructescence,long,long-acuminat,longer,lower,mature,midpoint,narrow-deltate,near,nflorescence,often,older,one,open,orolla,oung,per,perfec,pericarp,poricidal,portion,ray,red-brow,resembling,ruit,scar,smooth,spaced,spreading,stalk,stellate-pubescen,tamen,tapering,time,tip,tube,unarme,unit,vary,wide,ympodial,young	apart,arrangement,color,colour,corolla,form,fruit,growth,height,history,inflorescence,life,na,number,ovary,plant,position,rachi,red-brown,reproduction,seed,shape,spacing,staman,stigma,texture,width
693	wfo-0001031114	success	208	128	100	108	28	0.481	.2,0-0.3,0.5,0.5-1,0.8-1.2,1-10,1-7,1-8,1.5-4,2-3,25-50,3-10,4-10,4-5,4.5-6,5-10,6-7,abaxially,acuminate,acute,adaxially,anther,apex,base,becoming,blade,branched,brown,chartaceous,cm,dark,densely,diameter,elliptic-ovate,entire,erect,especially,filament,first,flattened,flower,fruit,glabrous,globose,green,hair,homostylous,impressed,leaf,leaf-opposed,light,major,margin,membanaceous,midpoint,minor,mm,multangulate,nearly,nodding,outline,ovate,pedicel,peduncle,petiole,porrect,prominent,pubescent,purple,rachi,ray,reniform,ripe,rounded,rugulose,short,shrub,side,simple,small,sparsely,stellate,stellate-pubescent,stem,stigma,strongly,style,subcoriaceous,subcuneate,surface,thickened,toward,tree,truncate,vein,white,white-pubescent,x,yellow,yellowish	.1,.5,0.3-0.5,0.7-1.5,1-1.5,1-2,1-4.5,1.5-2.5,10-15,2-17,2-4,2-7,2.5-3,2/3,3-4,3-5,3-7,4-8,5-8,5-merou,7-15,absen,accrescent,adaxiall,ag,alyx,apart,apparently,articulated,axe,ba,berry,calyx,capitat,connivent,covering,cylindrical,deltate,differentiated,directed,discolorous,distal,distally,dried,eaf,echinoid,eed,equal,fleshy,free,frui,fruiting,geminate,highly,interpetalar,introrsely,juic,lacking,large,like,lobe,long,long-stalked,longitudinal,lower,nflorescence,oblong,obtuse,often,one,opening,orolla,paired,part,perfect,pericarp,plurifoliate,pore,ruit,sessile,short-,short-stalked,slightly,slit,somewhat,spaced,stalk,ste,straight,subcucullate,subtending,tall,tamen,tem,thin,time,tip,tissue,triangular,tube,unarme,unit,vary,white-stellate,whitish,wide,without,ympodial	5-merous,abaxial,absent,adaxial,arrangement,capitate,color,colour,corolla,form,growth,height,history,inflorescence,length,life,na,number,ovary,plant,position,reproduction,seed,shape,spacing,staman,texture,width
694	wfo-0001031116	success	191	158	130	61	28	0.681	-10,.2,.5,.8,/4,0,0.05-0.15,0.3-0.5,0.4-0.7,0.7-0.9,1,1-5,1/2,1/6-1/4,2-5,3.5-4,30-100,4-10,4-7,5-15,5-merous,8-11,abaxial,abaxially,acuminate,adaxial,ame,anther,apart,apex,apparently,arachnoid,articulated,attenuate,bark,base,berry,blade,branching,bristle,c.,calyx,caudate,clearly,cm,collapsed,densely,diameter,dirty-white,discolorous,drying,dull,elliptic,elongated,epidermi,erect,evenly,filament,flat,flattened-reniform,flexuous,flower,fragile,fruit,fruiting,glabrescent,glabrous,glaucous-green,green,lateral,leaf,length,less,lobe,lobed,long,margin,mature,maturity,mauve,membranous,midpoint,mm,moderately,multangulate,narrow-deltate,obovate,obtuse,orange-brown,orange-red,pedicel,peduncle,perpendicular,petiole,primary,ray,recurved,red-brown,reflexed,rounded,secondary,sessile,sharply,shortly,shrub,simple,small,smooth,soft,sometimes,sparsely,spherical,stalked,stellate,stellate-pubescent,stem,straight,style,subentire,surface,terete,tree,trichome,upper,visible,way,weakly,wide,yellow,young	0.1,0.7-1,1/3-2/,10-14,15-25,2.7-3.2,30-50,5,9-13,almost,alyx,apar,apically,broad-deltate,brow,connivent,eaf,eed,elongating,equal,free,hair,infructescence,longer,lower,minute,nflorescence,obtu,often,older,one,open,orolla,oung,pair,per,perfec,pericarp,plurifoliat,poricidal,portion,ruit,scar,single,slender,spaced,stalk,tamen,tapering,tertiary,time,tip,tube,unarme,unarmed,unit,vary,vein,venation,woody,ympodial	arrangement,brown,color,colour,corolla,form,growth,height,history,inflorescence,life,na,number,ovary,perfect,plant,position,proportion,rachi,reproduction,seed,shape,spacing,staman,stigma,texture,visibility,width
695	wfo-0001031127	success	196	117	94	102	23	0.48	+,0.4-1.5,0.5,0.5-1,0.5-1.3,0.8-2,1-1.5,1.5-2,1.5-2.5,2,2-lobed,3-5,3.5-4,30-100,6-6.5,7-30,abaxially,acicular,acute,adaxially,almost,anther,apex,bark,brown,calyx,capitate,chartaceous,cm,conical,corolla,cupuliform,deep,densely,diameter,ellipsoid,elliptic,filament,flattened,flower,fruit,fruiting,glabrous,globose,growth,inflorescence,internodal,lanceolate-elliptic,leaf,lobed,long-styled,margin,membranous,midrib,minutely,mm,new,number,opposite,ovary,pale,pedicel,peduncle,pentagonal,petiole,pinnatifid,pitted,porrect,prickle,pubescent,purple,ray,red-violet,reddish,relatively,reniform,shallowly,shiny,short-styled,shrub,simple,somewhat,sparsely,stellate,stem,stigma,stout,style,surface,tan,thin,trichome,x,yellowish	-2,.5,0.3-0.4,0.5-3,0.8-1,1,1-5-2,1.5-3,12268,2-3,3-4,3.5-7,3/4,4,5,5-8,8,8-16,?,anthesi,apar,apparently,armed,articulated,attenuate,base,berry,cell,eaf,eed,ekman,elongate,elongating,equal,even,extremely,fide,free,heterostylous,hyaline,included,individual,lamina,like,linear,lobe,long,long-triangular,lower,m.,midpoint,minute,near,nflorescence,nodding,older,open,outline,pair,papillat,per,pericarp,planar,plurifoliat,pore,poricidal,portion,prickly,primary,prominent,rectangular,reduced,rest,ruit,scar,scattered,sessile,shin,short-stalked,sinuate,sinus,slightly,slit,sometimes,spaced,spreading,tapering,testal,time,tip,tube,ud,unit,upper,variable,vein,way,widely,woody,yellow,ympodial,½	abaxial,adaxial,apart,arrangement,bud,color,colour,form,height,history,length,life,na,plant,position,rachi,reproduction,seed,shape,spacing,staman,texture,width
696	wfo-0001031128	success	213	102	81	132	21	0.38	-100,-4.5,-6.5,0.05-0.2,0.5-0.7,0.5-0.8,0.5-5,0.6-1,0.8-1.7,1,1-,1.5-3,2-5,2.3-,20-60,3-4,4-5-merous,5-19,8-12,abaxial,anther,apart,apex,bark,base,branched,brown,cm,cuneate,diameter,dull,elliptic,entire,erect,evenly,eye,filament,flattened-reniform,flower,fruit,glabrescent,green,inflorescence,lateral,leaf,length,less,lobed,long-acuminate,margin,mauve,membranous,mm,multangulate,naked,often,orange-brown,pair,pale,pedicel,peduncle,petiole,purple-black,red,red-brown,shallowly,short-attenuate,shrub,smooth,spherical,stellate,style,surface,terminal,trichome,undulate,vein,visible,white,yellow,yellow-green	-10,/4,0,0-30,0.05-0.25,0.2,0.2-0.4,0.3-0.8,0.5-1.5,1-1.6,1.2-2,1.5-3.5,1/,1/6-1/3,10-20,10-35,2-9.5,2.5-10,2.5-3.5,20-50,3.5-4.5,4-7,5-,5-15,5-30,8-23,abaxially,acute,almost,alyx,apar,ape,apically,apparently,articulated,berry,blade,branching,bristle,calyx,concolorous,connivent,deltate,densely,drying,eaf,eed,elongated,elongating,equal,filiform,flexuous,free,fruiting,glabrous,gland,glandular,gra,hair,infructescence,lobe,lon,long,long-acuminat,longer,lower,mature,maturity,midpoint,minute,moderately,multangualte,narrow-deltate,near,nflorescence,occasionally,older,one,open,orolla,oung,per,perfect,pericarp,perpendicular,plurifoliat,poricidal,portion,primary,ray,recurved,reduced,reflexed,ruit,scar,secondary,sessile,short-styled,side,simple,single,soft,spaced,spreading,stalk,stalked,staminate,stellate-pubescent,stem,straight,tamen,tapering,terete,tertiary,time,tip,tube,unarme,unarmed,unit,usually,variously,vary,venation,way,weakly,whitish,wide,woody,yellow-brown,ympodial,young	adaxial,arrangement,color,colour,corolla,form,gray,growth,height,na,ovary,plant,position,reproduction,seed,shape,spacing,staman,stigma,texture,visibility
697	wfo-0001031135	success	189	125	95	94	30	0.503	0.5-2,1-,1-1.5,1-10,1-3,1-4,1.5-2,1.5-3,1.5-9,10-20,2,2-,2-2.5,2-3,2-4,3-10,3-4,3-5,3.5-12,4-5,5-30,5-9-pinnate,abaxially,acuminate,adaxially,along,also,apart,apex,base,broad,calyx,campanulate,cm,color,compound,connective,darker,deflexed,deltate,densely,diameter,distally,eglandular-pubescent,ellipsoidal,especially,flattened,flower,frequently,fruit,fusiform,glabrous,glandular-,green,leaf,light,lobe,longitudinal,margin,midrib,mm,moderately,narrowed,oblong,obtuse,often,ovoid,papillose,pedicel,peduncle,peltiform,petiole,pilose,pinnatifid,puberulent,pubescent,rachi,radiu,remnant,ripe,shrub,simple,spaced,sparsely,stigma,stripe,style,toward,tree,unbranched,unlobed,violet,whitish,x,yellowish	-7,0-2,0.7-2,1-2.5,2-23,2-3.5,2-5,2.5-28,4-foliat,5-11,7-15,absent,acute,adpressed,aggregate,ape,articulated,axe,basal,basiscopically,beyond,biglandula,blade,cell,chartaceous,cordate,coriaceous,cuneate,cylindrical,decurrent,dilated,directed,eaf,eed,ellipsoida,elliptic,entire,equal,exceeding,exserted,fading,hair,interstitial,irregularly,lateral,laterally,leaflet,leaving,lobed,lon,long,lower,nflorescence,nther,obconical,oblique,occasionally,orolla,ovate,pedicellar,perfect,pilo,pink,pinnately,pore,present,purple,ruit,shorter,slightly,small,smaller,stamen,stone,strongly,subcoriaceous,tal,tem,thecae,time,tip,tomento,triangular,truncate,tube,ud,unit,unknow,upper,vary,white,wide,yellow-green,ympodial	abaxial,adaxial,anther,arrangement,biglandular,bud,colour,corolla,form,growth,height,history,inflorescence,length,life,na,number,ovary,perennial,plant,position,reproduction,seed,shape,spacing,surface,texture,theca,tomentose,width
698	wfo-0001031143	success	217	110	64	153	46	0.295	2.5,4,5,abaxially,acute,adaxially,anther,apart,apex,articulated,attenuate,base,broad-based,broadly,cm,densely,diameter,elliptic,evenly,extra-axillary,filament,filiform,finely,flattened-reniform,flower,fruit,glabrous,globose,green,interpetalar,lanceolate,lateral,leaf,length,midrib,midvein,minutely,mm,moderately,narrowly,nearly,ovate,pale,pedicel,peduncle,petiole,pitted,prickle,shrub,simple,smooth,stellate,stellate-tomentose,stem,stigma,straight,style,surface,tissue,well-developed,white,yellow,yellow-ferruginous,yellow-orange	0.3–0.5,0.3–0.8,0.4–0.8,0.4–1,0.7–0.9,0.9–1,0–50,1.1–2,1.4–1.7,1.5,1.5–1.9,1.5–2.5,1.5–3,1.5–5.5,10,10.5–11,15–23,1–1.2,1–1.5,1–4,2,2.3–2.5,2.5–4,2.5–4.5,2–2.5,2–3,2–3-branched,2–9,3,3–3.5,4–8-rayed,5-merou,5–7,6–8,7–12,8–10,9,acicular,alyx,apical,apparently,appearing,armed,axe,ba,berry,bifoliate,blad,blade,branch,broad,bud,capitat,contrast,dark,directed,distall,dried,eaf,eed,entire,except,fertile,forming,free,geminat,glabrescent,glabrou,hair,half,high,homostylous,immature,internode,irregularly,large,layer,leaving,like,lobe,lon,long,lower,major,margin,material,maturing,midpoint,midvei,minor,minute,mixed,mostly,much,near,nflorescence,oblong,often,orolla,overlapping,ovoid,per,pore,porrect,potentially,principal,rarely,ray,remaining,repand,ruit,sessile,set,several,shallow,short-caudate,shorter,side,sinus,slender,soon,spaced,splitting,stellae,stellate-tomento,stipe,stipitate,subcordate,tamen,tardily,tem,thick-chartaceous,time,tip,tomentum,truncate,tube,ud,unarme,unarmed,usually,various,vary,vein,weak,wide,ympodia,×,–11,–2.5,–4,–4.5,–8	0.3-0.8,0.9-1,1-1.2,1-1.5,1.1-2,1.5-2.5,1.5-3,10.5-11,2-2.5,2-3,2-3-branched,2.5-4.5,20-50,4.5,5-merous,6-8,8,8-10,abaxial,adaxial,arrangement,capitate,color,colour,corolla,form,growth,height,history,inflorescence,life,na,number,ovary,perennial,plant,position,rachi,reproduction,seed,shape,spacing,staman,texture,width,x
699	wfo-0001031144	success	231	126	102	129	24	0.442	.5,0.5,0.8-1.4,1-1.5,1-4,1.1-2.5,100,2-3,2-6,2.5-3,2/3,25,3-7,4,4-4.5,4-6,6,7-10,acuminate,acute,anther,apart,apex,base,berry,bright,broadly,brown,capitate,cell,cm,commonly,cordate,corolla,densely,diameter,elliptic,entire,filament,flattened-reniform,flower,form,glabrous,globose,groove,growth,inflorescence,irregularly,later,lateral,leaf,leaflet,less,lobed,margin,minutely,mm,number,pair,pale,pedicel,peduncle,pentagonal,petiole,pinnately,pinnatifid,pitted,primary,pubescent,red,reddish,seed,shiny,simple,slightly,spaced,sparsely,stellate-rotate,stem,stigma,style,surface,tan,terete,terminal,tiny,triangular,trichome,truncate,uniseriate,usually,vein,vine,violet,wall,way,wing,woody,x,yellow,yellowish,½	-11,-13,.2,0.2,1-,2,2-,2-9,3-4.5,3.5-10,4-20,5,5-9,5-merou,<,adaxially,ag,alyx,anthesi,apicula,apiculae,appearing,ark,around,articulated,asymmetric,away,axi,basal,basiscopically,blac,branch,branche,brow,calyx,closer,connivent,corresponding,cupped,curved,divaricate,drying,eaf,eed,ellipsoid,elongate,elongating,exserted,extending,flattened,four,free,fruiting,geminat,ilament,inflated,lamina,larger,leaving,lengthening,like,lobe,long,longer,longest,loosely,lower,many,markedly,membranous,mere,minute,near,new,nflorescence,oblique,occasionally,often,older,one,open,orolla,outline,papillo,peg,pendant,per,perfect,pericarp,plurifoliate,pore,poricidal,portion,progress,quite,rim,ripe,ruit,scar,sleeve,slit,small,smaller,sometimes,spreading,strongly,tangle,tem,testal,thin,third,tip,together,tube,tuft,twinin,twining,two,ud,unequal,unit,upper,variable,vary,weight,white,widest,wood,ympodial	abaxial,adaxial,appearance,arrangement,bark,color,colour,feature,fruit,height,history,length,life,na,ovary,plant,position,rachi,reproduction,shape,spacing,staman,texture,width
700	wfo-0001031152	success	232	138	109	123	29	0.47	-10,.4,/100-1/16,0.2-0.3,0.2-1.5,0.3-1.3,0.3-3,1-1.5,1-6,1.2-1.8,1.5-3,1/2-2/3,11,2-5,2.7-3.7,4-19,4-6,4-8,5-6,8-20,abaxially,accrescent,acuminate,acute,adaxially,anther,apart,apex,attenuate,base,becoming,blade,branched,brown,bud,bullate,calyx,chartaceous,cm,conical,continued,corolla,deltoid,densely,diameter,due,entire,filament,flower,fruit,fruiting,globose,green,greenish,growth,honeycombed,lanceolate,lateral,lavender,leaf,length,less,lilac,lobed,long,margin,mm,mostly,narrowly,oblanceolate,open,openly,orbicular,pale,pedicel,peduncle,petiole,pitted,probably,pubescent,rachi,reniform,reticulate-punctate,ripe,rotate-stellate,scabrous,shrub,simple,somewhat,sparingly,sparsely,splitting,stellate-pubescent,stem,stigma,style,suborbicular,surface,terminal,testa,time,tree,tube,violet,way,x,yellow,yellowish,young	-1.5,-5.5,0-100,1-3,1.1-2.2,1.1-3,1.3-4,1.4-2.6,1.5-3.5,1/2-3/4,13-27,2.5-7.5,2.7-4.5,2.7-6,2.8-4,3.7-7,4-7,6.5-10,9-13,ag,along,anthesi,apical-lateral,apparently,articulated,axe,axillary,ba,basal,berry,blister,blunt-tipped,branch,capitat,closely,decurrent,dehiscing,directed,eaf,earl,eed,evident,exserted,extend,few-rayed,fleshy,free,glabrescen,glabrous,granular-tomentose,hair,high,inserted,introrse,lackin,large,lobe,long-,longer,longitudinal,lower,m.,main,midvein,mixed,moderately,multangulat,multangulate,nearly,nflorescence,oblong,obtuse,occasionally,one,orolla,ovate,partly,perfect,persistently,plurifoliate,pore,porrect-stellate,rather,ray,reddish,reddish-brown,relatively,ruit,runk,sessile,short-,short-stalked,side,slightly,slit,soon,spaced,stamen,stelliform,stipitate-glandular,stout-stalked,strongly,suture,swelling,tamen,terete,thick,thick-stalked,thin,thin-,thin-stalked,tomentose,touching,toward,unarme,unarmed,unit,usually,variously,vary,vein,wide,ympodial	30-100,abaxial,adaxial,arrangement,branching,capitate,color,colour,early,form,glabrescent,height,history,inflorescence,life,na,number,ovary,perennial,plant,position,ratio,reproduction,seed,shape,spacing,staman,texture,thicknes
701	wfo-0001031155	invalid_json_followup	193	135	100	93	35	0.518	.5,0.2-1.2,0.5,1,1-1.2,1-1.5,1.5-2,2-5,2.5-3.2,4-,4-6,5-20,7-15,abaxially,acuminate,acute,almost,anther,apart,apex,apparently,bark,base,beneath,bilobed,broader,calyx,climbing,closely,cm,corolla,cream,cup-shaped,dark,deeply,densely,diameter,distally,echinoid,elliptic,evenly,filament,flower,glabrous,glandular,globose,growth,height,inflorescence,internodal,lanceolate,leaf-opposed,like,lobed,lower,margin,midrib,minutely,mm,multangulate,new,once-branched,open,orange,pale,part,pedicel,peduncle,petiole,prickle,prickly,pubescent,purple,scar,shallowly,shiny,shrub,simple,slightly,somewhat,spaced,sparsely,stellate,stem,stigma,straight,strongly,style,surface,tan,terminal,tip,trichome,unknown,white,whitish,widely,within,x,yellowish	0,0.1,0.2,0.3-0.4,0.7,0.7-1.5,1.5,1.5-1.6,1.5-5,3-4-foliate,4.5-7,5-7,8.5-13,adaxially,age,along,anthesi,appearing,armed,articulate,axi,bullate,cell,central,common,deltate,discolorous,distall,due,eaf,eed,enlarged,equal,exserted,ferrugineous,fine,glabrescen,halfway,heavily,heterostylous,hub-like,intertwined,know,known,larger,leaving,lengthening,lobe,long,longer,los,midpoint,mixed,mixture,multiseriate,narrowly,nflorescence,oblique,obtuse,occasionally,older,outline,pair,papillat,peg,plurifoliate,pore,poricidal,porrect,primary,principal,ray,reddish,ruit,seen,sessile,short-stalked,short-styled,size,small,sparse,sparser,split,stalk,stout,tapering,tube,ud,unevenly,unit,variable,vein,ympodial	'',[,``,abaxial,adaxial,arrangement,bud,characteristic,color,colour,form,fruit,fruiting,glabrescent,history,leaf,length,life,na,number,ovary,papillate,plant,position,rachi,reproduction,seed,shape,spacing,staman,texture,value,width,{,}
702	wfo-0001031162	success	241	127	102	139	25	0.423	.5,0-25,0.5-1.5,0.5-3,0.5-7,0.7-5,1-1.5,1-15,1-5,1.5-2,1.5-3,1.7-4.5,10-30,2-,2-7,3-10,3-4,3-branched,3.5-5.5,5-10,600-1400,7-9,abaxially,acicular,acute,angled,anther,apex,base,black,broadly,calyx,chartaceous,cm,cordate,deeply,densely,diameter,dm,erect,extra-axillary,filament,flower,fruit,fruiting,glabrous,globose,green,index,inflorescence,irregularly,lateral,leaf,length,lobe,lobed,lobing,long,margin,midpoint,midvein,minutely,mm,obtuse,outline,ovate,pale,pedicel,peduncle,pendant,per,perennial,petiole,present,prickle,pseudohair,pubescent,purple,rachi,ray,reniform,reticulate,rhizomatous,shrub,side,simple,sparsely,stellate,stellate-pubescent,stigma,straight,style,surface,tan,throughout,time,unbranched,vein,white,x,yellow,yellowish	%,-74,0,0-1.2,0-1.5,0-2.5,0.05-0.1,0.1-0.15,0.1-0.2,0.1-0.8,0.15-0.4,0.25,0.4-0.8,0.5-0.7,0.5-0.8,0.5-2,0.6-0.8,0.7-1.2,0.8-1.2,1-1.7,1-10,1-13,1-2,1-locular,1.2-1.4,1.5-1.9,1.5-2.5,1.5-8,10,10-12,15-20,2-2.8,2-foliate,20-40,26-,3.5-10,35-200,4-5,4-6,4-8,4-9,5-6,5-7,5-merou,6,6-7,6-8,60,7-17,7-70,8-14,absent,accrescent,across,adaxially,adult,alyx,apart,apparen,armed,articulated,ascending,attenuate,axe,ba,blade,branch,branche,capitat,connivent,cylindrical,decimetre,deltate,directed,distall,distributed,eaf,eed,eglandular,exocarp,finger,geminat,generally,gland-tipped,hair,half,homostylous,incomplete,interpetalar,juicy,juvenile,lamina,lanceolate,less,lon,longer,lower,mature,mesocarp,mid-point,minute,moderate,moderately,narrow,nflorescence,oblique,orolla,pair,part,perfect,placenta,pore,porrect,presen,ruit,septum,sessile,short,somewhat,spaced,sparse,stalk,stellae,succulent,tal,tamen,tem,thick,tissu,tissue,transparent,triangular,tube,unit,upper,vary,wide,wing,ympodial	5-merous,abaxial,adaxial,arrangement,capitate,color,colour,corolla,form,growth,height,history,life,na,number,ovary,plant,position,presence,reproduction,seed,shape,spacing,staman,texture
703	wfo-0001031178	success	167	91	62	105	29	0.371	0-0.2,0.1-0.25,0.3-0.6,0.7-1.7,1-3,1.5-6,180-400,2-5,4-4.5,5-11,7-11,7.5-8.5,accrescent,acicular,acute,anther,apart,apex,base,calyx,cm,cuneate,densely,diameter,entire,extra-axillary,flower,fruit,fruiting,glabrous,globose,green,grey,half,inflorescence,length,lobed,long,margin,mature,mm,ovate,pedicel,peduncle,per,perennial,petiole,porrect,prickle,purple,rusty,shallowly,shrub,simple,sparsely,stellate,stellate-pubescent,stem,style,unbranched,unknown,yellow	%,0-0.25,0-0.4,0-0.6,0-10,0-5,0-6,0.1-0.2,0.4-0.6,0.6-0.9,0.6-1,0.6-1.2,0.7-1,0.8-1.2,0.9-1.2,1-2,1-4,1.2-1.4,1.2-1.5,1.2-3.4,1.5-5.2,11-18,19-30,2-3.5,3.5-9,4-9,40-65,5-merou,6-14,6-8,7-8,abaxially,absent,across,adaxiall,adaxially,alyx,armed,articulated,ascending,attenuate,axe,ba,blade,brown,chartaceous,cylindrical,d.,directed,distall,distributed,dult,eaf,eed,eglandular,erect,finger,glabrou,gland-tipped,hair,hig,juic,lamina,lanceolate,lateral,lobe,lon,longer,lower,mesocarp,midpoint,midvein,minute,moist,nflorescence,oblique,orolla,part,pore,presen,present,pseudo-racemose,ray,rhizomatous,ruit,short,solitary,spaced,stage,stalk,stellae,straight,tamen,thick,throughout,time,tube,unit,unknow,uvenile,vary,vein,wide,x,ympodial	5-merous,abaxial,adaxial,arrangement,color,colour,corolla,dm,filament,form,growth,height,history,leaf,life,na,number,ovary,plant,position,rachi,reproduction,seed,shape,spacing,staman,stigma,surface,texture
704	wfo-0001031185	success	213	128	115	98	13	0.54	-10,-8,.2,.5,0.5,0.5-3,0.9-,1,1-,1-10,1-5,1.2-5,10-40,2-9,2.5-16,2/3,3-4,4.5-7.5,7-10,anther,apart,apex,appearing,base,berry,branched,bright,broadly,brown,capitate,cell,closer,cm,commonly,corolla,curved,densely,diameter,distal,dry,ellipsoid,elongate,eye,filament,flattened,flower,glabrous,globose,green,growth,inflorescence,irregularly,lateral,lax,leaf,like,lobed,long,many,material,mature,meter,minutely,mm,moderately,open,ovate,pale,papillate,part,pedicel,peduncle,petiole,pinnatifid,pitted,pubescent,red,reniform,ripe,scar,seed,several,shape,shiny,shrub,simple,size,slightly,spaced,sparsely,stellate,stem,stigma,style,surface,tan,terminal,thin,time,toward,trichome,uniseriate,variously,vine,violet,wall,way,white,whitish,wide,winged,woody,yellow,yellowish,½	0.5-1.5,0.8-1,0.8-1.3,1-1.2,1-1.5,1-4,1.5-4,20,4-6,5-merou,>,acuminate,acute,ag,alyx,anthesi,apically,appressed,ark,articulated,attenuate,away,axi,basal,blade,calyx,conical,connivent,deeply,deltate,eaf,eed,entire,exserted,extremely,free,fruiting,glabrescen,ilament,inflorescenc,irregular,leaving,lengthening,living,lobbing,lobe,lon,loosely,lower,margin,materia,midrib,new,nflorescence,older,onto,orolla,outline,pair,particularly,peg,per,perfect,pericarp,plurifoliat,pointing,pore,poricidal,portion,reflexed,rounded,ruit,sinus,slender,slit,small,spreadin,spreading,still,strongly,tem,thickened,third,tip,truncate,tube,ud,ultimate,unit,upper,usually,variable,vary,visible,weak,widest,within,ympodial	bark,bud,color,form,fruit,glabrescent,height,length,number,ovary,plant,spacing,texture
705	wfo-0001031195	success	216	104	84	132	20	0.389	0.25-0.35,0.3,0.5-1,0.6-1.5,1,1-1.5,1-4,1.5-2.5,10-13,10-14,15-35,2-2.5,3-6,3.5-5.5,4-7,4-9,5-9,7.5-8,absent,acute,andromonoecious,anther,apex,base,broadly,calyx,chartaceous,cm,cylindrical,deeply,densely,diameter,ellipsoidal,extra-axillary,filament,finely,flattened,flower,fruit,glabrous,globose,green,grey,inflorescence,lateral,leaf,length,lobe,lobed,long,longer,mm,moderately,obtuse,ovate,pale,per,petiole,plant,prickle,pseudo-racemose,purple,ray,reticulate,rusty,shallowly,solitary,stage,stellae,stellate-pubescent,stigma,style,surface,time,tube,unbranched,weakly,white,whitish,wide,x,yellow,yellowish,yellowish-green	%,0-0.7,0-3,0-8,0.05-0.3,0.2-0.4,0.2-0.5,0.3-0.4,0.5-0.7,0.6-0.8,0.6-3,1-2,1-locular,1.4-1.6,1.4-2.9,10-19,11-28,2,2-4,2-5,2.5-4,20-32,3-3.5,3-4,3-5,3.5-4,4-5,5-merou,5.5-10,6-10,7-8,8-9,9-15,abaxially,absen,accrescent,acicular,across,adaxially,alyx,apart,articulated,attenuate,axe,ba,blade,capitat,center,confined,connivent,cuneate,d.,difoliate,directed,distal,distall,distributed,eaf,eed,eglandular,entire,exocarp,filiform,finger,fruiting,functional,geminate,gland-tipped,hair,half,heterostylous,incomplete,interpetalar,irregularly,juic,lamina,less,loosely,lower,margin,mature,mesocarp,midpoint,midrib,midvein,minute,moist,narrowly,nflorescence,oblique,orolla,part,pedicel,peduncle,perennial,pore,porrect,presen,present,probably,prostrate,rachi,ruit,septum,sessile,short,shrub,simple,spaced,sparse,sparsely,splitting,stellate,stoloniferous,straight,tal,tamen,tem,thick,throughout,tip,tissu,tissue,transparent,triangular,unarme,unarmed,unit,uvenile,vary,vein,ympodial	abaxial,adaxial,capitate,color,colour,corolla,density,dm,height,juvenile,number,ovary,position,reproduction,seed,shape,staman,stem,texture,width
706	wfo-0001031202	success	198	111	84	114	27	0.424	0-0.5,0-1,0.6-1.1,0.8-1,1-5,1.5-2.5,2-8,2/3,3.5-4,6-25,accrescent,acute,anther,apart,apex,axi,bark,base,broadly,bud,calyx,capitate,cm,completely,complex,cordate,corky,corolla,cup-shaped,deflexed,enclosed,erect,filament,fleshy,flower,fruit,fruiting,furcate,glabrous,globose,green,hard,inflorescence,later,lateral,leaf,lobe,lobed,many,minutely,mm,obovate,opposite,ovary,overtopping,ovoid-reniform,pale,paler,papillose,pedicel,petiole,pitted,plant,puberulent,raised,reddish-brown,scar,shape,shoot,shrub,slightly,small,stigma,straight,style,surface,tan,terminal,time,tip,tree,way,white,woody	.1,.5,0.1-0.3,0.5,0.5-1,1-1.5,1-1.7,1.5-2,1.5-9,15-40,2-3,2.5-13,2.5-3.5,2.5-4,20-100-flowered,9-11,9-20,abrupt,along,anthesi,apiculate,beneath,berry,condition,decurrent,deltoid,densely,dia,differing,difoliate,distal,dry,due,eaf,edicel,eed,exserted,extremely,free,frui,geminat,glabrate,golden,greenish-white,greyi,irregularly,large,like,live,lon,long,long-ellipsoid,long-styled,longer,lower,main,major,margin,material,middle,minor,minute,narrowing,nflorescence,occasional,occasionally,often,older,one,orbicular,pair,papillo,planar,pore,poricidal,portion,prominent,pubescent,quite,rounded,ruit,scattered,sessile,shaped,short-styled,size,slender,spaced,sparsely,specimen,stem,tall,tapering,tear-drop,thick,thickened,thicker,third,trichome,tub,tube,ud,uniseriate,unit,usually,variable,vein,weight,whitish,widest,winged,x,ympodial,young	20-100,abaxial,adaxial,arrangement,color,colour,decurren,diameter,form,greyish,growth,height,history,length,life,na,number,peduncle,perennial,position,rachi,reproduction,seed,spacing,staman,texture,width
707	wfo-0001031203	success	218	125	99	119	26	0.454	-1.5,-2,.7-1,0-0.5,0-0.8,0-2.5,0.05-0.15,0.1,0.1-0.8,0.3-0.6,0.4-1,1-2,1.5-2.5,1.8-2.8,2-7,3-10,4-16,5-8.5,6-16,6.5-9.5,8-11,adaxially,almost,along,anther,apart,apex,articulated,base,berry,broadly,cinereous-tomentose,cm,deciduous,deep,densely,diameter,distributed,elongate,erect,essentially,extra-axillary,filament,first,flower,foveolate,fruit,glabrous,globose,greenish-white,hair,inflorescence,lateral,length,lenticular,lignescent,long,margin,maturity,midpoint,minutely,mm,orange-red,outline,ovate,ovoid,pedicel,peduncle,perennial,perfect,petiole,rachi,rarely,ray,red,reduced,reniform-ovate,ripe,sericeous,shorter,simple,smooth,somewhat,sparsely,spreading,stalk,stellate,stellate-pubescent,stigma,style,surface,thickened,thin-textured,unbranched,usually,well-developed,white,x,yellow	.2,0.05-0.2,0.3,0.5-1.8,1-3,1-5,1/10-1/4,11-18,15-22,15-50,2-3.5,2-5,2-foliate,2.1-2.7,2.5-9.5,21-39,25-45,3.2-4,4-12,4-6-locular,4-6.5,5-7,5-8,5-9,5.5-8,8-14,abaxiall,abaxially,acute,acute-tipped,adaxiall,apparently,asymmetric,attenuate,axe,ba,blade,calyx,campanulate,capitat,coarsely,connivent,consisting,curved,cylindrical,deltoid,dentate,directed,distall,downcurved,eaf,eed,flesh,geminat,interlobal,interwoven,invested,lanceolate,less,linear-lanceolate,lobe,lon,longer,lower,lowermost,lying,major,midvein,much,nflorescence,numerous,obsolete,obtuse,often,orolla,ovate-lanceolate,pair,parallel,per,plane,pore,present,prickl,projecting,prominent,pubescence,relatively,ruit,sessile,short,short-stalked,side,sinus,smaller,spaced,stellae,stellate-pubescen,stem,surfac,tal,tamen,tem,terete,termination,three,time,tip,tooth-like,truncate,tube,unarmed,unit,uppermost,upward,vary,vein,weakly,wide,ympodial	abaxial,adaxial,arrangement,capitate,color,colour,corolla,distribution,form,growth,height,history,leaf,life,na,number,ovary,plant,position,reproduction,seed,shape,spacing,staman,texture,width
708	wfo-0001031207	success	219	112	90	129	22	0.411	-5,0-10,0.25-0.5,0.5-1,0.6-1.2,0.85-1.4,1.4-2,2-3,3-5,5-8,9,abaxially,anther,apart,apex,bark,base,berry,bristle,cell,cm,cordate,curved,dark,densely,diameter,dull,evenly,eye,filament,filiform,flattened-reniform,flower,fruit,glabrescent,glabrous,gray,green,herb,lateral,leaf,length,lobed,margin,maturity,mauve,mm,moderately,naked,obtuse,orange-brown,outline,ovate,pair,pale,pedicel,peduncle,persistent,petiole,pit,poricidal,primary,raised,red,shrub,small,smooth,sometimes,spherical,spreading,stalk,stellate,stellate-pubescent,straight,style,subentire,surface,tapering,terminal,tertiary,tip,toward,trichome,vein,venation,visible,white,yellow,yellow-green,young	-0.4,-1/2,-11,-4,-7,-8,.1,/5,0,0-0.5,0-20,0.1-0.2,0.1-0.3,0.1-0.5,0.2,0.2-0.3,0.3-0.5,0.6-0.9,0.7-2,0.8,0.9-1.6,1,1-3,1-4,1-5,1.5-5,1/,1/3,1/3-equal,1/4-1/3,2-4,2.1-2.3,2.5-,2.8-3,3.5-7,5-merous,6-8,6.5-8,acuminat,acute,alyx,ame,apar,apically,apparently,articulated,blade,branched,bristly,broad-deltate,brow,c.,calyx,chartaceous,concolorous,difoliate,discolorous,distance,drying,eaf,eed,elongated,elongating,equal,erect,extending,free,fruiting,geminat,gently,herbaceous,infructescence,lanceolate,less,like,lobe,long,longer,lower,mature,midpoint,midvein,multangulate,narrow-deltate,nflorescence,oblong,occasionally,older,one,open,orolla,oung,pendulous,per,perfec,pericarp,perpendicular,porrect,portion,prickl,prickle,prickly,ray,reflexed,rounded,ruit,scandent,scar,sessile,shorter,side,simple,spaced,stalked,stem,tamen,terete,time,tube,unarmed,unit,upper,usually,variously,vary,way,weakly,wide,ympodial	0-8,abaxial,adaxial,brown,color,colour,corolla,count,form,growth,height,inflorescence,na,ovary,plant,position,reproduction,seed,shape,spacing,staman,texture
709	wfo-0001031217	success	222	114	94	128	20	0.423	.5,0-3.5,0.1-0.3,0.25-1.3,0.5-0.75,0.6-1.8,1-1.5,1.5-2,2-5,3-4,3.5-4.5,5.5-7,6-12,7-17,7-9,absent,accrescent,acicular,acuminate,acute,adaxially,anther,apex,base,borwn,broad-based,brown,calyx,chartaceous,cm,cuneate,densely,diameter,elliptical,entire,erect,extra-axillary,filament,flower,fruit,fruiting,glabrous,gland-tipped,globose,green,greenish-white,hair,half,inflorescence,lanceolate,leaf,length,less,light,lobe,longer,margin,mature,mm,narrowly,oblique,ovate,pale,part,pedicel,peduncle,perennial,petiole,present,prickle,pseudo-umbellate,purple,rachi,red,reticulate,rhizomatous,scarcely,scattered,shape,short,shrub,sparsely,stellate,stellate-pubescent,stigma,straight,style,surface,time,unbranched,violet,wide,x,yellow	%,.5-2,0-0.1,0-5,0-6,0.1-0.2,0.15-0.25,0.2-0.3,0.25-0.4,0.3-0.4,0.3-0.5,0.3-1,0.35-0.6,0.4-0.7,0.5-3,0.8-4,1,1-2,1-20,1-4,1-locular,1.5-4,1.5-4.2,13-21,2-2.5,2-3,2-8,2-9,2.5-4,2.6-3,3-4.2,4-11,4-6,5-12,5-7,5-merou,6-8,7-8,9-10,abaxially,absen,across,adult,alyx,apart,apparen,articulated,axe,ba,blade,branch,branche,confined,connivent,contiguous,cylindrical,directed,distall,distributed,dm,eaf,eed,eglandular,elliptic,exocarp,finger,geminate,incomplete,interpetalar,juicy,juvenile,lamina,lateral,lobed,long,loosely,lower,mesocarp,mid-point,midpoint,midrib,midvein,minute,moderately,much,nearly,nflorescence,orolla,overlapping,pair,paired,pendent,per,perfect,placenta,plurifoliate,pore,porrect,ray,ruit,septum,sessile,shallowly,simple,smaller,sometimes,spaced,sparse,stalk,stellae,succulent,tal,tamen,tem,thick,throughout,tissu,tissue,transparent,triangular,truncat,tube,unarme,unarmed,unit,upper,vary,ympodial	5-merous,abaxial,color,corolla,form,growth,height,history,life,ovary,plant,position,presence,reproduction,seed,staman,stem,texture,truncate,width
710	wfo-0001031218	success	154	120	87	67	33	0.565	-5,0.5,0.5-1,1-2,1-3,15-25,2-2.5,2-22,2-3,3,3-14,3-5,4-5,4-8,40-100+,5-7,6-7,8-20,abaxially,acuminate,adaxially,aggregate,apart,apex,articulated,base,branched,calyx,cell,cm,connective,coriaceous,dark,densely,diameter,eglandular,eglandular-pilose,ellipsoidal,especially,flattened,flower,fruit,glabrous,glandular,glandular-puberulent,globose,greenish-purple,hair,lanceolate,lavender,leaving,less,lobe,long,minutely,mm,moderately,mottled,obtuse,orange,ovate,ovate-elliptic,ovoid,pedicel,pedicellar,peduncle,petiole,present,puberulent,pubescent,purple,rachi,radiu,remnant,ripe,simple,sparsely,stellate,stigma,stone,style,succulent,toward,tree,violet,x,yellow	1-4,10-19,2.5-3,4-28,4-7,4-foliat,40,5-37,5.5-7,6-10,6-9,8-17,acute,ape,apiculate,axe,basal,beyond,blade,connivent,cordate,cylindrical,directed,distally,eaf,eed,entire,equal,exceeding,exserted,glabrou,introrse,lon,lower,margin,narrowly,nflorescence,nther,oblique,orolla,papillo,perfect,pore,presen,purpl,ruit,shorter,slightly,small,sometimes,spaced,stamen,subcoriaceous,tal,tem,thecae,time,tip,tomento,triangular,truncat,tube,ud,unit,vary,wide,ympodial	abaxial,adaxial,anther,arrangement,bud,color,colour,corolla,form,growth,height,history,inflorescence,leaf,length,life,na,number,ovary,papillose,perennial,plant,position,presence,reproduction,seed,shape,spacing,stem,surface,texture,truncate,width
711	wfo-0001031225	success	163	110	78	85	32	0.479	0.2,0.5,0.7-6,0.75-1,0.8-1,1-1.5,1-1.7,1-5,2.5-3,3/4,5-6,7-9,acute,anther,apart,apex,bark,base,broadly,bud,calyx,closely,cm,corolla,cup-shaped,darker,decurrent,elliptic,erect,filament,fruiting,furcate,glabrate,glabrous,globose,green,growth,inflorescence,leaf,less,lobed,long,minute,minutely,mm,often,opposite,ovary,ovate,ovoid-reniform,pale,papillose,pedicel,petiole,pitted,plant,prominent,pubescent,raised,scar,shape,shrub,slender,slightly,small,spaced,stigma,style,surface,tan,tapering,tip,tree,tube,unevenly,way,white,x	.25,.5,/3,0.1-0.75,0.2-0.75,0.5-1,1-3,1.5-5,2,3-9,5-50-flowered,6-8,9-16,along,anthesi,beginning,berry,characteristic,conspicuous,deltoid,dia,differentiated,differing,difoliate,dry,eaf,edicel,eed,ellipsoid,exserted,flattene,fragrant,free,geminat,greyish-brow,inflorescenc,lateral,like,live,lobe,lon,lower,main,major,margin,middle,minor,much,narrowly,nflorescence,older,one,outline,pair,papillo,pore,poricidal,portion,proximal,red-papillose,reflexed,rest,rhomboidal,rounded,ruit,shaped,size,soon,specimen,stem,straight,strongly,sweetly,swelling,tall,tear-drop,trichome,ud,uniseriate,unit,vein,widest,woody,ympodial,young	1,3,5-50,abaxial,adaxial,branching,color,colour,decurrence,diameter,feature,flattened,flower,form,fruit,greyish-brown,height,history,length,life,na,number,peduncle,perennial,position,rachi,reproduction,seed,spacing,staman,texture,width
712	wfo-0001031231	success	175	123	97	78	26	0.554	-2,.5,0.5-1.5,1-1.5,1-3,1.5-2,13,2-3,37/2,37/3,5-7,8-10,absent,acumen,acuminate,acute,adherent,almost,anther,apex,aromatic,axillary,base,branch,brown,campanula,campanulate,cell,cluster,cm,colour,corolla,dark,discoidal,elliptic,equal,exceeding,except,facetted,filament,flower,folded,fork,glabrous,glandular,globose,green,greyish,hair,herbarium,juvenile,lanceolate,leaf,len,less,long,marbled,margin,mauve,midrib,minute,mm,often,ovary,pedicel,pedicellate,peduncle,pentagonal,petal,pinnatisect,plant,purple,recurve,rh,ripe,ripening,rotate,rounded,rugose-ruminate,seed,sessile,shallow,short,shrub,simple,sinus,slightly,small,sometimes,stigma,style,succulent,surface,tinged,tip,usually,violet	1-2,1-4,2-4,2.5-3,25-35,3-4,4-8,80-110,along,anthesi,aspect,axi,basal,becoming,berry,beyond,blunt,bluntly,branched,calyx,clonal,declinate,developed,dia,eaf,eed,ellipsoid,entire,erect,exerted,expanded,fleshy,flowering,general,gree,habit,interacuminal,lasting,lengthening,lobe,lon,loosely,lower,mature,nflorescence,oblong,occasionally,pedice,plurifoliat,pore,poricidal,projecting,rarely,readily,ruit,several,shed,slit,soft,specimen,stone,stonrgly,stout,tissue,toward,translucent,triangular,tub,ud,unit,variable,vigorous,well,without,wooded,x,year,ympodial	abaxial,adaxial,arrangement,color,diameter,form,fruit,growth,height,history,inflorescence,length,life,na,number,perennial,petiole,position,rachi,reproduction,shape,spacing,speciman,staman,texture,width
713	wfo-0001031252	success	170	115	87	83	28	0.512	0.2-1.5,0.3-1.1,0.4-3,1-2,1.75-5.2,12-20,16-33,2.8-3.6,3-10,3-5,5-8,5-9,7-18,abaxially,acute,adaxially,along,anther,apex,axillary,bead,brownish,bud,cell,ciliate,clavate,cm,condition,coriaceous,corolla,covering,dark,deep,diameter,drying,elliptic,exceeding,filament,flower,forked,fresh,fruit,glabrous,globose,green,green-white,greenish,hair-like,herb,honeycomb-shaped,lateral,light,like,margin,medium,mm,moniliform,mucilaginous,necklace,ovate,ovoid,pedicel,peduncle,petiole,plant,purple,rotate,rounded,seed,serrate,simple,stamen,stigma,stolon,stripe,style,subtending,terminal,testal,thick,throughout,tuber,wall,wet,white,whitish,yellow	1-3,1.3-1.9,2-3,2.5-7,3-6,5-17,5-merou,5.5-6.5,absent,acumen,adaxiall,ag,alyx,apart,apparently,arranged,articulated,attenuate,axe,base,berry,blade,capitat,connivent,cuneate,digestion,distal,dorsally,eaf,edge,eed,entire,enzyme,erec,flat,folded,geminat,generally,glabrou,hal,half,high,homostylous,interjected,lanceolate,leaflet,lengthening,linear,living,lobe,long,lower,make,mottled,multiple,nflorescence,orolla,perfect,plurifoliate,pore,poricidal,removed,ripe,ruit,seudostipule,slit,sometimes,spaced,specimen,straight,tall,tamen,tem,tip,tri-,tube,typically,unit,unwinged,usually,vary,x,ympodial	abaxial,adaxial,arrangement,capitate,color,colour,form,growth,height,history,inflorescence,leaf,length,life,na,number,ovary,perennial,position,pseudostipule,rachi,reproduction,shape,spacing,staman,surface,texture,width
714	wfo-0001031257	success	206	115	84	122	31	0.408	-5,-6,0.75-2.5,1-1.2,1-1.3,2-4.5,3.5-,4-4.5,7.5-9,abundant,acuminate,anther,anthesi,antrorse,apex,ascending,base,berry,blue-violet,branch,bud,campanulate,cell,cm,coarsely,coat,corolla,cotyledon,curved,dark,dentate,diameter,embryo,endosperm,epidermal,filament,flexuous,globose,hair-like,herb,hollow,honey-combed,lateral,leaf,length,light,little,long,longer,margin,midvein,mm,non-glandular,ovate,pericarp,petiole,pubescent,purple,rest,ring,robust,secondary,seed,serrate,shorter,shrub,simple,stem,stigma,strand,style,subglobose,thickened,thickening,tip,trans-ovoidal,trichome,tube,vein,wall,white,within,x,yellow	-12,-22.5,0,0.4,0.5,0.5-0.8,0.7-1,1.1-1.2,1.5,1.5-1.7,1.5-2,1/10,10-16,11.5-15,2-,3,3.5-5.7,4-10,4.5-,5,5-,5-8.5,6-12,6-celled,7-,8,8-celled,abaxially,accrescen,adaxially,ag,aggregate,attenuate,basal,bicellular,broad,calyx,connectival,cuneate,cuticle,deep,densely,diamete,difoliate,directed,dorsally,eaf,edentate,eed,ellipsoidal,elliptical,erect,finely,foliage,free,fruiting,geminat,glabrous,glandular,half,head,herbaceous,high,inconspicuous,inserted,lamina,like,lobe,lon,long-stalked,longitudinal,longitudinally,lower,many-seeded,narrowly,odorles,opening,orolla,outward,pair,papillate,patent,pore,poricidal,portion,prolongation,rarely,reduced,ree,ridged,ruit,saddle-shape,scarce,scarcely,separated,short-stalked,single-celled,sinus,slightly,slit,small,smooth,solitary,somewhat,spur-like,stalk,stone,striate,tem,thecae,time,tooth,triangular,unequal,unit,upward,vary,ventrifixed,verrucate,viscid,viscid-pubescen,ympodial	abaxial,adaxial,arrangement,color,colour,flower,form,fruit,growth,height,history,inflorescence,life,na,number,ovary,pedicel,peduncle,perennial,plant,position,rachi,reproduction,saddle-shaped,shape,spacing,staman,surface,texture,viscid-pubescent,width
715	wfo-0001031270	success	234	112	99	135	13	0.423	+,0.4-1.5,0.5-1,1-4,1/3,10-12,2-3,2-7,3-10,3-20,5-15,5-merous,6-50,9-10,abaxial,abaxially,acute,adaxial,anther,apex,base,bipinnatifid,bright,brown,capitate,clavate,cm,conical,curved,deeply,densely,depressed-spherical,diameter,filament,flower,glabrous,glandular,green,growth,herb,heterostylous,inflorescence,lateral,leaf,leaf-opposed,length,like,live,lobed,long,long-styled,margin,membranous,minutely,mixture,mm,ovoid,pale,petiole,pinnatifid,pitted,plant,prickle,prickly,pubescent,red,reddish,reniform,ripe,rounded,shallowly,shining,short-styled,shrub,simple,size,slightly,small,sparsely,spherical,stellate,stem,stigma,straight,straw-colored,style,surface,tan,terete,thin,trichome,uniseriate,usually,way,white,wide,yellow,yellowish,½	.5,1,1-1.2,1-3,1.2-1.6,1.5,1.5-2,10,100,2-2.5,2-20,2-4,2.5-3,3-5,4-5,5,5-10,5-6,6-17,7-12,8,>,accrescent,adaxiall,along,alyx,anthesi,apart,arme,articulated,associated,bark,basal,beginning,berry,blade,brow,c.,calyx,cell,celled,colored,connivent,consistently,differentiated,difoliate,directed,distal,eed,ellipti,elliptic,entire,equal,erect,few-rayed,free,frui,fruiting,geminat,gland,glandular-pubescent,heavily,infructescence,investing,later,leafy,lobe,lon,longer,loosely,lower,midpoint,midvein,minute,multangulate,multiseriate,narrowly,new,nflorescence,obovate,occasionally,often,older,orolla,oung,outline,pair,papillo,pedicel,peduncle,per,pericarp,pore,poricidal,portion,primary,rachi,ray,reflexed,rest,ruit,scar,scattered,secondary,sessile,shallow,short-stalked,single,sinuate,slender,spreading,stalk,staminat,strongly,tall,tamen,tapering,testal,thus,tightly,tip,tissue,truncate,tube,unit,upward,vary,varying,vein,well,wice,wid,wing,woody,ympodial	adaxially,color,corolla,form,fruit,height,number,ovary,position,seed,shape,staman,texture
716	wfo-0001031283	success	52	76	36	16	40	0.692	-0.25,0.1-0.15,0.4-0.5,0.5-0.7,0.7,2.2-2.8,30-40,acute,apex,appearance,base,brown,calyx,cm,diameter,elongating,erect,fide,fruit,hair-like,markedly,mm,moore,narrowly,obovate,outgrowth,pale,pleasant,pubescent,shrub,silky,somewhat,sprawling,surface,winged,woody	.7-2.3,cell,eed,give,lateral,lo,lobe,long,small,smelling,spreadin,tall,testa,thick,wall,wide	1.7-2.3,abaxial,adaxial,anther,arrangement,color,colour,corolla,elongation,filament,flower,form,growth,height,history,inflorescence,leaf,length,life,na,number,ovary,pedicel,peduncle,petiole,plant,position,rachi,reproduction,seed,shape,smell,spacing,spreading,staman,stigma,style,texture,thicknes,width
717	wfo-0001031287	success	147	122	88	59	34	0.599	.5,0.5-1.5,0.9-1,1,1-1.5,1-5,1.5-2,2-2.5,3-5,4-6,4.5-5,6-7,abaxially,acute,adaxially,anther,anthesi,apex,attenuate,bark,base,bearing,bi-lobed,branch,calyx,cm,conical,corolla,dark,deltate,dendritic,densely,divergently,ellipsoid,elliptic,elongate,erect,exserted,filament,fleshy,glabrous,globose,green,greenish-white,internodal,later,leaf,lobe,lobed,long,margin,membranous,minutely,mm,nearly,onto,ovary,ovoid-reniform,pair,pale,papillose,pedicel,petiole,pitted,planar,pointed,pubescent,reflexed,rounded,shoot,short,shrub,simple,sinus,somewhat,stigma,strongly,style,surface,tan,thick,thin,trichome,tube,tuft,white,winged,x	1-1.2,1-1.3,1.5-5.5,3-4,4-5,5-14,6-10-flowered,apar,ape,axil,berry,connective,coriaceous,deflexed,dia,difoliate,eaf,edicel,eed,enlarged,free,frui,fruiting,geminate,knob,lamina,lateral,lon,lower,main,many,middle,nflorescence,occasionally,older,papillo,plurifoliate,pore,poricidal,portion,red-papillose,reddish-brow,ruit,scar,shaped,small,spaced,stem,tear-drop,tip,tub,ud,unevenly,unit,vein,widest,woody,ympodial,young	6-10,abaxial,adaxial,alternate,apart,arrangement,bud,color,colour,diameter,flower,form,fruit,growth,height,history,inflorescence,length,life,na,number,peduncle,perennial,plant,position,rachi,reddish-brown,reproduction,seed,shape,spacing,staman,texture,width
718	wfo-0001031300	success	219	135	107	112	28	0.489	-4,-5,-6,/4,0.2-0.4,0.2-0.5,0.3,0.3-0.6,0.5-0.9,0.5-18,0.5-2,0.7-0.9,0.8-1.5,1-2,1-4,1.5-3.5,1/2-3/4,2-,2-3,2-4,2-6,2.5-3.2,3-4,5-merous,abaxially,acute,anther,apart,apex,apically,articulated,attenuate,bark,base,berry,branched,brown-green,cell,chartaceous,cm,creeping,curved,diameter,distance,dull,erect,eye,filament,flattened,flattened-reniform,flower,fruit,glabrescent,glabrous,gray-green,lateral,leaf,length,lobed,long,margin,maturity,membranous,midvein,mm,moderately,naked,near,oblanceolate,obtuse,orange,orange-brown,orange-green,outline,pair,pale,pedicel,peduncle,petiole,pit,prickle,primary,pubescent,raised,red,rounded,shrub,side,simple,small,smooth,sparsely,spherical,stellate,stellate-pubescent,style,surface,tertiary,trichome,vein,venation,visible,way,white,yellow,yellow-green,yellow-orange	-2.2,.5,0-15,0-20,0-3,0-8,0.1,0.1-0.5,0.1-0.6,0.15-0.7,0.2-0.7,0.2-1,0.3-1.3,0.5-1.5,0.6-0.8,0.6-1,0.6-1.2,0.7-1.2,1-5,1.2-1.7,1.3-2,1/3-1/2,1/6-1/4,10-30,2-5.5,2.2-2.3,2.2-2.7,3-,4,4.5-6,5-15,6-8,absent,also,alyx,apar,apparently,ba,blade,brow,bulbous,calyx,caudat,concolorous,connivent,deltate,densely,difoliate,drying,eaf,eed,elongating,equal,extending,filiform,free,fruiting,geminat,geniculate,hair,herbaceous,highly,infructescence,lobe,lon,longer,lower,mature,midpoint,minute,nflorescence,oblong,older,one,open,orolla,oung,pendulous,per,perfec,pericarp,poricidal,porrect,portion,prickl,prickly,rarely,ray,reduced,ruit,scar,sessile,spaced,spreading,stalk,stalked,stem,tamen,tapering,terete,thin,time,tip,tube,uniradiate,unit,vary,weakly,wide,wider,winged,ympodial	abaxial,adaxial,arrangement,brown,color,colour,corolla,extension,form,growth,height,history,inflorescence,life,number,ovary,perennial,plant,position,reproduction,seed,shape,spacing,staman,stigma,texture,unknown,width
719	wfo-0001031310	success	203	100	73	130	27	0.36	0-3,1-10,1-3,1-6,1.5-4,15-40,3-10,4-10,4.5-4.8,abaxially,adaxially,anther,apex,blue,blue-purple,brown,brownish,cell,chartaceous,cm,condition,corolla,covering,diameter,drying,filament,flower,forked,fresh,fruit,glabrous,globose,green,greenish,hair-like,herb,lateral,leaf,less,light,membranous,minutely,mm,obtuse,odd-pinnate,ovate,ovate-elliptic,ovoid,pale,pedicel,peduncle,petiole,pilose,plant,puberulent,pubescent,rachi,rotate,seed,simple,sometimes,somewhat,sparsely,stigma,streak,style,terminal,testal,thick,tuber,wall,whitish,yellow	.5,0-4,0.5-3,1-2,1-5.5,2-3,2.5-5.5,2.5-8.5,4-12,5-6,5-7,5-merou,5.5-21,6-7,absent,acumen,acuminate,ag,along,alyx,apart,apparently,articulated,attenuate,axe,axillary,base,berry,blade,borne,broadly,bud,caly,ciliate,connivent,conspicuously,cuneate,decreasing,decurrent,digestion,distal,dorsally,eaf,edge,eed,elliptic,end,enzyme,erect-decumben,especially,exceeding,extremely,flat,folded,geminat,generally,glabrou,gradually,green-white,hair,half,high,homostylous,honeycomb-shaped,interjected,lanceolate,larger,leaflet,lengthening,like,living,lobe,long,lower,make,margin,midrib,mottled,mucilaginous,multicellular,narrowly,nflorescence,orolla,ovate-lanceolate,pair,perfect,petiolule,plurifoliate,pointed,pore,poricidal,purple,removed,rosette-forming,ruit,seudostipule,shortly,singly,size,slightly,slit,small,spaced,specimen,stamen,ste,stem,stolo,straight,subellipsoi,subrosette-forming,subtending,tall,tamen,tem,throughout,tip,tissue,toward,tri-,tube,typically,unit,unwinged,usually,vary,wet,white,x,ympodial	abaxial,adaxial,arrangement,color,colour,form,growth,height,history,inflorescence,length,life,na,number,ovary,perennial,position,pseudostipule,reproduction,shape,spacing,staman,stolon,subellipsoid,surface,texture,width
720	wfo-0001031316	success	207	93	79	128	14	0.382	-2,0.05-0.1,0.1-0.2,0.3-1,0.5-2,0.8-1.8,0.9-1.3,1-5,1.5-2,2-3,3-8,5-10,5-8,5-merous,abaxial,abaxially,almost,ame,anther,apparently,bark,blue-mauve,bright,c.,cm,cream,dark,densely,diameter,dull,entire,erect,filament,flattened-reniform,flower,fruit,glabrescent,glabrous,gray,green,lateral,leaf,length,margin,marking,maturity,midpoint,mm,moderately,multangulate,orange,orange-brown,ovate,pale,pedicel,peduncle,petiole,purple,ray,red-brown,scar,sessile,shrub,sparsely,spherical,stalked,stellate,stellate-pubescent,stem,style,surface,terete,terminal,trichome,unarmed,variously,white,yellow,young	.1,/3,0.05-0.15,0.4-0.6,0.4-0.8,0.6-1,0.8-1.2,1.2-2.1,1.3-3.5,1.5-,1.5-3.5,1.5-5,1/3-1/2,1/3-2/3,2-20,2-4,2.5-8,3-10,3.5-3.8,3.8-5,4,4-7,4-9,5-15,5-6,6-20,8-11,8-12,8-25,acuminate,acute,adaxial,alyx,apar,apex,apically,articulated,base,becoming,berry,blade,branched,broad,calyx,colored,concolorous,connivent,contrast,curved,difoliate,discolorous,drying,eaf,eed,elongating,eye,fifth,foliaceou,four,free,fruiting,geminat,glabrou,hair,held,herbaceous,infructescence,inward,lobe,lobed,long,long-acuminat,longer,lower,lowermost,mature,membranous,minute,naked,narrow-deltate,nflorescence,obtuse,older,one,open,orolla,oung,pair,pendulous,per,perfec,pericarp,poricidal,porrect,portion,primary,red-brow,reflexed,ruit,simple,slender,smooth,sometimes,spaced,spreading,stalk,stellate-pubescen,strongly,tamen,tapering,tertiary,time,tip,tube,unarme,unequal,unit,usually,vary,vein,venation,visible,way,white-green,whitish,wide,yellow-green,ympodial	color,corolla,form,growth,height,inflorescence,ovary,plant,reproduction,seed,shape,spacing,staman,texture
721	wfo-0001031333	success	194	130	104	90	26	0.536	+,.5,0.1-0.5,0.5,1-1.5,1-4,1-5,1.5,1.5-2,2-3,2.7-7,3-4,5-7,7-10,7-9,?,acuminate,acute,almost,anther,anthesi,apart,apex,base,berry,bilobed,branched,broadly,brown,calyx,capitate,cell,cm,conical,densely,diameter,ellipsoidal,elliptic,entire,exserted,filament,flattened,flower,glabrescent,glabrous,globose,golden,green,greenish,growth,immature,inflorescence,long,many,margin,minute,minutely,mm,narrowly,new,nodding,ovate,pair,pale,pedicel,peduncle,pentagonal,pericarp,petiole,pitted,poricidal,primary,pubescent,pubescent-papillate,reniform,scar,somewhat,soon,sparsely,stellate,stem,stigma,strongly,style,surface,thickened,thin,time,tip,triangular,trichome,truncate,tube,twining,undersurface,vein,venation,vine,white,whitish,woody,x,yellow,yellowish	1.2-2,1.5-1.7,1/2,2,2.5-3,3/4,30-40,5-8,5-merou,50,<,>,abaxially,adaxiall,adaxially,adjacent,ag,alyx,appearing,ark,articulated,branche,clustered,collection,composed,crea,cupped,denser,eaf,eed,free,fruting,glabrescen,half,high,ilament,lamina,leaving,lengthening,less,like,lobe,lobed,lower,m.,matte,membranous,mere,near,nflorescence,occasionally,older,orolla,outline,papillat,peg,penden,per,perfect,planar,plurifoliat,pore,portion,quadrate,rest,rhachi,ruit,simple,sinus,slightly,slit,small,splitting,ste,striped,tangled,tem,terminal,testal,trailing,ud,undulation,unequal,unevenly,uniseriate,unit,upper,vary,way,ympodial	5-merous,bark,branching,bud,colour,composition,corolla,cream,exsertion,form,fruit,glabrescence,glabrousnes,leaf,length,number,ovary,papillate,pubescence,seed,shape,size,spacing,state,texture,thicknes
722	wfo-0001031333	success	194	119	90	104	29	0.464	.5,0.1-0.5,1-1.5,1-4,1.5-1.7,1.5-2,1/2,2.5-3,3-4,3/4,30-40,7-10,7-9,?,acuminate,acute,almost,anther,anthesi,apex,bark,base,berry,bilobed,broadly,brown,capitate,clustered,cm,corolla,cream,densely,diameter,elliptic,filament,flattened,flower,fruiting,glabrescent,glabrous,globose,golden,green,greenish,growth,immature,inflorescence,lobed,matte,membranous,minutely,mm,narrowly,near,new,nodding,ovate,pale,pedicel,peduncle,petiole,pitted,pubescent,pubescent-papillate,reniform,rotate-stellate,scar,simple,somewhat,sparsely,stellate,stem,stigma,style,surface,terminal,thin,tip,triangular,trichome,undersurface,uniseriate,upper,vein,vine,way,white,whitish,woody,yellowish	+,0.5,1-5,1-5-2,1.5,2,2-3,2.7-7,3,5-7,5-8,5-merou,50,<,>,abaxially,adaxiall,adaxially,adjacent,ag,alyx,apart,appearing,articulated,branche,branched,calyx,cell,composed,conical,cupped,denser,eaf,eed,ellipsoid,entire,exserted,free,glabrescen,half,high,ilament,lamina,leaving,lengthening,less,like,lobe,long,lower,m.,many,margin,mere,minute,nflorescence,occasionally,older,orolla,outline,pair,papillat,peg,penden,per,perfect,pericarp,planar,plurifoliat,pore,poricidal,portion,primary,quadrate,rest,rhachi,ruit,sinus,slightly,slit,small,soon,spaced,splitting,striped,strongly,tangled,testal,thickened,time,trailing,truncate,tub,tube,twinin,ud,undulation,unequal,unevenly,unit,vary,venation,wide,ympodial	abaxial,adaxial,arrangement,branch,color,colour,form,fruit,height,history,leaf,length,life,na,number,ovary,papillate,pendent,perennial,plant,position,rachi,reproduction,seed,shape,spacing,staman,texture,width
723	wfo-0001031359	success	166	104	73	93	31	0.44	.25,0.5-6,0.75-1,1-4,1.2-1.6,1.2-2.5,1.3-1.6,3-3.5,6-7,acuminate,anther,apart,apex,attenuate,bark,base,beginning,beneath,berry,bi-lobed,brown,calyx,cm,corolla,curled,dark,dull,elliptic,evenly,filament,flattened-reniform,glabrous,globose,green,leaf,lobed,long,membraneous,minutely,mm,narrowly,near,nearly,obovoid,opposite,outline,ovary,papillose,pedicel,petiole,pitted,plant,ripe,round,scar,shrub,simple,spaced,stem,stigma,style,surface,tan,tapering,trichome,tube,tuft,undulate,uniseriate,white,x,yellow,yellow-orange	.02,.5,/4,0.5-1,1.1-1.6,1.5-2,1.6-2.8,1.9-2.3,12-21,2.5-3,3.6-8.8,5-30-flowered,5-7,5-angled,5.3-7.5,angle,anthesi,apiculate,appearing,axil,ba,broadly,deflexed,dia,differing,difoliate,distal,dried,eaf,edicel,eed,extending,free,fruiting,geminat,incrassate,inflorescenc,internodal,interpetalar,lamina,lateral,live,lobe,lon,lower,main,major,margin,middle,minor,nflorescence,occasionally,often,older,one,originating,pair,paler,papillae,papillo,pit,planar,pore,poricidal,portion,reflexed,ridged,ruit,rusty,shaped,shiny,sinus,size,slender,slightly,somewhat,specimen,straight,strongly,tall,tear-drop,tip,triangular,tub,ud,unit,vein,way,white-lenticellat,widest,woody,ympodial,young	5-30,abaxial,adaxial,arrangement,bud,color,colour,diameter,flower,form,fruit,growth,height,history,inflorescence,length,life,na,number,peduncle,perennial,position,rachi,reproduction,seed,shape,spacing,staman,texture,white-lenticellate,width
724	wfo-0001031362	success	138	76	58	80	18	0.42	.2,.5,1-1.1,1-1.5,1-3,1-4,2-2.5,3-6,?,anther,base,calyx,cm,conical,corolla,densely,ellipsoid,flattened,flattened-reniform,glabrous,globose,incrassate,internodal,lanceolate,leaf,lobed,margin,minutely,mm,nearly,opposite,orange-red,ovary,pale,papillose,pedicel,petiole,pitted,poricidal,pubescent,pubesent,red,shaped,shiny,shrub,simple,small-capitate,sparsely,stigma,style,subshrub,surface,tan,tear-drop,thin,tip,tube,white	.3,0.4-0.5,0.5-1,0.7-1,1-3-flowered,1.5-2,3-4,abaxially,acute,adaxially,along,anthesi,apex,appearance,attenuate,bark,berry,branch,brown,bushy,cell,closely,dendritic,denser,dia,eaf,edicel,eed,erect,exceeding,exserted,filament,free,fruiting,giving,golden,golden-brow,inflorescenc,lamina,lateral,like,lobe,lon,long,long-triangular,lower,main,middle,nflorescence,nodding,older,outline,overlappin,packed,pair,papillo,pericarp,planar,plurifoliat,pore,portion,rectangular,rest,rounded,ruit,scar,slender,somewhat,spaced,stem,straight,trichome,ud,unit,vein,widest,woody,x,ympodial,young	abaxial,arrangement,bud,color,diameter,flower,form,fruit,growth,inflorescence,length,na,number,plurifoliate,position,seed,shape,texture
725	wfo-0001031363	success	198	107	78	120	29	0.394	0-3,0-30,1-2.2,1-5,1-6,1.1-1.6,1.5-4,10-11.5,10-12,3-7,4-7,4.5-7.5,5-10,6-13,7-12,absent,acicular,adaxially,adult,andromonoecious,anther,apex,articulated,bark,base,branch,broadly,chartaceous,cm,decimetre,densely,diameter,erect,extra-axillary,flower,fruit,glabrous,globose,green,inflorescence,juvenile,lateral,leaf,length,lobed,longer,midvein,mm,moderately,obtuse,ovate,pale,pedicel,peduncle,per,perennial,petiole,plant,present,prickle,pseudo-racemose,purple,rhizomatous,shallowly,shrub,simple,sparsely,stellate,stellate-pubescent,straight,style,surface,time,unbranched,vein,weakly,wide,yellow	%,.3,.5,0-15,0-6,0.3-0.5,0.3-0.6,0.3-0.7,0.4-0.5,0.4-0.8,0.5-0.8,0.5-0.9,0.5-1,0.7-1.5,0.9-1.6,1-2,1-locular,1.1-1.4,1.6-2.1,13-25,2-3,2-foliate,2.3-2.5,2.5-7.5,3-4,3-5,3.5-5.5,3.5-6,30,4-8,5-6,5-7,5-8,5-merou,6-8,6.5-11,6.5-8.5,80-120,abaxially,absen,across,acute,adaxiall,alyx,apart,attenuate,axe,ba,blade,branche,brown,calyx,corky,cross-section,cylindrica,deltate,directed,distall,distributed,dm,eaf,eed,eglandular,exocarp,finger,fruiting,functional,furrowed,geminat,gland-tipped,hair,half,heterostylous,incomplete,index,juicy,lamina,less,lobe,lobing,long,lower,margin,mature,mesocarp,midpoint,minute,moist,nflorescence,oblique,orolla,pair,part,placenta,pore,porrect,ray,ruit,semi-circula,septum,sessile,short,side,spaced,stalks-0.1,stellae,tal,tamen,tem,thick,throughout,transparent,tube,unarme,unarmed,unit,upper,vary,x,ympodial	5-merous,abaxial,adaxial,arrangement,color,colour,corolla,density,filament,form,growth,height,history,life,na,number,ovary,position,presence,rachi,reproduction,seed,shape,spacing,stalk,staman,stem,stigma,texture
726	wfo-0001031372	success	192	126	98	94	28	0.51	0,0.05-0.2,0.2-0.8,0.4-0.6,1,1-2,10-14,10-30,2-5,2-7,2.5-4.5,3,4-5,5-10,7-10,8-15,abaxially,acute,acute-,adaxially,anther,apart,apex,articulated,base,blade,broadly,brown,central,closely,cm,coarsely,compressed,concealing,dark,deltoid,densely,diameter,elliptic,entirely,extra-axillary,filament,flattened,flower,fruit,glabrous,globose,green,hair,interwoven,lateral,laterally,leaf-opposed,length,light,lighter,lilac,lobe,main,margin,midpoint,minutely,mm,obtuse,ovate,pedicel,peduncle,perennial,petiole,pitted,prickle,prickly,pubescent,rachi,ray,recurved,repand,round-tipped,several,simple,spaced,sparsely,spreading,star,stellate,stellate-pubescent,stem,stigma,style,thin-textured,ultimately,unbranched,vein,weakly,white,woolly,x,yellow	-1.5,0-15,1.5,1/4-1/3,10,10-12,2-2.5,2-foliate,2.5,25-30,5-20,6-9,7,8-10,abaxiall,accrescent,adaxiall,along,armed,axe,ba,blunt-tipped,broad-based,calyx,capitat,completely,connivent,covering,cylindrical,decurrent,directed,distal,distally,eaf,eed,enveloping,female-sterile,foliaceous,fruiting,geminat,glabrou,lanceolate,large,long,longer,lower,m.,midrib,minute,mostly,much,multiseriate,nflorescence,often,onto,orolla,ovate-lanceolate,perfect,pore,present,probably,reaching,reddish,ruit,scattered,short,short-styled,shorter,side,similar,soft-wooded,somewhat,stalk,ste,stellae,stellate-woolly,stelliform,stipitate,tal,tamen,tem,termination,time,tube,unarmed,unit,vary,well-developed,whitish,wide,widely,winged,ympodial,young	abaxial,adaxial,arrangement,capitate,color,colour,corolla,form,growth,height,history,inflorescence,leaf,life,na,number,ovary,plant,position,reproduction,seed,shape,spacing,staman,surface,tall,texture,width
727	wfo-0001031389	success	242	85	69	173	16	0.285	0-0.5,0-2,0.25-0.75mm,0.4-0.6,0.4-1.8,0.5-1,0.8-2.5,1-1.5,1.5-2.5,14-18,20-60,4-5.5,5.5-8,6-10,8-15,almost,anther,base,branch,chartaceous,cm,densely,diameter,dm,extra-axillary,filament,fruit,globose,green,inflorescence,juvenile,lanceolate,leaf,length,lilac,longer,minutely,mm,ovate,pale,pedicel,peduncle,per,petiole,pitted,prickle,pseudo-racemose,pseudo-umbellate,purple,rachi,red,reniform,reticulate,reticulately,rotate-stellate,simple,sparsely,stellate,stellate-pubescent,stigma,style,surface,thicknes,time,white,wide,x,yellow,yellowish	%,0-0.1,0-0.4,0-0.6,0-1,0-10,0-3,0.05-0.1,0.25-0.4,0.25-0.5,0.3-0.5,0.3-0.6,0.3-0.8,0.5-1.5,0.5-3,0.6-0.7,0.65-1,0.9-4.5,1-2,1-3,1-4,1-5,1-locular,1.3-2.4,1.5-3,1.5-4,1.5-5,1.8-3.5,1.9-2.2,11-16,14-30,2-6,2-foliate,2.5-13,4-5,4-7,4-8,5-8,5-merou,6-12,6-7,6-9,7-8,abaxially,absen,absent,accrescent,acicular,across,acute,adaxially,adult,alyx,andromonoecious,apart,apex,apparen,articulated,axe,ba,becoming,blade,branche,brown,calyx,capitat,confined,connivent,cuneate,cylindrical,dark,decimetre,deltate,directed,distall,distally,distributed,eaf,eed,eglandular,entire,erect,exocarp,finger,first,flower,fruiting,functional,geminat,glabrous,gland-tipped,hair,half,heterostylous,homo-,incomplete,interpetalar,juicy,lamina,lateral,less,lobe,lobed,long,loosely,lower,margin,markedly,mature,mesocarp,mid-point,midpoint,midrib,midvein,minute,moderate,narrowly,nflorescence,oblique,obtuse,often,orolla,pair,part,perennial,perfect,placenta,plant,plump,pore,porrect,present,ray,reddish,rhizomatous,rostrate,ruit,scattered,septum,sessile,shallowly,short,shrub,solitary,sometimes,somewhat,spaced,sparse,stalk,stellae,straight,succulent,summit,tal,tamen,tem,thick,thicker,throughout,tightly,tip,tissu,tissue,triangular,tube,unarme,unarmed,unbranched,unit,upper,vary,weakly,ympodial	abaxial,adaxial,arrangement,capitate,color,colour,corolla,density,ovary,position,seed,shape,staman,stem,texture,width
728	wfo-0001031394	invalid_json_followup	217	133	82	135	51	0.378	0.5,3,4,5,abaxially,acicular,acute,alternate,anther,apart,apex,apparently,base,branch,branched,cm,crenulate,curved,densely,diameter,eventually,extra-axillary,filament,finely,flattened,flower,fruit,glabrous,gland-tipped,glandular-pubescent,globose,hair,length,light,lobe,main,margin,midpoint,midrib,minute,mm,narrowly,ovate,pedicel,peduncle,petiole,pilose,pitted,plant,prickle,pubescent,purple,rachi,red,rounded,short,single-celled,slightly,sometimes,sparse,stellae,stellate,stem,stigma,stipitate-glandular,straight,style,subcordate,subreniform,subshrub,tan,taprooted,thin-textured,tooth,triangular,unbranched,usually,vein,white,x,yellow,yellow-orange	-celled,-rayed,0.2–0.4,0.3,0.3–1.5,0.5–1,0.6–1.6,0.8,1,1.1–1.6,1.2–3.2,1.4–2.1,1.7–4.5,1/2,1/3,1–,1–1.5,1–2,1–3,1–4,2,2-foliat,2.2–2.5,2.5–3,2–3,2–3-celled,2–3.2,2–4,3.7–7.6,33–80,3–4,3–5,3–6,4–8,5–8,64,6–11,6–8,9–13,=,?,accrescent,adaxially,additional,almost,appearing,armed,articulated,axe,ba,basal,beginning,blade,bottom,broadly,bulbous,calyx,caudate,cylindrical,directed,distal,distall,eaf,eed,enlarging,even,fertile,free,fruiting,glabrou,gland-tippe,glandular-pilosulose,halfway,hyaline,investing,lanceolate,leafy,least,less,lon,long,longest,lower,male,many,maturity,n,nflorescence,numerous,one,orolla,overtopped,per,pore,pubescence,quite,reaching,recurved,reflexed,ruit,scattered,sessile,shorter,side,similar,simple,small,smaller,somewhat,spaced,spreadin,staminate,sterile,stout,tall,taman,tem,terminal,thick,thickened,time,tip,truncat,tube,unit,variable,vary,wide,ympodial,±,–1.5,–2,–3,–5,–6	'',0.2-0.4,0.3-1.5,1-3,1-4,1.2-3.2,1.4-2.1,1.7-4.5,2-4,3-4,3.7-7.6,4-8,5-8,6,6-8,[,``,abaxial,adaxial,arrangement,branching,characteristic,color,colour,corolla,form,growth,height,history,inflorescence,leaf,leaflet,life,na,number,ovary,position,rayed,reproduction,seed,shape,spacing,staman,surface,texture,thicknes,truncate,value,width,{,}
729	wfo-0001031400	success	161	90	73	88	17	0.453	-3,0.25-0.8,0.4-1.7,0.6-1.8,0.7-6,0.8-1.1,1-,1.2-2,1.5-5,10-11,2,2-3,2-5,2-9,4-13,4-17,4-6.5,4-7,7-28,abaxial,abruptly,base,branched,calyx,cm,corolla,cuneate,cyme,dark,deeply,diameter,dichasial,dichasially,diminishing,distal,ebracteate,flower,forked,globose,green,green-white,half,lateral,leaf,leaflet,linear,linear-lanceolate,mm,monochasial,mucilaginous,oblique,odd-pinnate,ovoid,pair,pedicel,peduncle,petiole,plant,proximal,puberulent,seed,size,stellate,stigma,style,subglabrous,terminal,tone,toward,violet,white,yellow,¼	1,1-4,3-6-foliat,4-,5-12.5,6-23,7-25,abaxially,absen,acumen,acute,adaxially,apex,apical,apically,apiculate,articulate,cell,connate,covering,decurrent,dehiscent,digestion,dorsally,eaf,edge,eed,emoval,enzyme,exceeding,filament,flat,folded,forming,generally,globo,hair-like,herbaceous,honeycomb,interjected,introrse,living,lobe,lon,long,lower,lunat,make,maturing,nflorescence,nther,oblong,occasionally,often,orolla,pattern,perennial,perfect,plan,poricidally,rachi,reveal,ruit,sessile,seudostipule,short,side,slit,specimen,stamen,straight,stripe,structure,tal,tem,testal,thick,throughout,tip,trilobe,tuber-bearing,typically,unit,vary,wall,wide,without,ympodial	adaxial,anther,arrangement,articulation,color,fruit,height,inflorescence,length,number,ovary,position,shape,stem,surface,texture,width
730	wfo-0001031401	success	182	116	90	92	26	0.495	0.6-1.2,1-6,1.5-2,2-2.4,2-5,2.5-4,3.5-4,7-9,8-10,abaxial,abaxially,acute,adaxial,anther,apex,appearing,attenuate,axi,bark,base,bi-lobed,black,branching,brown,cm,conical,corolla,dark,dendritic,densely,diameter,dichasial,elliptic,filament,flattened,flower,fruit,globose,golden,golden-yellow,growth,lateral,leaf,lenticular,lobed,matted,minutely,mm,narrowly,new,nodding,occasionally,ovary,pedicel,pericarp,petiole,pitted,poricidal,prominently,pubescent,purplish-black,pyramidal,raised,reddish-brown,rounded,roundish,scar,shiny,shrub,small,sometimes,somewhat,stem,stigma,strongly,style,surface,tapering,terminal,thin,tip,tree,tree-like,trichome,tube,unit,usually,violet,white,winged	0.5,0.8-1.2,1,1-1.4,1-1.5,1.1-3,1/2,3,3/4,5,5-7,5-9,adaxially,age,along,anthesi,apical,basal,becoming,berry,blade,branch,calyx,clearly,deciduous,deflexed,deltoid,denser,differentiated,drying,eaf,ecuador,ecuadorian,edicel,eed,ew,exserted,finely,fork,free,fruiting,glabrous,impressed,inserted,less,lobe,long,long-triangular,lower,m.,mesophyll,monochasia,near,nflorescence,noddin,node,often,older,outline,overtopping,pair,papillo,per,planar,plurifoliate,pore,portion,puberulent,pubescen,ruit,secondary,shoot,short,sleev,slit-like,sparsely,specimen,stamen,ste,tall,time,tub,ud,vein,visible,way,wide,woody,x,yellow,ympodial,young	arrangement,color,colour,form,height,history,inflorescence,length,life,monochasial,na,number,papillose,peduncle,perennial,plant,position,rachi,reproduction,seed,shape,spacing,staman,sympodial,texture,width
731	wfo-0001031402	success	200	93	73	127	20	0.365	%,0-0.2,0-0.3,0.2-0.4,0.4-1.2,0.5-0.7,0.5-1,0.5-1.3,0.7-1.4,1.5-2,10-15,10-18,10-38,14-18,2-2.5,2-8,3-5.5,4-8,7-15,7.5-8.5,absent,anther,chartaceous,cm,color,diameter,dm,filament,finger,flower,fruit,gland-tipped,globose,green,hair,inflorescence,lamina,lateral,leaf,leaf-opposed,length,linear,long,longer,midpoint,mm,moderately,ovate,ovoid,pedicel,peduncle,per,petiole,plant,prickle,purple,rachi,ray,rotate-stellate,simple,single-flowered,sparsely,stage,stellae,stellate-pubescent,stem,stigma,style,time,unknown,wide,x,yellow	0-3,0.3-0.6,0.3-1.1,0.5-2.6,0.6-1.2,0.8-2.5,0.8-3,1,1-15,1-2,1-3,1-4,1-5,1.5-2.5,2-3,2-4,2-6,2-foliate,2.2-12,3-15,3-4,3-5,4-7,5-40,5-merou,6-9,8-10,abaxially,absen,abundant,accrescent,acicular,across,acute,adaxiall,adaxially,adult,alyx,andromonoecious,apart,apex,armed,articulated,axe,ba,base,blade,branche,calyx,capitat,confined,connivent,contiguous,cuneate,cylindrical,deeply,deltate,densely,directed,distall,distributed,dult,eaf,eed,eglandular,entire,erect,fruiting,functional,geminate,glabrou,glabrous,half,herbaceous,heterostylous,index,interpetalar,lobe,lobed,lobing,lon,lower,margin,mature,midrib,midvein,minute,narrowly,nearly,nflorescence,oblique,obtuse,orolla,part,pore,porrect,possibly,present,projecting,pseudo-umbellate,resprouter,ripe,ruit,sessile,shallowly,short,shorter,side,spaced,sprawling,straight,strongly,tal,tamen,thick,throughout,tissue,tube,unarmed,unbranched,unit,uvenile,vary,vein,weakly,winged,ympodial	5-merous,abaxial,adaxial,arrangement,capitate,corolla,density,height,juvenile,ovary,position,presence,pseudoumbellate,seed,shape,staman,surface,texture,thicknes,width
732	wfo-0001031480	success	237	121	98	139	23	0.414	0-0.5,0.1-0.3,0.1-0.4,0.4-0.8,0.5-2,0.6-0.8,0.8-1,1-1.5,1-2,1-3,1.5-2.2,1.8-3,2-,2-6,3.5-7,4-5,5-8,5-merous,6-30,6-8,abaxial,acute,adaxial,andromonoecious,anther,apex,bark,branched,branching,bright,calyx,cm,curved,deltate,diameter,dull,ellipsoid,entire,faint,filament,flattened-reniform,flower,fruit,fruiting,glabrescent,glabrous,lateral,leaf,length,lobe,lobed,margin,mauve,midpoint,minutely,mm,moderately,obtuse,orange-brown,ovate,pair,pale,pedicel,peduncle,petiole,plant,porrect,prickle,primary,pubescent,purple,ray,red,red-brown,red-green,red-yellow-green,reticulate,scar,shallowly,shrub,simple,smooth,sparsely,spherical,stalk,stellate,stellate-pubescent,stem,straight,style,surface,terminal,trichome,unarmed,vein,visible,woody,yellow	-0.25,-2,/3,0,0-1,0-2,0-30,0-5,0.1,0.15-0.3,0.2-0.35,0.4,0.5-,0.7,0.8,1-1.3,1-4,1.7-2.2,1/2,1/3,1/4,1/6-1/5,2-2.7,2-3,2-5,3,3-10,3-6,3-7,4-6,6-13,7-8,8-12,abaxially,acuminat,alyx,apar,apart,apically,apparently,articulated,ba,base,berry,blade,broad-deltate,cell,cream,cuneate,dark,densely,difoliate,discolorous,distal,distance,drying,eaf,eed,elongate,elongating,equal,erect,extending,eye,flattened,free,geminat,glandular,green,hair,hermaphrodite,heterostylous,inconspicuous,infructescence,long,long-styled,longer,lower,lowermost,marking,mature,maturity,midvein,naked,near,nflorescence,often,older,one,open,orolla,oung,outline,pendulous,per,pericarp,persistent,pit,poricidal,portion,prickly,raised,red-brow,reduced,rounded,ruit,scandent,sessile,short-styled,shorter,side,slender,slightly,small,somewhat,spaced,spreading,stalked,staminat,tamen,tapering,terete,tertiary,thick-chartaceous,time,tip,truncate,tube,unarme,unit,upper,variously,vary,venation,way,weakly,wide,ympodial,young	0.1-0.7,arrangement,color,colour,corolla,form,growth,height,history,inflorescence,life,na,ovary,perennial,position,reproduction,seed,shape,spacing,staman,stigma,texture,width
733	wfo-0001031482	success	275	146	119	156	27	0.433	-0.6,-150,-16,-18,.5-5,/20-,0-0.2,0.02-0.03,0.03-0.3,0.04-0.3,0.2-0.3,0.5-1.5,0.6-1.8,0.7-1.3,1-4.5,1.2-1.5,1/10-1/4,2.5-10,2.5-4,4-13,4-5,4-6,8,9-13,abaxially,acuminate,acute,adaxially,anther,apart,apex,attenuate,bark,base,becoming,blade,blue,branch,brown,cm,commonly,continued,corolla,deltoid,densely,diameter,due,echinoid,elliptic,elongate,farinose,filament,flower,fruit,granular-tomentose,grayish,green,growth,hair,honeycombed,lanceolate,lateral,leaf,length,main,midvein,mixed,mm,moderately,mostly,multangulate,multiseriate,oblong-orbicular,obtuse,pale,pedicel,peduncle,perfect,petiole,porrect-stellate,possibly,pubescent,rachi,ray,reniform,reticulate-punctate,ripe,rotate-stellate,rounded,scabridulous,sessile,short-stalked,shrub,side,simple,slightly,small,sometimes,somewhat,stalk,stellate,stem,stigma,style,subcapitate,subconical,subglobose,suborbicular,subspherical,sulcate,terete,terminal,tomentose,tree,vein,velutinous,x,yellow,yellowish	-0.06,-0.2,-0.4,-0.5,-1.4,-5,-5.3,-5.5,-6,.04-0.1,.04-0.35,.04-0.5,.06-1,.2-1.6,.5-0.7,.5-3.5,0-0.3,0-0.4,0-0.6,0-0.7,0.02-0.04,0.02-0.06,0.03-0.04,0.04-0.4,0.04-0.5,0.04-0.6,0.04-1.4,0.3-0.5,1,1.2-3,1.3-4,1.4-2.2,1.6-2.8,1.9-2.5,1/2-2/3,2-3.3,2-3.5,2-4.6,2-4.7,2.5-4.5,3.5-4.8,3.7-8,3/4,4-7,4.5,5-7,5-80,5-merou,6-11,6-16,accrescent,adaxiall,ag,along,alyx,anthesi,ape,apical-lateral,apparently,appressed,articulated,axe,axillary,ba,berry,beyond,blunt-tipped,branched,bud,calyx,decurrent,dehiscing,directed,eaf,eed,ellipti,entire,evident,exserted,extend,few-rayed,free,fruiting,glabrescent,glabrous,high,immature,inserted,interpetalar,introrse,irregular,lacking,large,later,line,lobe,lobed,long,long-stalked,longer,longitudinal,lower,m.,margin,minute,narrowly,nearly,nflorescence,oblong,occasionally,often,older,orolla,ovate,overlapping,persistent,plurifoliate,pore,present,prominent,pubescence,rather,relatively,ribbed,ruit,runk,short-,slender,slit,spaced,sparsely,splitting,stamen,stelliform,subcampanulate,suture,tamen,testa,thick,thin,time,tissue,toward,tube,unarme,unarmed,unevenly,unit,usually,vary,way,weakly,white,wide,ympodial,young	0.5-3.5,15-80,abaxial,adaxial,arrangement,color,colour,form,height,history,inflorescence,life,na,number,ovary,perennial,plant,position,relative,reproduction,seed,shape,spacing,staman,surface,texture,trunk
734	wfo-0001031483	success	154	82	66	88	16	0.429	.5,/2,0.5-2,1,1-2,1.7-5.5,11-20.5,2-3,3-8-flowered,7-10,acuminate,acute,almost,anther,apart,apex,attenuate,base,clavate,cm,corky,corolla,decurrent,dry,evenly,filiform,flower,fresh,fusiform,glabrous,green,indistinct,internode,lateral,leaf,less,linear,lobed,main,mm,oblanceolate,obovate,obovoid,ovary,ovoid-reniform,pair,pale,pedicel,petiole,poricidal,shape,slightly,spaced,stem,stigma,straight,strongly,style,tan,tapering,tip,turbinate,vein,way,white,winged	0,0.5,1.1-2.5,1.2-1.4,1/3,2-2.5,2.5-3.2,3-4,6-10,across,anew,anthesi,ba,bearing,beginning,beneath,berry,blade,ca,caly,calyx,continuous,cork,deflexed,deltoid,dia,difoliate,distal,eaf,edicel,eed,end,exserted,filament,free,fruiting,geminat,indistinc,larger,lea,lenticellate,lobe,long,lower,major,markedly,minor,minutely,nflorescence,oblong,often,opposite,orbiculate,paler,papillo,papillose,per,planar,pointed,pore,portion,prominent,quite,raised,rounded,ruit,scar,shaped,short,short-triangular,shrub,simple,slender,somewhat,soon,subshrub,tall,tear-drop,third,tube,ud,unit,variable,widest,wing,woody,x,ympodial	arrangement,bud,color,diameter,fruit,height,inflorescence,length,na,number,plant,seed,spacing,surface,texture,width
735	wfo-0001031486	success	166	144	112	54	32	0.675	0.2-0.7,1-4,1.5-4,1.5-6,1.8-3.3,11-37,2-3,3-26,3.4-10,3.5-6.5,5-10,5-16,abaxially,abruptly,acuminate,acute,adaxially,almost,apex,apical,apically,articulate,base,branched,cell,cm,commonly,cordate,corolla,covering,cuneate,cyme,darker,deep,dehiscent,diameter,dichasial,dichasially,digestion,diminishing,distal,dorsally,ebracteate,elliptic,enzyme,filament,flat,flower,folded,forked,globose,green,green-white,hair-like,half,herbaceous,honeycomb,interjected,introrse,lateral,leaf,leaflet,less,light,lightly,make,maturing,mm,monochasial,mucilaginous,oblique,odd-pinnate,often,ovate,ovoid,pattern,pedicel,peduncle,pentagonal,perennial,petiole,petiolule,plant,poricidally,proximal,puberulent,pubescent,pure,purple,rotate,seed,short,size,slit,sometimes,spot,stigma,strigose,stripe,style,testal,thick,throughout,tinged,tip,toward,tuber-bearing,usually,wall,white,yellow,¼	0-1.,0-4.5,0.9-1.7,1-2.2,1-3,2-3.5,2-6,2.5-3.2,2.8-6,3-6-foliat,3.5-8,7.5-22,9-37,acumen,calyx,connate,decurrent,eaf,edge,eed,emoval,exceeding,generally,globo,highly,living,lobe,lon,long,long-attenuate,lower,lunat,nflorescence,nther,obovate,orolla,pair,perfect,plan,reveal,ruit,seudostipule,specimen,stamen,straight,tal,tem,terminal,throughou,typically,unit,vary,wide,ympodial	0-15,abaxial,adaxial,anther,arrangement,color,colour,dehiscence,form,fruit,growth,height,history,inflorescence,length,life,lunate,na,number,ovary,position,pseudostipule,rachi,reproduction,shape,spacing,staman,surface,texture,wet,width,ye
736	wfo-0001031492	success	175	131	103	72	28	0.589	.5,/4,0.5,0.7-1.3,0.9-1.1,08,1.3-2,1.5-1.8,10-15,2-10,3-5,4-10,4-4.5,6-8,abaxially,adaxially,anther,apex,apical,appearing,attenuate,bark,basal,base,bi-lobed,bitter,cm,corolla,dark,decurrent,dendritic,densely,denser,diameter,distinguishable,drying,dull,echinoid,elliptic,filament,flattened,flower,fruit,fruiting,glabrous,globose,golden,grey,growth,juice,lamina,lateral,leaf,lenticular,lightly,lobe,lobed,medium,minutely,mm,narrowly,ovary,overtopping,pedicel,pericarp,petiole,pitted,prominent,pubescent,purplish-black,pyramidal,rather,reddish-brown,remaining,scar,scarcely,scattered,shiny,shoot,short,shrub,size,sometimes,somewhat,sparsely,stem,stigma,style,surface,tapering,terminal,thin,tip,tree,tree-like,trichome,vein,violet,way,winged,woody,x,younger	1-1.3,1-1.5,1.5-2.5,2-3,2-5,20,3-4,8-11,8-9,absent,acuminate,acute,age,anthesi,axe,ba,becoming,beneath,berry,branching,calyx,conical,dbh,deciduous,deltoid,eaf,edicel,eed,erect,ew,exserted,free,inserted,long,lower,m.,monochasia,nflorescence,nodding,occasionally,older,pair,papillo,per,planar,plurifoliate,pore,poricidal,portion,predominantly,ruit,secondary,sleeve,slightly,slit-like,stamen,ste,sticky,strongly,sunken,tall,time,tub,tube,ud,undersurface,unit,upper,upturned,wide,ympodial,young	abaxial,adaxial,arrangement,bitternes,color,colour,form,height,history,inflorescence,length,life,na,number,papillose,peduncle,perennial,plant,position,prominence,rachi,reproduction,seed,shape,spacing,staman,texture,width
737	wfo-0001031497	success	264	129	105	159	24	0.398	.1-0.2,0.05-0.2,0.1-0.2,0.1-0.8,0.2-0.4,0.2-0.5,0.5-2.5,1-2,1.2-2,1.5-2.5,1.5-4,12-30,3-10,3-5,3-9,4-12,4.5-7,5-15,6-13,6-9,abaxially,actinomorphic,acuminate,acute,adaxially,anther,apart,apex,articulated,base,berry,broadly,cauline,cm,compressed,deciduous,densely,diameter,erect,extra-axillary,filament,flower,fruit,glabrous,globose,green,hair,inflorescence,lateral,laterally,leaf,length,lenticular,light,long,major,margin,maturity,midpoint,minutely,mm,orange,outline,ovate,ovate-lanceolate,pedicel,peduncle,perennial,perfect,petiole,pitted,prickle,pubescent,rachi,ray,recurved,red,reniform-ovate,ripe,sessile,short,short-stalked,side,simple,sometimes,spreading,stellae,stellate,stellate-pubescent,stigma,strongly,style,surface,tan,thickened,thin-textured,unbranched,usually,vein,weakly,white,wide,x,yellow,zygomorphic	-1.4,-30,-35,-7,.1,0.4-1,1,1.2-2.4,1/3,1/5-1/3,10-25,14-,15-,18-25,2-5,2-foliate,2.25-3,2.25-4.75,2.5-4,2.5-5,2.8-3.5,20-30,3-15,3-6,4-locular,4.5-9,5-8,7-12,along,ape,appearance,appearing,appressed,attenuate,axe,ba,blade,broa,c.,calyx,campanulate,cast,clearly,close,closely,coarsely,connivent,curved,cylindrical,deeply,deltoid,dense,denser,depressed-deltoid,directed,distal,distall,distributed,downcurved,due,eaf,eed,entire,equaling,essentially,external,falcate,female-sterile,foliar,geminat,giving,glabrescent,high,incised,interlobal,intermixed,lanceolate,large,largely,larger,less,lignescent,lobe,lon,longer,lower,main,mature,minute,nectary,never,nflorescence,numerous,oblique,obsolete,obtuse,occasionally,often,one,orolla,other,otherwise,oung,outer,pair,per,persistent,pigmented,pore,presence,present,prickly,projecting,pubescence,purple,purplish,readily,reduced,rigid,ring,ruit,scabrous,scattered,section,seldom,sharp-tipped,short-stipitate,similar,sinus,slightly,small,smaller,somewhat,spaced,species,stalk,stellate-puberulent,stem,subcapitat,summi,tamen,three,time,tip,toothlike,truncate,tube,two,type,unarmed,unit,unlobed,uppermost,upward,vary,varyingly,vestiture,widely,ympodial	abaxial,adaxial,arrangement,color,colour,corolla,form,growth,height,history,life,na,number,ovary,plant,position,reproduction,seed,shape,spacing,staman,subcapitate,texture,width
738	wfo-0001031503	success	142	125	88	54	37	0.62	-10,-15,-25,-30,-6,-7,0.3-3,0.5-1,0.5-4,1-,1-5,1-7,1.5-2,1.5-3,1.5-7,1.5-8,1.7-3.5,2-3,2.5-10,3-15,3-6,6-7,7-10,abaxially,acuminate,acute,aggregate,angled,apart,apex,articulated,base,blade,branched,calyx,cell,chartaceous,cm,cuneate,decurrent,deltate,densely,diameter,directed,distally,elliptic,entire,flower,forked,glabrous,globose,lobe,long,margin,mm,moderately,often,orange,ovate,pedicel,peduncle,petiole,pore,present,pubescent,rachi,radiu,rarely,reddish,rounded,rugose-pubescent,shrub,simple,slightly,stellate,stigma,stone,style,time,truncate,tube,unbranched,unequal,unit,white,wide,x,yellow	1-2.5,1-3,10-19,3-4,3-5,5613,6-many-foliat,7-15,abruptly,absen,adaxially,axe,ba,connivent,curled,cylindrical,distall,eaf,eed,eglandular,except,fide,gland,hair,lanceolate,lower,mostly,narrowed,narrowly,nflorescence,nther,obtuse,occasionally,orolla,perfect,puberulent,ripe,ruit,spaced,sparsely,stalked,subcapitat,subclavate,tal,tem,tip,toward,triangular,uniseriate,usually,vary,vein,venturi,ympodial	6-many-foliate,abaxial,absent,adaxial,anther,arrangement,color,colour,corolla,direction,filament,form,fruit,growth,height,history,inflorescence,leaf,length,life,na,number,ovary,plant,position,presence,ratio,reproduction,seed,shape,spacing,staman,subcapitate,surface,sympodial,texture,width
739	wfo-0001031511	success	231	115	94	137	21	0.407	-12,-3.5,-5,0.5-1,0.5-5,0.7-2.1,0.8-2,1-1.5,1-2,10-25,2-6,2.5-3,4-10,4.5-7,5-9,7-11,absent,acicular,acute,ample,andromonoecious,anther,apex,articulated,base,black,broadly,brown,chartaceous,cm,conspicuously,contiguous,cordate,cuneate,densely,diameter,discoid,ellipsoidal,erect,extra-axillary,filament,flower,forked,fruit,glabrous,globose,green,inflorescence,interpetalar,length,light,lobe,lobed,midrib,midvein,minutely,mm,moderately,nearly,obtuse,orange,ovate,pale,pedicel,peduncle,perennial,petiole,pitted,plant,present,prickle,pseudo-racemose,pubescent,purple,rachi,rhizomatous,ripe,rotate,shallowly,shrub,sparsely,stellate-pubescent,stigma,straight,strongly,style,surface,tissue,tomentose,triangular,violet,white,x,yellow	%,-15,-7,0,0-0.3,0-1.1,0-2,0-3,0.1-0.2,0.3-0.5,0.3-0.8,0.3-1.7,0.4-0.7,0.5-0.7,0.5-0.9,0.6-1.5,1,1-3,1-7,1.1-1.6,1.7-2.4,1.8-2.6,10-12,10-18,15-25,17-25,2-3,2-4,2-locular,2.2-3,2.2-4.3,2.8-3.5,25-45,3-5,4.5-9,5-10,5-15,5-6,5-7,5-merou,6-8,6-9,7-8,8-15,9-15,9-20,abaxially,absen,accrescent,across,adaxiall,adaxially,alyx,anvil-shape,apart,armed,axe,ba,basal,bisexual,blade,calyx,connivent,cross-section,cylindrical,deltate,dense,directed,distal,distall,dm,dult,eaf,eed,eglandular,entire,exocarp,finger,fruiting,functional,geminat,gland-tipped,hair,half,heterostylous,hig,juicy,lamina,lanceolate,lateral,less,lon,long,longer,lower,male,margin,mature,mesocarp,mid-point,midpoint,minute,moist,nflorescence,oblique,orolla,part,per,placenta,plurifoliate,pore,porrect,ray,ruit,rusty,short,simple,somewhat,spaced,stage,stalk,stalked,stellae,stem,tamen,thick,throughout,time,tube,unbranched,unit,unknow,uvenile,vary,wid,wide,ympodial	abaxial,adaxial,color,colour,corolla,form,growth,height,history,leaf,life,number,ovary,position,presence,reproduction,seed,shape,spacing,staman,texture
740	wfo-0001031512	success	199	113	87	112	26	0.437	%,-3,0-10,0-3,0.3-1,0.3-1.5,0.5-0.6,0.5-1.5,1-1.5,1-2,15-25,2-6,3-4,4-8,4.5-6,5-12,5-7,7-10,absent,acute,andromonoecious,anther,apex,articulated,base,black,broad-based,brown,brownish-black,chartaceous,cm,cuneate,cylindrical,densely,diameter,entire,extra-axillary,filament,flat,flower,fruit,glabrous,globose,grey,grey-green,inflorescence,lamina,lanceolate,length,lilac,longer,margin,minute,mm,oblique,obtuse,part,pedicel,peduncle,per,perennial,petiole,plant,present,prickle,pseudo-racemose,purple,rachi,raised,rotate-stellate,shrub,simple,slightly,stellate-pubescent,stigma,straight,style,surface,though,time,tubercle,twisted,undulate,white,wide,yellow,yellowish	0.05-0.1,0.1-0.2,0.15-0.2,0.15-0.25,0.15-0.3,0.2-0.3,0.3-0.5,0.5-0.8,0.5-1.8,0.8-1,0.9-1.5,1-2.5,1-3,1.5-3,12-15,12-16,13-15,13-16,2-foliate,3-5.1,3.8-5.7,4.5-7,5-merou,6-13,7-12,8-10,abaxially,absen,abundant,accrescent,adaxiall,adaxially,alyx,and/or,apart,axe,ba,blade,broad,calyx,capitat,connivent,decimetr,deltate,directed,distall,distinct,distributed,dr.,dult,eaf,eed,erect,finger,first,fruiting,functional,geminat,gland-tipped,green,hair,half,heterostylous,interpetalar,later,lateral,less,lobe,long,loosely,lower,marbled,mature,mesocarp,mid-point,midpoint,moderately,nflorescence,orolla,pore,porrect,pubescent,ray,rhizomatous,rounded,ruit,scarcely,sessile,short,smooth,sometimes,spaced,stage,stellae,stellate,stem,strongly,tal,tamen,thick,throughout,tissue,tube,unarmed,unbranched,unit,unknow,uvenile,vary,weakly,x,ympodial	abaxial,adaxial,arrangement,capitate,color,colour,corolla,decimetre,form,growth,height,history,leaf,life,na,number,ovary,percentage,position,presence,reproduction,seed,shape,staman,texture,width
741	wfo-0001031586	success	167	86	65	102	21	0.389	-2,0.1-1,0.5-1,1-1.2,1-1.5,1-2,1.4-2.5,2,5-6,acute,anther,anthesi,apart,apex,bark,bright,broadly,bud,capitate,cm,completely,conical,corolla,cream-colored,cucullate,deflexed,ellipsoid,elliptic,filament,flower,glabrous,globose,green,greenish,inflorescence,leaf,lobed,minutely,mm,mucro,open,opposite,ovary,pale,paler,papillose,pedicel,petiole,ridged,shiny,simple,somewhat,stem,stigma,style,surface,tapering,thickened,tip,truncate,trunk,white,x,yellow,yellowish	.25,0.5-0.8,1,1.3-5,1.5-2,2-2.5,3-11,5-10,7-10-flowered,abrupt,absent,apparently,appearing,attenuate,base,becoming,beneath,borne,branch,calyx,campanulate,closer,deltate,dia,differing,difoliate,distance,drying,eaf,edicel,eed,exerted,exfoliatin,fleshy,free,fresh,geminate,gree,inflorescenc,know,known,later,lateral,leave,lobe,long,lower,main,major,margin,material,may,minor,near,nearly,new,nflorescence,notched,occasionally,older,olive,one,onto,overtopping,pair,papillate,planar,pore,poricidal,portion,present,prominent,raised,remaining,rounded,ruit,scar,shap,shaped,shin,shrub,size,slender,small,sometimes,soon,spaced,sparsely,straight,swollen,tall,tear-drop,thick,trichome,tube,ud,uniseriate,unit,vein,widely,ympodial,young	7-10,abaxial,adaxial,color,colour,deflexion,diameter,exfoliating,height,length,na,number,peduncle,plant,position,rachi,shape,spacing,staman,texture,width
742	wfo-0001031587	success	142	77	58	84	19	0.408	.5,0.8-1,1-1.5,1.5-2,1.7-2,10-15,12-16,17-30,5,6-7,6-8,acute,anther,apex,bark,base,bi-lobed,clavate,cm,corolla,dendritic,densely,elliptic-ovoid,globose,inflorescence,lateral,leaf,lobed,main,major,minor,minutely,mm,pale,parallel,pedicel,petiole,pubescent,reddish-grey,shape,shaped,simple,size,soft,stem,stigma,style,surface,tear-drop,thick,thickened,tree,trichome,vein,verrucose,white,winged,x	2,2-2.5,2-9-celled,2/3,3-4,7-9,abaxially,adaxially,along,anthesi,apart,attenuate,axi,broadly,calyx,closely,cone,conical,decurrent,deflexed,deltate,denser,dia,differing,drying,eaf,edicel,eed,elliptic,erect,evenly,exserted,fide,filament,fleshy,free,furcate,glabrous,golden-red,included,irregular,know,known,lamina,later,like,lobe,long,loose,lower,lowered,middle,mostly,oblique,ocasionally,occasional,older,ovary,overlappin,pair,papillate,papillo,perpendicular,persisten,pore,poricidal,portion,rarely,rect,rest,ruit,scar,somewhat,spaced,steinbach,tall,tip,tub,tube,ud,uniseriate,way,widest,young	abaxial,adaxial,arrangement,color,diameter,form,growth,height,history,length,life,na,papillose,perennial,plant,position,texture,thicknes,width
743	wfo-0001031589	success	222	132	108	114	24	0.486	-6,0.1,0.1-0.5,0.2-0.5,0.2-3,0.4,0.5-1,0.55-0.7,0.6-1.2,0.9-1.3,0.9-1.6,1-1.8,1-5,1.5-5,1/3-1/4,2.8-4,3-5,5-merous,8-14,abaxially,acute,anther,apart,apex,apically,attenuate,bark,base,berry,bright,brown-green,calyx,cell,chartaceous,cm,deltate,densely,density,diameter,dull,elliptic,eye,filament,flattened-reniform,flower,fruit,fruiting,glabrescent,glabrous,gray-green,higher,lateral,leaf,length,lobe,lobed,long-obovate,margin,mauve,membranous,midpoint,mm,moderately,multangulate,naked,narrow-cuneate,occasionally,often,orange-brown,orange-green,outline,pair,pale,part,pedicel,petiole,pit,plant,porrect,prickle,primary,raised,ray,rounded,scandent,shiny,shrub,simple,small,smooth,sparsely,spherical,stalk,stellate-pubescent,straight,style,subentire,surface,tertiary,trichome,vein,venation,visible,way,white,yellow,yellow-green,yellow-orange	-0.5,-15,-6.5,.5,/6,0,0-1,0-10,0-3,0-30,0.15-0.3,0.2-0.4,0.7,0.8-2.3,1,1.2-1.5,1.7-2.5,1.8-2.9,1/3,1/3-1/2,10-30,2-,2-10,2-3.5,2.5-4.5,2.5-6,3-4,3/4,4-6.5,4/5,5-8,6-8,8-30,alyx,ame,apparently,articulated,blade,broadly,brow,c.,caudat,concolorous,connivent,cream,dark,difoliate,discolorous,distance,drying,eed,elongating,equal,erect,extending,free,geminat,green,infructescence,lengt,lon,long,longer,lower,marking,mature,maturity,midvein,narrow,nflorescence,oblong,obovate,older,orolla,oung,pendulous,per,perfec,pericarp,poricidal,portion,prickl,prickly,reflexed,ruit,sessile,shorter,side,solitary,sometimes,somewhat,spaced,spreading,stalked,stellate,stem,stout,subsessile,tamen,tapering,terete,time,tip,tube,unit,upper,vary,weakly,whole,wide,winged,woody,ympodial,young	abaxial,adaxial,arrangement,brown,caudate,color,colour,corolla,form,growth,height,history,inflorescence,life,na,ovary,reproduction,seed,shape,spacing,staman,stigma,texture,width
744	wfo-0001031609	success	154	121	88	66	33	0.571	0-30,0.4-3,0.5-3,1-10,1-6,1.5-2,1.5-3,10-25,2,2-,2-3,2.5-4,3-5,3-9-lobed,4-6,abaxially,absent,acute,adaxially,apex,around,base,brownish,calyx,campanulate,cm,connective,connivent,conspicuous,contiguous,dark,deltate,dia,diameter,distally,ellipsoidal,elliptic,elliptic-ovate,entire,flattened,fleshy,flower,forked,fruit,glabrous,globose,green,inflorescence,laterally,leaf,lobe,lobed,margin,minutely,mm,nearly,obovate,obtuse,orange,papillose,pedicel,pedicellar,peduncle,petiole,pinnately,pore,puberulent,rachi,radiu,reticulate,ripe,scar,shallowly,shrub,simple,small,stellate,stigma,style,succulent,thecae,tree,triangular,truncate,unbranched,unlobed,x,yellow	.5,/4,0.5-1,1.3-3,20-25,3-24,3-foliat,4,4-5,4.5-60,5-25,5/6,8-20,absen,aggregate,ape,apiculate,articulated,axe,barely,beyond,bilobe,blade,branch,brow,cell,cuneate,dilated,directed,divided,eaf,eed,emerging,equal,exceeding,exserted,glabrou,leaving,long,lower,midrib,nflorescence,nther,obconical,occasionally,orolla,point,rounded,ruit,sinus,stamen,stone,strongly,succulen,tal,tem,time,tip,tomento,tube,two,ud,unit,vary,wide,ympodial	abaxial,adaxial,anther,arrangement,bilobed,brown,bud,color,colour,corolla,direction,filament,form,growth,height,history,length,life,na,number,ovary,perennial,plant,position,reproduction,seed,shape,spacing,staman,surface,texture,tomentose,width
745	wfo-0001031615	success	154	101	81	73	20	0.526	0.5,0.5-1,0.8-1,1-1.6,1.5-5,11-15.5,2-3,2-4.2,3.8-6.1,4-6.5,5-20-flowered,5-6,8-10,acuminate,acute,anther,apex,arising,attenuate,bark,base,bilobed,brown,capitate,closely,cm,corolla,decurrent,deep,distal,elliptic,filament,flattened-reniform,fruit,glabrous,glandular,globose,green,inflorescence,lamina,leaf,less,lobe,lobed,long,major,minor,minutely,mm,nearly,ovary,packed,pair,papillose,pedicel,petiole,pitted,scar,shaped,shiny,shrub,size,slender,small,stem,stigma,style,subumbellate,surface,tear-drop,tip,tree,trichome,tube,tuft,unicellular,uniseriate,vein,white,winged,x	.5,0,0.9-1.1,1.3-1.8,1.5,6-8,anthesi,axil,ba,becoming,berry,caly,calyx,dark,dark-papillo,deflexed,deltoid,dia,differing,difoliate,eaf,edicel,eed,expanded,exserted,free,fruiting,furcate,geminat,impressed,incrassate,interpetalar,lateral,lon,lower,main,margin,maroo,middle,minute,nflorescence,occasionally,older,one,opposite,overlappin,paler,papillae,per,pore,poricidal,portion,prominent,reflexed,ruit,scarcely,simple,sinus,slightly,somewhat,straight,tall,tapering,terminal,thickened,thin,ud,unit,urceolate,widest,woody,ympodial,young	bud,color,dark-papillose,flower,form,glandularity,growth,height,history,length,life,maroon,number,origin,perennial,plant,seed,shape,spacing,texture
746	wfo-0001031618	success	184	92	74	110	18	0.402	-2,1-1.5,10-lobed,2-3,3-4,acute,anther,apex,appearance,base,calyx,capitate,cell,cm,corolla,cuneate,darker,discoidal,equal,erect,facetted,filament,finely,glabrous,glandular,green,greyish,growing,hair,lasting,lavender-purple,leaf,less,long,loosely,marbled,maturity,minute,mm,oblong,obovoid,often,ovary,ovoid,pale,petiole,pinatisect,point,pore,purple,reddish-brown,reticulate,rotate,rounded,rugose,several,shallowly,shrub,simple,slit,soft-wooded,somewhat,stem,stigma,stone,stripe,surface,tapering,terete,tinged,tip,unequal,year,young	0-3,0.5-1.5,1-7,1.5-2,1.5-3.5,10-18,13,2-2.5,3,3-8,4-5,40-60,5,5-12,90-110,acuman,almost,also,anthesi,appearing,aspect,axil,becoming,berry,beyond,blunt,bluntly,branch,broadly,c.,clonal,cluster,column,conical,covering,cut,cyme,developed,dia,eaf,eed,ellipsoid,elliptic,emarginate,enlarged,except,exerted,extending,fleshy,floral,flower,fork,forked,frui,general,giving,greatly,gree,habit,half,interacuminal,lanceolate,lengthening,lobe,lobed,lon,lower,mauve,may,mid-vein,midrib,narrowly,nflorescence,occasional,occur,ovate-lanceolate,pal,pedicel,pedicellate,peduncle,petal,plurifoliat,poricidal,rarely,rhachi,ripe,ruit,scorpioid,sessile,side,single,sinus,sometimes,specimen,stout,strongly,styl,succulent,tissue,triangular,tub,ud,unit,variable,vigorous,way,well,x,ympodial,younger	arrangement,color,form,fruit,growth,height,history,length,life,na,plant,plurifoliate,position,reproduction,seed,shape,style,texture
747	wfo-0001031646	success	171	99	80	91	19	0.468	-7,-pinnate,.2,0.2-0.8,0.5-2,1-10,1-6,1.2-2.5,15-25,18-38,2-10,2.5-10,20,4-5,5,5-7,7-8,8-15,abaxially,acuminate,acute,adaxially,anther,apart,apex,apparently,base,blue,branched,brown,chartaceous,cm,covered,darker,densely,diameter,ellipsoidal,elliptic-lanceolate,filament,flattened,flower,fruit,glabrous,globose,green,high,highly,homostylous,immature,leaf,leaflet,light,maroon,mature,mm,obliquely,pedicel,peduncle,petiole,pubescence,pubescent,rachi,red,rugulose,scandent,shortly,shrub,size,smooth,spreading,stem,stigma,style,surface,tawny,tree,vine,violet,x,yellow	.5,0.8-1.5,1-1.8,1.5-3.5,1.5-4,1962,2-2.5,2-3,3.5-4,4-18,4-20,4-8,4-foliate,5-6,5-7.5,5-merou,absen,absent,accrescent,acut,aggregate,alyx,apical,articulated,axe,ba,basally,berry,blade,calyx,cell,ciliat,climbing,connivent,correll,cuneate,cylindrical,decreasing,directed,distall,eaf,eed,elliptic,entire,equal,fide,fruiting,geminat,glandular,hair,hyaline,interjected,lateral,lobe,long,lower,margin,multicellular,nflorescence,oblique,oblong,obtuse,orolla,ovate-lanceolat,ovate-lanceolate,part,perfect,petiolule,pore,present,pubescen,rotate-pentagonal,rounded,ruit,seudostipule,simple,slightly,small,spaced,stone,stout,tamen,tem,tip,toward,truncat,tube,uniseriate,unit,vary,ympodial	5-merous,arrangement,color,corolla,form,growth,height,inflorescence,length,number,ovary,plant,pseudostipule,seed,shape,spacing,staman,texture,truncate
748	wfo-0001031651	success	201	118	102	99	16	0.507	.7,/3,0.1-0.15,0.1-0.2,0.1-0.25,0.3-0.5,0.3-0.8,0.3-1.5,0.6-1,0.7-1,1-1.7,1-4,1.2-2,1.3-1.6,3-5,4-6,5-merous,abaxial,absent,adaxial,ame,anther,apart,apex,base,berry,branched,c.,calyx,cell,cm,cordate,curved,densely,diameter,dull,elliptic,entire,eye,faint,filament,filiform,flattened-reniform,flower,fruit,fruiting,herb,herbaceous,leaf,length,lobe,margin,mature,maturity,midpoint,mm,naked,obtuse,orange-brown,outline,ovate,pair,pedicel,peduncle,pendulous,petiole,pit,poricidal,porrect,prickly,primary,purple,raised,ray,red,reflexed,rounded,shorter,shrub,small,smooth,sometimes,spherical,stalk,stellate,stellate-pubescent,stem,straight,style,subentire,surface,terete,tertiary,tip,trichome,unarmed,vein,venation,visible,weakly,white,yellow	-2,-3,-3.5,.1,.6,/5,0-20,0.1,0.15-0.2,0.2-0.5,0.6-1.3,1,1-2,1.2-3,1.5-2,1/5,1/6-1/4,2-10,2-3,2-3.5,2/3-3/,4-5,4.5-7,abaxially,acuminat,acute,alyx,apar,apically,apparently,articulated,bark,blade,brown,chartaceous,concolorous,dark,deltate,difoliate,discolorous,drying,eaf,eed,elongating,equal,erect,free,geminat,glabrescent,glabrous,gra,gray,infructescence,lanceolate,lateral,lobed,long,longer,lower,nflorescence,oblong,older,one,open,orolla,oung,per,perfec,pericarp,persistent,portion,prickl,prickle,red-green,ruit,scandent,scar,simple,spaced,spreading,stalked,subsessile,tamen,tapering,terminal,thick,thick-stalked,time,toward,tube,unarme,unit,upper,variously,vary,way,wide,yellow-green,ympodial	color,corolla,form,growth,height,inflorescence,ovary,plant,reproduction,seed,shape,spacing,staman,stigma,texture,visibility
749	wfo-0001031654	success	191	123	98	93	25	0.513	0.5,0.5-0.75,0.5-1,0.5-1.5,0.5-2,0.5-3.5,1-2,1-4,1.5-2.0,1/3-1/2,2-3,2-5,2-8,2-ranked,3,3-10,4-6,abaxial,absent,acute,adaxial,anther,apex,base,brown,chartaceous,cm,cream,cut,cylindrical,dark,decurrent,diameter,extra-axillary,filament,flower,fruit,glabrous,globose,green,hair,immature,leaf,leaf-opposed,less,lobe,lobed,many,margin,mature,midpoint,midvein,mm,moderately,multicellular,nearly,netlike,obtuse,onto,ovate,pedicel,peduncle,per,petiole,pit,porrect-stellate,prickle,pubescent,rachi,raised,ray,red,reniform,ridge,rusty,separated,shrub,side,simple,sinus,slightly,small,sparsely,stalk,stellate,stem,stigma,straight,style,surface,tan,unbranched,unicellular,way,white,whitish,x,yellow	1,1-.,1-1.5,1-3,1.5-2,1.5-3,10-20,2-6,3-6,4-16,4-7,5-8,5-merou,8-15,abaxially,accrescent,adaxiall,adaxially,alyx,apar,apical,apparently,armed,attenuate,axe,berry,beyond,blade,bud,calyx,connivent,contiguous,cordate,cylindrica,densely,difoliate,directed,discolorous,eaf,eed,either,em,equa,exserted,flattened,frui,fruiting,geminate,glabrou,interpetaler,introrsel,lacking,like,long,lower,m.,major,midrib,multiseriate,narrowly,nflorescence,obscure,occasional,occasionally,often,orolla,pair,parallel,perfect,perpendicular,pore,recurved,ruit,scandent,secondary,spaced,spine,spreading,stamen,ste,tamen,tapering,thin-skinned,tissue,triangular,tube,unarmed,unit,usually,vary,vein,wide,ympodial	5-merous,apart,arrangement,color,colour,corolla,form,growth,height,history,inflorescence,length,life,na,number,ovary,perennial,plant,position,reproduction,seed,shape,spacing,staman,texture
750	wfo-0001031656	success	154	68	44	110	24	0.286	1-2,1-2.5,1.2-1.5,1.5-2,1.5-5,3-3.5,3-5,5-ribbed,6-8,anther,bright,capitate,closely,cm,corolla,densely,ellipsoid,elliptic,flower,fruit,glabrous,globose,green,leaf,lobed,matte,minor,mm,opposite,ovary,ovate,papillose,pedicel,petiole,plant,reddish,shiny,shrub,spaced,stigma,strongly,style,surface,white	.5,/4,0.5,0.5-1,1-1.5,10-20,2.5-3.5,4-9,5-7,acuminate,acute,also,anthesi,apex,arising,ba,bark,base,berry,calyx,cork,dia,differing,difoliate,directly,drying,eaf,edicel,eed,enclosing,erect,extremely,filament,fleshy,free,fruiting,geminat,greyish,hooded,known,lateral,live,lobe,lon,long,long-acuminate,lower,main,major,margin,mature,middle,minute,minutely,nflorescence,node,oblique,often,older,one,pair,pale,paler,papillo,peelin,persistent,planar,pore,poricidal,portion,prominent,proximal,rather,red-papillose,reflexed,rib,ridged,rounded,ruit,scar,sessile,shaped,size,slightly,somewhat,specimen,stem,straight,swollen,tall,tear-drop,terminal,thick,thickened,tip,top,transversely,tube,ud,unit,upper,vein,visible,way,wide,widest,woody,x,ympodial,young	abaxial,adaxial,arrangement,color,colour,corky,diameter,form,growth,height,history,inflorescence,length,life,na,number,peduncle,position,rachi,reproduction,seed,shape,spacing,texture
751	wfo-0001031667	success	153	116	86	67	30	0.562	0.6-1,1-1.5,1-4,1.4-3,10-13,12-35,2-3,2-5,2.5-5,3-13,3-5,5-15,5-9,6-10,8-13,8-15,acuminate,acute,apex,apically,apiculate,articulate,base,branched,calyx,cell,cm,cordate,corolla,covering,cuneate,cyme,dark,dehiscent,diameter,dichasial,dichasially,distal,ebracteate,elliptic-lanceolate,filament,flower,forked,globose,green,green-white,hair-like,half,herbaceous,interjected,lanceolate,lateral,leaf,leaflet,mm,monochasial,oblique,odd-pinnate,ovoid,pair,pedicel,peduncle,perennial,perfect,petiole,pilose,plant,poricidally,proximal,rounded,seed,size,spot,stellate,stigma,stripe,style,terminal,testal,thick,throughout,unit,wall,white,yellow,¼	0.6-1.5,1.5-2,2-6,3-6-foliat,3-8,4-1.,abaxially,abruptly,acumen,adaxially,apical,caudate,connate,digestion,diminishing,dorsally,eaf,edge,eed,emoval,enzyme,exceeding,flat,folded,generally,globo,honeycomb,introrse,irregularly,living,lobe,lobed,lon,long,lower,lunat,make,maturing,mucilaginous,nflorescence,nther,oblong,often,orolla,pattern,petiolate,petiolule,plan,reveal,ruit,sessile,seudostipule,short,slit,specimen,stamen,straight,tal,tem,toward,tuber-bearing,typically,vary,whit,wide,without,ympodial	3-6-foliate,4-10,abaxial,adaxial,anther,arrangement,color,dehiscence,foliation,form,fruit,growth,height,history,inflorescence,length,life,lunate,number,ovary,position,pseudostipule,shape,spacing,stem,surface,sympodial,texture,type,width
752	wfo-0001031672	success	157	97	71	86	26	0.452	0.5-1.5,1,1-10,1-5,1.5-2,1.5-5,10-20,15-50,2-12,4.5-5,5-6,6,acute,apart,apex,apiculate,articulated,base,calyx,chartaceous,cm,connective,cylindrical,densely,diameter,flattened,flower,fruit,glabrous,glandular-puberulent,globose,green,greenish-brown,lanceolate,leaf,lobe,long,margin,membranaceous,mm,moderately,narrowly,near,ovate,ovoid,pedicel,pedicellar,peduncle,perfect,petiole,pilose,puberulent,purple,rachi,radiu,rounded,simple,sparsely,stellate,stigma,style,subcoriaceous,thecae,tip,tree,triangular,truncate,unbranched,white,whitish,yellow	0,0-2,0.3-0.5,0.5,0.5-1,1-,1-1.5,1-2,1.5-2.5,1.5-3.5,15-20,2-28,3-4-foliat,3/4,4,4-34,4/5,9-lobed,abaxially,absent,acuminate,adaxially,aggregate,ape,aublet,axe,basal,beyond,blade,cell,ciliat,cordate,directed,distally,divided,eaf,eed,entire,exceeding,exserted,fide,fleshy,hair,leaving,lobed,lon,lower,mature,midrib,nflorescence,nther,obtuse,occasionally,often,one,orolla,pilo,pinnately,pore,presen,present,pubescent,remant,represented,ruit,shorter,sinus,slightly,small,spaced,stamen,stone,tal,tem,time,toward,truncat,tube,ud,unit,unlobed,vary,wide,x,yello,ympodial	abaxial,adaxial,anther,arrangement,bud,ciliate,color,corolla,form,growth,height,history,inflorescence,length,life,number,ovary,perennial,plant,remnant,reproduction,seed,shape,spacing,surface,texture
753	wfo-0001031684	success	161	130	99	62	31	0.615	.25,.5,.75,/4,0.1,0.4-1.5,0.5-0.7,0.5-0.8,0.5-1,0.7-1,0.75-1,1-1.2,1-5,3-3.5,3-30,acute,along,anther,anthesi,apex,bark,base,beneath,black,calyx,clavate,cm,corolla,curly,decurrent,deflexed,densely,dia,difoliate,drying,elliptic,elongated,exserted,filament,filiform,flower,free,fruiting,geminate,glabrous,globose,greatly,green,inflorescence,internodal,leaf,less,lobe,lobed,long,minutely,mm,occasionally,opposite,ovary,ovoid-reniform,pale,papillose,pedicel,persistently,petiole,pitted,planar,pore,poricidal,portion,pubescent,reflexed,shaped,shrub,slender,slightly,small,soon,sparsely,stigma,straight,style,surface,tan,tapering,tear-drop,tip,tipped,tree,trichome,tube,unifoliate,uniseriate,vein,way,white,winged,x	10-100,2,2-9,4-17,5-7,acuminate,apar,bearing,berry,borne,branched,causing,denser,differing,eaf,edicel,eed,except,expanded,extremely,gre,irregularly,lateral,like,lon,long-triangular,lower,main,major,middle,midrib,minor,nflorescence,obconic,older,one,pair,papillo,present,previously,pulled,raised,reflexe,rest,ruit,scar,short,single,siz,size,spaced,stem,tall,time,ud,unevenly,unit,varying,widely,widest,ympodial,young	abaxial,adaxial,apart,arrangement,bud,color,colour,deflexion,diameter,exsertion,form,fruit,grey,growth,height,history,length,life,na,number,peduncle,perennial,plant,position,rachi,reproduction,seed,shape,spacing,texture,width
754	wfo-0001031690	success	140	112	85	55	27	0.607	.5,1.2-2.0,1/2-2/3,2-3,2-5,2-8,2.5-3.5,4-9,7-10,acute,along,anther,apex,apically,bearing,beneath,blade,blue,broadly,brown,calyx,campanulate,cm,corky,dark,depressed-spherical,developing,dm,dry,eglandular,foveolate,glabrate,glabrous,green,hair,internodal,invested,lanceolate,least,length,linear,lobe,long,main,maturity,minutely,mm,numerous,obtuse,often,ovate,persistent,petiole,pinnatifid,prickle,prickly,rarely,reflexed,reniform,rhizome,root,rounded,sessile,shape,slightly,splitting,spreading,stellae,stem,stipitate-glandular,strait,terete,thrice,tightly,tube,twice,ultimate,uniseriate,usually,variable,vein,violet,violet-tinged,viscid-glandular,widely	2.7-3.6,2/3,6-9-flowere,8-40,accrescent,acro,always,alyx,anthesi,arcuate,base,berry,cauline,completely,covered,da,difoliate,divided,eaf,eed,emerging,erect,exceeded,geminat,herb,lon,nflorescence,orolla,pedicel,per,perennial,ruit,scattered,separated,short,slende,slender,somewhat,space,stellate,tall,tamen,tapering,throughout,tigma,tub,tyle,unexpande,unit,vary,yearly,yellow,ympodial,young,zygomorphic	6-9-flowered,across,arrangement,color,corolla,diameter,filament,flower,fruit,height,inflorescence,leaf,na,number,ovary,plant,position,seed,spaced,spacing,staman,stigma,style,surface,texture,type,unexpanded
755	wfo-0001031695	success	185	113	85	100	28	0.459	0.5-1,1-2,1-9,1.5-2,1.5-8,10-35,2-3,20-30,3-10,3-17,3-7,4-5,4-6,5-7,6-10,6-20,6-8,abaxially,abruptly,acuminate,adaxially,aggregate,also,apart,apex,articulated,base,branched,calyx,campanulate,cell,chartaceous,cm,color,connective,dark,deep,densely,diameter,ellipsoidal,flattened,flower,fruit,glabrous,green,greenish,immature,lanceolate,lavender,leaf,lobe,mm,moderately,mottled,narrowly,oblong,occasionally,ovate,pedicel,pedicellar,peduncle,petiole,pilose-hirsute,present,puberulent,puberulent-pubescent,pubescent,purple,purplish,rachi,radiu,remnant,shrub,simple,sparsely,stigma,stone,stripe,style,subcoriaceous,tree,triangular,unbranched,x,yellow	0.5-2,1,1-3,1/2,1/3,10-,10-15,15-20,2-4,2-5,2.5-5,3-,3-19,30-40,4-10,4-foliat,5,5-20,7-,?,acute,ape,apically,apiculate,axe,basal,beyond,blade,broadened,capitat,connivent,cordate,cylindrical,d,dilated,directed,divided,eaf,eed,eglandular,eglandular-pilose,entire,exceeding,exserted,fleshy,glabrate,glabrescent,glandular-puberulent,hair,hard,lateral,laterally,leaving,lilac,lobed,lon,long,lower,margin,midrib,nflorescence,nther,oblique,obtuse,often,orolla,ovoid,perfect,pilo,pilose,pilose-hirsut,pore,presen,ripe,rounded,ruit,shorter,sinus,slight,slightly,small,sometimes,somewhat,spaced,stamen,swelling,tal,tem,thecae,time,tip,tomento,tube,unequal,unit,unknown,unlobed,vary,wide,ympodial	abaxial,adaxial,anther,arrangement,capitate,colour,corolla,form,growth,height,history,inflorescence,length,life,na,number,ovary,plant,position,presence,reproduction,seed,shape,spacing,surface,texture,theca,width
756	wfo-0001031697	success	185	93	57	128	36	0.308	0.4,0.5,1,1.2,4,4.5,?,anther,apex,attenuate,base,blade,cm,cordate,diameter,entire,filament,flower,foveolate,fruit,glabrous,gland-tipped,globose,hair,herbaceous,less,linear,margin,minute,mm,ovate-lanceolate,pedicel,peduncle,petiole,pilose,plant,prickle,pubescence,pubescent,purple,scattered,shallowly,sharp,simple,sparsely,stellate,stem,stigma,straight,style,subreniform,subshrub,thin-textured,unbranched,white,yellow,yellow-brown	-celled,.4,.5,.6,.7,.8,0.1,0.3,0.6–1.0,0.8,1.2–2.5,1.4,1.5–7,10-celled,15,15–60,1–1.6,1–2,2-celled,2-foliate,2.2,2–3,2–4,3,3.5,3–4,3–8,4-rayed,4–5,5,6–13,abaxially,accrescent,acute,adaxially,apparently,around,axe,branch,calyx,completely,consistently,covering,cylindrical,densely,directed,distall,divergent,eaf,eed,especially,except,face,fertile,few-celled,flattened,flowering,free,frui,fruiting,geminat,glabrou,gland-tippe,hilum,hyaline,indentation,lacking,lobe,lon,long,longer,longest,lower,lowermost,lowest,major,many,midpoint,mixed,mostly,nflorescence,non-glandular,often,orolla,ovate,part,per,pigment,pore,raised,ruit,sessile,several-celled,shiny,short,shorter,similar,single,size,slender,small,smaller,somewhat,ste,stellae,tall,tamen,taproo,tem,terminal,thick,time,tip,truncat,tube,tuberculate,ultimate,unarme,unarmed,unit,upper,vary,varying,vein,wide,x,ympodial,–3	1.2-2.5,1.5-7,1.7,15-60,2,2-3,3-8,abaxial,adaxial,arrangement,color,colour,corolla,form,growth,height,history,inflorescence,leaf,length,life,na,number,ovary,position,rachi,reproduction,seed,shape,spacing,staman,surface,texture,thicknes,truncate,width
757	wfo-0001031698	success	58	67	22	36	45	0.379	2-2.5,2.5,bark,cm,dull,elliptic,fruiting,glabrous,green,leaf,margin,minutely,pale,pedicel,pitted,reddish-brown,reniform,shrub,stem,surface,woody,yellowish	'',2.5-3,4-4.5,``,ape,base,branch,decurrent,deflexed,dia,difoliate,eaf,eed,fide,flattened,geminat,incrassate,long,maguire,mm,older,otherwise,paler,papillae,persistin,repandly,rugose,stout,strongly,tall,unit,wing,winged,x,ympodial,young	abaxial,adaxial,alternate,anther,apex,arrangement,bud,calyx,cell,center,color,colour,corolla,diameter,filament,flower,form,fruit,growth,height,history,inflorescence,length,life,na,new,number,ovary,peduncle,petiole,plant,position,prickle,rachi,reproduction,scar,seed,shape,spacing,staman,stigma,style,texture,trichome,width
758	wfo-0001031707	success	178	119	89	89	30	0.5	.5,/4,1-1.3,1.5-6,16-20,2-3,2-4,2-6,24,3,4-5,6-7,80-140,abaxially,acute,adaxially,almost,along,anther,apex,apically,axillary,base,berry,brown,calyx,capitate,cm,conical,corolla,dense,densely,diameter,drying,elliptic,erect,exserted,filament,flattened,flower,four-lobed,glabrous,globose,green,greenish,leaf,leaflet,lobed,margin,minutely,mm,ovary,pair,papillate,pedicel,per,petiole,pink,pinnate,plant,pointed,pubescent,raised,reddish,round,scar,scattered,simple,slightly,smooth,somewhat,spaced,sparsely,stigma,strongly,style,surface,ternate,tip,trichome,tube,uniseriate,vein,vine,way,white,widely,woody,x	-3,0.5-1,1-1.2,1-1.5,1-3,1.2-1.8,1.2-2,1.5-1.7,1.5-2,1/3,2,2-10,4-6,5-10-celled,8-12,9-15,absent,acuminate,anthesi,apical,attenuate,axil,basal,basiscopically,bearing,c.,cateniform,cell,clavat,climbing,conspicuously,cucullate,distal,distinct,eaf,edicel,eed,endrophilum,enlarged,epidermal,flap-like,flat,fleshy,free,fruiting,high,horizonta,inflorescenc,lanceolate,lateral,less,like,lobe,lon,long,lower,narrower,narrowly,nflorescence,oblique,obovate,occasionally,open,penden,petiolule,planar,poricidal,portion,primary,quadrate,quite,regular,rest,ruit,sagittate,smaller,stout,tem,terminal,thickening,time,tub,type,ud,unifoliat,unit,usually,white-lenticellate,ympodial	abaxial,adaxial,arrangement,bud,cateniforme,clavate,color,colour,form,fruit,growth,height,history,horizontal,inflorescence,length,life,na,number,peduncle,position,rachi,reproduction,seed,shape,spacing,staman,stem,texture,width
759	wfo-0001031714	invalid_json_followup	201	125	94	107	31	0.468	-6,-8,0.2-0.5,0.5,1-1.4,1-2,1-3,1.5-2.4,2-3,2-3.5,6-8.5,7,abaxial,absent,anther,apex,bark,base,berry,bright,broadly,calyx,capitate,cell,closely,cm,conical,corolla,cup-shaped,dense,densely,diameter,ellipsoid,elliptic,elongate,entire,filament,flattened,flower,foliose,fruiting,glabrous,globose,greyish,growth,inflorescence,juicy,leaf,less,lobed,margin,minutely,mm,narrowly,nearly,new,often,older,orbicular,ovary,pale,pedicel,peduncle,petiole,pitted,prickle,pubescence,pubescent,rarely,rectangular,red,reniform,ripe,rounded,scar,shallowly,shoot,short,shrub,simple,spaced,sparsely,stellate,stem,stigma,stout,straight,style,surface,terminal,thin,trichome,white,yellow	-3.5,.25,0.15-0.3,0.3-0.5,0.4-,0.5-,0.5-0.6,0.5-0.8,0.7-2.2,0.8-1.2,1,1-4,1.5-2,2,2-4,3-3.5,3-4,3-6,4-merous,6,7-10,7-8,<,?,abaxially,adaxially,anthesi,appearing,arising,armed,articulated,axi,basal,broad,broad-based,caly,eaf,eed,enlarged,equal,erect,especially,exserted,extending,free,frui,irregular,leafy,lengthening,like,lobe,lon,long,longer,lower,markedly,membranous,midpoint,midrib,mixture,nflorescence,numerous,oblique,obvious,occasionally,pair,papillo,per,perfect,pericarp,planar,plate,plurifoliat,pore,poricidal,portion,prickly,primary,ray,ruit,sessile,short-stalked,shorter,sinuate,size,slightly,slit,smaller,sometimes,spreading,stalked,strongly,tapered,testal,tiny,tip,truncate,tube,ud,unarmed,unit,upper,usually,vein,woody,x,ympodial	'',[,``,adaxial,arrangement,bud,center,characteristic,color,colour,form,fruit,height,history,length,life,na,number,plant,position,rachi,reproduction,seed,shape,spacing,staman,texture,value,width,{,}
760	wfo-0001031721	success	208	95	75	133	20	0.361	0-0.1,0-1,0-5,0.2-0.5,0.3-1.1,0.4-0.6,0.4-2.2,0.8-1.3,1-1.5,1-20,1.5,2-4,3-10,5-20,5-7,6-15,6-9,8-15,8.5-12.5,anther,black,brown,chartaceous,cm,dark,densely,diameter,elliptic,extra-axillary,filament,flattened,flower,fruit,glabrous,globose,green,grey,inflorescence,lanceolate,lateral,lavender,leaf-opposed,length,long,longer,midpoint,minutely,mm,ovate,pale,pedicel,peduncle,per,petiole,prickle,purple,rachi,ray,reticulate,simple,sparsely,stalk,stellate-pubescent,stem,stigma,streak,style,surface,time,unbranched,white,wide,yellow,yellowish,yellowish-green	%,.1,0-3,0.1-0.2,0.1-0.5,0.25-0.4,0.25-0.5,0.4-0.7,0.4-1.6,0.6-1.1,0.6-1.2,0.7-1.2,0.7-1.3,1,1-3,1-3.5,1.1-3.2,1.2-1.7,11-30,2.2-3.2,2.5-3,2.7-3.5,3-4.5,3-7,3-foliate,4-5,4-7,4-locular,5-11,5-merou,7-10,7-8,7-9,8-20,abaxially,absen,absent,accrescent,acicular,across,adaxiall,adaxially,alyx,andromonoecious,anvil-shape,apart,apex,articulated,axe,ba,base,blade,calyx,capitat,confined,connivent,cross-section,cuneate,curved,cylindrical,d.,deltate,directed,distall,distributed,dult,eaf,eed,eglandular,entire,erect,exocarp,finger,fruiting,functional,geminat,gland-tipped,hair,half,herbaceous,heterostylous,hig,juicy,lamina,less,lobe,lower,margin,mature,mesocarp,mid-point,midrib,midvein,minute,moderately,moist,nflorescence,oblique,obtuse,orolla,part,placenta,plant,pore,porrect,possibly,present,pseudo-racemose,resprouter,ruit,semi-circular,sessile,short,solitary,somewhat,spaced,stage,stalked,stellae,stellate,straight,tamen,thick,throughout,tube,unarme,unarmed,unit,uvenile,vary,weakly,x,ympodial	5-merous,abaxial,adaxial,arrangement,capitate,colour,corolla,density,dm,leaf,ovary,position,seed,shape,spacing,staman,stella,texture,thicknes,width
761	wfo-0001031723	success	228	128	110	118	18	0.482	-1.5,-5,-8,0.05-0.2,0.1-0.3,0.4-,0.4-1,0.6-1,0.7-1,1-,1-2.5,1-3,1-5,1.2-2,1.5-10,15-45,2-,2-7,2/3-3/4,4-11,4-6,abaxial,abaxially,acuminate,acute,adaxial,ame,anther,apart,apex,bark,base,berry,brown,c.,chartaceous,cm,conical,cuneate,dark,densely,diameter,dull,entire,erect,evenly,eye,filament,finely,flattened-reniform,flower,fruit,glabrescent,gray,green,lateral,leaf,length,lobed,margin,marking,maturity,mauve,midpoint,mm,moderately,multangulate,naked,obtuse,orange-brown,ovate,pair,pale,pedicel,peduncle,petiole,prickle,primary,ray,red,rounded,sessile,shrub,smooth,sometimes,sparsely,spherical,stalked,stellate,stellate-pubescent,stem,straight,style,subentire,surface,terete,terminal,tertiary,tip,trichome,vein,venation,visible,way,weakly,white,whitish,yellow,yellow-green,young	-1/2,-15,-16,-2,-6,-6.5,-merous,0,0.1-0.2,0.1-0.5,0.15,0.2-1,0.4,0.4-0.9,0.55-0.9,0.8-1.5,1-2,1.5-,1.5-2.5,1/3-1/2,1/4-1/3,1/6-,10-30,2-3.5,2-5.5,2.5-4.5,2.5-5,2/3,3-10,3-15,4-,4-10,4-20,4-5,5-40,5-9,8-20,acut,alyx,apar,apically,apparently,articulated,ba,blade,branched,branching,brow,calyx,connivent,curved,deltate,discolorous,drying,eaf,eed,elongated,elongating,equal,filiform,free,fruiting,gently,glabrous,gland,gland-tipped,glandular,hair,herbaceous,inflated,infructescence,lobe,long,longer,lower,mature,minute,narrow-deltate,near,nflorescence,older,one,open,orange,orolla,oung,per,perfec,pericarp,perpendicular,plurifoliat,poricidal,porrect,portion,prickly,recurved,reflexed,ruit,scar,secondary,simple,spaced,spreading,stalk,strongly,tamen,tapering,time,tube,unarme,unarmed,unit,usually,variously,vary,wide,woody,ympodial	color,colour,corolla,form,growth,height,inflorescence,ovary,plant,position,seed,shape,spacing,staman,stigma,texture,unknown,width
762	wfo-0001031729	success	161	103	73	88	30	0.453	-0.5,-2,0.5-1,0.6-,1-2,1-2.5,1.0-1.3,1.5-2,2-2.5,2-3,2.5-5,5-6,5-7,abruptly,acuminate,anther,apex,apicula,branched,brittle,cell,cm,conical,corolla,cucullate,darker,diameter,elliptic,elongate,filament,flattened,flower,fruit,fruiting,glabrous,globose,green,lobed,minutely,mm,mottling,obovate,outline,ovary,ovate-reniform,pale,papillate,papillose,pedicel,peduncle,pericarp,petiole,pink,point,purplish,reddish,regularly,shrub,single,sinuate,smooth,stigma,striate,stripe,surface,tan,testa,thin,time,tip,tube,tuft,x	-45,..,0.5,0.5-4,1-1.5,1.5,10-20,11-30,12-13,2.5-,3-4,3-celled,3.5-4,4.1-16,5-,50,8-9,along,anthesi,apiculate-deltate,attenuate,base,beneath,branc,branch,brow,c.,calyx,curve,dark,deltate,dry,drying,eaf,edicel,eed,erec,flattened-capitat,glandular,gradually,greenish,later,less,lobe,long,lower,markedly,membranous,middle,minute,narrowly,nearly,never,nflorescence,noddin,occasionally,open,outer,pair,papillae,per,planar,plurifoliat,pointed,primary,quadrate,ruit,scar,scattered,short,single-stemmed,small,somewhat,stem,thing,toward,triangular,trichome,ud,unit,usually,vein,wall,wand-like,white,widening,ympodial,young	1,abaxial,adaxial,arrangement,color,colour,flattened-capitate,form,growth,height,history,inflorescence,leaf,length,life,na,nodding,number,perennial,plant,plurifoliate,position,rachi,reproduction,seed,shape,spacing,texture,thicknes,width
763	wfo-0001031738	success	231	133	109	122	24	0.472	-5,-6,-merous,0.7-1,0.7-1.1,1-1.5,1-3,1-4,1.5-4,1/3,1/3-2/3,15-40,2.3-3,20-200,3-4,3-7,4-6,4-8,5,6-15,7-12.5,8-18,abaxial,abaxially,acute,adaxial,adaxially,andromonoecious,anther,apart,apex,articulated,auriculate,bark,base,berry,cell,chartaceous,cm,cordate,curved,dark,deltate,densely,diameter,distance,dull,erect,evenly,filament,flattened,flattened-reniform,flower,fruit,glabrescent,glabrous,gray,green,lateral,leaf,length,lobed,margin,maturity,midvein,mm,multangulate,oblong,obovate,orange,orange-brown,outline,ovate,pair,pale,pedicel,peduncle,petiole,pit,plant,poorly,porrect,prickle,primary,raised,shrub,small,smooth,spherical,stellate,stellate-pubescent,straight,strongly,style,surface,terminal,tertiary,tree,trichome,upper,vein,venation,visible,weakly,white,yellow,yellow-green,yellowish,young	-15,.5,0,0-2,0-3,0.1-0.25,0.2-0.3,0.25-0.8,0.3-1,0.9-2.1,1-1.8,1.4-1.7,1.5-,1/,1/2-2/3,1/4-1/3,1/6-1/4,10-15,2-,2-4,3-6,3.5-3.8,3.5-4.5,4,4-10,4-5,5-8,7-12,8-10,acuminat,almost,always,alyx,apar,apically,apparently,blade,branched,calyx,connivent,discolorous,distal,drying,eaf,eed,elongating,equal,extending,free,frequently,fruiting,held,hermaphrodite,heterostylous,infructescence,inside,lobe,lobing,long,long-styled,longer,lower,lowermost,mature,midpoint,narrow-deltate,nflorescence,often,older,one,open,orolla,oung,per,pericarp,plurifoliat,poricidal,portion,prickl,prickly,prominent,pubescent,ray,reflexed,resin,rounded,ruit,scar,secondary,sessile,short-styled,shorter,side,simple,sometimes,spaced,sparsely,spreading,stalk,stalked,staminat,stem,sticky,stout,tamen,tapering,terete,time,tip,truncate,tube,unarmed,unit,usually,variously,vary,way,white-brow,wide,woody,yellow-orange,ympodial	arrangement,color,colour,corolla,extension,form,growth,height,inflorescence,na,number,ovary,pattern,position,rachi,reproduction,seed,shape,spacing,staman,stigma,texture,white-brown,width
764	wfo-0001031752	success	172	118	85	87	33	0.494	-10,-100,-44,-47,-6,0.5-1,0.5-1.5,1-1.5,1-3,1-4,1.5-10.5,1.5-2,1.5-3.5,15-25,15-40,2-2.5,2-3,2-5,3.5-15,5-6,5-8,acuminate,acute,apex,articulated,base,calyx,chartaceous,cm,connective,darker,deltate,densely,diameter,ellipsoidal,elliptic,flattened,fleshy,flower,fruit,fusiform,glabrescent,glabrous,glandular-puberulent,green,immature,lanceolate,light,lobe,membranaceous,mm,moderately,near,oblong,obtuse,older,ovate,ovoid,pedicel,peduncle,petiole,pink,puberulent,pubescent,purplish,rachi,radiu,ripe,rugose,shrub,simple,small,sparsely,stellate,stigma,stripe,style,subcoriaceous,tree,truncate,unbranched,white,x,yellow,young	-3,-pubescent,1,1-,1-2,1.5-2.5,1.5-3,20-35,3-11.5,3-4,3-4-foliat,3-7,3.5-5,5-23,8-15,9-16,abaxially,adaxially,aggregate,apart,ape,apiculate,axe,basal,beyond,blade,cell,ciliat,ciliate,connivent,cuneate,cylindrical,directed,distally,eaf,eed,entire,equal,exceeding,exserted,glabrate,gland,glandular-puberulen,leaving,less,linear,lon,long,lower,margin,narrowly,nearly,nflorescence,nther,often,olde,orolla,pedicellar,perfect,pore,presen,present,purpl,remnant,rounded,ruit,slightly,spaced,stalked,stamen,stone,subcordate,swelling,tal,tem,thecae,time,tip,tomentose,triangular,truncat,tube,ud,unit,vary,wide,ympodial	abaxial,adaxial,anther,arrangement,bud,color,colour,corolla,filament,form,growth,height,history,inflorescence,leaf,length,life,na,number,ovary,plant,position,pseudostipule,purple,reproduction,seed,shape,spacing,staman,stem,surface,texture,width
765	wfo-0001031756	success	186	140	112	74	28	0.602	-5,.1,.5,.8,/2,0-2,0-5,0.1,0.4-1.6,0.5-1,0.6-1.6,0.8-1,00,1-3,1-4,1.5-2,1.5-3.5,10,2-6,3-5,3-7,5-merous,9-14,abaxially,accrescent,anther,apart,apex,articulated,bark,base,berry,calyx,cm,color,conical,cordate,densely,diameter,enclosing,entire,erect,evenly,eye,filament,finely,flattened-reniform,flower,fruit,fruiting,fully,glabrescent,glabrous,gray,green,herbaceous,inflated,invested,known,leaf,lobed,long,margin,mature,mauve,midpoint,mm,moderately,naked,older,orange-brown,ovate,pair,pale,pedicel,peduncle,pendulous,petiole,pitted,porrect,prickle,prickly,primary,ray,red-brown,rounded,scandent,shoot,short,shorter,shrub,simple,sparsely,spherical,stalk,stellate-pubescent,stem,straight,style,surface,terete,terminal,trichome,truncate,unarmed,vein,visible,way,white,wide,yellow-green,young	-1,0,0.02-0.2,0.15-0.25,0.2,0.5-1.3,0.6-1.2,0.7-1.7,1-1.8,1-2,1.8-2.5,1/2,1/3,3-15,4-5,4.5,6-9,7-10,acut,alyx,apar,apically,apparently,blade,branched,broad-deltate,chartaceous,concolorous,connivent,curved,deltate,drying,eaf,eed,elongating,equal,free,glabrou,infructescence,lobe,longer,lower,nflorescence,one,open,orolla,oung,per,perfec,pericarp,perpendicular,plurifoliat,poricidal,portion,prickl,ruit,scar,sessile,slender,small,smooth,spaced,spreading,stalked,stellate,tamen,tapering,time,tip,tube,unit,variously,vary,ympodial	abaxial,adaxial,arrangement,colour,corolla,form,growth,height,history,inflorescence,investment,length,life,na,number,ovary,plant,position,rachi,reproduction,seed,shape,spacing,staman,stigma,texture,visibility,width
766	wfo-0001031761	success	207	105	81	126	24	0.391	-12,-20,.5,0,0-10,0-12,0-5,0.3-2.8,0.5-0.7,0.7-1.3,0.7-1.6,0.9-2,1,1-4,2-3.5,3-5,3.2-3.5,4-7,acute,anther,apart,apex,bark,base,berry,branched,calyx,cm,cordate,densely,diameter,dull,elongating,erect,faint,filament,flattened-reniform,flower,fruit,fruiting,lateral,leaf,length,lobe,lobed,long,margin,mauve,mm,moderately,orange,orange-brown,ovate,pair,pedicel,peduncle,petiole,prickle,primary,purple,red,red-green,rounded,scandent,scar,shrub,smooth,sparsely,spherical,stellate-pubescent,stem,style,surface,terete,tertiary,vein,venation,visible,weakly,woody,yellow	-3/,-6.5,-7,.4,0-0.4,0-15,0-25,0-4,0.2-0.4,0.3,0.3-0.4,0.5,0.5-1.5,0.6-1.2,0.75-1.7,1-3,1-8,1.5,1.5-4.2,1.5-6,1.8-2.3,1/2,1/2-2/3,1/3,1/3-2/3,1/4-1/3,2,2-4,2-8,2.5-3.1,2.5-5.5,3-15,4-6,5-merous,7-9,abaxially,acicular,acut,alyx,ame,apar,apically,apparently,articulated,blade,brow,c.,cell,concolorous,connivent,curved,deltate,difoliate,discolorous,distance,drying,eaf,eed,equal,extending,flattened,free,fully,geminat,glabrous,gray-green,infructescence,longer,lower,mature,maturity,midpoint,midvein,narrow-oblong,nflorescence,older,one,open,opening,orolla,oung,outline,pale,per,perfec,pericarp,perpendicular,pit,poricidal,porrect,portion,prickly,raised,ray,recurved,sessile,shallow,side,simple,slender,small,sometimes,spaced,spreading,stalk,stalked,stellate,straight,tamen,tapering,thick-chartaceous,time,tip,trichome,tube,uit,unarme,unarmed,unit,upper,variously,vary,way,wide,yellow-green,ympodial	abaxial,adaxial,brown,color,colour,corolla,form,growth,height,history,inflorescence,life,ovary,perennial,plant,position,reproduction,seed,shape,spacing,staman,stigma,texture,unknown
767	wfo-0001031786	success	209	115	93	116	22	0.445	/3,0.1,0.1-0.4,0.2-2.5,0.5-1.5,0.7-1,0.7-1.6,0.7-4,1,1-4,1.2-1.6,1.5-2.5,2-3,2-7,2-8,4-5,5-merous,6-8,abaxially,acute,almost,anther,apex,apparently,articulated,bark,base,berry,cell,chartaceous,cm,curved,dark,deep,densely,diameter,elliptic,erect,filament,flattened-reniform,flower,fruit,glabrescent,glabrous,herb,lateral,leaf,length,lobed,long,maturity,mauve,membranous,midpoint,mm,orange,outline,ovate,pale,pedicel,peduncle,petiole,pit,porrect,prickle,raised,ray,red,red-brown,reflexed,sessile,shiny,shrub,small,smooth,sometimes,sparsely,spherical,stalked,stellate-pubescent,stem,stigma,straight,style,surface,terete,trichome,variously,way,weakly,white,wide,yellow-orange	-5,.4,.5,/2,0,0-2,0-20,0-3,0-5,0.2-0.3,0.25-0.5,0.8,0.8-1.2,1-2,1-3,1-6,1.5-1.9,1/3-1/2,2-13,2.5-3.5,3-4,3-5.5,5-7,8-12,acut,alyx,ame,apar,apart,apically,becoming,blade,branched,c.,calyx,clavat,concolorous,connivent,cuneate,deltate,distance,drying,eaf,eed,elongating,equal,evenly,extending,eye,filiform,flattened,free,fruiting,gray,gray-brow,green,herbaceous,inconspicuous,infructescence,lobe,lon,longer,lower,margin,mature,midvein,minute,naked,nflorescence,obtuse,older,one,open,orange-brown,orolla,oung,pair,pendulous,per,perfec,pericarp,plurifoliat,poricidal,portion,prickl,prickly,primary,rounded,ruit,scandent,scar,shorter,side,simple,slightly,spaced,spreading,stalk,stellate,tamen,tapering,tertiary,thick,time,tip,truncate,tube,unarmed,unit,vary,vein,venation,visible,woody,ympodial,young	abaxial,adaxial,clavate,color,colour,corolla,form,gray-brown,growth,height,inflorescence,na,number,ovary,plant,reproduction,seed,shape,spacing,staman,texture,width
768	wfo-0001031791	success	288	121	89	199	32	0.309	.3,.5,.9,0.2,0.7,15.0,3,abaxially,acute,adaxially,alveolate,anther,apex,area,base,brochidodromous,central,chartaceous,cm,cordate,corolla,developed,diameter,distinct,dry,entire,erect,extra-axillary,filament,flattened-reniform,flattened-suborbicular,flower,fruit,glabrous,globose,green,inflorescence,internode,interpetalar,lanceolate,lateral,lavender,leaf,length,margin,material,maturing,midvein,mm,moderately,nearly,orange-red,oval,pedicel,peduncle,petiole,poorly,preserved,pubescent,raised,ray,rounded,shiny,shrub,simple,small,smooth,somewhat,stellate,stem,stigma,stipe,straight,style,subcoriaceous,surface,thrice-branched,tissue,tree,triangular,truncate,twice,vein,wavy,weakly,well,white,yellow,yellow-tan	.08,.2,.4,0.04,0.3–0.5,0.3–0.6,0.3–0.7,0.4–0.6,0.5,0.5–0.6,0.5–1.0,0.7–0.8,0.7–1.0,1.1–1.4,1.3–1.8,1.5,1.5–1.9,1.5–2.3,1.5–3.0,1.6,1.6–2.2,1.7–2.3,1.8,1.9–2.2,1/3,11–14,11–15,13.0–30.0,2.0–11.0,2.0–2.5,2.6–3.4,2.8–3.3,2/3,3.0,3.0–3.5,33–54,4.6–5.4,4.9,4.9–7.4,5-merou,6.0,6.0–14.0,6.2–8.5,7.0–9.0,7–10,7–8,8.0–11.0,8–12,9.0–16.0,across,adaxiall,adnate,alyx,anthesi,apical,apiculate,apparently,appearing,appressed,around,articulated,attachment,attenuate,axe,ba,backward,berry,blade,branch,broad,broad-based,bud,calyx,capitat,channeled,congested,connivent,curved,dehiscence,densely,dentate,development,difoliate,distally,dorsally,drying,eaf,eed,either,emerging,endocarp,entir,especially,fertile,filiform,first,flexed,fork,free,frui,geminat,glabrescent,glandular,gradually,hair,homostylous,immature,inclined,increasing,intersepalar,juic,juvenile,lamina,large,largest,light,like,line,lobe,lon,long,longer,lower,m.,major,mature,membranaceous,middle,midpoint,midrib,minor,minute,multangulate,nflorescence,notched,numerous,oblique,obscured,often,one,orolla,oung,ovoid,particularly,persisting,point,pore,porrect,porrect-stellate,portion,potentially,prickle,project,rigid,ripe,row,rugose,ruit,scarcely,scattered,sessile,short,shorter,side,single,sinus,slender,slightly,smaller,sometimes,sparsely,splitting,stamen,stellae,stellate-pubescen,stipitate,suture,tamen,tardily,time,tip,totally,translucent,tube,two,ud,unarmed,undulate,various,vary,wide,yellow-brown,ympodia,young,±90°at,±equal,±glabrous,±laterally,×	0.5-1.0,2.0-11.0,2.8-3.3,3.0-3.5,33-54,5-merous,6.2-8.5,7-8,8.0-11.0,abaxial,adaxial,arrangement,capitate,color,colour,form,growth,height,na,number,ovary,plant,position,rachi,reproduction,seed,shape,spacing,staman,texture,width,x
769	wfo-0001031793	success	188	125	97	91	28	0.516	-4,.5,0,1,1-2,1-8,1.5-4,1/3,1/4,10-15,15-20,2-3,2-5,26,3-4,3-8,40,5-merous,abundant,acuminate,aging,almost,anther,apex,armed,articulated,base,black,branched,broadly,brown,brownish,capitate,cm,cuneate,cut,densely,diameter,elliptic,evident,extra-axillary,ferrugineous,filament,flattened,flower,forked,fruit,globose,hair,inflorescence,interpetalar,leaf,lobe,lobing,long,margin,midrib,minutely,mm,mucilaginous,oblique,orange-yellow,orbicular-ovate,ovate,pedicel,peduncle,petiole,prickle,principal,pubescent,rachi,reddish,rounded,rusty,scarcely,scattered,shallow,shrub,side,simple,size,small,stellate,stellate-pubescent,stem,stigma,style,surface,tissue,tree,unbranched,way,well-developed,white,x,yellow,yellow-brown	1-1.5,1-3,1.5-2,1/5,13-20,20,3/4,4,7,8-11,absent,accrescent,acumen,acute,adult,alyx,apparently,aspect,axe,ba,berry,bilobe,blade,branche,broad,calyx,central,chartaceous,difoliate,distal,eaf,eed,elongatin,erec,erect,extreme,fruiting,geminat,general,glandular,homostylou,larger,linear,lon,lower,main,many,maturing,midpoint,mostly,nflorescence,oblong-lanceolate,obtuse,often,older,orolla,per,perfect,pore,porocidal,porrect,reduced,reticulation,ruit,sessile,similar,single,sinus,smaller,sparsely,stellate-pubescen,stipitate,stout,tall,tamen,tem,testa,thickened,tip,triangular,triangular-acuminat,trichome,tube,unarmed,unit,upward,usually,uvenile,vary,woody,ympodial	abaxial,adaxial,armament,arrangement,bilobed,color,colour,corolla,form,growth,height,history,homostylous,juvenile,length,life,na,number,ovary,plant,position,reproduction,seed,shape,spacing,staman,texture,width
770	wfo-0001031795	success	234	131	106	128	25	0.453	..,0.5,0.5-1,0.5-2,1,1-1.2,1-3,1-4,1.5-2,1.5-4,10-12,2-6,2/3,3,5,50,6-8,abaxial,acuminate,acute,adaxial,almost,anther,apex,articulated,base,berry,branched,calyx,capitate,cm,conical,curved,densely,diameter,elliptic,entire,evenly,filament,flattened,flower,fruiting,globose,grayish,green,growth,irregularly,lateral,leaf,leaf-opposed,live,lobe,lobed,long,long-stalked,margin,matte,midpoint,minutely,mm,multiseriate,oblique,occasionally,ovate,pale,pedicel,peduncle,pendant,persistent,petiole,pitted,plant,porrect,pubescent,ray,reniform,ripe,scar,shallowly,shape,shiny,short-,shrub,slender,slightly,smooth,somewhat,spaced,sparsely,spreading,stellate-pubescent,stem,stigma,style,surface,tan,terete,thin,time,trichome,truncate,way,white,woody,yellowish,½	.2,.5,1-1.3,1/3,10,100,2-2.5,2.5-3,3-4,4-,4-5,4-6,5-12,5-40+,5-merous,5.5-,7-9,9-17,<,>,abaxially,absent,adaxiall,alf,along,always,alyx,anthesi,apar,armed,around,bark,blade,broad-based,broadly,brownish,c.,caudate,cell,clearly,connivent,dark,deeply,denser,differing,difoliate,directed,discolorous,distally,dry,eaf,eed,equal,free,geminat,geminate,glabrescent,glabrous,gland-tipped,glandular,gra,infructescence,lamina,like,lon,longer,lower,major,many-branched,membranous,midrib,midvein,minor,mixture,much,multangulate,never,new,nflorescence,often,older,orolla,oung,outline,pair,papillat,per,perfec,pericarp,pore,poricidal,portion,prickle,prickly,primary,reduced,reflexed,ruit,scattered,sessile,short,short-stalked,simple,sinuate,size,stalk,stellate,straigh,tamen,tapering,testal,thicker,tip,toward,triangular,tube,unarme,unarmed,unicellular,unit,upward,usually,vary,vein,visible,wide,ympodial,young	apart,articulation,branching,color,corolla,form,fruit,height,hermaphroditic,history,inflorescence,length,life,na,number,ovary,perennial,persistence,reproduction,seed,spacing,staman,straight,texture,type
771	wfo-0001031829	success	138	84	56	82	28	0.406	.25,0.5-2.1,0.7-1,1-2,1.3-1.5,1.5-2,1.5-4.5,2-4,4-4.5,acute,adaxial,anther,apex,bark,base,capitate,cm,corolla,densely,elliptic,filament,globose,green,greenish-brown,growth,inflorescence,lateral,leaf,lobed,main,margin,minor,minutely,mm,opposite,ovary,packed,papillose,pedicel,petiole,pubescent,revolute,shaped,shrub,simple,size,sparsely,stigma,style,surface,tapering,tear-drop,vein,waxy,white,x	.5,1,1.5-2.5,1.5-3.5,3-5-flowered,3/4,4-8.5,7-10,abaxially,absent,adaxially,along,anthesi,ape,apiculae,bae,berry,branched,broadly,calyx,conical,crystalline,deflexed,denser,dia,differing,difoliate,drying,eaf,edicel,eed,epidermi,erect,exserted,free,fruiting,geminat,glabrat,glabrous,immature,known,large-celled,leathery,like,lobe,lon,long,lower,major,minute,nflorescence,occasionally,often,older,overlappin,pair,papillo,planar,pore,poricidal,portion,quadrate,ruit,scar,soft,somewhat,stem,tall,thick,tip,trichome,tub,tube,tuft,ud,uniseriate,unit,way,woody,yellowish,ympodial,young	3-5,abaxial,arrangement,color,colour,diameter,flower,form,fruit,glabrate,height,history,length,life,na,number,peduncle,perennial,plant,position,rachi,reproduction,seed,shape,spacing,staman,texture,width
772	wfo-0001031832	success	232	124	101	131	23	0.435	0.1-0.3,0.2-1.5,0.3-0.8,0.3-3,0.7-2,1-12,1.2-1.6,1/2-3/4,14,2-4,2-6,2.5-6.5,3-6.5,3-7,4-20,5-21,5.5-10,8-25,9,anther,apart,bark,base,becoming,blade,branch,branched,brown,brownish,bud,bullate,calyx,chartaceous,cm,conical,continued,corolla,dark,deltoid,diameter,due,ferrugineous,filament,fleshy,flower,fruit,glabrescent,globose,granular-tomentose,green,greenish,growth,honeycombed,indument,lanceolate,lateral,leaf,length,lobed,mm,mostly,oblanceolate,oblong,obovoid,orbicular,pale,pedicel,peduncle,persistent,petiole,pitted,probably,pubescent,rachi,relatively,reniform,reticulate-punctate,ripe,rotate-stellate,rough,scabrous,shrub,simple,smooth,somewhat,sparingly,stem,stigma,style,suborbicular,terete,terminal,thick,time,tree,violet,way,white,x,yellow,yellowish	-8,.5-1,/50-1/10,0-150,0.2-0.6,0.7-1.5,0.7-1.6,0.8-1.2,1.1-2.4,1.2-2,1.2-2.5,1.3-4.2,1.5-4,1.7-4,1.8-4,2-3.6,2.8-4.8,3.5-7,4-7,7-10,abaxially,accrescent,acuminate,acute,adaxially,ag,anthesi,apex,apical-lateral,apice,apparently,articulated,attenuate,axe,axillary,ba,basal,berry,blister,blunt-tipped,capitat,closely,connate,decurrent,dehiscing,directed,eaf,eed,entire,evident,exserted,extend,few-rayed,forming,free,fruiting,glabrescen,glabrous,hair,half,high,inserted,introrse,lackin,large,line,lobe,long,long-,longer,longitudinal,lower,m.,main,margin,midvein,minute,mixed,multangulate,nearly,nflorescence,obtuse,occasionally,older,orolla,ovate,partly,perfect,plurifoliate,pore,porrect-stellat,porrect-stellate,pubescence,rather,ray,ruit,runk,sessile,short-,short-stalked,side,slit,sometimes,soon,spaced,sparse,splitting,stamen,stellate-pubescent,stipitate-glandular,subcampanulate,surface,suture,swelling,tamen,testa,thick-stalked,toward,translucent,tube,unarme,unarmed,unit,usually,vary,vein,weakly,whitish,wide,ympodial,young	1/50-1/10,20-150,abaxial,adaxial,arrangement,branching,capitate,color,form,height,inflorescence,number,ovary,persistence,plant,ratio,seed,shape,size,spacing,staman,texture,thicknes
773	wfo-0001031834	success	150	110	77	73	33	0.513	.5,0.5,0.5-1,0.5-3,0.5-3.5,0.6-1.4,0.8-1,1,1.5,1.6-2,6-7,accrescent,acuminate,acute,anther,anthesi,apex,base,calyx,campanulate,cm,corolla,deflexed,deltoid,few-flowered,filament,flattened-reniform,fruit,fruiting,glabrous,globose,green,greenish-yellow,hooked,incrassate,leaf,less,lobe,lobed,long,margin,minute,minutely,mm,opposite,ovary,ovate,pale,papillose,pedicel,petiole,pitted,planar,pubescent,scabrous,scar,shrub,simple,slightly,spaced,sparsely,speck,stem,stigma,style,surface,tan,tapering,tip,trichome,tube,tufted,unevenly,white,woody,x,yellow	0.8-1.3,0.9-1.4,1.5-4,1.9-6.5,2.9-7,2/3,6.5-14,across,apar,apically,apiculate,appear,attenuate,berry,bi-cellular,borne,covered,deciduou,deciduous,decurrent,depression,dia,difoliate,eaf,edicel,eed,expanded,eye,free,geminat,glabrou,hook,lamina,larger,leaving,like,lon,lower,major,markedly,middle,minor,mound-like,multicellular,naked,nflorescence,often,papillo,persistent,pore,poricidal,portion,proximal,ruit,shaped,short,slender,small,soon,straight,tall,tear-drop,ud,uni-,uniseriate,unit,upper,usually,vein,way,widest,ympodial,young	abaxial,accrescence,adaxial,apart,arrangement,bud,color,colour,diameter,flower,form,growth,height,history,inflorescence,length,life,na,number,peduncle,perennial,plant,position,pubescence,rachi,reproduction,seed,shape,spacing,speckle,staman,texture,width
774	wfo-0001031839	invalid_json_followup	138	115	69	69	46	0.5	1-1.4,1.2-1.5,1/3-2/3,2.5-3.5,3-7,4-8,6-15,7-10,8-15,along,anther,apically,armed,blade,blue,blue-tinged,broadly,brown,cm,dark,dark-based,deltoid,density,erect,foveolate,glabrous,green,herb,internodal,lenticular,ligneous,long,main,minutely,mm,olivaceous,otherwise,ovary,ovate,pale,perennial,persisting,petiole,pinnatifid,prickle,prickly,purple,root,several,smooth,somewhat,spherical,spreading,stellate-pentagonal,stellate-pubescent,stellate-tomentose,stem,subulate,tawny,twice,usually,varying,vein,velvety-tomentose,weakly,white,whitish,year,yellow	.5,1,2/3,8-14-rayed,9-12,9-13-flowere,accrescent,across,alyx,annually,anthesi,arcuate,base,becoming,beneath,berry,bristly,broad,calyx,campanulate,cauline,confluent,da,densely,developing,dia,difoliate,divided,dry,eaf,eed,emerging,extended,externall,fully,geminat,invested,linear-lanceolate,lobe,lon,long-stalked,long-stipitate,maturity,nearly,nflorescence,often,orolla,pubescent,rounded,ruit,short,slende,splitting,stella,stellae,stellate-tomento,stipitate,tamen,throughout,tightly,tigma,tub,tube,tyle,ultimate,unexpande,unit,ympodial,zygomorphic	'',9-13-flowered,[,``,abaxial,adaxial,apex,arrangement,characteristic,color,colour,corolla,diameter,filament,flower,form,fruit,growth,height,history,inflorescence,leaf,length,life,na,number,pedicel,peduncle,persistence,plant,position,rachi,reproduction,seed,shape,spacing,staman,stigma,style,surface,texture,unexpanded,value,width,{,}
775	wfo-0001031842	success	161	120	89	72	31	0.553	0.1-0.5,0.5-2,0.6-1,0.7-1,1-1.8,10-20,2-10,2.5-3,3-8,3/4,4.5-6,acute,anther,apart,apex,bark,base,beginning,beneath,bi-lobed,brown,calyx,capitate,cm,corolla,cup-shaped,dark,deeply,dry,ellipsoid,elliptic,exsertion,filament,flattened-reniform,free,glabrous,globose,green,irregularly,later,lateral,leaf,leaf-opposed,lobed,minutely,mm,near,new,often,opposite,ovary,overtopping,pale,papillose,pedicel,petiole,pitted,pore,poricidal,portion,scar,shaped,shiny,shoot,shrub,simple,slender,soon,spaced,specimen,stem,stigma,strongly,style,surface,tapering,tear-drop,terminal,tip,tree,trichome,tube,tuft,uniseriate,way,white,woody,yellowish,young	.1,.4,.5,.75,0.5-1,1,1-1.5,1-3.5,1.5-2,10-12,10-30-flowered,2-3,2.5-6,7-9,9-15,anthesi,attenuate,axil,ba,bearing,berry,cusp,decurrent,deflexed,densely,dia,differing,difoliate,eaf,edicel,eed,exserte,fruiting,geminat,incrassate,inflorescenc,lobe,lon,long,lower,main,major,margin,middle,minor,nflorescence,older,one,onto,pair,paler,papillo,prominent,pubescent,quadrate,reddish,reddish-resinous,reflexed,ruit,size,somewhat,sparsely,straight,tall,time,ud,unit,vein,widest,x,yellowish-whit,ympodial	0.5,10-30,abaxial,adaxial,arrangement,bud,color,colour,diameter,exserted,flower,form,fruit,growth,height,history,inflorescence,length,life,na,number,peduncle,plant,position,rachi,seed,shape,spacing,texture,width,yellowish-white
776	wfo-0001031843	success	245	135	109	136	26	0.445	.5,0-4,0.5-1.5,0.6-1.2,0.8-2,1-7,1.2-2,1.2-2.2,1.5-2,3-4,3-7,5-12,6-9,acuminate,age,almost,always,anther,apex,apically,apparently,appressed,around,bark,base,berry,black,branch,brown,capitate,caudate,cm,conical,corolla,curved,dark,deeply,density,diameter,dilated,discoid,distributed,domatia,drying,dull,erect,evenly,eye,filament,finely,flower,glabrous,green,hand,honeycomb,largely,leaf,len,length,liana,lignified,lobed,long,longitudinally,main,mm,naked,oblong,obovate,older,orange,orange-brown,orange-yellow,pattern,pedicel,peduncle,petiole,pitted,present,prominent,pubescent,rachi,red,reddish,ridged,scar,seed,shiny,shrub,side,slender,sometimes,sparsely,spheroidal,stem,stigma,straight,stump,style,surface,terminal,thick-chartaceous,trichome,variable,violet,visible,white,x,young	.2,.3,.6,0.2-2,0.4-0.5,0.5-1,0.7-1.2,0.7-2,1-2,1.5,1.8-2.5,1/6-1/4,1mm,2-3,2-4,2.5,4-12,45-60°,5-10,abaxially,accrescent,adaxially,along,alyx,anthesi,apar,apice,articulated,attenuate,basal,becoming,branched,branching,broadly,calyx,canaliculate,clearly,collapsing,completely,cupular,cuspidate,delineated,deltoid,dendritic,detaching,discolorous,eaf,eed,ellipsoi,entire,equal,even,fertilisation,fine,flat,flexuous,forming,free,fruiting,inner,leave,lengthening,like,lobe,loop,looping,lower,m.,margin,midvein,much,multiseriate,network,never,nflorescence,nther,oblique,obscure,opening,orolla,outline,ovate,pair,papillo,part,partly,pendulous,perfec,pericarp,pit,plurifoliat,pore,poricidal,portion,primary,pronounced,protruding,raised,rarely,recurve,reveal,ribbed,rounded,ruit,see,shallowly,shortly,simple,sinus,slightly,small,smaller,smooth,soon,spreading,strongly,surfac,tearing,tertiary,thickened,thin,tip,tube,tuft,twice,ud,unarmed,unit,vary,vein,venation,weakly,wide,wider,without,ympodial	abaxial,adaxial,apart,arrangement,color,colour,form,fruit,growth,height,inflorescence,na,number,ovary,papillose,perfect,plant,position,presence,reproduction,seen,shape,spacing,staman,texture,visibility
777	wfo-0001031852	success	155	95	67	88	28	0.432	0.1-1,1-4,1-4.2,1-9,1.4-3,12-35,3-9,4-6,7-,9-11,apex,articulate,base,branched,cell,cm,conical,corolla,covering,cyme,diameter,dichasial,dichasially,digestion,distal,ebracteate,elliptic-lanceolate,enzyme,filament,flower,green,green-white,hair-like,half,herbaceous,honeycomb,lanceolate,lateral,leaf,light,long,mm,monochasial,mucilaginous,odd-pinnate,ovoid,pattern,pedicel,peduncle,perennial,petiole,plant,proximal,pubescent,rachi,seed,size,stellate,stigma,style,testal,thick,throughout,wall,white,yellow,¼	-8,0.5-1.3,0.5-3,1-,1.3-2.5,1.5-3,2-3,2-5.5,2.6-9.5,3-4,3-6-foliat,3.5-10,4-,4-10,4-5,5-15,abaxially,abruptly,absen,acumen,acuminate,acute,adaxially,apical,apically,apiculate,attenuate,calyx,connate,decurrent,dehiscent,diminishing,dorsally,eaf,edge,eed,elliptic,emoval,exceeding,flat,folded,forked,generally,globo,interjected,introrse,leaflet,living,lobe,lon,lower,lunat,make,maturing,nflorescence,nther,oblique,oblong,often,orolla,ovate-elliptic,pair,perfect,plan,poricidally,reveal,ruit,sessile,seudostipule,short,shortly,slit,specimen,stamen,straight,tal,tem,terminal,throughou,toward,tuber-bearing,typically,unit,vary,white-crea,wide,without,ympodial	abaxial,adaxial,anther,arrangement,color,colour,form,fruit,globose,growth,height,history,inflorescence,length,life,na,number,ovary,position,reproduction,shape,spacing,staman,surface,texture,wet,white-cream,width
778	wfo-0001031864	success	140	101	71	69	30	0.507	.2,.25,.5,0.2-0.5,0.4-3,0.5-13.5,0.5-4,0.6-3.5,0.6-4,1-1.2,1-1.8,1-2,1-3,1.5-10,15-60,2-3,2.5-6,3-3.5,3-pinnate,5-15,abaxially,adaxially,anther,apex,apical,apiculate,base,cm,color,cuneate,dense,diameter,emarginate,extra-axillary,filament,flower,fruit,glabrous,herbaceous,leaflet,lenticular,long,minutely,mm,near,oblique,ovoid-deltoid,pedicel,peduncle,petiole,petiolule,pubescence,pubescent,rachi,rotate,rounded,short,slender,sparsely,stem,stigma,style,surface,tip,trichome,truncate,unbranched,unknown,vine,violet,x	0.7-0.8,0.8-1,1-5,1-6.5,1.2-1.5,1.5,1.5-2.5,2,5-9,5-merous,7.5-8,accrescent,acuminate,acute,alyx,apar,axe,berry,blade,c.,calyx,capitat,chartaceous,ciliate,clavate,deltoid,densely,eaf,eed,entire,fine,flattened,fleshy,fruiting,glabrou,hair,lateral,like,lobe,lon,lower,m.,margin,middle,moderately,nflorescence,nternode,orolla,papillose,perfec,plurifoliat,pointed,pubescenc,ruit,sand-punctate,scattered,slightly,spaced,tamen,tem,terrestria,tube,typical,unit,vary,vein,wide-diameter,widely,ympodial	abaxial,adaxial,apart,arrangement,capitate,colour,corolla,form,growth,height,history,inflorescence,internode,leaf,length,life,na,number,ovary,perfect,plant,position,reproduction,seed,shape,spacing,staman,terrestrial,texture,width
779	wfo-0001031864	success	148	92	67	81	25	0.453	.2,.25,.5,0.5-13.5,0.5-4,1-1.2,1-1.8,1-2,1-3,15-60,2-3,2.5-6,3-3.5,3-pinnate,5-15,7.5-8,abaxially,absent,adaxially,anther,apart,apex,apical,base,blue-purple,ciliate,cm,color,cordate,cuneate,dense,diameter,entire,extra-axillary,filament,fleshy,flower,glabrous,herb,interjected,lateral,leaflet,lenticular,margin,mm,oblique,oblong,pedicel,peduncle,petiolule,pubescence,pubescent,rachi,rotate,rounded,short,slender,somewhat,stigma,style,surface,terrestrial,trailing,unbranched,unknown,x,yellow	0.4-3,0.6-3.5,0.6-4,1-5,1-6.5,1.2-1.5,1.5,1.5-2.5,2,3-5-celled,5-9,5-merou,accrescent,acuminate,acute,ag,alyx,apiculate,apparently,articulated,axe,ba,basally,blade,calyx,capitat,center,clavate,connivent,deltoid,densely,directed,distally,eaf,eed,emarginate,equal,etiole,fine,fruit,fruiting,geminat,hair,large,lobe,long,longitudinal,lower,m.,minutely,near,nflorescence,node,opening,orolla,papillose,perfect,plurifoliate,pore,pubescenc,rooting,scattered,simple,slightly,slit,spaced,sparsely,tamen,tem,thick,tip,truncate,tube,uniseriate,unit,vary,weakly,widely,wiry,woody,ympodial	abaxial,adaxial,arrangement,capitate,corolla,form,growth,height,history,inflorescence,leaf,length,life,na,ovary,petiole,plant,position,reproduction,seed,shape,spacing,staman,texture,width
780	wfo-0001031871	success	185	89	62	123	27	0.335	0.4-2,0.6-1.2,1-2,1.5-11,14-22,3-10,3-5,3.5-4,33-40,6-7,6.5-20.5,acute,anther,apex,cell,chartaceous,clavate,cm,condition,corolla,covering,dark,deep,diameter,dot,drying,elliptic,filament,flower,forked,fresh,fruit,glabrous,globose,green,greenish,hair-like,herb,honeycomb-shaped,medium,mm,mucilaginous,odd-pinnate,ovate,ovoid,pedicel,peduncle,petiole,plant,rotate,rounded,seed,stigma,style,subglabrous,terminal,testal,thick,tiny,white,whitish,yellow	1.4-2.1,1.5-2,1.5-2.1,1.6-2.7,2-3,2-4,2.9-6,3-4,36-44,4-6,4-7,5-merou,5.4-12.3,6-12,7-9,7.5-23,abaxially,acumen,adaxiall,adaxially,ag,alyx,apart,apparently,articulated,asymmetric,attenuate,axe,axillary,base,basiscopic,berry,blade,brownish,bud,capitat,connivent,digestion,distal,dorsally,eaf,edge,eed,end,enzyme,erec,exceeding,flat,folded,geminat,generally,glabrou,green-white,hair,hal,half,high,homostylous,interjected,lanceolate,lateral,leaflet,lengthening,linear,living,lobe,long,lower,make,mottled,narrowly,nflorescence,one,orbicular,orolla,pair,perfect,petiolulate,placed,plurifoliate,pore,poricidal,pubescent,purple,removed,ripe,round,ruit,sessile,seudostipule,short,side,size,slit,sometimes,spaced,specimen,stamen,stolo,straight,subequal,subglabrou,subtending,symmetric,tall,tamen,tem,throughout,tip,tissue,tri-,tube,tuber,typically,unit,usually,vary,wall,wet,wide,winged,x,ympodial	abaxial,adaxial,arrangement,capitate,color,colour,form,growth,height,history,inflorescence,leaf,length,life,na,number,ovary,perennial,position,rachi,reproduction,shape,spacing,staman,surface,texture,width
781	wfo-0001031874	success	197	132	103	94	29	0.523	-1.2,-7,0.2,0.2–0.8,0.5-1,0.5-1.5,0.5–0.9,1-4,1.2,1.8–2.3,2-4,2-5,3-lobed,3–5,4.5-6,5,7–8,9–11,abaxially,acute,adaxially,anther,apart,apex,base,bi-lobed,bilobed,blue,branch,broadly,chartaceous,ciliate,cm,completely,contact,decumbent,diameter,elliptic,erect,especially,even,extra-axillary,filament,flattened-reniform,flower,fruit,fully,generally,glabrous,globose,green,herb,hermaphroditic,lateral,least,length,light,lobe,long-attenuate,lowermost,margin,midrib,minutely,mm,nearly,node,numerous,one,orange,ovate,pedicel,peduncle,petiole,pitted,prostrate,pubescent,rachi,rarely,recurved,red,ripe,rooting,rotate-stellate,several,simple,slightly,soil,sometimes,sparsely,spreading,stem,stigma,style,surface,tall,tip,violet,white,white-puberulent,winged,x,yellow,young	-1.5,-3.5,-4,.5-1.2,0.4,0.6-1,1.2-1.8,1.3–1.4,1.4–1.5,1.5-,1.8,1/10,1/3,1/5,2,2-3,2-3.5,2-foliate,2–2.5,2–9-branched,3-8,3.5–11,5-merou,6–7,accrescent,adaxiall,always,alyx,angulate,articulated,asymmetrically,axe,ba,barely,berr,bifurcation,blade,broad,calyx,capitat,connivent,covering,cylindrical,dehiscent,downward,eaf,eed,fruiting,geminat,hair,hold,juic,lanceolate,level,line,lobed,long,longitudinall,lower,main,mesocarp,near,nflorescence,oblong,obtuse,often,orolla,ovate-triangular,partially,passing,petiol,pore,puberulent,ruit,short,side,somewhat,spaced,swollen,tamen,tem,terete,terminal,time,triangular,tube,unit,usually,vary,vein,way,well,wide,ympodial	abaxial,adaxial,arrangement,capitate,color,colour,corolla,form,growth,habit,height,history,inflorescence,leaf,life,na,number,ovary,perennial,plant,position,reproduction,seed,shape,spacing,staman,texture,variation,width
782	wfo-0001031876	success	140	74	51	89	23	0.364	.1,.5,0.8-1,1,1-1.5,1-1.6,1-4,1.5-2.2,anther,arc,bright,calyx,cm,corolla,elliptic,filament,flower,fruiting,glabrous,globose,granular,green,greenish-yellow,leaf,lightly,lobed,minutely,mm,oblanceolate,ovary,papillose,pedicel,petiole,pore,poricidal,recurved,shaped,shrub,simple,stigma,straight,style,tapering,tear-drop,time,tip,tube,venation,white,winged,yellow	0-flowered,0.5,27-35,3,5,9-15,?,across,acute,anthesi,apex,apiculate,arising,ba,bark,base,bearing,beneath,berry,closely,convergence,corky,cup-like,decurrent,dia,differing,eaf,edicel,eed,erect,family,free,glabrou,immature,irregularity,known,lateral,lenticellat,less,lobe,long,long-acuminate,lower,main,major,margin,melastomataceae,member,middle,minute,nearly,nflorescence,oblique,often,opposite,otherwise,overlappin,pair,parallel,perpendicular,persistent,point,portion,present,primary,prominent,raised,reflexed,resemble,ruit,running,scar,secondary,slender,slightly,spaced,stem,styl,tall,ud,unifoliat,unit,vein,wide,widest,woody,x,ympodial,young	50,abaxial,adaxial,color,colour,diameter,form,fruit,growth,height,history,inflorescence,length,life,na,number,perennial,plant,seed,shape,surface,texture,width
783	wfo-0001031877	success	216	149	118	98	31	0.546	0.3-1,0.3-1.2,0.5,0.6-1.2,1,1-1.5,1-3,1-4,1.5-1.9,2,3-6,3.5-4,6-8,abaxially,abruptly,acuminate,acute,adaxially,angled,anther,apex,basally,base,bright,brown,capitate,cell,clavate,cm,corolla,deflexed,deltate,densely,diameter,ellipsoid,entire,exposed,filament,flattened,flower,free,fruit,fruiting,furcate,glabrous,globose,greenish,growth,hastate,irregularly,lateral,lengthening,line,linear,lobe,lobed,long,margin,mature,minute,minutely,mm,nearly,new,occasionally,outline,pale,pedicel,peduncle,petiole,pitted,plant,plump,pore,portion,prominently,pubescent,purple,red,reddish,reniform,ripe,rounded,scar,scrambler,seed,semi-woody,shiny,silky,simple,slender,slightly,slit,sometimes,somewhat,spaced,sparsely,stellate,stem,stigma,style,surface,terminal,testal,thin,tinged,tip,triangular,trichome,truncate,tube,uniseriate,usually,vine,wall,white,woody,x	+,.3,.5,0.2,0.3-,0.5-1,0.8-0.9,1-3.5,1.1-,1.5,1.5-2,1.8-5,2-,2.5,3-5,5-merou,6-10,adaxiall,ag,along,alyx,anthesi,apar,apparently,ark,articulated,ascending,basal,berry,calyx,conical,connivent,deep,distal,dried,eaf,eed,ellipsoidal,enlarged,erect,especially,exserted,eye,fleshy,green,ilament,impressed,internal,lamina,later,like,long-acuminate,loosely,lower,material,midvein,nflorescence,often,older,orolla,pair,papillate,papillo,parallel,part,per,perfect,pericarp,plurifoliat,pointing,poricidal,primary,pubescence,purplish,rectangular,reflexed,rest,ruit,short,shorte,sinuate,sleeve,spreadin,strongly,subshru,tem,twinin,ud,uniformly,unit,upper,vary,vein,visible,weak,yello,ympodial,young	abaxial,adaxial,age,angle,apart,arrangement,bark,color,colour,form,glabrousnes,height,history,inflorescence,leaf,length,life,na,number,ovary,papillose,position,rachi,reproduction,shape,spacing,spreading,staman,texture,width,yellow
784	wfo-0001031880	success	180	137	114	66	23	0.633	.5,0.5-1,0.5-2,0.7-0.8,1,1-1.3,1-1.5,1-2,2-9,2.5-8,3-3.5,3-4-pluri-foliate,3-foliate,3-lobed,4-8,6-9,7-9,acuminate,acute,anther,anthesi,apart,apex,base,berry,brown,calyx,capitate,cell,cm,color,conical,cordate,corolla,crowded,curved,dark,densely,diameter,ellipsoid,elliptic,enlarged,entire,erect,exerted,flattened,fleshy,flower,flush,fruit,fruiting,glabrous,glandular,globose,growing,herb,inflorescence,internodal,lamina,leaf,lobe,long,margin,markedly,mature,minutely,mm,near,nodding,orange,ovary,ovoid,pale,papillose,pedicel,peduncle,petiole,pitted,pubescent,purple,rachi,red,reddish,reflexed,scar,shallowly,simple,slender,slightly,spaced,spreading,stem,stigma,straight,strongly,style,subshrub,surface,testal,thin,tip,toothed,triangular,trichome,truncate,uniseriate,unit,upward,vein,wall,widely,woody,x,yellow	1.5,2,2-3,2-4,4,5,5-6,abaxially,adaxially,age,basal,bearing,becoming,broadly,c.,ciliate,crenate,cup-shaped,eaf,edicel,eed,filament,free,gland,gland-tipped,green,heteromorphic,hollow,horn,irregularly,lengthening,less,lon,longest,lower,maturit,mid-length,middle,narrowly,nflorescence,ovate,pair,papillo,pericarp,plan,pore,poricidal,portion,primary,pubescen,ruit,shortest,single,slit,sometimes,sparse,sparsely,terminal,tube,ud,unicellula,unlobed,upper,widest,ympodial,–5	1.5-5,abaxial,adaxial,arrangement,bud,form,growth,height,history,length,life,maturity,na,number,perennial,plant,position,reproduction,seed,shape,texture,unicellular,width
785	wfo-0001031881	invalid_json_followup	168	102	66	102	36	0.393	.5,0.1-0.5,0.5-0.7,0.5-1,1-1.3,1-1.5,1-7,1.2-6,1.5-2.5,3.5-4,5-6,acute,anther,apex,attenuate,bark,base,branch,branched,brown,bud,capitate,cm,corolla,dark,densely,elliptic,erect,filament,fruit,glabrous,globose,golden,golden-puberulent,green,inflorescence,leaf,lightly,lobed,midrib,minutely,mm,obovate,opposite,ovary,ovoid-reniform,papillose,pedicel,petiole,pitted,puberulent,pubescent,shape,shrub,small,sparsely,stigma,style,surface,tapering,tree,trichome,uniseriate,usually,white,winged	0.2,0.2-0.6,0.4-1,1/3,10-12,10-30,2,2-9,3-19,3/4,7-14,absent,along,anthesi,apar,apparent,axil,ba,beneath,broadly,calyx,campanulate,constriction,decurrent,deflexed,deltoid,dia,differing,difoliate,distal,dry,drying,eaf,edicel,eed,either,ellipsoid,evenly,exserted,fleshy,free,fruiting,geminat,golden-pubescent,greyish-brow,incrassate,inflorescenc,junction,lateral,like,lobe,lon,long,lower,main,major,margin,material,maturity,middle,minor,minute,nflorescence,occasionally,older,one,orbicular,pair,papillo,planar,pore,poricidal,portion,puberulen,rest,rounded,ruit,scar,shaped,simple,size,slender,slightly,somewhat,soon,spaced,stem,straight,strong,tall,tear-drop,tip,tube,ud,unit,vein,way,widest,woody,x,ympodial,young	'',[,``,abaxial,adaxial,apart,arrangement,characteristic,color,colour,diameter,flower,form,greyish-brown,growth,height,history,inflo,length,life,na,number,peduncle,perennial,plant,position,rachi,reproduction,seed,spacing,staman,texture,value,width,{,}
786	wfo-0001031886	success	169	102	73	96	29	0.432	-9,0.1,0.5-1,1-1.5,1-4,1.5-2,2-2.5,2-3,2-5,20-30,5-6,9-10,abruptly,acuminate,anther,anticlinal,apex,axillary,beak,bright,brown,capitate,cell,cm,conical,corolla,diameter,elliptic,epidermal,filament,flower,fruit,fruiting,glabrous,green,greenish,irregular,lobed,margin,minutely,mm,narrowed,occasionally,open-conical,ovary,ovoid-reniform,papillose,pedicel,petiole,pinnate,portion,projection,purple,rachi,raised,rugose,seed,shape,shrub,simple,sinuous,somewhat,stigma,style,surface,thickening,tip,trichome,uniseriate,white,without,woody,x	-1.2,-25,-4,.5,0,1.2-2.5,10-40,2,2-4,2.0-2.5,3-6,3.0,4,4-15,5-10,5-ridged,6-20,6-8,abaxially,absent,adaxially,along,anthesi,arising,attenuate,axil,basal,base,bearing,berry,broadly,bud,calyx,clavat,commonly,completely,deltate,distinctly,dry,eaf,earl,edicel,eed,either,em,equal,erec,exserted,fleshy,free,half,lanceolate,lateral,le,leaflet,lobe,long,lower,near,nearly,nflorescence,noddin,node,oblique,pair,papillae,papillate,per,petiolule,poricidal,primary,reddish,reflexed,ripe,ruit,scar,scattered,similar,single,smaller,smelling,sparse,specimen,strongly,terminal,time,triangular,tub,tube,ud,unifoliat,unit,usually,vein,wintergreen,ympodial	1,1-1.2,3,abaxial,adaxial,arrangement,clavate,color,colour,erect,form,growth,height,history,inflorescence,leaf,length,life,na,nodding,number,peduncle,plant,position,reproduction,spacing,staman,texture,width
787	wfo-0001031895	success	160	125	99	61	26	0.619	0.5,0.5-1,1-1.5,1.5-3,2-2.5,2.5-3,3-10,3-8,3.5-6,4,5,5-8,6-7,6-9,acute,anther,apex,articulating,attenuate,base,beneath,berry,bluish,calyx,capitate,cell,cm,completely,conical,corolla,dark,densely,diameter,drying,ellipsoid,elliptic,entire,exerted,filament,fleshy,flower,glabrous,globose,green,growth,leaf-opposed,leafy,leaving,less,lobed,margin,matte,minutely,mm,occasionally,once-branched,ovary,ovoid,pair,pale,papillate,part,pedicel,peduncle,peg,petiole,pitted,pore,poricidal,primary,reddish,reniform,revolute,scar,shiny,shoot,short,shrub,simple,sinuate,slightly,stigma,stout,straight,strongly,style,surface,tan,terminal,testal,thin,tip,tube,vein,violet,way,white,x,¼-1/2	-1.5,0.5-2,1.5-2,1.5-6,3-4,4-5,4.5-16.5,5-6,age,anthesi,apparently,bark,blac,broadly,campanulate,cup-shaped,deltate,eaf,eed,emarginated,enlarging,erec,erect,exfoliating,expand,fragrant,free,fruiting,glabrou,immature,inflorescenc,intensely,irregular,lengthening,lobe,lower,new,nflorescence,older,overlapping,papillat,patch,peeling,perfect,pericarp,planar,plurifoliat,portion,ruit,slender,slit,small,somewhat,stem,thick,tree,tub,ud,unit,woody,ympodial	abaxial,adaxial,arrangement,articulation,bud,color,colour,form,fruit,height,history,inflorescence,leaf,length,life,na,number,perennial,plant,position,reproduction,revulsion,seed,shape,texture,width
788	wfo-0001031896	success	196	108	87	109	21	0.444	0.1-0.6,0.3-0.8,0.4-0.8,0.5-1,0.5-2,1-1.5,1-10,1-2,1-3,10-20,10-20+,13,2,2-4.5,2-5,2-7,5,5-15,6-9,7-10,abaxially,acute,adaxially,anther,apart,apex,branched,brown,calyx,cm,contiguous,densely,diameter,elliptic,erect,extra-axillary,ferruginous,filament,flattened,flower,forked,fruit,glabrous,glandular-puberulent,globose,green,hair,lateral,long,long-acuminate,midpoint,midvein,minutely,mm,moderately,nearly,orange,pedicel,peduncle,perfect,petiole,pitted,prickle,pubescence,pubescent,rachi,ray,shape,shrub,simple,small,spaced,sparsely,stellate,stellate-pubescent,stem,stigma,style,surface,tapered,tip,tree,unbranched,white,whitish,x,yellow	-1.5,0-1.2,0.3-0.5,0.3-0.7,0.3-1,1-1.2,1.5,15-20,2-2.5,2-3,3-30+,3-5,4-7,5-10,5-6,5-9,6-10,6-30+,9-18,accrescent,adaxiall,ample,apparently,armed,articulated,axe,ba,base,blade,broad-based,capitat,chartaceous,coarsely,connivent,conspicuously,covering,curved,cylindrical,denser,difoliate,directed,distall,eaf,eed,eglandular,entire,equal,ferruginous-pubescent,frequently,frui,fruiting,geminate,gland-tipped,glandular,held,interpetalar,lanceolate,less,like,lobe,lon,long-stalked,longer,lower,margin,midrib,mixed,mostly,multangulate,nflorescence,oblique,occasional,occasionally,often,orolla,pinnatifid,pore,porrect,recurved,rounded,ruit,sessile,short,shorter,size,slightly,sometimes,stalk,stalked,ste,stellae,straight,subcordate,tal,tamen,tem,time,tissue,toothed,truncate,tube,unarmed,uniform,unit,uprigh,vary,vein,wide,ympodial	abaxial,adaxial,arrangement,capitate,color,colour,corolla,form,growth,height,inflorescence,leaf,length,number,ovary,plant,position,seed,spacing,staman,texture
789	wfo-0001031897	success	264	134	119	145	15	0.451	.1,.5,0-1,0.1-0.5,1.3-2,1.7-3,2-4,4-5,5-6,6-9,abaxial,abaxially,absent,acute,adaxial,adaxially,almost,along,anther,apex,apically,articulated,bark,base,berry,black,brachyblast,branch,branched,brown,calyx,cell,chartaceous,clavate,clustered,cm,conical,coriaceous,corolla,curved,dark,densely,diameter,dilated,distributed,dry,drying,dull,elliptic,enlarged,epiphyte,erect,evenly,eye,faint,fruit,glabrous,green,grey,inside,lanceolate,lateral,leaf,least,light,like,lobed,long,longitudinal,longitudinally,mauve,midvein,mm,naked,obconical,oblong,one,orange-brown,outside,ovoid,pair,papillose,pedicel,peduncle,petiole,primary,pubescent,raised,rarely,reddish,ribbed,ridge,ridged,short,shrub,simple,slender,slightly,smooth,sparsely,stem,stigma,style,sunk,surface,terete,terminal,thick,thin,trichome,usually,vein,venation,visible,weakly,white,winged,x,young	.8,0.15,0.2-0.4,0.4-1.1,0.5-1,0.5-3,0.6,0.8-1.5,0°,1,1-1.5,1-2,1-2.5,1.1,1.5,1.5-8,13,2/3,462.,8,accrescent,age,alyx,anthesi,apar,apparently,appearing,appendage,arising,aristate,attenuate,axillary,bendy,boiteau,clearly,concolorous,condensed,connate,covering,cuneate,datum,dehiscing,delineated,dendritic,dense,developed,developing,development,divided,domatia,dorsal,dorsifixed,eaf,earliest,ed,entire,equal,even,except,extending,filament,filiform,fine,flower,foliaceous,free,fruiting,hair,immature,indistinc,inner,known,lamina,larger,lengthening,linear,lobe,looped,lower,m.,main,margi,margin,membranous,minute,minutely,multicellular,multiseriate,never,nflorescence,nther,oblon,obtuse,occasional,occasionally,orange,orolla,ovate,overlapping,part,partly,pendulous,perfec,pericarp,persisting,plant,plurifoliat,pointed,pore,poricidal,portion,prominent,pronounced,protruding,reach,revolute,ruit,scar,secondary,see,seen,shoot,side,sinus,smaller,smoot,sometimes,sparse,stump,subulate,tearing,tertiary,tip,toward,tube,ud,unarmed,unbranched,unicellular,unit,vary,well-developed,wide,wrinkle,ympodial	arrangement,branching,color,density,form,growth,inflorescence,length,na,ovary,position,seed,shape,spacing,texture
790	wfo-0001031908	success	213	147	120	93	27	0.563	0-22,0-25,0-45,0.4-1.4,1-10,1-2,10-35,2-6,3-8,4-25,5-11,9-13,abaxially,absent-10,acuminate,acute,adaxially,almost,along,anther,apex,approximately,articulated,auriculate,axillary,band,base,blue,broadly,brownish,bud,cell,ciliate,cm,color,condition,corolla,covering,dark,decreasing,densely,diameter,dorsally,drying,dull,edge,elliptic,elliptic-lanceolate,especially,falcate,filament,flat,flower,folded,forked,fresh,fruit,glabrous,globose,green,green-white,greenish,hair,hair-like,herb,honeycomb-shaped,interjected,lateral,leaf,leaflet,like,lilac,make,margin,medium,middle,midrib,minutely,mm,mucilaginous,nearly,odd-pinnate,ovate,ovoid,pair,pedicel,peduncle,petiole,pink,plant,puberulent,pubescent,purple,red-purple,ripe,rotate,rotate-pentagonal,seed,semi-elliptic,shiny,shortly,size,slightly,spot,stem,stigma,style,subtending,surface,terminal,testal,thick,throughout,tinged,tip,wall,wet,white,whitish,yellow	0-9,1-4,1-5.5,1-8,1.5-5.5,3-5,3.5-9,5,5-13,5-19,5-merou,7,8-22,acumen,ag,alyx,apart,apparently,ascending,attenuate,axe,berry,blade,capitat,chartaceous,connivent,cordate,cuneate,decumbent,digestion,distal,eaf,eed,enzyme,erect,exceeding,geminat,generally,glabrou,half,homostylous,lanceolate,lengthening,living,lobe,long,lower,membranous,mottle,nflorescence,oblique,often,orolla,papillose,perfect,petiolulate,plurifoliate,pore,poricidal,prominent,prostrat,rarely,removed,rounded,ruit,secondary,semi-erect,sessile,seudostipule,short,slit,spaced,specimen,stamen,star,ste,stippled,straight,tall,tamen,tem,thir,tri-,truncate,tube,uniform,unit,unwinged,usually,vary,wing,x,ympodial	abaxial,adaxial,arrangement,calyx,capitate,colour,form,growth,height,history,inflorescence,length,life,na,number,ovary,perennial,position,pseudostipule,rachi,reproduction,shape,spacing,staman,texture,third,width
791	wfo-0001032157	success	136	87	56	80	31	0.412	.5,0.6-1,0.75-1,1-3,2-3,7-9,acute,anther,apart,apex,bark,bi-lobed,calyx,cm,corolla,crystalline,elliptic,filament,fruiting,glabrous,globose,golden,green,incrassate,leaf,lobed,margin,minutely,mm,opposite,ovary,ovoid-reniform,paler,papillose,pedicel,peeling,persistent,petiole,pitted,plant,reddish,rounded,shaped,shrub,simple,slightly,stem,stigma,style,surface,tapering,tear-drop,white,woody,x,yellowish	.75,0.25,0.5-1,1.9-2.2,2-5,2.2,3-6,5-15-flowered,5-8,5-9,9-17,anthesi,base,becoming,beginning,beneath,berry,caly,completely,decurrent,deflexed,deltoid,dia,differing,difoliate,dry,eaf,edicel,eed,evenly,exserted,free,frui,geminat,glabrou,inflorescenc,lateral,less,live,living,lobe,lon,long,longitudinal,lower,main,major,middle,minor,nearly,nflorescence,obscure,older,one,pair,papillo,pore,poricidal,portion,raised,reflexed,ruit,scar,shiny,size,slender,soon,spaced,straight,strip,tall,tip,translucen,tube,ud,unit,vein,widest,ympodial,young	5-15,abaxial,adaxial,arrangement,bud,color,colour,diameter,flower,form,fruit,growth,height,history,inflorescence,length,life,na,new,number,peduncle,position,rachi,reproduction,seed,shape,spacing,staman,texture,trichome,width
792	wfo-0001032161	success	146	110	78	68	32	0.534	.5,0.4-1.2,0.8-1,1-3,1.2-1.3,1.4-2,2-7,2.5-3,adaxially,anther,apex,apical,area,bark,base,closely,cm,color,corolla,dark,deflexed,delicate,densely,drying,ellipsoid,elliptic,exserted,filament,filiform,fruiting,glabrous,globose,green,inflorescence,internodal,later,leaf,lobed,merely,minutely,mm,mustard,nearly,obovate,opposite,ovary,ovoid-reniform,pale,papillose,pedicel,pericarp,petiole,pitted,plant,plurifoliate,pore,poricidal,pubescent,shaped,shiny,shrub,simple,spaced,sparsely,stem,stigma,strongly,style,sulcate,surface,tan,tear-drop,thin,tip,tube,white,yellow,yellowish	0.5-1,0.7-4,0.75-1,1-1.5,1-11,2-8-flowered,3.5-4,?,abaxially,acute,adaxiall,anthesi,ba,beneath,berry,branched,brownish-blac,calyx,conical,coriaceous,deltate,dendritic,dia,difoliate,eaf,edicel,eed,free,giving,golden,hanging,lamina,like,lobe,long,lower,many,margin,middle,minute,nflorescence,occasionally,older,overlappin,persistent,portion,projection,quadrate,reflexed,rest,revolute,ruit,scar,shoot,short,styl,tall,trichome,tub,ud,uniseriate,unit,usually,vein,widest,x,ympodial,young	2-8,abaxial,adaxial,arrangement,brownish-black,bud,colour,deflexion,diameter,exsertion,flower,form,fruit,growth,height,history,length,life,na,number,overlapping,peduncle,perennial,position,rachi,reproduction,seed,shape,spacing,texture,thicknes,width
793	wfo-0001032165	success	197	95	67	130	28	0.34	0.1,0.25-0.5,1-1.2,1-2,1.5-4,2.5-3.5,3-4,3-6,5-6,5-7,8-9,abaxial,acute,adaxial,anther,anthesi,apex,bark,base,brown,bud,calyx,capitate,closely,cm,corolla,dark,dull,elliptic,erect,exsertion,filament,fruiting,glabrous,globose,golden-puberulent,green,greyish-brown,inflorescence,leaf,less,lobed,long,minutely,mm,obovate,ovary,ovoid-reniform,pedicel,petiole,pitted,plant,puberulent,shape,simple,small,spaced,stem,stigma,style,surface,terminal,time,tree,trichome,tube,white	.25,.5,0.1-0.3,0.3-1,0.75-1,1-1.5,10-25,2-2.5,3.5-8.5,4-6,5-15,5-30-flowered,5-9.5,along,apparent,appearing,ba,beginning,beneath,berry,broadly,center,continued,cucullate,cup-shaped,deciduous,decurrent,deltoid,densely,denser,dia,differing,difoliate,distal,dry,due,eaf,edged,edicel,eed,ellipsoid,end,entire,even,expansion,exserted,free,geminat,golden,golden-pubescent,immature,inflorescenc,later,lateral,like,live,lobe,lon,lower,main,major,margin,markedly,medial,middle,midrib,minor,minute,near,nearly,nflorescence,node,occasionally,older,once-furcate,one,onto,opposite,orbicular,overlapping,pair,pale,paler,papillo,papillose,planar,pore,poricidal,portion,presence,prominent,purplish,rather,rest,ridge,ripe,rounded,ruit,scar,shaepd,single,size,slender,slightly,slow,smoot,specimen,stout,straight,stripe,strongly,swollen,tall,tapering,tear-drop,thickened,tinged,tip,tub,ud,uniseriate,unit,vein,widest,winged,woody,x,yellowish,ympodial,young	5-30,alternate,arrangement,color,colour,diameter,feature,flower,form,fruit,growth,height,history,length,life,na,number,peduncle,perennial,position,rachi,reproduction,seed,smooth,spacing,staman,texture,width
794	wfo-0001032167	success	163	95	69	94	26	0.423	.5,0.5-1,0.5-2.5,1,1-2,1-2.5,1-5,1.5,12-20,2-7,2-foliate,4-6,5-15,7-10,absent,acute,anther,apex,base,brown,cell,chartaceous,cm,cordate,curved,diameter,dm,drying,elliptic,elliptic-ovoid,filament,flower,forming,fruit,glabrous,globose,growth,herb,immature,maturing,membranaceous,mesocarp,mm,moderately,nearly,netlike,oblong,pedicel,peduncle,petiole,projection,pubescent,purple,rachi,raised,rotate,seed,semitransparent,sparsely,staman,stigma,style,surface,twisted,wall,watery,white,x,yellow	0.5-1.5,0.75-3,1-2-celled,1-3,1-7,10-20,10-35,2-4,3-6,3-7,4-10,abaxially,abundant,adaxiall,adaxially,along,appressed,axe,berry,blade,calyx,ciliate,closely,common,connected,decurrent,dehiscing,dense,densely,denser,eaf,eed,emarginat,entire,explosively,few-,flat,flattened,frui,geminat,geniculate,growt,hair,held,interpetalar,larger,linear-lanceolate,lobe,long,longer,lower,lowermost,lying,many-branched,margin,maturit,near,new,nfloresence,notch,obtuse,often,older,one-celled,orolla,per,placenta,pressure,pubescen,rounded,ruit,shorter,slightly,small,smaller,sometimes,stamen,straight,tal,tamen,tem,tissue,triangular,tube,two-celled,unbranched,unit,upper,usually,vary,vein,wid,woody,ympodial	abaxial,adaxial,arrangement,color,colour,corolla,emarginate,form,height,history,inflorescence,leaf,length,life,na,number,ovary,perennial,plant,position,reproduction,shape,size,spacing,texture,width
795	wfo-0001032176	invalid_json_followup	177	102	67	110	35	0.379	.5,0.5-0.7,0.5-1,0.8-6,1-10,1.5-2.5,100,3-4,5-6-celled,6,6-10,7,anther,apart,apex,apical,attenuate,axillary,base,cm,conical,corolla,cucullate,densely,diameter,elliptic,filament,filiform,flower,green,greenish,grey-brown,greyish,herb,leaf,lobed,margin,minutely,mm,nearly,obtuse,ovary,ovoid-reniform,pale,papillose,pedicel,petiole,pinnate,projection,pubescent,quadrate,rachi,reflexed,rounded,seed,simple,slightly,somewhat,sparsely,stem,stigma,style,tip,trichome,uniseriate,vein,white	0,0.42,0.5,0.5-0.75,0.8-1,1-1.2,1.5-1.6,1.5-6,1/2,2-3,2.5-10,3-15,3-3.5,3-7,adaxially,adhering,along,anthesi,arising,attaining,axil,basal,beak,becoming,berry,branched,calyx,capitat,cateniform,cell,containing,copiously,creeping,denser,drying,eaf,edicel,eed,ellipsoid,epidermal,equal,especially,exserted,fallen,free,fruiting,glabrous,globose,hangin,inflorescenc,lateral,leaflet,lengt,lengthening,like,lobe,log,long,long-papillose,lower,minute,nflorescence,nodding,node,obovate,occasionally,often,onto,open,pair,per,petiolule,pore,poricidal,portion,rest,rooting,ruit,scar,separate,single,sinuous,size,slit,smaller,soon,spaced,strait,strongly,tem,terminal,thickening,tightly,time,tree,truncate,trunk,tub,tube,ud,ultimate,unevenly,unifoliat,unit,wall,whit,winged,without,x,ympodial	'',[,``,abaxial,adaxial,arrangement,capitate,characteristic,color,colour,form,fruit,growth,height,history,inflorescence,length,life,na,number,peduncle,perennial,plant,position,reflexion,reproduction,shape,spacing,staman,surface,texture,value,width,{,}
796	wfo-0001032183	success	162	100	71	91	29	0.438	0-0.1,0-1.5,0.3-0.6,0.4-0.8,0.6-0.9,0.7-1.4,1-3,3.5-4.5,5-9,5.5-7,7-9,absent,accrescent,acute,adaxially,anther,apex,base,calyx,chartaceous,cm,contiguous,cuneate,densely,diameter,entire,exceeding,extra-axillary,flower,fruit,fruiting,glabrous,globose,green,inflorescence,juicy,lanceolate,lateral,length,long,margin,mature,mesocarp,midpoint,mm,nearly,oblique,obtuse,ovate,pale,part,pedicel,peduncle,perennial,petiole,purple,rachi,ray,red,rotate-stellate,sessile,shrub,simple,stalk,stellae,stellate-pubescent,stigma,style,time,white,yellow	%,0.1-0.2,0.2-0.8,0.25-0.4,0.4-0.5,0.4-0.6,0.4-4,0.5-1,0.5-1.5,0.9-1,1-2,1.1-2.3,1.5-1.9,16-23,2-foliate,2.4-2.7,2.7-3.6,4-,4-6,4.5-7,5-merou,7-12,7-8,8-9,abaxially,absen,across,adaxiall,alyx,apart,articulated,axe,ba,blade,capitat,confined,cylindrical,directed,distall,distally,distributed,eaf,eed,eglandular,elliptic,erect,finger,geminat,glaberous,gland-tipped,grey,hair,homostylous,lamina,lobe,lower,markedly,mid-point,midrib,minute,nflorescence,orolla,per,perfect,pore,porrect,prickle,pseudo-umbellate,pubescent,rhizomatous,ruit,short,solitary,spaced,sparsely,succulen,tal,tamen,tem,thick,thicker,throughout,tube,unarme,unarmed,unbranched,unit,vary,wide,x,ympodial	abaxial,adaxial,arrangement,capitate,color,colour,corolla,filament,form,growth,height,history,leaf,life,na,number,ovary,plant,position,reproduction,seed,shape,spacing,staman,stem,succulent,surface,texture,width
797	wfo-0001032187	success	139	96	65	74	31	0.468	-11,-2.1,-4.2,-9,0.1–1.4,0.5,0.5-,0.5–1,0.6–1.3,1.1–3.2,1.8–2,1.8–2.8,1–1.7,2–9,3.1–3.5,5-merous,5–7,7–11,acuminate,acute,anther,apex,aromatic,berry,blade,brown,brownish,cm,corolla,cyme,dull,elliptic,erect,filament,forked,glabrescent,globose,green,herb,leaf,light,mature,mm,obovate,occasionally,ovate,pedicel,peduncle,persistent,petiole,plant,purple,rarely,simple,soft,stage,stellate,style,sub-glabrous,texture,tinged,widest,yellow,yellowish,±	-4,-5,1.3–1.8,1.6–2.1,100,22,24.6–26.3,3–3.2,3–4,9,adherent,alyx,angular,ape,appressed,base,branch,broadly,changing,consisting,dark,di-foliate,dia,eaf,eed,eglandular,entire,equal,flowered,fully,geminat,granule,hair,hite,hooked,hydrated,lobe,long,lower,many,margin,marked,nflorescence,numerous,penden,pentagonal,per,perfec,petiolate,pollen,predominantly,presen,protruding,ridge,ruit,running,sclerotic,short,small,sometimes,sparse,spreading,stem,straight,tooth,triangular,truncate,unit,well,wing,ympodial,±1,µm,×	abaxial,adaxial,arrangement,color,colour,diameter,flower,form,fruit,growth,height,history,inflorescence,length,life,na,number,ovary,part,pendent,perennial,perfect,position,reproduction,seed,shape,staman,stigma,surface,white,width
798	wfo-0001032190	success	230	97	77	153	20	0.335	-1,0-0.6,0.4-1.5,0.5-3,1-1.5,1-6,1.3-5,10,2-6,3-21,5-22,abaxially,acuminate,adaxially,apart,apex,appressed-tomentose,attenuate,bark,becoming,branch,branched,brown,bud,calyx,campanulate,cm,corolla,deltoid,diameter,ellipsoid,evident,flower,fruit,glabrous,globose,granular-pubescent,green,growth,hair,honeycombed,lanceolate,lateral,leaf,length,line,lobe,minute,mm,mostly,openly,ovate,pale,pedicel,peduncle,petiole,pubescent,rachi,reniform,reticulate-punctate,ripe,rotate-stellate,scabridulous,scabrous,shrub,simple,small,stelliform,suborbicular,suture,terete,terminal,tree,white,whitish,yellow,yellowish	-3.4,-6,.5-6,/100-1/20,0-80,0.2-0.3,0.6-1.5,0.7-1.1,0.8-1.1,1-1.7,1.2-2.1,1.2-3,1.5-3.5,1.5-4,1.6-4.4,1.8-3,1.9-4.5,1/2-3/4,2.5-10,2.5-4.3,2.7-6.8,3.5-8,4-5,4-6,4.5-7,6-11,6x,7-11,7-28,absent,accrescent,acute,ag,along,anther,anthesi,apical-lateral,apparently,articulated,axe,axillary,ba,base,berry,blade,blunt-tipped,chartaceous,closely,coarse-stalked,conical,continued,coriaceous,decurrent,dehiscing,densely,due,eaf,eed,elliptic,entire,exserted,extend,few-rayed,filament,fleshy,free,fruiting,glabrescent,glabrou,high,hirsute,inserted,introrse,large,lobed,long,long-,long-attenuate,long-stalked,longitudinal,lower,m.,magnification,main,margin,midvein,mixed,moderately,multangulat,multangulate,multiseriate-stalked,near,nearly,nflorescence,oblanceolate,oblong,obtuse,occasional,occasionally,older,orolla,ovat,overlapping,partly,perfect,plurifoliate,pore,porrect-stellat,porrect-stellate,present,rarely,rather,relatively,ruit,runk,sessile,short-,short-stalked,side,slit,somewhat,spaced,sparse,sparsely,stamen,stem,stigma,stipitate-glandular,strongly,style,subcapitat,subcoriaceous,tamen,testa,thick,thin-stalked,time,tomentose,touching,toward,truncate,tube,unarme,unarmed,unit,usually,vary,vein,way,wide,x,ympodial,young	20-80,abaxial,adaxial,arrangement,branching,color,form,height,inflorescence,na,number,plant,position,seed,shape,spacing,surface,texture,thicknes,trunk
799	wfo-0001032206	success	216	128	100	116	28	0.463	-20,0.2,0.8–1.2,1.1–1.2,1.5–2.5,1/3,1/4–1/2,1/4–1/3,1/6,1–2,1–2.3,1–3,2.5–3.3,2–8,3.5–9,3–4,4.5–5.8,5-merous,5–20,5–6,6–15,acute,andromonoecious,anther,apart,apex,apparently,approximately,bark,base,berry,blade,branched,calyx,chartaceous,cm,cream,cuneate,dark,deltate,diameter,distance,elliptic,filament,flattened-reniform,flower,fruit,fruiting,glabrescent,glabrous,green,green-brown,lateral,leaf,length,lobed,lobing,long-styled,margin,marking,mature,maturity,mauve,midvein,mm,moderately,obtuse,often,orange-brown,pale,pedicel,peduncle,petiole,plant,porrect,prickle,purple,rarely,reflexed,scar,secondary,sessile,short-styled,shrub,side,smooth,sometimes,spherical,stalked,stellate,stellate-pubescent,style,surface,trichome,truncate,usually,white,yellow,yellow-orange,young	-0.8,-2,-5,..,.2,.5,0,0.2–0.4,0.2–0.5,0.5–1,00–200,0–20,0–30,0–5,1,1.2–2.2,1.5–2,10–80,11–22,1–4,2.7–3.5,2–2.5,2–3,30–80,4–6,5–15,5–8,5–9,6–10,6–8,7–10,8–20,abaxially,accrescent,adaxially,alyx,apar,apically,armed,articulated,bluntly,broad-deltate,brow,clearly,concolorous,connivent,covering,curved,discolorous,distal,drying,eaf,eed,equal,erect,extending,flattened,foliaceous,free,functionally,gently,hermaphroditic,heterostylous,infructescence,lengt,lobe,long,longer,lowermost,mal,midpoint,nflorescence,older,one,open,orolla,ovate,ower,pair,pendent,pendulous,per,pericarp,plurifoliat,poricidal,portion,primary,ray,slender,spaced,sparsely,spreading,stalk,stem,stout,straight,tamen,tapering,tertiary,time,tip,toward,tube,uit,unarmed,ung,unit,variously,vary,vein,venation,visible,weakly,wide,woody,ympodial	/,0.5–1.5,abaxial,adaxial,arrangement,branching,brown,color,colour,corolla,extension,form,growth,height,history,inflorescence,life,number,ovary,perennial,proportion,reproduction,seed,shape,spacing,staman,texture,width
