	coreid	status	nwords_original	nwords_result	nwords_recovered	nwords_omitted	nwords_created	prop_recovered	common_words	original_only	result_only
0	wfo-0001025636	success	208	53	36	172	17	0.173	0.1-0.3,1,2-4,absent,broadly,brownish,chartaceous,condition,diameter,drying,elliptic,fresh,fruit,globose,green,greenish,herb,long,membranous,minute,mm,mottled,mucilaginous,odd-pinnate,ovate,ovoid,plant,purple,ripe,rosette-forming,scale-like,seed,slightly,stem,unforked,whitish	0-2,0-5,0.1,0.6-2.8,1-10,1-2,1-2.2,1-3,1-3.5,1-4,1-5,1-5.5,1.1-6.1,1.4-3.5,1.7-5.2,1.7-9.2,1.8,10-45,2,2.5-6,2.6-8.3,3-5,3-6,5-merou,6.5-10,9.5-29.5,abaxially,acumen,acuminate,acute,adaxially,ag,along,alyx,anther,apart,apex,apparently,articulated,axe,base,berry,blade,blue,capitat,cell,ciliate,clavate,clearly,cm,connivent,contracted,corolla,covering,cuneate,decurrent,digestion,distal,dorsally,eaf,edge,eed,end,enzyme,especially,exceeding,except,filament,flat,flower,folded,geminat,generally,glabrou,glabrous,greatly,green-white,hair,hair-like,hal,half,high,highly,homostylous,honeycomb-shaped,interjected,lanceolate,larger,lateral,leaflet,lengthening,like,living,lobe,longer,lower,make,margin,midrib,minutely,moderately,multicellular,near,nflorescence,oblique,obovate,obtuse,often,orbicular,orne,orolla,pair,pedicel,peduncle,perfect,petiole,petiolulate,petiolule,plurifoliate,pore,poricidal,proximal,puberulent,pubescent,reduced,removed,rotate,rotate-pentagonal,rounded,ruit,semierec,sessile,seudostipule,short,singly,size,slit,sometimes,spaced,specimen,stamen,ste,stigma,stolo,straight,style,subequal,subglabrous,tall,tamen,tem,terminal,testal,thick,throughout,tip,tri-,truncate,tube,tuber,typically,unequal,unit,unwinged,uppermost,vary,wall,wet,wide,x,yellow,ympodial	arrangement,color,form,growth,height,history,inflorescence,leaf,length,life,property,pseudostipule,semierect,shape,surface,texture,ye
1	wfo-0001025637	success	193	77	54	139	23	0.28	0.2-0.9,1-2,2-20,2-7,2.5-8,2.8-4.2,3-10,3-4,3-5,5-7,anther,blue,brownish,cm,condition,coriaceous,corolla,dark,deep,diameter,dot,drying,elliptic,filament,flower,forked,fresh,fruit,glabrous,globose,green,greenish,herb,homostylous,leaf,light,lilac,medium,mm,moniliform,mottled,mucilaginous,odd-pinnate,ovoid,plant,purple,seed,stripe,style,tiny,tuber,white,whitish,yellow	0-0.3,0-27,0.2-0.5,0.3-0.5,0.8-2.6,1-12,1-2.5,1-5,1.2-3.5,1.5-5,1.6-2.5,14-38,2-3,3-9,4-6,5-merou,abaxially,acumen,acuminate,acute,adaxiall,adaxially,ag,along,alyx,apart,apex,apparently,arranged,articulated,attenuate,axe,axillary,base,bead,berry,blade,bud,capitat,cell,clavate,connivent,covering,cuneate,decreasing,decurrent,digestion,distal,dorsally,eaf,edge,eed,enzyme,erec,exceeding,flat,folded,geminat,generally,glabrescent,glabrou,green-white,hair,hair-like,hal,half,high,honeycomb-shaped,interjected,lanceolate,lateral,leaflet,lengthening,like,linear,living,lobe,long,lower,make,multiple,necklace,nflorescence,onto,orolla,ovate,pair,pedicel,peduncle,pentagonal,perfect,petiole,petiolulate,petiolule,plurifoliate,pore,poricidal,rachi,removed,ripe,rotate,rounded,ruit,secondary,seudostipule,short,size,slit,sometimes,spaced,specimen,stamen,stigma,stolon,straight,subequal,subtending,symmetric,tall,tamen,tem,terminal,testal,thick,throughout,tip,toward,tri-,tube,typically,unit,unwinged,usually,vary,wall,wet,wide,x,ympodial	abaxial,adaxial,arrangement,calyx,color,erect,form,growth,height,history,inflorescence,length,life,number,ovary,property,pseudostipule,shape,staman,stem,surface,texture,ye
2	wfo-0001025639	success	154	72	46	108	26	0.299	1-2,1-4,2-3,2.8-3.2,3-6,5-10,5-8,6-8,8-12,8-9,branched,broadly,calyx,cm,corolla,cyme,dark,diameter,dichasial,dichasially,ebracteate,elliptic,filament,flower,forked,globose,green,green-white,leaf,medium,mm,monochasial,mucilaginous,obovate,odd-pinnate,ovate,ovoid,perennial,plant,puberulent,pubescent,seed,style,violet,white,yellow	1-3,10-21,2-3.5,20-35,3-4,3-5,3-6-foliat,3.5-7,4-10,4.5-8.5,5-1.,6-12,abaxially,acumen,acuminate,acute,adaxially,apex,apical,apically,articulate,base,belo,cell,connate,covering,cuneate,dehiscent,digestion,diminishing,distal,dorsally,eaf,edge,eed,elliptical,emoval,enzyme,exceeding,flat,folded,frequently,generally,globo,gradually,hair-like,half,herbaceous,honeycomb,interjected,introrse,lateral,leaflet,lobe,lon,long,long-attenuate,lower,lunat,make,maturing,nflorescence,nther,oblique,often,orolla,pair,pattern,pedicel,peduncle,perfect,petiole,petiolule,plan,poricidally,present,produced,proximal,rare,reveal,rotate,ruit,seudostipule,short,size,slit,sometimes,stamen,stigma,straight,tal,tem,terminal,testal,thick,throughou,throughout,top,toward,truncate,tuber-bearing,typically,unit,vary,wall,wide,ympodial,¼	abaxial,adaxial,anther,arrangement,color,form,fruit,growth,height,herb,history,inflorescence,length,life,na,number,ovary,property,pseudostipule,shape,staman,stem,surface,texture,tuber,ye
3	wfo-0001025642	success	149	67	40	109	27	0.268	0.3-0.4,1-4,1.5-2.5,2-10,2-3,3-5,5-6,5.5-7,8-13,9-12,branched,calyx,cm,corolla,cyme,diameter,dichasial,dichasially,ebracteate,elliptic,elliptic-lanceolate,filament,flower,forked,globose,green,green-white,leaf,mm,monochasial,mucilaginous,odd-pinnate,ovoid,perennial,plant,puberulent,seed,style,throughout,yellow	1,1-2,1-2.5,1-2.7,1-3,1-3.2,10-20,3,3-6-foliat,3.5-6,4-7.5,4.5-8,7-11.5,abaxially,absen,absent,acumen,acuminate,acute,adaxially,apex,apical,apically,apiculate,articulate,attenuate,base,cell,connate,covering,dehiscent,digestion,diminishing,distal,dorsally,eaf,edge,eed,emoval,enzyme,exceeding,flat,folded,generally,globo,gradually,hair-like,half,herbaceous,honeycomb,interjected,introrse,lanceolat,lanceolate,lateral,leaflet,living,lobe,lon,long,lower,lunate,make,maturing,nflorescence,nther,oblique,obtuse,often,orolla,pair,pattern,pedicel,peduncle,perfect,petiole,plan,poricidally,present,proximal,reveal,ruit,sessile,seudostipule,short,size,slit,specimen,stamen,stellate,stigma,straight,tal,tem,terminal,testal,thick,throughou,toward,tuber-bearing,typically,unit,vary,wall,whit,wide,without,ympodial,¼	abaxial,adaxial,anther,arrangement,color,form,fruit,growth,height,herb,history,inflorescence,length,life,na,number,ovary,property,pseudostipule,shape,staman,stem,surface,texture,tuber,white,ye
4	wfo-0001025644	success	204	91	67	137	24	0.328	1-2,10,10-11,12-28,13-21,2,2-3,2.5-11,25-50,3-10,3-5,4-6,6-7,abaxially,adaxially,anther,blue,brownish,chartaceous,ciliate,cm,condition,corolla,denticulate,diameter,drying,filament,finely,flower,forked,fresh,fruit,glabrous,globose,green,greenish,hair,herb,invested,like,margin,membranous,mm,mottled,mucilaginous,multicellular,non-glandular,odd-pinnate,ovoid,plant,pubescent,purple,seed,short,stem,style,tinged,trichome,tuber,uniseriate,usually,white,whitish,wing,winged,x,yellow	.3,0-5,0.8-1.5,1-10,1.3-2.1,2-4,2.4-4,2.5-6,3-4,3.3-8.2,4-19,4.5-9.5,5-merou,6.5-13,absent,acumen,acuminate,acute,ag,almost,along,always,alyx,apart,apex,apparently,articulated,attenuate,axe,axillary,base,berry,blade,broadly,bud,c.,capitat,cell,clavate,connivent,cordate,covering,cuneate,digestion,distal,dorsally,eaf,edge,eed,elliptic,end,enzyme,erec,especially,exceeding,except,flat,folded,geminat,generally,glabrou,greatly,green-white,hair-like,half,homostylous,honeycomb-shaped,interjected,lanceolate,lateral,leaflet,lengthening,living,lobe,long,lower,make,middl,midrib,minutely,nflorescence,oblique,often,one,orbicular,orolla,ovate,pair,pedicel,peduncle,pentagonal,perfect,petiole,petiolule,placed,plurifoliate,pore,poricidal,proximal,puberulent,rarely,reduced,removed,rounded,ruit,sessile,seudostipule,shallowly,size,slit,spaced,specimen,stamen,ste,stigma,stolo,straight,subequal,subtending,tall,tamen,tem,terminal,testal,thick,throughout,tip,tri-,truncate,tube,typically,unit,vary,wall,well-developed,wet,ympodial	5-merous,abaxial,adaxial,arrangement,calyx,color,form,growth,height,history,inflorescence,leaf,length,life,na,number,ovary,property,pseudostipule,shape,staman,surface,texture,ye
5	wfo-0001025645	success	150	67	41	109	26	0.273	0.3-0.8,1-4,10-11,12-17,2.5,4-6,5,5-5.5,8-10,branched,calyx,cm,corolla,cyme,diameter,dichasial,dichasially,ebracteate,elliptic-lanceolate,filament,flower,glabrous,globose,green,green-white,herbaceous,lanceolate,leaf,mm,monochasial,mucilaginous,odd-pinnate,ovoid,perennial,plant,puberulent,seed,style,throughout,tuber-bearing,yellow	0.5-1,0.8,1-2,1-3.5,10-16,15-25,2-3,2-4.5,3-5.5,3-6-foliat,4-12,4-5,4-7,abaxially,absen,acumen,acuminate,acute,adaxially,apex,apical,apically,articulate,base,cell,connate,covering,cuneate,decurrent,dehiscent,digestion,diminishing,distal,dorsally,eaf,edge,eed,elliptic,emoval,enzyme,exceeding,flat,folded,forked,generally,globo,gradually,hair-like,half,honeycomb,interjected,introrse,larger,lateral,leaflet,living,lobe,lon,long,lower,lunat,make,maturing,mucronate,nflorescence,nther,oblique,oblong,often,orolla,pair,pattern,pedicel,peduncle,perfect,petiole,plan,poricidally,proximal,rachi,reveal,ruit,second,sessile,seudostipule,short,size,slit,specimen,stamen,stellate,stigma,straight,tal,tem,terminal,testal,thick,throughou,toward,typically,unit,vary,wall,whit,wide,without,ympodial,¼	abaxial,adaxial,anther,arrangement,color,form,fruit,growth,height,history,inflorescence,length,life,na,number,ovary,property,pseudostipule,shape,staman,stem,surface,texture,tuber,white,ye
6	wfo-0001025646	success	136	61	35	101	26	0.257	0.25-0.4,1-4,1-7,1.1-1.4,2-4,3.5-7,4-10,4-5,7-8,branched,calyx,cm,corolla,cyme,diameter,dichasial,dichasially,ebracteate,elliptic,filament,flower,fruit,globose,leaf,mm,monochasial,odd-pinnate,ovary,ovate,perennial,plant,puberulent,strigose,style,yellow	0-.,0.5-2.1,0.6-2.3,0.6-3,0.7-3.5,1.1-4.5,1.2,1.2-7.0,1.5-3,2-3,2.3-9.0,2.5-3,3,3-6-foliat,3.2-6,4-15.5,abaxially,abruptly,acumen,acuminate,acute,adaxially,apex,apical,apically,apiculate,articulate,attenuate,ature,base,caudate,connate,cuneate,decurrent,dehiscent,diminishing,distal,dorsally,eaf,edge,eed,exceeding,flat,folded,forked,generally,globo,gradually,half,herbaceous,interjected,introrse,lateral,leaflet,like,lobe,lon,long,lower,lunat,maturing,nflorescence,nther,oblique,obovate,often,orolla,pair,pedicel,peduncle,pentagonal,perfect,petiole,petiolule,plan,poricidally,probably,proximal,seen,sessile,seudostipule,short,size,slightly,slit,sometimes,stamen,stigma,straight,tal,tem,terminal,toward,tuber-bearing,typically,unit,vary,whit,wide,ympodial,¼	abaxial,adaxial,anther,arrangement,color,form,growth,height,herb,history,inflorescence,length,life,mucilaginous,na,number,property,pseudostipule,seed,shape,staman,stem,surface,texture,tuber,white
7	wfo-0001025647	success	194	72	47	147	25	0.242	0.06-0.24,1-2,1.2-3,2,2-3,2-4,2-5,2.5-3,3-6,5-6,anther,blue,cm,corolla,densely,diameter,elliptic,filament,flower,forming,fruit,glabrous,globose,green,greenish,herb,light,linear,mm,moderately,mucilaginous,narrowly,odd-pinnate,ovoid,plant,pubescent,ripe,rosette,scale-like,seed,stem,style,tuber,unbranched,unwinged,whitish,yellow	0-4,0.4-1.5,0.6-3,0.8-3,1,1-10,1-3,1-5,1.3-2.9,1.4-5,1.5-5,1.5-5.5,4-10,4-6,5-merou,6.2-11,abaxially,absent,acumen,acute,adaxially,ag,along,alyx,apart,apex,apparently,articulated,attenuate,axe,axillary,base,berry,blade,borne,broadly,brownish,bud,capitat,cell,chartaceous,ciliate,clavate,condition,connivent,covering,decurrent,digestion,distal,dorsally,drying,eaf,edge,eed,end,enzyme,erec,especially,exceeding,except,flat,folded,frequently,fresh,geminat,glabrou,greatly,green-white,hair,hair-like,hal,half,high,homostylous,honeycomb-shaped,interjected,lanceolate,lateral,leaflet,lengthening,like,living,lobe,long,lower,make,margin,membranous,midrib,minutely,multicellular,near,nflorescence,oblique,obtuse,often,orbicular,orolla,ovate,pair,pedicel,peduncle,perfect,petiole,petiolulate,plurifoliate,pore,poricidal,proximal,puberulent,reduced,removed,rotate,ruit,sessile,seudostipule,short,singly,size,slit,sometimes,spaced,specimen,stamen,ste,stigma,stolo,straight,subequal,subtending,tall,tamen,tem,terminal,testal,thick,throughout,tip,tri-,tube,typically,unit,vary,wall,wet,x,ympodial	5-merous,abaxial,adaxial,arrangement,calyx,color,erect,form,growth,height,history,inflorescence,leaf,length,life,na,number,ovary,property,pseudostipule,shape,staman,surface,texture,ye
8	wfo-0001025652	success	156	68	48	108	20	0.308	.3,0.5-1,1-1.5,2-3,2-6,3-3.5,3-5,4-6,anther,calyx,closed,cm,completely,corolla,densely,elliptic,envelope,filament,fleshy,flower,fruit,furcate,glabrous,green,growth,leaf,mm,occasionally,ovary,ovoid-reniform,pale,paler,papillose,pinkish-grey,plant,shape,shiny,shrub,simple,small,stem,straight,style,surface,tan,tree,white,x	.5,1,1.5-2,10-20,15-17,15-19,2-5,20-50,3-5-flowered,4,4-7,9-11,abruptly,acuminate,acute,anthesi,apex,appearing,bark,base,bilobed,blade,broad,campanulate,closely,connate,decurrent,dia,differing,difoliate,dry,eaf,edicel,eed,emerge,free,geminat,glabrate,greyi,greyish,growing,irregular,lateral,like,live,lobe,lobed,lon,long,lower,main,major,margin,matte,middle,minor,minute,minutely,narrowing,nearly,new,nflorescence,older,one,onto,opposite,overlappin,ovoid,pair,papillae,papillo,parallel,pedicel,petiole,pitted,planar,pore,poricidal,portion,rather,red-papillose,ry,scar,shaped,size,soon,spaced,specimen,stigma,strongly,tall,tapering,tear,tear-drop,thick,thicker,tightly,tip,tube,ud,unit,vein,wider,widest,wing,winged,ympodial,young	abaxial,adaxial,arrangement,color,diameter,form,height,history,inflorescence,length,life,mucilaginous,na,number,property,pseudostipule,seed,staman,texture,tuber
9	wfo-0001025653	success	218	59	34	184	25	0.156	.0,.6,.7,.8,.9,0.13,1.3,20,anther,brown,calyx,chartaceous,cm,corolla,densely,diameter,filament,flower,fruit,glabrous,leaf,least,long,mm,ovate,pubescent,reddish,short,shrub,simple,sparsely,stem,style,surface	.1,.2,.3,.5,0.1,0.15,0.2–0.4,0.3–0.5,0.3–0.8,0.6–1.6,0.7–1.1,0.8,1.0–1.6,1.1–1.3,1.3–1.8,1.6,1.9–3.3,1–1.5,2.3–3.2,2.5–4.0,2.6,4–6,5-merou,6–8,6–9,7–12,8–11,90°,abaxially,absent,acuminate,adaxiall,adaxially,adnate,aequilateral,ag,alyx,among,anthesi,apart,apex,apical,apparently,appearing,around,articulate,attenuate,axe,ba,bark,base,blade,broad,bud,channeled,clinate,congested,craspedodromous,cylindrical,deltoid,developed,directed,distinct,dry,eaf,edge,eed,either,emerging,entire,erect,extending,extra-axillary,ferruginous,fertile,filiform,free,glandular,globolunate,globose,hair,heterostylous,increasing,intact,internode,interpetalar,intersepalar,know,known,lanceolate,lateral,layer,less,lobe,lobed,lon,longer,low,lower,margin,mature,midpoint,midrib,midvein,minute,much,nflorescence,noticeably,oblique,obtuse,occasionally,opaque,opposed,orolla,pedicel,peduncle,persistent,petiole,plurifoliat,pore,porrect,porrect-stellate,portion,potentially,prickl,prickle,primary,raised,ray,reduced,remaining,restricted,rhizomatous,rigid,rounded,row,ruit,scarcely,secondary,see,seen,sessile,short-stipitate,shorter,shot-stipitate,side,sinuate,sloughing,splitting,spread,stamen,stellae,stellate,stellate-pubescent,stigma,stipe,stipitate,straight,subcordate,suture,tamen,tem,time,tip,tissue,transparent,truncat,truncate,tube,two,ud,unarme,unarmed,unbranched,vary,vein,well,wide,yellow-ferruginous,ympodia,young,±equal,±erect,×	2.3-3.2,6-8,abaxial,adaxial,arrangement,color,form,growth,height,history,inflorescence,length,life,mucilaginous,na,number,ovary,plant,property,pseudostipule,seed,shape,staman,texture,tuber
10	wfo-0001025654	success	140	61	40	100	21	0.286	1,1-2,2,5-6,5-merous,abaxial,abaxially,acumen,adaxial,anther,apex,broadly,calyx,chartaceous,diameter,dull,elliptic,filament,flower,fruit,glabrous,globose,hair,inflorescence,leaf,long,minutely,mm,pedicellate,pubescent,purple,shrub,simple,stellate,stem,style,surface,toward,triangular,yellow	0,15-22,2-2.5,2-foliate,25-30,3/4,4,4-5,5,6,7-8,?,abortive,absent,abundant,accrescen,acuminate,alyx,ape,apica,apparently,armed,articulated,axe,ba,base,blade,branched,cm,cuneate,eaf,eed,erect,flattened,frequently,fruiting,geminat,glandular,homostylou,hooked,juvenile,lanceolate,larger,later,less,lobe,lower,mainly,margin,mature,midvein,minute,mostly,narrowed,nflorescence,oblique,often,older,orolla,pale,pedicel,peduncle,petiole,phase,pore,position,prickle,rachi,repand,retrorse,ruit,scarcely,scattered,sessile,several,shallowly,shortly,single,size,slender,slightly,smaller,solitary,sparsely,stigma,straw-coloured,sub-acuminate,sub-axillary,tal,tamen,tem,tip,unarme,unit,unknow,unknown,vary,x,ympodial,young	arrangement,color,corolla,form,growth,height,homostylous,length,mucilaginous,na,number,ovary,plant,property,pseudostipule,red,seed,shape,staman,texture,tuber
11	wfo-0001025655	success	226	67	45	181	22	0.199	1-1.2,1-1.5,1-2,1.3-1.5,1.5-2,4-5,6-8,abaxial,anther,beige,calyx,cinereous,cm,cordate,cordate-lanceolate,cyme,diameter,ferruginous,ferruginous-pubescent,filament,flower,fruit,glabrous,globose,helicoid,hirsute-glandular,leaf,length,lilac,mm,mucilaginous,plant,reddish,rugose,shrub,solitary,stem,style,subreniform,surface,tomentose,velutinous,violet,viscid-velutinous,yellowish	-3-5-lobed,-8-17,0.3-0.4,0.6-0.8,1-3,1.4-2,11,2,2-2.5,2-3,2-3.5,2-5-celled,2.5-3,2.5-5-,3-,3-5,3-7,3-8-flowered,4,4-6,5-6-merous,5-7,6-7,8-10,accrescent,acuminate,along,alyx,anthesi,apex,armed,articulate,asymmetric,attenuate,ba,bark,basal,base,blade,branch,branched,brow,brown,canaliculate,central,clavate,compressed,curved,dark,deeply,densely,di-,discolorous,distal,dry,eaf,eed,elongate,enlarged,entire,epicarp,equal,erect,exceeding,ferruginous-tomentose,free,fruiting,functional,fused,geminat,glabrescent,gland,glandular,glandular-stellate,glandular-tipped,gynoeci,held,indument,lanate,leathery,linear-lanceolate,lobe,long,long-exserted,long-stalked,longer,lower,many-celled,maturit,midrib,minutely,mix,monoclinous,multiangulate,multiangulate-stellate,multiseriate,nflorescence,numerous,oblong-urceolate,older,one,orolla,papillo,part,parted,pedicel,peduncl,peduncle,perennia,persistent,persistently,petiol,petiole,porrect-stellate,prickle,primary,prolonged,prominent,rachi,ranch,ray,recurved,reduced,reflexed,rounded,ruit,secondary,sepal,sessile,short,similar,slender,slightly,small,somewhat,sparsely,splitting,stalk,stalked,stamen,staminate,stellae,stellate,stellate-glandular,stigma,straight,strongly,sub-capitate,sub-globose,sub-quadrangular,sub-sessile,subcoriaceous,subsagittate,subterete,surrounded,tall,tamen,terete,time,tomentose-velutinous,triangular-lanceolate,trichome,trifoliate,tube,unarmed,unbranched,uniseriate,unit,upright,vary,vein,villous,weakly,wide,within,without,woolly,ympodial,young,¼,½	3-8,adaxial,arrangement,color,corolla,form,growth,height,history,inflorescence,life,na,number,ovary,perennial,property,pseudostipule,seed,shape,staman,texture,tuber
12	wfo-0001025656	success	209	84	61	148	23	0.292	-10,1-1.5,1-2,1/3,12-15,2.5-5,3-12,4-5,8-9,almost,anther,apical,basal,base,blue,branched,brown,calyx,chartaceous,cm,corolla,corymbose,cyme,diameter,elliptic,elliptic-ovate,filament,flattened,flower,glabrous,glandular,globose,green,grey,growth,hirsute,inflorescence,lobed,long-styled,mm,ochraceous,ovary,ovate,plant,prickly,pubescent,purple,reniform,rusty,short-styled,shrub,simple,stellate,stem,style,subcoriaceous,subreniform,surface,tomentose-lanate,viscid,yellow	-14,0.2-,0.2-0.3,0.2-0.4,0.5-0.6,0.8-1,1-4,1.5-2,1.8-2,10-,10-15,2-2.5,3,3-3.5,3-7,30-40,4-4.5,4-6,5-,6,6-11,8-10,abaxially,acuminate,acute,adaxially,adult,along,anthesi,apart,apex,apically,armed,bark,berry,cell,channelled,clavate-truncate,congested,coriaceous,cuneate,curved,densely,denser,discolorous,distal,eaf,eed,elongate,entire,erect,evenly,exserted,flexuous,foliaceous,free,fruiting,gland,gre,heterostylous,inflorescenc,internodal,juvenile,lanate,lengthening,like,linear-lanceolate,lobe,lobed-angulate,long,long-stalked,longer,loosely,looser,lower,margin,mature,midpoint,midrib,minute,minutely,mixed,multangulate,multicellular,near,new,nflorescence,older,papillat,partially,pedicel,peduncle,perfect,pericarp,petiole,plurifoliat,pore,poricidal,porrect,portion,prickle,pubescence,raised,reflexed,relatively,reticulate,rounded,rugose,ruit,scandent,scar,sessile,several,short-stalked,single,slightly,spaced,sparse,sparsely,stalk,staminate,stigma,straight,subglobose,subscandent,subtuncate,tall,tapering,testa,time,tip,tomentose,tomentose-velutinous,trichome,tube,turbinate,ud,unit,upper,vein,venation,white,whitish,without,wood,x,ympodial,young	/,10-40,abaxial,adaxial,arrangement,color,form,fruit,height,history,leaf,length,life,mucilaginous,na,number,property,pseudostipule,seed,shape,staman,texture,tuber
13	wfo-0001025657	success	239	83	61	178	22	0.255	1-3,1.3-2,1.5-1.8,2.7-4.3,25-60,4-4.4,5-14,7-9.5,abaxially,adaxially,anther,berry,bluish,branched,brown,calyx,cm,conical,corolla,dark,deltoid,densely,diameter,dried,filament,fleshy,flower,fruit,glabrous,granular,green,hair,half,leaf,length,lower,mm,narrowly,orbicular,ovate,pale,porrect-stellate,ripe,shrub,simple,soft,stellate-pubescent,stem,style,subcoriaceous,suborbicular,surface,tan,tomentose,tomentose-pubescent,tree,unarmed,velutinous-pubescent,white,yellow,yellowish	-2,/3,0.1-0.4,0.2-0.4,0.5-2.5,1-1.1,1-1.3,1-1.6,1.2-1.5,1.7-1.9,12x,2-10,2-3.5,2.2-5.5,2.5-9.3,2/3,3-4,3-4.8,3-6,3.2-6,4-4.5,4-7,5-16,6-12,6-8,6.5-10,7-27,7-9,8-10.5,8.3-12,accrescent,acute,ag,also,anthesi,apart,apex,apparently,appearing,ark,around,articulated,ascending,axe,axillary,ba,base,blade,blunt-tipped,branch,broadly,bud,capitat,central,chartaceous,closely,cordate,cylindrical,dendritic-multangulat,dendritic-multangulate,dense,directed,distally,due,eaf,earl,edge,eed,elliptic,entire,especially,evident,exerted,expanded,exserted,farinose,few-rayed,free,fruiting,glandula,glandular,inserted,lanate-pubescent,lanceolate,lateral,lengthening,light,lobe,lobed,long,long-stalked,longitudinal,m.,magnification,main,margin,midrib,minutely,mixed,multangulate,nearly,nflorescence,oblong,obtuse,occasional,often,older,open,orolla,ovat,ovate-lanceolate,overlapping,part,parted,partly,pedicel,peduncle,perfect,persistent,persistently,petiole,plurifoliate,pore,poricidal,present,pseudo-terminal,pubescence,pubescent,rachi,ray,reportedly,reticulate-punctate,ruit,scented,semi-ovate,sessile,short,short-,short-stalked,side,slightly,slit,somewhat,spaced,splitting,stamen,stellate,stigma,stipitate-glandular,stipitate-multangulate,strongly,subcampanulate,suture,tall,tamen,terete,thick-stalked,thickened,thin-stalked,time,tip,tomentum,transparent,tube,two-third,ud,unarme,unit,upper,usually,vary,vein,way,weakly,wide,x,ympodial,young	abaxial,adaxial,arrangement,color,form,growth,height,history,inflorescence,life,mucilaginous,na,number,ovary,plant,property,pseudostipule,seed,shape,staman,texture,tuber
14	wfo-0001025666	success	217	75	52	165	23	0.24	0.3,0.5-1,0.5-1.5,1,1-1.5,1.5-2.5,2-8,4-5,5-6,6-7.5,anther,base,brown,calyx,chartaceous,cm,diameter,elliptical,filament,flattened,flower,fruit,glabrous,gland-tipped,globose,green,hair,inflorescence,leaf,length,mm,moderately,ovate,pale,perennial,pinkish,plant,pseudo-racemose,pseudo-umbellate,purple,short,shrub,simple,stellate-pubescent,style,surface,white,whitish,x,yellow,yellowish,yellowish-green	%,.8,0-0.7,0-5,0.05-0.25,0.2-0.3,0.2-0.35,0.2-0.8,0.25-0.35,0.25-0.4,0.5-2,1-1.4,1-1.7,1-2,1-locular,1.5-1.8,1.5-3.5,1.6-2.3,10-30,14-29,2-3,2-4,2.8-4.5,20-60,21-30,25-65,3-3.5,3-5,3-7,3.5-4,4-6,5-merou,5.5-9.5,6-20,7-8,8-12,9-10,9-20,abaxially,absen,absent,acicular,across,acute,adaxially,alyx,andromonoecious,apart,apex,armed,articulated,attenuate,axe,ba,blade,capitat,center,confined,connivent,cross-section,cuneate,cylindrical,d.,densely,difoliate,directed,distal,distall,eaf,eed,eglandular,elliptica,entire,exocarp,extra-axillary,finely,finger,fruiting,functional,geminate,half,heterostylous,incomplete,index,interpetalar,juicy,lamina,lateral,less,lobe,lobed,lobing,long,longer,loosely,lower,margin,mature,mesocarp,midpoint,midrib,midvein,minute,moist,narrowly,nflorescence,oblique,obtuse,orolla,part,pedicel,peduncle,per,petiole,placenta,pore,porrect,presen,present,prickle,probably,prostrate,rachi,ray,reticulate,ridged,ruit,septum,sessile,shallowly,side,slightly,spaced,sparse,sparsely,stage,stellae,stellate,stigma,stoloniferous,straight,strongly,tal,tamen,tapered,tem,terete,thick,throughout,time,tissu,tissue,transparent,triangular,tube,unarme,unarmed,unbranched,unit,uvenile,vary,vein,weakly,wide,ympodial	5-merous,abaxial,adaxial,arrangement,color,corolla,form,growth,height,history,life,mucilaginous,na,number,ovary,property,pseudostipule,seed,shape,staman,stem,texture,tuber
15	wfo-0001025669	success	216	88	64	152	24	0.296	.5,0.1-0.3,1,1-2,1-4,1.4-2.5,2-3,2-4,3-5,3-7,absent,anther,blue,broadly,brownish,chartaceous,cm,condition,corolla,diameter,drying,elliptic,filament,flower,forming,fresh,fruit,glabrous,globose,green,greenish,hair,herb,like,long,membranous,minute,mm,moderately,mottled,mucilaginous,odd-pinnate,ovate,ovoid,plant,pubescent,purple,rarely,ripe,rosette,scale-like,seed,slightly,sometimes,stem,streaked,style,subglabrous,tinged,tuber,unwinged,white,whitish,yellow	'',0-1,0-5,0-7,0.8-2.4,1-10,1-2.2,1-3,1.3-4.2,1.6-4.4,13-35,2,2.2-6,2.2-6.5,2.4-7,4-6,5-merou,9-24.5,``,abaxially,absen,acumen,acuminate,acute,adaxially,ag,along,alyx,apart,apex,apparently,articulation,axe,base,berry,blade,capitat,cell,ciliate,clavate,clearly,connivent,contracted,covering,cuneate,decurrent,digestion,discussion,distal,distinct,dorsally,eaf,edge,eed,end,enzyme,erec,especially,exceeding,except,extra,flat,flowered,folded,geminat,glabrou,greatly,green-white,hair-like,half,highly,homostylous,honeycomb-shaped,interjected,lanceolate,larger,lateral,leaflet,lengthening,living,lobe,lower,make,margin,midrib,minutely,monochasium,multicellular,near,nflorescence,oblique,obovate,obtuse,often,one,orbicular,orolla,pair,pedicel,peduncle,perfect,petiole,petiolulate,petiolule,placed,plurifoliate,pore,poricidal,proximal,puberulent,reduced,removed,rotate,rounded,ruit,see,sessile,seudostipule,short,single,size,slit,spaced,species,specimen,stamen,ste,stigma,stolo,straight,subequal,tall,tamen,tem,terminal,testal,thick,throughout,tip,tri-,truncate,tube,typically,unbranched,unequal,unit,vary,wall,wet,wide,x,ympodial	abaxial,adaxial,arrangement,calyx,color,erect,form,growth,height,history,inflorescence,leaf,length,life,na,number,ovary,property,pseudostipule,shape,staman,surface,texture,ye
16	wfo-0001025685	success	222	80	56	166	24	0.252	1.5-2,12-13,2-5,2-7,3-10,3-3.5,4-5,6.5-9,anther,branched,brown,calyx,chartaceous,cm,cordiforme,corolla,dark,diameter,discolorous,filament,flattened,flower,foliaceous,glandular,globose,green,growth,lanceolate,long-styled,mm,orangish,ovary,ovate-cordiforme,ovate-elliptic,plant,puberulent,pubescent,quadrate,red,reniform,scabrous,short-styled,shrub,simple,size,small,sparsely,stem,style,subcompressed,tomentose-floccose,tree,trichome,uneven,white,yellowish	-15,-22,-30,/3,/4,0.2-0.3,0.3-0.5,0.3-1,0.4-6,0.45-0.9,0.5-1,1-1.5,1-4,1-multicellular,1.4,1.5-2.5,1.8-2.5,10-15,2,2-2.2,2-3,2-4,2-6,3,3-4,3.5-10,4-4.5,50,7-18,7-8,8-10,<,abaxially,acuminate,acute,adaxially,adult,angulate,anthesi,apart,apex,apiculate,armed,articulated,ascendin,bark,basal,basally,base,berry,caly,channelled,clavate,concav,cordate,coriaceous,cuneate,curved,deciduous,deltate,dense,distal,eaf,eed,elongating,entire,erect,exserted,finely,flowering,free,fruiting,glabrescen,glabrous,glandular-viscid,heavily,heterostylous,impressed,internodal,juvenile,larger,like,lobe,lobed,long,lower,margin,midpoint,minute,minutely,mixed,multangulate,multicellular,new,nflorescence,oblique,oblong-lanceolate,obverse,older,ornamented,ovate,papillo,partially,pedicel,peduncle,per,perfect,pericarp,persistent,petiole,plurifoliat,pore,poricidal,porrect,portion,prickle,prickly,pubescence,raised,ray,recurved,reduced,reflexed,rest,reticulate,ripe,ruit,scandent,scar,sessile,shallowly,slightly,slit,spaced,sparse,stalked,staminate,stellate,stigma,straight,subcordate,subglobose,subscabrous,subtruncate,tapering,testa,thick,time,tip,tomentose-ferruginous,tomentose-scabrous,tomentose-velutinous,triangular-lanceolate,truncate,tube,turbinate,ud,unit,vein,velutinous-floccose,venation,way,without,woody,x,ympodial	/,abaxial,adaxial,arrangement,color,form,fruit,height,history,inflorescence,leaf,length,life,mucilaginous,na,number,property,pseudostipule,seed,shape,staman,surface,texture,tuber
17	wfo-0001025688	success	218	112	71	147	41	0.326	0.2,0.5,1-celled,1/2,abaxially,adaxially,also,anther,base,brown,calyx,cm,cylindrical,densely,diameter,filament,flower,fruit,glabrous,gland,gland-tipped,globose,glutinous,hair,hyaline,lacking,leaf,lobe,lobed,long,margin,minute,mm,narrowly,otherwise,ovate,pilose,prickle,puberulent,rarely,ripe,scarious,scattered,short,shrub,simple,slightly,somewhat,sparsely,spreading,stellate,stem,stipitate,style,suborbicular,surface,thickened,thin-textured,tip,triangular,tube,unbranched,usually,vein,way,white,x,yellow,yellow-green,yellowish-green,±	0.1,0.1–2,0.5–2,0.5–3,0.5–3.5,0.6–0.8,0.6–2,0.6–2.4,0.6–4,0.8,0–10,1,1.3–1.7,1.5–2,1.5–3,1.5–4,14155,15–25,1–1.5,1–1.6,1–1.8,1–2,1–3-celled,1–6-celled,1–8,2-foliate,25,2–3,2–3.5,2–4-celled,2–4–celled,3.2–3.6,3–10,3–4,4,4-lobed,40–75,4–15,4–5-rayed,4–6,4–9,5,59,5°,5–18,6–7,6–8,8–10,8–15,=,abruptly,accrescent,acicular,acute,adaxiall,angle,anthesi,apex,armed,ascending,average,axe,blade,branch,coiling,conpsicuously,constricted,contiguou,curved,darker,deeply,dense,developing,directed,distall,distally,eaf,eed,enlarged,entire,erect,except,extra-axillary,fewer,flattened,flowering,free,fresh,fruiting,geminate,grading,green,lanceolate,larger,less,lon,lower,major,many,minor,mottling,n,narrowed,nearly,nee,nflorescence,none,often,one,orolla,pedicel,peduncle,per,pericarp,petiole,pore,pubescence,rachi,rather,recurved,ruit,sessile,similar,single,size,small,sometimes,stellae,stigma,straight,sulcate,tal,tamen,tapering,tem,thic,thick,thickene,truncat,truncate,twice,unit,upper,vary,wide,wing,ympodial	0.5-2,0.5-3,0.6-2.4,0.6-4,1-1.5,1-1.6,1-2,1-3-celled,1-6-celled,1.5-3,2-3.5,2-4-celled,3-10,3-4,4-6,6-7,abaxial,adaxial,arrangement,color,corolla,form,growth,height,history,inflorescence,length,life,mucilaginous,na,number,ovary,perennial,plant,property,pseudostipule,seed,shape,staman,texture,tuber
18	wfo-0001025694	success	199	102	83	116	19	0.417	0.5–1,0.5–1.5,0.5–3,1,1–3,2.5,20,2–15,2–3,2–3.5,2–5-branched,3–6,4–12,4–5,5-merous,6–10,abaxial,acute,adaxial,androgynoecious,andromonoecious,anther,apex,armed,asymmetrical,base,brown,calyx,chartaceous,cm,dark,densely,diameter,discolorous,elliptic,entire,filament,flower,fruit,gland-tipped,globose,green,hair,inflorescence,interpetalar,length,little,long,margin,midpoint,midvein,mm,moderately,mottled,obtuse,often,ovate,petiole,pinnate,plant,porrect-stellate,prickle,pubescent,reniform,rusty,secondary,shrub,side,simple,sparsely,specifically,stellate,stellate-pubescent,stem,style,surface,tissue,vein,venation,white,whitish,yellow,×	0.2,0.2–0.3,0.3–0.6,1.5–2,1.5–3.5,10–15,10–25,1991,1–2,1–2.5,2.5–11,25–50,2–4,3–5,4–15,5–10,6–20,8–12,abaxially,absen,absent,accrescent,adaxiall,adaxially,alyx,apart,apical,articulated,attenuate,axe,ba,becoming,berry,beyond,blade,capitat,center,completely,connivent,cordate,covering,cylindrical,drying,eaf,eed,erect,exerted,exserted,flattened,frui,fruiting,functionally,fused,glabrous,glandular,hermaphroditic,heterostylou,like,lobe,lower,male,matur,membranaceous,midrib,mixed,multicellular,multiseriate,narrowly,nearly,nflorescence,occasionally,opening,orange,orolla,pedicel,peduncle,per,plurifoliat,pore,rachi,ray,recurved,reflexed,roselike,rugose,ruit,scandent,short,slit,spaced,sparse,spine,stalk,stamen,staminate,stigma,still,swollen,tal,tamen,tan,tem,tip,triangular,triangular-ovate,tube,turning,unicellular,uniseriate,unit,vary,walker,whelan,wide,ympodial,young	arrangement,branching,color,corolla,form,growth,height,heterostylous,leaf,mucilaginous,na,number,ovary,property,reproduction,seed,shape,staman,texture
19	wfo-0001025697	success	181	95	73	108	22	0.403	0-14,0.15-0.75,1-1.7,1-2,10-26,2-4,2-6,3-10,3-4,3-6,5.5-11.5,abaxially,acuminate,acute,adaxially,anther,apex,apparently,attenuate,base,blue,brownish,cm,condition,coriaceous,corolla,dark,deep,diameter,drying,elliptic,filament,flower,forked,fresh,fruit,glabrescent,glabrous,globose,green,greenish,hair,herb,interjected,lateral,leaf,leaflet,light,lilac,medium,mm,mucilaginous,odd-pinnate,ovate,ovoid,pair,pentagonal,perfect,petiole,plant,purple,rotate,rounded,seed,sessile,short,stripe,style,terminal,typically,usually,whitish,yellow	-9,0.6-3.5,0.8-2,1-3,1.5-1.8,1.7-8.6,2-10.5,2-2.6,25-35,3-5,3.3-11,4-7.5,5-merou,6.5-13.5,acumen,adaxiall,ag,alyx,apart,articulated,asymmetric,axe,axillary,basiscopic,berry,blade,bud,capitat,cell,clavate,connivent,covering,decreasing,decurrent,digestion,distal,dorsally,eaf,edge,eed,enzyme,erec,exceeding,flat,folded,geminat,generally,glabrou,green-white,hair-like,hal,half,high,homostylous,honeycomb-shaped,lanceolate,lengthening,linear,living,lobe,long,lower,make,nflorescence,orbicular,orolla,pedicel,peduncle,petiolulate,plurifoliate,pore,poricidal,rachi,removed,ripe,ruit,seudostipule,side,size,slightly,slit,spaced,specimen,stamen,stigma,straight,subequal,subglabrou,subtending,tall,tamen,tem,testal,thick,throughout,tip,tissue,toward,tri-,tube,unit,unwinged,vary,wall,wet,wood,x,ympodial	abaxial,adaxial,arrangement,branching,calyx,color,form,growth,height,inflorescence,length,ovary,property,pseudostipule,reproduction,shape,staman,stem,subglabrous,surface,texture,ye
20	wfo-0001025699	success	181	92	68	113	24	0.376	1-1.5,1-2.5,1-3,1.5-2,1/3,10,2-2.5,2-6,3-15,3-3.5,4-5,5-8,8-9,acute,anther,anthesi,apex,apparently,attenuate,base,becoming,berry,branching,brown,calyx,campanulate,cm,completely,corolla,dark,darker,diameter,dry,ellipsoid,elliptic,entire,filament,flower,glabrous,globose,green,growth,immature,inflorescence,leaf,lobed,margin,mm,ovary,pair,perfect,petiole,reniform,rounded,simple,small,somewhat,stem,style,surface,time,tip,tree,vein,way,white,x,½	.2,.5,0.5,1,1-2,1.5,15-20,2,2cm,3-5.5,3-8,499,5-winged,5.5-14,abaxially,absent,adaxially,age,almost,apart,appearing,articulating,bark,c.,capitate,conical,conspicuously,continuing,corrugate,crystal,cup-shaped,deltate,densely,difoliate,dorsal,drying,eaf,eed,erect,exerted,face,fide,free,fruiting,glabrou,grey-brown,included,inclusion,inflorescenc,irregularly,lanceolate,leaf-opposed,leafy,leaving,lengthening,less,lobe,lower,markedly,midrib,minutely,narrowly,new,nflorescence,nodding,older,one,onto,oxalate,pale,papillat,papillose,pedicel,peduncle,peg,penden,per,plurifoliate,pore,poricidal,portion,primary,red,reddish,reticulate-pitted,rounded-sagittate,ruit,sand,scar,shoot,short,slightly,slit,spaced,stearn,stigma,straight,strongly,tangled,thickened,triangular,trichome,tube,ud,unit,white-spotted,wide,wing,winged,woody,yellow,ympodial,young	abaxial,adaxial,armed,arrangement,color,form,fruit,hair,height,length,midpoint,mucilaginous,na,number,plant,prickle,property,reproduction,secondary,seed,shape,staman,texture,venation
21	wfo-0001025700	success	189	83	59	130	24	0.312	0-16,0.30-2.0,0.5-2,0.7-2.7,0.8-2.6,1.1-2.3,10-40,10.5-12,2.5-4,3-8,3.5-10.5,3.7-8.6,5-15,5-20,5.3-17.5,5.5-8,anther,chartaceous,cm,corolla,diameter,elliptic,filament,flower,forked,fruit,glabrescent,glabrous,globose,green,greenish,herb,interjected,lateral,leaf,leaflet,lilac,medium,mm,mucilaginous,narrowly,odd-pinnate,ovate,ovoid,pentagonal,perfect,petiole,plant,purple,rotate-pentagonal,seed,size,style,terminal,unwinged,whitish,winged,x,yellow	0.8-4,1-2,1-3,1.5-2,15-40,2-12,2-7,3-4,4-5,5-merou,5.5-18,9-31,abaxially,acuman,acumen,acuminate,acute,adaxially,ag,alyx,apex,apiculate,apparently,articulated,asymmetric,attenuate,axe,axillary,basal,base,basiscopic,berry,blade,brownish,bud,capitat,cell,clavate,condition,connivent,considerably,covering,decrease,decreasing,digestion,distal,dorsally,dot,drying,eaf,edge,eed,enzyme,erec,exceeding,except,flat,folded,fresh,geminat,generally,glabrou,green-white,hair,hair-like,hal,half,high,homostylous,honeycomb-shaped,lanceolate,larger,lengthening,light,linear,living,lobe,long,lower,make,nflorescence,orbicular,orolla,pair,par,pedicel,peduncle,petiolulate,plurifoliate,pore,poricidal,proximal,removed,ripe,rounded,ruit,sessile,seudostipule,short,side,slightly,slit,sometimes,specimen,stamen,stigma,straight,subequal,subglabrou,subtending,tall,tamen,tem,testal,thick,throughout,tip,tissue,toward,tri-,tube,typically,unit,usually,vary,wall,wet,white,whose,ympodial	abaxial,adaxial,arrangement,branching,calyx,color,form,growth,height,inflorescence,length,number,ovary,property,pseudostipule,reproduction,shape,staman,stem,subglabrous,surface,texture,winging,ye
22	wfo-0001025702	success	279	91	70	209	21	0.251	0.3–2.2,2,2.2,2.3,2–14,3.2,4–16,5.4,6.6,acute,apex,attachment,base,broadly,brochidodromous,chartaceous,cm,cuneate,densely,dry,either,elliptic,entire,extending,flattened-orbicular,flower,forked,fruit,glabrous,globose,homostylous,joining,lanceolate,laterally,margin,mature,midpoint,midvein,mm,moderately,notched,oblong,obtuse,petiole,point,prickle,pseudo-intermarginal,pubescent,red,retrorse,rounded,scandent,secondary,shrub,side,simple,sometimes,sparsely,stem,strongly,sub-coriaceous,surface,triangular,unbranched,vein,yellow-ferruginous,yellow-tan,±90°,×,–6	.0,.1,.3,.5,.7,/2,0.04,0.3–0.4,0.4–2.3,0.5–0.6,0.5–0.8,0.5–1.3,0.6–0.9,0.6–1.0,0.7–1.4,1.2–1.6,1.3–1.8,1.3–2.8,1.4–1.6,1.4–2.2,1.4–2.8,1.6–1.7,1.6–1.8,1.6–2.0,1.6–2.1,1.6–2.3,1.7,1.7–2.3,1.7–9.2,1.9,1/3,1/4–1/3,2.0–3.2,2.2–2.9,2.3–6.6,2.3–7.8,2.5,2.6–7,3.6–3.9,4,4.3,4.5–5.2,5-merou,5.2–7.5,6.9–10.3,6–10,6–8,abaxially,acuminate,adaxially,adjacent,adnate,aequilateral,ag,alyx,anther,anthesi,apart,apical,apiculate,apparently,appearing,appresse,around,articulate,attenuate,axe,ba,bark,based,becoming,berry,blade,branch,broad,broad-based,brown,bud,calyx,capitate,channeled,completely,congested,corolla,cream,curved,deciduous,deflexed,deltate,deltoid,dentate,developed,diameter,difoliate,directed,distal,distally,distinct,eaf,edge,eed,emerging,endocarp,exocarp,extra-axillary,ferruginous,fertile,filament,filiform,flexed,free,geminat,glandular,glossy,gradually,gree,hair,hooked,hort,increasing,incurved,indistinct,intact,internode,interpetalar,intersepalar,juic,lateral,lax,layer,limp,lobe,lon,long,longer,lower,m.,midrib,minute,nearly,nflorescence,oblique,occasionally,opaque,orolla,ovate,pedicel,per,perforated,poorly,pore,porrect,portion,potentially,presen,primary,pseudo-peduncle,raised,ray,reddish,reflexed,remaining,row,ruit,scattered,seen,sessile,shoot,sinus,sloughing,smoot,smooth,somewhat,soon,splitting,spread,stamen,stellae,stellate,stellate-pubescent,stigma,straight,style,suture,tamen,tem,thin,time,tip,tissue,toward,transparent,truncate,tube,two,ud,unarmed,upper,vary,white,wide,yellow,yellow-ferruginou,ympodia,young,±90,±connivent,±equal,±glabrous	5-merous,abaxial,adaxial,arrangement,branching,color,form,growth,height,inflorescence,leaf,length,mucilaginous,na,plant,property,reproduction,seed,shape,texture,venation
23	wfo-0001025704	success	248	138	119	129	19	0.48	0-2,0.5-1.5,0.7-1,1,1-6,1.2-3,1.5-3.2,1.5-4.5,1/2-4/5,1/5,2-3,3-10,3-15,3-6,4-12,4.5-6.5,5-merous,8-17,abaxial,acute,adaxial,almost,andromonoecious,anther,apex,auriculate,base,berry,branched,calyx,chartaceous,cm,connivent,cordate,curved,densely,diameter,discolorous,drying,ellipsoid,elliptic,erect,evenly,filament,flattened,flattened-reniform,flower,fruit,glabrescent,green,green-yellow,heterostylous,irregular,leaf,length,lobe,lobed,long,margin,maturity,mauve,midpoint,mm,near,occasionally,often,orange,orange-brown,outline,ovate,pair,pale,petiole,plant,poricidal,prickle,prickly,primary,prominent,rarely,ray,recurved,red-green,round,rounded,shape,shrub,side,slender,small,sometimes,somewhat,sparsely,spherical,stellate-pubescent,stem,stout,straight,strongly,style,surface,tapering,tertiary,tip,tree,truncate,unbranched,upper,vein,venation,visible,way,white,white-gray,wide,yellow,yellow-green,yellowish,young	-10,-2,-3,-5,/6,0,0-100,0-3.5,0-5,0.1,0.1-0.3,0.1-0.5,0.15-0.8,0.3-0.8,1-3.5,1-4,1.5-2,1.8-3.5,1/4-3/4,2,2-10,2-4.5,2-5,2-7,2.5-4.5,2.7-4,3-5,4-5,5-20,6-12,6-15,8-12,8-15,abaxially,age,alyx,apar,apart,apically,apiculate,apparently,articulated,axe,ba,bark,blade,broad-deltate,brow,cell,covering,deltate,development,distal,distance,eaf,eed,elongating,end,equal,extending,free,fruiting,glabrous,gray,half,hermaphrodite,infructescence,lateral,less,lobing,long-styled,longer,lower,lowermost,mature,midvein,moderately,multangulate,nflorescence,obtuse,older,one,open,orolla,oung,pedicel,peduncle,pendulous,per,pericarp,pit,plurifoliat,porrect,portion,prickl,raised,red-brown,reflexed,retaining,ruit,scar,secondary,sessile,short-styled,shorter,smooth,spaced,spreading,stalk,stalked,staminat,stellate,stellate-pubescen,tamen,terete,terminal,throughout,time,trichome,tube,unarmed,unit,variously,vary,warty,widening,woody,ympodial,×	armed,arrangement,branching,color,corolla,form,growth,hair,height,inflorescence,mucilaginous,na,number,ovary,property,reproduction,seed,staman,texture
24	wfo-0001025714	success	249	82	47	202	35	0.189	acute,anther,apex,armed,base,broadly,calyx,cm,decidedly,diameter,enlarged,filament,flattened,flower,fruit,glabrous,gland-tipped,glandular-pubescent,globose,hair,hyaline,light,lobed,margin,minutely,mm,orbicular,ovary,ovate,petiole,prickle,pubescent,rounded,shrub,simple,stellate,stem,stipitate-glandular,style,subcordate,subreniform,tan,truncate,unbranched,white,yellow,yellowish	%,-5,-rayed,.2,0.1–0.8,0.2–0.8,0.5,0.5–0.6,0.5–1.3,0.5–2,0.8,0–0.4,1,1.2–2.4,1.3–3,1.5–2,1.5–2.5,1.5–3.5,1.6–2.3,1.8–,1/3,100,10–11,13,15,15–25,1–2,1–4,2,2-foliate,2.2–3,2.5,2.5–3.8,2.8,2–3,2–4-celled,2–7,2–8,3.7–5,3–16,3–9,4–18,4–6,5,5.9–7.5,50,5–25,5–6.5,6.2–6.8,6–16,7–18,7–8.5,8–13,9.2–10,9–22,>,abaxially,absent,accrescent,acicular,adaxiall,adaxially,additional,always,anthesi,apart,appearing,around,articulated,ascending,asia,attenuate,axe,ba,berry,blade,branch,capitat,caudate-tipped,completely,concealing,covering,curved,cylindrical,differing,dilated,dimorphic,directed,distall,eaf,eed,entire-margined,erect,extra-axillary,fertile,few-branched,few-rayed,forward,free,frui,fruiting,geminat,glabrou,gland,gland–tipped,half,halfway,herbarium,horizontally,immediately,increasingly,lacking,larger,latter,less,lobe,lobing,long,longer,longest,lower,lowermost,mainly,major,male,many-rayed,maturity,midrib,minor,minute,mixed,multangulate,narrowly,nearly,nflorescence,numerous,obtuse,often,one,orolla,pair,pedicel,peduncle,per,perhaps,pilose,plane,pointing,pore,predominating,pubescence,rachi,rare,rarely,recurved,reflexed,ruit,scarcely,scattered,sessile,short,shorter,similar,single,size,slender,slightly,small,smaller,sometimes,spaced,sparse,specimen,spine,spreading,stellae,stigma,stipitate,stouter,straight,subglabrous,tal,tamen,tem,terete,thin-textured,time,toward,triangular,tube,unequal,unit,upper,usually,various,vary,way,wide,x,ympodial,–1.25,–7–9	0.1-0.8,0.5-2,1.3-3,1.6-2.3,2-7,2-8,3-9,5.9-7.5,6.2-6.8,7-8.5,abaxial,adaxial,arrangement,branching,color,corolla,form,growth,height,inflorescence,leaf,length,midpoint,na,number,plant,reproduction,secondary,seed,shape,staman,surface,texture,vein,venation
25	wfo-0001025726	success	158	68	44	114	24	0.278	-5,0.5-1.5,1-2.5,10-15,20-40,3-5,acuminate,acute,apex,armed,base,branched,brown,chartaceous,cm,elliptic,entire,flattened,flower,fruit,glabrous,globose,green,hair,light,margin,mm,ovate,perennial,petiole,pinnate,pinnatifid,prickle,rarely,recurved,rounded,scandent,shape,side,strongly,surface,terminal,variously,vein	-10,-16,0-1,0.2,0.2-0.3,0.5,1,1-1.5,1-3,2-,2-3,2.5,3-10,3-4,4,4-10,5,6-12,6-8,7-9,abaxially,accrescen,adaxiall,adaxially,adjacent,ag,alyx,anther,anthesi,articulated,axe,ba,becoming,blade,broadly,calyx,campanulate,clustered,compound,confluent,connivent,diameter,dr.,eaf,eed,elongating,equal,fertile,filament,foveolate,fruiting,geminat,imparipinnately,internode,lateral,leaflet,lengthening,lobe,lobed,long,major,midrib,narrowly,nflorescence,oblon,oblong,occasionally,often,orolla,pedicel,peduncle,plurifoliate,pore,poricidal,present,puberulent,purple,rachi,ranging,recurve,rugose,ruit,simple,size,slender,slit,spreading,stellate,stigma,stout,straight,style,subwoody,swollen,tamen,tem,terminally,time,tip,truncat,tube,ud,unbranched,unit,usually,variable,vary,vin,white,wide,woody,x,yellow,ympodial	abaxial,adaxial,arrangement,branching,color,form,growth,height,inflorescence,leaf,length,midpoint,mucilaginous,na,plant,property,reproduction,secondary,seed,stem,texture,various,venation,vine
26	wfo-0001025729	success	177	102	73	104	29	0.412	.5,/4,0.25-0.5,0.7-1.2,1-1.5,1-5,1.2-1.8,1.75,4-5,5-50-flowered,abaxial,abaxially,acute,adaxially,anther,apex,appearing,axil,base,blackish,calyx,cm,corolla,cyathiform,dirty,drying,elliptic,filament,flattened-reniform,furcate,glabrous,globose,green,greenish-yellow,growing,lateral,leaf,lobed,long,main,margin,mm,oblique,occasionally,often,opposite,ovary,overtopping,pale,petiole,plant,pubescent,ripening,rounded,shiny,simple,sparsely,stem,style,surface,terminal,tip,tree,treelet,trichome,tuft,uniseriate,usually,vein,way,white,x,yellow	-20,1.1-1.5,1.5-2,2,2-3.5,20,3-6,4-8,6-8,7-8,9-17,abrupt,along,anthesi,apar,apical,apiculate,bark,basal,berry,black,branched,bright,bristly,bud,covered,covering,dark,deflexed,deltoid,densely,denser,dia,diam,differing,difoliate,eaf,edicel,eed,enclosed,expanded,f,fleshy,free,fruiting,geminat,gently,glabrou,greyish-brown,incrassate,lamina,lat,like,live,lobe,lon,lower,m.,mainly,major,member,middle,minor,minute,minutely,nflorescence,older,one,overlapping,pair,papillo,papillose,partially,pedicel,pit,pitted,pore,poricidal,portion,prominent,quite,raised,reflexed,ruit,scar,shaped,short,size,stigma,stout,straight,tall,tapering,tear-drop,touching,tub,tube,ud,unit,widening,widest,woody,ympodial,young	4-20,5-50,adaxial,armed,arrangement,branching,color,diameter,flower,form,fruit,growth,hair,height,inflorescence,length,midpoint,mucilaginous,na,number,prickle,property,reproduction,secondary,seed,shape,staman,texture,venation
27	wfo-0001025737	success	220	126	103	117	23	0.468	-branched,0.3–0.7,0.7–1.3,0.9–1.1,1.5–2,1.5–3,1.5–5,10,10–12,1–,2,2.5–4.5,25–50,2–3,3.5–5,3.5–8,3–10,4–6,5-merous,7–8,abaxially,adaxially,angularly-cordate,anther,apex,apparently,attenuate,base,branch,bright,broad-based,cm,densely,diameter,entire,extra-axillary,fertile,filament,filiform,flattened-reniform,flower,fruit,glabrous,gland-tipped,globose,greenish,growth,hair,internode,interpetalar,lateral,light,lighter-colored,like,lobe,lobed,long,loosely,margin,midpoint,midvein,minute,mm,narrow,near,obtuse,orange,ovate,ovate-lanceolate,pale,per,perfect,persistently,petiole,prickle,principal,rarely,rounded,seed,shallowly,shrub,side,simple,stellate,stellate-tomentose,stem,straight,style,surface,thick-chartaceous,time,tinge,tissue,tomentose,usually,vein,violet,white,wide,yellow,×,–3,–4	0.2–0.3,0.3–2,0.6,0.6–0.9,0.8–1.1,1.4–1.8,1.5,1.5-2,1.5–6.5,1.7–2.2,1–1.2,1–1.5,2.5–3,3,44599,47092,4–11,5,51,5–6,8–10,8–16,9-10,95,absent,accrescen,acute,adaxiall,age,alyx,apart,apical,appressed-tomentose,armed,articulated,axe,ba,becoming,blade,capitat,deeply,difoliate,directed,distall,eaf,eed,except,finely,free,geminat,glabrou,green,high,homostylous,immature,juicy,juvenile,lance-ovoid,linear-attenuate,linear-lanceolate,lon,long-stipitate,lower,major,midzone,minutely,mixed,nee,nflorescence,northern,numerous,oblong,odorle,orolla,part,pedicel,peduncle,pitted,pore,porrect,range,ray,reflexed,ruit,scarcely,sessile,shiny,short-,short-stipitate,shorter,sinus,slender,southern,spaced,sparsely,splitting,ste,stellae,stellate-pubescent,stigma,stipe,straigh,tamen,tem,tomento,triangular-attenuate,tube,turning,ud,unarmed,vary,vigorous,whitish,x,ympodia,–14,–20	abaxial,adaxial,arrangement,branching,calyx,color,corolla,form,height,inflorescence,leaf,length,mucilaginous,na,odorles,ovary,plant,property,reproduction,shape,staman,texture,venation
28	wfo-0001025741	success	231	108	89	142	19	0.385	0-0.1,0.5–0.8,1.2–1.5,1.7–2,1.8–2.1,11–14,12–15,2.5–8,3–10,4–6,5-merous,5–6,6.5–9,8–15+,abaxial,acuminate,acute,adaxial,andromonoecious,anther,apex,armed,base,broad-based,brown,calyx,chartaceous,cm,cuneate,dark,densely,diameter,either,entire,fading,filament,flattened,flower,fruit,glabrous,globose,golden-tan,green,hair,inflorescence,juicy,lanceolate,leaf,length,light,lighter,lobed,margin,maturity,midpoint,midvein,mm,moderately,nearly,oblique,once-branched,orange,outline,ovate,petiole,plant,prickle,pubescent,reniform,rotate-stellate,shallowly,side,simple,sparsely,stem,stout,strongly,style,surface,tree,unbranched,vein,violet,white,yellow,×,–20,–30,–8	.2,.5,0.5–3,0–0.1,1.1–2,10–35,15–45,1–2,1–2.5,1–4,2.5–3,2.5–3.5,20–23,29–36,2–3,2–3.2,2–4,2–7.5,30–120,3–6,4–5,4–7,5–17,6–7,8–18,abaxially,abundant,abundantly,adaxially,along,alyx,andromonoeciou,anthesi,apart,articulated,axe,ba,bark,becoming,berry,blade,capitat,column,congested,connivent,covered,curved,cylindrical,db,deltate,deltoid,difoliate,directed,distall,dry,eaf,eed,eglandular,emergent,equal,extraaxillary,flowering,free,fresh,frui,fruiting,functionally,geminat,glandular,half,hermaphroditic,heterstylous,included,inflated,interpetalar,knobby,like,lobe,lon,long,long-stalked,lower,lustrous,major,membranaceous,multangulate,multiseriate,nflorescence,one,orange-tan,orolla,part,pedicel,peduncle,pericarp,pore,porrect-stellate,present,rachi,ray,remaining,rugose,ruit,runk,sessile,sharp,shiny,short,short-cylindrical,short-stalked,small,somewhat,spaced,sparse,stalk,stalked,staminate,stellate,stellate-pubescent,stigma,straight,subtending,tamen,tan,tapered,thi,thin,time,tissue,tube,tuft,unarmed,unit,vary,wide,within,ympodial,young,–12,–28,–39,–6	arrangement,branching,color,corolla,form,growth,height,mucilaginous,na,number,ovary,property,reproduction,secondary,seed,shape,staman,texture,venation
29	wfo-0001025743	success	157	87	56	101	31	0.357	0.15-0.3,1.2-4,2-3,4-8,4.5-5.5,6-10,6-7,8-10,acicular,andromonoecious,apex,base,broadly,brown,calyx,chartaceous,cm,cordate,cuneate,deeply,diameter,flower,fruit,glabrous,gland-tipped,globose,green,grey,hair,herbaceous,inflorescence,length,lobed,margin,mm,obtuse,ovate,pale,petiole,plant,present,prickle,prostrate,resprouter,short,simple,sprawling,stellate,straight,strongly,style,throughout,unbranched,vein,white,yellow	%,.5,0-15,0-6,0.1-0.3,0.3-0.5,0.3-0.6,0.4-0.5,0.4-0.8,0.5-0.9,0.9-1.2,0.9-2.6,1,1-6,1.3-1.8,11-25,12-17,2-4,2-4.5,2.3-5,2.8-3.5,3-13,3-4,3-6,3.5-5.5,30-80,5-10,5-20,5-merou,6-20,9-18,abaxially,absen,absent,adaxiall,adaxially,adult,alyx,apart,armed,articulated,axe,ba,blade,branche,cylindrical,decimetre,deltate,dense,directed,distall,eaf,eed,extra-axillary,finger,fruiting,functional,half,heterostylous,index,lamina,lateral,less,lobe,lobing,lon,long,longer,lower,mature,mid-point,midvein,minute,nflorescence,nther,oblique,onl,orolla,part,pedicel,peduncle,per,pore,presen,ruit,side,spaced,stage,tal,tem,thick,time,tube,unit,unknow,uvenile,vary,wide,x,yellowish-gree,ympodial	5-merous,abaxial,adaxial,anther,arrangement,branching,color,corolla,filament,form,growth,height,history,leaf,life,midpoint,mucilaginous,na,number,ovary,property,reproduction,secondary,seed,shape,staman,stem,surface,texture,venation,yellowish-green
30	wfo-0001025749	success	217	97	75	142	22	0.346	-1,-12,0.2-1.5,0.3-1.5,0.5,0.5-0.8,0.5-3,0.8-0.9,1-13,1-2,1-9,2.5-6,3-5,5-10,5-merous,abaxial,acute,adaxial,anther,apex,apparently,base,branched,calyx,chartaceous,cm,cuneate,dark,densely,diameter,dull,filament,flattened-reniform,flower,fruit,glabrous,green-brown,indistinct,lateral,leaf,length,lobed,long,magnification,margin,mauve,midpoint,mm,moderately,orange-brown,orange-red,orbicular,ovate,pale,petiole,prickle,rarely,red-brown,rounded,shrub,sometimes,sparsely,spherical,stellate-pubescent,straw-yellow,style,surface,usually,venation,visible,white,without,yellow,yellow-green,yellow-orange	.5,/5,0-10,0-3,0-5,0-6,0-8,0.1,0.1-0.2,0.1-0.3,0.1-0.4,0.2,0.4-0.7,0.5-0.9,0.5-1.3,0.6-4.5,1,1-10,1-3,1-6,1-8.5,1.5,1.5-2,1.5-2.5,1/4-1/3,1/5-1/2,2-10,2-2.5,2/3,3-20,4-8,5-,5-20,6-8,abaxially,acuminat,adaxially,adnate,almost,alyx,apar,apart,apically,articulated,bark,berry,blade,broad-deltate,concolorous,curved,difoliate,discolorous,distance,drying,eaf,eed,elongating,equal,erect,extending,filiform,flattened,free,fruiting,geminat,gently,glabrescent,gray,herbaceous,infructescence,light,lobe,lon,long-ovate,longer,lower,markedly,mature,maturity,midvein,narrow-deltate,narrow-ovate,nflorescence,oblong,obtuse,occasionally,older,one,open,orange-brow,orolla,oung,pair,pedicel,peduncle,pendulous,per,perfec,pericarp,poricidal,porrect,portion,prickl,prickly,primary,procumbent,purple,ray,recurved,reduced,ruit,scar,sessile,shorter,side,smooth,spaced,spreading,stalk,stalked,stellate,stem,straight,strongly,tamen,tapering,terete,tertiary,time,tip,toward,trichome,tube,unit,variously,vary,vein,way,wide,yellowish,ympodial,½-2/	arrangement,branching,color,corolla,form,growth,hair,height,history,inflorescence,life,na,ovary,perennial,perfect,plant,reproduction,seed,shape,staman,texture,width
31	wfo-0001025754	success	164	100	70	94	30	0.427	.5,0.5-1,0.5-1.5,1,1-3,1.5,1.5-3,3-10,4-6,abundant,acuminate,acute,anther,apex,asymmetrical,base,beyond,brown,calyx,chartaceous,ciliate,cm,cordate,cordiform,decurrent,densely,diameter,dm,drying,entire,equal,exserted,filament,flower,fruit,glabrous,globose,hair,herb,immature,interpetalar,leaf,leaving,long,margin,maturing,membranaceous,mm,moderately,nearly,often,palmately,petiole,pubescent,rotate,semitransparent,slightly,solitary,sparsely,stamen,stem,style,surface,tissue,truncate,unbranched,vein,white,x,yellow	-celled,0.1-0.2,1-2,1-3.5,1.5-4,10-20,10-35,2-4,2-5-celled,2-7,2-foliate,3-5,3-6,4,5-12,5-15,abaxially,absent,adaxiall,adaxially,along,axe,barely,berry,blade,branch,center,connected,decumbent,dehiscing,denser,dried,eaf,edge,eed,eglandular,emarginat,erect,explosively,fine,flat,geminat,glandular,held,like,linear-lanceolate,lobe,lower,lying,main,material,maturit,mesocarp,mixed,much-branched,nfloresence,notch,oblong,orolla,parallel,pedicel,peduncle,penden,per,placenta,pressure,probably,pubescen,rachi,radiating,raised,ridge,ruit,running,shallow,short,small,sometimes,stigma,straight,swollen,tal,tamen,tem,triangular,tube,unit,upright,vary,visible,watery,wid,woody,ympodial	abaxial,adaxial,arrangement,branching,color,corolla,form,geminate,growth,height,history,inflorescence,length,life,midpoint,mucilaginous,na,number,ovary,perennial,plant,prickle,property,reproduction,secondary,seed,shape,staman,texture,venation
32	wfo-0001025760	success	210	94	70	140	24	0.333	-10,-6,0.3-1,0.4-0.8,0.45-0.9,0.8-1.8,1-1.8,1-2,1-4,2.3-4,3-6,3.5-9,5-10-merous,abaxial,acute,adaxial,almost,annual,anther,apex,base,black,calyx,chartaceous,cm,cream,cuneate,dark,diameter,dull,filament,flattened-reniform,flower,fruit,glabrous,green,hair,herb,leaf,length,lobed,margin,marking,maturity,membranous,midpoint,mm,moderately,orange,orange-brown,ovate,pair,pale,perennial,petiole,red-brown,rounded,shape,spherical,stellate-pubescent,stem,style,surface,unbranched,vein,venation,white,yellow,yellow-green,young	-12,-3,-5,.5,/3,0-0.5,0-100,0.1,0.1-0.2,0.15-0.3,0.2-0.35,0.5-1.5,0.5-2,0.7-2.5,1,1-,1.5,1.5-2.5,1.5-4.5,1.5-5,1/4,1/4-1/2,1/4-1/3,1/5,2-2.5,2-3,2.1-3.5,2.5-10,2.5-8,2/3,3,3.5-17,5-18,8-10,abaxially,acut,alyx,apar,apically,apparently,articulated,bark,berry,blade,broad-deltate,brow,concolorous,connivent,cultivar,curved,deltate,difoliate,discolorous,distance,drying,eaf,eed,elliptic,elongating,equal,erect,extending,free,fruiting,geminat,geminate,gently,glabrescent,infructescence,lateral,lengt,lobe,long,longer,lower,mature,midvein,minute,nflorescence,often,older,one,open,orolla,oung,pedicel,peduncle,pendulous,per,perfec,pericarp,poricidal,porrect,portion,primary,ray,recurved,reflexe,ruit,scar,sessile,shorter,shrub,side,simple,slender,smooth,sometimes,spaced,spreading,stalk,stalked,stellate,stellate-pubescen,stout,straight,subentire,tamen,tapering,terete,tertiary,thick-stalked,time,tip,trichome,tube,unarme,unarmed,unit,upper,usually,various,variously,vary,visible,way,weakly,wide,woody,ympodial	arrangement,branching,brown,color,corolla,form,growth,height,history,inflorescence,life,mucilaginous,na,number,ovary,perfect,plant,prickle,property,reproduction,secondary,seed,staman,texture
33	wfo-0001025782	success	200	85	67	133	18	0.335	0.3-1,0.4-0.6,0.55-0.75,1-2.5,1-4,1.2-6,1.3-1.6,1.5-3,2-3,3-4,4,4-4.5,abaxial,acuminate,adaxial,andromonoecious,anther,apex,apically,base,brown,calyx,chartaceous,climbing,cm,cuneate,diameter,dull,elliptic,evenly,filament,flattened-reniform,flower,fruit,glabrous,green,green-brown,hair,leaf,length,lobed,long,margin,membranous,midpoint,mm,moderately,orange-brown,petiole,plant,prickle,shrub,sparsely,spherical,stellate-pubescent,stem,style,surface,unbranched,vein,venation,visible,weakly,white,wide,yellow,yellow-green	-2,.5,0-10,0-5,0.1-0.15,0.1-0.2,0.1-0.25,0.5-1,0.9-1.3,1,1-1.7,1-2,1/4-1/2,1/4-1/3,1/6,10-13,2-10,2-2.5,2-5,2-7,2.5-3.5,2/3-3/4,20,3-5,4.5-9,5-20,5-6.5,5-8,5-merous,5.5-6,6-14,6-8,abaxially,acuminat,also,alyx,apar,apart,apparently,articulated,bark,berry,blade,concolorous,conical,connivent,curved,deltate,densely,difoliate,discolorous,distal,distance,drying,eaf,eed,elongated,elongating,equal,extending,flattened,free,fruiting,geminat,geminate,gently,glabrescent,hermaphrodite,heterostylous,infructescence,lateral,lengt,less,lobe,long-styled,longer,lower,lowermost,mature,maturity,midvein,minute,nflorescence,occasionally,older,one,open,orolla,oung,pair,pedicel,peduncle,pendulous,per,pericarp,poricidal,porrect,portion,prickl,prickly,primary,ray,red-brow,reduced,ruit,scar,sessile,short-styled,shorter,side,simple,smooth,spaced,spreading,staminat,stellate,stout,straight,tamen,tapering,terete,tertiary,time,tip,toward,trichome,tube,unit,vary,way,woody,ympodial,young	arrangement,branching,color,corolla,form,growth,height,inflorescence,na,number,ovary,red-brown,reproduction,secondary,seed,shape,staman,texture
34	wfo-0001025783	success	179	96	73	106	23	0.408	.5,0.5-1.5,1-1.5,1-3,2-3+,2-5,3-4,7-10,acute,anther,apex,base,berry,branching,brown,c.,calyx,cm,coriaceous,corolla,dendritic,diameter,elliptic,entire,flattened,fleshy,flower,glabrous,globose,greyish,growth,lateral,lax,lobed,margin,minutely,mm,narrowly,obtuse,pair,pale,perfect,petiole,pubescent,purple,reniform,revolute,ripe,scarious,shiny,shoot,short,shrub,simple,slightly,sometimes,somewhat,sparsely,stellate,stem,surface,suture,terminal,time,transparent,trichome,truncate,uniseriate,vine,violet,way,within,woody	0.5,0.5-1,0.8-3.5,1-1.2,1.8-2,2,2-6.5,5,5-merou,<,abaxiall,abaxially,adaxiall,adaxially,along,alyx,anthesi,apart,ape,ark,articulated,axil,branched,bud,cell,cluster,completely,confined,conical,densely,eaf,eed,ellipsoid,erect,expanded,exposed,exserted,filiform,flexuous,free,fruiting,glabrou,green,groove,hromosome,ilament,inserted,keeled,known,less,lobe,long,long/tall,lower,mature,midrib,midvein,minute,mmm,near,new,nflorescence,nodding,number,obscured,occasionally,older,orolla,outlin,pedicel,peduncle,penden,pentagonal,pericarp,pitted,plurifoliat,point,portion,possibly,primary,ruit,sagittate,scar,see,sleeve,spaced,sparse,stigma,strongly,style,testal,thin,triangular,tube,tuft,twinin,type,ud,unit,upper,vary,vein,weak,wide,yellowish,ympodial	5-merous,abaxial,adaxial,arrangement,color,filament,form,fruit,height,inflorescence,leaf,length,midpoint,mucilaginous,na,ovary,plant,property,reproduction,seed,shape,staman,texture
35	wfo-0001025784	success	241	96	59	182	37	0.245	.5,0.2-0.3,0.5,1-5,acute,always,anther,apex,base,black,calyx,cm,diameter,filament,flattened,flower,fruit,glabrous,glandular-pubescent,globose,green,greenish,greenish-yellow,hair,irregularly,leaf,lobed,longitudinal,margin,midpoint,mm,ovate,petiole,prickle,pubescent,purple,raised,rounded,shallowly,shrub,simple,slightly,somewhat,spiny,stellate,stem,style,subcordate,subreniform,surface,thin-textured,unbranched,unequal,vein,white,x,yellow,yellow-brown,yellow-green	-3,.2–0.4,0.2,0.2–1.1,0.3–0.5,0.4–2.5,0.5–1.8,0.5–2,0.5–3,0.6–0.8,0.7,0.8–1.1,0.8–1.2,0.9–1.2,0.9–1.4,1,1.2,1.2–2.5,1.3–1.8,1.6–2.2,1/3,10,10–15,15075,1709,1–,1–3,1–5,2,2-foliate,2.5–3.3,2/3,2–2.5,2–3,2–4,2–5-celled,2–7,3.5,3–4,3–4-rayed,4.5–5.5,5,5–6,6,6.5–8,6.5–8.5,=,abaxially,accrescent,acicular,adaxiall,adaxially,also,anthesi,apart,articulated,asplund,ba,becoming,blade,branched,brazil,cell,ciliate,completely,conical,curved,cylindrical,directed,distall,drying,eaf,eed,enclosing,enlarged,especially,et,exceeding,extra-axillary,fertile,fide,free,frui,fruiting,geminat,glabrescent,glabrou,gland,gland-tipped,hyaline,insolated,irwin,lanceolate,lobe,long,lower,lowest,major,male,many,midrib,minute,minutely,moderately,mostly,mottled,much,n,narrowly,nearly,nflorescence,numerous,obtuse,offset,one,orolla,pair,pedicel,peduncle,per,pilose,pore,pubescence,rachi,rarely,ray,recurved,reflexed,reported,ripe,rudimentary,ruit,second,sessile,sharp,short,side,similar,small,smooth,sometimes,spaced,sparsely,sprawling,spreading-pilose,stamen,ste,stellae,stigma,stipitate,stout,straight,subcapitat,tal,tamen,tem,thick,thicker,time,tip,toward,triangular,truncate,tube,unarmed,unit,upper,usually,variously,vary,way,wid,wide,widest,without,ympodial,young,–2,–4,–5.5,–8,–9	0.5-3,0.6-0.8,0.8-1.2,0.9-1.2,0.9-1.4,2-3,2-4,2-7,4.5-5.5,8,abaxial,adaxial,arrangement,branching,color,corolla,form,growth,height,history,inflorescence,length,life,mucilaginous,na,number,ovary,perennial,plant,property,reproduction,secondary,seed,shape,staman,texture,venation
36	wfo-0001025788	success	158	81	58	100	23	0.367	0.5-2,1-5,1.8-2.7,1.8-3.9,2-13,2-3,2-5,4-5.5,4.5-10.1,4.5-12.5,5-8,6.2-12.5,8-38,blue,branched,calyx,cm,conical,corolla,cyme,deep,diameter,dichasial,dichasially,distal,ebracteate,elliptical,finely,flower,forked,generally,green,green-white,half,herbaceous,interjected,lateral,leaf,leaflet,medium,mm,monochasial,mucilaginous,narrowly,odd-pinnate,ovate,ovoid,perennial,petiole,plant,pubescent,purple,rotate,seed,style,terminal,tuber-bearing,yellow	-8,0-6,1-4,10-24,14-48,15-30,2-10,2.8-9.5,2m,3-,3-6-foliat,4-3.,6-7,abaxiall,abaxially,acumen,acuminate,acute,adaxially,apex,apical,apically,articulate,attenuate,base,cell,connate,covering,cuneate,dehiscent,digestion,diminishing,dorsally,eaf,edge,eed,emoval,enzyme,exceeding,filament,flat,folded,globo,gradually,hair-like,honeycomb,introrse,living,lobe,lon,long,long-attenuate,lower,lunat,make,maturing,nflorescence,nther,oblique,obtuse,often,orolla,pair,pattern,pedicel,peduncle,perfect,petiolule,plan,poricidally,proximal,reveal,rounded,ruit,sessile,seudostipule,short,size,slit,specimen,stamen,stigma,straight,subequal,subsessile,tal,tem,testal,thick,throughou,throughout,tip,toward,typically,unit,vary,wall,wide,ympodial,¼	4-31,anther,arrangement,branching,color,form,fruit,growth,height,history,inflorescence,length,life,na,number,ovary,property,shape,stem,surface,texture,width,ye
37	wfo-0001025792	success	203	95	63	140	32	0.31	0.4-0.7,1-2,1-3,2.5-3.5,4-12,4-6,5-10,7.5-8,9-12,acute,anther,apex,base,blue-mauve,blue-purple,brownish,chartaceous,cm,condition,corolla,dark,densely,diameter,distinctly,drying,elliptic,filament,flower,forked,fresh,fruit,glabrous,globose,green,greenish,hair,herb,lanceolate,like,margin,mauve,membranous,mm,mucilaginous,oblique,odd-pinnate,ovoid,papillose,perfect,petiole,plant,pubescent,purple,rotate-pentagonal,rounded,seed,stem,streak,style,tinged,white,whitish,yellow	1-10,1-4,10-15,2-11,2-3,2-3.5,2.5-4,21-28,3-4,3-5,3.5-6,4.5-7,5,5-6,5-9,5-merou,7-10,8-10,abaxially,acumen,acuminate,adaxially,ag,along,alyx,apart,apparently,articulated,articulation,auriculate,axe,axillary,basiscopic,berry,blade,broadly,bud,capitat,cell,ciliate,connivent,covering,decurrent,developing,digestion,distal,distinct,dorsally,eaf,edge,eed,enzyme,especially,exceeding,except,flat,folded,geminat,generally,glabrou,greatly,green-white,hair-like,hal,half,high,homostylous,honeycomb-shaped,indistinct,interjected,lateral,leaflet,lengthening,living,lobe,long,lower,make,midrib,minute,minutely,mottle,narrow,narrowly,nflorescence,often,onto,orolla,pair,pedicel,peduncle,petiolulate,plurifoliate,pore,poricidal,proximal,puberulent,rachi,reduced,removed,ripe,ruit,semi-erec,semi-rosette,sessile,seudostipule,short,shortly,side,size,slightly,slit,spaced,specimen,stamen,ste,stigma,straight,sub-rosette,subequal,subtending,tall,tamen,tem,terminal,testal,thick,throughout,tip,tri-,tube,unit,usually,vary,wall,wet,wing,x,ympodial,young	5-merous,abaxial,adaxial,arrangement,branching,calyx,color,form,growth,height,history,inflorescence,leaf,length,life,midpoint,mottled,na,number,ovary,perennial,prickle,property,reproduction,secondary,shape,staman,surface,texture,vein,venation,ye
38	wfo-0001025804	success	155	88	56	99	32	0.361	0.5-1,1-1.5,1-3,1.2-1.5,10-20,3-4.5,3.5-12,6-8,7-10,abaxially,acute,adaxially,anther,apex,attenuate,base,branched,calyx,cm,corolla,cream,difoliate,elliptic,filament,flattened,flower,glabrous,globose,green,lateral,leaf,light,lobed,main,many,margin,minutely,mm,nearly,obovate,often,ovary,pair,papillose,plurifoliate,reddish-brown,reniform,shrub,stem,style,surface,time,tip,vein,white,whitish-green	.25,.5,1.4-1.7,1.5-2,11-20,16-35,2-2.5,2.5-4,4-10,5,?,age,anthesi,apar,ape,apiculate,ba,bark,berry,bilobed,c.,clavate,conical,covered,cucullate,dark,decurrent,deflexed,densely,dia,differing,drying,eaf,edicel,eed,ellipsoid,erect,exserted,fleshy,free,fruiting,geminat,glandular,incrassate,internodal,later,lengthening,lobe,long,lower,major,mere,middle,minor,minute,near,nflorescence,occasionally,older,onto,opposite,paler,papillae,papillat,papillate,pedicel,pitted,planar,pore,poricidal,portion,projection,red,red-papillose,reddish-brow,regularly,rim,ruit,scar,sessile,size,slit,somewhat,spaced,stigma,strongly,tall,thick,tub,tube,ud,unit,widest,wing,winged,woody,x,ympodial,young	abaxial,adaxial,arrangement,branching,color,diameter,form,fruit,geminate,growth,hair,height,history,inflorescence,length,life,midpoint,mucilaginous,na,number,perennial,petiole,plant,prickle,property,reproduction,secondary,seed,shape,staman,texture,venation
39	wfo-0001025813	success	197	90	60	137	30	0.305	1-2,1-4,1.5-1.8,3-3.5,3-7,5-6,6-7,anther,apex,base,blue,broadly,brownish,chartaceous,cm,condition,corolla,cuneate,dark,densely,diameter,drying,elliptic,filament,flower,fresh,fruit,glabrous,globose,green,greenish,hair,herb,light,like,margin,membranous,mm,monochasium,mucilaginous,obtuse,odd-pinnate,ovoid,perfect,petiole,pilose,plant,pubescent,rarely,rotate,seed,stem,style,suborbicular,unforked,vein,violet,white,whitish,yellow	'',0-2,0.7-1.7,1-1.5,1-10,1.2-4.5,1.3-7,1.5-2,1.5-6.5,15-30,2-3,2-4,2-5,3-4,3-5,3-6,5-18.5,5-merou,``,abaxially,absent,acumen,acuminate,acute,adaxially,ag,along,alyx,apart,apparently,articulated,axe,berry,blade,borne,cell,ciliate,connivent,contracted,covering,decreasing,decurrent,digestion,discussion,distal,distinct,dorsally,eaf,edge,eed,end,enzyme,especially,exceeding,extra,flat,folded,geminat,glabrou,green-white,hair-like,half,highly,homostylous,honeycomb-shaped,interjected,lanceolate,larger,lateral,leaflet,lengthening,living,lobe,long,longer,lower,make,midrib,minute,minutely,near,nflorescence,often,orbicular,orolla,ovate,ovoi,pair,pedicel,peduncle,petiolulate,plurifoliate,pore,poricidal,puberulent,rachi,removed,rosette-formin,ruit,see,sessile,seudostipule,short,single-flowered,singly,size,slit,sometimes,spaced,species,specimen,stamen,ste,stigma,stolo,straight,strongly,tamen,tem,terminal,testal,thick,thir,throughout,tip,toward,tri-,tube,tuber,typically,unit,unwinged,vary,wall,wet,x,ympodial	5-merous,abaxial,adaxial,arrangement,branching,calyx,color,form,growth,height,history,inflorescence,leaf,length,life,midpoint,na,number,ovary,perennial,prickle,property,reproduction,secondary,shape,staman,surface,texture,venation,ye
40	wfo-0001025817	success	238	127	86	152	41	0.361	1-1.6,abaxially,acuminate,adaxially,anther,apex,apparently,asymmetric,asymmetrically,base,bifurcate,black,branch,branched,broad-based,broadly,brown,calyx,chartaceous,cm,dark,deeper,densely,diameter,distally,dull,entire,eventually,expanded,fertile,filament,filiform,flower,fruit,glabrate,glabrous,globose,green,impressed,lanceolate,larger,laterally,leaf,lenticular,margin,midpoint,mm,moderate,near,obtuse,occasionally,one,ovate,pale,pedunculate,persistently,petiole,prickle,pubescent,purple,rarely,ripe,rounded,short,shrub,simple,sized,slightly,small,soon,stellate,stem,style,surface,time,tomentose,tree,turning,unequally,usually,vein,violet,white,woolly,yellow,×	0.5–0.7,0.6–0.8,0.8–1.5,0–1.6,1.5–2.5,1.7-2.1,1.8–2.3,1.8–3,10,10–16,10–35,12–16,1–3,1–5,2–2.9,2–3,2–5,2–6.5,2–8,3.2–8,3.5–6,3–,3–13,3–6,3–8,4–5.5,4–6,4–7,5-merou,5–20,5–6,6–13,7–9,8–14,8–21,absent,accrescen,acute,age,along,although,alyx,amount,apart,apiculate,armed,articulated,axe,ba,berry,bicolorous,blade,campanulate,capitat,central,compresse,conical,deciduous,deltoid,dense,developing,difoliate,directed,distall,eaf,eed,exceeding,except,expansion,extra-axillary,fewer,flowering,forming,free,fruiting,geminat,glabrou,high,interpetalar,juvenile,lacking,large,lateral,like,linear-lanceolate,lobe,long,low,lower,major,midvein,minute,minutely,much,nerve,nflorescence,numerous,oblong,often,orolla,overlapping,pedicel,peduncle,persistent,pinnatifi,pitted,pore,portion,present,prickly,principal,pubescence,racemose,rachi,rayed,reaching,recognizable,row,ruit,sessile,single,sinuate–repand,sinus,slender,sometimes,spaced,sparse,spreading,stalked,stellae,stigma,stout,strongly,tamen,tapering,tissue,trunk,tube,ultimate,unarmed,underside,unit,variously,vary,velvety,weakly,well,white-stellate,wide,without,ympodial,young	1-5,1.5-2.5,2-2.9,2-5,2-8,3-13,3-8,4-5.5,5-20,5-merous,7-9,abaxial,adaxial,arrangement,branching,color,compressed,corolla,form,growth,hair,height,history,inflorescence,length,life,mucilaginous,na,number,ovary,perennial,plant,property,reproduction,secondary,seed,shape,sinuate-repand,staman,texture,venation
41	wfo-0001025825	success	187	89	63	124	26	0.337	0-0.21,0.4-1,0.5-10.4,1-2,1-5.5,10-24,2-3.7,22-86,3-10,3-5,4-8,4-9,6-10,abaxially,adaxially,anther,back,berry,brownish,cm,condition,coriaceous,corolla,dark,diameter,drying,elliptic,filament,flower,forked,fresh,fruit,glabrescent,glabrous,green,greenish,hair,herb,homostylous,leaf,light,lilac,lobe,medium,mm,mucilaginous,odd-pinnate,ovoid,pedicel,peduncle,pentagonal,petiole,plant,rotate-pentagonal,seed,shiny,short,streak,style,white,whitish,wing,yellow	0.4-3,0.5-0.8,0.7-2.2,0.9-2,0.9-4,1-3,1.1-1.4,10.5-26,14-85,2-5,3-8.5,3.7-6.5,5-10,5-7,5-merou,6.6-14,acumen,acuminate,acute,adaxiall,ag,alyx,apart,apex,apparently,articulated,asymmetric,attenuate,axe,axillary,base,basiscopic,blade,bud,capitat,cell,clavate,connivent,covering,cuneate,decreasing,decurrent,digestion,distal,dorsally,eaf,edge,eed,enzyme,erec,exceeding,flat,folded,geminat,generally,glabrou,green-white,hair-like,hal,half,high,honeycomb-shaped,increasing,interjected,lanceolate,lateral,leaflet,lengthening,living,long,lower,make,middle,nflorescence,orbicular,orolla,ovate,pair,perfect,petiolulate,plurifoliate,pore,poricidal,rachi,removed,rounded,ruit,sessile,seudostipule,side,size,slightly,slit,smaller,spaced,specimen,stamen,stigma,straight,subequal,subglabrou,subtending,tall,tamen,tem,terminal,testal,thick,throughout,tip,tissue,toward,tri-,tube,unit,unwinged,usually,vary,wall,wet,wide,winged,x,ympodial	5-merous,abaxial,adaxial,arrangement,branching,calyx,color,form,growth,height,history,inflorescence,length,life,ovary,perennial,property,pseudostipule,shape,staman,stem,subglabrous,surface,texture,width,ye
42	wfo-0001025835	success	297	113	89	208	24	0.3	0.5-2.8,0.65-0.8,0.7-3,1-1.5,1-2.5,1.2-2,1.5-3,2.5-3,3-6,3-7,3.5-4,4,abaxially,acuminate,acute,adaxial,adaxially,anther,apex,apparently,base,becoming,berry,branched,bright,brown,calyx,cm,corolla,diameter,drying,dull,equal,erect,evenly,faint,filament,finely,flattened-reniform,flower,fruit,glabrous,globose,green,lateral,leaf,length,lobed,margin,maturity,mauve,midpoint,mm,moderately,obtuse,occasional,orange-translucent,ovate,pale,perfect,petiole,point,prickle,rarely,ray,red,secondary,shorter,shrub,simple,sparsely,stellate,stellate-pubescent,stem,straw-yellow,style,surface,trichome,usually,vein,venation,visible,white,wide,widest,yellow,yellow-orange,yellowish,young	.1,.3,/4,0.05-0.1,0.1,0.1-0.2,0.2-2,0.5,0.5-0.7,0.5-1,0.6-1.3,0.7-1.8,1,1-2,1-3,1-4,1-5,1-7,1-8,1-9,1.2-1.8,1.5-1.8,1.5-2,1.5-3.5,1/2,1/3,1/3-3/4,1/4-1/2,1/4-1/3,1/4-2/3,2-6,2.2-2.5,2.5-3.5,20,3-5,30-45°,4-5,4-8,5,5-20,5-merou,6,6-8,7-9.5,8,9-11,accrescent,ag,almost,always,alyx,apar,apart,apically,apiculate,armed,articulated,axe,bark,beyond,black,blade,branche,broad-based,broad-deltate,cell,chartaceous,clavate,concolorous,covering,cupular,curved,dark,deep,deltate,developed,development,difoliate,distance,divided,dorsal,eaf,eed,elongating,exserted,extending,finger-hair,flat,flattened,foliaceous,free,fruiting,geminat,gently,glabrescent,gre,green-brown,greenish,infructescence,irregula,irregular,lamina,lengthening,less,lobe,lobing,long,long-deltate,longer,longitudinal,lower,mature,midvein,minute,mostly,network,nflorescence,obconical,oblong,often,older,one,open,opening,orange,orange-brown,orolla,oung,outline,ovoi,ovoid,pair,papillae,papillo,part,pedicel,peduncle,pendulous,per,pericarp,pit,pore,poricidal,porrect,portion,primary,pronounced,rachi,raised,reduced,reflexed,regular,rest,ribbed,ridged,rounded,ruit,scar,secondarily,sessile,shallow,shiny,short,shortly,side,significantly,sinus,slender,slightly,slit,small,smooth,sometimes,somewhat,spaced,spherical,spreading,stalk,stalked,stigma,straight,stump,tamen,tapering,terete,terminal,tertiary,thin,throughout,time,tip,toward,translucent,trifoliate,tube,ud,unarmed,unequal,unit,upper,variously,vary,weakly,wing,woody,x,ympodial,×	5-merous,abaxial,arrangement,branching,color,form,growth,hair,height,history,inflorescence,life,mucilaginous,na,number,ovary,perennial,plant,property,reproduction,seed,shape,staman,texture
43	wfo-0001025838	success	217	117	91	126	26	0.419	-20,0.5-1,0.7-2,1-1.5,1.5-2.5,1.5-5,1.8-2,10-15,10-60,2/3,4-15,4.5-5.5,6.5-7,abruptly,acuminate,adaxial,anther,apex,attenuate,base,berry,black,branched,brown,calyx,cm,corolla,cup-shaped,dendritic,dense,densely,diameter,elliptic,entire,filament,flattened,fleshy,flower,fruit,glabrous,globose,greenish,growth,inflorescence,lanceolate,lateral,leaf,like,lobed,many,margin,membranous,mm,narrowing,narrowly,often,onto,pair,pale,pedicel,perfect,petiole,pubescent,purple,reddish,reniform,revolute,ripe,seed,shrub,simple,slightly,sometimes,sparsely,stellate,stem,style,surface,terminal,time,tinged,tree,trichome,tuft,vein,way,white,winged,x,yellow,¾	.5,0.5,1-1.2,1.2-5,1.5-1.7,1.5-2,1.5-3.5,2-2.5,2-5,2.5-3,20-40,3.5-,5,5-merou,6-15,adaxially,ag,along,alyx,anthesi,apart,apiculate,appearing,archin,ark,articulated,axil,basall,branch,broad,capitate,cell,clavate,clustered,connivent,cucullate,dark,decurrent,denser,disintegrating,drying,eaf,eed,ellipsoidal,erect,exserted,extending,free,fruiting,glabrescent,hairy,ilament,inserted,insertion,irregularly,keeled,lamina,lengthening,less,lobe,long,loosely,lower,m.,midrib,minute,minutely,mostly,never,new,nflorescence,nodding,occasionally,older,orolla,ovoid,papillat,papillo,peduncle,per,pericarp,pitted,platform,plurifoliat,point,pointed,pore,poricidal,portion,primary,quadrate,ruit,scar,shin,shiny,short,sinus,sleeve,slender,slit,small,spaced,spreading,square,stigma,strongly,tall,tem,testal,thi,thin,tip,tube,turbinate,twinin,ud,uniseriate,unit,upper,vary,wall,weight,wing,woody,yellowish,ympodial	5-merous,abaxial,arrangement,branching,color,form,hair,height,history,length,life,midpoint,mucilaginous,na,number,ovary,perennial,plant,prickle,property,reproduction,secondary,shape,staman,texture,venation
44	wfo-0001025845	success	180	98	68	112	30	0.378	0.3-0.5,0.4-1.5,0.5-11,1.5-2,1.5-7,2-3,2-5-lobed,4-5,4-6,5-6,6-6.5,abundantly,acuminate,adaxial,anther,apex,base,brown,calyx,chartaceous,cm,corolla,cuneate,cylindrical,diameter,eglandular,ellipsoidal,entire,filament,flattened,flower,fruit,glabrous,greenish,herb,leaf,light,lobed,margin,membranaceous,minutely,mm,near,orange,ovate,ovoid,patch,perfect,petiole,pinnately,puberulent,pubescent,rotate-stellate,sand-punctate,shrub,side,simple,sparsely,style,subcordate,truncate,unbranched,vein,veiny,white,x,yellow,yellowish	.5,0.5-2.5,1,1-1.8,1-2,1-4.5,1.5,1.5-13,1.5-2.5,2,2-15,2.5-4,3,3-13,3-4,3-6,3-foliat,6-9,7-10,abaxially,acute,adaxially,aggregate,along,apart,apiculate,around,articulated,ascending,axe,ba,blade,branch,cell,channe,compressed,connivent,dark,decurrent,deltate,diamete,directed,distall,distally,divided,eaf,eed,elliptic,especially,extra-axillary,fork,free,glabrou,green,inserted,lateral,laterally,lobe,located,long,longitudinal,lower,major,mesocarp,midrib,narrowly,nearly,nflorescence,obovate,obtuse,often,orolla,part,pedicel,peduncle,pore,purple,rachi,radiu,rarely,rounded,rugose-verrucate,ruit,sagittate,shorter,sinus,small,spaced,stigma,stone,stripe,strongly,tal,tamen,tapered,tem,terminal,thecae,thick,tightly,time,tip,tomento,triangular,truncat,tube,unit,unlobed,vary,wide,ympodial,youn	abaxial,arrangement,branching,color,form,growth,hair,height,history,inflorescence,length,life,midpoint,mucilaginous,na,number,ovary,perennial,plant,prickle,property,reproduction,secondary,seed,shape,staman,stem,surface,texture,venation
45	wfo-0001025850	success	197	112	85	112	27	0.431	-7,.5,0.5,0.5-1,1,1-1.5,1.5,2-6.5,30,4-5,6-7,abaxial,acute,anther,apex,base,berry,branched,brown,calyx,cm,corolla,diameter,divaricate,ellipsoid,elliptic,entire,filament,flattened,fleshy,flower,glabrous,glandular,globose,green,growth,inflorescence,later,lateral,lax,lobed,many,margin,membranous,minutely,mm,narrowly,nearly,occasionally,often,openly,orange,pair,pale,perfect,petiole,pinnatifid,pubescent,reddish,reniform,rhomboid,ripe,rounded,scattered,shallowly,shrub,simple,slightly,stellate,stem,style,surface,tan,terminal,time,trichome,truncate,uniseriate,vein,vine,white,woody,x,yellow,young	-5,.8,0.5-,0.5-3,0.6-1,1-3,1-celled,1.5-5,15-20,2,2-12,3-4,5-7,5-merou,ag,along,alyx,anthesi,apar,apparently,ark,articulated,axi,basal,broadly,capitate,cell,connivent,cupped,cyathiform,deciduous,deflexed,deltate,densely,denser,divided,drying,eaf,eed,elongate,em,erect,exserted,extending,free,fruiting,geminat,glabrou,gland,half,halfway,ilament,irregularly,lamina,leaving,lengthening,less,lobe,long,loosely,lower,midrib,minute,new,nflorescence,nodding,node,older,orolla,outline,papillate-puberulent,papillo,pedicel,peduncle,peg,per,pitted,planar,plurifoliate,pore,poricidal,portion,primary,puberulen,ruit,scar,shiny,sinuate,sinus,sleeve,slender,slit,small,sometimes,soon,spaced,splitting,spreadin,spreading,stigma,strongly,surfac,testal,thin,tiny,tip,tube,twinin,ud,unit,vary,ympodial	5-merous,adaxial,arrangement,branching,color,form,fruit,hair,height,leaf,length,midpoint,mucilaginous,na,number,ovary,plant,prickle,property,puberulent,reproduction,secondary,seed,shape,staman,texture,venation
46	wfo-0001025856	success	185	82	58	127	24	0.314	0,1-3,15–20,1–5,2,2.5–4,20–35,2–4,3-10,5–10,5–7,6–12,acuminate,always,anther,apex,base,blade,branched,brown,calyx,campanulate,cm,compound,corolla,cuneate,diameter,elliptic,entire,filament,flattened-reniform,flower,glabrescent,glabrous,globose,green,internode,lateral,leaflet,light,margin,mm,oblique,oblong,orange,perennial,petiole,pinnately,prickle,recurved,spreading,streak,strongly,style,terminal,uniformly,white,yellow	.4,/4,0.3-1,0.3–0.5,0.5,1.5–2,10–,10–15,1–,1–1.5,1–2,20,20–30,2–,3,3–4,3–5,4–,4–10,4–6,5–,5–15,abaxially,acute,adaxially,ag,alyx,anthesi,apiculate,armed,articulated,axe,becoming,berry,bud,c.,calcium,chartaceous,commonly,connivent,corresponding,crystal,densely,difoliate,dr.,eaf,eed,ellipsoid,equal,exserted,fifth,four,foveolate,fruiting,geminat,glabrou,herbaceous,larger,lengthening,lobe,lobed,long,long-styled,longer,lower,major,narrowly,nearly,nflorescence,often,one,opposite,orolla,outline,oxalate,pair,papillat,pedicel,peduncle,pericarp,petiolulate,petiolule,plurifoliate,pointed,pore,poricidal,present,rachi,rarely,recurve,rounded,rugose,ruit,side,slender,slightly,slit,somewhat,soon,stellate,stigma,stout,straight,subopposite,subwood,subwoody,surface,tamen,tem,throughout,time,tip,triangular,truncat,tub,tube,unequal,unit,usually,vary,vein,vin,way,wide,widest,ympodial,×	10–30,arrangement,branching,color,form,fruit,growth,history,inflorescence,leaf,length,life,mucilaginous,na,number,ovary,property,seed,shape,staman,stem,texture,vine,width
47	wfo-0001025872	success	160	97	65	95	32	0.406	0.25-0.5,0.6-1,1-2,1.2-1.6,10-25-flowered,2-5,2/3,4-4.5,6-8,acute,along,anther,apex,base,becoming,beneath,brownish,calyx,cm,corolla,crinkled,dark,decurrent,densely,dry,elliptic,filament,flattened-reniform,flower,glabrous,globose,green,greenish-tan,later,lateral,leaf,live,lobed,margin,midrib,mm,narrowly,occasionally,older,onto,opposite,ovary,papillose,petiole,plant,pubescent,red-papillose,revolute,rounded,several,shrub,stem,style,surface,terminal,time,vein,way,white,young	.1,.5,0.5,0.5-1,1,1-1.3,1-1.5,1.2-1.5,1.7-3,2-2.5,3.5-4,4.5-13,6-10,anthesi,apart,apically,auriculate,ba,bark,beginning,berry,blade,branched,bright,broadly,capitate,coriaceous,crowded,cup-shaped,deeply,deflexed,dense,dia,eaf,edicel,eed,exserted,flattened,fleshy,free,fruiting,glandular-resinous,grayish-brow,incrassate,inflorescenc,irregularly,junction,lobe,lon,long,lower,main,material,minutely,nflorescence,often,pair,paler,papillae,papillo,pedicel,pitted,planar,plurifoliat,pore,poricidal,portion,prominent,rounded-triangular,ruit,scar,shaped,simple,somewhat,soon,spaced,specimen,stigma,straight,tall,tapering,tear-drop,thick,thickened,tip,trichome,tub,tube,ud,uniseriate,unit,visible,woody,x,ympodial	0.1,1.5,abaxial,adaxial,arrangement,branching,color,diameter,form,fruit,growth,hair,height,history,inflorescence,length,life,midpoint,mucilaginous,na,number,perennial,plurifoliate,prickle,property,reproduction,secondary,seed,shape,staman,texture,venation
48	wfo-0001025875	success	205	101	78	127	23	0.38	0-0.5,0.3-2,0.8-1.8,1.2-1.8,1.5-2.5,2.3-3,2.4-2.8,3-6,4.5-6.5,5-9,8-11,acicular,acute,andromonoecious,anther,apex,basal,base,calyx,chartaceous,cm,cuneate,dark,deeply,densely,diameter,entire,erect,filament,flower,fruit,gland-tipped,globose,green,grey,hair,hastate,inflorescence,lanceolate,lateral,leaf,length,lobe,lobed,long,margin,midpoint,mm,oblate,obtuse,pale,perennial,petiole,plant,prickle,pseudo-racemose,purple,ray,rhizomatous,rotate,sessile,shallowly,short,shrub,simple,sparsely,stellate,stellate-pubescent,straight,streak,style,surface,time,unbranched,weakly,white,yellow,yellowish	%,.05,0-0.1,0-1.5,0-5,0.1-0.2,0.1-1.1,0.2-0.45,0.25-0.4,0.3-0.4,0.4-0.5,0.4-0.7,0.5-1,0.5-1.3,0.5-6,0.7-0.8,0.8-0.9,0.9-1.4,1-10,1-2,1-3,1-7,1.1-1.6,1.5-6,15-25,2-locular,2.5-4.5,3-5,4-10,5-10,5-11,5-14,5-15,5-merou,6-13,7-10,7-14,7-8,8-14,9-13,?,abaxially,absen,absent,accrescent,across,adaxiall,adaxially,adult,alyx,anvil-shape,apart,articulated,attenuate,axe,ba,blade,branchlet,cross-section,cylindrical,decimetre,deltate,directed,distally,dm,eaf,eed,eglandular,exocarp,extra-axillary,finger,fruiting,functional,geminat,glabrous,half,heterostylous,juicy,juvenile,lamina,less,linear,longer,lower,mature,mesocarp,mid-point,midvein,minute,moist,narrowly,nflorescence,oblique,orolla,pair,part,pedicel,peduncle,per,placenta,plurifoliate,pore,porrect,possibly,present,ruit,spaced,stalk,stalked,stellae,stigma,tal,tamen,tem,thick,throughout,transparent,truncate,tube,unarme,unarmed,unit,upper,vary,wide,x,ympodial	abaxial,adaxial,arrangement,branching,color,corolla,form,growth,height,history,life,na,number,ovary,reproduction,secondary,seed,shape,staman,stem,texture,vein,venation
49	wfo-0001025888	success	256	136	101	155	35	0.395	.3,.5,.6,0.04,0.4,1.5,3,3.2,3.8,5,9.5,abaxially,across,acute,adaxially,along,anther,apex,apiculate,attachment,base,branching,brochidodromous,calyx,channeled,chartaceous,cm,corolla,cuneate,deltoid,densely,diameter,distinct,dry,entire,extra-axillary,filament,filiform,flattened-orbicular,flexed,flower,fruit,glabrous,glandular,globose,hair,homostylous,hooked,lamina,lateral,leaf,lobe,long,margin,midpoint,midrib,midvein,mm,moderately,notched,oblique,oblong,orange-red,petiole,point,porrect,pubescence,pubescent,raised,ray,red,restricted,rounded,scattered,sessile,shrub,simple,sinuate,small,stellae,stellate,stigma,stipe,style,time,tip,tree,tube,unbranched,vein,weakly,white,wide,yellow,yellow-ferruginous,yellow-tan,±90°,±aequilateral,±erect,±glabrous,±straight	.05,.4,0.1,0.2,0.3–0.5,0.4–0.6,0.4–0.7,0.5–0.7,0.6–1.2,0.7–0.8,0.7–1.5,0.8,0.8–1.0,0.9–1.1,0.9–1.2,0.9–1.3,1.0–1.8,1.2–2.3,1.4–1.8,1.5–1.9,1.5–2.0,1.5–2.1,1.5–4.0,1.7–2.1,1.8–2.3,1.8–3.5,1.9–2.2,1.9–3.4,1/2–2/3,1/3,2.1,2.2,2.5–2.6,2.6,2.7–3.0,3.0–11.1,3.1–4.2,3/4,4.2–5.5,4–8,4–9,5-merou,5.5–11.1,5–7,6–10,7.1–9.1,8.1–17.1,90°,adnate,alveolate,alyx,anthesi,apart,apparently,appearing,appresse,arching,area,articulate,axe,ba,berry,blade,branch,broad,bud,capitat,central,clinate,congested,dehiscen,denser,dentate,development,difoliate,distal,eaf,eed,either,emerging,endocarp,exocarp,fertile,free,geminat,glabrescent,gradually,increasing,internode,interpetalar,intersepalar,juic,less,little,lon,longer,longitudinally,lower,major,many,mature,middle,minor,minute,nearly,nflorescence,opaque,orolla,ovate,pedicel,peduncle,per,poorly-developed,portion,potentially,pubescen,reflexed,rigid,row,ruit,shinny,short-stipitate,shorter,side,sinus,smoot,sometimes,spaced,sparsely,splitting,spread,spreading,stellate-pubescent,straight,surface,swelling,tamen,tardily,tem,thin,though,tissue,truncate,two,typically,ud,unarmed,vary,well,ympodia,young,±equal,±overlapping,±smooth,×	0.4-0.6,0.4-0.7,0.7-1.5,0.8-1.0,1.0-1.8,1.4-1.8,1.5-1.9,1.5-2.0,1.5-4.0,1.9-2.2,2.5-2.6,5-merous,5.5-11.1,6-10,8.1-17.1,color,dense,form,growth,height,history,inflorescence,length,life,ovary,perennial,plant,reproduction,seed,shape,size,staman,stem,texture,width
50	wfo-0001025892	success	170	105	78	92	27	0.459	.3,0-0.1,0-0.3,0-1,0.2-0.4,0.2-0.5,0.3-0.5,0.3-0.7,0.3-0.8,1-2,2-7,2.5-4,2.5-6,2.8-3,4.5-7.5,6-10,8-10,8-11.5,abaxially,adaxially,anther,apex,base,calyx,chartaceous,cm,cuneate,curved,cylindrical,deltate,densely,diameter,entire,flower,fruit,glabrous,glandular,globose,grey,herbaceous,inflorescence,lanceolate,lateral,length,linear,lobe,long,margin,midpoint,mm,narrowly,oblate,oblique,obtuse,pale,part,perfect,petiole,pseudo-racemose,purple,ray,resprouter,solitary,stellae,stellate,stellate-pubescent,stem,stigma,style,time,triangular,tube,unbranched,white,wide,x,yellow,yellowish-green	%,0-10,0.05-0.1,0.1-0.2,0.2-0.8,0.4-0.6,0.4-0.8,0.7-0.9,0.8-1.1,1.5-5,10-17,2-locular,4-merou,5-17,5-7,7-15,8-11,8-13,9-18,absen,absent,adaxiall,alyx,apart,articulated,axe,ba,blade,broad-based,connivent,cross-section,d.,dense,directed,distall,distributed,dult,eaf,eed,eglandular,erect,exocarp,extra-axillary,finger,fruiting,geminat,gland-tipped,grey-green,hair,half,juicy,lamina,leaf-opposed,less,longer,lower,mature,mesocarp,mid-point,minute,moist,nflorescence,orolla,papillae,pedicel,peduncle,per,placenta,pore,porrect,present,prickle,ruit,sessil,sessile,short,simple,spaced,stage,stalk,sticky-glandular,straight,tal,tamen,thick,throughout,truncat,unarmed,unit,uvenile,vary,ympodial	branching,color,corolla,filament,form,growth,height,history,leaf,life,midrib,midvein,na,ovary,perennial,plant,pubescence,reproduction,seed,shape,size,staman,stipe,texture,tip,vein,width
51	wfo-0001025893	success	157	50	35	122	15	0.223	0.5-1.5,1-1.2,1-4,1.5-2,11-20,2-3,along,apex,attenuate,base,beneath,branched,brownish-green,cm,dia,ellipsoid,elliptic,fruit,glabrous,globose,golden-puberulent,green,leaf,long-acuminate,minutely,mm,narrowly,obovate,occasionally,ovoid-reniform,pale,petiole,shrub,vein,x	.25,.4,.5,0.8-1,1-1.5,1-2.5,1.5-1.7,2-2.5,3-5,5-6,6-10,accrescent,anther,anthesi,bank,barely,bark,bearing,beginning,berry,bi-lobed,blade,broadly,calyx,capitate,closely,corolla,cup-shaped,decurrent,deflexed,deltoid,densely,difoliate,dry,eaf,early,eed,erect,even,exserted,faintly,filament,flower,free,fruiting,geminate,glabrate,gravelly,greyish,growing,impressed,inflorescenc,internodal,lateral,lobe,lobed,lon,long,longitudinally,lower,main,many,margin,material,middle,nearly,nflorescence,older,opposite,ovary,overlapping,pair,papillo,papillose,pedicel,pitted,planar,plurifoliat,pore,poricidal,portion,puberulent,red-papillose,reflexed,river,rocky,ruit,sandy,scar,shaped,slender,slightly,sometimes,spaced,specimen,stem,stigma,straight,stream,striat,style,surface,tall,tapering,tear-drop,thickened,time,tip,trichome,tube,ud,unicellular,unit,usually,visible,white,widest,winged,woody,yellowish,ympodial,young	branching,color,form,growth,height,history,inflorescence,length,life,perennial,plant,seed,shape,size,texture
52	wfo-0001025896	success	146	103	71	75	32	0.486	-3,-30,.5-2.5,0.5,0.5-2,1-1.5,1-3,1-8,1.5-2,2-14,2-2.5,2.5-14,2.5-5,4,4-23,4-5,4-6,5-7,6-10,acuminate,acute,angled,apex,base,brownish,calyx,chartaceous,cm,cuneate,densely,diameter,elliptic-ovate,entire,flower,forked,fruit,glabrous,globose,greenish,lobe,long,margin,mm,moderately,nearly,orange,ovate,pale,perfect,petiole,puberulent,pubescent,purple,red,rotate-stellate,shrub,sparsely,stem,stigma,style,subcordate,time,tip,triangular-ovate,tube,unbranched,vein,white,wide,x,yellow	1-25,1-6.5,1.5-9,10-15,10-25,4-12,5-15,6-13,7-,7743,abaxial,abaxially,absen,acosta,adaxiall,adaxially,aggregate,also,apart,articulated,axe,ba,blade,branched,cell,connivent,constricted,cylindrical,deltate,dendritically,directed,distall,eaf,eed,eglandular,especially,gland,hair,inflated,like,lower,many-foliat,membranaceous,near,nflorescence,nther,obtuse,occasionally,often,orolla,pedicel,peduncle,pore,present,pubescen,rachi,radiu,ripe,rugose,ruit,short-stalked,simple,smooth,solí,spaced,stalked,stone,surface,tal,tem,triangular-subulate,truncat,unit,vary,ympodial	anther,branching,color,corolla,filament,form,growth,height,history,inflorescence,lateral,leaf,length,life,midpoint,midrib,midvein,na,ovary,perennial,plant,pubescence,ray,reproduction,seed,shape,size,staman,stellae,stipe,texture,width
53	wfo-0001025902	success	211	125	101	110	24	0.479	.2,0.1-0.5,0.5-2,1-1.2,1-1.5,1.5,1.5-2,1.5-3,1/3,11-15,1983,2-6,2.5-4,4-13,4-5,4-6,5-6,8-15,abaxially,acute,adaxially,anther,anthesi,apex,attenuate,base,becoming,black,branched,branching,cabrera,calyx,chartaceous,cm,completely,conical,corolla,densely,diameter,dull,ellipsoid,entire,fide,filament,flattened-reniform,fleshy,flower,glabrous,globose,green,growth,inflorescence,lanceolate,lateral,leaf,leaf-opposed,length,linear,lobe,long,lower,margin,mature,minute,mm,occasionally,ovary,pair,pale,petiole,planar,pubescent,rotate-stellate,rounded,scattered,simple,sometimes,somewhat,sparsely,spreading,stem,stigma,style,surface,tapering,terminal,time,tip,trichome,tube,uniseriate,usually,vein,vine,violet,whitish,woody,x,yellow,yellowish,½	.5,/2,0.5-2.5,1.2-1.5,3-10,4,40,5-merou,8-10,8-9,>,absent,accompanied,ag,aid,along,always,alyx,apar,ark,articulated,axi,bark,beginning,berr,berry,branch,broadly,c.,cell,circular,clavate,climbin,connivent,deciduou,deltate,eaf,eed,either,except,exfoliatin,exserted,free,fruiting,geminat,ilament,leaving,lengthening,less,lobed,loosely,low,markedly,midvei,minutely,new,nflorescence,obscured,often,older,one,orolla,papillat,papillose,pedicel,peduncle,peg,pendant,per,perfect,pericarp,pitted,plurifoliate,pore,poricidal,portion,primary,prominent,revolute,ridged,ruit,scar,scrambling,semi-aquati,semi-circular,shallow,sleeve,slender,slit,small,soon,spaced,strongly,tangled,tem,testal,thin,twining,ud,ultimate,unit,vary,vegetation,water,way,weak,weight,widely,wing,ympodial	color,form,fruit,height,history,life,midpoint,midrib,midvein,na,papillate,perennial,plant,pubescence,ray,reproduction,seed,shape,size,staman,stellae,stipe,texture,width
54	wfo-0001025906	success	188	99	77	111	22	0.41	0.1-2,0.15-0.6,0.20-0.60,1-2,1-3,1.1-2,1.6-12.4,16-51,2-4.4,2-6,2.6-5.2,3-10,4-10,4-12,4-5,4-7,5-6,5-7,5.2-9,8-16,8.5-12.5,acumen,anther,blue,clavate,cm,coriaceous,corolla,dark,diameter,filament,flower,forked,fruit,glabrous,globose,green,greenish,hair,herb,lanceolate,lateral,leaf,leaflet,light,lilac,linear,lobe,long,mm,odd-pinnate,ovoid,pair,pedicel,peduncle,pentagonal,petiole,plant,pubescent,purple,rotate,seed,shiny,short,size,sparsely,stigma,stripe,style,sub-glabrous,subglabrous,terminal,tube,white,whitish,x,yellow	0-14,0.2-0.6,1-6,1.8-4.8,3-5,5-merou,abaxially,acute,adaxiall,adaxially,ag,alyx,apart,apex,apparently,articulated,axe,axillary,base,berry,blade,brownish,bud,capitat,cell,condition,connivent,covering,cuneate,decreasing,decurrency,decurrent,delimited,digestion,diminishing,distal,dorsally,drying,eaf,edge,eed,enzyme,erec,exceeding,falcate,first,flat,folded,fresh,geminat,generally,glabrou,green-white,hair-like,hal,half,high,homostylous,honeycomb-shaped,interjected,lengthening,living,lower,make,mucilaginous,next,nflorescence,obtuse,orolla,perfect,plurifoliate,pore,poricidal,rachi,removed,ripe,ruit,second,sessile,seudostipule,slightly,slit,smaller,spaced,specimen,stamen,straight,subequal,subglabrou,subtending,tall,tamen,tem,testal,thick,third,throughout,tip,toward,tri-,typically,unit,unwinged,usually,vary,wall,well,wet,width,wood,ympodial	abaxial,adaxial,branching,calyx,capitate,color,colour,form,growth,height,history,inflorescence,length,life,ovary,perennial,pseudostipule,pubescence,shape,staman,stem,texture
55	wfo-0001025907	success	148	66	52	96	14	0.351	.5,.5-1,1-1.2,1-2.3,1-3,1-5,1.5-2.2,12-45,2,2-3.5,3-,5-15,acuminate,acute,apex,attenuate,base,brown,cm,conical,densely,diameter,elliptic,flattened,fruit,glabrous,green,greenish,growth,iquito,isolated,long,minutely,mm,near,new,obovate,ovoid-reniform,petiole,plant,population,pubescent,red-papillate,round,seed,shrub,simple,size,trichome,truncate,uniseriate,x	-4,.05,0,0-60,0.8-1.8,1,1.5-2,10-15,2-8,2/3,3-4,3/2,4-5,absent,along,anther,anthesi,anthesis5-7,anticlinal,appearing,axil,axillary,beak,bearing,berry,breaking,c,calyx,cell,clavat,conspicuously,deciduous,eaf,edicel,eed,epidermal,erec,filament,flower,free,fruiting,globose,highly,included,irregular,lamina,lobe,lobed,lon,lower,margin,nearly,nflorescence,occasionally,open,ovary,pair,papillate,papillose,pedicel,per,poricidal,portion,primary,projection,raised,reflexed,remaining,rugose,ruit,scar,scattered,single-stemmed,sinuous,slender,soon,sparsely,stigma,style,surface,tal,tem,thickening,time,tip,tub,tube,ud,unifoliat,unit,variable,vein,white,white-lenticellate,without,ympodial	branching,color,form,height,history,inflorescence,leaf,length,life,perennial,pubescence,shape,stem,texture
56	wfo-0001026203	success	197	94	71	126	23	0.36	0.06-0.86,0.3-11,0.4-3,0.5-2.3,0.7-2.6,1-2,1-9,2-10,2-4.9,2-43,2-5,2.2-13.3,3-10,3-11,3.2-22,3.2-23,abaxially,adaxially,anther,blue,brownish,cm,condition,coriaceous,corolla,dark,deep,diameter,drying,filament,flower,forked,fresh,fruit,glabrescent,glabrous,globose,green,greenish,hair,herb,lanceolate,leaf,light,lilac,lobe,long,medium,mm,odd-pinnate,ovate,ovoid,pentagonal,perfect,petiole,plant,rotate,seed,short,size,sometimes,stigma,stripe,style,tip,tube,white,whitish,wide,x,yellow	0-39,0-7,0.3-6,0.38-11.3,0.5-3.2,1-13,1-4,1-5,1.1-7.9,1.2-5.5,2-8.5,3-5,5-merou,7-47,acumen,acuminate,acute,ag,along,alyx,apart,apex,apparently,arranged,articulated,asymmetric,attenuate,axe,axillary,base,basiscopic,bead,berry,blade,bud,capitat,cell,clavate,connivent,covering,decreasing,decurrent,digestion,distal,dorsally,eaf,edge,eed,elliptic,enzyme,erect,exceeding,flat,folded,geminat,generally,glabrescen,glabrou,green-white,hair-like,hal,half,high,homostylous,honeycomb-shaped,interjected,lateral,leaflet,lengthening,like,linear,living,lower,make,middle,moniliform,mucilaginous,multiple,necklace,nflorescence,orbicular,orolla,pair,pedicel,peduncle,plurifoliate,pore,poricidal,rachi,removed,ripe,rosett,rounded,ruit,sessile,seudostipule,side,slightly,slit,spaced,specimen,stamen,stolon,straight,subequal,subglabrous,subtending,tall,tamen,tem,terminal,testal,thick,throughout,tissue,toward,tri-,tuber,typically,unit,unwinged,usually,vary,wall,wet,ympodial	abaxial,adaxial,branching,calyx,color,colour,form,growth,height,history,inflorescence,length,life,midrib,na,ovary,perennial,pubescence,reproduction,shape,staman,stem,texture
57	wfo-0001026205	success	165	101	72	93	29	0.436	0.3-2,1,1-1.5,1-3,1-6,1.5,2-14,4,5-7.5,5.5-6,7-9,abaxially,acuminate,acute,adaxially,anther,apex,base,calyx,chartaceous,cm,cream,cuneate,deeply,densely,diameter,elliptic,entire,filament,flattened,flower,fruit,glabrous,glandular,globose,growth,hair,lateral,leaf,linear-lanceolate,lobe,margin,midpoint,minute,minutely,mm,oblique,often,petiole,porrect-stellate,pubescent,purple,ray,seed,sessile,shortly,shrub,size,sparsely,stellate,stellate-pubescent,stem,stigma,strongly,style,tip,trichome,tube,violet,white,x,yellow	-14,-2.5,-6,.5,.5-2,0.5-,0.75-1,1-2,15-20,2-3,3,3/4,30-35,5-merous,8,absent,accrescen,alyx,apical,apparently,armed,around,articulated,attenuate,axe,ba,blade,difoliate,distinct,divided,eaf,eed,enlarged,erect,exceeding,extra-axillary,extror,four,fruiting,geminat,globo,homostylous,including,long,lower,major,maturing,minor,new,nflorescence,node,orolla,pedicel,peduncle,perfec,pore,porrect,prickle,proximally,rachi,rare,rarely,ruit,scarcely,short,similar,simple,slender,slightly,small,smaller,solitary,sparse,stellat,stellate-pubescen,straight,summit,surface,tall,tamen,tem,thickened,third,toward,unarme,unarmed,unit,usually,vary,wide,wing,ympodial,zigza	0.5-2.5,1.5-2,2,5,branching,color,corolla,form,height,history,inflorescence,length,life,midrib,midvein,na,ovary,perennial,plant,pubescence,red,reproduction,shape,staman,stellae,stipe,texture,vein,width
58	wfo-0001026208	success	214	123	96	118	27	0.449	/3,0.1-0.3,0.6-0.8,0.6-0.9,0.7-2,0.8-1.5,1-2,1-5,1.5-2.5,1.8-2.3,1.8-2.5,11-25,2.5-6,3-5,3.5-5,4-7,5,5-17,5-22,6-8,abaxially,acuminate,acute,anther,apex,apically,apparently,base,berry,branched,bright,brown,calyx,chartaceous,cm,cuneate,dark,deltate,densely,diameter,dull,erect,evenly,filament,flattened-reniform,flower,fruit,glabrous,green,lateral,leaf,length,lobe,lobed,long,longer,lower,margin,maturity,mauve,membranous,midvein,mm,moderately,orange,orange-brown,pair,pale,petiole,ray,red,rounded,shrub,side,sometimes,sparsely,spherical,spreading,stellate,stellate-pubescent,stem,straw-yellow,style,subentire,terminal,time,tip,toward,trichome,tube,vein,way,white,wide,yellow,young	-1/2,-10,-3,-5,.5,0,0-20,0-4,0-5,0-8,0.1,0.1-0.2,0.1-0.25,0.5-0.8,0.5-1.2,0.8-1.3,1-4,1.5,1/3,1/4-1/3,1/4-1/6,2,2-20,2-3,2-4,2.5-5,3-30,3-6,3/,4-9,5-,5-merous,6-22,abaxial,acut,adaxial,alyx,apar,apart,articulated,bark,becoming,blade,broad-deltate,conical,connivent,curved,difoliate,discolorous,distance,drying,eaf,eed,elliptic,elongated,elongating,equal,extending,flattened,free,fruiting,geminat,geminate,glabrescent,gray-greenish,green-brown,infructescence,mature,midpoint,nflorescence,older,one,open,orolla,oung,ovate,pedicel,peduncle,pendulous,per,perfec,pericarp,poricidal,porrect,portion,prickle,prickly,primary,pubescent,recurved,red-brow,ruit,scar,sessile,shorter,slender,smooth,somewhat,spaced,stalk,stalked,stout,straight,surface,tamen,tapering,terete,tertiary,unarme,unarmed,unit,usually,variously,vary,venation,visible,woody,ympodial	3/4,branching,color,corolla,form,growth,height,history,inflorescence,life,midrib,na,ovary,perennial,perfect,plant,pubescence,reproduction,seed,shape,size,staman,stellae,stigma,stipe,texture,width
59	wfo-0001026215	success	150	106	79	71	27	0.527	-3,.05,.5,0.05,0.5-1,1,1-3,1.5,1.5-2,1.5-2.2,13-35,2,2-3,2-3.5,3/4,4-15,4-5,abruptly,acuminate,along,anther,apex,axil,base,broadly,brown,calyx,cm,completely,conical,corolla,deltate,densely,diameter,elliptic,entire,filament,flattened-round,flower,fruit,glabrous,green,greenish,herb,length,less,lobe,lobed,long,mm,narrowing,nearly,occasionally,ovary,ovoid-reniform,papillae,papillate,per,petiole,purple,red-papillose,rounded,seed,shrub,simple,stem,stigma,strongly,style,surface,time,tip,tube,vein,way,white,white-pubescent,winged,x	0,15-2,18-20,2-4,7-8,abaxially,absent,anthesi,anticlinal,ape,axillary,beak,berry,bifi,cell,clavate,conspicuously,continually,eaf,edicel,eed,enlarged,epidermal,erect,exserted,free,fruiting,globose,highly,horizontal,internode,irregular,kink,lower,marked,markedly,minutely,nflorescence,noddin,nodding,often,onto,pair,papillat,pedicel,poricidal,portion,primary,projection,raised,reflexed,rugose,ruit,scar,shortsympodial,single-stemmed,sinuous,small,ste,tal,tem,thickening,tub,ud,unifoliat,unit,usually,white-lenticellate,wide,wing,without	branching,color,form,growth,height,history,inflorescence,lateral,leaf,life,margin,midpoint,midrib,midvein,na,plant,pubescence,ray,reproduction,shape,size,staman,stellae,stipe,tall,texture,width
60	wfo-0001026220	success	158	99	59	99	40	0.373	/3,0.2,0.3-1.5,1.3-1.7,1.5-2.5,10-20,2.5-3.5,4-10,4-12,8-12,across,annual,anther,back,band,base,becoming,blade,brown,calyx,cm,dark,dia,glabrous,glandular,glaucescent,hair,herb,lacking,leaf,lobe,long,mm,often,one,ovate,pentagonal,petal,petiole,pigment,plant,purple,ray,red,reddish,short,simple,spherical,stellae,stellate,stellate-pubescent,stem,suffused,surface,terminally,tube,upon,vein,yellow	.3-2.8,.5,1,1.0-1.8,5-10,50-90,6-10,7-11-flowere,accrescent,acute,along,alyx,anthesi,ape,armed,bearded,berry,campanulate,closely,coarsely,conspicuous,developing,difoliate,divided,dry,dryin,eaf,eed,essentially,flattened-ovo,foliaceous,foveolate,geminat,heteromorphic,internodal,interpetalar,invested,lanceolate,large,later,latter,lon,main,many,maturity,minutely,mostly,much,near,nearly,nflorescence,obtuse,orolla,pentagonal-stellae,per,persistent,persisting,pinnatifid,pinnatisect,plicate,portion,prickle,prickly,proximal,reduced,reticulately,ridged,ruit,scattered,second,shorter,side,similar,slende,somewhat,spaced,splitting,straight,surrounding,tall,tamen,thrice,tightly,tigma,tissue,tub,twice,tyle,ultimate,unexpande,unit,vary,ventral,well-developed,widely,year,yello,ympodial,young	2.3-2.8,7-11-flowered,apex,branching,color,corolla,diameter,drying,filament,flattened-ovoid,flower,form,fruit,growth,height,history,inflorescence,lateral,length,life,margin,midpoint,midrib,midvein,na,ovary,pentagonal-stellate,pubescence,reproduction,seed,shape,size,slender,staman,stigma,stipe,style,texture,tip,width
61	wfo-0001026227	success	150	85	58	92	27	0.387	.3,0-0.1,0.3-0.5,0.3-2.2,0.4-1.4,1-4,1.5-4,1.6-2,2-2.5,2.5-3,3-7.5,apex,base,calyx,chartaceous,cm,cuneate,deltate,densely,diameter,elliptical,entire,flower,fruit,globose,green,grey,herbaceous,inflorescence,length,lobe,lobed,long,margin,mm,moderately,obtuse,ovate,pale,petiole,pseudo-racemose,resprouter,shallowly,solitary,sparsely,stalk,stellae,stellate,stellate-pubescent,stigma,style,throughout,time,tube,unbranched,wide,x,yellow	%,.8,0,0-1,0-1.5,0-3,0.1-0.7,0.25-0.4,0.3-0.4,0.3-0.6,0.3-0.9,0.5-1,0.9-1.2,1,1-1.3,10-15,15-20,17-55,2-10,2-3,3-6,5-30,5-merous,6-8,7-8,abaxially,absen,absent,acicular,across,adaxially,apart,armed,articulated,axe,ba,blade,chartaceou,d.,distributed,eaf,eed,eglandular,finger,fruiting,gland-tipped,gree,hair,half,index,lamina,lateral,leaf-opposed,lobing,lon,longer,lower,mature,mid-point,midpoint,midvein,nflorescence,oblique,orolla,part,pedicel,peduncle,per,porrect,present,prickle,ray,ruit,sessile,short,side,simple,spaced,sprawling,stage,straight,tal,tamen,tem,thick,transparent,unit,unknow,uvenile,vary,yellowish,ympodial	abaxial,adaxial,anther,branching,color,corolla,filament,form,growth,height,history,leaf,life,midrib,na,ovary,perennial,plant,pubescence,reproduction,seed,shape,size,staman,stem,texture,width
62	wfo-0001026229	success	299	117	81	218	36	0.271	0.35,1,13,5,acuminate,acute,anther,apex,asymmetric,attenuate-caudate,base,berry,black,branching,brown,calyx,cm,corolla,cuneate,cylindrical,cyme,deltoid,densely,diameter,elliptic,elongated,entire,flattened,flower,fruit,glabrous,globose,golden,green,growth,hirsute,hispid,immature,inflorescence,lateral,leaf,lobe,lobed,long,margin,mature,membranaceous,midpoint,midvein,mm,moderately,narrowly,ovate,ovate-elliptic,pair,pale,perfect,petiole,pubescent,purple,ray,reniform,revolute,rounded,shrub,size,slightly,sparsely,spreading,stellate,stem,stigma,style,tube,unbranched,upper,vein,white,wide,yellow,yellowish-white	0.1–1.47,0.2–0.8,0.3–0.9,0.3–1.2,0.4,0.8–1.2,0.8–2,0.9,0.9–4.3,1-celled,1.2–4.8,1.3–1.5,1.3–1.7,1.4,1.7–11.8,1.7–2.3,1.8,1.8–5.5,1.9–2.5,1/3,1–1.4,1–2,1–4,2,2.3–3.4,2.8–4,2–3,2–3-celled,2–4-celled,3,35,3–4,3–5,4.5–6.5,4–6,5-merou,5–9,6–15,6–7,6–8,8.6–12,8–10,9–31,abaxial,abaxially,accrescent,adaxial,adaxiall,adaxially,ag,almost,also,always,alyx,anthesi,ark,articulated,associated,axe,ba,barely,beneath,blade,branch,broadly,broken,camptodromous,capitate,celled,central,changing,clavate,commentary,commonly,completely,concentrated,connivent,cordate,covered,creating,dark,develope,developed,differing,directed,discolorous,di­,dried,drying,eaf,eed,eglandular,ellipsoidal,even,faces,few-rayed,found,free,frequently,fresh,fully,geminate,glabrescent,gland,glandular,glandular-capitate,hair,head,hyaline,ilament,impressed,included,insertion,internodal,introrsely,involute,irregular,lamina,lanceolate,larger,less,like,long-stalked,longer,longitudinal,lower,mainly,material,maturit,midri,minute,mixed,much,multangulate,multangulate-stellate,multiseriate,narrow-ovate,near,nearly,new,nflorescence,oblong,often,old,older,one,open,opening,orientation,orolla,other,oung,paired,papillose,pedicel,peduncle,pedunculate,per,pink,pit,plurifoliate,point,poorly,pore,poricidal,porrect-stellate,portion,primary,purplish,ra,rachi,raised,rarely,remnant,ruit,secondary,see,sessile,shin,shiny,short-,short-stalked,shorter,simple,slit,small,smaller,solitary,sometimes,somewhat,spread,spreadin,stalk,strongly,subopposite,subsessile,supported,surfac,surface,terminal,three,tree,trichome,trifoliate,tuft,type,ud,unequal,unit,usually,vary,venation,vestiture,visible,weakly,whitish-green,ympodial,¾	0.9-4.3,1-1.4,1-2,1.2-4.8,1.3-1.7,1.7-11.8,1.7-2.3,1.8-5.5,2.3-3.4,2.8-4,5-9,6-15,6-7,6-8,color,filament,form,height,history,length,life,midrib,na,ovary,perennial,plant,pubescence,reproduction,seed,shape,staman,stellae,stipe,texture,tip,width
63	wfo-0001026230	success	144	83	61	83	22	0.424	.5,.8,0.3-1.5,0.5-3,0.9-2,1-1.5,1-4,1.1-1.8,1.9-4.1,12.6-20.8,2-4,2-5,3-4,4.6-9.3,anisomorphic,anther,bark,base,bud,calyx,clavate,cm,corolla,dia,elliptic,fruit,glabrous,globose,green,grey,large,leaf,lobe,lobed,long-acuminate,major,minor,minutely,mm,nearly,older,orbicular,ovary,papillose,petiole,rusty-papillose,shrub,simple,slightly,small,stem,stigma,strongly,style,surface,tip,tree,tube,white,x,young	.25,0.75-1,1-1.4,1.8-2.3,5-10,5-20-flowered,acuminate,acute,anisophyllou,anthesi,apart,apex,apiculate,appears,area,back,beginning,beneath,berry,broadly,clu,completely,cordate,coroll,deflexed,deltoid,difoliate,distal,eaf,edicel,eed,enclosing,erect,evenly,except,filament,free,fruiting,geminate,immature,inflorescenc,lateral,lon,long,long-triangular,lower,main,margin,middle,nflorescence,obtuse,opposite,ovoid,pair,pedicel,pointed,pore,poricidal,portion,raised,reflexed,rounded,ruit,scar,shaped,sinus,slender,spaced,straight,tall,tapering,tear-drop,thickened,ud,umbonate,unit,unknown,vein,white-lenticellat,widest,winged,woody,ympodial	anisophyllous,arrangement,branching,color,diameter,form,growth,height,history,inflorescence,length,life,na,perennial,plant,pubescence,reproduction,seed,shape,size,texture,white-lenticellate
64	wfo-0001026233	success	165	101	69	96	32	0.418	-1,-1.9,-3.8,-5.5,-50,.25,.75,0.3,0.5,0.7-0.8,0.8-1.55,0.8-4,1.2-2.7,1.5,1/2,2.1,2.3-7,2.4-3.5,2.6,2/3,3.5-4.5,5-30,6,abundant,acute,annual,anther,antrorse,apex,basal,base,calyx,campanulate,cm,cuneate-attenuate,densely,diameter,elliptic,entire,filament,glabrous,globose,herb,leaf,less,lilac,lobe,margin,mm,moderately,non-glandular,obtuse,ovate,pale,petiole,pinnatisect,pubescent,seed,simple,sparsely,stigma,style,tip,trans-ovoidal,trichome,tube,uniseriate,x,yellow	-8.1,0.7-,0.8-1.3,1,1-,1.1,2,2-,3.2-3.7,3.2-4.7,4-,5-6.2,accrescent,ag,annular,articulated,ascending,bearing,berry,broadly,capitate,coat,conspicuous,curved,cylindrical,difoliat,dimorphic,eaf,eed,ellipsoidal,embryo,evident,few-,fruiting,hair,herbaceous,hig,interlobular,investing,lamina,larger,lobed,long,longitudinal,longitudinally,lower,membrane,minutely,multicellular,narrowly,near,occasionally,opening,orolla,other,outer,ovule,papery-scarious,partially,pinnatipartite,pore,poricidal,portion,present,protuberance,pubescen,ree,reticulate,ridged,rounded,ruit,scarcely,seede,serrate,shorter,slender,slightly,slit,small,smaller,striate,strongly,styl,subglobose,surface,tem,tuberculate,unequal,unifoliate,unit,vary,venatio,verrucose,wider,winged,ympodial	0.7-1.3,branching,color,corolla,flower,form,fruit,growth,height,history,inflorescence,lateral,length,life,midpoint,midrib,midvein,na,ovary,plant,pubescence,ray,reproduction,shape,size,staman,stellae,stem,stipe,texture,vein,width
65	wfo-0001026241	success	220	104	79	141	25	0.359	0.5,1.5–1.7,1.5–2.5,1.5–3.5,1.9–2.1,109,1–,1–1.1,1–1.4,1–1.5,1–2,2.5–3,2–2.1,2–3,3–3.1,4.5–5,anther,apex,base,black,branching,brown,calyx,campanulate,cm,corolla,deltate,dia,dry,eglandular,entire,erose,et,filament,flower,fruit,galiano,glabrous,glandular-pubescent,globose,herb,inflorescence,irregularly,lateral,leaf,lobe,lobed,margin,midvein,mm,orangish,outline,ovary,ovoid,papillate,perennial,perfect,petiole,pinnatifid,pubescent,rachi,reniform,seed,simple,somewhat,stellate,stem,stigma,style,subshrub,ternate,tip,trichome,truncate,tube,uniseriate,vein,white,x	.2,.3,.5,0.1–0.15,0.2–,0.3–,0.3–0.4,0.3–0.6,0.3–1,0.5–0.7,0.5–0.8,0.5–1,0.7–1.1,1-,1-celled,1.2–1.5,1.2–2,1/3–1/2,10-20,2-flowered,3,3-,30–50,4-,5,5-celled,5-merous,6,abaxially,adaxially,always,anthesi,apical,appearing,appears,articulated,attenuate,ba,basal,basiscopically,beak,berry,brittle,broader,capitate,cell,center,conical,connecting,cordate,covered,cup,curved,curving,darker,decurrent,deflexe,dehiscing,densely,denser,depressed-globose,difoliate,discrete,drying,dwarf,eaf,elliptic,enclosed,equal,erect,extended,foliat,foliose,free,fruiting,geminate,gland,glandular,internodal,intially,larger,leaflet,like,lon,long,longitudinal,main,mixture,much,near,nflorescence,oblique,one,onto,open,ovate,papillat,pedicel,peduncle,per,pericarp,pitted,pore,portion,prolonged,pubescen,pulp,remain,robust,ruit,shallowly,shiny,sinuate,slightly,slit,small,smaller,sometimes,spatulate,stamen,stout,strongly,succulent,sulcate,surface,taproot,terminal,testa,thick,thickened,tissue,triangular,tuberculate,ud,unit,usually,way,wide,wing,woody,ympodial	2,30-50,color,decurrenct,diameter,form,growth,height,history,length,life,midpoint,midrib,na,plant,pubescence,ray,reproduction,shape,size,staman,stellae,stipe,texture,width
66	wfo-0001026242	success	210	123	96	114	27	0.457	-0.9,-6,/4,0.05-0.2,0.4-2,0.5-1,0.55-0.9,0.7-1.3,1-1.5,1-2.5,1-3,1.5-3,1.5-4,1/2,10-20,2-2.5,2.5-2.8,2.5-4.5,3-6.5,4-13,7-17,abaxially,acute,anther,apex,apically,apparently,base,berry,branched,bright,calyx,cm,concolorous,cuneate,densely,diameter,drying,dull,erect,evenly,filament,flattened-reniform,flower,fruit,glabrescent,glabrous,glandular,green,hair,lateral,leaf,length,lobe,lobed,long,longer,margin,maturity,membranous,midpoint,midvein,minute,mm,moderately,narrow-deltate,obtuse,orange-brown,pale,pale-brown,petiole,ray,red,reflexed,shrub,side,sometimes,sparsely,spherical,spreading,stellate-pubescent,stem,style,subentire,surface,time,tip,tube,upper,vein,way,weakly,white,wide,yellow,young	-1.5,-2,-5,0,0-2,0.1,0.3-0.5,0.35-,0.4-0.5,0.4-0.55,0.5,0.5-0.7,0.7,1.2-2,1/5-1/3,1/6-1/4,10-,2-5,30-80,4-10,4-5-merous,4.5-5.5,5-,5-18,5-7,6.5-8,8-20,abaxial,acut,almost,alyx,ame,apar,apart,articulated,bark,blade,broad-deltate,c.,connivent,curved,deltate,difoliate,distance,eaf,eed,elliptic,elongating,equal,extending,eye,filiform,flattened,free,fruiting,geminat,glabrou,green-gra,infructescence,irregularly,largely,lower,mature,multangulate,naked,nflorescence,occasionally,older,one,open,orolla,oung,pair,pedicel,peduncle,per,perfec,pericarp,poricidal,porrect,portion,prickl,prickle,prickly,primary,recurved,red-brown,rounded,ruit,scar,sessile,shorte,shorter,simple,smooth,spaced,stalk,stalked,stellate,straight,tamen,tapering,terete,tertiary,trichome,unarme,unarmed,unit,variously,vary,venation,visible,woody,ympodial	0.35-0.55,branching,color,corolla,form,growth,height,history,inflorescence,life,midrib,na,ovary,perennial,perfect,plant,pubescence,reproduction,seed,shape,size,staman,stellae,stigma,stipe,texture,width
67	wfo-0001026259	success	233	127	92	141	35	0.395	.1,.7,0404,1-celled,1.5,2/3,6,?,abaxially,acuminate,acute,affected,anther,apex,base,berry,branching,broadly,brown,calyx,central,cm,concave-reniform,corolla,decurrent,densely,diameter,ellipsoid,entire,especially,et,filament,fleshy,flower,fruit,glabrous,green,green-orange,halfway,herb,inflorescence,knapp,lateral,leaf,length,less,lilac,lobe,lobed,long,margin,membranous,mm,nearly,node,often,once-branched,ovary,ovate-lanceolate,pair,pathogen,petiole,plant,pubescent,purple,purple-black,purple-coloured,rarely,ripe,rounded,shrub,simple,slightly,somewhat,sparsely,star,stellate,stem,stigma,style,tinged,tip,translucent,trichome,tube,turning,uniseriate,vein,white,wide,yellow,yellow-green	.8,0.1–0.2,0.2–0.4,0.3–1.2,0.4–0.6,0.5,0.5–0.6,0.7–0.9,0–2,1,1.0–1.2,1.0–3.3,1.2–8.4,1.4–4.0,1.5–2.0,11–22,12–24,1m,1–2,1–2-celled,1–3-celled,2-ridged,2–17,2–3-celled,3.0–3.4,35–45,4–5,5-merous,5–14,5–7-celled,7–10,8–11,abaxial,adaxial,adaxially,age,anthesi,apar,appressed,arising,becoming,beyond,branch,branched,cell,close,coloured,cone,congested,conical-ellipsoid,cream-coloured,cylindrical,dehiscing,deltate,difoliate,drop,eaf,eed,elongating,end,exerted,free,fruiting,geminat,globose,gradually,growt,hilum,individual,internodal,larger,leave,lengthening,like,live,lon,longer,lower,lowermost,minutely,much,narrower,narrowly,near,nflorescence,occasionally,one,outline,pale,papillate,pedicel,peduncle,pentagonal,per,perfect,pericarp,pore,poricidal,portion,positioned,primary,rachi,recurving,reduced,reflexed,relatively,remaining,ruit,scar,shiny,short,shorter,similar,slit,smooth,sometimes,spaced,splitting,spreading,stone,stout,straight,strongly,sub-laterally,surface,tall,tapering,tem,testal,thick,tightly,together,toward,two,ud,unit,winged,woody,ympodial,young,–15	.8-3.4,0.3-1.2,0.4-0.6,0.7-0.9,1-3-celled,1.2-8.4,1.4-4.0,1.5-2.0,12-24,2-17,2-3-celled,5-14,7-10,8-11,color,form,growth,height,history,life,midpoint,midrib,midvein,na,perennial,pubescence,ray,reproduction,seed,shape,size,staman,stellae,stipe,texture
68	wfo-0001026262	success	179	104	81	98	23	0.453	0.2-0.6,0.25-0.5,0.5-1,0.5-1.5,0.8-1.4,1,1-2,1.5,1.5-2,2-2.5,2-5,3-6,4-15,4-6,5-8,7-13,7-9,abaxial,abaxially,absent,acute,adaxial,anther,apex,apparently,asymmetrical,base,brown,calyx,chartaceous,cm,dark,densely,diameter,filament,fruit,glabrous,globose,green,hair,immature,leaf,light,lobe,lobed,mature,midrib,midvein,mm,moderately,mottling,narrowly,nearly,obscure,obtuse,occasionally,orange,ovate,perfect,petiole,porrect-stellate,pubescent,reniform,rusty,shrub,slightly,stellate,stem,stigma,style,tan,triangular,tube,unbranched,unlobed,vein,vine,white,wide,x,yellow	0.5,0.5-1mm,0.75-1.5,1-.,1-5,10-15,2-3,3,3-10,30,4-10,4-7,4-8,5-merou,absen,accrescent,adaxiall,adaxially,alyx,apar,apical,armed,attenuate,axe,berry,beyond,blade,connivent,contiguous,cordate,cylindrical,difoliate,directed,discolorous,distal,eaf,eed,either,em,end,expanded,exserted,extra-axillary,filiform,flower,frui,fruiting,geminate,glabrou,gree,interpetelar,intorsel,lacking,like,long,lower,major,midpoint,multicellular,multiseriate,netlike,nflorescence,often,orolla,pair,pedicel,peduncle,per,pit,pore,prickle,rachi,raised,ray,recurved,ridge,roselike,ruit,scandent,secondary,separated,side,simple,spaced,sparsely,stalk,stamen,ste,surface,tamen,tapering,tissue,unarmed,unequa,unicellular,unit,vary,ympodial	1-4,branching,color,corolla,form,growth,height,inflorescence,lateral,length,margin,na,ovary,plant,pubescence,reproduction,seed,shape,size,staman,stellae,texture,tip
69	wfo-0001026267	success	162	108	78	84	30	0.481	0.1-1,0.5-1,0.6-1.7,1-1.2,1-2.6,1.5-2,2.5-3,20-30-flowered,3-15,3-6.1,5-7,8-10,8.5-15,acuminate,acute,anther,apex,attenuate,axil,base,beneath,blackish,bright,broadly,calyx,cm,corolla,cuneate,densely,drying,filament,flattened-reniform,glabrous,globose,green,lateral,lavender,leaf,lobe,lobed,long,main,margin,minutely,mm,narrowly,nearly,often,ovary,ovate,pair,papillose,petiole,pubescent,ripening,scattered,shrub,simple,size,slightly,small,sparsely,stem,stigma,style,tan,tinge,tip,tree,triangular,trichome,tube,tuft,uniseriate,vein,white,x,yellow-green	.25,.5,0.7-1.1,1-1.5,1-4,1.5-2.3,3.2-8.6,4-8,anthesi,ba,bark,beginning,berry,body,closely,crateriform,decurrent,deflexed,depressed,dia,differing,difoliate,distally,distinct,eaf,edicel,eed,except,exerted,free,fruiting,geminat,greenish-white,greyish-green,hard,incrassate,inflorescenc,larger,lon,longinflorescence,lower,major,maturity,middle,minor,occasionally,older,one,opposite,overlapping,pale,papillo,pedicel,pitted,pitting,pore,poricidal,portion,quickly,raised,reflexed,remaining,rough,ruit,scar,scarious,shaped,slender,softening,soon,spaced,straight,surface,tall,tapering,tear-drop,ud,unit,widest,wing,winged,woody,ympodial,young	0.25,1,branching,color,diameter,flower,form,fruit,growth,height,history,inflorescence,length,life,midpoint,midrib,midvein,na,perennial,plant,pubescence,ray,reproduction,seed,shape,staman,stellae,stipe,texture,width
70	wfo-0001026272	success	182	115	90	92	25	0.495	1,1-1.5,1-2,1.5-2,1/3,12-15,2-2.5,2-3,20,3-4,3-5,3.5-4,5-8,7-10,7-8,abaxial,abaxially,adaxially,anther,apex,apiculate,base,branched,brown,calyx,celled,cm,corolla,corymbose,cyme,densely,diameter,distal,elliptic,filament,flattened,flower,form,fused,glabrous,glandular,globose,green,growth,heterostylous,inflorescence,lobe,lobed,lower,many,midpoint,mixed,mm,obelliptic,ovary,ovoid,petiole,porrect,pubescence,pubescent,quarter,reddish,reniform,rugose,rusty,scabrous,scandent,sessile,shrub,somewhat,sparsely,stalked,stellate,stem,stigma,style,subcoriaceous,surface,thick,time,tip,triangular-lanceolate,trichome,tube,unarmed,way,white,x,yellowish,¾	0.2-0.3,1-1/5,1-2-celled,1.2-1.5,2-7,20-30,4-5,6-8,age,anthesi,armed,articulated,bark,basal,berry,beyond,clavate,coriaceous,cream-colored,denser,discolorous,eaf,eed,epidermi,erect,exserted,free,fruiting,internodal,lanceolate,lengthening,like,long,long-styled,midpoin,minute,multangulate,multicellular,new,nflorescence,numerous,oblong,older,partially,pedicel,peduncle,pendant,per,perfect,pericarp,pitted,plurifoliat,pore,poricidal,porrect-stellate,portion,prickle,prickly,rachi,raise,recurved,reduced,reticulately,ruit,scar,short-styled,simple,slightly,slit,spaced,sparse,staminate,sub-sessile,subconical,subglobose,subtruncat,tapering,terete,testa,turbinate,ud,unarme,unevenly,unicellular,unit,upper,velutinous,venation,viscid-pubescent,visible,woody,ympodial	branching,color,fruit,height,history,lateral,leaf,length,life,margin,midrib,midvein,na,plant,ray,reproduction,seed,shape,size,staman,stellae,stipe,texture,vein,width
71	wfo-0001026279	success	248	117	93	155	24	0.375	-5.9,0.2-0.4,0.8-2.3,1-10,1-3.5,1.1-1.6,1.1-1.9,1.5-1.8,1.5-3,1.7-2.3,1.9-3,14-27,3.1-4.2,3.4-5.2,3.5-7.8,3.8-5.1,5-200,8-11,9-22,abaxially,acute,adaxially,anther,apex,attenuate,base,black,branched,brown,calyx,chartaceous,cm,corolla,cuneate,dark,deltoid,diameter,drying,elliptic,entire,filament,flower,fruit,globose,granular,grayish,grayish-green,green,lanceolate,lateral,lavender,leaf,length,lilac,lobe,many,margin,midrib,mm,multangulate-pubescent,narrowly,ovate-lanceolate,pale,perfect,petiole,plant,porrect-stellate,pubescence,scabridulous,scabrous,scattered,semi-ovate,short,shrub,side,stellate,stem,stigma,style,suborbicular,time,tip,tomentose,tomentose-pubescent,tree,tube,vein,white,whitish,x,yellow,yellowish,yellowish-tan	-11.4,-2.9,-34.3,-4,/14-1/8,0.25-0.4,0.9-1,0.9-1.8,1-1.4,1.9-3.2,1/2,11.5-19.7,2.4-3.2,2.5-3.2,2.6-4.8,2/3,3-4,3.1-3.6,4-7.5,5-8,8,8.5-10.5,accrescent,acuminate,adaxiall,ag,anthesi,apart,apparently,appearing,appressed,ark,around,articulated,axe,axillary,ba,berry,blade,blunt-tipped,branch,bud,capitate,closely,completely,conical,covering,cylindrical,dendritic-echinoi,dendritic-echinoid,dense,directed,distally,due,eaf,earl,echinoi,echinoid,edge,eed,elongated,enveloping,equal,evident,exerted,expanded,farinose,few-rayed,fleshy,free,fruiting,glabrescen,glabrescent,glabrous,hair,half,immature,inserted,lengthening,lobed,long,long-stalked,longer,longitudinal,longitudinall,lower,m.,main,mature,minute,mixed,multangulate,multiseriate,nflorescence,oblong,obovate,occasional,occasionally,often,older,open,orbicular,orolla,overlapping,partly,pedicel,peduncle,plurifoliate,pore,poricidal,present,prominent,pseudo-terminal,rachi,reticulate-punctate,rounded,ruit,secondary,sessile,short-,short-decurrent,short-stalked,simple,slightly,slit,slowly,somewhat,spaced,splitting,stalk,stamen,subcampanulate,subcoriaceous,subsessile,sulcate,surface,suture,tall,tamen,tertiary,thickened,thin,thin-stalked,ud,unarme,unarmed,unit,unwinged,upper,usually,vary,way,wide,ympodial,young	branching,color,form,growth,height,history,inflorescence,life,midpoint,midvein,na,ovary,perennial,pseudoterminally,ray,reproduction,seed,shape,size,staman,stellae,stipe,texture,width
72	wfo-0001026292	success	190	126	100	90	26	0.526	-13,0.25-0.5,0.5-1,0.5-1.5,0.5-2,0.75-1.25,1-1.5,1-2.5,1-3,1-8,1.5-2,1/3,12-16,2-3,2-4,2.5-3.5,20-25,3-15,3-8,3-9,abaxially,absent,acute,adaxial,adaxially,anther,apex,armed,asymmetrical,base,brown,calyx,chartaceous,cm,cut,densely,diameter,filament,flower,fruit,glabrous,globose,green,hair,immature,lanceolate,leaf,less,like,lobe,lobed,long,many,margin,mature,midpoint,midrib,midvein,mm,moderately,nearly,netlike,obscure,obtuse,often,orange,orange-red,ovate,per,perfect,petiole,pit,porrect-stellate,prickle,pubescent,raised,ray,reniform,ridge,separated,shrub,side,sinus,small,sparsely,stalk,stellate,stem,stigma,style,surface,tan,tube,unarmed,unbranched,vein,way,white,x,yellow	0.5,1-5,1.5,1.5-2.5,1.5-8,10-15,13-17,2-6,3-5,30-40,4-8,5-10,5-merou,absen,accrescent,adaxiall,alyx,apar,apical,apparently,attenuate,axe,berry,beyond,blade,bud,connivent,cordate,curved,cylindrical,dark,difoliate,directed,discolorous,distal,distally,eaf,eed,either,end,expanded,exserted,extra-axillary,filiform,flattened,frui,fruiting,geminate,glabrou,gree,introrsel,lon,lower,major,multicellular,multiseriate,nflorescence,occasionally,orolla,pair,pedicel,peduncle,pore,rachi,recurved,reflexed,roselike,ruit,scandent,secondary,simple,slightly,spaced,spreading,stamen,swollen,tamen,tapering,tem,thin-skinned,triangular,unequa,unicellular,unit,upward,vary,vegetatio,whitish,wide,ympodial	branching,color,corolla,form,growth,height,history,inflorescence,lateral,length,life,na,ovary,perennial,plant,pubescence,reproduction,seed,shape,size,staman,stellae,stipe,texture,tip,width
73	wfo-0001026298	success	192	63	52	140	11	0.271	0.1-0.3,0.2-4,0.3-2,0.5-3,1-1.5,1.5-2.5,3-4,4-13,8-28,along,appressed,beneath,cm,densely,dia,elliptic,glabrous,globose,golden,green,inflorescence,leaf,length,long,midrib,minute,mm,obovate,occasionally,opposite,ovoid-reniform,pale,petiole,plant,puberulent,reddish,rhizomatous,scattered,shape,shrub,simple,size,sometimes,somewhat,stem,surface,treelet,trichome,unicellular,uniseriate,x,yellowish-tan	.5,0.25-0.5,0.4-1,0.5-2,0.6-1.5,0.75-1,0.8-2,1.4-6,1.5-4,1.5-9,2-3,2850,3-6,3/4,5-30-flowered,7-12,acuminate,acute,american,anther,anthesi,apex,appearing,area,auriculate,ba,bark,base,bearing,beginning,berry,blade,broadened,bu,calyx,caudate,central,closely,conical,corky,corolla,costa,deflexed,deltoid,differing,difoliate,distal,dry,eaf,edicel,eed,ellipsoid,erect,even,exsertion,fide,filament,flower,free,fruiting,geminat,glabrate,greyish,haught,impressed,inflorescenc,later,lateral,lobe,lobed,locality,lon,long-styled,long-triangular,lower,main,major,margin,material,middle,minor,minutely,nflorescence,oblique,often,older,one,orbicular,ovary,overlapping,pair,papillo,papillose,pedicel,peelin,pitted,planar,pore,poricidal,portion,prominent,rarely,rather,red,reflexed,rest,rican,rough,rounded,ruit,scar,shaped,short-styled,shorter,single,slender,spaced,stigma,straight,style,tall,tapering,tear-drop,thick,third,time,tip,tube,two,ud,unit,variable,varying,vein,way,white,widest,woody,ympodial,young	branching,color,form,fruit,growth,height,history,life,pubescence,seed,texture
74	wfo-0001026299	success	239	99	76	163	23	0.318	.5,0.25-0.5,0.4-0.5,0.5-0.7,0.5-2.5,0.8-1,1,1-1.4,1.8-2,2.2-3.2,2.5-7,5-20,6-20,7-12,acute,almost,anther,apex,base,brown,calyx,cm,corolla,crenate-serrate,dark,densely,diameter,entire,filament,flower,fruit,glabrous,globose,green,hair-like,herb,imparipinnate,inflorescence,interrupted,irregularly,lanceolate,lateral,leaf,lobe,long,margin,minute,mm,obovate,outgrowth,ovary,pale,pentagonal,perennial,petiole,pubescence,pubescent,regularly,short,simple,size,sparsely,stem,stigma,stripe,style,surface,tall,tip,trichome,truncate,tube,variously,vein,white,yellow	--,-0.8,-1,-10,-2.5,-3.5,-5,0-8,0.1-0.2,0.1-0.25,0.1-0.4,0.1-0.5,0.15-0.2,0.2-0.25,0.2-1,0.3-0.4,0.4-2,0.5,0.5-0.6,0.5-1,0.6-2,0.7-3.5,0.8-0.9,0.9-1,1-celled,1.1-1.7,1.2-1.6,1.2-5,1.5-,1.5-2.3,2-4,2-6,2-foliate,2-locular,2.5,25,3-,3.5-10,5,5-15,abaxially,absent,abundant,acroscopically,adaxially,along,angled,anthesi,apical,appearance,appendage,approximately,articulated,axi,basal,basiscopically,beneath,berr,bract,bracteate,broadly,capitate,cell,change,chota,column,conical,could,crenat,decurrent,developed,diamete,distal,eaf,ebracteate,edicel,eed,eglandular,elliptic,erect,exserted,fruiting,give,glandular,gree,hal,half,head,interjected,intermixed,internode,investing,jequetepeque,lacking,larger,leaflet,less,like,lobed,lon,long-acuminate,longer,loosely,lower,marañón,maturity,middle,minutely,mixture,multicellular,narrowly,nearly,nflorescence,node,oblique,occasionally,often,pair,patent,pedicel,peduncle,petiolule,population,present,primary,prostrate,pseudostipule,purple,rachi,reflexed,rest,ruit,scarcely,scattered,secondary,sessile,silky,sparse,spreading,staminal,sterile,stout,straight,tem,terminal,tertiary,testa,thick,toward,ud,unicellular,uniseriate,unit,usually,valley,velvety,wall,way,weak-walled,wide,winged,woody,ympodial	3-15,branching,color,form,growth,height,history,length,life,midpoint,midrib,midvein,na,plant,ray,reproduction,seed,shape,staman,stellae,stipe,texture,width
75	wfo-0001026305	success	135	101	71	64	30	0.526	.25,/4,0.2-1,0.25-0.5,0.5-2,0.6-1,1-1.5,2-2.5,2.5-3,3-8.5,4-4.5,5-7,6-9,7-16,7-9,abaxial,abaxially,acute,adaxially,anther,anthesi,apex,attenuate,base,beige-tan,calyx,cm,congested,corolla,dendritic,densely,dia,elliptic,filament,glabrous,globose,green,greenish-white,lateral,leaf,lobe,lobed,long,margin,midrib,minutely,mm,ovary,ovoid-reniform,pair,pale,petiole,pitted,planar,pubescent,rounded,shining,shrub,simple,sparsely,stem,stigma,style,surface,tan,tip,trichome,tube,vein,way,x	0.7-1,1.3-1.5,2-6-flowered,along,apical,area,ba,bark,berry,closely,conical,dark,deflexed,deltate,difoliate,drying,eaf,edicel,eed,exserted,free,fruiting,geminat,glabrate,interlocking,knob-like,lamina,leaf-opposed,like,lon,lower,main,middle,minute,nflorescence,occasionally,older,overlappin,papillose,pedicel,pore,poricidal,portion,projection,reddish-brow,ruit,scar,scattered,shaped,slender,spaced,strongly,styl,tall,tear-drop,tub,ud,unifoliate,unit,visible,widest,woody,ympodial,young	2-6,branching,color,diameter,flower,form,fruit,growth,height,history,inflorescence,length,life,midpoint,midvein,na,perennial,plant,pubescence,ray,reddish-brown,reproduction,seed,shape,size,staman,stellae,stipe,texture,width
76	wfo-0001026307	success	193	123	85	108	38	0.44	0.6,9,abaxial,abaxially,acute,acute-acuminate,adaxial,anther,anthesi,apex,base,berry,black,broadly,central,clavate,cm,corolla,cuneate,decurrent,densely,diameter,ellipsoid,entire,eye,filament,flattened-reniform,flower,fruit,glabrous,glandular,globose,green,growth,herb,internodal,lateral,length,lobe,lobed,long,margin,membranous,minutely,mm,ovary,ovate,pair,paler,pedicel,peduncle,petiole,primary,pubescent,purple,purple-yellow,reflexed,ripe,scar,shallowly,shape,shrub,simple,sparsely,stellate,stem,stigma,strongly,style,surface,tinged,tip,translucent,triangular,trichome,tube,turning,undulate,uniseriate,variable,vein,white,wide,yellow,yellow-green	.0–1.2,.3,.5,.5–4.0,.6,.8,0.2–0.5,0.2–1.5,0.4,0.5–0.6,0.5–0.7,0.5–5.0,0.8–0.9,0.8–2,0.8–5,1.0–1.2,1.0–1.5,1.0–2.0,1.0–2.4,1.0–2.5,1–3-celled,1–6-celled,2.0,2.0–3.0,2.0–3.5,2.6–13,2/3,3.0–4.0,3.5–7.0,35–45,3–8,3–8-celled,4–5.7,5-merous,5–7,8–12,adaxially,age,angled,apar,appressed,articulated,becoming,beyond,calyx,cell,cone,cylindrical,difoliate,eaf,eed,end,exerted,facing,free,fruiting,geminat,gradually,hilum,later,lengthening,like,longer,lower,middle,narrower,narrowing,new,nflorescence,one,outline,papillat,pentagonal,per,perfect,pore,poricidal,portion,positioned,recurved,reflexe,restricted,ruit,shallow,shorter,side,slightly,slit,spaced,spreading,ste,stone,straight,sub-laterally,tal,tem,testal,three,toward,two,ud,unequal,unevenly,unit,upper,vigorous,weak-stemmed,ympodial	0.2-1.5,0.3-0.4,0.5-0.7,0.5-5.0,0.8,0.8-2,0.8-5,1.0-1.2,1.0-2.4,1.0-2.5,1.5-2.0,2.0-3.5,2.6-13,3-8,3-8-celled,3.0-4.0,3.5-7.0,4-5.7,5-7,8-12,branching,bud,color,form,glandularity,height,inflorescence,leaf,midrib,na,papillate,plant,pubescence,seed,size,spacing,texture,type
77	wfo-0001026317	success	169	104	84	85	20	0.497	/4,0.3-1.2,0.5,0.5-0.6,0.5-1,0.8-1,1-1.2,1-1.5,1-5.7,2-2.5,2.5-10,3-3.5,3.5-15,4-5,50-200,6x,acuminate,acute,anther,anthesi,apex,attenuate,base,branched,bright,brown,calyx,clonal,cm,corolla,dark,deltate,dendritic,densely,diameter,elliptic,entire,filament,flattened,flower,glabrous,globose,growth,inflorescence,less,lobe,lobed,many,margin,minutely,mm,narrowly,orange,ovary,pale,papillate,perfect,petiole,pitted,planar,plant,pubescence,pubescent,red,reflexed,reniform,shrub,simple,slightly,sparsely,stem,stigma,style,surface,time,tip,triangular,trichome,tube,uniseriate,way,white,x,yellowish	.5,0.25-1,0.5-0.8,0.6-,0.7-0.9,10-12,2-,2-4,3,3-foliate,6-8,?,abaxially,absent,adaxially,age,apart,apically,approximately,bark,berry,capitate,closely,conical,correlated,dense,distally,drying,eaf,eed,em,erec,erect,essentially,exerted,extremely,found,free,fruiting,geminat,halfwa,internodal,lamina,lengthening,like,longer,lower,maturity,new,nflorescence,nodding,occasionally,often,packed,pair,papillat,pedicel,peduncle,per,pericarp,plane,population,pore,poricidal,portion,primary,pubescen,pulp,rachi,ruit,scar,shiny,slit,sticky,straight,swollen,terminal,thin,toward,ud,unit,variable,vein,woody,ympodial	2,2-15,branching,color,form,fruit,height,history,leaf,length,life,midrib,na,reproduction,seed,shape,size,staman,texture,width
78	wfo-0001026321	success	213	99	77	136	22	0.362	.5,0.1-0.4,0.4-0.7,0.6-0.9,1-4,1.2-3.5,1.5-3,2-7,2.5-5.5,2.7-3.1,3-4,3.5-8.5,4.5-6,7-10,7-9,andromonoecious,anther,apex,attenuate,base,bisexual,broadly,brown,calyx,chartaceous,cm,cordate,densely,diameter,entire,flower,fruit,glabrous,glandular-puberulent,globose,green,herbaceous,inflorescence,lateral,leaf,length,lobe,lobed,long,margin,midvein,mm,moderately,oblique,obtuse,orbicular,ovate,pale,petiole,plant,present,prostrate,pseudo-racemose,ray,resprouter,rostrate,rusty,shallowly,solitary,sprawling,stellae,stellate,stellate-pubescent,stigma,style,tube,unbranched,weakly,white,x,yellow,yellowish-green	%,0-0.1,0-0.2,0-0.25,0-0.3,0-2,0-3.5,0.1-0.2,0.1-0.3,0.3-0.6,0.4-0.6,0.5-0.6,1-1.2,1-1.5,1-2,1-3,1-5,1-locular,1.2-1.7,10-17,2-3,2-4,2-5,2-5.5,20-40,3-10,30-65,4-,4.5,5-25,5-merou,50-100,6-10,6-11,8-11,8-20,abaxially,absent,accrescent,acicular,across,adaxial,adaxiall,adaxially,adult,also,alyx,apart,armed,articulated,ascending,axe,ba,blade,branchlet,capitat,central,connivent,cross-section,cylindrical,decimetre,deltate,directed,distall,eaf,eed,eglandular,elliptica,exocarp,extra-axillary,finger,frui,fruiting,functional,gland-tipped,glandular,greenish-white,grey-green,hair,half,halfway,heterostylous,hig,incomplete,juicy,juvenile,lanceolate,leaf-opposed,less,longer,lower,mature,mesocarp,mid-point,midpoint,midrib,minute,moist,nflorescence,orolla,pair,part,pedicel,peduncle,per,placenta,pore,porrect,prickle,rachi,ruit,septum,sessile,shallowly-lobed,short,side,simple,spaced,sparse,stalk,straight,surface,tamen,tem,thick,throughout,time,transparent,unarme,unarmed,unit,unknow,upper,vary,wide,ympodial	branching,color,corolla,elliptical,filament,form,growth,height,history,life,na,ovary,pubescence,reproduction,seed,shape,size,staman,stem,texture,tip,vein
79	wfo-0001026325	success	216	123	97	119	26	0.449	.2,0.15–0.4,0.5,0.5–5,0.6–1.8,1.1–2,1.2–1.8,1.2–2,1.2–2.2,1.5–2.3,1.7–3.5,1.8–2.5,10–12,1–1.5,1–2.5,1–5,1–6,2.5–4,2–10,4–7,7–10,7–8.5,abaxially,acuminate,acute,adaxially,andromonoecious,anther,apex,base,blue-violet,calyx,caudate,cm,cuneate,darker,deltate,densely,diameter,ellipsoid,elliptic,filament,finely,flattened-reniform,flower,forked,foveolate,fruit,glabrous,green,herb,inflorescence,lateral,leaf,lenticular,less,light,lobe,lobed,margin,maturity,mm,mottling,oblong,obtuse,ovate-elliptic,ovoid,pale,perennial,petiole,pubescent,ray,rotate-stellate,shallowly,sinuate,sometimes,sparsely,stellate,stellate-pentagonal,stellate-pubescent,stem,stigma,style,subentire,subtruncate,surface,triangular,tube,unbranched,usually,vein,weakly,white,yellow,yellow-orange,young,×	0.3,0.5–1.5,1,1.2–2.5,1.3–2.5,1.5,10–20,12–16,1–2,2,2-,2–4,2–5,2–6,3,3-foliate,3.3,3.5,4,4–8,5,5-merous,5–9,6.5–15,absent,accrescent,adaxiall,alyx,apart,appearing,armed,articulated,axe,berry,blade,bud,c.,capitat,central,chartaceous,completely,connivent,covering,curved,cylindrical,directed,directly,discolorous,distal,distall,downward,eaf,eed,emerging,exserted,extra-axillary,few-branched,formed,fruiting,functionally,geminat,hair,hermaphorditi,hermaphroditic,heteromorphic,lanceolate,like,linear,lon,long,long-stuled,lower,lowermost,major,malae,moderately,narrowly,nflorescence,node,often,one,orolla,outline,pedicel,peduncle,per,plurifoliate,pointed,pore,prickle,producing,proximal,rind,root,ruit,sessile,shoot,short-styled,side,simple,somewhat,spaced,staminate,straight,subglobose-ovoid,swelling,tall,tamen,tapered,tem,toug,tuber-like,unarmed,unequal,unit,upright,vary,ympodial,–3	branching,color,corolla,form,growth,height,history,length,life,midpoint,midrib,midvein,na,ovary,plant,pubescence,reproduction,seed,shape,size,staman,stellae,stipe,texture,tip,width
80	wfo-0001026335	success	157	113	89	68	24	0.567	.5,.5-3.5,0.25-0.5,0.5-1,0.6-1,1,1-1.5,1-2,1.5-2,10-20,10-30,2,2-3,2-4,2-7.5,3-18,4-5,5-15,5-7,abaxially,acuminate,acute,adaxially,anther,apex,base,branched,calyx,chartaceous,cm,cuneate,deltate,dense,densely,diameter,elliptic,elliptic-ovate,entire,especially,filament,flattened,flower,forked,fruit,glabrescent,glabrous,globose,green,hair,lanceolate,leaf,like,lobe,long,margin,mm,moderately,multangulate,pedicel,peduncle,perfect,petiole,probably,pubescence,pubescent,rachi,reticulate,ripe,rounded,scattered,sessile,shrub,stellate,stellate-pubescent,stem,stigma,style,surface,time,tip,toward,tube,unripe,white,whitish,wide,x,yellow,yellowish	0.1-0.3,0.8-1.3,1-3,1-4,1.5-4,3-5,5-,7-8,accrescent,adaxiall,ag,apart,apparently,articulated,axe,ba,blade,capitat,connivent,covering,curved,cylindrical,directed,distally,eaf,eed,equal,erect,frui,fruiting,geminate,glandula,glandular,held,large,leaf-opposed,longitudinal,lower,many-foliate,midpoint,much,nflorescence,oblong,often,opening,orolla,paired,pore,ray,ruit,simple,slightly,slit,smaller,sometimes,spaced,ste,straight,subtending,tal,tamen,tem,unit,uprigh,usually,vary,vein,ympodial	abaxial,branching,color,corolla,form,growth,height,history,inflorescence,length,life,midrib,na,ovary,perennial,plant,reproduction,seed,shape,size,staman,stellae,texture,width
81	wfo-0001026342	success	280	123	85	195	38	0.304	2.0,4.7,4602,abaxially,acute,adaxially,aequilateral,anther,apex,attachment,base,brochidodromous,calyx,caudate,chartaceous,cm,corolla,deltoid,densely,diameter,entire,erect,extra-axillary,filament,flattened-orbicular,flattened-reniform,flower,fruit,globose,inflorescence,lateral,leaf,length,lobe,long,margin,mckee,midrib,midvein,mm,moderately,notched,oblique,oblong,observed,occasionally,one,oval,ovate,pedicel,peduncle,petiole,point,porrect,pubescence,pubescent,raised,ray,red,rounded,sessile,shrub,slightly,sparsely,speciman,stellae,stellate,stellate-pubescent,stem,stigma,stipe,style,time,tip,trifurcating,tube,unbranched,vein,weakly,white,wide,yellow,yellow-ferruginous,yellow-tan,±glabrous	.3,.4–3.0,.6,.9,0.06,0.07,0.08,0.3–0.5,0.3–0.6,0.3–0.9,0.4–0.6,0.6–1.3,0.6–2.8,0.7–1.4,0.7–1.6,0.7–1.8,0.8,0.8–1.1,0.8–1.2,0.8–1.5,0.9–1.3,1.1–1.5,1.1–3.7,1.2,1.3–1.8,1.5–2.1,1.5–2.3,1.7–2.6,1.8–2.2,1.9–2.9,1/2–2/3,1/3,2.0–7.6,2.1,2.1–3.3,2.1–3.7,2.5,2.5–3.8,2.8–4.9,2.9,3.1–13.7,3.2–3.7,3.6–4.6,5-merou,5.1–6.6,5.2–7.7,5–8,6–12,7.7–11.2,7–8,8,8.5–9.5,8–13,9.5–14.2,90°,absent,acuminate,adaxial,adnate,ag,along,alyx,anthesi,apart,apical,apparently,appearing,arching,around,articulate,attenuate,axe,ba,bark,becoming,bent,berry,blade,borne,branch,broad,brown,bud,cancellate,capitat,channeled,climate,clinate,congested,connivent,deciduous,dentate,development,difoliate,directed,distal,dorsally,dry,edge,eed,either,emerging,endocarp,exocarp,extending,fertile,filiform,flexed,free,geminat,glabrous,glandular,glossy,gradually,hair,homostylous,immature,increasing,individually,intact,internode,interpetalar,intersepalar,juic,laxly,layer,less,lon,longer,lower,many,markedly,mature,midpoint,minute,moderate,nearly,nflorescence,orolla,ove,per,perforated,pore,porrect-stellate,portion,potentially,reddish,reflexe,remaining,rigid,row,ruit,seen,short-stipitate,shorter,side,simple,sinus,sloughing,smoot,soon,spaced,splitting,spread,stamen,straight,surface,suture,tamen,tardily,tem,thin,tissue,toward,translucent,transparent,truncate,two,typically,ud,unarmed,upper,various,vary,well-developed,ympodia,young,±90°,±densely,±equal,±evenly,×,–0.9,–19.0,–31.0	0.3-0.5,0.3-0.6,0.4-0.6,0.6,0.6-2.8,0.7-1.4,0.7-1.6,0.7-1.8,0.8-1.1,0.8-1.2,0.8-1.5,1.1-1.5,1.1-3.7,1.4-3.0,1.5-2.1,1.8-2.2,1.9-2.9,2.0-7.6,2.8-4.9,3.1-13.7,3.2-3.7,5.2-7.7,7.7-11.2,8-13,9.5-14.2,branching,color,form,growth,height,ovary,plant,seed,shape,size,staman,texture,width
82	wfo-0001026343	success	221	115	90	131	25	0.407	-3.5,-4,-7,.5,0.05-0.5,0.1-0.2,0.5-1.5,1.3-1.7,1.5-2.5,1.8-2.2,1.8-3,1/3,2-3,2-3.2,2-4,2-6,2-8,2.2-3.2,3-4,5.5-9,7-9,abaxial,abaxially,acute,andromonoecious,anther,apex,apically,apparently,base,berry,branched,broadly,calyx,chartaceous,cm,cream,cuneate,dark,densely,diameter,dull,filament,flattened-reniform,flower,fruit,glabrescent,green,lateral,leaf,length,lobe,lobed,long,lower,margin,marking,maturity,mauve,midpoint,midvein,mm,narrow-deltate,orange,orange-brown,pale,petiole,plant,purple,ray,rounded,shrub,small,sparsely,spherical,spreading,stellate,stellate-pubescent,stem,style,surface,tip,tree,tube,upper,vein,weakly,wide,yellow,young	-1,-1.5,-15,/2,/5,0,0-10,0-2,0-4,0-40,0-5,0.05-0.2,0.15,0.2,0.2-0.3,0.2-0.7,0.3,0.45-1,0.5,0.8-1.5,1-2,1-3,1-4,1.5-2,1/,1/4-2/3,1/5,10-30,2-5,2.5-8,3-5,3.5-4.5,5-10,5-merous,6-9,7-12,7-14,7-8,acuminat,adaxial,alyx,apar,apart,articulated,bark,blade,brow,concolorous,connivent,curved,deltate,distal,distance,drying,eed,elliptic,elongating,equal,erect,extending,faint,flattened,free,fruiting,glabrous,green-brown,hermaphrodite,heterostylous,infructescence,less,lobing,lon,long-styled,longer,lowermost,mature,moderately,multangulate,nflorescence,obtuse,older,one,open,orolla,oung,ovate,pair,pedicel,peduncle,pendulous,per,pericarp,plurifoliat,poricidal,porrect,portion,prickl,prickle,prickly,primary,reddish,reduced,reflexed,ruit,scar,secondary,sessile,short-styled,side,smooth,sometimes,spaced,stalk,stalked,staminat,stout,tamen,tapering,terete,tertiary,time,trichome,unarmed,unit,variously,vary,venation,visible,way,woody,ympodial	acuminate,branching,color,corolla,form,growth,height,history,inflorescence,life,midrib,na,ovary,perennial,pubescence,reproduction,seed,shape,size,staman,stellae,stigma,stipe,texture,width
83	wfo-0001026351	success	199	121	99	100	22	0.497	0.25-0.5,0.5-1,0.5-1.0,0.5-1mm,0.75-1.0,1-1.5,1-2,1-2.5,1-3,10-15,15-50,2-3.5,3-9,4-6,4-7,5-15,6-8,8-15,abaxially,acute,adaxially,andromonoecious,anther,apex,asymmetrical,base,branch,branched,brown,calyx,chartaceous,cm,commonly,coriaceous,corolla,densely,diameter,distally,either,entire,filament,flattened,flower,fruit,glabrous,globose,green,hair,immature,leaf,length,like,lobe,lobed,major,margin,mature,midpoint,midrib,midvein,mm,moderately,narrowly,nearly,obtuse,occasionally,often,orange,orange-red,ovary,ovate,pale,petiole,plant,porrect-stellate,proximally,pubescent,purple,ray,red,reniform,revolute,seed,side,stellate,stem,stigma,style,subcoriaceous,surface,tan,triangular,tube,unbranched,vein,vine,white,x,yellow	0.5,0.5-1.5,1-.,1-4,10-18,12-16,2-4,2-5,3-10,3-6,4-9,40-80,5-merou,6-10,abaxial,absent,accrescent,adaxial,alyx,apar,apical,apparently,armed,attenuate,axe,berry,beyond,blade,bud,connivent,cordate,cylindrical,dark,difoliate,directed,discolorous,distinct,eaf,eed,em,exserted,exseted,extra-axillary,filiform,forming,frui,fruiting,functionally,geminate,glabrou,gree,hermaphroditic,heteromorphic,introrsel,leathery,long,long-styled,lower,male,multicellular,multiseriate,nflorescence,occasional,orane,orolla,outer,pair,pedicel,peduncle,per,pore,prickle,rachi,recurved,roselike,ruit,scrambling,short-,simple,siz,slightly,spaced,sparsely,spreading,stalk,stamen,ste,stellare,straight,surfac,swellin,tamen,tapering,unarmed,unequal,unicellular,unit,vary,wide,ympodial	1-6,branching,color,form,growth,height,history,inflorescence,lateral,life,na,perennial,pubescence,reproduction,shape,size,staman,stellae,stipe,texture,tip,width
84	wfo-0001026352	invalid_json	209	120	86	123	34	0.411	.3,.5,0.5-1,0.6-,0.7-2,1-,1.2-1.7,1.5-4.6,12-60,3-15,3.5-9,4-4.5,5-6,7-9,?,abaxially,acuminate,acute,anther,apex,base,berry,blue,branching,broadly,brown,calyx,chartaceous,cm,cordate,corolla,deltate,densely,diameter,ellipsoid,entire,evenly,filament,flattened,flower,glabrous,globose,green,greenish,growth,immature,inflorescence,lamina,length,lobe,lobed,long,many,margin,membranous,mm,narrowly,nearly,ovate,pair,petiole,pink,pubescent,reniform,revolute,shallowly,simple,stellate,stem,stigma,style,surface,time,tip,trichome,truncate,tube,unspecified,vein,vine,violet,weak,white,wide,woody,yellowish	0.5,0.5-0.8,0.5-1.5,0.5-3,0.9-1,1-1.5,1-10,1-2-celled,1.5,1.5-2,10+,2,2-3-celled,5-merou,6-7,<,adaxiall,ag,almost,alyx,angle,anthesi,antrorsely,apart,apparently,appearance,arising,articulated,articulation,axi,bark,basal,bending,branch,capitate-truncate,cell,conical,curved,deciduous,denser,discolorous,eaf,eed,eventually,expanded,exserted,few-celled,free,fruiting,giving,half,heigh,herbarium,ilament,impressed,inflorescenc,irregularly,junction,large,largest,leafy,leave,leaving,lengthening,like,lower,mature,minutely,near,new,nflorescence,older,orolla,outline,pale,papillate,papillo,pedicel,peduncle,peg,per,perfect,pericarp,plurifoliat,point,pore,poricidal,portion,primary,principal,rachi,reflexed,rest,right,ruit,scar,seen,shiny,shoot,short,sleeve,slit,small,spaced,sparser,specimen,spreadin,spreading,straw-colored,strongly,tem,terminal,thin,third,tub,tuberculate,ud,uniseriate,unit,upper,vary,widest,ympodial	'','pale,[,],``,characteristic,color,form,fruit,height,history,lateral,leaf,life,midpoint,midrib,midvein,na,ovary,plant,pubescence,ray,reproduction,seed,shape,size,staman,stellae,stipe,texture,value,width,{,}
85	wfo-0001026352	success	214	109	86	128	23	0.402	.3,.5,0.5-1,0.6-,0.7-2,1-,1.2-1.7,1.5-4.6,12-60,3-15,3.5-9,4-4.5,5-6,7-9,abaxially,acuminate,acute,adaxially,anther,apex,base,berry,blue,branching,broadly,calyx,chartaceous,cm,cordate,corolla,deltate,densely,diameter,ellipsoid,entire,evenly,filament,flattened-reniform,flower,form,glabrous,globose,green,growth,inflorescence,lamina,leaf,length,lobe,lobed,many,margin,membranous,mm,narrowly,nearly,ovate,pair,pale,perfect,petiole,pink,pubescent,revolute,shallowly,shiny,simple,stellate,stem,stigma,style,surface,time,tip,trichome,truncate,tube,unspecified,vein,vine,weak,white,woody,x,yellow,yellowish	0.5,0.5-0.8,0.5-1.5,0.5-3,0.9-1,1-1.5,1-10,1-2-celled,1.5,1.5-2,10+,2,2-3-celled,5-merou,6-7,<,?,ag,almost,alyx,angle,anthesi,antrorsely,apart,apparently,appearance,arising,ark,articulated,articulation,axi,basal,bending,branch,brown,capitate-truncate,cell,conical,connivent,curved,deciduous,denser,discolorous,eaf,eed,eventually,expanded,exserted,few-celled,free,fruiting,geminat,giving,greenish,half,heigh,herbarium,ilament,immature,impressed,inflorescenc,irregularly,junction,large,largest,leafy,leaving,lengthening,like,long,lower,mature,minutely,near,new,nflorescence,older,orolla,outline,papillate,papillo,pedicel,peduncle,peg,per,pericarp,plurifoliate,point,pore,poricidal,portion,primary,principal,rachi,reflexed,rest,right,ruit,scar,seen,shoot,short,sleeve,slit,small,spaced,sparser,speciman,specimen,spreadin,spreading,straw-colored,strongly,tem,terminal,thin,third,tub,tuberculate,twining,ud,uniseriate,unit,upper,vary,violet,widest,ympodial	color,fruit,height,history,lateral,life,midpoint,midrib,midvein,na,ovary,plant,pubescence,ray,reproduction,seed,shape,size,staman,stellae,stipe,texture,width
86	wfo-0001026357	success	206	116	96	110	20	0.466	0.1-0.3,0.2-0.7,0.6-1.5,0.8-1,0.8-1.2,0.9-1.2,1-6,1.1-1.7,1.4-2,1.5-2.2,1.5-2.8,10-17,2-2.8,2-3,2-3.3,30-68,4-6,4-7,5,7-15,abaxially,acute,adaxially,along,anther,apex,apparently,asymmetrically,base,branched,brown,calyx,chartaceous,cm,corolla,dark,decurrent,densely,diameter,elliptic,entire,ferrugineous-pubescent,filament,flower,foveolate,fruit,glabrous,globose,green,hair,half,immature,lanceolate,leaf,length,lobe,long-attenuate,lower,many,margin,mature,midrib,mm,multangulate-pubescent,narrowly,nearly,oblanceolate,ovate,ovate-lanceolate,pale,perfect,petiole,revolute,scabrous,semi-ovate,several,shrub,simple,slightly,small,smooth,stellate,stellate-pubescent,stellate-tomentose,stem,stigma,style,tan,time,tip,tree,tube,white,within,x,yellow	0.11-0.29,0.4-1.6,1-1.2,1.5-2.5,1.7-2.9,1/2,10-11,2-6,2.3-4.2,2.5-3.3,3.9-6.2,4-5,5.8-13.6,6-7.5,7-10,absen,accrescent,adaxiall,ag,anthesi,apart,around,articulated,axillary,ba,bark,berry,blade,blunt-tipped,branch,capitat,closely,completely,conical,conspicuous,coriaceous,covering,cylindrical,directed,distally,eaf,edge,eed,ellipsoid,enveloping,exserted,farinose,fleshy,free,fruiting,granular,hig,inserted,large,lateral,lengthening,line,lobed,long,m.,main,minute,mostly,multangulat,multangulate,nflorescence,oblong,obovoid,obtuse,older,orolla,pedicel,peduncle,persistently,plurifoliate,pore,poricidal,porrect-stellat,porrect-stellate,pubescent,rachi,rough,ruit,runk,sessile,short-stalked,side,slit,somewhat,spaced,sparse,sparsely,stellate-pubescen,stelliform,suture,tamen,terete,testa,thick-stalked,tomentose-pubescent,touching,ud,unit,vary,vein,way,weakly,whitish,ympodial,young	branching,color,form,growth,height,history,inflorescence,life,na,ovary,perennial,plant,pubescence,reproduction,seed,shape,size,staman,surface,texture
87	wfo-0001026367	success	216	134	89	127	45	0.412	1.2-1.6,abaxially,acuminate,adaxially,anther,apex,armed,asymmetric,base,black-brown,blue,broadly,caudate,close,cm,colored,cordate,dense,densely,diameter,dried,entire,eventually,filament,finely,flower,fruit,glabrous,globose,green,growth,irregularly,lance,later,lateral,lavender,leaf,lenticular,lighter,like,lobe,lobed,long,longer,loosely,margin,midpoint,midvein,minutely,mm,ovate,pentagonal,perfect,petiole,pitted,plump,prickle,pubescence,pubescent,ray,rotate,rounded,shallowly,shrub,sinuately,slightly,sparsely,stellae,stellate,stellate-pubescent,stellate-tomentose,stem,stigma,style,surface,tan,tawny,thick-chartaceous,tip,tomentose,triangular,tube,turning,unarmed,usually,vein,weakly,yellow,×	.5,0.2–0.5,0.4–0.6,0.4–0.7,0.5–0.7,0.7–1.5,1.8–2.5,10,10–15,10–18,15-20,15–30,1–2,1–3,2.5–4,2–3,2–3.5,2–4,2–4.5,2–5-branched,3–4,3–6,3–7,5-merou,5–7.5,5–9,6–8,7-9.7,7–11,8–10,abaxial,acicular,acute,adaxial,adaxiall,age,along,alyx,apart,apparently,articulated,ascending,attenuate,axe,ba,blade,branch,branched,capitat,center,closely,deeply,deltoid,denser,directed,distally,eaf,eed,erect,farinose,filiform,geminat,glabrate,hair,high,homostylous,immature,initially,internode,interpetalar,interwoven,larger,little,lon,looser,lower,maturit,midvei,midzone,mostly,much,narrowly,near,nflorescence,oblong,often,orolla,overtopped,ovoid,pedicel,peduncle,plurifoliate,pore,porrect,principal,ruit,sessile,short,shorter,side,similar,simple,sinus,small,somewhat,some­what,soon,spaced,splitting,spreadin,spreading,spreadingly,stalk,stalked,ste,tamen,tem,terminal,time,tissue,tomento,ud,vary,well-developed,wide,ympodia,–20	0.2-0.5,0.4-0.6,0.5-0.7,0.7-1.5,1-2,1-3,1.8-2.5,10-15,15-30,2-3,2-4,2-4.5,2-5-branched,2.5-4,20,3-4,3-7,5-7.5,5-9,6-8,7-11,8-10,branching,calyx,color,corolla,form,height,history,inflorescence,length,life,midrib,na,ovary,perennial,plant,reproduction,seed,shape,size,staman,stipe,texture,width
88	wfo-0001026377	success	155	84	56	99	28	0.361	0,1,12,2,2.5,30,5-7,8-13,abaxially,abundantly,along,andromonoecious,anther,base,bright,broadly,brownish,calyx,chartaceous,cm,densely,distinctly,filament,flower,forked,hair,leaf,lobe,main,mainly,margin,mm,oblique,ovate,pale,petiole,plant,prickle,prickly,pubescent,purple,retrorse,scattered,shrub,side,stellate,stellate-pubescent,stem,stigma,style,subcordate,surface,tube,unbranched,vein,x	-8,0.5,1/5-1/4,16,2-3,3,3-,3-5,4,5-6,5-merous,7,7-7.5,abaxiall,abundant,acumen,acute,adaxially,apex,apica,armed,articulated,axe,ba,belo,blade,branched,broad,cell,central,cut,distall,eaf,eed,ending,ermaphroditic,extra-axillary,fresh,geminat,hermaphrodite,hermaphroditic,heterostylous,internode,lateral,like,linear,lon,long,lower,midpoint,midrib,minor,narrow,nflorescence,often,orolla,pedicel,peduncle,polished,pore,porrect,prickl,proximal,rachi,ray,reduced,repand,rounded,ruit,seen,shallow,sharp,short,simple,single,sinus,smaller,sparsely,staminate,stipe,stou,straggly,straight,structure,subsagittate,tamen,taminate,tapered,tem,tipped,transition,triangular,unequal,unknow,unknown,vary,vestigia,way,ympodial	3-6,abaxial,adaxial,branching,color,corolla,diameter,distribution,form,fruit,growth,height,history,inflorescence,length,life,na,ovary,perennial,pubescence,reproduction,seed,shape,size,staman,stout,texture,vestigial
89	wfo-0001026379	success	219	125	106	113	19	0.484	-4.5,0.2-0.4,0.7-1,0.8-1.2,0.9-1.2,1-1.7,1-10,1-2,1-3.7,1.3-2.1,1.5-2.3,1.7-4.9,1.8-2.6,1.8-3.2,1/2,13,2.6-3.7,2/3,3-11,4.1-7,50-450,8-15,8-29,abaxially,acute,adaxially,along,anther,apex,attenuate,basal,base,branched,brown,calyx,cm,corolla,dark,densely,diameter,distal,dried,echinoid,entire,filament,finely,flower,fruit,globose,granular,gray-brown,grayish,growth,leaf,length,lobe,long-attenuate,many,margin,midrib,minutely,mm,multangulate,multangulate-pubescent,nearly,obovate,ovate,ovate-lanceolate,pale,perfect,persistently,petiole,pitted,plant,porrect-stellate,present,reniform,rich,scabrous,scattered,sessile,short-stalked,shrub,simple,size,small,stellate,stellate-,stellate-pubescent,stellate-tomentose,stem,stigma,style,terete,time,tip,tomentose-pubescent,tree,tube,uneven,upper,velutinous-pubescent,violet,whitish,x,yellow	0.2-0.38,0.7-2.5,1.8-5,1.9-3.4,2-2.8,2-7,2.4-5.1,2.9-4,3/4,4-5,5.3-10.2,6-10.6,8-13,8.3-10,9-14,accrescent,adaxiall,ag,anthesi,apart,apparently,around,articulated,axillary,ba,bark,berry,blade,blunt-tipped,branch,capitat,chartaceous,closely,completely,conical,covering,cylindrical,dendritic-echinoid,directed,distally,eaf,echinoi,echinoid-pubescent,edge,eed,ellipsoid,enveloping,evident,farinose,few-rayed,fleshy,free,fruiting,glabrous,hair,hig,included,inserted,lacking,large,lateral,lengthening,line,lobed,long,lower,m.,main,mature,minute,mostly,multangulat,nflorescence,oblong,obtuse,often,older,orolla,partly,pedicel,peduncle,plurifoliate,pore,poricidal,pubescen,rachi,rather,recent,ruit,runk,semi-ovate,side,slit,sometimes,somewhat,spaced,sparse,stelliform,suture,tamen,testa,thin,translucent,ud,unit,usually,vary,vein,vestigial,way,whitish-brown,ympodial,young	branching,color,form,height,history,inflorescence,life,midvein,na,ovary,perennial,pubescence,pubescent,reproduction,seed,shape,staman,surface,texture
90	wfo-0001026388	success	264	127	92	172	35	0.348	.5,0.2-0.6,1-2,1.5-2,1.6,1.8,8.5,abaxially,acuminate,acute,adaxially,anther,apex,attenuate,base,brown,calyx,cm,color,corolla,covering,deeply,dense,diameter,erect,except,filament,flower,fruit,glabrous,gland,globose,glutinous,green,hair,hyaline,inside,lanceolate,lateral,leaf,length,life,lighter,lobe,lobed,margin,midrib,minute,mm,moderately,much,nearly,oblique,one,outside,ovate,pair,petiole,pilose,plant,rarely,ripe,shallowly,shape,shrub,simple,size,sometimes,sparsely,spreading,stellae,stellate,stem,stigma,stipitate,style,suborbicular,surface,thickened,thin-textured,tip,truncate,tube,unbranched,unicellular,usually,vein,wide,x,yellow-orange,yellowish,±	.2,.7,0.15,0.2–1,0.2–2,0.4–1,0.5–1.7,0.5–2,0.5–4,0.8–1.5,0.8–2.5,1.4,1.4–1.6,1.5–2.2,1.5–3.5,108,10–20,12,1–2,1–2.5,1–6,2-foliate,2.5–4,20–,25,2–4,2–4-celled,2–9,3,3.2–3.7,45,4–10,4–5-rayed,4–6-celled,5,5–12,5–20,6,65–145,6–11,6–7,8-13,=,?,abundant,acicular,adaxiall,always,angle,apar,apiculate,apparent,appearance,armed,ascending,becoming,bilobed,blade,bleaching,branch,bright,ciliate,closely,conduplicate,confined,cylindrical,developing,dilated,directed,distall,distinctly,divided,division,dried,eaf,eed,enlarged,entire,especially,exceeding,exclusive,exserted,extra-axillary,first,flowering,folded,forward,free,geminat,geminate,giving,glistening,golden,grading,greenish,halfway,inserted,larger,least,less,light,lon,long,lower,major,minutely,mostly,n,nflorescence,often,orolla,otherwise,ovate-apiculate,papillat,par,pedicel,peduncle,per,plane,pointing,pore,pressing,prickle,probably,purple-colored,rachi,ranging,recurved,reflexed,reported,rip,ruit,scarious,scattered,sessile,sideway,similar,single,sinuate,sinus,slightly,small,smaller,somewhat,spaced,stamen,straight,straw,strongly,sunlight,tal,tamen,tem,triangular,turning,twice,twisted,two,unarmed,unit,upper,various,variously,vary,viewed,white,whole,wing,yellow,yellow-green,ympodial,–8	0.5-2,0.8-1.5,0.8-2.5,1-2.5,1.4-1.6,1.5,2-4,2-4-celled,2-9,20-45,3.2-3.7,4-10,4-6-celled,5-20,6-7,branching,form,growth,height,history,inflorescence,midpoint,midvein,na,ovary,perennial,pubescence,purple,ray,reproduction,seed,staman,stipe,texture,width
91	wfo-0001026397	success	202	121	102	100	19	0.505	0.5-1,1-2,1-2.5,1-3,1.5,1.5-3.5,10-14,13-18,2-10,2-2.5,2-5,2.5,3-3.5,3-4,3-9,4-16,5-8,8-20,abaxially,absent,acute,adaxially,andromonoecious,anther,apex,armed,asymmetrical,base,brown,calyx,chartaceous,cm,coriaceous,dark,densely,diameter,entire,extra-axillary,filament,flower,fruit,functionally,glabrous,glandular,globose,green,hair,hermaphroditic,immature,leaf,leathery,like,line,lobe,lobed,male,many,margin,mature,midvein,mm,moderately,nearly,netlike,occasional,often,older,orange,ovate,petiole,pit,plant,porrect-stellate,prickle,pubescent,purple,raised,recurved,red,reniform,ridge,roselike,rusty,separated,small,sparsely,stellate,stem,stigma,style,surface,tan,tube,unbranched,vine,white,whitish,wide,woody,x,yellow,young	0.5-1.5,1,1-.,1-6,1-9,1.5-3,10-20,12-15,12-16,3-5,4-8,5,5-15,5-merou,50-100,6-10,absen,accrescent,adaxial,alyx,anthesi,apar,apical,attenuate,axe,berry,beyond,blade,bud,connivent,cordate,cylindrical,difoliate,directed,discolorous,eaf,eed,either,em,expanding,exserted,filiform,flattened,frui,fruiting,geminate,glabrou,greatly,gree,greem,heteromorphic,introrsel,long,long-styled,lower,major,midpoint,midrib,multicellular,multiseriate,narrowly,nflorescence,obscure,obtuse,orolla,pair,pedicel,peduncle,per,pore,present,rachi,ray,reflexed,ruit,secondary,short-and,side,simple,siz,slightly,spaced,spreading,stalk,stamen,ste,straight,tamen,tapering,thick,triangular,unarmed,unequal,unicellular,unit,usually,vary,vein,weakly,ympodial	1-4,armature,branching,color,corolla,form,growth,height,inflorescence,length,ovary,pubescence,reproduction,seed,shape,size,staman,texture,tip
92	wfo-0001026400	success	187	114	92	95	22	0.492	0.2-0.8,0.4-1,0.5-1.2,1-2,1.3-2.6,1.7-2.2,10-18,12-27,13-30,2-8,2.4-5.9,3.4-4.8,3.5-5.9,4-7,5-7,6-13,6-15,8-12,9-13,anther,blue,brownish,cell,clavate,cm,condition,coriaceous,corolla,covering,dark,deep,diameter,drying,elliptic,filament,finely,flower,forked,fresh,fruit,glabrescent,glabrous,globose,green,green-white,greenish,hair,hair-like,herb,interjected,lateral,leaf,leaflet,light,lilac,lobe,long,make,mm,moderately,mucilaginous,odd-pinnate,orbicular,ovate,ovoid,pentagonal,petiole,plant,puberulent,pubescent,purple,ripe,seed,semi-stellate,short,simple,size,stigma,stripe,style,terminal,testal,thick,throughout,tip,tube,wall,wet,white,whitish,x,yellow	0.5-1,0.7-1.1,1-10,10-28,2-6,3-6,30-55,5-merou,6.5-20,abaxially,acumen,acuminate,acute,adaxiall,adaxially,ag,alyx,apart,apex,apparently,articulated,asymmetric,attenuate,axe,axillary,base,basiscopic,berry,blade,bud,capitat,connivent,decreasing,decurrent,digestion,distal,dorsally,eaf,edge,eed,enzyme,erec,exceeding,flat,folded,geminat,generally,glabrou,gree,hal,half,high,homostylous,honeycomb-shaped,lanceolate,lengthening,linear,living,lower,nflorescence,orolla,pair,pedicel,peduncle,perfect,petiolulate,plurifoliate,pore,poricidal,removed,rounded,ruit,sessile,seudostipule,side,slightly,slit,spaced,specimen,stamen,straight,subequal,subtending,tall,tamen,tem,tissue,toward,tri-,typically,unit,unwinged,usually,vary,ympodial	abaxial,adaxial,branching,calyx,capitate,color,form,growth,height,history,inflorescence,length,life,ovary,perennial,pseudostipule,pubescence,shape,staman,stem,surface,texture
93	wfo-0001026406	success	219	121	100	119	21	0.457	-1,.2,.5,0.3-0.5,0.4-0.8,0.5-1.5,0.8,1.8-2.4,1/3,1/4,1/4-1/2,12-19,2-2.7,2-3,2-6,2.5-8,2.9-3.2,3-10.5,3.2-3.8,5-6,5-8,6-12,6-15,6.5-7,7-10,7-8,9-15,abaxially,acute,ame,andromonoecious,anther,apex,base,berry,branched,broad-deltate,c.,calyx,chartaceous,cm,cordate,cream,dark,deltate,densely,diameter,elongated,filament,flattened-reniform,flower,foliaceous,fruit,green,herb,lateral,leaf,length,lobe,lobed,long,long-styled,lower,margin,marking,maturity,mauve,midpoint,midvein,mm,moderately,oblong,obtuse,orange-brown,ovate,pair,pale,petiole,plant,purple,ray,red-brown,short-styled,shrub,sparsely,spherical,spreading,stellate-pubescent,stem,style,tip,tube,upper,vein,velvety,way,white,wide,yellow,young	0,0-3,0-30,0-5,0.3,0.3-0.7,0.4-0.9,0.5,0.5-2.5,00-200,1,1-2,1.3-1.5,1.5-2,1.5-5,1/,1/4-1/3,10-30,20-60,3-4,30-60,5,5-25,5-50,5-7,5-merous,7-9,abaxial,adaxial,adaxially,alyx,apar,apart,apically,apparently,articulated,bark,blade,conical,connivent,curved,dirty-whitish,discolorous,distal,distance,drying,eaf,eed,elongating,equal,erect,extending,flattened,free,fruiting,fully,gently,glabrous,hermaphrodite,heterostylous,infructescence,least,lon,longer,lowermost,mature,nflorescence,older,one,open,opening,orolla,oung,pedicel,peduncle,pendent,pendulous,per,pericarp,plurifoliat,poricidal,porrect,portion,prickl,prickle,prickly,primary,reflexed,rounded,ruit,scar,sessile,side,smooth,sometimes,spaced,stalk,stalked,staminat,stellate,stout,straight,surface,tamen,tapering,terete,terminal,tertiary,time,trichome,unit,variously,vary,venation,visible,weakly,woody,yellow-brow,ympodial	branching,color,corolla,form,growth,height,inflorescence,midrib,na,ovary,pubescence,reproduction,seed,shape,size,staman,stellae,stigma,stipe,texture,width
94	wfo-0001026407	success	221	135	113	108	22	0.511	-11,-6,.5,/3,0.5,0.5-2,0.9-3,1,1.2-1.5,1.3,1.5-1.7,1.5-2,1.5-7,2-2.5,2.5-3,3.5,4-5,5,5-10,7-8,abaxially,acute,anther,anthesi,apex,basal,base,berry,black,blunt,branch,branched,brown,brownish,calyx,capitate,cell,chartaceous,cm,congested,conical,corolla,deep,dendritic,densely,diameter,elliptic,entire,erect,evenly,filament,flattened-reniform,fleshy,glabrous,globose,golden,growth,inflorescence,lamina,lax,like,lobe,lobed,long,many,margin,markedly,membranous,minutely,mixture,mm,narrowly,oblique,occasionally,outline,pale,papillate,pentagonal,perfect,petiole,pitted,planar,pubescence,pubescent,purple,purplish,reddish,revolute,ripe,shiny,short,shrub,simple,slightly,sparsely,stellate,stem,stiff,stigma,style,surface,time,tip,trichome,truncate,tube,vein,vine,violet,way,woody,x,yellow	+,0.5-0.6,0.5-1,1-1.2,1-10,20-30,20-40,3.5-5.5,5-7,5-merou,7-10,adaxially,ag,aid,along,always,alyx,apart,appearing,area,ark,around,articulated,axi,becoming,beneath,berr,broadly,clear,climbin,connivent,deltate,dense,denser,discolorous,eaf,eed,ellipsoid,exserted,flower,free,fruiting,geminat,glabrescen,glabrou,golden-pubescent,ilament,internodal,interpetalar,irregularly,lateral,leafy,leaving,lengthening,loosely,lower,midvein,near,new,nflorescence,numerous,obscured,often,older,open,orolla,pair,paler,papillat,pedice,pedicel,peduncle,peg,per,pericarp,persistent,plurifoliate,pore,poricidal,portion,primary,pubescenc,ruit,scar,sinus,sleeve,slit,small,spaced,sparser,spreading,stout,strongly,tangled,tem,terminal,testal,thin,transition,twining,ud,undulate,unit,upper,usually,vary,weak,ympodial	abaxial,adaxial,branching,color,form,fruit,glabrescent,height,history,leaf,length,life,midrib,ovary,perennial,plant,reproduction,seed,shape,size,staman,texture
95	wfo-0001026422	success	273	117	79	194	38	0.289	.0,.3,.7,3.5,56,6.8,7.6,8.4,abaxially,acuminate,acute,adaxially,anther,apex,apiculate,base,branching,brochidodromous,calyx,channeled,chartaceous,cm,corolla,cuneate,deltoid,densely,diameter,distinct,elliptic,entire,extra-axillary,filament,filiform,flattened-irregular,flattened-reniform,flower,fruit,glabrous,globose,gray-brown,lanceolate,lateral,length,lobe,long,many,margin,midrib,midvein,mm,moderately,oblong,petiole,pubescence,pubescent,raised,ray,red-brown,rounded,shrub,sinuate,stellae,stellate,stem,stigma,stipe,straight,style,time,tip,tube,unbranched,vein,weakly,white,wide,yellow,yellow-tan,yellowish-green	.04,.6,.9,/3,0.04,0.06,0.08,0.1–0.5,0.2,0.2–0.4,0.3–0.5,0.3–0.7,0.4–1.3,0.4–2.4,0.6–0.9,0.6–1.1,0.6–2.0,0.7–0.8,0.7–1.6,0.8,0.9–1.5,0.9–1.9,0.9–7.5,1.0,1.0–1.9,1.1–1.4,1.2–2.8,1.3–2.2,1.6–1.9,1.6–2.2,1.7–2.4,1.8–2.2,1.8–2.3,1/2–2/3,1/3,1/3–2/3,10,13.2–27.8,1–3,2.0–3.2,2.2–14.0,2.8–4.2,3.5–4.5,3.8–4.8,4.7,4–8,5-merou,5.0,5.8–7.4,5.8–8.3,5–7,6–8,7.7–9.2,7.8–26.9,absent,adnate,aequilateral,ag,alveolate,alyx,anthesi,apart,apical,apparently,appearing,appresse,around,articulate,attenuate,axe,ba,bark,basal,becoming,bent,berry,blade,borne,branch,broad,bud,capitate,cream,darker,deciduous,dentate,development,difoliate,directed,distal,distally,dry,eaf,edge,eed,either,emerging,endocarp,erect,especially,evenly,exocarp,extending,fertile,free,geminat,glandular,glossy,gradually,gree,green,hair,homostylous,immature,increasing,individually,intact,internode,interpetalar,intersepalar,juic,layer,light,lon,longer,lower,many-flowered,mature,midpoint,minute,much,nearly,nflorescence,oblique,observed,occasionally,orolla,ovate,ove,pedicel,peduncle,per,perforated,pore,porrect,porrect-stellae,portion,potentially,presumably,reflexed,remaining,rigid,row,ruit,scarcely,sessile,short-stipitate,side,simple,sinus,sloughing,smoot,soon,sparsely,splitting,spreading,stamen,stellate-pubescent,stripe,surface,suture,tamen,tardily,tem,thin,tissue,translucent,transparent,truncate,two,typically,ud,unarmed,upper,various,vary,well-developed,yellow-ferruginous,ympodia,young,±congested,±erect,×,–5	0.06-0.08,0.1-0.5,0.4-1.3,0.4-2.4,0.6-1.1,0.9-1.9,0.9-7.5,1-3,1.3-2.2,1.6-1.9,1.7-2.4,1.8-2.3,2.2-14.0,2.8-4.2,3.5-4.5,4-8,5,5.8-7.4,color,dense,form,growth,height,history,inflorescence,leaf,life,na,ovary,perennial,plant,reproduction,seed,shape,size,staman,texture,width
96	wfo-0001026424	success	138	81	42	96	39	0.304	1-1.5,10,10-15,15,15-30,3-4,acuman,acuminate,acute,apex,base,blunt,blush-violet,broad,calyx,cm,corolla,cuneate,cyme,exceeding,flower,glabrous,glandular,hair,interacuminal,leaf,lobe,midvein,minute,mm,oblique,petiole,pinnatisect,rotate-stellate,scorpioid,shrub,simple,slightly,stem,tip,tissue,x	-25,-3.5,-4,0.75-1.5,1,1-,1-10,1-2,1.5-2,12-60,2,3-11,637/1,8-,acumen,age,angular,anthesi,aspect,axil,ba,becoming,bluntly,broadly,campanulate,cell,clonal,close,common,conspicuous,cut,dia,distinct,downard,eaf,ellipsoid,elliptic,erect,except,exerted,facetted,facing,floral,fork,forked,general,gree,growing,lacking,lanceolate,lanceolate-elliptic,larger,lasting,lavender,line,lobed,lon,long,lower,nflorescence,obovate,often,part,pedicel,pedicellate,peduncle,plurifoliat,point,rachi,raised,rarely,rh,rounded,second,several,shallowly,short,sinus,soft-wooded,soon,stone,straggly,time,toward,triangular,tub,ud,unit,unwinged,usually,violet,within,woody,year,ympodial,young	1-4,anther,branching,color,diameter,filament,form,fruit,green,growth,height,history,inflorescence,lateral,length,life,margin,midpoint,midrib,na,ovary,perennial,plant,pubescence,ray,reproduction,seed,shape,size,staman,stellae,stigma,stipe,style,surface,texture,tube,vein,width
97	wfo-0001026440	success	181	117	96	85	21	0.53	0-15,1-5,1.1-1.4,1.1-1.5,1.5-2.1,1.9-3.7,14-30,2-2.8,2-4,2.9-4.4,3-5,3-7,3-8,3/4,4-12,5-7,7-14,9,abaxially,acute,adaxially,along,anther,apex,appressed,basal,base,bract-like,branched,broadly,brown,calyx,chartaceous,cm,corolla,diameter,dichotomy,elliptic,entire,filament,first,flower,globose,granular,green,greenish-yellow,hair,leaf,length,lobe,long-attenuate,many,margin,minutely,mm,mostly,multangulate,multangulate-pubescent,nearly,obovate,obovoid-oblong,obtuse,often,ovate,pair,pale,pedicel,peduncle,petiole,pitted,porrect-stellate,reniform,ripe,scabrous,semi-ovate,short-acuminate,shrub,simple,size,small,sometimes,stellate,stellate-pubescent,stem,stigma,style,terete,time,tomentose,tomentose-pubescent,tree,truncate,turning,white,x,yellow	1.3-1.7,1.8-4.5,1/2,1/2-2/3,3.9-6.5,accrescent,adaxiall,ag,always,anthesi,apparently,articulated,axillary,ba,bark,berry,blade,blunt-tipped,branch,branche,capitat,closely,conical,dendritic-echinoid,dense,developed,directed,distal,distally,eaf,echinoi,echinoid,eed,fleshy,free,fruiting,high,included,inserted,large,lengthening,lobed,long,lower,m.,minute,multangulat,nflorescence,oblong,obscure,older,openly,orolla,perfect,persistently,plurifoliate,pore,poricidal,pubescen,rather,ruit,runk,sessile,short-stalked,slit,somewhat,spaced,sparse,suture,tamen,testa,thick,thin,tip,tomentum,translucent,tube,ud,uneven,unit,usually,vary,way,ympodial,young	branching,bud,capitate,color,form,fruit,growth,height,history,inflorescence,life,na,ovary,perennial,plant,pubescence,seed,shape,staman,surface,texture
98	wfo-0001026441	success	197	103	77	120	26	0.391	0.3-0.7,1-1.5,1-2,10,10-14,2-2.5,2-8,4-8,4-8.5,5-10.5,7-20,7-8,9-14,abaxially,adaxially,anther,apex,attenuate,base,berry,brownish,cell,chartaceous,cm,condition,conical,corolla,covering,diameter,drying,filament,flower,forked,fresh,fruit,glabrous,green,greenish,hair-like,herb,lateral,leaf,light,lobe,long,margin,minutely,mm,mottled,odd-pinnate,ovoid,pale,perfect,petiole,plant,puberulent,pubescent,purple,ripe,rotate,seed,size,sparsely,stem,stigma,style,testal,thick,tip,tube,usually,violet,wall,whitish,wide,x,yellow	.5,0-2,0.4-3,0.5-1.5,0.8,1-10,1.5-2,1.5-2.5,15-20,2-5.5,3-5,4-6,4.5-6.5,5,5-merou,6-15,absent,acumen,acuminate,ag,alyx,apart,apparently,articulated,axe,axillary,blade,bud,capitat,ciliate,connivent,decreasing,digestion,distal,dorsally,eaf,edge,eed,elliptic-lanceolate,end,enzyme,equal,erec,especially,exceeding,flat,folded,fourt,geminat,generally,glabrou,gradually,green-white,hair,half,homostylous,honeycomb-shaped,interjected,internal,lanceolate,larger,leaflet,lengthening,like,living,lower,make,middle,minute,mucilaginous,narrow,nflorescence,obtuse,one,orbicular,orolla,ovate,pair,pedicel,peduncle,petiolule,placed,plurifoliate,pore,poricidal,removed,rounded,ruit,secondary,semierect,seudostipule,short,slightly,slit,spaced,specimen,stamen,star,ste,stolo,straight,subequal,subsessile,subtending,symmetrical,tall,tamen,tem,terminal,throughout,toward,tri-,tuber,typically,unit,vary,wet,white,wing,ympodial	branching,calyx,color,form,growth,height,history,inflorescence,length,life,midpoint,midrib,midvein,na,ovary,perennial,pubescence,ray,reproduction,shape,staman,stellae,stipe,surface,texture,vein
99	wfo-0001026453	success	211	122	102	109	20	0.483	.5,0.1-2.7,0.45-5.5,0.5,0.5-0.7,0.5-1,1-1.5,1.5-2,1.9-21.3,15,2-2.5,30,4m,5.5-8,6-8,7-9,abaxially,acuminate,acute,adaxially,almost,anther,apex,attenuate,base,berry,branched,bright,brown,calyx,cm,conical,corolla,deltate-triangular,densely,diameter,elliptic,entire,filament,flattened,flower,glabrous,globose,growth,inflorescence,irregularly,lateral,leaf,length,linear,lobe,lobed,margin,maturity,midpoint,midrib,midvein,minutely,mm,narrowly,nearly,oblique,occasionally,opposite,pale,perfect,petiole,pitted,porrect,pubescence,pubescent,ray,red,reddish,reniform,rounded,scattered,sessile,shallowly,shrub,simple,small,sometimes,sparsely,stellate,stem,stigma,style,surface,tan,tip,tree,triangular,trichome,tube,usually,vein,violet,weak,white,x,yellowish	0.8-1.1,1,1-1.2,1-2,10-20,2,5-32,6-10,6376,<,aberrant,absent,adaxial,along,anthesi,apart,armed,articulated,axi,bark,basal,based,beneath,bent,broad,capitate,cell,deflexed,dense,denser,directed,distall,distally,eaf,easily,eed,enlarged,enmeshing,equal,evenly,exceeding,exserted,filiform,free,fruiting,glabrescent,grayish,hanging,howard,internode,lamina,lengthening,less,like,long,lower,new,nflorescence,often,older,one,open,orange,outline,pair,papillo,parallel,pedicel,peduncle,per,pericarp,plurifoliat,pore,poricidal,portion,prickle,primary,rest,ruit,scar,shiny,shorter,side,sinuate,slightly,slit,smaller,somewhat,sorter,spaced,sparse,sparser,spreading,straight,strongly,surfac,tangled,tapering,testal,thin,time,trunk,ud,unarmed,unit,upper,visible,within,ympodial	branching,color,form,fruit,height,history,life,na,ovary,perennial,plant,reproduction,seed,shape,size,staman,stellae,stipe,texture,width
100	wfo-0001026460	success	131	101	70	61	31	0.534	.5,0.5-1.5,1-1.5,1.5-2,10-15,13.5-21,2.5-3,4.5-5,6-9,7-9,8-10,abaxially,acute-acuminate,adaxially,anther,apex,base,becoming,branched,brown,calyx,cm,completely,corolla,dark,deltate,dia,elliptic,filament,floccose,flower,glabrous,globose,green,greenish,inflorescence,internodal,leaf,less,lobe,lobed,minutely,mm,nearly,often,older,opposite,ovary,ovoid-reniform,pair,papillose,pitted,puberulent,reddish,shrub,simple,somewhat,soon,stem,stigma,style,subshrub,surface,tiny,tip,trichome,tube,vein,white,x	.1,1/2,2-2.5,5,513,6-7,acut,anthesi,axi,berry,capitate,closely,conical,deflexed,distal,do,drying,eaf,edicel,eed,erect,fide,filiform,free,frui,fruiting,inflorescenc,like,long,long-exserted,lower,major,membraneous,middle,nflorescence,pale,papillo,pedicel,pore,poricidal,portion,reddish-brow,reflexed,ruit,santo,scar,shaped,slightly,spaced,tall,tapering,tear-drop,tub,ud,unifoliat,unit,widest,woody,yellow,ympodial,young	acute,branching,color,diameter,form,fruit,growth,height,history,lateral,length,life,margin,midpoint,midrib,midvein,na,petiole,plant,pubescence,ray,reddish-brown,reproduction,seed,shape,size,staman,stellae,stipe,texture,width
101	wfo-0001026485	success	188	112	89	99	23	0.473	-35,.25,0.25-1,1-2,1-2.5,10-25,2,2-6,2.3-5,2.5-5,3-25,3-4,3-6,3-7,3.5-7,4.5-9,5-7,6-9,7-15,abaxially,acute,adaxially,andromonoecious,anther,apex,armed,attenuate,base,bright,brown,calyx,cm,diameter,entire,filament,flattened,flower,forked,foveolate,fruit,glabrous,globose,greenish-white,inflorescence,lanceolate,lateral,leaf,light,lobe,margin,midvein,mm,narrowly,oblique,obovoid,orange,ovate,perennial,petiole,prickle,puberulent,pubescent,pyriform,rarely,recurved,reflexed,ripe,robust,scandent,side,sparsely,spreading,stellate,stigma,strongly,style,subcoriaceous,surface,tapering,thickened,tip,triangular,trichome,truncate,tube,unbranched,vein,x,yellow	-1.5,-22,1-10,1-4,1.5,1.5-5,10-20,2-3,2-4,20-30,20-40,20-50,4-9,45,5-20,5-merou,6-10,abaxiall,absen,accrescen,aggregate,alyx,apart,appearing,articulated,axe,blade,broadly,chartaceous,compound,congested,connivent,cylindrical,developing,difoliate,directed,distall,dr.,eaf,eed,elliptic,elongating,even,fertile,fruiting,geminat,glabrou,heterostylous,hollow,imparipinnate,internode,leaflet,leaving,like,long,long-attenuate,lower,lowermost,major,nearly,nflorescence,occasionally,one,opposite,orolla,pair,pedicel,peduncle,per,plant,pore,rachi,recurve,rugose,ruit,scar,simple,slightly,small,sometimes,spaced,speciman,straight,subopposite,swollen,tamen,tem,time,tissue,tone-cell,toward,truncat,unit,usually,vary,vin,wide,winged,ympodial	branching,color,corolla,form,growth,length,midpoint,midrib,na,ovary,pubescence,ray,reproduction,seed,shape,size,staman,stellae,stem,stipe,texture,vine,width
102	wfo-0001026489	success	153	109	80	73	29	0.523	.3,0.05-0.1,0.5-1,0.5-2,0.8-1.2,0.8-3.7,1-1.5,1.5-5,2-3,2-4,2-5,2-8-flowered,2.5-13,2.5-4,2/3,5-6,8-13,acute,along,anther,anthesi,apex,axil,base,beneath,branched,brown,calyx,cm,corolla,dark,deflexed,densely,dia,elliptic,filament,flattened-reniform,glabrous,globose,green,lateral,leaf,lobe,lobed,long,main,margin,minutely,mm,occasionally,often,ovary,pair,papillose,parallel,petiole,pitted,planar,prominent,pubescent,shiny,shrub,simple,size,somewhat,stem,stigma,straight,strongly,style,surface,tip,trichome,tube,uniseriate,vein,way,white,whitish,x	0.25-0.5,0.5,0.5-0.75,0.6-1.4,0.8-1.3,1.3-3,appearing,area,ba,bark,berry,broadly,closely,cup-shaped,deltoid,differing,difoliate,dry,eaf,edicel,eed,erect,exserted,extending,flattened,fleshy,free,fruiting,geminat,gra,incrassate,lamina,later,lon,lower,major,middle,minor,nflorescence,older,one,opposite,overlappin,paler,papillo,pedicel,perpendicular,pore,poricidal,portion,red-papillose,rhachi,ruit,scar,shaped,slender,soon,spaced,specimen,tall,tapering,tear-drop,terminal,thickened,tub,ud,unit,usually,widened,widest,woody,ympodial,young	branching,color,diameter,flower,form,fruit,gray,growth,height,history,inflorescence,length,life,midpoint,midrib,midvein,na,perennial,plant,pubescence,ray,reproduction,seed,shape,staman,stellae,stipe,texture,width
103	wfo-0001026490	success	272	117	101	171	16	0.371	.5,0.1–0.2,0.1–2.5,0.5–1.5,0.5–8,0.8–1.5,0.8–12,1.5–2,1.5–3.5,1–1.2,1–2.5,1–3,1–8,2.5–3.5,2–2.5,2–4,3,3–4.2,3–4.5,4–5,5–7,7-pinnate,abaxially,acute,adaxially,along,anther,apex,branched,brown,calyx,chartaceous,cm,corolla,covered,crisped,darker,densely,diameter,ellipsoidal,filament,flattened,flower,fruit,glabrous,green,immature,inflorescence,leaf,length,lenticular,light,lobe,long,lower,mature,medium,middle,midvein,mm,moderately,mottled,oblong,obtusely,orange,ovate-lanceolate,papillose,pentagonal,petiole,pointed,pubescence,pubescent,radial,rounded,seed,shape,simple,size,slightly,smooth,sometimes,sparsely,stem,stigma,striation,striping,style,surface,tawny,teardrop-shaped,tip,transparent,trichome,tube,vine,violet,white,yellow,½,×,–4.5	0.2–1,0.2–1.5,0.3–3.5,0.4–0.8,0.5–1,0.5–3.5,0.7–3,1.2–8,1.5,1.5–5,1.8–2.2,1.9,10–20,1–15,2,2–6,2–8,3–5,3–5-pinnate,3–8,4.6,4–4.5,5-merous,6,7,7–15,=,[,],absent,accrescent,acuminate,ag,alyx,anthesi,apart,apical,apicall,apparently,around,articulated,axe,axillary,ba,base,becoming,blade,bract,bracteate,broadly,capitat,cauline,ciliate,climbing,commonly,completely,connivent,contiguously,cordate,cylindrical,decreasing,directed,distal,distally,eaf,eed,eglandular,elliptic,entire,equal,exceeding,expanded,extra-axillary,flat,free,fruiting,fused,geminat,ground,incurved,interjected,irregularly,lacking,large,lateral,latrorse-introrse,leaflet,lobed,longitudinal,lowermost,lunate,main,margin,markedly,match,mean,mean=,minute,multicellular,near,nearly,nflorescence,node,obliqu,oblique,obliquely,oblon,obtuse,occasionally,one,opening,orolla,ovate,pair,part,pedicel,peduncle,per,perfec,perfect,petiolule,plurifoliate,pore,present,pseudostipule,pubescen,punctate,pur,rachi,reflexed,reniform,resulting,revolute,rooting,ruit,sand,seudostipule,shoot,short,shorter,similar,slender,slit,smaller,somewhat,spaced,spur,stamen,strongly,tamen,tem,terminal,thickened,toward,trailing,trichomessympodial,truncate,typically,unbranched,undulate,unit,vary,vegetation,wide,wing,woody,yellowish-tan,youn,–4,–8,–9.5	branching,color,form,growth,height,history,life,midrib,na,ovary,perennial,plant,reproduction,staman,texture,width
104	wfo-0001026491	success	165	112	80	85	32	0.485	.5,1,1-2,1.5-2,1.5-2.5,1.5-3.5,1.7,10-50,2-4,2.5-3.5,3,5-6,6-8,abaxially,acuminate,acute,adaxially,anther,apex,averaging,base,branched,branching,broadly,cellular-papillose,central,cm,crinkly,cuneate,deep,densely,diameter,elliptic-lanceolate,entire,filament,flower,glistening,globose,green,hair,highly,inflorescence,lanceolate,lateral,leaf,less,light,lobe,margin,middle,minutely,mm,obtuse,often,ovate-elliptic,ovoid,pale,perfect,petiole,pubescent,purple,rotate-pentagonal,rotate-substellate,rounded,row,sharp,shortly,shrub,spotted,stigma,straight,strigose,subacute,suborbicular-ovate,surface,tip,tube,white,x,yellow	1977,2-3,2-celled,3-pinnate,5-8,5-merou,7-8,abaxiall,absent,alyx,anderson,apparently,appressed,articulated,axe,ba,bayonet,bent,berry,blade,bract,capitat,cellular-pilose,connivent,conspicuously,deciduous,deltoid,directed,distall,eaf,eed,equal,first,geminat,greatly,growing,homostylous,interjected,leaflet,long,lower,lunulat,mean,near,nflorescence,oblong-elliptic,orolla,ovate,pedicel,peduncle,pilose,plurifoliate,point,pore,poricidal,porrect-incurved,present,rachi,rarely,readily,reduced,ruit,scandent,seudostipule,similar,simple,slender,small,strigo,strong,strongly,tal,tamen,tawny,tem,terminal,tightly,tyle,uniseriate,unit,upright,usually,ventral,whitish,ympodial	calyx,color,corolla,distally,form,fruit,growth,height,history,length,life,midpoint,midrib,midvein,na,ovary,perennial,plant,pubescence,ray,reproduction,seed,shape,size,staman,stellae,stem,stipe,style,texture,vein,width
105	wfo-0001026501	success	195	126	98	97	28	0.503	-1.7,.1,.5,.6,/3,0.05-0.3,0.1,0.27-0.7,0.5-0.6,0.5-1,0.6-1.1,0.6-2,0.9-2.2,1,1-2,1-2.5,1.8-2.2,1/4,2.5-4,2.8-3,3.5-4,6-9,7-9,?,abaxially,acute,anther,apex,apically,apparently,base,berry,branched,brown,calyx,chartaceous,cm,color,cuneate,deltate,densely,diameter,dull,elliptic,elongated,entire,filament,flattened-reniform,flower,fruit,glabrous,gray,green,leaf,length,light,lobe,lobed,long,margin,mauve,midpoint,mm,moderately,orange-brown,orbicular,ovate,pale,petiole,porrect,ray,rounded,shoot,short,shorter,shrub,sometimes,sparsely,spherical,spreading,stalk,stalked,stellate,stellate-pubescent,stem,style,surface,terminal,tip,trichome,tube,unarmed,upper,vein,way,white,wide,yellow	-3,.35,.7,0,0-1,0-2,0.2-1.8,0.5,0.5-0.9,0.6-1,1/2-2/3,1/6-1/2,2-10,3-4,3-5,3-9,4-5,4-7,5-merous,acicular,almost,alyx,apar,apart,articulated,bark,becoming,blade,borne,brown-green,concolorous,curved,discolorous,drying,eaf,eed,elongating,equal,erect,eye,filiform,filiform-acuminat,flattened,free,fruiting,glabrou,infructescence,known,longer,lower,mature,naked,nflorescence,often,older,one,open,orolla,oung,pair,pedicel,peduncle,pendulous,per,perfec,pericarp,plurifoliat,poricidal,portion,prickl,prickle,prickly,primary,reddish,ruit,scandent,scar,sessile,simple,slender,small,smooth,somewhat,spaced,straight,subsessile,tamen,tapering,terete,time,unarme,unit,variously,vary,visible,yellow-green,ympodial	branching,corolla,filiform-acuminate,form,growth,height,history,inflorescence,lateral,life,midrib,midvein,na,ovary,perennial,perfect,plant,pubescence,reproduction,seed,shape,size,staman,stellae,stigma,stipe,texture,width
106	wfo-0001026503	success	269	133	109	160	24	0.405	.3,.5,0.3–0.6,0.4–1.2,0.6–1.0,0.7,0.8–1.1,1.0–1.6,1.0–3.5,1.3–1.6,1.4–2.3,1.5–2.0,1.9–5.5,2.2–2.5,2.2–2.8,2.2–6.3,2.6–2.9,22,2–3,3,3.0–4.5,4.0–12.0,5,8.2,9.0–1.0,abaxially,acute,adaxially,aequilateral,anther,apex,apiculate,attachment,attenuate,base,branching,brochidodromous,brown,calyx,chartaceous,cm,corolla,deltoid,diameter,dry,eglandular,entire,filament,flattened-orbicular,flattened-reniform,flower,fruit,glabrous,glandular,globose,hair,homostylous,lanceolate,lateral,leaf,lobe,long,many,margin,mature,midrib,midvein,minute,mm,moderately,notched,oblique,oblong,ovate,petiole,point,pubescence,pubescent,raised,red,red-brown,reddish,rotate-stellate,rounded,scattered,short,shortly,shrub,simple,sinuate,small,sparsely,stem,stigma,style,subacute,time,tip,tree,tube,vein,weakly,white,wide,yellow,yellow-ferruginous,yellow-tan,young,×	.6,.9,0.03,0.3–,0.6–0.7,0.7–3.7,0.8–1.7,0.8–3.5,1.0–1.5,1.1–1.4,1.3,1.3–3.7,1.4–1.7,1.5–1.8,1.5–2.5,1.7,1/3,1/3–1/2,1/4–1/3,2.3–2.6,4.7,4.8,4.9–5.8,5-merou,5.0,6.0,6.9–10.3,7–10,90°,acuminate,adnate,ag,always,alyx,anthesi,apart,apical,apparently,appearing,arching,around,articulate,axe,ba,bark,becoming,bent,berry,blade,branch,bud,capitate,central,channeled,dentate,depression,developed,development,difoliate,directed,distal,distally,eaf,edge,eed,either,emerging,endocarp,exocarp,extending,extra-axillary,fertile,filiform,flattened,flexed,free,geminat,glabrou,glossy,gradually,gree,green,increasing,intact,internode,interpetalar,intersepalar,irregularly,juic,lackin,lacking,layer,lon,lower,lying,major,minor,moderate,near,nearly,nflorescence,obviously,ocasionally,occasionally,opaque,orolla,outline,oval,pale,pedicel,peduncle,per,perforated,pore,portion,potentially,present,reflexe,remaining,rigid,row,ruit,scarcely,shallow,side,sinus,slightly,sloughing,smoot,spaced,sparse,splitting,spread,spreading,stamen,stellate,stipitate,straight,surface,suture,tamen,tem,thin,though,tissue,transparent,truncate,two,ud,unarmed,upper,usually,vary,well,without,yellowish,ympodia,±equal,±smooth,±straight	5-merous,color,form,growth,height,history,inflorescence,length,life,midpoint,na,ovary,perennial,plant,ray,reproduction,seed,shape,size,staman,stellae,stipe,texture,width
107	wfo-0001026513	success	138	87	56	82	31	0.406	0.8-2,1-1.5,1-3,2-5,3-5,3-6-flowered,4-5,7-9,8-16,acute,anther,apex,apiculate,base,broadly,calyx,cm,completely,corolla,deltoid,dia,elliptic,filament,flower,fruit,glabrous,globose,green,lanceolate,lateral,leaf,lobe,lobed,long-styled,minute,minutely,mm,ovary,pair,petiole,plant,short-styled,shrub,simple,slender,small,stem,stigma,style,surface,tip,treelet,tube,vein,white,x	.1,.25,.3,.75,/3,2-2.2,6-8,anthesi,area,ba,bark,berry,caly,closely,darkish,decurrent,deflexed,delicate,differentiated,dry,eaf,edicel,eed,erect,except,exserted,free,fruiting,gre,hirsute,immature,known,leave,less,live,long,longer,lower,main,mature,middle,much,nflorescence,obscure,older,opposite,overlappin,pale,papillose,pedicel,pore,poricidal,portion,prominent,raised,reflexed,rest,ruit,scar,shaped,shiny,somewhat,soon,spaced,specimen,straight,styl,tall,tear-drop,trichome,ud,undersurface,unifoliat,uniseriate,unit,venation,way,wide,widest,woody,ympodial,young	/,0.25,1,3,branching,color,diameter,form,growth,height,history,inflorescence,length,life,margin,midpoint,midrib,midvein,na,perennial,pubescence,ray,reproduction,seed,shape,size,staman,stellae,stipe,texture,width
108	wfo-0001026529	success	219	95	78	141	17	0.356	0.3-1,0.5-4.5,1-2,1.1-2.5,1.5-2.5,10-28,11-14,3-5,4-8,5-15,5-9,6-20,abaxially,adaxially,anther,attenuate,blue,brownish,chartaceous,cm,condition,corolla,creamy,dark,deep,densely,diameter,drying,faintly,filament,flower,forked,fresh,fruit,glabrous,globose,green,greenish,hair,herb,length,light,like,lilac,lobe,long,medium,membranous,midrib,minutely,mm,moderately,odd-pinnate,ovoid,pentagonal,perfect,petiole,plant,puberulent,pubescent,pure,rarely,ripe,seed,shape,size,slightly,stem,stigma,style,substellate,tip,tube,white,whitish,x,yellow,yellowish	0-25,1,1-10,1-3,1-4.5,1.5-4,10,12-22,120-210,2,2-5,2-7.5,20-60,3-12,3-6,3-9.5,5-17,5-merou,50-70,600-950,?,acumen,acuminate,acute,ag,along,alyx,apart,apex,apparently,articulated,axe,axillary,base,berry,blade,broadly,bud,capitat,cell,ciliate,clavate,connivent,cordate,covering,digestion,distal,dorsally,dot,eaf,edge,eed,elliptic,enzyme,erec,especially,exceeding,except,flat,folded,geminat,generally,glabrou,gland,glandular,greatly,gree,green-white,hair-like,hal,half,head,homostylous,honeycomb-shaped,interjected,lanceolate,lateral,leaflet,lengthening,living,longer,lower,lunate,make,margin,mucilaginous,narrowly,nflorescence,non-glandular,oblique,often,orbicular,orolla,ovate,pair,pedicel,peduncle,petiolulate,petiolule,plurifoliate,pore,poricidal,proximal,reduced,removed,rounded,ruit,scattered,sessile,seudostipule,short,slit,spaced,specimen,stamen,ste,straight,subequal,subsessile,subtending,tall,tamen,tem,terminal,testal,tetralobulate,thick,throughout,tri-,trichome,typically,unit,unwinged,usually,vary,varying,wall,wet,wide,wing,ympodial	branching,calyx,color,form,growth,height,history,inflorescence,leaf,life,na,ovary,perennial,pubescence,reproduction,staman,texture
109	wfo-0001026534	success	150	92	64	86	28	0.427	0.5-1,1-2,1.5-6,2-2.5,2-3,2-7,2.5-15,3-25,3-4,3-5,3.5-4,4-10,5-6,6-35,7-40,abaxially,acuminate,acute,adaxially,apex,apiculate,auriculate,basal,base,branched,calyx,chartaceous,cm,cordate,densely,diameter,ellipsoidal,entire,flattened,fruit,glabrous,lobe,margin,mm,moderately,narrowly,orange,ovate,ovoid,pale,perfect,petiole,pinkish,puberulent,pubescent,purple,red,sparsely,stellate,stigma,style,tip,tree,triangular,tube,unbranched,white,x,yellow	-1.5,1-2.5,1-3,1.5-9,10-15,10-20,10-50,15-50,2-8,2.5-4,3-,3-10,4-foliat,4.5-5,7-12,absent,aggregate,apart,ape,articulated,axe,beyond,blade,bright,cell,connective,connivent,cylindrical,darker,deltate,directed,distally,eaf,eed,eglandular,equal,exserted,fleshy,flower,glandular,hair,lanceolate,leaving,lemon-yello,lon,long,longitudinal,lower,m.,nflorescence,nther,obtuse,often,orolla,pedicel,pedicellar,peduncle,pore,presen,puberulen,rachi,radiu,remnant,ruit,shorter,simple,slightly,small,spaced,stamen,stone,stripe,subcoriaceous,tal,tem,thecae,time,tomento,truncat,truncate,ud,unit,vary,vein,wide,ympodial	anther,branching,color,corolla,filament,form,growth,height,history,inflorescence,leaf,length,life,midrib,na,ovary,perennial,plant,pubescence,reproduction,seed,shape,size,staman,stem,surface,texture,width
110	wfo-0001026535	success	248	114	102	146	12	0.411	.5,0.7-1.5,1,1.2-2,1.3,1/2-2/3,1/3,2-3,2-5,3,3-4.5,3.5-4,5-7,7-8,abaxial,abaxially,acute,adaxially,age,almost,alternate,anther,anthesi,apex,apparently,base,becoming,berry,black,brachyblast,branched,branching,brown,calyx,chartaceous,cm,condensed,corolla,cuneate,dark,dendritic-pubescent,dense,developed,diameter,dorsal,drying,elliptic,elongated,entire,fine,flat,fruit,glabrous,leaf,length,liana,like,lobe,lobed,lower,margin,membranous,midvein,mm,network,obovate,orange-brown,ovate,ovoid,pair,partly,petiole,primary,prominent,pubescent,raised,rarely,rounded,short,shrub,side,sinus,stem,stigma,style,tearing,terminal,tertiary,tip,trichome,truncate,tube,unarmed,unevenly,vein,venation,violet,visible,white,x,yellowish,young	.1,.2,.4,.8,0-0.5,0.1-0.2,0.15,0.2,0.2-0.3,0.2-1.5,0.5-1,1-2,1-3,1-5,1.5-2,1.5-3,2.5,3-5,4-15,5-10,5°,absent,accrescent,along,alyx,apar,apically,area,around,articulated,bark,branch,broadly,clavate,clearly,clustered,concolorous,conical,cup,cupular,curved,deeply,delineate,delineated,deltoid,dendritic,detaching,developing,dilated,discolorous,distributed,divided,domatia,dry,eaf,eed,ellipsoi,equal,evenly,except,eye,fertilisation,filament,flexuous,flower,forming,free,frui,fruiting,green-brown,increasing,inside,known,leave,lengthening,linear,lon,long,loop,loose,m.,main,marginal,minute,minutely,mostly,much,naked,nflorescence,nther,number,oblong,obscure,older,orolla,outside,papillo,pedicel,peduncle,pendulous,perfec,pericarp,plant,plurifoliat,pointed,pore,poricidal,portion,protruding,rachi,ray,reaching,ridged,ruit,scar,secondary,see,simple,slender,slightly,smaller,smooth,soon,spaced,sparsely,spreading,stump,surface,terete,thin,tissue,toward,translucent,tufted,two,ud,uneven,unit,unlignified,vary,weakly,wide,widely,wider,ympodial,youngest	color,form,growth,inflorescence,na,ovary,perfect,pubescence,reproduction,shape,size,texture
111	wfo-0001026538	success	226	96	75	151	21	0.332	-3.5,-5.8,.5-3,0.1-0.3,0.6-0.8,0.8-1.2,0.9-1.2,1-1.9,1-3,1.2-1.5,1.3-2.8,1.4-2.6,1.7-2.5,12-21.5,3.2-4.8,3.5-4.6,4-8,5,6-13,anther,black,branched,broadly,brown,brown-black,calyx,cm,corolla,deltoid,diameter,drying,elliptic,filament,fruit,glabrous,globose,gray,green,hair,leaf,length,lobe,long,many,mm,mostly,obovate,ovate,pale,perfect,porrect-stellate,pubescence,rarely,rather,reticulate-punctate,scabridulous,shrub,small,stellate,stem,stigma,style,suborbicular,surface,terete,thin-textured,time,tree,tube,white,wide,x,yellow,yellowish,yellowish-tan	/15-1/9,0-160,0.3-1.5,0.4-,0.8-1.5,0.8-2.2,1-2.5,1.2-1.4,1.2-2.6,1.4-3,1.5-2.5mm,1.8-4.6,1/2,2-3.5,2-5,2.1-3.2,2.1-3.4,3-4,3.5-5.8,3.7-5.8,6.3-8.9,6.7-,8-10,8.1-14.8,[,],abaxially,accrescent,acuminate,acute,adaxiall,adaxially,ag,along,anthesi,apart,apex,apparently,appearing,around,articulated,axe,axillary,ba,bark,base,berry,blade,blunt-tipped,branch,bud,capitat,chartaceous,closely,completely,constricted,covering,cylindrical,decurrent,dense,densely,directed,distally,due,eaf,edge,eed,entire,enveloping,exserted,farinose,fleshy,flower,free,frui,fruiting,glabrescen,glabrou,inserted,lackin,lanceolate,lateral,lengthening,lobed,long-attenuate,long-stalked,longer,longitudinal,lower,main,margin,measured,midrib,mixed,multangulate,nearly,nflorescence,obscured,obtuse,occasionally,older,orolla,ovate-lanceolate,overlapping,pedicel,peduncle,petiole,plurifoliate,pore,poricidal,porrect-stellat,pseudo-terminal,pubescent,rachi,ruit,runk,semi-ovate,sessile,short,short-stalked,side,simple,slightly,slit,sometimes,somewhat,soon,spaced,stamen,subcampanulate,subconical,suture,tall,tamen,thick,thickened,tip,tomentose-pubescent,tomentu,touching,ud,unarme,unarmed,unit,usually,vary,vein,way,weakly,ympodial,young	0.4-1.5,branching,color,form,growth,height,history,inflorescence,life,na,ovary,perennial,plant,pseudoterminally,reproduction,seed,shape,size,staman,texture,width
112	wfo-0001026539	success	194	105	71	123	34	0.366	0.2,2.5,5.5,abaxially,acuminate,acute,adaxially,anther,apex,apiculate,base,branched,brown,calyx,chartaceous,cm,corolla,creamy,deltate,densely,diameter,entire,filament,flattened-reniform,flower,fruit,glabrous,globose,growth,height,lance-elliptic,lateral,leaf,lobe,long,long-attenuate,margin,midrib,minutely,mm,narrowly,oblanceolate,occasionally,orange,perennial,petiole,pilosulose,pitted,puberulent,pubescent,red,short,side,sinuate,staman,stellate,stem,stigma,strongly,style,surface,time,tip,triangular,tube,usually,vein,vine,white,wide,yellow	-6,.5,0,0.25,0.3-0.5,0.5,0.9,1,1-1.5,1-2-celled,1.5–2,10–15,10–28,15–20,1–2,2,2-4-celled,2.5–4,20,20–35,2–2.5,2–3,2–4,2–5,3,30,3–5,4–6,5,5–,5–10,6–15,absent,ag,always,alyx,anthesi,approximately,armed,articulated,axe,ba,basal,becoming,berry,blade,broadly,bud,campanulate,capitat,cell,clustered,connivent,cucullate,dr.,eaf,early,eed,ellipsoid,elongate,elongating,equal,exserted,four,glabrou,hair,hooked,ine,interpetalar,larger,lengthening,lobed,long-styled,longer,lower,major,nearly,nflorescence,often,one,orolla,pair,pedicel,peduncle,pericarp,pointed,pore,poricidal,present,prickle,pustulate,rachi,recurve,recurved,robust,rounded,rugose,ruit,sessil,shallow,shoot,simple,slender,slightly,slit,somewhat,spreading,stout,straight,subwoody,tamen,tapering,terminal,terminally,tissue,trichome,tub,unequal,vary,winged,woody,young,×	0.25-0.9,1.5-2,10,10-28,2-4,2.5-4,20-35,3-5,30-20,4-6,5-10,5-5.5,branching,color,form,history,inflorescence,length,life,midpoint,midvein,na,ovary,plant,pubescence,ray,reproduction,seed,shape,size,stellae,stipe,texture,width
113	wfo-0001026604	success	192	104	92	100	12	0.479	.4,.5,0.8-0.9,1-1.2,1.2-1.7,1.5-2,1.5-9,10-30,2-2.3,2-2.5,2.3-3.5,3-3.5,3-5,4-4.5,4.5-7,5,5-7,acuminate,along,anther,apex,articulated,articulation,bark,base,berry,branching,brown,c.,calyx,cm,cordate,corolla,dark,diameter,distal,ellipsoid,entire,flattened,fruit,glabrous,globose,growth,inflated,liana,lobed,margin,midrib,minute,minutely,mm,narrowly,new,nodding,oblique,ovary,ovate,ovoid,pair,pale,pedicel,peduncle,petiole,pitted,primary,pubescent,purple,quarter,red,reddish,reniform,ripe,shape,shrub,simple,somewhat,stellate,stem,stigma,style,surface,time,trichome,truncate,tube,uniseriate,vein,vining,violet,way,woody,x	.75,0,0.1,0.4-0.6,0.8-1,1.1-1.3,3.5-4,50-100,<,?,absent,age,aid,always,anthesi,apart,appearing,atop,basal,brow,capitate,cell,clearly,climbing,comical,conical,cucullate,cupped,deflexed,densely,differentiated,distinct,drying,due,eaf,eed,elongate,expanding,exserted,filament,flexuous,flower,free,fruiting,later,leaf-opposed,leaving,lengthening,lobe,lower,mere,nflorescence,occasionally,older,outline,overall,papillo,papillose,part,particularly,peg,per,perfect,pericarp,planar,plurifoliat,poin,point,pore,poricidal,portion,receptacle-like,rim,ruit,scar,series,shiny,sinuate,slender,slightly,slit,spaced,stout,strongly,structure,support,swolle,terminal,testal,thin,tip,tub,twisting,ud,undulation,unit,upper,widely,ympodial,½	bud,color,form,inflorescence,leaf,length,na,pubescence,seed,size,texture,type
114	wfo-0001026606	success	213	99	64	149	35	0.3	0.4-0.8,1.3-1.9,1.4-2.1,1.7-2.1,12.5-22.5,2-3,3-4.6,3-6,abaxially,acute,along,apex,asymmetric,berry,black,branched,broadly,central,chartaceous,closely,cm,densely,diameter,filament,flower,fruit,glabrate,glabrous,globose,golden,lenticular,lobe,minutely,mm,nerve,ovate,pentagonal,perfect,petiole,pitted,puberulent,pubescence,pubescent,ripe,scabrous,shrub,small,stellae,stellate,stellate-pubescent,stelliform,stem,stigma,style,surface,tan,thickened,tree,tube,white,wider,woolly,x,yellow	0.5-1.6,0.5–0.8,10–20,12-17,15–20,15–25,1–1.5,1–3,2.4-3.6,2–2.5,2–4,3–10,3–4,3–5,3–6,4.2-5.2,4–20,4–7,5-merou,5.8-7.2,5–15,6–7,6–8,7.3-9.7,7–12,8–10,abaxial,abaxiall,absent,adaxial,adaxially,almost,alyx,an¬ther,apart,apiculate,apparently,armed,articulated,asymmetrically,axe,ba,band,base,based,blade,blunt-tipped,broad,capitat,coarsely,compressed,concentrated,cordate,cylindrical,developed,difoliate,directed,distally,eaf,eed,entire,eventually,expanded,extra-axillary,forming,geminat,glabrou,hair,homostylous,initially,internode,interpetalar,lanceolate,larger,lateral,laterally,lighter,linear,lon,long,low,lower,main,margin,midpoint,midvein,moderately,much,nearly,nflorescence,obsolete,obtuse,occasionally,often,of¬ten,older,open,orolla,pedicel,peduncle,peripherally,persistently,pore,present,prickle,prickly,pubescen,rachi,rarely,ray,rayed,recurved,reduced,rounded,ruit,scar,scattered,sessile,short,shortly,simple,slightly,sometimes,spaced,sparingly,sparsely,spreading,stout,subentire,tall,tamen,tapering,tem,thick,three,tissue,toothed,truncate,unarmed,usually,vary,vein,warty,weakly,wide,widely,yello,ympodia,young	0.5-0.8,1-1.5,1-3,10-20,15-25,2-2.5,3-10,3-4,4-20,6-7,8-10,anther,branching,calyx,color,corolla,form,growth,height,history,inflorescence,leaf,length,life,midrib,na,ovary,perennial,plant,reproduction,seed,shape,size,staman,texture
115	wfo-0001026607	success	204	113	89	115	24	0.436	0.1-0.3,0.8-3.4,0.8-5,1-2,1-5,1.5-4,2-10,2-2.5,2.4-5.8,2.5-3.8,3-8,4-10,4-6,5.8-19.8,6-10,abaxially,acute,adaxially,along,anther,apex,attenuate,base,basiscopic,brownish,chartaceous,ciliate,cm,coarse,condition,corolla,decurrent,deep,diameter,dot,drying,especially,filament,finely,flower,forked,fresh,fruit,glabrous,globose,green,greenish,hair,herb,lateral,leaf,like,lobe,long,margin,medium,membranous,midrib,minutely,mm,moderately,obtuse,odd-pinnate,often,ovoid,pentagonal,perfect,petiole,plant,puberulent,pubescent,ripe,rounded,scattered,seed,sessile,side,simple,size,stem,stigma,style,tip,tube,violet,white,whitish,x,yellow	0-3,0-4,0.3-1.8,0.5-5.8,0.8-4.5,1-10,1-3.8,1-8,10-30,2-3,2.7-19,5,5-merou,absent,acumen,ag,alyx,apart,apparently,articulated,axe,axillary,berry,blade,bud,capitat,cell,clavate,clearly,connivent,covering,decreasing,digestion,distal,dorsally,eaf,edge,eed,elliptic,enzyme,exceeding,flat,folded,forming,geminat,generally,glabrou,greatly,gree,green-white,hair-like,hal,half,high,homostylous,honeycomb,interjected,lanceolate,larger,leaflet,lengthening,living,lower,make,marked,minute,much,mucilaginous,nflorescence,orbicular,orolla,ovate,pair,pedicel,peduncle,petiolulate,plurifoliate,pore,poricidal,present,rachi,rarely,removed,rosette,ruit,semierec,seudostipule,shaped,short,slit,sometimes,spaced,specimen,stamen,ste,straight,subtending,tall,tamen,tem,terminal,testal,thick,throughout,toward,tri-,typically,unit,unwinged,usually,vary,wall,wet,without,ympodial	branching,calyx,color,form,growth,height,history,inflorescence,length,life,midpoint,midvein,na,ovary,perennial,pubescence,ray,reproduction,shape,staman,stellae,stipe,texture,vein
116	wfo-0001026613	success	159	81	61	98	20	0.384	0.6,1-2,11-19.5,2.3-8,2.5-2.8,4-5,4.5-8.5,5-6,5-7,6-12,6-8,6.2-9.5,8.5-10,8.5-9,9.5-13.5,abaxially,adaxially,anther,apparently,attenuate,berry,chartaceous,cm,corolla,densely,diameter,filament,flower,forked,fruit,glabrous,green,herb,lateral,leaf,leaflet,lobe,long,m-1.2,membranous,midrib,minutely,mm,mottled,odd-pinnate,pair,perfect,petiole,plant,puberulent,pubescent,purple,rotate-pentagonal,size,stem,stigma,style,terminal,tube,x,yellow	0.5-1,1-10,1.5-4,2-7.5,3-10,3-5,5,5-merou,5.5-7,8-18,absent,acumen,acuminate,ag,along,alyx,apart,apex,articulated,axe,axillary,base,blade,borne,bud,capitat,ciliate,conical,connivent,cordate,decreasing,distal,dorsally,eaf,edge,eed,end,erec,especially,flat,folded,geminat,generally,greatly,hair,hal,half,homostylous,immature,interjected,lanceolate,larger,lengthening,like,lower,margin,mature,middle,minute,nflorescence,orolla,ovate,pedicel,peduncle,petiolule,plurifoliate,pore,poricidal,proximal,pubescen,ruit,secondary,semierect,seudostipule,singly,slit,spaced,sparsely,ste,stolo,subequal,subtending,symmetrical,tall,tamen,tem,tip,toward,tri-,tuber,typically,unit,unknow,unknown,unwinged,usually,vary,ympodial	branching,calyx,color,form,growth,height,history,inflorescence,length,life,na,ovary,perennial,pubescence,reproduction,seed,shape,staman,surface,texture
117	wfo-0001026614	success	200	132	94	106	38	0.47	.8,0.2,0.4-0.7,1.3-1.8,2.2,2.5,4-7,5,abaxially,acuminate,acute,adaxially,anther,apex,base,berry,black,brown,calyx,cm,commonly,dark,densely,diameter,dried,entire,especially,evenly,filament,flattened-reniform,flower,foveolate,fruit,glabrescent,glabrous,gland-tipped,globose,golden,hair,interpetalar,irregularly,lanceolate-attenuate,lateral,leaf,less,lobe,lobed,margin,midpoint,midvein,minute,minutely,mm,mottled,oblique,often,orange,orange-red,ovate,ovate-lanceolate,pair,perfect,petiole,pubescence,pubescent,ray,repand,ripe,rotate-pentagonal,rounded,scattered,sessile,shallowly,shrub,simple,smaller,sometimes,soon,sparsely,stellae,stellate,stellate-pubescent,stem,stigma,style,surface,tissue,tube,usually,vein,white,x,yellow,yellowish	0.2–0.3,0.5,0.5–2,1-,1.5–2,11-15,15–30,1–2,1–3,1–5,2.2-5.5,2.5–3,20–25,2–4,2–4-branched,2–6.5,3-foliate,3.2-5.2,3–10,4.5–11,4.5–5.5,5-merou,5.3-8.2,50,6.4-8.4,6–8,7.2-9.8,8–10,9–16,>,absent,across,adaxiall,alyx,apart,apparently,armed,articulated,axe,ba,blade,blunt-tipped,broad-based,campanulate,capitat,chartaceous,clavate,closely,concentrated,cylindrical,denser,developed,directed,distally,eaf,eed,erect,expanded,extra-axillary,fleshy,fruiting,geminate,globo,homostylous,internode,linear,lon,long,lower,nearly,nflorescence,obtuse,orolla,ovoid,pedicel,peduncle,per,pore,prickle,rachi,rarely,reflexed,ruit,shin,side,similar,slightly,somewhat,spaced,spreading,tall,tamen,tapering,tem,time,tissu,ud,unarme,unarmed,vary,weakly,well,wide,ympodia,young,–5	0.2-0.3,0.5-3,1-2,1-3,1.5-2,15-30,2-4,2-4-branched,2-6.5,2.5-3,3-10,4.5-11,4.5-5.5,8-10,branching,color,corolla,form,growth,height,history,inflorescence,length,life,midrib,na,ovary,perennial,plant,reproduction,seed,shape,size,staman,stipe,texture,tip,width
118	wfo-0001026632	success	108	84	51	57	33	0.472	.5,0,1-2,3-4,7,abaxially,abundantly,acuminate,acute,adaxially,anther,apex,base,broadly,cm,condensed,cyme,densely,diameter,divided,elliptic,exposed,extra-axillary,filament,flower,glandular,hair,halfway,height,lateral,leaf,lobe,long,margin,mm,moderately,ovate,petiole,pubescent,ray,rounded,shrub,stellate,stellate-pubescent,stigma,style,triangular,truncate,tube,unknown,x	1.5,10-12,5-merou,6,acumen,alyx,armed,ba,blade,bu,capitat,cell,central,commonly,developed,eaf,eed,equal,erect,flattened,geminat,interacuminal,lamina,lanceolat,less,little,lon,lower,minute,nflorescence,orolla,pedicel,peduncle,porrect-stellate,prickle,prickly,prominent,reddish-brown,ruit,scarcely,sessile,shallow,short,simple,sinus,straight,structure,tamen,tem,tissue,toward,unarme,unknow,vary,well,ympodial,young	branching,bud,calyx,color,corolla,dense,form,fruit,growth,history,inflorescence,length,life,midpoint,midrib,midvein,na,ovary,plant,pubescence,reproduction,seed,shape,size,staman,stellae,stem,stipe,surface,texture,tip,vein,width
119	wfo-0001026642	success	193	93	53	140	40	0.275	0.25,0.5,6,acute,annual,anther,bipinnate,black,blue,brown,calyx,cm,cylindrical,dark,diameter,filament,flattened,fruit,glabrous,globose,green-purple,hair,herb,lavender,leaf,length,lilac,lobe,long,mm,multicellular,pale,pentagonal,perennial,perfect,pinnate,pitted,pubescent,shallowly,simple,sparsely,stigma,straight,style,subglabrous,surface,time,tip,tube,uniseriate,violet,x,yellow	.05,.1,.8,0.1,0.1–0.3,0.2,0.4,0.4–2.2,0.5–,0.5–0.7,0.5–1.7,0.5–2.0,0.5–3.5,0.6,0.6–1.0,0.75–1.0,0.75–2.0,0.7–1.6,0.8–1.2,1.0,1.0–2.0,1.2–1.7,1.2–2.0,1.2–3.5,1.2–6.2,1.6–8.0,1.9–3.0,12–30,1–10,1–3,2.0–4.0,2.5–3.5,2.5–4.0,2.8–3.0,3.0–5.1,3–5,4.0–6.0,4–7,5,5.0–7.0,50–100,<,abaxial,abaxially,adaxiall,adaxially,ag,along,anthesi,apart,apex,appressed,articulated,axe,axillary,ba,base,blade,borne,branched,cell,chartaceous,circular,clavate,connivent,decreasing,decumbent,densely,denser,divided,eaf,eed,either,elliptic,equal,erect,fleshy,flower,geminat,glabrescen,gland,glandular,half,indumentum,lon,longitudinal,lower,m.,moderately,narrow,nflorescence,number,oblong,obtuse,occasionally,often,opening,orolla,ovate,pair,pedicel,peduncle,petiole,pinnae,pore,poricidal,present,primary,probably,rapidly,rounded,ruit,secondary,sessile,shoot,side,slit,sometimes,spaced,stone,tal,tamen,tem,unicellular,unifoliate,unit,usually,vary,vein,white,wide,wing,woody,ympodial,–1.2,–11.0,–2.0,–4.5,–6,–7	0.1-0.3,0.5-0.7-1.2,0.5-2.0,0.5-8.0,0.6-1.0,0.75-1.0,0.75-2.0,0.8-1.2,1-3,1.2-1.7,1.2-2.0,1.2-3.5,1.2-6.2,2.0-4.0-4.5,2.8-3.0,3.0-5.1-11.0,4.0-6.0,5.0-7.0,50-100,branching,color,corolla,form,growth,height,history,inflorescence,life,na,ovary,plant,pubescence,reproduction,seed,shape,size,staman,stem,texture,width
120	wfo-0001026651	success	222	98	65	157	33	0.293	1.8,3,acuminate,acute,anther,apex,attenuate,base,berry,brownish-green,calyx,chartaceous,cm,cyme,densely,diameter,dull,entire,filament,flattened,flower,fruit,glabrous,globose,green,herb,lanceolate,lateral,leaf,length,lobe,margin,midrib,mm,moderate,moderately,narrowly-elliptic,ovate-lanceolate,ovate-reniform,perfect,petiole,plant,pubescence,pubescent,revolute,rounded,seed,shape,shrub,size,slightly,sometimes,stellate,stem,stigma,style,surface,translucent,unbranched,undulate,vein,visible,white,yellow,×	-celled,0.2–1.3,0.35–2.6,0.9–3,1,1–2,2.2–10,2.8,2–11.5,2–13,2–3,2–3.3,2–4,2–4.5,2–8,3-plurifoliate,3–5,3–7,4,4–6,4–7.8,5-merou,6–10,6–14,8,abaxially,absent,accrescent,adaxiall,adaxially,along,alyx,anisophyllous,antror,antrorse,antrorsely,apar,appressed,arcuate,ark,articulated,asymmetric,axi,beneath,beyond,branch,broadly,brochidodromous,brown,capitat,capitate,cell,ciliate,circular,connivent,cordate,cylindrical,dark,decumbent,decurrent,differing,directed,discolorous,drying,eaf,eed,elliptic,emarginate,equal,erect,exfoliating,exserted,eye,flexuous,frui,geminate,geniculate,glabrescent,glabrou,glandular,growt,hair,head,highly,hilum,hollow,impressed,introrsely,less,light,like,long,longitudinal,lower,lying,major,markedly,matte,membranaceous,minor,mostly,much-branched,multicellular,naked,new,nflorescence,normally,oblong-ellipsoid,obtuse,older,one,onto,opening,orolla,ovate-deltate,parallel,pedicel,peduncle,pedunculate,per,pore,poricidal,prominent,reduce,region,ripe,ruit,secondary,shiny,similar,simple,single-celled,slit,small,smaller,spaced,stalk,stamen,straight,sub-opposite,subapical,tall,tamen,tem,terminal,trichome,turning,uniseriate,unit,upper,usually,vary,venation,wide,woody,ympodial,young	0.9-3,1-2,2-11.5,2-13,2-3.3,2-4.5,3-7,4-6,4-7.8,6-10,branching,color,corolla,form,growth,height,history,inflorescence,life,midpoint,midvein,na,ovary,perennial,ray,reproduction,staman,stellae,stipe,texture,tip,tube,width
121	wfo-0001026656	success	211	76	58	153	18	0.275	1-1.8,1-2,1-3.8,1.5-7,2-6,2.5-17,20-60,4-10,4-13,4-8,5-18,5.5-27,9-11,anther,blue,brownish,chartaceous,cm,condition,corolla,densely,diameter,dot,drying,filament,flower,forked,fresh,fruit,glabrous,globose,green,greenish,herb,light,lobe,long,membranous,mm,moderately,mottled,odd-pinnate,ovoid,pentagonal,plant,pubescent,purple,rotate-pentagonal,scattered,seed,stem,style,subglabrous,tube,violet,white,whitish,wide	0-4,0.3-3,0.3-4.2,0.4-6.5,0.7-10.5,0.9-13,1,1-10,1-4,1-5,1.1-8.1,10,2-8,5,5-35,5-merou,abaxially,absent,acumen,acuminate,acute,adaxially,ag,along,alyx,apart,apex,articulated,attenuate,base,bearing,blade,borne,broadly,bud,capitate,cell,ciliate,clavat,connate,connivent,covering,cuneate,curved,dark,decurrent,digestion,distal,dorsally,eaf,edge,eed,elliptic,end,enzyme,erec,especially,exceeding,flat,folded,geminat,generally,glaucous,greatly,green-white,greenish-yellow,hair,hair-like,half,homostylous,honeycomb-shaped,interjected,lanceolate,larger,lateral,leaflet,lengthening,like,living,lower,lunate,make,margin,middl,midvein,minutely,mucilaginous,narrowly,nflorescence,non-glandular,oblique,occasionally,often,orolla,ovate,pair,pedicel,peduncle,petiole,petiolulate,petiolule,plurifoliate,pore,poricidal,puberulent,pubescen,rachi,ranging,removed,ruit,scale-like,seudostipule,short,singly,slightly,slit,sometimes,somewhat,spaced,specimen,stamen,star,ste,stigma,stolo,straight,subequal,subtending,symmetrical,tall,tamen,tem,terminal,tertiary,testal,therefore,thick,throughout,tinged,tip,tri-,truncate,tuber,typically,unit,unwinged,vary,wall,wet,wing,without,yellow,ympodial	branching,calyx,color,form,growth,height,history,inflorescence,leaf,length,life,ovary,perennial,pubescence,shape,size,staman,texture
122	wfo-0001026663	success	251	125	104	147	21	0.414	-2.9,/3,0-160,0.2-0.6,0.9-1.5,1-2.5,1-3.2,1.1,1.1-2.1,1.2-2,1.4-2.6,1.6-2.3,1/3,10-26,2-12,2.1-2.6,2.5-3.7,2.9-5,2/3,24-45,3.8-5.7,31,8-17,abaxially,acuminate,acute,adaxially,along,anther,apex,attenuate,base,branched,brown,calyx,cm,corolla,dark,densely,diameter,distributed,drying,echinoid,entire,filament,flower,fruit,glabrescent,globose,granular,green,hair,leaf,length,light,lobe,long,long-stalked,lower,many,margin,midrib,mm,multangulate,ovate,ovate-lanceolate,pale,perfect,petiole,porrect-stellate,pubescence,pubescent,rich,scabrous,sessile,short,short-stalked,shrub,simple,slightly,small,soon,spaced,sparsely,stellate,stem,stigma,style,subglabrous,time,tip,tomentose,tomentose-pubescent,touching,tree,tube,upper,vein,violet,way,white,whitish,x,yellow	-15,-8,-9.7,.5-2.5,/25-1/15,0.3-0.8,0.4-2.2,1,1-5,1.4-3.1,1.9-2.6,1/2,1/4-1/2,10.3-13.2,12-14,2.8-5.3,3-5,3.5-5,4.5-5.7,4.7-25.9,5-8,5.5-,5.5-8.8,7.5-9,accrescent,adaxiall,ag,angled,anthesi,apart,apparently,appressed,around,articulated,ascending,axe,axillary,bark,becoming,berry,blade,blunt-tipped,branch,broadly,bud,capitat,chartaceous,closely,completely,conical,constricted,covering,cylindrical,directed,distally,eaf,echinoi,echinoid-pubescent,edge,eed,elongated,enveloping,especially,evident,exserted,farinose,flared,fleshy,free,fruiting,glabrescen,glabrous,granular-tomentose,greenish-brown,grooved,immature,inserted,lanceolate,lateral,lengthening,less,line,lined,lobed,long-stalke,longer,longitudinal,longitudinally,m.,main,matur,midvein,minute,multangulate-pubescent,nearly,nflorescence,obtuse,occasional,occuring,older,opening,openly,orolla,ovate-lanceolat,pedicel,peduncle,persistent,plurifoliate,pore,poricidal,present,pseudo-terminal,rachi,rather,ray,ridged,robust,ruit,runk,side,slit,sometimes,somewhat,stalk,stalked,stamen,strongly,subcampanulate,subcoriaceous,subglobose,suture,tall,tamen,tangled,terete,thick,thin,tomentum,ud,unarme,unarmed,unit,usually,vary,wide,ympodial,young	5.5-9,branching,color,form,growth,height,history,inflorescence,life,na,ovary,perennial,plant,pseudoterminally,reproduction,seed,shape,size,staman,surface,texture
123	wfo-0001026686	success	196	101	75	121	26	0.383	.4,0.6-0.9,1-2,1.5-7,1.7-2.5,3-4,4-6,5-16.5,5-8,6.5-12.7,7-9,8-10,8-14,8-27,abaxially,acuminate,adaxially,anther,apex,base,berry,brownish,chartaceous,cm,condition,conical,corolla,densely,diameter,drying,filament,flower,forked,fresh,fruit,glabrous,green,greenish,herb,lateral,leaf,light,lobe,long,margin,midrib,minutely,mm,mottled,mucilaginous,obtuse,odd-pinnate,ovoid,perfect,petiole,plant,puberulent,pubescent,purple,purple-violet,ripe,rotate-stellate,round,seed,size,sparsely,stigma,style,tip,tube,wet,whitish,wide,x,yellow	0.2-0.5,1,1-10,1-2.5,1.2-3.4,1.2-3.6,10-28,2-10,2-9,2.4-3.6,2.5-8,3-5,3.7-8,5,5-merou,absent,acumen,ag,along,alyx,apart,apparently,articulated,axe,axillary,blade,borne,bud,capitat,cell,ciliate,connivent,covering,decreasing,digestion,distal,dorsally,eaf,edge,eed,elliptic-lanceolate,end,enzyme,equal,erec,especially,exceeding,flat,folded,geminat,generally,glabrou,gradually,green-white,hair,hair-like,half,homostylous,honeycomb-shaped,interjected,lanceolate,larger,leaflet,lengthening,like,living,lower,make,middle,minute,nflorescence,often,orbicular,orolla,ovate,pair,pedicel,peduncle,petiolule,plurifoliate,pore,poricidal,pubescen,removed,ruit,secondary,semierect,seudostipule,singly,slightly,slit,spaced,specimen,stamen,star,ste,stolo,straight,stripe,subequal,subsessile,subtending,symmetrical,tall,tamen,tem,terminal,testal,thick,throughout,toward,tri-,tuber,typically,unit,usually,vary,wall,white,wing,ympodial	branching,calyx,color,form,growth,height,history,inflorescence,length,life,midpoint,midvein,na,ovary,perennial,pubescence,ray,reproduction,shape,staman,stellae,stem,stipe,surface,texture,vein
124	wfo-0001026695	success	128	91	57	71	34	0.445	0.6-8,1-1.5,1-4,1.6,11-14,2-3,2.5-5.2,3-4,3-8,4,4-5,6-8,8-16,abaxially,acumen,acute,adaxially,apex,base,branched,calyx,cm,cordate,corolla,cuneate,cyme,diameter,dichasial,dichasially,ebracteate,filament,flower,forked,glabrescent,herbaceous,lateral,leaf,lobe,long,mm,monochasial,oblique,odd-pinnate,perennial,perfect,petiole,plant,pubescent,rounded,short-acuminate,simple,stellate,stigma,style,tuber-bearing,wide,yellow	1-2,2,2-6,2.5-3,2.5-7,3-6-foliat,4-5.5,6-12,6-7,6.5-13,8-17.5,absen,acuminate,apical,apically,articulate,compound,connate,decurrent,dehiscent,distal,dorsally,eaf,edge,eed,exceeding,flat,folded,generally,globo,half,interjected,introrse,leaflet,lon,lower,lunat,maturing,nflorescence,nther,often,one,orolla,ovate,ovate-lanceolate,pair,pedicel,peduncle,plan,poricidally,proximal,ruit,sessile,seudostipule,short,slit,stamen,straight,tal,tem,terminal,triangular,typically,unit,unknow,unknown,vary,whit,without,ympodial,¼	anther,branching,color,form,fruit,growth,height,history,inflorescence,length,life,margin,midpoint,midrib,midvein,na,ovary,pubescence,ray,reproduction,seed,shape,size,staman,stellae,stem,stipe,surface,texture,tip,tube,vein,white,width
125	wfo-0001026696	success	139	101	68	71	33	0.489	0.8-7,0.9-7.2,1,1-1.3,1-4,1.3-2.1,2-17,2-3,3-3.5,3-6,3-8.5,5-35,9,abaxially,acumen,acute,adaxially,apex,apiculate,base,branched,calyx,cm,corolla,cuneate,cyme,decurrent,densely,diameter,dichasial,dichasially,ebracteate,entire,filament,flower,forked,globose,green,green-white,herbaceous,lateral,light,lobe,long,margin,mm,monochasial,mucilaginous,oblong,obtuse,odd-pinnate,often,ovoid,perennial,perfect,petiole,plant,pubescent,rounded,seed,sinuate,stellate,stigma,style,throughout,white-cream,wide,yellow	0.3-4.5,1.5-3,3-17,3-6-foliat,4-16,apical,apically,articulate,broadly,cell,connate,covering,dehiscent,digestion,distal,dorsally,eaf,edge,eed,emoval,enzyme,exceeding,flat,folded,generally,globo,hair-like,half,honeycomb,introrse,lanceolate,light-yello,linear,living,lon,lower,lunat,make,maturing,nflorescence,nther,orolla,ovate,pattern,pedicel,peduncle,plan,poricidally,proximal,reveal,ruit,seudostipule,short,simple,slit,specimen,stamen,straight,tal,tem,testal,thick,throughou,tuber-bearing,typically,unit,vary,wall,without,ympodial,¼	anther,branching,color,form,fruit,growth,height,history,inflorescence,leaf,length,life,light-yellow,midpoint,midrib,midvein,na,ovary,pubescence,ray,reproduction,shape,size,staman,stellae,stem,stipe,surface,texture,tip,tube,vein,wet
126	wfo-0001026706	success	232	113	92	140	21	0.397	-3.1,.5,/14-1/6,0.2-0.3,0.8-1.2,0.8-1.5,0.9-2,1-2.2,1-5,1.1-4,1.5-3,12,14-32,2.2-3.3,2.5-3,3-4.6,3.1-3.8,3.6-5.7,4,4.2-12,5.3-6.4,7-16,acute,anther,apex,appearing,attenuate,base,blade,branched,calyx,cm,coriaceous,corolla,crisped,cuneate,dark,densely,diameter,entire,filament,fruit,glabrate,globose,golden,grayish,green,leaf,length,lobe,long,many,margin,midrib,mm,obtuse,occasionally,ovate,ovate-elliptic,ovate-lanceolate,perfect,petiole,pseudo-terminal,pubescence,pubescent,reddish,reticulate-punctate,semi-ovate,shrub,slightly,small,softly,stellate,stem,stigma,style,suborbicular,surface,tall,time,tip,tomentose-pubescent,tree,tube,velutinous,wavy,white,whitish,wide,x,yellow,yellowish-tan	-4.4,-5.5,-6.1,0-240,0.2-0.5,0.6-2.2,0.8-2.8,0.9-1.9,1/2-2/3,10-15,2.3-3.8,2.7-4,2.9-6,2/3-3/4,4.5-5.5,5-6.5,6-10,6-8,6.1-,8-14,9.8-15.4,abaxially,accrescent,adaxiall,adaxially,ag,anthesi,apart,apparently,around,articulated,axe,axillary,ba,bark,becoming,berry,blunt-tipped,branch,brown,bud,capitat,chartaceous,closely,completely,covering,cylindrical,dendritic-echinoid,dendritic-multangulate,directed,distally,eaf,edge,eed,enveloping,exserted,farinose,fleshy,flower,fourth,free,fruiting,furfuraceou,glabrous,hair,herbarium,indument,inserted,lackin,lacking,lanceolate,lateral,lengthening,lobed,long-stalked,longitudinal,lower,m.,main,matted,minute,mixed,multangulat,multangulate,nearly,nflorescence,oblong,obscured,often,older,orolla,pale,pedicel,peduncle,persistent,plurifoliate,pore,poricidal,porrect-stellate,rachi,rather,ruit,runk,sessile,short-,short-stalked,side,simple,slit,somewhat,soon,spaced,sparsely,specimen,splitting,stalked,stamen,strongly,subcampanulate,subconical,subglobose,sulcate,suture,tamen,thin-walled,tomentu,touching,translucent,transparent,ud,unarme,unarmed,unevenly,unit,upper,vary,vein,way,ympodial,young	abaxial,adaxial,branching,color,form,growth,height,history,inflorescence,life,ovary,perennial,plant,present,reproduction,seed,shape,size,staman,texture,width
127	wfo-0001026707	success	196	120	92	104	28	0.469	-1/3,.5,/3,0.05-0.15,0.3-0.8,0.5-1,0.6-0.7,0.7-1,0.7-1.5,1.5-1.8,1.6-2,1/3,1/8-1/4,11-16,2-2.3,2.5-4,3-4,3-4.5,3-7,3-8,4,5-10,?,abaxially,acute,anther,apex,apically,apparently,attenuate,base,berry,blade,branched,calyx,chartaceous,cm,color,densely,diameter,entire,eye,filament,flattened-reniform,flower,fruit,glabrous,green,lateral,leaf,length,lobe,lobed,long,longer,margin,mauve,midpoint,mm,moderately,naked,narrow-deltate,narrow-oblong,obtuse,orange-brown,petiole,ray,red-brown,reflexed,rounded,shorter,shrub,small,sometimes,spherical,spreading,stellate,stellate-pubescent,stem,stout,style,surface,terminal,time,tip,tree,tube,upper,visible,way,white,wide	-3,-5,.8,0,0-20,0.05,0.1-0.2,0.5-3,0.6-0.8,0.7-1.4,1-1.7,1-3,1-5,1/3-1/2,1/3-3/4,1/4-1/3,2-10,2-6,2.5-3,2.5-6,5-25,5-7,5-8,5-merous,8-15,alyx,apar,apart,articulated,bark,branche,broad-deltate,broadly,clustered,concolorous,connivent,curved,cuspidat,decurrent,discolorous,drying,eaf,eed,elongating,equal,erect,foliaceous,free,fruiting,fused,gently,glabrescent,glabrou,gray,inflated,infructescence,juvenil,known,less,lower,mature,nflorescence,older,one,open,orolla,oung,pedicel,peduncle,per,perfec,pericarp,plurifoliat,poricidal,porrect,porrect-lepidote,portion,prickle,prickly,pubescent,ruit,scar,sessile,simple,slender,smooth,spaced,sparsely,stalk,stalked,straight,tamen,tapering,terete,trichome,unarmed,unit,variously,vary,venation,weakly,yellow-green,ympodial,¼	branching,corolla,cuspidate,form,growth,height,history,inflorescence,life,midrib,midvein,na,ovary,perennial,perfect,plant,pubescence,reproduction,seed,shape,size,staman,stellae,stigma,stipe,texture,vein,width
128	wfo-0001026711	success	210	102	83	127	19	0.395	-5,.2,.5,.8,0.3-1,0.5-1.5,0.7-,0.75-1,0.8-2.2,0.9-1.1,1.5-2.2,1.7-4,1/2-2/3,1/3,1/4-1/3,2-2.2,2-3.5,2.1-2.5,3-4.5,3-7,3.5-5.2,4.5-7,acute,anther,apex,apically,apparently,base,berry,blade,branched,calyx,cm,cuneate,densely,diameter,dull,erect,evenly,filament,flattened-reniform,fruit,green,lateral,leaf,length,lobe,lobed,long,margin,maturity,mauve,midvein,mm,obtuse,orange,orange-brown,pair,pale,petiole,primary,purple,red,rounded,shallowly,shrub,sometimes,spherical,stellate-pubescent,stem,style,surface,terminal,thick-chartaceous,tip,tube,upper,vein,way,weakly,wide,yellow,young	-15,-2,-6,-7,0,0-0.2,0-25,0-4,0-6,0.1,0.15,0.2-0.3,0.7-0.9,0.7-1.4,0.8,0.9-1.5,1-,1-2,1-30,1.5-,1/,1/4,2-2.5,2-4,2-6,3-4,3-5,4-8,5-merous,7-8,abaxially,acicular,acuminat,alyx,ame,apar,apart,articulated,bark,brow,c.,cell,concolorous,connivent,curved,deltate,difoliate,discolorous,distance,drying,eaf,eed,elliptic,elongating,equal,extending,faint,flower,free,fruiting,geminat,glabrous,infructescence,less,longer,lower,mature,midpoint,moderately,narrow-deltate,nflorescence,occasionally,older,one,open,orolla,oung,outline,pedicel,peduncle,pendulous,per,perfec,pericarp,perpendicular,pit,poricidal,porrect,portion,prickl,prickle,prickly,raised,ray,reduced,reflexed,ruit,scar,sessile,shorter,side,slender,small,smooth,somewhat,spaced,spreading,stalk,stalked,stellate,straight,tamen,tapering,terete,tertiary,time,trichome,unarmed,uniform,unit,variously,vary,venation,visible,woody,yellow-green,ympodial	acuminate,branching,color,corolla,form,growth,height,inflorescence,ovary,perfect,plant,pubescence,reproduction,seed,shape,size,staman,stellae,texture
129	wfo-0001026717	success	207	107	87	120	20	0.42	0.3-0.6,0.6-1.5,1-2,1-2.5,1.4-2.2,14-22,15-34,2.5-4.5,2.5-5.5,3-4,3-6,4-6,5-11,5-13.5,5-6,7-11,abaxially,adaxially,along,anther,attenuate,brownish,cell,chartaceous,cm,condition,conical,corolla,covering,dark,diameter,drying,especially,filament,flower,forked,fresh,fruit,glabrous,green,green-white,greenish,hair,hair-like,herb,lateral,leaf,light,like,lobe,long,make,membranous,midrib,minutely,mm,mottled,mucilaginous,odd-pinnate,ovoid,pentagonal,perfect,petiole,plant,puberulent,pubescent,purple,ripe,rotate,seed,size,sparsely,stigma,style,subglabrous,testal,thick,throughout,tip,tube,violet,wall,wet,whitish,wide,x,yellow	0.3-2.5,0.3-5,0.8,1-10,1-3,1.3-2.5,1.8-3,13-28,2.2-5,3-5,3.3-11,4-8,4-9,5,5-merou,5.3-9,acumen,acuminate,ag,alyx,apart,apex,apparently,articulated,axe,axillary,base,berry,blade,borne,bud,capitat,ciliate,connivent,darker,decreasing,decurrent,digestion,distal,dorsally,eaf,edge,eed,elliptic,end,enzyme,equal,erec,exceeding,flat,folded,geminat,generally,glabrou,gradually,half,homostylous,honeycomb-shaped,interjected,lanceolate,larger,leaflet,lengthening,living,lower,margin,medium,middle,minute,narrow,nflorescence,obtuse,often,one-quarte,orbicular,orolla,ovate,pair,pedicel,peduncle,petiolule,plurifoliate,pore,poricidal,present,pubescen,removed,round,ruit,secondary,semierect,sessile,seudostipule,singly,slightly,slit,spaced,specimen,stamen,ste,stolo,straight,stripe,subequal,subsessile,subtending,symmetrical,tall,tamen,tem,terminal,toward,tri-,tuber,typically,unit,usually,vary,wing,ympodial	branching,calyx,color,form,growth,height,history,inflorescence,length,life,na,ovary,perennial,pubescence,reproduction,shape,staman,stem,surface,texture
130	wfo-0001026725	success	166	99	72	94	27	0.434	.3,.5,0.2,0.7-1.2,1-1.5,1-4.5,1-5,1.5,1.5-2,1.6-2,2,3.5-4,3.6-7.7,5-20-flowered,8-18.6,8-9,acute,anther,apex,base,beneath,broadly,calyx,cm,corolla,cup-shaped,dark,dia,drying,elliptic,filament,flattened-reniform,fruit,glabrous,globose,green,greenish-white,lateral,leaf,less,lobe,long,margin,minutely,mm,onto,ovary,ovate,pair,papillose,petiole,pitted,pubescent,reddish-brown,rounded,shrub,simple,size,stem,stigma,style,surface,tip,triangular,trichome,tube,tuft,uniseriate,vein,white,winged,x	/4,1-1.2,1.2-1.7,1/2,2.2-4,5-5.5,5-6,accrescent,anthesi,apart,attenuate,axil,bark,becoming,berry,black,bluish,brownish-papillose,capitate,character,crackin,deflexed,differing,difoliate,dry,eaf,edicel,eed,ellipsoid,evenly,extremely,free,fruiting,geminat,geographically,glandular-papillose,incrassate,inflorescenc,interpetalar,large,lobed,lon,lower,main,major,margine,material,middle,minor,nflorescence,occasionally,often,older,one,open,opposite,ovoid,pale,paler,papillo,pedicel,planar,pore,poricidal,portion,prominent,proximal,reflexed,ruit,scar,scarious,shaped,short,sinus,slender,slightly,spaced,split,straight,stretching,subshrub,tall,tan,tapering,tear-drop,ud,unit,upper,varying,way,widest,woody,ympodial,young	branching,color,diameter,flower,form,growth,height,history,inflorescence,length,life,midpoint,midrib,midvein,na,perennial,plant,pubescence,ray,reproduction,seed,shape,staman,stellae,stipe,texture,width
131	wfo-0001026733	success	188	126	99	89	27	0.527	-1,-13,-4,-7,0.3-0.5,0.3-2,1-1.5,1-2,1-3,1-7,1.5-14,1.5-2,1.5-2.5,2-2.5,2-3,2.5-7.5,3-15,3-3.5,3-7,4,4-23,4-5,5-8,abaxially,acuminate,acute-acuminate,adaxially,apex,basal,base,calyx,chartaceous,cm,color,cordate,curled,dense,densely,diameter,eglandular-pubescent,eglandular-villous,ellipsoidal,elliptic-ovate,entire,especially,flattened,forked,fruit,fusiform,glabrate,glabrous,gland-tipped,glandular-,glandular-puberulent,glandular-tomentose,green,greyish,hair,hirsute,immature,lobe,long,longitudinal,margin,midrib,mm,moderately,narrowly,oblique,ovate,perfect,petiole,pilose,pubescent,pubescent-pilose,ripe,shining,sometimes,sparsely,stellate,stigma,stripe,style,submarginally,toward,tree,triangular,truncate,tube,unbranched,unknown,vein,villous,white,white-puberulent,wide,x,yellow,yellowish	-11,-14,-15,-2,-8,.5-3,0.5,0.5-1,0.5-2,0.5-4,1,10-20,15-,2-4,2-6,20-50,25-40,3-4-foliat,4.5-5,7-10,8-12,acute,aggregate,apart,ape,articulated,axe,beyond,blade,capitat,cell,ciliat,connective,connivent,cylindrical,deltate,dia,directed,distally,eaf,eed,eglandular-pilose,equal,exceeding,exserted,flower,glandula,lanceolate,leaving,linear-triangular,lon,lower,membranaceous,near,nflorescence,nther,orolla,ovoid,ovum,pedicel,pedicellar,peduncle,pore,present,pubescent-pilo,rachi,radiu,remnant,round,ruit,shorter,simple,slightly,small,smooth,spaced,stamen,stone,swelling,tal,tem,thecae,time,ud,unit,unknow,usually,vary,ympodial	anther,branching,corolla,filament,form,glandular,growth,height,history,inflorescence,leaf,length,life,na,ovary,perennial,plant,pubescence,reproduction,seed,shape,size,staman,stem,texture,tip,width
132	wfo-0001026734	success	266	82	57	209	25	0.214	0.3,0.5,1,3,acuminate,acute,anther,broadly,brown,calyx,chartaceous,cm,congested,corolla,cyme,densely,diameter,elliptic,fruit,glabrous,globose,green,growth,immature,irregular,leaf,length,lobe,lobed,long,maturity,membranaceous,mm,moderately,ovary,pale,perfect,pit,pubescence,pubescent,purple,reniform,shape,shrub,size,sparsely,stellate,stem,stigma,style,surface,tube,unbranched,white,wide,yellow,yellowish	0.1,0.2,0.6,0.7–0.9,0.7–1,0.8–1,1.6–2,1.6–2.5,1.8–2.2,1.8–3,1/4,1–1.2,1–3,2.2–7,2.3–5,2.5–3,2–2.4,2–3,3.2–3.8,3–4,3–4-celled,3–8,4–6,4–7,4–8,4–9,5-merou,5–9,8,abaxial,abaxially,absent,accrescent,adaxial,adaxiall,adaxially,ag,also,always,alyx,anthesi,apex,apical,apice,archin,ark,articulated,associated,asymmetric,axi,barely,base,becoming,beneat,beneath,berry,blade,branch,branched,bright,caly,camptodromous,capitate,celled,central,clavate,closely,commonly,connivent,covered,covering,cuneate,cylindrical,dark,dense,denser,differing,directed,discolorous,distally,downward,dried,drying,due,eaf,eed,eglandular,emergent,entire,erect,f.,fewer,flat,flattened,flower,foliate,forked,found,free,frequently,geminate,glabrescen,glabrescent,glandular,gray,hair,held,ilament,initially,internodal,introrsely,j,lamina,lanceolate,large,lateral,less,long-attenuate,longer,longitudinal,lower,lying,margin,material,mature,maturit,midpoint,midri,minute,mostly,much,multiseriate,narrow,near,new,nflorescence,normally,oblong,obovate,observed,obtuse,often,old,older,one,one-celled,opening,orolla,other,oung,ovate,pair,paired,papillose,pedicel,peduncle,petiole,plane,pointing,pore,poricidal,porrect,porrect-stellate,portion,purplish,rachi,raised,rarely,ray,rayed,reaching,rounded,ruit,scandent,secondary,sessile,shiny,short-stalked,shorter,simple,slightly,slit,smaller,sometimes,spaced,sparse,spread,spreading,stalk,still,subopposite,subsessile,surfac,terminal,trichome,tuft,ud,unequal,uniseriate,unit,upward,vary,vein,venation,vestiture,visible,whole,ympodial,¾	0.7-0.9,0.8-1,1-3,1.6-2,1.6-2.5,1.8-3,2-2.4,2.2-7,2.5-3,color,filament,form,height,history,inflorescence,life,na,perennial,plant,reproduction,seed,staman,stellae,texture,tip
133	wfo-0001026739	success	197	115	94	103	21	0.477	0-38,0.25-0.94,0.4-5,1-2,1-3,1.2-2.1,10-60,2-5.3,2-9,2.6-4.8,3-4,3.2-17.5,3.8-8.5,4-8,5.6-13.1,6-13,6.6-18,7-9,abaxially,acumen,adaxially,anther,brown,brownish,cell,cm,condition,coriaceous,corolla,covering,densely,diameter,drying,filament,flower,forked,fresh,fruit,glabrous,globose,green,green-white,greenish,hair,hair-like,herb,interjected,lateral,leaf,leaflet,light,linear,lobe,long,make,margin,mm,mucilaginous,odd-pinnate,orbicular,ovate,ovoid,pentagonal,perfect,petal,petiole,plant,pubescent,purple,ripe,rotate,seed,short,simple,size,sometimes,stem,stigma,stripe,style,sub-glabrous,terminal,testal,thick,throughout,tip,tube,usually,wall,wet,white,whitish,x,yellow	0-0.34,0.5-1.2,1-10,1.4-3.5,16-54,2-4,2-6,2.5-13.5,2.7-6.9,5-merou,abaxiall,acuminate,acute,ag,along,alyx,apart,apex,apparently,arranged,articulated,asymmetric,attenuate,axe,axillary,base,basiscopic,bead,berry,blade,bud,capitat,clavate,connivent,dark,decreasing,digestion,distal,dorsally,eaf,edge,eed,enzyme,erec,exceeding,flat,folded,geminat,generally,glabrou,hal,half,high,homostylous,honeycomb-shaped,lanceolate,larger,lengthening,like,living,lower,moniliform,multiple,necklace,nflorescence,oblanceolate,orolla,pair,pedicel,peduncle,plurifoliate,pore,poricidal,removed,rest,rounded,ruit,sessile,seudostipule,side,slit,spaced,specimen,stamen,stolon,straight,subequal,subtending,tall,tamen,tem,tissue,toward,tri-,tuber,typically,unit,vary,wide,wing,winged,yellowish,ympodial	branching,calyx,color,form,growth,height,history,inflorescence,length,life,midrib,na,ovary,perennial,pseudostipule,pubescence,reproduction,shape,staman,surface,texture
134	wfo-0001026740	success	171	119	84	87	35	0.491	0-10,0.5-1,1-2,1-3,1-5,10-30,2-3,2.5-27,2.5-3,2.5-4.5,3-15,3-3.5,3-5,3.5-40,4-5,4.5-10,5-40,5-8,6-10,abaxially,acuminate,acute,acute-acuminate,adaxially,also,apex,apiculate,basal,base,branched,calyx,cm,cordate,curled,densely,diameter,eglandular,ellipsoidal,elliptic,entire,especially,flattened,flower,fruit,glabrate,glabrous,glandular-puberulent,greenish,hair,lobe,long,margin,mm,moderately,narrowly,often,ovate,perfect,petiole,pilose,puberulent,pubescent,purple,reticulate,sometimes,sparsely,stellate,stigma,style,subcoriaceous,tomentose,toward,tree,triangular,truncate,tube,unbranched,vein,villous,violet,white-puberulent,whitish,x,yellow	-17,-2,1-10,1-12,1-4,10-20,2-4,2.5-6,20-50,3-foliat,8-19,absen,absent,aggregate,apart,ape,articulated,axe,beyond,blade,browni,cell,ciliate,connective,connivent,corky,cylindrical,darker,deltate,directed,distally,eaf,eed,equal,exceeding,exserted,fleshy,immature,lanceolate,leaving,lon,lower,mature,near,nearly,nflorescence,nther,oblong,obtuse,orange,orolla,ovoid,pedicel,pedicellar,peduncle,pilo,pore,present,rachi,radiu,rarely,remnant,ruit,scar,sessile,shorter,simple,slightly,small,spaced,stamen,stone,stripe,swelling,tal,tems,thecae,time,truncat,ud,unit,unlobed,vary,wide,woody,ympodial,young	anther,branching,color,corolla,filament,form,growth,height,history,inflorescence,lateral,leaf,length,life,midpoint,midrib,midvein,na,ovary,perennial,plant,pubescence,ray,reproduction,seed,shape,size,staman,stellae,stem,stipe,surface,texture,tip,width
135	wfo-0001026752	success	169	126	91	78	35	0.538	-4,-50,1,1-1.5,1-12,1-2,1-3,1-5,1.5-2,1.5-2.5,15-35,2-2.5,2-3,2.5-20,2.5-5,3-18,3-4,3.5-4,4-45,4-5,abaxially,abruptly,acute,adaxially,also,apex,apiculate,basal,base,black,branched,calyx,campanulate,chartaceous,cm,cordate,cuneate,darker,densely,diameter,ellipsoidal,elliptic-oblong,elliptic-ovate,entire,finely,flattened,fleshy,flower,forked,fruit,glabrous,globose,green,greenish-brown,immature,lobe,long,margin,mm,moderately,narrowly,nearly,papillose,perfect,petiole,pilose,possibly,pubescent,pubescent-pilose,purplish,rarely,rather,ripe,short-acuminate,stellate,stigma,stripe,style,time,tree,triangular,truncate,tube,unbranched,vein,violet,white,whitish,wide,x,yellow	-25,-3,0-,1-6,1.5-12,10-20,2,2-4,20-30,3,3-5,3-foliat,7-15,8-16,absent,aggregate,apart,ape,articulated,axe,beyond,blade,capitat,cell,connective,connivent,coriaceous,cylindrical,deltate,dilated,directed,distally,eaf,eed,equal,exceeding,exserted,hair,lanceolate,laterally,leaving,less,lon,lower,near,nflorescence,nther,obtuse,orolla,ovoid,pedicel,pedicellar,peduncle,pilo,pore,presence,present,rachi,radiu,remnant,ruit,simple,slightly,small,somewhat,spaced,stamen,stone,tal,tem,thecae,tomento,ud,unit,unknow,vary,yello,ympodial	anther,branching,color,corolla,filament,form,growth,height,history,inflorescence,lateral,leaf,length,life,midpoint,midrib,midvein,na,ovary,perennial,plant,pubescence,ray,reproduction,seed,shape,size,staman,stellae,stem,stipe,surface,texture,tip,width
136	wfo-0001026754	success	176	96	76	100	20	0.432	-6+,0.5-1,1-,1.5-3,1/2,10,2,2-2.5,2-3,2-4,2.5-3.5,2/3,30+,5-lobed,5.5-9,7-9,abaxially,acute,anther,apex,asymmetric,basal,base,branched,calyx,cm,conical,corolla,deeply,densely,diameter,entire,filament,flower,glabrous,globose,growth,half,inflorescence,irregularly,lamina,later,lateral,leaf,lobe,lobed,many,margin,membranous,midvein,mm,oblique,pair,perfect,petiole,pubescent,simple,sparsely,splitting,stellate-rotate,stem,stigma,style,surface,terminal,time,tip,truncate,tube,vein,vine,way,white,woody,x,yellow	.5,0.5,0.9-1.1,1,198.,3-4-celled,4-5,5,5-merou,9,9-11,adaxially,ag,along,alyx,anthesi,apar,apparently,ark,articulated,axi,berry,broadly,brow,cabrera,clavate,complete,connivent,cucullat,dendritic,denser,distal,divided,eaf,ed,ellipsoid,elliptic,especially,exerted,extending,fide,free,halfway,ilament,leaving,lengthening,like,long,loosely,lower,mature,minute,minutely,mixture,mostly,narrowly,new,nflorescence,older,orolla,outline,papillo,pedicel,peduncle,peg,pinnate,planar,plurifoliat,pore,poricidal,portion,primary,puberulent,ruit,scandent,scar,seen,sleeve,slender,slit,small,sometimes,spaced,spreading,tangled,tem,transparent,trichome,tub,twinin,twining,ud,uniseriate,unit,upper,vary,weak,within,yellowish,ympodial	branching,color,form,fruit,length,midpoint,midrib,na,ovary,pubescence,ray,reproduction,seed,shape,size,staman,stellae,stipe,texture,width
137	wfo-0001026756	success	147	75	57	90	18	0.388	0.5-1,0.5-3,1-1.5,1.5-1.7,1.5-10,1.5-2,1.8-3,3-4,3.5-8.5,5-10,5-5.5,6-16,abaxially,adaxially,anther,base,brown,calyx,cm,corolla,dark,dendritic,densely,dia,elliptic,fleshy,glabrous,globose,green,lax,leaf,lobed,long,mm,nearly,ovary,ovate,ovoid-reniform,perhaps,petiole,pinkish-white,pubescence,pubescent,shape,shrub,simple,somewhat,sparsely,stem,stigma,style,thick,tree,trichome,uniseriate,white,wide	.25,.5,0-7-1.2,0.25-0.5,1-2,1.5-3,5-10-flowered,6-10,abaxial,acute,along,anthesi,apex,apiculate,attenuate,ba,bark,berry,bilobed,broadly,closely,conical,corresponding,deflexed,deltate,denser,differing,difoliate,distal,eaf,edicel,eed,erect,exserted,filament,free,fruiting,geminat,glabrescent,grayish-brow,hard,inflorescenc,irregular,lamina,lateral,like,lobe,lower,main,major,middle,minor,minutely,nflorescence,occasionally,older,opposite,overlappin,pair,pale,papillo,pedicel,pericarp,pitted,planar,pore,poricidal,portion,present,rest,ruit,scar,shaped,soon,spaced,strongly,surface,tall,tear-drop,tip,tub,tube,ud,unifoliate,unit,vein,widest,woody,ympodial,young	branching,color,diameter,form,fruit,growth,height,history,inflorescence,length,life,na,perennial,plant,reproduction,seed,size,texture
138	wfo-0001026777	success	168	80	62	106	18	0.369	.5,0.5-1.5,1-1.5,1-10,1-2,1-4,1.2-1.8,1.5-3,2-4,2-4.5,3-3.5,5-14,5-50-flowered,5-7,anther,axil,base,beneath,blue,branching,brown,calyx,cm,corolla,dia,elliptic,fide,flattened-reniform,flexuous,glabrous,globose,green,growth,lateral,leaf,lobed,long,main,mm,narrowly,nearly,occasionally,ovary,petiole,pubescent,russet,seed,shiny,shrub,size,sparsely,stem,stigma,straight,style,trichome,tuft,uniseriate,vein,vellozo,white,x	.25,/3,0.25-0.5,0.5-1,0.5-5,0.9-3,1-1.3,1.5-5,2-5,4-8,acuminate,acute,anthesi,apart,apex,apiculate,ba,beginning,berry,body,campanulate,capitate,cell,cup,decurrent,deflexed,dense,differing,difoliate,distal,eaf,edicel,eed,end,exserted,filament,filiform,flattened,free,fruiting,geminat,glabrate,greyi,hyaline,incrassate,inflorescenc,irregularly,like,lobe,lon,lower,major,margin,matted,middle,minor,minutely,near,new,nflorescence,often,older,one,onto,opposite,outline,overtopping,pair,papillo,papillose,pedicel,pitted,planar,pore,poricidal,portion,prominent,quadrate-deltoid,quite,rest,ruit,scar,shaped,sinuate,slightly,smooth,somewhat,soon,spaced,surface,tall,tapering,tear-drop,testa,thread-like,tip,tube,ud,unit,wall,way,widest,woody,yellowish,ympodial,young	color,diameter,flower,form,fruit,greyish,height,history,inflorescence,length,life,na,perennial,plant,pubescence,reproduction,shape,texture
139	wfo-0001026782	success	206	113	84	122	29	0.408	-10,-5,0.5-1,0.5-2,1,1-1.5,1.4–2,1.5,1.8–3,2,2-5,3-4,6-7,abaxially,acute,adaxially,annual,anther,apex,base,blue,bluish,brown,calyx,cm,cordate,dark,darker,deltoid,densely,diameter,except,filament,finely,flower,fruit,glabrous,globose,green,greenish,herb,immature,irregularly,length,light,lilac,lobe,margin,maturity,midpoint,midrib,mm,mottling,obtuse,ovate,perfect,petiole,pubescence,pubescent,purple,pustulate,ray,reniform,rotate-campanulate,small,stellae,stellate-pubescent,stellate-tomentose,stem,stigma,style,surface,thin-textured,tip,tomentose,tube,unbranched,vein,white,x,yellow,yellowish-brown,–5,–6	-4,0.5,0–1,0–10,1.3,1.5–2.5,1/3–1/2,10–15,15,1–3,1–5,2-foliate,2–4,3,3.5–8.5,3–12,4,4–10-rayed,4–13,4–6-rayed,4–9,5,6,7,8-10,abundant,abundantly,accrescent,acicular,adaxiall,additional,anthesi,apiculate,armed,articulate,axe,becoming,berr,blade,clavat,clustered,coarse,commonly,curved,dehiscent,dilated,divided,eaf,eed,enclosing,exceeding,fertile,fruiting,geminat,glabrou,gland-tipped,gradually,hair,internode,interpetalar,larger,like,lon,long,lower,lowermost,main,male,minute,much,much-branched,narrowly,nearly,nflorescence,numerous,often,one,orolla,pair,partially,pedicel,peduncle,pore,porrect-stellate,prickle,rachi,radiu,rarely,ruit,sessile,shallow,short,shorter,simple,slightly,smaller,somewhat,sparsely,spreading,stalk,staminate,ste,stellate,stipitate,straight,strongly,tall,tamen,tapered,tem,terminal,thick-stalked,tissue,tooth,triangular,two,upper,upward,vary,way,woody,ympodia	1-3,1-5,3-12,4-13,4-6-rayed,branching,color,corolla,form,growth,height,history,inflorescence,lateral,leaf,life,lobed,midvein,na,ovary,plant,reproduction,seed,shape,size,staman,stipe,texture,width
140	wfo-0001026788	success	291	148	126	165	22	0.433	.3,0.2–0.3,0.3–0.4,0.4–0.6,0.5–0.8,0.6–1.3,0.6–1.9,0.8–1.1,0.9–1.3,1.2–1.6,1.2–1.7,1.3–1.6,1.3–2.5,1.5–1.9,1.7–1.9,1/4–1/3,2.1–2.9,2.7–5.7,2.8–3.1,3,3.8,3.8–4.9,4,4–8,5,6.4,7.8–11.0,abaxially,acute,adaxially,aequilateral,alveolate,anther,apex,attachment,basal,base,branching,broad-based,brochidodromous,brown,calyx,chartaceous,cm,corolla,deltoid,densely,developed,diameter,distinct,dry,entire,erect,filament,flat,flattened-orbicular,flattened-reniform,flexed,flower,fruit,glabrous,glandular,globose,hair,homostylous,interpetalar,lanceolate,lateral,laying,leaf,lobe,margin,mature,midpoint,midrib,midvein,mm,moderately,notched,oblique,occasionally,orange,oval,petiole,point,portion,prickle,pubescent,raised,ray,reddish,restricted,retrorse,rounded,scandent,scarcely,shrub,simple,sinuate,slightly,small,sometimes,sparsely,stellae,stellate,stem,stigma,style,subcoriaceous,surface,time,tissue,tree,tube,unarmed,unbranched,vein,weakly,well,white,yellow,yellow-ferruginous,yellow-tan,±90°,±glabrous,×	.0,.04,.05,/3,0.3–0.5,0.4–0.7,0.5–0.7,0.6–1.0,0.8–1.8,0.9–1.2,0.9–2.0,0–,1.0–1.5,1.0–2.0,1.1–1.3,1.3–1.8,1.4–2.2,1.5–2.2,1.7,1/3,10.8,1–3,2.0,2.5–11.0,2.9–4.0,2/3,2/3s,2–3,3.0,3.4,4.0,4.6–6.0,4–7,5-merou,7.0–8.9,8,8.3–10.9,8.5,90°,absent,acuminate,adjacent,adnate,ag,alyx,anthesi,apart,apical,apparently,appearing,appressed,around,articulate,attenuate,axe,ba,bark,based,becoming,berry,blade,branch,broad,broadly,bud,capitat,channeled,clinate,connivent,curved,deciduous,deflexed,dentate,development,difoliate,directed,distal,distally,distinctly,eaf,edge,eed,either,emerging,evenly,exocarp,extending,extra-axillary,fertile,filiform,free,geminat,glossy,gradually,hort,increasing,incurved,intact,internode,intersepalar,juic,layer,less,lobed,lon,long,longer,lower,many,markedly,minute,nearly,nflorescence,opaque,orolla,ovate,pedicel,peduncle,per,perforated,pore,porrect,porrect-stellate,potentially,presen,primary,proximal,reflexe,remaining,rigid,row,ruit,scattered,sessile,shoot,side,sigmoid,sinus,sloughing,smoot,somewhat,soon,spaced,splitting,spread,stamen,stellate-pubescent,straight,suture,swelling,tamen,tem,thin,transparent,triangular,two,ud,upper,vary,wide,yellow-ferruginou,ympodia,young,±dense,±equal	5-merous,color,form,growth,height,history,inflorescence,length,life,na,ovary,perennial,plant,pubescence,reproduction,seed,shape,size,staman,texture,tip,width
141	wfo-0001026790	success	236	118	95	141	23	0.403	-11,-19,-4,-40,0.2-0.6,0.2-1.5,0.5-4,0.6-10,0.7-1.5,1-1.5,1.5-3,1.5-5,1.8-4,1.9-2.6,1/4,1/4-1/2,2-11,2.5-4.5,2.7-3.2,3.5-17,4-9,5-10,6-8,6.5-9,7-15,abaxially,acute,andromonoecious,anther,apex,apically,base,berry,branched,broad-deltate,calyx,chartaceous,cm,cordate,cream,dark,densely,diameter,dull,elliptic,erect,filament,flattened-reniform,flower,fruit,glabrous,green,lanceolate,lateral,leaf,length,lobe,lobed,long,long-styled,lower,margin,marking,maturity,mauve,midpoint,midvein,mm,moderately,obtuse,orange-brown,ovate,pale,petiole,plant,ray,rounded,short-styled,shrub,sometimes,sparsely,spherical,spreading,stellate-pubescent,stem,style,surface,tip,tube,upper,vein,way,wide,yellow,young	-1/2,-1/3,-10,-2,-3,-6,-merous,0,0-10,0-150,0-20,0-30,0-5,0.2,0.2-0.4,0.2-2,0.5-2,0.7-3,0.8,1,1-2,1-3,1.5,1.5-2.5,1.5-4,1/2-3/,1/5-1/3,1/6-1/4,2,2-,2-3,2-30,2-5,2-7,4-,4-11,4-7,5,5-9,6-12,7-12,7-13,7-20,acuminat,adaxially,alyx,ame,apar,apart,apparently,articulated,bark,becoming,blade,brown-green,c.,concolorous,conical,connivent,curved,deltate,discolorous,distance,drying,eaf,eed,elongated,elongating,entire,equal,extending,flattened,free,fruiting,gently,glandular,green-brown,hair,heterostylous,inflorescenc,infructescence,longer,mature,minute,narrow-deltate,near,nflorescence,older,one,open,orolla,oung,pair,pedicel,peduncle,pendulous,per,pericarp,plurifoliat,poricidal,porrect,portion,prickle,prickly,primary,red-brow,red-brown,reduced,reflexed,ruit,scar,sessile,side,simple,smooth,spaced,stalk,stalked,stellate,stout,straight,tamen,tapering,terete,terminal,tertiary,time,toward,trichome,unarme,unarmed,unit,usually,variously,vary,venation,visible,weakly,woody,yellow-green,ympodial	1/2-3/4,acuminate,branching,color,corolla,form,growth,height,inflorescence,midrib,na,ovary,pubescence,reproduction,seed,shape,size,staman,stellae,stigma,stipe,texture,width
142	wfo-0001026818	success	252	125	104	148	21	0.413	-15,-2.5,-3,-7,0.3-0.8,0.5-1,0.5-1.5,0.5-2.5,0.7-2,1.8-3.5,2-4,2-4.5,2.5-4,2.7-4,3-5,4-10,4-6,5-11,5-20,6.5-9.5,7-30,7-50,8-11,8-15,abaxially,acute,acute-,adaxially,anther,apex,base,branched,broadly,calyx,cm,coarsely,cordate,cylindrical,deltoid,densely,dentate,depressed-deltoid,diameter,elliptic,elliptic-ovate,erect,felty-pubescent,filament,flower,fruit,glabrous,globose,hair,inflorescence,lateral,length,lenticular,like,lobe,long,margin,middle,midpoint,midrib,mm,oblique,obtuse,obtuse-,orange,orange-red,outline,ovate-lanceolate,perennial,perfect,petiole,prickle,pubescence,pubescent,ray,reniform-ovate,ripe,round-tipped,sessile,shallowly,side,size,sometimes,sparsely,spreadingly,stellae,stellate,stellate-pubescent,stem,stigma,style,tan,thin-textured,truncate,tube,unbranched,vein,white,x,yellow	-1.5,-2,-4.5,0-1,0-1.5,0.1-0.3,0.3-1,0.3-2.5,1,1-4,1.5-,1/3,2,2-15,2-3,2-foliate,2.5-5,4-7,5-12,5-15,5-9,6-10,7-15,abrupt,abundant,accrescent,adaxiall,along,always,apart,apparent,articulated,ascending,attenuate,average,axe,ba,becoming,blade,broad-based,campanulate,capitat,capitate-glandular,cast,cauline,class,closely,commonly,compresse,connivent,covering,cream,density,directed,distal,distall,distinct,eaf,eed,elongate,entire,equaling,especially,essentially,extra-axillary,female-sterile,foliar,frui,fruiting,geminate,grading,inserted,interlobal,lanceolate,large-leaved,larger,largest,laterally,leaf-opposed,less,lignescent,longest,lower,major,maturit,mesocarp,minutely,mixture,mostly,multiseriate,nearly,nflorescence,numerous,occasionally,often,one,orolla,oung,ovate,pedicel,peduncle,per,persistent,pitted,pore,prickly,principal,prominent,purplish,rachi,radiu,ruit,scattered,short,shorter,similar,simple,sinus,smaller,somewhat,spaced,sparse,spreading,spreading-hirsute,stalk,stalked,ste,stipitate,surface,tal,tamen,termination,thickened,time,tooth-like,transition,trichome,two,unarmed,unit,usually,variable,vary,vivo,weakly,wide,yellowish,ympodial	branching,color,corolla,form,growth,height,history,leaf,life,midvein,na,ovary,plant,reproduction,seed,shape,staman,stipe,texture,tip,width
143	wfo-0001026819	success	218	119	92	126	27	0.422	0.5-1.5,1-2,1.5-12,1.5-3.3,1.6-3.5,2-5,2.5-5,3-120,3-18,3-20,3-35,3-38,4-10,4-7,6-11,abaxially,acuminate,acute,adaxially,anther,apex,attenuate,base,blue,brownish,cell,chartaceous,cm,condition,corolla,covering,cuneate,densely,diameter,dot,drying,filament,flower,forked,fresh,fruit,glabrous,globose,green,greenish,hair-like,herb,lateral,light,lobe,long,make,margin,membranous,midvein,minutely,mm,moderately,mottled,mucilaginous,oblique,odd-pinnate,ovoid,pentagonal,petiole,plant,puberulent,pubescent,purple,rotate-pentagonal,scattered,seed,slightly,stem,stigma,stripe,style,subglabrous,symmetrical,testal,thick,tinged,tip,truncate,tube,violet,wall,wet,white,whitish,wide,yellow	0-27,0.3-4.7,1-10,1-2.3,1-5,1.2-36,1.5-10,1.5-3.0,1.5-3.5,10,10-26,2-6,4,5-30,5-merou,7,absent,acumen,ag,along,alyx,apart,articulated,ascending,bearing,blade,borne,broadly,bud,capitate,ciliate,clavat,connate,connivent,curved,dark,decurrent,digestion,distal,dorsally,eaf,edge,eed,elliptic,end,enzyme,erec,especially,exceeding,flat,folded,geminat,generally,glabrou,glaucous,greatly,green-white,greenish-yellow,hair,half,homostylous,honeycomb-shaped,interjected,lanceolate,larger,leaflet,lengthening,like,living,lower,lunate,middle,narrowly,nflorescence,non-glandular,often,orolla,ovate,pair,pedice,pedicel,peduncle,petiolule,plurifoliate,pore,poricidal,rachi,ranging,removed,ruit,scale-like,seudostipule,short,singly,slit,sometimes,somewhat,spaced,specimen,stamen,star,ste,stolo,straight,subequal,suborbicular,subrosette,subtending,tall,tamen,tem,terminal,tertiary,therefore,throughout,tri-,tuber,typically,unit,unwinged,usually,vary,wing,within,without,ympodial	branching,calyx,color,form,growth,height,history,inflorescence,leaf,length,life,midpoint,midrib,na,ovary,perennial,pubescence,ray,reproduction,shape,size,staman,stellae,stipe,surface,texture,vein
144	wfo-0001026821	success	204	114	81	123	33	0.397	.2,0.4-1.5,0.5-1.2,0.7-1.8,0.8-1,1-1.5,1-2,1-5,1.2-1.5,1.5-2.5,2-3.5,3-18,3-branched,4-4.5,5-20,5-34,abaxially,acuminate,adaxially,anther,apex,apiculate,appressed,base,broadly,brown,cm,cordate,dark,deltate,diameter,due,ellipsoidal,filament,flattened,flower,forked,fruit,gglobose,glabrous,green,herb,lanceolate,lateral,length,light,lobe,long,long-attenuate,margin,mature,membranous,minutely,mm,oblique,obtuse,odd-pinnate,pale,petiole,pilose,puberulent,pubescent,rarely,remnant,rounded,somewhat,sparsely,stellate,stigma,stripe,style,subglabrous,substellate,surface,thickening,tube,unbranched,wall,white,x,yellow	/3,0-20,0.2-1.5,0.3-1.2,0.3-2.5,0.5-3.5,1-20,1-3,10-15,17,1977,2-15,2-6,2-celled,2.5-18,3-11,3-6,3-7,3-celled,5-10,5-12,5-merou,acut,adaxial,ag,alyx,anderson,angular,apart,apical,apically,articulated,auriculate,axe,ba,basal,bayonet,berry,blade,bract,cell,chartaceous,ciliat,cuneate,directed,distal,distally,eaf,eed,elliptic,equal,especially,exceeding,frequent,fused,geminat,glabrou,gland-tipped,greatly,hair,homostylous,incurved,interjected,interstaminal,large,leaf-opposed,leaflet,longitudinal,lower,lowermost,many,mean,membrane,minute,moderately,much,narrowly,nflorescence,obliquely,oblong,occasional,occasionally,one-celled,opening,orolla,pair,paired,pedicel,peduncle,per,perfect,petiolule,plurifoliate,pore,present,pseudostipular,pubescen,rachi,reduced,reniform,ruit,scandent,seudostipule,short,slender,slightly,slit,small,smaller,spaced,stamen,subtended,tamen,tem,terminal,time,tri-,truncat,unit,vary,wide,winged,ympodial	10-20,branching,calyx,color,corolla,form,growth,height,history,inflorescence,leaf,life,midpoint,midrib,midvein,na,ovary,perennial,plant,pubescence,ray,reproduction,seed,shape,size,staman,stellae,stem,stipe,texture,tip,vein,width
145	wfo-0001026827	success	143	101	76	67	25	0.531	/3,0.4-0.6,0.5-2,0.6-1,1-,1-1.1,1-1.5,1-2.1,1.5-2,2-2.2,2-2.5,2-4,3-9,5-6,7-9,?,abaxially,acute,and/or,anther,apex,arachnoid,attenuate,base,branched,broadly,calyx,cm,corolla,deltate,dendritic,densely,diameter,distally,especially,filament,fleshy,flower,glabrescent,glabrous,growth,inflorescence,lanceolate,leaf,like,lobe,lobed,margin,mm,narrowly,near,oblanceolate,ovary,pair,papillate,perfect,petiole,pubescent,reddish,revolute,shrub,simple,sinus,sparsely,stem,stigma,style,thick,tip,trichome,tube,uniseriate,vein,way,white,x	.5,0.2-0.5,1-2,1.3-1.6,adaxiall,age,anthesi,apart,appearing,bark,branch,clavate,conical,crowded,deciduou,dense,dry,drying,eaf,ellipsoid,erect,exerted,free,internodal,irregularly,know,known,lamina,lengthening,less,lower,minutely,new,nflorescence,nodding,ot,paler,papillat,pedicel,peduncle,planar,plane,plurifoliat,pore,poricidal,portion,primary,rachi,scar,slender,slit,small,soon,stout,straight,strongly,surfac,surface,terminal,thickened,third,tub,ud,unit,upper,widest,ympodial	adaxially,branching,color,form,height,history,lateral,length,life,midpoint,midrib,midvein,na,perennial,plant,pubescence,ray,reproduction,shape,size,staman,stellae,stipe,texture,width
146	wfo-0001026830	success	198	112	89	109	23	0.449	0.3-1.3,0.5-1.0,0.9-1.9,1-2,1.5-4,2.5-4.4,2.5-5,4-10,4-14.5,4-7,4.4-14.5,4.5-17.5,5-11,6-13,7-18,abaxially,acumen,adaxially,anther,brown,brownish,cell,ciliate,cm,condition,coriaceous,corolla,covering,deep,diameter,drying,filament,finely,flower,forked,fresh,fruit,glabrescent,glabrous,globose,green,green-white,greenish,hair,hair-like,herb,lateral,leaf,light,linear,lobe,long,make,margin,medium,mm,moderately,mucilaginous,odd-pinnate,ovoid,pentagonal,perfect,petiole,plant,puberulent,pubescent,purple,ripe,rotate,seed,short,simple,size,stigma,stripe,style,subglabrous,testal,thick,throughout,tip,tube,wall,wet,white,whitish,x,yellow,yellowish	0-10,0.4-1,0.5-1.2,1-10,1-11,1.1-2.7,1.4-4,10-57,2-4,2-6,2.7-8,3.5-8.5,5-merou,acuminate,acute,adaxiall,ag,along,alyx,apart,apex,apparently,arranged,articulated,asymmetric,attenuate,axe,axillary,base,basiscopic,bead,berry,blade,bud,capitat,clavate,connivent,decreasing,digestion,distal,dorsally,eaf,edge,eed,elliptic,enzyme,erec,exceeding,flat,folded,geminat,generally,glabrou,hal,half,high,homostylous,honeycomb,interjected,lanceolate,leaflet,lengthening,like,living,lower,moniliform,multiple,necklace,nflorescence,orbicular,orolla,ovate,pair,pedicel,peduncle,petiolulate,plurifoliate,pore,poricidal,removed,rounded,ruit,sessile,seudostipule,shaped,side,slit,spaced,specimen,stamen,stolon,straight,subequal,subglabrou,subtending,tall,tamen,tem,terminal,tissue,toward,tri-,tuber,typically,unit,unwinged,usually,vary,ympodial	abaxial,adaxial,branching,calyx,color,form,growth,height,history,inflorescence,length,life,midrib,na,ovary,perennial,pubescence,reproduction,shape,staman,stem,surface,texture
147	wfo-0001026831	success	207	106	82	125	24	0.396	-6.5,-9,.5,/4,0.5-1.2,0.6,0.6-2,0.65-1,0.7-2,1-2.2,1-2.5,1.5-2.5,1/3,2-2.5,2-3,2.3-2.9,2.5-4.5,3-6,acute,anther,apically,apparently,base,berry,branched,bright,calyx,cell,chartaceous,cm,cream,dark,densely,diameter,dull,erect,filament,flattened-reniform,fruit,glabrous,gray-brown,green,lateral,leaf,length,lobe,lobed,long,longer,lower,marking,maturity,mauve,membranous,mm,moderately,orange,orange-brown,outline,pale,raised,scandent,shiny,shrub,slender,smooth,sometimes,sparsely,spherical,stellate-pubescent,stem,style,surface,time,tip,tube,upper,way,white,wide,yellow,young	-0.25,-5,0-10,0-20,0-3,0-6,0.1,0.1-0.2,0.1-0.25,0.15-0.25,0.2-0.4,0.2-1,0.3-0.6,0.3-0.65,0.7-1.1,1-10,1-2,1-3,1-4,1-6,1.2-2,1/3-1/,1/3-2/3,1/5-1/4,2-4,3-5,3.5-10,5-merous,7-10,7-8,abaxially,alyx,apar,apart,apex,articulated,attenuate,bark,blade,broad-deltate,brow,caudat,concolorous,connivent,curved,deltate,difoliate,distance,drying,eaf,eed,elliptic,elongating,equal,extending,eye,flower,free,fruiting,fully,geminat,glabrescent,herbaceous,infructescence,less,margin,mature,midpoint,midvein,multangulate,naked,narrow-cuneate,nflorescence,oblong,occasionally,older,one,open,opening,orolla,oung,ovate,pair,pedicel,peduncle,pendulous,per,perfec,pericarp,petiole,poricidal,porrect,portion,prickl,prickle,prickly,primary,ray,red-brown,reduced,rounded,ruit,scar,sessile,shorter,side,spaced,spreading,stalk,stellate,subsessile,tamen,tapering,terete,tertiary,trichome,unit,usually,vary,vein,venation,visible,white-gray,yellow-green,ympodial	1/3-1/2,branching,caudate,color,corolla,form,growth,height,history,inflorescence,life,na,ovary,perennial,perfect,plant,pubescence,reproduction,seed,shape,size,staman,texture,width
148	wfo-0001026841	success	139	74	54	85	20	0.388	.5,/4,0.5-1,0.6-1,0.75-1,0.8-1,0.8-3,1.5,1.5-2,3-6.5,3.5-5,4-8,6-8,9.2-18,along,anther,base,beneath,bi-lobed,calyx,clavate,cm,corolla,curly-tipped,elliptic,glabrous,globose,inflorescence,leaf,lobed,long,minutely,mm,ovary,paler,papillose,pedicel,petiole,pubescent,shining,shrub,simple,sparsely,stem,stigma,style,thickened,trichome,tube,uniseriate,vein,way,white,x	.25,0.05,0.25-0.3,0.25-0.5,0.5-0.75,0.5-2,2-2.5,5-8-flowered,7-9,acute,anthesi,apart,apex,arch,axi,ba,bark,berry,broadly,conical,coroll,decurrent,deflexed,deltoid,dia,eaf,edicel,eed,ellipsoid,exsertion,filament,filiform,free,fruiting,glabrate,green,greyish-gree,hyaline,immature,joined,known,later,lateral,like,lobe,lon,lower,main,margin,middle,nflorescence,older,opposite,pair,papillo,pore,poricidal,portion,prominent,raised,reddish,reflexed,rest,ruit,scar,series,shaped,slender,slightly,spaced,straight,tall,tapering,tear-drop,terminal,tip,ud,unevenly,unifoliat,unit,widest,winged,woody,ympodial,young	arrangement,branching,color,diam,diameter,form,fruit,greyish-green,growth,height,history,length,life,perennial,plant,pubescence,shape,size,texture,unifoliate
149	wfo-0001026849	success	180	88	61	119	27	0.339	0.5-1,1,1-2,1-6,1.5-2.5,1.75-2,2,2-3,38/2,5-10,637/2,7-8,acute,anther,apex,aster,base,brown,calyx,cm,conical,corolla,cyme,discoidal,distinctly,entire,filament,flower,flowered,glabrous,green,grey-brown,growth,inflorescence,lavender,leaf,lobe,long-cuneate,margin,minutely,mm,oblong-lanceolate,ovary,petiole,reticulate,rh,rotate,rounded,sea,seed,short-lived,shrub,stem,stigma,style,surface,tip,tube,undulate,violet,x	-50,0-10,1-1.5,100-130,11,30-,40,5,80-,adherent,adult,amongst,appearing,aspect,australian,axil,berry,capitate,cell,colour,composed,conspicuous,curved,cut,deflexed,developed,dia,distinct,eed,ellipsoid,emarginate,enlarge,erect,exceeding,except,exerted,expanded,facetted,filled,flesh,floral,fork,free,fruiting,general,glandular,globose,globular,granule,greater,gree,hair,half,interacuminal,large,leave,lengthening,less,linear-lanceolate,little,lon,long,loosely,lower,mature,maturity,mid-vein,minute,native,nflorescence,oblong,occasionally,often,pal,pale,pedicel,pedicellate,peduncle,petal,plurifoliat,pore,poricidal,preparation,pruinose,purple,rarely,relatively,reproducing,rhachi,ruit,ruiting,shallow,shed,simple,sinus,slende,slightly,slit,soft-wooded,solanum,solitary,sometimes,somewhat,soon,stone,stony,stout,thus,tissue,tub,ud,unarmed,unit,uvenile,vegetatively,way,well,ympodial,young	8,branching,color,diameter,form,fruit,height,history,lateral,length,life,midpoint,midrib,midvein,na,plant,pubescence,ray,reproduction,shape,size,staman,stellae,stipe,texture,vein,width
150	wfo-0001026851	success	267	131	92	175	39	0.345	.8,1-7,2,4-5,acute,andromonoecious,anther,apex,base,berry,bright,broadly,c.,calyx,circular,cm,cordate,dark,diameter,evenly,except,fading,filament,flattened,flower,fruit,glabrous,gland,globose,glossy,green,greenish,hair,hyaline,inside,irregularly,lateral,leaf,light,lighter,lobe,lobed,long,margin,matte,membranous,midrib,minute,minutely,mm,moderately,narrowly,orange,outside,ovate,pair,petiole,pilose,plant,pubescence,pubescent,recurved,shrub,similar,simple,size,slender,sparsely,spreading,stellate,stem,stipitate,stipitate-glandular,straw-colored,style,suborbicular,surface,tip,triangular,trichome,tube,unbranched,uniform,usually,vein,way,white,wide,wing,winged,yellow,yellowish	-2,-celled,.4,0.3–1,0.8–1.5,0–1,1,1.5,1.5–2,1.5–2.8,10-15,15,175–415,1979,1–4.5,1–7,2.2–3.6,2.5–4,2/3,2–10,2–3,2–3.5,300,3–3.6,3–5,4–5-celled,4–6,4–6-celled,5,5-merous,5–6.5,5–7-celled,6–11,7–12,8–10.5,8–15,=,abaxial,abaxiall,abundant,acicular,adaxial,almost,alyx,apar,appearing,armed,articulated,average,ba,becoming,bilobed,blade,branched,capitate,ciliate,coarse,coarsely,coil,complete,connivent,conspicuous,conspicuously,curve,densely,dentate,difoliate,directed,distall,distally,dot,eaf,eed,elongating,endocarp,enlarged,entire,equal,exceeding,eye,fertile,fide,fine,flexuous,free,fruiting,geminat,grading,gradually,heavily,heterostylous,infructescence,lacking,large,larger,lenticel,less,little,live,long-styled,lower,major,making,merely,minor,mostly,much,n,naked,near,nearly,nee,nflorescence,occasionally,often,one,orolla,otherwise,oung,papillo,pattern,pedicel,peduncle,per,pericarp,pore,poricidal,portion,preserved,prickle,prickly,reflexed,rest,ruit,sap,scanden,scant,scar,scarious,scattered,sessile,shiny,short-styled,slightly,small,smaller,sometimes,somewhat,spaced,specimen,speckled,spongy,sprawling,stamen,staminat,straight,tall,tamen,tapering,tasteles,terete,thick,thickened,tooth,tough,twice,unarmed,unit,vary,visible,watery,well,ympodial,–13,–2	0.3-1,0.8-1.5,1.5-2,13,2-10,2-3,2-3.5,4-5-celled,4-6,4-6-celled,5-6.5,6-11,7-12,abaxially,branching,color,corolla,form,growth,height,history,inflorescence,length,life,midpoint,midvein,na,ovary,perennial,ray,reproduction,seed,shape,staman,stellae,stigma,stipe,texture,width
151	wfo-0001026858	success	153	74	55	98	19	0.359	-30,0.8,0.8-1,1-4,1.3-1.5,1.5-4,2-3,2-4,2.5-3,3-4,4-24,4.5-10.5,6-7,abaxially,adaxially,branched,calyx,cm,corolla,cyme,diameter,dichasial,dichasially,ebracteate,flower,forked,glabrescent,glabrous,globose,green,green-white,herbaceous,interjected,lateral,leaf,leaflet,light,long,mm,monochasial,mucilaginous,odd-pinnate,ovoid,pair,perennial,petiole,plant,seed,shiny,size,stellate,stigma,style,wide,yellow	-4,0-.,0.5,1-,1-10,1-11.5,1-5,2-2.5,3-,3-6-foliat,5-15,6-10,6-18,abruptly,acumen,acute,apex,apical,apically,articulate,base,cell,connate,cordate,covering,cuneate,dehiscent,digestion,diminishing,distal,dorsally,eaf,edge,eed,emoval,enzyme,exceeding,filament,flat,folded,generally,globo,hair-like,half,honeycomb,introrse,living,lobe,lon,lower,lunat,make,maturing,minute,mucronate,nflorescence,nther,oblique,oblong,obtuse,often,orolla,ovate,ovate-lanceolate,pattern,pedicel,peduncle,perfect,plan,poricidally,proximal,reveal,rounded,ruit,seudostipule,short,slightly,slit,specimen,stamen,straight,tal,tem,testal,thick,throughou,throughout,toward,triangular,tuber-bearing,typically,unit,vary,wall,white-crea,without,ympodial,¼	0-2,3-15,anther,color,form,fruit,growth,height,history,inflorescence,length,life,na,ovary,shape,stem,surface,texture,white-cream
152	wfo-0001026870	success	206	109	88	118	21	0.427	.5,0-0.1,0.2-0.35,0.25-0.5,0.5-1,0.7-1.4,1.9-3,12-28,2-3,2-3.5,2-5,2-7,3-12,4-5,4-9,5-7.5,7-8,9.5-12,acute,adaxially,anther,apex,base,black,broadly,brownish,calyx,chartaceous,cm,color,cuneate,deeply,deltate,densely,diameter,dioecious,elliptical,female,filament,finely,flower,fruit,glabrous,globose,grey,grey-green,inflorescence,lateral,length,lobe,lobed,long,male,margin,midvein,mm,obtuse,ovate,ovate-reniform,perennial,petiole,plant,pseudo-racemose,purple,ray,reticulate,rotate,rotate-stellate,rusty,shrub,solitary,stellae,stellate-pubescent,stem,stigma,style,surface,throughout,time,triangular,tube,unbranched,unknown,vein,white,wide,x,yellow	%,.05,0,0-1,0.05-0.15,0.2-1.2,0.25-0.4,0.3-0.4,0.4-0.8,0.7-2,1,1-11,1-4,1-5,1.4-1.8,1.5-2,10-14,11-14,140-600,15-25,18-30,2-6,2-foliate,2.5-12,3-10,3-5,300-600,4-7,5-merou,6-70,7-11,abaxially,absent,abundant,accrescent,acicular,adaxiall,alyx,apart,armed,articulated,ascending,axe,ba,basal,blade,broad-based,brown,cylindrical,d.,diamete,directed,distal,distall,distributed,dult,eaf,eed,eglandular,enclosing,erect,extra-axillary,finger,flattened,forked,fruiting,functional,geminat,glabrou,gland-tipped,hair,heterostylous,index,interpetalar,lamina,lanceolate,lobing,lon,longer,lower,mature,midpoint,minute,nflorescence,oblique,orolla,part,pedicel,peduncle,per,pore,porrect,presen,present,prickle,probably,rhizomatous,ridged,ruit,sessile,short,side,simple,spaced,stage,stalk,straight,tal,tamen,terete,thick,tissue,unit,unknow,uvenile,vary,yellowish,ympodial	branching,corolla,form,growth,height,history,leaf,life,midrib,na,ovary,pubescence,reproduction,seed,shape,size,staman,stipe,texture,tip,width
153	wfo-0001026874	success	222	116	80	142	36	0.36	.5,0.5,1.5,2,3-5,6-7,abaxially,acuminate,acute,anther,apex,asymmetric,base,broadly,calyx,caudate,cm,dark,deltoid,diameter,drying,entire,filament,finely,flower,foveolate,fruit,glabrate,glabrous,glandular-pubescent,globose,growth,lanceolate,lateral,leaf,length,lenticular,lobe,margin,midpoint,midrib,midvein,mm,moderately,narrowly,obtuse,orange,ovate,petiole,pinnatifid,pubescence,pubescent,reddish,repand,ripe,rounded,scabrous,shrub,side,sparsely,stellae,stellate,stellate-pentagonal,stellate-tomentose,stem,stigma,style,surface,tan,thin-textured,tip,truncate,tube,upon,vein,weakly,white,x,yellow,–many	.3,0,0-1,0.2–0.6,1.5–2.5,1.5–4,1.5–5,12–20,15-20,1–,1–3,2-foliate,2–2.5,2–3,2–4,2–5,2–6,2–several-branched,4.5,4–7.5,5.5,5.5–7.5,5–15,6–12,6–9,8-12,8–20,9.5–11.5,absent,across,adaxiall,adaxially,along,apar,apical,attenuate,axe,basally,based,berry,beset,blade,broad,capitate,clavat,colored,compressed,connivent,dense,densely,depressed,developed,eaf,eed,erect,except,filiform,flowering,fruiting,geminat,generally,glabrou,gland,glandular,green,hair,hermaphroditic,internode,interpetalar,juvenile,lance,lanceolat,lanceoloid,larger,laterally,lighter,like,lon,long,lower,main,major,minute,near,new,nflorescence,often,orolla,ovoid,pedicel,peduncle,per,perfect,point,pore,portion,present,prickle,prickly,prominently,pubescen,rachi,recurved,reduced,ruit,scattered,sessile,shiny,short,similar,simple,slender,slightly,small,sometimes,somewhat,spaced,sparse,spreading,stalked,straight,subulate,swollen,tall,tamen,tem,tipped,tissue,tooth,ud,unarmed,usually,variable,vary,varying,vestiture,warty,widely,widest,yello,ympodia,–5	0.2-0.6,1-3,1.5-2.5,1.5-4,2-2.5,2-3,2-6,2-several-branched,4-7.5,5-15,5.5-7.5,6-12,6-9,8-20,9.5-11.5,branching,color,corolla,form,height,history,inflorescence,life,na,ovary,perennial,plant,ray,reproduction,seed,shape,size,staman,stipe,texture,width
154	wfo-0001026895	success	166	118	92	74	26	0.554	0.5-1,0.5-1.2,0.5-1.5,0.5-2,0.8-1,1-1.5,1-5,1.5-2,2-2.3,2-2.5,2-3,2/3,3-12,4.5-5,5-6,5-8-flowered,acute,along,anther,anthesi,apex,apically,attenuate,base,broad,brown,calyx,campanulate,cm,corolla,dark,dendritic,denser,dia,drying,elliptic,filament,flattened,glabrate,glabrous,globose,green,incrassate,lamina,lateral,leaf,lobe,lobed,main,margin,minutely,mm,mustard,narrowly,often,ovary,pair,pale,petiole,pitted,pointed,pubescent,reddish,reniform,scattered,shape,shrub,shrublet,simple,size,small,soon,sparsely,stem,stigma,style,surface,swollen,swollen-based,tan,thin,tip,toothed,trichome,tube,type,uniseriate,vein,way,white,x,yellow	.5,0-0.5,1.4-2.1,2.5-3.2,abaxial,adaxial,apical,appearing,ba,bark,berry,borne,broadly,capitate,closely,conical,contracted,deflexed,deltoid,differing,difoliate,eaf,edicel,eed,ellipsoid,elongate,erect,filiform,free,fruiting,geminat,hard,internodal,like,lon,long,long-exserted,lower,major,middle,minor,minute,nflorescence,obovate,older,overlappin,papillo,pedicel,pericarp,pore,poricidal,portion,present,projection,reddish-brow,ruit,scar,shaped,shoot,short,side,somewhat,spaced,tall,tear-drop,tub,tuft,ud,unit,usually,widest,woody,ympodial,young	branching,color,diameter,flower,form,fruit,growth,height,history,inflorescence,length,life,midpoint,midrib,midvein,na,plant,pubescence,ray,reproduction,seed,staman,stellae,stipe,texture,width
155	wfo-0001026905	success	204	91	74	130	17	0.363	0.4-1,0.75-1.1,0.9-1.3,1-2,1-2.5,1-3.7,1.9-2.5,1/2-3/4,2-3,2.5-2.9,3-5,3-8,acute,apically,apparently,base,berry,branched,calyx,cell,chartaceous,cm,cream,dark,densely,diameter,dull,erect,flattened-reniform,fruit,green,inflorescence,lateral,leaf,length,lobe,lobed,long,longer,marking,maturity,mauve,mm,moderately,oblong,orange,orange-brown,outline,ovate,pale,pit,raised,red,shrub,small,smooth,sometimes,sparsely,spherical,stellate,stellate-pubescent,stem,subentire,surface,time,tip,tube,usually,way,weakly,white,wide,yellow,young	-1.5,-10,-2,-2/3,-3,-4,.2,.5,0,0-2,0-20,0-25,0.1,0.15,0.2-0.3,0.2-0.5,0.3-0.4,0.4,0.4-0.9,0.5-0.7,0.5-1.5,0.6-0.7,0.7-1.4,1,1-20,1-4,1-6,1/3,1/4,1/5-1/3,2.5-3.5,2/3-3/,5-6,5-merous,6-8,7-8,abaxially,acuminat,alyx,ame,anther,apar,apart,apex,articulated,attenuate,bark,blade,brow,c.,connivent,curved,deltate,difoliate,discolorous,distance,drying,eaf,eed,elongating,equal,extending,eye,filament,flower,free,fruiting,geminat,glabrous,gray-green,infructescence,lower,margin,mature,midpoint,midvein,naked,older,one,open,orolla,oung,pair,pedicel,peduncle,pendulous,per,perfec,pericarp,petiole,poricidal,porrect,portion,prickl,prickle,prickly,primary,ray,reduced,rounded,ruit,scar,sessile,shallowly,shorter,side,slender,somewhat,spaced,spreading,stalk,stalked,straight,style,tamen,tapering,terete,tertiary,trichome,unarmed,unit,upper,variously,vary,vein,venation,visible,woody,yellow-green,ympodial	acuminate,branching,color,corolla,form,growth,height,na,perfect,plant,pubescence,reproduction,seed,shape,size,texture,width
156	wfo-0001026923	success	177	107	82	95	25	0.463	.5,0.25-0.5,0.5,0.5-1,0.6-0.8,0.8-1,1,1-1.5,1-7,10,2,2-2.5,2-6,20-50,3-5,4-18,5-9,abaxially,acuminate,acute,adaxially,anther,apex,base,black,branched,brown,calyx,chartaceous,cm,cuneate,densely,diameter,elliptic,elliptic-ovate,entire,filament,flattened,flower,forked,fruit,glabrescent,glabrous,globose,green,lanceolate,lateral,leaf,light,lobe,long,margin,midvein,mm,moderately,orange,petiole,possibly,pubescence,pubescent,purple,ray,red,ripening,rounded,rugulose,shrub,small,sparsely,stellate,stem,stigma,strongly,style,surface,tip,tree,tube,white,x,yellow,yellowish	-5,.1-0.3,0-5,1-3,1-4,1.5-2,1.5-4,2-3,3-4,4-5-,5-10,5-15,5-6,absent,accrescent,adaxiall,ag,apart,apparently,articulated,axe,ba,blade,capitat,center,connivent,covering,curved,cylindrical,deltate,denser,directed,distally,eaf,eed,eglandular,equal,erect,frui,fruiting,fused,geminate,gland-tippe,glandular,hair,held,intermediate,large,leaf-opposed,like,longitudinal,lower,many-foliate,midpoint,much,multangulate,nearly,nflorescence,oblong,opening,orolla,paired,pedicel,peduncle,peltate,perfect,pore,rachi,relatively,ruit,scale,sessile,short,simple,slightly,slit,smaller,sometimes,somewhat,spaced,ste,straight,subtending,tal,tamen,tem,time,trichome,unit,uprigh,usually,vary,whitish,wide,ympodial	0.1-0.3,branching,color,corolla,form,growth,height,history,inflorescence,length,life,midrib,na,ovary,plant,reproduction,seed,shape,size,staman,stellae,stipe,texture,vein,width
157	wfo-0001026924	success	190	99	76	114	23	0.4	%,0.2-0.4,0.5-0.6,0.5-6,0.8-2.6,1-1.5,1-4,1.1-4.2,10-13,17-40,2-2.5,2-4,2.8-8.5,3-6,4.3-6.2,8-9,acute,adaxially,anther,apex,base,brown,calyx,chartaceous,cm,cordate,cuneate,densely,diameter,drab,drying,entire,finally,fruit,glabrous,globose,green,grey,grey-green,herbaceous,inflorescence,lamina,length,light,lobe,lobed,long,margin,minutely,mm,obtuse,ovate,pale,perfect,petiole,pseudo-racemose,purple,resprouter,rusty,shallowly,stellae,stellate,stellate-pubescent,stem,stigma,style,surface,time,tube,unbranched,undulate,white,wide,x,yellow,yellowish	-4,0-0.2,0-1.5,0-2,0-2.3,0.05-0.1,0.05-0.2,0.1-0.3,0.4-0.5,0.5-0.7,0.5-0.8,0.5-1.5,0.7-1.1,0.7-1.2,0.8-1.2,0.9-1.3,1-6,2-,2-foliate,3,4-7,5,5-7,5-merou,6-8,7-10,7-8,abaxially,absen,absent,accrescent,acicular,across,adaxiall,alyx,apart,apparently,appearance,axe,blade,capitat,connivent,curved,cylindrical,d.,directed,distall,distally,distributed,dult,eaf,eed,eglandular,erect,extra-axillary,finger,first,flower,fruiting,geminat,glabrou,gland-tipped,hair,half,lanceolate,lateral,less,longer,lower,markedly,mature,mid-poin,midpoint,minute,narrowly,nflorescence,oblique,orolla,part,pedicel,peduncle,per,pore,porrect,present,prickle,rachi,raisin-like,ray,rostrate,ruit,short,simple,slightly,spaced,sparsely,stage,stalk,straight,tal,tamen,thick,thicker,thicknes,throughout,triangular,truncate,unarme,unarmed,unit,unknow,uvenile,vary,ympodial	abaxial,branching,color,corolla,filament,form,growth,height,history,leaf,life,na,ovary,perennial,plant,pubescence,reproduction,seed,shape,size,staman,texture,width
158	wfo-0001026925	success	215	115	89	126	26	0.414	.5,0.5-1.5,1-1.3,1-1.4,1-3.5,1.8-2,1.8-2.5,1/3,1/3-1/2,2.4-2.6,2.4-3,2.5-6,3-7,4-10,4-14,4-7,5-6,5.5-10,6-17,6-8,7-12,abaxially,acute,andromonoecious,anther,apex,apically,apparently,attenuate,base,berry,branched,broad-deltate,calyx,chartaceous,cm,cream,dark,diameter,erect,filament,flattened-reniform,flower,fruit,glabrescent,green,lateral,leaf,length,lobe,lobed,long,long-styled,lower,margin,marking,maturity,mauve,membranous,midpoint,midvein,mm,moderately,orange-brown,pale,petiole,plant,rarely,ray,short-styled,shrub,sparsely,spherical,spreading,stellate-pubescent,stem,style,surface,terminal,tip,tube,upper,vein,way,white,wide,yellow,yellow-orange,young	-2,/6,0,0-10,0-20,0-5,0-7,0.1,0.1-0.2,0.1-0.3,0.2,0.5-4,0.7-1.8,0.9-1.8,00-200,1-25,1-3,1-4,1.5-2,1.5-2.5,1.5-4.5,1/4-2/3,1/6-1/3,2-4,2-5,2/,3-20,4-5,5-8,5-merous,6-10,acuminat,alyx,ame,apar,apart,articulated,bark,blade,brow,c.,concolorous,connivent,curved,deltate,distal,distance,drying,eaf,eed,elliptic,elongating,equal,extending,flattened,free,fruiting,gently,glabrous,green-brown,hair,hermaphrodite,heterostylous,infructescence,lobing,longer,lowermost,mature,minute,narrow-deltate,nflorescence,oblong,older,one,open,orolla,oung,ovate,pair,pedicel,peduncle,pendent,pendulous,per,pericarp,plurifoliat,poricidal,porrect,portion,prickl,prickle,prickly,primary,red-brown,reduced,reflexed,rounded,ruit,scar,secondary,sessile,side,simple,smooth,sometimes,spaced,stalk,stalked,staminat,stellate,stout,straight,tamen,tapering,terete,tertiary,time,translucent,trichome,unarmed,unit,vary,venation,visible,woody,ympodial	2/3,acuminate,branching,color,corolla,form,growth,height,history,inflorescence,life,midrib,na,ovary,perennial,pubescence,reproduction,seed,shape,size,staman,stellae,stigma,stipe,texture,width
159	wfo-0001026946	success	205	94	75	130	19	0.366	0.5-2,1-2,1-4,1.5-2,1.6-3.7,10-39,2-15,3-5,3.5-10,5-7,6-24,8-15,8-25,abaxially,acute,adaxially,anther,attenuate,brownish,chartaceous,cm,condition,corolla,creamy,deeply,densely,diameter,drying,filament,flower,forked,fresh,fruit,glabrous,globose,green,greenish,hair,herb,like,lobe,long,membranous,midrib,minutely,mm,mottled,odd-pinnate,ovoid,pentagonal,perfect,petiole,plant,puberulent,pubescent,pure,purple,ripe,seed,short,short-pubescent,size,slightly,stellate,stem,stigma,streak,style,tip,tube,white,whitish,x,yellow,yellow-white	0-20,0-5,0.9-3.5,0.9-4.3,1,1-10,12-23,2,2-5,2.5-10.5,2.7-9,3-20,3-6,4-7,4.1-9.4,5-merou,acumen,acuminate,ag,along,alyx,apart,apex,apparently,articulation,axe,axillary,base,berry,blade,borne,broadly,bud,capitat,cell,ciliate,clavate,connivent,covering,digestion,distal,dorsally,dot,eaf,edge,eed,elliptic,end,enzyme,erec,especially,exceeding,except,extremely,flat,folded,geminat,generally,glabrou,greatly,green-white,hair-like,half,homostylous,honeycomb-shaped,interjected,lanceolate,lateral,leaflet,lengthening,living,lower,make,margin,mucilaginous,narrowly,nflorescence,oblique,often,orbicular,orolla,ovate,pair,pedicel,peduncle,petiolulate,petiolule,plurifoliate,pore,poricidal,proximal,pubescen,reduced,removed,rounded,ruit,scattered,sessile,seudostipule,singly,slit,spaced,specimen,stamen,ste,stolo,straight,subequal,subtending,tall,tamen,tem,terminal,testal,thick,thir,throughout,tri-,truncate,tuber,typically,unit,unwinged,usually,variable,vary,wall,wet,wing,ympodial	branching,calyx,color,form,growth,height,history,inflorescence,leaf,length,life,na,ovary,perennial,pubescence,reproduction,shape,staman,texture
160	wfo-0001026962	success	205	98	78	127	20	0.38	.05,.5,0.3-0.7,0.8-1,1,1-1.2,1-1.5,1-6,1.5-17,1.5-2,1.5-5,10-20,2-2.5,2-6,3-3.5,4-5,6-7,abaxially,acute,adaxially,anther,apex,base,beneath,calyx,chartaceous,cm,corolla,densely,diameter,dry,entire,evenly,filament,flattened-reniform,flower,fruit,glabrous,globose,green,inflorescence,leaf,lobe,lobed,long,margin,material,minutely,mm,ovate-lanceolate,pale,perfect,petiole,pitted,prominent,pubescent,purplish,raised,rounded,shrub,simple,size,small,sometimes,stellate,stem,stigma,style,surface,tinged,tip,tree,tube,unbranched,white,x,yellow,yellowish	0,0.5,0.5-0.8,0.5-1,0.5-1.5,1-2,1-3,1-4.5,1.5-3,10-12,15-22,2-5,2/3-3/4,3-6,9-12,9-17,abrupt,abruptly,accrescent,ag,alyx,anthesi,apparently,appearing,arising,articulated,axe,bark,basebud,becoming,blade,brittle,broadly,bud,capitat,cell,closely,composed,connivent,constricted,cucullat,cylindrical,darker,deflexed,deltate,denser,differing,difoliate,dimorphic,eaf,eed,elliptic,elongate,except,exerted,free,fruiting,geminat,glabrate,glabrou,ilament,incrassate,internodal,later,lateral,like,longitudinal,main,major,minor,narrowly,nflorescence,obconic,oblong,obovoid,occasionally,often,older,one,opening,opposite,orolla,oung,outline,overlapping,packed,pair,papillose,paten,pedicel,peduncle,pendent,pore,portion,pubescen,rachi,reflexed,remaining,rest,rounder,ruit,sagittate,shaped,slender,slightly,slit,somewhat,soon,straight,tal,tapering,tear-drop,tooth,triangular,trichome,trunk,unarmed,unifoliate,uniseriate,unit,vary,vein,way,whit,woody,ympodial,young	branching,color,form,growth,height,history,length,life,midrib,midvein,na,ovary,perennial,plant,pubescence,reproduction,seed,shape,staman,texture
161	wfo-0001026963	success	151	111	92	59	19	0.609	-5,.4,.5,0.2-0.6,0.8-3,1-1.5,1-2,1.2-1.5,1.5-4.5,1.5-6,2-2.5,2-4.5,4,4-5,6-7,abruptly,acute,anther,anthesi,apex,apical,bark,base,c.,calyx,capitate,cm,conical,coriaceous,corolla,curved,dark,densely,diameter,ellipsoid,elliptic,elongate,flower,glabrous,growth,herb,heterostylous,included,inflorescence,lobe,lobed,long,long-styled,long-triangular,margin,markedly,mature,membranous,midpoint,minute,minutely,mm,new,node,oblique,ovary,ovate,pair,pedicel,peduncle,petiole,prickle,prickly,primary,pubescent,reddish,rooting,scattered,shallowly,short-styled,simple,sparsely,stellate,stem,stigma,style,subshrub,tapering,tooth,trichome,truncate,tube,vein,way,white,x,yellowish	0.5,0.5-0.6,1.1-1.4,3-5,3-5-rayed,5-6,<,abaxially,absent,acicular,armed,articulated,brow,closely,clustered,creeping,cup-shaped,deep,eaf,eed,elongating,filament,free,inflorescenc,internodal,know,known,like,lower,nflorescence,nodding,older,outline,papillo,per,plurifoliat,pore,poricidal,porrect,portion,prominent,ray,reflexed,rootstock,ruit,scar,sessile,side,slit,small,sometimes,spaced,surface,tip,ud,unarmed,unit,woody,ympodial	branching,brown,bud,color,form,habit,history,inclusion,leaf,length,less,life,papillose,perennial,pricklines,pubescence,shape,size,texture
162	wfo-0001026964	success	128	93	64	64	29	0.5	.2,.5,0,0.5,0.5-1,10,10-30,2-2.5,7-8,?,acuminate,acute,along,anther,anthesi,apex,attenuate,base,calyx,cm,conical,corolla,diameter,filament,flower,glabrous,green,greenish,herb,lateral,lobe,lobed,long,margin,minutely,mm,nearly,open,ovary,pair,papillate,petiole,pinnate,pubescent,purple,reflexed,rugose,shape,simple,size,smooth,somewhat,sparsely,stigma,style,surface,time,tip,trichome,tube,uniseriate,vein,x,yellow	1-1.2,1-2.5,2-4,3-5,3.5-7,4.5-8.5,axillary,basal,beak,bearing,berry,capitat,conspicuously,differentiated,distinct,eaf,edicel,elliptic,equal,erec,exserted,filiform,fleshy,free,fruiting,glabrou,globose,horizontal,immature,known,leaflet,lenticellate,lightly,line,long-attenuate,lower,nflorescence,noddin,obovate,often,one,onto,ot,pedicel,petiolule,poricidal,portion,primary,purpli,rachi,ruit,scar,side,slender,small,tal,tem,terminal,tub,ud,unifoliat,unit,winged,ympodial	.5-1,branching,color,form,fruit,growth,height,history,inflorescence,leaf,length,life,midpoint,midrib,midvein,na,perennial,plant,pubescence,purplish,ray,reproduction,seed,staman,stellae,stem,stipe,texture,width
163	wfo-0001026965	success	157	91	57	100	34	0.363	-2.5,0.2,0.4,0.5-,0.5-1.5,0.6-2,0.7-1,0.7-1.5,1.1-1.65,1.3-2,1.5-2,1.5-4,1.7-2,1.9-2.4,2.5-4,acute,anther,antrorse,apex,base,calyx,campanulate,cm,cuneate-attenuate,diameter,elliptical,filament,glabrous,globose,herb,lobe,margin,mm,narrowly,obovate,ovate,pale,petiole,pinnatifid,pinnatipartite,pubescent,seed,simple,stem,stigma,style,surface,tip,trans-ovoidal,trichome,tube,tuberculate,uniseriate,violet,white,x,yellow	.3,.5,.6,0.6-1.1,0.7-1.1,0.8-1.25,2/3,25,3-,3-4,3.5-6.2,3.5-9,5-15,6.4-12,8-17,abaxially,abundant,accrescent,adaxially,ag,appressed,articulated,basal,berry,broadly,c.,capitate,coat,coiled,connectival,covering,cylindrical,difoliat,dorsal,eaf,eed,eglandular,ellipsoidal,elliptic,embryo,evident,exserted,flexuose,fruiting,glandular,herbaceous,hig,latitudinally,long,longer,longitudinal,longitudinally,lower,mixed,multi-seeded,non-glandular,noticeable,opening,opposite,orolla,outer,ovat,pair,papery-scarious,papillae,papillose,partially,pore,poricidal,portion,procumbent,prolongation,prostrate,ree,reticulate,ridged,rounded,ruit,segment,short,similar,slightly,slit,small,smooth,straight,striate,strongly,styl,subglobose,tem,time,unequal,unifoliate,unit,vary,venation,wider,winged,ympodial	0.6,3-15,branching,color,corolla,flower,form,fruit,growth,height,history,inflorescence,lateral,leaf,length,life,midpoint,midrib,midvein,na,ovary,perennial,plant,pubescence,ray,reproduction,shape,size,staman,stellae,stipe,texture,vein,width
164	wfo-0001026981	success	252	102	85	167	17	0.337	-0.8,-2.5,-35,-4,0.05-0.1,0.3-0.5,0.3.6,0.4-0.5,0.5,0.5-30,0.6-1.4,0.8-1.2,1-2,1-3,1.5-2.0,1.5-8.5,1.8-2.8,11,2-3,2-3-branched,3.5-14,4,6-10,7.5,<,abaxially,adaxially,anther,brown,calyx,capitate,cm,corolla,dark,deltate,densely,diameter,filament,flower,fruit,glabrescent,glandular,globose,green,hair-like,herb,imparipinnate,interrupted,leaf,leaflet,lime,linear,lobe,long,minutely,mm,narrowly,obovate,orange,orbicular,outgrowth,ovary,ovate,pale,pentagonal,perennial,petiole,plant,pubescence,pubescent,simple,sometimes,sparsely,stem,stigma,style,surface,thick,tube,upto,variously,velvety,villous,wide,yellow	-0.4,-14,-2,-8,.2,.2-0.2,0-5,0.1-0.2,0.1-0.3,0.15-0.2,0.2,0.2-0.4,0.2-2,0.25-0.4,0.4-0.7,0.4-2,0.45-1.3,0.5-0.3,0.6-2,0.7-0.8,0.8-6,0.9-1.4,0.9-1.5,1,1-2-cellular,1-3-celled,1-3.3,1-4,1.5-5,1/3,196.,2-locular,3-foliate,4-8,4-celled,absen,absent,abundant,academy,accrescent,acute,adpressed,along,amongst,angled,anthesi,apex,apical,appearance,appendage,appressed,articulated,articulation,asymmetric,axi,base,basiscopically,bay,beak,becoming,bract,bracteole-like,cell,citrus-like,coastal,column,composed,cone,conical,cordate,d,distal,eaf,ebracteate,edicel,eed,entire,erect,exserted,fruiting,giving,gree,half,halfway,head,included,initially,interjected,internode,irregularly,jointles,larger,later,lateral,less,like,lobed,lon,lower,mainly,margin,maturity,mixed,much,multicellular,nflorescence,occasionally,pair,patent,pedicel,peduncle,per,petiolule,population,present,primary,procumbent,pronounced,proximal,pseudostipule,rachi,reflexed,rick,robust,rounded,ruit,scen,secondary,see,sessile,several,shaggy,shaped,short,shorter,silky,slender,smaller,sparser,specimen,spreadin,staminal,sterile,straight,strong,tangled,tem,terminal,tertiary,testa,tightly,transparent,trichome,tub,type,uni-,unicellular,uniseriate,unit,usually,viny,wall,winged,without,ympodial,‘,’	color,form,growth,height,history,inflorescence,length,life,midrib,na,reproduction,seed,shape,size,staman,texture,tip
165	wfo-0001026987	success	214	113	92	122	21	0.43	0.2-0.4,0.2-0.5,0.4-1,0.5-2,0.7-0.8,0.7-1.5,1-2,1-3,1-4,1.1-6,1.5-2,2-5,2.5-11,3.5-3.8,3.5-5,5-10,5.5-7,6-20,acute,adaxially,anther,apex,base,bent,calyx,chartaceous,cm,cordate,cuneate,cylindrical,deltate,densely,diameter,entire,erect,filament,flower,fruit,glabrous,glandular,glandular-hairy,globose,grey,hair,hastate,inflorescence,lacking,lateral,leaf,length,lilac,lobe,lobed,long,margin,midpoint,mm,narrowly,obtuse,often,pale,perennial,perfect,petiole,purple,ray,red,rhizomatous,shallowly,shrub,simple,slightly,sparse,sparsely,stellae,stellate,stellate-pubescent,stigma,style,summit,thickened,thin,time,toward,triangular,tube,twisted,unbranched,upward,white,x,yellow	%,0-0.1,0-0.2,0-1,0-10,0-4,0.05-0.1,0.2-1,0.25-0.4,0.4-0.5,0.4-0.7,0.5-0.7,0.5-1,0.5-2.5,0.7-1,1-11,1.1-2.6,1.4-3,15-35,2-7,2.5-6.5,4-6,4-7,4.5-6,5-8,5-merou,7-10,8-10,8-11.5,8-12,8-13,abaxially,absen,absent,abundant,accrescent,across,adaxiall,adult,alyx,apart,articulated,ascending,axe,ba,basal,berry,blade,branch,branche,broad-based,capitat,connivent,curved,decimetre,deflexed,directed,distall,distributed,dm,eaf,eed,eglandular,extra-axillary,finger,fruiting,gland-tipped,green,half,homostylous,interpetalar,juicy,juvenile,lamina,lanceolate,less,longer,loosely,lower,mature,mesocarp,mid-point,minute,nflorescence,oblique,orolla,ovate,pair,part,pedicel,peduncle,per,pore,porrect,present,prickle,rachi,ruit,scarcely,sessile,shallowly-lobed,short,spaced,stalk,straight,succulen,surface,tal,tamen,tem,thick,throughout,tissue,unarme,unarmed,unit,unknow,upper,vary,wide,yellowish,ympodial	capitate,color,corolla,form,growth,height,history,life,midrib,na,ovary,plant,pubescence,reproduction,seed,shape,size,staman,stem,texture,tip
166	wfo-0001026992	success	243	128	105	138	23	0.432	-2.5,0.2-0.5,0.5-1.2,0.8-3.4,00-170,1-4,1.2-1.4,1.2-1.7,1.3-2.6,1.3-4.3,1.4-1.6,1.4-1.9,1.7-2.4,1.7-4.3,10-12,12-33,2.8-4.7,3-4,3.3-5.6,5-15,8,8-14,abaxially,abruptly,acuminate,acute,anther,apex,attenuate,base,branched,broadly,brown,calyx,chartaceous,cm,corolla,dark,deltoid,diameter,drying,elliptic,entire,filament,flower,fruit,glabrous,globose,granular-tomentose,greenish,hair,lance-ovate,lateral,leaf,length,lobe,long,many,margin,midrib,mm,moderately,occasional,orange-tan,ovate,ovate-lanceolate,perfect,petiole,plant,pubescence,pubescent,rather,reniform,reticulate-punctate,ripe,scabridulous-,semi-ovate,short,shrub,side,size,small,sometimes,stellate,stem,stigma,style,surface,tan,terminal,thin-textured,time,tip,tomentose,tree,tube,vein,velutinous,violet,white,whitish,wide,x,yellow,yellowish	/7,0.25-0.45,0.6-1.5,1.5-3.4,1.7-1.9,1/2,2-10,2-5.6,2.3-3.3,2.6-4.6,2.8-4.6,3.3-5.5,4-8,5-merou,5.3-12.1,6-10,8-11,abaxial,accrescent,adaxiall,adaxially,ag,along,alyx,angled,anthesi,apart,apparently,appressed,approximately,around,articulated,axe,axillary,ba,bark,berry,blade,blunt-tipped,branch,capitat,completely,coriaceous,covering,crown,cylindrical,densely,directed,distally,eaf,echinoi,echinoid,edge,eed,enveloping,equal,evident,exserted,farinose,flat-topped,fleshy,forming,free,fruiting,geminate,glabrescen,grooved,high,homostylous,immature,inserted,lacking,lanceolate,lengthening,less,line,lobed,long-stalked,longitudinal,longitudinally,lower,m.,main,mature,maturity,minute,mostly,multangulate,nearly,nflorescence,oblong,obtuse,occasionally,often,older,orolla,overlapping,pedicel,peduncle,plurifoliate,pore,poricidal,porrect-stellate,rachi,rare,ruit,runk,sessile,short-,short-stalked,shorter,simple,slit,somewhat,spaced,sparingly,split,spreading,stalked,stamen,stout-stalked,subcampanulate,subglobose,suture,tamen,terete,ud,unarme,unarmed,unequal,unit,usually,vary,way,weakly,ympodial,young,½	branching,color,form,growth,height,history,inflorescence,life,midpoint,midvein,na,ovary,perennial,ray,reproduction,seed,shape,sparsely,staman,stellae,stipe,texture,width
167	wfo-0001026994	success	266	126	103	163	23	0.387	-10,-20,-30,.5,0.05-0.1,0.5,0.5-0.6,0.5-0.7,0.5-0.8,0.5-2,1,1-1.4,1-1.5,1.2-1.6,2-,2-2.6,2.2-3.2,2.5-6.5,20-50,4,5-,6-20,7-13,8-12,abaxially,acuminate,acute,anther,apex,basal,base,bifurcate,branched,bright,broadly,brown,calyx,cell,cm,corolla,crenate,dark,deeply,densely,diameter,filament,flower,fruit,glabrous,globose,grayish,greenish,hair-like,half,herb,imparipinnate,inflorescence,interrupted,irregularly,lanceolate,lateral,leaf,less,lobe,lobed,locule,long,margin,midvein,minutely,mm,obovate,outgrowth,ovary,perennial,petiole,puberulent,pubescent,purple,rachi,regularly,ripe,rotate-stellate,simple,size,sparsely,stem,stigma,stripe,style,surface,testa,thick,tip,trichome,tube,uniseriate,usually,velvety,wall,white,wide,yellow	-0.7,-foliate,.2,0.05-0.2,0.1,0.1-0.2,0.1-0.3,0.15-0.2,0.2-0.4,0.2-0.5,0.25,0.3-0.4,0.4-0.5,0.4-1.2,0.5-0.9,0.5-1.2,0.5-1.3,0.7-2.5,0.9-1.2,0.9-1.3,1-1.2,1-1.6,1-2,1.2-3.5,1.4-2.1,10-20,12-,2,2-4,2-5-locular,3,3-branched,4-15,4-celled,5,5-7,8,absent,abundant,acroscopically,additional,adpressed,along,also,amongst,andscattered,anthesi,apical,apically,appearance,appendage,articulate,articulation,basally,basiscopically,becoming,beneath,bent,berry,bifurcation,bract,bracteate,broader,capitate,celled,column,conical,crenat,crowded,darker,decreasing,decumbent,decurrent,developed,distal,eaf,ebracteate,edicel,eed,eglandular,elliptic,erect,especially,essentially,exserted,fewer,fruiting,giving,glandular,gree,green,habitat,hal,halfway,head,interjected,internode,investing,lamina,large,larger,largest,leaflet,leave,like,lon,loosely,lower,markedly,medial,moderately,much,narrower,narrowing,narrowly,nearly,nflorescence,node,oblique,occasionally,often,pair,paler,papillate,pedicel,peduncle,petiolule,present,primary,pseudostipule,rarely,reflexed,robust,rocky,secondary,sessile,set,shaggy,short,silky,sinus,slightly,sometimes,specimen,spreadin,spreading,staminal,sterile,straight,tall,tem,terminal,tertiary,toward,ud,unicellular,unit,weak-walled,well,winged,woody,ympodial,young	branching,color,decurrenct,form,growth,height,history,length,life,midpoint,midrib,na,plant,pubescence,ray,reproduction,seed,shape,staman,stellae,stipe,texture,vein
168	wfo-0001026996	success	188	99	77	111	22	0.41	0.6-1,1-2,1-3,1.2-1.8,1.8-4.4,14-33,2-3,3-10,3-7,3.8-14.1,4-8,4.5-10.5,5-8,8.7-18.6,abaxially,acumen,adaxially,anther,blue,brownish,cell,cm,condition,coriaceous,corolla,covering,dark,deep,diameter,drying,filament,flower,forked,fresh,fruit,glabrous,globose,green,green-white,greenish,hair-like,herb,lateral,leaf,lilac,linear,lobe,long,make,medium,mm,mottled,mucilaginous,odd-pinnate,ovoid,pentagonal,petiole,plant,purple,ripe,rotate,seed,size,stigma,stripe,style,testal,thick,throughout,tip,tube,wall,wet,white,whitish,x,yellow	0-6,0.9-2.7,1-4,1-5,1.3-7.7,15-28,3-5,3.3-6,4-4.4,5-merou,6-8,6.9-10.9,abaxiall,acuminate,acute,ag,along,alyx,apart,apex,apparently,arranged,articulated,asymmetric,attenuate,axe,axillary,base,basiscopic,bead,berry,blade,bud,capitat,clavate,connivent,considerably,decreasing,digestion,distal,dorsally,eaf,edge,eed,elliptic,enzyme,erec,exceeding,flat,folded,geminat,generally,glabrou,half,homostylous,honeycomb-shaped,interjected,lanceolate,larger,leaflet,lengthening,like,living,lower,middl,moniliform,multiple,necklace,nflorescence,orbicular,orolla,ovate,pair,pedicel,peduncle,perfect,petiolulate,plurifoliate,pore,poricidal,removed,rounded,ruit,sessile,seudostipule,side,slightly,slit,sometimes,spaced,specimen,stamen,stolon,straight,subglabrou,subtending,symmetric,tall,tamen,tem,terminal,tissue,toward,tri-,tuber,typically,unit,unwinged,usually,vary,ympodial	abaxial,adaxial,branching,calyx,color,form,growth,height,history,inflorescence,length,life,midrib,na,ovary,perennial,pubescence,shape,staman,stem,surface,texture
169	wfo-0001027009	success	226	114	93	133	21	0.412	0-0.2,0.4-1,0.5-2,0.7-1,0.8-1.3,0.8-2.1,1.4-4,1.6-3.5,10-15,2-3,2.3-3,3-3.5,3-5,3.3-3.6,4-6.5,4-9.5,6-9,6.5-11,7-11,7-12.5,acute,adaxially,andromonoecious,anther,apex,attenuate,base,black,broadly,brown,calyx,chartaceous,cm,cuneate,deeply,deltate,densely,diameter,elliptical,erect,filament,flower,fruit,glabrous,glandular,globose,green,grey,grey-green,hair,inflorescence,lateral,length,lobe,lobed,long,margin,midvein,minutely,mm,obtuse,ovate,pale,perennial,petiole,plant,pseudo-racemose,purple,ray,reticulate,rhizomatous,ripe,rotate,shallowly,shrub,stellae,stellate-pubescent,stem,stigma,strongly,style,surface,throughout,time,tip,tube,unbranched,vein,white,wide,x,yellow,yellowish-green	%,0-0.3,0-0.5,0-1.2,0-1.5,0-15,0-5,0-8,0.1-0.2,0.15-0.3,0.7-0.9,0.7-1.3,0.8-1.2,1-1.5,1-1.8,1-2,1-2.5,1-3,1-5,1-9,1.3-2.2,10-20,2-4,2-6,2-foliate,20-30,23-48,3-10,35-400,40-125,5,5-23,5-7,5-merous,6-8,7-8,abaxially,absent,abundant,accrescent,acicular,adaxiall,alyx,apart,armed,articulated,ascending,axe,ba,basal,bilobe,bisexual,blade,broad-based,capitate,connivent,curved,cylindrical,d.,deflexed,dimorphic,directed,distal,distall,distributed,dult,eaf,eed,eglandular,entire,extra-axillary,finger,fruiting,functional,geminate,gland-tipped,half,heterostylous,incised,index,interpetalar,juic,lamina,lanceolate,larger,lobing,lon,longer,lower,male,markedly,mature,mesocarp,midpoint,minute,moist,nflorescence,oblique,orolla,part,pedicel,peduncle,per,pore,porrect,presen,present,prickle,pricklie,probably,rarely,ridged,ruit,short,side,simple,slightly,spaced,stage,stalk,straight,tal,tamen,terete,thick,tissue,unarmed,unit,unknow,uvenile,vary,yellowish,ympodial	branching,color,corolla,form,growth,height,history,leaf,life,midrib,na,ovary,pubescence,reproduction,seed,shape,size,staman,stipe,texture,width
170	wfo-0001027010	success	198	92	70	128	22	0.354	0.4-5.1,0.5-1.5,1-2,1-7,1.2-1.7,1.2-1.9,2.1-4.3,3-10,3-6,3-8,4-12,4-8,4.4-29,4.9-31,5-13,5-14,abaxially,acumen,acute,adaxially,anther,brownish,cm,condition,coriaceous,corolla,deep,diameter,drying,filament,forked,fresh,fruit,glabrescent,glabrous,green,greenish,hair,herb,lanceolate,leaf,light,lobe,long,mm,odd-pinnate,ovate,ovoid,pentagonal,perfect,petiole,plant,purple,ripe,rotate,scabrous,seed,short,size,stigma,stripe,style,tip,tube,usually,white,whitish,wide,x,yellow	0-2,0-2.5,0-3,1-10,1-4,1.4-6.9,10-60,14-46,2-6,2-9.4,2.1-15.3,2.2-12.9,3-5,3.5-13.6,5-merou,acuminate,adaxiall,ag,along,alyx,apart,apex,apparently,arranged,articulated,asymmetric,attenuate,axe,axillary,base,basiscopic,bead,blade,bud,capitat,cell,clavate,coloration,connivent,covering,decreasing,digestion,distal,dorsally,eaf,edge,eed,elliptic,enzyme,erec,exceeding,flat,flower,folded,geminat,generally,glabrescen,glabrou,green-white,hair-like,hal,half,high,homostylous,honeycomb-shaped,interjected,larger,lateral,leaflet,lengthening,like,living,lower,make,moniliform,mucilaginous,multiple,narrow,necklace,nflorescence,occasionally,orbicular,orolla,pair,pedicel,peduncle,petiolulate,plurifoliate,pore,poricidal,present,removed,rounded,ruit,scabrou,sessile,seudostipule,side,slightly,slit,sometimes,spaced,specimen,spot,stamen,stolon,straight,subequal,subtending,tall,tamen,tem,terminal,testal,thick,throughout,tissue,toward,tri-,tuber,typically,unit,vary,wall,wet,wing,winged,ympodial	abaxial,adaxial,branching,calyx,color,form,growth,height,history,inflorescence,length,life,midrib,na,ovary,perennial,pubescence,reproduction,shape,staman,stem,texture
171	wfo-0001027019	success	142	86	66	76	20	0.465	/4,0-0.5,0.5-1,1-1.5,1-2,1.5-2,1.5-3,10-40-flowered,12-30,2-3,2-8,4-5,7-14,abaxially,adaxially,along,anther,anthesi,base,branched,calyx,cm,corolla,densely,dia,filament,flattened,glabrous,globose,golden,green,inflorescence,leaf,like,lobe,lobed,long,midrib,minutely,mm,obovate,ovary,ovoid-reniform,pale,papillose,petiole,pitted,planar,plant,pubescent,rest,shrub,small,somewhat,stem,stigma,style,surface,tan,tip,tree,trichome,tube,way,white,x	.5,1/2,10,2-5,4-8.5,abaxial,abruptly,acute,apex,apparent,attenuate,ba,bark,berry,bright,capitate,constriction,cyathiform,deflexed,deltoid,difoliate,distal,eaf,edicel,eed,ellipsoid,elliptic,erect,even,exserted,fleshy,free,fruiting,geminat,glabrate,inflorescenc,largely,later,live,lon,lower,major,minor,narrowed,nflorescence,older,onto,opposite,overlapping,papillo,pedicel,pore,poricidal,portion,reddish-brow,ruit,scar,shaped,spaced,sparsely,straight,strongly,tall,tapering,tear-drop,third,tub,ud,unit,waxy,widest,wing,winged,woody,ympodial,young	color,diameter,flower,form,fruit,growth,height,history,length,life,na,perennial,pubescence,reproduction,seed,shape,size,staman,texture,width
172	wfo-0001027030	success	234	93	75	159	18	0.321	-15,.5,0.05-0.1,0.4-0.5,0.5-0.7,0.6-0.7,0.8-0.9,1,1-1.3,1-3,1.2-1.6,1.6-2,2-6,2-7,2.2-3.2,5-12,abaxial,acute,anther,apex,branched,bright,brown,calyx,capitate,cm,corolla,crenate,dark,deeply,densely,denser,diameter,entire,evenly,filament,flower,fruit,globose,grayish,green,hair-like,herb,imparipinnate,inflorescence,interrupted,lanceolate,lobe,long,margin,minutely,mm,obovate,outgrowth,ovary,pale,papillate,perennial,petiole,pubescence,pubescent,rotate-stellate,simple,size,soft,sometimes,spread,stem,stigma,style,surface,tube,velvety,wide,yellow	-11,.2,0-4,0.1-0.7,0.1-0.9,0.15-0.2,0.2,0.2-0.3,0.2-1,0.3-,0.3-0.5,0.3-0.7,0.4-0.8,0.4-1.5,0.5,0.5-,0.5-0.8,0.5-1,0.6-0.8,0.6-1.8,0.7-1,0.8-1,0.9-1.1,1-,1-1.2,1-3.4,1.5-,2-,2-3,2-4,2-4.8,2-foliate,2-locular,3-4-celled,3-8,3-9,4-celled,8-celled,abaxially,absent,abundant,acuminate,adaxially,adpressed,angled,anthesi,apical,appearance,appendage,articulated,articulation,axi,basal,base,basiscopically,beneath,berry,beyond,bract,cell,column,conical,crenat,crenation,darker,decurrent,deeper,diamete,distal,due,eaf,edicel,eed,eglandular,elliptic,exserted,extremely,fruiting,giving,gland,glandular,gree,growt,hal,half,halfway,interjected,internode,interspersed,investing,irregularly,lamina,larger,lateral,leaflet,less,like,lon,longer,loosely,lower,multicellular,narrowly,near,nflorescence,node,oblique,occasionally,often,pair,paler,pedicel,peduncle,petiolule,present,primary,pseudostipule,reflexed,robust,ruit,secondary,sessile,silky,similar,slender,slightly,small,smaller,somewhat,sparsely,spreadin,spreading,staminal,sterile,straight,stripe,tall,tem,terminal,tertiary,testa,thick,tiny,trailing,trichome,truncate,ud,unicellular,uniseriate,unit,usually,vein,wall,weak,white,winged,woody,ympodial,young	2-9,adaxial,color,form,growth,height,history,leaf,length,life,na,plant,reproduction,seed,shape,staman,texture,tip
173	wfo-0001027035	success	199	108	88	111	20	0.442	0.1-0.9,0.3-2.3,0.5-5,0.5-7,0.9-3.1,1-2,1-3,1-3.4,1.8-5.2,2-38,2.8-10.3,3-10,4-18,4-18.5,4.9-23.5,abaxially,acumen,adaxially,anther,blue,brownish,cell,cm,coloration,completely,condition,corolla,covering,deep,diameter,drying,elliptic,filament,flower,forked,fresh,fruit,glabrescent,glabrous,globose,green,green-white,greenish,hair,hair-like,herb,lanceolate,lateral,leaf,light,lilac,lobe,long,make,medium,mm,mucilaginous,odd-pinnate,ovate,ovoid,pentagonal,perfect,petiole,plant,purple,ripe,rotate,seed,shape,short,size,sometimes,stigma,stripe,style,testal,thick,throughout,tip,tube,usually,wall,wet,white,whitish,wide,x,yellow	0-36,0-7,0.4-12.8,0.5-3.4,0.8-3,0.8-4.2,1-8,1.5-5.9,1.7-8,10-80,2-7,3-5,5-merou,acuminate,acute,adaxiall,ag,along,alyx,apart,apex,apparently,arranged,articulated,asymmetric,attenuate,axe,axillary,base,basiscopic,bead,blade,bud,capitat,clavate,connivent,decreasing,digestion,distal,dorsally,eaf,edge,eed,enzyme,erec,exceeding,flat,folded,geminat,generally,glabrescen,glabrou,hal,half,high,homostylous,honeycomb,interjected,larger,leaflet,lengthening,like,living,lower,moniliform,multiple,necklace,nflorescence,orbicular,orolla,pair,pedicel,peduncle,petiolulate,plurifoliate,pore,poricidal,present,removed,rounded,ruit,second,sessile,seudostipule,shaped,side,slightly,slit,smaller,spaced,specimen,stamen,stolon,straight,subequal,subglabrous,subtending,tall,tamen,tem,terminal,tissue,toward,tri-,tuber,typically,unit,unwinged,variable,vary,ympodial	branching,calyx,color,form,growth,height,history,inflorescence,length,life,midrib,na,ovary,perennial,pubescence,reproduction,staman,stem,surface,texture
174	wfo-0001027050	success	244	115	93	151	22	0.381	-12,-9,/3,0.1-0.3,0.2-1,1-1.5,1-2,1.5-6,10-13.5,15-50+,2-2.5,2-5,2-8,2.5-3,3-5,4-20,4-8,5-10,5-9,8-26,acuminate,acute,anther,apex,base,branched,broadly,brown,calyx,chartaceous,cm,coarsely,cordate,cuneate,densely,diameter,elliptic,entire,ferruginous,filament,flattened-reniform,flower,fruit,glabrous,glandular-puberulent,green,growth,heterostylous,inflorescence,lateral,leaf,length,lobe,lobed,long,margin,midrib,midvein,mm,moderately,obtuse,ovate,ovate-lanceolate,pale,petiole,plant,pubescent,ray,ripe,rounded,several,shallowly,shrub,small,sparsely,spherical,stellate-pubescent,stem,stigma,style,time,tip,toothed,tree,truncate,tube,unbranched,way,weakly,white,wide,yellow,yellowish-green	.2,.5,0-0.2,0-3,0.1-3,0.2-0.5,0.3-1.5,0.5-3,0.8,0.9-2.1,1,1.5-2,12-15,2-3,2-4,5,5-6,5-7,5-merous,50,6-8,7-30+,abaxial,abaxially,absen,absent,abundant,adaxial,adaxiall,adult,alyx,andromonoeciou,apar,arme,articulated,axe,bark,basal,berry,blade,branch,broad,broad-based,brow,capitate,closely,conical,connivent,curved,deeply,difoliate,directed,distal,distall,distally,drying,eaf,eed,eglandular,equal,erec,erect,except,flattened,free,fruiting,geminat,hair,half,infructescence,inside,interpetalar,juicy,juvenile,lanceolate,larger,leaf-opposed,least,less,like,long-styled,longer,lower,markedly,mature,mid-way,midpoint,minute,minutely,moist,mucilaginous,multiseriate,narrowly,near,nflorescence,numerous,oblique,occasionally,often,older,orolla,oung,papillat,pedicel,peduncle,per,pericarp,pore,poricidal,porrect,portion,present,prickle,pricklier,prickly,rest,ruit,scar,scattered,secondary,sessile,shiny,short-stalked,short-styled,shorter,side,slightly,somewhat,spaced,stalk,stalked,stellate,straight,surface,tall,tamen,terete,thicker,tissue,touching,triangular,trichome,unarmed,unit,usually,vary,whitish,woody,ympodial,young,younger	andromonoecious,branching,color,corolla,form,height,history,life,na,ovary,perennial,pubescence,reproduction,seed,shape,size,staman,stellae,stipe,texture,vein,width
175	wfo-0001027050	success	234	125	104	130	21	0.444	0.2-0.6,0.2-1,0.5-1,1-1.5,1-2,1.5-2,1.5-6,10-13.5,15-50+,2-10,2-2.5,2-3,2-5,2-8,2.5-3,3-5,4-40,4-8,5-10,5-9,8-40+,abaxially,acuminate,acute,adaxially,andromonoecious,anther,apex,base,branched,broadly,brown,calyx,chartaceous,cm,coarsely,cordate,cuneate,densely,diameter,drying,elliptic,entire,ferruginous,filament,flattened,flower,forked,fruit,glabrous,glandular-puberulent,globose,green,growth,hair,inflorescence,lanceolate,lateral,leaf,length,like,lobe,lobed,margin,midvein,mm,moderately,narrowly,oblique,obtuse,often,ovate,ovate-lanceolate,pale,petiole,plant,porrect,ray,rounded,shallowly,shrub,side,small,sparsely,stellae,stellate,stellate-pubescent,stem,stigma,style,tip,toothed,tree,triangular,truncate,tube,unbranched,usually,weakly,white,whitish,x,yellow,yellowish-green	.2,0-0.2,0-0.5,0-1,0-3,0.1-3,0.3-0.6,0.4-1,0.5-0.8,0.5-3,0.8,1-5,10-30,11-21,12-15,14-20,16-40,2-3-locular,2-4,2-6,2-foliate,23-40+,3-15,4-19,5,5-6,5-7,5-merous,6-8,7-30+,8-26,absen,absent,abundant,accrescent,across,adaxiall,adult,anvil-shape,apart,armed,articulated,axe,ba,blade,branche,broad-based,capitat,connivent,contiguous,cross-section,curved,cylindrical,deeply,directed,distall,distally,distributed,eaf,eed,eglandular,erect,except,exocarp,extra-axillary,fruiting,functional,geminat,half,held,interpetalar,juicy,juvenile,leaf-opposed,less,long,longer,lower,markedly,mature,mesocarp,midpoint,minute,minutely,moist,mucilaginous,multiseriate,nearly,nflorescence,orolla,pair,pedicel,peduncle,per,pinnatifid,pitted,placenta,pore,present,prickle,rachi,ruit,scattered,sessile,shorter,simple,slightly,somewhat,spaced,stalk,stalked,straight,surface,tal,tamen,tem,thick,thicker,throughout,time,tissue,unarme,unarmed,unit,upper,upright,vary,wide,ympodial,younger	branching,color,corolla,form,height,history,life,midrib,na,ovary,perennial,pubescence,reproduction,seed,shape,size,staman,stipe,texture,vein,width
176	wfo-0001027067	success	228	104	85	143	19	0.373	0-7,0.2-0.4,0.3-1,0.35-0.5,0.5-2,1.7-2.8,1.7-3.3,2-3,2.5-3.8,2.5-4,2.9-3.7,3.5-9,4-5.5,5-12.5,6-10,6-7,6-8,acute,adaxially,andromonoecious,anther,apex,attenuate,base,black,broadly,brown,calyx,chartaceous,cm,cuneate,dark,deeply,densely,diameter,filament,finally,firm,flattened,fruit,glabrous,globose,green,grey,inflorescence,lateral,leaf,length,lobe,lobed,margin,midvein,mm,obtuse,ovate,pale,papery,perennial,petiole,pink,plant,present,pseudo-racemose,purple,ray,rotate,shrub,skin,slightly,sparsely,stellae,stellate-pubescent,stem,stigma,streak,style,throughout,tube,twisted,unbranched,vein,weakly,x,yellow,yellowish-green	%,.05,0-0.1,0-0.2,0-0.5,0-1.8,0-12,0-6,0.4-0.5,0.4-0.7,0.5-1,0.5-1.5,0.8-1,0.9-2.5,1-2,1-4,1-7,1.2-1.4,1.4-2.5,1.5-2,11-16,11-20,13-65,15-27,15-60,2-10,2-4.5,2-7,2-foliate,2-locular,2.7-5,20-45,20-50,20-65,3-10,3-4,3-5,3-6,3.5-5.5,4-9,5-6,5-9.5,5-merou,5.5-12.5,7-11,7-16,7-8,8-14,abaxial,abaxially,absent,abundant,accrescent,acicular,across,adaxiall,adult,alyx,apart,armed,articulated,axe,ba,bilobe,blade,broad-based,connivent,curved,cylindrical,decimetr,directed,distall,dult,eaf,eed,eglandular,erect,exocarp,extra-axillary,finger,flower,fruiting,functional,geminate,gland-tipped,hair,half,heterostylous,hig,index,interpetalar,juic,juvenile,lanceolate,less,lobing,lon,long,longer,lower,mature,mesocarp,mid-point,midpoint,minute,moist,nflorescence,oblique,orolla,part,pedicel,peduncle,per,pore,porrect,presen,prickle,rachi,rhizomatous,ruit,scattered,sessile,short,side,simple,somewhat,spaced,sprawling,stalk,stellate,straight,tamen,thick,time,tissue,transparent,truncate,unit,vary,white,wide,yellowish,ympodial	branching,color,corolla,form,growth,height,history,life,midrib,na,ovary,pubescence,reproduction,seed,shape,size,staman,texture,tip
177	wfo-0001027069	success	200	110	90	110	20	0.45	0.15-0.8,0.5-1.5,0.5-5,0.8-3.3,1-2,1-2.5,1-5,1.5-12,1.5-5,2-6,3-19,3.5-6,4-8,4-9,7-10,abaxially,adaxially,anther,blotch,brown,brownish,cell,chartaceous,ciliate,cm,condition,corolla,covering,darker,diameter,drying,elliptical-conical,especially,filament,flower,forked,fresh,fruit,glabrescent,glabrous,green,greenish,hair,hair-like,herb,lateral,light,like,linear,lobe,long,make,margin,membranous,midrib,minutely,mm,mucilaginous,narrowly,odd-pinnate,ovate,ovoid,perfect,petiole,plant,puberulent,pubescent,purple,seed,short,simple,size,sparsely,stellate,stem,stigma,stripe,style,testal,thick,tip,tube,vertical,wall,wet,white,whitish,wide,x,yellow	0-4,0.2-3,0.5-5.5,1-10,1-7.7,1.5-3,1.5-6,10-25,2-5,2.5-12,3-11,5-merou,acumen,acuminate,acute,ag,along,alyx,apart,apex,apparently,articulated,axe,axillary,base,berry,blade,borne,broadly,bud,capitat,connivent,cordate,cuneate,decreasing,decurrent,digestion,distal,dorsally,eaf,edge,eed,elliptic,end,enzyme,erect,exceeding,flat,folded,geminat,generally,glabrou,green-white,half,homostylous,honeycomb-shaped,interjected,lanceolate,lax,leaflet,lengthening,living,lower,middl,nflorescence,obtuse,orolla,pair,pedicel,peduncle,petiolule,plurifoliate,pore,poricidal,pubescen,rachi,rare,rarely,removed,ruit,seudostipule,singly,slightly,slit,sometimes,spaced,specimen,stamen,ste,stolo,straight,subequal,subtending,tall,talle,tamen,tem,terminal,throughout,toward,tri-,truncate,tuber,typically,unequal,unit,unwinged,usually,vary,ympodial	branching,calyx,color,form,growth,height,history,inflorescence,leaf,length,life,na,ovary,perennial,pubescence,reproduction,shape,staman,surface,texture
178	wfo-0001027091	success	142	98	68	74	30	0.479	1-1.6,1.1-1.6,1.8-2.6,1/2-2/3,2.3-2.9,2.5-3.5,3-8,3-9,4-10,5-11,8.5-11.5,acute-tipped,along,annual,anther,beneath,blade,blue,bristly,broadly,brown,calyx,campanulate,cm,dark,densely,dm,few-rayed,glabrous,gland,glandular,green,hair,herb,internodal,lenticular,linear-lanceolate,lobe,long,low,main,mm,oriented,ovate,petiole,prickly,radially,reticulately,ridge,scattered,sessile,short-stipitate,simple,sometimes,sparsely,spherical,stellae,stellate-pentagonal,stem,strait,surface,terminally,tube,undulate,variously,vein,violet,wrinkled	.3,0.7,0.8,30-60,6-10,6-10-flowere,9-13,accrescent,across,alyx,anthesi,arcuate,armed,base,berry,branched,capitate-glandular,cauline,deltoid,developing,dia,difoliate,divided,dry,eaf,eed,enveloped,extended,fully,geminat,high,invested,lon,longer,maturity,mostly,narrowly,near,nflorescence,obtuse,occasionally,orolla,pedicel,per,pinnatifid,pinnatisect,rounded,ruit,short,slende,somewhat,splitting,spreadingly,ste,suffused,tamen,tapering,taprooted,terete,tightly,tigma,tub,twice,tyle,unexpande,uniseriate,unit,usually,vary,vestiture,wholly,yello,ympodial,younger	6-10-flowered,color,corolla,diameter,filament,flower,form,fruit,growth,height,history,inflorescence,leaf,length,life,na,ovary,plant,pubescence,seed,shape,size,slender,staman,stigma,style,texture,unexpanded,width,yellow
179	wfo-0001027102	success	167	102	73	94	29	0.437	.5,.5-6,0.5-1,0.5-2,0.5-3,1-1.5,1-2,1-2.5,1-6,1.5-2,2-3,3,3-12,3-4,4-5,abaxially,acuminate,acute,adaxially,anther,apex,base,calyx,ciliate,cm,cuneate,densely,diameter,entire,filament,flattened,flower,forked,fruit,glabrous,globose,leaf,lobe,long,long-tapered,margin,mm,moderately,narrowly,orange,ovate,perfect,petiole,pubescent,rarely,ripe,rugulose,shrub,simple,size,somewhat,stellate,stem,stigma,style,subcoriaceous,surface,time,tip,tomentose,triangular,tube,unbranched,white,wide,x,yellow,yellow-brown	0.2-2,0.5,1-3,1-4,10-20,15,15-35,2-2.5,3-5,4-7,5-12,<,absen,absent,accrescent,acuman,adaxial,adaxiall,ag,aggregate,almost,alyx,apart,appearance,articulated,axe,ba,blade,broad,broadly,cell,channe,chartaceous,congested,connivent,corky,curved,cylindrical,deltate,differing,difoliate,dimorphic,directed,distally,eaf,eed,elliptic,few-,free,fruiting,geminat,giving,hair,ilament,lanceolate,leaf-opposed,longitudinal,m.,major,minor,multiseriate,nflorescence,oblong,obtuse,often,one,opening,orolla,pedicel,peduncle,per,pore,portion,rachi,roughened,ruit,short,slender,slit,small,spaced,sparsely,stone,straight,tal,tem,truncat,truncate,unarme,unit,usually,vary,ympodial,young	branching,color,corolla,form,growth,height,history,inflorescence,lateral,length,life,midpoint,midrib,midvein,na,ovary,perennial,plant,pubescence,ray,reproduction,seed,shape,staman,stellae,stipe,texture,vein,width
180	wfo-0001027104	success	141	73	51	90	22	0.362	0.15-0.35,0.5-0.8,1-3,1.5-2.3,1.5-4.2,2-3,2-6,2.2-5,3-5.5,6-7.5,abaxially,acute,adaxially,branched,calyx,cm,corolla,cyme,diameter,dichasial,dichasially,ebracteate,finely,forked,globose,green,green-white,herbaceous,lobe,long,mm,monochasial,mucronate,ovate,ovoid,perennial,perfect,petiole,plant,pubescent,seed,stellate,stigma,style,throughout,tone,tuber-bearing,white,wide,yellow,yellow-green	1-1.5,1-4,1.2-6,10-15,3-6-foliat,4-15,5-15,acumen,acuminate,apex,apical,apically,articulate,attenuate,base,cell,condition,connate,cordate,covering,dehiscent,digestion,distal,dorsally,eaf,edge,eed,emoval,enzyme,epiphyti,epiphytic-like,exceeding,filament,flat,flower,folded,generally,globo,growing,hair-like,half,honeycomb,introrse,lateral,linear,living,lon,lower,make,maturing,mos,mucilaginous,narrowly,nflorescence,nther,odd-pinnate,often,orolla,ovat,pattern,pedicel,peduncle,plan,poricidally,proximal,rarely,reveal,ruit,seudostipule,short,simple,slit,specimen,stamen,straight,tall,tem,terrestrial,testal,thick,throughou,truncate,typically,unit,vary,viole,wall,without,ympodial,¼	anther,branching,color,form,fruit,growth,height,history,inflorescence,leaf,length,life,na,ovary,pubescence,reproduction,shape,size,stem,texture,tip,violet
181	wfo-0001027114	success	154	103	81	73	22	0.526	-17,-2,-30,.5,0.5-1,1-1.1,1-1.2,1-1.5,1.5-2,1/2,13-21,2-2.5,2-3,20-40,3-4,3-7,6-9,abaxial,abaxially,adaxially,along,anther,anthesi,appearing,base,branched,bushy,calyx,cm,corolla,dark,dendritic,densely,dia,elliptic,filament,flattened-reniform,flowered,glabrous,globose,green,inflorescence,lamina,leaf,lobe,lobed,long,main,many,margin,minute,minutely,mm,occasionally,opposite,ovary,petiole,pitted,planar,pubescent,reddish,reddish-brown,scattered,shoot-terminal,shrub,simple,size,stem,stigma,style,surface,thickened,time,tip,trichome,tube,uniseriate,vein,way,white,wide	1-2,1.5-1.7,5,6-8,7-10,7-9,acute,alternating,apar,apex,axillary,ba,bark,berry,capitate,closely,commonly,conical,deltate,differing,difoliate,drying,due,eaf,edicel,eed,erect,exserted,free,fruiting,geminate,glabrou,growt,halfway,inflorescenc,investing,lateral,like,lon,lower,major,minor,nflorescence,older,opening,pair,papillo,pedicel,plurifoliate,pore,poricidal,portion,projection,rapid,rest,ruit,scar,several,shoot,slit,soft,spaced,tall,tapering,triangular,tub,ud,unevenly,unit,woody,yellowish,ympodial,young	branching,color,diameter,flower,form,fruit,growth,height,history,length,life,midrib,midvein,na,perennial,plant,pubescence,reproduction,seed,shape,staman,texture
182	wfo-0001027117	success	235	122	96	139	26	0.409	/3,0.1-,0.1-0.7,0.2-0.45,0.5-1.5,0.6-0.9,0.7-1.3,0.8-,1-2,1.5-,1.5-2.3,1.5-6.5,1.7-2.5,1/3,2-3,2-6,2.3-2.8,3-15,4-6.5,4.5-6.5,5-11,5-14,6-10,abaxially,acute,almost,anther,apex,apically,apparently,attenuate,base,berry,black,branched,brown,calyx,cell,chartaceous,cm,cordate,dark,deltate,densely,diameter,evenly,filament,fine,flattened-reniform,flower,fruit,glabrous,green,herb,lateral,leaf,length,lobe,lobed,long,longer,lower,margin,maturity,mauve,midpoint,midvein,mm,moderately,outline,pale,petiole,pit,raised,ray,rounded,shallowly,small,smooth,sparsely,spherical,staman,stellate-pubescent,stem,style,surface,time,tip,trichome,tube,upper,vein,way,wide,yellow,young	-1.5,-11,-12,-2.8,-3/4,.5,0-10,0-15,0-20,0-25,0-40,0-5,0.1,0.15-0.25,0.15-0.35,0.2,0.5,0.7-0.9,0.7-1.5,1-4,1-6,1.2,1.8-2.5,1/,1/4,1/8-1/2,10-20,2-8,25-100,3-10,3-6,4-7,4-8,4.5-8,5-merous,6-9,7-,8,accrescent,acicular,alyx,ame,apar,apart,articulated,bark,beyond,blade,brittle,c.,concolorous,connivent,curved,discolorous,distance,drying,eaf,eed,elongating,enclosing,erect,extending,fifth,four,free,fruiting,gently,glabrescent,gra,herbarium,infructescence,irregularly,less,lon,long-acuminat,mature,membranous,narrow-deltate,narrow-elliptic,narrow-lanceolate,nflorescence,oblong,obovate,older,one,open,orolla,oung,ovate,pair,pedicel,peduncle,pendulous,per,perfec,pericarp,perpendicular,plurifoliat,poricidal,porrect,portion,prickl,prickle,prickly,primary,red-brown,reduced,reflexed,ruit,scar,sessile,shiny,shorter,side,sometimes,spaced,specimen,spreading,stalk,stalked,stellate,straight,tamen,tapering,tearing,terete,tertiary,tissue,translucent,unequal,unit,variously,vary,venation,visible,weakly,woody,yellow-green,ympodial	branching,color,corolla,form,growth,height,history,inflorescence,life,long-acuminate,midrib,na,ovary,perennial,perfect,plant,pubescence,reproduction,seed,shape,size,stellae,stigma,stipe,texture,width
183	wfo-0001027123	success	181	108	81	100	27	0.448	-10,-20,0.7-3.5,1,1-1.2,1-1.5,1.5-2,2-2.6,2.5-10.4,2.5-4,2.5-6,3-15,3-4,4-5,4-6,5-10,5-6,acute,anther,apex,attenuate,base,branched,broadly,brown,calyx,cm,commonly,constricted,corolla,dark,deltate,dendritic,densely,diameter,edge,elliptic,filament,flattened,flower,glabrous,globose,inflorescence,leaf,less,lobe,margin,mauve-purple,midvein,minute,mm,narrowly,ovary,pair,perfect,petiole,pubescent,reddish,reniform,revolute,scattered,shining,shiny,simple,sometimes,soon,stellate,stem,stigma,strongly,style,subshrub,terminal,time,tip,trichome,tube,vein,violet,x,young	.3,.5,0.3-1.6cm,0.5,0.5-0.8,0.8-1.3,0.9-1.3,2-2.2,2-2.5,2-3,2-5.5,2-lobed,abaxial,adaxial,adaxially,along,anthesi,appearing,axe,axi,bark,bright,campanulate,cell,clavate,completely,conical,coriaceous,cup-shaped,darker,denser,drying,eaf,eed,enlarged,erect,exerted,fide,free,fruiting,glandular,green,inserted,lamina,lax,lewi,like,lobed,lon,long,loose,loosely,lower,minutely,monopodia,nflorescence,nodding,older,outline,papillae,papillate,pedicel,peduncle,perhaps,petal,pitted,planar,plurifoliate,portion,primary,prominent,scar,scatted,shin,shinin,short,sinuate,sleeve,slightly,spaced,sparsely,stoutish,straight,surface,testal,thick,trailing,tub,turned,ud,unit,upper,usually,warty,way,white,widely,wood,ympodial,¾	0.3-1.6,branching,color,form,fruit,growth,height,history,lateral,length,life,midpoint,midrib,na,perennial,plant,pubescence,ray,reproduction,seed,shape,size,staman,stellae,stipe,texture,width
184	wfo-0001027125	success	155	104	82	73	22	0.529	.5,0,0.3,0.5,0.8,1,10–15,12–17,1–,3–5,3–7,4,4–6,5,5–7,6–9,abaxially,acuminate,acute,adaxially,anther,anthesi,apex,apiculate,armed,base,blue,branched,brown,calyx,cm,completely,coriaceous,corolla,diameter,elliptic,entire,filament,flattened,fleshy,flower,foveolate,fruit,glabrous,globose,green,lateral,light,lobe,long,margin,midrib,minutely,mm,mostly,narrowly,oblong,papillate,petiole,prickle,recurved,rugose,side,spreading,stem,stigma,strongly,style,surface,terminal,thick,time,tip,triangular,truncate,tube,vein,vine,wide,yellow,×,–9	/4,0.3-0.6,1.2-2,10–,12,25–50,3,3–,3–10,50,5–10,6,6–,?,absent,ag,alyx,articulated,axe,ba,becoming,bilobe,blade,bud,campanulate,clavate,clustered,connivent,cucullat,deeply,dr.,eaf,eed,ellipsoid,elongating,equal,exserted,internode,lengthening,lobed,long-styled,lower,major,middle,nflorescence,orolla,pedicel,peduncle,plurifoliat,pore,poricidal,rachi,recurve,robust,rounded,ruit,simple,slender,slit,somewhat,stellate,stout,subwoody,tamen,terminally,thickened,unit,vary,way,widest,woody,ympodial,youn	branching,color,form,growth,inflorescence,leaf,length,midpoint,midvein,na,ovary,pubescence,ray,reproduction,seed,shape,size,staman,stellae,stipe,texture,width
185	wfo-0001027131	success	186	105	79	107	26	0.425	0-0.1,0.4-0.8,0.5-1,0.9-2.5,1-1.5,1.4-2,1.7-3.5,2-5,2.3-2.7,2.6-3,3-4,3-9,4.5-8.5,5.5-6.5,7-8,9.5-11.5,abaxially,acute,adaxially,andromonoecious,anther,apex,ascending,attenuate,base,black,brown,calyx,chartaceous,cm,cordate,cylindrical,dark,densely,diameter,entire,erect,flower,fruit,globose,green,grey,inflorescence,lateral,length,lobe,long,margin,mm,obtuse,ovate,pale,perennial,petiole,plant,porrect,pseudo-racemose,purple,ray,rhizomatous,rotate,rusty,shrub,stellae,stellate-pubescent,stem,straight,streak,style,time,tube,unbranched,weakly,white,wide,x,yellow,yellowish,yellowish-green	%,.05,.7,0-0.3,0-2,0-3,0-5,0.2-2.2,0.4-1,0.5-0.8,0.7-2.5,1-1.2,1-2,1-3,1-4,1.5-3.3,12-20,17-35,4-10,4-7,4-8,4-locular,5-merou,7-11,7-9,absen,absent,across,adaxiall,alyx,anvil-shape,apart,articulated,axe,ba,blade,broad-based,circular,cross-section,d.,directed,distall,distally,distributed,dult,eaf,eed,eglandular,elliptical,exocarp,extra-axillary,finger,fruiting,functional,geminat,gland-tipped,hair,half,heterostylous,hig,juicy,lamina,less,longer,lower,markedly,mature,mesocarp,mid-point,midpoint,minute,moist,nflorescence,oblique,onl,orolla,part,pedicel,peduncle,per,placenta,plurifoliate,pore,possibly,present,prickle,ridged,ruit,short,simple,spaced,stage,stalk,stalked,tamen,terete,thick,thicker,thicknes,throughout,unarme,unarmed,unit,unknow,uvenile,vary,ympodial	branching,color,corolla,filament,form,growth,height,history,leaf,life,midrib,midvein,na,ovary,pubescence,reproduction,seed,shape,size,staman,stigma,stipe,texture,tip,vein,width
186	wfo-0001027146	success	213	110	91	122	19	0.427	0.3-2.2,0.7-2.4,0.8,1-2,1-2.5,10,13-36,2-13,2-4.2,3.3-6.1,3.5-22,4-11,4-12.5,4-38,4-8,6-10,6-17.5,6.5-52,abaxially,adaxially,anther,axillary,berry,brownish,bud,chartaceous,clavate,cm,coarsely,condition,conical,corolla,deep,diameter,distal,drying,filament,finely,flower,forked,fresh,fruit,generally,glabrous,green,greenish,hair,half,herb,homostylous,leaf,like,lobe,long,medium,membranous,minute,mm,mottled,odd-pinnate,ovoid,pedicel,peduncle,pentagonal,plant,puberulent,pubescent,purple,ripe,rotate,seed,simple,size,stem,stigma,style,subglabrous,subtending,terminal,throughout,tinged,tube,unwinged,usually,violet,white,whitish,wide,wing,x,yellow	0-11,0.5-3.2,0.6-3.3,0.8-3.1,0.8-5.8,1-10,1-9.5,1.9-10,2-12.2,2-5,5-merou,6,acumen,acuminate,ag,along,alyx,apart,apex,apparently,arranged,articulated,asymmetrical,attenuate,axe,base,basiscopic,bead,blade,capitat,cell,ciliate,commonly,connivent,covering,dark,darker,decreasing,digestion,dorsally,eaf,edge,eed,elliptic,enzyme,erec,especially,exceeding,flat,folded,fourt,fourth,geminat,glabrou,gradually,green-white,hair-like,honeycomb-shaped,interjected,lanceolate,lateral,leaflet,lengthening,living,lower,make,margin,midrib,minutely,moniliform,mucilaginous,multiple,necklace,nflorescence,orbicular,orolla,ovate,pair,perfect,petiole,petiolule,plurifoliate,pore,poricidal,proximal,rarely,ray,removed,ruit,secondary,semierect,sessile,seudostipule,side,slit,sometimes,spaced,specimen,stamen,ste,stolon,straight,subequal,subglabrou,subsessile,symmetrical,tall,tamen,tem,testal,thick,tip,tissue,toward,tri-,tuber,typically,unit,vary,wall,wet,ympodial	5-merous,branching,calyx,capitate,color,form,growth,height,history,inflorescence,length,life,ovary,perennial,pseudostipule,pubescence,shape,staman,texture
187	wfo-0001027154	success	215	112	80	135	32	0.372	.5,.6,0.4-0.5,1-1.3,1.9,2.9,26,3-7,5,abaxially,adaxially,anther,apex,attenuate,base,branched,calyx,chartaceous,cm,color,curved,cylindrical,deltate,densely,diameter,ferruginous,filament,flattened,flower,foveolate,fruit,globose,green,highly,immature,leaf,length,lobe,margin,mature,midpoint,midrib,minutely,mm,oblique,outline,ovate,paler,perfect,petiole,plant,pubescent,ray,reniform,rotate-pentagonal,rounded,shape,shrub,size,slightly,sometimes,stellae,stellate-tomentose,stem,stigma,stipitate,straight,style,surface,tan,truncate,tube,unknown,variable,vein,white,x,yellow,yellowish,young	-15,-16,.2,0,0.2,0.3–0.6,1.5–2.5,1.5–3,17–19,1–2,2,2-6,2.5-5,23,2–2.5,2–4,35,3–10,4.5–5,4.5–8,4–8,6–8,6–9-rayed,7.5-11,7–20,8,8-11,absent,accrescent,acute,adaxiall,ag,alyx,ample,apart,armed,articulated,axe,ba,basal,berry,blade,branch,broad,broad-based,capitat,clavate,connivent,difoliate,directed,distally,eaf,eed,entire,evidently,except,extra-axillary,finer,flowering,free,fruiting,geminat,glabrescen,glabrous,hair,ilament,interpetalar,irregularly,juvenile,lanceolate,larger,less,lighter,like,linear,lobed,lognitudinal,long,m.,major,minute,mostly,much,near,nearly,nflorescence,normally,often,older,opening,orolla,part,pedicel,peduncle,per,pinnately,pore,prickle,rachi,rarely,reaching,recurved,reflexed,repand,ruit,sessile,shiny,side,simple,sinus,slit,smaller,spaced,sprout,ste,stipe,stout,sulcate,tal,tardily,tem,third,three,tissue,tomentose,unarme,unarmed,underside,uniform,unit,usually,vary,within,ympodial,–4	0.3-0.6,0.6,1,1.5-3,2-2.5,2-4,3-10,4-8,4.5-5,4.5-8,6-8,7-20,branching,corolla,form,growth,height,history,inflorescence,lateral,life,midvein,na,ovary,perennial,pubescence,reproduction,seed,staman,texture,tip,width
188	wfo-0001027157	success	207	99	75	132	24	0.362	0.15-0.3,0.9-2.8,1,1-2,1-3,1-6,2-15,2-2.5,2-3,2.5-3,3-12,3-7,3.3-7.8,4-5,6.5-14.5,9-12,abaxially,acute,adaxially,anther,apex,attenuate,base,brownish,chartaceous,cm,condition,conical,corolla,deeply,densely,diameter,drying,filament,flower,forked,fresh,fruit,glabrous,green,greenish,herb,lateral,leaf,lobe,long,margin,membranous,midrib,minutely,mm,odd-pinnate,ovoid,perfect,petiole,plant,puberulent,pubescent,ripe,seed,size,sometimes,stellate,stem,stigma,style,tinged,tip,tube,violet,white,whitish,wide,x,yellow	0-3,0.7-2,1-10,1-3.8,1.5-6.5,10-30,2,2-5,2.3-4,3.8-8.3,5-merou,absent,acumen,acuminate,ag,along,alyx,among,apart,apparently,articulated,axe,axillary,berry,blade,broadly,bud,capitat,cell,ciliate,clavate,connivent,cordate,covering,cuneate,decreasing,decurrent,digestion,distal,dorsally,eaf,edge,eed,elliptic,end,enzyme,erec,especially,exceeding,flat,folded,geminat,generally,glabrou,grassland,greatly,green-white,hair,hair-like,half,homostylous,honeycomb-shaped,interjected,lanceolate,leaflet,lengthening,like,living,low-growing,lower,make,markedly,middl,mucilaginous,narrowly,nflorescence,oblique,obtuse,one,orbicular,orolla,ovate,pair,pedicel,peduncle,petiolulate,petiolule,placed,plurifoliate,pore,poricidal,rarely,removed,rounded,ruit,semi-rosette,sessile,seudostipule,shady,short,situation,slightly,slit,spaced,specimen,stamen,ste,stolo,straight,subsessile,subtending,sunny,tall,tamen,tem,terminal,testal,thick,throughout,toward,tri-,tuber,typically,unequal,unit,unwinged,usually,vary,wall,wet,woodland,ympodial	branching,calyx,color,form,growth,height,history,inflorescence,length,life,midpoint,midvein,na,ovary,perennial,pubescence,ray,reproduction,shape,staman,stellae,stipe,texture,vein
189	wfo-0001027184	success	219	115	99	120	16	0.452	.3,.5,.7,.8,0.2-0.4,0.4–0.9,0.5-2,0.8,1.5-5,1–4,2,2–4-celled,3-foliolate,3–,3–4-celled,4,4–12,7,abaxially,acute,adaxially,anther,apex,base,blue,branch,brown,calyx,chartaceous,cm,cylindrical,densely,diameter,especially,filament,flattened,fleshy,flower,fruit,generally,glabrescent,glabrous,globose,grading,hair,half,herbaceous,imparipinnate,lanceolate,leaf,leaflet,least,light,lobe,long,lower,membranous,meter,midrib,minutely,mm,mostly,older,orange,petiole,pilose,prominent,prominently,puberulent,pubescent,raised,rarely,red,reticulate,ripe,secondary,several,shape,simple,size,slightly,sparsely,stellate,stem,stigma,straight,style,tertiary,tip,tube,unbranched,vein,vine,weak,white,x,yellow,young,–9	0-,0-0.2,0.4-2,0.8–1.6,0–3,1-2,1.5,1.8–3.5,13–18,19,1–2,1–2.5,2.8–4.1,3-4-,3.5–8,5,5-7,9,absent,accrescent,adaxiall,adventitious,ag,along,always,alyx,apart,appressed,articulated,axe,axi,axillary,ba,basal,blade,borne,bract-like,broad,broadly,cell,clavat,cluster,connivent,cordat,covered,directed,eaf,eed,elliptic,entire,epidermal,extension,fasciculate,foliaceous,free,fruiting,geminat,glabrou,hairlike,ilament,introrsely,larger,largest,lateral,leafy,less,like,longitudinal,m.,margin,much,narrowly,nearly,nflorescence,node,oblong,obtuse,often,opening,opposite,orolla,ovate,ower,pedicel,peduncle,per,petiolule,plurifoliate,pore,portion,pseudostipule,rachi,revolute,root,ruit,scarcely,shoot,short,slit,small,soft-woody,somewhat,spaced,subopposite,sulcate,surface,terminal,tightly,tree,truncate,trunk,unarme,unequal,uniform,unit,usually,vary,visible,wall,ympodial	branching,color,corolla,form,growth,height,inflorescence,length,midvein,na,ovary,plant,pubescence,seed,staman,texture
190	wfo-0001027186	success	168	119	99	69	20	0.589	-6,.4,.5,0.5-1,1-1.5,1-2.5,1.5,1.5-2,1.5-2.5,1.6-5,15,3-4,3.5-4,30-40,4-15,4-9,5-10,6-7,?,abaxially,acute,adaxially,always,anther,anthesi,apex,apparently,attenuate,axil,base,berry,branch,branched,calyx,cm,corolla,deltate,dendritic,densely,denser,diameter,elliptic,entire,filament,flower,fruit,glabrescent,glabrous,globose,golden,green,growth,immature,lamina,lobe,lobed,loose,margin,maturity,midrib,minutely,mm,narrowly,occasionally,ovary,ovoid,pale,perfect,petiole,pitted,planar,pubescent,reniform,scattered,seed,shiny,short,simple,slightly,soon,sparsely,stalk,stem,stigma,style,surface,terminal,time,tip,tree,trichome,tube,uniseriate,variably,vein,way,white,x,yellow	1.4-1.6,2-6,2-lobed,2.5-3,9-10,abaxial,age,apart,bark,broadly,brown,clavate,conical,dark,dbh,deflexed,denditic,dry,eaf,ellipsoid,enlarging,exerted,filiform,free,fruiting,incrassat,irregularly,keeled,lengthening,less,like,longer,lower,m.,much,new,nflorescence,pair,papillat,papillate,pedicel,peduncle,pendent,pericarp,plane,plurifoliat,pointed,pore,poridical,portion,primary,pubescen,rachi,reddish,rough,ruit,scar,slit,small,spaced,spreading,straight,strongly,treelet,tub,ud,unit,woody,ympodial	branching,color,form,height,history,incrassate,inflorescence,leaf,length,life,na,perennial,plant,pubescence,reproduction,shape,size,staman,texture,width
191	wfo-0001027187	success	224	90	67	157	23	0.299	.5,0.15–0.4,0.3–1,0.6,0.8–2,1–1.8,1–2,1–3,2.5–4,2.5–6,2–2.5,2–3,3.5–10,3–10.5,4.5–8,5–11,5–15,7–12,acute-acuminate,andromonoecious,anther,blue,broadly,calyx,cm,darker,deltoid-ovate,densely,diameter,filament,finely,flattened-reniform,forked,foveolate,fruit,glabrous,glandular-puberulent,globose,green,herb,leaf,lenticular,light,lobe,maturity,minutely,mm,moderately,mottling,perennial,pubescent,rotate-stellate,sky,sparsely,stellate,stellate-pubescent,stem,stigma,style,subglobose,surface,tube,unbranched,weakly,yellow,young,×	0,0.05–0.1,0.2,0.4,0.5,0.5–1,0.5–1.5,1,1-celled,1.0,1.2,1.5–3.5,12,13–18,1–1.5,1–3-celled,2,2-,2–5,2–7,3-foliate,3.2,3–10,3–6,3–7,4,4–5,5,5-merous,5.4,5.5,5–10,5–6,5–8,6,6–8,7,7–15,9,abaxially,accrescent,acute,adaxiall,adaxially,alyx,apart,apex,armed,articulated,axe,base,berry,blade,branched,bud,capitat,central,chartaceous,completely,connivent,continuum,cordate,covering,cuneate,cylindrical,decumbent,deflexed,deltate,deltate-lanceolate,directed,distal,distall,downward,eaf,eed,equal,erect,exserted,extra-axillary,flower,fruiting,geminat,grading,hair,hermaphroditic,irregularly,lanceolate,lateral,like,lobed,lon,long,long-stalked,lower,major,margin,morphology,narrowly,nflorescence,node,obtuse,offset,often,one,open,orolla,outline,pedicel,peduncle,perfect,petiole,plurifoliate,pore,prickle,prickle-like,producing,proximal,rarely,ray,rind,root,rooting,rounded,ruit,serrate,sessile,shallowly,short-stalked,showing,side,simple,sinus,small,sometimes,spaced,spreading,stalk,staminate,stout,straight,strongly,subequal,subsessile,tall,tamen,tapered,tem,toug,triangular,truncate,unequal,unit,usually,vary,vein,wide,ympodial	branching,color,corolla,form,growth,height,history,inflorescence,length,life,na,ovary,plant,pubescence,reproduction,seed,shape,size,staman,stellae,texture,tip,width
192	wfo-0001027198	success	191	123	100	91	23	0.524	.4,.5,0.5-1,0.8-1,1-1.5,1-10,1.5-10,1.5-2,11-20,3/4,5-120-flowered,5-6,7.5-9,acuminate,acute,anther,anthesi,apex,attenuate,base,bushy,calyx,channeled,clavate,cm,complex,corolla,decurrent,deltoid,dendritic,densely,dia,dry,elliptic,extremely,filament,flower,furcate,glabrous,globose,golden,green,inflorescence,large,leaf,like,lobe,lobed,long,many,medium,minute,minutely,mm,obovate,often,opposite,ovary,ovoid-reniform,pale,paler,papillose,petiole,pitted,planar,plant,puberulent,pubescence,pubescent,reflexed,rounded,shining,short,shrub,simple,size,slightly,small,speciman,specimen,stem,stigma,straight,style,styled,surface,tannish-yellow,thickened,time,tip,tree,trichome,tube,two,type,vein,way,white,x,yellowish	0.05-1.0,0.5-0.75,0.7-1,1-5,10-11,2-5.5,4-9,abruptly,always,apart,axil,ba,beginning,beneath,berry,broadening,caly,closely,constriction,corky,corresponding,cyathiform,differing,difoliate,eaf,edge,edicel,eed,entire,erect,evenly,exserted,eye,female,found,free,fruiting,geminat,glabrate,impressed,inflorescenc,invisible,lateral,live,lon,lower,main,major,male,margin,meet,middle,minor,naked,nearly,nflorescence,older,overlapping,ovoid,papillo,pedicel,pendan,pore,poricidal,portion,rather,reddi,rest,ruit,scar,sessile,set,shaped,slender,soon,spaced,strong,tall,tear-drop,testae,thin,top,ud,undersurface,uniseriate,unit,usually,widest,woody,ympodial,young	abaxial,branching,color,colour,diameter,form,fruit,growth,hair,height,history,length,life,midrib,na,perennial,reddish,reproduction,seed,shape,staman,texture,width
193	wfo-0001027200	success	139	89	68	71	21	0.489	0.05-0.25,0.25-0.5,0.5-1,0.6-1,1-1.4,1-1.5,1.2-1.5,1.5-2,1.5-5,2.5-3,3-3.5,3.5-6,6-8,8-15,anther,anthesi,base,beneath,brown,calyx,cm,corolla,dark,deeply,densely,dia,elliptic,filament,glabrous,globose,golden,green,grey-brown,inflorescence,leaf,lobe,lobed,long,minute,minutely,mm,nearly,ovary,ovoid-reniform,papillose,petiole,pitted,planar,puberulent,reflexed,shrub,size,slightly,small,sparsely,stem,stigma,style,surface,tip,tree,trichome,tube,unicellular,uniseriate,vein,white,x	0.5-0.75,0.7-2.5,1.6-6,2-3,9-11,across,acute,apex,aspec,ba,bark,berry,branch,branche,broadly,capitate,conical,converging,decurrent,deflexed,deltoid,differing,eaf,eed,except,flattened,free,fruiting,geminate,giving,horizontally,impressed,lateral,lightly,like,lon,lower,main,major,margin,middle,minor,near,node,non-reproductive,occasionally,older,onto,papillo,pedicel,pore,poricidal,portion,prominent,rest,ruit,shaped,sparse,spreading,straight,tall,tear-drop,unifoliate,unit,widened,widest,winged,woody,yellowish,ympodial,young	branching,color,diameter,form,fruit,growth,height,history,length,life,midrib,na,perennial,plant,pubescence,reproduction,seed,shape,staman,texture,width
194	wfo-0001027204	success	154	118	83	71	35	0.539	-40,-8,.5-1,.8-2,0.5-4,1-3.5,1-7,1.5-3.5,1.5-6.5,2-2.5,2-8,3-20,3-5,4-6,5-19,5-30,5-9,6-10,abaxially,acuminate,acute,adaxially,along,angled,apex,base,branched,brown,calyx,chartaceous,cm,cuneate,cylindrical,decurrent,dense,densely,diameter,elliptic,entire,especially,flower,forked,fruit,glabrate,glabrous,globose,greenish,lobe,margin,midrib,mm,moderately,narrowly,nearly,orange,ovate,perfect,petiole,pink,pseudohair,puberulent,pubescent,pubescent-pilose,purplish,reddish,rugose,shrub,sparsely,stellate,stellate-campanulate,stigma,style,subcoriaceous,tip,triangular,tube,twice,unbranched,violet,white,x,yellow,yellowish	-4.5,1,1-10,1-14,1.5-9,15-35,2-4,2-5,4-5-foliat,6-12,8-15,absen,adaxial,aggregate,apart,articulated,axe,blade,cell,channe,connivent,denser,directed,distall,distally,eaf,eed,eglandular,except,expanded,glandular,hair,lanceolate,leaving,lon,long,lower,membranaceous,narrowed,near,nflorescence,nther,obtuse,often,orolla,pedicel,peduncle,peg,pore,present,pubescen,rachi,radiu,ripe,ruit,scar,short,simple,spaced,stone,subacute,tal,tem,time,triangular-deltate,truncat,unit,vary,wide,x1-2,ympodial	1-2,anther,branching,color,corolla,filament,form,growth,height,history,inflorescence,lateral,leaf,length,life,midpoint,midvein,na,ovary,perennial,plant,pubescence,ray,reproduction,seed,shape,size,staman,stellae,stem,stipe,surface,texture,vein,width
195	wfo-0001027213	success	231	141	116	115	25	0.502	-230,-3.3,0-160,0-2.5,0.2-0.4,0.8-1.8,1-2,1-5,1.1-1.7,1.2-1.6,1.2-2.5,1.3-2.2,1.7-3.6,1.7-3.9,1.8-3.2,10-24,2.9-3.8,2/3,3.5-8,4.2-5.9,5.7-6.2,8-24,9-13,abaxially,acute,adaxially,anther,apex,attenuate,basal,base,branched,broadly,brown,calyx,cell,cm,corolla,cuneate,dark,deltoid,diameter,drying,elliptic,entire,epidermal,eventually,few-rayed,filament,flower,fruit,glabrescent,glabrous,globose,granular,grayish-brown,green,group,hair,lateral,leaf,length,lobe,long-stalked,many,margin,midrib,mm,multangulate,oblanceolate,obtuse,often,ovate,ovate-lanceolate,pale,perfect,petiole,porrect-stellate,prominent,pubescence,pubescent,rather,reniform,reticulate-punctate,scabrous,short,short-,short-attenuate,shrub,side,simple,sometimes,sparsely,stellate,stem,stigma,style,surface,thick-stalked,time,tip,tomentose,tomentose-pubescent,tree,tube,vein,vestigial-rayed,violet,white,whitish,whitish-green,x,yellow,yellow-green,yellow-tan,yellowish	-19,-4.5,/10,0.2-0.5,0.7-2.3,1.2-1.7,1.8-2.8,1/2-2/3,12.3-16.3,2-5,2.4-4.7,2.5-5.1,2.9-4.8,3.5-5,4-9.5,5-7.5,5-8,5-merou,8.2-10.5,accrescent,acuminate,ag,along,alyx,anthesi,apart,apparently,ark,around,articulated,axe,axillary,ba,blade,blunt-tipped,branch,capitat,completely,conical,covering,cylindrical,decurrent,directed,distally,eaf,early,edge,eed,enveloping,exserted,farinose,free,fruiting,glabrescen,high,homostylous,immature,inserted,lackin,lanceolate,lengthening,lobed,long,long-,longitudinal,lower,m.,main,mixed,moderately,mostly,multangulat,nearly,nflorescence,obovate,obscured,older,orbicular,orolla,partly,pedicel,peduncle,plurifoliate,pore,poricidal,porrect-stellat,pseudo-terminal,rachi,relatively,ruit,sessile,short-stalked,slit,somewhat,spaced,stamen,subcampanulate,suture,tamen,terete,thick,thin-stalked,ti,tomentu,touching,ud,unarme,unarmed,unit,unwinged,vary,way,wide,ympodial,young	branching,color,form,growth,height,history,inflorescence,life,midpoint,midvein,na,ovary,perennial,plant,pseudoterminally,ray,reproduction,seed,shape,size,staman,stellae,stipe,texture,width
196	wfo-0001027214	success	181	97	78	103	19	0.431	-20,-38,.5,0.5-1,0.7-2.5,1-2.8,1.5,1.5-1.8,10-,10-13,12-17,15-25,2,2-9,3-6,6-,6-12,abaxially,adaxially,anther,anticlinal,apex,base,calyx,cm,corolla,densely,diameter,elliptic,finely,flattened-round,flower,fruit,glabrous,green,greenish,grown,height,herb,inflorescence,irregular,lanceolate,leaflet,length,lobe,lobed,long-acuminate,long-conical,minutely,mm,narrowly,nearly,oblique,occasionally,once-branched,ovary,papillate,petiole,pinnate,pointed,projection,pubescent,rachi,seed,sharply,simple,sinuous,somewhat,stigma,style,surface,thickening,tip,truncate,tube,white,without,x	-9,..,.25,0,0-16,0.25,0.3-1.5,0.3-1.7,0.5-0.8,0.7-2,0.8-1,1-1.5,1.2-3,1.5-6,3-,4-5,5-6,7-12,8-9,absent,acuminate,acute,along,anthesi,apical,basal,berry,broadly,capitat,cell,climbing,composed,conical,conspicuously,decurrent,deltate,dr.,drying,eaf,edicel,eed,epidermal,erect,exserted,extending,filament,free,fruiting,globose,groove,horizontal,inflorescenc,lamina,lateral,less,like,lon,long,lower,margin,markedly,midrib,nflorescence,noddin,nodding,obovate,often,onto,open,opposite,pair,paired,papilla,pedicel,per,perfectly,petiolule,poricidal,portion,reflexed,rest,rugose,rugosity,ruit,scar,scattered,scrambling,smaller,tem,terminal,time,triangular,trichome,tub,ud,unevenly,unifoliat,uniseriate,unit,vein,white-lenticellate,whitish,ympodial	.0,2.0,branching,capitate,color,form,growth,history,leaf,life,na,perennial,plant,pubescence,reproduction,shape,size,stem,texture
197	wfo-0001027219	success	143	92	64	79	28	0.448	0.4-0.6,0.5-0.8,1-15,1-2,1-3,1.5-2,1.5-2.5,2,2-2.5,2-3.5,3-5,3-6,6-8,7-8,acuminate,acute,anther,apex,base,bright,broadly,brown,calyx,cm,conical,corolla,deltate,densely,diameter,elliptic,entire,filament,flower,glabrescent,glabrous,green,greyish,growth,heterostylous,lobe,lobed,margin,mm,ovary,pair,pale,papillose-pubescent,petiole,purple,shrub,simple,stem,stigma,style,surface,tip,trichome,tube,tuft,uniseriate,vein,violet,white,x	.5,/4,0.3,0.5,1,2-3,2-4,absent,age,anthesi,axillary,bark,berr,berry,c.,capitate,closely,completely,cup-shaped,drying,eaf,edge,eed,erect,exerte,exfoliatin,free,fruiting,glabrou,globose,hard,known,leaf-opposed,lengthening,less,long-conical,long-styled,lower,maturity,minutely,new,nflorescence,overlappin,papillo,pedicel,peduncle,pendent,pericarp,planar,plurifoliat,pointed,pore,poricidal,portion,primary,pubescent,ruit,scar,sharply,shoot,short,short-styled,slightly,slit,sometimes,somewhat,soon,spaced,stout,terminal,thickened,ud,unit,way,weight,woody,yellowish,ympodial,–1/3	branching,color,form,fruit,height,history,inflorescence,lateral,leaf,length,life,midpoint,midrib,midvein,na,perennial,plant,pubescence,ray,reproduction,seed,shape,size,staman,stellae,stipe,texture,width
198	wfo-0001027221	success	261	104	67	194	37	0.257	.5,0.3-0.6,1,1.4-2,2,25-30,3.1-4.8,4,6-8,acute,andromonoecious,anther,apex,attenuate,base,blue,branched,bright,calyx,cm,diameter,filament,flattened-reniform,flower,fruit,glabrous,glandular-pubescent,globose,lateral,leaf,light,lobe,margin,midrib,midvein,minutely,mm,orange,outline,ovate-triangular,pale,petiole,pitted,plant,ray,rounded,shrub,simple,size,stellae,stellate,stellate-pubescent,stellate-tomentose,stem,stigma,style,subcordate,surface,tip,triangular-caudate,tube,unbranched,variable,vein,violet,x,yellow	-9.5,0,0.4,0.4–0.6,0.5–2,0.8–1,1-4,1.5-2,1.6–2,11-17,11–14,13–16,14–17,1–2,2.2-3.2,2.5–2.8,2.5–5,2.9–3.6,2/3,2–2.5,2–3,2–5,3–6,4.5–11,4–8-rayed,5-8,5-merou,6.5–7,8.5–18,9,abaxial,abaxiall,abaxially,acicular,actually,acutely,adaxially,along,also,always,alyx,ample,apart,apparent,apparently,appear,armed,aromatic,articulated,ba,becoming,berry,blade,blunt-tipped,broad-based,bud,capitat,caudate,central,chartaceous,clavate,closely,common,contrasting,coroll,curved,cylindrical,darker,deeply,delicate,dense,densely,development,difoliate,directed,discrete,distally,eaf,eed,entire,equal,eventually,evidently,exceeding,expanded,extra-axillary,fewer,frequently,fresh,fruiting,geminat,glabrescent,gland,hair,half,herbarium,hermaphrodite,homostylous,intensity,interpetalar,juic,lanceolate,least,like,likely,lobed,long,lower,main,major,material,microscope,midpoint,minor,mostly,much,nearly,nerve,nflorescence,obtuse,often,older,orolla,ovate,ovate-oblong,pair,paired,pedicel,peduncle,per,perfect,perhaps,peripherally,persistently,plurifoliate,pore,predominately,prickle,probably,rachi,rarely,reflexed,repand,ruit,sessile,short-stalked,side,similar,sinus,slightly,smaller,sometimes,somewhat,soon,source,spaced,sparsely,specimen,splitting,sprout,stalk,stalked,stamen,straight,sulcate,tal,tapered,tem,thick-textured,thickened,time,tissue,tomentose,toward,unarmed,underside,unequal,unit,unpleasantly,usually,vary,viscid,viscidity,way,weakly,white,wide,ympodial,youn,young,–11.5,–15,–3,–4	0.4-0.6,0.8-1,1-2,1.6-2,11.5,15,2-2.5,2.5-2.8,2.5-5,2.9-3.6,3,3-6,4-8,4.5-11,6.5-7,8.5-18,branching,color,corolla,form,growth,height,history,inflorescence,length,life,na,ovary,pellucid,perennial,pubescence,reproduction,seed,shape,staman,texture,width
199	wfo-0001027223	success	189	96	73	116	23	0.386	.5,0.19-0.75,0.3-1.2,1-2,1-3,1.8-3.5,3-10,3-11,3-5.2,3.5-4,5-10,5-8,5.9-12.2,9-15,9-22,9-35,anther,brownish,cell,cm,condition,conical,corolla,covering,deep,densely,diameter,dot,drying,filament,flower,forked,fresh,fruit,glabrous,green,greenish,hair,hair-like,herb,hyaline,lateral,leaf,light,lobe,long,mm,odd-pinnate,ovoid,pentagonal,perfect,petiole,plant,pubescent,purple,rotate,seed,short,size,sometimes,stigma,stripe,style,testal,thick,tip,tube,wall,white,whitish,wide,x,yellow	1.3-2,1.5-3.5,16-41,2-4,2-7,3-5,3.5-6,3.5-7,3.7-9.3,4-6,5-21,5-merou,abaxially,acumen,acuminate,adaxiall,adaxially,ag,alyx,apart,apex,apparently,articulated,asymmetric,attenuate,axe,axillary,base,basiscopic,berry,blade,bud,capitat,clavate,connivent,decreasing,digestion,distal,dorsally,eaf,edge,eed,elliptic,end,enzyme,erec,exceeding,flat,folded,geminat,generally,glabrou,green-white,hal,half,homostylous,honeycomb-shaped,interjected,lanceolate,larger,leaflet,lengthening,like,living,lower,make,middle,mucilaginous,nflorescence,one,orbicular,orolla,ovate,pair,pedicel,peduncle,petiolulate,placed,plurifoliate,pore,poricidal,present,removed,ripe,rounded,ruit,sessile,seudostipule,shortly,side,slightly,slit,spaced,specimen,stamen,ste,stolo,straight,subequal,subtending,tall,tamen,tem,terminal,throughout,tissue,toward,tri-,tuber,typically,unit,unwinged,usually,vary,wet,ympodial	abaxial,adaxial,branching,calyx,color,form,growth,height,history,inflorescence,length,life,midrib,na,ovary,perennial,pubescence,reproduction,shape,staman,stem,surface,texture
200	wfo-0001027229	success	206	110	84	122	26	0.408	0-0.2,0.1-3,0.5-0.9,0.6-1,1-1.5,1-2,1.3-1.7,1.5-2.5,1.5-3,2-10,3-6,3.5-5,3.5-6,4-10,4-6,5-15,5-6,7-11,8.5-12,abaxially,acute,adaxially,anther,apex,attenuate,base,broadly,calyx,chartaceous,cm,cordate,cylindrical,densely,diameter,especially,filament,flower,fruit,glabrous,globose,green,herbaceous,inflorescence,lateral,length,lilac,lobe,lobed,long,margin,midvein,minutely,mm,moderately,obtuse,ovate,pale,pentagonal,perfect,petiole,ray,reniform,resprouter,reticulate,shallowly,sparsely,stellae,stellate,stellate-pubescent,stigma,straight,style,surface,tan,throughout,time,toward,triangular,tube,unbranched,vein,wide,x,yellow	%,0-0.1,0-8,0.1-0.3,0.1-0.6,0.1-1,0.1-1.4,0.2-0.4,0.2-1.7,0.2-2,0.5-0.7,0.5-3,0.6-0.7,1-6,1-7,1-8,1.1-1.2,1.8-2.7,12-17,2-4,2-5,2-foliate,2-locular,2.5-6,20-65,25-35,30-145,30-300,4-5,4-7,40-55,5-9,5-merou,8-12,absen,absent,abundant,accrescent,acicular,across,adaxiall,adult,alyx,apart,armed,articulated,axe,ba,blade,branche,capitat,circular,cross-section,decimetre,directed,distall,eaf,eed,eglandular,elliptica,erect,exceeding,exocarp,extra-axillary,finger,flattened,fruiting,geminat,gland-tipped,glandular,hair,homostylous,index,interpetalar,juicy,lamina,lanceolate,lobing,lon,longer,lower,mature,mesocarp,mid-point,midpoint,minute,moist,nflorescence,oblique,orolla,part,pedicel,peduncle,per,placenta,pore,porrect,presen,present,prickle,prostrate,pseudo-racemose,rachi,ruit,short,side,simple,spaced,sprawling,stage,stalk,stalked,tal,tamen,tem,thick,tissue,transparent,unit,uvenile,vary,ympodial	branching,color,corolla,form,growth,height,history,leaf,life,midrib,na,ovary,perennial,plant,pseudoracemose,pubescence,reproduction,seed,shape,size,staman,stem,stipe,texture,tip,width
201	wfo-0001027232	success	195	111	88	107	23	0.451	0.3-0.45,0.3-0.5,0.4-0.8,0.6-0.9,0.7-1.5,1.1-1.5,1.5-2.5,1.5-3,14-30,2-3.4,2.1-2.8,2.5-3,3-5,3.5-10,4-5.5,4-8,4.5-6.5,5-11.5,5-8,acute,adaxially,anther,apex,base,black,bluntly,broadly,brown,calyx,chartaceous,cm,cordate,cylindrical,deeply,deltate,diameter,discoid,erect,filament,flattened,flower,forked,fruit,glabrous,globose,green,inflorescence,irregularly,lateral,length,lilac,lobe,lobed,long,margin,midpoint,midrib,midvein,mm,moderately,obtuse,orbicular,ovate,pale,perennial,perfect,petiole,purple,ray,rhizomatous,rostrate,shrub,sparsely,stellae,stellate,stellate-pubescent,stigma,straight,style,throughout,time,triangular,tube,unbranched,vein,wide,x,yellow	%,0-0.1,0-7,0.15-0.3,0.25-0.4,0.3-0.4,0.45-0.6,0.5-0.8,0.7-1.3,0.8-3.2,0.9-7.5,1-10,1-locular,1.8-3.9,10-30,14-18,15-100,2-25,25-35,3-9,350-800,4-10,4-6,5-merous,6-8,7-9,abaxially,absen,absent,accrescent,acicular,across,adaxiall,adult,apart,apparen,armed,articulated,axe,ba,blade,branche,capitat,confined,decimetre,directed,distall,distributed,eaf,eed,eglandular,exocarp,extra-axillary,finger,fruiting,gland-tipped,hair,half,incomplete,index,juicy,lamina,lancolate,less,lobing,longer,lower,mature,mesocarp,mid-point,minute,minutely,nflorescence,oblique,orolla,outline,part,pedicel,peduncle,per,placenta,pore,porrect,present,prickle,reticulate,ruit,septum,sessile,short,side,simple,spaced,sparse,stalk,succulent,surface,tal,tamen,tem,thick,transparent,unarme,unit,unknow,vary,ympodial	branching,color,corolla,form,growth,height,history,leaf,life,na,ovary,plant,pubescence,reproduction,seed,shape,size,staman,stem,stipe,texture,tip,width
202	wfo-0001027234	success	206	137	110	96	27	0.534	-0.15,-1.5,-2,-3,-3.5,0.05-0.1,0.15,0.2-1.3,0.3-1,0.5-0.7,0.5-2,0.6-0.8,0.7-1.3,0.7-1.5,0.8-0.9,0.9-1.6,1,1-2,1.5-2.2,1.5-4,1.8-3,2-4,2/3-4/5,3-5,8-16,abaxially,acute,almost,anther,apex,apically,apparently,attenuate,base,berry,black,branched,brown,calyx,cell,cm,concolorous,cordate,dark,deltate,diameter,drying,entire,erect,filament,flattened-reniform,flower,fruit,glabrescent,glabrous,gland,globular,herb,lateral,leaf,length,lobe,lobed,long,longer,margin,maturity,mauve,membranous,midpoint,mm,near,obtuse,one,open,orbicular,outline,ovate,pair,pale,petiole,pit,prickly,purple,raised,ray,red,reduced,reflexed,rounded,scandent,shrub,sometimes,sparsely,spherical,spreading,stellate,stellate-pubescent,stem,style,surface,time,tip,trichome,tube,unarmed,vein,way,wide,yellow	-6,.5,0-20,0-4,0.1,0.1-2,0.3-0.4,0.5-3,1-4,1.2-2,1.5-3.5,1/3,1/4-1/3,12-18,3-10,3-6.5,4-5-merous,8-15,absent,acuminat,alyx,apar,apart,articulated,bark,beyond,blac,blade,broad-deltate,curved,difoliate,dot,eaf,eed,elongating,equal,eye,filiform,free,fruiting,geminat,glabrou,glan,gray,green,herbaceous,infructescence,lower,mature,moderately,multangulate,naked,narrowly,nflorescence,oblong,older,orolla,oung,pedicel,peduncle,pendulous,per,perfec,pericarp,perpendicular,poricidal,porrect,portion,prickle,primary,protruding,ruit,scar,scattered,sessile,shorter,simple,slightly,smooth,spaced,stalk,stalked,straight,tamen,tapering,terete,tertiary,unarme,unit,vary,venation,visible,white,winged,yellowish,ympodial	acuminate,branching,color,corolla,form,growth,height,history,inflorescence,life,midrib,midvein,na,ovary,perfect,plant,pubescence,reproduction,seed,shape,size,staman,stellae,stigma,stipe,texture,width
203	wfo-0001027235	success	189	126	100	89	26	0.529	.5,0.5,1,1.2,1.5,10,11,12,14,2,2.5,3,35,4,5,6,8,9,?,abaxial,abaxially,adaxially,anther,apart,apex,armed,asymmetrical,base,black,brown,calyx,chartaceous,chocolate-brown,cm,deeply,diameter,drying,filament,flower,fruit,glabrous,gland-tipped,globose,green,hair,herb,irregularly,leaf,length,like,lobe,lobed,long,margin,maturity,midrib,midvein,mm,moderately,multicellular,narrowly,nearly,obtuse,occasional,often,one,per,petiole,pinnatifid,pinnatisect,prickle,pubescent,raised,ray,reniform,ridge,rotate-stellate,rounded,side,simple,sparsely,stellate,stem,stigma,style,surface,tan,tearing,triangular,tube,turning,unbranched,undulate,unicellular,uniseriate,vein,white,yellow,zygomorphic,×	13,18,30,40,5-merous,absent,abundant,accrescent,acicular,acute,adaxial,alternating,alyx,articulated,axe,ba,berry,blade,burr-like,c.,completely,cordate,covering,creating,curved,cylindrical,densely,difoliate,dimorphic,directed,distally,dry,eaf,eed,enantiostylou,extra-axillary,four,fruiting,geminate,glabrou,interpetalar,introrsely,invested,larger,left-handed,linear-lanceolate,lon,longitudinal,lower,lowermost,midpoint,multiseriate,nflorescence,occasionally,opening,opposite,orolla,pair,pedicel,peduncle,pinnate,pore,prickly,rachi,right,ruit,secondary,shallowly,slightly,slit,spaced,stalk,ste,straight,strongly,tamen,tapering,tem,tightly,tissue,unequa,unit,upper,upward,usually,vary,venation,wid,ympodial	branching,color,corolla,enantiostylous,form,growth,height,history,inflorescence,lateral,life,na,ovary,perennial,plant,pubescence,reproduction,seed,shape,size,staman,stellae,texture,tip,wide,width
204	wfo-0001027236	success	199	118	96	103	22	0.482	1-2,1-3,1.5-2,10-20,2-2.5,2-3,2-5,2-6,2.5-,3-3.5,3-4,3-8,5-,5-6,5-9,7-14,8-10,abaxially,acute,adaxially,anther,apex,basal,base,becoming,berry,blue,branched,brown,calyx,chartaceous,cm,cordate,corolla,densely,diameter,distal,filament,flattened,flower,foveolate,fruit,glabrous,glandular-hirsute,globose,green,growth,heterostylous,lanceolate,lateral,length,lobe,lobed-angulate,margin,midpoint,mm,ovary,ovate-cordate,petiole,plant,prickle,prickly,pubescence,pubescent,ray,reniform,reticulate,ripe,runcinate,rusty,shrub,simple,sparsely,stellate,stellate-pilose,stem,stigma,style,subcoriaceous,suborbicular,subsagittate,surface,terete,tiny,tip,tube,unarmed,villous-glandular,violet,viscid-tomentose,woody,x,yellow,yellow-orange,¼,½	-4.5,-5,-82,/6,0.2-0.3,0.6-0.7,1,1-1.5,1-2.5,1.2-1.5,10,2-,30-50,4-5,5-8,anthesi,armed,articulated,asymmetric,bark,brow,caly,clavate-truncate,closely,compressed,dark,discolorous,eaf,eed,eglandular,erect,exserted,free,fruiting,fused,glabrescent,gland-tipped,glandular,internodal,lengthening,light,like,lobed,long,long-styled,lower,middle,minute,minutely,mixed,multangulate,nearly,new,nflorescence,obverse,ochraceous,older,ovate-turbinate,papillo,partially,pedicel,peduncle,per,perfect,pericarp,plurifoliat,pore,poricidal,porrect,portion,raise,recurved,reflexe,rounded,ruit,scandent,scar,sessile,short-styled,slightly,slit,smooth,somewhat,space,stalked,staminate,stellate-glandular,striped,subglobose,tall,tapering,testa,trichome,ud,unevenly,unit,upper,velutinous,villous,viscid,woolly,ympodial,young	branching,color,form,height,history,inflorescence,leaf,life,midrib,midvein,na,perennial,reproduction,seed,shape,size,staman,stellae,stipe,texture,vein,width
205	wfo-0001027237	success	122	89	57	65	32	0.467	0.5-1,1-1.2,1.5-2,1.5-2.5,2-3,3-3.5,3-4,30-100-flowered,6-11,6-8,8,anther,apiculate,base,black,branched,broadly,brown,calyx,cm,corolla,dark,deltoid,drying,filament,flattened,glabrous,globose,green,greenish-white,inflorescence,leaf,lobe,lobed,many,margin,minutely,mm,ovary,paler,papillose,pitted,regularly,reniform,shining,shrub,small,stem,stigma,style,surface,time,tip,tree,tube,white,x	.5,/4,5,anthesi,apart,apiculae,appearing,ba,bark,berry,blac,branc,clavate,completely,cucullate,cup-shaped,deflexed,dia,difoliate,edicel,eed,ellipsoid,erect,exsertion,free,fruiting,geminate,greyi,internodal,later,long,lower,nflorescence,occasionally,older,papillate,papillo,part,pedicel,plurifoliat,pore,poricidal,portion,reflexed,regulary,ruit,scar,shaped,slender,spaced,straight,tall,tapering,tear-drop,terminal,ud,unit,upper,usually,way,widely,woody,x.,ympodial,young	0.5,apex,branching,color,diameter,flower,form,fruit,growth,height,history,lateral,length,life,midpoint,midrib,midvein,na,petiole,plant,pubescence,ray,reproduction,seed,shape,size,staman,stellae,stipe,texture,vein,width
206	wfo-0001027238	success	204	123	97	107	26	0.475	-25,.3,0-1,0-1.5,0.3-0.5,0.3-0.8,0.3-1,0.3-5,0.5-1,0.5-16,1-1.5,1.5-3,1.5-4,2-4,3-4,3-5,3-6,4-10,6-15,6-8,abaxially,acuminate,acute,adaxially,anther,apex,base,black,blade,brown,calyx,chartaceous,cm,cuneate,densely,diameter,elliptic,elliptic-ovate,entire,filament,flower,fruit,glabrous,globose,hair,lavender,leaf,light,like,lobe,major,margin,membranaceous,midpoint,minutely,mm,multangulate,narrowly,near,oblique,obtuse,outline,pale,petiole,pitted,porrect-stellate,pubescent,purple,ray,reniform,ripe,rounded,sessile,shiny,shrub,side,small,sometimes,sparsely,stellate,stellate-pubescent,stem,stigma,style,surface,tip,toward,tree,triangular,tube,unbranched,vein,white,whitish,x,yellow,yellowish	-5,.5,0-0.7,0.5-2,1-2,1.5-7,10,15-30,2-3,4-,4-16,4-5,4-8,5-15,5-7,5-merou,accrescent,adaxiall,ag,alyx,apparently,articulated,axe,ba,berry,branch,capitat,connivent,contiguous,covering,cylindrical,dark,deltate,differentiated,directed,discolorous,distally,eaf,eed,equal,extra-axillary,flattened,fleshy,foliaceous,fork,free,frui,fruiting,geminate,glabrescent,gland,gland-tipped,green,greenish,growt,homostylous,interpetalar,introrsely,juic,large,lighter,long,longitudinal,lower,minor,mixed,nearly,new,nflorescence,oblong,often,one,opening,orolla,paired,part,pedicel,peduncle,perfect,pericarp,plurifoliate,pore,rachi,ruit,scandent,short-stalked,similar,simple,slit,somewhat,sparse,sprawling,ste,straight,strongly,subtending,tamen,tem,time,tissue,unarme,unequal,unit,vary,wide,without,ympodial	branching,color,corolla,form,growth,height,history,inflorescence,lateral,length,life,midrib,midvein,na,ovary,plant,pubescence,reproduction,seed,shape,size,staman,stellae,stipe,texture,width
207	wfo-0001027242	success	238	127	107	131	20	0.45	0.15-0.25,0.25-0.5,0.3-1.1,0.6-3,0.7-1.2,1-1.5,1-2.5,1.5,1.5-2,1.5-3,1.9-5,2.5-3,2.8-3.7,3-12,3-4.5,4-5.5,4.5-11,5.5-7,7-8,abaxially,acute,adaxially,andromonoecious,anther,apex,base,calyx,chartaceous,cm,cuneate,cylindrical,deltate,densely,diameter,entire,erect,filament,flattened,flower,forked,fruit,glabrous,gland-tipped,globose,hair,heterostylous,inflorescence,interpetalar,lateral,leaf,length,light,lobe,lobed,margin,midpoint,midrib,midvein,minutely,mixed,mm,moderately,narrowly,nearly,occasionally,orange,ovate,pale,perennial,perfect,petiole,pink,plant,pseudo-racemose,pseudo-umbellate,purple,ray,red,reticulate,rhizomatous,rostrate,shallowly,short,shrub,smooth,sparsely,sprawling,stellae,stellate,stellate-pubescent,stigma,style,subcoriaceous,surface,throughout,tip,tissue,toward,triangular,tube,unbranched,vein,white,whitish,x,yellow,yellowish	%,.05,.2,0-0.7,0-1.5,0-15,0-20,0-5,0.2-0.7,0.2-1,0.3-0.5,0.5-1,0.6-0.9,1-1.2,1-2,1-locular,10-22,12-16,15-25,2,2-2.9,2-3,3-6,3-7,3.5-4.5,4-30,4-7,4.5-10.5,5-merou,6-14,6-21,6-7,6-8,8-15,9-11,absen,absent,accrescent,acicular,across,adult,alyx,apart,apparen,articulated,axe,ba,blade,bract-like,branch,branche,capitat,confined,connivent,contiguous,directed,distall,dm,eaf,eed,exocarp,extra-axillary,finger,fruiting,geminate,green,half,incomplete,index,juicy,juvenile,lamina,less,lobing,long,longer,loosely,lower,mature,mesocarp,mid-point,minute,much,nflorescence,oblique,obtuse,often,one,orolla,pair,part,pedicel,peduncle,per,placenta,plurifoliate,pore,porrect,present,prickle,rachi,rooting,rounde,ruit,septum,sessile,side,simple,slightly,smaller,spaced,sparse,straight,strongly,succulent,tall,tamen,tapered,tem,thick,time,tissu,unarme,unarmed,unit,upper,usually,vary,weakly,wide,ympodial	branching,color,corolla,form,growth,height,history,life,na,ovary,pubescence,reproduction,seed,shape,size,staman,stem,stipe,texture,width
208	wfo-0001027244	success	294	115	99	195	16	0.337	-12,-3.2,.5,0.1-0.5,0.1-0.6,0.4-0.6,0.45-0.6,0.5,0.5-0.8,0.7-1.5,0.8-1.2,0.9-1.3,1,1.1-1.3,1.2-1.6,1.5-2.4,1.5-6.5,1.7-3.0,1/2,2-,2.1-8,3.5-13,3/4,4-12,7-12,anther,apex,articulated,articulation,base,bifurcate,bracteate,branched,broadly,brown,capitate,cell,cm,conical,corolla,curved,dark,densely,diameter,distal,elliptic,filament,flower,fruit,glabrous,glandular,globose,green,greenish,hair-like,half,herb,inflorescence,lateral,length,like,long,middle,mixture,mm,obovate,often,orbicular,outgrowth,ovary,pedicel,peduncle,perennial,present,pubescent,purple,rotate-stellate,simple,size,slender,sparsely,stem,stigma,stripe,strongly,style,surface,testa,thick,trichome,uniseriate,usually,velvety,vivid,wall,white,wide,woody,yellow	-1.2,-2,0-,0.02-,0.04-,0.05,0.05-1,0.07-0.15,0.1-,0.1-0.3,0.15-0.2,0.2,0.2-,0.2-1,0.25-0.4,0.3,0.3-0.4,0.3-0.5,0.3-0.6,0.3-0.8,0.4-,0.4-1,0.5-1,0.6-0.9,0.6-09,0.7-1,0.7-2,0.7-3,0.9-1.7,1-2-celled,1-2.5,1-3.5,1-celled,1.5-2,1.5-2.1,2-4,2-4-celled,2-9,2-foliate,2-locular,3-5,4-celled,5-,5-10,5-9-celled,8-16,8-celled,abaxially,absent,abundance,abundant,acroscopically,acuminate,acute,adaxially,adpressed,alfway,along,also,always,amongst,angled,anthesi,apical,apparently,appearance,appendage,arequipa,around,articulatio,axi,basal,berr,berry,bract,c.,cage,calyx,column,common,cordate,crenate,deciduous,decumbent,decurrent,deeper,deltate,dense,density,dentate,developed,diamete,eaf,edicel,eed,eglandular,either,elliptical,erect,exserted,extremely,flushed,forming,fruiting,general,giving,glabrescent,gland,gree,halfway,head,hyaline,imparipinnate,interjected,internode,interrupted,investing,irregularly,lamina,lanceolate,larger,largest,leaflet,leave,lobe,lobed,lobing,lon,longer,lower,margin,midvein,minute,mixed,multicellular,narrowly,near,node,oblique,occasionally,onto,pair,papillate-pubescent,patent,petiole,petiolule,population,primary,pseudostipule,rachi,reflexed,rest,ripe,rounded,ruit,scattered,secondary,sessile,shaggy,short,shorter,silky,sinus,small,sometimes,somewhat,sparse,sparser,spreading,staminal,sterile,stout,straight,tall,tem,terminal,tertiary,tiny,tip,tipped,toward,truncate,tube,two,ud,undulate,unicellular,unit,united,upper,variable,variety,vein,winged,ympodial	bud,color,form,growth,height,history,leaf,life,plant,pubescence,reproduction,seed,shape,staman,texture,width
209	wfo-0001027248	success	158	102	75	83	27	0.475	.5,0.5-2.5,0.7-1.2,1-1.5,1-2,1-3,1-5,3-4,3-7,3-7-flowered,3.5-4,5-5.5,6-13,6.5-8,7-9,abaxially,acute,adaxially,anther,apex,arachnoid,arachnoid-pubescent,base,beige,broadly,brown,calyx,cm,corolla,dark,deltate,densely,dia,dirty,elliptic,filament,fruit,glabrous,globose,green,lateral,leaf,lobe,lobed,long,margin,minutely,mm,nearly,ovary,ovoid-reniform,pair,pale,patch,petiole,pitted,pubescence,pubescent,scattered,shrub,simple,size,small,sparsely,stem,stigma,style,surface,tip,tree,trichome,tube,vein,white,wide	0,0.5-1,2-2.5,2-4.5,4-8,abaxial,along,anthesi,ape,appearing,arachnoid-pubescen,area,bark,beneath,berry,broadened,brownish,brownish-gra,closely,conical,deflexed,denser,differing,difoliate,eaf,edicel,eed,ellipsoid,erect,exserted,felty,fleshy,free,fruiting,geminate,glabrescent,grayish-green,impressed,lamina,later,lightly,lower,main,major,merely,minor,nflorescence,node,occasionally,older,opposite,overlappin,papillo,papillose,pedicel,per,planar,pore,poricidal,portion,present,ruit,scar,shaped,shoot,somewhat,soon,spaced,specimen,strongly,tall,tear-drop,thick,top,tub,ud,unifoliate,unit,wid,winged,woody,ympodial,young	branching,brownish-gray,color,diameter,flower,form,growth,height,history,inflorescence,length,life,midpoint,midrib,midvein,na,perennial,plant,ray,reproduction,seed,shape,staman,stellae,stipe,texture,width
210	wfo-0001027258	success	178	101	74	104	27	0.416	0.25-0.5,0.6-2,1-2.3,1.5-1.6,2-2.5,3-4,3-6,3.5-4,4-5,4.5-5,5-10-flowered,6-8,7-13,7-9,abaxially,acuminate,acute,anther,anthesi,apex,apical,attenuate,base,calyx,cm,corolla,densely,elliptic,filament,flattened-reniform,fruit,glabrous,globose,green,greenish-yellow,lateral,leaf,length,lobe,lobed,margin,minutely,mm,ovary,ovate,pair,pale,papillose,petiole,pitted,planar,projection,prominent,pubescent,shrub,simple,size,slightly,sparsely,stem,stigma,style,surface,tip,treelet,trichome,tube,tuft,uniseriate,vein,white,winged,x,yellowish-tan	.25,.5,/4,0.5-1,0.9-1.3,1-1.5,1-4,1.2-2,2.5-8,abruptly,adaxially,age,along,apar,apiculae,axil,ba,bark,beneath,berry,broadly,capitate,crystal,darker,decurrent,deflexed,deltate,dense,deposit,dia,differing,difoliate,dissecting,drying,eaf,edicel,eed,ellipsoid,enlarge,entire,evenly,exserted,extending,fide,fragrant,free,fruiting,geminat,glabrou,incrassate,internodal,lamina,large,lengthening,lenticel,long,lower,main,major,microscope,middle,minor,minute,nee,nflorescence,occasionally,often,older,onto,opposite,papillo,pedicel,pore,poricidal,portion,red-papillose,reddish,ruit,sand,scar,scattered,slender,slit,small,spaced,speck,straight,strongly,sweetly,swollen,tall,tiny,tub,ud,unit,urceolate,visible,way,widening,widest,woody,yellowish,ympodial,young	0.5,branching,color,diameter,flower,form,growth,height,history,inflorescence,life,midpoint,midrib,midvein,na,perennial,plant,pubescence,ray,reproduction,seed,shape,staman,stellae,stipe,texture,width
211	wfo-0001027260	success	176	121	85	91	36	0.483	-60,0.25-1,0.5-3,0.5-6.5,0.8-2,1-3,1-6,1-7,1.5-2,2-10,2-18,2-2.5,2.5-3.5,3-11,3-4.5,3-6,3.5-25,4-32,4-6,6-20,abaxially,acuminate,acute,acute-,adaxially,age,also,apex,basal,base,branched,chartaceous,cm,cordate,cylindrical,darker,densely,diameter,ellipsoidal,elliptic,elliptic-ovate,entire,fading,flattened,flower,fruit,glabrate,glabrous,globose,greenish,lavender,lobe,longitudinal,margin,mm,moderately,often,ovate,petiole,pilose,pink,puberulent,puberulent-pubescent,pubescent,pubescent-pilose,purple,shrub,small,sparsely,stellate,stigma,stripe,style,subcoriaceous,tree,triangular,tube,unbranched,usually,vein,white,x,yellow,yellow-green,yellowish	-17,-2,-7,0.5-1,0.75-1,1-,1-2,1-4,1.5-13,10-25,15-30,2-,2.5-14,3-,3-10,4-25,4-5-foliat,4.5-14,5-,5-25,5-40,5-merous,absent,aggregate,alyx,apart,ape,articulated,axe,berry,beyond,blade,cell,clavate,connective,connivent,diamete,directed,distally,eaf,eed,eglandular,equal,exceeding,exserted,hair,lanceolate,leaving,lon,long,lower,membranaceous,narrowly,nearly,nflorescence,nther,obtuse,orolla,pedicel,pedicellar,peduncle,perfec,perfect,pilo,pore,presen,puberulent-pubescen,rachi,radiu,remnant,ruit,shorter,simple,slightly,spaced,stamen,stone,strongly,tal,tapered,tem,thecae,time,tomento,truncate,ud,unit,vary,wide,yellow-orang,ympodial	15-40,anther,branching,calyx,color,corolla,filament,form,growth,height,history,inflorescence,lateral,leaf,length,life,midpoint,midrib,midvein,na,ovary,plant,pubescence,ray,reproduction,seed,shape,size,staman,stellae,stem,stipe,surface,texture,tip,width
212	wfo-0001027265	success	159	96	63	96	33	0.396	0.2-0.4,0.5-1,1.2-1.3,1.2-2,2,2-3,2/3,20-30,3-lobed,abaxially,acute,adaxially,anther,apex,base,calyx,chartaceous,ciliate,cm,cylindrical,diameter,entire,filament,flattened-reniform,flower,fruit,glabrous,globose,herb,hermaphroditic,light,lobe,long-attenuate,lower,margin,minutely,mm,nearly,orange,ovate-lanceolate,petiole,pitted,puberulent,pubescent,purple,rarely,red,rotate-stellate,seed,slightly,sometimes,sparsely,stigma,style,subcoriaceous,surface,tip,triangular,tube,white,white-puberulent,x,yellow	-2.5,.2,.3,.5,0.1–2,0.5,0.5–0.6,1-1.3,1-2.5,1-3,1.2–1.4,1.5-2.5,1.5–1.8,1.5–2,1.5–4,2-,2-4,2–2.5,2–3,3-,30–50,4-5,4.5–8,4–6,4–7-branched,5-merou,58409,accrescent,adaxiall,alyx,apart,apparently,articulated,axe,ba,berry,blade,broad,capitat,connivent,covering,croat,dehiscent,eaf,eed,erect,extra-axillary,foliate,frui,fruiting,geminat,granule,hair,juic,larger,leaf-opposed,lon,long,longitudinall,low,mesocarp,near,nflorescence,node,numerous,oblong,obtuse,orolla,paired,partially,pedicel,peduncle,pore,present,prominent,rachi,recurved,ripe,rooting,ruit,scarcely,sclerotic,simple,somewhat,spaced,tall,tamen,tem,time,unit,usually,vary,weak,wide,winged,ympodial	0.2,0.5-0.6,1.2-1.4,1.5-1.8,1.5-4,30-50,4-6,4-7-branched,4.5-8,branching,color,corolla,form,growth,height,history,inflorescence,leaf,length,life,midrib,na,ovary,perennial,plant,pubescence,reproduction,shape,size,staman,stem,texture,width
213	wfo-0001027265	success	156	108	69	87	39	0.442	.2,.5,0.2-0.4,0.5,0.5-1,1.2-1.3,1.2-2,2,2-3,2/3,20-30,3-lobed,abaxially,acute,adaxially,anther,apex,base,calyx,chartaceous,ciliate,cm,cylindrical,diameter,entire,filament,flattened-reniform,flower,fruit,glabrous,globose,herb,hermaphroditic,light,lobe,long-attenuate,lower,margin,minutely,mm,near,nearly,orange,ovate-lanceolate,petiole,pitted,puberulent,pubescent,purple,rarely,red,ripe,rotate-stellate,seed,slightly,sometimes,sparsely,stigma,style,subcoriaceous,surface,tip,triangular,tube,white,white-puberulent,winged,x,yellow	-2.5,.3,0.1–2,0.5–0.6,1-1.3,1-2.5,1-3,1.2–1.4,1.5-2.5,1.5–1.8,1.5–2,1.5–4,2-,2-4,2–2.5,2–3,3-,30–50,4-5,4.5–8,4–6,4–7-branched,5-merou,58409,accrescent,adaxiall,alyx,apart,apparently,articulated,axe,ba,blade,broad,capitat,connivent,covering,croat,dehiscent,eaf,eed,erect,extra-axillary,foliate,frui,fruiting,geminat,granule,hair,juic,larger,leaf-opposed,lon,long,longitudinall,low,mesocarp,nflorescence,node,numerous,oblong,obtuse,orolla,paired,partially,pedicel,peduncle,pore,prominent,rachi,recurved,rooting,ruit,scarcely,sclerotic,simple,somewhat,spaced,tall,tamen,tem,time,unit,vary,weak,wide,ympodial	0.5-0.6,1.2-1.4,1.5-1.8,1.5-4,30-50,4-6,4-7-branched,4.5-8,branching,color,corolla,form,growth,height,history,inflorescence,lateral,leaf,length,life,midpoint,midrib,midvein,na,ovary,perennial,plant,pubescence,ray,reproduction,shape,size,staman,stellae,stem,stipe,texture,vein,width
214	wfo-0001027276	success	219	104	70	149	34	0.32	-22,1,10,2,6,7,80,acuman,acute,anther,apex,base,black-green,broadly,brown,calyx,clonal,cm,conspicuously,corolla,cyme,dense,diameter,drying,entire,filament,filiform,flower,fruit,glabrous,globular,gray-green,green,growth,indumentum,inflorescence,lanceolate,least,length,linear,lobe,lobed,margin,minutely,mm,ovary,petiole,plant,purple,rarely,reticulate,rotate,scabrous,short,slender,slightly,staman,stellate,stellate-pubescent,stem,stigma,style,subshrub,surface,tapering,tip,trichome,wavy,yellow-green,×	.5,0,0.5,0.5–1,1.2–1.5,1.5,1.5–2,1–1.5,1–2,2–5,2–6,4–5,4–9,5,5-merous,5–10,5–12mm,5–7,9–12,absent,acumen,ale,along,alternate,alyx,anthesi,apparently,armed,around,aspect,ba,becoming,beneath,berry,beyond,bifid,boht,borne,branche,c.,caly,central,cone,covered,dark,densely,detaching,different,dioeciou,drop,eaf,eduncle,eed,ending,erect,even,eventually,except,expanding,exserted,extending,falling,female,fine,following,functionally,fused,gra,growt,hermaphrodite,inaperturate,including,ingle,largest,lighter,lon,long,loose,lower,mostly,mout,near,new,newer,next,oblong-lanceolate,older,open,opening,orphologically,pedicel,petal,plurifoliat,pollen,poricidal,porrect-stellate,prickle,prickly,producing,proportion,ra,red-tinged,remaining,resprout,retained,rickle,ruit,ruiting,scarcely-rooted,scattered,seaso,shed,shor,side,small,solitary,somewhat,sparsely,splitting,stalked,stamen,staminate,stellate-funnelform,stigmatic,stolon,straight,successively,surrounding,suture,taminate,tapered,tem,tending,throughout,time,toward,type,unarme,underground,unequal,unit,verall,vestigial,wide,widened,without,woody,ympodial,–	-,1-1.5,1.2-1.5,1.5-2,2-5,4-5,4-9,5-10,9-12,branching,color,dioecious,form,height,history,lateral,leaf,life,midpoint,midrib,midvein,na,pubescence,ray,reproduction,seed,shape,size,stellae,stipe,texture,tube,vein,width
215	wfo-0001027284	success	172	119	91	81	28	0.529	.3,0.7–0.9,0.7–1,1.2–1.5,1.5–2,1.5–2.5,1.5–8,1.8–2,1–1.5,1–2,1–3,2.5–3,2.5–3.5,2–16,2–2.2,3.5–14,3–4,4,4–6,abaxially,acuminate,acute,adaxially,anther,anthesi,apex,base,branched,brownish,calyx,cm,cordate,cylindrical,deflected,diameter,elliptic,entire,filament,fine,flattened-reniform,flower,fruit,glabrous,globose,green,inflorescence,lobe,long,margin,maturity,midvein,minutely,mm,near,nearly,oblique,one,orangish,ovate,ovoid,pale,petiole,planar,pubescence,pubescent,rarely,reticulate-rugulose,rounded,scandent,shortly,shrub,side,size,sometimes,soon,sparsely,stellate,stigma,style,surface,tan,time,tip,truncate,tube,unbranched,vein,vine,white,wide,x	0.1–0.5,0.1–2,0.2–,1.5–5.5,4–12,5-merous,5–7,5–8,9–18,accrescent,alyx,axe,axillary,berry,blade,branch,c.,capitat,ciliat,climbing,conspicuous,contiguousl,deltoid,densely,distally,eaf,eed,enlarged,extra-axillary,flattened,fleshy,fruiting,glabrescen,glabrou,gradually,herbaceous,immature,leafy,lower,m.,nflorescence,nternode,orolla,pair,pedicel,peduncle,pendulou,perfec,pink,pinnate,plurifoliate,pointed,prominent,rachi,reduced,ruit,sand-punctat,sand-punctate,scar,secondary,seen,simple,slightly,somewhat,spaced,spreading,stem-terminal,tamen,tem,thickened,thickly,toward,tree,understory,unifoliat,unit,vary,venation,weakly,woody,ympodial	0.2–1.5,branching,color,corolla,form,glabrescent,growth,height,history,lateral,leaf,length,life,midpoint,midrib,na,ovary,plant,ray,reproduction,seed,shape,staman,stellae,stem,stipe,texture,width
216	wfo-0001027289	success	194	115	89	105	26	0.459	%,0-0.7,0.25-0.7,0.3-1,0.5-1.4,0.8-2.6,1-2,1-5,1.4-1.8,1.5-3.5,10-16,10.5-12.5,12-17,16-35,2.5-2.8,3.5-5,3.5-7.5,4-7,5.5-7.5,6-9,7-10,acute,anther,apex,bark,base,black,broadly,brown,calyx,chartaceous,circular,cm,cordate,cylindrical,deltate,densely,diameter,entire,flower,fruit,furrowed,glabrous,gland-tipped,globose,green,hair,inflorescence,lamina,lateral,length,lobe,lobed,long,longer,margin,midpoint,mm,obtuse,ovate,perennial,petiole,pink,plant,prickle,pseudo-racemose,purple,ray,rhizomatous,rusty,shallowly,short,shrub,solitary,stalk,stellae,stellate,stellate-pubescent,straight,style,time,tube,unbranched,white,wide,x,yellow,yellowish,yellowish-green	.05,0-1,0-3,0.05-0.1,0.3-0.9,0.4-0.8,0.5-0.7,1,1.1-1.5,1.2-2.5,1.3-1.5,1.5-2,1.5-2.3,2-foliate,2.4-3,30-160,4-11,4-locular,5-merou,6-8,7-13,7-8,abaxially,absen,absent,accrescent,acicular,across,adaxiall,adaxially,alyx,andromonoecious,apart,articulated,ascending,axe,ba,blade,connivent,cork,cross-section,directed,distall,distally,distributed,dm,eaf,eed,eglandular,elliptica,erect,exocarp,finger,fruiting,functional,geminate,glabrou,grey,half,heterostylous,juicy,lanceolate,leaf-opposed,less,lower,markedly,mature,mesocarp,mid-point,minute,moist,nflorescence,oblique,orolla,part,pedicel,peduncle,per,placenta,pore,porrect,present,probably,ruit,simple,spaced,stage,stalked,strongly,tal,tamen,tem,thick,thicker,thicknes,throughout,transparent,unarme,unarmed,unit,unknow,uvenile,vary,weakly,ympodial	abaxial,adaxial,branching,color,corky,corolla,elliptical,filament,form,growth,height,history,leaf,life,na,ovary,pubescence,reproduction,seed,shape,size,staman,stem,surface,texture,width
217	wfo-0001027290	success	165	83	56	109	27	0.339	.8,0.3-0.5,0.9-1.2,1.1-4.4,1.4-1.6,1.5-2,2.8-5.5,3-5,3.5-5,5-9.5,8-10,anther,attenuate,broadly,calyx,chartaceous,cm,cylindrical,densely,diameter,erect,flower,fruit,glabrous,gland-tipped,globose,green,grey-green,hair,inflorescence,length,lobe,lobed,mm,moist,ovate,perennial,petiole,pseudo-racemose,purple,rhizomatous,rusty,shallowly,short,shrub,sparsely,stellae,stellate-pubescent,straight,style,tube,unbranched,unknown,x,yellow,yellowish-green	%,0-0.7,0-1,0-2.5,0-3,0.05-0.25,0.1-0.9,0.2-0.4,0.7-0.9,0.7-1.2,0.8-1.2,1-1.7,1-2,1-5,1.5-1.8,1.6-1.8,11-15,180-420,2-11,2-6,20-45,3-35,3-6,4-6,5-20,5-merou,50-70,6-8,7-8,8-9,abaxially,absent,acicular,across,adaxiall,adaxially,alyx,apart,apex,armed,articulated,ascending,axe,ba,base,blade,cordate,d.,directed,distall,distributed,eaf,eed,eglandular,entire,extra-axillary,finger,fruiting,functional,half,juic,lamina,lateral,lon,long,longer,lower,margin,mature,mesocarp,mid-point,midpoint,midvein,minute,nflorescence,oblique,obtuse,onl,orolla,part,pedicel,peduncle,per,pore,porrect,presen,present,prickle,ray,ruit,simple,spaced,stage,stalk,tal,tamen,tem,thick,throughout,time,unit,unknow,uvenile,vary,vein,white,wide,yellowish,ympodial	abaxial,adaxial,branching,color,colour,corolla,filament,form,growth,height,history,juicy,leaf,life,na,ovary,plant,pubescence,reproduction,shape,size,staman,stem,stigma,surface,texture,tip
218	wfo-0001027299	success	237	120	78	159	42	0.329	2.7,25-30,5.2,6,abaxially,acuminate,anther,apex,asymmetric,base,branch,broadly,calyx,cm,cordate,deltate,dense,diameter,distally,entire,filament,flower,fruit,glabrous,globose,hirsute,inflorescence,lanceolate,lateral,leaf,length,lenticular,lobe,margin,midpoint,midvein,minutely,mm,obtuse,ovate,pentagonal,petiole,pitted,plump,prickly,pubescence,pubescent,purplish,racemose,ray,reniform,repand,rotate,short-stalked,shrub,stalked,stellae,stellate,stellate-pubescent,stellate-tomentose,stem,stigma,style,surface,tan,thick-textured,truncate,tube,ultimate,undulate,usually,vein,violet,weakly,woolly,yellow,young,×	.5,0.2–3,0.3–0.8,0.5–1.5,0.8–1,0.8–1.2,0–10,1.2–1.5,1.3–1.7,1.5,1.5–3,1.5–4,11–17,15,15–19,1–2,1–3.5,1–4,2.5–4,2.5–5,2–13,2–2.7,3–3.5,4.5–13,4–10,5,5-merou,5–10,5–12,6–10,6–8,6–9,7–11,7–9,8–13,8–20,9–25,abaxial,accrescent,acicular,adaxially,along,alyx,apart,apiculate,apparently,appearing,articulated,ascending,axe,barely,becoming,blade,branched,bristle,bristle-like,c.,campanulate,cauline,common,composed,conduplicate,contiguous,coriaceous,deciduou,delicate,deltoid,densely,densest,developed,directed,distall,eaf,eed,elongating,equalling,erect,erry,exceeding,expanded,falcate,filiform,fruiting,geminat,glabrou,hair,initially,intense,intergrading,internode,intervening,interwoven,like,linear,long,long-stalked,lower,maturit,midzone,mixed,narrowly,nearly,nflorescence,often,one,orange,orolla,overtopped,ovoid,pedicel,peduncle,perfect,plurifoliate,pore,prickle,principal,rachise,rarely,reaching,ripe,secondary,short,shorter,side,similar,simple,slender,slightly,smaller,sometimes,somewhat,some­what,soon,spaced,sparse,spreading,spreadingly,stalk,stipitate-stellate,straight,styl,sun,tall,tamen,tapering,tardily,tem,terminal,tippe,ud,unarme,unarmed,vary,varying,well,wooll,ympodia,–7,–9	0.5-1.5,0.8-1,1.2-1.5,1.3-1.7,1.5-3,1.5-4,2-2.7,2.5-4,2.5-5,3-3.5,4.5-13,5-12,6-10,7-11,7-9,8-13,8-20,9,9-25,branching,color,corolla,form,growth,height,history,life,maturity,midrib,na,ovary,perennial,plant,reproduction,seed,shape,size,staman,stipe,texture,tip,width
219	wfo-0001027302	success	188	118	95	93	23	0.505	0.4-5,0.5-1,0.6-1,0.8-1,1-1.5,1-3,1.2-2.5,1.5-2,10,10-20,2,2-3,2-6,2.2,2.7-7.5,3.5-5,3/4,5-7,6-12,7,7/8,acuminate,acute,along,anther,anthesi,apex,base,branching,bright,brownish-yellow,calyx,cm,cordate,corolla,crispate,dendritic,densely,diameter,entire,filament,flat-topped,flattened,flower,glabrous,globose,growth,lateral,leaf,length,lenticular,lobe,lobed,main,margin,minutely,mm,narrowly,ovary,ovate,pair,pale,pericarp,petiole,pitted,planar,plant,puberulent,pubescent,pyramidal,red,reddish-brown,reflexed,scattered,shrub,simple,small,somewhat,stem,stigma,style,surface,thin,time,tiny,tip,tree,trichome,truncate,tube,undulate,vein,violet,way,x	.5,0.5,1,1-1.3,1-2,1.2-1.6,abaxial,abaxially,adaxial,adaxially,age,apical,appearing,ba,bark,basal,becoming,berry,blade,broader,capitate,clavate,conical,cultivation,decurrent,deflexed,deltoid,denser,dichasia,discussion,eaf,edicel,eed,elliptic,especially,ew,exserted,fine,free,fruiting,growing,inserted,juvenile,larger,later,lax,less,like,lon,long,long-triangular,lower,m.,monochasial,nflorescence,nodding,occasionally,older,otherwise,overtopping,papillo,pedicle,per,plurifoliate,pore,poridical,portion,prominent,ruit,scar,scrambling,secondary,see,shade,shin,shoot,sleeve,slit-like,sparsely,stamen,strongly,tall,tapering,terminal,tub,ud,unit,usually,wide,winged,woody,ympodial,young	color,form,fruit,height,history,inflorescence,life,midpoint,midrib,midvein,na,perennial,pubescence,ray,reproduction,seed,shape,size,staman,stellae,stipe,texture,width
220	wfo-0001027310	success	215	120	96	119	24	0.447	-2.2,-20,/3,0.05-0.15,0.6-1,0.7-2,0.9-0.17,1-1.2,1-6,1.1-1.5,11-16,2-3.1,2-4,2.2-2.5,2.8-3,4-9,4.5-5.5,5-20,5-7,6-8,9-13,abaxially,acute,andromonoecious,anther,apex,apically,base,branched,branching,calyx,chartaceous,cm,cuneate,deltate,densely,diameter,entire,evenly,filament,flattened-reniform,flower,fruit,glabrous,glaucous,green,hair,lanceolate,lateral,leaf,length,lobe,lobed,long,longer,margin,maturity,mauve,midpoint,minutely,mm,moderately,orange-brown,petiole,pitted,plant,primary,purple,ray,reflexed,rounded,secondary,shallowly,shrub,simple,smooth,sometimes,sparse,spherical,spreading,stellate,stellate-pubescent,stem,style,surface,time,tip,toward,tree,truncate,tube,vein,way,wide,yellow,young	.8,0,0-20,0-5,0.05,0.1,0.1-0.2,0.15-0.3,1-1.7,1.5-2.2,1.5-5,1/10-1/6,1/3-1/2,1/3-3/4,2-10,2-5,2/3,20-60,22-30,3-15,4-10,4.5-7,5-10,5-merous,7-10,8-10,abaxial,acut,adaxial,alyx,apar,apart,apparently,articulated,bark,berry,blade,broadly,connivent,curved,dark,discolorous,distal,drying,eaf,eed,elongating,equal,erect,faint,flattened,foliaceous,free,fruiting,fused,gently,glabrescent,glabrou,gray,green-brown,hermaphrodite,heterostylous,inflated,infructescence,less,long-styled,lower,lowermost,mature,nflorescence,older,one,open,orolla,oung,pair,pale,pedicel,peduncle,pendulous,per,pericarp,plurifoliat,poricidal,porrect,porrect-lepidote,portion,prickle,prickly,pubescent,red,reddi,ruit,scar,sessile,short-styled,shorter,spaced,sparsely,stalk,stalked,staminat,stout,straight,strongly,tamen,tapering,terete,terminal,tertiary,trichome,unarme,unarmed,unit,vary,venation,visible,woody,ympodial	color,corolla,form,growth,height,history,inflorescence,life,midrib,midvein,na,ovary,perennial,pubescence,reproduction,seed,shape,size,staman,stellae,stigma,stipe,texture,width
221	wfo-0001027313	success	173	125	101	72	24	0.584	.5,.7,0.15,0.1–0.3,0.5–0.6,1.2–1.3,1.2–1.4,1.5,1–2,1–4,2–3-branched,3–4,3–5.5,3–9,4,4.5–5,5,5.5–16,5.5–7,50,5–6,abaxially,acute,adaxially,anther,apex,apparently,atenuate,base,cm,cordate,dbh,densely,diameter,dull,entire,filament,finely,flower,fruit,glabrous,globose,green,hair,half,high,interpetalar,irregularly,lanceolate,lateral,leaf,little,lobe,long,loosely,lower,margin,maturing,midvein,minutely,mm,obtuse,ovate,persistently,petiole,pitted,purplish,shrub,side,sinuate,small,sparse,stellae,stellate,stellate-pubescent,stellate-tomentose,stem,stigma,style,surface,thick-chartaceous,time,tissue,tomentose,tree,tube,unarmed,undulate,usually,vein,vigorous,violet,weak,whitish,whitish-tomentose,wide,yellow,yellowish,×,–12,–3	0.8–1,1.5–2,1–1.3,2–4.5,2–8.5,3–3.5,5-merou,6–11,6–8,adaxiall,along,alyx,apar,apical,articulated,attenuate,axe,blade,branch,branched,broadbased,capitat,difoliate,directed,distall,eaf,eed,filiform,geminat,homostylous,immature,internode,like,lon,midpoint,minute,much,narrowly,nearly,nflorescence,orolla,ovoid,pedicel,peduncle,perfect,pore,porrect,prickle,principal,rarely,ray,ruit,scar,sessile-stellate,short-stalked,short-stipitate,shorter,similar,simple,sinus,slender,sometimes,splitting,stalk,stellate-tomento,tamen,tem,triangular,ud,unarme,vary,ympodia	branching,calyx,color,corolla,form,growth,height,history,inflorescence,length,life,midrib,na,ovary,plant,pubescence,reproduction,seed,shape,size,staman,texture,tip,width
222	wfo-0001027315	success	217	93	74	143	19	0.341	.5,.9,0.3-1,0.4-0.7,0.6-0.8,1.3-3,10-20,2,2-2.5,2-5,2-7.5,2/3,3,3-7,acute,anther,apex,base,blue-green,brown,calyx,cm,corolla,deltate,densely,diameter,dioecious,elliptic,entire,filament,flattened,flower,glabrous,globose,growth,inflorescence,length,lobe,lobed,margin,midrib,mm,oblique,ovary,paler,pentagonal,petiole,plant,prominent,pubescent,purple,ray,reddish,reniform,ripe,shiny,shrub,simple,somewhat,stellate,stem,stigma,style,surface,thin,tip,trichome,tube,way,white,x,yellowish,young,½	.15,.5x,0.15-0.2,0.2,0.2-0.5,0.25-0.4,0.3-0.5,0.3-0.6,0.5,0.6-0.6,0.6-0.7,0365,1-1.3,1-1.5,1-2,1.5-1.7,1.5-2,1.5-3,3-3.5,3-5,5-7,8,<,?,abaxially,adaxially,age,almost,along,anthesi,arching,armed,articulated,bark,berry,broad-based,capitate,conical,consisting,correlated,dark,dense,difoliate,discolorous,drying,eaf,echinoid,eed,ekman,ellipsoid,especially,exerted,female,fide,filiform,free,fruiting,fused,geminat,glabrescen,globular,greyish-white,half,hangin,highly,immature,impressed,internodal,lamina,lengthening,lepidote,like,long,lower,male,marginal,markedly,midpoint,minute,minutely,mixture,new,nflorescence,obscuring,occasionally,often,older,overlappin,packed,pair,pale,papillo,pedicel,peduncle,per,pericarp,pistillate,pitted,plan,planar,pore,poricidal,porrect,portion,present,prickle,pricklines,primary,rest,rhachi,rounded,ruit,scar,scattered,sessile,shoot,short,short-stalked,shorter,similar,slit,smaller,solitary,sparse,sparsely,stalked,staminate,stellate-lepidote,straight,strongly,throughout,tightly,ud,unarmed,unisexual,unit,vein,venation,vestigial,visible,without,woody,ympodial	branching,color,form,fruit,height,history,leaf,life,midvein,na,perennial,pubescence,reproduction,seed,shape,size,staman,stellae,texture
223	wfo-0001027317	success	144	93	64	80	29	0.444	0.1-0.2,0.4-1.5,0.5-1,0.8-3.5,1,1-1.5,1-2,2-9,3-3.5,4.5-5,7-9,?,acuminate,acute,adaxially,along,anther,apex,base,calyx,cm,corolla,cucullate,deltoid,densely,dia,elliptic,erect,filament,fruit,glabrous,globose,golden,green,lateral,leaf,like,lobe,lobed,long,margin,minute,mm,nearly,ovary,pair,papillose,pedicel,petiole,pubescent,shrub,simple,size,stem,stigma,style,surface,tip,trichome,tube,uniseriate,vein,white,x	.25,.5,0.3-1,0.5-3,1-5,1.4-1.6,1.5-2,2-3-flowered,abaxial,anthesi,apical,apically,arch,ba,bark,beneath,berry,bilobed,broadly,closely,conical,deciduous,deflexed,differing,difoliate,drying,eaf,edicel,eed,ellipsoid,elongated,expanded,filiform,free,fruiting,geminat,greyish-whit,immature,inflorescenc,joined,known,lon,long-exserted,lower,main,major,mature,minor,minutely,nflorescence,offset,older,opposite,overlappin,pale,papillo,pointed,pore,poricidal,portion,projection,prominent,reflexed,rest,ruit,scar,series,shaped,slightly,soon,spaced,sparsely,strongly,tall,tear-drop,tub,ud,woody,ympodia,young	0.25,2-3,branching,color,diameter,flower,form,growth,height,history,inflorescence,length,life,midpoint,midrib,midvein,na,perennial,plant,pubescence,ray,reproduction,seed,shape,staman,stellae,stipe,texture,width
224	wfo-0001027323	success	175	87	60	115	27	0.343	0.5-1,1-1.5,14-21,2-3,2-6,2.5-3,20-45,3-5,5-20-flowered,5-7,7-9,acute,anther,apex,attenuate,base,calyx,cm,corolla,densely,elliptic,filament,fleshy,flower,fruit,furcate,glabrous,globose,grey,lateral,leaf,lobe,lobed,long-triangular-deltoid,margin,minutely,mm,opposite,ovary,ovoid-reniform,pair,papillose,petiole,pinkish-grey,pitted,plant,red-papillose,reddish-grey,size,stem,stigma,style,surface,tan,tip,treelet,tube,vein,white,x	.75,/3,1-2,1.2-1.5,10-15,6-11,adaxial,along,anthesi,apparent,appearing,area,arising,asymmetric,ba,bark,berry,broadened,bud,campanulate,character,closed,closely,cork,decurrent,deflexed,dia,differing,difoliate,dried,dry,eaf,edicel,eed,elongate,entire,erect,erose,exserted,five-pointed,flopping,free,fruiting,geminat,glabrate,growing,held,higher,hood,hooded,immature,interpetalar,like,live,lon,long,lower,main,major,matte,mature,measured,middle,minor,nflorescence,occasionally,older,one,onto,overlapping,ovoid,papillae,papillo,partially,pedicel,persistent,planar,pore,poricidal,portion,prominent,proximal,rather,rest,ridge,ruit,scar,secondary,seen,shaped,sinus,slightly,small,smoot,soon,spaced,specimen,straight,tall,tear-drop,thickened,thin,tiny,trunk,two,ud,unit,upper,visible,way,widest,winged,woody,ympodial,young	3,5,7,branching,color,diameter,form,growth,height,history,inflorescence,length,life,midpoint,midrib,midvein,na,pubescence,ray,reproduction,seed,shape,staman,stellae,stipe,texture,width
225	wfo-0001027340	success	189	115	89	100	26	0.471	0.5-0.9,1-2,10-16,2-3,2-4,3.5-5,3.5-9,4-7.5,5-11,5-6,6-8.5,7-18,8-14,8-9.5,abaxially,acumen,acuminate,adaxially,anther,apex,apparently,base,brownish,cell,chartaceous,cm,condition,cordate,corolla,covering,diameter,distal,drying,elliptic,filament,flower,forked,fresh,fruit,glabrous,globose,green,greenish,hair,hair-like,half,herb,lanceolate,lateral,like,lilac-purple,lobe,long,margin,membranous,midrib,minutely,mm,odd-pinnate,ovoid,papillose,perfect,petiole,plant,pointed,puberulent,pubescent,purple,rotate,rounded,seed,short,shortly,size,sparsely,splotched,stem,stigma,style,testal,thick,tinged,tip,truncate,tube,wall,whitish,x,yellow	1-10,1-3,1.5-2.7,16-22,2-3.5,2.5-4.5,2.7-4.5,3-4,4-6,5-merou,7-8,abruptly,absent,ag,along,alyx,apart,articulated,articulation,auriculate,axe,axillary,berry,blade,bud,capitat,ciliate,connivent,dark,decreasing,developing,digestion,distinct,dorsally,eaf,edge,eed,enzyme,especially,exceeding,flat,folded,geminat,generally,glabrou,green-white,hal,high,homostylous,honeycomb-shaped,indistinct,interjected,leaflet,lengthening,living,lower,make,minute,mucilaginous,narrow,narrowed,nflorescence,orolla,ovate,pair,pedicel,peduncle,petiolulate,plurifoliate,pore,poricidal,purpl,removed,ripe,ruit,semi-erec,semi-rosette,sessile,seudostipule,slightly,slit,spaced,specimen,stamen,ste,straight,subtending,tall,tamen,tem,terminal,throughout,tri-,unit,usually,vary,wet,wing,ympodial,young	branching,calyx,color,form,growth,height,history,inflorescence,leaf,length,life,midpoint,midvein,na,ovary,perennial,pubescence,ray,reproduction,shape,staman,stellae,stipe,surface,texture,vein
226	wfo-0001027354	success	166	103	80	86	23	0.482	0,0.5-2,1-1.2,1-1.5,1-7,1.5-1.8,1.5-2,1.7-5,10-20,2.5-3.5,3-4,3.4-4,3/4,4-10,5-7,6.5-13,8-12,acute,along,anther,anthesi,apex,base,branching,calyx,cm,corolla,dendritic,densely,diameter,elliptic,entire,filament,flattened,flower,fruit,glabrous,globose,golden,growth,lateral,leaf,length,lenticular,lobe,lobed,minutely,mm,narrowly,occasionally,ovary,pair,pericarp,petiole,pitted,planar,pubescent,purplish-black,pyramidal,reddish-brown,shrub,small,sparsely,stem,stigma,style,surface,thin,time,tiny,tip,tree,tree-like,trichome,tube,vein,violet,way,white,x	.5,0.5,0.7-1.3,1,10,abaxial,abaxially,absent,adaxial,age,apical,appearing,ba,bark,basal,becoming,belo,berry,bi-lobed,blade,branch,conical,covered,dark,deltoid,denser,dichasia,drying,eaf,edicel,eed,erect,ew,exserted,fork,free,fruiting,glabrate,inserted,later,less,like,long,loose,loosely,lower,m.,monochasial,mostly,near,nflorescence,nodding,older,papillo,pedicel,per,plurifoliate,pore,poricidal,portion,pubescen,raised,ruit,scar,secondary,side,simple,sleeve,slightly,slit-like,somewhat,stamen,strongly,tall,tapering,terminal,thecalyx,tub,type,ud,unit,wide,winged,woody,ympodial,young	color,form,height,history,inflorescence,life,margin,midpoint,midrib,midvein,na,plant,pubescence,ray,reproduction,seed,shape,size,staman,stellae,stipe,texture,width
227	wfo-0001027359	success	224	128	102	122	26	0.455	-0.25,-2,.5,/3,0.1-0.2,0.3-1.2,0.5-2,0.6-1,1-1.2,1-2,1.2-1.5,1.5-2.5,1.8-3.2,2-3,2-4,2.5-3.5,2.5-5.5,3-10,4-,5-6.5,6-8,abaxially,acute,anther,apex,apically,base,berry,branched,bright,calyx,cell,chartaceous,cm,cuneate,curved,densely,diameter,dull,entire,erect,filament,flattened-reniform,flower,fruit,glabrescent,glabrous,lateral,leaf,length,lobe,lobed,long,longer,margin,maturity,membranous,minutely,mm,moderately,narrow-deltate,narrow-ovate,near,obtuse,occasional,orange-brown,outline,ovate,pale,petiole,pit,purple,raised,ray,red,reticulate,scandent,shallowly,shrub,simple,slender,small,smooth,sometimes,sparsely,spherical,stellate,stellate-pubescent,stem,style,surface,time,tip,trichome,tube,undulate,vein,way,white,wide,yellow,yellow-brown	-20,-3,-4,-7,-9,.1,.2,/4,0,0-2,0-3,0-5,0-9,0.1,0.1-1.5,0.3-0.5,0.5,0.5-1,0.6-0.8,1-3,1-4,1-5,1.2-2,1.5-2,1/5-1/4,2-10,4-5,5-,5-merous,7-8,acut,alyx,apar,apart,apparently,articulated,ba,bark,blade,brow,concolorous,coroll,cream,dark,deltate,difoliate,distinctive,drying,eaf,eed,elongate,elongating,equal,eye,filiform,flattened,free,fruiting,geminat,gray,green,herbaceous,infructescence,less,like,lower,marking,mature,midpoint,naked,nflorescence,often,older,one,open,orolla,oung,ovoid,pair,pedicel,peduncle,per,perfec,pericarp,poricidal,porrect,portion,prickle,prickly,primary,rachi,rarely,reflexed,ruit,scar,sessile,shorter,slightly,spaced,spreading,stalk,stalked,stump,tamen,tapering,terete,terminal,tertiary,tinge,ud,unarme,unarmed,unit,usually,variously,vary,venation,visible,weakly,woody,ympodial,young	branching,color,corolla,form,growth,height,history,inflorescence,life,midrib,midvein,na,ovary,perennial,plant,pubescence,reproduction,seed,shape,size,staman,stellae,stigma,stipe,texture,width
228	wfo-0001027365	success	233	112	90	143	22	0.386	.5,0,0.2–0.5,1.1–1.4,1.5–1.8,14–15,15–30,1–1.9,2,2.5–4.5,2.6–3,2.8,3,3–10,4.5–5,4–5,7–15,8–15,abaxial,adaxial,andromonoecious,anther,apparently,blue,branched,broadly,brown,calyx,capitate,chartaceous,cm,cylindrical,dark,densely,diameter,elliptic,extraaxillary,filament,flower,fruit,glabrous,globose,golden-tan,green,inflorescence,interpetalar,juicy,lanceolate,leaf,length,light,lighter,lobe,long,mm,moderate,moderately,mostly,nearly,obtuse,orange,outline,petiole,plant,pubescent,reniform,rotate-stellate,rugose,shiny,slightly,somewhat,sparsely,stellate,stem,stigma,style,subcoriaceous,surface,tan,time,tissue,tree,truncate,tube,unbranched,violet,wide,yellow,×,–20	.1,.1–0.3,.2,0.1–0.3,0–0.03,0–0.1,1,10–15,11–14,1–4,2.2–2.3,2.3–4.2,2–,2–5,3–3.5,3–3.9,4–4.5,5-merous,5–5.5,5–8,6–7.5,7–1,8–9,abaxially,absent,acuminate,acute,adaxially,ag,along,alyx,andromonoeciou,anthesi,apart,apex,articulated,axe,ba,bark,base,becoming,berry,bilobe,blade,broad-based,central,column,congested,connivent,cuneate,curved,db,difoliate,directed,discolorous,distally,dried,eaf,eed,eglandular,either,emergent,entire,equal,flattened,flowering,free,fresh,frui,fruiting,functionally,geminat,glandular,hair,half,hermaphroditic,heterstylous,included,inflated,knobby,like,lobed,longitudinal,lower,major,margin,maturity,membranaceous,midpoint,midvein,mpodial,multangulate,multangulate-stellate,multiseriate,multiseriate-stalked,nflorescence,oblique,often,one,opening,orolla,part,pedicel,peduncle,pericarp,pore,porrect-stellate,portion,prickle,pronounced,rachi,ray,reduced-stellate,reflexed,repand,ruit,runk,sessile,shallowly,sharp,short-stalked,side,simple,slit,spaced,stalk,stalked,staminate,stellate-pubescent,stout,straight,strongly,subtending,tamen,tapered,thi,unarmed,unit,vary,vein,within,young,–2	bilobed,branching,color,corolla,dbh,form,growth,height,history,life,midrib,ovary,perennial,pubescence,reproduction,seed,shape,size,staman,texture,tip,width
229	wfo-0001027366	success	136	76	54	82	22	0.397	/4,0.5-1,0.7-1,1-1.5,1-3,11-21,2-2.5,4-4.5,4-5,6-19,abaxially,adaxially,anther,base,bright,broadly,brown,calyx,cm,corolla,dark,dia,drying,elliptic,filament,glabrous,globose,golden,green,greenish-white,leaf,lobe,lobed,long,minutely,mm,orbicular,ovary,ovoid-reniform,pale,papillose,pitted,shining,shrub,simple,somewhat,stem,stigma,style,surface,tip,tube,way,wide	.5,/2,0.25-0.5,1-2,1.5-2,3-10-flowered,3-9,5-7,603,acute,anthesi,ape,apex,axe,ba,bark,berry,capitate,closely,conical,conspicuously,deflexed,deltate,eaf,edicel,eed,erect,et,except,exserted,fide,free,fruiting,internodal,lamina,lateral,less,lon,long-triangular,lower,main,margin,middle,nflorescence,older,opposite,overlappin,ovoid,packed,pair,papillo,parallel,pedicel,petiole,planar,pointed,pore,poridical,portion,ramo,reddish,rounded,ruit,scar,secondary,shaped,sometimes,straight,tall,tear-drop,trichome,tub,ud,unifoliat,unit,vein,venation,widest,woody,yellowish-gre,ympodial,young	branching,color,diameter,form,fruit,growth,height,history,inflorescence,length,life,na,perennial,plant,pubescence,reproduction,seed,shape,size,staman,texture,yellowish-grey
230	wfo-0001027368	success	145	105	71	74	34	0.49	-5,.5,0.3-2.5,0.5-3.5,0.5-5,0.8-2,1-2,1-6,1.5-2,1.5-2.5,2,2-2.5,2-9,3-12.5,4-6,5-6,abaxially,acuminate,acute,adaxially,apex,base,calyx,chartaceous,cm,color,cuneate,decurrent,densely,diameter,ellipsiodal,elliptic,elliptic-ovate,entire,forked,glabrous,globose,lanceolate,lenticular,lobe,margin,midvein,mm,moderately,narrowly,nearly,occasionally,otherwise,ovoid-fusiform,petiole,puberulent,pubescent,purple,ray,shrub,small,sparsely,stellate,stigma,style,subcoriaceous,subhastate,tip,triangular,tube,unbranched,unknown,vein,white,x,yellow	-10,-15,-2,-20,1-15-flower,2-3,2-4,3,4-many-foliat,5-10,5-15,8-13,abruptly,absen,adaxiall,aggregate,also,apart,articulated,axe,ba,blade,branched,cell,connivent,contiguous,cylindrical,darker,deltate,dendritically,denser,directed,distally,eaf,eed,except,gland,hair,lighter,long,long-stalked,lower,narrowed,nflorescence,nther,oblong,obtuse,often,orolla,pedicel,peduncle,pore,pubescen,rachi,radiu,ruit,simple,sometimes,spaced,stalked,star,stone,subcapitat,tal,tem,terminal,three,time,truncate,unit,usually,vary,wide,ympodial	1-15,anther,branching,corolla,filament,flower,form,fruit,growth,height,history,inflorescence,lateral,leaf,length,life,midpoint,midrib,na,ovary,perennial,plant,pubescence,reproduction,seed,shape,size,staman,stellae,stem,stipe,surface,texture,width
231	wfo-0001027369	success	191	89	63	128	26	0.33	-11,.5,.7,0.1,0.25-0.4,0.5-0.8,0.6-0.8,1-2.5,1.2-2.5,1.2-3,2-4,2-5,3-4,4-8,abaxially,almost,anther,apex,apically,base,branched,calyx,cm,color,cordate,deltate,densely,diameter,filament,flower,fruit,glabrous,lateral,leaf,length,lobe,lobed,long,margin,mauve,membranous,midvein,mm,moderately,orbicular,pale,petiole,ray,reniform,rounded,shrub,smooth,sparsely,spherical,stellate-pubescent,stem,style,surface,terminal,tip,tube,wide,yellow	-1,-10,-2,.1,.4,/4,0,0-1,0-15,0-3,0-5,0-6,0.05-0.15,0.1-0.2,0.1-0.3,0.2-0.5,0.3-1.5,0.5,0.5-1.5,1-,1-2,1-3,1-4,1.5-2,1/3,2-3,3,3-10,4-5,5,5-merous,7-15,acut,alyx,ame,apar,apart,apparently,articulated,bark,berry,blade,broad-deltate,c.,concolorous,curved,difoliate,distance,drying,eaf,eed,elongating,equal,erect,extending,eye,filiform,free,fruiting,geminat,glabrou,glaucous,gra,green,hair,herbaceous,infructescence,know,known,lanceolate,less,lon,lower,mature,midpoint,multangulate,naked,narrowly,nflorescence,older,one,open,orolla,oung,pedicel,peduncle,pendulous,per,perfec,pericarp,perpendicular,poricidal,porrect,portion,prickl,prickle,prickly,reflexed,ruit,scandent,scar,sessile,side,simple,slender,slightly,spaced,spreading,stalk,stalked,stellate,straight,strongly,tamen,tapering,terete,time,trichome,unarmed,unequal,unit,vary,venation,visible,way,wider,winged,ympodial	acute,branching,corolla,form,growth,height,history,inflorescence,life,midrib,na,ovary,perennial,plant,pubescence,reproduction,seed,shape,size,staman,stellae,stigma,stipe,texture,vein,width
232	wfo-0001027378	success	149	100	82	67	18	0.55	.2,0.5–1,0.7–1,1.2–1.5,1.2–1.8,1.5–1.8,1.5–8,1–1.5,1–3,2–11,2–2.2,2–2.5,3–4.5,3–5,3–6,4–6,5–13,abaxially,acuminate,acute,adaxially,anther,apex,base,blue,broadly,calyx,chartaceous,cm,color,cordate,deeply,diameter,filament,fleshy,flower,fruit,glabrous,hair-tipped,half,herbaceous,lanceolate,leaf,light,lobe,long,lower,margin,minutely,mm,moderately,obscure,often,ovate,ovoid,papillose,pentagonal,petiole,pubescent,revolute,rotate-stellate,rounded,slender,small,somewhat,spaced,sparsely,stem,stigma,style,terrestrial,tip,tooth,trichome,tube,unbranched,unknown,vein,vine,white,widely,x	0.8–2.5,15–35,2.3–5,2.5–7,4–9,5-8,5-merous,5–10,5–7,6–10,6–7,adaxial,alyx,apar,apicall,axe,berry,blade,c.,capitat,ciliate,clavate,climbin,cylindrical,deltoid,densely,eaf,eed,extra-axillary,flattened,fruiting,glabrou,hair,like,lon,longer,m.,markedly,membranous,narrowly,nflorescence,nternode,orolla,palmate,pedicel,peduncle,perfec,plurifoliat,pointed,primary,rachi,ruit,sand-punctat,sand-punctate,scattered,short,side,simple,slightly,tamen,tem,unit,unknow,vary,venation,wide,ympodial	capitate,climbing,corolla,form,growth,history,inflorescence,length,life,midvein,ovary,pubescence,seed,shape,size,staman,surface,texture
233	wfo-0001027378	success	141	108	84	57	24	0.596	.2,0.7-1,1-1.5,1-3,1.2-1.5,1.5-1.8,1.5-8,2-11,2-2.2,2-4,3-4.5,3-5,3-6,4-6,5-13,abaxially,acuminate,acute,adaxially,anther,apex,base,blade,blue,broadly,calyx,chartaceous,clavate,climbing,cm,cordate,cylindrical,deeply,deltoid,densely,diameter,filament,fleshy,flower,fruit,glabrous,hair,hair-tipped,herb,lanceolate,leaf,light,lobe,margin,minutely,mm,moderately,multicellular,narrowly,node,obscure,often,ovate,petiole,pubescent,revolute,rooting,rotate-pentagonal,rounded,scattered,short,simple,small,somewhat,spaced,sparsely,stigma,style,terrestrial,tip,tooth,trailing,tube,unbranched,vein,white,widely,x,yellow	0.8-2.5,15-35,2.3-5,2.5-7,4-9,5-8,5-merou,6-10,6-7,ag,alyx,apart,apicall,apparently,articulated,axe,ba,basally,capitat,ciliate,connivent,directed,distally,eaf,eed,equal,extra-axillary,fruiting,geminat,large,long,longer,longitudinal,lower,nflorescence,oblong,opening,orolla,pedicel,peduncle,perfect,plurifoliate,pore,pubescen,rachi,slender,slightly,slit,tamen,tem,unit,unknow,unknown,vary,weakly,wide,ympodial	branching,color,corolla,form,growth,height,history,inflorescence,length,life,midrib,na,ovary,plant,pubescence,reproduction,seed,shape,size,staman,stem,surface,texture,width
234	wfo-0001027380	success	134	102	69	65	33	0.515	.5,1-1.5,11-17,2-3,2.5-3,3-4,4-6.5,5-8,5-merous,9-10,?,abaxially,acuminate,adaxially,anther,apex,apparently,base,broadly,calyx,chartaceous,cm,conical,deeply,diameter,entire,erect,filament,flattened,flower,forked,fruit,glabrous,globose,greenish-brown,hair,homostylous,leaf,len,lobe,long,margin,minute,minutely,mm,oblique,orange-red,ovate-lanceolate,pair,perfect,petiole,pubescent,red,reticulate,rounded,shrub,small,sparsely,stellate,stem,stigma,style,tree,triangular,unbranched,vein,visible,white,x	0,1136.,2-3.5,30-35,5,accrescen,adaxiall,almost,alyx,armed,articulated,axe,ba,bark,berry,blade,brown,capitat,developed,distally,drying,eaf,eed,extra-axillary,fruiting,geminate,hartley,hooked,lon,loose,lower,mpodial,nflorescence,occasionally,open,orolla,oung,paler,pedicel,peduncle,perfec,prickle,primary,rachi,rip,ruit,scarcely,scattered,scramblin,shallow,simple,slender,slightly,smooth,somewhat,sparse,structure,tall,tamen,testa,thickening,truncate,unarmed,unknown,vary	branching,capitate,color,corolla,form,growth,height,history,inflorescence,lateral,length,life,midpoint,midrib,midvein,na,ovary,plant,pubescence,ray,reproduction,ripe,seed,shape,size,staman,stellae,stipe,surface,texture,tip,tube,width
235	wfo-0001027381	success	262	83	70	192	13	0.267	.8,0-1,0-1.5,0.5-0.6,0.5-1,0.6-0.7,1.5-4,2-6,3-4,3-7.5,3.5-4,4-5,5-11,almost,anther,apex,apparently,berry,blackish,brown,calyx,capitate,chartaceous,clavate,cm,cream,dark,densely,diameter,drying,dull,elliptic,erect,filament,filiform,fruit,glabrous,globose,green,lateral,leaf,length,lobed,longer,marking,maturity,mauve,mm,obconical,orange,ovate,pale,pedicel,peduncle,plant,rachi,shrub,side,simple,size,stellate-pubescent,stem,stigma,style,time,white,wide,x,yellow,young	.3,.4,/5,0.1,0.2,0.3-0.5,0.4-0.6,0.5,0.5-0.7,0°,1-1.5,1-2,1-2.5,1/3-1/2,1/4-1/3,2,2-2.5,2-3,2-4,3-5,4-8,5-8,5-merou,7-8,8-10,abaxially,absent,accrescent,acute,adaxially,age,along,alyx,angle,apically,area,articulated,attachment,bark,base,blade,branch,branched,clearly,concolorous,cordate,covering,curved,delineated,deltoid,density,difoliate,dilated,distance,distributed,divided,eaf,eed,ellipsoi,elongated,elongating,epidermi,equal,even,evenly,exserted,extending,eye,faint,fertile,flat,flattened,flower,free,fruiting,geminat,gland,grey,greyi,higher,inconspicuous,indumentum,infructescence,irregula,known,lamina,lanceolate,lengthening,less,light,like,lobe,long,long-deltoid,longitudinal,lower,main,margin,mature,midpoint,midvein,minute,mostly,naked,never,nflorescence,oblique,oblong,obscuring,obtuse,often,orange-green,orolla,pair,papillose,part,pendulous,per,perfect,pericarp,petiole,point,pore,poricidal,porrect,portion,present,prickle,primary,prominently,protruding,puffy,raised,rarely,ray,reduced,region,rest,right,rounded,ruit,scar,sessile,shallow,shiny,sinus,slender,slightly,slit,small,smoot,smooth,sometimes,sparse,sparsely,spreading,stalk,stellate,straight,striate,stump,surface,surrounded,tamen,tapering,terminal,tertiary,thin,tip,tissue,translucent,trichome,truncate,tube,ud,unarme,unarmed,unit,usually,variable,variously,vary,vein,venation,visibl,visible,widening,without,woody,yellow-green,yellowish,ympodial	branching,color,corolla,form,growth,height,inflorescence,ovary,pubescence,shape,staman,texture,width
236	wfo-0001027384	success	155	93	64	91	29	0.413	0.4-1.1,0.5-1,1-1.3,1-3,1-4,1.5-2,2.5-6.5,3-3.5,3-4,3/4,4-7,5-15-flowered,5-5.5,7-14,7.5-8,acute,anther,anthesi,apex,base,brown,calyx,cm,corolla,cuneate,dia,filament,flattened-reniform,glabrous,globose,green,hard,lateral,leaf,lobe,lobed,margin,minutely,mm,narrowly,obovate,ovary,pair,papillose,petiole,pitted,planar,rounded,shrub,simple,small,stem,stigma,straight,style,sulcate,surface,tip,tree,tube,vein,way,white,x	.25,.5,.75,/3,0.9-1,1-1.5,abov,anothe,apart,ba,bark,beginning,beneath,berry,breaking,broadly,bud,capitate,clavate,closely,deep,difoliate,distal,drying,eaf,edicel,eed,ellipsoid,equal,erect,free,fruiting,geminate,herbarium,incrassate,inflorescenc,later,long,long-exserted,lower,main,member,middle,mustard,nflorescence,occasionally,older,opposite,overlapping,pale,paler,papillo,pedicel,peeling,pore,poricidal,portion,prominent,pseudo-terminal,rarely,reddish-purple,ruit,scar,section,shaped,shining,siz,slender,spaced,specimen,subcoriaceous-fleshy,tall,tapering,tear-drop,thick,transverse,triangular,trichome,tub,tuft,ud,uniseriate,unit,widely,widest,without,woody,yellow,yellowish,ympodial,young	branching,color,diameter,flower,form,fruit,growth,height,history,inflorescence,length,life,midpoint,midrib,midvein,na,perennial,plant,pubescence,ray,reproduction,seed,shape,size,staman,stellae,stipe,texture,width
237	wfo-0001027389	success	154	95	67	87	28	0.435	.5,0.25-0.3,0.25-0.5,0.5-1.5,1-1.5,11-14,2-2.5,3-3.5,3-4.5,4-5-flowered,5-7,7-8,acuminate,acute,along,anther,apex,base,beneath,brown,calyx,cm,corolla,dark,deltoid,dia,dry,elliptic,filament,glabrous,globose,green,hispidulous,inflorescence,lateral,leaf,lobe,lobed,margin,material,minutely,mm,nearly,occasionally,ovary,ovate,ovoid-reniform,pair,paler,papillose,petiole,pitted,puberulent,shrub,simple,sparsely,stem,stigma,style,surface,thread-like,tip,truncate,tube,vein,white,x	.1,.25,0.5-0.75,0.6-1,1,1-2,1.8-1.9,anthesi,apart,ba,bark,berry,broadening,broadly,bud,conical,decurrent,deflexed,eaf,edicel,eed,ellipsoid,erect,evenly,except,expanded,exserted,filiform,foetid,foliage,free,fruiting,geminate,like,lon,long,lower,main,making,middle,nflorescence,node,non-reproductive,obovoi,often,older,one,opposite,papillo,pedicel,pore,poricidal,portion,prominent,prominently,proximal,raise,raised,reddish-golden,reflexed,rest,ruit,scar,shaped,shin,side,slender,slight,slightly,soon,spaced,straight,tall,tapering,tear-drop,top,trichome,ud,unifoliat,uniseriate,unit,widest,winged,woody,yellowish,ympodial,young	branching,color,diameter,flower,form,fruit,growth,height,history,length,life,midpoint,midrib,midvein,na,perennial,plant,pubescence,ray,reproduction,seed,shape,size,staman,stellae,stipe,texture,width
238	wfo-0001027395	success	153	103	76	77	27	0.497	.25,.5,0.25-0.5,1-1.5,1-2,1-5,1.5-1.9,1.5-2.5,10-20-flowered,11-15,12.5-17.3,2-3,3.5-4,5-6.5,8,acute,anther,anthesi,apex,apiculate,attenuate,base,beneath,black,calyx,cm,conical,corolla,decurrent,densely,dia,filament,fruit,glabrous,globose,green,immature,lateral,leaf,lobe,lobed,long,margin,midrib,minutely,mm,narrowly,nearly,obovate,occasionally,once-furcate,ovary,pair,papillose,petiole,planar,primary,pubescent,rusty-papillate,secondary,shiny,shrub,simple,size,stem,stigma,style,tip,trichome,tube,uniseriate,vein,white,within,without,x	0.6-1.1,0.75-1,1.1-1.5,1.6-2.9,2.2-7,4-6,apically,bark,becoming,beginning,berry,caly,capitate,closely,constricted,cucullate,deflexed,deltoid,depressed,differing,difoliate,drying,eaf,edicel,eed,enlarging,erect,exfoliating,exserted,fleshy,free,fruiting,geminat,imperceptibly,inflorescenc,known,large,lon,lower,main,major,minor,nflorescence,older,opposite,overlapping,ovoid,papillo,partially,pedicel,piece,pointed,pore,poricidal,portion,raised,restricted,robust,ruit,scar,shaped,shining,small,somewhat,spaced,straight,tall,tapering,tear-drop,thick,thickened,transverse,ud,unit,woody,ympodial,young	branching,color,diameter,flower,form,growth,height,history,inflorescence,length,life,midpoint,midvein,na,perennial,plant,pubescence,ray,reproduction,seed,shape,staman,stellae,stipe,surface,texture,width
239	wfo-0001027396	success	244	119	98	146	21	0.402	0-4,0.5-1,0.5-1.5,0.8-1.3,1.5-3.5,1/3,10-30,10-35,12-25,2-3.5,2.5-4,2.8-4.5,3.5-6,4-7,5-10,5.5-7.5,6-20,6.5-7.5,7-10,8-20,abaxially,acute,almost,andromonoecious,anther,apex,attenuate,base,black,broad-deltate,brown,calyx,chartaceous,cm,cream,cuneate,dark,densely,diameter,elliptic,elongate,filament,flattened-reniform,flower,fruit,glabrous,glandular,green,hair,herb,lateral,leaf,length,lobe,lobed,long,long-styled,margin,marking,maturity,mauve,midpoint,midvein,mm,moderately,near,obtuse,orange,pale,petiole,plant,pubescent,purple,ray,rotate,short-styled,shrub,simple,smooth,sometimes,somewhat,sparsely,spherical,stellate-pubescent,stem,style,surface,tip,trichome,tube,unbranched,upper,vein,white,wide,yellow,yellowish,young	-2,-5,-6,/3,0-100,0-3,0-30,0-5,0.1-0.5,0.1-1,0.4-0.7,0.5-2,0.5-2.5,0.7-2.5,0.8,1,1-4,1.2-2,1.5-3,1.8-3,1/2-2/3,1/4-1/3,1/6,10-15,10-25,15-40,2-3,2-7,20-100,3-,3-9,4,4-5,4-6,5-20,5-30,5-50,5-8,5-merous,7-15,abaxial,adaxial,alyx,ame,apar,apart,apically,apparently,articulated,ba,bark,berry,blade,broad,bulbous,c.,concolorous,connivent,curved,decurrent,deltate,difoliate,discolorous,distal,distance,drying,eaf,eed,elongating,equal,erect,extending,extensive,fewer,flattened,free,fruiting,fully,geminat,glabrescent,gray-brow,hermaphrodite,heterostylous,infructescence,less,lignified,lobing,lon,long-acuminat,longer,lower,lowermost,mature,nflorescence,often,older,one,open,opening,orolla,oung,pair,pedicel,peduncle,pendulous,per,pericarp,perpendicular,poricidal,porrect,portion,prickl,prickle,prickly,primary,red-brown,reflexed,ruit,scar,secondary,sessile,side,spaced,spreading,stalk,stalked,staminat,stout,straight,tamen,tapering,tearing,terete,tertiary,time,unarmed,unit,usually,variously,vary,venation,visible,way,woody,yellow-green,ympodial	branching,color,corolla,form,growth,height,inflorescence,midrib,na,ovary,pubescence,reproduction,seed,shape,size,staman,stellae,stigma,stipe,texture,width
240	wfo-0001027416	success	137	87	49	88	38	0.358	0.3-0.5,1.3-2.0,1.5-2.0,2.6-3.0,4-7,4-8,5-10,5.5-8.5,8-10,acute,annual,anther,apically,base,blue,branching,broadly,brown,calyx,cm,dark,deltoid,dm,dry,foveolate,glabrous,green,herb,lenticular,lobe,minutely,mm,ovary,ovate,pentagonal-stellate,prickly,slender,spherical,splitting,stellae,stem,strigulose,tube,vein,villous,violet,viscid-villous,weakly,yellow	.5,0.2-0.4,0.5-1.0,1.0,1/2-2/3,3-7,4.0-5.5,5-9-flowere,accrescent,across,along,alyx,anthesi,appearance,beneath,berry,blade,borne,campanulate,capitate,capitate-glandular,cauline,developing,dia,difoliate,divided,eaf,eed,enveloped,erect,externally,few-rayed,fine,geminat,gland,hair,heteromorphic,incurved,internodal,invested,lanceolate,linear,lon,long,main,maturity,much-dissected,narrowly,nflorescence,often,orolla,otherwise,pedicel,pinnatifid,prickle,quantity,reticulately,ruit,scattered,sessile,short,short-stipitate,simple,slende,slightly,smooth,somewhat,spreading,straight,strait,tall,tamen,taprooted,terete,thrice,tightly,tigma,tub,twice,tyle,ultimate,uniseriate,unit,usually,varying,wholly,wrinkled,ympodial	5-9-flowered,apex,color,corolla,diameter,filament,flower,form,fruit,growth,height,history,inflorescence,lateral,leaf,length,life,margin,midpoint,midrib,midvein,na,petiole,plant,pubescence,ray,reproduction,seed,shape,size,staman,stigma,stipe,style,surface,texture,tip,width
241	wfo-0001027432	success	215	127	104	111	23	0.484	-1.5,1-1.5,1-3,1.4-2,1.5-,1.5-2,1/4,10-22,2-2.5,2-3-lobed,3-10,3-4,3-5,3-7,3.5-4.5,30,4.5-,6-7,7-,8-10,8-16,abaxially,acute,angulate,anther,apex,apical,attenuate,base,branching,brownish,c.,calyx,chartaceous,cm,coriaceous,corolla,cream,cuspidate,densely,diameter,entire,ferruginous,filament,flower,fruit,glabrous,glandular,glandular-pubescent,globose,green,greenish,growth,heterostylous,hirsute,irregularly,leaf,light,linear-lanceolate,lobe,lobed,many,margin,maturing,midpoint,mm,near,ovary,ovate,ovate-elliptic,perfect,petiole,plant,puberulent,rarely,ray,reniform,reticulate,scabrous,shrub,somewhat,stellate,stem,stigma,style,sub-coriaceous,surface,tan,terminal,time,tip,tomentose,tomentose-floccose,tomentose-scabrous,trichome,tube,velutinous,way,white,woody,x,yellow,yellowish,young	.5,0.1,0.2-0.3,0.3-0.4,0.3-1.0,0.3-3.5,0.5-0.1,0.5-1,0.8-1.0,1-multicellular,1/3,20-30,3,3-6,4-5,5-10,6-10,acicular,adaxially,apart,armed,articulate,bark,basal,berry,blade,branched,brow,campanulate,clavate,confined,conical,curved,distal,eaf,eed,eglandular,epidermi,erect,especially,exserte,fewer,flattened,free,fruiting,glabrescent,juvenile,laterally,leave,lengthening,like,long,long-styled,lower,many-celled,minute,much,mucilaginous,multangulate,multiangulate,new,nflorescence,ochraceous,older,one,partially,pedicel,peduncle,per,pericarp,plurifoliat,pore,poricidal,porrect,porrect-stellate,portion,prickle,prickly,prominent,pubescent,raise,recurved,ruit,sessile,short-styled,similar,simple,slightly,spaced,sparsely,staminate,stellate-pubescen,stellate-pubescent,stellate-tomentose,stipitate,straight,subglobose,subsessile,tapering,terete,testa,thick,ud,unarmed,unevenly,unicellular,unit,upper,villose,visible,ympodial	color,form,height,history,inflorescence,lateral,length,life,midrib,midvein,na,perennial,pubescence,reproduction,seed,shape,size,staman,stellae,stipe,texture,vein,width
242	wfo-0001027437	success	193	113	89	104	24	0.461	0,0.2-0.4,1,1-1.5,1-2,1-4,2-2.5,2-3,2-several,2.5,2.8-6,30,4,4-4.5,5-12,5-6,6-8,7-17,abaxially,acuminate,acute,anther,apex,base,beige,beneath,berry,branched,brown,calyx,chartaceous,cm,corolla,corymbose,cyme,decurrent,diameter,elliptic,entire,erect,filament,flower,fruit,glandular-viscous,globose,growth,heterostylous,hirsute,impressed,lateral,lenticulate,like,linear-lanceolate,lobe,margin,middle,midpoint,mm,oblanceolate,ovary,petiole,prominent,puberulent,pubescence,pubescent,ray,reddish,reticulate,rusty,scabrous,shrub,slightly,sparsely,stellate-rotate,stem,stigma,style,subreniform,surface,time,tip,tomentose,triangular-lanceolate,tube,unicellular,velutinous,white,woody,x	0.4-0.5,1-3,1.2-1.5,2-2.5mm,2-4.5,4-5,adaxially,anthesi,antrorse,armed,articulated,attenuate,bark,basal,clavate,compressed,cordate,curved,dark,densely,diamete,discolorous,distal,eaf,eed,egalndular,elongate,erec,exceeding,free,fruiting,glabrous,glandular,green,inserted,internodal,laterally,leaving,lengthening,lobed,long,long-styled,lower,minute,mixed,mixture,near,nerve,new,nflorescence,oblong,older,one,ovate,partially,pedicel,peduncle,perfect,pericarp,plurifoliat,pore,poricidal,porrect,portion,prickle,prickly,raise,recurved,reduced,reflexed,rugose,ruit,scar,scarce,sessile,short-styled,simple,slit,spaced,sparse,stalked,staminate,stellate,stipitate,straight,strongly,subcampanulate,subspherical,tall,terete,testa,thick,three,tinge,trichome,ud,unarmed,unevenly,unit,upper,venation,within,yellow,ympodial	branching,color,form,height,history,inflorescence,leaf,length,life,midrib,midvein,na,perennial,plant,reproduction,seed,shape,size,staman,stellae,stipe,texture,vein,width
243	wfo-0001027447	success	197	102	80	117	22	0.406	0.2-0.6,0.2-1,0.25-0.5,0.4-0.6,0.6-1,1-2.5,1.3-1.7,1.5-3,2.3-5,3-4.5,3.5-4.5,3.8-4.3,5-13,5-8,7-14,7-8,abaxially,acuminate,acute,adaxially,andromonoecious,anther,apex,base,brown,calyx,chartaceous,cm,cuneate,densely,diameter,elliptical,entire,erect,flower,fruit,glabrous,globose,green,inflorescence,lateral,leaf,length,lobe,lobed,long,margin,midpoint,midrib,midvein,mm,moderately,obtuse,ovate,pale,perennial,petiole,plant,pseudo-racemose,pubescence,ray,red,rhizomatous,rostrate,shallowly,shrub,sparsely,stellae,stellate,stellate-pubescent,style,surface,throughout,time,tube,unbranched,vein,white,x,yellow	%,.25,0-0.4,0-0.5,0-1,0-10,0-2.5,0-4,0.15-0.25,0.25-0.3,0.5-1.7,0.6-0.8,1-1.4,1-10,1-2,1-locular,1.2-1.7,10-20,13-18,17-28,2.1-3.2,2.5-4,25-30,3-6,4-6,4-8,4-9,5-merou,6-10,7-10,7-14.5,8-13,absen,absent,acicular,across,adaxiall,adult,alyx,apart,articulated,axe,ba,blade,branch,branche,confined,cross-section,cylindrical,decimetre,directed,distall,distally,dm,eaf,eed,eglandular,elliptica,exocarp,extra-axillary,finger,fruiting,functional,gland-tipped,hair,half,heterostylous,incomplete,index,juicy,juvenile,lamina,less,lobing,longer,lower,markedly,mature,mesocarp,minute,nflorescence,oblique,orolla,pair,part,pedicel,peduncle,per,placenta,pore,porrect,present,prickle,ruit,septum,sessile,short,side,simple,spaced,straight,succulent,tal,tamen,tem,thick,thicker,transparent,unarme,unarmed,unit,unknow,upper,vary,weakly,wide,ympodial	branching,color,corolla,filament,form,growth,height,history,life,na,ovary,reproduction,seed,shape,size,staman,stem,stigma,stipe,texture,tip,width
244	wfo-0001027449	success	160	102	72	88	30	0.45	/3,0.5-1,0.8-1.5,1.4-1.5,10-15-flowered,2-4,3,3-3.5,3-7,4-6,5-6,8-15,acuminate,acute,anther,apex,base,beneath,brown,calyx,cm,corolla,dark,densely,dia,dry,elliptic,filament,fruit,glabrous,globose,green,inflorescence,lateral,leaf,lobe,lobed,long,long-triangular,material,minutely,mm,narrowly,oblique,often,ovary,ovoid-reniform,pair,papillose,petiole,pitted,pubescent,red-papillose,shrub,simple,size,small,sparsely,stem,stigma,style,surface,tip,tree,trichome,tube,tuft,uniseriate,vein,way,white,x	.4,.5,.75,0.5-1.5,0.9-1.1,1.2-1.5,1.5-2.5,2-3,anthesi,appearing,area,arising,around,axil,bark,becoming,beginning,berry,bud,closely,cup,deciduous,deflexed,dense,density,differing,difoliate,eaf,edicel,eed,ellipsoid,erect,exserted,extreme,forming,free,frui,fruiting,geminat,glabrate,inflorescenc,lamina,later,like,lon,long-acuminate,lower,main,major,minor,nflorescence,obconic,older,one,opposite,orangish,overlapping,packed,pale,pedicel,persistent,pointed,pore,poricidal,portion,prominent,raised,reddish-brow,reflexed,rest,ruit,scar,shaped,slender,soon,sparse,straight,styl,tall,tapering,tear-drop,trunk,ud,unit,varying,woody,ympodial,young	0.4,1,2,branching,color,diameter,flower,form,growth,height,history,length,life,margin,midpoint,midrib,midvein,na,perennial,plant,pubescence,ray,reproduction,seed,shape,staman,stellae,stipe,texture,width
245	wfo-0001027452	success	152	112	79	73	33	0.52	.5,0.5-1,0.5-1.5,0.5-2,0.5-2.5,1,1-3,1-4.5,1-5,1.5,1.5-3,2-6,3-9,4,4-6,5-12,abaxially,acute,adaxially,anther,apex,base,brown,calyx,cell,center,chartaceous,ciliate,cm,connected,densely,diameter,dm,drying,elliptic,elliptic-ovoid,entire,filament,flower,fruit,glabrous,globose,herb,immature,large,linear-lanceolate,lobe,long,margin,maturing,membranaceous,mm,moderately,obtuse,outer,parallel,perpendicular,petiole,pubescent,raised,ridge,rotate,rounded,running,seed,semitransparent,smaller,smoother,sparsely,stigma,style,swollen,triangular,tube,vein,wall,white,x,yellow	1-2,10-20,2-4,2-foliate,3-6,5-20,absent,abundant,adaxiall,along,axe,berry,beyond,blade,branched,celled,cordate,decurrent,dehiscing,denser,eaf,eed,emarginat,equal,explosively,exserted,flat,frui,geminat,growt,hair,held,interpetalar,lower,lying,maturit,mesocarp,nearly,new,nfloresence,notched,oblong,often,one-,orolla,pedicel,peduncle,per,placenta,pressure,pubescen,rachi,ruit,short,significantly,single,slightly,sometimes,stamen,straight,tal,tamen,tem,tissue,two-celled,unbranched,unit,usually,vary,watery,wid,woody,ympodial	branching,color,corolla,form,growth,height,history,inflorescence,lateral,leaf,length,life,midpoint,midrib,midvein,na,ovary,perennial,plant,pubescence,ray,reproduction,shape,size,staman,stellae,stem,stipe,surface,texture,tip,wide,width
246	wfo-0001027471	success	165	107	85	80	22	0.515	.5,/4,0.2-0.5,0.4-1,0.5-1.5,0.9-1,1-1.2,1-1.5,1.4-3,2-2.5,2-3,3-4,3-7,4-5,6-7,acute,adaxially,along,anther,anthesi,apex,base,branched,brittle,calyx,cm,corolla,deltate,densely,diameter,entire,filament,flattened,flower,glabrous,globose,growth,herb,inflorescence,lamina,leaf,lobe,lobed,long-triangular,margin,maturity,midvein,minutely,mixture,mm,ovary,pair,pale,petal,petiole,pitted,planar,pubescent,red-orange,reflexed,reniform,scattered,shape,shrub,simple,size,slightly,small,sparsely,stem,stigma,style,subshrub,surface,tan,thin,tip,trichome,tube,uniseriate,vein,way,white,x,yellowish	0.1-0.2,0.2-0.4,0.5,0.5-0.6,0.5-0.7,0.7-0.9,1-1.6,1.5-2,2-lobed,abaxially,age,appressed,ascending,bark,berry,bifid,c.,closely,conical,dendritic,desnsely,differing,difoliate,distant,drying,eaf,eed,elliptic,erec,erect,especially,free,fruiting,furcate-dendritic,geminate,included,internodal,leaf-opposed,lengthening,less,like,lower,major,minor,new,nflorescence,nodding,node,occasionally,open-conical,orbicular,ovate,overlapping,papillat,pedicel,peduncle,perfect,pericarp,plane,pore,poridical,portion,primary,pubscent,rachi,ruit,scar,similar,slender,slit,somewhat,spaced,straight,thickened,trifoliat,ud,unit,usually,woody,ympodial	branching,color,form,fruit,height,history,lateral,length,life,midpoint,midrib,na,plant,pubescence,ray,reproduction,seed,staman,stellae,stipe,texture,width
247	wfo-0001027473	success	138	106	79	59	27	0.572	.25,/2,0.5-1,0.8-1,1-1.5,1-2,1.3-2,1.5-2,2-2.5,2.5-3,3.5-5,4.5-13,6-9,8.5-37,?,abaxially,acute,adaxially,anther,anthesi,apex,base,brown,calyx,cm,corolla,decurrent,dendritic,densely,dia,filament,flattened-reniform,glabrous,globose,green,incrassate,later,lateral,leaf,like,lobe,lobed,long,margin,minute,minutely,mm,near,obovate,occasionally,ovary,pair,petiole,pitted,planar,pointed,pubescent,pubesent,rootstock,rusty,sessile,shape,shrub,somewhat,sparsely,stem,stigma,style,subshrub,surface,tip,trichome,tube,vein,way,white,wide,woody,young	0.25-0.5,1.8-2,1/3,5,absen,along,ape,apparently,bark,berry,clavate,conical,deccurent,deep,deflexed,denser,di-,differing,drying,eaf,eed,empty,erect,free,fruiting,geminat,giving,less,long-triangular,lower,main,major,middle,minor,older,overall,pale,papillo,pedicel,pore,poricidal,portion,ruit,sac,shaped,sterile,strongly,tall,tear-drop,thick,trifoliate,unit,usually,widest,wing,winged,yellowish,yellowish-brow,ympodial	absent,branching,color,diameter,flower,form,fruit,growth,height,history,inflorescence,length,life,midpoint,midrib,midvein,na,plant,pubescence,ray,seed,size,staman,stellae,stipe,texture,width
248	wfo-0001027483	success	164	106	76	88	30	0.463	0.6,1,1-2.5,1-4,1.5-10,1.5-2.6,1.5-3,2-3,2-4.5,3-6,3.5-20,4.5-8,5-10,5-6,abaxially,acute,adaxially,apex,base,branched,calyx,cell,cm,coarsely,corolla,covering,cuneate,cyme,diameter,dichasial,dichasially,dot,ebracteate,filament,finely,flower,forked,globose,green,green-white,hair-like,herbaceous,lateral,leaf,light,lobe,long,medium,minute,mm,monochasial,obtuse,odd-pinnate,ovoid,perennial,petiole,plant,pubescent,ray,rotate,rounded,seed,size,smooth,sometimes,stigma,style,testal,thick,throughout,violet,violet-purple,wall,white,wide,yellow	0-1.,0.2-1.9,1-2,1-5,1.2-2.5,2,2-4,3-15,3-6-foliat,acumen,apical,apically,articulate,basal,connate,decurrent,dehiscent,digestion,diminishing,distal,dorsally,eaf,edge,eed,elliptical,emoval,enzyme,erec,exceeding,flat,folded,generally,globo,gradually,half,honeycomb,interjected,interpetiolar,introrse,leaflet,lighter,living,lon,lower,lunat,make,maturing,mucilaginous,nflorescence,nther,often,orolla,ovate,pair,pattern,pedicel,peduncle,perfect,petiolule,plan,poricidally,proximal,purple,rachi,reveal,rosette,ruit,sessile,seudostipule,short,slit,specimen,stamen,straight,subsessile,tall,tem,terminal,tissu,toward,tuber-bearing,typically,uniform,unit,vary,varying,ympodial,¼	anther,branching,color,form,fruit,growth,height,history,inflorescence,length,life,margin,midpoint,midrib,midvein,na,ovary,pubescence,reproduction,shape,staman,stellae,stem,stipe,surface,texture,tip,tube,vein,width
249	wfo-0001027503	success	197	113	92	105	21	0.467	.5,0.2,0.4-0.7,0.5,0.5-0.7,0.8-1,1-1.2,1-3,1.2-2.5,10,2-3,2.5-5.5,20-40,4,8-11,<,abaxially,acute,adaxially,along,anther,apex,base,beige,berry,bluntly,broadly,calyx,cm,coriaceous,corolla,deltate,densely,diameter,dioecious,distally,echinoid,elliptic,entire,filament,flower,fruit,glabrous,globose,greenish,growth,inflorescence,lanceolate,leaf,like,lobe,lobed,long,margin,midrib,mm,narrowly,nearly,ovary,pair,pale,petiole,plant,prominent,pubescence,pubescent,ray,rest,ripe,shiny,shrub,small,sparsely,stellate,stem,stigma,style,surface,tan,thick,thin,time,tip,tree,trichome,truncate,tube,underside,vein,white,x,yellowish	0.15-0.2,0.5-0.6,0.6-0.7,0.9-1.2,1,1.1-1.5,2.5-3,549,age,almost,anthesi,armed,articulated,bark,beneath,berr,branched,broad-based,clavate,common,conical,consisting,deflexed,dense,due,eaf,eed,ellipsoid,elongate,enclosing,erect,expanding,female,fide,foliose,free,fruiting,glabrescen,greatly,grey,included,internodal,juvenile,known,lamina,large,lengthening,lepidote,less,likely,lower,male,minutely,mixture,new,nflorescence,occasionally,often,older,overlappin,packed,papillo,partially,pedicel,peduncle,peguero,pericarp,pistillate,planar,plurifoliat,pore,poricidal,porrect,portion,prickle,prickly,primary,rhachi,rounded,rudimentary,ruit,scar,seen,shoot,short,similar,simple,slit,solitary,somewhat,staminate,stout,straight,tightly,tiny,tubular,ud,unarme,unarmed,unisexual,unit,visible,without,ympodial,½	branching,color,form,height,history,lateral,length,life,midpoint,midvein,na,perennial,reproduction,seed,shape,size,staman,stellae,stipe,texture,width
250	wfo-0001027506	success	215	124	99	116	25	0.46	-0.35,-7,-7.5,.2,/6,0.1-0.3,0.25,0.5-1.5,0.5-6,0.8-1.5,1.2-1.5,1.8,1/3,2-3.2,2.2-3.5,2.5-5,3-10,3-5,3-6,3.5-5,6.5-10,8-10,abaxially,acuminate,acute,andromonoecious,anther,apex,apically,base,becoming,berry,branched,brown,calyx,cell,chartaceous,cm,cordate,cream,cuneate,dark,densely,diameter,entire,erect,filament,fine,flattened-reniform,flower,fruit,green,lateral,leaf,length,lobe,lobed,long,margin,marking,maturity,mauve,mm,moderately,narrow-deltate,occasionally,orange,orange-brown,outline,ovate,pale,petiole,pit,plant,purple,raised,ray,shrub,small,smooth,sometimes,spherical,spreading,stellate-pubescent,stem,style,subentire,surface,tip,tree,truncate,tube,twice,upper,vein,way,wide,yellow,young	-1,-20,-3,.5,/2,0,0-10,0-2,0-6,0-60,0.1-,0.2,0.2-0.3,0.7-1.3,1-2,1-3,1-4,1.5-2.2,1/6-1/4,10-40,2.5-8,5-10,5-7,5-merous,6-13,7-8,7-9,9-13,acuminat,alyx,ame,apar,apart,apparently,articulated,bark,blade,brow,c.,concolorous,connivent,curved,distal,dry,drying,eaf,eed,elongating,equal,flattened,free,fruiting,glabrescent,glabrous,hard,hermaphrodite,heterostylous,infructescence,lengt,long-styled,longer,lower,lowermost,mature,midpoint,multangulate,nflorescence,older,one,open,orolla,oung,pair,pedicel,peduncle,pendulous,per,pericarp,plurifoliat,poricidal,porrect,portion,prickl,prickle,prickly,primary,reddish,reduced,reflexed,ruit,scar,sessile,short-styled,simple,spaced,stalk,stalked,staminat,stellate,stout,tamen,tapering,terete,terminal,tertiary,time,trichome,unarmed,unit,variously,vary,venation,visible,woody,yellow-green,ympodial	branching,color,corolla,form,growth,height,history,inflorescence,life,midrib,midvein,na,ovary,perennial,pubescence,reproduction,seed,shape,size,staman,stellae,stigma,stipe,texture,width
251	wfo-0001027510	success	195	113	88	107	25	0.451	.5,.7,0-0.5,0.4-0.9,0.5-1.1,0.7-1.5,0.9-3.4,1.5-2,1.5-2.5,10-15,2-2.2,2.5-3,2.6-6,3-5,4-5.5,4-6,5-10,6-13,6-7.5,abaxially,acute,adaxially,anther,apex,base,broadly,calyx,chartaceous,cm,cordate,cylindrical,deltate,densely,diameter,distributed,elliptic,entire,erect,filament,flower,fruit,glabrous,gland-tipped,globose,green,grey,hair,inflorescence,interpetalar,juicy,lateral,leaf,leafy,length,lobe,margin,minutely,mm,obtuse,ovate,pale,perennial,petiole,porrect,pseudo-umbellate,pubescent,purple,ray,red,reticulate,rhizomatous,rotate-stellate,short,shrub,soliary,stellae,stellate,stellate-pubescent,stigma,style,succulent,surface,throughout,tissue,tube,unbranched,x,yellow	%,0-0.4,0-0.9,0-2,0-5,0.1-0.3,0.2-0.4,0.5-0.6,0.7-1.6,0.8-1.8,1-2,1-3,1-locular,1.5-3,1.5-4,1.6-2,10-12,10-13,17-35,2-3,2-5,2-foliate,2.6-5.5,3-6,4-5,4-8,4-9,5-merou,6,6-8,9-12,absen,absent,abundant,accrescent,across,adult,alyx,apart,apparen,articulated,axe,ba,blade,capitate,connivent,contiguous,directed,distall,eaf,eed,eglandular,exceeding,extra-axillary,finger,forke,fruiting,geminat,homostylous,incomplete,juvenile,lamina,lanceolate,lobed,long,lower,mature,mesocarp,midpoint,minute,nearly,nflorescence,oblique,orolla,pair,part,pedicel,peduncle,per,perfect,placenta,pore,prickle,rachi,ruit,septum,sessile,shallowly,simple,spaced,stalk,tal,tamen,tem,thick,time,tissu,transparent,unarme,unarmed,unit,upper,usually,vary,wide,without,ympodial	branching,color,corolla,form,growth,height,history,life,midrib,midvein,na,ovary,plant,pubescence,reproduction,seed,shape,size,staman,stem,stipe,texture,tip,vein,width
252	wfo-0001027536	success	200	111	86	114	25	0.43	0.4-2.0,1-2,1.5-2,2-,2-2.5,2-3,20,3-3.5,3-4,3-forked,4,4-10,4-12,4-5,5-6,8-10,abaxially,anther,apex,apiculate,base,bicolored,brown,calyx,cm,curved,densely,diameter,eglandular,elliptic,epicarp,ferruginous,ferruginous-tomentose,filament,fine,flower,fruit,glabrous,gland-tipped,glandular,glandular-stellate,globose,hair,inflorescence,leaf,leathery,lenticular,linear-lanceolate,lobe,long,lower,mixed,mm,multiseriate-stalked,oblanceolate,ornamentation,perennial,persistently,petiole,pubescent,reddish,reticulated,sessile,short,shrub,similar,stellate,stem,stigma,straight,style,subcoriaceous,subreniform,surface,terete,tip,tomentose,trichome,tube,unbranched,velutinous,villose,white,x,yellow,yellowish	-15,-3,1-1.5,2-10,2-4,2-5,3-5,30-50,4-8,5-10,5-7,8-,accrescent,acute,adaxiall,adaxially,alyx,apart,ape,apical,armed,articulated,asymmetric,axe,ba,basal,berry,bisexua,blade,branch,branched,chartaceous,clavate-truncat,compressed,connivent,dark,decurrent,depressed-globose,distal,dry,eaf,eed,enlarged,entire,equal,erect,exceeding,fleshy,free,fruiting,gynoecia,held,impressed,introrse,laterally,like,longer,many-foliat,margin,maturit,midpoint,mostly,multiseriate,nflorescence,one,opening,orolla,part,pedicel,peduncle,per,perfect,persistent,pore,prickle,primary,prominent,rachi,recurved,reduced,reflexed,ruit,simple,single,slender,slightly,small,somewhat,spaced,sparsely,splitting,stalk,stamen,staminate,subcampanulate,subulate,surrounded,tal,tamen,tem,thick,time,unarme,unarmed,unisexual,unit,upper,upright,usually,vary,vein,wide,ympodial,zygomorphic	1,abaxial,adaxial,bisexual,branching,color,colour,corolla,form,growth,height,history,length,life,midrib,na,ovary,plant,pubescence,reproduction,seed,shape,size,staman,texture
253	wfo-0001027538	success	137	78	48	89	30	0.35	.5,.9,0.3-0.4,0.4-0.5,0.4-0.85,0.9-1,0.9-1.8,1.5-3.5,2-4,8,acute,adaxially,anther,apex,attenuate,base,brown,calyx,chartaceous,cm,cordate,densely,diameter,entire,flower,fruit,glabrous,inflorescence,lateral,length,lobe,margin,midvein,mm,obtuse,ovate,petiole,prostrate,ray,rusty,stellae,stellate,stellate-pubescent,tube,unbranched,unknown,x,yellow	%,0-0.1,0-1.5,0-2,0.05-0.15,0.1-0.2,0.3-0.45,0.5,0.5-1,0.5-1.5,0.6-1,0.9-1.2,1,1-4,1.9-2.4,20-25,4-5,5-merou,7-12,8-13,?,abaxially,absen,absent,acicular,across,adaxiall,alyx,apart,armed,articulated,axe,ba,blade,directed,distall,distributed,eaf,eed,eglandular,extra-axillary,finger,fruiting,gland-tipped,globo,grey-green,hair,half,lamina,less,lon,long,lower,mature,mid-point,midpoint,minute,nflorescence,oblique,orolla,part,pedicel,peduncle,per,pore,porrect,present,prickle,ruit,sessile,short,shru,simple,spaced,stage,stalk,straight,tamen,tem,thick,throughout,time,unarmed,unit,unknow,uvenile,wide,yellowish,ympodial	branching,color,corolla,filament,form,globose,growth,height,history,leaf,life,midrib,na,ovary,plant,pubescence,reproduction,seed,shape,shrub,size,staman,stem,stigma,style,surface,texture,tip,vein,width
254	wfo-0001027548	success	216	108	82	134	26	0.38	-11.5,0.5-2,1,1-1.5,1-2.5,1-3.5,1.2,1.5-2.5,10-50,3-7,4-8,4.5,6-9,acuminate,acute,almost,anther,anthesi,apex,attenuate,base,berry,black,branched,branching,brown,calyx,cm,corolla,dark,densely,depressed-elliptic,diameter,dull,elliptic,entire,filament,flattened-reniform,flower,glabrous,globose,green,growth,immature,inflorescence,leaf,like,lilac,lobe,many,margin,matte,membranous,minutely,mm,narrowly,pale,papillate,petiole,pitted,planar,puberulent,pubescent,reddish,ripe,size,sparsely,stellate,stem,stigma,style,surface,time,tinged,tip,tube,vein,vine,white,woody,x,yellow	.3,0.2,0.3-1.2,0.5,1-10,1.5,1.5-2,10-12,4-6,5-merou,7-10,8-9,abaxiall,adaxially,ag,along,also,although,alyx,apart,apical,apparently,appearing,area,ark,articulated,articulation,axi,basal,beneath,bent,branch,bu,c.,capitate,cell,conical,connivent,darker,deflexe,deltate,dendritic,denser,drying,eaf,early,eed,ellipsoid,elongate,em,exserted,extending,flexuous,free,fruiting,geminat,glabrescen,glandular,half,herbarium,ilament,irregularly,lamina,leaving,lengthening,less,lobed,lon,long,long-styled,loose,loosely,lower,minute,mixed,near,new,nflorescence,occasionally,older,orolla,outline,pair,papillae,papillo,pedicel,peduncle,per,perfect,pericarp,plurifoliate,point,pore,poricidal,portion,primary,prominent,rachi,rectangular,revolute,ruit,scar,scattered,simple,slender,slit,small,sometimes,somewhat,spaced,sparse,specimen,spreading,strongly,swollen,tapering,terminal,testal,thickened,thin,tiny,transparent,trichome,twinin,type,ud,uniseriate,unit,upper,usually,vary,warty,way,ympodial	8,color,form,fruit,height,history,lateral,length,life,midpoint,midrib,midvein,na,ovary,perennial,plant,pubescence,ray,reproduction,seed,shape,staman,stellae,stipe,texture,width
255	wfo-0001027581	success	200	92	61	139	31	0.305	100+,acute,anther,apex,base,branched,branching,broadly,brown,calyx,cm,corolla,dark,deltate,densely,diameter,elliptic,entire,evenly,filament,flattened-reniform,flower,globose,golden,green,growth,inflorescence,leaf,length,lobe,lobed,long,many,margin,minutely,mm,moderately,petiole,pitted,plane,pubescent,purple,ray,reddish,shrub,size,small,sparsely,stellate,stem,stigma,style,surface,terminal,time,tip,tree,tube,unevenly,wide,yellow	0.2–0.3,0.3,0.3–1,0.5–1,0.5–1.5,1,1.2–1.5,1.3–1.5,1.5,1.5–2,1.5–3,10,10–16,12,12–30,15–20,1–1.5,1–3-rayed,2.5–3,200,3.5–4.5,3–3.5,4.5–16,4–8,5-merou,6–7,7–10,7–9,8,8–10,9–11,9–9.5,>,abaxial,abaxially,adaxial,ag,along,alyx,anthesi,apar,ark,articulated,axe,beneath,berry,brow,bulbous,c.,clavate,clearly,closely,connivent,cup-shaped,dichasia,discolorous,distally,drying,eaf,echinoid,eed,ellipsoidal,erec,exserted,free,fruiting,glabrescent,glabrous,gradually,greyish,ilament,lamina,largest,lengthening,less,like,longest,loosely,lower,midvei,minute,mixed,multangulate,multiseriate,narrowing,near,new,nflorescence,nodding,older,orolla,pair,papillo,part,pedicel,peduncle,per,perfect,pericarp,plurifoliate,pore,poricidal,porrect-stellate,portion,primary,reflexed,rhachi,ripe,ruit,scar,scarcely,sessile,shiny,short-stalked,simple,slit,smaller,spaced,spreading,stalk,stout,tall,tem,thin,trichome,ud,undersurface,unit,upper,vary,varying,vein,visible,way,weak,whit,woody,yellowish,ympodial	0.3-1,1-1.5,1-3,1.3-1.5,1.5-2,1.5-3,12-30,15-20,2.5-3,3-3.5,4-8,4.5-16,9-9.5,color,form,fruit,height,history,life,midrib,na,ovary,plant,pubescence,reproduction,seed,shape,staman,stellae,texture,width
256	wfo-0001027584	success	144	97	69	75	28	0.479	-16,-2,0.5-1,0.5-1.5,0.9-2.5,1-1.2,1.5-2,1.6-1.9,11.5-45,2,3,3-.,4-6,4-7,4.5-20,7-10,abruptly,acuminate,anther,apex,attenuate,base,branched,calyx,cm,corolla,darker,densely,diameter,ellipsoid,elliptic,filament,flattened,flower,four,fruit,glabrous,green,herb,lobe,lobed,margin,mm,narrowly,nearly,ovary,ovate,pair,pale,papillate,petiole,reddish,reniform,smooth,sparsely,stem,stigma,stripe,style,suffruticose,surface,tan,time,tip,triangular,tube,vein,white,x	..,.5,0.9-1,1.2-1.4,1.5-8,10-15,100,2-10,2.5-3,8-9,absent,anthesi,apical,bark,becoming,beginning,beneath,branch,brittle,broadly,brow,c.,capitat,cell,conical,cucullate,deflexe,deltate,dry,eaf,edicel,eed,erec,fruiting,irregular,lamina,long,lower,markedly,minutely,nflorescence,open,outer,outline,pedicel,peduncle,per,pericarp,planar,plurifoliat,pointed,present,primary,regularly,ruit,scar,scattered,shrub,single,single-stemmed,sinuate,small,sparse,striate,testal,thickening,thin,trichome,tuft,ud,uniseriate,unit,wall,without,ympdoial	branching,brown,color,form,growth,height,history,inflorescence,lateral,leaf,length,life,midpoint,midrib,midvein,na,plant,pubescence,ray,reproduction,seed,shape,size,staman,stellae,stipe,texture,width
257	wfo-0001027585	success	217	110	88	129	22	0.406	0-0.5,0-2,0.15-0.25,0.25-0.35,1-3,1-4,10-25,2-5,2.3-2.8,3-3.5,3-4,3-7,4.5-20,5-17,5-8,7-10,7-9,absent,acuminate,acute,adaxially,anther,apex,base,brown,calyx,chartaceous,cm,cuneate,deltate,densely,diameter,elliptic,entire,erect,flattened,flower,fruit,glabrous,globose,green,hair,inflorescence,lateral,leaf,length,lilac,lobe,lobed,long,margin,midpoint,midrib,midvein,mm,narrowly,oblate,ovate,pale,perennial,petiole,plant,pubescent,ray,rhizomatous,ripe,rounded,shallowly,shrub,sparse,sparsely,sprawling,stellae,stellate,stellate-pubescent,stigma,style,surface,throughout,time,triangular,tube,unbranched,unripe,vein,vine,x,yellow	%,.05,0,0-1,0-15,0-4,0.2-0.3,0.2-0.4,0.5-1,0.6-0.9,0.7-4.5,0.9-1.8,1,1.9-2.5,11-15,12-23,13-18,15-20,15-30,2-3,2-6,2-foliate,2-locular,22-25,29-40,3.8-4.2,4-8,5-7,5-merou,6-7,6-8,7-14.5,8-10,8-14,abaxially,absen,accrescent,acicular,across,adaxiall,adult,alyx,andromonoecious,anvil-shape,apart,articulated,axe,ba,blade,branch,branche,broad-based,capitat,confined,connivent,cross-section,curved,cylindrical,decimetre,directed,distall,distributed,dm,eaf,eed,eglandular,exocarp,extra-axillary,finger,fruiting,functional,geminat,gland-tipped,half,heterostylous,interpetalar,juicy,juvenile,lamina,lanceolate,less,longer,loosely,lower,mature,mesocarp,mid-point,minute,moist,nflorescence,oblique,orolla,pair,part,pedicel,peduncle,per,placenta,pore,porrect,present,prickle,purple,rachi,ruit,scarcely,sessile,short,side,simple,spaced,stalked,straight,tal,tamen,tem,thick,tissue,transparent,unarme,unarmed,unit,upper,vary,weakly,white,wide,yellowish,ympodial	branching,color,corolla,filament,form,growth,height,history,life,na,ovary,pubescence,reproduction,seed,shape,size,staman,stem,stipe,texture,tip,width
258	wfo-0001027594	success	168	87	63	105	24	0.375	0.3-1.2,0.7-1,0.7-1.2,1,1-2,1.5-2,10-15,2.5,2.5-4,3-4,4-5,age,anther,becoming,bright,brown,calyx,cm,corolla,curved,dark,dia,filament,flattened-reniform,fleshy,glabrous,globose,green,hard,immature,lavendar,leaf,lobe,lobed,maroon,minutely,mm,oblanceolate,occasionally,often,orange,ovary,pale,papillose,petiole,pitted,puberulent,ripe,seed,shrub,simple,stem,stigma,straight,style,surface,tinged,tip,tube,white,winged,x,yellow-tan	.1,.2,.5,0.6-1.4,0.9-2.5,2-2.2,2-3,2-5,3/4,4.7-6.8,5-20-flowered,across,acute,anthesi,apex,attenuate,ba,bark,base,berry,bi-lobed,body,branch,capitate,closely,constriction,decurrent,deltoid,difoliate,distal,eaf,edicel,eed,elliptic,erect,especially,extending,free,fruiting,geminat,geminate,glandular,incrassate,interpetalar,junction,lateral,lenticellat,less,locule,lon,long,lower,main,major,margin,middle,minor,minute,nflorescence,non-reproductive,oblong,obovate,obovoid,older,one,opposite,ovate,overlappin,pair,paler,papillo,pedicel,pore,poricidal,portion,prominent,raised,reflexed,reproductive,rounded,ruit,scar,shaped,shoot,sinus,slender,slightly,small,spaced,straggly,tall,tapering,tear-drop,thin,trichome,two,ud,uniseriate,unit,vein,way,widest,woody,ympodial,young	0.5,3,branching,color,diameter,form,fruit,growth,height,history,inflorescence,length,life,na,perennial,plant,pubescence,reproduction,shape,size,staman,sympodial,texture,width
259	wfo-0001027600	success	185	124	97	88	27	0.524	-3,0.5-1.5,1,1-14,1-4,1.5-2,1.5-2.5,10-20,2-18,2-3,2-3.5,2-4,2-4.5,2-6,2.5-21,2.5-6,3-15,3-5,3-5-lobed,3-6,abaxially,acuminate,acute,adaxial,adaxially,along,apex,basal,base,calyx,campanulate,cm,collection,cordate,cuneate,deltate,densely,diameter,ellipsoidal,entire,especially,except,fading,flattened,flower,forked,fruit,glabrescent,glabrous,glandular-puberulent,greenish-white,leaf,lobe,lobed,long,main,margin,mature,midrib,minutely,mm,moderately,occasionally,older,orange,papillose,petiole,pilose,pinnately,puberulence,puberulent,pubescent,purple,purplish,rarely,rounded,simple,sparsely,stigma,style,subcoriaceous,surface,time,tip,tree,triangular,truncate,tube,unbranched,unlobed,vein,white,wide,x,yellow,yellow-green,young	-10,0.5-1,1-2,1-5,1/2-3/4,10-,15-25,2-11,2-5,20-30,4-6,4-foliat,5-13,8-17,abruptly,absen,absent,adpressed,aggregate,apart,ape,apical,apiculate,articulated,axe,beyond,blade,brow,cell,channe,concave,connective,coriaceous,cream,dilated,directed,distally,divided,eaf,eed,elliptic,exceeding,exserted,fleshy,gland,laterally,leaving,lon,lower,narrowed,nflorescence,nther,obconical,oblong,obtuse,orolla,ovate,ovoid,pedicel,pedicellar,peduncle,perfect,pilo,pore,puberulen,rachi,radiu,remnant,ruit,shorter,sinus,slightly,small,somewhat,spaced,stamen,stone,strongly,tal,tem,thecae,tomento,two,ud,unit,vary,yellowish,ympodial	anther,branching,channel,color,corolla,filament,form,growth,height,history,inflorescence,length,life,na,ovary,perennial,plant,pubescence,reproduction,seed,shape,size,staman,stem,texture,tomentose,width
260	wfo-0001027601	success	204	108	83	121	25	0.407	%,0.25-0.4,0.4-2,0.5-1.5,0.5-2,1-1.4,1.5-2,1.6-5,2.3-4.3,2.5-3,2.5-6,2.6-4,4-10,7-18,7-20,acuminate,acute,adaxially,andromonoecious,angularly,anther,apex,base,brown,buff,calyx,chartaceous,cm,cuneate,cylindrical,deltate,densely,diameter,ellipsoidal,elliptical,entire,filament,flattened,flower,fruit,glabrous,globose,green,hair,inflorescence,lamina,lanceolate,length,lilac,lobe,lobed,long,margin,midrib,mm,ovate,pale,perennial,petiole,plant,pseudo-racemose,red,reniform,reticulate,shallowly,shrub,sparsely,stellae,stellate,stellate-pubescent,stigma,style,surface,throughout,time,toward,tube,unbranched,white,wide,x,yellow,yellowish	.05,0-0.1,0-10,0-3,0-7,0.1-0.5,0.2-0.4,0.2-0.8,0.3-0.5,0.4-0.5,0.5-0.8,0.5-1,1-1.3,1-2,1-locular,10-16,13-25,2-15,2-6,3-5,3-6,3-7,3-foliate,5-merou,6-8,7-8,8-9,abaxially,absen,absent,accrescent,acicular,across,adaxiall,adult,alyx,apart,apparen,around,articulated,axe,ba,blade,branche,capitat,confined,congested,connivent,contiguous,decimetre,directed,distall,eaf,eed,eglandular,erect,exocarp,extra-axillary,finger,fruiting,functional,geminate,gland-tipped,half,heterostylous,incomplete,index,juicy,lateral,leaf-opposed,less,lobing,longer,lower,mature,mesocarp,midpoint,midvein,minute,narrow,nearly,nflorescence,oblique,obtuse,orolla,outer,part,pedicel,peduncle,per,placenta,pore,porrect,present,prickle,rachi,ray,rhizomatous,ruit,septum,sessile,short,side,simple,spaced,stalk,straight,strongly,succulent,tal,tamen,tem,thick,unarme,unarmed,unit,vary,vein,weakly,wing,ympodial	abaxial,adaxial,branching,capitate,color,colour,corolla,form,growth,height,history,leaf,life,na,ovary,pubescence,reproduction,seed,shape,size,staman,stem,texture,tip,width
261	wfo-0001027606	success	192	100	75	117	25	0.391	0.2-4,0.3-0.8,0.3-1.2,0.5-0.75,0.5-1,0.7-0.9,1-1.5,1-2,1-2.5,2-4,2-5,2-7,2.5-4,3-4.1,4-6.5,abaxially,acute,anther,apex,base,branched,broadly,brown,calyx,chartaceous,cm,cuneate,deeply,diameter,entire,erect,filament,flattened,flower,fruit,glabrous,globose,grey,inflorescence,leaf,length,lilac,lobe,lobed,long,margin,midpoint,midvein,mm,narrowly,obtuse,occasionally,pale,perennial,petiole,pinkish,pseudo-racemose,pubescence,red,reniform,rhizomatous,rostrate,shrub,simple,stellate,stigma,style,surface,throughout,triangular,tube,unbranched,vein,x,yellow	%,-10,0-0.2,0-1.5,0-4,0.2-0.3,0.2-2.5,0.4-0.5,1,1-5,1-7,1-locular,1.5-2.9,10-19,12-25,2,2-,2-3,2-5.5,3-10,3-4,3-foliate,4-11,5-merou,5.5-7,6-8,6-9,7-10,7-22,9-13,absen,absent,accrescent,acicular,adaxiall,adaxially,adult,alyx,apart,apparen,apparently,articulated,axe,ba,blade,branch,branche,cylindrical,depression,directed,distall,distally,dm,eaf,eed,exocarp,extra-axillary,finger,fruiting,geminat,gland-tipped,green,hair,half,incomplete,index,juicy,juvenile,lamina,lanceolate,less,lobing,longer,lower,markedly,mature,mesocarp,mid-point,minute,nflorescence,oblique,orolla,ovate,pair,part,pedicel,peduncle,per,perfect,placenta,pore,present,prickle,rachi,ruit,scarcely,septum,short,side,spaced,straight,succulent,tal,tamen,tem,thick,thicker,time,truncat,unarme,unarmed,unit,upper,usually,vary,wide,ympodial	branching,color,corolla,form,growth,height,history,lateral,life,midrib,na,ovary,plant,ray,reproduction,seed,shape,size,staman,stellae,stem,stipe,texture,tip,width
262	wfo-0001027607	success	167	110	82	85	28	0.491	.1,.25,.5,0.25-0.5,0.5-1,0.8-1,1,1-4,1.5-3,2-2.5,2-3,2-4,2.5-3,3-3.5,3/4,4-10-flowered,5-10,5-7,acuminate,acute,anther,apex,base,brown,calyx,cm,corolla,curling,dark,decurrent,deltoid,dia,dry,elliptic,filament,glabrous,globose,golden,green,lateral,leaf,like,lobe,lobed,long,main,material,midrib,minute,minutely,mm,narrowly,occasionally,ovary,ovoid-reniform,pair,papillose,petiole,pitted,plant,present,prominent,reddish-brown,short,shrub,simple,stem,stigma,style,surface,tan,tip,treelet,trichome,tube,uniseriate,vein,way,white,winged,x,yellowish	0.5,1.2-1.5,8-9,age,anthesi,apar,arching,area,aspect,ba,bark,basal,becoming,berry,branch,branche,corky,deflexed,densely,eaf,edicel,eed,ellipsoid,elongate,erect,evenly,except,exserted,f,filiform,flattened,free,fruiting,geminate,gently,giving,glabrate,lamina,lenticellat,less,lon,lower,m.,middle,narrow,nflorescence,non-reproductive,obovoid,older,opposite,pagoda-like,pedicel,pore,poricidal,portion,pubescent,raised,rarely,reflexed,ruit,scar,shaped,slender,slight,slightly,small,soon,spaced,straight,strongly,styl,tall,tapering,tear-drop,tub,ud,unifoliate,unit,widened,widening,widest,woody,ympodial,young,zig-zag	branching,color,diameter,flower,form,fruit,growth,height,history,inflorescence,length,life,margin,midpoint,midvein,na,perennial,pubescence,ray,reproduction,seed,shape,size,staman,stellae,stipe,texture,width
263	wfo-0001027613	success	238	120	99	139	21	0.416	.5,0.1-0.6,0.2-1.6,0.5-0.6,0.5-0.7,1-1.7,1.3-1.8,1.5-2,1.5-3,2-2.2,2-2.5,2-3,2-5,2-5.6,2.3-2.6,3-4,3-5,4-5,4-8,4.5-9.5,6-12.5,7-12,9-10.5,abaxially,acute,andromonoecious,anther,apex,attenuate,base,broadly,brown,calyx,campanulate,chartaceous,circular,cm,cordate,corolla,dark,deltate,densely,diameter,filament,flower,fruit,glabrous,gland-tipped,globose,green,hair,herbaceous,inflorescence,lateral,length,lilac,lobe,lobed,long,margin,midpoint,midvein,mm,moderately,nearly,obtuse,ovate,pale,petiole,plant,prostrate,pubescent,purple,ray,reniform,resprouter,rotate,shallowly,short,sparsely,sprawling,stellae,stellate-pubescent,stigma,streak,style,surface,tan,throughout,time,triangular,tube,unbranched,vein,weakly,wide,x,yellow,yellowish-green	%,0-0.1,0.1-0.7,0.3-0.4,0.3-1,0.4-0.5,0.4-1,0.4-1.2,0.4-1.5,0.7-1.5,0.8-1.7,1-1.5,1-10,1-2,1-7,1.2-1.4,1.2-2,10-17,12-15,15-100,15-28,2-7,2-8,2-foliate,2-locular,20-50,3-6,30-100,36-70,4-7,5,5-18,5-6,5-8,5-merou,7-8,80-180,9-17,absen,absent,abundant,accrescent,acicular,across,adaxially,adult,alyx,and/or,anvil-shape,apart,armed,articulated,axe,ba,bitter,blade,branche,capitat,clear,connivent,contiguous,cross-section,curved,cylindrical,decimetre,directed,distall,distally,distributed,eaf,eed,eglandular,exocarp,extra-axillary,finger,flattened,fruiting,functional,geminat,glandular,half,heterostylous,index,inserted,interpetalar,juicy,lamina,less,lobing,lon,lonf,longer,lower,markedly,mature,mesocarp,mid-point,minute,minutely,moist,nflorescence,oblique,orolla,part,pedicel,peduncle,per,placenta,pore,porrect,presen,present,prickle,rachi,reticulate,ruit,sessile,side,simple,somewhat,spaced,stage,stalk,stalked,stellate,straight,tal,tamen,tem,thick,thicker,tissu,tissue,transparent,unit,uvenile,vary,watery,ympodial	branching,color,form,growth,height,history,leaf,life,midrib,na,ovary,pubescence,reproduction,seed,shape,size,staman,stem,texture,tip,width
264	wfo-0001027618	success	202	109	73	129	36	0.361	0.5-1,1-1.5,1-3,1-5,1-9,1.4-4,2-11.5,2-27,2-5,2.5-6,3-30,3-5,5-30,5-7.5,6-40,8-16,acute,apex,base,branched,campanulate,chartaceous,cm,compound,cordate,cuneate,deltate,densely,diameter,ellipsoidal,entire,flower,fruit,fusiform,glabrous,globose,greenish,lateral,leaf,length,lobe,long,margin,membranaceous,minutely,mm,moderately,obtuse,orange,papillose,petiole,pinnately,puberulent,pubescent,pubescent-pilose,purple,reticulate,shrub,simple,stigma,style,tomentose,tree,triangular,truncate,tube,unbranched,urceolate,white,wide,width,x,yellow	-10,-pubescent,0-10,0.5,0.5-6,1,1-,1-13,1-14,1-23,1.5-13,1.5-3,1.5-7,1.5-8.5,11-16,11-22,11-pinnate,12-27,15-30,15-35,2-11,2-12,2-8.5,2-9,3-18,3-7,3-7-pinnate,3.5-6,4,4-8,5-18,5-20,5-merous,5.5-12,6-25,7-25,8-35,abaxially,acuminat,acut,adaxially,aggregate,also,alyx,apart,ape,articulated,ascending,axe,basal,beyond,blade,bud,capitate,cell,connective,cylindrical,darker,dia,diamete,dilated,directed,distally,eaf,eed,elliptic,elliptic-ovate,exceeding,exserted,fleshy,laterally,leaflet,leaving,less,lon,longitudinal,lower,mesocarp,near,nflorescence,nther,oblong,obovate,obtu,often,orolla,ovate,pedicel,pedicellar,peduncle,per,perfec,perfect,petiolule,pilo,pilose,pore,presen,puberulent-pilo,puberulent-pubescent,rachi,radiu,ranch,ratio,remnant,ripe,rown,ruit,runk,shallowly,shorter,slightly,small,sometimes,somewhat,spaced,sparsely,spreading,stamen,stone,stripe,sympodial,tal,terminal,thecae,uni,unit,vary,without	1-8.5,acuminate,anther,branching,calyx,color,corolla,filament,form,growth,height,history,inflorescence,life,midpoint,midrib,midvein,na,ovary,perennial,plant,puberulent-pilose,pubescence,ray,reproduction,seed,shape,size,staman,stellae,stem,stipe,surface,texture,tip,vein
265	wfo-0001027622	success	203	123	97	106	26	0.478	.5,0-14,0.3-10,1-2,12-23,2-6,2.5-3.5,3-4,3-4.5,6-17,6-7,8-16,8-20,abaxially,acuminate,acute,adaxially,along,anther,apex,base,blue,blue-purple,brownish,cell,chartaceous,ciliate,cm,condition,corolla,covering,diameter,drying,especially,filament,flower,forked,fresh,fruit,glabrescent,glabrous,globose,green,green-white,greenish,hair,hair-like,herb,lateral,light,like,lobe,long,make,margin,membranous,middle,midrib,minutely,mm,mottled,mucilaginous,oblique,odd-pinnate,ovate-lanceolate,ovoid,pale,pentagonal,petal,petiole,plant,puberulent,pubescent,purple,rounded,seed,shortly,size,slightly,star,stellate,stem,stigma,striped,style,subglabrous,testal,thick,throughout,tip,truncate,tube,wall,wet,whitish,x,yellow	0-16,1,1-10,1.5-3.5,1.5-4.2,1.6-4.5,1/,2-25,2-3,3-16,3.5-11,4-5,4-9.5,5-11,5-merou,acumen,ag,alyx,apart,apparently,articulated,axe,axillary,berry,blade,borne,broadly,bud,capitat,clavate,connivent,decumben,different,digestion,distal,dorsally,eaf,edge,eed,elliptic,elliptical,end,enzyme,erect,exceeding,except,flat,folded,geminat,generally,glabrou,greatly,half,homostylous,honeycomb-shaped,interjected,lanceolate,leaflet,lengthening,living,lower,narrowly,nflorescence,often,orolla,ovate,pair,pedicel,peduncle,perfect,petiolule,plurifoliate,population,pore,poricidal,proximal,reduced,removed,ruit,seudostipule,singly,slit,sometimes,spaced,specimen,stamen,ste,stolo,straight,subequal,subtending,tall,tamen,tem,terminal,tri-,tuber,typically,unit,unwinged,usually,vary,varying,wide,wing,ympodial	branching,calyx,color,form,growth,height,history,inflorescence,leaf,length,life,midpoint,midvein,na,ovary,perennial,pubescence,ray,reproduction,shape,staman,stellae,stipe,surface,texture,vein
266	wfo-0001027624	success	189	99	76	113	23	0.402	0-3,0.1-0.9,0.3-1,0.5-1.5,1-2,1-3,1.2-2.6,1.3-2.9,2-20,2.4-4.8,3-10,3-11,3-4,4-15.2,4-7,4-8,6-18.5,acumen,anther,brownish,cell,cm,condition,corolla,covering,deep,densely,diameter,drying,entirely,filament,flower,forked,fresh,fruit,glabrous,globose,green,greenish,hair,hair-like,herb,lanceolate,lateral,leaf,light,lobe,long,mm,mottled,odd-pinnate,ovate,ovoid,pentagonal,petiole,plant,pubescent,purple,rotate,seed,short,size,sometimes,stigma,style,testal,thick,tip,tube,usually,wall,white,whitish,wide,x,yellow	0-7,0.4-3,0.8-5.6,1-5,1.1-8.4,1.5-6.6,2-5,2-7,2.9-12,3-5,5-9,5-merou,9-41,abaxially,acuman,acuminate,acute,adaxially,ag,along,alyx,apart,apex,apparently,arranged,articulated,axe,axillary,base,bead,berry,blade,bud,capitat,clavate,connivent,considerably,cuneate,decreasing,decumben,decurrent,digestion,distal,dorsally,eaf,edge,eed,elliptic,enzyme,erect,exceeding,flat,folded,geminat,glabrou,green-white,half,homostylous,honeycomb-shaped,interjected,larger,leaflet,leave,lengthening,like,living,lower,make,middl,moniliform,mucilaginous,multiple,necklace,nflorescence,onto,orbicular,orolla,pair,pedicel,peduncle,perfect,plurifoliate,pore,poricidal,present,rachi,removed,ruit,sessile,seudostipule,slightly,slit,spaced,specimen,stamen,stolon,straight,subtending,tall,tamen,tem,terminal,throughout,toward,tri-,tuber,typically,unit,unwinged,vary,wet,widely,ympodial	abaxial,adaxial,branching,calyx,color,form,growth,height,history,inflorescence,length,life,midrib,na,ovary,perennial,pubescence,reproduction,shape,staman,stem,surface,texture
267	wfo-0001027626	success	152	107	78	74	29	0.513	.3,.5,0.2–0.6,0.5-1,0.5–1,0.7–1,1,1.3–4.5,1.5–2,14–116,2–3,3–4,3–55,4.4–11,4–6,8,9–18,abaxially,acuminate,acute,adaxially,along,anther,apex,base,broadly,calyx,center,chartaceous,cm,color,cordate,coriaceous,diameter,elliptical,entire,filament,fleshy,flower,fruit,glabrous,greenish-white,lanceolate,liana,lobe,long,margin,midvein,mm,moderately,oblique,ovate,pair,petal,petiole,possibly,pubescent,rounded,sand-punctate,scandent,secondary,shortly,shrub,somewhat,sparsely,spindle-shaped,stellate,stigma,style,time,tip,tube,unbranched,unknown,vein,white,wide,x	0.1–0.2,0.7–2.8,1.5–8,13–14,2–49,2–5,3–4.5,3–5,5-merous,5–6,accrescen,alyx,apar,arrangement,axe,berry,blade,c.,capitat,ciliat,clavate,climbing,densely,distant,distichous,distinct,eaf,eed,extra-axillary,frequently,fruiting,glabrou,immature,lamina,leaf-opposed,line,lower,m.,maturity,membranous,minutely,mor,nearly,nflorescence,nternode,orolla,pedicel,peduncle,perfec,pinnate,plurifoliat,pointed,rachi,reflexed,ruit,sand-punctat,scar,seen,side,simple,slender,spaced,ste,tamen,tem,terminal,trichome,truncate,two,unit,vary,venation,wiry-woody,ympodial	branching,corolla,form,growth,height,history,inflorescence,lateral,leaf,length,life,midpoint,midrib,na,ovary,plant,pubescence,ray,reproduction,seed,shape,size,staman,stellae,stem,stipe,surface,texture,width
268	wfo-0001027627	success	245	77	49	196	28	0.2	abaxially,adaxially,base,bifurcate,branched,broadly,brown,chartaceous,cm,densely,diameter,extensively,flattened-reniform,fruit,glabrescent,globose,green,leaf,lighter,long,loosely,minutely,mm,narrowly,near,occasionally,ovate,pitted,pubescence,pubescent,shrub,simple,small,sparsely,stellate,stellate-tomentose,stem,subeaqually,surface,tardily,thick,time,tomentose,tree,unequally,velvety,wide,yellow,×	.1,.5,0.05–0.25,0.1–1,0.3,0.4,0.6–1,0–,1.5,1.5–2,1.5–2.5,1.8–2.5,11–14,12–25,13–17,1–1.5,1–5,2,2.5–4,2–15,2–4,2–5,2–6,3.5,3–3.5,3–6,4–,4–12,5-angled,5-merou,5–7,6–,6–15,7–10,7–15,9,9–13,9–15,abundant,accrescent,across,acuminate,along,alyx,ampliate,anther,apart,apex,apparently,articulated,ascending,axe,ba,band,based,becoming,berry,blade,borne,branch,briefly,broad,bud,c.,calyx,capitat,caudate,central,contiguous,cordate,corolla,dense,difoliate,distal,distally,eaf,eed,entire,erect,evident,except,exposed,extra-axillary,fertile,filament,filiform,flower,flowering,free,geminat,glabrous,grayish,growt,hair,half,high,homostylous,internode,interpetalar,interwoven,juvenile,larger,lateral,lavender,like,line,linear,linear-lanceolate,lobe,longer,lower,major,margin,middle,midpoint,midvein,minor,minute,mostly,much,narrow,nearly,nflorescence,numerous,oblong,obtuse,often,ovary,ovoid,paired,par,pedicel,peduncle,petiole,portion,present,prickle,principal,prominently,purple,ray,recurved,reduced,rounded,ruit,scattered,shallowly,short,shorter,side,single,sinuate,sinus,slender,smaller,sometimes,somewhat,spaced,sparse,splitting,spreading,stalk,stalked,stellae,stellate-pubescent,stellate-tomento,stellate-velvety,stemmed,stigma,stipe,stout,style,tamen,tapering,tawny,thickened,tip,tissue,triangular,trunk,tube,ud,unarmed,usually,vein,violet,visible,weakly,yello,ympodia,young,zone,×1.5–1.7,–2.5,–30,–5	1-1.5,1-5,1.5-1.7,1.8-2.5,12-25,2-2.5,2-6,3-6,4-,7-15,branching,color,form,growth,height,history,inflorescence,length,life,na,perennial,plant,reproduction,seed,shape,size,texture,width
269	wfo-0001027630	success	149	98	73	76	25	0.49	.1,0.05-0.1,0.5-1,0.5-1.2,0.5-2,1-5,1.4-1.7,1.5-2,2-6-flowered,3/4,5.5-11.2,6-10,8-9,acute,anther,anthesi,apex,base,blunt,calyx,ciliate,climbing,cm,corolla,decurrent,erose,extreme,filament,fruit,glabrous,globose,golden,green,hirsute,lanceolate,lateral,leaf,linear,lobe,lobed,long,long-acuminate,margin,midrib,minutely,mm,near,ovary,pair,papillose,petiole,prominent,puberulent,pubescent,reflexed,rounded,shrub,simple,sparsely,stem,stigma,straight,style,tip,trichome,tube,uniseriate,vein,way,white,winged,x,yellowish	.2,.5,1-1.5,2-3,4-6,also,apart,arising,bark,beginning,berry,branchlet,broadly,de,deflexed,deltoid,densely,dia,distinguishable,eaf,edicel,eed,elongat,except,free,fruiting,glabrate,globo,immature,indistinct,inflorescenc,internodal,irregularly,knob-like,known,lon,lower,main,middle,nflorescence,novo,occasionally,older,opposite,paler,partially,pedicel,pore,poricidal,portion,proximal,raised,rest,ruit,scar,seen,shaped,slender,spaced,strongly,swollen,tall,tapering,tear-drop,terminal,thickened,ti,ud,ultimate,unifoliat,unit,wide,widest,wing,ympodial,young	branching,color,diameter,flower,form,growth,height,inflorescence,length,midpoint,midvein,na,plant,pubescence,ray,reproduction,seed,shape,size,staman,stellae,stipe,surface,texture,width
270	wfo-0001027646	success	166	100	71	95	29	0.428	0.15-0.25,0.2-1.1,0.4-0.6,0.6-0.7,1-2,1-3,2-4,2.1-3.2,3.5-4,5-10,6-7,6-8,acuminate,acute,adaxially,anther,apex,base,brown,calyx,chartaceous,cm,cuneate,cylindrical,densely,diameter,entire,erect,flattened,flower,fruit,glabrous,gland-tipped,globose,green,grey,hair,inflorescence,juicy,lateral,length,lobe,long,margin,midrib,midvein,mm,moderately,obtuse,ovate,pale,perennial,petiole,pseudo-umbellate,ray,red,reniform,rhizomatous,short,shrub,solitary,sparsely,stellae,stellate,stellate-pubescent,style,time,unbranched,wide,x,yellow	%,.4,0-0.1,0-0.2,0-1,0-10,0-2,0.1-0.25,0.4-0.5,0.5-0.6,0.7-1.2,0.7-1.5,0.7-2,1,1-6,1-locular,10-18,15-20,2-6,2-foliate,4-11,5-merou,6-13,abaxially,absen,absent,acicular,across,adaxiall,adult,alyx,apart,articulated,axe,ba,blade,branche,confined,directed,distall,dm,eaf,eed,eglandular,extra-axillary,finger,fruiting,functional,geminat,half,incomplete,lamina,less,longer,lower,mature,mesocarp,midpoint,minute,multiradiate,nflorescence,oblique,onl,orolla,part,pedicel,peduncle,per,pore,porrect,present,prickle,probably,ruit,septum,simple,spaced,stage,stalk,straight,succulen,tal,tamen,tem,thick,throughout,transparent,unarme,unarmed,unit,unknow,uvenile,vary,yellowish,ympodial	branching,color,corolla,filament,form,growth,height,history,leaf,life,na,ovary,plant,pubescence,reproduction,seed,shape,size,staman,stem,stigma,stipe,succulent,surface,texture,tip,tube,vein,width
271	wfo-0001027661	success	222	129	113	109	16	0.509	+,0.5-2,0.6-1.1,0.6-1.5,1.2-6,1.3,1.5,1.5-2,2.5-7,4-15,4.5-6,40,5-9,6-12,8-10,acuminate,acute,anther,apex,articulate,base,branch,branched,bright,capitate,cell,cm,cordate,corolla,deeply,dendritic,densely,diameter,ellipsoid,entire,filament,flattened,flower,fruiting,glabrous,globose,green,grey,growth,herbaceous,lateral,leaf,leaf-opposed,like,lobed,long,many,margin,membraneous,minute,minutely,mixture,mm,moderately,often,pale,papillate,pedicel,peduncle,pentagonal,petiole,pinnatifid,pitted,pubescence,pubescent,purple,purplish,red,reniform,ripe,shape,short,simple,size,sleeve,slender,small,sparsely,spreading,stellate,stem,stigma,style,surface,tan,terminal,ternately,testa,time,tip,trichome,truncate,tube,turbinate,two,type,uniseriate,upper,usually,vine,violet,way,white,wide,woody,yellow,yellowish,¾	-10,0.5,0.5-,1-,1-1.5,1-5,1-7,2,2.5-3,30,4-8-celled,5-merou,6-8,6-9,<,>,abaxially,adaxiall,ag,along,alyx,anthesi,apart,ark,axi,basal,berry,broadly,calyx,column,commonly,conical,connivent,creeping,denser,density,eaf,eed,elliptic,even,extremely,free,fused,gre,ground,hue,ilament,irregularly,lamina,leaving,lengthening,lobe,long-exserted,lower,markedly,narrowing,near,new,nflorescence,occasionally,older,open,orolla,outline,ovate,pair,papillat,papillo,peg,per,perfect,pericarp,plurifoliat,pointed,pore,poricidal,portion,primary,prominent,pubescen,rachi,rarely,reflexed,ruit,scar,shiny,single,sinus,slit,spaced,spot,spreadin,strongly,swollen,tangled,tem,thin,tightly,trailing,triangular,ud,underground,unieriate,unit,variable,vary,vein,ympodial,zig-za	0.5-7,abaxial,adaxial,articulation,bark,branching,bud,color,form,fruit,inflorescence,length,ovary,seed,texture,width
272	wfo-0001027714	success	251	131	118	133	13	0.47	+,0.5,1-1.5,1-1.6,1-2,1.5-2,1.5-3,1.5-5,14-16,2-2.5,4-5,4.5-5,5,5-6,6-7,7-20,80,<,abaxial,acuminate,acute,adaxial,almost,anther,apex,basal,base,berry,branched,bright,brown,calyx,capitate,cm,conical,cordate,corky,corolla,cucullate,deep,dendritic,densely,diameter,ellipsoid,elliptic,elongate,entire,filament,flattened,fleshy,flower,fruit,furcate,glabrate,glabrous,globose,growth,inflorescence,juicy,lateral,leaf,lobe,long,many,margin,mere,mm,obovate,occasionally,often,ovary,pair,pale,papillate,pedicel,peduncle,petiole,primary,pubescence,pubescent,purple,red,reddish,reniform,rim,ripe,seed,shiny,simple,slender,slightly,small,somewhat,sparsely,stellate-rotate,stem,stigma,style,surface,tangled,terminal,thick,thin,time,tip,tooth,trichome,truncate,tube,uniseriate,vein,vine,violet,weak,woody,x,yellow,yellowish	.5,/3,0,0.4,0.5-0.7,0.6-0.7,0.9-1.5,1,1-,1.5-2.5,2-,2-8,2.5-,2.5-4,2373.,3-3.5,4-10,5-10,5-merou,abaxially,adaxially,age,aid,along,alyx,angle,anthesi,apar,apice,appearance,ark,around,articulated,axi,canop,cell,channelled,climbin,confined,connected,connivent,creating,cupped,deflexed,denser,drying,eaf,eed,enlarged,especially,exserted,fide,free,fruiting,giving,glabrou,groove,hairy,hanging,ilament,immature,individual,inflated,irregularly,lamina,large,leaving,lengthening,like,lobed,lon,longer,loosely,lower,marginal,mature,minute,minutely,mpodial,nee,new,nflorescence,nodding,older,orolla,otherwise,outline,papillo,peg,per,perfect,pericarp,petal,petiolule,pinnatifid,pitted,plat,plurifoliat,pore,poricidal,portion,prominent,reaching,rectangular,ruit,scar,showy,similar,sleeve,slit,spaced,spreading,strongly,tem,testa,testal,thecae,thickened,third,tiny,twining,ud,uniformly,unit,upper,usually,visible,wall,way,weight,widest,wing,younger	1-8,2-4,2.5-10,bark,branching,color,form,furcation,length,shape,size,texture,width
273	wfo-0001027719	success	172	106	80	92	26	0.465	0-0.15,0-7,0.25-0.6,0.3-0.5,0.3-0.7,0.6-2.8,0.8-1,1-3,1.6-1.9,2-2.3,3-5,3-7.5,4-5,4-6,4.5-12.5,5-6,5-8,acute,adaxially,andromonoecious,anther,apex,attenuate,base,broadly,brown,calyx,chartaceous,cm,cuneate,densely,diameter,entire,flower,fruit,gland-tipped,globose,green,hair,herbaceous,inflorescence,lateral,length,lilac,lobe,lobed,long,margin,mesocarp,midvein,mm,moist,oblique,obtuse,ovate,pale,part,petiole,plant,pseudo-racemose,ray,resprouter,shallowly,short,solitary,sparsely,stellae,stellate,stellate-pubescent,stem,style,thick,time,tube,unbranched,vein,white,wide,x,yellow	%,.25,0-0.2,0-1,0-20,0.15-0.4,0.25-0.4,0.4-1.7,0.6-0.8,0.9-1.1,1-1.5,1-2,1.1-2,10-24,13-20,13-25,3-7,30-70,4-7,5-merou,6-10,6-8,7-11,8-13,abaxially,absent,acicular,across,adaxiall,alyx,apart,armed,articulated,axe,ba,blade,d.,difoliate,directed,distall,distributed,dult,eaf,eed,eglandular,erect,exocarp,extra-axillary,finger,fruiting,functional,geminat,greenish-white,half,heterostylous,hig,juic,lamina,less,longer,lower,mature,mid-point,midpoint,minute,nflorescence,orolla,pedicel,peduncle,per,pore,porrect,presen,present,prickle,ruit,sessile,simple,spaced,sprawling,stage,stalk,straight,strongly,tamen,throughout,unarme,unit,unknow,uvenile,vary,ympodial	branching,color,corolla,filament,form,growth,height,history,juicy,leaf,life,na,ovary,perennial,pubescence,reproduction,seed,shape,size,staman,stigma,stipe,surface,texture,tip,width
274	wfo-0001027720	success	184	108	84	100	24	0.457	0-15,0.25-0.35,0.3-5,0.4-0.8,0.8-1,1-1.5,1-2,1-3.5,1.5-2,13-35,15-25,2-3,2-4,2-7,2-branched,4-5.5,4.3-15,7-8,7-9,acute,adaxially,anther,apex,base,brown,calyx,chartaceous,cm,confined,cuneate,cylindrical,deltate,densely,diameter,elliptic,entire,filament,flattened,flower,fruit,glabrous,globose,hair,inflorescence,lateral,leaf,length,lilac,lobe,long,margin,midpoint,midrib,mm,narrowly,notched,oblique,ovate,pale,part,perennial,petiole,pubescent,ray,red,rhizomatous,shrub,slightly,sparsely,stellae,stellate,stellate-pubescent,stigma,straight,style,subreniform,surface,time,toward,triangular,tube,white,x,yellow	%,.25-0.3,0,0.15-0.25,0.4-0.7,0.5-0.8,0.5-1,0.6-1.2,1-locular,13-23,2-foliate,2.8-3.1,23-35,3-13,4-,4-7,4.3-7.5,5-merous,6,7-10,8-11,8-16,9-15,abaxially,absen,absent,adaxiall,adult,alyx,apparently,articulated,axe,ba,berry,blade,capitat,connivent,directed,distall,distally,eaf,eed,eglandular,erect,extra-axillary,finger,fruiting,geminat,gland-tipped,green,half,hig,homostylous,incomplete,intepetalar,juicy,juvenile,lamina,lanceolate,less,loosely,lower,markedly,mature,mesocarp,mid-point,minute,nflorescence,orolla,pedicel,peduncle,per,perfec,perfect,pore,porrect,present,prickle,rachi,ruit,scarce,septum,sessile,short,simple,succulen,tamen,tem,thick,thicker,tissue,unarme,unarmed,unit,upper,vary,wide,without,yellowi,ympodial	branching,color,corolla,form,growth,height,history,life,midvein,na,ovary,plant,pubescence,reproduction,seed,shape,size,staman,stem,stipe,texture,tip,vein,width
275	wfo-0001027720	success	272	147	107	165	40	0.393	0,2.0,abaxially,acuminate,acute,adaxially,aequilateral,anther,apex,apiculate,attachment,attenuate,base,becoming,brochidodromous,calyx,cancellate,channel,cm,corolla,curved,densely,developed,diameter,dry,elliptic,entire,especially,filament,filiform,flattened-irregular,flattened-orbicular,flattened-reniform,flower,fruit,glabrous,glandular,globose,growth,hair,hooked,interpetalar,juvenile,lateral,lavender,leaf,lobe,long,margin,mature,midrib,midvein,minute,mm,moderately,notched,oblique,oblong,occasionally,often,orange,ovate,per,petiole,point,poorly,porrect,portion,proximal,pubescent,raised,ray,red,sessile,short,shrub,slightly,small,sparsely,stellae,stellate,stellate-pubescent,stem,stigma,straight,style,subacute,subcoriaceous,surface,time,tip,tissue,toward,tree,tube,twice-branched,vein,violet,wavy,way,weakly,white,wide,yellow,yellow-ferruginous,yellow-tan,young	.0,.04,.2,.3,.5,.9,0.1–0.6,0.2–0.4,0.3–0.4,0.7–0.9,0.7–1.1,0.7–1.2,0.8–1.3,0.8–1.9,0.8–2.0,0.9,1.4–1.9,1.5–1.7,1.5–2.0,1.5–2.5,1.5–3.3,1.5–9.0,1.7–1.8,1.7–2.0,1.7–2.5,1.8–2.0,1.9–2.2,1/2,1/3,1/3–1/2,10.0,10.8–18.2,12–16,13.0,19.7–30.0,2.5,2.5–2.8,2.5–2.9,2–3,3.2,3.6,3.7–5.7,3.9,4.0–12.6,4.0–18.0,4–5-merou,5.1–18.6,6.5–9.5,6–8,8.0,8.0–11.9,8.2–10.5,8.5–9.4,9.5–16.0,adnate,alyx,anthesi,apical,apparently,appearing,armed,articulated,axe,ba,berry,bilobed,blade,branch,broad,broad-based,bud,capitate,channeled,colore,concave,congested,conical,connivent,cream,crisped,deciduous,dehiscence,dentate,difoliate,distally,dorsally,eaf,eed,either,emerging,endocarp,erect,exocarp,extra-axillary,fertile,free,geminat,glossy,gradually,heavily,homostylous,inclined,increasing,internode,intersepalar,juic,lamina,large,least,like,line,lon,longer,lower,m.,major,midpoint,minor,narrowly,nearly,nflorescence,orolla,part,pedicel,peduncle,perforate,pore,porrect-stellate,potentially,presumably,prickle,reflexed,rigid,rip,row,ruit,scattered,shorter,side,simple,sinus,soon,splitting,spread,stamen,stellate-pubescen,suture,tall,tamen,tem,thin,translucent,triangular,truncate,two,ud,unarmed,upper,vary,yellow-ferruginou,ympodia,youngest,±equal,×,–4	0.1-0.6,0.2,0.2-0.4,0.3,0.8-1.9,1.4-1.9,1.5-2.5,1.5-3.3,1.5-9.0,1.7-2.5,1.8-2.0,1/3-1/2,19.7-30.0,2-4,3.7-5.7,6-8,6.5-9.5,8.0-11.9,8.5-9.4,9.5-16.0,branching,color,form,height,history,inflorescence,length,life,na,ovary,perennial,plant,pubescence,reproduction,seed,shape,size,staman,texture,width
276	wfo-0001027735	success	166	91	61	105	30	0.367	.7,.75,0-0.1,0.25-0.5,1.3-3.5,1.9-2.2,12-15,2-2.5,2-3.5,2.5-3,3.5-5,4-5,5-5.8,7-10.5,acuminate,acute,anther,apex,attenuate,base,brown,calyx,chartaceous,cm,diameter,flower,fruit,inflorescence,lateral,length,lobe,lobed,long,margin,midvein,mm,obtuse,ovate,pale,perennial,petiole,pinkish,pseudo-racemose,ray,rotate-stellate,shallowly,shrub,sparsely,stellae,stellate,stellate-pubescent,style,throughout,time,tube,unbranched,vein,white,wide,x,yellow	%,0-1,0-4,0-5,0.15-0.2,0.3-0.6,0.4-0.8,0.5-0.8,0.5-3,1,1-2,1.3-1.6,1.7-3.5,10-14,11-17,2-8,20-35,25-50,3-8,30-50,4-6,4-8,5,5-merou,8-11,9-12,abaxially,absent,abundant,acicular,across,adaxially,adult,alyx,apart,armed,articulated,axe,ba,blade,branche,directed,distall,distributed,dm,eaf,eed,eglandular,erect,extra-axillary,finger,fruiting,geminat,glabrou,gland-tipped,globo,green,hair,half,index,lamina,less,lobing,longer,lower,mature,mid-point,midpoint,minute,moderately,nflorescence,oblique,orolla,part,pedicel,peduncle,per,pore,porrect,presen,present,prickle,purpl,rhizomatous,ruit,sessile,short,side,simple,spaced,sparse,stage,stalk,straight,tal,tamen,tem,thick,transparent,unarme,unctional,unit,unknow,uvenile,ympodial	branching,color,corolla,filament,form,glabrous,globose,growth,height,history,leaf,life,midrib,na,ovary,plant,pubescence,purple,reproduction,seed,shape,size,staman,stem,stigma,stipe,surface,texture,tip,width
277	wfo-0001027742	success	239	123	99	140	24	0.414	-8,0-0.2,0.1-0.5,0.4-0.8,0.5-5,0.6-0.8,1-2,1.7-2,2-2.5,2-3,2-5,2-6,3-6,3.5-10,4-6,4-lobed,5-12,7-10,7-9,abaxially,acute,adaxially,annual,anther,apex,attenuate,base,black,broad,broadly,brown,calyx,chartaceous,cm,cordate,densely,depressed,diameter,drying,entire,erect,especially,filament,finally,flower,fruit,glabrous,globose,grey-green,inflorescence,ivory-green,lateral,length,lilac,lobe,lobed,long,margin,midvein,minutely,mm,moderately,obtuse,ovate,ovate-lancelate,pale,perennial,petiole,prostrate,purple,ray,reticulate,rhizomatous,rostrate,rounded,rusty,shallowly,shrub,somewhat,square,stellae,stellate-pentagonal,stellate-pubescent,stem,stigma,style,surface,throughout,time,tip,toward,tube,unbranched,vein,white,wide,yellow,yellowish,yellowish-green	%,-13,-20,-9,0-0.8,0-1.1,0-12,0-3.5,0-9,0.05-0.1,0.1-0.4,0.6-0.9,0.7-0.9,0.8-1.8,1-,1-1.1,1-1.2,1-1.5,1-1.8,1-3,1-4,1-5,1-8,10-18,10-20,2-,2-2.3,2-5.5,2-foliate,2.5-5,200-660,25-55,3-4,3-5,3-9,3.5-9.5,4-locular,5-merou,60-300,7-8,9-14,absent,abundant,accrescent,acicular,adaxiall,alyx,anthesi,anvil-shape,apart,armed,articulated,axe,ba,bent,blade,capitat,cone,connivent,cross-section,curved,cylindrical,decimetr,directed,distall,distally,distributed,dult,eaf,eed,eglandular,enclosing,exceeding,exocarp,extra-axillary,finger,fruiting,geminat,gland-tipped,hair,homostylous,index,interpetalar,juicy,lamina,lanceolate,lobing,lon,longer,loosely,lower,markedly,mature,mesocarp,mid-point,midpoint,minute,moist,nflorescence,oblique,one,orolla,outside,part,pedicel,peduncle,per,perfect,placenta,pore,porrect,presen,present,prickle,pseudo-racemose,rachi,ruit,short,side,simple,slightly,spaced,stage,stalk,stalked,straight,strongly,tal,tamen,thick,thicker,thicknes,tissue,truncate,unit,unknow,uvenile,vary,x,ympodial	2-9.5,branching,color,corolla,form,growth,height,history,leaf,life,midrib,na,ovary,plant,pseudoracemose,pubescence,reproduction,seed,shape,size,staman,stipe,texture,width
278	wfo-0001027757	success	186	114	74	112	40	0.398	0.5,0.7,abaxially,acute,along,anther,apex,base,blue,branching,brown,calyx,campanulate,cm,dark,decurrent,deeply,diameter,elliptic,erect,filament,flattened,flower,fruit,glabrous,globose,hair,irregularly,lanceolate,leaf,lilac,lobe,lobed,long,margin,mm,moderately,multicellular,narrowly,oblong,obtuse,occasionally,ovate,pale,perennial,petiole,pitted,pubescent,regularly,rotate,shrub,simple,sparsely,stigma,style,surface,time,tip,toward,tube,unbranched,unicellular,uniseriate,unknown,violet,white,wide,x,yellow,–2.7,–3.2,–4.0,–5.5,–9	0.2,0.2–0.3,0.3–2.0,0.6,0.6–1.0,0–1.4,1.0–1.1,1.0–2.5,1.2–4.0,1.5–1.6,1.5–2.5,1.6–2.4,1.9–2.7,12,1–1.5,1–11,1–2,1–3,2,2.5,2.5–4,2.5–5.5,2.5–7,2–,2–10,3–12,3–5,4–9,5,5–,60–100,6–9,7–8,8–16,absen,accrescent,adaxiall,adaxially,ag,anthesi,apart,apical,arising,articulated,axe,axillary,ba,basal,blade,borne,cell,chartaceous,clavate,colour,concave,connivent,convex,cylindrical,densely,directed,distally,eaf,eed,entire,equal,erose,fleshy,geminat,glabrescen,glabrou,leafy,lon,longitudinal,lower,m.,nflorescence,often,opening,opposed,orolla,pair,pedicel,peduncle,perfect,plurifoliate,pore,poricidal,primary,probably,rootstock,ruit,secondary,serrate,shoot,side,slit,smaller,sometimes,spaced,stone,straight,tall,tamen,tem,thic,thickened,unit,vary,woody,ympodial,–19,–6	0-1.4,0.2-0.3,0.3-2.0,1-1.5,1-11,1-2,1-3,1.0-1.1,1.0-2.5,1.2-4.0,1.5-1.6,1.5-2.5,1.9-2.7,2.5-5.5,2.5-7,4-9,5-7-8,6-9,60-100,color,corolla,form,growth,height,history,inflorescence,length,life,midrib,na,ovary,plant,pubescence,seed,shape,size,staman,stem,texture,width
279	wfo-0001027765	success	167	90	73	94	17	0.437	-30,-44,0.8,1,1-11.5,1-4,1.5-6,10-13,2-2.5,2-3,2-4,2.5-4.2,20-30,3-12,3-20,5-15,5-6,5-8,abaxial,abaxially,branched,calyx,cm,corolla,cyme,diameter,dichasial,dichasially,distal,ebracteate,flower,forked,generally,glandular,globose,green,green-white,hair,half,herbaceous,interjected,lateral,leaf,leaflet,light,lobe,long,mm,monochasial,odd-pinnate,ovoid,pair,pedicel,peduncle,perennial,petiole,pilose,plant,seed,side,simple,size,stellate,stigma,style,terminal,throughout,tip,tone,violet,white,wide,yellow	-4,0-.,1-,1-10,1-2,1-5,2.5-4,3-,3-6-foliat,5,7-20,abruptly,acumen,acuminate,acute,apex,apical,apically,apiculate,articulate,base,cell,connate,cordate,covering,cuneate,dehiscent,digestion,diminishing,dorsally,eaf,edge,eed,elliptic,elliptic-lanceolate,emoval,enzyme,exceeding,filament,flat,folded,globo,hair-like,honeycomb,introrse,living,lon,lower,lunat,make,maturing,mucilaginous,nflorescence,nther,oblique,obtuse,often,orolla,ovate,ovate-elliptic,ovate-lanceolate,pattern,perfect,petiolate,petiolule,plan,poricidally,proximal,reveal,rounded,ruit,sessile,seudostipule,short,slightly,slit,specimen,stamen,straight,tal,tem,testal,thick,throughou,toward,truncate,tuber-bearing,typically,unit,vary,wall,without,ympodial,¼	0-2,anther,color,form,fruit,growth,height,history,inflorescence,length,life,na,ovary,reproduction,shape,stem,texture
280	wfo-0001027767	success	184	105	76	108	29	0.413	1,1-1.5,1.0-2,1.5-1.8,1.5-2,10-20,2-2.5,3,3-6-branched,3.5-5,30-many-flowered,4-5,5-6,5-8,acute,anther,apex,attenuate,base,beige,brown,calyx,cm,coriaceous,cyme,dark,deeply,diameter,entire,equal,ferruginous,filament,flower,fruit,glabrous,glandular-stalked,globose,helicoid,hirsute-glandular,irregularly,lanuginose,leaf,lobe,lobed,long,midrib,mm,oblanceolate,oblong-lanceolate,oval-elliptic,parted,persistently,petiole,plant,prominent,pubescent,ray,reniform,shrub,stellate,stem,stigma,style,subcoriaceous,subreniform,thick,trichome,tube,vein,villous,viscid-glandular,viscid-villous,white,wide,within,yellowish	0.3-0.5,1-2,10-12,15-25,2-3,2.6-3,4-many-celled,5-7,5-merous,7-8,8-9,abaxial,accrescent,across,along,alyx,anthesi,armed,articulate,attenuat,bicolorous,blade,branch,campanulate,central,clavate,curved,dark-green,distal,eaf,eed,enlarged,epicarp,erect-branched,exceeding,floral,free,fruiting,geminat,glandular,glandular-stalke,glandular-stellate,gynoeci,indument,long-exserted,longer,lower,many-celled,minutely,multiangulate,nflorescence,numerous,orolla,papillo,part,pedicel,peduncl,peduncle,pendent,perennia,perfect,persistent,plurifoliate,porrect-stellate,prickle,primary,rachi,ranch,recurved,reduced,reflexed,rugose,ruit,secondary,sessile,shiny,short,similar,small,solitary,somewhat,sparse,sparsely,stalked,stamen,staminate,straight,sub-conic,sub-globose,sub-sessile,sub-truncate,surfac,surrounded,tall,tamen,terete,terminal,tomentose,unarmed,uniseriate,unit,vary,winged,withi,without,yellow,ympodial,young	branching,color,corolla,form,growth,height,history,inflorescence,lateral,length,life,margin,midpoint,midvein,na,ovary,perennial,pubescence,reproduction,seed,shape,size,staman,stellae,stipe,surface,texture,tip,width
281	wfo-0001027768	success	214	67	52	162	15	0.243	0-0.1,0.1-0.3,0.1-0.4,0.15-0.25,0.15-0.3,0.3-1.5,0.5-3.4,1.2-1.4,2-2.5,2.9-3.7,black,brown,chartaceous,cm,dark,densely,diameter,elliptical,flattened,fruit,glabrous,globose,green,grey,inflorescence,leaf,length,margin,minutely,mm,nearly,pale,pear-shaped,perennial,petiole,reticulate,rhizomatous,sessile,shrub,smooth,sparsely,stellae,stellate-pubescent,streak,subcoriaceous,surface,toward,turning,unbranched,white,x,yellow	%,.5,0,0-0.2,0-0.3,0-2,0.2-0.3,0.25-1,0.3-0.6,0.3-0.7,0.5-1.5,0.6-0.9,0.6-1.5,1,1-2,1-2.5,1.2-1.8,1.2-3.4,1.5-2,1.7-2.6,10-15,11-14,15-50,18-35,2-7,2-locular,3,3-15,3-4.5,4-,4-5,5-7,5-merou,6-12,6-15,6-6.5,7-10,8-10,8-12,8-16,abaxiallly,abaxially,absent,accrescent,acicular,across,adaxiall,adaxially,adult,alyx,anther,apart,apex,articulated,attenuate,axe,ba,base,blade,branchlet,calyx,capitat,confined,connivent,contiguous,cuneate,curved,cylindrical,deltate,difoliate,directed,distall,distributed,dm,eaf,eed,eglandular,entire,erect,exocarp,filament,finger,flower,fruiting,geminat,gland-tipped,greenish-white,grey-green,hair,half,hig,juicy,juvenile,lamina,lanceolate,lateral,leaf-opposed,less,light,lobe,long,longer,loosely,lower,mature,mesocarp,mid-point,midpoint,midrib,midvein,minute,moist,narrowly,nflorescence,oblique,obtuse,orolla,part,pedicel,peduncle,per,perfect,placenta,pore,porrect,present,prickle,pseudo-racemose,pubescent,purple,rachi,ray,reddish,ruit,semi-circula,short,simple,solitary,somewhat,spaced,spongy,sprawling,stellate,stigma,straight,style,tamen,tem,thick,throughout,time,triangular,tube,unarme,unarmed,unit,vary,violet,wide,winged,yellowish,ympodial	branching,color,form,growth,height,history,life,plant,pubescence,reproduction,seed,shape,size,stem,texture
282	wfo-0001027770	success	242	112	91	151	21	0.376	0.1-0.3,0.15,0.2-2,0.3,0.6-1.2,1-2,1.5,12,2,2-3,2-4,2.5-3,3,3-4,3-5,3-6,4,4-8,6,6-10,7-15,abaxially,adaxially,anther,apex,base,berry,branching,calyx,cm,cuneate,cuspidate,dark,deltate,densely,diameter,elliptic,entire,filament,flattened,flower,fruit,glabrous,herbaceous,lateral,leaf,length,lobe,lobed,long,longer,margin,maturity,midpoint,midvein,mm,mostly,narrowly,obtuse,orange,orange-brown,pale,petiole,plant,porrect,pubescent,ray,reniform,rounded,sessile,shallowly,smooth,spherical,stellate,stellate-pubescent,stem,stigma,style,subsessile,surface,thin,time,tip,trichome,tube,vein,violet,white,wide,woody,yellow	0-45°,0.1-0.15,0.3-2,0.5,0.5-1,0.5-2,0.8-1.5,0.8-2.5,1-2.5,1-3,1-5,1.5-2,1/2-1/6,10-14,12-14,16,2-6,2/3,20,4-6,4-7,5-30,5-merous,50,7,9,acute,ag,almost,alyx,anthesi,apart,apically,apparently,armed,articulated,bark,blade,brown,c.,clavate,concolorous,dense,difoliate,dilated,distance,drying,eaf,eed,elongating,equal,erect,extending,eye,filiform,flat,free,fruiting,geminat,globose,gray,green,horizontal,infructescence,irregular,lanceolate,lengthening,less,like,lon,lower,markedly,mature,naked,nflorescence,oblique,obscured,often,older,orolla,oung,ovate,ovoid,pair,papillate,papillo,pedicel,peduncle,pendulous,per,perfect,pericarp,pore,poricidal,portion,present,prickle,prickly,primary,prominent,pubescenc,raised,rare,rarely,red,reduced,reduced-multangulat,reflexed,ruit,scar,short-styled,side,simple,slightly,small,sometimes,somewhat,spaced,sparse,sparsely,spreading,stalk,staminat,stolon,straight,stump,tall,tamen,tapering,terete,terminal,tertiary,throughout,toward,unarme,unarmed,underground,uniform,unit,usually,variously,vary,venation,visibl,visible,way,white-green,yellow-green,ympodial,young,½	20-50,color,corolla,form,growth,height,history,inflorescence,life,midrib,na,ovary,pubescence,reproduction,seed,shape,size,staman,stellae,texture,width
283	wfo-0001027807	success	116	84	49	67	35	0.422	0.1-1,0.2-0.3,0.2-0.9,0.3-0.4,0.9-1,0.9-2.5,2-5,2-6,3.5-9,acuminate,acute,apex,attenuate,base,brown,cm,diameter,dry,elliptic,flattened,flower,glabrous,globose,grayish,green,growth,lanceolate,leaf,margin,material,midrib,minutely,mm,narrowly,petiole,pitted,reddish,reniform,revolute,shrub,simple,slightly,small,stem,surface,tree,vein,winged,x	.5,0-0.2,1-1.5,15-30,abaxially,adaxially,almost,barely,bark,berry,brittle,bud,closely,decurrent,deflexe,deflexed,difoliate,drying,eaf,eed,ellipti,fruiting,geminat,gray,internodal,know,known,leaf-opposed,maturity,new,nflorescence,occasionally,older,ot,overlapping,pair,pale,paler,papillae,papillate,parallel,pedicel,peduncle,plane,primary,prominent,rachi,reddi,reproductive,ruit,scar,seemingly,shoot,slender,somewhat,spaced,sparsely,thickened,ud,unifoliate,unit,usually,visible,white,yellowish,ympodial,young	anther,branching,calyx,color,corolla,filament,form,fruit,height,history,inflorescence,lateral,length,life,lobe,midpoint,midvein,na,ovary,plant,pubescence,ray,reproduction,seed,shape,size,staman,stellae,stigma,stipe,style,texture,tip,tube,width
284	wfo-0001027808	success	178	92	67	111	25	0.376	.5,.7,0.2-0.3,0.2-0.35,0.5-1,0.5-3,1-2,1.6-3,1.9-2.4,2.5-3.5,5-7.5,5.5-6.5,7-10,7-8,8-12,acuminate,acute,andromonoecious,anther,apex,base,broadly,brown,calyx,chartaceous,cm,cuneate,deltate,densely,diameter,flower,fruit,globose,inflorescence,lateral,lavender,length,lobe,lobed,long,margin,midpoint,midvein,mm,ovate,pale,perennial,petiole,plant,pseudo-racemose,ray,rostrate,shallowly,sparsely,stellae,stellate,stellate-pubescent,stigma,style,throughout,time,tube,unbranched,vein,vine,x,yellow	%,.2,0-0.1,0-7,0.05-0.2,0.25-0.35,0.3-0.6,0.4-0.8,0.4-1,0.5-0.6,0.6-1.2,0.6-1.4,1,1-1.3,1.1-1.3,1.4-1.8,12-18,15-30,2-4,2-foliate,2.5-4,20-30,23-28,3-11,40-120,5-7,5-merou,6-8,70-90,9-14,abaxially,absent,acicular,across,adaxiall,adaxially,alyx,apart,armed,articulated,axe,ba,blade,broad-based,capitat,curved,d.,directed,distall,distributed,eaf,eed,eglandular,extra-axillary,finger,fruiting,functional,geminat,gland-tipped,green,hair,half,heterostylous,index,lamina,less,lobing,longer,lower,mature,mid-point,minute,nflorescence,oblique,orang,orolla,part,pedicel,peduncle,per,pore,porrect,presen,present,prickle,purple,ruit,sessile,short,side,simple,spaced,sprawling,stage,stalk,straight,tal,tamen,tem,thick,unarme,unarmed,unit,unknow,uvenile,vary,weakly,white,wide,yellowish,ympodial	branching,color,corolla,filament,form,growth,height,history,leaf,life,na,orange,ovary,pubescence,reproduction,seed,shape,size,staman,stem,stipe,surface,texture,tip,width
285	wfo-0001027816	success	187	122	97	90	25	0.519	.5,0.2,0.5-1,0.5-2,0.6-0.8,0.7-1,1,1-1.5,1.5-2,1.8-6,2-4,2/3,3-3.5,3.5-4,4-5,5-30,6-9,<,acuminate,acute,along,anther,apex,attenuate,base,berry,bluish,branched,brown,calyx,cell,cm,corolla,dark,densely,diameter,entire,filament,flattened,fleshy,flower,glabrous,glandular,globose,growth,half,inflorescence,lanceolate,lateral,leaf,less,like,linear,lobe,lobed,lower,margin,minutely,mm,occasionally,orange,pair,petiole,pitted,plant,pubescent,purple,rectangular,reddish,reniform,ripe,several,shiny,shrub,simple,slightly,small,sparsely,square,stellate,stem,stigma,style,surface,testal,thin,time,tip,triangular,trichome,tube,uniformly,uniseriate,vein,way,x,½	..,0.5,1-1,1-3,1-4,1.2-2,12-14,2-2.5,5-merou,ag,almost,alyx,anthesi,apar,ark,articulated,axi,becoming,capitate,confined,conical,connivent,cupped,dense,drying,eaf,eed,ellipsoid,em,erect,exserted,filiform,free,fruiting,gland-tipped,ilament,irregularly,leaving,lengthening,loosely,m.,markedly,minute,new,nflorescence,nodding,often,older,orolla,papillo,patent,pedicel,peduncle,peg,per,perfect,perhaps,pericarp,plurifoliat,pore,poricidal,portion,primary,prominen,pubescen,red,rounded,ruit,scar,sleeve,slit,sometimes,somewhat,spaced,sparse,spreadin,spreading,terminal,twinin,ud,ultimate,unit,upper,usually,variable,vary,viscous,woody,yellowish,ympodial	branching,color,form,fruit,height,history,length,life,midpoint,midrib,midvein,na,ovary,perennial,pubescence,ray,reproduction,seed,shape,size,staman,stellae,stipe,texture,width
286	wfo-0001027819	success	199	107	82	117	25	0.412	-100,0.5-1,1-2,10-20,10-50,12-21,16-25,2-15,2-3,20-35,20-40,22-35,3-40,3-5,4-10,4-5,5-6,8-10,9-12,abaxially,acute,adaxially,apex,base,branched,cm,color,cordate,cuneate,densely,diameter,ellipsoidal,entire,especially,fading,finely,flower,forked,fruit,glabrous,globose,green,leaf,length,lobe,lobed,long,margin,midrib,mm,moderately,narrowly,oblong,occasionally,pedicel,peduncle,perfect,petiole,probably,puberulent,purple,purplish,rachi,rarely,rugose,simple,sparsely,stellate,stigma,style,subcoriaceous,tree,tube,unbranched,unknown,unlobed,villous,whitish,wide,x,yellow,young	1,1-,1-5,1.5-2,15-22,2,2-,20-25,25-35,3-5-lobed,4,4-15,4-25,5,5-merous,aggregate,also,alyx,apart,ape,apical,apiculat,articulated,axe,ba,basal,beyond,blade,cell,ciliate,concave,connective,cylindrical,deeply,denser,dia,diamete,dilated,directed,distally,divided,eaf,eed,eglandular,eglandular-pilose,elliptic,elliptic-ovate,equal,exceeding,except,exserted,fleshy,hair,halfway,leaving,lon,lower,main,mesocarp,narrow,near,nflorescence,nther,oblique,obtu,obtuse,often,orolla,ovate,pedicellar,per,perfec,pilose,pinnately,pore,present,prominent,protuberance,puberulen,puberulence,radiu,ranch,ratio,remnant,ripe,rounded,rown,ruit,runk,shallowly,short-acuminat,shorter,sinus,slightly,small,sometimes,spaced,stamen,stone,strongly,swelling,sympodial,tal,thecae,toward,triangular,truncate,two,ud,umbrella-shaped,uni,unit,usually,vary,vein,width,without	abaxial,adaxial,anther,branch,branching,calyx,corolla,form,growth,height,history,inflorescence,life,na,ovary,perennial,plant,pubescence,reproduction,seed,shape,short-acuminate,size,surface,texture
287	wfo-0001027829	success	197	105	86	111	19	0.437	0.1-0.8,0.5,0.6-0.7,0.7,1-,1-1.5,1.5-2,1.7-2,12,3-7,30,4-6,5,5-18,5.5-6,6-6.5,abaxially,acuminate,acute,anther,apex,base,black,bright,calyx,cm,conical,corolla,dense,densely,diameter,elliptic,elongate,entire,equal,evenly,filament,flattened,flower,glabrous,globose,growth,inflorescence,lateral,length,lobe,margin,midpoint,midrib,midvein,minutely,mm,narrowly,nearly,oblique,orange,ovary,pale,petiole,pitted,pointed,pubescence,pubescent,ray,reniform,shiny,shorter,shrub,simple,small,sparsely,stellate,stem,stigma,style,surface,tan,thin,tip,tree,truncate,tube,vein,white,x,yellowish	.1,.5,0.6-0.9,0.7-0.8,1,1-3,1.5,1.5-2.5,1/3,10-20,2,20-31,5-8,8-10,adaxially,along,anthesi,apar,armed,articulated,axi,bark,beneath,bent,berry,brown,cell,clavate,commonly,denser,directed,distally,drying,eaf,eed,enmeshing,erect,exceeding,exserted,filiform,free,fruiting,glabrescen,gland-tipped,hang,larger,like,lobed,long,lower,minute,mixed,mixture,multicellular,new,nflorescence,nodding,often,older,one,open,pair,papillat,pedicel,peduncle,per,perfect,pericarp,plurifoliat,pore,porect,poricidal,porrect,portion,prickle,primary,prominent,rectangular,reddish,reflexed,regular,ripe,ruit,scar,scattered,sessile,sharply,short,short-stalked,side,sinuate,somewhat,spaced,straight,strongly,tangled,tapering,testal,time,triangular,trichome,twice,ud,un,unarmed,unit,upper,usually,weak,within,ympodial	branching,color,form,fruit,height,history,leaf,life,na,perennial,plant,reproduction,seed,shape,size,staman,stellae,texture,width
288	wfo-0001027834	success	236	119	98	138	21	0.415	-6.1,0-110,0.2-0.3,0.9-1.8,1-1.6,1-1.9,1-10,1.1-1.6,1.1-1.8,1.4-2,1.8-4.9,10-25,2-3.8,2-8,2.2-4.3,2.3-3.4,25,3-15,4-5.2,4.8-6.9,5-20,abaxial,acuminate,acute,adaxial,anther,apex,attenuate,base,branched,branching,brown,calyx,cm,corolla,deltoid,diameter,discolorous,drying,entire,filament,finely,flower,fruit,glabrous,globose,granular-tomentose,gray,leaf,lenticular,light,lobe,many,margin,mm,obovate,obtuse,orbicular,ovate,ovate-elliptic,ovate-lanceolate,persistent,petiole,pubescence,rarely,reticulate-punctate,ripe,rounded,scabridulous,semi-ovate,short,shrub,small,soft,sometimes,sparsely,stellate,stellate-pubescent,stem,stigma,style,subcoriaceous,surface,time,tip,tomentose,tomentum,tree,tube,velutinous-tomentose,white,whitish,whitish-tomentose,x,yellow,yellowish,yellowish-tan,yellowish-tomentose	.5-3,0.2-0.4,0.2-0.6,0.4-1.1,0.5-2,1-2.5,1.6-2.7,1/2,2.4-6.2,2.7-7.3,2.9-4.2,3-4.3,4-6,5-merous,5.1-8,6.9-18.1,9-11.9,9-13,abaxially,absent,accrescent,adaxially,ag,alyx,angled,anthesi,apar,apical,around,articulated,axillary,ba,bark,becoming,berry,blade,blunt-tipped,branch,bud,capitat,closely,completely,concentrated,connivent,coriaceous,covering,crown,cylindrical,dendritic-echinoi,dendritic-echinoid,densely,dichasia,directed,distally,eaf,echinoi,echinoid,edge,eed,ellipsoid,enclosing,enveloping,equal,erec,exserted,farinose,flat-topped,fleshy,forming,fruiting,glabrescent,grooved,hair,high,included,inserted,lengthening,less,lobed,long,long-stalked,longitudinal,longitudinally,lower,mostly,multangulat,multangulate,near,nflorescence,numerous,obscured,older,orolla,pair,pedicel,peduncle,perfec,plurifoliate,pore,poricidal,porrect-stellate,primary,pseudo-terminal,pubescent,rachi,ray,ruit,runk,scar,semi-spherical,sessile,short-stalked,simple,slit,somewhat,spaced,spreading,stalked,stamen,subcampanulate,suture,tamen,though,tomentu,toward,trichome,turbinoid,ud,unarme,unit,usually,vary,vein,villous,way,wide,ympodial,young	color,form,growth,height,history,inflorescence,length,life,midrib,na,ovary,perennial,plant,pseudoterminally,reproduction,seed,shape,size,staman,texture,width
289	wfo-0001027843	success	154	82	60	94	22	0.39	.5,0.5-0.75,0.5-1,0.8-3.5,1-1.2,1-1.3,1-1.5,2-2.5,3-15-flowered,3-6,5-6,6-13,6-9,along,anther,apiculate,base,beneath,calyx,cm,corolla,deltoid,densely,denser,dia,filament,flower,glabrous,globose,green,lamina,leaf,lobe,lobed,long,minutely,mm,nearly,ovary,ovate,papillose,petiole,pubescent,shape,shrub,simple,size,slender,sparsely,stem,stigma,style,surface,tip,trichome,tube,uniseriate,vein,white,x	.75,/3,1.2-1.5,1.2-2.5,2-4,acute,anthesi,apart,apex,ba,bark,bearing,becoming,beginning,berry,broadly,clavate,conical,coroll,curly,deflexed,differing,difoliate,distally,eaf,edicel,eed,ellipsoid,erose,exsertion,free,fruiting,geminat,glabrate,hairy,impressed,irregularly,known,larger,later,lateral,like,lon,long-acuminate,lower,main,major,margin,middle,minor,near,nflorescence,occasionally,older,one,opposite,orbicular,pair,papillo,pedicel,pleated,pore,poricidal,portion,prominent,proximal,reddish-gre,reflexed,rounded,ruit,scar,shaped,sinus,slightly,somewhat,spaced,sparser,stiff,straight,strongly,tall,tapering,tear-drop,time,tipped,two,ud,unit,way,widest,winged,woody,ympodial,young	branching,color,diameter,form,fruit,growth,height,history,inflorescence,length,life,midrib,na,perennial,plant,pubescence,reddish-grey,reproduction,seed,staman,texture,width
290	wfo-0001027847	success	219	119	94	125	25	0.429	-4,-5,-6,0.1-0.4,0.4-1,0.8-0.9,0.8-1.2,1-2,1-2.5,1.5-2.5,1.9-2.3,1/4,2-2.8,2-5,2.2-3,2.5-3.5,3-6,5.5-8,6-8,abaxially,acute,almost,anther,apex,apically,base,berry,branched,calyx,chartaceous,cm,cordate,deltate,densely,diameter,dull,elliptic,erect,evenly,filament,finely,flattened-reniform,flower,fruit,glabrous,gray,green,lateral,leaf,length,lobe,lobed,long,lower,margin,maturity,mauve,middle,midpoint,midvein,mm,moderately,orange,orange-brown,ovate,petiole,pitted,purple,ray,red,red-brown,rounded,scandent,seed,shrub,size,smooth,sometimes,sparsely,spherical,spreading,stellate,stellate-pubescent,stem,style,surface,tip,tube,upper,vein,white,wide,yellow,young	-0.8,-2,-2.5,-3,.35,.7,/2,/3,0,0-2,0-7,0.15-0.2,0.2,0.5,0.5-1,0.8,1,1.5-2,1.5-5,1/2,1/6-1/3,2-3,2-4,2/,3-15,3-5,3.5-6,4-5-merous,5-25,5-6,6-11,7-10,alyx,ame,apar,apart,apparently,articulated,bark,blade,broadly,brow,c.,connivent,curved,dimorphic,discolorous,distance,drying,eaf,edge,eed,elongating,equal,extending,faint,filiform,filiform-acuminat,flattened,free,fruiting,geminate,glabrescent,increasing,infructescence,lon,longer,mature,minor,narrow-deltate,nflorescence,older,one,open,orbicular,orolla,oung,pair,pedicel,peduncle,pendulous,per,perfec,pericarp,perpendicular,pit,plurifoliat,poricidal,porrect,portion,prickl,prickle,prickly,primary,reddish,retrorse,ruit,scar,sessile,side,simple,slender,spaced,stalk,stalked,straight,strongly,tamen,tapering,terete,terminal,tertiary,time,toward,trichome,unarmed,unit,usually,variously,vary,venation,visible,way,weakly,ympodial	2/3,branching,color,corolla,filiform-acuminate,form,growth,height,history,inflorescence,life,midrib,na,ovary,perennial,plant,pubescence,reproduction,shape,staman,stellae,stigma,stipe,texture,width
291	wfo-0001027850	success	221	133	117	104	16	0.529	-10,-22,-4,-5,0.2-0.5,0.5-1,1,1-1.5,1-2,1-3,1-4,1.5-2,2-2.5,2-5,2.5-3,3-4,3-6,3.5-13,4-5,4-6,6-7,7-18,8-10,>,acuminate,acute,adult,almost,anther,apex,basal,base,berry,blue,branched,brown,calyx,charataceous,cm,coriaceous,corolla,dark,diameter,elliptic,entire,filament,flattened,flower,foliaceous,glandular,globose,green,growth,hirsute,inflorescence,juvenile,laxly,length,like,linear,lobe,lobed,lobed-angulate,long-styled,margin,mature,minute,mixture,mm,oblong,oblong-lanceolate,obovate,ornamented,ovary,ovate-lanceolate,petiole,plant,porrect,prominent,pubescence,purple,reddish,reniform,reticulate,rounded,rugose,rusty,rusty-pubescent,sagittate,scabrous,sessile,short-styled,shrub,simple,single,sparse,stellate,stellate-apiculate,stem,stigma,style,subreniform,subsessile,surface,tapered,tip,tomentose,triangular-lanceolate,trichome,tube,velutinous,whitish,woody,x,yellow,yellowish,¼	-6,0.3-0.35,0.6-1,1-multicellular,2-3,2-4,2-6,3-7,50,6-10,<,abaxially,adaxially,angled,anthesi,apart,armed,articulated,bark,brow,caly,cell,channelled,clavate,curved,discolorous,distal,dry,eaf,eed,eglandular,enclosed,erect,expanding,flowering,free,fruiting,glabrescent,glabrous,heterostylous,impressed,internodal,leaving,lengthening,long,longer,loosely,lower,material,midpoint,minutely,mixed,multicellular,new,nflorescence,obliqu,obverse,occasionally,older,one,papillo,partially,pedicel,peduncle,per,perfect,pericarp,persistent,plurifoliat,pore,poricidal,portion,prickle,prickly,pubescent,raised,reduced,reflexed,rest,ruit,scandent,scar,slightly,slit,spaced,sparsely,stalked,staminate,straight,strongly,subglobose,subtruncate,tall,testa,time,turbinate,ud,unevenly,unit,upper,vein,venation,wood,ympodial	abaxial,adaxial,branching,color,colour,form,fruit,height,leaf,midrib,midvein,seed,shape,size,staman,texture
292	wfo-0001027864	success	222	127	102	120	25	0.459	0-0.1,0-2,0.1-0.4,0.25-0.5,0.4-0.7,0.4-1.4,0.5-0.7,0.7-0.9,0.7-1.4,1-2,1-3,1-3.5,1.2-1.5,1.5-8,2-3,2.5-3,3-10,3-4.2,3-5.5,3-6,3.5-5,3.8-14,6-12,6-7,abaxially,acute,adaxially,anther,apex,attenuate,base,brown,calyx,chartaceous,cm,cuneate,deltate,densely,diameter,ellipsoidal,entire,filament,finely,flower,fruit,glabrous,globose,green,grey,grey-green,hair,herbaceous,inflorescence,interpetalar,lanceolate,lateral,length,lilac,linear,lobe,lobed,long,margin,mm,moderately,nearly,oblique,obtuse,pale,part,petiole,porrect,pseudo-racemose,purple,ray,reniform,resprouter,reticulate,rostrate,rusty-brown,scattered,shallowly,smooth,stellae,stellate,stellate-pubescent,stem,stigma,style,surface,throughout,time,tip,tissue,tube,unbranched,white,wide,x,yellow,yellowish,yellowish-green	%,0-0.2,0-100,0-3,0.05-0.4,0.3-1,0.5-0.8,0.5-1,0.6-0.7,0.7-1,0.9-1.1,1-1.1,1-1.3,1-1.5,1-4,1.4-4,13-20,2-foliate,2-locular,3-4,3-5,4,4-,5-9,5-merou,6-8,6-9,7-10,7-20,8-12,8-13,8-14,absen,absent,abundant,accrescent,acicular,alyx,anvil-shape,apart,articulated,axe,ba,blade,broad-based,capitat,connivent,cross-section,curved,cylindrical,decimetr,deflexed,directed,distall,distributed,dult,eaf,eed,eglandular,erect,exocarp,extra-axillary,finger,flattened,fruiting,geminate,gland-tipped,half,homostylous,index,juicy,lamina,less,lobing,lon,longer,loosely,lower,mature,mesocarp,mid-point,midpoint,minute,moist,nflorescence,oblong,orolla,pedicel,peduncle,per,perfect,placenta,pore,present,prickle,rachi,ridged,ruit,sessile,short,side,simple,slightly,spaced,sprawling,stage,stalk,stalked,straight,tal,tamen,tapered,terete,thick,tissu,unarmed,unit,uvenile,vary,ympodial	branching,color,corolla,form,growth,height,history,leaf,life,midrib,midvein,na,ovary,perennial,plant,pubescence,reproduction,seed,shape,size,staman,stipe,texture,vein,width
293	wfo-0001027872	success	190	127	92	98	35	0.484	0.5,1,1-1.2,1-4,1.0-1.3,10,12-35,15,2,2-3,2.2-3.5,2.8,35,5-7,5-8,8-11,abaxially,acumen,acuminate,acute,adaxially,apex,apiculate,b,base,branched,ca,calyx,caudate,cm,commonly,cordate,cuneate,cyme,deep,densely,diameter,dichasial,dichasially,distal,ebracteate,externally,filament,flower,forked,generally,glabrescent,gland,glandular,glandular-pubescent,globose,gray-green,green,green-white,half,herbaceous,homogeneously,lateral,light,lobe,long,mm,moderately,monochasial,mottled,mucilaginous,obliquely,oblong,odd-pinnate,ovoid,perennial,plant,pubescent,purple,rhizomatous,rotate,rounded,seed,shape,size,sometimes,stigma,straight,style,tinged,tip,type,uniformly,usually,wide,yellow,yellowish-green	1-8,1.5-4,20,3-6-foliat,4-6,5-10,5-lobed,6-20,angular,apical,apically,articulate,ba,basal,becoming,cell,celled,clasping,connate,covering,decreasing,dehiscent,digestion,eaf,eed,elliptic,emoval,enzyme,erect,exceeding,four-celled,globo,hair-like,honeycomb,interjected,introrse,lanceolate,leaflet,living,lon,longer,lower,make,maturing,middle,narrowly,nearly,nflorescence,nther,often,orolla,ovate,pair,pattern,pedicel,peduncle,pentagonal,perfect,petiolate,petiolulate,petiolule,poricidally,puberulent,purpl,rarely,reduced,reveal,rhizome,rotate-,ruit,semi-lunate,sessile,seudostipule,short,single,slightly,slit,somewhat,specimen,stamen,ste,subequal,symmetrically,tem,terete,terminal,testal,thick,trailing,typically,unbranched,unit,vary,viole,wall,wid,wider,ympodial	anther,branching,color,corolla,form,fruit,growth,height,history,inflorescence,leaf,length,life,margin,midpoint,midrib,midvein,na,ovary,petiole,pubescence,ray,reproduction,rotate-pentagonal,staman,stellae,stem,stipe,surface,texture,tube,vein,violet,wet,width
294	wfo-0001027880	success	185	116	91	94	25	0.492	.25,0.3-3,0.5-1.5,0.5-5,0.6-1,0.6-1.5,0.8-1.5,1-15,1-2,1-2.5,1-3,1.5-2,1.5-3,2-3,2-80,3-4,4-6,abaxially,acuminate,acute,adaxially,along,anther,apex,apiculate,base,blade,branching,calyx,cm,cordate,coriaceous,cylindrical,dense,densely,diameter,entire,epiphytic,filament,flattened,flower,fruit,glabrous,globose,greenish,inflorescence,leaf,lobe,margin,midvein,minutely,mm,oblique,oblong-ovate,often,ovate,ovoid,pair,papillose,petiole,pink,pubescent,purple,red-brown,revolute,ripe,rounded,rugulose,secondary,shrub,size,slightly,sometimes,somewhat,sparsely,stellate,stigma,style,surface,tan,tip,trailing,truncate,tube,unbranched,undulate,vein,vine,white,x,yellow	-3,-3.5,1-14,10-15,2/,4-10,5-11,5-8,5-merou,8,absen,accrescen,ag,aggregate,alyx,apart,apparently,articulated,axe,ba,branch,cell,chartaceous,ciliat,clavate,conical,connivent,contiguously,curled,deltate,diminishing,directed,discolorous,distally,distichous,distinct,distinctly,eaf,eed,equal,extra-axillary,fruiting,geminat,green,growing,hair,increasing,internode,leaf-opposed,line,long,longer,longitudinal,lower,multicellular,nearly,nflorescence,node,oblong,occasionally,opening,orolla,pale,pedicel,peduncle,perfect,plurifoliate,point,pore,pubescen,rachi,reddish,rooting,ruit,scar,simple,slender,slit,spaced,ste,stone,tamen,tem,thickened,time,tree,trunk,typically,uniseriate,unit,usually,vary,wide,ympodial	color,corolla,form,growth,height,history,lateral,length,life,midpoint,midrib,na,ovary,plant,pubescence,ray,reproduction,seed,shape,staman,stellae,stem,stipe,texture,width
295	wfo-0001027880	success	170	116	87	83	29	0.512	.25,0.3–3,0.5,0.5–1.5,0.5–5,0.6–1,0.6–1.5,0.8–1.5,1.5–2,1.5–3,1–15,1–2,1–2.5,2-80,2/3,2–3,4–6,abaxially,absent,acuminate,acute,adaxially,along,anther,apex,apiculate,base,bluish-purple,calyx,chartaceous,clavate,cm,cordate,coriaceous,cylindrical,densely,diameter,entire,filament,flattened,flower,fruit,glabrous,globose,greenish,lanceolate,leaf,lobe,lower,margin,midvein,minutely,mm,nearly,oblique,oblong-ovate,often,ovate,ovoid,papillose,petiole,pink,pubescent,red,reddish-brown,revolute,rounded,rugulose,shrubby,slightly,sometimes,somewhat,sparsely,stellate,stigma,style,surface,tan,tip,truncate,tube,unbranched,undulate,vein,vine,white,x	0.2-0.5,10–15,1–14,1–3,3–4,4–10,5-merous,5–11,5–8,8,accrescen,alyx,apar,arrangement,axe,berry,blade,c.,capitat,ciliat,climbing,conical,contiguously,curled,deltate,dense,discolored,distichous,distinct,distinctly,eaf,eed,extra-axillary,fruiting,green,hair,leaf-opposed,line,long,longer,m.,membranous,mottled,nflorescence,nternode,occasionally,orolla,pair,pale,pedicel,peduncle,perfec,pinnate,plurifoliat,rachi,reddish,rip,ruit,sand-punctat,sand-punctate,scar,secondary,simple,slender,spaced,ste,tamen,tem,thickened,time,tree,trichome,trunk,typically,uniseriate,unit,vary,vegetatio,venation,wide,woody,ympodial,–3.5	branching,color,corolla,form,growth,height,history,inflorescence,lateral,length,life,midpoint,midrib,na,ovary,plant,pubescence,ray,reproduction,ripe,seed,shape,size,staman,stellae,stem,stipe,texture,width
296	wfo-0001027881	success	215	99	58	157	41	0.27	-3,acuminate,acute,anther,apex,attenuate,base,blackish,calyx,chartaceous,ciliate,cm,cordate,cordiform,densely,diameter,entire,filament,flattened,flower,fruit,glabrous,globose,greenish,groove,herb,lateral,leaf,light-brown,lobe,margin,membranaceous,mm,moderately,ovate-elliptic,petiole,projection,pubescence,pubescent,raised,reniform,rotate,seed,sessile,size,sparsely,staman,stem,stigma,style,surface,triangular,tube,unbranched,vein,white,yellow,×	.3–0.5,0.5–2.2,0.8–1.5,1-celled,1.3–2,1.8–2.9,10–25,1–2,1–2-celled,1–2.5,1–2.6,1–3,1–3-celled,1–4,2.5–3.6,20–40,2–4,2–6,2–7,4–6,4–9.5,5,5-merous,6–10,7–14,7–9,8,abaxially,absent,abundant,accrescent,adaxiall,adaxially,almost,alyx,appressed,articulated,asymmetric,axe,ba,barely,berry,blade,bulge,camptodromous,capitat,case,central,closely,commonly,connected,connivent,contiguous,curved,cylindrical,decurrent,dehiscing,denser,difoliate,directed,dorsally,drying,eaf,ed,eglandular,emarginate,emerging,equal,erect,exceeding,exclusively,explosively,extra-axillary,eye,few-,fewer,forming,frequent,geminate,giving,glandular,hair,half,held,hollow,immature,impression,interpetalar,introrsely,larger,less,like,long,longer,longitudinal,lower,mainly,many-branched,maturit,maturity,mesocarp,mixed,much,multicelled,multicellular,naked,near,netlike,nflorescence,normally,one,opening,orolla,other,pair,parallel,part,pedicel,peduncle,per,perfec,placenta,pore,pressure,primary,prominent,rachi,ruit,secondary,short,side,similar,simple,slightly,slit,small,smaller,solitary,sometimes,stalk,stamen,subapically,subopposite,tal,tamen,tem,tissue,translucent,two,unit,vary,venation,visible,watery,winged,woody,ympodial	0.5-2.2,0.8-1.5,1-2,1-2.5,1-2.6,1-3,1-4,1.3-2,1.8-2.9,2-6,2-7,2.5-3.6,20-40,4-6,7-9,branching,color,corolla,form,growth,height,hermaphroditic,history,inflorescence,length,life,midpoint,midrib,midvein,na,ovary,perennial,plant,ray,reproduction,shape,stellae,stipe,texture,tip,width
297	wfo-0001027882	success	184	111	84	100	27	0.457	0.5-1,1-1.5,1-5,1.5-,1.5-2,1.5-6,10-25,10-40,2-3,2.1-2.6,3-4,3.2-6,3.5-4,3.5-5,4-5,6-9,7-,abaxially,acuminate,adaxially,anther,anthesi,apex,appearing,attenuate,base,berry,branched,branching,calyx,cm,corolla,dark,densely,diameter,elliptic,entire,filament,flattened,flower,glabrous,globose,green,growth,hairy,inflorescence,less,lobe,lobed,margin,maturity,midrib,minutely,mm,ovary,ovoid,pale,papillate,petiole,pitted,planar,reddish,reniform,shiny,shrub,simple,small,sometimes,sparse,stem,sticky,stigma,style,surface,time,tip,tree,trichome,tube,uniseriate,vein,white,x,yellow	.25,.5,0.1,06a,1,1.5-2.2,1.6-2.2,2-6,2-lobed,2.5-3,9-13,absent,age,along,apart,apparently,axil,bark,branch,broadly,brown,c.,caly,clavate,completely,conical,cucullate,deltate,dense,difoliate,dry,drying,eaf,eed,erect,et,exerted,fide,fork,free,fruiting,fusiform,geminat,glabrou,hollow,hooked,irregularly,junction,kallunki,lamina,leaf-opposed,lengthening,lower,markedly,new,nflorescence,nodding,occasionally,pair,papillat,paulo,pedicel,peduncle,penden,perfect,plane,pointed,population,pore,poricidal,portion,primary,pulp,rachi,rarely,red-papillat,ruit,scar,shattering,slender,slit,spaced,sparsely,specimen,stout,straight,strongly,structurally,sweet-scented,swollen,são,thickened,tuft,ud,unit,usually,way,woody,yellowish,ympodial	color,form,fruit,height,history,lateral,leaf,length,life,midpoint,midvein,na,perennial,plant,pubescence,ray,reproduction,seed,shape,size,staman,stellae,stipe,texture,tufted,unknown,width
298	wfo-0001027889	success	151	102	69	82	33	0.457	0.5-1,0.5-11,0.7-2,1-10,1-3.5,1.5,10-30,2-20,2-3,3-4,3-9,abaxially,acuminate,acute,acute-acuminate,adaxially,apex,apiculate,basal,base,calyx,chartaceous,cm,color,densely,diameter,eglandular-puberulent,eglandular-pubescent,elliptic,entire,finely,flower,fruit,glabrous,glandular-,green,greenish,immature,length,light,lobe,margin,mm,moderately,ovate,ovoid,petiole,probably,puberulent,puberulent-pubescent,ripe,shrub,sparsely,stellate,stigma,style,subcordate,tip,tomentose,tree,triangular,truncate,tube,unbranched,unknown,violet,white,x,yellowish	-2.5,-pubescent,.5,.5-2,0,1,1-3,1.5-2,10-12,10-20,3-8,4-foliat,5-10,aggregate,apart,ape,articulated,axe,beyond,blade,capitat,cell,connective,connivent,cylindrical,darker,deltate,dilated,directed,distally,eaf,eed,equal,exceeding,exserted,extending,introrse,laterally,leaving,lon,long,longitudinal,lower,narrow,nflorescence,nther,oblong,orolla,pedicel,pedicellar,peduncle,perfect,pore,presen,present,puberulen,puberulent-pubescen,rachi,radiu,remnant,ruit,simple,slightly,small,somewhat,spaced,stamen,stone,stripe,subcoriaceous,swelling,tal,tem,thecae,time,tomento,ud,unit,vary,wide,yello,ympodial	1-2.5,anther,branching,corolla,filament,form,growth,height,history,inflorescence,lateral,leaf,life,midpoint,midrib,midvein,na,ovary,plant,pubescence,ray,reproduction,seed,shape,size,staman,stellae,stem,stipe,surface,texture,vein,width
299	wfo-0001027900	success	227	134	112	115	22	0.493	.1,.1–0.3,.5,0,0.2–0.5,1.5–1.8,14–15,1–3,2,2.8,2–3,3,3.5–4.5,3–5,3–9.5,5–7.5,7–17,7–8,8–15,9–25,absent,abundantly,acute,adaxially,andromonoecious,anther,apex,armed,base,blue,broad-based,brown,calyx,capitate,cm,cordate,coriaceous,curved,cylindrical,deeply,deltate,densely,diameter,entire,falcate,filament,flower,fruit,glabrous,glandular,globose,green,grey-brown,hair,half,inflorescence,lanceolate,leaf,length,light,like,likely,lobe,long,long-stalked,lower,margin,maturity,midvein,mm,moderately,multangulate,multangulate-stellate,nearly,oblique,obtuse,older,petiole,plant,porrect-stellate,powdery,prickle,pubescence,pubescent,ray,reddish-dark,repand,rotate-stellate,sessile,short-stalked,shrub,slightly,small,sparsely,stalked,stellate,stem,stigma,style,surface,tan,time,tree,tube,unbranched,violet,wide,yellow,young,×,–4,–5	.1–0.2,0.1–0.3,0.2–0.4,0–0.1,16–19,16–23,18–22,1–,1–4,2–8,3.5–4,3–8,4–10,5-merous,5–,5–10,5–6,6–8.2,7–10,7–10+,7–15,abaxial,abaxially,abundant,accrescent,adaxial,age,alyx,anthesi,apart,articulated,axe,ba,bark,becoming,beneath,berry,bilobe,blade,congested,connective,connivent,db,difoliate,directed,discolorous,distally,dried,eaf,eed,either,enclosing,equal,extraaxillary,flowering,free,fresh,frui,fruiting,functionally,geminat,golden-tan,hermaphroditic,heterstylou,interpetalar,lighter,lobed,longitudinal,major,membranaceous,midpoint,mixed,multiseriate,multiseriate-stalked,nflorescence,often,one,opening,orolla,part,pedicel,peduncle,pore,pronounced,rachi,reflexed,roughened,ruit,runk,sharp,short,side,simple,slit,smooth,spaced,stalk,staminate,stellate-pubescen,stellate-pubescent,stout,strongly,subtending,tamen,tapered,thickened,tissue,unarmed,unit,unknown,vary,vein,vestigial,ympodial,–6.2	bilobed,branching,color,corolla,dbh,form,growth,height,history,life,midrib,ovary,perennial,reproduction,shape,size,staman,stellae,stipe,texture,tip,width
300	wfo-0001027901	success	156	105	79	77	26	0.506	.25,.5,0.3-1.2,0.5-1,1-1.5,1-2.5,1.8-4.5,2.5-3,3-5,4-10-flowered,4-5,4.7-12,6-7,abaxial,abaxially,acuminate,acute,adaxially,anther,anthesi,apex,attenuate,base,bright,brown,calyx,cm,corolla,dark,dia,dry,elliptic,filament,fresh,glabrous,globose,green,inflorescence,keeled,lateral,leaf,lobe,lobed,long,material,midrib,minutely,mm,nearly,ovary,ovoid-reniform,pair,petiole,pitted,planar,prominently,pubescent,reddish,reflexed,shape,shiny,shrub,simple,size,sparsely,stem,stigma,style,surface,swollen,tip,translucent,trichome,tube,uniseriate,vein,white,x,yellow	0.8-1,0.8-2,0.9-2.3,1-2,1.5-1.8,?,area,ba,bark,beneath,berry,broadened,brow,closely,conical,curled,deflexed,densely,differing,difoliate,direction,drying,eaf,edicel,eed,ellipsoid,exserted,firm,fleshy,free,fruiting,geminat,imbedded,immature,later,like,lon,lower,main,major,matrix,middle,minor,nflorescence,older,opposite,orbicular,oriented,overlappin,papillo,papillose,pedicel,pore,poricidal,portion,rest,ripe,rounded,ruit,scar,shaped,single,slender,spaced,straight,strongly,tall,tear-drop,triangular,tub,ud,unit,usually,widest,woody,ympodial,young	branching,color,diameter,flower,form,fruit,growth,height,history,length,life,margin,midpoint,midvein,na,perennial,plant,pubescence,ray,reproduction,seed,staman,stellae,stipe,texture,width
301	wfo-0001027902	success	128	101	68	60	33	0.531	-2.5,0.5-1,1-1.5,1-2,2,2-15,2-3,20-50,3-4,3-5,4-25,4-5,5-20,6-37,7-9,abaxially,acuminate,acute,adaxially,angled,apex,base,branched,calyx,chartaceous,cm,color,cordate,deeply,densely,diameter,entire,flower,forked,fruit,glabrous,globose,lobe,long,margin,mm,moderately,narrowly,nearly,ovate,petiole,puberulent,pubescent,purple,purplish,reticulate,shrub,small,sparsely,stellate,stigma,style,time,tip,tree,triangular,truncate,tube,unknown,whitish,wide,x,yellow	1-6,1.5-3,10-15,10-20,15-30,2-12,2-8,2-9,3-foliat,8-13,absen,adaxiall,aggregate,apart,articulated,axe,blade,cell,connivent,cylindrical,directed,distall,distally,eaf,eed,eglandular,glandular,hair,inflated,leaving,like,lon,lower,nflorescence,nther,obtuse,orolla,pedicel,pedicellar,peduncle,pore,pubescen,rachi,radiu,remnant,ripe,ruit,simple,spaced,ste,stone,subcoriaceous,tal,tem,truncat,unbranched,unit,usually,vary,ympodial	anther,branching,corolla,filament,form,growth,height,history,inflorescence,lateral,leaf,length,life,midpoint,midrib,midvein,na,ovary,plant,pubescence,ray,reproduction,seed,shape,size,staman,stellae,stem,stipe,surface,texture,vein,width
302	wfo-0001027920	success	228	116	90	138	26	0.395	0.2-0.8,0.5-1,1.4-2.5,12-25,2-5,2-7,2-foliate,20-40,25-45,3-5,3.5-4,3.5-4.5,4-11,4-7,4.5-7,5-7,7-11,8-12,8-18,abaxially,acute,acute-tipped,adaxially,almost,anther,apex,base,black,bristly,bristly-hirsute,broadly,brown,calyx,cm,coarsely,dark,densely,dentate,diameter,ellipsoidal,flower,fruit,glabrous,hair,hirsute,indument,inflorescence,lateral,leaf,length,lenticular,lobe,long,margin,midpoint,mm,oblong,obovoid,obtuse,orange,outline,ovate,ovate-lanceolate,perennial,persistently,petiole,prickly,pubescent,ray,ripe,side,small,smaller,stellae,stellate,stellate-pubescent,stem,stigma,style,surface,thin-textured,tree,truncate,tube,unbranched,unit,vein,white,x,yellow	-25,-3,.1-1.4,0.1-0.2,0.1-0.5,1-2,1-2.5,1-4,1.5-3,1/5-1/3,11-28,12-18,17-25,2-,2-8,4-10,4-6,4-locular,7-18,8-30,acicular,acute-,adaxiall,along,apart,appressed,approximately,articulated,ascending,attenuate,axe,ba,basally,blade,bristle-like,broad-based,bulbou,campanulate,capitat,cauline,class,close,concealed,concentrated,connivent,cylindrical,deltoid,depressed-deltoid,descending,directed,distal,distall,distinct,divergently,eaf,eed,elongate,enlarging,entire,equaling,erect,extra-axillary,female-sterile,few-branched,flesh,frui,geminat,green,inserted,interlobal,intermixed,lanceolate,large,larger,less,lignescent,locule,long-stalked,longitudinal,lower,major,minute,minutely,much,multiseriate,narrowly,nearly,nflorescence,obtuse-tipped,occasionally,often,one,orolla,pair,pedicel,peduncle,per,persistent,pitted,pore,prickle,principal,proliferation,rachi,radiu,receptacular,recurved,rigid,ruit,scattered,section,sessile,short,similar,simple,singled-stemmed,sinus,spaced,sparse,spreading,stalk,stalked,stella,swollen,tal,tamen,tawny,tem,termination,time,trichome,two,usually,vary,vestitur,weakly,wide,ympodial	branching,color,corolla,filament,form,geminate,growth,height,history,life,midrib,midvein,na,ovary,plant,pubescence,reproduction,seed,shape,size,staman,stipe,sympodial,texture,tip,width
303	wfo-0001027929	success	193	105	85	108	20	0.44	1,1.0-1.3,1.5-4,15,2,2-3,2.0-3.0,20,3.5-5,35,4-30,4-5,5-10,5-6,abaxially,acuminate,acute,adaxially,along,apex,base,beyond,branched,calyx,center,cm,color,cordate,corolla,cuneate,cyme,darker-violet-blue,deep,diameter,dichasial,dichasially,distal,ebracteate,elliptic,except,flower,forked,generally,glabrous,globose,green,green-white,hair,half,herbaceous,lanceolate,leaflet,light,long,mm,monochasial,narrowly,obliquely,occasional,odd-pinnate,ovate,ovoid,perennial,plant,puberulent,purple,rarely,rhizomatous,rotate,rounded,seed,shape,size,sometimes,spot,stigma,straight,style,tinged,usually,vein,violet,violet-blue,wide,yellow	0.2-0.9,1-10,1-4,1-8,10,3-6-foliat,4-6,5-lobed,6-15,acumen,angular,apical,apically,apiculate,articulate,ba,basal,becoming,caudate,cell,cente,clasping,coat,connate,covering,dark,decreasing,dehiscent,digestion,eaf,eed,embryo,emoval,enzyme,erect,exceeding,filament,formed,globo,hair-like,honeycomb,included,interjected,introrse,lateral,living,lobe,lon,lower,make,maturing,middle,mostly,mucilaginous,nearly,nflorescence,nther,oblong,often,orolla,pair,pattern,pedicel,peduncle,pentagonal,perfect,petiolate,petiolulate,petiolule,poricidally,purpl,radiating,reduced,reveal,rhizome,rotate-,ruit,semi-lunate,sessile,seudostipule,short,slightly,slit,somewhat,specimen,stamen,star,ste,subequal,symmetrically,tem,terete,terminal,testal,thick,tip,trailing,typically,unbranched,unit,vary,visible,wall,white,wid,wider,without,ympodial	anther,branching,form,fruit,growth,height,history,inflorescence,leaf,length,life,na,ovary,pseudostipule,pubescence,reproduction,rotate-pentagonal,stem,texture,width
304	wfo-0001027930	success	210	115	92	118	23	0.438	%,0-2,0.2-0.7,0.2-1.2,0.25-0.4,0.4-1,0.4-1.5,0.6-0.9,0.7-1.5,1-2,2-10,2-2.5,2-3,3-12,3-3.6,3-7.5,3.5-5.5,4.5-6.5,8-20,9-26,absent,acute,adaxially,and/or,andromonoecious,anther,apex,basal,brown,calyx,chartaceous,cm,cylindrical,deltate,densely,diameter,entire,erect,filament,flower,fruit,glabrous,gland-tipped,globose,green,grey,hair,inflorescence,lamina,leaf,length,lilac,linear,linear-hastate,lobe,long,margin,midrib,midvein,mm,moderately,narrowly,obtuse,pale,perennial,perfect,petiole,plant,present,prickle,red,rhizomatous,rostrate,scattered,short,shrub,sparse,sparsely,stellae,stellate,stellate-pubescent,stigma,style,time,triangular,tube,unbranched,white,wide,x,yellow,yellowish	-2,.1,.4,0,0-0.5,0-0.7,0-0.8,0-1,0-4,0.05-0.7,0.2-0.4,0.25-0.35,0.3-0.5,0.4-0.8,0.5-0.6,0.5-1,0.8-1.2,1-4,1-locular,13-16,15-60,2-6,2-9,2-foliate,4-,4-8,5-merou,6-12,6-13,6-8,7-12,7-8,9-13,abaxially,absen,acicular,across,adaxiall,adult,alyx,apart,apparen,articulated,axe,ba,base,blade,branch,branche,capitat,confined,connivent,cuneate,decimetre,directed,distall,distributed,dm,eaf,eed,eglandular,exocarp,extra-axillary,finger,fruiting,functional,geminat,half,hastate,heterostylous,homo-,incomplete,interpetalar,juicy,juvenile,lanceolate,lateral,less,longer,loosely,lower,mature,mesocarp,mid-point,midpoint,minute,nflorescence,oblique,orolla,part,pedicel,peduncle,per,placenta,pore,porrect,rachi,ray,ruit,septum,sessile,simple,spaced,straight,strongly,succulent,tal,tamen,tem,thick,throughout,tissue,unarme,unarmed,unit,vary,weakly,ympodial	abaxial,adaxial,branching,capitate,color,corolla,form,growth,height,history,life,ovary,pubescence,reproduction,seed,shape,size,staman,stem,surface,texture,tip,width
305	wfo-0001027943	success	208	94	74	134	20	0.356	-1.5,-4,0.5-1,0.5-1.5,0.5-6,0.8-1.5,1-1.5,1-3,2-14,2-2.5,2-3,2-4,3-20,4-20,4-7,5-9,7-10,andromonoecious,anther,brown,brownish,calyx,chartaceous,cm,densely,diameter,elliptic,elliptic-ovate,filament,flower,forked,fruit,glabrescent,glabrous,glandular,globose,green,inflorescence,leaf,linear-apiculate,lobe,long,mature,minutely,mm,moderately,nearly,outline,plant,pubescent,reniform,ripe,rugulose,shrub,smooth,sparsely,stellate,stellate-pubescent,stem,stigma,style,surface,tan,time,tip,truncate,tube,turning,unbranched,white,wide,x,yellow,young	.1,.5,0,0.2-2,0.3-0.5,0.5-4,1-4,1-5,1.5-3,10-15,2-10,2-3-lobed,3-15,3-8,4-6,5-8,5-merou,6-.,7-15,abaxially,accrescent,acute,adaxially,ag,alyx,apart,apex,armed,articulated,axe,ba,base,berry,blade,broad,broad-based,capitat,coarsely,connivent,covering,curved,cylindrical,difoliate,directed,distally,eaf,eed,entire,equal,erect,extra-axillary,ferruginous,flattened,free,frui,fruiting,geminat,gland-tipped,hair,half,heterostylous,homo-,initially,interpetalar,interspersed,interwoven,like,linear-acuminate,longitudinal,lower,major,margin,membanaceous,midline,midpoint,midrib,narrowly,nflorescence,numerous,oblique,obtuse,often,opening,orolla,part,pedicel,peduncle,perfect,pericarp,petiole,pore,porrect-stellate,prickle,rachi,rarely,ray,recurved,reflexed,rounded,ruit,sessile,shallowly,short,short-stalked,side,simple,sinus,slightly,slit,small,somewhat,spaced,sparse,splitting,staminate,straight,strongly,subtending,tamen,tapered,tem,thi,tissu,tissue,toward,triangular,unarme,unarmed,unit,vary,vein,whitish,woody,ympodial	branching,capitate,color,corolla,form,growth,height,history,length,life,ovary,perennial,pubescence,reproduction,seed,shape,size,staman,texture,width
306	wfo-0001027944	success	175	94	70	105	24	0.4	0.3-0.4,0.4-0.5,0.4-0.8,0.5-1.2,0.9-1.2,1-2,1.5-2,2-4.5,3-3.5,3-4.5,3-7,5-7,7-20,7-8,7.5-14,acute,adaxially,anther,apex,base,brown,calyx,chartaceous,cm,confined,cuneate,deltate,densely,diameter,entire,flower,fruit,glabrous,globose,green,hair,inflorescence,lanceolate,lateral,lavender,length,lobe,lobed,long,margin,midpoint,midrib,mm,ovate,pale,perennial,petiole,pseudo-racemose,ray,red,rhizomatous,shallowly,shrub,stellae,stellate,stellate-pubescent,stigma,style,throughout,time,tube,unbranched,white,x,yellow	%,.8,0-0.3,0-4,0.1-0.2,0.2-0.3,0.2-0.4,0.25-0.4,0.5-0.8,0.5-1,1-1.2,1-3,1-locular,13-16,15-23,2-3,2-6,2-foliate,2.5-5.2,3-20,3-4,3-5,4-7,5-merou,abaxially,absen,absent,acicular,across,adaxiall,adult,alyx,apart,apparen,articulated,axe,ba,blade,branche,capitat,cylindrical,directed,distall,dm,eaf,eed,eglandular,erect,exocarp,extra-axillary,finger,fruiting,geminat,gland-tipped,half,incomplete,index,juicy,lamina,less,lobing,longer,lower,mature,mesocarp,mid-point,minute,nflorescence,oblique,obtuse,orolla,part,pedicel,peduncle,per,perfect,placenta,pore,porrect,present,prickle,ruit,rusty,septum,sessile,short,side,simple,spaced,stage,straight,succulent,tal,tamen,tem,thick,unarme,unarmed,unit,unknow,uvenile,vary,wide,yellowish,ympodial	branching,color,corolla,filament,form,growth,height,history,leaf,life,na,ovary,plant,pubescence,reproduction,seed,shape,size,staman,stem,surface,texture,tip,width
307	wfo-0001027948	success	186	97	71	115	26	0.382	-16,-6,.5,0.4,0.5-2,0.6,0.8-,1-1.2,1.2-2.2,1.3-1.8,1.5-4.5,2.2-,2.5-,3-8.2,3.2-5.2,3.7-4,5-,7-15,7.5-10,abundant,acuminate,anther,apex,attenuate,basal,base,calyx,campanulate,cm,corolla,diameter,elliptical,filament,flexuous,glabrous,glandular,globose,herb,leaf,length,light,lobe,long,margin,midvein,mm,narrowly,non-glandular,occasionally,ovate,patent,petiole,pubescence,pubescent,purple,seed,serrulate,stem,stigma,style,sub-shrub,tip,trichome,tube,unequal,vein,violet,viscid-pubescent,x,¼,½	-15,0-,0.5-0.7,1-2,1.6,1/10,10-14,13,14,2-,3.5,5,6-celled,7,8-celled,abaxially,accrescen,adaxially,ag,aggregate,antrorse,ape,articulate,ature,berry,bicellular,branch,c.,cell,connectival,crushed,cuticle,dark,delicate,diamete,difoliate,directed,dorsally,eaf,edentate,ellipsoidal,erect,finely,fragrance,free,fruiting,generally,head,herbaceous,hig,hollow,ill-smelling,inconspicuous,inserted,lamina,long-stalked,longer,longitudinal,longitudinally,lower,many-,narrow,near,odorles,opening,orolla,ovoid,pair,papillate,pericarp,pore,poricidal,portion,prolongation,reduced,ree,ridged,ruit,saddle-shape,scarce,scarcely,secondary,seeded,seen,separated,short-stalked,shorter,simple,single-celled,sinus,slightly,slit,small,smooth,solitary,spur-like,stalk,stone,straight,striat,striate,sub-opposite,tem,thecae,thickened,time,tooth,triangular,twice,unit,upward,vary,ventrifixed,verrucate,ympodial	branching,color,flower,form,fruit,growth,height,history,inflorescence,lateral,life,midpoint,midrib,na,ovary,perennial,plant,ray,shape,size,staman,stellae,stipe,surface,texture,width
308	wfo-0001027961	success	177	110	85	92	25	0.48	0.9-1,1-1.5,1-3,1-4,1-5,1-9,10-50,2-2.5,2.3-2.5,2.5-9,3-3.5,4.5-5,8-10,?,abaxially,acute,anther,apex,asymmetric,base,berry,branched,broadly,c.,calyx,cm,conical,cordate,corolla,deltate,densely,diameter,entire,fading,filament,flower,glabrous,globose,green,growth,immature,inflorescence,lateral,lobe,lobed,many,margin,maturity,membranous,midrib,mm,occasionally,often,one,other,petiole,pinnatifid,probably,pubescent,purple,rotate-stellate,shiny,simple,slightly,sparsely,stem,stigma,style,surface,terminal,time,tip,trichome,truncate,tube,uniseriate,vein,vine,violet,way,white,white-pubescent,woody,x,yellow	.5,0.25,0.25-0.5,0.5-1,1,5-8,5-merou,6-9,7-9,<,adaxiall,adaxially,age,always,alyx,anthesi,apar,ark,articulated,axil,brow,clavate,clear,connivent,curling,distributed,eaf,early,eed,ellipsoid,elliptic,equalling,exserted,free,fruiting,fusiform,geminat,ilament,irregularly,lamina,lengthening,lon,long,loosely,lower,mature,minute,minutely,new,nflorescence,obovate,observed,older,orolla,pair,papillo,pedicel,peduncle,pendan,perfect,pericarp,pinched,planar,plurifoliate,pore,poricidal,portion,present,primary,pubescen,reddish,ruit,scar,sleeve,slender,slit,small,spaced,spreading,tem,thin,transition,triangular,tuft,twinin,twining,ud,unequal,unit,upper,vary,ympodial	branching,color,form,fruit,height,history,leaf,length,life,midpoint,midvein,na,ovary,plant,pubescence,ray,reproduction,seed,shape,size,staman,stellae,stipe,texture,width
309	wfo-0001027965	success	265	76	60	205	16	0.226	.25,0.15-0.3,0.5,0.6-0.9,0.8-1.6,1.5-3.2,2-3.5,2-4,2.2-2.6,2.8-3.3,3.5-10,4-7,4.5,7-8,abaxially,adaxially,almost,armed,branched,brown,chartaceous,cm,densely,development,diameter,dull,evenly,fasciculate,finely,flat,flattened,fruit,glabrous,grey-brown,leaf,length,liana,midvein,mm,orange,ovate,petiole,pitted,pubescent,raised,ray,red-brown,reniform,rounded,shiny,shrub,sparsely,spheroidal,stellate-pubescent,stem,surface,throughout,unarmed,white,x	-2,.1,.2,.3,.5,.7,.9,/3,0.1-0.2,0.15,0.2,0.3,0.4,0.4-0.5,0.5-3,0°,1,1-2,1-8,1.2,1.5-2,1.5-2.5,1/3-1/4,1/3-2/3,1/4-1/3,2-2.5,2-3,3.5,4-merou,6-9,abaxial,absent,accrescent,acicular,acuminate,acute,adaxial,adjacent,age,along,alternate,alyx,ame,anther,anthesi,apar,ape,apex,apically,apparently,articulated,bark,base,becoming,beneath,berry,branch,brown-green,c.,calyx,canaliculate,capitate,clavate,clustered,cordate,corolla,covered,cupular,curved,deltoid,dense,density,detaching,discolorous,distributed,divided,dry,drying,eaf,early,eed,ellipsoi,elongated,entire,equal,erect,even,except,extending,fairly,filament,filiform,fissure,flexuous,flower,forming,free,fruiting,glabrescent,green,increasing,indumentum,inside,lateral,leave,lengt,lengthening,less,like,lobe,lobed,long,loop,lower,m.,main,mature,maturity,midpoint,minor,mixture,nflorescence,nther,obconical,oblique,oblong,occasional,often,orange-brown,orolla,outside,pair,pale,papillose,patch,pedicel,peduncle,pendulous,perfect,pericarp,pit,plurifoliat,pore,poricidal,porrect,portion,present,prickle,primary,protruding,rachi,reduced,regular,remnant,ridged,ruit,scar,series,sessile,short,simple,sinus,small,smooth,sometimes,somewhat,sparse,spreading,stalk,stalked,stellate,stigma,straight,strongly,stump,style,tapering,tearing,terete,tertiary,thin,tip,toward,translucent,transverse,trichome,tube,ud,unarme,underneath,unequal,uneven,unit,usually,variable,vary,vein,venation,visible,wide,widening,wrinkled,ympodial,young,youngest	branching,color,form,growth,height,inflorescence,na,plant,pubescence,reproduction,seed,shape,size,stellae,texture,width
310	wfo-0001027966	success	207	87	66	141	21	0.319	0.4-0.5,1-1.8,1-2,1-4.2,1.3-2.2,2.2-2.9,2.5-10.5,3-4,3-5,3-7,40-80,5-6,5-9.5,5.5-14,6-11,abaxially,adaxially,anther,attenuate,blue-violet,brownish,chartaceous,cm,condition,conical,corolla,densely,diameter,drying,filament,forked,fresh,fruit,glabrous,green,greenish,herb,leaf,light,lobe,long,membranous,mm,mottled,mucilaginous,odd-pinnate,ovoid,pentagonal,petiole,plant,pubescent,purple,ripe,rotate,seed,size,sparsely,stem,stigma,tip,tube,wet,whitish,wide,x,yellow	0.7-3,0.8,0.8-2.5,1-10,1-3,1-5,1.2-4.5,1.5-3,1.5-5.2,10,10-30,2.8-9,4,5-10,5-merou,absent,acumen,acuminate,ag,along,alyx,apart,apex,apparently,arranged,articulated,asymmetrical,axe,axillary,base,basiscopic,bead,berry,blade,bud,capitat,cell,ciliate,commonly,connivent,covering,decreasing,digestion,distal,dorsally,eaf,edge,eed,elliptic,enzyme,erec,especially,exceeding,flat,flower,folded,geminat,generally,glabrou,gradually,green-white,hair,hair-like,half,homostylous,honeycomb-shaped,interjected,lanceolate,larger,lateral,leaflet,lengthening,less,like,living,lower,make,margin,medium,middle,minute,moniliform,multiple,narrow,necklace,nflorescence,orbicular,orolla,ovate,pair,pale,pedicel,peduncle,perfect,petiolule,plurifoliate,pore,poricidal,proximal,rarely,ray,removed,ruit,secondary,semierect,sessile,seudostipule,shorter,side,slightly,slit,somewhat,spaced,specimen,stamen,ste,stolon,straight,subequal,subsessile,subtending,symmetrical,tall,tamen,tem,terminal,testal,thick,throughout,tissue,tri-,tuber,tyle,typically,unit,usually,violet,wall,white,wing,ympodial	branching,calyx,color,form,growth,height,history,inflorescence,length,life,midrib,na,ovary,perennial,pubescence,reproduction,shape,staman,style,surface,texture
311	wfo-0001027978	success	197	103	83	114	20	0.421	0.2-0.5,0.5-1,1-1.5,1-2,1-3,1-6,1.5-2.5,10-14,11,2-2.5,2.5-3,3-5,3-6,4-5,4-6,4-8,7-9,andromonoecious,anther,base,becoming,brown,calyx,chartaceous,cm,cylindrical,densely,diameter,distal,end,filament,flower,fruit,functionally,glabrous,globose,green,hair,hermaphroditic,immature,initially,leaf,length,like,lilac,lobe,lobed,male,many,mature,mm,moderately,narrowly,nearly,netlike,orange,orange-red,ovary,ovate,pit,plant,porrect-stellate,proximal,pubescent,raised,ridge,round,scattered,separated,shrub,small,stellate,stem,stigma,style,surface,tan,triangular,tube,unbranched,white,x,yellow	0.5-1x,1,1.5,1/6,2-3,2.5-5.5,20-40,4-10,5-8,6,6-10,7-10,8-12,abaxial,abaxially,absen,absent,accrescent,acute,adaxial,adaxially,along,alyx,andormonoeciou,apar,apex,apical,apparently,armed,asymmetrical,attenuate,axe,berry,beyond,blade,connivent,cordate,cut,dark,difoliate,directed,discolorous,eaf,eed,either,entire,except,exserted,extra-axillary,filiform,flattened,frui,fruiting,geminate,glabrou,gree,heteromorphic,introrsel,less,long,lower,major,margin,midpoint,midrib,midvei,midvein,multicellular,multiseriate,nflorescence,obtuse,occasionally,often,orolla,pair,pedicel,peduncle,per,petiole,pore,prickle,rachi,ray,recurved,reflexed,roselike,ruit,scandent,short,side,simple,sinus,slightly,spaced,sparsely,stalk,stamen,staminate,ste,straight,tamen,tapering,tem,thin-skinned,unarmed,unequa,unicellular,unit,vary,vegetatio,vein,way,wide,ympodial	branching,color,corolla,form,growth,height,history,inflorescence,life,na,perennial,pubescence,reproduction,seed,shape,size,staman,texture,tip,width
312	wfo-0001027997	success	174	97	63	111	34	0.362	0.2-2,1-2,1-4,1.5-1.7,1.5-2,10-23,2,3.5-10,7-10,acute,anther,anthesi,apex,attenuate,auriculate,base,becoming,calyx,cm,corolla,dia,dirty,filament,glabrous,globose,green,greenish-yellow,inflorescence,lateral,leaf,lobe,lobed,margin,minutely,mm,obovate,occasionally,ovary,ovoid-reniform,pair,pale,petiole,pitted,planar,plant,pubescent,ripe,shrub,simple,small,somewhat,sparsely,stem,stigma,style,surface,tan,tip,tree,tube,vein,white,x	.1,.2,.5,.6,0.1-0.7,0.1-0.8,0.9-1,1,1.5-1.8,10-20-flowered,7/8,abaxially,along,apar,ba,bark,beneath,berry,bi-lobed,black,blade,breaking,bright,brittle,consisting,corky,decurrent,deflexed,deltoid,dense,densely,denser,distal,dry,eaf,edicel,eed,entire,erect,even,evenly,exserted,free,fruiting,glabrate,impressed,inflorescenc,keel,keeled,later,like,live,living,long,long-acuminate-triangular,long-ellipsoid,lower,main,middle,nflorescence,often,old,older,onto,opposite,ovoid,papillose,partially,pedicel,pore,poricidal,portion,prominent,pubesent,raised,reddish-brown,remaining,rest,ribbed,ruit,scar,scattered,sessile,shaped,short,slender,slightly,soft,soon,spaced,specimen,straight,strongly,tall,tapering,tear-drop,trichome,trunk,ud,ultimately,unifoliat,uniseriate,unit,vasculature,way,widest,wing,winged,woody,ympodial,young	0.1,1.2,10-20,3,3.5,7,branching,color,diameter,flower,form,fruit,growth,height,history,length,life,midpoint,midrib,midvein,na,perennial,pubescence,ray,reproduction,seed,shape,size,staman,stellae,stipe,texture,width,ye
313	wfo-0001028014	success	222	125	104	118	21	0.468	-1,-2.5,-4,-6,/5,0.2-0.4,0.2-1.6,0.25,0.5-1,0.5-2,0.5-3,0.6-0.9,0.7-1,0.9-1.2,1-10,1-4,1.3-2.4,1.8-3,2-4.5,2-6.5,2.5-4,4.5-7,6-10,abaxially,almost,anther,apex,apically,around,base,berry,black,branched,brown,calyx,cell,chartaceous,cm,cordate,curved,deltate,densely,diameter,edge,erect,filament,flattened-reniform,flower,fruit,glabrescent,glabrous,lateral,leaf,length,lobe,lobed,long,margin,maturity,mauve,membranous,midpoint,midvein,mm,moderately,obtuse,one,open,orange,outer,outline,ovate,pale,petiole,pit,purple,raised,ray,red,reflexed,rough,rounded,scandent,seed,shiny,shrub,slender,smooth,spherical,spreading,stellate,stellate-pubescent,stem,style,surface,time,tip,tube,vein,visibly,way,weakly,wide,yellow	-0.5,-1/2,-10,-15,-3,-5,.5,0,0.1-0.2,0.15,0.15-0.3,0.2,0.2-1,0.3-0.4,0.5,0.5-1.5,0.7-1.6,1-,1-2,1-3,1.5,1.5-2,1/4,1/4-2/3,2,2-20,2-3,3-10,4-10,5-merous,6-11,acuminat,alyx,ame,apar,apart,apparently,articulated,bark,blade,broad-deltate,brown-green,c.,concolorous,connivent,decurrent,difoliate,discolorous,distance,drying,eaf,eed,elongating,equal,extending,eye,flattened,free,fruiting,geminat,glabrou,gland,globular,gray,gray-green,herbaceous,infructescence,lon,longer,lower,mature,naked,nflorescence,occasionally,older,orange-gra,orolla,oung,pair,pedicel,peduncle,pendulous,per,perfec,pericarp,poricidal,porrect,portion,prickl,prickle,prickly,primary,reduced,ruit,scar,sessile,shorter,side,simple,sometimes,spaced,stalk,stalked,straight,strongly,tamen,tapering,terete,terminal,tertiary,trichome,unit,vary,venation,visible,winged,yellow-green,ympodial	acuminate,branching,color,corolla,form,growth,height,inflorescence,midrib,na,ovary,plant,pubescence,shape,size,staman,stellae,stigma,stipe,texture,width
314	wfo-0001028017	success	158	114	78	80	36	0.494	-2.5,0.3-1,1.5-2,10-22,13-40,15-50-flower,2,2-3,2-4,2.5-5,3,3-12,3-14,3-4,5-7,5-9,6-8,abaxially,acute,adaxially,apex,apiculate,basal,base,brown,calyx,cm,cuneate,densely,diameter,eglandular-puberulent,eglandular-pubescent,ellipsoidal,elliptic,entire,flattened,flower,forked,fruit,fusiform,glabrous,glandular-,glandular-puberulent,green,greenish,immature,lobe,margin,mm,moderately,narrowly,oblique,ovate,petiole,pubescent,purplish,rarely,ripe,short-acuminate,sometimes,sparsely,stellate,stellate-campanulate,stigma,style,subcoriaceous,tip,tomentose,tree,triangular,truncate,tube,unbranched,vein,white,without,x,yellow	1,1-10,1-2,1-3,15-35,3-foliat,40-50,5,6-7,9-11,absen,absent,acuminate,aggregate,apart,ape,articulated,axe,beyond,blade,cell,chartaceous,ciliat,clavate,connective,connivent,cream,cylindrical,directed,distally,eaf,eed,eglandular,exceeding,exserted,fleshy,glandular,hair,introrse,lanceolate,leaving,lon,long,lower,near,nflorescence,nther,obtuse,orolla,ovoid,pedicel,pedicellar,peduncle,perfect,pointed,pore,puberulen,purple,rachi,radiu,remnant,ruit,shorter,simple,slightly,small,spaced,stamen,stone,tal,tan,tem,thecae,time,truncat,ud,unit,vary,wide,ympodial	anther,branching,ciliate,color,corolla,filament,form,growth,height,history,inflorescence,lateral,leaf,length,life,midpoint,midrib,midvein,na,ovary,perennial,plant,puberulent,pubescence,ray,reproduction,seed,shape,size,staman,stellae,stem,stipe,surface,texture,width
315	wfo-0001028025	success	182	96	70	112	26	0.385	.8,0,0.15-0.25,0.2-0.3,0.2-0.7,1.4-2.2,1.5-7,1.6-3.5,13-21,2-2.3,2.5-4,3.5-4.5,6.5-10,7-9,9-14,acute,anther,apex,attenuate,base,brown,calyx,chartaceous,cm,cordate,cylindrical,diameter,flower,fruit,glabrous,globose,green,inflorescence,lateral,lavender,length,lobe,lobed,long,margin,midpoint,midvein,mm,moderately,obtuse,ovate,pale,perennial,petiole,pseudo-racemose,ray,rhizomatous,shallowly,shrub,sparsely,stellae,stellate,stellate-pubescent,stem,straight,style,throughout,time,tube,unbranched,vein,white,x,yellow,yellowish-green	%,0-0.5,0-11,0.1-2.2,0.3-0.8,0.3-1,0.4-3,0.5-0.7,0.9-1.2,1-1.4,1-8,1.1-1.4,1.9-2.4,10-140,11-18,12-17,16-23,2-6,2-locular,3-5,3-6,4-10,4-8,5-,5-11,5-20,5-7,50-90,6-,7-13,7-8,abaxially,absen,absent,acicular,across,adaxiall,adaxially,alyx,anvil-shape,apart,armed,articulated,axe,ba,blade,broad-based,cross-section,d.,directed,distall,distributed,dult,eaf,eed,eglandular,erect,exocarp,extra-axillary,finger,fruiting,gland-tipped,hair,half,hig,index,juicy,lamina,less,lobing,lon,longer,lower,mature,merou,mesocarp,mid-point,minute,moist,nflorescence,oblique,onl,orolla,part,pedicel,peduncle,per,perfect,placenta,pore,porrect,present,prickle,ridged,ruit,sessile,short,side,simple,spaced,stage,stalked,tamen,thick,transparent,unarmed,unit,unknow,uvenile,vary,wide,ympodial	branching,color,corolla,filament,form,growth,height,history,leaf,life,midrib,na,ovary,plant,pubescence,reproduction,seed,shape,size,staman,stigma,stipe,surface,texture,tip,width
316	wfo-0001028033	success	157	97	72	85	25	0.459	1.4–1.8,1–4,1–5,2–4,3–11,3–4,3–5,4–5,50,6–12,abaxially,acuminate,acute,adaxially,anther,anthesi,apex,attenuate,base,brown,calyx,chartaceous,ciliate,cm,cylindrical,cyme,decurrent,densely,diameter,elliptic,entire,eye,filament,flower,fruit,glabrescent,glabrous,growth,herb,hispid-pubescent,lateral,length,light,like,lobe,margin,midrib,mm,naked,ovate-lanceolate,petiole,pubescence,pubescent,recurved,rhizomatous,shrub,slightly,sparsely,stellate,stem,stigma,straight,strongly,style,surface,tube,unbranched,vein,visible,white,yellow,×	.6,1.5,2–3,2–foliate,3,4–12,5-merou,5–7,adaxiall,along,alyx,ark,ascending,becoming,blade,branch,brochidodromous,capitat,cell,connivent,contiguou,cordate,darker,deeply,denser,directed,discolorous,drying,eaf,eed,emarginate,equal,few-branched,florescence,geminat,green,greenish,high,introrsely,know,known,linear-lanceolate,lobed,long,longitudinal,lower,mainly,membranaceous,nearly,new,oblong,older,onto,opening,order,orolla,pedicel,perfect,pore,poricidal,prominent,prostrat,ruit,secondary,sessile,shin,shiny,shorter,simple,slit,solitary,spreading,subapical,tamen,tem,trichome,uniseriate,unit,unknown,upright,vary,venation,wide,woody,ympodial	branching,color,corolla,form,height,history,inflorescence,leaf,life,midpoint,midvein,na,ovary,plant,ray,reproduction,seed,shape,size,staman,stellae,stipe,texture,tip,width
317	wfo-0001028035	success	172	101	68	104	33	0.395	1,1.3-1.8,1/4-1/3,2,2.5-3.1,2.5-4,4.2-5.5,5-10,6-13,7-10-flowered,9-13,along,annual,anther,armed,base,blade,bristly,brown,calyx,cm,dark,densely,dia,diameter,dry,felty,flattened-ovoid,flower,foveolate,fruit,glabrous,herb,lanceolate,leaf,lobe,long,long-rayed,main,maturity,midpoint,minutely,mm,oblong,ovate,pentagonal,petiole,pigmentation,prickly,purple,ray,red,reticulately,seed,slightly,spherical,splitting,stellae,stellate-pubescent,stem,suffused,surface,tube,twice,undulate,vein,wrinkled,yellow	1.5,2/3,3,3-6,3.7-4.2,4-8,5,50-90,7-10,accrescent,acicular,across,almost,alyx,ample,anthesi,apically,berry,bristle,broad,broad-based,broadly,campanulate,capitate,cauline,closely,confluent,congested,da,dark-based,deep,developing,difoliate,distinct,divided,eaf,erect,exceeding,externall,flattened,geminat,hardly,hilum,incurved,internodal,interpetalar,invested,lon,m.,markedly,n,narrowly,nflorescence,notch,noticeably,numerous,often,one,orolla,other,pedicel,per,pinnatifid,plicate,prickle,prominent,reaching,recurved,rounded,ruit,scattered,short,shorter,slende,sometimes,somewhat,spaced,spreading,stalk,stellate,stellate-wooll,stout,styl,sunken,symmetrically,tall,tamen,tapering,taprooted,terminal,tightly,tigma,tissue,tub,tyle,ultimate,unit,upper,usually,vary,well,wide,yello,ympodial	apex,branching,color,corolla,externally,filament,form,growth,height,history,inflorescence,lateral,length,life,margin,midrib,midvein,na,ovary,plant,pubescence,reproduction,shape,size,slender,staman,stellate-woolly,stigma,stipe,style,texture,tip,width
318	wfo-0001028044	success	195	98	71	124	27	0.364	.9,0.3,1.2-1.4,1.4-1.6,1.5-2,16,19-22,2-3,2-4,2.7-4,3-4,3.4-4.3,31-46,50,6.5-7.2,9.5-13,acute,anther,apex,attenuate,base,black,branched,calyx,cm,corolla,creamy,cylindrical,diameter,drying,entire,filament,flower,fruit,glabrate,globose,immature,lateral,leaf,length,lobe,long-attenuate,many,margin,midrib,mm,obovate-elliptic,ovate-lanceolate,pale,petiole,pubescent,rough-granular,seed,semi-obtuse,shrub,side,sparsely,stellate,stigma,style,surface,thin-textured,time,tip,tomentose,tube,vein,white,x,yellow,yellow-brown	-3.5,-5,.6,0.4-0.5,1.3-2.2,1/3-1/2,11-13,11-16,2.8-3.3,20-21,3-6,3.5-4.6,4-5,5-merou,6-8,7.5-9,abaxial,abaxially,accrescent,adaxiall,adaxially,ag,along,alyx,anthesi,apart,around,articulated,ature,axe,axillary,becoming,berry,blade,blunt-tipped,branch,brown,bud,bulbous-based,capitat,closely,concentrated,connivent,dark,decurrent,dendritic,directed,distally,eaf,edge,except,exserted,few-rayed,fleshy,frui,fruiting,geminate,glabrescen,glabrous,green,greenish,hair,high,homostylous,lackin,lengthening,lobed,long,long-stalked,longitudinal,lower,main,moderately,mostly,much,multangulat,multangulate,nearly,nflorescence,oblong,obscured,obtuse,occur,orolla,pedicel,peduncle,plurifoliate,pore,poricidal,porrect-stellate,presumably,rachi,rather,resorption,ruit,runk,simple,slender,slit,somewhat,spaced,sparse,stalked,stamen,subcampanulate,suture,tamen,terete,thick,thick-stalked,tissue,tomentu,unarme,unbranched,unit,unknown,vary,way,weakly,wide,winged,yellowish,ympodial,young	0.6,branching,color,form,glabrescent,growth,height,history,inflorescence,life,midpoint,midvein,na,ovary,perennial,plant,pubescence,ray,reproduction,shape,size,staman,stellae,stem,stipe,texture,width
319	wfo-0001028046	success	186	98	75	111	23	0.403	1-1.5,1-7,1.5-2,12-13,13-38,2-3,2-4,2.5-3,20,3-12,5-18,6-7,8-9,acuminate,acute,anther,apex,approximately,attenuate,base,blue,brown,calyx,chartaceous,cm,compressed,coriaceous,corolla,diameter,elliptic,entire,filament,flower,foveolate,glabrous,glandular,globose,green,growth,heterostylous,inflorescence,leaf,length,like,lilac,lobe,margin,midpoint,mm,obovate,ovary,petiole,pubescence,pubescent,ray,red,reniform,rusty,rusty-red,scabrous,shrub,simple,stellate,stem,stigma,style,sub,subhirsute,surface,tip,tomentose-scabrous,trichome,tube,x,yellow	0.2-0.3,0.3-0.5,0.4-0.5,0.5-1,1-1.3,1-multicellular,1.2-1.5,10,10-15,4-5,abaxially,adaxially,anthesi,armed,articulated,bark,basal,berry,c.,campanulate,clavate,cylindrical,dark-brown,decurrent,deflexe,densely,denser,difoliat,distal,eaf,eed,erect,exserted,flattened,foliaceous,free,fruiting,glabrescent,gland-tipped,grayish,half,lanceolate-subulate,large,lengthening,lightly,lobed,long,long-styled,lower,minute,minutely,mixed,multangulate,multicellular,nearly,new,nflorescence,obverse,occasionally,older,opposite,ovoid,papillo,pedicel,peduncle,per,perfect,pericarp,pore,poricidal,porrect,portion,prickle,prickly,prominent,raise,reduced,reflexed,rest,rigid,ruit,scar,sessile,short-styled,slightly,slit,somewhat,spaced,sparse,sparsely,stalked,staminate,subcordate,subglobose,subscandent,subsessile,tall,tapering,testa,thick,tomentose,truncate,ud,unarmed,unevenly,unicellular,unit,upper,winged,ympodial,¼	branching,color,form,fruit,height,history,lateral,life,midrib,midvein,na,perennial,plant,reproduction,seed,shape,size,staman,stellae,stipe,texture,vein,width
320	wfo-0001028059	success	221	106	81	140	25	0.367	-4.5,0-0.3,0-2,0.4-0.8,0.4-0.9,0.5-1.3,1-3,1.1-12,1.5-2,1.5-2.1,1.5-3.5,2-3,2-5,2.5-2.6,2.5-3.5,3-17,4-7,4.5-7,5-9,8.5-10,acuminate,acute,adaxially,anther,apex,attenuate,base,brown,brownish,calyx,chartaceous,cm,cuneate,deltate,densely,diameter,elliptic,entire,erect,filament,flower,fruit,glabrous,glandular,globose,green,hair,inflorescence,lateral,leaf,length,lilac,lobe,margin,midvein,mm,moderately,oblate,obtuse,ovate,pale,perennial,petiole,plant,pseudo-racemose,purple,ray,rhizomatous,shrub,sparsely,stellae,stellate,stellate-pubescent,style,surface,toward,tube,unbranched,x,yellow,yellowish-green	%,.4,0-0.2,0-1.2,0-15,0-7,0.1-0.3,0.1-0.6,0.1-0.7,0.4-0.7,0.5-0.7,0.5-0.8,0.6-0.8,0.6-1,1,1-1.5,1-2,1.1-4.5,15,2-10,2-2.6,2-foliate,2-locular,2.1-2.7,2.5-12,3-10,3-11.5,4-10,4-8,5-7,5-merou,6-17,60-90,8-18,9-12,9-17,abaxially,absen,absent,accrescent,acicular,across,adaxiall,adult,alyx,andromonoecious,anvil-shape,apart,articulated,ascending,axe,ba,bark,blade,branch,branche,connivent,contiguous,corky,cross-section,cylindrical,decimetre,directed,distall,distributed,dm,eaf,eed,eglandular,exocarp,finger,fruiting,functional,furrowed,geminat,gland-tipped,half,heterostylous,interpetalar,juicy,juvenile,lamina,leaf-opposed,less,lobed,long,longer,loosely,lower,mature,mesocarp,mid-point,midpoint,minute,moist,nearly,nflorescence,oblique,oblong,often,orolla,pair,part,pedicel,peduncle,per,placenta,pore,porrect,present,prickle,rachi,ruit,rusty,shallowly,short,simple,somewhat,spaced,sparse,stalk,stalked,straight,tal,tamen,tem,thick,throughout,time,tissue,transparent,unarme,unarmed,unit,upper,vary,weakly,wide,yellowish,ympodial	branching,color,corolla,dioecious,form,growth,height,history,life,midrib,na,ovary,pubescence,reproduction,seed,shape,size,staman,stem,stigma,stipe,texture,tip,vein,width
321	wfo-0001028067	success	139	103	72	67	31	0.518	0.5-1,0.5-1.5,0.5-2,1-2,1-3,1-7,1.5-2.5,2,2-2.5,2-3,2.5-3,3-17,3-5,5-7,6-12,6-18,7-11-compound,7-20,7-9,abaxially,acuminate,acute,adaxially,apex,base,calyx,cm,color,cuneate,dark,diameter,elliptic-fusiform,entire,flattened,flower,fruit,glabrous,lateral,leaf,lobe,long,margin,midrib,mm,moderately,narrowly,obtuse,petiole,pink,pinnately,puberulent,purple,rarely,shrub,simple,sparsely,stellate,stigma,strongly,style,subcoriaceous,time,tip,tomentulose,triangular,truncate,tube,unbranched,unknown,wide,x,yellow	-30,1,1-10,1-11,10-25,3-4,3-7,4-foliat,8-13,adaxiall,aggregate,along,apart,articulated,axe,basiscopically,blade,cell,chartaceous,compound,connivent,cylindrical,decurrent,directed,distall,eaf,eed,elliptic-ovate,especially,glabrou,hair,leaflet,leaving,lon,lower,nearly,nflorescence,nther,often,orolla,pedicel,pedicellar,peduncle,per,pore,puberulen,rachi,radiu,remnant,ripe,ruit,several,slightly,smal,spaced,stone,tal,tem,triangular-deltate,truncat,unequal,unit,upper,usually,vary,ympodial,zigzag	anther,branching,corolla,filament,form,growth,height,history,inflorescence,length,life,midpoint,midvein,na,ovary,perennial,plant,pubescence,ray,reproduction,seed,shape,size,staman,stellae,stem,stipe,surface,texture,vein,width
322	wfo-0001028069	success	253	101	85	168	16	0.336	0.05-0.1,0.3-0.45,0.3-0.6,0.4-0.5,0.4-0.8,0.5,0.6-1.1,0.8-1.2,1-2.7,1.5-2.0,1.6-3.2,10,10-12,12,2-17,2-3-branched,3,5-25,<,acute,along,anther,brown,calyx,cell,cm,composed,corolla,deep,dense,densely,diameter,eglandular,filament,flower,fruit,glabrescent,glandular,glandular-villous,globose,green,hair-like,herb,lateral,leaf,length,linear,lobe,long,midvein,minute,minutely,mm,obovate,occasionally,orange,outgrowth,ovary,ovate,pale,patent,pentagonal,perennial,plant,pubescence,pubescent,short,simple,size,stem,stigma,straight,style,surface,tangled,testa,thick,transparent,trichome,tube,uniseriate,wall,weak,wide,yellow	-0.4,-30,-6,.1,.1-0.2,.2,.5,0.1-0.15,0.1-0.2,0.1-0.3,0.1-0.5,0.1-0.6,0.2-0.3,0.2-0.5,0.3,0.3-0.4,0.3-0.7,0.3-1,0.4,0.4-1,0.5-0.7,0.5-1.8,0.5-2,0.6-4,0.7-1,0.7-1.3,0.7-1.5,1-2-celled,1-3.5,1-4.5,1.4,1.5-3.5,10-30,2-4,2-7,2-locular,3-,3-foliate,4-celled,5-22,6-,abaxially,absen,abundant,accrescent,adjacent,adpressed,alternate,always,among,anthesi,apex,apical,appearance,appendage,appressed,articulated,axi,ba,basal,base,basioscopically,becoming,berry,bilaterally,bract,bracteole-like,bright,citru,column,cone-shaped,conical,cordate,cuneate,curving,decurrent,deeply,due,eaf,ebracteate,edicel,eed,erect,exserted,forming,fruiting,fusion,giving,gland,gland-tippe,gland-tipped,gree,half,halfway,head,imparipinnate,included,initially,interjected,internode,interrupted,larger,later,leaflet,less,like,lime,lobed,lon,longer,longest,lower,margin,maturity,middl,multicellular,narrowly,nflorescence,oblique,often,one,pair,pedicel,peduncle,per,petiole,petiolule,population,present,primary,procumbent,pseudostipule,quaternary,rarely,reflexed,robust,rounded,ruit,scarcely,scent,secondary,sessile,several,shaggy,shorter,silky,single-celled,slender,smaller,somewhat,staminal,sterile,strong,subopposite,symmetric,tem,terminal,tertiary,tightly,toward,ud,unicellular,unit,usually,varying,viny,winged,ympodial	color,form,growth,height,history,inflorescence,life,midrib,na,reproduction,seed,shape,staman,texture,tip,width
323	wfo-0001028070	success	185	103	79	106	24	0.427	%,0-2,0.2-0.3,0.3-0.4,0.3-0.6,0.35-0.5,0.5-1.5,1-1.5,1-2,1.5-2.5,3-7,3.5-4,4-5.5,4-7,4-9,7-11,8-9.5,8.5-17,acute,adaxially,andromonoecious,anther,apex,base,brown,calyx,chartaceous,cm,cuneate,cylindrical,dark,deltate,densely,diameter,entire,erect,flower,fruit,globose,green,inflorescence,lamina,lavender,length,linear,lobe,long,margin,mm,moderately,oblique,obtuse,pale,part,perennial,petiole,plant,pseudo-racemose,pseudo-umbellate,rhizomatous,rusty,shrub,sparsely,stellae,stellate,stellate-pubescent,stem,stigma,straight,streak,style,thick,time,tube,unbranched,white,wide,x,yellow	.05,0-0.1,0-0.15,0-0.4,0-6,0.15-0.4,0.25-0.35,0.4-0.5,0.4-0.6,0.4-0.8,0.5-0.9,0.5-1,0.6-1.4,0.7-1.3,1-4,1-locular,1.5-7,10-40,3-8,4-6,5-7,5-9,5-merou,7-8,8-13,8-9,abaxially,absen,absent,accrescent,acicular,across,adaxiall,alyx,apart,articulated,axe,ba,blade,connivent,cross-section,d.,directed,distall,distributed,dult,eaf,eed,eglandular,exocarp,extra-axillary,finger,fruiting,functional,geminat,gland-tipped,hair,half,heterostylous,hig,incomplete,juicy,lanceolate,lateral,less,longer,lower,mature,mesocarp,mid-point,midpoint,midvein,minute,moist,nflorescence,orolla,pedicel,peduncle,per,placenta,pore,porrect,present,prickle,purple,ray,ruit,semi-circula,septum,sessile,short,simple,spaced,stage,stalk,tamen,throughout,truncat,unarme,unarmed,unit,unknow,uvenile,vary,weakly,ympodial	abaxial,adaxial,branching,color,corolla,filament,form,growth,height,history,leaf,life,na,ovary,pubescence,reproduction,seed,shape,size,staman,surface,texture,tip,width
324	wfo-0001028075	success	196	103	76	120	27	0.388	1-2,1.5-2.5,1.6-2.7,10-35,2-4.5,2-6,3-23.5,4-7,5-12,5-17,5-7,5-8,7-30,8-12,abaxially,acuminate,acute,adaxially,anther,apex,base,brownish,chartaceous,ciliate,cm,condition,corolla,dark,diameter,drying,filament,flower,forked,fresh,fruit,glabrescent,glabrous,globose,green,greenish,herb,lateral,leaf,light,lobe,long,margin,membranous,midrib,minutely,mm,mucilaginous,oblique,obtuse,odd-pinnate,ovoid,pale,pentagonal,petiole,plant,puberulent,rotate,rounded,seed,size,stigma,style,subcordate,tip,tube,wet,white,whitish,wide,x,yellow	.5,1-10,1-2.7,1-3,1.5-7,2-3,2.5-10,3-11,4-12,5-14,5-9,5-merou,7-13,absent,acuman,acumen,ag,along,alyx,apart,apparently,articulated,axe,axillary,berry,blade,borne,broadly,bud,capitat,cell,connivent,covering,cuneate,decreasing,differentiated,digestion,distal,distally,distinctively,dorsally,dot,eaf,edge,eed,elliptic-lanceolate,end,enzyme,erec,especially,exceeding,flat,folded,geminat,generally,glabrescen,green-white,hair-like,half,homostylous,honeycomb-shaped,interjected,lanceolate,larger,leaflet,lengthening,ligulate,living,lower,make,middl,much,narrow,nflorescence,often,orolla,ovate,ovate-elliptic,pair,pedicel,peduncle,perfect,petiolule,plurifoliate,pore,poricidal,purple,reflexed,removed,ruit,scattered,seudostipule,singly,slightly,slit,sometimes,spaced,specimen,stamen,star,stolo,straight,subtending,tall,tamen,tem,terminal,testal,thick,throughout,toward,tri-,tuber,typically,unit,usually,vary,wall,wing,ympodial	branching,calyx,color,form,growth,height,history,inflorescence,length,life,midpoint,midvein,na,ovary,perennial,pubescence,ray,reproduction,shape,staman,stellae,stem,stipe,surface,texture,vein,width
325	wfo-0001028076	success	195	85	65	130	20	0.333	.5,0.4-0.5,1-1.3,1-2,1.8-2.2,110,13-14,2-12,2.2-2.6,2.5-4,4-5,5-20,5-6,5-6.5,7-8,abaxially,adaxially,anther,brownish,chartaceous,cm,condition,conical,corolla,diameter,drying,filament,flower,forked,fresh,fruit,glabrous,green,greenish,herb,leaf,less,light,lobe,long,membranous,mm,mucilaginous,odd-pinnate,ovoid,pentagonal,petiole,plant,pubescent,purple,rarely,ripe,rotate,seed,size,stem,stigma,style,tall,tube,wet,whitish,wide,x,yellow	0.5,1-10,1-3,1.2-2.2,12-22,2-3,2-5.4,2.2-3.7,2.5-3,2.6-3.8,4.5-7,5,5-merou,?,absent,acumen,acuminate,ag,alyx,apart,apex,apparently,articulated,attenuate,axe,axillary,base,berry,blade,borne,bud,capitat,cell,ciliate,connivent,covering,decreasing,densely,digestion,distal,dorsally,eaf,edge,eed,elliptic,end,enzyme,erec,especially,exceeding,flat,folded,geminat,generally,glabrou,gradually,green-white,hair,hair-like,half,homostylous,honeycomb-shaped,interjected,lanceolate,larger,lateral,leaflet,lengthening,like,living,lower,make,margin,medium,minute,nflorescence,obtuse,orolla,ovate,pair,pedicel,peduncle,perfect,petiolule,plurifoliate,pore,poricidal,proximal,pubescen,ray,removed,round,ruit,secondary,semierect,sessile,seudostipule,singly,slightly,slit,spaced,specimen,stamen,ste,stolo,straight,subequal,subsessile,subtending,symmetrical,tamen,tem,terminal,testal,thick,thir,throughout,tip,toward,tri-,tuber,typically,unit,unwinged,usually,vary,wall,white,wing,ympodial	branching,calyx,color,dense,form,growth,height,history,inflorescence,length,life,na,ovary,perennial,pubescence,reproduction,shape,staman,surface,texture
326	wfo-0001028080	success	187	103	79	108	24	0.422	0.25-0.5,0.5-1.5,0.5-2,0.5-3,1,1-1.5,1-2,1-3,1.5-2,1.5-5,2-2.5,2.5-3,2.5-9,3-4,4-6,5-6,6-7,8-10,acuminate,acute,andromonoecious,anther,apex,base,brown,calyx,chartaceous,cm,densely,diameter,ellipsoidal,entire,filament,flower,form,fruit,glabrous,green,lateral,lobe,long,margin,midvein,mm,moderately,narrowly,outline,ovate,ovoid,petiole,plant,puberulent,pubescent,reniform,rugulose,shrub,side,sometimes,sparsely,stellate,stellate-pubescent,stem,stigma,style,subcordate,surface,time,triangular,truncate,tube,unbranched,unequal,vein,white,white-pubescent,whitish,wide,x,yellow	0.2-1.5,2-10,2-3,2-5,2-8,20-30,30-40,5-12,5-merous,abaxially,absent,accrescen,adaxiall,adaxially,alyx,andromonoeciou,apart,armed,articulated,axe,ba,bark,berry,blade,branch,brownish,capitat,clavate,connivent,cylindrical,directed,distally,eaf,eed,eglandular,equal,extra-axillary,fine,fissure,flattened,formed,free,fruiting,geminat,glandular,gradually,hair,hermaphroditic,heteromorphic,interpetalar,lanceolate,leaf-opposed,like,linear-lanceolate,long-,long-stalked,longitudinal,lower,lowering,major,midpoint,multangulate,needle-like,nflorescence,opening,orolla,part,pedicel,peduncle,pendent,perfect,pericarp,persistent,plurifoliate,pore,porrect-stellate,prickle,projection,rachi,ray,recurved,ruit,scandent,sessile,short-,short-stalked,short-styled,shorter,simple,slit,small,spaced,staminate,stellate-multangulate,straight,strongly,tall,tamen,tapered,thi,tissue,unarmed,unit,vary,vertical,weakly,without,ympodial	branching,color,corolla,growth,height,history,inflorescence,leaf,length,life,midrib,na,ovary,perennial,pubescence,reproduction,seed,shape,size,staman,stellae,texture,tip,width
327	wfo-0001028105	success	150	95	71	79	24	0.473	.1,.4,.5,0.3-1.5,0.5-1,0.5-2,0.6-1,1-1.2,1.5-1.8,1.5-2,2,3-6,3.5-4,5-7-flowered,9.5-15,abaxially,adaxially,anther,anthesi,apical,axil,base,calyx,cm,corolla,dark,dense,dia,elliptic,filament,flattened-reniform,glabrous,globose,green,incrassate,leaf,lobe,lobed,long,margin,minutely,mm,nearly,ovary,pale,petiole,pitted,planar,projection,pubescent,reddish-brown,reflexed,scattered,shrub,simple,size,slightly,small,stem,stigma,style,surface,tip,tree,trichome,tube,tuft,uniseriate,vein,white,x	0.5,1-1.5,1-2.5,1.5,1.5-4.5,2-2.2,2-5,3-5-celled,6-7,acuminate,acute,apar,apex,attenuate,axi,ba,bark,berry,bilobed,clavate,conical,deflexed,differing,difoliate,distinct,drying,eaf,edicel,eed,ellipsoid,erect,evenly,exserted,filiform,free,fruiting,geminat,glandular,greenish-yello,lamina,lateral,like,lon,lower,main,major,middle,minor,nflorescence,occasionally,older,olive-green,opposite,pair,papillo,papillose,pedicel,pore,poricidal,portion,quadrate,ruit,scar,shaped,spaced,sparsely,spreading,straight,strongly,tall,tear-drop,tub,ud,unit,widest,woody,yellowish,ympodial,young	branching,color,diameter,flower,form,fruit,greenish-yellow,growth,height,history,inflorescence,length,life,midrib,na,perennial,plant,pubescence,reproduction,seed,shape,staman,texture,width
328	wfo-0001028109	success	205	112	88	117	24	0.429	-20,-4,-7,0.1-0.2,0.4-0.8,0.45-0.65,0.5-2.5,0.6-0.8,0.8-1.5,1.5-2.5,1.5-5.5,12-40,2-4,2.3-2.9,2.5-3,2.5-5,2/3-3/4,3-,30-150,4-13,5-13,8-25,abaxially,acuminate,acute,almost,anther,apex,apically,base,branching,bright,calyx,chartaceous,cm,cuneate,deltate,densely,diameter,dull,elliptic,entire,evenly,filament,flattened-reniform,flower,fruit,glabrous,green,lateral,leaf,length,lobe,lobed,long,margin,maturity,mauve,midpoint,mm,moderately,obtuse,orange-brown,petiole,primary,ray,red,secondary,shrub,small,smooth,sometimes,spherical,stellate,stellate-pubescent,stem,style,surface,tip,tree,tube,vein,way,weakly,white,wide,yellow,young	.5,/3,0.05-0.15,0.05-0.2,0.1,0.3,0.4-1.5,0.5-1.2,0.7,0.8-1.6,1.5-10,1/8-1/4,10-25,10-30,15-100,2-15,20-60,3-7,3.5-6,3/4,4-5-merous,5-30,8-12,8-15,abaxial,acut,adaxial,alyx,ame,apar,apart,apparently,articulated,bark,berry,blade,brow,c.,connivent,curved,dimorphic,discolorous,drying,eaf,eed,elongating,equal,erect,free,fruiting,fully,geminate,gently,glabrescent,glabrou,gray-green,green-brown,infructescence,light,long-styled,longer,lower,mature,minor,multangulate,nflorescence,occasionally,older,one,open,opening,orolla,oung,pair,pedicel,peduncle,per,perfec,pericarp,perpendicular,plurifoliat,poricidal,porrect,portion,prickl,prickle,prickly,recurved,red-brown,reflexed,ruit,scar,sessile,simple,slender,spaced,spreading,stalk,stalked,straight,strongly,tamen,tapering,terete,terminal,tertiary,time,trichome,unarme,unarmed,unit,usually,vary,venation,visible,woody,ympodial	color,corolla,form,growth,height,history,inflorescence,life,midrib,midvein,na,ovary,plant,pubescence,reproduction,seed,shape,size,staman,stellae,stigma,stipe,texture,width
329	wfo-0001028115	success	165	113	78	87	35	0.473	-1.1,-2.5,-5.2,.6,0.2-0.3,0.42,0.5,0.6-0.7,0.7-0.8,1.1-1.8,1.4-1.7,1.7-2.2,1.8-3.5,2-3.2,5-15,6-10,abaxially,abundant,acute,adaxially,anther,antrorse,apex,attenuate,basal,base,berry,blue,calyx,campanulate,cm,diameter,ellipsoidal,elliptical,entire,filament,glabrescent,glabrous,glandular,globose,half,herb,length,light,lobe,long,margin,mixed,mm,moderately,narrowly,non-glandular,one,ovate,pale,petiole,pinnatifid,pinnatipartite,pinnatisect,prostrate,pubescent,rarely,scarce,seed,similar,small,stem,stigma,style,tip,trans-ovoidal,trichome,tube,violet,wide,width,x,yellow	.2,0.8-,1-2.4,1-3,1.3-1.8,12-13.5,2-,2.5-,3-4.5,3-5,3-6.5,4.7-,5-8.5,7-7.5,9-17,accrescent,acuminat,ag,alternate,amply,annular,articulate,blade,capitate,coat,connectival,curved,difoliat,dorsal,eaf,eed,embryo,especially,evident,exceeding,fruiting,growing,herbaceous,hig,inflated,linear,longer,longitudinal,longitudinally,lower,much,multi-seeded,near,nerve,oblong,opening,opposite,orolla,pair,papery-scarious,papillo,pore,poricidal,portion,prolongation,ree,reticulate,ridged,ruit,segment,simple,slender,slightly,slit,smooth,sometimes,strongly,styl,subsessil,tem,time,triangular,tuberculate,unequal,unifoliate,uniseriate,unit,vary,venation,wider,winged,ympodial	0.8-2.4,2-6.5,2.5-4.5,branching,color,corolla,flower,form,fruit,growth,height,history,inflorescence,lateral,leaf,life,midpoint,midrib,midvein,na,ovary,papillose,perennial,plant,pubescence,ray,reproduction,shape,size,staman,stellae,stipe,surface,texture,vein
330	wfo-0001028131	success	208	116	89	119	27	0.428	.5,0.1-0.15,0.2-1.5,0.3-0.7,0.4-0.8,0.8-1,0.8-1.1,1-5,1.5-3,1.8-2.2,2-2.8,2-4,2-6.5,3-6,4-6,5-6.5,5-8,anther,apex,apically,attenuate,base,branched,calyx,cell,chartaceous,cm,cream,dark,densely,diameter,dull,filament,flattened-reniform,flower,fruit,glabrescent,green,herb,lanceolate,lateral,leaf,length,lobe,lobed,long,longer,margin,marking,mature,mauve,membranous,midpoint,midvein,mm,moderately,narrow-obovate,narrow-ovate,oblong,obtuse,orange,orange-brown,outline,pale,pale-brown,petiole,pit,purple,raised,ray,red,rounded,shiny,small,smooth,sparsely,spherical,stellate,stellate-pubescent,stem,style,surface,time,tip,tube,vein,wide,yellow,young	-1.2,.1,/5,0-0.6,0-2,0-3,0-30,0-4,0.05-0.2,0.1-0.3,0.5-1.1,0.7-1.1,1-10,1-3,1-4,1.5-5,1.8-2,1/4-2/3,1/5,2-5,2/3,5-merous,6-7,7-8,abaxial,abaxially,absent,acuminat,adaxial,alyx,apar,apart,apparently,articulated,bark,berry,blade,broad-deltate,concolorous,connivent,curved,deltate,difoliate,distance,drying,eaf,eed,elongating,epidermi,equal,erect,extending,eye,filiform,flattened,free,fruiting,geminat,glabrous,gland,infructescence,lengt,like,lower,maturity,naked,nflorescence,often,older,one,open,orolla,oung,pair,pale-gra,pedicel,peduncle,pendulous,per,perfec,pericarp,poricidal,porrect,portion,prickl,prickle,prickly,primary,reduced,reflexed,ruit,scar,sessil,sessile,shorter,side,simple,sometimes,spaced,spreading,straight,strongly,sunk,tamen,tapering,terete,tertiary,trichome,unarme,unarmed,unit,upper,vary,venation,visible,way,woody,yellow-green,ympodial	acuminate,branching,color,corolla,form,growth,height,history,inflorescence,life,midrib,na,ovary,pale-gray,perennial,plant,pubescence,reproduction,seed,shape,size,staman,stellae,stigma,stipe,texture,width
331	wfo-0001028147	success	185	108	75	110	33	0.405	.5,0.5,3-5,4-5,abaxially,acuminate,adaxially,anther,apex,base,branched,broadly,brown,calyx,chartaceous,cm,corolla,cuneate,dark,decurrent,deltate,diameter,dry,entire,except,filament,flattened-reniform,flower,glabrous,globose,green,immature,lanceolate,lateral,light,lobe,long,margin,mature,midrib,minutely,mm,mottled,narrowly,oblong,orange,ovate,ovoid,pale,petiole,pitted,puberulent,rugose,seed,shape,side,somewhat,stellate,stem,stigma,style,surface,time,tip,tube,turning,vein,vine,white,wide,x,yellow,yellow-green,yellowish-orange,×	0.25,0.6,1.5–2,1.5–5.5,1.6–2.3,10–15,15–20,1–2,1–4,1–5,2–4,2–7,2–8,3.5–4.5,3.5–9,3–4,3–6,5–10,5–12,6–9,7–10,absent,acute,ag,alyx,anthesi,appearing,armed,articulated,axe,becoming,berry,blade,break,bud,campanulate,cell,connivent,deciduous,dr.,eaf,eed,ellipsoid,elongate,elongating,equal,exserted,fifth,five,four,fruiting,hairy,herbaceous,internode,interpetalar,larger,lengthening,lobed,long-styled,longer,lower,major,nearly,nflorescence,often,one,orange-red,orolla,outer,paired,pedicel,peduncle,pentagonal,pericarp,plurifoliat,pore,poricidal,prickle,pulp,rachi,rarely,recurve,recurved,robust,ruit,season,seen,shallowly,short-styled,simple,slender,slightly,slit,spine,spreading,stout,straight,subcaudate,tamen,terminal,testal,tissue,truncat,unequal,unit,vary,wall,wood,woody,ympodial	0.25-0.6,1-4,1.5-2,1.5-5.5,1.6-2.3,10-15,15-20,2-4,3-6,3.5-9,5-12,6-9,7-10,branching,color,form,fruit,growth,inflorescence,leaf,length,midpoint,midvein,na,ovary,pubescence,ray,size,staman,stellae,stipe,texture,width
332	wfo-0001028148	success	157	120	93	64	27	0.592	0.25-0.5,0.5-1.5,0.6-3.5,0.75-2,1.5,1.5-2.5,15,2-3,2.5-4,20-50,3.5-4,3.5-9,4.5-10,5,5-7,6-18,abaxially,acute,adaxially,angled,apex,apiculate,base,blue-black,branched,broadly,calyx,cm,cylindrical,dark,decurrent,densely,diameter,distal,elliptic,entire,especially,except,fleshy,flower,fresh,fruit,glabrous,glaucous,globose,hair,highly,less,light-colored,lobe,long,margin,material,midrib,minute,mm,moderately,narrowly,orange,part,petiole,pink,plicae,plicate,puberulence,puberulent,puberulent-pubescent,purple,rarely,rhizomatous,ridge,ripe,rotate-stellate,scalloped,shrub,smooth,sparse,stigma,style,succulent,surface,tapered,time,tip,treelet,triangular,tube,unbranched,violet,whitish,wide,x,yellow	-6,.5-4,1-15,1-3.5,10-30,12-15,2,2-7,4-10,5-10,5-20,5-8,absen,aggregate,apart,articulated,axe,ba,blade,cell,central,chartaceous,connivent,deltate,directed,distall,eaf,eed,lower,many-foliat,margi,mature,nflorescence,nther,obtuse,often,orolla,ovate,pedicel,peduncle,perfect,pore,rachi,radiu,ruit,simple,slender,slightly,smoot,sometimes,spaced,star,stone,tal,tem,thickened,truncat,unit,usually,vary,white,winge,ympodial,young	0.5-4,4-6,anther,branching,color,corolla,filament,form,growth,height,history,inflorescence,leaf,length,life,na,ovary,plant,pubescence,reproduction,seed,shape,size,staman,stem,texture,width
333	wfo-0001028161	success	124	102	67	57	35	0.54	0.1-0.25,0.25-0.5,1-1.3,1-1.5,1.5-4.5,2-5-flowered,2-9,2.5-3,3-4,3-7,7.5-12,9-11,acuminate,acute,adaxially,along,apex,attenuate,base,branch,branched,brown,calyx,cell,closely,cm,congested,corolla,dendritic,denser,dia,elliptic,globose,green,incrassate,lanceolate,lateral,leaf,long,main,margin,minutely,mm,narrowly,outline,ovoid-reniform,pair,pale,petiole,pitted,pubescence,pubescent,reddish-brown,shape,short,shrub,simple,sinuate,size,somewhat,sparsely,stem,surface,tan,trichome,vein,x	.5,0.7-1.7,1-2,1-2.3,1/3,4-5,6-9,abaxially,anthesi,arising,ba,bark,berry,consisting,deflexed,densely,differing,difoliate,distal,eaf,edicel,eed,exserted,fruiting,geminat,glabrescen,inflorescenc,later,like,lon,major,middle,minor,nflorescence,obovoid,often,older,opposite,orbicular,overlappin,pedicel,probably,rest,rounded,ruit,scar,spaced,strongly,tall,tapering,thin,tub,ud,unit,widest,ympodial,young	anther,branching,color,dense,diameter,filament,flower,form,fruit,growth,height,history,inflorescence,length,life,lobe,midpoint,midrib,midvein,na,ovary,perennial,plant,ray,reproduction,seed,staman,stellae,stigma,stipe,style,texture,tip,tube,width
334	wfo-0001028164	success	197	130	103	94	27	0.523	-14,-6,/4,0.05-0.2,0.5-0.8,0.5-1,0.7-1.1,0.9-1.6,1-1.5,1-4.5,1.8-2.5,1/3,1/6-1/4,2-2.5,2.5-4,2.5-4.5,2.8-4,3-7,3.6-4.8,4-8,8-15,8-17,abaxially,acuminate,acute,ame,anther,apex,apically,apparently,attenuate,base,berry,blade,branched,bright,c.,calyx,cm,densely,diameter,dull,elliptic,entire,erect,evenly,filament,flattened-reniform,flower,fruit,glabrescent,glabrous,glandular,gray,green,hair,lateral,leaf,length,lobe,lobed,long,longer,margin,maturity,mauve,membranous,midvein,minute,mm,moderately,narrow-deltate,obtuse,orange-brown,pale,petiole,ray,red,shallowly,shorter,shrub,smooth,sometimes,sparsely,spherical,spreading,stellate,stellate-pubescent,stem,style,surface,terminal,time,tip,tube,undulate,upper,vein,way,white,wide,yellow,young	-1,-8,0-20,0.05-1.5,0.1,0.3-0.8,0.4-0.8,0.8-1.5,1,1.5-2.5,12-20,3-17,4-13,4-5-merous,4-7,6-8,abaxial,almost,alyx,apar,articulated,bark,concolorous,connivent,curved,dark,deltate,difoliate,drying,eaf,eed,elongating,equal,eye,filiform,free,fruiting,geminat,glabrescen,glabrou,infructescence,less,long-acuminat,lower,mature,midpoint,multangulate,naked,nflorescence,often,older,one,open,orolla,oung,pair,pedicel,peduncle,per,perfec,pericarp,poricidal,porrect,portion,primary,recurved,red-brown,reflexe,ruit,scar,sessile,shorte,side,simple,spaced,stalk,stalked,straight,tamen,tapering,terete,tertiary,trichome,unarme,unarmed,unit,variously,vary,venation,visible,woody,yellow-gra,yellow-green,ympodial	branching,color,corolla,form,growth,height,history,inflorescence,life,long-acuminate,midrib,na,ovary,perennial,plant,pubescence,reproduction,seed,shape,size,staman,stellae,stigma,stipe,texture,width,yellow-gray
335	wfo-0001028180	success	147	106	79	68	27	0.537	.05,.5,1-1.2,1-1.5,1-1.8,1-3,15-28,2-3,2.5-3,20-30-flowered,3-4,4.5-5,5-6,5-8,7,8-10,abaxially,acute,adaxially,along,anther,apex,attenuate,base,calyx,cm,corolla,cucullate,dark,deltate,densely,dia,drying,elliptic,filament,glabrous,globose,golden,green,irregularly,lateral,leaf,lobe,lobed,long,main,margin,midrib,minutely,mm,nearly,onto,ovary,ovoid-reniform,pair,pale,papillose,petiole,pinkish-white,pitted,pubescent,shiny,simple,size,somewhat,stem,stigma,style,surface,tan,tip,tree,trichome,tube,uniseriate,vein,white,winged,x	/2,0.7-1,1.5-5,2-2.2,3-10,anthesi,ba,bark,beginning,berry,c.,capitate,closely,conical,darker,deflexed,differing,difoliate,distinctly,eaf,eed,elongate,erect,falcate,fleshy,four-angled,free,fruiting,geminat,glabrat,gold,know,larger,leathery,lon,lower,major,minor,nflorescence,obscure,older,opposite,overlappin,pedicel,planar,pore,poricidal,portion,puberulent,ruit,scar,shaped,small,spaced,sparsely,straight,styl,tall,tear-drop,thick,ud,underside,unit,way,woody,yellow-gray,ympodial,young	branching,color,diameter,flower,form,fruit,growth,height,history,inflorescence,length,life,midpoint,midvein,na,perennial,plant,pubescence,ray,reproduction,seed,shape,staman,stellae,stipe,texture,width
336	wfo-0001028182	success	150	74	58	92	16	0.387	.5,0.5-1,0.8-1,0.9-1,1-1.5,2-2.5,2-6.5,3-5,4-6,6-9,anther,base,beneath,black,calyx,cm,corolla,dry,ellipsoid,filiform,glabrous,globose,hemiepiphyte,inflorescence,keeled,later,lateral,lax,leaf,like,lobed,long,material,mm,narrowly,nearly,obovoid,ovary,ovate,pair,pedicel,petiole,pubescent,purplish,shiny,shrub,simple,sparsely,stem,stigma,style,trichome,tube,uniseriate,vein,white,x,young	0-90,0.1-0.2,0.5,0.5-0.6,2,3,5-15-flowered,5-ribbed,along,anthesi,apart,apex,apiculae,apiculate,arching,axi,bark,bending,blade,branch,brown,capitate,ciliate,conical,cordate,deflexed,deltoid,densely,dia,eaf,edicel,eed,evenly,except,extreme,filament,flower,free,gre,internodal,know,known,less,lobe,long-acuminate,lower,main,margin,midrib,minute,minutely,nflorescence,older,opposite,papillo,papillose,planar,pore,poricidal,portion,present,prominent,proximal,reflexed,rib,rounded,ruit,sca,scar,shaped,slender,slightly,somewhat,spaced,sparser,specimen,spindly,still,strongly,surface,tapering,tear-drop,third,time,tip,truncate,ud,unifoliat,unit,widest,ympodial,zig-zag	branching,bud,color,diameter,form,grey,growth,height,length,midvein,na,plant,pubescence,shape,size,texture
337	wfo-0001028183	success	237	130	103	134	27	0.435	-10,0.2-0.3,0.5-2.5,0.7-1.2,0.7-2,0.8-1.4,1.1-1.8,1.2-1.4,1.3-1.7,1.4-2.8,1.5-3.4,1.9-3.7,10-15,11-30,2-5,2.8-4.2,3.5-6.6,4.5-9,50-400,7.5-23,9-13,abaxial,abaxially,acute,adaxially,anther,apex,attenuate,base,branched,brown,calyx,chartaceous,cm,corolla,cuneate,dark,deltoid,diameter,drying,dull,elliptic,entire,filament,flower,fruit,glabrescent,glabrous,globose,hair,half,lanceolate,lateral,leaf,lobe,lower,many,margin,midrib,mm,narrowly,nearly,orangish-tan,ovate-lanceolate,petiole,porrect-stellate,pseudoterminal,pubescence,pubescent,purple,reportedly,reticulate-punctate,ripe,scabrous,shrub,side,simple,small,soon,sparingly,stellate,stem,stigma,stipitate-glandular,streak,strongly,style,sub-lenticular,surface,tan,time,tip,tree,tube,upper,usually,vein,violet,white,whitish,x,yellow,yellowish	-5.3,.5-3,0.1,0.1-0.2,0.1-0.4,0.1-0.9,0.2-0.4,0.2-0.5,0.5,0.6,0.8-3.1,1.3-1.4,1.6-2.3,1.7-2.7,1/3-1/2,2-4.2,2.2-5.7,2.5-4.1,2.6-4.4,3.2-,4.6-6.4,5-8,5-8.5,5.2-6.2,6.6-20,8-9.1,accrescent,ag,along,alyx,anthesi,apart,apparently,around,articulated,axi,axillary,bark,berry,blade,blunt-tipped,branch,bud,capitate,cell,central,closely,cylindrical,dendritic-multangulate,directed,distally,distantly,eaf,earl,edge,eed,elongated,epidermal,especially,evident,except,exserted,farinose,few-rayed,free,fruiting,glabrescen,granular-punctate,group,high,inserted,lackin,lengthening,lobed,lon,long,long-decurrent,longitudinal,m.,main,multangulate,nflorescence,oblong,obovoid,older,open,orolla,overlapping,pedicel,peduncle,perfec,plurifoliate,pore,poricidal,porrect-stellat,present,prominent,rachi,rarely,relatively,ruit,runk,sessile,short,short-,slit,somewhat,spaced,sparse,spherical,splitting,stage,stalk,stamen,stout,subcampanulate,suture,tamen,terete,thick,thin,thin-textured,tomentose,touching,translucent,ud,unarme,unit,vary,way,wide,yellowish-tomentose,ympodial,young	3.2-6.4,branching,color,form,growth,height,history,inflorescence,length,life,midpoint,midvein,na,ovary,perennial,plant,ray,reproduction,seed,shape,size,sparely,staman,stellae,stipe,texture,width
338	wfo-0001028226	success	185	87	63	122	24	0.341	.5,0.15-0.3,0.15-0.45,0.25-0.5,0.6-1.3,1-2,1.2-2.6,2-5.5,2.5-3,2.7-3.2,3.5-4.5,5.5-8.5,anther,apex,brown,calyx,chartaceous,cm,deeply,deltate,densely,diameter,elliptical,flower,fruit,glabrous,globose,green,herbaceous,inflorescence,lavender,length,lobe,lobed,long,margin,midvein,mm,moderately,obtuse,ovate,pale,petiole,plant,present,prickle,prostrate,pseudo-umbellate,resprouter,rostrate,shallowly,solitary,sparsely,sprawling,stellae,stellate,stellate-pubescent,style,throughout,tube,unbranched,x,yellow	%,0-0.1,0-1,0-2,0.1-0.3,0.2-0.3,0.25-0.4,0.3-0.7,0.3-1,0.4-0.6,0.4-0.7,0.5-1,0.5-1.2,0.7-0.9,1,1-3,1-5,1.5-3,1.5-5,1.6-2.4,10-16,10-45,13-22,15-27,18-50,2-3,2-5,2.5-9,5-8,5-merou,6-8,7-8,9-14,9-15,abaxially,absen,absent,accrescent,acicular,across,adaxiall,adaxially,adult,alyx,andromonoecious,apart,apparently,armed,articulated,axe,ba,base,blade,branche,confined,cuneate,cylindrical,directed,distall,distributed,dm,eaf,eed,eglandular,extra-axillary,finger,fruiting,functional,geminat,gland-tipped,hair,half,heterostylous,index,juic,lamina,lateral,leaf-opposed,less,lobing,lon,longer,lower,mature,mesocarp,midpoint,midrib,minute,moist,nflorescence,oblique,onl,orolla,part,pedicel,peduncle,per,plurifoliate,pore,porrect,ray,ruit,sessile,short,side,simple,somewhat,spaced,stage,straight,strongly,tal,tamen,tem,thick,time,transparent,unit,uvenile,vary,wide,ympodial	abaxial,adaxial,branching,color,corolla,filament,form,growth,height,history,leaf,life,na,ovary,pubescence,seed,shape,size,staman,stem,stigma,surface,texture,tip
339	wfo-0001028227	success	236	106	86	150	20	0.364	-6.2,0-250,0.2-0.3,0.8-1.4,0.9-1.4,1-1.7,1-2.5,1-4.2,1.2-2,1.4-2.6,1.5-2.3,1.7-2.8,10,10-24,2-12,2-3.8,2.5-7.8,3-4.9,3.7-6.3,4.8-7.6,6-16,abaxially,acute,adaxially,anther,branched,brown,brownish,calyx,cm,corolla,cylindrical,dark,deltoid,diameter,drying,echinoid,elliptic,farinose,filament,fleshy,flower,fruit,glabrescent,globose,granular-tomentose,gray,green,leaf,lobe,many,midrib,mm,multangulate,oblong-lanceolate,older,orangish-tan,ovate-lanceolate,pale,petiole,porrect-stellate,pseudoterminal,pubescence,pubescent,purple,reticulate-punctate,ripe,scabridulous,shrub,sparsely,stellate,stem,stigma,style,sublenticular,surface,time,tip,tomentose,tree,tube,velutinous,violet,x,yellow,yellowish	-2/3,.5-4,0.1,0.2,0.2-0.4,0.2-0.5,0.3,0.4,0.5,0.7-2.1,0.8,0.9,0.9-1.2,1,1.1-3.1,1.3-4,1.4,1.9,1.9-4.2,1.9-5.8,1/2,1/2-3/4,11-15,2.6-5.9,2.9-4.7,3.7-7,4-13,5-7.5,6.7-15,8.1-18,8.5-22,abaxial,accrescent,acuminate,ag,age,along,alyx,anthesi,apart,apex,apparently,appressed,around,articulated,attenuate,axillary,bark,base,becoming,berry,blade,blunt-tippe,blunt-tipped,branch,bud,c.,closely,cuneate,decurrent,dendritic-echinoid,directed,distally,eaf,early,echinoi,edge,eed,elongate,ength,entire,exserted,free,fruiting,glabrous,grayish,hair,high,inserted,lacking,lanceolate,lateral,lengthening,less,lobed,lon,long,longitudinal,lower,m.,main,margin,midvein,mostly,nflorescence,oblong,obscured,obtuse,occasionally,often,orbicular,orolla,ovate-orbicula,overlapping,pedicel,peduncle,perfec,plurifoliate,pore,poricidal,present,prominent,quarter,rachi,relatively,rounded,ruit,runk,sessile,side,simple,slightly,slit,somewhat,spaced,stalk,stamen,stout,subcampanulate,subspherical,sulcate,suture,tamen,thick,thicker,thin,tomentu,touching,ud,unarme,unit,upper,usually,vary,vein,way,well,wide,ympodial,young	branching,color,form,growth,height,history,inflorescence,length,life,na,ovary,perennial,plant,reproduction,seed,shape,size,staman,texture,width
340	wfo-0001028228	success	143	95	63	80	32	0.441	0.1-1.7,1-1.5,1.1-1.2,1.2-1.8,10-30-flowered,2,2-8,2.8-6.5,3/4,6-7,6-8,7.5-12.5,acute,anther,apex,base,brown,calyx,cm,coriaceous,corolla,dark,deltoid,dia,dry,elliptic,filament,glabrous,globose,green,greenish-yellow,lateral,leaf,lobe,lobed,margin,material,minutely,mm,obovate,occasionally,ovary,ovoid-reniform,pair,papillose,petiole,reticulate,rounded,shining,shrub,simple,small,stem,stigma,style,surface,tip,tree,tube,vein,way,white,x	.5,0.75,1.1-2.5,1.5-2,1.8-3.4,2-5,2.1-4.2,abruptly,age,anthesi,area,ba,bark,becoming,beginning,beneath,berry,caly,campanulate,clavate,closely,deflexed,difoliate,distal,eaf,edicel,eed,erect,exserted,fragrant,free,fruiting,geminat,impressed,inflorescenc,lon,long,lower,main,major,middle,minor,minute,narrowing,nflorescence,older,opposite,overlapping,ovoid,pale,pedicel,planar,pore,poricidal,portion,prominent,ruit,scar,shaped,shinin,slender,slightly,spaced,straight,styl,sweetly,tall,tapering,tear-drop,terminal,thick-margined,thickened,ud,unit,usually,weight,widest,woody,ympodial,young	1.5,3,3.5,branching,color,diameter,flower,form,fruit,growth,height,history,inflorescence,length,life,midpoint,midrib,midvein,na,perennial,plant,pubescence,ray,reproduction,seed,shape,size,staman,stellae,stipe,texture,width
341	wfo-0001028234	success	155	102	64	91	38	0.413	/3,0.15-0.35,0.25-0.5,0.5-1.0,1-2.5,1.0-1.8,2.6.3.2,3-10,5-11,520,8-11,across,along,annual,anther,armed,around,base,blade,blue-tinged,broadly,brown,calyx,campanulate,cm,dark,dia,dm,extended,fully,glabrous,gland,green,hair,herb,leaf,linear-lanceolate,lobe,long,main,margin,mm,narrowly,ovate,petiole,plump,prickly,purplish-tinged,radially,ridged,sessile,short-stipitate,simple,spherical,stellae,stellate,stem,strait,triangular,tube,unicellular,uniseriate,vein,white	/2,15-30,3.5-7,4-10,5-20-flowere,accrescent,acro,acute,alyx,and,anthesi,basally,beneath,berry,black,branched,caly,capitate,capitate-glandular,cauline,central,closely,deltoid,density,developing,difoliate,dissected,divergently,divided,dry,eaf,earliest,eed,enveloped,erect,few-rayed,fleshy,geminat,heteromorphic,high,internodal,invested,largest,later,lon,many,marking,maturity,mostly,nflorescence,occasionally,often,one,orolla,pedicel,per,persisting,pinnatifid,prickle,purple,reduced,ruit,scattered,second,short,slende,somewhat,spaced,splitting,starlike,ste,stipitate,stout,subulate,tamen,taprooted,thrice,tightly,tigma,tub,twice,tyle,ultimate,unexpanded,unit,vary,varying,wholly,year,yello,ympodial	5-20-flowered,apex,branching,color,corolla,diameter,filament,flower,form,fruit,growth,height,history,inflorescence,lateral,length,life,midpoint,midrib,midvein,na,ovary,plant,pubescence,ray,reproduction,seed,shape,size,slender,staman,stigma,stipe,style,surface,texture,tip,width
342	wfo-0001028250	success	256	151	134	122	17	0.523	.2,.3,0.08,0.2–0.6,0.3–0.5,0.3–0.6,0.3–3.9,0.5–1.0,0.5–1.3,0.7–0.8,0.8–1.0,0.8–1.3,1,1.0–2.0,1.1–1.6,1.2–1.7,1.2–6.3,1.6–1.8,1.8–2.2,1.9–2.2,12.5,1–3,2.3–2.5,2.3–5.1,2.7,3.9–12.2,4–11,5.0,5.8–6.6,8.3–18.0,95,abaxially,acute,adaxially,aequilateral,anther,apex,apically,apiculate,attachment,base,brochidodromous,calyx,caudate,channeled,chartaceous,cm,corolla,cuneate,curved,deltate,densely,depression,diameter,distinct,dry,edge,egandular,entire,filament,filiform,flattened-orbicular,flower,fruit,glabrous,glandular,globose,glossy,hair,hooked,interpetalar,lanceolate,lateral,leaf,lobe,lobed,long,margin,mature,midrib,midvein,minute,mm,moderately,nearly,notched,oblique,oblong,occasionally,ovate,pedicel,peduncle,petiole,point,poorly-developed,porrect,pubescent,raised,ray,red,rounded,sessile,shallow,short-stipitate,shrub,simple,sinuate,small,sparsely,stellae,stellate,stigma,stipe,style,surface,time,tip,tissue,toward,tree,tube,typically,unarmed,vein,weakly,white,yellow,yellow-ferruginous,yellow-tan,young,±smooth,×,–1.6,–3	.4,.7,.8,0.13,0.17,0.4–0.8,0.6–0.7,0.9–1.3,1.0–1.6,1.3–1.6,1.3–2.0,1.5,1.5–3.4,1.7,1.7–2.5,1.8,1/3,1/4–3/4,2.1,2.2–2.9,2.8,4–6,4–8,5-merou,5.1–6.2,5.7–7.7,6–10,90°,adnate,alyx,anthesi,apart,apical,apparently,appearing,appressed,articulate,axe,ba,berry,blade,branch,branched,broad,bud,climate,clinate,congested,continuing,dentate,development,difoliate,directed,disc-shape,eaf,eed,either,emerging,endocarp,entir,erect,evenly,exocarp,extra-axillary,fertile,free,frui,geminate,glabrescent,growt,homostylous,increasing,internode,intersepalar,juic,large,less,lon,longer,lower,major,midpoint,minor,new,nflorescence,opaque,orolla,overlapping,per,pore,portion,potentially,restricted,rigid,row,ruit,shorter,side,sinus,smoot,split,splitting,spread,spreading,stamen,stella,stellate-pubescent,straight,suture,tamen,tardily,tem,thin,truncate,two,ud,upper,upright,vary,wide,ympodia,±equal	0.4,branching,color,form,growth,height,inflorescence,length,ovary,plant,pubescence,seed,shape,size,staman,stem,texture
343	wfo-0001028263	success	156	74	56	100	18	0.359	0.25,1-3,11-13,14-44,2-3,2.6,3,4,6,8-14,9,abaxially,adaxially,branched,calyx,cm,conical,corolla,cyme,darker,deep,diameter,dichasial,dichasially,distal,ebracteate,flower,forked,generally,green,green-white,half,herbaceous,leaf,light,long,medium,mm,monochasial,odd-pinnate,ovoid,perennial,petiole,plant,puberulent,pubescent,rotate,seed,size,stigma,strigose,style,throughout,violet,wide,yellow	1-2,1-4,11-23,2,2-4,3-6-foliat,3.4,3.5-4.2,4-5,5-7,5-7.5,6-8,8-1.,abaxiall,acumen,acuminate,acute,apex,apical,apically,articulate,atenuate,base,broadly,cell,connate,cordate,covering,cuneate,dehiscent,digestion,diminishing,dorsally,eaf,edge,eed,elliptical,emoval,enzyme,equal,exceeding,filament,first,flat,folded,globo,gradually,hair-like,honeycomb,interjected,introrse,lateral,leaflet,living,lobe,lon,lower,lunat,make,maturing,mucilaginous,nflorescence,nther,oblique,often,orolla,ovate,pair,pattern,pedicel,peduncle,perfect,plan,poricidally,proximal,reveal,ruit,sessile,seudostipule,short,slit,specimen,stamen,straight,tal,tem,terminal,testal,thick,throughou,toward,truncate,tuber-bearing,two,typically,unit,vary,wall,ympodial,¼	anther,branching,color,form,fruit,globose,growth,height,history,inflorescence,length,life,na,ovary,reproduction,shape,stem,texture
344	wfo-0001028273	success	225	116	97	128	19	0.431	-8,0.4-0.5,0.4-1,0.5,0.5-1,1-2,2-3,2-6,2.3-3,3-5,4,4-10,4-11,4-7-lobed,6-8,acute,anther,apex,armed,base,berry,branched,brown,calyx,cell,cm,color,coriaceous,corolla,dense,densely,diameter,elliptic,filament,flattened,flower,fruit,globose,growth,height,holly-like,impressed,inflorescence,leaf,less,lobe,lobed,long,long-styled,margin,midpoint,midvein,minutely,mm,mucronate,ovary,ovate,papillae,petiole,pitted,planar,puberulent,pubescence,pubescent,ray,reddish,reniform,shallowly,shiny,shrub,simple,sinuate,size,slightly,sparse,sparsely,spreading-campanulate,stellate,stem,stigma,style,surface,terminal,testal,time,tip,toothed,trichome,truncate,tube,unicellular,unknown,way,white,x,yellow,½-2/3	-2,.5,0,0.1,0.2,0.4,0.6-0.8,0.6-1,1,1-1.5,1-4,1.2,1.5-,1.5-2,2,2.5-,2.5-6,2.6-5,30,4-7,4-8.5,5-8,<,>,?,abaxial,abaxially,abruptly,absent,acicular,adaxial,adaxially,age,alfway,along,also,anthesi,apart,articulated,bark,basal,beneath,broad-based,c.,closer,conical,deep,discolorous,distall,eaf,eed,equalling,erect,evenly,exfoliatin,exserted,free,fruiting,glabrous,greyish,heterostylous,known,like,linear,lon,long-stalked,long-triangular,longer,lower,major,markedly,minute,mixture,multangulate,multiseriate,new,nflorescence,nodding,occasionally,often,older,orange,pair,pedicel,peduncle,per,pericarp,persisting,plurifoliat,poricidal,porrect,portion,prickle,prickly,primary,rachi,rest,rim,ruit,scar,scattered,sessile,short,shorter,small,smaller,sometimes,spaced,splitting,stalk,stalked,stellate-pubescent,stout,straight,styled,tapering,terminating,together,tooth,truncat,ud,unit,urceolate,variable,vein,widely,woody,ympodial	1.5-5,10,2.5-8.5,branching,form,history,length,life,midrib,na,plant,reproduction,seed,shape,short-styled,staman,stellae,texture,width
345	wfo-0001028278	success	219	124	100	119	24	0.457	0.45-0.7,0.5-0.75,0.5-1.5,0.7-1,0.8-3,1,1-5,1.4-1.9,1.5,1.5-2,1.5-3,2,2-3,2.2-7,2.5-9,2.7-2.9,3-7,4-12,4.5-6,5-11,6-11,abaxially,acute,adaxially,andromonoecious,anther,apex,base,broadly,brown,calyx,chartaceous,cm,cordate,cylindrical,densely,diameter,ellipsoidal,elliptic,entire,erect,filament,flattened,flower,fruit,glabrous,gland-tipped,green,grey-green,hair,inflorescence,interpetalar,leaf,length,light,lobe,lobed,long,margin,midrib,mm,obtuse,ovate,pale,perennial,perfect,petiole,pink,pseudo-racemose,purple,red,reniform,rhizomatous,rugose,shallowly,shallowly-lobed,shape,short,shrub,somewhat,sparsely,stellae,stellate,stellate-pubescent,stigma,style,surface,throughout,time,tissue,transparent,triangular,truncate,tube,unbranched,weakly,white,wide,x,yellow	%,.5,0-0.15,0-0.7,0-1,0-3,0.1-0.25,0.1-0.5,0.2-0.3,0.4-2.1,0.5-0.9,0.5-2.5,0.7-1.2,0.8-1.3,0.8-2,1-1.2,1-10,1-2,1-3,1-4,1-locular,1.2-1.6,11-15,17-30,2-4,2.5-3,3-4,3-5,4,4-,4-5,5-10,5-merou,6-8,7-10,7-12,7-15,7-8,8-10,absen,absent,accrescent,across,adult,alyx,apart,apparen,articulated,ascending,axe,ba,bilobe,blade,connivent,dense,difoliate,directed,distall,eaf,eed,exceeding,exocarp,extra-axillary,finger,fruiting,functional,geminat,glandular,heterostylous,incomplete,index,juicy,juvenile,lamina,lanceolate,lateral,leave,lobing,lower,mature,mesocarp,mid-point,midpoint,minute,nflorescence,oblique,orolla,pair,part,pedicel,peduncle,per,placenta,pore,porrect,present,prickle,rachi,ray,ruit,septum,side,simple,spaced,sparse,stalk,succulent,tal,tamen,tem,thick,tissu,unarme,unarmed,unit,upper,vary,without,ympodial	abaxial,adaxial,bilobed,branching,color,corolla,form,growth,height,history,life,na,ovary,plant,pubescence,reproduction,seed,size,staman,stem,tall,texture,tip,width
346	wfo-0001028280	success	87	80	41	46	39	0.471	.5,0.7-1,1-2,1-2-flowered,1.5-2.7,2-3,6-9,7-8,acuminate,apex,attenuate,base,ciliate,cm,completely,dark,decurrent,dia,elliptic,glabrous,globose,green,lanceolate,lateral,leaf,margin,minutely,mm,narrowly,onto,pair,petiole,rounded,shrub,simple,stem,surface,tip,ultimate,vein,x	2-2.5,almost,anthesi,ape,arching,axil,bark,berry,branch,brow,closely,eaf,eed,flattened,fruiting,immature,know,known,lon,long,lower,main,middle,new,nflorescence,older,opposite,papillae,pedicel,pendant,present,ruit,scar,sessil,small,somewhat,spaced,tall,ud,unifoliat,unit,widest,winged,woody,ympodial,young	anther,branching,brown,calyx,color,corolla,diameter,filament,flower,form,fruit,growth,height,history,inflorescence,length,life,lobe,midpoint,midrib,midvein,na,ovary,perennial,plant,pubescence,ray,reproduction,seed,shape,size,staman,stellae,stigma,stipe,style,texture,tube,width
347	wfo-0001028281	success	267	110	94	173	16	0.352	-1,-20,-36,-45,-5,.5,0.1-0.15,0.2-0.5,0.3-1,0.5-0.7,0.5-1,0.7-1.2,0.75-1,1-1.5,1.0-1.6,1.1-1.4,10-30,2-4,2.1-3.0,20-30,3-16,6,7-30,acuminate,acute,almost,anther,apex,base,basiscopically,branching,broadly,brown,calyx,cm,corolla,dark,deep,densely,diameter,distal,doubly,elongate-triangular,entire,extended,filament,flower,form,fruit,glabrous,globose,golden,green,hair-like,half,imparipinnate,inflorescence,interrupted,lateral,leaf,lobe,long,margin,midvein,mm,narrowly,oblique,obovate,occasionally,once-branched,outgrowth,ovary,pale,petiole,proximal,pubescent,regularly,rotate,serrate,shrub,size,sparsely,stem,stigma,stripe,style,surface,thick,tip,tube,vein,vine,wide,yellow	+,-0.9,-10,-3,-7,-8,.2,.4,0.05-0.4,0.15-0.2,0.2-0.3,0.2-0.7,0.3-0.5,0.5-,0.5-0.6,0.5-1.1,0.5-1.2,0.7-,0.7-2.5,0.8-1,1,1-,1-3,1-5,1.1-2.4,1.2-1.5,1.2-1.6,1.4-4,1.5-2,1.5-6,1.7-2.5,10-18,2-13,2-4-celled,2-6.5,2-locular,2.5-,3-5,3-8.5,3-foliate,5-8-celled,6-15,abaxial,abaxially,absent,adaxial,alternate,anthesi,apical,appearance,appendage,appressed,arising,articulation,autogamous,axi,bent,berr,blade,bract,bracteate,capitate,cell,column,composed,conical,covering,darker,decreasing,decurrent,developed,dry,eaf,edicel,eed,eglandular,either,elliptic,elongate,enclosing,exerted,exserted,fragile,free,fruiting,generally,giving,gland,glandular,gree,hal,halfway,head,included,interjected,internode,large,largest,leaflet,less,like,lon,longest,lower,material,medial,minute,mixture,multi-celled,multi-cellular,multicellular,nflorescence,node,opposite,orbicular,other,ovate,pair,paler,patent,pedicel,peduncle,petiolule,point,population,portion,present,primarily,primary,probably,pseudostipule,rachi,rest,ruit,secondary,serrat,sessile,set,shorter,silky,small,smaller,smooth,sometimes,sparser,sprawling,staminal,sterile,stiff,straight,strongly,subopposite,tem,terminal,tertiary,testa,thin,three,toward,transparent,trichome,type,ud,unicellular,uniseriate,unit,usually,wall,weak,weak-walled,well,winged,ympodial	color,growth,height,length,midpoint,midrib,na,plant,pubescence,ray,seed,shape,staman,stellae,stipe,texture
348	wfo-0001028294	success	222	104	81	141	23	0.365	0.25-0.4,0.3-0.4,0.5-2,0.7-1.2,1.3-1.5,1.5-3.5,1.5-7,1.9-7,11-22,2-2.5,2-3.5,2-5,4-8,4.5-6,5-12,5-13,6-8,8-10,acuminate,acute,andromonoecious,anther,apex,base,broadly,brown,calyx,chartaceous,cm,cordate,cuneate,cylindrical,deltate,densely,diameter,entire,flower,fruit,glabrous,globose,green,grey,inflorescence,lateral,leaf,length,lilac,lobe,lobed,long,margin,midpoint,midvein,mm,obtuse,ovate,pale,perennial,petiole,plant,ray,repand,rusty,shallowly,sparsely,stellae,stellate,stellate-pubescent,stigma,style,surface,time,tube,unbranched,vein,vine,weakly,white,x,yellow,yellowish-green	%,0-0.2,0-0.4,0-1,0-10,0-6,0.1-0.15,0.2-0.3,0.25-0.5,0.3-0.5,0.5-0.6,0.5-1,0.7-1.5,0.8-1,0.8-1.2,1,1-2,1-2.5,1-3.5,1-6,1.7-2.4,11-15,17-25,18-22,18-40,2-3,2-foliate,2-locular,2.5-7,30-40,4-6,5-8,5-merou,50-100,50-140,7-10,7-8,8-18,9-13,9-15,abaxially,absent,accrescent,across,adaxiall,adaxially,adult,alyx,anvil-shape,apart,armed,articulated,ascending,axe,ba,blade,branch,branche,broad-based,capitat,connivent,cross-section,curved,decimetre,directed,distall,distally,distributed,dm,eaf,eed,eglandular,elliptic,erect,exocarp,extra-axillary,finger,fruiting,functional,geminat,gland-tipped,grey-green,hair,half,heterostylous,juicy,juvenile,lamina,lanceolate,less,longer,loosely,lower,markedly,mature,mesocarp,mid-point,minute,moist,nflorescence,oblique,orolla,pair,part,pedicel,peduncle,per,placenta,pore,porrect,presen,present,prickle,rachi,ruit,scattered,scrambling,semi-circular,sessile,short,simple,slightly,spaced,stalk,stalked,straight,tal,tamen,tem,thick,thicker,throughout,toward,unarme,unarmed,unit,upper,vary,wide,yellowish,ympodial	branching,color,corolla,filament,form,growth,height,history,life,midrib,na,ovary,pubescence,reproduction,seed,shape,size,staman,stem,stipe,texture,tip,width
349	wfo-0001028298	success	188	100	75	113	25	0.399	0.3-0.4,0.4-0.65,0.5-1,0.8-1.7,1-1.5,1-2,1.5-2,1.5-3.5,2.2-2.5,2.5-3,3-7,4-5,4.5-8,5-8,9-10,abaxially,acute,anther,apex,base,broadly,brown,calyx,chartaceous,cm,cordate,deltate,densely,diameter,elliptic,entire,erect,filament,flower,fruit,glabrous,gland-tipped,globose,hair,inflorescence,leaf,length,lilac,lobe,lobed,margin,mm,moderately,obtuse,ovate,pale,perennial,petiole,pseudo-umbellate,red,reniform,reticulate,rhizomatous,rotate-stellate,sessile,shallowly,short,shrub,soliary,stellae,stellate-pubescent,stigma,style,surface,tube,unbranched,white,x,yellow,yellowish	%,.5,0-0.1,0.1-0.2,0.15-0.3,0.2-0.4,0.25-0.4,0.3-0.5,0.4-0.5,0.6-0.7,0.7-1,1-3,1-4,1-locular,1.9-2.5,10-11,17-25,2-3,2-7,2-foliate,3-5,4-9,5-6,5-7,5-merou,6-8,7-12,7-8,8-11,absen,absent,accrescent,across,acuminate,adaxially,adult,alyx,apart,apparen,articulated,axe,ba,blade,capitat,connivent,contiguous,cylindrical,directed,distall,distributed,eaf,eed,eglandular,exceeding,exocarp,extra-axillary,finger,fruiting,geminat,grey-green,incomplete,interpetalar,juicy,juvenile,lamina,lanceolate,lateral,long,lower,mature,mesocarp,midpoint,minute,nearly,nflorescence,oblique,orolla,part,pedicel,peduncle,per,perfect,placenta,pore,porrect,present,prickle,probably,rachi,ray,ruit,septum,simple,somewhat,spaced,stalk,succulent,tal,tamen,tem,thick,throughout,time,tissu,tissue,transparent,truncate,unarme,unarmed,unit,vary,wide,ympodial	0.5,abaxial,adaxial,branching,color,corolla,form,growth,height,history,life,midrib,na,ovary,plant,pubescence,reproduction,seed,shape,size,staman,stem,texture,tip,width
350	wfo-0001028317	success	204	115	88	116	27	0.431	-1.5,0.1-0.4,0.3-1,0.6-0.8,0.6-1.2,0.8-1.1,0.8-2.5,1-1.3,1-3,1.4-2,1/5,2-2.8,2-4.5,2.5-6.5,2.8-3.3,3-5,4-6,4-8,5-8,abaxially,acute,anther,apex,apically,base,branched,bright,brown,calyx,chartaceous,cm,cream,cuneate,dark,densely,diameter,dull,filament,flattened-reniform,flower,fruit,gray,green,herb,lanceolate,lateral,leaf,length,lobe,lobed,long,lower,margin,marking,maturity,mauve,midpoint,midvein,mm,moderately,oblong,obtuse,orange-brown,ovate,pale,petiole,purple,ray,red,shrub,smooth,sometimes,sparsely,spherical,stellate,stellate-pubescent,stem,style,surface,tip,truncate,tube,upper,vein,white,wide,yellow,young	-5,/5,0,0-1,0-5,0.1,0.1-0.25,0.1-0.3,0.3-0.4,0.5-3.5,0.6-1.5,1-4,1.1-1.9,1.8-2.5,1/,1/3-1/4,1/4-2/3,2-4,2/3,3-10,3-4,4-5-merous,6-10,absent,acuminat,almost,alyx,apar,apart,apparently,articulated,bark,berry,blade,broad-deltate,brow,concolorous,curved,deltate,difoliate,distance,drying,eaf,eed,elongating,equal,erect,extending,eye,filiform,free,fruiting,geminat,glabrous,hair,herbaceous,infructescence,longer,mature,minute,naked,nflorescence,older,one,open,orolla,oung,pair,pedicel,peduncle,pendulous,per,perfec,pericarp,poricidal,porrect,portion,prickl,prickle,prickly,primary,reduced,reflexed,rounded,ruit,scandent,scar,sessile,shorter,side,simple,spaced,spreading,stalk,stalked,straight,subsessile,tamen,tapering,terete,terminal,tertiary,time,toward,translucent,trichome,unarme,unarmed,unit,variously,vary,venation,visible,way,yellow-green,ympodial	1/2,acuminate,branching,color,corolla,form,growth,height,history,inflorescence,life,midrib,na,ovary,perennial,plant,pubescence,reproduction,seed,shape,size,staman,stellae,stigma,stipe,texture,width
351	wfo-0001028323	success	164	124	97	67	27	0.591	0.2-1,0.4-1.3,0.5,0.8,0.9-1.2,1,1-1.2,1-1.5,1-2,1.1-4.5,1.5,1.5-2.5,2-3,2-9,3,3-5,3-6,3.5-4,7.5-9,abaxially,acute,along,anther,anthesi,apex,attenuate,base,blue-green,brown,c.,calyx,cm,corolla,dark,deltate,dendritic,densely,diameter,ellipsoid,elliptic,entire,fading,filament,fleshy,flower,glabrescent,glabrous,grey,growth,inflorescence,less,like,lobe,lobed,longer,main,margin,maturity,minute,minutely,mm,ovary,ovate,ovoid,pale,papillose,petiole,pitted,planar,pubescent,reddish,revolute,rounded,scattered,shiny,shrub,simple,sinus,soft,sometimes,sparely,sparsely,stem,stigma,style,surface,tearing,tip,trichome,tube,tuft,uniseriate,vein,violet,way,white,x	-2,0.2-0.5,0.5-1,0.6-1,5-6,abscissio,absent,apart,apparently,appressed,articulated,ba,bark,berry,capiatate,cell,conical,coriaceous,cup-shaped,drying,eaf,eed,erect,free,fruiting,glabrescen,globose,included,internodal,lanceolate,leaf-opposed,lengthening,lower,new,nflorescence,occasionally,pair,papillat,pedicel,peduncle,peg,perfect,pericarp,plurifoliat,pore,poricidal,portion,primary,proceed,remaining,ruit,scar,shoot,short,small,somewhat,soon,splitting,straight,testal,thick,thin,ud,unit,wall,woody,ympodial	branching,color,form,fruit,height,history,lateral,leaf,length,life,midpoint,midrib,midvein,na,perennial,plant,pubescence,ray,reproduction,seed,shape,size,staman,stellae,stipe,texture,width
352	wfo-0001028328	success	215	134	109	106	25	0.507	-15,.5-2,0-0.3,0.2-0.5,0.5-1,1-1.5,1-2,1-6,1.5-2,14,16-30,2-10,2-2.5,2-4,2-4-lobed,2-9,2.5-3,20-35,3-4,5-7,50,6-8,7-9,abaxially,abundantly,acuminate,acute,andromonoecious,anther,apex,apiculate,apparently,armed,base,blade,branched,broad-based,brown,calyx,chartaceous,cm,coarsely,compressed,dark,densely,diameter,elliptic,elliptic-ovate,entire,ferruginous,filament,flower,forked,fruit,glabrous,globose,green,hair,half,inflorescence,juvenile,leaf,light,like,lobe,long,lower,margin,membanaceous,minutely,mm,moderately,narrowly,nearly,oblique,obtuse,outline,petiole,plant,prickle,ray,reniform,ripe,rounded,rugulose,shallowly,side,small,smooth,stellate,stellate-pubescent,stem,stigma,straight,style,subcoriaceous,subcuneate,surface,time,tip,tree,triangular,truncate,tube,vein,white,wide,x,yellow	.2,0-4,1,1-7,15-20,2-3,20-30,4-7,5-10,5-merou,6-18,7-.,7-10,7-14,7-30,8-18,absent,accrescent,adaxiall,adaxially,ag,alyx,apart,articulated,axe,ba,berry,capitat,congested,connivent,covering,cylindrical,differentiated,difoliate,directed,discolorous,distally,eaf,eed,equal,except,extra-axillary,flattened,flowering,free,frui,fruiting,geminat,heterostylous,highly,interpetalar,leaf-opposed,leave,lighter,lobed,longitudinal,major,midpoint,minor,multangulate,nflorescence,often,one,opening,orolla,paired,part,pedicel,peduncle,perfect,perhaps,pericarp,pore,porrect,pubescent,rachi,reflexed,ruit,runk,sessile,sharp,shiny,short,short-stalked,simple,slightly,slit,somewhat,spaced,sparse,stalk,staminate,strongly,subtending,tamen,tapered,thi,tissue,tomentose,tubevery,unarmed,unit,vary,whitish,ympodial,young	branching,color,corolla,form,growth,height,history,lateral,length,life,midrib,midvein,na,ovary,perennial,pubescence,reproduction,seed,shape,size,staman,stellae,stipe,texture,width
353	wfo-0001028329	success	215	138	113	102	25	0.526	.75-2,.75-5.75,/10-3/10,0-100,0.2-0.3,0.8-1.1,0.8-1.4,0.9-1.3,1-6,1.1-2.5,1.3-1.8,1.3-2,1.5-2.3,1.5-2.75,10-34,12,2-3,2.2-3.9,2.6-5,3-14,6-8,7-19,abaxially,acuminate,acute,adaxially,anther,apex,asperous,base,blade,branched,brown,calyx,cm,corolla,cylindrical,deltoid,dendritic-echinoid,diameter,dichotomously,distantly,echinoid,entire,filament,finely,flower,fruit,glabrous,granular,granular-tomentose,gray,green,growth,hair,honeycombed,leaf,length,lobe,long,long-attenuate,margin,minutely,mm,moderately,mostly,multangulate,obovate,obtuse,occasional,ovate,ovate-elliptic,pale,petiole,porrect-stellate,pubescent,rather,reniform,reticulate-punctate,ripe,sessile,short-,short-stalked,shrub,simple,small,sometimes,spaced,sparse,sparsely,stellate,stellate-pubescent,stellate-rotate,stem,stigma,style,subglobose,suborbicular,time,tomentose,touching,toward,tree,tube,turning,velutinous,vestigial,white,whitish,wide,x,yellow,yellowish	.5-3,1.0-1.4,1.5-3.5,1.5-8,2-4,2.75-4.5,3-8,3.75-7,3/4,4-15,4-5,5-10,6-11,6-9,absen,ag,angled,anthesi,apart,apical-lateral,apparently,articulated,axe,axillary,ba,bark,becoming,berry,blunt-tipped,branch,bud,chartaceous,closely,conical,continued,dehiscing,dendritic-echinoi,distinct,due,eaf,eed,fleshy,free,glabrescen,grooved,high,inserted,introrse,large,lateral,lengthening,lobed,longitudinally,lower,main,midvein,multangulat,nflorescence,obelliptic,oblong,obscured,older,orbicular,orolla,pedicel,peduncle,perfect,plurifoliate,pore,present,pseudo-terminal,rachi,receptacle,relatively,ruit,runk,sessil,several,side,slightly,slit,stalked,stellat,stelliform,subcapitat,suture,swollen,tamen,testa,thick,thickened,thin,tomentu,unarme,unarmed,unit,usually,vary,vein,way,ympodial,young	branching,color,form,glabrescent,height,history,inflorescence,life,midrib,na,ovary,perennial,plant,pseudoterminally,pubescence,reproduction,seed,shape,size,staman,subcapitate,surface,texture,tip,width
354	wfo-0001028337	success	195	118	93	102	25	0.477	-2,-2.5,-4,.5,/3,0.05-0.15,0.3-0.5,0.4-0.7,0.7-0.9,0.7-1,1-1.8,1-2,1-3,1.5-3,1.8-2,11-16,2-2.2,2-4,3-4,4-5,5-6,abaxially,anther,apex,apically,base,berry,branched,calyx,chartaceous,cm,color,cuneate,dark,deltate,densely,diameter,entire,erect,evenly,filament,flattened-reniform,flower,fruit,glabrescent,glabrous,glaucous,gray-brown,green,hair,inflorescence,lateral,leaf,length,lobe,lobed,long,longer,margin,marking,mauve,midpoint,minutely,mm,moderately,narrow-oblong,orange-brown,petiole,pitted,ray,reflexed,rounded,shallowly,shrub,simple,smooth,sparse,spherical,stellate,stellate-pubescent,stem,style,surface,time,tip,toward,tube,unarmed,vein,way,white,wide,young	-6,.8,0,0.05-1,0.1-0.3,0.4-0.8,1,1.5-4,1/2,1/3-2/3,1/4-1/3,1/8-1/4,15-50,5-25,5-8,5-merous,6-7,8-10,8-14,abaxial,acut,adaxial,alyx,apar,apart,ape,apparently,articulated,bark,blade,conical,connivent,curved,discolorous,drying,eaf,eed,elongating,equal,eye,free,fruiting,fused,gently,glabrou,gray,green-brown,infructescence,juvenil,juvenile,known,long-styled,lower,mature,naked,nflorescence,occasionally,older,one,open,orolla,oung,pale,pedicel,peduncle,per,perfect,pericarp,plurifoliat,poricidal,porrect,porrect-lepidote,portion,prickle,prickly,primary,reddish,ruit,scar,sessile,shoot,short,short-styled,shorter,slender,small,spaced,staminate,stout,straight,strongly,tamen,tapering,terete,terminal,trichome,unarme,unit,usually,vary,visible,ympodial	acute,branching,corolla,form,growth,height,history,life,midrib,midvein,na,ovary,perennial,plant,pubescence,reproduction,seed,shape,size,staman,stellae,stigma,stipe,texture,width
355	wfo-0001028339	success	195	121	96	99	25	0.492	0.05-0.1,1-1.2,1-1.5,1-2,1-5,1.2-1.5,1.5,1.5-2,1.7-3.2,10-30-flowered,10.2-18.5,2.5-5,3.5-4,5-7,5.8-7.9,8-10,8182,acuminate,acute,anther,apex,appressed,base,beneath,berry,blue,broadly,brown,calyx,cm,corolla,cuneate,dark,decurrent,dia,dried,dry,evenly,filament,filiform,flattened,flower,glabrous,globose,greyish-brown,growth,lateral,leaf,little,lobe,lobed,long,long-triangular,main,margin,minutely,mm,mustard,nearly,oblique,ovary,ovate,ovoid-reniform,papillate,papillose,petiole,pitted,pulp,schwarz,shrub,simple,size,slightly,small,somewhat,spaced,specimen,speckled,stem,stigma,strong,strongly,style,surface,texture,tip,tree,trichome,tube,uniseriate,vein,white,winged,woody,x,yellow	.5,0.8-1.2,1.1-1.4,3.4-5.5,43191,5-angled,7-11,across,almost,anthesi,appearance,appearing,attenuate,bark,becoming,bud,capitate,carinate,carpel,closely,connate,covered,crystalline,cup-shaped,deflexed,densely,differing,difoliate,distinctly,eaf,edicel,eed,enclosed,epidermi,erect,exserted,fide,first,floccose,free,frui,fruiting,geminat,glabrate,grainy,irregular,large-celled,later,leave,like,lon,lower,major,middle,minor,nee,nflorescence,obscure,occasionally,older,one,opposite,overlappin,ovoid,papery,pedicel,planar,pore,poricidal,portion,proximal,red-brown,reflexed,ruit,scar,secondary,septum,shaped,shining,slender,sparsely,straight,tall,tapering,tear-drop,tightly,tub,ud,unit,urceolate,venation,white-lenticellat,white-papillo,white-speckled,wide,widest,yellowish,ympodial,young	branching,color,diameter,form,fruit,height,history,inflorescence,length,life,midpoint,midrib,midvein,na,perennial,plant,pubescence,ray,reproduction,seed,shape,staman,stellae,stipe,width
356	wfo-0001028351	success	175	109	79	96	30	0.451	.2,.8,0,0.2,0.5,0.6,1.4–1.5,2.0–5.0,2/3,2–2.5,2–4,3,3.4–5.0,3–4,40,5.0,5.0–5.5,5.5–10.5,6–12,abaxially,acute,adaxially,along,annual,anther,apex,base,blue,branching,brown,calyx,cm,densely,diameter,filament,flattened,flower,fruit,glabrous,globose,green,hair,herb,lanceolate,leaf,lobe,lobed,long,lower,margin,midvein,mm,moderately,multicellular,ovate,pale,pentagonal,perennial,petiole,pitted,pubescent,regularly,shallowly,shiny,simple,stem,stigma,style,surface,truncate,tube,unbranched,unicellular,uniseriate,unknown,velutinous,white,x,–3.0	.8–1.0,0.1,0–,1.0–,1.0–1.6,1.0–2.0,1.0–2.5,1.5–4.0,1.6–,10,2,2.0–2.5,2.1–3.5,4,5,5–7,6.5–8.5,8–15,absent,adaxiall,ag,anthesi,apart,apical,articulated,axe,ba,basal,becoming,blade,capitate,cell,chartaceous,clavate,colour,connivent,convex,cylindrical,directed,distally,eaf,eed,equal,erect,fleshy,geminat,glandular,indumentum,lamin,like,lon,longitudinal,m.,narrowly,nfloresence,number,oblong,obtuse,occasionally,opening,opposed,orolla,pair,pedicel,peduncle,perfect,plurifoliate,pore,present,probably,ruit,serrate,shaped,side,slender,slit,smaller,spaced,sparsely,stone,straight,tal,tamen,tardily,teardrop,tem,time,unit,vary,wide,wing,winged,woody,ympodial,young,–	0–1.0–2.5,1.0–4.0,1.5,color,corolla,form,growth,height,history,inflorescence,lateral,length,life,midpoint,midrib,na,ovary,plant,pubescence,ray,seed,shape,size,staman,stellae,stipe,texture,tip,vein,width
357	wfo-0001028353	success	177	122	96	81	26	0.542	/3,0.2-0.4,0.5,0.9-1.2,1,1-4,1.5-5,2-3,2-4,3,3-5,4-7,6-8,7,8-10,abaxially,acute,along,anther,apex,base,becoming,beneath,bluntly,bright,calyx,campanulate,cell,centre,ciliate,clasping,cm,coarsely,cordate,corolla,dark,deep,deeply,densely,diameter,elliptic,filament,flower,fracturing,glabrous,globose,green,greenish,herb,honey-comb,leaf,less,like,lobe,long,margin,midrib,minute,mm,ovary,ovoid,pale,papery,petiole,pitted,plant,plump,principal,pubescent,purple,rhomboid,ripe,scattered,sessile,short,simple,size,somewhat,sparsely,stem,stigma,style,surface,tan,testal,thin,tip,toothed,trichome,truncate,tube,uniseriate,vein,way,x,yellow	.5,0.5-,1-2,1.4-2,1.5-2,2,accrescent,age,anthesi,apart,area,berry,capitate,conical,cup-shaped,curved,decreasing,decumben,difoliate,distally,dry,drying,eaf,edicel,eed,ellipsoid,emarginated,erect,exerted,fleshy,free,frui,fruiting,geminat,gree,growing,heteromorphic,hollow,horn,horned,inserted,internodal,lengthening,lon,lower,m.,material,minutely,nflorescence,nodding,often,open,outline,pair,papillate,papillose,pedicel,peduncle,pericarp,point,pore,poricidal,portion,primary,reddish,ruit,scar,sessil,shallow,sleeve,slender,slightly,slit,straight,strongly,toward,ud,unit,wall,wrinkled,ympodial	0.5-1,branching,color,form,fruit,growth,height,history,inflorescence,lateral,length,life,midpoint,midvein,na,perennial,pubescence,ray,reproduction,seed,shape,staman,stellae,stipe,texture,width
358	wfo-0001028367	success	178	112	83	95	29	0.466	0.2–0.4,0.4–2.3,0.8–0.9,1.0–1.8,1.2–3.0,1.4–2.0,1.5,1.5–1.7,1–1.5,2.0–4.5,2.8–3.1,2–3,3.5–6.9,3–3.5,4–10,4–7,5–5.8,5–6,6.5–8.5,60,6–9,8.5–9.5,abaxially,anther,apex,base,black,blue,brown,calyx,cm,cuneate,cylindrical,dark,deeply,densely,diameter,filament,flattened,flower,fruit,glabrous,globose,leaf,lobe,lobed,longer,margin,mm,moderately,oblong,obtuse,ovate,pair,pale,pentagonal,perennial,perfect,petiole,pitted,pubescent,purple,regularly,rounded,shorter,shrub,stigma,straight,style,surface,texture,time,tip,toward,tube,unknown,white,width,x,yellow,–10.0,–5.0,–5.5	0.2,0.5,0.5–3,1,1.3–9.0,1–,1–2,2.0–4.2,2–10,3–5,5,6–8,7–15,8–17,8–23,absen,accrescent,adaxiall,adaxially,ag,anthesi,apart,apical,arising,articulated,axe,ba,basal,blade,branched,cell,chartaceous,colour,concave,connivent,diamete,directed,eaf,eed,equal,erect,geminat,glabrescen,grey-green,hair,half,lanceolate,laterally,lon,long,longitudinal,lower,marking,multicellular,narrowly,nflorescence,obliquely,opening,opposed,orolla,pedicel,peduncle,pore,poricidal,primary,probably,ruit,secondary,shiny,side,simple,slit,smaller,spaced,stone,strongly,tal,tamen,tapering,tem,three,tomentose,two,unequal,unicellular,unifoliate,uniseriate,unit,usually,vary,wide,woody,ympodial,–25,–7	branching,color,corolla,dense,form,growth,height,history,inflorescence,lateral,length,life,midpoint,midrib,midvein,na,ovary,plant,pubescence,ray,reproduction,seed,shape,size,staman,stellae,stem,stipe,vein
359	wfo-0001028370	success	147	114	74	73	40	0.503	1.0-1.7,1.5-2.2,1/2-2/3,2.5-2.9,3-5,3-7,3.5-5.0,4-10,4-11,9-12,across,along,annual,anther,armed,attenuate,base,beneath,blade,blue,broadly,brown,calyx,cm,dark,deltoid,dia,dm,dry,eglandular,extended,few-rayed,foveolate,fully,glabrous,gland,gland-tipped,glandular,green,hair,herb,lanceolate,lenticular,lobe,long,main,markedly,maturity,minutely,mm,narrowly,oblong,often,ovate,pentagonal,petiole,prickly,purple-tinged,ridged,scattered,seed,sessile,short-stipitate,simple,spherical,splitting,stellae,stem,strait,tube,variously,vein,violet,viscid	-0.6,/3,0.2-0.4,0.8,2-4,2-8,40-70,5-9-flowere,accrescent,acicular,acro,alyx,ample,anthesi,ature,berry,branched,broad,bud,campanulate,capitate,coarsely,densely,developing,difoliate,distinct,divided,eaf,geminat,hardly,high,incurved,internodal,interpetalar,invested,lon,near,nflorescence,obovoid,obtuse,one,orolla,per,pinnatifid,pinnatisect,plicat,prickle,rounded,ruit,short,slende,slightly,somewhat,sparsely,spreadingly,subulate,surrounding,tamen,taprooted,terete,terminal,tightly,tigma,tissue,tub,twice,tyle,ultimate,unti,usually,vary,yellow,ympodial	0.3-0.6,5-9-flowered,apex,branching,color,corolla,diameter,filament,flower,form,fruit,growth,height,history,inflorescence,lateral,leaf,length,life,margin,midpoint,midrib,midvein,na,ovary,plant,pubescence,ray,reproduction,shape,size,slender,staman,stigma,stipe,style,surface,texture,tip,width
360	wfo-0001028390	success	147	98	63	84	35	0.429	0,0.5,0.5-1.5,1-2.5,1-3,1.5-2,1.5-3.5,1.5-5.5,2,3-4,3-5,4-11,4-5,5-7,7-8,abaxially,acute,adaxially,angled,apex,apiculate,base,calyx,chartaceous,cm,cuneate,densely,diameter,elliptic,entire,felty-pubescent,flower,forked,glabrous,globose,lobe,margin,midvein,mm,moderately,narrowly,orange,ovate,petiole,pseudohair,puberulent,pubescent,rarely,shrub,sparsely,stellate,stigma,style,subcordate,subcoriaceous,tip,triangular,tube,unbranched,violet,white,x,yellow	-10,.5-3.3,0.5-1,0.5-2.5,1,1-5,10-15,2.5,6-many-foliat,7,9,absen,adaxiall,aggregate,apart,articulated,axe,blade,branched,cell,connivent,curled,cylindrical,deltate,dendritically,dendritically-branched,dense,directed,distall,divided,eaf,eed,eglandular,gland,hair,lanceolate,leaving,less,like,lon,long,lower,mixed,mostly,near,nflorescence,nther,obtuse,occasionally,often,orolla,pedicel,peduncle,peg,perfect,pore,presen,pubescen,rachi,radiu,ripe,ruit,scar,short,simple,slightly,small,spaced,stalked,ste,stone,subcapitat,subclavate,tal,tem,time,truncate,unequally,unit,usually,vary,white-pubescent,wide,ympodial	anther,branching,color,corolla,filament,form,fruit,growth,height,history,inflorescence,lateral,leaf,length,life,midpoint,midrib,na,ovary,perennial,plant,pubescence,ray,reproduction,seed,shape,size,staman,stellae,stem,stipe,surface,texture,vein,width
361	wfo-0001028399	success	273	142	104	169	38	0.381	/3,4.3,5,9.1,9.8,abaxially,acute,adaxially,aequilateral,age,anther,apex,apiculate,attachment,basal,base,branching,brochidodromous,calyx,channeled,chartaceous,cm,corolla,cunate,deltoid,densely,developed,diameter,distinct,dry,elliptic,emerging,entire,extra-axillary,filament,filiform,flattened-orbicular,flattened-reniform,flower,fruit,glabrous,globose,glossy,hair,internodal,interpetalar,lanceolate,lateral,leaf,length,lobe,lobed,long,margin,mature,midrib,midvein,mm,moderately,notched,oblique,orange,ovate,pedicel,peduncle,petiole,point,porrect-stellate,portion,position,pubescent,raised,ray,red,restricted,reticulate,rounded,scattered,sessile,shrub,sinuate,sparse,stellae,stellate,stellate-pubescent,stem,stigma,stipe,straight,style,surface,time,tip,tissue,toward,tube,upper,vein,weakly,well,wide,yellow-ferruginous,yellow-tan,young	.3,.4,.5,.5–2.4,.8,0.04,0.06,0.13,0.2–0.3,0.3–0.4,0.3–0.5,0.3–0.6,0.4–0.5,0.4–0.6,0.4–0.7,0.4–0.9,0.5–1.1,0.5–1.3,0.7–1.0,0.7–2.3,0.8–2.5,0.9–1.9,1.0–5.5,1.1–1.4,1.1–1.7,1.2–1.5,1.2–1.7,1.2–2.0,1.3–2.0,1.4–2.4,1.5–2.1,1.6–2.3,1.6–2.5,1.7–2.7,1/2–2/3,1/3–1/2,1/4–1/3,2.0–3.9,2.2–2.6,2.2–2.8,2.2–2.9,2.4–3.2,2.5–11.2,2.8–3.0,3.1–3.8,3.2–3.8,3.4–3.6,4.0–5.4,4.2,4.4,5-merou,5.0,5.2–17.8,5.4,5–8,5–9,6.0–6.6,7.0,7–11,8–120,absent,adnate,alyx,anthe,anthesi,apart,apparently,appearing,appressed,arching,articulate,attenuate,axe,ba,bark,based,becoming,berry,blade,branch,broad,broad-based,brown,bud,capitat,deciduous,dehiscent,dentate,difoliate,distal,eaf,eed,either,erect,exocarp,extending,fertile,flexed,free,geminat,glandular,gradually,heterostylous,increasing,incurved,internode,intersepalar,juic,large,layer,lon,longer,longitudinally,lower,major,many,midpoint,minor,minute,narrowly,nearly,nflorescence,oblong,orolla,per,porrect,potentially,prickle,primary,probably,red-orang,reddish,reflexe,ridge,rigid,row,ruit,secondary,short,shorter,side,simple,sinus,slit,sloughing,somewhat,soon,spaced,splitting,spread,spreading,stamen,stipitate,tamen,tem,thin,translucent,transparent,triangular,truncate,two,ud,unarmed,various,vary,ympodia,±90°,±equal,×	0.04-0.06,0.2-0.3,0.3-0.4,0.3-0.6,0.4-0.5,0.4-0.7,0.4-0.9,0.5-1.3,0.7-2.3,0.9-1.9,1.0-5.5,1.1-1.4,1.2-1.7,1.2-2.0,1.4-2.4,1.5-2.4,1.7-2.7,2.2-2.9,2.5-11.2,2.8-3.0,5-8,5.2-17.8,8-120,color,dense,form,growth,inflorescence,moderate,na,ovary,pubescence,seed,shape,size,staman,texture,width
362	wfo-0001028405	success	149	83	58	91	25	0.389	0.4-0.5,1-4,1.5-6.5,10-11,2,2-2.5,2-3,2-4,3-20,3-4,4-11.5,4-6,6-7,7-14.5,abaxially,acumen,adaxially,apiculate,branched,calyx,cm,conical,corolla,cyme,diameter,dichasial,dichasially,ebracteate,elliptic,filament,flower,forked,green,green-white,herbaceous,leaf,lobe,long,mm,monochasial,mucilaginous,oblong,odd-pinnate,ovate-elliptic,ovoid,perennial,petiole,plant,puberulent,seed,size,stellate,stigma,style,throughout,tuber-bearing,wide,yellow	0.5-3,1-9,1.3-8,3-6-foliat,3.5-10,3.5-6.5,8-15,9-15,absen,acute,apex,apical,apically,articulate,attenuate,base,cell,connate,covering,decurrent,dehiscent,digestion,diminishing,distal,dorsally,eaf,edge,eed,elliptic-lanceolate,emoval,enzyme,exceeding,flat,folded,generally,globo,gradually,hair-like,half,honeycomb,interjected,introrse,lanceolate,lateral,leaflet,living,lon,lower,lunat,make,maturing,nflorescence,nther,oblique,often,orolla,pair,pattern,pedicel,peduncle,perfect,plan,poricidally,proximal,rachi,reveal,ruit,seudostipule,short,short-acuminate,short-petiolate,slit,specimen,stamen,straight,subsessile,tal,tem,terminal,testal,thick,throughou,toward,typically,unit,vary,wall,whit,without,ympodial,¼	anther,branching,color,form,fruit,growth,height,history,inflorescence,length,life,midrib,na,ovary,pubescence,reproduction,shape,staman,stem,surface,texture,tip,tube,wet,white
363	wfo-0001028424	success	253	144	125	128	19	0.494	-1.2,-28,-3,-9,0-1,0.1-0.2,0.2-0.35,0.3-0.6,0.5,0.7-2,1,1.5-2.5,1.8-3,2-2.5,2-3,2-4,3,3-12,3-16,3-5,3-6,3-7,4-12,4-5,5-10,5-22,5.5-10,8-15,abaxially,acute,acute-,adaxially,anther,apex,ascending,base,broadly,calyx,cm,coarsely,convex,deeply,deltoid,deltoid-orbicular,densely,dentate,depressed-deltoid,diameter,elongate,felty,filament,flower,fruit,glabrous,globose,hair,inflorescence,inserted,lateral,length,lenticular,less,light,like,lobe,long,margin,midpoint,midrib,minutely,mm,narrower,obtuse,obtuse-,occasionally,often,orange,outline,ovate,ovate-lanceolate,pentagonal-stellate,perennial,persistently,petiole,pitted,prickle,pubescent,ray,recurved,ripe,round-tipped,sessile,short,side,simple,size,somewhat,spreading-hirsute,stellae,stellate,stellate-puberulent,stellate-pubescent,stem,stigma,strongly,style,subcordate,suffrutescent,surface,tan,termination,thin-textured,time,tip,trichome,truncate,tube,unbranched,vein,weakly,white,white-pubescent,wide,x,yellow	-0.8,0-0.5,0.15-0.4,0.2-0.7,0.3-0.7,1-3,1-7,1/3-1/2,10-16,12,12-19,2,2-foliate,3-8,4-6,4-7,5-15,5-8,8-25,accrescent,acicular,adaxiall,almost,along,and/or,apart,articulated,attenuate,axe,ba,blade,branched,broad-based,broader,campanulate,capitat,capitate-glandular,cauline,closely,commonly,connivent,conspicuously,covering,curved,cylindrical,dense,diffusely,directed,distal,distally,distributed,divergently,diverging,eaf,eed,elongate-lanceolate,entire,equaling,exceeding,extra-axillary,female-sterile,flexuous,fruiting,geminat,gland-tipped,glandular,interlobal,larger,laterall,leaf-opposed,longer,lower,major,mixture,mostly,much,multiple-stemmed,multiseriate,nflorescence,numerous,obsolete,orolla,pedicel,peduncle,per,perfect,pore,prickly,principal,puberulent,rachi,radiu,rarely,reduced,reflexe,resembling,ruit,scattered,section,short-styled,shorter,similar,single-,sinus,slender,small,smaller,sometimes,spaced,sparsely,species,stalk,stalked,ste,stout,tal,tamen,tem,thickened,typically,unarmed,unit,upward,usually,variable,vary,widely,ympodial	branching,color,corolla,form,growth,height,leaf,midvein,na,ovary,plant,pubescence,reproduction,seed,shape,staman,stipe,texture,width
364	wfo-0001028429	success	162	78	62	100	16	0.383	0.2-0.4,0.8-1.2,1.5-3,10-11,10-27,10.5-21,2-3,2.5-7.5,2.7-3.6,3-6,5-12,6-18,abaxially,adaxially,branched,calyx,cm,corolla,cyme,darker,diameter,dichasial,dichasially,distal,ebracteate,flower,forked,generally,glabrescent,glabrous,globose,green,green-white,greenish,hair,half,herbaceous,leaf,light,long,medium,mm,monochasial,odd-pinnate,ovoid,pentagonal,perennial,petiole,plant,rotate,scattered,seed,size,slightly,spot,stigma,style,throughout,violet,white,wide,yellow	0.9-2.3,1-2.5,1-4,1.5-4,2-1.,2-4,2-8,2.5-12,2.5-4,3-6-foliat,4-14,6-28,7-7,abaxiall,acumen,acuminate,acute,apex,apical,apically,articulate,base,broadly,cell,connate,cordate,covering,cuneate,dehiscent,digestion,diminishing,dorsally,eaf,edge,eed,elliptical,emoval,enzyme,especially,exceeding,filament,flat,folded,globo,gradually,hair-like,honeycomb,interjected,introrse,lateral,leaflet,living,lobe,lon,long-attenuate,lower,lunat,make,maturing,mucilaginous,narrowly,nflorescence,nther,oblique,obovate,often,orolla,ovate,pair,pattern,pedicel,peduncle,perfect,petiolule,plan,poricidally,proximal,reveal,ruit,seudostipule,short,slit,specimen,stamen,straight,tal,tem,terminal,testal,thick,throughou,toward,tuber-bearing,typically,unit,vary,vein,wall,ympodial,¼	anther,color,form,fruit,growth,height,history,inflorescence,length,life,na,ovary,reproduction,shape,stem,texture
365	wfo-0001028436	success	150	103	71	79	32	0.473	0.2-0.4,0.5,0.5-1,1-2,1-3,1.5,1.5-2,1.5-2.5,2-3,2-4,2.5-3,4,5-12,5-8,7,8-12,abaxially,absent,acute,anther,apex,base,brown,calyx,center,chartaceous,ciliate,cm,decurrent,diameter,dm,dried,edge,elliptic,entire,filament,fine,flower,fruit,glabrous,globose,hair,leaf,linear,linear-lancolate,lobe,margin,membranaceous,mm,moderately,nearly,often,parallel,petiole,pubescent,radiating,raised,ridge,rotate,running,shallow,shrub,stem,stigma,style,surface,triangular,tube,unbranched,white,x	.5,0.8-1.5,1-2-celled,10-20,1st,2nd,5-10,5-15,abundant,adaxiall,adaxially,along,apically,appearance,appearing,axe,berry,beyond,blade,cell,connected,cordat,deflated,dehiscent,difficult,due,eaf,eed,evaluat,explosively,exserted,flat,frui,fruiting,geniculate,glabrescen,interpetalar,lengt,like,long,lower,lying,much-branched,nflorescence,notch,oblong,older,orolla,oung,pedicel,peduncle,per,placenta,pointing,presence,pubescen,rachi,reaching,rhizomatous,ruit,small,sparsely,stamen,structure,swollen,tal,tamen,taproot,tear,thick,tissue,two-celled,unifoliate,unit,vary,wid,woody,wrinkled,ympodial	2.5,branching,color,corolla,form,growth,height,history,inflorescence,lateral,length,life,midpoint,midrib,midvein,na,ovary,perennial,plant,pubescence,ray,reproduction,seed,shape,size,staman,stellae,stipe,texture,tip,vein,width
366	wfo-0001028465	success	159	81	63	96	18	0.396	0.75,1.2-2,1.5-2.9,10-24,2-3,2-6,2.4-2.8,3-4,3-5,4-8,4.5-5.5,5-7,7-15,8-10,9-19,branched,calyx,cm,corolla,cyme,diameter,dichasial,dichasially,distal,ebracteate,flower,forked,generally,globose,green,green-white,half,herbaceous,interjected,interpetalar,lateral,leaf,leaflet,long,medium,mm,monochasial,odd-pinnate,ovoid,pair,perennial,petiole,plant,puberulent,pubescent,purple,rotate,seed,size,spot,stigma,strigose,style,terminal,throughout,white,wide,yellow	1-2,1-4,10,11-23,2,2-4,2-9.3,2.5-4,3-6-foliat,3-8,3.8-7,4-1.,abaxially,acumen,acuminate,acute,adaxially,apex,apical,apically,articulate,attenuate,base,broadly,cell,connate,covering,cuneate,decurrent,dehiscent,digestion,diminishing,dorsally,eaf,edge,eed,elliptical,emoval,enzyme,equal,exceeding,filament,first,flat,folded,globo,gradually,hair-like,honeycomb,introrse,living,lobe,lon,lower,lunat,make,maturing,mucilaginous,nflorescence,nther,oblique,often,orolla,pattern,pedicel,peduncle,perfect,petiolule,plan,poricidally,proximal,rachi,rarely,reveal,ruit,sessile,seudostipule,short,slit,specimen,stamen,straight,tal,tem,testal,thick,tissu,toward,tuber-bearing,two,typically,unit,vary,wall,ympodial,¼	4-18,anther,color,form,fruit,growth,height,history,inflorescence,length,life,na,ovary,reproduction,shape,stem,texture,tissue
367	wfo-0001028468	success	255	122	93	162	29	0.365	-10,.1-0.4,0.2-0.3,0.4-4,0.5-2,0.5-3,0.6-1.2,0.7-2.5,1.2-1.5,1.3-2,16,2-9,2.2-3,2.5-4,2.8-4.1,2/3-3/4,4-6,5-21,5-9,6-9,acuminate,acute,anther,apex,attenuate,base,blue,brown,bud,calyx,chartaceous,cm,corolla,densely,diameter,ellipsoid,filament,flattened,flower,foveate,fruit,glabrous,gray,greenish,lateral,length,light,lobe,lobed,margin,midvein,mm,moderately,narrowly,orange,orangish,ovate,ovoid,pale,pedicel,peduncle,petiole,proximal,pubescence,purple,rachi,ray,reduced,reticulate,rhombic,rotate-stellate,shallowly,short,shrub,side,sparsely,stellate-pubescent,stem,stigma,style,subcuneate,subelliptic,subglobose,sublenticular,subreniform,subshrub,surface,tube,unbranched,vein,x,yellow,yellowish	-1.3,-3,-4,-5.5,-7,.1-0.2,.1-0.3,.2,.2-0.4,.3,.3-0.4,.5,.5-1.5,.5-1.6,.6-1,/10-1/5,/4-1/3,0.05,0.1,0.2-0.6,0.2-1.5,0.4-1,0.5-3.3,0.5-3.5,0.5-8,0.6-2,0.8-3.5,1,1.5-2.2,1.5-3.1,1.6,1/3-1/2,1/5-1/2,2,20,3-4,4-9,6-10,abaxially,accrescent,adaxially,along,apart,appressed,ark,armed,articulated,axe,becoming,berry,beyond,blade,broad-based,broadly,bu,c.,campanulate,cauline,central,clavate,commonly,compresse,compressed,connivent,d.,dark,decreasing,density,directed,distal,distally,distantly,dry,eaf,eed,equal,exserted,extra-axillary,fruiting,geminat,glabrescent,gradually,green,hair,half,increasing,inserted,interpetalar,introrsel,lamin,laterally,long,longer,lower,m.,main,midpoint,minutely,mixed,mostly,multangulat,multangulate,nflorescence,oblique,oblong-conical,oblong-lanceolate,obtuse,occasionally,older,orolla,overlapping,pair,papillo,per,perfect,pore,porrect-stellate,prickle,pubescent,recurved,relatively,ruit,sessile,short-,short-stalked,similar,similarly,simple,slightly,somewhat,spaced,specimen,stalk,stamen,stelliform,straight,subacuminate,subcapitate,subchartaceous,subsessile,tal,tamen,terete,testa,thick,thick-stalked,thicknes,time,tissue,touching,toward,triangular,unarmed,unifoliate,unit,upper,usually,vary,way,wide,ympodial,young	0-1.3,0.1-0.4,0.3-0.4,0.5-1.5,0.5-1.6,0.6-1,4-5.5,abaxial,adaxial,bark,branching,color,form,growth,height,inflorescence,leaf,midrib,na,ovary,plant,seed,shape,size,staman,stellae,texture,tip,width
368	wfo-0001028470	success	185	94	71	114	23	0.384	0.25-0.75,0.9-2.2,0.9-2.3,1-2,1-3,11.8-21,2-7,2-8,2.1-3.9,3-10,3.5-16,4-7,5.5-11.6,6-33,abaxially,adaxially,anther,brownish,chartaceous,cm,condition,corolla,dark,deep,diameter,dot,drying,filament,flower,forked,fresh,fruit,glabrous,green,greenish,hair,herb,leaf,light,lobe,long,medium,mm,mottled,mucilaginous,odd-pinnate,ovate,ovoid,pentagonal,petiole,plant,pubescent,purple,ripe,scarce,seed,short,size,sometimes,stigma,style,substellate,tip,tube,usually,wet,white,whitish,wide,x,yellow	0-18,1-12.3,1.5-2.8,1.6-3.2,12-44,2-10,2-5,3-5,3.2-5.5,3.5-7,4-6,5-merou,acumen,acute,adaxiall,ag,alyx,apart,apex,apparently,articulated,asymmetric,attenuate,axe,axillary,base,basiscopic,berry,blade,bud,capitat,cell,clavate,connivent,covering,decreasing,digestion,distal,dorsally,eaf,edge,eed,elliptic,end,enzyme,erec,exceeding,flat,folded,geminat,generally,glabrescent,glabrou,green-white,hair-like,hal,half,high,homostylous,honeycomb-shaped,interjected,lanceolate,lateral,leaflet,lengthening,living,lower,make,nflorescence,one,orbicular,orolla,pair,pedicel,peduncle,perfect,petiolulate,placed,plurifoliate,pore,poricidal,removed,rounded,ruit,sessile,seudostipule,side,slit,spaced,specimen,stamen,stolo,straight,subequal,subglabrou,subtending,tall,tamen,tem,terminal,testal,thick,throughout,tissue,toward,tri-,tuber,typically,unit,unwinged,vary,wall,wing,ympodial	abaxial,adaxial,branching,calyx,color,form,growth,height,history,inflorescence,length,life,midrib,na,ovary,perennial,pubescence,reproduction,shape,staman,stem,surface,texture
369	wfo-0001028476	success	246	109	87	159	22	0.354	-16,-6,-8,0.25-0.5,0.4-0.6,0.5,0.5-0.6,0.8-1.2,1,1-1.4,1-4,1-6,1-celled,1.1-1.5,1.8-2.5,12-30,2.4-3,3.5-13,7-10,8-30,acuminate,acute,anther,apex,base,bifurcate,branched,brown,calyx,cm,corolla,dark,deeply,diameter,filament,flower,fruit,globose,green,hair-like,herb,imparipinnate,inflorescence,interrupted,irregularly,lanceolate,lateral,leaf,less,lobe,lobed,long,margin,midvein,minutely,mm,obovate,outgrowth,ovary,pale,perennial,petiole,puberulent,pubescence,pubescent,purple,regularly,rounded,simple,sparsely,stellate,stem,stiff,stigma,stripe,style,surface,thick,tip,trichome,truncate,tube,uniformly,uniseriate,vein,wide,yellow	-1,-20,.05-0.1,.5,0-,0-0.5,0.1-0.15,0.1-0.4,0.15-0.2,0.15-0.4,0.2-0.3,0.2-0.5,0.2-0.6,0.25-0.4,0.3-0.4,0.3-0.5,0.3-0.7,0.3-1.2,0.4-0.5,0.4-1.5,0.5-1.7,0.7-2.5,0.8-1.6,1-1.2,1-1.5,1-2,1-2-celled,1.1-1.6,1.2-2.5,2,2-6,2-foliate,2-locular,3-12,3-7,3-foliate,4-celled,5-15,6-,abaxially,absent,abundant,acroscopically,age,almost,along,also,alternate,anthesi,ape,apical,appearance,appendage,articulated,axi,basal,basiscopically,becoming,bifurcation,bract,bracteate,bright,capitate,cell,column,conical,curved,decurrent,diamete,distal,eaf,ebracteate,edicel,eed,elliptic,elongate,entire,especially,exserted,first,fortaleza,fruiting,give,glabrescent,glandular,gradually,gree,hal,half,head,hyaline,incurved,interjected,internode,largest,leaflet,like,lon,lower,main,maturity,minute,mixed,narrowly,nflorescence,node,numerous,oblique,occasionally,often,pair,pedicel,peduncle,petiolule,population,present,primary,prominent,pseudostipule,rachi,rarely,recurve,reflexed,rest,ruit,río,scattered,secondary,sessile,set,short,silky,sinus,slightly,smaller,sprawling,spreading,staminal,sterile,straight,subopposite,tall,tem,terminal,tertiary,testa,toward,ud,unicellular,unit,unpaired,usually,wall,weak-walled,white,wid,winged,woody,ympodial	0.05-0.1,branching,color,form,growth,height,history,length,life,midpoint,midrib,na,plant,ray,reproduction,seed,shape,size,staman,stellae,stipe,texture
370	wfo-0001028478	success	267	125	105	162	20	0.393	.0,.2,.3,.8,.9,0.0,0.3–0.5,0.4,0.5–0.6,0.5–0.9,0.6–1.3,0.9–1.1,1.1–1.6,1.4–2.3,1.4–4.4,1.8–2.0,2,2.0–11.0,2.1–2.3,2.2–4.0,2.3,2.5,3.3–4.9,3–6,4,abaxially,adaxially,anther,apex,attachment,base,brochidodromous,calyx,cm,corolla,deeply,densely,developed,diameter,distinct,dry,elliptic,entire,filament,flattened-orbicular,flower,fruit,glabrous,globose,interpetalar,lanceolate,lateral,leaf,length,lobe,margin,mature,midrib,midvein,mm,moderately,notched,oblong,obtuse,occasionally,orange-red,ovate,petiole,pitted,point,poorly,pubescent,raised,ray,rounded,scattered,shallowly,shrub,sinuate,slightly,sparsely,spatulate,stellae,stellate,stem,stigma,strongly,style,sub-cordate,sub-coriaceous,suborbicular,surface,tip,tissue,toward,truncate,tube,typically,unbranched,vein,white,yellow,yellow-tan,×,–10	.04,.5,0.1,0.2,0.2–0.4,0.3–0.4,0.4–0.5,0.5–0.8,1.0–1.3,1.0–1.5,1.3–1.6,1.5–2.4,1.5–4,1/2–1/3,3.4,4.6,4.6–7.0,4.8,4–6,4–7,5-merou,5.5–6.6,7,7.7–9.2,acuminate,adjacent,adnate,aequilateral,ag,alyx,anthesi,apart,apical,apparently,appearing,appresse,around,articulate,attenuate,axe,ba,bark,based,berry,bilobed,blade,borne,broad,broad-based,broadly,brown,bud,capitat,channeled,clinate,connivent,deciduous,deflexed,deltate,development,difoliate,directed,distal,distally,distinctly,eaf,edge,eed,either,emerging,endocarp,erect,exocarp,extending,fertile,filiform,flexed,free,geminat,glandular,glossy,gradually,hair,hort,increasing,incurved,individually,internode,intersepalar,juic,layer,lobed,lon,long,longer,lower,markedly,midpoint,minute,nearly,nflorescence,oblique,opaque,orolla,pedicel,peduncle,per,perforated,pore,porrect,porrect-stellate,portion,potentially,presen,prickle,probably,reddish,retrorse,rigid,row,ruit,seen,sessile,shoot,short,side,sigmoid,simple,sinus,sloughing,smoot,somewhat,soon,spaced,splitting,spread,stamen,stellate-pubescent,stipe,stipitate,straight,suture,tamen,tem,terminal,thin,time,transparent,triangular,two,ud,unarmed,various,vary,well,wide,yellow-ferruginou,ympodia,young,±45°,±90°,±equal	branching,color,form,growth,height,history,inflorescence,life,na,ovary,perennial,plant,pubescence,reproduction,seed,shape,size,staman,texture,width
371	wfo-0001028481	success	194	122	104	90	18	0.536	.1,.5,0.6-1,0°,1-3,1-4,1.5,1.5-2,1.8-2.5,2.5-3,3-4,3-4.5,3-6,5.5-7.5,8,acuminate,acute,almost,along,anther,apex,apically,attenuate,bark,base,branch,branched,chartaceous,clavate,cm,conical,corolla,cuneate,cupular,deltoid,dendritic,dendritic-pubescent,diameter,discolorous,distributed,drying,elliptic,entire,equal,erect,evenly,flaking,glabrous,lamina,leaf,length,less,liana,like,lobe,lobed,long,long-acuminate,longitudinally,main,margin,midvein,mm,narrowly,oblique,occasional,often,orange-brown,pair,pedicel,peduncle,petiole,primary,pubescent,ray,ridged,scar,shortly,shrub,side,size,slender,small,smoothly,sparsely,stem,stigma,stump,style,surface,terminal,tertiary,thickly,trichome,tube,unarmed,unknown,vein,venation,visible,white,wide,x,young	.3,0-2,0.1-0.2,0.15,0.5-1,1-1.4,1-2,1/2-2/3,2-3,3,3-3.5,abaxially,absent,adaxially,age,alyx,anthesi,apar,apparently,articulated,brown,canaliculate,clearly,close,colour,deeply,delineated,density,different,dilated,divided,domatia,dorsifixed,dry,eaf,eed,ellipsoi,except,extending,extent,eye,faint,filament,flat,flexuous,flower,free,green,increasing,know,known,lengthening,linear,lon,longer,lower,m.,mostly,naked,nflorescence,nther,oblong,orolla,ovate,perfec,plurifoliat,pore,poricidal,portion,protruding,rachi,raised,reddish,ribbed,ruit,see,simple,sinus,smoot,spreading,tearing,tip,together,toward,ud,uneven,unit,vary,yellowish,ympodial	angle,apart,arrangement,branching,calyx,color,form,fruit,growth,inflorescence,na,number,ovary,seed,shape,smooth,texture,width
372	wfo-0001028482	success	224	131	107	117	24	0.478	.1,.5,/3,00,1-1.5,1-11,1-2,1-4,1.1-5,1.2-1.6,1.5-2,10,2-3,2-celled,3-12,3-4,4-5,5-25,6-50,abaxially,acuminate,acute,adaxially,alternate,anther,apex,ascending,asymmetric,base,bifurcate,broadly,brownish,calyx,chartaceous,cm,coriaceous,corolla,creamy,cucullate,cymose,deltate,densely,diameter,dry,elliptic,emarginate,entire,filament,flattened-reniform,flower,fresh,fruit,glabrous,glandular,globose,green,growth,hard,impressed,keeled,lobe,lobed,long,margin,material,maturity,midrib,midvein,minute,minutely,mm,obovate,occasionally,ovary,pale,petiole,pitted,pubescent,revolute,short,simple,size,slightly,small,somewhat,stem,stigma,style,subcoriaceous,subglobose,surface,tan,tip,tree,trichome,truncate,tube,tuft,uniseriate,vein,way,white,x,yellow,yellowish,young,µm	0,0.2,0.5,0.5-1,0.5-5,0.7-1.1,1.5-3,7-14,age,angled,anthesi,apiculae,bark,basal,becoming,berr,berry,bifid,bilobed,branched,bright,brochiodromous,bud,campanulate,capitate,channeled,circinate,closely,constriction,corky,corrugated,curved,deciduous,deflexed,diffusely,difoliate,discolorous,distally,distinct,drying,eaf,eed,ellipsoid,embryo,enlarged,exerted,exfoliating,expanding,fleshy,free,fruiting,geminat,glabrou,golden,grayish,halfway,heterostylous,incrassate,individual,internodal,investing,irregular,leaf-opposed,lengthening,less,lower,markedly,materia,new,nflorescence,nodding,olive,overlappin,pair,papillat,pedicel,peduncle,pentamerous,per,pericarp,petal,pore,poricidal,portion,primary,reddish,row,ruit,scandent,scar,shaped,shiny,slit,sometimes,soon,spaced,sparsely,stout,straight,subpyramidal,tear-drop,tightly,tiny,transparent,transversely,tub,tuberculate,twice,two,ud,unifoliate,unit,usually,vegetative,venation,woody,ympodial	branching,color,form,height,history,inflorescence,lateral,leaf,length,life,midpoint,na,perennial,plant,pubescence,ray,reproduction,seed,shape,staman,stellae,stipe,texture,width
373	wfo-0001028487	success	195	112	84	111	28	0.431	0.3-0.7,0.9-3,1-2,1-3,1.1-1.5,1.4-1.7,10-41,2-4,2-6,2.5-3.5,3-10,3-19,4-7,4.6-13.6,5-6,7.8-16.4,abaxially,acuminate,acute,adaxially,anther,apex,attenuate,base,brownish,cell,central,cm,condition,coriaceous,corolla,covering,deep,diameter,drying,filament,flower,forked,fresh,fruit,glabrescent,glabrous,green,greenish,hair,hair-like,herb,lateral,leaf,light,lobe,long,medium,mm,odd-pinnate,ovate,ovoid,pentagonal,petiole,petiolulate,plant,purple,ripe,rounded,scabrous,scarce,seed,short,size,star,stigma,style,substellate,testal,thick,tip,tube,usually,wall,white,whitish,wide,x,yellow	0-9,0.4-1.5,1-3.2,1.7-7,10-4.3,15-28,2-4.8,3-4,3-5,3.4-7.8,5-merou,acumen,adaxiall,ag,along,alyx,apart,apparently,arranged,articulated,asymmetric,axe,axillary,basiscopic,bead,berry,blade,bud,capitat,clavate,connivent,considerably,dark,decreasing,digestion,distal,dorsally,eaf,edge,eed,elliptic,enzyme,erec,exceeding,flat,folded,geminat,generally,glabrou,green-white,hal,half,high,homostylous,honeycomb-shaped,interjected,lanceolate,leaflet,lengthening,like,living,lower,make,moniliform,mucilaginous,multiple,narrow,necklace,nflorescence,orbicular,orolla,pair,pedicel,peduncle,perfect,plurifoliate,pore,poricidal,removed,ruit,second,sessile,seudostipule,side,slit,smaller,sometimes,spaced,specimen,stamen,stolon,straight,subequal,subglabrou,subtending,tall,tamen,tem,terminal,throughout,tissue,toward,tri-,tuber,typically,unit,unwinged,vary,wet,wing,ympodial	branching,calyx,color,form,growth,height,history,inflorescence,length,life,margin,midpoint,midrib,midvein,na,ovary,perennial,pubescence,ray,reproduction,shape,staman,stellae,stem,stipe,surface,texture,vein
374	wfo-0001028489	success	224	130	108	116	22	0.482	-0.6,-2.5,-6,/4,0.2-0.4,0.2-0.7,0.3-1,0.3-1.2,0.5-0.8,0.5-1.5,0.6-1.2,0.7-3,1-3,1-4,1.5-4,1.8-2.2,1.8-4,1/3,2-3,2-6,2.1-3,3-7,3.5-6,4-8,7.5,abaxially,acute,anther,apex,apically,apparently,base,berry,branched,calyx,cell,chartaceous,cm,cordate,cream,cuneate,curved,dark,deltate,densely,diameter,dull,elliptic,erect,filament,flattened-reniform,flower,fruit,glabrous,gray,green,lateral,leaf,length,lobe,lobed,long,margin,marking,maturity,mauve,membranous,midpoint,midvein,mm,moderately,obtuse,orange,orange-brown,outline,ovate,pale,petiole,purple,raised,ray,rounded,shiny,shrub,side,slender,smooth,sometimes,sparsely,spherical,stellate,stellate-pubescent,stem,style,surface,tip,toward,trichome,truncate,tube,upper,vein,way,white,wide,yellow,yellow-orange,young	-10,-4,-5,0-10,0-15,0-20,0-3,0-50,0.1,0.1-0.6,0.2,0.2-,0.2-0.5,0.2-0.6,0.3-0.5,0.3-0.7,0.4-0.8,0.5-1,0.5-1.1,1-6,1-7,1.5-3,1.8-5.5,1/3-1/2,1/4-1/2,2-4,4-10,4-13,5-25,5-8,5-merous,acicular,alyx,apar,apart,articulated,ba,bark,beyond,blade,broad-deltate,caudat,concolorous,connivent,difoliate,distance,drying,eaf,eed,elongating,equal,extending,eye,free,fruiting,geminat,hair,herbaceous,infructescence,less,lon,longer,lower,mature,minute,naked,nflorescence,occasionally,often,older,one,open,orange-green,orolla,oung,pair,pedicel,peduncle,pendulous,per,perfec,pericarp,perpendicular,poricidal,porrect,portion,prickle,prickly,primary,protruding,red-brown,ruit,scar,sessile,simple,spaced,spreading,stalk,straight,subsessile,tamen,tapering,terete,tertiary,time,unarme,unarmed,unit,vary,venation,visible,weakly,white-gra,woody,yellow-green,ympodial	branching,caudate,color,corolla,form,growth,height,inflorescence,midrib,na,ovary,perfect,plant,pubescence,reproduction,seed,shape,size,staman,stellae,stigma,texture
375	wfo-0001028492	success	130	105	69	61	36	0.531	0.5-1,1-2.5,1.5-2.5,1.5-3,1.5-6,1.75-3.5,2-2.5,2-3,2-5,2.5-9,3,3-6,4,5-25-flower,5-8,6-11,abaxially,acute,adaxially,angled,apex,apiculate,base,calyx,ciliolate,cm,color,colored,dark,diameter,elliptic-ovate,entire,except,forked,fruit,glabrous,globose,hair,herb,lobe,long,margin,mm,petiole,pubescent,purple,rarely,reticulate,ripe,rounded,shrub,somewhat,sparse,stellate,stigma,style,subcordate,subcoriaceous,succulent,time,tip,triangular-ovate,tube,unbranched,unknown,white-punctate,whitish,wide,x	-5-foliat,0.2-2,1-4,1-5,15-20,2-4,5-15,6-12,8-15,absen,aggregate,apart,articulated,axe,axi,blade,cell,chartaceous,connivent,containing,crystal,cylindrical,deltate,directed,distall,eaf,eed,glabrou,irregularly,leaving,lower,narrowly,nflorescence,nther,obtuse,orolla,pedicel,peduncle,pore,punctate,rachi,radiu,ruit,san,sand-punctate,scar,simple,spaced,splitting,stone,tal,tem,triangular,truncat,unevenly,unit,vary,veiny,white,x1-3,ympodial	1-3,anther,branching,corolla,filament,flower,form,growth,height,history,inflorescence,lateral,leaf,length,life,midpoint,midrib,midvein,na,ovary,perennial,plant,pubescence,ray,reproduction,seed,shape,size,staman,stellae,stem,stipe,surface,texture,vein,width
376	wfo-0001028501	success	195	118	89	106	29	0.456	0-3.2,0.3-0.7,0.8-1.6,0.8-1.7,1-2,1-8,2-4,2.8-18,2.8-4.9,3-10,3-5,3-7,3.1-12,4-8,6.6-21.1,8-10,8-34,abaxially,acumen,acuminate,acute,adaxially,anther,apex,base,brownish,cell,cm,condition,coriaceous,corolla,covering,decurrent,diameter,drying,filament,flower,forked,fresh,fruit,glabrescent,glabrous,green,greenish,hair,hair-like,herb,lateral,leaf,light,linear,lobe,long,medium,mm,mottled,narrowly,odd-pinnate,onto,ovate,ovoid,petiole,plant,purple,pyriform,rachi,ripe,rotate,scarce,seed,sessile,short,simple,size,sometimes,spot,stigma,style,testal,thick,tip,tube,usually,wall,white,whitish,wide,x,yellow	0-3,0-4,0.3-3.3,0.6-5.8,1,1-3,1.8-10.7,13-41,2-5,3.1-10.4,4.8-18,5-merou,adaxiall,ag,along,alyx,apart,apparently,arranged,articulated,attenuate,axe,axillary,bead,berry,blade,broadly,bud,capitat,clavate,connivent,considerably,dark,decreasing,digestion,distal,dorsally,eaf,edge,eed,elliptic,enzyme,erec,exceeding,flat,folded,geminat,generally,glabrou,green-white,hal,half,high,homostylous,honeycomb-shaped,interjected,lanceolate,larger,leaflet,lengthening,like,living,lower,make,moniliform,mucilaginous,multiple,narrow,necklace,nflorescence,orbicular,orolla,pair,pedicel,peduncle,perfect,plurifoliate,pore,poricidal,present,removed,ruit,seudostipule,slit,spaced,specimen,stamen,stolon,straight,subglabrou,subtending,tall,tamen,tem,terminal,throughout,toward,tri-,tuber,typically,unit,unwinged,vary,wet,wing,ympodial	branching,calyx,color,form,growth,height,history,inflorescence,length,life,margin,midpoint,midrib,midvein,na,ovary,perennial,pubescence,ray,reproduction,shape,staman,stellae,stem,stipe,surface,texture,vein,width
377	wfo-0001028502	success	158	107	84	74	23	0.532	/2,1-2,1.5-2,1.5-2.5,1.5-3,1.5-6,1.6-2.4,2-4,2-5,2-7,2-8,3.5-15,3.5-4,5-15,abaxially,acute,adaxially,along,anther,anthesi,apex,base,beige,branched,brown,calyx,cm,congested,corolla,dark,dendritic,densely,denser,dia,elliptic,fawn,filament,flattened-reniform,flower,glabrous,globose,impressed,inflorescence,later,lateral,leaf,light,lobe,lobed,long,margin,matted,minutely,mm,often,ovary,papillose,petiole,pitted,planar,pubescent,reddish-brown,scattered,seed,shining,shrub,small,stem,stigma,style,surface,terminal,time,tip,tree,tree-like,trichome,tube,vein,warty,way,white,wide,woody	.5,0.5-1,2-2.5,5-6,6-8,?,abaxial,age,apar,ba,bark,blade,body,branch,campanulate,cazalet,christmas-tree-like,clavate,closely,cone,constricted,deltate,eaf,edicel,eed,erect,exserted,fide,flat,fleshy,free,fruiting,glabrat,heteromorphic,included,incrassate,inflorescenc,lengthening,like,lon,long-styled,lower,main,middle,narrower,nflorescence,obovate,older,packed,pair,papillo,pedicel,plurifoliat,pore,poricidal,portion,prominent,rest,ruit,scar,short-styled,slit,spaced,structure,tall,thick,tub,ud,unclear,unevenly,widest,within,ympodia,young	4-6,branching,color,dense,diameter,form,fruit,growth,height,history,length,life,midrib,midvein,na,perennial,plant,pubescence,reproduction,shape,size,staman,texture
378	wfo-0001028505	success	168	89	64	104	25	0.381	.1,.3,.5,0.8-1.5,1-3,10-14-flowered,10-15,2,3.5-5,7-8,acuminate,acute,anther,apex,base,beneath,calyx,cm,corolla,deltoid,dia,drying,filament,glabrous,globose,green,grey,lateral,leaf,lobe,lobed,margin,minutely,mm,narrowly,ovary,ovate,ovoid-reniform,pair,pale,papillose,petiole,pitted,plant,prominent,pubescent,rounded,seed,shape,shrub,simple,size,stem,stigma,style,surface,tan,tip,truncate,tube,vein,white,x,yellowish	.01,/3,0.25-0.5,0.8-1,1,1.2-2.5,1/3,2.5-4.5,3-5,anthesi,aspect,ba,barely,bark,basal,berry,black,blade,body,branch,bright,broadly,bud,characteristic,conical,darker,deciduous,decurrent,deflexed,delicate,differentiated,differing,difoliate,distance,distinct,dried,dry,eaf,edicel,eed,elliptic,erect,expanded,exserted,exsertion,f,flattened,free,fruiting,geminat,gently,greatly,incrassate,live,lon,long,lower,m.,main,major,materia,material,member,minor,minute,nflorescence,obovoid,obvious,older,opposite,overlapping,pedicel,pore,poricidal,portion,proximal,purple,reflexed,ruit,scar,shaped,short,slightly,somewhat,soon,specimen,straight,strongly,tall,tapering,tear-drop,touching,trichome,ud,unicellular,uniseriate,unit,usually,way,whit,widest,woody,ympodial,young	branching,color,diameter,flower,form,fruit,growth,height,history,inflorescence,length,life,midpoint,midrib,midvein,na,perennial,pubescence,ray,reproduction,staman,stellae,stipe,texture,width
379	wfo-0001028513	success	240	107	84	156	23	0.35	-17,0.1-0.4,0.2-0.8,0.3-0.5,0.5-0.6,1-2.5,1-4,1.5-5,15-40,2-4,2-5,2.75-3.25,20-35,25-45,3-4,3-4.5,3.5-4,4-6,4-8,5-10,5-6,7-11,8-11,acute,anther,apex,apiculate,base,broadly,brown,calyx,cm,coarsely,densely,dentate,diameter,ellipsoidal,filament,flower,fruit,globose,inflorescence,lateral,lavender,leaf,length,lenticular,light,lobe,margin,mm,obtuse,orange,outline,ovate,ovate-lanceolate,perennial,petiole,pitted,pubescent,ray,ripe,rounded,small,somewhat,stellae,stellate,stellate-pubescent,stigma,style,subcordate,surface,texture,thin-textured,tree,trichome,truncate,tube,unbranched,variable,vein,white,x,yellow	-0.7,-0.8,-5,-6,.1-1.3,.2,.3-0.5,/3,0-0.4,0.1-0.15,0.5-2,1,1-2,1-3,1/5-1/3,2,2-4.5,2-6,2-foliate,30,4-locular,4.5-6,5-9,8-15,8-16,8-25,9-11,abaxially,accrescent,acute-,acute-tipped,adaxiall,adaxially,along,apart,appearing,appressed,approaching,approximately,armed,articulated,attenuate,axe,ba,berr,blade,bristly,broad,broad-based,bud,campanulate,capitat,cauline,close,closely,commonly,compresse,connivent,cylindrical,deciduous,deltoid,depressed-deltoid,directed,distal,distall,doubling,eaf,eed,enclosing,entire,erect,exceeding,extra-axillary,female-sterile,flexible,fruiting,geminat,glabrous,hair,horizontal,inserted,interlobal,large,larger,laterally,less,lignescent,linear-lanceolate,long,lower,major,many,mature,midpoint,minute,near,nflorescence,numerous,obtuse-,often,one,oriented,orolla,pair,partially,pedicel,peduncle,per,pericarp,persisting,plane,pore,present,prickl,prickle,prickly,principal,purple,rachi,radiu,rarely,reaching,recurved,rigid,round-tipped,ruit,rust-colored,scabrous,scattered,sessile,short,short-stalked,side,silvery-gray,simple,sinus,siz,smaller,soft,spaced,sparsely,stalk,tal,tamen,tem,termination,time,tooth-like,unarmed,underdeveloped,unit,usually,vary,weakly,wide,ympodial	branching,color,corolla,form,growth,height,history,life,midrib,midvein,na,ovary,plant,pubescence,reproduction,seed,shape,size,staman,stem,stipe,tip,width
380	wfo-0001028524	success	236	142	116	120	26	0.492	0.3,0.6-1.4,1-5,1.1-1.2,1.2-1.3,1.5-1.6,1.5-3,1.8-2.5,10-20,2-3.8,2-6,2.8-3.5,3-10,3-15,3-4.3,3.4-3.6,4-6,4.3-6,7-11,9-14,abaxially,acuminate,acute,adaxially,along,anther,apex,base,branched,brown,calyx,chartaceous,cm,corolla,cream,deltoid,densely,diameter,dm,due,echinoid,entire,exserted,ferrugineous,few-rayed,filament,flower,fruit,glabrescent,granular-tomentose,gray,greenish,growth,hair,honeycombed,lanceolate,lateral,leaf,length,lobe,long,margin,midvein,mixed,mm,multangulate,nearly,obtuse,ovate,ovate-lanceolate,pale,partly,persistent,petiole,porrect-stellate,probably,prominent,pubescent,rather,ray,reniform,reticulate-punctate,ripe,rounded,scabridulous,sessile,short,short-stalked,side,simple,slightly,small,somewhat,sparingly,sparsely,stamen,stellate,stem,stigma,style,subcoriaceous,subglobose,suborbicular,terete,thick-stalked,time,tomentose,tree,tube,vein,velutinous,warty,x,yellow,yellowish,yellowish-green	-2.7,-3,.5-1,/10-3/10,0-150,0.3-0.8,0.5-3.5,1/3-2/3,11,2.5-3.4,2.5-3.8,2.5-4,3.3-4,4-8,6-7,6-9,7-10,8-13,accrescent,ag,anthesi,apart,apical-lateral,apparently,articulated,ascending,axe,axillary,ba,bark,becoming,berry,blade,blunt-tipped,branch,bud,capitat,closely,conical,continued,dark,dehiscing,distal,eaf,echinoi,eed,elliptic,extend,few-,first,fleshy,free,fruiting,glabrescen,glabrous,green,half,high,indument,inserted,interpetalar,introrse,lacking,lanceolat,large,late,later,lobed,longitudinal,lower,m.,main,many-rayed,matted,midvei,nflorescence,oblong,obscured,often,older,orbicular,orolla,overlapping,pedicel,peduncle,perfect,plurifoliate,pore,present,pseudo-terminal,rachi,relatively,ruit,runk,slit,spaced,stalked,stelliform,stout-stalked,strongly,sulcate,suture,tamen,testa,thick,thin,thin-stalked,tissue,tomentu,touching,translucent,unarme,unarmed,unit,usually,vary,way,wide,ympodial,young	30-150,branching,color,form,height,history,inflorescence,life,midpoint,midrib,na,ovary,perennial,plant,pubescence,reproduction,seed,shape,size,staman,stellae,stipe,surface,texture,tip,width
381	wfo-0001028525	success	257	106	96	161	10	0.374	0.5-1.5,0.5-2.5,1-1.5,1.1-1.7,1.2-1.6,1.5-3,1/3-3/4,10,10-13,2,2-2.5,2.5-5,3,3-7,4,4-5,4-7,6,7,7.5,acuminate,acute,almost,anther,anthesi,apex,attenuate,base,black,branched,branching,brown,calyx,capitate,chartaceous,clavate,cm,cordate,corolla,curved,dark,dendritic,dendritic-pubescent,developed,diameter,drying,elongated,entire,flat,flattened,form,fruit,glabrous,grey,laterally,leaf,liana,light,lobe,lobed,long,lumpy,margin,mature,mauve,membranous,midvein,mm,obconical,orange-brown,ovate,pair,partly,pedicel,peduncle,petiole,primary,pubescent,pyriform,shrub,side,size,slender,sometimes,spheroidal,stem,stigma,style,terminal,thick,truncate,unarmed,vein,weakly,whitish,x	.25,.4,0.2-0.3,0.2-0.6,0.5,0°,1-2,1-2.5,1-4,1.5,1mm,2-3,3-5,4-15,7-13,accrescent,age,along,alternate,alyx,apar,apart,apically,apice,apparently,around,articulated,axil,bark,becoming,berry,brachyblast,branch,broadly,centre,clearly,clum,clustered,conical,cup,deeply,delineated,deltoid,densely,density,detaching,developing,dilated,discolorous,divided,domatia-like,dorsal,dorsifixed,eaf,eed,ellipsoi,equal,erect,eye,fertilisation,fewer,filament,fine,flexible,flexuous,flower,formed,forming,free,frequently,frui,fruiting,glabrescent,green-brown,increasing,inside,known,lamina,lateral,leave,lengthening,less,like,linear,longer,longitudinally,loop,loose,lower,m.,main,minute,much,multicellular-dendritic,naked,narrowly,nflorescence,nther,oblong,obscuring,often,one,orolla,outside,overlapping,ovoid,pendulous,perfec,pericarp,plurifoliat,pore,poricidal,portion,prominent,protruding,puberulous,rachi,ray,red-brown,ridged,rounded,ruit,scar,scattered,sessile,simple,sinus,slightly,small,smaller,smoot,smooth,somewhat,soon,sparsely,spreading,stripe,structure,stump,surface,tangling,tearing,terete,tertiary,thin,tip,toward,trichome,tube,ud,uneven,unit,vary,venation,visible,well-developed,white,wide,wider,ympodial,young	color,growth,inflorescence,length,ovary,pubescence,shape,texture,true,width
382	wfo-0001028528	success	155	110	85	70	25	0.548	.5,1-2,1.1-1.2,2-3,2-4,2.5-3,3.5-4,3.5-6,3/4,4-5,4-6,6-10,6-7,8-9,acuminate,acute,along,anther,anthesi,apex,attenuate,base,berry,blackish,branching,calyx,cm,coriaceous,corolla,decurrent,dendritic,densely,denser,diameter,elliptic,filament,flattened,flower,glabrous,globose,growth,leaf,lobe,lobed,long,margin,midvein,minutely,mm,mucronate,narrowly,obovate,occasionally,outline,ovary,pair,per,pericarp,petiole,pitted,planar,pubescent,pyramidal,reddish-brown,revolute,round,shiny,shrub,sparsely,stem,stigma,strongly,style,surface,thin,time,tip,triangular,trichome,tube,vein,violet,way,white,x	0.9-1.2,1.5,1.8-2,?,abaxial,absent,adaxial,adaxially,age,apical,ba,bark,basal,becoming,bi-lobed,branch,conical,dichasia,eaf,edicel,eed,erect,ew,except,exserted,fork,free,fruiting,glabrat,glandular,immature,impressed,inserted,later,leave,like,lower,m.,minute,nflorescence,nodding,older,papillo,pedicel,petal,plurifoliate,pore,poricidal,portion,prominent,ruit,scar,secondary,short,sleeve,slit-like,somewhat,stamen,ste,tall,tapering,terminal,tub,ud,unit,wide,winged,woody,ympodial,young	color,form,fruit,height,history,inflorescence,lateral,length,life,midpoint,midrib,na,perennial,plant,pubescence,ray,reproduction,seed,shape,size,staman,stellae,stipe,texture,width
383	wfo-0001028529	success	164	105	79	85	26	0.482	0.1,0.5-2,0.8-1.3,0.8-3.2,1,1-1.2,1-1.5,1.5,2.5-3,2/3,3-40-flowered,5-6,6-9,8-14,acuminate,anther,anthesi,apex,attenuate,base,bluish,brown,calyx,cast,cm,corolla,dark,decurrent,dia,filament,flower,furcate,glabrous,globose,green,lanceolate,lateral,leaf,less,lobe,lobed,long,metallic,minute,minutely,mm,narrowly,nearly,oblanceolate,occasionally,ovary,ovoid-reniform,pair,papillae,papillose,petiole,pitted,planar,reflexed,scattered,shape,short,shrub,simple,size,slightly,smooth,stem,stigma,style,subshrub,surface,tip,tube,vein,way,white,winged,x	.2,0.5,0.8-3,3-5,7-8,across,acute,age,apart,apiculate,bark,becoming,beginning,beneath,berry,bud,capitate,close,cork,course,deflexe,deltoid,distal,eaf,edicel,eed,ellipsoi,elliptic,erect,evenly,exfoliating,exserted,free,fruiting,growing,heterostylous,hrub,hyaline,immature,indistinct,inflorescenc,internodal,lenticellat,linear,lon,lower,main,major,middle,minor,much,nflorescence,older,one,opposite,paler,papillo,pedicel,pore,poricidal,portion,present,prominent,range,river,ruit,scar,shaped,slender,small,somewhat,soon,spaced,species,straight,tall,tapering,tear-drop,ud,umbonate,variable,widest,woody,yellowish,young	branching,color,diameter,form,fruit,growth,height,history,inflorescence,length,life,margin,midpoint,midrib,midvein,na,plant,pubescence,ray,reproduction,seed,staman,stellae,stipe,texture,width
384	wfo-0001028532	success	186	102	74	112	28	0.398	0.2-1,1-1.7,1-2,1-3,1-5,15-36,2-3,2-8,2.2-4.2,3-10,3-7,4-7,5.5-15,6.5-9.2,7.5-15.2,abaxially,acumen,acuminate,acute,adaxially,anther,apex,attenuate,base,brownish,chartaceous,cm,condition,corolla,deep,diameter,drying,filament,flower,forked,fresh,fruit,glabrous,globose,green,greenish,herb,lateral,leaf,linear,lobe,long,medium,mm,mottled,mucilaginous,odd-pinnate,ovoid,pentagonal,petiole,petiolulate,plant,purple,ripe,rotate,rounded,seed,size,sometimes,spot,stigma,style,tip,tube,wet,white,whitish,x,yellow	0-19,1-1.6,1.3-8.7,1.4-1.6,17-42,2-6,3-5,3.3-4.4,3.9-5,5-9,5-merou,abaxiall,ag,along,alyx,apart,apparently,arranged,articulated,asymmetric,axe,axillary,basiscopic,bead,berry,blade,bud,capitat,cell,clavate,connivent,covering,dark,decreasing,digestion,distal,dorsally,eaf,edge,eed,enzyme,erec,exceeding,flat,folded,geminat,generally,glabrou,green-white,hair-like,half,homostylous,honeycomb-shaped,interjected,lanceolate,larger,leaflet,lengthening,like,living,lower,make,middl,moniliform,multiple,necklace,nflorescence,orbicular,orolla,ovate,ovate-lanceolate,pair,pedicel,peduncle,perfect,plurifoliate,pore,poricidal,removed,ruit,second,sessile,seudostipule,side,slightly,slit,spaced,specimen,stamen,stolon,straight,subequal,subtending,symmetric,tall,tamen,tem,terminal,testal,thick,throughout,tissue,toward,tri-,tuber,typically,unit,unwinged,usually,vary,wall,ympodial	branching,calyx,color,form,growth,height,history,inflorescence,length,life,margin,midpoint,midrib,midvein,na,ovary,perennial,pubescence,ray,reproduction,shape,staman,stellae,stem,stipe,surface,texture,vein
385	wfo-0001028546	success	239	138	116	123	22	0.485	%,0-18,0.4-0.5,0.5-0.75,0.5-1.5,1-2,1-3,1-3.5,1.1-1.8,1.1-2.2,1.5-1.75,1.5-2,10-22,2-3.5,2.3-2.7,2.5-3,2.6-3.4,3-4,3-5,3.5-19,3.5-7.5,4-13,4-8,4-9,4.5-6,5-10,7.5-10,9.5-19,9.5-24,abaxially,acuminate,acute,adaxially,anther,apex,attenuate,base,brown,calyx,chartaceous,cm,cuneate,deeply,diameter,ellipsoidal,elliptical,erect,extra-axillary,filament,finely,flattened,flower,fruit,glabrous,gland-tipped,globose,green,hair,index,inflorescence,interpetalar,lamina,lateral,leaf,length,lobe,lobed,lobing,long,margin,midpoint,midvein,mm,moderately,oblique,obtuse,ovate,pale,part,perennial,petiole,pinkish,plant,porrect,present,pseudo-racemose,purple,ray,red,reticulate,rhizomatous,rotate,shallowly,short,shrub,side,simple,sparsely,stellae,stellate,stellate-pubescent,stigma,style,surface,tan,throughout,time,tissue,triangular,tube,unbranched,vein,white,wide,x,yellow	0-0.1,0-0.5,0-1,0-9,0.15-0.25,0.3-0.5,0.3-1,0.5-1,0.5-1.3,0.5-2,0.6-2,0.8-1.4,1-4,1-7,1-locular,1.5-6,10-14,100-150,11-12,120-400,16-24,2-,2-4,2-9,26-38,3-,3-11,3-7,5-55,5-8,5-merou,6-10,7-24,8-15,8-40,9-16,absen,absent,accrescent,acicular,across,adult,also,alyx,ample,andromonoecious,apart,apparen,articulated,axe,ba,bilobe,blade,branch,branche,capitate,connivent,cylindrical,directed,distall,distally,distributed,dm,eaf,eed,eglandular,exocarp,finger,foliate,fruiting,functional,geminat,half,heterostylous,incomplete,juicy,juvenile,lanceolate,less,longer,lower,main,markedly,mature,mesocarp,mid-point,minute,nflorescence,often,orolla,pair,pedicel,peduncle,pendent,per,placenta,pore,prickle,rachi,ruit,septum,sessile,slightly,somewhat,spaced,stalk,straight,succulent,tal,tamen,tem,thick,thicker,thicknes,tissu,unarme,unarmed,unit,upper,usually,vary,weakly,ympodial	branching,color,corolla,dioecious,form,growth,height,history,life,midrib,na,ovary,pubescence,reproduction,seed,shape,size,staman,stem,texture,tip,width
386	wfo-0001028547	success	224	104	84	140	20	0.375	-13,-6,.2,.5,1-2.5,1.2-1.4,1.5-2.5,1.7-2,2-6,2.5-2.8,2.8-3.2,3-5,3.5-4.5,4-5,4-6,7-10,7-9,acute,anther,apex,base,berry,branched,branching,bright,calyx,cell,chartaceous,cm,cuneate,densely,diameter,dull,entire,filament,flattened-reniform,flower,fruit,glabrous,inflorescence,lateral,leaf,length,lobe,lobed,long,long-acuminate,margin,maturity,mauve,midpoint,midvein,mm,moderately,oblong,orange,orange-brown,outline,ovate,pair,petiole,pit,purple,raised,ray,red,scandent,shallowly,shrub,small,smooth,somewhat,spherical,stellate,stellate-pubescent,stem,style,surface,tip,truncate,tube,vein,wide,yellow	-1/2,-3,.7,.8,/2,/5,0,0-1,0-10,0-15,0-2,0-30,0-5,0.05-0.15,0.1-0.2,0.15,0.2-0.35,0.3-0.4,0.5-,0.7-1,0.8-1,1-2,1-4,1-5,1/3,1/5-1/4,10-12,2-1.5,2-2.5,2-4,5-merous,6-8,abaxial,abaxially,absent,adaxial,alyx,apar,apart,ape,apically,apparently,appearing,articulated,bark,blade,bulbous,conical,connivent,cream,curved,dark,deltate,discolorous,distance,drying,eaf,eed,elongate,elongating,equal,erect,extending,faint,flattened,free,fruiting,gently,glabrescent,glabrou,gray-brow,green,infructescence,lon,long-styled,longer,lower,marking,mature,narrow-deltate,nflorescence,occasionally,often,older,one,open,orolla,oung,pale,pedicel,peduncle,pendulous,per,perfect,pericarp,plurifoliat,poricidal,porrect,portion,prickl,prickle,prickly,primary,reddish,reflexed,rounded,ruit,scar,sessile,short-styled,side,simple,slender,sometimes,spaced,spreading,stalk,stalked,staminate,straight,subsessile,tamen,tapering,terete,terminal,tertiary,thin-acuminat,time,trichome,unit,usually,vary,venation,villous,way,woody,yellow-green,yellow-orange,ympodial,young	color,corolla,form,growth,height,midrib,na,ovary,plant,pubescence,reproduction,seed,shape,size,staman,stellae,stigma,stipe,texture,width
387	wfo-0001028548	success	266	121	112	154	9	0.421	.2,.8,.9,0,0.3–0.8,0.4,0.4–0.5,0.7–1.7,0.9–1.2,1.0–4.1,1.1–1.2,1.1–1.4,1.1–1.5,1.3–1.6,1.7–2.1,2.2–2.8,2.8,3.1,3.6–8.1,4,4.9,4–8,5.6,6.4–19.8,abaxially,acuminate,adaxially,anther,apex,apiculate,attachment,attenuate,base,branching,brochidodromous,brown,calyx,chartaceous,cm,color,corolla,cuneate,deltoid,densely,developed,diameter,distinct,dry,entire,filament,flattened-orbicular,flower,fruit,glabrous,glandular,globose,growth,hair,juvenile,lanceolate,lateral,leaf,length,lobe,lobed,long,many,margin,mature,midrib,midvein,minute,mm,notched,occasionally,ovate,petiole,point,poorly,porrect,probably,pubescent,raised,ray,rounded,sessile,short,short-stipitate,shortly,shrub,sparsely,stellae,stellate,stem,stigma,style,surface,time,tip,tube,unarmed,unbranched,unknown,vein,wave,weakly,white,yellow,yellow-ferruginous,young,±glabrous,×	.4,.6,.7,.8–2.4,/3,0.06,0.4–0.6,0.4–0.7,0.6,0.7–0.8,0.8–1.2,0.8–1.9,0.8–2.0,0.8–2.9,1.4–2.3,1.6–2.7,1/3,1/3–1/2,2.0,2.3,2.4–2.7,3.1–3.8,3.7–4.0,3.8–4.6,5-merou,5.5–6.6,6–10,6–9,90°,absent,acute,adnate,aequilateral,ag,alyx,anthesi,apart,apical,apparently,appearing,arching,area,around,articulate,axe,ba,bark,berry,blade,branch,broad,bud,capitat,central,channeled,clinate,congested,deciduous,dentate,development,difolate,directed,distal,eaf,edge,eed,either,elliptic,emerging,endocarp,erect,exocarp,extending,extra-axillary,fertile,filiform,flexed,free,geminat,glossy,gradually,heterostylous,increasing,incurved,intact,internode,interpetalar,intersepalar,juic,large,layer,less,lon,longer,lower,major,midpoint,minor,moderately,nearly,nflorescence,oblique,oblong,opaque,orolla,pedicel,peduncle,per,pitted,pore,porrect-stellate,portion,potentially,pubescenc,reddish,reflexe,remaining,rigid,row,scarcely,seen,shorter,side,simple,sinus,sloughing,smoot,smooth,somewhat,soon,splitting,spread,spreading,stamen,stellate-pubescent,stipe,straight,suture,swelling,tamen,tem,thin,tissue,transparent,truncate,two,ud,upper,various,vary,wide,ympodia,±90°,±equal	form,inflorescence,ovary,pubescence,seed,shape,size,staman,texture
388	wfo-0001028551	success	243	128	101	142	27	0.416	.3–0.5,.5,.8,0,0.5–0.6,0.7–2.3,0.8–1.4,1.0–1.6,1.1–1.4,1.4–2.0,1.5–1.8,1.7–2.6,1.8–2.5,2,2.0–2.6,2.0–3.5,2.2–7.5,2.75–4.0,4.2–5.9,4.5–7.0,8.0–11.4,8.0–12.0,8.5–20.5,abaxially,acuminate,adaxially,anther,apex,apiculate,attachment,attenuate,base,becoming,brochidodromous,calyx,caudate,chartaceous,cm,corolla,cuneate,dark,densely,diameter,dry,elliptic,entire,filament,flattened-suborbicular,flower,forking,fruit,glabrous,glandular,globose,green,hair,lanceolate,lateral,leaf,lilac,lobe,long,margin,maturing,midrib,midvein,minute,mm,nearly,notched,oblong,occasionally,petiole,point,prominent,pubescent,red,shiny,shrub,slender,somewhat,stellae,stigma,style,subcoriaceous,tan,time,tip,toward,tree,tube,unbranched,vein,violet,wavy,weakly,white,wide,yellow,×,–4.8	.0,.06,.1,.6,0.4–0.5,0.7–1.0,1.0,1.0–1.5,1.1,1.1–2.2,1.3,1.5–1.9,1.6–1.7,1.7,1/3,2.0–3.7,2.2–3.4,2.2–5.2,2.3–3.4,2.5,3/4,4–6-merou,5–11,7.5–10.5,9.0,adnate,aequilateral,almost,alveolate,alyx,anthesi,apart,apical,apparently,appearing,area,armed,articulated,axe,ba,berry,blade,branch,broad-based,bud,capitat,central,channeled,closely,conical,connivent,continuing,dehiscence,deltate,dentate,development,difoliate,distally,distinctly,dorsally,eaf,eed,either,endocarp,enlargement,entir,equal,exocarp,extra-axillary,fertile,filiform,free,frui,geminat,glabrou,gradually,homostylous,immature,inclined,increasing,internode,interpetalar,juic,lacking,large,line,lobed,lon,longer,lower,major,markedly,mature,minor,narrowly,nflorescence,numerous,oblique,orolla,outline,pedicel,poorly-developed,pore,porrect,portion,potentially,prickle,pseudo-peduncle,ripe,row,ruit,scattered,side,simple,sinus,smooth,spaced,split,splitting,spread,stamen,stellate,stellate-pubescent,straight,suture,tamen,tem,thin,tissue,triangular,two,typically,ud,unarme,unarmed,upper,vary,yellow-ferruginou,ympodia,young,±appressed,±globose	branching,color,form,growth,height,history,inflorescence,length,life,midpoint,na,ovary,perennial,plant,pubescence,ray,reproduction,seed,shape,size,staman,stem,stipe,surface,texture,width,yellow-ferruginous
389	wfo-0001028558	success	224	114	91	133	23	0.406	0.15-0.5,0.4-1.5,1-1.3,1-9,1.5-2.3,1.5-3,1.8-2.3,1/3-1/2,1/4,2.2-2.8,2.4-3,2.5-3.5,2.5-5,3-8,4-15,4.2-7,4.5-8,5-10,6-10,6-22,6-7.5,8-12,abaxially,acute,almost,andromonoecious,anther,apex,apically,base,berry,branched,broad-deltate,calyx,chartaceous,cm,cordate,cream,dark,densely,diameter,dull,entire,filament,flattened-reniform,flower,fruit,green,herb,lateral,leaf,length,lobe,lobed,long,long-styled,lower,margin,marking,maturity,mauve,midpoint,midvein,mm,moderately,often,orange-brown,ovate,pale,petiole,plant,ray,rounded,short-styled,shrub,smooth,sparsely,spherical,spreading,stellate-pubescent,stem,style,surface,tip,tube,upper,vein,way,wide,yellow,young	-2,-5,.5,/6,0-10,0-30,0-4,0-5,0.1,0.1-0.3,0.1-0.4,0.2,0.5-0.9,0.5-2,0.6,0.8-1.5,00-200,1,1-3,1-4,1.3-1.8,1.5-2.5,1.5-6,1/3,1/4-1/3,15-60,2-5,3-,3-50,3-9,3/,4,5-60,5-7,5-merous,6-20,6-9,7-10,adaxially,alyx,ame,apar,apart,apparently,articulated,bark,blade,c.,clearly,concolorous,conical,connivent,curved,deltate,discolorous,distal,distance,drying,eaf,eed,elongated,elongating,equal,erect,extending,flattened,free,fruiting,gently,glabrescent,glabrous,gra,hermaphrodite,heterostylous,infructescence,least,longer,lowermost,mature,multangulate,narrow-deltate,nflorescence,obtu,older,one,open,orolla,oung,pair,pedicel,peduncle,pendent,pendulous,per,pericarp,plurifoliat,poricidal,porrect,portion,prickl,prickle,prickly,primary,reflexed,ruit,scar,sessile,side,simple,spaced,stalk,stalked,staminat,stellate,stout,straight,tamen,tapering,terete,terminal,tertiary,time,trichome,unarmed,unit,variously,vary,venation,visible,weakly,woody,yellowish,ympodial	3/4,branching,color,corolla,form,growth,height,inflorescence,midrib,na,obtuse,ovary,pubescence,reproduction,seed,shape,size,staman,stellae,stigma,stipe,texture,width
390	wfo-0001028571	success	230	119	74	156	45	0.322	2.5,abaxially,acute,adaxially,anther,apex,base,broadly,brown,calyx,cm,cordate,curved,cylindrical,dark,densely,diameter,elongated,entire,erect,filament,finely,flattened,flower,fruit,gland-tipped,glandular-puberulent,globose,hair,highly,lanceolate,length,light,lobe,lobed,margin,marginal,minutely,mm,narrowly,nearly,ovate,pair,pale,perhaps,petiole,pubescence,pubescent,ray,rounded,shallow,shrub,similar,simple,size,somewhat,stellae,stellate,stem,stigma,straight,style,surface,surrounded,thin-textured,tip,tube,unbranched,undulate,variable,white,wing,x,yellow	'',.1,.2,.5,/3,0.2–0.4,0.3–0.4,0.3–0.6,0.4,0.4–0.8,0.5–1,0.6–0.8,0.6–1.4,0.75–4,0.9–1.7,0–,1,1.1-1.4,1.5–2.4,1.7–2.6,1/2,1/3,10–21,11–12,12,13–25,18,1–1.4,1–1.5,1–2,1–5,2,2-foliate,2.5–15,2–10,2–3.4,3,3.4–3.7,3.5–16,3–13,3–5-celled,3–7.5,3–8,4-rayed,40–80,4–10,4–15,5,5.2–9.2,5–15,5–8,62,7–16,8–12,8–14,8–15,9,=,``,absent,accrescent,acicular,almost,also,apical,average,axe,ba,bacca,blade,capitat,cell,compressed,contiguou,cover,dense,differing,dilated,dimorphic,directed,distall,divided,eaf,eed,enlarged,especially,exclusively,extra-axillary,extreme,fertile,fewer,free,fruiting,geminat,geminate,glabrou,gland,glaziou,half,hyaline,interlocking,larger,linear,long,longer,longest,lower,lutea,matura,maturing,merely,minute,multangulate,n,near,nflorescence,one,orolla,p,pedicel,peduncle,per,pore,prickle,proportion,rachi,recurved,ruit,scattered,sessile,slender,small,smaller,sparsely,spreading,stipitate,stout,summit,tal,tamen,tem,terete,time,tomentose,triangular,unarmed,unit,usually,vary,varying,vestigial,visible,wide,ympodial,–1.6,–19	0.3-0.6,0.5-1,0.6-0.8,0.75-4,1-1.4,1-1.5,1-2,1.7-2.6,11-12,19,2.5-15,3-7.5,3-8,3.4-3.7,3.5-16,4-15,5-8,5.2-9.2,branching,color,corolla,form,glabrous,growth,height,history,inflorescence,lateral,leaf,life,midpoint,midrib,midvein,na,ovary,perennial,plant,reproduction,seed,shape,staman,stipe,texture,vein,width
391	wfo-0001028583	success	294	137	118	176	19	0.401	.0,.2,.5,.6,.9,0,0.01,0.2–0.6,0.3–0.6,0.6–1.3,0.8–1.2,0.8–1.4,0.8–1.5,0.9–1.5,1.0–1.2,1.1–7.7,1.4–1.5,1.4–1.9,1.4–4.7,1.5–2.4,1.8–2.3,2.2–3.1,2.3–6.8,2.5–2.9,3.5–3.8,4,4–8,5.1–15.4,abaxially,acute,adaxially,anther,ape,apex,base,branching,brown,calyx,channeled,chartaceous,cm,corolla,craspedodromous,cuneate,deltate,deltoid,densely,diameter,distinct,dry,evenly,ferruginous,filament,filiform,flattened-reniform,flower,fruit,glabrous,glandular,globose,green,hair,heterostylous,lanceolate,lateral,leaf,lobe,lobed,long,margin,mature,midrib,midvein,minute,mm,moderately,oblong,orange,ovate,petiole,porrect,pubescence,pubescent,purple,raised,ray,red,red-brown,reddish,rounded,scattered,semicraspedodromous,sessile,short,shrub,sinuate,sparsely,stellae,stellate,stem,stigma,stipe,straight,style,subacute,subcoriaceous,time,tip,toward,triangular,tube,unbranched,vein,white,wide,yellow,yellow-ferruginous,×	0.06,0.08,0.13,0.4,0.4–0.6,0.6,0.6–0.9,0.6–1.0,0.6–2.2,0.9–1.3,1.0–2.1,1.2–1.9,1.4,1.5–3.1,1.9–2.6,1.9–3.2,1/2,1/3,1/3–1/2,2.0,2.3,2.6,2.6–3.7,2.6–4.8,2/3,3.1–4.0,3.2–6.2,4.3,5-merou,5.2,5.2–6.3,5.7,5–9,6.3,6.5–16.0,6.9–9.2,6–8,7.0–1.4,absent,adnate,aequilateral,ag,alyx,anthesi,apart,apical,apparently,appearing,appressed,around,articulate,attenuate,axe,ba,bark,basal,based,bent,berry,blade,borne,branch,broad,bud,capitate,central,congested,deciduous,deeply,dentate,developed,difoliate,directed,distal,eaf,edge,eed,either,emerging,endocarp,erect,exocarp,extending,extra-axillary,fertile,flexed,free,geminate,glossy,gradually,gree,immature,immediately,increasing,incurved,individually,intact,internode,interpetalar,intersepalar,juic,large,layer,lightly,lon,longer,lower,major,many,midpoint,minor,narrowly,nearly,nflorescence,oblique,occasionally,opaque,orolla,pedicel,peduncle,per,perforated,pitted,poorly,pore,porrect-stellate,portion,potentially,present,prickle,primary,red-orang,reflexed,remaining,restricted,ridge,rigid,row,ruit,secondary,several,shorter,shot,side,simple,sinus,slightly,sloughing,somewhat,spaced,splitting,spread,spreading,stamen,stellate-pubescent,stipitate,surface,suture,tamen,tardily,tem,thin,tissue,transparent,truncate,two,ud,unarmed,upper,vary,well,ympodia,young,±90°,±equal,±erect	color,form,growth,height,history,inflorescence,length,life,na,ovary,perennial,plant,reproduction,seed,shape,size,staman,texture,width
392	wfo-0001028587	success	178	99	71	107	28	0.399	0.3-1,0.5-1,0.8-1.8,1-1.3,1-2,1-4,2-5,2.1-6.9,2.5,6.5-17.7,8-10,8-10-flowered,acuminate,acute,anther,anthesi,apex,base,brown,calyx,cm,corolla,dia,filament,flower,fruit,glabrous,globose,green,greenish-white,keeled,lateral,leaf,length,like,lobe,lobed,long,midrib,minutely,mm,nearly,obovate,ovary,ovate,ovoid-reniform,pair,papillose,persistent,petiole,pitted,puberulent,pubescence,pubesent,reflexed,seed,shrub,slightly,stem,stigma,style,subumbellate,surface,tip,trichome,tube,umbonate,uniseriate,vein,white,x	.4,.5,.75,0,0.3,0.5,0.7-1.2,0.8-1.6,0.8-2.9,1-1.5,1.3-5.1,1/4,3-8,6-8,abruptly,accrescent,across,bark,baseflower,becoming,berry,ca,chartaceou,closely,coat,cracking,cup,deflexed,degree,densely,different,difoliate,distal,drying,eaf,edicel,eed,ellipsoid,erect,forming,free,fruiting,geminat,geminate,impressed,lamina,layer,lon,long-styled,lower,main,major,middle,minor,minute,narrowing,nflorescence,obe,obovoid,occasionally,often,older,open,opposite,outer,overlappin,paler,papillo,pedicel,peeling,per,pore,poricidal,portion,pubescent,ruit,scar,scattered,short,simple,slender,slit-like,spaced,sparsely,stiff,straight,straw-colored,tall,terminal,thickened,thin,transversel,triangular,two,type,ud,unicellular,unit,upon,upper,usually,variable,wide,widest,woody,ympodial,young	0.4,1,3.5,6,branching,color,diameter,form,growth,height,history,inflorescence,life,margin,midpoint,midvein,na,perennial,plant,ray,reproduction,shape,size,staman,stellae,stipe,texture,width
393	wfo-0001028594	success	142	110	83	59	27	0.585	.5,1-1.2,1-1.3,1-2,1-3,1.5-9,12,12-14,2,3-4,3-6,3-9,6-20,6-7,abaxially,acuminate,acute,anther,apex,axil,base,black,bottle-shaped,calyx,cm,conical,corolla,densely,diameter,drying,elliptic,especially,filament,flattened-reniform,flower,fruit,glabrous,globose,green,hair-like,herb,immature,inflorescence,leaf,length,lobe,long,margin,maturity,minute,minutely,mm,obtuse,open,orange-brown,ovary,ovate,pair,per,petiole,planar,projection,pubescent,purple,rectangular,reddish,reflexed,regular,slightly,smooth,somewhat,sparsely,spreading,stigma,strait,style,surface,time,tip,tube,vein,violet,x	0-100,0.3-1.0,0.8-1.8,1-1.5,5-6,adaxially,along,anthesi,axillary,bearing,becoming,berry,capitat,cell,climbing,denser,eaf,edicel,eed,ellipsoid,epidermal,exserted,floo,forest,free,fruiting,glabrat,inflorescenc,lax,like,lon,lower,nflorescence,noddin,often,papillate,pedicel,pendent,portion,primary,quit,rest,rounded,ruit,scar,scattered,side,simple,soft,strongly,tem,trailing,trichome,tub,ud,unifoliat,uniseriate,unit,ympodial	branching,capitate,color,form,growth,height,history,lateral,life,midpoint,midrib,midvein,na,perennial,plant,pubescence,ray,reproduction,seed,shape,size,staman,stellae,stem,stipe,texture,width
394	wfo-0001028660	success	204	121	95	109	26	0.466	0.5-2.8,0.8-1,1-2,1.5-2.8,1.5-4,1.5-7.6,2-9,3-30,3-7,3-9,3.8-13,4-6,5-8,7-10,abaxially,acute,adaxially,along,anther,apex,apparently,attenuate,base,blue,broadly,brownish,cell,chartaceous,ciliate,cm,condition,corolla,covering,decurrent,densely,diameter,drying,entirely,especially,filament,flower,forked,fresh,fruit,glabrous,globose,green,greenish,hair,hair-like,herb,lateral,like,lobe,long,make,margin,membranous,midrib,minutely,mm,mucilaginous,oblique,obtuse,odd-pinnate,ovoid,pentagonal,perfect,petiole,plant,puberulent,pubescent,purple,ripe,rotate,scabrous,seed,short,size,sparsely,stem,stigma,style,substellate,testal,thick,tinged,tip,tube,wall,wet,white,whitish,x,yellow	0-5,0.1-0.3,0.2-1.1,0.3-1.1,0.5-5.5,0.7-4.2,0.9-2.5,1-10,2-11,2-5,2-6,20,3-5,5-merou,6,absent,acumen,ag,alyx,apart,articulated,axe,axillary,berry,blade,borne,bud,capitat,clavate,connivent,decumbent,digestion,distal,dorsally,dot,eaf,edge,eed,elliptic,end,enzyme,erec,exceeding,except,flat,folded,geminat,generally,glabrou,greatly,green-white,half,homostylous,honeycomb-shaped,interjected,lanceolate,leaflet,lengthening,less,linear,living,lower,middl,narrowly,nflorescence,often,orbicular,orolla,ovate,pair,pedicel,peduncle,petiolulate,petiolule,plurifoliate,pore,poricidal,proximal,rarely,reduced,removed,ruit,scattered,sessile,seudostipule,singly,slit,spaced,specimen,stamen,ste,stolo,straight,subequal,subtending,sunny,tall,tamen,tem,terminal,throughout,tri-,tuber,typically,unit,unwinged,usually,vary,ympodial	branching,calyx,color,form,growth,height,history,inflorescence,leaf,length,life,midpoint,midvein,na,ovary,perennial,pubescence,ray,reproduction,shape,staman,stellae,stipe,surface,texture,vein
395	wfo-0001028666	success	159	102	73	86	29	0.459	0.2-0.3,0.25-0.4,0.3-0.45,0.3-0.6,0.4-0.8,0.8-2,1-1.5,1-2,2.2-2.3,2.5-7,3-4.5,3-6,4-5,4-5.5,7-8,abaxially,acute,adaxially,anther,apex,base,brown,calyx,chartaceous,cm,cordate,densely,diameter,ellipsoidal,entire,erect,flower,fruit,glabrous,gland-tipped,grey-green,hair,inflorescence,lanceolate,lateral,lavender,length,lobe,long,margin,midpoint,mm,moderately,obtuse,ovate,pale,perennial,petiole,pubescent,purple,ray,red,rhizomatous,scattered,short,shrub,stellae,stellate,stellate-pubescent,stigma,style,time,tube,unbranched,white,x,yellow,yellowish	%,0-0.1,0-2,0.05-0.1,0.1-0.15,0.2-0.25,0.7-0.8,1,1-locular,11-19,2.5-5,2.6-4.2,3-4,4-5-merou,5-11,7-11,7-9,absen,absent,accrescent,across,adaxiall,alyx,apart,apparen,articulated,axe,ba,blade,capitat,connivent,cylindrical,directed,distall,distributed,eaf,eed,eglandular,elliptic,exceeding,exocarp,extra-axillary,finger,fruiting,incomplete,juicy,lamina,lower,mature,mesocarp,minute,nflorescence,oblique,orolla,part,pedicel,peduncle,per,perfect,placenta,pore,porrect,prickle,pseudo-umbellate,ruit,septum,sessile,simple,solitary,somewhat,spaced,stalk,succulent,tal,tamen,tem,thick,throughout,transparent,unarme,unarmed,unit,unknow,vary,wide,ympodial	branching,color,corolla,filament,form,growth,height,history,leaf,life,midrib,midvein,na,ovary,plant,pubescence,reproduction,seed,shape,size,staman,stem,stipe,surface,texture,tip,unknown,vein,width
396	wfo-0001028667	success	129	86	56	73	30	0.434	-2.6,0.4-0.7,1-1.5,1-4.5,1-6,1.3-2,3,3-11,5-20,8-10,acute,apex,base,branched,calyx,cm,completely,coriaceous,corolla,diameter,dry,elliptic,entire,flattened,flower,glabrous,growth,inflorescence,leaf,lobe,margin,midrib,minutely,mm,narrowly,pale,petiole,pitted,reniform,revolute,shiny,simple,stem,straw-colored,strongly,surface,tip,tube,twice,vein,vine,white,woody,wrinkling,x,yellow	.5,0.7-4,1-2-1.5,5,5-merou,aid,alyx,anthesi,apar,appearing,ark,around,articulated,axillary,berry,branch,cell,climbin,climbing,clustered,conical,creamy,curling,deciduous,discolorous,eaf,eed,ellipsoid,exfoliatin,exfoliating,exserted,fide,fragrant,fruiting,irregularly,like,long,lower,mentz,new,nflorescence,occasionally,older,orolla,other,outer,papilla,papillat,pedicel,peduncle,pendan,per,perfect,plurifoliat,primary,scar,shoot,short,sleeve,slender,slightly,small,soon,spaced,support,tem,terminal,triangular,twining,ud,unit,visible,ympodial	anther,branching,color,filament,form,fruit,height,history,lateral,length,life,midpoint,midvein,na,ovary,papillate,plant,pubescence,ray,reproduction,seed,shape,size,staman,stellae,stigma,stipe,style,texture,width
397	wfo-0001028672	success	207	108	83	124	25	0.401	.5,0.3-1,0.5-0.7,0.5-1,0.7-3,1-3,1.3-8,1.5-3,1.8-2.2,1.8-2.5,1/4,2.4-2.8,2.5-12,2.5-3.5,4-6,5-10,5-8,abaxially,acute,almost,andromonoecious,anther,apex,apically,base,berry,branched,broad-deltate,calyx,chartaceous,cm,cream,dark,diameter,erect,filament,flattened-reniform,flower,fruit,glabrescent,green,lateral,leaf,length,lobe,lobed,long,lower,margin,marking,maturity,mauve,midpoint,midvein,mm,moderately,obtuse,orange-brown,ovate,pale,petiole,plant,ray,rotate,rounded,shrub,smooth,sometimes,sparsely,spherical,spreading,stellate-pubescent,stem,style,surface,tip,truncate,tube,upper,vein,wide,yellow,young	-6,-merous,/4,0,0-13,0-15,0-150,0-5,0.2,0.2-0.4,0.2-0.7,0.5-1.2,0.5-5,0.8-1,1,1-2,1.5-2.2,1/,1/4-1/3,2-10,2-20,2-3,2-30,3-5,3-8,4-8,5,6-12,9-15,acut,adaxially,alyx,ame,apar,apart,apparently,articulated,bark,black,blade,broad,brow,c.,concolorous,connivent,deltate,difoliate,discolorous,distal,distance,drying,eaf,eed,elongated,elongating,equal,extending,flattened,free,fruiting,geminat,glabrous,gray,hair,hermaphrodite,heterostylous,infructescence,long-styled,longer,lowermost,mature,minute,nflorescence,older,one,open,orolla,oung,pair,pedicel,peduncle,pendulous,per,pericarp,poricidal,porrect,portion,prickl,prickle,prickly,primary,reflexed,ruit,scar,sessile,short-styled,side,simple,spaced,stalk,stalked,staminat,straight,tamen,tapering,terete,terminal,tertiary,time,translucent,trichome,unarmed,unit,usually,variously,vary,venation,visible,way,weakly,woody,yellow-green,yellow-orange,ympodial	1/2,branching,color,corolla,form,growth,height,history,inflorescence,life,midrib,na,ovary,perennial,pubescence,reproduction,seed,shape,size,staman,stellae,stigma,stipe,texture,width
398	wfo-0001028674	success	196	118	96	100	22	0.49	1-1.5,1-2,1-3,1.5-3,1/4,10-15,10-30,2-2.5,2-3,2-5.5,2.5-3,3-10,3-11,3-3.5,3-4-lobed,4-4.2,5-7,8-10,abaxially,acuminate,acute,angulate,anther,apex,apiculate,attenuate,basal,base,branching,brown,c.,calyx,chartaceous,cm,conical,coriaceous,corolla,densely,diameter,elliptic,entire,filament,flattened,flower,fruit,glabrescent,glandular,glandular-puberulent,glandular-pubescent,globose,green,greenish,growth,heterostylous,hirsute,lateral,leaf,lenticular,linear-lanceolate,lobe,lobed,margin,maturing,midpoint,mm,ochraceous,ovary,perfect,petiole,plant,prickly,ray,reddish,reniform,reticulate,rounded,shrub,sparsely,stellate,stem,stigma,style,surface,time,tip,tomentose,trichome,tube,unicellular,variegated,way,white,woody,x,yellow,young	-1,0.1,0.2-0.25,0.2-0.3,0.5-0.7,0.5-0.8,0.7-1,0.7-1.0,1/3,4-5,5-6,adaxial,adaxially,armed,articulate,bark,berry,blade,branched,brow,caly,campanulate,confined,cream,curved,dark,directed,distal,distally,eaf,eed,eglandular,erec,erect,especially,exserted,face,fewer,free,fruiting,glabrous,juvenile,larger,laterally,leaf-opposed,leave,lengthening,like,long-styled,lower,minute,much,mucilaginous,new,nflorescence,older,one,partially,pedicel,peduncle,pericarp,plurifoliat,pore,poricidal,porrect,portion,prickle,pubescent,raise,recurved,reduced,ruit,rusty,scar,scattered,sessile,shallowly,short-styled,similar,simple,slightly,staminate,stellate-pubescent,stellate-tomentose,straight,subcapitate,subglobose,subsessile,tapering,terete,testa,thick,triangular-lanceolate,ud,unarmed,unit,upper,whitish,yellowish,ympodial	color,form,height,history,inflorescence,length,life,midrib,midvein,na,perennial,pubescence,reproduction,seed,shape,size,staman,stellae,stipe,texture,vein,width
399	wfo-0001028680	success	236	131	109	127	22	0.462	.0,.3,.5,.8,0.2–0.3,0.3–2.1,0.4,0.5–0.8,0.5–2.3,0.9–1.0,1,1.1,1.1–6.5,1.4–1.8,1.7–2.1,1.9–2.4,1/2,1–2,2.2–2.5,2–3,3.8–4.6,6–8,abaxially,adaxially,aequilateral,anther,apex,apiculate,attachment,attenuate,base,brochidodromous,brown,calyx,cm,coriaceous,corolla,deltoid,diameter,distinct,dry,elliptic,entire,filament,flattened-orbicular,flattened-reniform,flower,fruit,glabrous,glandular,globose,growth,hair,lanceolate,lateral,lobe,long,lower,margin,mature,midpoint,midrib,midvein,mm,nearly,notched,obtuse,ovate,petiole,pitted,point,pubescent,raised,ray,reddish,revolute,rounded,scattered,shortly,shrub,simple,sinuate,slightly,sometimes,sparsely,stellae,stellate,stem,stigma,style,sub-cordate,surface,time,tip,toward,tube,typically,unbranched,vein,weakly,white,wide,yellow,yellow-tan,±90°,±glabrous,×,–1.75,–3	.2,0.9,0.9–1.2,1.2,1.2–2.2,1.6–2.5,1.7–2.2,1/3,1/4–1/3,2.1–3.0,2.2–3.0,3.2–3.5,4.3–5.9,4–5,4–5-merou,5.2–7.2,?,acuminate,adnate,ag,alyx,anthesi,apical,apparently,appearing,appresse,around,articulate,ba,bark,based,berry,blade,borne,broad,capitat,channeled,connivent,dentate,developed,development,directed,distal,distally,eaf,edge,eed,either,emerging,endocarp,exocarp,extending,extra-axillary,fast,fertile,filiform,flexed,free,glossy,gradually,homostylous,hort,increasing,individually,intact,internode,interpetalar,intersepalar,isolated,juic,layer,limp,lon,longer,many,markedly,middle,minute,nflorescence,occasionally,opaque,orolla,pedicel,per,perforated,plurifoliate,poorly,pore,porrect,portion,potentially,presen,prickle,rachi,remaining,retrorse,ruit,see,sessile,shoot,short,shorter,side,sinus,sloughing,splitting,spread,stamen,straight,suture,tamen,tem,terminal,thin,tissue,transparent,truncate,ud,unarmed,vary,yellow-ferruginou,ympodia,young,±absent,±equal,±straight,–6	branching,color,form,height,history,inflorescence,leaf,length,life,na,ovary,perennial,plant,pubescence,reproduction,seed,shape,size,staman,texture,width,yellow-ferruginous
400	wfo-0001028688	success	137	82	50	87	32	0.365	.5,0.4-1,0.5-1,1-1.5,1-5,1.1-1.2,1.4-2.8,2-3,5-11,5-6,acuminate,acute,anther,apex,base,beneath,calyx,cm,corolla,deltoid,filament,glabrous,lanceolate,leaf,lobe,lobed,minutely,mm,near,nearly,opposite,ovary,overtopping,papillose,petiole,pilose,pubescent,reddish-brown,shoot,shrub,size,sparsely,stem,stigma,style,tip,tube,vein,white,x	0.5,0.5-0.75,0.5-1.5,0.9-1,1-1.8,1-3,2.2-4.8,across,along,anthesi,apar,area,bark,bi-cellular,branch,clavate,curl-tipped,deciduous,decreasing,deflexed,densely,densest,dia,differing,difoliate,eaf,edicel,eed,elliptic,exfoliatin,exserted,free,furcate,geminat,globose,golden,interpetalar,irregularly,know,known,like,lon,long,lower,major,markedly,membraneous,middle,minor,nflorescence,occasionally,often,older,paler,pedicel,planar,pore,poricidal,portion,proximal,ruit,scar,shaped,shiny,sinus,slender,slightly,soon,spaced,straight,styl,tall,tapering,tear-drop,terminal,thickened,thin,trichome,tub,ud,uniseriate,unit,usually,wide,widest,ympodial,young	branching,color,diameter,flower,form,fruit,furate,growth,height,history,inflorescence,lateral,length,life,margin,midpoint,midrib,midvein,na,perennial,plant,pubescence,ray,reproduction,seed,shape,staman,stellae,stipe,surface,texture,width
401	wfo-0001028690	success	191	98	71	120	27	0.372	0-0.2,0.15-0.25,0.3-0.5,0.3-2.5,0.8-2,1-5,1.3-6.5,1.5-1.7,2-7,2.3-2.8,3-4.5,4-10,4.5-16.5,8-9,abaxially,acute,adaxially,andromonoecious,anther,apex,attenuate,base,calyx,chartaceous,cm,cuneate,densely,diameter,entire,erect,flower,fruit,glabrous,globose,green,inflorescence,lanceolate,lateral,leaf,length,lobe,lobed,long,margin,mm,moderately,obtuse,ovate,pale,perennial,petiole,plant,pseudo-racemose,pseudo-umbellate,purple,ray,rhizomatous,shallowly,shrub,sparsely,stellae,stellate-pubescent,stigma,style,surface,tube,unbranched,weakly,white,x,yellow	%,.3,0-0.1,0-0.5,0-5,0-7,0.05-0.1,0.1-0.2,0.2-0.6,0.25-0.4,0.3-0.7,0.4-0.6,0.5-0.8,0.5-1,0.5-6,0.8-1,1-2,1-7,2-3,2-locular,2.1-4.5,30-50,4-5.5.5,4-7,4-9,5-6,5-merou,5.5-6,6-8,7-10,7-30,7-8,9-13,9.5-14,absen,absent,accrescent,across,adaxiall,adult,alyx,apart,articulated,ascending,axe,ba,blade,branch,branche,broad-based,capitat,connivent,cross-section,cylindrical,directed,distall,distributed,dm,eaf,eed,eglandular,exocarp,extra-axillary,finger,fruiting,functional,geminat,gland-tipped,grey-green,hair,half,heterostylous,juicy,juvenile,lamina,less,linea,longer,lower,mature,mesocarp,mid-point,midpoint,minute,moist,nflorescence,oblique,orolla,pair,part,pedicel,peduncle,per,placenta,pore,porrect,present,prickle,ruit,sessile,short,simple,somewhat,spaced,stalk,stellate,straight,tal,tamen,tem,thick,throughout,time,unarme,unarmed,unit,upper,vary,wide,ympodial	4-5.5,branching,color,corolla,filament,form,growth,height,history,life,linear,midrib,midvein,na,ovary,pubescence,reproduction,seed,shape,size,staman,stem,stipe,texture,tip,vein,width
402	wfo-0001028696	success	224	121	81	143	40	0.362	.5,2.4,abaxially,acuminate,adaxially,along,anther,apex,asymmetric,base,blue,branched,broadly,calyx,cm,coarsely,color,cordate,densely,diameter,entire,filament,finely,flower,fruit,glabrous,gland-tipped,glandular,globose,hair,hirsute,known,lateral,lavender,length,lenticular,linear-caudate,linear-lanceolate,lobe,lobed,long,margin,mature,midvein,mm,obtuse,ovate,ovoid,per,petiole,pilose,pitted,plump,principal,pubescence,pubescent,ray,reniform,repand,rotate-pentagonal,shiny,shrub,side,simple,sinuate,stellae,stellate,stellate-pilose,stellate-pubescent,stem,stigma,style,surface,tan,truncate,tube,vein,well,woolly,yellow,×	0.8–,1.5–4,12–20,15–17,15–30,1–2,1–4,1–6,2.5,2.8–3.5,2–2.3,2–5,2–7,3.5–5.5,3–5,3–6.5,4–5,4–7,5,5-merou,5–15,6–13,6–8,7–8,7–9,8–13,8–20,9–10,9–12,accrescent,acicular,adaxiall,alyx,ample,anthesi,apart,apparently,armed,articulated,ascending,attenuate,axe,ba,bifi,blade,borne,branch,bristle,bristle-like,bristly,chartaceous,connivent,deltoid,density,developed,difoliate,directed,distally,diverse,drie,eaf,eed,elongate,erect,fruiting,geminat,glabrou,gland,homostylous,intergrading,intermixed,internode,interpetalar,lamina,larger,like,lon,long-stipitate,longitudinally,lower,middle,midpoint,midzone,moderately,narrowly,near,nflorescence,numerous,oblong,occasionally,often,one,orange,orolla,overtopped,pedicel,peduncle,perfect,pericarp,pore,prickle,prickly,prominent,reflexed,resembling,ruit,scattered,sessile,several-celled,short,short-,shorter,slender,slightly,small,smaller,sometimes,somewhat,soon,spaced,sparser,splitting,spreading,stalked,stellate-hirsute,subterminal,tall,tamen,tem,tippe,tipped,tissue,toothed,trichome,ud,ultimate,vary,varying,weakly,wide,widely,ympodia,young	0.8-2.5,1.5-4,15-30,2-2.3,2.8-3.5,3-5,3.5-5.5,4-5,4-7,5-15,6-13,6-8,7-8,8-13,8-20,9-10,9-12,branching,corolla,form,growth,height,history,inflorescence,leaf,life,midrib,na,ovary,perennial,plant,reproduction,seed,shape,size,staman,stipe,texture,tip,width
403	wfo-0001028698	success	166	92	70	96	22	0.422	0.3-0.75,1-2,1.9-4,2-10,2-3,3-17,3-5,5-6,5-8,6-27,8-10,9-35,abaxially,acute,adaxially,branched,calyx,cell,cm,conical,corolla,covering,cyme,dark,diameter,dichasial,dichasially,dot,ebracteate,ellipsoid,flower,forked,green,green-white,hair-like,herbaceous,lateral,leaf,light,lobe,long,long-attenuate,medium,mm,monochasial,odd-pinnate,often,ovoid,pentagonal,perennial,petiole,plant,puberulent,pubescent,raised,rotate,seed,size,smooth,stigma,strigose,style,testal,thick,throughout,violet,wall,white,wide,yellow	0-1.,1-4,1-9.8,1.8-5,13-25,2-4,3-6-foliat,3.5,4-14,5-15,6,6-13,abaxiall,acumen,acuminate,apex,apical,apically,articulate,base,broadly,commonly,connate,cuneate,darker,decurrent,dehiscent,digestion,diminishing,distal,dorsally,eaf,edge,eed,elliptical,emoval,enzyme,equal,exceeding,filament,first,flat,folded,generally,globo,gradually,half,honeycomb,interjected,introrse,leaflet,living,lon,lower,lunat,make,maturing,minute,mucilaginous,nflorescence,nther,oblique,orolla,ovate,pair,pattern,pedicel,peduncle,perfect,petiolule,plan,poricidally,proximal,rachi,rarely,reveal,ruit,sessile,seudostipule,short,slit,specimen,stamen,straight,tal,tem,terminal,toward,tuber-bearing,two,typically,unit,usually,vary,ympodial,¼	anther,branching,color,form,fruit,growth,height,history,inflorescence,length,life,na,ovary,pubescence,reproduction,shape,stem,surface,texture,tip,tube,width
404	wfo-0001028716	success	145	82	48	97	34	0.331	0.5,0.6-1.9,0.75,1-2,11-16.4,2.5-8,3.6-8.8,7-8,9-10,acuminate,anther,apex,base,calyx,cm,corolla,cuneate,filament,fruit,glabrous,glandular,hirsute,lateral,leaf,less,lobe,lobed,minutely,mm,ovary,ovate,pair,papillose,petiole,reflexed,shape,shrub,simple,size,stem,style,tip,trichome,tube,uniseriate,vein,white,x	.2,.5,1.9-5.5,10-40-flowered,2-4,2.2-7.9,5-6,8-9,across,anisophyllou,anthesi,apart,appearing,asymmetric,ba,bark,becoming,beginning,beneath,bi-cellular,branched,brown,dark,decurrent,deflexed,dia,differing,difoliate,eaf,edicel,eed,ellipsoid,elliptic,evenly,except,fertilization,fifth,filiform,free,geminate,inflorescenc,intermediate,know,known,lengthening,lenticellat,like,lon,long,long-triangular,lower,main,major,markedly,middle,minor,much,nearly,nflorescence,node,often,older,one,opposite,orbicular,pedicel,pointed,pore,poricidal,portion,prominent,proximal,puberulent,pubescent,raised,remaining,rounded,ruit,scar,shaped,slightly,spaced,sparsely,stigm,straight,strongly,tall,tear-drop,triangular,truncate,two,ud,unit,widening,widest,ympodial,young	1,1.5,10-40,2,3,branching,color,diameter,flower,form,growth,height,history,inflorescence,length,life,margin,midpoint,midrib,midvein,na,perennial,plant,pubescence,ray,reproduction,seed,staman,stellae,stigma,stipe,surface,texture,width
405	wfo-0001028723	success	211	119	102	109	17	0.483	-1.5,.5,0.2,0.8-1,0.8-2,1-1.5,1-1.8,1-2.2,1-2.5,1/5-1/3,10-15,10-16,2-2.5,2-2.7,2-4,3.5-4,4-5,5,5-6,5-7,abaxial,abaxially,adaxially,almost,anther,anthesi,bark,base,branch,branched,branching,broadly,brown,calyx,capitate,clustered,cm,conical,corolla,curved,dark,deltoid,dendritic,diameter,drying,elliptic,entire,faint,filament,fine,flat,flower,glabrous,green,leaf,length,liana,lobe,lobed,long-attenuate,main,margin,membranous,midvein,minutely,mm,obconical,oblong,obovate,occasional,orange-brown,pair,pale,pedicel,peduncle,petiole,primary,pubescent,raised,ray,shrub,slender,smooth,sparsely,stem,stigma,style,surface,terminal,tertiary,trichome,tube,unarmed,unevenly,vein,venation,white,widely,wrinkled,x,yellow,young	.3,0-0.5,0°,1,1/3-1/2,2.5,3-4,4,acute,age,alternate,alyx,another,apar,apex,apically,apice,apparently,articulated,becoming,brachyblast,clearly,common,concolorous,decurrent,delineated,densely,density,developed,dilated,divided,domatia,dorsifixed,eaf,eed,ellipsoi,equal,except,ey,flexuous,formed,free,frequent,gradual,increasing,inner,junction,know,known,lengthening,less,like,long,longitudinally,lower,m.,middle,mostly,much,multiply,naked,narrowly,nflorescence,nther,obtuse,one,orolla,outer,ovate,overlapping,papillo,perfec,plurifoliat,poorly,pore,poricidal,portion,prominent,protruding,rachi,region,regular,ridged,ruit,scar,separated,short,side,simple,sinus,small,smaller,spreading,stump,surrounding,tearing,tip,tissu,toward,transition,tuft,ud,uneven,unit,vary,visible,wide,ympodial,youngest	adaxial,arrangement,color,form,fruit,growth,inflorescence,na,number,ovary,papillose,pubescence,seed,shape,size,texture,width
406	wfo-0001028725	success	197	113	89	108	24	0.452	-10,0.1-0.2,0.6-1,1.5-1.7,1.5-2,1.5-4,10-12,2.5-3,2.5-8,3-4,3-6,4-12,5-10,7-8,anther,bark,base,berry,brown,bud,calyx,chartaceous,clavate-truncate,cm,cordate,corolla,densely,depressed,diameter,elliptic-ovate,entire,filament,finely,flattened,flower,glabrescent,glabrous,glandular-tomentose,glandular-villose,globose,green,greyish,growth,inflorescence,lanceolate-subulate,leaf,linear-lanceolate,lobe,margin,minute,minutely,mm,moderately,oblique,ovary,ovate,pedicel,peduncle,petiole,pubescence,pubescent,ray,recurved,reniform,repand-angular,reticulate,rounded,rusty,rusty-brown,rusty-tomentose,shrub,simple,size,stellate,stem,stigma,style,surface,terete,trichome,tube,unarmed,undulate,vein,velutinous,violet,viscid,x,yellowish	.1,0.2-0.5,0.3-0.4,1-1.5,1-2,1.2-1.5,1/4,2,3-plurifoliat,4-5,4-6-celled,4-locular,7,abaxially,acicular,acute,adaxially,anthesi,apex,armed,articulated,basal,clearly,closely,connate,curved,denser,discolorous,distal,eaf,eed,eglandular,elongate,enlarged,exserted,free,fruiting,gland-tipped,glandular,glandular-pubescent,greatly,heterostylous,inconspicuous,internodal,leathery,lengthening,like,lobed,long,long-styled,longer,lower,midpoint,midrib,mixed,multicellular,nearly,new,nflorescence,obverse,older,papillo,perfect,pericarp,persistently,pore,poricidal,porrect,portion,prickle,prickly,reduced,reflexe,reflexed,rest,ruit,scar,sessile,short-styled,short-talked,similar,slender,slightly,slit,small,somewhat,space,sparsely,stalked,staminate,stellate-tomentose,straight,strongly,tall,tapering,terminal,testa,tip,tomentose,turbinate,ud,unevenly,unit,upper,varying,whit,yellow,ympodial	abaxial,adaxial,arrangement,branch,branching,color,drying,form,fruit,length,main,midvein,na,number,papillose,primary,seed,shape,tertiary,texture,venation,white,width,young
407	wfo-0001028736	success	180	131	102	78	29	0.567	0.5,0.5-1,0.5-1.5,0.5-1mm,1,1-1.5,1-2,1-3,1.5,10-15,2-5,2-7,3-5,3-6,3.5-5,4-12,4-6,5-10,5-15,6-13x3-8,6-8,abaxially,absent,acute,adaxially,anther,attenuate,base,brown,calyx,chartaceous,cm,connivent,contiguous,created,cylindrical,dark,densely,diameter,filament,filiform,flower,fruit,glabrous,globose,green,hair,immature,leaf,length,light,like,lobe,lobed,many,mature,midvein,mm,moderately,mottled,narrowly,nearly,netlike,occasional,orange,pedicel,peduncle,per,petiole,pit,porrect-stellate,prickle,pubescent,raised,ray,red,reniform,rhombic,ridge,shrub,side,simple,small,spaced,sparsely,stalk,stellate,stem,stigma,style,surface,tapering,triangular,tube,unarmed,unbranched,unlobed,vein,white,x,yellow,yellow-white	0.2-0.4,0.5-2,1.5-3,1/6,2-4,3-8,4-9,40-70,5-merou,accrescent,adaxiall,alyx,apar,apex,apical,apparently,armed,axe,berry,beyond,blade,cordate,cut,decurrent,difoliate,directed,discolorous,eaf,eed,either,exserted,extra-axillary,flattened,frui,fruiting,geminate,glabrou,glandular,gree,introsel,less,long,lower,m.,major,midpoint,midrib,multicellular,multiseriate,nflorescence,obtuse,occasionally,onto,orolla,pair,perfect,pore,purple,rachi,recurved,roselike,ruit,scanden,sinus,slightly,stamen,ste,tamen,tem,thin-skinned,unequa,unicellular,uniseriate,unit,vary,way,wide,ympodial	abaxial,adaxial,apart,arrangement,bark,branch,branching,color,corolla,drying,form,growth,inflorescence,main,margin,na,number,ovary,primary,pubescence,seed,shape,size,tertiary,texture,trichome,venation,width,young
408	wfo-0001028737	success	151	96	60	91	36	0.397	1,1-2.5,1-4,1-6,1.5-3.5,12-14,16-30,2-3,2-5,2.8-3.5,4-10,4-9,6,7-15,apiculate,base,branched,calyx,caudate,cm,corolla,cyme,dehiscent,diameter,dichasial,dichasially,ebracteate,elliptic-lanceolate,filament,flower,forked,glabrescent,glandular,globose,green,green-white,herbaceous,lanceolate,leaf,lobe,long,mm,monochasial,mucilaginous,oblique,oblong,odd-pinnate,ovoid,pedicel,peduncle,petiole,poricidally,seed,size,stellate,stigma,style,throughout,wide,yellow	0.2-0.5,0.7-2,10,3-4,3-5,3-6-foliat,4-6.5,5-6,abaxially,absen,acumen,acuminate,acute,adaxially,apex,apical,apically,articulate,attenuate,cell,connate,covering,decurrent,digestion,diminishing,distal,dorsally,eaf,edge,eed,emoval,enzyme,exceeding,flat,folded,generally,globo,gradually,hair-like,half,honeycomb,interjected,introrse,larger,lateral,leaflet,living,lon,lower,make,maturing,nflorescence,nther,often,orolla,pair,pattern,perennial,perfect,pinnatifi,plan,plant,proximal,rachi,reveal,ruit,second,sessile,seudostipule,short,slit,specimen,stamen,straight,strongly,tal,tem,terminal,testal,thick,throughou,toward,tuber-bearing,typically,unit,vary,wall,whit,without,ympodial,¼	abaxial,adaxial,anther,arrangement,bark,branch,branching,color,drying,form,fruit,growth,inflorescence,length,main,margin,midvein,na,number,ovary,primary,pubescence,ray,shape,stem,surface,tertiary,texture,trichome,tube,unarmed,vein,venation,white,width,young
409	wfo-0001028773	success	169	96	65	104	31	0.385	0-0.2,0.5-0.58,0.9-2.8,1-2,1-3,1-4.3,2-6,2.2-2.8,3-4.5,4-6.5,4-7,5-6.5,7-9,adaxially,anther,base,broadly,brown,calyx,chartaceous,cm,cordate,densely,diameter,elliptic,entire,extra-axillary,flower,fruit,glabrous,gland-tipped,globose,green,grey,hair,inflorescence,leaf,length,lilac,lobe,margin,mm,obtuse,ovate,pale,pedicel,peduncle,perennial,petiole,ray,red,rotate,rotate-stellate,rusty,short,shrub,simple,stellate-pubescent,style,surface,tube,unarmed,unbranched,x,yellow	%,.7,0-1,0.1-0.2,0.15-0.25,0.15-0.3,0.15-0.35,0.3-0.4,0.3-0.5,0.3-0.6,0.4-0.5,0.8-0.9,1-locular,1.4-2,10-16,2,2-5,2-foliate,3-5,3.3-3.8,30-55,4.5-5.5,5-merou,6-11,7-8,abaxially,absen,absent,accrescent,across,adaxiall,adult,alyx,apart,apex,apparen,articulated,axe,ba,blade,directed,distall,distributed,eaf,eed,eglandular,erect,exceeding,exocarp,finger,fruiting,geminate,glandular,greenish-white,homostylous,incomplete,juicy,juvenile,lamina,lateral,lobed,long,lower,mature,mesocarp,midpoint,minute,nflorescence,oblique,onl,orolla,pair,part,per,perfect,placenta,pore,porrect,prickle,probably,pseudo-racemose,rhizomatous,ruit,septum,sessile,shallowly,solitary,spaced,stellae,succulent,tal,tamen,tem,thick,throughout,time,unarme,unit,upper,vary,white,wide,without,ympodial	abaxial,adaxial,arrangement,bark,branch,branching,color,corolla,drying,filament,form,growth,main,midvein,na,number,ovary,primary,pubescence,seed,shape,size,stem,stigma,tertiary,texture,trichome,vein,venation,width,young
410	wfo-0001028774	success	141	88	44	97	44	0.312	0.4-0.7,1.4-1.8,1/2-2/3,10-20,2.5-3.5,2.5-4.0,2.7-3.3,3-8,5-9,9-12,anther,arcuate,base,blade,bright,broadly,calyx,chocolate-brown,cm,elongate,foveolate,glabrous,herb,lenticular,linear-lanceolate,lobe,long,margin,midvein,minutely,mm,ovate,pentagonal-stellate,perennial,petiole,spherical,stellate,stellate-pubescent,stem,surface,tube,unarmed,velvety-farinaceous,yellow	0.5-0.8,12-20-rayed,3-5,3-7,30-60,4-8,6-10-flowere,8-12,accrescent,acro,almost,along,alyx,annually,anthesi,appearance,armed,beneath,berry,broad,campanulate,closely,deeply,density,developing,dia,difoliate,distinctive,divided,dm,dry,eaf,eed,emerging,erect,extended,externally,fine,fully,geminat,giving,grayish-green,hair,herbage,hetermorphic,internodal,invested,irregular,least,lengt,lon,lowermost,maturity,merely,nflorescence,numerous,often,orolla,otherwise,per,pinnatifid,prickle,prickly,rounded,ruit,scattered,separated,short,short-stipitate,slende,smooth,somewhat,spaced,splitting,spreading,stellate-woolly,stout,straight,strait-yellow,surrounding,tall,tamen,thick,tightly,tigma,tub,tyle,undulate,unexpande,unit,vary,varying,vestiture,weakly,woody,ympodial,zygomorphic	12-20,6-10,abaxial,adaxial,arrangement,bark,branch,branching,color,corolla,diameter,drying,filament,flower,form,fruit,growth,inflorescence,leaf,length,main,na,number,ovary,pedicel,peduncle,primary,pubescence,ray,seed,shape,size,slender,stellate-hairy,stigma,style,tertiary,texture,trichome,unexpanded,vein,venation,width,young
411	wfo-0001028777	success	205	140	118	87	22	0.576	-10,-2.5,-4,.5,.9,0-2,0.1-0.2,0.1-0.3,0.4-0.8,0.5-1.3,0.6-1,0.7-1.2,0.8-2.2,1-2.5,1-3,1.5-3,1.8-2.5,1/4-1/2,2-,2.5,2.5-3,2.5-5,3/4-4/5,4.5-8,8-15,acute,anther,apex,apically,attenuate,bark,base,berry,blade,branched,calyx,chartaceous,cm,concolorous,connivent,dark,deltate,diameter,discolorous,drying,entire,erect,filament,flattened-reniform,flower,fruit,glabrescent,glabrous,green,green-brown,inflorescence,leaf,length,lobe,lobed,long,margin,marking,maturity,mauve,minute,mm,moderately,multangulate,obovate,orange,orange-brown,ovate,pair,pale,pedicel,peduncle,petiole,poricidal,primary,ray,red-brown,reflexed,sessile,shoot,short,shrub,simple,small,smooth,sometimes,sparsely,spherical,stalked,stellate,stellate-pubescent,stem,stout,style,surface,tapering,terminal,tertiary,tip,tree,trichome,truncate,tube,unarmed,variously,vein,venation,way,white,whole,wide,yellow-green,young	-12,-3,.8,0-30,0.2,0.7-1.3,0.8-1,1,1-2,1.5,1.5-4,1/4,3,3.5-5,4-5-merous,6-10,7-11,8,abaxially,acuminat,alyx,ame,apar,ape,articulated,briefly,c.,curved,deciduou,eaf,eed,elongating,equal,faint,free,fruiting,glabrescen,infructescence,lengt,less,long-styled,longer,lower,mature,midpoint,narrow-deltate,nflorescence,occasionally,older,one,open,orolla,oung,per,perfect,pericarp,plurifoliat,porrect,portion,present,recurved,reflexe,retuse,rounded,ruit,scar,short-styled,shorte,shorter,somewhat,soon,spaced,spreading,stalk,staminate,strongly,tamen,terete,time,unarme,unit,usually,vary,visible,wider,woody,ympodial	abaxial,acuminate,adaxial,arrangement,branch,branching,color,corolla,form,growth,main,midvein,na,number,ovary,pubescence,seed,shape,size,stigma,texture,width
412	wfo-0001028788	success	189	98	66	123	32	0.349	0.15-0.4,0.4-1.3,0.6-1.2,1-10,1.1-2.3,1.4-1.6,2-3,2-5,2.5-3.5,2.5-4.5,2.5-8.5,3-10,4.5-6.5,8-10,8-11,anther,attenuate,base,black,brown,calyx,chartaceous,cm,cordate,dark,densely,diameter,entire,flower,fruit,globose,green,grey,grey-green,inflorescence,lanceolate,length,lilac,lobe,margin,mm,obtuse,ovate,pale,pedicel,peduncle,petiole,pseudo-racemose,purple,ray,rostrate,rusty,shrub,simple,stellate,stellate-pubescent,stem,streak,style,tube,unarmed,unbranched,x,yellow,yellowish,yellowish-green	%,0-0.3,0-0.4,0-10,0-3.5,0.05-0.1,0.1-0.4,0.2-0.4,0.3-0.5,0.5-1,0.7-1.3,0.7-1.4,0.7-1.8,0.8-1.1,0.8-1.5,0.8=2.5,1,1-1.5,1-2,10-14,10-20,2.3-3.6,4-locular,5-15,5-merou,6-10,6-14,6-8,7-10,7-9,abaxially,absen,absent,acicular,across,acute,adaxiall,adaxially,alyx,andromonoecious,anvil-shape,apart,apex,articulated,ascending,axe,ba,blade,broad-based,cross-section,cylindrical,decimetr,directed,distall,distally,distributed,dult,eaf,eed,eglandular,erect,exocarp,extra-axillary,finger,fruiting,functional,gland-tipped,hair,half,heterostylous,hig,juicy,lamina,lateral,less,long,longer,lower,markedly,mature,mesocarp,mid-point,midpoint,minute,moist,multiradiate,nflorescence,oblique,onl,orolla,part,per,perennial,placenta,plant,pore,porrect,present,prickle,rhizomatous,ruit,sessile,short,spaced,stage,stalk,stalked,stellae,straight,tamen,thick,thicker,throughout,time,unarme,unit,unknow,uvenile,vary,weakly,white,wide,ympodial	abaxial,adaxial,arrangement,bark,branch,branching,color,corolla,drying,filament,form,growth,leaf,main,midvein,na,number,ovary,primary,pubescence,seed,shape,size,stigma,surface,tertiary,texture,trichome,vein,venation,width,young
413	wfo-0001028791	success	257	148	125	132	23	0.486	+,.5,0.05-0.2,0.25-0.3,0.3-0.4,0.3-0.6,0.4-0.65,0.45-0.55,0.6-0.8,0.8-1,0.8-1.3,1-1.5,1-2,1-2-celled,1-3-celled,1.5-2,1.7-2.1,1.8-3.3,100,2-3.5,2-7,2-7-celled,2.8-3.0,20-to,3-,4-5+,4-celled,5-,5-15,5-22,50-80,8-10-celled,9-30,9-35,acuminate,anther,articulated,basal,base,beneath,branched,broadly,brown,calyx,capitate,cell,clambering,cm,conical,corolla,dark,deltate,densely,diameter,dichotomously,elliptic,entire,filament,flower,fruit,glabrous,glandular,globose,green,hair-like,half,head,imparipinnate,interrupted,lateral,leaf,liana,like,lobe,long,many,margin,middle,midvein,minutely,mm,near,oblique,obovate,occasionally,outgrowth,ovary,pale,paler,pedicel,peduncle,petiole,primary,pubescence,pubescent,scandent,seed,short,simple,slightly,somewhat,sparsely,stellate,stem,stigma,style,surface,tertiary,testa,thick,time,transparent,trichome,truncate,tube,unicellular,uniseriate,vein,vine,wall,white,wide,woody,yellow,–1-2-celled	-0.6,-1.5,-9,0-6,0.05,0.2-0.3,0.2-0.4,0.2-0.8,0.3-0.5,0.3-0.8,0.4-0.5,0.4-0.6,0.4-1.1,0.5,0.6-0.9,0.7-1.5,1-3,1-celled,1.5-,1.6-4.5,10,2-3,2-locular,2.5-4.5,3-4,4-11.5,4-15,5-10,5-plurifoliate,abaxially,absen,absent,abundant,acute,adaxially,addition,ag,along,anthesi,apex,apical,appearance,appendage,articulation,basiscopically,berr,border,breaking,bullate,colo.,column,consistently,darker,deciduous,densest,developed,eaf,ebracteate,edicel,eed,eglandular,elongating,enlarged,even,exserted,extended,free,fruiting,give,glabrescent,gree,grow,growing,halfway,interjected,internode,lamina,large,leaflet,leaving,less,lon,lower,mixture,much,multicellular,nflorescence,often,pair,papillate,per,petiolule,plant,poorly,present,protuberance,pseudostipule,rachi,reflexed,rest,rough,round,ruit,sandpapery,secondary,sessile,shorter,silky,single,small,smaller,sometimes,sparse,spreading,stamen,staminal,sterile,stiff,straight,tal,tem,terminal,thickened,tip,touch,ud,unit,upper,usually,vegetation,winged,ympodial	abaxial,adaxial,arrangement,bark,branch,branching,color,drying,form,growth,inflorescence,length,main,na,number,ray,shape,size,texture,unarmed,venation,width,young
414	wfo-0001028798	success	214	126	101	113	25	0.472	0-1,0-60,0.2-0.4,0.9-1.2,1-4.5,1.1-2,1.5-1.8,1/20,10,15-19,2-3,2-3.75,2-6,2-7,2.4-4.4,2.6-4,3-5,3.3-5.6,5.25-7.5,7-8,8-18,acuminate,acute,anther,apex,attenuate,base,becoming,blade,branch,branched,calyx,chartaceous,cm,conical,corolla,cylindrical,decurrent,diameter,echinoid,entire,exserted,filament,flower,fruit,glabrous,granular,granular-tomentose,green,greenish,growth,lanceolate,lateral,leaf,length,less,lobe,long,main,margin,midvein,mm,multangulate,oblanceolate,oblong,obovate,obtuse,pale,pedicel,peduncle,persistent,petiole,porrect-stellate,probably,pseudo-terminal,ray,ripe,rotate-stellate,rough,rough-granular,semi-ovate,short,shrub,simple,slightly,stamen,stem,stigma,style,subcampanulate,subcoriaceous,subglobose,time,tomentose,tube,unarmed,vein,velutinous,x,yellow,yellowish	.5-5,0.5-2,1-3,1-6,1/2-2/3,2.5-3.5,2/3,3-4,3.8-4.2,4-5.4,5-8,6-10,6-8,8.5-13,abaxially,accrescent,adaxially,ag,anthesi,apart,apical-lateral,apparently,articulated,axe,axillary,ba,berry,blunt-tipped,boat-shaped,bud,capitat,continued,curved,dehiscing,densely,distal,dm,downward,due,eaf,echinoi,eed,extend,fleshy,free,fruiting,hair,hal,high,included,inserted,introrse,irregularly,lacking,large,lined,lobed,longitudinal,lower,m.,many,minutely,mixed,multangulat,nearly,nflorescence,oblanceolat,obscured,often,orbicular,orolla,oung,ovate-lanceolate,overlapping,perfect,persistently,plurifoliate,pore,present,prominent,pubescent,quite,rachi,rather,ruit,sessile,short-stalked,side,slit,small,somewhat,spaced,sparingly,splitting,stalked,stellate-pubescent,strongly,sulcate,suture,tamen,thick,tip,tomentu,tomentum,toward,translucent,unarme,unit,unknow,vary,way,wide,ympodial	abaxial,adaxial,arrangement,bark,branching,capitate,color,drying,form,inflorescence,na,number,ovary,primary,pubescence,seed,shape,size,surface,tertiary,texture,trichome,venation,width,young
415	wfo-0001028803	success	204	131	92	112	39	0.451	.5,0.5,10,2,5,8-12,abaxial,absent,adaxial,anther,anthesi,armed,asymmetrical,attenuate,base,berry,branch,branched,brown,bud,calyx,chartaceous,cm,connivent,cupular,densely,diameter,entire,erect,extra-axillary,filament,flower,fruit,functionally,glabrous,globose,green,hair,hermaphroditic,leaf,length,liana,light,like,lobe,lobed,long,main,male,margin,midrib,midvein,mm,moderately,nearly,obtuse,often,ovate,pedicel,peduncle,petiole,prickle,pubescent,purple,ray,recurved,reniform,rounded,scandent,shrub,simple,small,sparsely,spreading,stellate,stem,stigma,style,surface,tan,tapering,tree,triangular,unarmed,vein,venation,violet,weakly,white,yellow,young,×	0.5–1,0.5–3,1,12–14,14–20,1–1.2,1–1.5,1–2,1–3,1–3.5,2–10,2–3,2–3.5,2–4,3–10,3–4,3–6,4–10,4–7,5-merous,5–8,6–10,75-120,8–12,8–14,actinomorphic,acute,ag,alyx,andromonoecious,apart,apex,apical,apparently,appearing,articulated,axe,ba,bearing,becoming,blade,cordate,curve,curved,curving,cylindrical,darker,developed,difoliate,distal,downward,due,eaf,early,eed,elongated,em,end,exceeding,field,flowering,fruiting,geminate,glabrou,glandular,held,herbarium,infructescenc,lacking,late,longitudinal,midpoint,multiseriate,narrowly,nflorescence,occasional,older,opening,orolla,ower,pair,per,pinnate,plant,pore,proximally,rachi,ruit,secondary,sheet,side,slightly,slit,spaced,splitting,stalk,ste,stellate-pubescent,surfac,tamen,tomentose,triangula,typically,unequa,unit,upright,upward,usually,vary,wid,ympodial,zygomorphic	0.5-3,1-1.2,1-1.5,1-2,1-3.5,12-14,14-20,2-10,2-3,3-4,3-6,4-10,4-7,5-8,6-10,8-14,arrangement,bark,branching,color,corolla,drying,form,growth,inflorescence,na,number,ovary,primary,pubescence,seed,shape,size,tertiary,texture,trichome,tube,wide,width
416	wfo-0001028815	success	196	106	74	122	32	0.378	0.5-1,1-2,10-15,14-28,2-4,2-9,22-35,3-4,3-5,4-10,5-6,6-10,6-8,7-16,anther,base,broadly,brownish,chartaceous,cm,condition,corolla,cuneate,dark,diameter,drying,elliptic,elliptic-lanceolate,filament,flower,forked,fresh,fruit,glabrous,globose,green,greenish,herb,lanceolate,lilac-purple,lobe,margin,medium,membranous,mm,mucilaginous,odd-pinnate,ovate,ovoid,papillose,pedicel,peduncle,petiole,pubescent,purple,red-purple,rotate,rounded,rugose,seed,size,sparsely,splotched,stem,stigma,style,tinged,triangular-lanceolate,tube,wet,whitish,x,yellow,young	0.4-0.8,1-10,1-3.5,1-4,1-5,2-4.5,2.5-6.5,3-7,5-7,5-merou,abaxially,acumen,acute,adaxially,ag,along,alyx,apart,apex,apparently,articulated,articulation,auriculate,axe,axillary,basiscopic,berry,blade,bud,capitat,cell,ciliate,connivent,covering,decreasing,decurrent,developing,digestion,distal,distinct,dorsally,eaf,edge,eed,enzyme,especially,exceeding,flat,folded,geminat,generally,glabrou,green-white,hair,hair-like,hal,half,high,homostylous,honeycomb-shaped,indistinct,interjected,lateral,leaflet,lengthening,like,living,long,lower,make,midrib,minutely,narrowly,nflorescence,obtuse,onto,orolla,pair,perfect,petiolulate,plant,plurifoliate,pointed,pore,poricidal,puberulent,purpl,rachi,removed,ripe,ruit,semi-erec,semi-rosette,sessile,seudostipule,short,side,slightly,slit,spaced,specimen,stamen,ste,straight,subtending,tall,tamen,tem,terminal,terminated,testal,thick,throughout,tip,tri-,unit,unwinged,usually,vary,wall,winged,ympodial	abaxial,adaxial,arrangement,bark,branch,branching,calyx,capitate,color,form,growth,inflorescence,leaf,length,main,midvein,na,number,ovary,primary,pubescence,ray,semi-erect,shape,surface,tertiary,texture,trichome,unarmed,vein,venation,width
417	wfo-0001028876	success	127	107	79	48	28	0.622	.5,/4,0.4-1,0.5-2,1-2,1.5-2,1.5-3,2-2.3,3-5,3-8,4-5,4-8,5-6,abaxial,acute,adaxially,along,anther,apex,attenuate,bark,base,brown,calyx,capitate,cm,conical,corolla,dark,dendritic,densely,drying,elliptic,filament,flower,glabrous,golden,internodal,lateral,leaf,like,lobe,lobed,long,long-triangular,main,midrib,minutely,mm,opposite,ovary,pair,papillose,pedicel,petiole,poricidal,pubescent,reddish,rest,rounded,sagittate,shining,shrub,simple,small,stem,stigma,style,subshrub,surface,tip,trichome,tube,uniseriate,vein,way,white,x,young	abaxially,anthesi,branched,closely,dia,difoliate,eaf,edicel,eed,ellipsoid,free,geminat,glabrat,hroughout,included,inflorescenc,know,known,lamina,leave,lower,middle,nflorescence,nodding,occasionally,older,overlappin,papillae,papillo,planar,pore,portion,ruti,scar,shaped,slender,spaced,sparsely,speciman,straight,tall,tear-drop,tub,type,ud,unit,widest,ympodial	adaxial,arrangement,branch,branching,color,diameter,form,fruit,glabrate,growth,inflorescence,length,margin,midvein,na,number,peduncle,primary,pubescence,ray,seed,shape,size,tertiary,texture,unarmed,venation,width
418	wfo-0001028883	success	207	108	75	132	33	0.362	1,4,5,anther,antrorse,articulated,attenuate,base,berry,branch,calyx,capitate,cell,chartaceous,ciliate,cm,concolorous,connivent,coriaceous,curved,cylindrical,cyme,dark,deltate,diameter,drying,dull,elliptic,entire,filament,flower,fruit,glabrous,globose,green,greenish,growth,herb,leaf,length,light,lobe,long,margin,mm,narrowly,notably,oblong,pedicel,peduncle,petiole,pubescence,pubescent,reniform,ripe,seed,shiny,simple,size,slightly,sparsely,stellate,stem,stigma,style,surface,trichome,unbranched,undulate,uniseriate,vein,venation,white,whitish,yellow	0.3–0.6,0.4–1.2,0.5–2,0.6,1.5–7,1–2,1–6,2,2–3,2–5,3–5,4–6,5-merou,50,6,6–10,6–12,abaxially,absent,accrescent,acuminate,acute,adaxiall,adaxially,almost,along,alyx,antrorsely,apar,apex,arched,ark,ascending,axi,becoming,blade,brochidodromous,brow,capitat,circular,common,completely,decurrent,densely,differing,directed,eaf,eed,elliptic-ovate,emarginate,equal,erect,exfoliating,eye,flattened,frui,geminate,geniculat,glabrescent,glabrou,glandular,head,hilum,hollow,impressed,introrsely,lateral,less,like,longitudinal,lower,lying,membranaceous,midrib,minor,moderately,multicellular,naked,new,nflorescence,normally,obtuse,often,older,onto,opening,orolla,ovate-lanceolate,parallel,pendan,per,perfect,plurifoliate,pore,poricidal,present,primarily,prominent,rachi,rarely,region,rounded,ruit,secondary,sessile,shap,shrub,similar,single,single-celled,slit,small,sometimes,spaced,sparse,spreading,stalk,straight,subapical,subopposite,subsessile,swollen,tall,tamen,tem,unit,vary,visible,wide,woody,ympodial,×	1-2,1-6,1.5-7,2-3,2-5,3-5,4-6,6-10,6-12,abaxial,adaxial,arrangement,bark,branching,color,corolla,form,inflorescence,main,midvein,na,number,ovary,primary,ray,shape,tertiary,texture,tube,unarmed,width,ye,young
419	wfo-0001028885	success	214	137	111	103	26	0.519	-1,0.3-0.5,0.5-1,0.7-2,1-1.2,1-3,1.5-3.5,10-20,2,2-2.5,2.3-2.5,2.5-3.5,2/3,3-5,3.5-4.5,7-8,7-9,9-11,?,abaxial,acute,adaxial,adaxially,anther,apex,apiculate,attenuate,base,berry,black,branch,branched,broadly,brown,calyx,capitate,cm,connivent,corolla,cup-shaped,dark,deltate,densely,diameter,drying,ellipsoid,elliptic,entire,erect,filament,fleshy,flower,glabrous,globose,growth,immature,inflorescence,lanceolate,lateral,leaf,like,lobe,lobed,long,loosely,margin,midvein,minute,minutely,mm,multicellular,narrowly,nodding,pair,pedicel,peduncle,petiole,poricidal,primary,pubescent,purple,reddish,revolute,rhachi,ripe,scandent,scattered,shiny,shrub,simple,slender,slightly,sometimes,sparsely,stellate,stem,stigma,style,surface,terminal,time,tip,trichome,tube,uniseriate,vein,vine,way,wide,woody,¾	.5,0.5-5,1-1.5,1-2,1.5-1.7,2-,3.5-8.5,4-5,5-merou,9-12,ag,along,alyx,anthesi,apart,apparently,archin,ark,articulated,basal,blackish,cell,collapsing,dark-pigmented,decurrent,dendriti,distal,dried,eaf,eed,exserted,extending,free,fruiting,furcate,glabrescent,glabrou,glandular,golden,gradually,groove,groupe,height,ilament,inserted,irregularly,known,lamina,leaving,lengthening,less,live,lower,material,mostly,narrowing,new,nflorescence,noddin,occasionally,often,older,orolla,papillo,part,peg,perfect,pericarp,pigmentation,plant,plurifoliat,pore,portion,quarter,recorded,retaining,ruit,scar,shin,short,sleeve,slit,small,smaller,spaced,spheroidal,spreading,strongly,tangled,tem,thin,third,twinin,ud,unit,upper,usually,vary,wall,weak,weak-walled,winged,ympodial	1,2-8.5,arched,arrangement,bark,branching,color,form,fruit,length,main,na,number,ovary,papillose,pubescence,ray,seed,shape,size,tertiary,texture,unarmed,venation,width,young
420	wfo-0001028888	success	207	119	87	120	32	0.42	0-3.5,1-1.5,1-2,10-25,12.5-25,2-6,2.3-7,2.5-3.3,3-4,4-25,4-7,5-10,5-7,8-11,8-13.5,acute,anther,apiculate,base,broadly,brownish,cell,chartaceous,clavate,cm,condition,corolla,covered,covering,diameter,drying,elliptic,filament,flower,forked,fresh,fruit,glabrous,glaucous,globose,green,greenish,hair,hair-like,herb,lanceolate,lateral,like,lobe,long,margin,membranous,mm,oblique,odd-pinnate,often,ovate,ovoid,pedicel,peduncle,pentagonal,petiole,poricidal,pubescent,ripe,rounded,seed,short,size,sparsely,stem,stigma,streak,style,subglabrous,substellate,testal,thick,tip,tube,typically,violet,wall,white,whitish,x,yellow	0-5,0-7,0.15-0.5,1,1-10,1-3,1.5-4,2-5,2.3-5,3-5,3.6-12.5,3.8-8.3,5-merou,6-11,abaxially,acumen,acuminate,adaxially,ag,along,alyx,apart,apex,apparently,articulated,axe,axillary,berry,blade,bud,capitat,center,central,ciliate,connivent,cuneate,digestion,distal,dorsally,dot,eaf,edge,eed,end,enzyme,erec,especially,exceeding,except,flat,folded,geminat,generally,glabrou,greatly,green-white,hal,half,homostylous,honeycomb-shaped,interjected,leaflet,lengthening,less,living,low,lower,make,middle,midrib,minutely,mottled,mucilaginous,nflorescence,one,orbicular,orolla,pair,perfect,petiolulate,petiolule,placed,plant,plurifoliate,pore,proximal,puberulent,purple,reduced,removed,ruit,scattered,sessile,seudostipule,slightly,slit,sometimes,spaced,specimen,stamen,ste,stolo,straight,subequal,subtending,tall,tamen,tem,terminal,throughout,tri-,truncate,tuber,unit,unwinged,usually,vary,wet,wing,ympodial	abaxial,adaxial,arrangement,bark,branch,branching,calyx,capitate,color,form,growth,inflorescence,leaf,length,main,midvein,na,number,ovary,primary,pubescence,ray,shape,surface,tertiary,texture,trichome,unarmed,vein,venation,width,young
421	wfo-0001028905	success	210	117	84	126	33	0.4	1,1.5-2,1.5-3,10,10-15,15-30,2,2.5-3,3-4,3-5,4,5,5-15,6-9,anther,base,bilobed,bluntly,broad,broadly,brown,calyx,capitate,cm,concentrically,conical,corolla,cuneate,cyme,deep,dia,distinctly,ellipsoid,entire,filament,flower,forked,form,free,glabrescent,glabrous,glandular,green,hair,later,leaf,line,lobe,main,margin,minute,mm,narrowly,oblong,obovoid,orange-yellow,ovary,ovate,ovoid,paling,pedicel,peduncle,petiole,poricidal,purple-blue,reddish,reticulate,rotate,rugose,scorpioid,short,shortly,shrub,simple,size,stem,stigma,style,surface,tip,tube,x,yellow,young	-20,-3.5,-4,-5,-9,1-,1-3,1.5,10-20,2-2.5,2-3,200-300,38/1-38/2,40-60,5-,7,acuman,acumen,acuminate,adult,age,almost,also,apex,appearing,appressed,aspect,aster,axil,becoming,berry,blunt,bud,cell,close,completely,continued,covering,deeply,developed,distance,eaf,eed,emarginate,enlarged,equal,even,exceeding,except,exerted,facetted,firming,first,floral,fork,frui,fruiting,general,growing,herbarium,inadequate,interacuminal,intermediate,lanceolate,lasting,lengthening,less,lobed,lobing,lon,long,lower,may,midrib,mucronate,nflorescence,occur,often,pair,papillo,pedicellate,pinnatisect,plant,plurifoliat,pore,purpli,range,rarely,reaching,readily,rh,rhachi,ripe,rounded,ruit,ruiting,scarious,seedling,several,shed,show,showy,sinus,slende,slit,smaller,soft-wooded,soon,sparse,specimen,spreading,stone,straggly,succulent,suffused,tall,tissue,tub,ud,unit,usually,variable,violet,well,year,ympodial	abaxial,adaxial,arrangement,bark,branch,branching,color,diameter,drying,fruit,growth,hirsute,inflorescence,length,midvein,na,number,papillose,plurifoliate,primary,pubescence,ray,seed,shape,slender,tertiary,texture,trichome,unarmed,vein,venation,width,ye
422	wfo-0001028916	success	212	104	77	135	27	0.363	0.25-0.3,0.4-0.8,0.5-3.2,0.5-3.5,1-1.5,1-4.6,1-7,1.5-2.5,1.5-3,2-12,2.5-5,3-4,3.5-4.5,5-10,5-7.5,7-18,8-9,anther,base,calyx,chartaceous,cm,cuneate,deeply,deltate,densely,depressed-globose,diameter,ellipsoidal,elliptical,flower,fruit,glabrous,globose,green,grey,herbaceous,inflorescence,later,length,light,lilac,lobe,lobed,marbled,margin,midvein,minutely,mm,moderately,oblong-attenuate,obtuse,ovate,pale,pedicel,peduncle,petiole,pitted,purple,ray,resprouter,rotate,rotate-pentagonal,sessile,simple,sparsely,stellate-pubescent,stigma,style,surface,throughout,tube,unbranched,vein,white,x,yellow	%,-8,0-0.4,0-0.5,0-2,0.05-0.1,0.2-0.3,0.2-0.4,0.25-0.35,0.3-0.4,0.4-1.3,0.5-3,0.5-5,0.9-1.1,1-2,1-3,1-4,1.8-2.2,10-16,14-21,15-25,2-5,3-5,35-50,35-55,4-,4-8,5-12,5-35,5-9,5-merou,6-20,7-10,7-8,8-10,abaxially,absen,absent,abundant,accrescent,acicular,across,adaxiall,adaxially,adult,alyx,andromonoecious,apart,apex,armed,articulated,axe,ba,blade,branche,broad-based,broadly,brown,connivent,cut,cylindrical,decimetre,deflexed,directed,distall,distributed,eaf,eed,eglandular,extra-axillary,filament,finger,fruiting,functional,gland-tipped,hair,half,heterostylous,index,interpetalar,lamina,lateral,less,lobing,lon,long,longer,loosely,lower,mature,mesocarp,midpoint,minute,nflorescence,notably,oblique,orolla,part,per,plant,pore,porrect,presen,present,prickle,prostrate,rachi,ruit,shallowly,short,side,somewhat,spaced,sprawling,stage,stellae,stellate,straight,succulen,tal,tamen,tem,thick,time,tissue,triangular,truncat,unit,unknow,uvenile,vary,weakly,wide,winged,ympodial	abaxial,adaxial,arrangement,bark,branch,branching,color,corolla,form,growth,leaf,main,na,number,ovary,primary,pubescence,seed,shape,size,stem,tertiary,texture,trichome,truncate,venation,young
423	wfo-0001028920	success	152	122	94	58	28	0.618	.25,.5,0.2-1,0.5-1,0.8-1.1,1-1.2,1-1.5,2-2.5,2-7,3-15-flowered,3-3.5,5-9,6-15,6-6.5,abaxially,acute,adaxially,anther,apex,arachnoid,arachnoid-pubescent,area,attenuate,bark,base,broadly,brown,brownish,calyx,cm,congested,conical,corolla,dark,decurrent,deltate,dendritic,dense,dia,difoliate,elliptic,erect,felty,filament,flower,glabrate,glabrous,globose,green,leaf,lightly,lobe,lobed,long-styled,main,minutely,mm,nearly,obovate,occasionally,ovary,ovoid-reniform,pair,papillose,pedicel,petiole,pitted,pubescence,pubescent,shape,shaped,short-styled,shrub,simple,size,small,soon,sparsely,stem,stigma,style,surface,tear-drop,tip,tree,trichome,tube,unifoliate,uniseriate,vein,white,winged,x,young	1-2.4,1-3,1.5-2,3-4,acuminate,anthesi,axil,ba,berry,closely,cucullate,deflexed,densely,differing,eaf,edicel,eed,ellipsoid,exserted,fleshy,free,fruiting,geminat,gray-brow,later,lateral,lon,long,lower,major,middle,minor,nflorescence,obovoid,older,opposite,overlappin,planar,pore,poricidal,portion,present,ruit,scar,somewhat,spaced,strongly,styl,tall,tapering,thick,tub,tuft,ud,unit,widest,woody,ympodial	abaxial,adaxial,arrangement,branch,branching,color,diameter,drying,form,fruit,geminate,gray-brown,growth,inflorescence,length,margin,midvein,na,number,peduncle,primary,ray,seed,tertiary,texture,unarmed,venation,width
424	wfo-0001028929	success	210	130	108	102	22	0.514	.5,.7,.9,/5,0-3,0.2-0.4,0.4-0.8,0.5-2,0.7-2,1-1.1,2-3,2-4,2.2-2.3,2.5-4,2.7-3,4-6,5-6,5-7.5,abaxial,adaxial,anther,apically,apparently,bark,base,berry,branched,calyx,cell,chartaceous,cm,concolorous,cuneate,curved,densely,diameter,discolorous,drying,dull,elliptic,erect,filament,flattened-reniform,flower,fruit,gently,glabrescent,glabrous,inflorescence,lateral,leaf,length,lobe,lobed,long,margin,maturity,midvein,minutely,mm,oblong,obovate,obtuse,orange-brown,outline,pair,patch,pedicel,peduncle,petiole,pit,poricidal,porrect,prickly,primary,raised,ray,red,red-brown,red-green,reticulate,sessile,shrub,simple,slender,small,smooth,sometimes,spherical,stalked,stellate-pubescent,stem,style,surface,tapering,tertiary,tip,trichome,tube,unarmed,variously,vein,venation,way,white,wide,yellow,yellow-green	-2,-2/3,0,0-1,0-10,0-20,0.1,0.15-0.3,0.2-0.3,0.2-0.8,0.3-0.6,0.5-1.5,0.7-1,0.8-1,1,1-3,1.5-2.4,1/2,1/4-1/3,2-6,2-9,2/3-3/4,3-20,3-4,5-25,5-merous,6-8,7-9,8-10,abaxially,acicular,acute,alyx,apar,apart,ape,apex,articulated,blade,connivent,difoliate,distance,eaf,eed,elongating,equal,extending,foliaceous,free,fruiting,geminat,glabrou,gra,hair,infructescence,lon,long-styled,longer,lower,mature,midpoint,minute,narrow-deltate,narrow-ovate,nflorescence,obtu,occasionally,older,one,open,orolla,oung,pale,pendulous,per,perfect,pericarp,perpendicular,portion,prickl,prickle,rounded,ruit,scar,short-styled,side,spaced,spreading,stalk,staminate,stellate,straight,subsessile,tamen,terete,time,unit,usually,vary,visible,woody,ympodial	arrangement,branch,branching,color,corolla,form,gray,growth,height,main,na,number,ovary,plant,pubescence,seed,shape,size,stigma,texture,width,young
425	wfo-0001028934	success	177	132	101	76	31	0.571	0.5-0.75,0.5-1,0.5-1.5,0.5-2,1-2,1-3,1.5,1.5-2,10-30,2-2.5,2-3,2-4,3-6,3-7,5-10,5-15,5-6,5-8,6-9,8-14,abaxially,acute,adaxially,anther,asymmetrical,attenuate,base,brown,bud,calyx,chartaceous,cm,connivent,created,dark,densely,diameter,distally,expanded,extra-axillary,filament,filiform,flower,fruit,glabrous,globose,green,hair,immature,leaf,light,like,lobe,lobed,many,margin,mature,midpoint,midvein,mm,moderately,narrowly,nearly,netlike,often,orange,ovate,pedicel,peduncle,petiole,pit,porrect-stellate,prickle,pubescent,raised,ray,recurved,red,reniform,ridge,simple,small,spreading,stellate,stem,stigma,style,surface,tan,tapering,triangular,tube,unarmed,unbranched,unlobed,vein,vine,white,wide,x,yellow	0.5,1,1-.,1.5-2.5,15-25,3-5,5-merou,6-7,absent,accrescent,adaxiall,alyx,apar,apex,apical,apparently,armed,axe,berry,beyond,blade,cordate,cylindrical,difoliate,directed,discolorous,eaf,eed,either,em,exserted,flattened,frui,fruiting,geminate,glabrou,gree,introrsel,lanceolate,leathery,long,lower,m.,major,midrib,multicellular,multiseriate,nflorescence,obscure,obtuse,orolla,pair,per,perfect,pirckle,pore,rachi,reflexed,roselike,ruit,secondary,side,skinned,slightly,spaced,stalk,stamen,ste,tamen,thin,unequa,unicellular,unit,vary,x1-3,ympodial	1-4,abaxial,adaxial,arrangement,bark,branch,branching,color,corolla,drying,form,growth,height,inflorescence,length,main,na,number,ovary,plant,primary,pubescence,seed,shape,size,tertiary,texture,trichome,venation,width,young
426	wfo-0001028944	success	212	144	122	90	22	0.575	0.5-0.75,0.5-1,0.5-1.5,0.8-1.5,0.8-5,1-1.5,1-3,1-3-lobed,1-4,10-20,2-15,2-2.5,2-3,2.5-4,20-50,3-4,4-6,5-10,5-25,6-15,6-8,8-13,acute,anther,apex,armed,base,branched,bright,brown,calyx,chartaceous,cm,coarsely,cordate,cuneate,dark,densely,diameter,elliptic,entire,erect,especially,extra-axillary,ferruginous,flattened,flower,forked,fruit,glabrescent,glabrous,globose,green,growth,hair,lanceolate,leaf,light,like,linear-acuminate,lobe,long,long-stalked,margin,mature,membanaceous,midpoint,mm,moderately,multangulate,narrowly,nearly,oblique,occasionally,often,outline,ovate,pedicel,peduncle,petiole,porrect-stellate,pubescent,purple,ray,reniform,ripe,rotate-stellate,rounded,sessile,shallowly,short-,short-stalked,shorter,shrub,side,simple,slightly,small,smooth,sometimes,sparsely,stellate,stellate-pubescent,stem,stigma,strongly,style,surface,tapered,tip,toward,tree,triangular,tube,unarmed,unbranched,white,whitish,x,yellow,yellowish,young	.5-2.5,0.75-1.25,1-2,1-5,1.5-7,2.5-10,4-5,4-8,5-merou,6-7,7-17,8-10,abaxially,abundant,accrescent,adaxially,ag,alyx,apart,apparently,articulated,axe,ba,berry,blade,broad,broad-based,brownish,capitat,connivent,covering,curved,cylindrical,deltate,denser,difoliate,directed,discolorous,distally,divided,eaf,eed,equal,filament,free,frui,fruiting,geminate,glabrou,halfway,highly,homostylous,interpetalar,longitudinal,lower,main,major,midrib,mucilaginou,nflorescence,numerous,obtuse,opening,orolla,part,perfect,pericarp,pore,prickle,rachi,recurved,ruit,slit,spaced,sparse,stalk,straight,subtending,tal,tamen,tem,thin,time,tissue,unit,vary,vein,white-pubescent,wide,ympodial	abaxial,adaxial,arrangement,branching,capitate,color,colour,corolla,form,height,inflorescence,length,na,number,ovary,plant,pubescence,seed,shape,size,texture,width
427	wfo-0001028963	success	197	141	118	79	23	0.599	.5,/2,0-0.4,0-2,0.1-0.25,0.3-1,0.3-1.5,0.45-0.6,0.6-0.9,0.6-1,0.9-1.5,1.5-2,1/5,1/6,2-2.3,2-4,2-9,2.4-2.8,3.5-4.2,4-10,6-10,7-8,anther,apically,apparently,articulated,attenuate,bark,base,berry,blade,bright,broad-deltate,brown,calyx,cell,chartaceous,cm,curved,densely,diameter,drying,dull,entire,erect,evenly,eye,flattened-reniform,flower,glabrescent,glabrous,gray-green,green,herb,inflorescence,lanceolate,lateral,leaf,length,less,light,lobed,long,lower,margin,maturity,mauve,midpoint,mm,moderately,naked,narrow-cuneate,narrow-elliptic,orange,outline,pair,pale,pedicel,peduncle,petiole,pit,poricidal,porrect,primary,purple,raised,ray,red,sessile,shorter,shrub,simple,slender,slightly,small,smooth,spherical,stalked,stellate-pubescent,stem,straight,style,surface,tapering,terminal,tip,trichome,tube,unarmed,unbranched,upper,variously,vein,visible,way,wide,yellow-orange,young	0.1,0.1-0.2,0.15-0.3,0.3-0.6,0.3-0.7,0.8-1.8,1-4,1/,1/4-1/3,2-3,2-5,3-4.5,4-8,5-25,5-merous,abaxially,acute,alyx,apar,ape,apex,becoming,concolorous,connivent,cuspidat,deltate,difoliate,discolorous,eaf,eed,elongating,equal,filament,free,frui,fruiting,geminat,gra,herbaceous,infructescence,lobe,long-styled,longer,mature,narrowly,nflorescence,obtuse,occasionally,older,one,open,orolla,oung,pendulous,per,perfect,pericarp,portion,ruit,scar,short-styled,spaced,spreading,stalk,staminate,stellate,subsessile,tamen,terete,tertiary,time,unarme,unit,usually,vary,venation,winged,woody,ympodial	1/2,abaxial,adaxial,arrangement,branching,color,corolla,cuspidate,form,fruit,gray,growth,height,midvein,number,ovary,plant,pubescence,seed,shape,size,texture,ye
428	wfo-0001028971	success	225	119	87	138	32	0.387	0.1-0.4,0.25-0.6,0.4-0.9,1-2,1.5-2.2,1.75-2.5,10-15,15-30,2.2-3.5,2.5-3.5,2.5-4.5,2.5-5,20-35,3-14,3-5,4-5,4-9,5-10,5-8,6-16,6-8.5,6-9,anther,attenuate,base,branched,broadly,calyx,campanulate,cm,coarsely,connivent,deltoid,densely,dentate,diameter,erect,felty-pubescent,filament,flower,form,fruit,glabrous,globose,inflorescence,leaf,length,lenticular,linear-lanceolate,lobe,margin,minutely,mm,obtuse,orange,outline,ovate,ovate-apiculate,pedicel,peduncle,perennial,petiole,pitted,pubescent,ray,reniform-ovate,ripe,short,simple,spreading-hirsute,spreadingly,stellate,stellate-pubescent,stem,stigma,style,surface,tan,thin-textured,trichome,truncate,tube,unbranched,vein,white,x,yellow	-0.8,-1.4,.1-0.2,0.1-0.5,0.2-0.5,0.25-1.25,0.3-0.6,0.4-1.5,0.8-2.5,05-2.5,1-5,1.5-4,1/5-1/2,2-5,2-foliate,3-6,5-15,7-16,abaxially,acute,acute-,adaxiall,adaxially,along,also,apart,apex,appearance,appearing,armed,articulated,ascending,axe,ba,bearing,becoming,blade,broad-based,capitat,cauline,close,compressed,cylindrical,delicate,directed,distal,distall,eaf,eed,elongate,elongate-deltoid,entire,essentially,extra-axillary,farinaceous,felty,female-sterile,frequently,geminat,grading,growt,hair,inserted,interlobal,invested,lanceolate,largest,later,lateral,laterally,least,lignescent,like,lon,long,longer,longest,lower,major,manifestly,maturit,midpoint,midrib,minute,mixture,much,multiseriate,narrowly,nflorescence,numerous,occasionally,often,one,orolla,other,ovate-lanceolate,pair,per,persistent,pore,prickle,prickly,principal,rachi,reduced,round-tipped,ruit,scattered,sericeous,sessile,short-stalked,shorter,side,similar,sinus,smaller,sometimes,spaced,sparse,stalk,ste,stellae,stipitate,tal,tamen,tem,termination,time,tooth-like,underdeveloped,unit,usually,variable,variously,vary,well-developed,wide,ympodial	0.5-2.5,abaxial,adaxial,arrangement,bark,branch,branching,capitate,color,corolla,drying,growth,height,history,life,main,midvein,na,number,ovary,plant,primary,pubescence,seed,shape,size,tertiary,texture,venation,width,ye,young
429	wfo-0001028975	success	163	105	78	85	27	0.479	0.1-1,0.5-1,1,1-3,1-5,1.2-1.5,1.5-2,3-10-flowered,3-3.5,3-6.5,6-6.5,7.5-15,8-9,acute,anther,area,bark,base,broad,brown,calyx,cm,conically,corolla,cup-shaped,dark,densely,dia,elliptic,filament,fruit,glabrous,globose,golden,green,immature,leaf,length,lobe,lobed,long,margin,middle,minutely,mm,narrowly,once-furcate,ovary,ovoid-reniform,pair,pedicel,petiole,pitted,pubescent,raised,shaped,shiny,shrub,simple,size,small,sparsely,stem,stigma,style,surface,tear-drop,tree,triangular,trichome,tube,uniseriate,vein,white,wide,widest,x,young	.2,.5,1.5-1.8,2.2-6,5-ribbed,5.5-10,?,acuminate,along,anthesi,apart,apex,appearing,beneath,berry,closely,conical,corky,decurrent,deflexed,denser,differing,difoliate,eaf,edicel,eed,entire,epidermi,equal,erect,exserted,extension,free,fruiting,geminat,hyaline,large-celled,late,lateral,like,lon,lower,main,mainly,major,member,mere,minor,nearly,nflorescence,obscured,occasionally,older,one,opposite,papillo,pore,poricidal,portion,prominent,pubescenc,reddi,reflexed,remaining,rib,ruit,scar,short,sinus,slender,slightly,somewhat,spaced,straight,strongly,tall,tapering,tip,tub,ud,unit,upper,varying,woody,ympodial	0.5,9,abaxial,adaxial,arrangement,branching,color,diameter,flower,form,growth,height,inflorescence,midvein,na,number,papillose,peduncle,plant,primary,pubescence,reddish,seed,shape,tertiary,texture,venation
430	wfo-0001028980	success	168	85	68	100	17	0.405	.75,1-1.2,1.2-1.8,1.2-3,1.5-1.8,1.5-2,1.5-6,2.5,2.5-5,3-4,4-5,5-6,6,7-12,anther,bark,calyx,capitate,cm,coarsely,conical,corolla,dia,elliptic,flattened-reniform,fleshy,furcate,glabrate,glabrous,glandular,globose,green,leaf,minor,minutely,mm,opposite,ovary,ovate,paler,pedicel,petiole,pitted,planar,prominent,reddish,reflexed,seed,shaped,shining,shrub,simple,size,slightly,small,speciman,stem,stigma,style,surface,tall,tear-drop,tree,type,usually,white,x,young	.1,.5,/3,0.5-1.5,20-25-flowered,3/4,5-8,6-8,acuminate,acute,along,anthesi,apart,apex,axil,basal,base,beginning,beneath,berry,black,broadly,clearly,corky,cucullate,deflexed,deltoid,densely,differentiated,differing,difoliate,dry,drying,eaf,edicel,eed,expanded,exserted,extending,f,filament,free,frui,fruiting,geminat,impressed,incrassate,inflorescenc,lamina,lateral,lenticellat,like,lobe,lobed,lon,long,lower,m.,main,major,margin,material,member,middle,nflorescence,occasionally,older,one,ovoid,pair,pale,papillose,peduncle,pit,pore,poricidal,portion,pubescent,ruit,scar,scarious,sharply,soon,sparsely,strongly,tapering,thick,ti,tip,trichome,tube,ud,uniseriate,unit,vein,way,widest,woody,yellowish,ympodial	abaxial,adaxial,alternate,arrangement,branching,color,diameter,form,fruit,growth,height,inflorescence,length,plant,pubescence,shape,texture
431	wfo-0001028982	success	213	115	98	115	17	0.46	%,.5,0-0.2,0.25-0.5,0.3-0.6,0.4-0.65,0.4-1.1,0.5-1.3,1-1.5,1.5-2,1.5-2.5,1.5-4.5,1.6-2.3,13-18,2-6,3-4.5,4-5,4-6,5-9,8-16,8-18,acicular,angled,anther,articulated,attemuate,basal,base,calyx,chartaceous,cm,connivent,contiguous,cuneate,cylindrical,diameter,entire,extra-axillary,fruit,glabrous,gland-tipped,globose,green,hair,hastate,inflorescence,lamina,lanceolate,leaf,length,lilac,lobe,lobed,long,longer,loosely,margin,midvein,mm,moderately,narrowly,nearly,pale,pedicel,peduncle,perennial,petiole,present,prickle,pseudo-umbellate,red,reniform,rugose,scattered,shallowly,shape,short,shrub,simple,solitary,sparsely,stellae,stellate,stellate-pubescent,stigma,straight,style,surface,tan,throughout,time,triangular,truncate,tube,unbranched,wide,x,yellow	.3,0-2.5,0-3,0.2-0.3,0.2-0.4,0.3-0.7,0.3-0.8,0.3-2,0.35-0.5,0.5-0.6,0.5-1,0.8-1.5,0.8-2.5,1,1-2,1-3,1-locular,1.5-3,14-24,15-30,2.5-4.5,35-50,4-,4-7,4.5-7.5,5-6,5-merou,6-8,9-16,abaxially,absen,absent,accrescent,across,acute,adaxially,adult,alyx,apart,apex,apparen,armed,axe,ba,blade,branch,branche,capitat,confined,decimetre,deeply,directed,distall,distributed,dm,eaf,eed,eglandular,erect,exocarp,filament,finger,flower,fruiting,geminat,half,hig,homostylous,incomplete,interpetalar,juicy,juvenile,lateral,less,linear-hastate,lower,mature,mesocarp,mid-point,midpoint,midrib,minute,nflorescence,oblique,obtuse,orolla,overall,pair,part,per,perfect,placenta,pore,porrect,rachi,ray,rhizomatous,ruit,septum,sessile,spaced,sparse,succulent,tamen,tem,thick,tissu,tissue,transparent,unarme,unarmed,unit,upper,vary,ympodial	0.3,abaxial,adaxial,capitate,color,corolla,form,growth,height,ovary,plant,pubescence,seed,size,stem,texture,width
432	wfo-0001028984	success	180	110	90	90	20	0.5	-9,0.5-,1,1-1.7,1-6,1-9,1.2-4,1.5,10-20,2-16,2-2.5,2-3,20-40,3-6,4-30,4-5,4-6,4-6.3,4-7,5-10,acuminate,acute,adpressed,age,also,apex,apical,articulated,base,broadly,calyx,campanulate,chartaceous,cm,color,concave,cordate,densely,diameter,dilated,distally,ellipsoid-fusiform,entire,equalling,forked,fruit,glabrous,gland,greenish,lanceolate,leaving,longer,margin,mm,moderately,obconical,often,ovate,pale,pedicel,pedicellar,peduncle,petiole,pilose,puberulent,puberulent-pubescent,pubescent-pilose,purple,rarely,remnant,shrub,simple,slightly,small,sparsely,stamen,stigma,strongly,style,subcoriaceous,tip,tree,truncate,tube,turning,two,unbranched,violet,x,yellow	-14,-2,-2.5,-3,-6,-65,1-,1-2,1-2.5,12-20,15-35,2,2-,2-4,3-10,3-26,3-28,4-foliat,5,7-14,8-15,abaxially,abruptly,absen,adaxially,aggregate,almost,apart,ape,axe,basal,blade,broad,cell,connective,directed,eaf,eed,eglandular,especially,exceeding,fleshy,flower,glandular-puberulent,globose,hair,laterally,lobe,lon,long,lower,minutely,narrowed,near,nflorescence,nther,obtuse,orolla,ovoid,papillose,perfect,pilo,pore,possibly,presence,present,pubescent-pilo,rachi,radiu,ripe,ruit,shorter,spaced,stone,swelling,tal,tem,thecae,time,tomento,tomentose,toward,triangular,ud,unit,unknow,unknown,vary,wide,ympodial	abaxial,adaxial,anther,arrangement,branching,corolla,form,growth,height,inflorescence,leaf,length,ovary,plant,pubescence,shape,size,stem,surface,texture
433	wfo-0001028997	success	136	111	81	55	30	0.596	0.5-0.7,0.5-1,0.8-1.1,1-1.2,1-1.5,2-3.5,20-50-flowered,3-4,3.3.5,4-10,4-4.5,5-6,6-10,6-7,anther,appearing,area,attenuate,bark,base,branched,broadened,calyx,cm,conical,coriaceous,corolla,difoliate,dry,drying,elliptic-obovate,erect,filament,flattened-reniform,glabrous,globose,golden,green,height,leaf,lobe,lobed,main,many,margin,matte,minutely,mm,mustard,nearly,opposite,ovary,pair,pale,papillose,pedicel,pericarp,petiole,pitted,quadrate,revolute,shaped,shiny,shrub,stem,stigma,style,surface,tan,tear-drop,terminal,thick,time,trifoliate,tube,unknown,vein,white,x,yellow,young	.5,0.5-1.5,2-2.5,4-angled,abaxially,acute,adaxially,anthesi,apar,apex,ba,berry,cucullate,deflexed,dia,eaf,edicel,eed,elliptic,exserted,filiform,fragrant,free,fruiting,geminat,glabrou,greenish-brow,incrassate,later,lateral,lon,long,lower,merely,middle,nflorescence,older,partially,pore,poricidal,portion,ruit,scar,spaced,specimen,strongly,styl,thickened,tip,tub,ud,unevenly,widest,woody,ympodia	0.5,abaxial,adaxial,arrangement,branch,branching,color,diameter,flower,form,fruit,greenish-brown,growth,inflorescence,length,midvein,na,number,peduncle,plant,primary,pubescence,seed,shape,size,sympodia,tertiary,texture,venation,width
434	wfo-0001029003	success	207	96	79	128	17	0.382	0.3-0.5,0.5,1-2,1.2-1.9,1.2-2.5,1.5-2.3,11-32,12.2-30,2.5-10,3,3-20,4-8,5,5-10.5,5-12.5,7-15.5,7-9,9-14,abaxially,adaxially,anther,attenuate,blue-violet,brownish,chartaceous,cm,condition,conical,corolla,diameter,drying,elliptic,forked,fresh,fruit,glabrous,green,greenish,hair,herb,lanceolate,leaf,light,like,long,medium,membranous,minute,mm,mottled,mucilaginous,odd-pinnate,ovoid,pale,pedicel,peduncle,pentagonal,petiole,plant,pubescent,purple,ripe,rotate,seed,size,sparsely,stem,stigma,style,subcapitate,subglabrous,tube,usually,violet,wet,whitish,wide,x,yellow	0-6,0.4-3,1,1-10,1-2.5,1-3,1-5,13-36,2-6,2.5-7.5,3-5,3.5-7.5,5-merou,absent,acumen,acuminate,ag,alyx,apart,apex,apparently,articulated,axe,axillary,base,berry,blade,bud,capitat,cell,ciliate,connivent,covering,decreasing,digestion,distal,dorsally,eaf,edge,eed,elongated,end,enzyme,equal,erec,especially,exceeding,filament,flat,flower,folded,fourth,geminat,generally,glabrou,gradually,green-white,hair-like,hal,half,highly,homostylous,honeycomb-shaped,interjected,larger,lateral,leaflet,lengthening,living,lobe,lower,make,margin,middle,nflorescence,obtuse,one,orbicular,orolla,ovate,pair,perfect,petiolule,pigmentation,placed,plurifoliate,pore,poricidal,prostrate,proximal,rarely,ray,removed,rounded,ruit,secondary,sessile,seudostipule,slightly,slit,sometimes,spaced,specimen,stamen,ste,stolo,straight,subequal,subtending,symmetrical,tall,tamen,tem,terminal,testal,thick,throughout,tip,toward,tri-,tuber,typically,unit,vary,wall,white,wing,ympodial	arrangement,branching,calyx,capitate,color,form,growth,height,inflorescence,length,na,ovary,pseudostipule,pubescence,shape,surface,texture
435	wfo-0001029006	success	217	163	136	81	27	0.627	-+,0.2,0.4-2.5,0.5,0.5-2,0.5-4,1,1-1.5,1-5,1.8-2.2,2-3,2.5,3.5-4,4-6,5,50,7-8,<,adaxial,along,anther,anthesi,apex,area,asymmetrical,axil,basal,base,berry,beyond,bilobed,blackish,branched,c.,calyx,cell,chartaceous,cm,conical,connivent,corolla,deeply,deltate,dense,diameter,ellipsoid,elliptic,elongate,entire,exserted,extending,filament,filiform,flattened,flower,glabrous,globose,green,groove,growth,inflorescence,lamina,later,lateral,lobe,lobed,long,loosely,many,margin,membranous,midrib,minute,minutely,mm,narrowly,nearly,nodding,oblique,occasionally,often,one,pair,pale,papillate,pedicel,peduncle,pentagonal,petiole,pinnatifid,pitted,poricidal,primary,puberulent,pubescent,purple,purplish,reaching,reddish,reniform,ripe,rotate-stellate,sagittate,shiny,simple,size,smaller,somewhat,sparsely,spreading,stem,stigma,style,surface,tan,terminal,testal,thin,time,tip,trichome,truncate,tube,tuft,uniseriate,usually,variously,vein,vine,violet,way,white,within,woody,x,young	.5,1-4,1.2-1.5,1/3,10,10-20,2-6,5-6,5-merou,7-9,>,abaxially,acuminate,acute,adaxiall,ag,age,alyx,apar,ark,articulated,axi,black,bright,broadest,clavat,depending,drying,eaf,eed,free,fruiting,growing,ilament,inflated,intramarginal,irregular,irregularly,keeled,leaving,lengthening,lower,markedly,new,nflorescence,obvious,older,orolla,part,peg,pendan,per,perfect,pericarp,planar,plurifoliat,pore,portion,puberulen,ruit,scar,sleeve,slit,small,sometimes,spaced,strong,strongly,sunligh,tem,tiny,twinin,twining,ud,unit,upper,variable,vary,widest,ympodial,zig-zag	abaxial,arrangement,bark,branch,branching,clavate,color,form,fruit,height,leaf,length,main,midvein,na,number,ovary,plant,pubescence,ray,seed,shape,tertiary,texture,unarmed,venation,width
436	wfo-0001029021	success	161	112	96	65	16	0.596	0.5-1,0.8-1,0.8-1.2,0.8-2.1,1-2,1-3.4,1-4,1.1-1.3,1.5-2,1.5-3,1.8-2,2,2-2.5,3,3.5,3/4,5.5-6,8-10,abaxial,absent,adaxial,age,along,anther,base,becoming,bi-lobed,black,branching,broadly,calyx,cm,conical,coriaceous,corolla,darker,decurrent,dendritic,densely,diameter,elliptic,filament,flattened,fleshy,flower,fruit,glabrous,globose,growth,lamina,lax,leaf,lenticular,lobe,lobed,long,long-triangular,loose,loosely,margin,minutely,mm,outline,ovary,ovate,pedicel,pericarp,petiole,pitted,pore,poricidal,pubescent,purple,reddish-brown,revolute,shiny,shrub,slit-like,sparsely,stem,stigma,strongly,style,surface,thin,time,tip,trichome,tube,vein,violet,way,wide,winged,x,young	1-1.5,3-6,abaxially,acute,adaxially,anthesi,apex,apical,appearing,axi,ba,bark,basal,berry,blade,caudate,deciduous,deflexed,denser,eaf,edicel,eed,ew,exserted,free,fruiting,glabrate,grey-brown,im.,impressed,inserted,later,lateral,lower,m.,monochasia,nflorescence,nodding,older,overtopping,pair,papillo,per,planar,plurifoliate,portion,prominently,raised,ruit,scar,scattered,secondary,shoot,simple,sleeve,stamen,ste,tapering,terminal,tiny,tub,ud,unit,woody,ympodial	color,form,height,im,inflorescence,length,na,papillose,peduncle,plant,pubescence,seed,shape,size,texture,width
437	wfo-0001029031	success	213	154	135	78	19	0.634	-11.4,-12.3,-8,.1-0.3,0-5,0.1-0.5,0.5,0.5-1.5,0.6-1.2,0.7-1.1,1-1.5,1-2.5,1-3,1-5,1-9.4,1.8-2.7,10,13.5,2-10.7,2-3,2-3.3,2-5,2.5-5.5,3-10,5-17,6-12,6-21,acuminate,acute,angle,anther,apart,apex,around,articulated,base,becoming,black,bluish,branched,brown,calyx,capitate,chartaceous,cm,corolla,cuneate,curved,cylindrical,deltate,densely,denser,diameter,edge,elliptic,elliptic-ovate,entire,erect,farinose,flattened,flower,forked,fruit,glabrescent,glabrous,globose,green,hair,held,immature,lateral,leaf,length,light,like,lobe,long,longitudinal,major,margin,midpoint,midvein,mm,oblong,obtuse,occasionally,opening,orange,outline,pedicel,peduncle,peltate,peltate-stellate,petiole,possibly,pseudoterminal,pubescence,pubescent,rarely,ray,reniform,ripening,rounded,rugulose,sessile,short-stalked,shrub,side,silvery,simple,slit,small,spaced,sparsely,stellate,stellate-pubescent,stem,stigma,straight,strongly,style,suborbicular,surface,tall,tip,tree,trichome,tube,unbranched,vein,white,whitish,x,yellow,yellowish	-3.6,.5-1.2,0.5-4,1-2,1-2.6,1.3-3.3,1.5-2.8,1.5-3.5,1.8-4,1/3,2.5-5.6,20-150,4-5-,4-7.5,abaxially,absent,accrescent,adaxiall,adaxially,ag,apexacute,apparently,axe,ba,berry,bilobe,blade,center,connivent,covering,directed,distally,eaf,eed,eglandula,eglandular,equal,filament,fleshy,frui,fruiting,fused,geminate,impressed,inserted,lanceolate,large,leaf-opposed,least,lower,many-foliate,nearly,nflorescence,orolla,paired,perfect,pore,porrect-stellate,prominent,pubescen,rachi,ruit,short,slightly,smaller,sometimes,somewhat,ste,subtending,tamen,tem,time,unarme,unit,usually,vary,wide,ympodial	abaxial,adaxial,age,arrangement,bilobed,branching,color,form,growth,height,inflorescence,number,ovary,plant,seed,shape,size,texture,unarmed
438	wfo-0001029047	success	168	86	68	100	18	0.405	.25,.5,0.1-0.5,0.5-1,0.7-1,0.7-3,1-1.2,1-4,1.25,2.5,3-5,3.6-8.5,5-20-flowered,6-7,9.5-19.6,anther,bark,base,beneath,broadly,calyx,campanulate,cm,corolla,dia,difoliate,elliptic,flower,geminate,glabrous,globose,green,herbarium,leaf,lobed,long,mm,much-branched,mustard,nearly,occasionally,ovate,ovoid-reniform,pale,pedicel,petiole,pubescent,reddish-brown,shape,shaped,shining,shrub,simple,slender,smooth,soft,somewhat,specimen,stem,strongly,tear-drop,trichome,uniseriate,unit,white,x,yellow,young	'',0-2,0.05-0.5,0.1-0.75,0.3-1.9,0.5-2,1,10-11,2.1-2.6,4-5,5-9,8365,``,across,acuminate,acute,amd,anisophyllou,anthesi,apex,arching,aspec,ba,back,bearing,beginning,berry,branch,brown,bud,deflexed,deltoid,differing,distinctly,eaf,edicel,eed,evenly,filament,filiform,flattened,free,fruiting,giving,glabrou,herb,impressed,inflorescenc,kruckoff,lateral,lenticellate,like,lobe,lon,lower,main,major,margin,markedly,middle,midrib,minor,minutely,nflorescence,older,opposite,orbicular,ovary,papillose,part,pically,pitted,pore,poricidal,portion,principal,prominent,reflexed,rounded,ruit,scar,shorter,smaller,spaced,sparsely,stigma,styl,style,surface,tall,tapering,thread-like,time,tip,tube,ud,vein,widest,woody,ympodial	anisophyllous,arrangement,branching,color,diameter,form,fruit,growth,height,inflorescence,length,midvein,plant,pubescence,seed,size,sympodial,texture
439	wfo-0001029048	success	162	121	98	64	23	0.605	.01,.5,/3,0.5-1,0.5-1.7,0.8-1,1,1-2,1-8,1.5-2,11,14,2,26,3-4,4-6,5-8,8-10,9-15,anther,arching,attenuate,base,beneath,bicellular,bright,broadly,calyx,cm,conical,corolla,decurrent,dia,elliptic,filament,filiform,flower,glabrate,glabrous,globose,golden,green,greenish-white,greenish-yellow,hanging,hispidulous,incrassate,leaf,like,live,lobe,lobed,long,margin,matte,minute,minutely,mm,obtuse,older,ovary,ovoid-reniform,pair,pale,papillose,pedicel,petiole,pitted,planar,poricidal,puberulent,ripe,rounded,shaped,sharply,shrub,slightly,small-capitate,somewhat,specimen,stem,stigma,straight,style,surface,tan,tear-drop,thread-like,tip,trichome,tube,uni-,unifoliate,vein,way,winged,x,young	.2,0.5,25,3-7,3.5-4,acuminate,angle,another,anthesi,apar,apex,apparent,basal,bearing,becoming,berry,blade,branch,eaf,edicel,eed,elongated,except,expanded,f,free,fruiting,geminate,greatly,greenish-yello,lateral,less,lower,main,middle,midrib,much,nflorescence,node,non-reproductive,obovoid,one,opposite,papillo,parallel,pore,portion,reflexed,right,ruit,scar,slender,spaced,tall,tapering,time,translucent,ud,unevenly,unit,widely,widest,ympodial,zig-zag	0.2,arrangement,branching,color,diameter,form,fruit,growth,height,inflorescence,length,midvein,na,number,peduncle,plant,primary,pubescence,seed,shape,size,texture,width
440	wfo-0001029053	success	275	146	126	149	20	0.458	.3,0.3–0.4,0.5–0.6,0.5–1.1,0.6–1.3,0.7–1.0,0.7–1.2,0.7–3.4,0.8–1.0,0.8–1.2,1.0–1.6,1.4–2.0,1.5–2.7,1.6–9.2,1.7–1.8,1/3–1/2,2.0–2.3,2.4–2.8,2.4–5.1,2.5,21,3.5,4.9,5.4–7.1,5–8,6.8–15.2,8.0–14.5,8.5–15.8,abaxially,across,acuminate,acute,adaxially,aequilateral,along,anther,apex,apiculate,attachment,attenuate,bark,basal,base,blade,borne,calyx,caudate,channeled,cm,corolla,densely,diameter,distinct,dry,entire,filiform,flattened-oval,flower,fruit,glabrous,glandular,glandular-pubescent,globose,hair,individually,interpetalar,lacking,lanceolate,layer,length,lobe,long,margin,markedly,mature,midvein,mm,moderately,nearly,notched,oblique,oblong,orange,ovate,pedicel,peduncle,petiole,point,porrect,probably,pubescence,pubescent,raised,red,rounded,semisucculent,sessile,short,short-stipitate,shrub,simple,slightly,sloughing,smooth,stellae,stellate,stellate-pubescent,stem,stigma,straight,style,surface,tip,tissue,transparent,truncate,tube,twice-branched,unbranched,vein,well-developed,white,yellow,yellow-ferruginous,yellow-tan,×	.04,.7,.9,0.1,0.2,0.2–0.6,0.3–0.7,0.4–0.8,0.7–1.1,0.7–1.3,0.7–1.7,1.1–1.3,1.3–2.0,1.5,1.5–2.5,1/2–2/3,1/3,2.0–2.8,2.1–2.4,2.1–3.8,3.5–7.2,4.5–6.2,5-merou,6.6,6–12,7.1–9.7,7–8,8,90°,accrescent,adnate,ag,alyx,anthesi,apart,apical,apparently,appearing,appressed,around,articulate,axe,ba,becoming,beneath,bent,berry,branch,broad,brochidodromous,bud,capitat,clinate,coat,congested,criss-cros,deciduous,deltoid,dentate,development,difoliate,directed,distal,distally,eaf,edge,eed,either,emerging,endocarp,erect,exocarp,extending,extra-axillary,fertile,filament,free,geminat,glossy,gradually,heterostylous,increasing,intact,internode,intersepalar,juic,lateral,less,lon,longer,lower,main,many,midpoint,midrib,minute,much,nflorescence,opaque,ove,overlapping,pattern,per,perforated,pore,portion,potentially,ray,remaining,revealing,rigid,row,ruit,seen,shorter,side,sinus,smoot,sometimes,soon,spaced,sparsely,splitting,spread,spreading,stamen,stipe,subopposite,suture,tamen,tem,thin,time,two,ud,unarmed,unit,upper,various,vary,weakly,well,wide,ympodial,young,±90°,±equal,±glabrous,–10	abaxial,adaxial,arrangement,branching,capitate,color,form,growth,height,inflorescence,leaf,na,number,ovary,plant,primary,seed,shape,size,texture
441	wfo-0001029055	invalid_json	169	125	93	76	32	0.55	0.4-1.5,1-2.6,1-4,1-5,1.6-3.5,1.8-3.5,14-50,2-3,2.2-3,2.5-8,4-10,4-6,4-7,5-24,5.5-9,6-14,8-9,9-22,acute,apical,apically,branched,calyx,cell,cm,connate,corolla,covering,cyme,dark,dehiscent,diameter,dichasial,dichasially,distal,ebracteate,elliptical,filament,flower,forked,generally,gland,green,green-white,half,herbaceous,interjected,introrse,lateral,leaf,leaflet,lobe,long,long-attenuate,longitudional,maturing,mm,monochasial,odd-pinnate,often,outline,ovate,ovoid,pedicel,peduncle,pentagonal,petiole,pilose,plant,poricidally,proximal,pubescent,purple,rotate,seed,short,short-stalked,size,slit,sometimes,stigma,straight,stripe,style,terminal,testal,thick,throughout,triangular,wall,wide,yellow,¼	1.7-2.2,2-1.,2-4,3,3-10,3-6,3-6-foliat,abaxially,acumen,acuminate,adaxially,apex,articulate,attenuate,base,cordate,covered,cuneate,decurrent,densely,digestion,diminishing,dorsally,eaf,edge,eed,elliptcal,emoval,enzyme,exceeding,first,flat,folded,globo,hair,hair-like,honeycomb,living,lon,longer,lower,lunat,make,mucilaginous,near,nflorescence,nther,oblique,orolla,pair,pattern,perennial,perfect,plan,rarely,reveal,ruit,second,sessile,seudostipule,short-petiolate,specimen,spreading,stamen,tal,tem,time,toward,tuber-bearing,type,typically,unit,vary,whit,widest,ympodial	'','hair-like,'type,2-11,[,],``,anther,arrangement,articulation,branching,characteristic,color,form,fruit,globose,growth,height,inflorescence,length,na,number,ovary,shape,stem,surface,texture,tube,value,white,{,}
442	wfo-0001029056	success	140	64	39	101	25	0.279	.5,0.3-0.5,1/3-1/2,3-5-lobed,3-5-rayed,3-6,6-10,7-10,across,anther,anthesi,blade,branched,broadly,calyx,capitate,cm,coarsely,dentate,dm,glabrous,glandular,hair,herb,irregularly,length,linear-lanceolate,long,mm,ovate,petiole,pinnately,prickly,scattered,sessile,stellate,stem,tube,white	-5,.2,0,0.7-1.0,4,5-9,6-8-flowere,acute,along,also,alyx,ample,annual,attenuate,basally,base,black,campanulate,cauline,central,consisting,densely,developing,dia,difoliate,divided,eaf,eed,elongated,erect,externall,externally,flanking,geminat,gland,green,intermixed,internod,invested,know,known,lacking,large,lobe,lon,lower,major,marking,midpoint,much,nflorescence,numerous,obtuse,occasional,often,one,orolla,present,prickle,purplish,ray,reduced,ruit,separated,sharply,short-stipitate,shorte,side,simple,slende,slender,somewhat,sparse,spreading,starlike,stellae,stellate-pubescent,strait,strongly,subulate,surface,swollen,tall,tamen,taprooted,terete,terminally,tightly,tigma,tip,tub,tyle,uniseriate,unit,upturned,vary,vein,vestiture,villous,yellow,ympodial	3-5,6-8-flowered,abaxial,adaxial,arrangement,branching,color,corolla,diam,diameter,flower,form,growth,height,inflorescence,internoda,leaf,ovary,plant,pubescence,shape,size,stigma,style,texture
443	wfo-0001029059	success	199	110	93	106	17	0.467	.5,0.1-0.5,0.1-1,0.2,0.5-1,1-1.5,1-4,1-6,1.2-3,1.3-1.7,1.5-2,1.5-2.8,10-19,3-3.5,3-6.5,3.5-6,3.5-8,4-10.5,5-15-flowered,7-9,along,anther,bark,base,berry,branched,calyx,clavate,cm,corolla,deep,deltoid,dense,densely,dia,difoliate,dirty,elliptic,extremely,flattened-reniform,geminate,glabrate,glabrous,globose,hispidulous,inflorescence,leaf,lobed,long,major,minor,minute,mm,nearly,occasionally,older,orange,orangish-yellow,orbiculate,ovary,partially,pedicel,petiole,pubescence,pubescent,purplish,ripe,shallowly,shape,shaped,shrub,simple,size,small,sparse,stem,stigma,style,tear-drop,tinge,tree,trichome,unicellular,uniseriate,unit,usually,variable,vein,waxy,white,x,yellowish-green,young	0.2-0.5,0.5,1-1.2,1-3,2.5,5,6-10,acute,anisophyllou,anthesi,apar,ape,apex,apiculae,apiculate,arising,beneath,bout,bud,closely,coiba,connivent,cordate,covered,cuneate,de,deflexed,differing,eaf,edicel,eed,ellipsoid,expanded,exserted,extending,filament,foetid,free,fruiting,greatly,impressed,incrassate,interpetalar,isla,lamina,lateral,lobe,lon,longest,lower,main,margin,member,membranous,middle,minutely,narrowly,nflorescence,oblique,often,one,opposite,pair,pale,paler,panama,papillo,papillose,pitted,planar,pointed,population,pore,poricidal,portion,prominent,reddish-gre,rest,rounded,ruit,scar,sinus,slender,somewhat,soon,spaced,specimen,straight,surface,tall,tapering,terminal,thickened,ti,tightly,tip,triangular,tube,ud,underside,wide,widest,woody,yellowish,yellowish-tan,ympodial	abaxial,adaxial,anisophyllous,arrangement,branching,color,diameter,form,fruit,growth,height,length,plant,reddish-grey,seed,sympodial,texture
444	wfo-0001029065	success	202	134	107	95	27	0.53	0.5-1,0.5-1.5,0.5-4,1,1-2.5,1-3,1.5-2,1.5-2.5,10-20,2-15,2-2.5,2-3,3-6,3-7,4-7,4-8,5-10,5-15,5-7,7-10,8-20,abaxial,abaxially,acute,adaxial,adaxially,anther,apex,attenuate,base,brown,calyx,chartaceous,cm,connivent,cylindrical,dark,densely,diameter,extra-axillary,filament,flower,fruit,functionally,glabrous,glandular,globose,green,green-brown,hair,hermaphroditic,immature,leaf,light,like,lobe,lobed,male,many,margin,mature,midvein,mm,moderately,multicellular,nearly,netlike,obtuse,orange,ovary,ovate,pedicel,peduncle,per,petiole,pit,plant,porrect-stellate,pubescent,raised,ray,red,reniform,ridge,separated,side,simple,small,sparsely,stellate,stem,stigma,style,surface,tapering,triangular,tube,unbranched,uniseriate,unlobed,vein,vine,white,woody,x,yellow,young	0.2-0.4,0.5,0.5-1mm,1-2,1-5,1-6,1.,1.5-3,1/3,2,2-4,2-5,2-ranke,30-60,5,8,8-12,absent,accrescent,adaxiall,alyx,andromonoecious,apar,apical,armed,asymmetrical,axe,berry,beyond,blade,charteacous,contiguous,cordate,cut,difoliate,directed,discolorous,eaf,eed,either,em,exserted,flattened,frui,fruiting,geminate,generally,glabrou,gree,heteromorphic,introsel,leathery,less,long,long-styeld,lower,m.,major,merou,midpoint,midrib,multiseriate,narrowly,nflorescence,often,older,orolla,pair,pore,prickle,rachi,recurved,roselike,ruit,sessile,short-styled,sinus,slightly,spaced,stalk,stamen,staminate,straight,strongly,tamen,unarmed,unequa,unicellular,unit,usually,vary,way,wide,ympodial,¼	0-2,10,arrangement,bark,branch,branching,color,corolla,drying,form,growth,height,inflorescence,length,main,na,number,primary,pubescence,seed,shape,size,tertiary,texture,trichome,venation,width
445	wfo-0001029072	success	235	128	106	129	22	0.451	-2.5,0.1-0.4,0.5-2,0.8,0.8-1.5,1-1.2,1-25,1/3,2-7,2.2-2.5,2.2-3.2,2.5-3.5,2.5-4.5,3-20,3-8,3.5-6,5-10,5-7,7-15,8-20,8-27,abaxial,adaxial,anther,apparently,bark,base,berry,branched,bright,calyx,chartaceous,cm,connivent,cordate,cream,cuneate,dark,deltate,densely,diameter,dirty,discolorous,drying,dull,filament,flattened-reniform,flower,fruit,glabrous,green,green-brown,herb,lateral,leaf,length,lobe,lobed,long,lower,margin,marking,maturity,mauve,midvein,mm,moderately,multangulate,narrow-deltate,orange-brown,ovate,pair,pale,pedicel,peduncle,petiole,plant,poricidal,porrect,prickly,primary,ray,shrub,simple,sometimes,spherical,stellate-pubescent,stem,strongly,style,surface,tapering,terminal,tertiary,tip,trichome,tube,unarmed,upper,vein,venation,weakly,white,wide,yellow,young	-1/2,-15,.5,/6,0,0-2,0-20,0-4,0-8,0.2-0.3,0.2-0.4,0.3,0.4-0.9,0.5-3,0.7,00-200,1,1-1.5,1-3,1.5-2.5,1.5-2.6,1.5-3.2,1/4-1/2,1/4-1/3,12-19,2-10,2-5,2-8,2.5-3.8,20-50,3-10,3-5,3-50,3/,4-,4-10,4.2-6.5,4.5-9,5-50,5-9,5-merous,7-10,abaxially,acute,adaxially,alyx,ame,andromonoecious,angled,apar,apart,apex,apically,articulated,blade,broad-deltate,broadly,c.,clearly,conical,curved,distal,distance,eaf,eed,elongated,elongating,equal,erect,extending,flattened,free,fruiting,gently,gra,hermaphrodite,heterostylous,infructescence,least,long-styled,longer,longitudinal,lowermost,mature,midpoint,nflorescence,obtu,older,one,open,orolla,oung,pendent,pendulous,per,pericarp,plurifoliat,portion,prickl,prickle,raised,reflexed,ridge,rounded,ruit,scar,sessile,short-styled,side,smooth,spaced,sparsely,spreading,stalk,stalked,staminat,stellate,stout,straight,tamen,time,unit,variously,vary,visible,way,whitish,woody,ympodial	2.5,3/4,arrangement,branch,branching,color,corolla,form,gray,growth,height,inflorescence,main,na,number,ovary,pubescence,seed,shape,size,stigma,texture
446	wfo-0001029073	success	211	127	103	108	24	0.488	.5,0.3-1,0.5,0.5-1,0.6-2,1-1.5,1-2.5,1.1-1.5,10-16,2,2-3,2-4,3.5-9,4-5,4-6,5-6,6-9,7-10,8-14,acute,anther,awn-like,bark,base,beneath,berry,brown,calyx,chartaceous,cm,conical,corolla,cream,dark,darker,dense,densely,diameter,drying,elliptic,entire,filament,flattened,flower,glabrous,globose,growth,inflorescence,lanceolate,leaf,length,linear,lobe,lobed,margin,maturity,midvein,minutely,mm,narrowly,occasionally,orange,pair,pale,paler,papillose,pedicel,peduncle,petiole,poricidal,porrect,primary,pubescence,pubescent,purple,ray,reniform,reticulate,shallowly,shiny,shrub,simple,sinuate,slightly,sparsely,stellate,stem,stigma,style,surface,tan,tapering,thin,tip,trichome,truncate,tube,unarmed,unequally,vein,whitish,x,yellowish	.7,0.6-0.7,1-1.2,1-3,1.2-1.6,1.5-2,10-15,2/3,5-8,5-merous,abaxially,acuminate,adaxially,along,another,anthesi,apart,apex,armed,articulated,away,ba,basal,broad-based,cell,curved,difoliate,dimorphic,discolorous,eaf,eed,enlarged,equal,erect,except,exserted,four,free,frui,fruiting,geminat,golden,gre,hooked,internodal,interpetalar,lamina,lengthening,like,long,long-styled,lower,midpoint,mixture,multangulate,new,nflorescence,nodding,oblique,older,one,opposite,per,perfect,pericarp,planar,plurifoliate,pore,portion,prickle,prickly,rectangular,ruit,scar,sessile,short,short-stalked,shorter,slit,sometimes,somewhat,spaced,splitting,straight,strongly,styled,testal,three,ti,tissue,triangular,two,ud,underside,unequal,unisexual,unit,upper,upward,visible,wall,way,wide,woody,yellow,ympodial,zygomorphic,½	1.5,abaxial,adaxial,arrangement,branch,branching,color,form,fruit,grey,height,main,na,number,ovary,plant,seed,shape,size,tertiary,texture,venation,width,young
447	wfo-0001029074	success	174	111	88	86	23	0.506	0.2-1,0.3-0.8,0.5-1,0.5-1.2,0.7-0.8,1,1-1.2,1-1.5,1-2,1.4-1.8,1.5-2,1.5-4,11,2-4,2-7,3-6,3.5-5,5-6,5-7,anther,apparently,bark,base,berry,black,broadly,calyx,capitate,cm,conical,corolla,cuneate,densely,diameter,entire,filament,flattened,flower,glabrous,globose,green,grey,growth,herb,immature,leaf,lobe,margin,minutely,mm,ovary,ovate,pair,pale,pedicel,peduncle,petiole,pitted,poricidal,primary,pubescent,pulp,purplish,ray,reniform,ripening,sagittate,simple,sparsely,stellate,stem,stigma,style,subshrub,surface,thin,tip,triangular,trichome,truncate,tube,uniformly,vein,watery,white,x,yellow,yellowish	.1,.5,0,0.3-0.4,0.7-0.95,1-,2-2.3,2-5,3-,abaxially,absent,acute,adaxially,age,almost,along,anthesi,apart,apex,appearing,articulation,basa,deflexed,denser,eaf,eed,ellipsoid,exerted,expanding,free,frui,fruiting,glabrescen,internodal,lacking,lengthening,less,lignescent,like,lobed,longest,lower,markedly,midpoint,midvein,mixture,new,nflorescence,obscuring,often,older,opposite,papillat,per,perfect,pericarp,petal,planar,plurifoliat,pore,portion,prominent,reflexed,rounded,ruit,scar,scattered,sessile,slit,small,somewhat,stalk,stalked,stellate-pubescent,strongly,swollen,tub,ud,underside,uniseriate,unit,usually,way,woody,ympodial,¾	0.5,abaxial,adaxial,arrangement,branching,color,form,fruit,glabrescent,height,inflorescence,length,na,number,papillate,plant,pubescence,seed,shape,size,texture,width,young
448	wfo-0001029075	success	217	147	125	92	22	0.576	.3,.5,0.8-1.5,1-2,10-20,2-5,2.5-3,30-60,4-10,4-14,4-7,4.5-6.5,5-10,5-8,6-12,7-17,7-9,8-9,abaxially,abruptly,acumen,adaxially,along,anther,axillary,berry,broadly,brown,brownish,bud,canescent,cell,ciliate,cm,condition,corolla,covering,dark,densely,diameter,distal,dot,drying,elliptic-lanceolate,especially,filament,flecked,flower,forked,fresh,fruit,generally,glabrescent,glabrous,glandular-pilose,glandular-puberulent,gray-green,green,green-white,greenish,hair,hair-like,half,herb,lanceolate,lateral,leaf,lengthening,light,like,lobe,long,long-spatulate,make,margin,midrib,minutely,mm,mucilaginous,narrowed,narrowly,odd-pinnate,ovoid,pedicel,peduncle,pentagonal,petal,petiole,plant,pore,poricidal,puberulent,pubescent,purple,seed,short,size,slit,small,sometimes,stem,stigma,style,subquadrate,substellate,subtending,terminal,testal,thick,throughout,tip,tube,unwinged,upper,usually,wall,wet,white,whitish,whitish-gray,wide,x,yellow,yellow-green,yellowish-white	0-3,0-8,0.5-0.8,0.8-1.2,1-10,1-2.5,1-3,2-4,2.7-4.2,4-5,5-8.5,5-merou,ag,alyx,apart,apex,apparently,articulated,attenuate-acuminate,atypically,axe,base,blade,clavifor,connivent,cuneate,decreasing,decurrent,digestion,dorsally,eaf,edge,eed,end,enzyme,erect,erect-ascendin,etota,exceeding,flat,folded,geminat,glabrou,gradually,greatly,homostylous,honeycomb-shaped,interjected,larger,leaflet,living,lower,middl,nflorescence,orbicular,orne,orolla,ovate,pair,perfect,petiolulate,petiolule,plurifoliate,pointed,rachi,removed,rounded,ruit,sec,sessile,seudostipule,singly,slightly,spaced,specimen,stamen,ste,stolo,straight,subequal,subobtuse,tall,tamen,tem,toward,tri-,tuber,typically,unit,vary,woody,ympodial	abaxial,adaxial,age,arrangement,branching,calyx,claviform,color,form,growth,height,inflorescence,length,na,ovary,pseudostipule,pubescence,shape,staman,surface,texture,width
449	wfo-0001029084	success	192	101	84	108	17	0.438	.5,0.8-2,0.8-2.1,1-2,1.1-2.2,1.5-2.5,10-50,2-3.5,2-5,3-6,3.5-7.5,3.5-8,4-17,4-7,4.5-10,4.5-6.5,5,5-7,6-13,7-9,8-23,anther,articulated,berry,blade,brownish,chartaceous,cm,condition,conical,connivent,corolla,diameter,drying,flower,forked,fresh,fruit,glabrous,green,greenish,herb,lanceolate,lateral,leaf,leaflet,light,lilac,lobe,long,middle,minute,mm,moniliform,mottled,mucilaginous,odd-pinnate,ovoid,pedicel,peduncle,petiole,pilose,plant,poricidal,proximal,pubescent,purple,ripe,rotate,seed,size,sparsely,stigma,style,subglabrous,terminal,tip,tube,tuber,wet,whitish,wide,x,yellow	1-10,1-3,1-4,2-4,5-merou,abaxially,absent,acumen,acuminate,adaxially,ag,along,alyx,apart,apex,apparently,arranged,axe,axillary,base,bead,bud,capitat,cell,ciliate,covering,darker,decreasing,digestion,distal,dorsally,eaf,edge,eed,enzyme,especially,exceeding,filament,flat,folded,geminat,generally,glabrou,gradually,green-white,hair-like,half,homostylous,honeycomb-shaped,interjected,interpetalar,larger,lengthening,like,living,lon,lower,make,margin,midrib,minutely,multiple,narrow,necklace,nflorescence,obtuse,orolla,ovate-lanceolate,pair,perfect,petiolule,plurifoliate,pore,puberulent,ray,removed,ruit,secondary,semierec,seudostipule,slit,spaced,specimen,stamen,stolon,subequal,subglabrou,subsessile,subtending,symmetrical,tall,tamen,tem,testal,thick,thir,throughout,tissue,toward,tri-,typically,unit,unwinged,usually,vary,wall,wing,ympodial	arrangement,branching,calyx,capitate,color,form,growth,height,inflorescence,length,ovary,pseudostipule,shape,stem,surface,texture,third
450	wfo-0001029087	success	226	109	91	135	18	0.403	0-0.5,0-14,0.3-0.8,0.5-0.75,0.5-2.3,0.7-0.9,0.7-2.2,0.9-8,1.4-1.7,1.5-1.75,10-30,11-20,2-3,2-7,2.5-4,2.7-2.9,3-7,3.5-5.5,6-7,6.5-13,8-12,acicular,adult,anther,apart,articulated,attenuate,base,branchlet,calyx,chartaceous,cm,cylindrical,dark,deltate,densely,diameter,dm,extra-axillary,finely,flattened,fruit,glabrous,gland-tipped,globose,green,grey,hair,half,herbaceous,inflorescence,juvenile,lanceolate,leaf,length,mm,moderately,ovate,pale,pedicel,peduncle,pendent,per,petiole,plant,prickle,proximal,pseudo-racemose,purple,resprouter,reticulate,rhizomatous,rotate,rotate-stellate,rusty,short,spaced,sparsely,stellate,stellate-pubescent,stigma,straight,streak,style,surface,tube,unarmed,unbranched,white,x,yellow	%,.05,.5,0-0.1,0-2,0-6,0-7,0.1-2,0.2-0.6,0.25-0.4,0.3-0.4,0.3-0.45,0.3-0.5,0.35-0.45,0.5-1,0.9-1.7,1-1.5,1-3,1-3.5,1-4,1-6,1.3-1.6,16-20,2-,2-locular,3,3-5,3-8,3-foliate,4.5-8,4.5-8.5,5-15,5-merou,6-8,7-10.5,7-8,7-9,8-20,8-30,8-9,9-15,abaxially,absen,absent,accrescent,across,acute,adaxially,alyx,ample,andromonoecious,anvil-shape,apex,axe,ba,blade,broadly,capitat,connivent,cross-section,deeply,directed,distall,distributed,eaf,eed,eglandular,entire,erect,exocarp,filament,finger,flower,fruiting,functional,geminat,grey-green,heterostylous,interpetalar,juicy,lamina,lateral,less,lobe,lobed,long,longer,lower,margin,mature,mesocarp,mid-point,midpoint,midvein,minute,moist,narrowly,nflorescence,oblique,obtuse,orolla,pair,part,placenta,pore,porrect,present,rachi,ray,ruit,sessile,shallowly,simple,slightly,stalk,stalked,stellae,tal,tamen,tem,thick,throughout,time,tissu,tissue,transparent,triangular,unarme,unit,upper,vary,weakly,wide,yellowish,ympodial	abaxial,adaxial,capitate,color,colour,corolla,form,growth,height,na,number,ovary,pubescence,seed,shape,size,stem,texture
451	wfo-0001029088	success	149	96	79	70	17	0.53	.3,0.1,0.6–3.2,1.3–4.5,15–25,1–1.5,1–1.6,1–3,2.5–4.2,25–30,2–2.5,3.5–7,3.5–8,3–16,4–8,<,acuminate,anther,apex,base,bronze-brown,calyx,capitate,cm,cordate,cylindrical,diameter,entire,flattened,flower,fruit,glabrous,greenish-brown,hair,half,herbaceous,immature,leaf,lenticular,light,lower,margin,mature,membranous,minutely,mm,moderately,near,obtuse,ovoid-rhomboid,papillose,pedicel,peduncle,petiole,pubescent,purplish,reddish-brown,revolute,rounded,rugose,sand-punctate,shortly,simple,slender,slightly,somewhat,sparsely,stellate,stigma,stout,straight,style,surface,tip,tube,unbranched,vine,white,x	.2,0.9–1.5,1.5–2,1.5–3,1–1.2,2-lobe,2.5–20,2–3,5,5-merous,5–8,6-10,abaxially,accrescent,acute,adaxially,alyx,apar,apicall,axe,berry,blade,c.,ciliate,climbing,densely,eaf,eed,emarginate,extra-axillary,filament,flavor,fleshy,fragrant,fruiting,glabrou,groun,heavy,juicy,lanceolate,lobe,long,m.,narrowly,nflorescence,nternode,orolla,palmate,perfec,plurifoliat,primary,rachi,ruit,scent,spaced,strongly,swee,sweet,tamen,tem,terrestrial,truncate,truncate-acuminat,unit,vary,vein,venation,wider,ympodial,–7	2-lobed,arrangement,color,corolla,form,growth,height,inflorescence,length,na,ovary,plant,seed,shape,size,stem,texture
452	wfo-0001029089	success	177	100	74	103	26	0.418	0.5-0.6,0.8-1,1,1-1.5,1.5-2,1.5-6,10-25,4.5-5,5-10,5-20-flowered,5-9,6-7,anther,bark,berry,bilobed,branched,calyx,campanulate,caniculate,cm,corolla,densely,dia,difoliate,elliptic,filament,flattened-reniform,furcate,glabrous,globose,golden,green,leaf,lobe,lobed,minutely,mm,occasionally,ovary,papillose,pedicel,petiole,pinkish,pitted,pubescent,purplish,reddish-grey,resinous,rounded-deltoid,shaped,shiny,shrub,simple,size,small,smooth,stem,stigma,straight,style,surface,tan,tapering,tear-drop,tree,trichome,tube,uniseriate,unit,usually,white,x,young	.5,.75,/4,0.1-0.25,0.5-1,0.8-1.2,1/2,2.5-3.5,5-6,8-9,abrupt,acute,along,anthesi,apart,apex,apiculate,axil,ba,base,beginning,beneath,bud,closely,completely,covered,covering,cracking,dark,decurrent,deflexed,differing,drying,eaf,edicel,eed,either,enclosed,entire,erect,expand,exserted,free,fruiting,geminat,glabrou,impressed,incrassate,inflorescenc,lamina,later,lateral,like,lon,long,lower,main,major,margin,material,member,middle,minor,nflorescence,obovoid,older,one,opposite,otherwise,overlapping,pair,papillo,part,peeling,persistent,planar,pore,poricidal,portion,primary,prominent,resinou,rounded,ruit,scar,secretion,slightly,somewhat,spaced,still,tall,tip,tub,ud,underside,varnish,varnished,vein,way,widening,widest,woody,ympodial	0.75,abaxial,adaxial,arrangement,branching,color,diameter,flower,form,fruit,geminate,growth,height,inflorescence,length,na,number,peduncle,plant,pubescence,ray,seed,shape,sympodial,texture,width
453	wfo-0001029091	success	212	132	91	121	41	0.429	-4,-4.5,1-2,1.5-,1.5-2,10,10-20,15-40,2-2.5,2-3,2.5-,3-4,4,7-8,anther,aromatic,base,bluntly,broadly,buff,calyx,campanulate,capitate,cm,corolla,cuneate,cyme,dia,discoidal,elliptic,filament,flower,flushed,fork,forked,glandular,globular,grey,intense,irregular,irregularly,larger,lasting,lavender,leaf,light,lobe,long,minutely,mm,oblong,obovate,ochre-yellow,ovate,overlain,ovoid,pale,pattern,pedicel,pedicellate,peduncle,pentagonal,petiole,poricidal,pubescent,reddish-purple,reticulate-concentric,ridge,ridged,several,shrub,sigmoid,simple,slender,slightly,soft,soft-wooded,sparsely,speckled,stellate-rotate,stem,stigma,style,succulent,surface,tip,transverse,triangular,violet-purple,x,year	-1,-15,0.3-,0.5-0.8,0.5-1,1,1-10,10-toothed,170-210,2-12,20-30,3,3-,3-11-lobed,46/1,5,5-7,635/1,acuminate,acute,age,apex,appearing,articulated,articulation,aspect,axil,ba,becoming,berry,blunt,brownish,cell,clonal,close,colour,common,conspicuous,cut,dark,deeply,develop,developed,downward,eed,effect,ellipsoid,emarginated,erect,exceeding,exerted,flattened,floral,fresh,fruiting,general,giving,globose,gree,growing,hair,half,interacuminal,juvenile,lacking,later,lateral,lavende,lengthening,line,linear,linear-lanceolate,long-triangular,lower,may,mid-vein,mineral,narrowly,nflorescence,obscure,occasionally,ower,petiol,petiolate,plurifoliat,point,pore,rachi,raised,readily,relatively,rh,ripe,rounded,ruit,scarcely,separate,shallowly,shed,shortly,sinus,slit,soon,stone,straggly,subulate,swollen,tall,tissue,toward,tub,ud,unit,upper,usually,violet,well,winged,without,woody,ympodial	abaxial,adaxial,arrangement,bark,branch,branching,color,diameter,drying,form,fruit,green,growth,height,history,inflorescence,length,life,main,margin,midvein,na,number,ovary,plant,plurifoliate,primary,pubescence,ray,seed,shape,size,tertiary,texture,trichome,tube,unarmed,vein,venation,width,young
454	wfo-0001029101	success	233	139	115	118	24	0.494	-15,.5,0-2,0.1-0.4,0.4-1.5,1-3,1.3-2,1.4-2.2,1.8-3,10-14,2.5-3.5,2.5-6,2.8-3.3,3-,3-4,4-12,5-,5-6,5-7,5-8,5-9,7-13,abaxial,adaxial,anther,apex,apparently,bark,base,berry,branched,broad-deltate,brown-green,calyx,cell,chartaceous,cm,concolorous,connivent,cream,cuneate,dark,darker,deltate,diameter,discolorous,drying,dull,elliptic,erect,filament,flattened-reniform,flower,fruit,glabrescent,glabrous,green,lateral,leaf,length,lobe,lobed,long,margin,marking,maturity,mauve,midvein,mm,moderately,obovate,obtuse,orange-brown,outline,ovate,pair,pale,pedicel,peduncle,petiole,pit,plant,poricidal,porrect,prickly,primary,raised,rarely,ray,sessile,shrub,simple,small,smooth,sometimes,sparsely,spherical,spreading,stalked,stellate-pubescent,stem,style,surface,tapering,tertiary,tip,trichome,tube,variously,vein,venation,wide,yellow,yellow-green,young	-3,/3,/4,0-100,0-20,0-5,0-8,0.1,0.1-0.5,0.1-0.7,0.1-1,0.2,0.5-1,0.7-,0.8-3.5,00-200,1,1-1.5,1-4,1-8,1.3-2.6,1.5-2,1.5-2.5,1.7,1/5-1/4,10-20,2-,2-20,2-6,2/3-3/4,3-10,3-7,30-100,4-7,5-20,5-merous,5.5-8,6-8,8-15,abaxially,acute,almost,always,alyx,andromonoecious,apar,apart,apically,articulated,blade,distal,distance,eaf,eed,elongating,equal,extending,flattened,free,fruiting,green-brow,hermaphrodite,heterostylous,infructescence,lengt,like,lon,long-styled,longer,lower,lowermost,mature,midpoint,multangulate,narrow-deltate,nflorescence,oblong,often,older,one,open,orolla,oung,pendulous,per,pericarp,plurifoliat,portion,present,prickl,prickle,reduced,reflexed,rounde,rounded,ruit,scar,secondary,short-styled,side,spaced,stalk,staminat,stellate,straight,suborbicular,tamen,terete,thick,time,unit,vary,visible,way,well-developed,woody,yellow-orange,ympodial	arrangement,branch,branching,color,corolla,form,green-brown,growth,height,history,inflorescence,life,main,na,number,ovary,perennial,pubescence,seed,shape,size,stigma,texture,unarmed
455	wfo-0001029106	success	200	135	107	93	28	0.535	.5,/3,0-5,0-6,0.2-0.4,0.2-1,0.25-0.7,0.5-0.9,0.9-1.2,1.5-2,2-4,2-5.5,2-8,2.2-3,3-3.5,3-4,4-8,5-14,acute,anther,apically,apparently,bark,base,berry,branched,calyx,cell,cm,concolorous,cuneate,curved,deltate,densely,diameter,discolorous,drying,elliptic,filament,flattened-reniform,flower,fruit,glabrescent,glabrous,lateral,leaf,length,light,lobe,lobed,long,lower,margin,maturity,mauve,membranous,midvein,mm,obtuse,orange,orange-brown,outline,ovate,pair,pale,pedicel,peduncle,petiole,pit,poricidal,porrect,prickle,prickly,primary,raised,ray,red,scandent,sessile,shiny,shrub,simple,size,slender,small,smooth,sparsely,spherical,spreading,stellate-pubescent,stem,style,subentire,surface,tapering,tertiary,tip,trichome,tube,vein,venation,way,weakly,white,wide,yellow-orange,yellowish-green	-6,.1,0,0-0.3,0-10,0-2,0-20,0.1,0.5,0.5-0.8,0.5-1,0.5-2.5,1-1.6,1-2,1-5,1.5-1.8,1.5-3.5,1/4,1/5-1/4,2-3.5,2-6,2/,3-25,4-6,5-8,5-merous,6-8,abaxially,acuminat,alyx,ame,apar,apart,apex,appearing,articulated,blade,c.,distance,eaf,eed,elongating,equal,erect,extending,eye,flattened,free,fruiting,gently,infructescence,lon,longer,mature,midpoint,naked,nflorescence,older,one,open,orange-brow,orbicular,orolla,oung,pendulous,per,perfec,pericarp,plurifoliat,portion,prickl,reflexed,rounded,scar,shallow,shorter,side,sometimes,spaced,stalk,stalked,stellate,straight,tamen,terete,time,uit,unit,variously,vary,visible,woody,ympodial	2/3,abaxial,acuminate,adaxial,arrangement,branch,branching,color,corolla,form,growth,height,history,inflorescence,life,main,na,number,ovary,perennial,plant,pubescence,seed,shape,stigma,texture,unarmed,young
456	wfo-0001029112	success	190	106	84	106	22	0.442	0.9-1.7,1-2,1.4-2.5,10-17,10-21,2-3.5,2.5-4.5,2.6-3,2.7-5.7,20,3-7,3.5-4.5,3.5-7,5,5-8,6.5-5.5,9.5-13,abaxially,acuminate,adaxially,anther,axillary,brownish,bud,chartaceous,cm,condition,conical,corolla,densely,diameter,dorsally,drying,edge,elliptic-lanceolate,filament,flat,flower,folded,forked,fresh,fruit,glabrous,green,greenish,herb,lanceolate,leaf,light,lobe,long,minute,mm,moniliform,mottled,mucilaginous,odd-pinnate,ovate,ovoid,pale,pedicel,peduncle,petiole,plant,poricidal,pubescent,purple,ripe,rotate,seed,size,stigma,style,subtending,terminal,tip,tube,tuber,violet,wet,whitish,wide,x,yellow	0-2,0.5,1-10,1-3,1-4,1.5-1.8,1.5-2,2.7-3.5,2.7-4.2,3-4,3-5,3-6,5-merou,acumen,ag,along,alyx,apart,apex,apparently,arranged,articulated,axe,base,bead,berry,blade,capitat,cell,ciliate,connivent,covering,decreasing,digestion,distal,eaf,eed,enzyme,equal,especially,exceeding,geminat,generally,glabrou,gradually,green-white,hair,hair-like,half,homostylous,honeycomb-shaped,interjected,larger,lateral,leaflet,lengthening,like,living,lower,make,margin,middle,multiple,narrow,necklace,nflorescence,obtuse,orolla,pair,perfect,petiolule,plurifoliate,pore,present,pubescen,ray,removed,ruit,secondary,semierec,seudostipule,slightly,slit,spaced,specimen,stamen,ste,stolon,subequal,symmetrical,tall,tamen,tem,testal,thick,thir,throughout,toward,tri-,typically,unit,usually,vary,wall,wing,ympodial	arrangement,branching,calyx,capitate,color,form,growth,height,history,inflorescence,length,life,na,ovary,perennial,pseudostipule,pubescence,shape,staman,stem,surface,texture
457	wfo-0001029120	success	168	123	91	77	32	0.542	.5,.75,0.1-0.5,0.5-1.5,0.7-1,1-1.5,1.1-1.5,1.1-2,2.5-3.5,2.6-7,3-3.5,5-10-flowered,5-8,6-8,6.5-16.5,abrupt,acute,anther,bark,basal,base,beneath,bullate,calyx,cm,corolla,dark,decurrent,densely,dia,drying,erose,especially,f,filament,glabrous,golden,greenish-brown,hirsute,larger,leaf,like,lobe,lobed,long,long-triangular,main,margin,minutely,mm,narrower,narrowly,nearly,ovary,ovate,pair,pale,paler,pedicel,peduncle,petiole,prominently,pubescent,raised,shaped,shrub,simple,slightly,sparsely,stem,stigma,straight,style,surface,tapering,tear-drop,thickened,trichome,tube,unbranched,unifoliate,uniseriate,vein,venation,white,wide,widening,x,yellow,yellow-green,young	.05,/2,8511,acuminate,anthesi,apart,apex,beginning,black,bud,cell,deflexed,difoliate,dry,eaf,edicel,eed,epidermi,evenly,fide,fleshy,free,geminat,globose,inflorescenc,infloresence,internodal,know,known,lanceolate,large,later,lateral,lehmann,lon,lower,middle,midrib,minor,narrow,nflorescence,occasionally,often,older,opposite,outer,papillose,peduncl,petaloid,point,pore,poricidal,portion,present,proximal,reproductive,rest,ruit,scar,scattered,slender,spaced,specimen,speckle,sympodial,tall,terminal,tip,tub,ud,unit,upper,urceolate,way,white-papillo,widest,ympodial	abaxial,adaxial,arrangement,branch,branching,color,decument,diameter,flower,form,fruit,growth,height,history,inflorescence,length,life,midvein,na,number,perennial,plant,primary,pubescence,seed,shape,size,tertiary,texture,unarmed,white-papillose,width
458	wfo-0001029121	success	161	89	70	91	19	0.435	0.2-2,1-5,1.1-3.9,1.2-2.5,15-30,2-13,2-3,2-3-celled,3.8-11,4-10,4-5.5,4.5-10.0,5-20,5-8,9-33,acute,blue,branched,calyx,cm,conical,connate,corolla,cyme,deep,diameter,dichasial,dichasially,distal,ebracteate,elliptical,forked,generally,glabrous,green,green-white,hair,half,herbaceous,lateral,leaf,leaflet,lobe,long,medium,mm,monochasial,narrowly,odd-pinnate,ovate,ovoid,pair,pedicel,peduncle,perennial,petiole,plant,purple,rotate,scattered,seed,short,short-attenuate,size,stigma,straight,style,terminal,wide,yellow	-6,0,0-2,1-4,1.2-3.3,10,2-,2-10,3-5,3-6-foliat,3.6-9,8-16,abaxiall,abaxially,acumen,acuminate,adaxially,apex,apical,apically,articulate,attenuate,base,cell,commonly,covering,cuneate,dehiscent,digestion,diminishing,dorsally,eaf,edge,eed,emoval,enzyme,exceeding,filament,flat,flower,folded,globo,gradually,hair-like,honeycomb,interjected,introrse,living,lon,lower,lunat,make,maturing,mucilaginous,nflorescence,nther,oblique,obtuse,often,orolla,pattern,perfect,petiolule,plan,poricidally,proximal,rarely,reveal,rounded,ruit,sessile,seudostipule,slit,specimen,stamen,subequal,tal,tem,testal,thick,throughou,throughout,tip,toward,tuber-bearing,typically,unit,vary,wall,ympodial,¼	2-6,anther,arrangement,branching,color,form,fruit,globose,growth,height,history,inflorescence,length,life,na,ovary,shape,stem,texture
459	wfo-0001029125	success	197	104	74	123	30	0.376	0.5,abaxial,acuminate,acute,adaxial,anther,anthesi,apex,appressed,attenuate,base,berry,black,brownish,calyx,central,cm,concave-reniform,corolla,cuneate,deltate,densely,diameter,ellipsoid,entire,fruit,glabrous,globose,green,herb,internodal,lateral,leaf,long,margin,maturity,minutely,mm,orange,ovary,ovate-lanceolate,pale,papillate,pedicel,peduncle,petiole,plant,pubescent,purple,purplish,ridged,ripe,seed,shiny,simple,small,sparsely,spreading,star,stellate,stem,stigma,straight,style,subshrub,surface,terete,trichome,turning,uniseriate,white,wide,woody,yellow	.0–3.5,.1,.1–1.4,.2,.4,.5–2.0,.6,0.5–0.6,0.5–1.0,0.8–0.9,0.9,1,1.0–1.2,1.0–1.5,1.0–4.0,1.5–2.0,1.5–3.0,1.7-,1.8–3.5,1–2-celled,2.5–12.0,2/3,20–100,2–3-celled,2–4,3.0–3.4,3.5–4,35–45,3–5,3–5-celled,4–8,5-merous,5–6,6,6–7,abaxially,adaxially,age,along,apar,apparently,arising,articulated,ba,beyond,branching,cell,closely,cone,conical,delicate,difoliate,eaf,eed,end,especially,exerted,filament,flower,free,fruiting,geminat,growt,hilum,later,lengthening,like,live,lobe,lobed,lon,lower,maximum,narrower,nearly,nflorescence,oblique,occasionally,often,one,outline,pair,pentagonal,per,perfect,place,pore,poricidal,portion,positioned,primary,purple-tinged,reflexe,reflexed,ruit,scar,scattered,shorter,single,slightly,slit,spaced,stemmed,stone,strongly,sub-lateral,tall,tem,testal,tinged,tip,toward,traingular,tube,ud,unequal,unit,usually,vein,whitewith,ympodial,young,¼	0.2,0.4,0.5-0.6,0.5-1.0,1-2-celled,1.0-1.5,1.0-4.0,1.1,1.2,1.5-3.0,1.7-3.4,2-4,2.5-12.0,20-100,3.5-4,5-6,6-7,color,form,growth,height,history,inflorescence,length,life,pubescence,shape,size,texture,triangular
460	wfo-0001029138	success	170	96	75	95	21	0.441	%,0.15-0.3,0.5-0.9,1-2.5,1-5,1.7-4,2-locular,2.4-5.5,2.5-3.5,20-30,3-8,3.5-4.5,3.5-6.7,4-6,6-10,6-6.5,65-115,7-10,acicular,adaxially,anther,armed,broad-based,broadly,brown,calyx,chartaceous,cm,cylindrical,deltate,densely,diameter,directed,distally,flower,fruit,glabrous,green,grey-green,inflorescence,lamina,length,lobe,longer,mid-point,minute,mm,oblate,ovate,pedicel,peduncle,perennial,petiole,prickle,prostrate,pseudo-racemose,purple,rhizomatous,rotate,rusty,simple,sparsely,stellate-pubescent,stem,straight,style,thick,time,tube,unbranched,unknown,wide,x,yellow,yellowish	0,0-0.1,0-0.6,0-1.5,0-5,0.25-0.5,0.6-0.7,0.6-0.8,0.6-1.1,0.8-1.5,0.9-1.2,1-1.5,1-1.8,1-2,1.6-2.1,2-foliate,20-100,3-4,3-80,5-8,5-merou,6-8,7-8,abaxially,absen,absent,accrescent,acute,adaxiall,alyx,apart,apex,apparently,articulated,axe,ba,base,blade,cuneate,d.,distall,distributed,dult,eaf,eed,eglandular,enclosing,entire,extra-axillary,finger,fruiting,functional,geminat,glabrou,gland-tipped,hair,juic,lateral,lon,long,lower,margin,markedly,mature,mesocarp,midpoint,midvein,moist,nflorescence,oblique,obtuse,orolla,part,per,pore,porrect,present,ray,ruit,short,shrub,spaced,stage,stalk,stellae,tal,tamen,thicker,thicknes,throughout,unit,unknow,uvenile,vary,ympodial	abaxial,adaxial,arrangement,branching,color,corolla,form,growth,height,history,leaf,life,ovary,plant,pubescence,seed,shape,size,surface,texture,width
461	wfo-0001029150	success	177	106	84	93	22	0.475	0.3,0.3-0.5,0.3–0.5,0.5–1.1,0.8–1,0.8–1.5,0.8–3.5,1.2–1.5,1.5,15,1–1.5,1–11,1–5,1–6,2.5–3,2.5–5,2.5–8,3–10,9–12,adaxially,anther,apiculate,base,branched,calyx,cm,color,conical,cylindrical,delicate,diameter,ellipsoidal,elliptical,enlarged,entire,extra-axillary,flower,fruit,glabrous,leaf,light,long,margin,membranaceous,midvein,minutely,mm,moderately,nearly,oblique,opposed,ovate,pedicel,peduncle,petiole,pubescent,rarely,rounded,rounded-deltoid,rugose,sand-punctate,shortly,simple,slender,slightly,small,spaced,sparsely,stellate,stem,stigma,style,surface,tan,teardrop-shaped,tip,trichome,truncate,tube,vein,vine,white,woody,x	.5,0.8-1,1.5–2,1.5–2.2,1–2,2–10,2–2.5,2–3,3-5,3–4,3–50,5-merous,6,7–8,8-shaped,abaxially,accrescent,across,acute,adaxiall,alyx,apar,apex,apicall,apically,attenuate,axe,berry,blade,c.,canopy,capitat,ciliate,climbing,cros,distant,dried,eaf,eed,except,filament,flattened,fleshy,flush,fruiting,glabrou,inconspicuous,lamina,lanceolate,larger,living,lobe,lon,lower,m.,material,mor,nflorescence,nternode,older,orolla,pair,pale,perfec,pinkish-white,pinnate,plurifoliat,pointed,rachi,reaching,ruit,scar,secondary,section,side,somewhat,specimen,strong,tamen,tem,thick,thickened,time,translucent,tree,understory,unit,vary,vegetation,venation,wide,wiry,ympodial	abaxial,apart,branching,capitate,corolla,form,growth,height,history,inflorescence,length,life,na,ovary,plant,plurifoliate,pubescence,seed,shape,size,texture,young
462	wfo-0001029151	success	197	110	87	110	23	0.442	-10,0.2-0.6,0.25-0.5,0.5-1,1-1.5,1-2,1-2.5,1-5,1-6,1.5-2,1.5-6,10-15,15-20,2-15,2-2.5,2-4,3.5-5,4-10,4.5-5,5-10,5-8,8-10,8-15,abaxially,acute,adaxial,adaxially,annual,anther,apart,armed,base,brown,calyx,chartaceous,cm,connivent,cylindrical,dark,diameter,elliptic,entire,forked,fruit,glabrous,globose,green,hair,herb,lateral,leaf,lobe,long,loosely,main,margin,minutely,mm,moderately,narrowly,oblong,obtuse,ovate,pedicel,peduncle,petiole,purple,rarely,reniform,reticulate,rounded,silvery,sparsely,stellate,stem,stigma,style,subcordate,surface,truncate,tube,unbranched,undulate,vein,white,x,yellow	0-0.5,0.1-0.3,1.5-3,2-3,2-6,2-8,5,5-7,6-10,7-10,7-9,8,abundantly,accrescent,acicular,acro,acumen,apex,apparently,articulated,axe,ba,blade,capitat,close,completely,cone,covered,covering,curved,deflexed,densely,developed,difoliate,directed,discolorous,distall,downward,eaf,eed,eglandular,equal,filament,flattened,flower,frui,fruiting,geminat,held,high,interpetalar,juic,juvenile,larger,leaf-opposed,like,lon,lower,markedly,mesocarp,midpoint,midrib,minute,moist,multangulate,nearly,nflorescence,oblique,orolla,outside,pale,perfect,pore,porrect,prickle,prickly,probably,pubescent,rachi,ray,ruit,scarcely,shallow,shorter,side,simple,small,spaced,sparse,sparser,spiny,sprawling,stalk,stellate-pubescent,straight,tamen,tem,time,tissu,tissue,triangular,unarmed,unit,usually,vary,vigorous,whitish,wide,yellowish,ympodial	abaxial,armament,branching,capitate,color,corolla,dense,form,growth,height,history,inflorescence,length,life,ovary,plant,pubescence,seed,shape,size,spacing,texture,width
463	wfo-0001029152	success	197	118	89	108	29	0.452	0.25-0.5,0.5-1,0.8-1,0.9-1.3,1,1-1.5,1-4,1.1-1.3,1.5-2,2-2.5,2-5,2.5-3,3-5,6-8,8.5-16,anther,appressed,attenuate,bark,base,branch,broadly,brown,calyx,cm,conical,corolla,cuneate,dark,deciduous,deep,deltoid,elliptic,filament,flower,fruit,glabrous,globose,green,greyish-red,inflorescence,keeled,leaf,lightly,lobe,lobed,main,margin,minutely,mm,obovate,ovary,ovoid-reniform,pair,pale,papillose,pedicel,petiole,pitted,plane,plant,poricidal,prominently,red-floccose,reddish-floccose,shape,shaped,shiny,shrub,simple,single,size,small,stem,stigma,straight,style,surface,tapering,tear-drop,tree,trichome,tube,vein,weak,white,winged,x,young	.1,.5,0.75-1,1-2,1-3,1.5-1.7,2-3,2-4,3-8-flowered,4-6,61-25,acuminate,acute,anthesi,apex,appearanc,appearing,area,ba,beginning,beneath,berry,blade,broadened,bud,citronella,closely,completely,corky,decurrent,deflexed,densely,dia,differing,difoliate,distal,dry,eaf,edicel,eed,ellipsoi,enclosing,erect,et,exsertion,fide,flattened,floccose,fragrance,free,fruiting,geminat,giving,held,hyaline,inflorescenc,large-lenticellate,late,lateral,live,lon,long,long-styled,longer,lower,major,material,middle,midrib,minor,nearly,nflorescence,often,older,one,opposite,overlapping,per,planar,pore,portion,prominent,quite,red,reddish,reflexed,reminiscent,rounded,ruit,scar,short-styled,slender,slightly,somewhat,soon,spaced,styl,tall,terminal,third,tillett,tip,ud,unit,usually,widest,woody,ympodial	0.1,1.5-4-6,3-8,abaxial,adaxial,arrangement,branching,color,diameter,drying,form,growth,height,history,length,life,midvein,na,number,peduncle,perennial,primary,pubescence,seed,tertiary,texture,unarmed,venation,width
464	wfo-0001029156	success	65	61	47	18	14	0.723	0.5,1,10-12,2,4-6,6,6-8,<,almost,bark,berry,cell,center,completely,deeply,exfoliating,flattened,glabrous,golden,growth,lateral,liana,long,margin,minute,minutely,mm,multiseriate,pale,per,pitted,rectangular,reniform,rib-like,seed,shiny,sinuate,stem,surface,tan,testal,thickening,trichome,vine,wall,wide,woody	-3,1.5-2,apex,apparently,cm,diameter,eed,epiphytic,fide,fruiting,markedly,nee,new,noddin,occasionally,older,pedicel,shreddy	color,form,fruit,height,history,life,perennial,plant,pubescence,shape,size,texture,type,young
465	wfo-0001029156	success	65	78	28	37	50	0.431	0.5,1.5-2,4-6,6-8,<,berry,cm,diameter,glabrous,golden,growth,liana,margin,minutely,mm,multiseriate,pale,pedicel,pitted,reniform,seed,stem,surface,tan,trichome,vine,woody,x	-3,1,10-12,2,almost,apex,apparently,ark,cell,center,completely,deeply,eed,em,epiphytic,exfoliating,fide,flattened,fruiting,lateral,lon,markedly,minute,nee,new,noddin,occasionally,older,per,rectangular,rib-like,shiny,shreddy,sinuate,testal,thickening,wall	2-3,6,abaxial,adaxial,anther,arrangement,bark,base,branch,branching,calyx,color,corolla,drying,filament,flower,form,fruit,height,history,inflorescence,leaf,length,life,lobe,long,main,midvein,na,nodding,number,ovary,peduncle,petiole,plant,primary,pubescence,ray,shape,size,stigma,style,tertiary,texture,tube,unarmed,vein,venation,width,young
466	wfo-0001029160	success	150	122	75	75	47	0.5	/2,0.5,0.7,1.3-1.8,1.8-2.2,2-7,3-8,3.0-3.5,4-8,5-13,6-10-flowered,6-8,6.5-8.6,acicular,annual,anther,armed,base,blade,branched,bristly,broadly,brown,calyx,campanulate,capitate,cm,dark,developing,divergently,dm,dry,eglandular,few-rayed,glabrous,gland,hair,herb,including,incurved,invested,less,linear-lanceolate,lobe,long,main,maturity,mm,narrowly,occasionally,ovate,petiole,plump,prickly,purple,radially,ridged,scattered,sessile,short-stipitate,size,sometimes,spherical,splitting,stellae,stellate,stem,strait,terminally,tightly,tinged,tube,vein,vestiture,yellow	0.35-0.50,1.11.4,1.3-1.6,20-40,4.5-6.0,5.6-7.5,accrescent,acro,across,acute,adjacent,also,alyx,among,anthesi,appearance,beneath,berry,deep,deltoi,dia,difoliate,divided,eaf,eed,enveloped,erect,exceeding,extende,finer,fully,geminat,giving,heteromorphic,hilum,internodal,lon,lowermost,many,mostly,much,much-dissected,nflorescence,notch,often,one,orolla,ovoid,pair,pinnatifid,prickle,ruit,shorter,shortest,slende,somewhat,spreading,stout,straigh,sunken,tall,tamen,three,thrice,tigma,tub,twice,tyle,ultimate,unit,uppermost,vary,whitish-tinged,wholly,ympodial	1.1-1.4,abaxial,adaxial,arrangement,bark,branch,branching,color,corolla,deltoid,diameter,drying,filament,flower,form,fruit,growth,height,history,inflorescence,leaf,length,life,margin,midvein,na,number,ovary,pedicel,peduncle,plant,primary,pubescence,ray,seed,shape,slender,stigma,style,surface,tertiary,texture,trichome,unarmed,venation,width,young
467	wfo-0001029163	success	149	119	83	66	36	0.557	-25,-9,0.3-2.5,0.5-1,1-2,1.5-2.5,1.5-3,10-,2,2-3,2-6,2-7,2.5-3,20-30,3-4,4-20,4.5-23,5-12,5-8,7-9,abaxial,acuminate,acute,band,base,calyx,chartaceous,cm,color,cuneate,decurrent,deltate,densely,diameter,eglandular,elliptic,elliptic-ovate,entire,flower,fruit,glabrous,glandular,globose,hair,herb,lanceolate,lenticular,like,lobe,margin,mm,moderately,narrowed,nearly,papillose,pedicel,peduncle,perennial,petiole,pseudohair,puberulent,puberulent-pubescent,pubescence,purple,roughened,scale-like,simple,sparsely,stalked,stellate,stem,stigma,style,surface,tip,tube,unbranched,unknown,vein,white,whitish,x,yellow	-4,1,1.5-2,13-18,2-18,3-14,3-5,4-5-foliat,4-6,9-15,abaxially,absen,adaxiall,adaxially,aggregate,apart,apex,articulated,axe,blade,cell,connivent,cylindrical,denser,directed,distall,distally,eaf,eed,free,leaving,lon,long,lower,narrowly,nflorescence,nther,obtuse,orolla,pedicellar,pore,projection,puberulent-pubescen,rachi,radiu,remnant,ripe,ruit,shrub,slightly,small,sometimes,spaced,stone,subapical,subcoriaceous,tal,tem,thickened,time,triangular,truncat,unit,vary,wide,ympodial	adaxial,anther,arrangement,bark,branch,branching,corolla,drying,filament,form,growth,height,history,inflorescence,leaf,length,life,main,midvein,na,number,ovary,plant,primary,ray,seed,shape,size,tertiary,texture,trichome,truncate,unarmed,venation,width,young
468	wfo-0001029171	success	137	117	75	62	42	0.547	-,-15,0.5,1-3,1-4.5,1.5-2,1.5-7.5,10-25,2-3,3-4,3.5-18,3.5-6.5,4-10,4-5,5-6,5-8,7-9,8-17,also,and/or,angled,base,branched,calyx,chartaceous,cm,cuneate,decurrent,deltate,dendritically,dense,diameter,eglandular,elliptic,entire,flower,forked,fruit,glabrous,gland,globose,hair,lanceolate,lobe,margin,mm,narrowly,often,orange,ovate-elliptic,pedicel,peduncle,petiole,puberulent,pubescent,purple,rarely,red,ripe,rugose,short-stalked,shrub,simple,slightly,smooth,sometimes,stellate,stigma,style,triangular,tube,unbranched,white,x,yellow	-10,1-5,10-35,11-20,6-,abaxially,abruptly,absen,acuminate,acute,adaxially,aggregate,apart,apex,articulated,axe,ba,blade,cell,connivent,cylindrical,densely,directed,distall,eaf,eed,except,glandula,glandular,like,long,lower,many-foliat,midrib,moderately,narrowed,near,nearly,nflorescence,nther,obtuse,orolla,perfect,pore,rachi,radiu,ruit,shoot,spaced,sparsely,ste,stone,tal,tem,time,tip,truncat,unit,usually,vary,wide,ympodial	abaxial,adaxial,anther,arrangement,bark,branch,branching,color,corolla,drying,filament,form,growth,height,history,inflorescence,leaf,length,life,main,midvein,na,number,ovary,plant,primary,pubescence,ray,seed,shape,size,stem,surface,tertiary,texture,trichome,truncate,unarmed,vein,venation,width,young
469	wfo-0001029215	success	49	75	24	25	51	0.49	-1.8-2.3,0.3-0.5,0.5-2.5,1,2.3-2.9,brown,calyx,cm,coarse,diameter,fruit,hair-like,herb,lobe,long,mm,obovate,outgrowth,pubescent,shrub,small,surface,wide,woody	.2,0.5-0.7,appearance,border,cell,eed,elongating,entire,fide,give,lateral,markedly,narrowly,round,silky,smelling,spreadin,strong,tall,testa,thick,wall,weigend,winged,xyledecor	0.2,abaxial,adaxial,anther,arrangement,bark,base,branch,branching,color,corolla,drying,filament,flower,form,growth,height,history,inflorescence,leaf,length,life,main,margin,midvein,na,number,ovary,pedicel,peduncle,petiole,plant,primary,pubescence,ray,seed,shape,size,spreading,stem,stigma,style,tertiary,texture,trichome,tube,unarmed,vein,venation,width,young
470	wfo-0001029216	success	243	86	72	171	14	0.296	0.4-0.5,0.5,0.5-1.5,0.6-1,1-1.2,1-2,1-4,1.5-2.3,1.5-2.5,10,10-14,2.5-3.3,20-35,3,3-7,4,annual,anther,biennial,bright,brown,calyx,capitate,cm,cone,conical,corolla,deep,diameter,elliptic,fruit,globose,herb,imparipinnate,inflorescence,interrupted,leaflet,length,less,linear,long,mm,multicellular,narrowly,numerous,obovate,orange,ovary,ovate,pale,pedicel,peduncle,pentagonal,perennial,petiole,plant,pubescent,red,shape,shaped,simple,sparsely,stem,stigma,style,trichome,unicellular,uniseriate,usually,villous,wide,yellow	+,-0.5,-10,-5,.5,.8-1,0.1-0.3,0.1-0.5,0.1-0.6,0.1-0.8,0.2-0.25,0.2-0.3,0.2-0.4,0.2-0.8,0.3-0.4,0.3-0.5,0.3-2,0.4,0.5-0.8,0.5-2,0.6-0.8,0.8-2.5,1-3,1-6,1.2-6,1.5-3,1/,10-,2,2-4.5,2-locular,3-,3-4,3-5,3-foliate,5,5-15-flower,6-10,7-10,<,absen,absent,accrescent,acroscopically,acute,adpressed,allogamous,always,and/or,angeld,anthesi,apex,apical,appearance,appendage,articulated,articulation,attenuate,axi,basal,base,basiscopically,becoming,branch,cell,cente,column,composed,cordate,crenate,cultivar,decurrent,deeply,dentate,distal,eaf,edicel,eed,entire,erect,exserted,extending,facultatively,fasciated,filament,fruited,fruiting,giving,glabrescent,gland-tipped,glandular,gree,green,hair-like,half,halfway,included,initially,interjected,internode,lanceolate,large,larger,later,lateral,like,lobe,lobulate,lon,longer,lower,mainly,margin,maturity,minute,minutely,mixture,multilocular,near,nflorescence,oblique,often,one,outgrowth,pair,particularly,petiolule,population,present,primary,procumbent,pseudostipule,rarely,reflexe,ruit,scen,secondary,sessile,shaggy,short,silky,sometimes,somewhat,sparse,spreading,staminal,sterile,straight,strong,strongly,surface,tangled,tem,terminal,tertiary,testa,thick,thickening,tip,total,toward,truncate,tube,ud,unit,variety,varying,viny,wall,winged,ympodial	3-10,arrangement,color,form,growth,height,history,leaf,life,number,pubescence,seed,size,texture
471	wfo-0001029226	success	206	148	118	88	30	0.573	-7,-9,.5,0-1,0.5-5,1-1.5,1-3,10-40+,2-6,2.5-10,3-3.5,4,4-6,5-7,7-11,8-13,anther,apex,apparently,base,berry,black,blue,branched,bright,calyx,capitate,cell,cm,conical,connivent,cordate,corolla,dark,deltate,diameter,dry,ellipsoid,elongate,enation,entire,filament,flattened,flower,glabrescent,glabrous,glandular,globose,growth,hairy,herbaceous,lateral,lavender,leaf,like,lobe,lobed,long,loosely,lyrate,many,margin,material,mature,membranous,mere,minute,minutely,mm,occasionally,often,open,pair,pale,papillate,pedicel,peduncle,petiole,pinnatifid,pitted,primary,pubescent,red,reniform,rim,ripe,seed,shiny,short-glandular,shrub,simple,slender,spreading,stellate,stem,stigma,style,surface,tan,terminal,testal,thin,time,translucent,trichome,truncate,tube,uniformly,uniseriate,vein,vine,wall,way,weak,white,wide,yellowish,¾	.75,0.5,1-2,1-celled,2,2-3,2-9,3-6,30,5-merou,>,acuminate,acute,ag,alyx,anthesi,apart,ark,articulated,ba,basal,breaking,completely,congested,decurrent,densely,distall,divided,eaf,eed,exserted,flexuous,free,fruiting,gland,green,ilament,irregularly,juice,lengthening,longer,lower,new,nflorescence,older,one,orolla,overtopping,papillat,papillo,per,perfect,pinnate,plurifoliat,pore,poricidal,portion,reflexed,remainin,ruit,sagittate,scar,scarlet,shorter,sleeve,slit,small,sometimes,spaced,sparsely,spot,sprawling,spreadin,staining,strongly,tangled,tem,third,tip,twinin,ud,unit,usually,vary,widest,winged,woody,ympodial	abaxial,adaxial,arrangement,bark,branch,branching,color,drying,form,fruit,height,history,inflorescence,length,life,main,midvein,na,number,ovary,plant,pubescence,ray,shape,size,tertiary,texture,unarmed,venation,young
472	wfo-0001029234	success	204	108	76	128	32	0.373	0-2,0.2-0.3,0.3-0.9,0.4-0.7,0.5-1,0.5-2,0.8-1.1,0.9-2.1,1-1.5,1.1-1.5,1.5-2,1.5-2.5,2-2.5,2-6,3-3.7,3-5,3-8,4-8,5-9.5,5.5-7,9-24,absent,anther,attenuate,base,calyx,capitate,chartaceous,cm,cuneate,diameter,entire,filament,flattened,flower,fruit,glabrous,glandular-puberulent,globose,inflorescence,lanceolate,length,lobe,margin,midvein,mm,moderately,narrowly,ovate,pale,pedicel,peduncle,perennial,petiole,present,pseudo-racemose,pubescent,purple,ray,red,rotate-stellate,rugose,shrub,simple,sparsely,stellate,stellate-pubescent,stigma,style,surface,triangular,tube,unarmed,unbranched,x,yellow	%,0-0.1,0-1,0-2.5,0-3,0-4,0-6,0.1-0.5,0.15-0.3,0.4-0.5,0.5-1.5,0.5-5,0.6-0.8,1-10,1-4,1-locular,11-23,18-24,2-3,20-,3-7,4-,4-7.5,4.7-7,5-merou,7-10,7-11,abaxially,absen,accrescent,acicular,across,acute,adaxiall,adaxially,adult,alyx,apart,apex,apparen,articulated,axe,ba,bilobe,blade,branche,brown,confined,connivent,cylindrical,dense,directed,distall,distally,dm,eaf,eed,eglandular,erect,exocarp,few-,finger,fruiting,geminat,gland-tipped,green,hair,half,incomplete,juicy,lamina,lateral,leaf-opposed,less,long,longer,loosely,lower,markedly,mature,mesocarp,mid-point,midpoint,midrib,minute,nflorescence,oblique,orolla,part,per,perfect,placenta,plurifoliate,pore,porrect,prickle,rachi,rhizomatous,ruit,seeded,septum,sessile,short,spaced,sparse,stage,stalk,stellae,straight,succulent,tal,tamen,tem,thick,thicker,thicknes,throughout,time,tip,toward,unarme,unit,unknow,uvenile,vary,white,wide,ympodial	abaxial,adaxial,arrangement,bark,bilobed,branch,branching,color,corolla,form,growth,height,history,leaf,life,main,na,number,ovary,plant,primary,pubescence,seed,shape,size,stem,tertiary,texture,trichome,vein,venation,width
473	wfo-0001029236	success	159	88	74	85	14	0.465	.5,0.2-0.7,0.2-1,0.45-0.5,0.5,0.5-1.5,0.9-2.3,1-1.5,1-2,1.4-1.7,1/2,2-4,3,6-9,adaxial,anther,apex,apically,base,branching,calyx,cm,conical,coriaceous,corolla,dendritic,densely,diameter,elliptic,flattened,fleshy,fruit,glabrous,globose,growth,leaf,lenticular,lobed,long,middle,minutely,mm,narrowly,near,obscurely,occasionally,ovary,pale,pedicel,pericarp,persistent,petiole,pitted,pointed,poricidal,pubescent,purplish-black,reddish-brown,scattered,shrub,slightly,stem,stigma,style,surface,thin,time,tip,trichome,violet,way,wide,x,young	2-5,abaxially,absent,age,anthesi,apical,apparently,appearing,axi,ba,bark,basal,becoming,berry,bi-lobe,branch,branchlet,broadly,compact,completely,cupulate,decurrent,deflexed,deltate,dichasial,eaf,edicel,eed,erect,ew,except,exserted,filament,flower,free,fruiting,grey-brown,inserted,later,lateral,less,lobe,lower,m.,many,margin,midvein,nflorescence,nodding,obscure,older,overtopping,packe,per,plurifoliate,pore,portion,prominent,purplish,revolute,ruit,scar,secondary,shiny,shoot,short,simple,sleeve,slit-like,sparsely,stamen,strongly,tall,tapering,terminal,trongly,tub,tube,ud,unit,usually,venation,winged,woody,ympodial	abaxial,bi-lobed,color,form,height,inflorescence,length,na,plant,pubescence,seed,shape,size,texture
474	wfo-0001029244	success	233	115	98	135	17	0.421	0-0.5,0-2,0-2.5,0-55,0.4-0.7,1-4,1.4-6,1.5-2.5,2-12,2-3,2.5-3.6,22-31,3-10,3-7,4-5.5,4-7,6-12,7-12,8-10,9-25,90-200,acicular,adult,anther,articulated,base,branch,brown,calyx,chartaceous,cm,contiguous,cuneate,decimetre,deltate,densely,diameter,dm,elliptic,entire,erect,especially,extra-axillary,flower,fruit,globose,green,inflorescence,juvenile,lanceolate,leaf,length,lilac,lobed,long,longer,margin,midpoint,minutely,mm,moderately,nearly,obovate,obtuse,occasionally,orange,ovate,pale,pedicel,peduncle,per,perennial,petiole,plant,prickle,purple,rachi,red,reniform,rhizomatous,rostrate,rugose,rusty,shallowly,shrub,sparsely,stellate,stellate-pubescent,straight,surface,thick,throughout,time,toward,unbranched,wide,x,yellow	%,0-0.2,0-0.3,0-1,0-16,0-80,0-9,0.15-0.25,0.2-0.25,0.2-0.3,0.2-0.5,0.25-0.4,0.5-2,0.8-5,1-1.5,1-2,1.1-1.8,1.8-3.5,10-18,100-150,12-25,2-4,2-foliate,2-locular,2.1-3.2,3-5,3-7.5,3-8,4.7-5,5-10,5-7,5-merou,6-8,6-9,7-10,7-30,7-9,9-16,abaxially,absen,absent,accrescent,across,acuminate,acute,adaxiall,adaxially,alyx,andromonoecious,anvil-shape,apart,apex,apiculate,axe,ba,blade,branche,capitat,confined,connivent,cross-section,cylindrical,directed,distall,distally,distributed,eaf,eed,eglandular,exocarp,filament,finger,flattened,fruiting,functional,geminat,gland-tipped,hair,half,hetereostylous,juicy,lamina,lateral,less,lobe,loosely,lower,markedly,mature,mesocarp,mid-point,midrib,midvein,minute,moist,narrowly,nflorescence,oblique,orolla,pair,part,placenta,pore,porrect,present,ray,ruit,scarcely,sessile,short,side,simple,sometimes,spaced,stalked,stellae,stigma,style,summit,tal,tamen,tem,thicker,tip,transparent,triangular,tube,unarme,unarmed,unit,upper,vary,vein,weakly,ympodial	5-merous,abaxial,adaxial,color,corolla,density,form,growth,height,ovary,pubescence,seed,shape,size,stem,texture,thicknes
475	wfo-0001029246	success	209	109	83	126	26	0.397	-1.5,-4,0.1-0.4,0.15-0.3,0.7-1.3,0.7-2,0.8-1.1,0.9-1.3,1-1.5,1.5-2.3,1.5-2.5,1.7-6,2,2-3,2.8-4,3-5,3.5-5,4-6,6-8,7-12,abaxial,acuminate,adaxial,anther,bark,base,calyx,chartaceous,cm,concolorous,cuneate,deltate,diameter,discolorous,drying,dull,elliptic,entire,filament,flattened-reniform,flower,fruit,glabrescent,leaf,length,less,lobe,lobed,margin,mauve,midvein,mm,moderately,orange-brown,orange-red,pale,pedicel,peduncle,petiole,poricidal,primary,ray,sessile,shrub,simple,smooth,sparsely,spherical,stellate-pubescent,stem,style,surface,tapering,tertiary,tip,trichome,tube,unarmed,unbranched,vein,venation,white,yellow	-1,/5,0,0-15,0-5,0.1-0.3,0.2-1.5,0.3-0.5,0.3-0.8,0.5,0.5-1.5,0.7-1.5,0.8-3,1-1.8,1-10,1-3,1-4,1-5,1-8,1.2-2,1.5-6,1.8-3,1/10-1/5,1/3,2-3.5,2-5,2.5-3.2,2/3,2/3-3/,3-20,5-,5-20,5-merous,6-10,8-16,abaxially,acuminat,acute,almost,alyx,apar,apart,apex,apically,apparently,articulated,berry,blade,broad-deltate,c.,connivent,curved,densely,distance,eaf,eed,elongating,equal,erect,extending,eye,flattened,free,fruiting,glabrous,infructescence,lateral,lon,long,longer,lower,mature,maturity,midpoint,naked,narrow-deltate,narrow-ovate,nflorescence,oblong,obtuse,older,one,open,orange-brow,orolla,oung,pair,pendulous,per,perfec,pericarp,plurifoliat,porrect,portion,prickl,prickle,prickly,procumbent,pubescent,purple,recurved,rounded,ruit,scar,side,sometimes,spaced,spreading,stellate,stout,straight,strongly,tamen,terete,time,unit,upper,usually,vary,visible,way,wide,woody,yellow-orange,ympodial,¼	arrangement,branch,branching,color,corolla,false,form,growth,height,history,inflorescence,life,main,na,number,ovary,perennial,plant,pubescence,seed,shape,size,stigma,texture,width,young
476	wfo-0001029263	success	211	123	109	102	14	0.517	0-2.5,0-5,0.3-1,0.5-1,0.6-1.5,1.2-2.5,1/2,1/4-1/3,1/6,10-35,12-35,2-3,2.2-3.2,2.8-3.8,3-5,3.5-5,4-6,4-7,6-20,acute,almost,anther,apically,apparently,articulated,attenuate,bark,base,berry,black,blade,calyx,cell,chartaceous,cm,concolorous,corolla,cream,cultivar,cuneate,curved,dark,deltate,diameter,drying,dull,elliptic,entire,erect,evenly,flattened-reniform,flower,fruit,glabrous,glandular,green,hair,herb,lateral,leaf,length,less,lobed,long,long-styled,margin,marking,maturity,minute,mm,near,often,orange,orange-brown,outline,pale,pedicel,peduncle,petiole,pit,plant,poricidal,raised,red-brown,rotate,short-styled,simple,small,smooth,sometimes,spherical,stem,stout,straight,style,surface,tapering,tearing,tip,trichome,unarmed,unbranched,upper,usually,way,white,wide,yellow,young	-2,0-100,0.5-1.5,1,1-10,1-4,1-7,1/3-2/3,1/3-3/4,10-20,2-4,30-60,4-10,5-10,5-8,5-merous,6-30,7-10,alyx,andromonoecious,apar,apex,ba,becoming,broad,broad-deltate,connivent,decurren,deep,difoliate,distal,distance,eaf,eed,elongating,equal,extending,extensive,filament,foliaceou,free,fruiting,fully,geminat,glabrescent,hermaphrodite,heterostylous,infructescence,lobe,lobing,long-acuminat,longer,lower,lowermost,mature,mauve,midvein,nflorescence,obtuse,older,one,onl,open,opening,orolla,oung,ovoi,pair,part,pendulous,per,pericarp,portion,primary,purple,reddi,reflexed,rounded,ruit,scar,secondary,side,spaced,sparsely,spreading,staminat,stellate-pubescent,tamen,terete,tertiary,time,tube,ud,unarme,unit,vary,vein,venation,visible,wider,woody,ympodial	branching,color,form,growth,height,inflorescence,long-acuminate,ovary,pubescence,reddish,seed,shape,size,texture
477	wfo-0001029286	success	224	122	102	122	20	0.455	.5,0.8,1-1.5,1-2,1.5-2,1.5-4,1/8,15-50,2-3,2.5-3,3-4,4-5,4-6,4.5,4.5-7,5,5-6,6-8,6-9,7-10,abaxial,abaxially,adaxially,almost,anther,anthesi,apically,attenuate,bark,base,branch,branched,branching,broadly,brown,capitate,chartaceous,clustered,cm,concolorous,conical,corolla,cuspidate,deltoid,dendritic,diameter,dilated,drying,entire,faint,filament,flat,flower,glabrous,green,grey,leaf,length,less,liana,light,lilac,lobe,lobed,main,margin,mauve,membranous,midvein,minutely,mm,obconical,oblong,obovate,pair,pedicel,peduncle,petiole,primary,raised,rounded,simple,slender,smooth,sparsely,stem,stigma,style,surface,terminal,tertiary,time,tip,trichome,tube,unarmed,vein,venation,widely,x,yellowish,young	.4,0-0.5,0.1,0.15-0.4,0.4-1.2,0.6-1.2,0°,1.5-8,abscising,acute,age,along,altered,alyx,another,apar,apart,apex,apice,apiculate,apparently,arising,around,articulated,articulation,axil,becoming,canaliculate,clearly,closer,concave,crenulate,curved,delineated,density,distributed,domatia,eaf,eed,equal,except,extending,fertilization,flexuous,formed,forming,free,fresh,glabrescent,globo,hair,increasing,inflorescenc,inside,isolated,junction,know,known,lamina,lengthening,long,lower,m.,margi,mas,meeting,middle,much,multicellular,narrowly,nflorescence,nther,occasional,often,one,orolla,outside,ovate,papillo,perfec,plurifoliat,pore,poricidal,portion,prominent,protruding,rachi,rarely,regular,ruit,scar,separated,shallowly,side,smaller,sometimes,somewhat,soon,specimen,spreading,stretchy,stump,tangled,tearing,terete,textur,thick,thickened,thinner,tissue,together,toward,translucent,translucent-violet,tuft,ud,uneven,unit,vary,visible,wide,ympodial	adaxial,arrangement,calyx,color,form,fruit,growth,inflorescence,na,number,ovary,papillose,pubescence,ray,seed,shape,size,texture,true,width
478	wfo-0001029289	success	292	181	169	123	12	0.579	.05,.5,0.4-1.1,0.4-2,0.5,0.5-1,0.5-1.2,1-2,1-2.5,1.2,1.5-4,1.5-5,1/6-1/3,100,12,15-45,2-3,2.5,2.5-4,25,3,3-7,4-9,4.5,5-12,5-20,6-12,8,abaxially,adaxially,almost,along,always,anther,anthesi,apex,apically,articulation,attenuate,bark,base,berry,black,boundary,branch,branched,branching,broadly,brown,calyx,canaliculate,capitate,chartaceous,clavate,clear,cm,collapsing,complex-dendritic,concolorous,conical,corolla,covering,cuneate,cupular,deeply,dendritic,developing,development,diameter,dilated,discolorous,distributed,dorsally,drying,elongated,entire,erect,evenly,faint,finely,flattened,flower,glabrous,green,half,honeycomb,indumentum,leaf,length,liana,line,lobe,lobed,long,longitudinally,lower,main,margin,maturity,midvein,minutely,mm,obconical,oblong,obovate,often,one,orange,outline,pair,pale,papillose,pattern,pedicel,peduncle,petiole,pili,pitted,primary,pubescent,rachi,raised,rarely,reddish,reniform,reveal,ridged,seed,shape,shiny,side,simple,size,smooth,sometimes,somewhat,sparse,sparsely,spheroidal,stem,stigma,straight,strongly,sturdy,style,sunken,surface,terminal,tertiary,thick,thin,thin-coriaceous,time,trichome,truncate,unarmed,undulate,unicellular,usually,variable,vein,venation,violet,visible,white,x,yellow,yellowish,young	.2,0-2,0.15-0.25,0.2-1.5,0.4-1,0.5-0.7,1-1.2,1-4,1.5-2,15,1mm,60-90°,accrescent,acuminate,acute,adaxial,age,alyx,apar,apice,apparently,appendage,arachnoid,arising,aristate,around,articulated,becoming,clearly,close,complexity,crenulate,curved,cuspidate,delineated,deltoid,dense,detaching,domatia,eaf,eed,ellipsoi,equal,eye,fertilisation,filament,flexuous,forming,found,free,fruiting,glabrescent,globose,hair,hard,inner,inside,irregular,lamina,leave,lengthening,less,light-coloured,linear,loop,m.,margi,may,middle,minute,mixture,multicellular,naked,narrowly,nflorescence,nther,orolla,outer,outside,papillae,papillo,pendulous,perfec,pericarp,pit,plurifoliat,point,pointed,pore,poricidal,portion,prominent,pronounced,protruding,puberulous,rising,rounded,ruit,scar,see,shallow,shallowly,short,sinus,slightly,soon,spreading,stump,tearing,terete,thickened,tip,together,toward,tube,tuft,ud,unit,various,vary,wide,widely,ympodial	arrangement,color,form,fruit,growth,inflorescence,mentioned,number,ovary,pubescence,texture,ye
479	wfo-0001029295	success	191	109	95	96	14	0.497	-5,-9,.5,0.5,0.7-1,1,1-1.5,1.2-3.5,2,2-3,2.5-3.5,2.5-6,2/3,3/4,4-4.5,5-6,6-8,<,abaxial,along,anther,anthesi,attenuate,base,calyx,capitate,cm,corolla,cup-shaped,diameter,drying,elliptic,entire,essentially,fide,flower,fruit,glabrescent,glabrous,globose,green,height,herb,known,leaf,length,lobed,long,margin,membranous,midrib,minutely,mm,narrowly,ovary,ovoid,pale,papillate,pedicel,peduncle,petiole,pitted,pointed,prolonged,puberulent,purple,red,reniform,rhomboidal,ripe,scattered,sessile,shallowly,shrub,simple,sinuate,slightly,small,sparsely,stem,stigma,style,surface,tan,thin,tip,trichome,tube,unarmed,uniseriate,urban,way,x,yellowish,young	0,2-4,4-5-celled,4-6,4-merous,?,acuminate,acute,apex,apparently,appearing,articulated,bark,become,berry,cell,closely,continuous,crystal,dark,deciduous,defined,defoliate,dense,distal,eaf,eed,ellipsoid,elongate,erect,exserted,filament,free,fruiting,geminat,glabrou,grey,half,internodal,irregular,lamina,lateral,lengthen,lobe,lobe-lik,lower,minute,nflorescence,nodding,obtusely,older,opening,orientation,outline,pair,papillat,peduncl,peelin,pentagonal,per,perfect,pericarp,pore,portion,primary,pubescent,rim,rooting,rounded,ruit,sand,scar,seen,short,slit,soon,spaced,splitting,sprawling,strongly,testal,tissue,top,ud,undulation,unifoliate,unit,upper,usually,vein,whitish,widest,wing,wiry,woody,ympodial	adaxial,branching,color,form,growth,inflorescence,na,plant,pubescence,seed,shape,size,texture,ye
480	wfo-0001029299	success	201	123	91	110	32	0.453	0.5-1.5,1-2,1-4,10-16,10-21,16-28.6,2.3-3.3,3-4.5,3-5,3-7.5,4-16,5-15,7-8,8.5-19,abaxially,acute,adaxially,anther,attenuate,base,broadly,brownish,cell,chartaceous,ciliate,clavate,cm,condition,corolla,covering,dense,diameter,drying,elliptic,filament,flower,forked,fresh,fruit,glabrous,glandular,green,green-white,greenish,hair,hair-like,herb,lanceolate,lateral,leaf,like,lobe,make,margin,medium,membranous,mm,moderately,mucilaginous,multicellular,non-glandular,oblique,odd-pinnate,ovate,ovoid,pedicel,peduncle,pentagonal,petiole,plant,pubescence,pubescent,rotate,rounded,seed,size,stem,stigma,style,testal,thick,throughout,trichome,truncate,tube,wall,wet,white,whitish,x,yellow	0-3,0-5,1-10,1.6-5,2-4,3,3-12,3-13,3.5-7.5,4-10,5-merou,6-5-15.3,acumen,acuminate,ag,along,alyx,apart,apex,apparently,articulated,axe,axillary,blade,borne,bud,capitat,connate,cordate,cuneate,decreasing,decurrent,digestion,distal,dorsally,eaf,edge,eed,end,enzyme,erec,especially,exceeding,flat,folded,geminat,generally,grading,gradually,half,homostylous,honeycomb-shaped,interjected,invested,leaflet,lengthening,living,long,lower,middl,midrib,minutely,mottled,nflorescence,orbicular,orolla,pair,perfect,petiolulate,petiolule,plurifoliate,pore,poricidal,puberulent,purple,removed,ruit,sessile,seudostipule,shallowly,short,singly,slightly,slit,spaced,specimen,spreading,stamen,ste,stolo,straight,subsessile,subtending,tall,tamen,tem,terminal,tip,tissue,toward,tri-,tuber,typically,unit,unknow,usually,vary,wide,wing,ympodial	abaxial,adaxial,arrangement,bark,branch,branching,calyx,capitate,color,form,growth,height,history,inflorescence,length,life,main,midvein,na,number,ovary,primary,ray,shape,surface,tertiary,texture,unarmed,vein,venation,width,young
481	wfo-0001029308	success	221	126	107	114	19	0.484	%,0-25,0.2-1.5,0.4-0.7,1-5,1.2-2.5,1.5-2.5,1.5-2.7,1.5-4,19-30,2-5,2-6,2.5-3,2.7-3.1,3-4,3.5-4.5,30-50,4-15,4-5,4-8,6-18,7-8,8-19,9-18,acicular,adult,anther,apex,articulated,base,branch,broad-based,brown,calyx,chartaceous,cm,cuneate,cylindrical,decimetre,deltate,densely,diameter,dm,elliptical,entire,erect,extra-axillary,flattened,flower,fruit,furrowed,glabrous,globose,heterostylous,inflorescence,juvenile,lamina,lanceolate,leaf,length,lilac,lobe,lobed,long,margin,mid-point,minutely,mm,moderately,ovate,pale,pedicel,peduncle,per,perennial,petiole,plant,prickle,purple,rachi,reticulate,rhizomatous,rotate-stellate,rusty,seed,shallowly,shrub,simple,sparsely,star,stellate,stellate-pubescent,stigma,straight,style,surface,thick,thickened,throughout,toward,tube,unarmed,unbranched,x,yellow,yellowish,yellowish-green	0-10,0-4.5,0.05-0.3,0.2-0.3,0.25-0.3,0.25-0.35,0.25-0.4,0.25-1,1,1-4,1.5-3,1.5-5.5,168,1981,2-foliate,2-locular,2.2-2.7,20-40,3-6,4-6,4.3-15,4.5-6,5-merou,6-11,6-8,7-10,9.5-28,abaxially,absen,absent,across,acuminate,acute,adaxiall,adaxially,alyx,andromonoecious,anvil-shape,apart,axe,ba,blade,branche,broadly,capitat,confined,connivent,counted,cross-section,directed,distall,distributed,eaf,eed,eglandular,elliptic,exocarp,finger,fruiting,functional,geminat,gland-tipped,green,hair,half,interpetalar,juicy,lateral,less,longer,loosely,lower,margi,mature,mesocarp,midpoint,midrib,midvein,minute,moist,nearly,nflorescence,oblique,one,orolla,pair,part,placenta,pore,porrect,present,ray,ruit,sessile,short,side,spaced,stalked,stellae,tal,tamen,tem,time,tissue,triangular,unarme,unit,upper,vary,vein,weakly,wide,ymon,ympodial	5-merous,abaxial,adaxial,arrangement,capitate,color,corolla,form,growth,height,history,life,number,ovary,pubescence,shape,size,stem,texture
482	wfo-0001029310	success	216	142	117	99	25	0.542	-16,-25,.5,/6,0-20,0-5,0.1-0.2,0.5,0.6-1.1,1-1.5,1.2-1.5,1.8-3,10-13,10-15,15-20,2-3.5,2-4,20-40,3-4,3.5,4-10,5-12,5-20,5-30,5-6,5-7,6-8,7-12,8,abaxially,anther,apex,apically,apparently,base,berry,blade,branched,calyx,cm,concolorous,connivent,cordate,deltate,diameter,difoliate,drying,dull,elliptic,filament,flattened-reniform,flower,fruit,glabrescent,glabrous,hair,herb,lateral,leaf,length,lobe,lobed,lobing,long,long-styled,lower,margin,maturity,mauve,membranous,midpoint,midvein,mm,moderately,narrow-deltate,ornately,pair,pedicel,peduncle,petiole,pinnatifid,plant,poricidal,porrect,prickle,prickly,primary,ray,secondary,sessile,short-styled,shorter,shrub,simple,sparsely,spherical,spreading,stalked,stellate-pubescent,stem,stout,style,surface,tapering,tertiary,tip,toward,trichome,truncate,tube,unit,variously,vein,venation,visible,wide,yellow	.1,.6,/4,0.2-0.3,0.2-0.8,0.5-3,00,1,1-2,1-4,1/,10,10-20,2.5-6,2/3-3/4,20-60,200-500,3-5,4-8,45-60,5,5-10,5-8,5-merous,7-13,accrescent,acute,alyx,ame,andromonoecious,apar,apart,articulated,bark,beyond,brown,c.,conical,dark,distal,distance,eaf,eed,elongating,enclosing,equal,erect,extending,filifor,free,fruiting,geminat,gently,gray,hermaphrodite,heterostylous,inflated,infructescence,lon,longer,lowermost,mature,minute,nflorescence,older,one,open,orange-green,orolla,oung,pendent,pendulous,per,pericarp,perpendicular,portion,prickl,recurved,red-brow,retrorse,ruit,scar,side,smooth,sometimes,spaced,stalk,staminat,stellate,straight,strongly,tamen,terete,time,tissue,vary,way,woody,ympodial	1/3,abaxial,adaxial,arrangement,branching,color,corolla,filiform,form,geminate,growth,height,inflorescence,na,number,ovary,pubescence,seed,shape,size,stigma,sympodial,texture,unarmed,young
483	wfo-0001029317	success	151	80	63	88	17	0.417	.5,0.25,0.5,0.5-0.75,0.8-1,1,1-1.5,10-16,2-3,2.5-5,7-8,8-9,anther,area,base,broadly,ca,calyx,cm,corolla,cup-like,densely,dia,filament,glabrate,glabrous,grayish,inflorescence,leaf,lobed,long,minutely,mm,narrowly,nearly,older,ovary,ovate,paler,papillose,pedicel,petiole,poricidal,probably,pubescent,shrub,simple,size,slightly,soft,sparsely,stem,stigma,straight,style,thickened,tip,trichome,tube,uniseriate,white,x,young	0.5-1,1.5-3.5,10-30-flowered,11-14,6-8,6.5-11,acuminate,along,anthesi,apar,apex,attenuate,barely,beneath,brow,bud,channeled,closely,deciduou,deflexed,deltoid,denser,differing,difoliate,dry,eaf,edicel,eed,ellipsoi,epidermi,erect,exserted,extreme,free,frui,fruiting,geminate,globose,immature,known,lateral,like,lobe,lon,lower,main,major,margin,middle,minor,nflorescence,occasionally,often,one,opposite,otherwise,overlapping,ovoid,pair,pore,portion,prominent,proximal,rachi,raised,reflexed,remaining,rest,rounded,ruit,scar,shaped,slender,soon,spaced,specimen,styl,tall,tapering,tear-drop,tuft,ud,unit,vein,visible,widest,yellowish,ympodial	abaxial,adaxial,branching,brown,color,diameter,form,growth,height,length,mentioned,na,plant,pubescence,shape,surface,texture
484	wfo-0001029332	success	197	122	98	99	24	0.497	0-2,0-5,0.1-0.2,0.5-1,1-2,1-4,1.3-1.5,1.5-2,1/2,2,2-2.5,2.5-3.5,2.8-3.7,2/3-3/4,3-4,3-6,3.5-5,4-10,5-6,5-8,6-8,8.5-9.5,abaxial,adaxial,anther,apparently,bark,base,berry,calyx,chartaceous,cm,concolorous,cordate,curved,densely,diameter,drying,filament,flattened-reniform,flower,fruit,glabrescent,glabrous,lateral,leaf,length,lobe,lobed,long,lower,margin,maturity,mauve,midvein,mm,moderately,narrow-deltate,orange-brown,ovate,pair,pedicel,peduncle,petiole,plant,poricidal,porrect,prickle,prickly,primary,ray,sessile,shrub,simple,slender,spherical,stalked,stellate-pubescent,stem,style,surface,tapering,terminal,tertiary,tip,trichome,tube,unbranched,upper,variously,vein,venation,way,weakly,wide,yellow,yellow-green,yellow-orange	-5,.5,/3,0,0-0.5,0-100,0-20,0-4,0.1,0.15-0.2,0.15-0.25,0.8-1,1-1.5,1-3,1/3,1/4,1/4-1/3,10-30,2-4,2/,4-15,5-merous,abaxially,alyx,andromonoecious,apar,apart,apex,apically,articulated,becoming,blade,broad-deltate,conical,connivent,difoliate,distal,distance,eaf,eed,elongating,equal,erect,extending,flattened,free,fruiting,geminat,gland,globular,grayi,herbaceous,hermaphrodite,heterostylous,infructescence,less,long-acuminat,long-styled,longer,lowermost,mature,midpoint,nflorescence,often,older,one,open,orolla,oung,pale,pendulous,per,pericarp,portion,prickl,pubescent,reduced,rounded,ruit,scandent,scar,short-styled,shorter,side,smooth,spaced,spreading,stalk,staminat,stellate,subsessile,tamen,terete,time,unit,vary,visible,woody,ympodial	2/3,arrangement,branch,branching,color,corolla,form,grayish,growth,height,inflorescence,main,na,number,ovary,pubescence,seed,shape,size,stigma,texture,unarmed,width,young
485	wfo-0001029333	success	155	105	88	67	17	0.568	.25,.5,/4,0.5,0.5-1,0.7-1,1-1.2,1-1.5,1-15,1-3,1-7,1.5-2,1.5-2.5,1.5-3,17-26,2-2.5,3-7,3-7.5,5-6,8-15,abaxially,adaxially,anther,apex,bark,base,beige,broadly,calyx,clavate,cm,conical,corolla,dendritic,dendritic-pubescent,densely,dia,difoliate,dry,elliptic-obovate,flattened-reniform,fresh,geminate,glabrous,globose,golden,green,incrassate,leaf,lobed,long,long-styled,margin,minor,minutely,mm,obovate,opposite,orbicular,ovary,pale,paler,pedicel,petiole,pitted,pubescence,pubescent,reddish-brown,shape,shaped,shining,short-styled,shrub,simple,size,small,sparsely,stem,stigma,style,surface,tear-drop,tree,trichome,unit,way,wide,young	1-2,10-15-flowered,100,9-13,abaxial,acuminate,acute,along,anisophyllou,anthesi,auriculate,ba,beneath,berry,contracted,deflexed,denser,differing,eaf,edicel,eed,erect,exserted,filament,flower,free,fruiting,heteromorphic,inflorescenc,lateral,like,lobe,lon,lower,main,major,nflorescence,occasionally,older,overlappin,pair,papillo,planar,pore,poricidal,portion,present,rest,rounded,ruit,scar,sessile,slender,somewhat,spaced,strongly,tall,time,tip,triangular,truncate,tube,type,ud,vein,woody,ympodial	anisophyllous,arrangement,branching,color,diameter,form,fruit,growth,height,inflorescence,length,papillose,plant,seed,sympodial,texture,width
486	wfo-0001029334	success	211	98	80	131	18	0.379	0.15-0.3,1,1-2,1-3,1-6,1.3-4.5,1.5-6,1.8-2.9,2-2.5,2-8,2.5-3,3-7,4-5.5,4-8.5,5-10,7.5-15.5,8-30,9-12,acute,almost,anther,attenuate,brownish,cell,chartaceous,clavate,cm,condition,corolla,covering,densely,diameter,drying,flower,forked,fresh,fruit,glabrous,globose,green,greenish,hair-like,herb,lanceolate,lateral,lobe,long,membranous,mm,odd-pinnate,orbicular,ovate,ovoid,pedicel,peduncle,petiole,plant,poricidal,puberulent,pubescent,pure,ripe,seed,size,stellate,stem,stigma,style,testal,thick,tinged,tip,tube,violet,wall,white,whitish,wide,x,yellow	.2,0-4,1-10,1.5-3.9,2,2-4,2-5,3-5,3.2-5.8,3.3-6.5,5-merou,abaxially,absent,acumen,adaxially,ag,along,alyx,among,apart,apex,apparently,articulated,axe,axillary,base,berry,blade,borne,broadly,bud,capitat,ciliate,connivent,cordate,cuneate,decreasing,decurrent,digestion,distal,dorsally,eaf,edge,eed,elliptic,end,enzyme,erect,especially,exceeding,except,filament,flat,folded,geminat,generally,glabrou,gradually,grassland,greatly,green-white,hair,half,homostylous,honeycomb-shaped,interjected,leaflet,lengthening,like,living,low-growin,lower,make,margin,middl,midrib,minutely,mucilaginous,narrowly,nflorescence,oblique,obtuse,often,orolla,pair,perfect,petiolulate,petiolule,plurifoliate,pore,proximal,rarely,reduced,removed,rounded,ruit,semi-rosette,sessile,seudostipule,shady,short,singly,situation,slightly,slit,spaced,specimen,stamen,ste,stolo,straight,subequal,subsessile,subtending,sunny,tall,tamen,tem,terminal,throughout,toward,tri-,tuber,typically,unit,unwinged,usually,vary,wet,woodland,ympodial	abaxial,adaxial,arrangement,branching,calyx,capitate,color,form,growth,height,inflorescence,leaf,length,na,pubescence,shape,surface,texture
487	wfo-0001029340	success	286	181	129	157	52	0.451	.05,.2,1-2,2,2.5,4,5,abaxial,abruptly,acicular,adaxial,age,almost,anther,base,becoming,berry,bilobed,bluish,bright,brown,calyx,capitate,cm,column,conical,cordate,curved,darker,densely,depressed-spherical,diameter,duller,embedded,exceeding,expanded,filament,flattened-reniform,flower,foveolate,fruit,glabrous,gland,gland-tipped,glandular,glandular-puberulent,green,greenish,hair,hyaline,lanceolate,lateral,leaf,less,light,like,lobe,lobed,long,long-styled,main,many,margin,maturity,mesocarp,minute,minutely,mixture,mm,much,narrowed,narrowly,nearly,occasionally,orange,orange-yellow,pale,pedicel,peduncle,petiole,pilose,poricidal,prickle,pulp,purple,ray,sessile,shiny,short-styled,shorter,shrub,simple,size,slightly,small,smooth,soft,soft-pilose,somewhat,spherical,spongy,spreading,spreading-pilose,stellate,stem,stigma,stipitate,straight,style,suborbicular,surface,terete,thin,thin-textured,tinged,tip,tough,trichome,tube,unarmed,unbranched,uniseriate,usually,variously,vein,white,wide,yellow,yellowish	'',-celled,.2–1.6,0,0.15–0.6,0.2–0.5,0.4,0.5,0.5–2,0.5–2.5,0.8–3.2,0–,1,1.2–2.0,1.2–2.2,1.4–1.8,1.5-3,1/2,1/4,10,100,13–15,1–,1–1.2,1–2,1–2-celled,20,2–10,2–2.2,2–3,2–3.2,2–5-celled,2–8,3,3.5–5.5,3–3.5,3–5-celled,3–5.3,3–6-celled,3–7,4–4.5,4–8,5-merous,5°,5–12,8–12.5,8–17,9–20,>,``,abaxially,absent,acute,alyx,angle,anthesi,apex,apical,apicall,armed,around,articulated,ba,basal,blade,branched,broad-based,coarse,compressed,concentrated,connivent,curving,cylindrical,developin,difoliate,directed,eaf,eed,elongate,equal,evenly,exceptionally,expanding,extending,falling,fertile,free,frui,fruiting,geminat,geminate,grading,gradually,greater,held,heterostylous,infructescence,irregularly,larger,largest,linea,lon,lower,lowermost,major,mature,midpoint,midrib,mostly,near,nflorescence,nipple,often,one,orolla,oung,ovoid,pair,papillat,per,pericarp,perpendicular,pore,portion,prickly,rarely,recurved,reflexed,ruit,secondary,senescent,sharp,short,shrivelling,similar,single,smaller,soon,sparsely,ste,stipitate-glandular,stout,strongly,tall,tamen,tapering,tooth,triangular,twice,two,unarme,unit,vary,viciously,way,whole,ympodial	.2-1.6,0.2-0.5,0.5-2,1-2-celled,1.2-2.0,1.4-1.8,2-10,2-2.2,2-3.2,2-5-celled,3-3.5,3-5-celled,3-5.3,3-7,3.5-5.5,4-4.5,4-8,5-12,8-12.5,8-17,9-20,arrangement,bark,branch,branching,color,corolla,drying,form,growth,height,history,inflorescence,length,life,linear,midvein,na,number,ovary,papillate,perennial,plant,primary,pubescence,seed,shape,tertiary,texture,venation,width,young
488	wfo-0001029344	success	147	115	77	70	38	0.524	0.4-1,0.5-1,0.5-1.5,0.5-3,1,1-3,1-5,1-6,1.5,1.5-3,1.5-4,10-20,2-7,3-10,4-6,5-12,5-15,anther,base,brown,calyx,center,chartaceous,ciliate,cm,diameter,dm,drying,edge,elliptic,elliptic-ovoid,entire,filament,fine,flower,fruit,glabrous,globose,hair,herb,immature,linear-lanceolate,lobe,long,margin,maturing,membranaceous,mm,moderately,nearly,oblong,obtuse,parallel,pedicel,peduncle,petiole,pubescent,radiating,raised,ridge,rotate,rounded,running,semitransparent,shallow,sparsely,stigma,straight,style,surface,tube,two-celled,unbranched,vein,white,x,yellow	.5,1-2,10-35,2-3,2-3-celled,2-4,abaxially,absent,abundant,acute,adaxiall,adaxially,along,apex,axe,berry,beyond,blade,connected,cordate,decurrent,dehiscing,densely,denser,difoliate,eaf,eed,emarginat,equal,explosively,exserted,flat,frui,geminat,held,interpetalar,lacking,lower,lying,maturit,mesocarp,nflorescence,notch,obvious,often,one-,orolla,per,placenta,pressure,pubescen,rachi,rhizomatous,ruit,short,slightly,sometimes,stamen,swollen,tal,tamen,tem,tissue,triangular,unit,vary,watery,wid,woody,ympodial	2.5,abaxial,adaxial,arrangement,bark,branch,branching,color,corolla,form,growth,height,history,inflorescence,leaf,length,life,main,midvein,na,number,ovary,perennial,plant,primary,pubescence,ray,seed,shape,size,stem,tertiary,texture,trichome,unarmed,venation,width,young
489	wfo-0001029363	success	152	79	63	89	16	0.414	.25,0.2-1.1,0.5-1,1,1-1.2,1.5-3.5,2-6,3-7,4-11,5-7-flowered,6-7,6-8,anther,bark,beneath,berry,bi-lobed,bud,calyx,capitate,cm,corolla,cup-shaped,deep,deflexed,densely,elliptic,filament,fruit,glabrous,globose,greyish,leaf,lobed,long,maroon,minutely,mm,narrowly,ovary,papillose,pedicel,petiole,poricidal,pubescent,shiny,shrub,simple,small,sparsely,stem,stigma,straight,style,surface,tapering,tip,tree,tube,white,white-papillose,wide,young	.75,/4,0-0.1,0.1-0.5,0.5,1.5-1.7,7-10,acuminate,acute,anthesi,apex,axil,ba,base,becoming,beginning,closely,coroll,deltoid,dia,drying,eaf,edge,edicel,eed,erect,except,exsertion,free,fruiting,green,immature,inflorescenc,internodal,known,lamina,larger,later,lateral,lobe,lon,lower,main,margin,mature,meeting,middle,minute,much,near,nflorescence,obtuse,occasionally,often,older,opposite,overlapping,pair,pale,paler,papillo,pore,portion,prominent,reflexed,ruit,scar,slender,slit-like,somewhat,spaced,sparse,tall,terminal,thickened,trichome,tuft,ud,unifoliat,uniseriate,unit,upon,usually,vein,way,widest,woody,yellowish,ympodial	abaxial,adaxial,color,diam,diameter,flower,form,growth,height,inflorescence,length,na,plant,shape,size,texture
490	wfo-0001029364	success	153	95	74	79	21	0.484	-2,-6,0.2-0.5,1-3,1-5,1.5-2,10-27,2,2-6,4-12,4-9,5-9,7-9,8-15,?,acuminate,anther,apex,base,calyx,chartaceous,cm,color,corolla,cream,cuneate,curled,cylindrical,diameter,distally,elliptic,entire,extra-axillary,finger,flower,fruit,glabrous,gland-tipped,globose,green,greenish,hair,herb,immature,lobe,margin,minutely,mm,moderately,narrowly,nearly,obtuse,pedicel,peduncle,petiole,puberulent,pubescent,sagittate,shallow,shrub,simple,sparsely,spot,stellate,stigma,strongly,style,tapered,triangular,unbranched,unknown,white,x,yellow	-3,.5,1,1-,1-4,191.,2-,2-foliat,3-4,5-,5-11,6-8,8-10,abaxially,according,acute,adaxially,aggregate,apart,around,articulated,axe,ba,bitter,blade,blue,cell,center,connivent,darker,deep,directed,distall,eaf,ed,fide,filament,free,glandular-puberulen,inserted,long,lower,major,membranaceous,mesocarp,nflorescence,orolla,ovate,part,perfect,pore,presence,present,puberulen,rachi,radiu,ripe,ruit,rusby,short-tomentose,shorter,side,small,spaced,stone,tal,tamen,tem,thecae,tightly,time,tomento,truncat,tube,unit,vary,vein,wide,ympodial	abaxial,adaxial,arrangement,branching,form,glandular-puberulent,growth,height,inflorescence,leaf,length,ovary,plant,pubescence,seed,shape,size,stem,surface,texture,truncate
491	wfo-0001029368	success	139	69	53	86	16	0.381	.2,0.5-2,0.9-1,1.5-1.6,1.5-3,1.5-4,11-13,16-25,2-5,2.5-4,5-6,anther,bark,broadly,calyx,capitate,cm,conical,corolla,densely,dia,elliptic,erect,fruit,glabrous,globose,golden,green,herb,inflorescence,internodal,leaf,minutely,mm,opposite,ovary,pedicel,petiole,puberulent,shaped,shrub,simple,somewhat,stem,stigma,style,tear-drop,trichome,tube,uniseriate,white,x,young	.25,.5,0,1.5-2,?,abaxially,acuminate,acute,adaxially,along,anthesi,apex,apparently,base,bearing,berry,bitter,borne,breaking,brow,closely,coarse,crumpled,cup,deflexed,distal,eaf,edicel,eed,exserted,few-branched,fide,filament,flattened,flower,free,fruiting,half,indistinct,inflorescenc,known,lamina,lanceolate,lateral,leaving,like,lobe,long,lower,main,margi,margin,middle,midrib,minute,nflorescence,non-flower,obtuse,older,one,overlappin,pair,papillo,papillose,parallel,pore,poricidal,portion,reflexed,rest,ruit,scar,spaced,straight,strongly,tall,tip,ud,unifoliat,unit,upper,vein,widest,winged,woody,ympodial	abaxial,arrangement,branching,brown,color,diameter,form,growth,height,length,plant,pubescence,shape,size,texture,unifoliate
492	wfo-0001029370	success	224	122	97	127	25	0.433	-32,.3,0-35,0.1-0.15,0.5-2.2,1-2,1.5-6,1.8-2.8,12-17,2.5-3.5,3-4,3.5-4,3.5-8,4-7,5.5-7,6-15,7-13,8-20,8-23,abaxial,adaxial,almost,anther,bark,base,berry,branched,broad-deltate,calyx,chartaceous,cm,cordate,cream,dark,densely,diameter,discolorous,drying,filament,fine,flattened-reniform,flower,fruit,glabrescent,glabrous,green,greenish,herb,leaf,length,lobe,lobed,long,margin,marking,maturity,mauve,midvein,mm,moderately,multangulate,orange-brown,ornate,ovate,pair,pale,pattern,pedicel,peduncle,petiole,plant,primary,ray,red-brown,reticulate,rotate,shiny,shrub,simple,smooth,spherical,stellate-pubescent,stem,strongly,style,surface,tapering,tertiary,trichome,tube,unarmed,vein,venation,white,wide,yellow,young	-20,.1,.5,/4,0-10,0-100,0-3,0.1,0.2,0.3,0.5-1,1,1-3,1-4,1.8-2.5,1/3-1/2,1/4-1/3,10-17,10-40,10-50,15-30,2-10,2-20,2-3,2-6,3/,4-6,4-9,5-10,5-12,5-merous,7-11,8-14,abaxially,acut,alyx,ame,andromonoecious,apar,apart,apex,apically,apparently,articulated,basal,blade,c.,clearly,conical,connivent,curved,distal,distance,eaf,eed,elongate,elongating,equal,erect,extending,fewer,flattened,free,fruiting,fully,gently,hermaphrodite,heterostylous,infructescence,lateral,long-styled,longer,lower,lowermost,mature,midpoint,mixture,nflorescence,obtuse,often,older,one,open,opening,orange,orolla,oung,overlapping,pendulous,per,pericarp,perpendicular,plurifoliat,poricidal,porrect,portion,prickl,prickle,prickly,rounded,ruit,scar,sessile,short-styled,side,slightly,sometimes,spaced,spreading,stalk,stalked,staminat,stout,straight,tamen,terete,time,tip,unit,variously,vary,visible,way,white-gra,whitish,woody,ympodial	arrangement,branch,branching,color,corolla,dense,false,form,growth,height,history,inflorescence,life,main,na,number,ovary,perennial,pubescence,seed,shape,size,stigma,texture,white-gray
493	wfo-0001029373	success	199	132	90	109	42	0.452	.5,2-celled,6.8,abaxial,acuminate,acute,adaxial,age,anther,apex,articulated,bark,basal,base,bayonet,berry,broadly,calyx,capped,cell,clavate,cm,conical,corolla,curved,deltate,densely,developing,diameter,ellipsoid,elongate,entire,filament,flattened-reniform,flower,fruit,glabrous,green,grey-brown,growth,hair,herb,leaf,lengthening,like,lobe,long,margin,minute,minutely,mm,moderately,obtuse,ovary,ovate-lanceolate,pair,papillate,pedicel,peduncle,petiole,pitted,plant,pore,poricidal,primary,pubescent,shallowly,shape,short,simple,slit,spreading,stellate,stem,stigma,straight,style,surface,thicker-walled,tip,trichome,tube,uniseriate,upper,vein,white,wide,yellow,yellow-green,yellowish	.0–1.2,.2,.3,.5–2.0,0.3–0.5,0.4–1.6,0.5–1.2,0.5–1.8,0.6–0.7,1.0–1.2,1.0–1.6,1.2–1.5,1.3–2.2,1.4–3.5,1.5–2.0,1.5–2.5,1.5–2.7,1.8–2.0,1.8–2.3,180°,2.0–2.5,2.7–3.0,20–30,2–4-celled,3,3.5–4.0,30–40,3–5,4–5,4–6,5,5-merous,5–6,8–9,abaxially,accrescent,adaxially,anthesi,apar,appearanc,appressed,arising,beyond,bud,cone,distal,eaf,eed,enclosed,enclosing,exerted,finger,free,fruiting,fully,geminat,glandular-tipped,globose,half,halfway,hilum,immature,individual,internodal,lateral,laterally,less,live,lobed,lon,lower,mature,mesocarp,middle,mouth,new,nflorescence,node,older,outline,pentagonal,per,perfect,plurifoliate,portion,positioned,reflexed,resembling,root,rounded,ruit,scar,seen,seudostipule,slightly,smoot,spaced,still,tall,tem,terete,testal,trailing,tub,ud,unit,woody,ympodial,–5	0.3,0.4-1.6,0.5-1.2,0.6-0.7,1.0-1.2,1.0-1.6,1.2-1.5,1.4-3.5,1.5-2.0,1.5-2.5,1.5-2.7,1.8-2.0,2.0-2.5,2.7-3.0,20-30,3-5,4-6,5-6,8-9,arrangement,branch,branching,color,form,height,history,inflorescence,length,life,main,midvein,na,number,perennial,pubescence,seed,size,smooth,texture,unarmed,width,young
494	wfo-0001029402	success	113	90	51	62	39	0.451	0.5-1,0.5-2,1-2.5,15-30,2,2-3,3-4,3-6,4-6,5-25,6-16,7-11,7-8,7-9,8-15,abaxial,base,branched,calyx,ciliolate,cm,color,deltate,diameter,elliptic,flower,glabrous,lanceolate,lobe,margin,mm,narrowly,nearly,pedicel,peduncle,petiole,pubescence,roughened,shrub,simple,somewhat,stellate,stigma,style,surface,tapered,triangular,tube,unknown,violet,x	11-17,2-10,3-5,4-7,4-8,abaxially,acuminate,acute,adaxially,apart,apex,articulated,axe,band,blade,chartaceous,connivent,cylindrical,denser,directed,distall,eaf,eed,fleshy,forked,free,glabrate,glabrou,hair,inrolled,leaving,long,lower,many-foliat,moderately,narrowed,nflorescence,nther,often,orolla,papillose,pore,pubescent,rachi,rachise,radiu,ruit,scale-like,scar,spaced,sparsely,tal,tem,thickened,time,tip,truncat,unit,unknow,vary,wide,ympodial	adaxial,anther,arrangement,bark,branch,branching,corolla,drying,filament,form,fruit,growth,height,history,inflorescence,leaf,length,life,main,midvein,na,number,ovary,plant,primary,ray,seed,shape,size,stem,tertiary,texture,trichome,truncate,unarmed,vein,venation,width,young
495	wfo-0001029404	success	154	128	88	66	40	0.571	-3,0-60-flower,0.5-1,1,1-4,2-3,2-4,2-5,2.5-22,2.5-3,3-4,3-5,3-8.5,5-10,5-20,5-24,5-6,6-8,6.5-34,8-12,abaxially,acute,adaxially,anther,apex,apiculate,auriculate,base,branched,calyx,center,chartaceous,cm,connivent,cordate,cream,dark,darker,deltate,densely,diameter,eglandular,ellipsoidal,entire,flattened,flower,fruit,glabrous,glandular,green,hair,lanceolate,less,light,lobe,long,longitudinal,margin,mm,moderately,mottling,orange,ovate,pedicel,peduncle,petiole,pink,puberulent,pubescent,purple,ripe,shrub,simple,somewhat,star,stellate,stigma,style,subcoriaceous,toward,tree,triangular,tube,unbranched,vein,white,x,yellow	-1.5,-10,-5,1.5-2,15-25,2,2-8,20-35,4-foliat,6-9,absent,acuminate,aggregate,apart,ape,articulated,axe,basal,beyond,blade,cell,connective,cylindrical,directed,distally,eaf,eed,exserted,fleshy,glandular-puberulen,leaving,lemon,lon,lower,narrowly,nflorescence,nther,obtuse,orang,orolla,ovoid,pedicellar,perfect,pore,presen,rachi,radiu,remnant,ruit,shorter,slightly,small,spaced,sparsely,stone,tal,tem,thecae,time,tomento,truncat,ud,unit,vary,wide,ympodial	abaxial,adaxial,arrangement,bark,branch,branching,color,corolla,drying,filament,form,growth,height,history,inflorescence,leaf,length,life,main,midvein,na,number,ovary,plant,primary,pubescence,ray,seed,shape,size,stem,surface,tertiary,texture,trichome,truncate,unarmed,venation,width,young
496	wfo-0001029406	success	136	106	86	50	20	0.632	0.3-1,0.5-1,0.6-1,0.7-1.5,1-1.5,1-10,1-2,1.5-2.2,1.5-5,2,2-11,2-3,2.5-3.5,28,3-9,30,4-18,4-6,anther,arachnoid,arachnoid-pubescent,bark,base,broadly,brown,calyx,clavate,cm,corolla,dark,deciduous,deltate,dia,elliptic,felt-like,filament,glabrous,globose,grayish-brown,grayish-green,green,greenish-white,large,leaf,lenticel,lilac,lobe,lobed,long,matted,maturity,minor,minutely,mm,nearly,often,ovary,ovoid,ovoid-reniform,pale,papillose,petiole,pitted,population,poricidal,pubescent,shaped,shiny,shrub,size,slightly,small,soon,stem,stigma,style,surface,tear-drop,tinge,tip,tree,trichome,tube,white,wide,young	.5,1.5-2.5,7-12,abaxially,acute,adaxially,along,anthesi,apex,ba,berry,brownish,bullate,conical,conspicuously,deflexed,densely,differing,difoliate,dry,eaf,eed,free,fruiting,geminat,impressed,lateral,lon,lower,main,major,margin,middle,occasionally,older,pair,papillo,pedicel,planar,pointed,pore,portion,ruit,tall,unit,vein,waxy,widest,woody,ympodial	abaxial,adaxial,arrangement,color,diameter,difeoliate,flower,form,fruit,geminate,growth,height,length,na,plant,pubescence,seed,shape,texture,width
497	wfo-0001029407	success	208	146	119	89	27	0.572	-25,-6,-7,.5,/3,0-2,0-5,0.1-0.25,0.4-0.7,0.5-0.7,0.5-1.5,0.5-2,0.6-0.9,1-1.4,1-2,1-4,1-4.5,1.8-2.5,1/5,2-3,2.5-3,3-4,3-6,4-15,5-7,6-20,7-8,abaxial,acute,adaxial,almost,anther,apically,apparently,bark,base,berry,bright-red,calyx,chartaceous,cm,connivent,cuneate,dark,deltate,densely,diameter,discolorous,drying,dull,elliptic,entire,erect,evenly,filament,flattened-reniform,flower,fruit,glabrescent,glabrous,gray-greenish,green,green-brown,lateral,leaf,length,lobe,lobed,long,margin,mature,maturity,mauve,mm,moderately,occasionally,orange,orange-brown,ovate,pair,pedicel,peduncle,petiole,poricidal,porrect,prickle,prickly,primary,rarely,ray,rounded,sessile,shrub,simple,sometimes,sparsely,spherical,stalked,stellate,stellate-pubescent,stem,strongly,style,surface,tapering,tertiary,tip,trichome,tube,unbranched,upper,vein,venation,way,white,wide,yellow,yellow-green,young	-10,-2,-4,0,0-15,0-4,0.1-0.2,0.15-0.4,0.2-0.3,0.4-1,0.6,0.7-1.2,1,1-3,1.5,1/3,1/3-1/2,1/8-1/5,2-4,2-5,3.5-4.5,4-9,4.5-6,5-merous,6-13,abaxially,acut,alyx,apar,apart,apex,articulated,blade,brow,curved,difoliate,eaf,eed,elongating,equal,flattened,free,fruiting,geminat,geminate,infructescence,lengt,longer,lower,midpoint,nflorescence,obtuse,older,one,open,orolla,oung,pale,pendulous,per,perfec,pericarp,portion,prickl,pubescent,recurved,reflexed,ruit,scar,shorter,side,slender,smooth,spaced,spreading,stalk,stout,straight,straw-yellow,tamen,terete,thick,time,unit,vary,visible,weakly,woody,ympodial	arrangement,branch,branching,brown,color,corolla,form,growth,height,history,inflorescence,life,main,midvein,na,number,ovary,perennial,plant,pubescence,seed,shape,size,stigma,texture,unarmed,width
498	wfo-0001029408	success	244	150	124	120	26	0.508	0,0-100,0.2-0.3,0.7-1.2,0.9-1.3,1-8,1.1-1.5,1.4-1.9,1.6-2.8,1.7-2.4,11-31,2-12,2-4,2-5,2.2-3.7,3-5,4-14,4-20,4-7.5,5-24,5-6.5,7-12,abaxially,acute,adaxially,anther,base,blade,blunt-tipped,branched,broadly,brown,calyx,clavate,cm,conical,corolla,cuneate,dark,decurrent,deltoid,dendritic-multangulate,densely,diameter,echinoid,elliptic,entire,few-rayed,fleshy,flower,fruit,glabrous,globose,green,growth,hair,honeycombed,lanate,lanceolate,leaf,length,lilac,lobe,long-,long-stalked,margin,midvein,mixed,mm,moderately,mostly,multangulate,oblong,ovate,overlapping,pale,part,partly,pedicel,peduncle,persistent,petiole,plurifoliate,porrect-stellate,pubescent,purplish,rarely,rather,reniform,reticulate-punctate,ripe,rotate-stellate,sessile,short-,short-attenuate,shrub,slightly,small,sometimes,stelliform,stem,stigma,style,subcampanulate,suborbicular,terete,thick-stalked,thick-textured,thin-stalked,time,tomentose,top,touching,tree,tube,unarmed,vein,velutinous,white,whitish,x,yellow,yellowish,young	-1.5,-10.5,-4.5,.2-3.5,/10,0.3-5,0.5-2.5,0.9-1.6,1.5-3,1.8-3.5,1/2,1/2-3/4,1/4,2-3.5,2.5-7,2/3,3.5-5,5-6,5-8,5-merou,accrescent,acuminate,adaxiall,ag,alyx,anthesi,apart,apex,apical-lateral,articulated,axe,axillary,ba,barely,bark,becoming,berry,branch,bud,capitat,chartaceous,continued,dehiscing,dendritic-echinoi,develope,directed,distal,distall,due,eaf,echinoi,eed,exserted,extend,faintly,filament,free,fruiting,gray,high,homostylous,indument,inserted,interpetalar,introrse,lacking,large,lateral,lobed,long,long-attenuate,longitudinal,lower,m.,main,many,near,nearly,nflorescence,obscured,obtuse,often,older,orbicular,orolla,ovate-lanceolate,perfect,pore,present,pseudo-terminal,rachi,ray,relatively,ribbed,ruit,runk,short-stalked,side,simple,slit,spaced,stamen,subovate,suture,tamen,testa,thick,tissue,tomentu,tomentum,toward,turbinate,unarme,unit,usually,vary,way,well,wide,ympodial	abaxial,adaxial,arrangement,branching,capitate,color,dendritic-echinoid,form,height,history,inflorescence,life,na,number,ovary,perennial,plant,primary,pseudoterminally,pubescence,seed,shape,size,surface,texture,ye
499	wfo-0001029417	success	213	141	107	106	34	0.502	.5,0.2-0.6,0.7-3,1-2,1.3-8,1.5-1.8,1.5-8,2.5-10,2.8-3.5,3-5,4-7,5-15,6-11,8-15,8-9,anther,attenuate,base,basiscopic,blue,broadly,brownish,cell,central,chartaceous,clavate,cm,coarsely,condition,corolla,covering,dark,decurrent,deep,diameter,dot,drying,erect,filament,flower,forked,fresh,fruit,glabrous,globose,green,greenish,hair,hair-like,herb,lanceolate,lateral,like,linear,lobe,long,margin,medium,membranous,mm,moderately,narrowly,non-glandular,odd-pinnate,often,orbicular,ovate,ovoid,pedicel,peduncle,pentagonal,petiole,pilose,plant,poricidal,pubescent,purple,rarely,ripe,rotate,scattered,seed,sessile,short,side,size,slightly,sometimes,star,stem,stigma,style,testal,thick,tinged,tip,trichome,tube,typically,violet,wall,white,whitish,wide,widely,x,yellow	0-7,0.4-8,1,1-1.5,1-10,1-4,1-8,1.5-10,12,2-4,3-14,5-merou,abaxially,acumen,acuminate,acute,adaxially,ag,along,alyx,apart,apex,apiculate,apparently,articulated,axe,axillary,berry,blade,borne,bud,capitat,ciliate,connivent,decreasing,digestion,distal,dorsally,eaf,edge,eed,end,enzyme,erec,especially,exceeding,flat,folded,geminat,generally,glabrou,greatly,green-white,hal,half,homostylous,honeycomb-shaped,interjected,leaflet,lengthening,living,lower,lunate,make,midrib,minute,minutely,mucilaginous,nflorescence,orolla,pair,perfect,petiolulate,plurifoliate,pore,puberulent,rapidly,removed,rounded,ruit,seudostipule,short-petiolulate,singly,slit,spaced,specimen,stamen,ste,stolo,straight,subequal,subtending,tall,tamen,tem,terminal,throughout,tri-,tuber,unit,unwinged,usually,vary,wet,wing,ympodial	abaxial,adaxial,arrangement,bark,branch,branching,calyx,capitate,color,form,growth,height,history,inflorescence,leaf,length,life,main,midvein,na,number,ovary,primary,pubescence,ray,shape,surface,tertiary,texture,unarmed,vein,venation,width,young
500	wfo-0001029437	success	198	152	122	76	30	0.616	-10,.5,1,1-3,1.5-2,10-12,2-3,2.5-3.5,2.5-5,3-3.5,3-5,3-7,4-5,5-9,6-8,7-10,acicular,anther,armed,axi,bark,basal,base,beige,berry,blue,branched,brownish,calyx,chartaceous,clavate-truncate,cm,cordate,coriaceous,corolla,cylindrical,dark-green,diameter,elliptic,elliptic-lanceolate,entire,filament,flattened,flower,glabrescent,glandular,globose,golden,green,greyish,growth,hirsute,inflorescence,irregularly,juvenile,lamina,leaf,lengthening,like,linear-oblong,lobe,lobed-angulate,long-styled,margin,maturity,membranous,minute,minutely,mm,oblong,oblong-lanceolate,obverse,orange,ovary,ovate,ovate-elliptic,pedicel,peduncle,persistently,petiole,plant,pore,poricidal,prickle,prickly,pubescence,pubescent,reniform,rest,reticulate,rounded,rusty,short-styled,shrub,similar,simple,slit,sparsely,stellate,stellate-pubescent,stem,stigma,style,subcordate,subglobose,suborbicular,subscabrous,subulate,surface,tip,tomentose,trichome,tube,unarmed,velutinous,villous,violet,visible,woody,x,yellow,¼	0.5-1,1-1.5,1-2,1/3,30-50,9-13,abaxially,acute,adaxially,anthesi,antrorse,apar,apex,apical,articulated,brow,c.,compressed,densely,distal,eaf,eed,eglandular,enclosed,erect,except,free,fruiting,glabrous,gland,heterostylous,internodal,leaving,lobed,long,loose,lower,midpoint,multangulate,multicellular,near,nearly,new,nflorescence,older,ovoid,packed,papillo,per,perfect,pericarp,plurifoliat,porrect,portion,recurved,rotate,ruit,scar,sessile,spaced,stalked,staminate,subscandent,tall,tapering,testa,thick,triangular,ud,unevenly,unicellular,unit,upper,whitish,without,ympodial	abaxial,adaxial,arrangement,branch,branching,brown,color,form,fruit,height,history,length,life,main,midvein,na,number,papillose,perennial,primary,ray,seed,shape,size,tertiary,texture,vein,venation,width,young
501	wfo-0001029440	success	218	144	118	100	26	0.541	-10,0.5-0.6,0.9-1,1,1-1.2,1-1.5,1.5-2,2-2.5,2-3,2-4,2-6,2.5-7,30,4-5,4-6,4-6-forked,5-15,5-5.5,6.5-8,8-10,>,abaxial,acicular,across,acute,anther,apex,armed,articulate,bark,base,beige,branch,brown,calyx,canaliculate,clavate,cm,coriaceous,curved,cyme,dark,dark-green,deeply,diameter,enlarged,entire,ferruginous,filament,finely,flower,fruit,glabrescent,glabrous,glandular-pubescent,glandular-stellate,glandular-tipped,globose,lanate,lanceolate-attenuate,leaf,leathery,length,lobe,lobed,long,minutely,mm,oblong-elliptic,oval-elliptic,papillose,parted,pedicel,peduncle,perennial,perfect,petiole,plant,porrect-stellate,prickle,primary,rarely,ray,reddish,reticulated,rounded,rugose,scabrous,shiny,shrub,slender,small,solitary,staminate,stellate,stem,stigma,straight,strigose,style,sub-coriaceous,sub-terete,sub-truncate,subcampanulate,subreniform,subsagittate,surface,terete,terminal,triangular,trichome,tube,unarmed,vein,velutinous,white,wide,young	0.2-0.3,0.3-1,1-2,1-2-celled,1-nerved,2,20,4-8,5-6,5-merous,9-10,9-12,<,accrescent,adpressed,along,alyx,anthesi,ape,apical,basal,bicolorous,blade,brow,caly,central,compressed,deciduous,distal,eaf,eed,elongate,enclosed,epicarp,equal,erect,exceeding,exserted,floral,free,fruiting,functional,fused,geminat,gynoeci,held,indument,leaving,longer,lower,midrib,mucilaginous,nflorescence,numerous,oblong-lanceolate,obver,older,orolla,part,partially,peg,persistent,petiol,plurifoliate,pore,prominent,rachi,recurved,reduced,reflexed,ruit,secondary,sepal,sessile,short,similar,somewhat,sparse,sparsely,stalked,stamen,stellate-glandular,stiff,strongly,surfac,tall,tamen,testa,tomentose,touch,tri-,unit,upright,vary,within,without,yellowish,ympodial,¼,¾	adaxial,arrangement,branching,color,corolla,drying,form,growth,height,history,inflorescence,life,main,margin,midvein,na,number,ovary,pubescence,seed,shape,size,tertiary,texture,venation,width
502	wfo-0001029461	success	217	132	109	108	23	0.502	-1.5,-3,-3.2,-4.5,-5,.5,0.1-0.25,0.6-1,0.8-1.5,1-,1-1.6,1.2-1.8,1.3-2.2,1.5-,2-2.4,2-2.8,2-3,2-4,2.5-3,3-6,4-6.5,4.5-7,5-merous,8-9,almost,anther,attenuate,bark,base,berry,black,broad-deltate,calyx,cell,chartaceous,cm,concolorous,cuneate,dark,densely,diameter,discolorous,drying,dull,elliptic,erect,evenly,faint,filament,fine,flattened-reniform,flower,fruit,glabrescent,glabrous,green,leaf,length,lobe,lobed,long,margin,maturity,mauve,midvein,mm,moderately,oblong,outline,ovate,pair,pedicel,petiole,pit,plant,poricidal,porrect,prickly,primary,raised,ray,reddish,sessile,shiny,shrub,simple,small,smooth,sometimes,sparsely,spherical,stalked,stellate-pubescent,stem,style,subentire,surface,tertiary,tip,trichome,tube,unarmed,vein,venation,weakly,wide,yellow,young,zygomorphic	-14,-2,-3/4,-4,0,0.1,0.15-0.25,0.7-1,0.8,1-2,1-3,1-4,1-6,1.2-1.7,1.5-2,1/3,1/3-2/3,1/4,1/4-1/2,3-20,4-10,4-7,4.7-7.2,5-10,5-25,7-10,7-12,abaxially,acuminat,alyx,ame,andromonoecious,apart,apex,apically,becoming,blade,breaking,brittle,brown,c.,curved,distal,distance,eaf,eed,elongating,extending,fifth,flattened,four,free,fruiting,gra,hermaphrodite,heterostylous,infructescence,lengt,long-styled,longer,lower,lowermost,mature,midpoint,obovate,obtuse,older,orange,orolla,oung,pendulous,per,pericarp,plurifoliat,portion,prickl,prickle,reduced,reflexed,rounded,ruit,shallow,short-styled,shorter,side,slender,slightly,spaced,spreading,stalk,staman,staminat,stellate,straight,strongly,tamen,terete,time,unarme,unequal,unit,upper,variously,vary,visible,way,woody,ympodial	abaxial,adaxial,arrangement,branch,branching,color,corolla,form,gray,growth,height,inflorescence,main,na,number,ovary,peduncle,pubescence,seed,shape,size,stigma,texture
503	wfo-0001029462	success	166	94	68	98	26	0.41	-2,-30,-4,0.5-1,0.5-2,1-3,1-6,1.5-2,1.5-7,10-,15-25,2-6.5,2.5-3.5,2.5-5.5,20-35,3-18,3-7,4-20,5-30,6-9,7-8,beyond,calyx,chartaceous,cm,cylindrical,dark,densely,diameter,ellipsoidal,elliptic,equal,exserted,flattened,flower,fruit,glabrous,green,lanceolate,light,lobe,longitudinal,membranaceous,minutely,mm,moderately,occasionally,ovate,pedicel,peduncle,petiole,puberulent,pubescent-pilose,purplish,reticulate,simple,sparsely,stamen,stigma,stripe,style,tree,triangular,truncate,unbranched,white,x,yellow	-5,1,1-,1-2,1.5,1.5-3,10-22,2-3,3,3-27,3-4,3-5,3-6,4-15,4-foliat,7-19,8-9,abaxially,abruptly,absent,acuminate,acute,adaxially,aggregate,apart,ape,apex,articulated,axe,basal,base,blade,broad,campanulate,cell,ciliate,connective,connivent,constricted,cuneate,curled,dentate,directed,eaf,eed,eglandular,entire,exceeding,hair,laterally,leaving,lon,long,lower,m.,margin,narrowly,near,nflorescence,nther,obtuse,often,orolla,oval,ovoid,pedicellar,perfect,pore,pubescent,pubescent-pilo,purpl,rachi,radiu,remnant,rounded,ruit,shorter,slightly,small,smooth,somewhat,spaced,stellate-,stone,tal,tem,thecae,time,tip,tomentose,truncat,tube,ud,unit,vary,wide,without,ympodial	abaxial,adaxial,anther,arrangement,color,corolla,form,growth,height,history,inflorescence,leaf,length,life,na,ovary,perennial,plant,pubescence,seed,shape,size,stellate-campanulate,stem,surface,texture
504	wfo-0001029464	success	235	137	115	120	22	0.489	.9,0-80,0.2-0.5,0.2-0.7,1-10,1-8,1/4,1/4-1/2,10-23,10-40,2-3,2-3.5,2.2-2.5,2.5-5,2.9-3.2,3-20,3-7,4-7,5-17,5.5-7.5,6-15,8-15,9-15,abaxial,adaxial,annual,anther,apparently,bark,base,black,branched,brown,calyx,chartaceous,cm,connivent,cordate,curved,dark,deltate,diameter,discolorous,drying,ellipsoid,filament,flattened-reniform,flower,fruit,glabrescent,glabrous,globular,green,green-brown,herb,lateral,leaf,length,lobe,lobed,long,lower,margin,maroon,maturity,mauve,midvein,mm,moderately,mottled,narrow-deltate,oblong,obtuse,orange-brown,ovate,ovoid,pair,pedicel,peduncle,petiole,pink,plant,poricidal,porrect,primary,purple,ray,red-brown,sessile,simple,smooth,sometimes,stalked,stellate-pubescent,stem,striped,style,surface,tapering,terminal,tertiary,tip,trichome,tube,unarmed,upper,usually,variously,vein,venation,way,white,wide,yellow-green,young	-2/3,-3,-30,-5,0,0-2,0.2,0.3-0.7,0.3-1,0.5,0.5-2,0.8-2,00-200,1,1-3,1.2-3,1.5-2,1/,1/4-1/3,10-15,10-50,12-50,2,2-4,2.4-4,2.5-8,3-5,3.5-5,4-8,4-8-merous,5-8,5.5-6,7-10,8-13,abaxially,acicular,acute,alyx,ame,andromonoecious,apar,apart,apex,apically,around,articulated,berry,blade,broad,broad-deltate,brow,c.,cultivar,cup-shaped,difoliate,distal,distance,eaf,eed,elongated,elongating,equal,erect,extending,free,fruiting,fully,geminat,glaucous,hair,hermaphrodite,heterostylous,infructescence,less,long-acuminat,long-styled,longer,lowermost,mature,midpoint,minute,nflorescence,occasionally,often,older,one,open,opening,orolla,oung,pendent,pendulous,per,pericarp,portion,prickl,prickle,prickly,rounded,ruit,scar,short-styled,side,spaced,sparsely,spreading,stalk,staminat,stellate,straight,tamen,terete,time,translucent,unit,vary,visible,woody,yellow-orange,ympodial	1/2,arrangement,branch,branching,color,corolla,form,glarescent,growth,height,inflorescence,main,na,number,ovary,pubescence,seed,shape,size,stigma,texture,ye
505	wfo-0001029505	success	169	110	89	80	21	0.527	%,.1,0-0.3,0.3-0.5,0.5-1.1,0.8-1,1-1.2,1-3,2-4,2-7,2.4-3.2,2.7-4,22-25,4.5-5.5,5-7.5,5.5-7,6-18,7-12,7-20,8-10,absent,acicular,anther,apex,articulated,base,brown,calyx,chartaceous,cm,deltate,densely,diameter,elliptic,elliptical,entire,extra-axillary,flower,fruit,glabrous,gland-tipped,globose,green,hair,inflorescence,lamina,length,lobe,long,longer,margin,midpoint,mm,moderately,obtuse,ovate,pale,pedicel,peduncle,perennial,petiole,plant,present,prickle,prostrate,pseudo-racemose,red,rotate-stellate,short,shrub,simple,solitary,sparsely,stellate,stellate-pubescent,stoloniferous,straight,style,thick,throughout,time,tube,unarmed,unbranched,white,wide,x,yellow,yellowish	.05,0-10,0-3,0-3.5,0.15-0.2,0.15-0.25,0.2-0.3,1-6,1-locular,1.5-2.2,2-5,5-merou,6-8,7-8,abaxially,absen,across,adaxiall,adaxially,adult,alyx,andromonoecious,apart,axe,ba,blade,branche,confined,cross-section,cuneateor,cylindrical,decimetre,directed,distall,eaf,eed,elliptica,exocarp,finger,fruiting,functional,half,heterostylous,incomplete,juicy,lateral,less,lower,mature,mesocarp,midrib,midvein,minute,moist,nflorescence,oblique,onl,orolla,part,per,placenta,pore,porrect,ray,ruit,semi-circular,septum,sessile,spaced,stellae,tal,tamen,tem,transparent,unarme,unit,unknow,vary,weakly,ympodial	abaxial,adaxial,branching,color,corolla,cuneate,form,growth,height,leaf,ovary,presence,pubescence,seed,shape,size,stem,tall,texture,unknown,width
506	wfo-0001029524	success	212	153	126	86	27	0.594	-5,-6,-8,0.1-0.3,0.7-0.8,1-,1-2,1-3,1.2-1.5,1.5-2,12-25,2-,2-2.5,2-3,2-4,25,3-,3-3.5,3-8,4-4.5,4-6,4-7,5-15,6-7,7-9,acicular,acute,angulate,anther,articulated,bark,base,beige,berry,branched,brown,calyx,campanulate,channelled,cm,corolla,corymbose,cyme,decumbent,diameter,eglandular,entire,filament,flattened,flexuous,flower,glandular,glandular-hirsute,globose,green,grey,growth,impressed,lanate,light,linear-oblong,lobe,lobed,long,long-styled,loosely,margin,maturity,membranous,minute,mixture,mm,oblique,obtuse,ovary,ovate,ovate-elliptic,ovate-lanceolate,pedicel,peduncle,petiole,plant,poricidal,porrect,prickle,pubescence,reniform,reticulate,rounded,rugose,rusty,short-styled,shrub,size,slightly,somewhat,stellate,stellate-pilose,stem,stigma,style,sub-cordate,subcordate,subcoriaceous,suborbicular,subspherical,surface,tapering,time,tiny,tip,tomentose,triangular-lanceolate,trichome,tube,unarmed,vein,velvety,venation,viscid,white,woody,x,yellow,yellow-green,yellowish	.5,0.2-0.3,0.9-1.2,1-1.5,10,6,9-10,abaxially,acuminate,adaxially,adult,anthesi,apex,basal,cell,clavate-truncat,congested,densely,discolorous,distal,distall,doubling,eaf,eed,elongating,erec,erect,exceeding,exserted,filamentous,flowering,foliaceous,free,fruiting,glabrescen,glabrous,heterostylous,internodal,leaving,like,long-stalked,lower,m.,midpoint,multicellular,new,nflorescence,numerous,oblong,oblong-lanceolate,obverse,occasionally,older,one,partially,perfect,pericarp,plurifoliat,pore,portion,prickly,pubescent,recurved,ruit,scar,sessile,single,slit,spaced,sparsely,stalked,staminate,stellate-pubescent,subbsessile,subscabrous,tall,testa,turbinate,ud,unevenly,unit,upper,villous,way,ympodial,¾	abaxial,adaxial,arrangement,branch,branching,clavate-truncate,color,form,fruit,glabrescent,height,inflorescence,leaf,length,main,midvein,na,number,plurifoliate,primary,ray,seed,shape,tertiary,texture,width,young
507	wfo-0001029546	success	203	124	90	113	34	0.443	0.3-1,1-2,1-4.5,1.5-2,1.5-6.2,2.2-2.8,3.5-5,4-10,4.5-12.5,4.5-7,5-18,5-8,7-10,8-17,8-19.5,anther,apiculate,attenuate,base,blue,broadly,brownish,cell,chartaceous,clavate,cm,condition,connivent,cordate,corolla,covering,densely,diameter,drying,elliptic,elliptical,filament,flower,forked,fresh,fruit,glabrous,glandular,globose,green,greenish,hair-like,herb,lanceolate,lateral,leaf,lobe,long,longer,membranous,mm,non-glandular,oblique,odd-pinnate,ovate,ovoid,pedicel,peduncle,pentagonal,petiole,plant,pubescent,rarely,regular,ripe,rotate-pentagonal,seed,short,simple,size,slightly,soft,stem,stigma,style,testal,thick,tinged,trichome,tube,wall,white,whitish,x,yellow	0-2,1-10,1-3.2,1-5,1.6-6.5,2-4,2-9,3-8,5,5-10,5-merou,6.3-19.5,8,abaxially,absent,acumen,acuminate,acute,adaxiall,adaxially,ag,alyx,apart,apex,apparently,articulated,axe,axillary,berry,blade,bud,capitat,covered,curved,decreasing,decumben,decurrent,digestion,distal,dorsally,dot,eaf,edge,eed,enzyme,erect,exceeding,flat,folded,frequently,geminat,generally,glabrou,greatly,green-white,hair,half,homostylous,honeycomb-shaped,interjected,leaflet,lengthening,like,living,lower,lunate,make,middl,minutely,mottle,mucilaginous,nearly,nflorescence,often,orbicular,pair,perfect,petiolule,plurifoliate,pore,poricidal,purple,rachi,removed,ruit,sessile,seudostipule,slit,sometimes,spaced,specimen,stamen,ste,straight,subequal,subtending,tall,tamen,tem,terminal,throughout,tip,tri-,truncate,typically,unit,unwinged,usually,vary,wet,wide,wing,ympodial	abaxial,adaxial,arrangement,bark,branch,branching,calyx,capitate,color,form,growth,height,history,inflorescence,length,life,main,margin,midvein,na,number,ovary,primary,pubescence,ray,shape,surface,tertiary,texture,unarmed,vein,venation,width,young
508	wfo-0001029552	success	161	124	95	66	29	0.59	.25,0.1-0.5,0.5,0.6-1,1-1.3,1-1.5,1-3,1-5,1.5-2,10-20,12,2-2.5,2.5-3,5-10-flowered,5.5-8,6-9,abaxial,abaxially,acute,adaxially,anther,area,bark,base,branched,broadened,broadly,calyx,cm,conical,corolla,decurrent,deltate,dendritic,densely,dia,drying,elliptic,erect,filament,flattened-reniform,flower,glabrous,globose,green,incrassate,inflorescence,lateral,leaf,lobe,lobed,long,long-styled,main,margin,minute,minutely,mm,nearly,occasionally,opposite,ovary,pair,pale,paler,pedicel,petiole,pitted,pubescent,shape,shaped,shining,shrub,simple,size,small,somewhat,sparsely,stem,stigma,style,surface,tan,tear-drop,tip,tree,tree-like,trichome,tube,vein,white,wide,x,yellowish,young	.5,1-2,1.5-6.5,2-9,abruptly,acuminate,along,anthesi,apex,berry,clavate,closely,contracted,deflexed,denser,differing,difoliate,eaf,edicel,eed,exserted,free,fruiting,geminat,greyish-brow,heteromorphic,inflorescenc,lamina,later,like,lon,lower,major,middle,minor,nflorescence,older,onto,orbicular,overlappin,papillo,persistent,planar,pore,poricidal,portion,present,reflexed,rest,rounded,ruit,scar,scattered,short-styled,slender,slightly,spaced,strongly,swollen,tall,tub,ud,unit,widest,woody,ympodial	adaxial,arrangement,branch,branching,color,diameter,form,fruit,greyish-brown,growth,height,history,length,life,midvein,na,number,papillose,peduncle,plant,primary,pubescence,ray,seed,tertiary,texture,unarmed,venation,width
509	wfo-0001029558	success	184	128	98	86	30	0.533	.5,0.05-0.1,0.1-0.2,0.1-0.9,0.3-0.5,0.5,1-1.1,1-1.5,1-3,1.5-2,2-3,2-4,2.5-3.5,6-10,6-9,<,acute,anther,bark,base,berry,branched,calyx,capitate,cm,conical,corolla,densely,diameter,divaricately,ellipsoid,elongate,entire,filament,flattened,flower,geminate,glabrous,globose,growth,inflorescence,interlocking,later,leaf,like,lobe,lobed,long-triangular,margin,mere,midvein,minutely,mixture,mm,narrowly,nearly,obovate,obspathulate,ovary,pair,pale,pedicel,peduncle,petiole,pitted,porrect,prickly,primary,pubescent,ray,red,reddish,reniform,rhombic,sessile,shape,shiny,short-stalked,shrub,simple,size,sparsely,stalked,stellate,stem,stigma,style,surface,tan,tapering,thin,trichome,tube,upper,vein,white,widening,x	0.1-,0.15-0.2,0.2-,0.4,0.4-0.6,0.4-1.1,0.5-2,1,1-4,10-16,2,4-merous,?,abaxially,adaxially,along,anthesi,apex,armed,articulated,bearing,cell,closely,deflexe,difoliate,eaf,easily,eed,elliptic,enclosed,equal,erect,filiform,free,fruiting,geminat,glabrescent,gre,highly,hyaline,including,internodal,larger,leave,lengthening,long,lower,midpoint,new,nflorescence,node,obtuse,occasionally,older,overlapping,paired,papillo,per,perfect,pericarp,planar,pore,poricidal,portion,prickle,rest,rhachi,rounded,ruit,scar,shorter,sinus,slit,small,spaced,square,straight,testal,tiny,tip,ud,unit,usually,visible,wall,ympodial	0.1-1.1,0.2-2,abaxial,adaxial,arrangement,branch,branching,color,drying,false,form,fruit,grey,height,history,length,life,main,na,number,papillose,plant,pubescence,seed,tertiary,texture,unarmed,venation,width,young
510	wfo-0001029569	success	265	125	94	171	31	0.355	0.2,1.6,1/3,2,3.2,4.9,8.1,abaxially,across,acuminate,adaxially,aequilateral,along,anther,apex,apiculate,attenuate,base,becoming,blade,branching,brochidodromous,calyx,channeled,chartaceous,cm,corolla,cuneate,densely,diameter,distinct,dry,elliptic,emerging,extra-axillary,flattened-reniform,flower,fruit,glabrous,globose,internode,interpetalar,lamina,lateral,length,light,lobe,mature,middle,midvein,mm,moderately,nearly,oblique,orange,ovate,pedicel,peduncle,petiole,porrect,porrect-stellate,probably,pubescent,raised,red,restricted,rounded,scarcely,sessile,shrub,sparsely,stellate,stem,stigma,stipitate,straight,style,surface,terete,time,tip,tissue,toward,truncate,tube,upper,vein,weakly,well-developed,white,yellow,yellow-ferruginous,yellow-tan,×	.0,.2,.3,.4,.9,/2,/3,0.03,0.05,0.1,0.2–0.5,0.3–0.5,0.4–0.6,0.5–0.8,0.6–0.8,0.6–0.9,0.7–0.9,0.8–1.0,0.9,0.9–1.3,0.9–1.4,0.9–2.0,1.0–1.3,1.3–1.8,1.4–2.4,1.5–1.7,1.6–4.5,1.7–2.3,1.8–2.5,1/2–2/3,130,14.6–16.5,2.0–3.2,2.3–3.0,2.3–4.4,3.2–3.8,3.4–3.7,4.0,4.5,4–6,5-merou,5.0,5.1,5.3–16.6,5.7–6.6,6.3–18.5,6.8–7.8,6–12,6–8,7.4–9.1,7–10,90°,adnate,ag,alyx,anthesi,apart,apical,apparently,appearing,around,articulate,axe,ba,bark,basal,berry,branch,broad,bud,capitat,clinate,deciduous,dentate,development,difoliate,directed,distal,distally,eaf,edge,eed,either,endocarp,entire,evenly,exocarp,extending,fertile,filament,filiform,flexed,free,geminat,glandular,glossy,gradually,hair,homostylous,increasing,intact,intersepalar,juic,lacking,layer,less,lon,long,longer,lower,many,margin,midpoint,midrib,minute,nflorescence,oblong,orolla,ove,per,perforated,pore,portion,potentially,ray,reduced,reflexe,remaining,reticulate,rigid,row,ruit,short,short-stipitate,shorter,side,simple,sinuate,sinus,sloughing,smoot,spaced,splitting,spread,spreading,stamen,stellae,stellate-pubescent,stipe,suture,tamen,tardily,tem,thin,translucent,transparent,triangular,two,ud,unarmed,unit,various,vary,well,wide,ympodial,young,±90°,±equal,±glabrous,±well	0.3,0.5-0.8,0.6-0.8,0.6-0.9,0.7-0.9,0.9-1.3,0.9-2.0,1.3-1.8,1.5-1.7,14.6-16.5,2.2,2.3-3.0,3.2-3.8,4-6,5.3-16.6,5.7-6.6,6.3-18.5,capitate,color,form,growth,height,inflorescence,leaf,ovary,plant,pubescence,seed,shape,size,texture
511	wfo-0001029584	success	180	123	87	93	36	0.483	1,1-2,1-6,1.5-6.5,16.2-33,2-3,2-4,3-10,4-15,4-5,4.5-11.5,6-7,7-14,8-15,9.7-23.4,abaxially,adaxially,anther,asymmetric,base,basiscopic,brownish,cell,clavate,cm,condition,connivent,coriaceous,corolla,covering,dark,densely,diameter,drying,elliptic,filament,flower,forked,fresh,fruit,glabrescent,glabrous,green,green-white,greenish,hair,hair-like,herb,lateral,leaf,light,lobe,make,margin,mm,mucilaginous,oblong-lanceolate,odd-pinnate,ovate,ovoid,pedicel,peduncle,pentagonal,petiole,petiolulate,plant,pubescent,purple,seed,short,side,simple,size,stigma,style,substellate,testal,thick,throughout,tissue,tube,wall,wet,white,whitish,x,yellow	0-30,1-3,2.4-6.3,3-5,3-7,4-14,5-merou,5.3-13.3,6.1-9.4,9.8-17,acumen,acuminate,acute,ag,alyx,apart,apex,apparently,articulated,attenuate,axe,axillary,blade,borne,bud,capitat,considerably,decreasing,dense,digestion,distal,dorsally,eaf,edge,eed,end,enzyme,erry,finer,flat,folded,geminat,generally,hal,half,homostylous,honeycomb-shaped,interjected,larger,leaflet,lengthening,linear,living,long,lower,middle,nflorescence,orbicular,orolla,pair,perfect,plurifoliate,pore,poricidal,present,proximal,removed,second,semi-erec,sessile,seudostipule,singly,slit,spaced,specimen,stolo,straight,subtending,tall,tamen,tem,terminal,tip,toward,tri-,tuber,typically,unit,unknow,unwinged,usually,vary,ympodial	abaxial,adaxial,arrangement,bark,branch,branching,calyx,capitate,color,form,growth,height,history,inflorescence,length,life,main,midvein,na,number,ovary,primary,pubescence,ray,shape,stem,surface,tertiary,texture,trichome,unarmed,unknown,vein,venation,width,young
512	wfo-0001029592	success	207	103	86	121	17	0.415	%,0-0.15,0.3-0.6,0.4-0.7,0.5-1,0.5-1.5,0.5-1.8,0.8-0.9,1-10,1.1-2.8,1.8-2.4,1.8-8,14-20,18-30,2-3-branched,2.1-4,3-6,3.5-5.5,5.5-11.5,6-8,6.5-8.5,7-10,8-10,acicular,anther,armed,attenuate,black,brown,calyx,chartaceous,cm,deeply,deltate,densely,diameter,directed,distally,eglandular,erect,extra-axillary,flower,fruit,glabrous,globose,hair,hemispherical,inflorescence,lamina,lateral,leaf,length,lobed,long,longer,mid-point,midpoint,minute,mm,moderately,ovate,pedicel,peduncle,perennial,petiole,prickle,purple,ray,rhizomatous,shrub,simple,sparsely,stalk,stellae,stellate,stellate-pubescent,straight,style,thick,time,tube,unbranched,white,wide,x,yellow	.05,.4,0,0-0.1,0-0.3,0-3.5,0.1-0.2,0.25-0.5,0.25-0.7,0.5-0.8,0.8-1.2,0.8-1.5,1-1.5,1-1.9,1-3,1-8,1-locular,1.5,1.5-3,1.8-6.5,2-10,2-3.5,2-foliate,240-1400,3-4,4-8,5-8,5-merou,5.5-10.5,7-17,7-25,7-9,8,8-20,abaxially,absent,across,acute,adaxiall,adaxially,adult,alyx,apart,apex,apparen,apparently,articulated,axe,ba,base,blade,branch,branche,cordate,decimetre,depression,distall,distributed,dm,eaf,eed,entire,exocarp,finger,fruiting,geminat,gland-tipped,green,half,homostylous,incomplete,index,juicy,juvenile,less,lobe,lobing,lower,margin,markedly,mature,mesocarp,midvein,nflorescence,oblique,obtuse,orolla,pair,part,per,perfect,placenta,pore,porrect,presen,present,ridged,ruit,septum,sessile,shallowly,short,side,spaced,sparse,succulent,surface,tal,tamen,tem,terete,thicker,thicknes,throughout,transparent,unarme,unit,upper,vary,vein,ympodial	abaxial,adaxial,arrangement,color,corolla,form,growth,height,ovary,plant,pubescence,seed,shape,size,stem,texture,width
513	wfo-0001029593	success	181	108	75	106	33	0.414	0.05,0.5-5,0.8-1.2,1,1-1.2,1-1.5,1-8,1.6-2.3,10-50,2.3-3.0,3-4,4-6,5-10,5-15,7-25,anther,anticlinal,attenuate,base,broadly,brown,calyx,capitate,cm,conical,deltate,densely,diameter,drying,elliptic,filament,filiform,flower,fruit,glabrous,globose,green,irregular,leaf,lobe,long,minutely,mm,obovate,ovary,ovoid-reniform,papillose,pedicel,petiole,pinnate,plant,poricidal,primary,projection,pubescence,pubescent,seed,shape,shrub,simple,sinuous,slightly,smooth,stigma,style,surface,thickening,trichome,tube,uniseriate,variable,vein,without,woody,x	-10,0.5-1,0.8-1,1-2,100,2,2-14,2-3,2-5,2.3,3.5-8,35-60,7.5-15,9-15,abaxially,abruptly,acuminate,acute,adaxially,age,always,anthesi,apex,apically,arising,axil,axillary,basal,basiscopically,bearing,berry,cateniform,cell,clavat,colony,cone,decurrent,dry,eaf,edicel,eed,enlarged,entire,epidermal,exserted,extremely,free,fruiting,glabrescent,growing,half,hollow,included,lamina,large,lateral,leaflet,lower,markedly,much,narrowing,nflorescence,noddin,oblique,occasionally,often,once-branched,onto,open,opposite,pair,per,perfectly,petiolule,place,pointed,portion,pubescen,purple,rachi,rarely,reflecting,rest,ruit,scar,short-styled,similar,single-stemmed,small,smaller,somewhat,sparsely,tall,tem,terminal,tip,tub,ud,unifoliat,unit,usually,white,white-lenticellate,wider,winged,ympodial	12-14,abaxial,adaxial,arrangement,bark,branch,branching,clavate,color,corolla,form,growth,height,history,inflorescence,length,life,main,margin,midvein,na,number,peduncle,perennial,ray,size,stem,tertiary,texture,unarmed,venation,width,young
514	wfo-0001029601	success	187	121	85	102	36	0.455	0.2-0.8,0.5-5.8,1-2,1-3,1-4,1-53,1.1-2.7,2.3-5.9,3-10,3-7,4-13.5,5-41,6-10,6.6-22,6.8-14.5,abaxially,adaxially,anther,attenuate,base,brownish,cell,clavate,cm,condition,coriaceous,corolla,covering,dark,diameter,dot,drying,elliptic,filament,flower,forked,fresh,fruit,glabrescent,glabrous,globose,green,green-white,greenish,hair,hair-like,herb,lanceolate,lateral,leaf,light,lobe,long,make,mm,mucilaginous,odd-pinnate,ovate,ovoid,pedicel,peduncle,pentagonal,petiole,plant,poricidal,puberulent,ripe,rotate,seed,short,size,small,stigma,style,testal,thick,throughout,tip,tube,wall,wet,white,whitish,x,yellow	0-37,0.5-8,1.2-2.3,1.7-6.5,2,2-12,2-3,2-7,2-9,2.2-4.5,2.8-10.5,3-5,5-merou,abaxiall,acumen,acuminate,acute,ag,alyx,apart,apex,apparently,articulated,asymmetric,axe,axillary,basiscopic,berry,blade,borne,bud,capitat,connivent,decreasing,digestion,distal,dorsally,eaf,edge,eed,end,enzyme,erec,exceeding,flat,folded,geminat,generally,glabrou,half,homostylous,honeycomb-shaped,interjected,larger,leaflet,lengthening,linear,living,lower,middl,middle,narrow,nflorescence,orbicular,orolla,pair,perfect,petiolulate,plurifoliate,pore,removed,rounded,ruit,sessile,seudostipule,side,singly,slightly,slit,spaced,specimen,stamen,stolo,straight,subequal,subglabrou,subtending,tall,tamen,tem,terminal,tissue,toward,tri-,tuber,typically,unit,unwinged,usually,vary,wing,ympodial	abaxial,adaxial,arrangement,bark,branch,branching,calyx,capitate,color,form,growth,height,history,inflorescence,length,life,main,margin,midvein,na,number,ovary,primary,pubescence,ray,shape,stem,surface,tertiary,texture,trichome,unarmed,vein,venation,width,young
515	wfo-0001029606	success	179	130	104	75	26	0.581	.5,/2,0.2-0.5,0.4-0.5,0.5-1,1,1.5-2,1.5-3.5,1.8-2.5,15,2-3,3,3-9,4-8,4.5-5,5,5-6,7-9,aciculate,acute,anther,armed,bark,base,beneath,berry,bilobed,broadly,brown,brownish,calyx,cm,color,coriaceous,corolla,densely,diameter,elliptic,elongate,entire,filament,flattened,flower,form,glabrous,globose,growth,impressed,inflorescence,internodal,leaf,like,lobe,lobed,long-styled,margin,minutely,mm,multangulate,narrowly,oblong,once-branched,orbicular,pair,pedicel,peduncle,petiole,poricidal,porrect,prickle,primary,prominent,pubescence,pubescent,ray,red,reddish,reniform,revolute,sessile,shiny,shrub,simple,sometimes,stalked,stellate,stellate-pubescent,stem,stigma,straight,style,surface,tapering,terminal,thin,tip,triangular,trichome,tube,urceolate,vein,way,white,x	0.5,1.5-3,2-2.5,4-5,4-6,7,abaxially,acuminate,adaxially,along,anthesi,apex,apparently,arching,articulated,cell,closely,deciduous,defoliate,dense,eaf,eed,ellipsoidal,elongation,equalling,erect,especially,exerted,free,fruiting,geminat,gre,herbarium,heterostylous,inshort-styled,known,lengthening,long,long-stalked,lower,m.,many,marginal,midpoint,midrib,mixture,multiseriate,new,nflorescence,nodding,older,papillat,per,pericarp,pore,portion,redder,ruit,rusty,scar,slightly,slit,soon,space,specimen,stalk,straggling,strongly,testal,ud,unit,usually,woody,yellowish,ympodial	abaxial,adaxial,arrangement,branch,branching,fruit,grey,height,length,main,midvein,na,number,ovary,papillate,plant,seed,shape,short-styled,size,tertiary,texture,venation,width,ye,young
516	wfo-0001029619	success	188	127	95	93	32	0.505	0.25-0.75,0.5-1.5,0.5-2,1-1.5,1-2,1-5,1.5-2,10-12,2-11,2-3,2-5,3-4,3-8,4-6,5-20,7,8-12,abaxially,acute,adaxially,anther,attenuate,base,brown,bud,calyx,chartaceous,cm,connivent,cylindrical,dark,densely,diameter,filament,flower,fruit,geminate,glabrous,glandular,globose,green,hair,immature,leaf,length,like,lobe,lobed,many,margin,mature,midvein,mm,moderately,nearly,netlike,obtuse,orange,ovate,pedicel,peduncle,per,petiole,pit,porrect-stellate,pubescent,raised,ray,reniform,ridge,rusty,scandent,separated,shrub,side,small,sparsely,spreading,stellate,stem,stigma,style,surface,tan,tapering,triangular,tube,unarmed,unbranched,unlobed,vein,white,whitish,x,yellow	0.5-1,1,1-.,1-2.5,1-3,1-3.5,2,25-40,5-merou,6,6-10,6-8,7-10,7-12,absent,accrescent,adaxiall,alyx,andromonoecy,apar,apart,apex,apical,apparently,appearing,armed,axe,berry,beyond,blade,clavat,contiguous,cordate,cut,difoliate,directed,discolorous,eaf,eed,either,elongated,em,exserted,extra-axillary,flattedned,frui,fruiting,glabrou,gland-tipped,implying,introrsel,leaf-opposed,less,long,lower,m.,major,midpoint,midrib,multicellular,multiseriate,narrowly,nflorescence,occasionally,often,orolla,pair,perfect,pore,prickle,rachi,recurved,reduced,roselike,ruit,simple,sinus,slightly,spaced,sparse,stalk,stamen,ste,tamen,unequa,unicellular,unit,usually,vary,way,wide,ympodial,¼	abaxial,adaxial,arrangement,bark,branch,branching,clavate,color,corolla,drying,form,growth,height,history,inflorescence,life,main,na,number,ovary,plant,primary,pubescence,seed,shape,size,tertiary,texture,trichome,venation,width,young
517	wfo-0001029621	success	165	101	87	78	14	0.527	.1,0.5-1,0.7-1.1,0.8-1,0.8-4.5,1-1.5,1.5-2,1.5-2.5,1.5-5,2.5-3,2/3,3-3.5,3.5-4.5,6-20,7-9,anther,appressed,area,base,becoming,branched,brown,calyx,cluster,cm,corolla,cup-shaped,dark,deltoid,dia,dry,erect,filament,fleshy,fruit,glabrous,globose,green,irregularly,lanceolate,later,lateral,leaf,live,lobe,lobed,many,material,merely,minutely,mm,oblanceolate,often,ovary,ovoid-reniform,pale,papillate,papillose,pedicel,plant,poricidal,puberulent,reddish,ripe,shaped,shrub,stem,stigma,straight,style,surface,tan,tear-drop,terminal,thick,time,tip,trichome,tube,uniseriate,way,white,whorl-like,widened,x,yellowish,young	0.5-0.75,0.5-1.2,0.5-1.5,1-2,1/3,5-20-flowered,6-8,accrescent,acute,along,anthesi,apar,apex,appearing,attenuate,bark,beneath,berry,borne,caudate,completely,constricted,course,decurrent,densely,distal,eaf,edicel,eed,ellipsoid,elongate,enclosed,exsertio,free,fruiting,geminate,glabrate,late,like,lon,long,lower,main,margin,middle,nflorescence,occasionally,older,onto,pair,papillo,pitted,planar,plurifoliat,pore,portion,prominent,quite,rarely,reddish-gre,river,ruit,scar,sessile,shiny,small,somewhat,spaced,ste,tall,tapering,ud,unit,vein,widest,woody,yellow,ympodial	arrangement,branching,color,diameter,form,growth,height,inflorescence,length,na,seed,shape,size,texture
518	wfo-0001029622	success	182	102	72	110	30	0.396	.1,.5,0.5-1,0.8-1,1-1.2,1-1.5,1-4,1.5,2-11,2.5-3,3-4,3-5,30-35,4-6.5,5-6,acute,anther,attenuate,base,beneath,brown,calyx,chartaceous,cm,corolla,cylindrical,deflexed,diameter,elliptic,entire,filament,flower,fruit,glabrous,globose,green,inflorescence,leaf,lobe,lobed,long-triangular,margin,mm,narrowly,obconic,oblong,older,ovate,pair,pedicel,peduncle,petiole,reddish,sagittate,shiny,shrub,simple,single,size,slightly,somewhat,stellate,stem,stigma,straight,style,tube,vein,white,x,yellow,young	.2,/3,0.3,0.5,0.5-0.7,0.6-0.9,1-2.7,2-4,2-5,40,45-50,7-11,abaxially,absent,accrescent,adaxially,ag,alyx,anthesi,apex,apparently,appearing,arising,axe,axil,bark,blade,bud,capitat,connivent,consisting,deciduous,differing,difoliate,dimorphic,eaf,eed,elongate,except,free,fruiting,geminate,glabrou,ilament,immature,included,interlaced,internodal,jointed,known,lamina,lateral,less,long,long-acuminate,longitudinal,m.,main,major,mature,measured,midrib,minor,minute,minutely,nflorescence,occasionally,often,one,onto,opening,opposite,orolla,oung,ovate-lanceolate,papillose,pendent,pore,portion,present,probably,rachi,raised,reflexed,remaining,rounded,ruit,scar,second,shaped,slende,slender,slit,tal,tapering,tear-drop,thin,thus,tip,trichome,tuft,ud,unarme,unifoliat,uniseriate,unit,vary,way,within,ympodial	1,abaxial,adaxial,arrangement,branching,capitate,color,colour,form,growth,hair,height,history,length,life,midvein,na,number,ovary,perennial,plant,primary,pubescence,seed,shape,surface,texture,unarmed,width,ye
519	wfo-0001029625	success	168	132	103	65	29	0.613	..,.1-0.2,0.5-1,0.5-1.3,0.5-2mm,0.8-1.4,1-1.5,1-2,1-3,1.2-1.6,2,3,3-,3-3.5,4-10,4-4,4-5-celled,4-7-celled,4-9,5,5-6,5-8,8-13,9-25,abaxial,along,anther,bark,base,beneath,branch,branched,calyx,cell,cm,conical,corolla,darker,deltate,densely,diameter,elliptic,filament,flattened,flower,four,fruit,glabrous,gland,gland-tipped,globose,green,greenish,growth,herb,inflorescence,lamina,like,lobe,lobed,long,margin,markedly,mixed,mm,nearly,occasionally,outer,ovary,ovate-reniform,pair,pale,papillate,pedicel,peduncle,point,primary,pubescent,purplish,rarely,reddish,regularly,scattered,single,smooth,sparsely,stem,stigma,striate,stripe,style,surface,tan,time,tinged,trichome,tube,uniseriate,vein,wall,white,x,young	-15,.5,0.5-2,0.8-1.8,100,2.5-.,3-3,5-10,6-9,anthesi,apical,branc,brittle,brow,capitat,cel,cucullate,deflexe,deflexed,denser,distinct,dry,eaf,edicel,eed,erect,frui,fruiting,glabrescent,glandular,hyaline,later,lighter,lower,middle,midline,minute,narrowly,new,nflorescence,open,outline,per,pericarp,planar,plurifoliat,pointed,ruit,scar,shrub,single-stemmed,sinuate,slightly,small,strongly,testa,thin,tip,triangular,tuft,ud,unit,weight,without,ympodial	1-100,adaxial,arrangement,branching,brown,capitate,color,form,height,history,leaf,length,life,main,midvein,na,number,petiole,plant,plurifoliate,pubescence,seed,shape,size,tertiary,texture,unarmed,venation,width
520	wfo-0001029630	success	286	147	129	157	18	0.451	.5,/6,0-10,0-5,0.2-0.3,0.4,0.5-1.5,1.5-4,1/3-1/5,1/3-2/3,12-17,2.5,2.5-3,3.5-5,4-5,4-8,5-20,5-9,6-8,7-10,8,8-9,abaxial,abaxially,adaxially,almost,along,anther,apex,apparently,armed,bark,base,berry,brachyblast,branch,branched,calyx,capitate,chartaceous,clavate,climber,cm,corolla,cuneate,cupular,curved,dark,densely,diameter,discolorous,distributed,divided,drying,dull-yellow,elliptic,entire,evenly,eye,finely,flat,flattened-reniform,fruit,glabrous,glaucous,globose,green-brown,grey-brown,lateral,leaf,length,like,lobed,main,margin,maturity,mauve,midvein,mm,naked,oblique,often,orange,orange-brown,ovate,pair,papillose,pedicel,peduncle,petiole,poricidal,porrect,prickle,primary,purple,raised,ray,red-brown,relatively,rounded,shiny,slender,smooth,sometimes,sparsely,stellate-pubescent,stem,stigma,stout,straight,strongly,style,suborbicular,sunk,tapering,terminal,tertiary,thin,tip,trichome,unequal,vein,venation,visible,weakly,yellow-brown,yellow-green,young,×	.1,.15,.7,.8,/2,0,0-8,0.1-0.2,0.15-0.3,0.2-0.4,0.2-0.7,0.3-0.5,0.5,0.5-1,0.5-2,0.5-4.5,0.6-0.8,1,1-3,1.2-1.5,1.5-2,1/3,10-30,12-15,2-6,2.5-6,3-10,45-60°,5,5-merou,accrescent,across,acuminate,acute,age,always,alyx,apar,apart,apically,area,articulated,ascendant,attachment,beyond,blade,broadly,brown,cell,clearly,coroll,delineated,deltoid,development,difoliate,distance,downward,eaf,eed,ellpsoid,elongating,equal,exserted,extending,fertile,filament,flattened,flower,free,fruiting,geminat,glabrescent,greyi,hooked,infructescence,irregula,lengthening,less,lighter,lobe,lon,long,longer,longitudinal,lower,mature,midpoint,mostly,narrow-ovate,nflorescence,orolla,outline,ovoid,pale,papillo,patchily,pendulous,per,perfect,pericarp,pit,point,pore,portion,prominently,rachi,recurved,reduced,reflexe,rest,robust,ruit,scar,secondary,shorter,side,simple,sinus,slit,small,somewhat,spaced,species,spherical,spreading,stalk,stalked,stellate,strong,stump,surface,tamen,terete,thicker,throughout,time,toward,translucent,tube,ud,undulate,unequal-deltoid,uniform,unit,usually,variously,vary,visibl,visibly,white,white-translucent,wide,widest,woody,yellow,yellow-translucent,ympodial	adaxial,arrangement,branching,color,form,greyish,growth,height,inflorescence,number,ovary,plant,pubescence,seed,shape,size,texture,ye
521	wfo-0001029632	success	202	151	115	87	36	0.569	.5,0.2,0.5,0.5–0.7,0.5–1.4,0.6–1.1,0.8–,0.8–1.0,0.8–1.5,0.9,0–1.5,1.0–1.5,1.0–2.0,1.0–3.5,1.0–6.0,1.1–,1.2,1.2–1.4,1.5–,1.5–2.6,1.7–8.5,10–30,11–25,2,2.0–11.5,2.0–2.2,2.7–3.5,2–3,3.5–5.0,3–8,4.5–6.0,4–8,5.5–9.5,abaxial,anther,anthesi,base,black,branching,brown,calyx,chartaceous,clavate,cm,connivent,dark,deeply,densely,diameter,elliptic,equal,filament,flattened,flower,fruit,glabrous,globose,green,hair,herb,leaf,like,lilac,lobe,lobed,long,margin,marking,midvein,mm,moderately,multicellular,oblong,ovate,pair,pale,pedicel,peduncle,pentagonal,perennial,petiole,pitted,poricidal,pubescent,purple,rarely,simple,sometimes,sparsely,stigma,style,subentire,surface,tip,tube,unbranched,unicellular,uniseriate,vein,violet,white,whitish,x,yellow,–1.4,–10,–11.0,–11.5,–13.5,–19.0,–2.0,–4.5,–40,–5.2,–50	.0,0.3–2.0,0.4–1.0,0.7,0.8–2.2,1,1.2–2.5,5,5–10,6–13,7.5–13,75,abaxially,absent,acute,adaxiall,adaxially,ag,along,angular,apart,apex,appressed,arising,articulated,associated,axe,ba,blade,caudex,cell,cylindrical,decurrent,eaf,eed,elongate,especially,geminat,indistinct,lamin,lon,longitudinal,lower,m.,midrib,midway,nflorescence,obtuse,occasionally,often,opening,orolla,particularly,perfect,pore,present,prostrate,purplish,rapidly,ruit,scandent,semi-succulent,shaped,side,slender,slit,spaced,spheroidal,stone,straight,subterranean,succulent,swollen,tall,tamen,tear-drop,tem,time,unifoliate,unit,vary,wide,wing,ympodial,–15,–2.2,–4.0	10-30,adaxial,arrangement,bark,branch,color,corolla,decurren,drying,form,growth,height,history,inflorescence,lamina,length,life,main,na,number,ovary,plant,primary,pubescence,ray,seed,shape,size,stem,tertiary,texture,trichome,unarmed,venation,width,young
522	wfo-0001029645	success	160	133	94	66	39	0.588	0.2-0.5,0.3-0.5,0.5-2.5,0.5-7,1,1-1.5,1-2,1.3-7,1.5,2.5-17,2.5-4,3-15,3-7,337,4-8,6-12,7-12,750,?,anther,apex,around,base,blue,brown,calyx,chartaceous,cm,connivent,corolla,cuneate,cylindrical,deltate,diameter,distally,entire,et,fide,filament,finger,flattened,flower,fruit,glabrous,gland-tipped,globose,green,greenish,hair,herb,immature,kayap,line,lobe,margin,membranaceous,minutely,mm,moderately,obtuse,ovate,ovate-elliptic,pedicel,peduncle,petiole,puberulent,purple,rarely,red,rotate-stellate,rugose-verrucate,sagittate,sand-punctate,side,simple,smith,sparsely,stigma,strongly,style,subcordate,tapered,tightly,triangular,truncate,tube,unbranched,vein,veiny,white,wide,x,yellow,±	-1,.5-1,1-4,1.5-2,2-3-foliat,2-4,3-10,3.5-4,4-5,5,5-8,abaxially,abundantly,acuminate,acute,adaxially,aggregate,along,apart,articulated,axe,ba,blade,cell,decurrent,directed,distall,eaf,eed,except,extra-axillary,free,glabrou,inserted,knapp,long,lower,major,mesocarp,nearly,nflorescence,orolla,part,perfect,pore,puberulen,rachi,radiu,ruit,short,short-tomentose,shorter,shru,small,spaced,stone,tal,tamen,tem,thecae,time,tomento,truncat,unit,vary,ympodial	0.5-1,abaxial,adaxial,arrangement,bark,branch,branching,color,drying,form,growth,height,history,inflorescence,leaf,length,life,main,midvein,na,number,ovary,plant,primary,pubescence,ray,seed,shape,shrub,size,stem,surface,tertiary,texture,trichome,unarmed,venation,width,young
523	wfo-0001029646	success	141	93	72	69	21	0.511	0.1-0.6,0.5-0.8,0.7-2.2,1-4,1.5-2,1.5-4.9,10-15,2-3,3-14,4-5.5,6-8,7-15,abaxially,acute,adaxially,apical,apically,branched,calyx,cm,corolla,cyme,dehiscent,diameter,dichasial,dichasially,ebracteate,elliptic,epiphytic,equaling,filament,finely,flower,forked,globose,green,green-white,herbaceous,introrse,leaf,lobe,long,maturing,mm,monochasial,mucronate,narrowly,often,ovate,ovoid,pedicel,peduncle,perennial,petiole,plant,poricidally,pubescent,seed,short,simple,slit,stamen,stellate,stigma,straight,style,throughout,tone,white,wide,yellow,yellow-green	0.5,3-6-foliat,5-15,acumen,acuminate,apex,articulate,attenuate,base,cell,commonly,covering,digestion,distal,dorsally,eaf,edge,eed,emoval,enzyme,flat,folded,free,generally,globo,ground,growing,hair-like,half,honeycomb,lateral,linear,living,lon,lower,make,mos,mould,mucilaginous,nflorescence,nther,oak,orolla,ovat,pattern,perfect,pine,plan,proximal,rarely,reveal,ruit,seudostipule,specimen,tall,tem,testal,thick,throughou,tree,tuber-bearing,typically,unit,vary,viole,wall,without,ympodial,¼	anther,arrangement,branching,color,form,fruit,growth,height,history,inflorescence,length,life,number,ovary,shape,size,stem,surface,texture,violet,ye
524	wfo-0001029652	success	160	92	76	84	16	0.475	.25,.5,0.5-1,0.5-4,0.75-1,0.8-1,1-3,1.5-2,2-2.5,2-4,2.5-3,3.5-4,3/4,4-4.5,6-15,abaxially,adaxially,along,anther,apex,arching,bark,base,calyx,cm,conical,corolla,curling,dia,elliptic-ovate,glabrous,globose,golden,green,greenish-white,hispid,leaf,lobed,long,long-styled,minute,minutely,mm,narrowly,near,occasionally,opposite,ovary,ovoid-reniform,pale,papillose,pedicel,petiole,pitted,pubescent,reddish-brown,shaped,short-styled,shrub,simple,size,slender,stem,stigma,style,surface,tan,tear-drop,tip,trichome,uniseriate,vein,way,white,x,young	.3,1,1-2,2,25,7-9,anthesi,apar,ape,apical,arch,attenuate,ba,bearing,berry,broadly,cone,deciduous,deflexed,deltate,denser,differing,difoliate,drying,eaf,edicel,eed,evenly,exserted,filament,filiform,flower,free,fruiting,geminat,golden-red,hard,heteromorphic,included,joining,lamina,lateral,like,lobe,lon,long-acuminate,lower,main,major,margin,maturity,middle,midrib,minor,nflorescence,older,pair,papillo,pericarp,pore,poricidal,portion,projection,reflexed,ruit,scar,series,slende,slightly,soon,spaced,sparsely,swollen,tall,thickened,time,tub,tube,ud,undulate,unit,widest,within,ympodial	.5-4,arrangement,branching,color,diameter,form,fruit,growth,height,inflorescence,length,plant,pubescence,seed,shape,texture
525	wfo-0001029662	success	181	122	93	88	29	0.514	.3,.5,0.5,0.7–3,1,1.4,1.5,15,20,2–3,2–3-celled,3.5–6,3–4,4–5,5-6,5–7.5,6-7,7-14,9–11,absent,anther,apart,armed,articulated,base,calyx,campanulate,caudate,chartaceous,cm,color,creeping,diameter,distally,erect,expanded,filament,flower,fruit,glabrous,hair,herb,including,leaf,like,linear-tapered,lobe,lobed,long,margin,mm,nearly,node,oblong-ovate,oblong-ovoid,ovate,pedicel,peduncle,petiole,pilose,plant,prickle,pubescent,ray,recurved,repand,rooting,shallowly,shape,simple,size,somewhat,spaced,sparsely,stellate,stellate-pentagonal,stem,stigma,style,subcordate,thickened,tip,truncate,tube,unarmed,unbranched,unknown,vein,vine,white,widely,x,yellow	0.7–1,1.7–3.5,12,1–3.5,2,2-,3-foliate,3.2,3.5,4-rayed,abaxially,accrescent,acicular,adaxiall,adaxially,ag,andromonecious,apex,axe,ba,blade,capitat,connivent,curve,cylindrical,directed,eaf,eed,equal,extra-axillary,fertile,fragrant,free,fruiting,geminat,glabrou,half,ilament,immature,lateral,less,lightly,longitudinal,lower,lowest,m.,major,midpoint,minute,nflorescence,obtuse,offset,one,opening,opposite,orolla,per,perhaps,pore,portion,probably,rachi,reflexed,ripe,rounded,ruit,sessile,shorter,side,slender,slightly,slit,small,stellae,straight,striaght,tal,tem,tomentose,triangular,two,unequal,uniform,unit,vary,way,wide,ympodial	abaxial,adaxial,arrangement,bark,branch,branching,capitate,corolla,form,growth,height,history,inflorescence,length,life,main,midvein,na,number,ovary,primary,pubescence,seed,surface,tertiary,texture,trichome,venation,young
526	wfo-0001029673	success	159	98	85	74	13	0.535	.5,0.5-1,0.7-1.1,0.75-1,0.8-1,1-10,1-2,1-5,1.2-3.5,1.5-2,2-2.5,2-4,2.5,3/4,4-6,5.5-15,abaxial,adaxial,age,anther,apex,base,becoming,black,branching,broadly,calyx,clavate,cm,conical,corolla,deep,dendritic,densely,diameter,elliptic,filament,fruit,glabrous,globose,greyish,greyish-yellow,growth,lamina,leaf,length,lenticular,long,minutely,mm,narrowly,ovary,pedicel,pericarp,petiole,pitted,planar,plurifoliate,pore,poricidal,pubescent,purple,pyramidal,reddish-brown,reflexed,shrub,slightly,slit-like,small,sparsely,stem,stigma,style,surface,thin,time,tip,tree,trichome,tube,vein,violet,wide,x,young	1.5-1.8,10-20,2-3,3-5,5-25,abaxially,absent,accrescent,acuminate,acute,adaxially,along,anthesi,apical,appearing,bark,basal,berry,blade,branch,decurrent,deflexed,deltoid,denser,dichasia,eaf,edicel,eed,ew,exserted,flower,fork,free,fruiting,greyish-yello,individual,inserted,later,lateral,like,lobe,lon,longer,lower,m.,monochasial,nflorescence,nodding,occasionally,older,overtopping,pair,papillo,petal,portion,prominent,ruit,scar,secondary,shoot,sleeve,somewhat,stamen,strongly,tall,tapering,terminal,triangular,tub,ud,unit,winged,woody,ympodial	arrangement,color,form,height,inflorescence,na,papillose,plant,pubescence,seed,shape,size,texture
527	wfo-0001029680	success	212	113	96	116	17	0.453	.0,0.1,0.6–1.2,0.6–2.0,1.0–1.1,1.1–1.2,1.4–7.5,1.7–7,11–16,11–25,12,1–2,3.0–4.2,3.3–5.5,3–6,4.0–16,4.0–6.5,4.5–20,4.5–7.0,50,5–11,8–32,abaxially,adaxially,annual,anther,anthesi,base,becoming,bipinnate,blue,branched,brown,calyx,clavate,cm,diameter,divided,filament,flattened,fleshy,flower,fruit,glabrous,globose,green,herb,indistinct,leaf,length,light,margin,mm,moderately,oblong,obovate,ovate,pair,pale,pedicel,peduncle,pentagonal,petiole,pinnae,pinnate,pitted,primary,pubescent,purple,rarely,red,ripe,rotate,shallowly,size,sometimes,sparsely,stem,stigma,style,subglabrous,surface,time,tripinnate,tube,turning,violet,white,winged,woody,x,yellow,–10,–12.5,–19,–3	0.4,0.5–1.5,0.6,0.9–1.0,1,1.0,1.0–1.5,1.0–1.8,1.4–2.5,1.5,1.6–2.7,1.8–3.8,10,1–3,1–6,1–8,2.2–4.2,2–20,3–22,4–10,4–30,5,5.5–8.5,7–10,absen,acute,adaxiall,ag,along,apart,apex,appressed,arequipa,arranged,articulated,asymmetrically,axe,axillary,ba,beyond,blade,borne,cell,connivent,cylindrical,decreasing,decurrent,densely,difoliate,eaf,eed,entire,equal,erect,extending,flange,forming,geminat,hair,irregularly,lobe,lon,long,longitudinal,lower,m.,midrib,multicellular,narrow,nflorescence,node,obtuse,occasionally,often,opening,orolla,parallel,pendant,perfect,plurifoliate,pore,poricidal,prostrate,rapidly,ruit,running,secondary,shaped,shoot,side,simple,spaced,specimen,split,stone,straight,tacna,tal,tamen,tear-drop,tem,terminal,tertiary,tip,unicellular,uniseriate,unit,usually,vary,wide,wing,winge,ympodial,–3.2,–46,–48	arrangement,color,corolla,decurred,form,growth,height,history,inflorescence,life,na,ovary,plant,pubescence,seed,shape,texture
528	wfo-0001029685	success	288	166	138	150	28	0.479	.4,/3,0.1-0.2,0.5,0.5-1.5,1-4,1-5,1.3-1.5,1.5,10,10-20,2-3,2-6,2.1-3,2.5-3.7,3-5,3-7,3.5-16,3.5-4,3/4-1/2,4-9,5-20,5.5-7,6-8,6.5-9,abaxially,adaxially,almost,anther,apically,apparently,armed,articulated,bark,base,berry,branched,bright,brown,calyx,cell,chartaceous,clavate,clearly,cm,corolla,covering,cuneate,cupular,curved,densely,diameter,discolorous,drying,erect,faint,filament,finely,flat,flattened-reniform,flower,fruit,globose,lateral,leaf,length,less,lobe,lobed,long-acuminate,long-deltate,margin,maturity,mauve,midvein,mm,much,obconical,oblique,often,orange,orange-brown,orange-translucent,outline,ovate,ovoid,pair,pedicel,peduncle,pericarp,persisting,petiole,pit,poricidal,porrect,prickle,primary,pronounced,raised,rarely,ray,red-brown,ridged,sessile,shiny,shrub,simple,slender,small,smooth,sparsely,stalked,stellate,stellate-pubescent,stem,stigma,stout,straight,strongly,style,surface,tapering,tertiary,thick,thin,tip,trichome,truncate,tube,unarmed,unbranched,upper,vein,venation,visible,yellow,yellow-green,×	.2,.5,.8,0-15,0.1,0.1-0.3,0.2,0.2-0.8,0.5-1,0.7-1.5,0.7-1.8,1-1.3,1-2,1-7,1.5-5,1.5-6,1/2-2/3,1/3,1/3-2/3,1/3-4/5,1/6-1/3,2.5-3,20,3,3-20,3-6,3.5,30-60°,4,4-10,4-7,4.5-6,5,5-11,5-merou,accrescent,acute,age,alyx,apar,apart,apex,axe,beyond,black,blade,breaking,brittle,broad-deltate,clump,dark,deep,deltate,dense,development,difoliate,distance,divided,dorsal,downward,eaf,eed,elongating,equal,exserted,extending,filiform,finger-hair,flattened,free,fruiting,geminat,glabrescent,glabrous,grey-brow,growing,inflated,infructescence,irregula,irregular,lengthening,long,longer,longitudinal,lower,mature,midpoint,minute,mixture,moderately,nflorescence,obovate,older,one,open,opening,orolla,oung,ovoi,papillae,papillo,partly,patch,per,perfect,point,pore,portion,pubescent,rachi,reduced,reflexed,regular,rest,ri,robust,rounded,ruit,scar,secondary,side,sinus,slightly,slit,sometimes,somewhat,spaced,specimen,spherical,spreading,stalk,stump,tamen,terete,terminal,throughout,time,toward,translucent,ud,unit,usually,variously,vary,well-developed,wide,widest,woody,x1.5-2,ympodial	abaxial,adaxial,arrangement,branch,branching,color,form,grey-brown,growth,height,history,inflorescence,life,main,na,number,ovary,papillose,perennial,plant,pubescence,rim,seed,shape,size,texture,width,young
529	wfo-0001029691	success	223	116	96	127	20	0.43	%,-8,0-0.1,0.2-0.4,0.3-0.45,0.3-0.7,0.5-0.8,1-6,1.2-1.7,1.6-2.1,1.7-2.7,11-14,13-20,13-25,2.5-4,2.5-8,3-4,3-6,3.3-3.5,5-8,5.5-9,6.5-10,6.5-8.5,8-14,acicular,anther,armed,articulated,attenuate,base,broadly,calyx,chartaceous,cm,curved,cylindrical,densely,diameter,entire,fruit,gland-tipped,globose,green,hair,herbaceous,inflorescence,lamina,lanceolate,lateral,length,lilac,lobe,lobed,long,longer,margin,midpoint,minutely,mm,orbicular,ovate,pale,pedicel,peduncle,petiole,plant,prickle,prostrate,ray,resprouter,reticulate,rotate,shallowly,shape,short,sparsely,sprawling,stalk,stellae,stellate,stellate-pubescent,stigma,straight,style,summit,surface,throughout,time,toward,tube,unbranched,white,wide,x,yellow,yellowish-green	0-6,0.25-0.45,0.3-1.4,0.4-0.5,0.5-0.7,0.5-1,0.8-1.2,0.8-1.6,0.8-2.5,1-1.1,1-2,1-5,1-locular,1.1-2.1,1.4-2,1.5-4,10,100-400,13-18,140-320,18-23,2-3,3-7,36-50,4-8,40-250,5-,5-merou,6-10,6-8,abaxially,absen,absent,abundant,accrescent,across,acute,adaxiall,adaxially,adult,alyx,andromonoecious,apart,apex,axe,ba,blade,branche,brown,bursting,cone,connivent,cross-section,cuneate,decimetre,directed,distall,eaf,eed,eglandular,elliptica,equalling,exocarp,extra-axillary,filament,finger,flower,fruiting,functional,glabrous,half,heterostylous,included,incomplete,index,interpetalar,juicy,less,lobing,lon,lower,mature,maturity,mesocarp,mid-point,midvein,minute,moderately,moist,nflorescence,oblique,obtuse,orolla,part,per,petal,placenta,pore,porrect,presen,present,rachi,readily,rounded,ruit,septum,sessile,side,simple,slightly,spaced,stage,tal,tamen,tem,thick,tip,tissue,transparent,truncat,unit,unknow,uvenile,vary,vein,weakly,ympodial	5-merous,abaxial,adaxial,color,corolla,elliptical,form,growth,height,history,leaf,life,ovary,pubescence,seed,size,stem,texture,truncate,width
530	wfo-0001029704	success	146	113	76	70	37	0.521	0-1.5,1.5-2.5,1.5-3,15-25,2-2.5,2-3,3-4-celled,3-5,4,7-10,9-20,acuman,along,anther,base,blue,branch,broadly,brown,calyx,cm,conical,corolla,cuneate,dark,deeply,dia,ellipsoid,few-flowered,filament,flower,glabrous,globose,green,halfway,leaf,less,lobe,lobed,minute,minutely,mm,mottled,obovate,occasionally,one,ovary,pedicel,peduncle,petiole,pinnatisect,poricidal,pubescent,purple,record,reddish,reticulate,rounded,short,shrub,simple,stellate,stigma,stout,striped,style,subdiscoidal,surface,tip,trichome,tube,variously,vein,white,x,young	-17,-3,.5,0.5,1,1-2,1-4,1.5,10-14,1000-1200,140-185,2-5,4-7,5,7-,acuminate,acute,also,anthesi,apex,apparently,aspect,axi,berry,c.,cell,composed,cunate,cut,deflexed,diam,eaf,eed,enlarged,erect,especially,exerted,extra-axillary,flowering,fork,fruiting,gradually,lanceolate,lengthening,long,lower,midrib,moderately,nflorescence,obovoid,plurifoliat,pore,ruit,shoot,single,sinus,slit,sombre,sprawling,stone,straight,subglobo,swollen,tub,twig,ud,unit,variable,within,ympodial	abaxial,adaxial,arrangement,bark,branching,color,diameter,drying,form,fruit,growth,height,history,inflorescence,length,life,main,margin,midvein,na,number,perennial,plant,plurifoliate,primary,pubescence,ray,seed,shape,size,stem,subglobose,tertiary,texture,unarmed,venation,width
531	wfo-0001029727	success	260	154	134	126	20	0.515	-1/3,-10,-3,/3,0-15,0-4,0-40,0-5,0.15-0.3,0.4-1,1-1.2,1-2,1-4,1.5-2.5,1.5-5.5,1.6-3,1/3-1/2,1/8-1/5,2.5-3.2,2.5-5.5,2.8-4,3-11,3-6,3-7,4.5,5.5-7,6-11,abaxial,acuminate,acute,adaxial,almost,anther,anthesi,apex,apically,apparently,bark,base,blade,branched,brown,calyx,chartaceous,clavate,climber,cm,cordate,corolla,cupular,curved,densely,diameter,discolorous,drying,erect,filament,filiform,finely,flattened-reniform,flower,glabrous,lateral,leaf,length,lobe,lobed,long,lower,margin,mauve,middle,midvein,minutely,mixture,mm,moderately,obconical,oblong,one,open,orange-brown,ovate,pair,papillose,pedicel,peduncle,petiole,pitted,poricidal,porrect,prickle,primary,rarely,ray,red-brown,reddish,regular,rounded,scandent,seed,sessile,shallowly,shape,shrub,simple,size,smooth,stalked,stellate,stellate-pubescent,stem,stigma,straight,strongly,style,subentire,surface,tapering,terminal,tertiary,time,tip,toward,trichome,tube,unarmed,uneven,variously,vein,venation,way,wide,young	.5,0-2,0-20,0-30,0-8,0.1-5,0.15-0.2,0.2,0.2-0.5,0.2-2.5,0.3,0.4,0.5,0.5-1.2,0.5-3,0.7-0.9,0.7-1,1,1-,1.2-2,1.5-2.3,1.5-3,1/2-2/3,1/4,2-5,2.5,3/,4-7,4-merou,4-merous,4.5-,5-12,5-8,5-9,7-10,abaxially,acicular,age,along,alternate,alyx,ame,apar,apart,articulated,berry,bristle,c.,colourles,connivent,covered,darker,deltate,deltoid,developing,different,dimorphic,divided,eaf,edge,eed,elongating,equal,except,extending,ferrugineous,filiform-acuminat,fissure,free,geminate,increasing,inside,lengthening,less,like,lon,longer,m.,mature,midpoint,minor,narrow-deltate,nflorescence,nther,occasional,older,orolla,oung,outside,papillo,per,perfec,perfect,pit,plurifoliat,pore,portion,prickl,prickly,protruding,pubescent,raised,red-brow,reduced,scar,series,short,sinus,sometimes,spaced,spreading,stalk,tamen,tearing,terete,translucent,transverse,unit,upper,variable,vary,violet,visible,x,yellowish,ympodial	3/4,arrangement,branch,branching,color,form,fruit,growth,height,history,inflorescence,life,main,na,number,ovary,plant,pubescence,texture,width
532	wfo-0001029728	success	238	140	110	128	30	0.462	0.3–0.4,0.5-1.5,0.5–0.9,0.6–1.5,0.8–1.6,0–0.5,1.6,1.7–2.5,12–20,1–2,2.4–3.6,2.7-3.1,2–3,2–4,2–4-celled,3.5–5.5,3–5,4–10,4–14cm,4–15,4–6-rayed,6.2–8.1,7–12,abundantly,acute,anther,anthesi,apex,base,becoming,broadly,brownish,bud,calyx,cm,diameter,early,enlarged,filament,flattened-reniform,flower,fruit,glabrous,gland-tipped,glandular,glandular-pilose,globose,golden,green,hair,hyaline,lanceolate,late,leaf,length,light,lobe,lobed,long,main,margin,mature,maturity,minutely,mixed,mm,narrowly,nearly,numerous,obtuse,ovate,pair,pedicel,peduncle,petiole,pitted,pubescence,pubescent,ray,scarcely,scattered,sessile,shallowly,shrub,simple,size,stellae,stellate,stem,stigma,style,subcordate,suborbicular,surface,tan,terete,thin-textured,triangular,triangular-lanceolate,truncate,tube,unbranched,various,vein,white,wide,x,yellow,yellowish,–5	.6,0.2,0.3,0.4–2,0.7–1.2,0.8,0.8–2.5,1.2–2.3,1.5–2,1/3,11,1–,1–2-celled,2,2-foliate,2.8,200-310,260,3,3.4–4.5,3–18,4,4.5-5.5,5,7,7-10,7–14,7–15,8–10.5,9,=,abaxially,absent,accrescent,acicular,adaxiall,adaxially,admixture,armed,around,ascending,auxiliary,axe,blade,branche,capitat,cell,column,compressed,contiguou,curled,curved,cylindrical,densely,differing,dimorphic,directed,distall,eaf,eed,erect,exceeding,extra-axillary,fallen,fertile,fewer,free,frui,fruiting,geminate,generally,glabrou,grading,half,horizontally,intermixed,larger,least,longer,lower,lowermost,major,many,midpoint,minute,much,n,nflorescence,often,one,orolla,per,pilose,plane,pore,prickle,rachi,recurved,reflexed,relatively,ruit,short-pilose,shorter,similar,similarly,single-stemmed,slender,slightly,small,smaller,sparsely,spine,spreading,stout,straight,tall,tamen,tem,terminal,tip,undulate,unit,usually,vary,wid,withered,ympodial,–4	abaxial,adaxial,arrangement,bark,branch,branching,capitate,color,corolla,form,growth,height,history,inflorescence,life,midvein,na,number,ovary,perennial,plant,primary,seed,shape,tertiary,texture,trichome,unarmed,venation,young
533	wfo-0001029731	success	246	107	89	157	18	0.362	0.1-0.8,1,1-2,1-2.5,1.5,1.5-2.5,10-20,2.5,2.5-4.5,3-4,4,4-5,4-9,6-7,7-11,8-9,acquiring,anther,bark,base,black,branch,branched,branching,brown,calyx,clavate,cm,conical,coriaceous,corolla,cuneate,diameter,distributed,drying,elliptic,entire,epiphyte,evenly,filiform,finely,fleshy,fruit,glabrous,leaf,less,liana,linear,lobed,long,long-ellipsoid,longitudinal,longitudinally,main,margin,mauve,midvein,mm,obconical,oblong,obovate,papillose,pedicel,peduncle,petiole,primary,pyriform,ridge,ridged,rounded,several,sometimes,sparsely,stem,stigma,style,succulent,surface,terminal,thick,trichome,vein,white,widely,woody,wrinkling,x,yellow-green,young	.5,.6,0.05,0.25-0.3,1-1.5,1.5-3,1/3,1994,2,2-3,2-6,3,3-10,31,6,abaxially,accrescent,acuminate,acute,adaxially,age,almost,along,alyx,anthesi,apar,apex,apically,apparently,arcy,articulated,basal,basally,beak,becoming,berry,boundary,broadly,bumpy,clearly,concolorous,connate,crinkled,darker,delimited,delineated,deltoid,dense,development,different,dilated,domatia,dorsal,dorsifixed,dry,dull,eaf,early,elongating,enlarge,equal,erect,even,exserted,faint,filament,fine,flaring,flattened,flower,free,fruiting,ground,hair,iscoid,lamina,large,later,lateral,lengthening,like,lobe,lon,lower,mature,maturity,much,narrowly,nflorescence,nther,obtuse,occasionally,often,orange-brown,orolla,pair,papillae,part,pendulous,perfec,pericarp,persisting,plurifoliat,pore,poricidal,portion,prominent,protruding,rachi,raised,rakotozafy,rarely,reflexed,reported,revolute,ribbed,ruit,scar,see,shallowly,shorter,simple,sinus,slender,slightly,small,smaller,smoot,straight,stretched,stump,sunk,tearing,thickened,thinner,though,time,tip,toward,tub,tube,tuft,ud,unit,usually,vary,venation,ventral,visibl,visible,well-developed,wide,wing,winged,yellow,ympodial,’	arrangement,color,form,growth,height,inflorescence,length,na,number,ovary,plant,pubescence,ray,shape,size,smooth,texture,width
534	wfo-0001029741	success	137	77	67	70	10	0.489	.4,.5,0.8-3.5,0.9-1.2,1-1.5,1-3.5,1.1-1.3,1.5-4,1.5-6,2.2-9,2.5-7.8,9.5-22.5,age,anther,apiculate,attenuate,base,becoming,black,calyx,capitate,cm,completely,corolla,dark,deltoid,dry,drying,elliptic,fruit,furcate,glabrous,globose,growth,inflorescence,lateral,leaf,lenticellate,lighter,lobe,lobed,main,minor,mm,nearly,new,ovary,ovate,pedicel,petiole,poricidal,prominent,raised,reddish-brown,shrub,size,stem,stigma,style,tip,tree,tube,usually,vein,weak,white,x	0.5-1.5,1.5,10-50-flowered,2-2.5,3,?,accrescent,acute,anthesi,apex,berry,branched,ca,caly,closely,deflexed,dia,differing,difoliate,divisio,eaf,early,edicel,eed,erect,exserted,filament,flower,free,fruiting,geminat,glabrou,green,immature,known,lon,long,lower,major,middle,minutely,nflorescence,opposite,overlapping,pair,papillo,papillose,planar,pore,portion,produced,proximal,quite,ruit,scar,shaped,slender,slightly,spaced,straight,tall,tapering,tear-drop,ud,unit,variable,widest,wood,woody,ympodial	branching,color,diam,diameter,form,height,length,plant,shape,texture
535	wfo-0001029744	success	113	102	65	48	37	0.575	0.3-0.6,0.5-1,1,1.5-3.2,2,5-8,50,7-15,8-11,abaxially,acute,adaxially,bark,base,branch,calyx,cm,deltate,dendritic,densely,difoliate,elliptic,entire,flattened,form,fruit,geminate,glabrous,golden,incrassate,lanceolate,leaf,lobe,margin,minutely,mm,narrowly,oblanceolate,oblique,occasionally,ovoid-reniform,pale,pedicel,petiole,pitted,primary,pubescence,pubescent,revolute,shape,shrub,simple,single-celled,slightly,sometimes,somewhat,stem,surface,trichome,unifoliate,uniseriate,vein,white,x,young	1.5,2-4,8-10-flowered,along,apart,apex,beginning,blunt,brow,denser,distinct,eaf,eed,examined,extreme,fide,flexuous,glabrescent,inflorescenc,lamina,leave,long-acuminate,looping,lower,major,marginal,mature,minor,nflorescence,node,non-reproductive,older,opposite,pair,scar,see,similar,small,smaller,smith,spaced,thee,thin,tip,ud,unicellular,unit,ympodial	3,8-10,abaxial,adaxial,anther,arrangement,branching,brown,color,corolla,diameter,filament,flower,growth,height,history,inflorescence,length,life,main,midvein,na,number,ovary,peduncle,plant,ray,seed,size,stigma,style,tertiary,texture,tube,unarmed,venation,width
536	wfo-0001029746	success	179	85	70	109	15	0.391	0.5-1,0.7-1,1,1-1.3,1-1.5,2-2.5,2-7,2-8,3,3-4,4-9,8-11,anther,berry,blackish,broadly,brown,calyx,capitate,centre,cm,color,conical,corolla,cup-shaped,dark,darker,diameter,flattened,fleshy,fruit,glabrous,gland-tipped,glandular,globose,herb,heteromorphic,hollow,inflorescence,leaf,minutely,mm,orange,ovary,ovate,ovoid,pale,papillose,pedicel,petiole,pitted,poricidal,principal,pubescent,purple,red,reddish,shallowly,simple,stem,stigma,style,subshrub,surface,thin,tip,triangular,trichome,vein,x	.5,0.3-2,1.2-1.5,1.5,2,2-4,3-4-pluri-foliate,3-4.5,3-6,6,6-7,8-10,abaxially,acuminate,acute,adaxially,age,anthesi,apart,apex,base,bearing,becoming,c.,cell,ciliate,cordate,crenate,crowded,curved,densely,eaf,edicel,eed,ellipsoid,elliptic,enlarged,entire,erect,exerted,filament,flower,flush,free,fruiting,greenish,growing,horn,internodal,irregularly,lamina,lengthening,less,lobe,lon,long,longer,longest,lower,margin,markedly,mature,maturit,mid-length,mixed,narrowly,near,nflorescence,nodding,occasionally,pair,papillo,peduncle,pericarp,plan,pore,portion,primary,pubescen,rachi,reflexed,ruit,scar,shortest,single,slender,slightly,slit,somewhat,spaced,sparse,sparsely,spreading,straight,strongly,testal,third,tube,ud,uniseriate,unit,upper,upward,wall,widely,widest,woody,ympodial,–3	1.5-3,abaxial,adaxial,arrangement,branching,form,growth,height,length,plant,pubescence,seed,shape,size,texture
537	wfo-0001029751	success	158	132	119	39	13	0.753	.5,0.6–1.6,1,1.2,1.3–2.6,1.7,1.8–4,10–11,10–19,1–2,2.2–2.5,2.5–5,2–3,2–4-celled,2–5,3,3–9,4,5–10,5–25-flowered,6,8–9,9–18,acicular,also,anther,apex,armed,attenuate,base,blade,broad-based,broadly,calyx,capitate,celled,central,clavate,cm,compressed,corolla,covered,cuneate,deltoid,di-,diam,diameter,eglandular,elongate,enlarged,fruit,geminate,glandular,globose,globose-ellipsoid,hair,immature,lateral,leaf,length,linear,linear-lanceolate,little,lobe,long,longer,lower,midpoint,midvein,mm,moderately,needlelike,orbicular,ovary,pair,pedicel,peduncle,petiole,prickle,prickly,pubescent,ray,recurved,ripe,scorpioid,sessile,shallow,short,short-stalked,shrub,simple,size,small,sometimes,sparsely,spreading,stellate,stigma,straight,style,subcordate,surface,tooth,toward,triangular,trichome,trifoliate,truncate,unarmed,unequal,upper,variegated,white,whitish,wide,winged,yellow,±,×	12–14,1–3,2,4.5–6,5-merous,apical,eaf,eed,equal,extra-axillary,geminat,glabrous,gree,inner,lanceolate,lon,membranaceous,nflorescence,one,opening,outside,pedunculate,perfect,planar,pore,ruit,shorter,smaller,solitary,somewhat,stalked,subtended,tal,tem,twice,unbranched,unit,usually,ympodial	arrangement,color,form,green,growth,height,inflorescence,plant,pubescence,seed,shape,stem,texture
538	wfo-0001029758	success	261	149	118	143	31	0.452	.2,.5,0.5–0.7,0.6–0.9,0.8–1.3,0.9–1.5,1.0–3.4,1.1–1.8,1.2–1.4,1.2–1.9,1.3–1.7,1.7–2.8,10.3–14.5,2.1–6.2,2.2–2.9,2.3–3.3,2.3–6.4,2.8–2.9,2.8–4.2,4–6,7.6,7–17,7–9,abaxially,acuminate,adaxially,anther,apex,appearing,arcuate,attachment,attenuate,base,bent,black,calyx,capitate,channeled,chartaceous,cm,cordate,corolla,cream,cylindrical,dark,deltoid,densely,diameter,distinct,dry,entire,evenly,extra-axillary,filament,flattened-orbicular,flattened-reniform,flower,fruit,glabrous,globose,green,interpetalar,lateral,length,lobe,lobed,margin,markedly,mature,midvein,mm,nearly,notched,occasionally,orbicular,oval,ovate,pedicel,peduncle,petalar,petiole,point,porrect,prostrate,pubescent,purple,raised,ray,red-brown,reticulate,rounded,short-stipitate,shorter,shrub,simple,stamen,stellae,stellate,stem,stigma,straight,style,sub-coriaceous,surface,tip,tissue,toward,tube,unarmed,unbranched,vein,well-developed,white,yellow,yellow-brown,young,±90°,×	.3,/4,0.2,0.4–1.2,0.7–0.8,0.7–1.3,0.8–1.1,0.9–1.0,0.9–1.2,1.1–1.5,1.8,1.9–2.6,1.9–2.7,1/3,1/4–1/3,3.1–3.8,3.2–3.5,3.5–4.8,3.6,4.1–6.3,4.3–4.8,4.3–6.2,5-merou,5.7–7.8,5.8,8.0–33.1,8–11,absent,adnate,aequilateral,ag,alyx,anthesi,apart,apical,apparently,appresse,arching,around,articulate,axe,ba,basal,berry,blade,broad,brochidodromous,bud,bulge,curved,dentate,development,directed,directly,distal,distally,eaf,edge,eed,either,emerging,endocarp,equal,erect,exocarp,extending,fertile,filiform,flexed,free,geminat,glossy,gradually,gree,heterostylous,immature,increasing,intact,internode,intersepalar,juic,lanceolate,layer,least,lon,long,longer,lower,many,midpoint,midrib,minute,moderately,nflorescence,observed,obtuse,often,opaque,orolla,ove,per,perforated,persistent,pore,portion,potentially,presumably,remaining,ridge,rigid,row,ruit,short,side,sinus,sloughing,spaced,splitting,spread,spreading,stellate-pubescent,stipe,stipitate,suture,tamen,tem,tetrafoliate,thin,though,transparent,trifoliate,two,ud,unit,various,vary,weakly,well,wide,yellow-ferruginous,ympodial,±a,¼	abaxial,adaxial,arrangement,bark,branch,branching,color,drying,form,growth,height,history,inflorescence,leaf,life,main,na,number,ovary,plant,primary,pubescence,seed,shape,size,tertiary,texture,trichome,true,venation,width
539	wfo-0001029769	success	142	89	73	69	16	0.514	.25,.5,0.5-1.5,1-1.2,1-3,1.5-2.5,2.5-3,2.5-8,3.5-4,30-60-flowered,5-8,6-17,7-8,8.5-17,abaxially,acute,adaxially,along,anther,bark,base,brown,calyx,capitate,cm,conical,corolla,curl-tipped,cyathiform,dark,densely,dia,elliptic,flower,fresh,glabrous,globose,golden,green,hen,horizontally,leaf,lobed,long,main,midrib,mm,nearly,ovary,ovoid-reniform,pedicel,petiole,pubescent,ried,scattered,shaped,shrub,simple,somewhat,sparsely,stem,stigma,style,swollen,tear-drop,trichome,tube,uniseriate,vein,white,wide,x,young	1.5-2,4,4-5,8-9,acuminate,anthesi,apar,ape,apex,archin,ba,bearing,berry,branch,brochidodromu,cerro,deflexed,deltoid,eaf,edicel,eed,exserted,filament,filiform,free,fruiting,inglé,internodal,lateral,less,like,lobe,lon,lower,margin,minutely,nflorescence,older,onto,opposite,pair,papillo,papillose,pitted,pore,poricidal,portion,puberulent,reflexed,ruit,scar,smooth,spaced,straight,surface,tall,three,time,tip,tub,two,ud,unevenly,unifoliat,unit,widely,winged,woody,ympodial	arching,branching,color,diameter,form,fruit,growth,height,inflorescence,length,plant,pubescence,seed,shape,size,texture
540	wfo-0001029771	success	196	104	84	112	20	0.429	.5,0-0.5,0.3-0.6,0.4-1.4,0.45-0.9,0.9-1,1-1.5,1-2,1.2-2.8,2-2.3,2-3,2.5-10,2.5-7,3-4,4-7,4.5-12,5.5-8,6-11,anther,articulated,base,branch,calyx,chartaceous,cm,contiguous,curved,cylindrical,densely,diameter,elliptic,erect,flower,fruit,glabrous,gland-tipped,globose,green,grey,hair,inflorescence,juvenile,lanceolate,leaf,length,lilac,lobe,mm,nearly,ovate,pale,pedicel,peduncle,perennial,petiole,present,prickle,pseudo-umbellate,pubescent,purple,red,reniform,reticulate,rhizomatous,rotate,rotate-stellate,scattered,short,shrub,simple,slightly,stellate-pubescent,stigma,straight,style,surface,thick,throughout,tube,unbranched,white,x,yellow,yellowish	%,0-0.25,0-0.6,0-3,0-4,0-5,0.05-0.15,0.1-0.3,0.2-0.25,0.2-0.4,0.3-1,0.4-0.7,0.4-1,0.5-0.7,0.5-1.2,0.7-1.2,0.7-1.8,0.8-1.2,1,1-5,1-locular,1.8-3,15-35,2,2-3-foliate,4-,5-10,5-9,5-merou,7-10,7-8,abaxially,absen,absent,accrescent,across,acute,adaxially,adult,alyx,apart,apex,apparen,axe,ba,blade,capitat,connivent,cordate,deltate,directed,distall,distributed,dm,eaf,eed,eglandular,entire,exceeding,exocarp,extra-axillary,filament,finger,fruiting,geminate,grey-green,incomplete,interpetalar,juicy,lamina,lateral,lon,long,lower,margin,mature,mesocarp,mid-point,midpoint,minute,nflorescence,oblique,obtuse,orolla,part,per,perfect,placenta,pore,porrect,rachi,ray,ruit,septum,somewhat,spaced,stalk,stellae,succulent,tal,tamen,tem,time,tissu,tissue,unarme,unarmed,unit,upper,vary,wide,ympodial	abaxial,adaxial,arrangement,capitate,color,corolla,form,growth,height,na,ovary,plant,presence,pubescence,seed,shape,size,stem,texture,width
541	wfo-0001029775	success	54	78	29	25	49	0.537	0.25-1.5,0.5-4,3-4,4-5.5,alveolate,base,brown,cm,diameter,flattened,glabrous,globose,light,margin,mm,orange,perennial,puberulent,sparsely,stigma,strongly,subshrub,surface,trichome,unbranched,unifoliate,vine,x,yellow	2-6,2-8,6-16,absen,aggregate,ecuador,eed,hollow,internode,long,prickle,recurve,ripe,robust,ruit,shin,straight,tal,tem,thickened,tone-cell,truncat,unit,wide,ympodial	abaxial,adaxial,anther,arrangement,bark,branch,branching,calyx,color,corolla,drying,filament,flower,form,fruit,growth,height,history,inflorescence,leaf,length,life,lobe,main,midvein,na,number,ovary,pedicel,peduncle,petiole,plant,primary,pubescence,ray,seed,shape,size,stem,style,tertiary,texture,truncate,tube,unarmed,vein,venation,width,young
542	wfo-0001029780	success	204	126	110	94	16	0.539	1-1.2,1.5-2,11-24,120-210,15-22,15-45,2-2.5,2-2.8,2-3.5,2-5.5,20-60,3-6,3.5-7.3,4-6,4.5-6,5-7,5.5-13,50-70,600-950,8-12,?,abaxially,acumen,adaxially,anther,articulated,attenuate,axillary,berry,brownish,bud,cell,chartaceous,cm,condition,connivent,cordate,corolla,covering,dark,densely,diameter,distal,drying,flower,forked,fresh,fruit,generally,glabrous,gland,glandular,globose,green,green-white,greenish,hair,hair-like,half,head,herb,high,invested,lanceolate,lateral,leaflet,length,like,long,make,membranous,mm,mucilaginous,non-glandular,odd-pinnate,ovate,ovoid,pair,pale,pedicel,peduncle,petiole,pinkish,plant,pubescent,ripe,rotate,seed,short,size,stem,stigma,streak,stripe,style,subtending,terminal,testal,tetralobulate,thick,throughout,tip,trichome,unwinged,wall,wet,white,whitish,x,yellow	1-10,1-2,1.4-1.9,2-12,2.4-4.2,3,5-merou,5.5,absent,acute,ag,along,alyx,apart,apex,apparently,axe,base,blade,borne,capitat,ciliate,cuneate,decumbent,digestion,dorsally,eaf,edge,eed,end,enzyme,erec,especially,exceeding,except,filament,flat,folded,geminat,glabrou,greatly,hal,homostylous,honeycomb-shaped,interjected,lengthening,living,lobe,longer,lower,margin,midrib,minute,minutely,nflorescence,obtuse,often,orbicular,orolla,perfect,petiolulate,petiolule,plurifoliate,pore,poricidal,proximal,puberulent,rarely,reduced,removed,ruit,sessile,seudostipule,singly,slit,spaced,specimen,stamen,ste,stolo,straight,subequal,tall,tamen,tem,tri-,truncate,tube,tuber,typically,unit,usually,vary,ympodial	arrangement,branching,calyx,capitate,color,form,growth,height,inflorescence,leaf,na,ovary,pubescence,shape,surface,texture
543	wfo-0001029784	success	237	132	105	132	27	0.443	-12,-5,0.1-0.15,0.25-0.3,0.3-0.4,0.3-0.5,0.4-0.45,0.4-0.6,0.5,0.5-1.5,0.6-1,1-1.1,1-1.2,1-2-celled,1-4,1.0-1.3,1.5-,1.7-2.6,2-,2-2.5,2-3-celled,2/3,3-,3-5,5-10,5-14,5-8,abaxial,acute,anther,base,beneath,brown,calyx,capitate,cell,cm,corolla,crenate-serrate,dark,densely,diameter,eglandular,elliptic,filament,flower,fruit,glabrous,glandular,globose,golden,green,hair-like,head,herb,imparipinnate,inflorescence,interrupted,lanceolate,lateral,like,lobe,long,margin,mm,mostly,multicellular,narrowly,obovate,outgrowth,ovary,pale,patent,pedicel,peduncle,pentagonal,perennial,petiole,primary,proximal,pubescence,pubescent,scattered,simple,soft,sparsely,stem,stigma,stout,stripe,style,surface,tertiary,testa,thick,trichome,truncate,tube,uniseriate,vein,velvety,wall,white,wide,yellow	.1,.2,.5,0-4,0.1-,0.1-0.5,0.2,0.2-,0.2-0.3,0.2-0.5,0.3-0.35,0.3-1,0.4-,0.4-0.5,0.5-,0.7-1.2,0.9-1.2,1,1-,1-1.5,1-2,1.2-2.5,1/3,2,2-4,2-4.5,2-foliate,2-locular,2.5-3.5,abaxially,absent,abundant,acuminate,adaxially,adpressed,along,angled,anthesi,apex,apical,appearance,appendage,arising,articulated,articulation,axi,basal,basicopically,berry,bract,broadly,column,conical,crenation,decurrent,deeper,developed,distal,distributed,due,eaf,edicel,eed,enclosing,entire,evenly,exserted,fruiting,giving,glabrescent,gree,hal,half,halfway,included,interjected,internode,interspersed,irregularly,lamina,larger,leaflet,live,lon,long-acuminate,loosely,lower,markedly,maturing,nflorescence,node,northern,occasionally,often,orbicular,pair,paler,petiolule,plant,population,present,pseudostipule,rarely,reflexed,ripe,robust,ruit,secondary,sessile,silky,smaller,sometimes,somewhat,sparse,spreadin,staminal,sterile,straight,strongly,tem,terminal,trailing,ud,undulate,unicellular,unit,unseriate,usually,winged,woody,x,ympodial	0.1,adaxial,arrangement,bark,branch,branching,color,drying,form,growth,history,leaf,length,life,main,midvein,na,number,ray,seed,shape,size,texture,unarmed,venation,width,young
544	wfo-0001029785	success	223	143	109	114	34	0.489	0.1-0.5,0.8-1,1-1.2,1-2,1-5,1.2-3.2,1.5-3.6,1.8-3.5,10-26,2-4,3-6,3-8,3.5-5,3.8-7.2,5-16,5-9,8-11,abaxially,acute,adaxially,along,anther,attenuate,base,brownish,cell,chartaceous,clavate,cm,commonly,condition,corolla,covering,cuneate,dark,darker,denser,diameter,drying,filament,flower,forked,fresh,fruit,glabrous,globose,green,green-white,greenish,hair,hair-like,herb,invested,lanceolate,lateral,leaf,lengthening,like,lobe,long,make,margin,membranous,mm,mucilaginous,multiple-celled,non-glandular,oblique,odd-pinnate,outer,ovoid,pedicel,peduncle,pentagonal,petiole,plant,pore,poricidal,pubescent,purple,purple-tinged,ripe,rotate,rounded,seed,short,size,slightly,slit,sparsely,stem,stigma,style,subglabrous,testal,thick,throughout,tip,tube,typically,unbranched,vein,violet,wall,wet,whitish,wide,x,yellow	0-2,0-3,0.3-2.2,0.4-4.9,1-10,1.8-7,3-4,4-10.5,5-merou,6,absent,acumen,ag,alyx,apart,apex,apparently,articulation,axe,axillary,berry,blade,borne,broadly,bud,capitat,connivent,cordate,decreasing,decumbent,digestion,distal,dorsally,eaf,edge,eed,elliptic,end,enzyme,erec,especially,exceeding,flat,folded,geminat,generally,glabrou,greatly,half,homostylous,honeycomb-shaped,interjected,larger,leaflet,living,lower,markedly,medium,middle,midrib,minute,minutely,mottled,much,nflorescence,obovate,obtuse,one-quarte,orbicular,orolla,ovate,pair,pale,perfect,petiolulate,petiolule,plurifoliate,point,present,puberulent,quite,rarely,removed,ruit,scale-like,sessile,seudostipule,shallowly,singly,sometimes,spaced,specimen,stamen,ste,stolo,straight,stripe,subtending,tall,tamen,tem,terminal,toward,tri-,truncate,tuber,unequal,unit,unwinged,usually,variable,vary,white,ympodial	abaxial,adaxial,age,arrangement,bark,branch,branching,calyx,capitate,color,form,growth,height,history,inflorescence,length,life,main,midvein,na,number,ovary,primary,pubescence,ray,shape,surface,tertiary,texture,trichome,unarmed,venation,width,young
545	wfo-0001029788	success	194	115	78	116	37	0.402	.7,1-2,1.2-2,12-15,2-2.5,2-4,25-30,3.5-6,4,4-5,4.5-5,5-13,6.5-7,7-21,abaxially,adaxially,anther,attenuate,base,berry,brownish,cell,chartaceous,cm,condition,conical,corolla,covering,densely,diameter,drying,filament,flower,forked,fresh,glabrous,green,green-white,greenish,hair-like,herb,lanceolate,lateral,leaf,light,lobe,long,make,margin,mm,mucilaginous,odd-pinnate,ovoid,pedicel,peduncle,petiole,plant,pubescent,ray,ripe,rotate,seed,size,sparsely,stigma,style,subsessile,testal,thick,throughout,tube,violet,wall,wet,whitish,wide,x,yellow	.4,0-5,0.5,0.7-2,1-10,1.5-2,2.4-5.5,3-4,4-6,5,5-merou,6,absent,acumen,acuminate,ag,along,alyx,apart,apex,articulated,asymmetrical,axe,axillary,basiscopic,blade,borne,bud,c.,capitat,ciliate,commonly,connivent,decreasing,digestion,distal,dorsally,eaf,edge,eed,elliptic,elliptic-lanceolate,end,enzyme,equal,erec,especially,flat,folded,geminat,generally,glabrou,gradually,hal,half,homostylous,honeycomb-shaped,increasing,interjected,larger,leaflet,lengthening,living,lon,lower,middle,midrib,minute,minutely,mottled,narrow,nflorescence,orbicular,orolla,pair,petiolule,pilo,plurifoliate,pore,poricidal,puberulent,purple,removed,ruit,secondary,semierect,sessile,seudostipule,side,singly,slightly,slit,spaced,specimen,stolo,straight,subequal,subtending,symmetrical,tall,tamen,tem,terminal,tip,tissue,toward,tri-,tuber,typically,unit,unwinged,usually,vary,white,wing,ympodial	abaxial,adaxial,arrangement,bark,branch,branching,calyx,capitate,color,form,fruit,growth,height,history,inflorescence,length,life,main,midvein,na,number,ovary,perennial,pilose,primary,pubescence,shape,stem,surface,tertiary,texture,trichome,unarmed,vein,venation,width,young
546	wfo-0001029789	success	167	108	70	97	38	0.419	0.2-0.5,1-2,1-3,2-25,2-6,2-6.5,2.7-4.7,3-8.5,4-10,5-7,6,6-7,7-16.6,7-21,8-9,anther,base,blue,broadly,chartaceous,clavate,cm,connivent,corolla,dark,decurrent,diameter,filament,flower,forked,fruit,glabrous,green,hair,herb,lanceolate,leaf,light,lilac,linear,lobe,long-attenuate,membranous,mm,narrowly,odd-pinnate,ovary,ovate,pedicel,peduncle,pentagonal,petiole,plant,pubescent,rarely,rotate,sessile,short,simple,size,sparsely,stigma,style,subglabrous,tinged,tube,typically,white,x,yellow	0-2,0.5-2.8,0.8-3.5,1-10,1.5-2,1.7-8.5,1.8-6.5,12,2-3,3-5,4-13,5-merou,abaxially,acumen,acuminate,acute,adaxiall,adaxially,ag,alyx,apart,apex,apparently,articulated,attenuate,axe,axillary,basiscopic,blade,bud,capitat,decreasing,distal,dorsally,eaf,edge,eed,erec,exceeding,flat,folded,formed,geminat,generally,greatly,hal,half,homostylous,interjected,lant,lateral,leaflet,lengthening,like,long,lower,lunate,maturing,minute,minutely,mottled,never,nflorescence,orbicular,orolla,pair,perfect,petiolulate,plurifoliate,pore,poricidal,pubescen,purpl,rachi,seudostipule,side,slightly,slit,spaced,stamen,star,ste,sterile,straight,subequal,subtending,tall,tamen,tem,terminal,tip,toward,tri-,unit,usually,vary,ympodial	abaxial,adaxial,arrangement,bark,branch,branching,calyx,capitate,color,drying,form,growth,height,history,inflorescence,length,life,main,margin,midvein,na,number,primary,pubescence,purple,ray,seed,shape,stem,surface,tertiary,texture,trichome,unarmed,vein,venation,width,young
547	wfo-0001029810	success	149	96	80	69	16	0.537	0.5-3,1-1.3,1-1.5,1-10,1-2,1.1-2.3,1.5-3,2.5-3,3-3.5,3-4,3-6,5-15-flowered,5-16,5-6,adaxially,along,anther,apically,arachnoid,bark,base,brown,calyx,capitate,cm,compact,compressed,congested,conical,corolla,dark,dendritic,densely,dia,drying,elliptic,glabrous,globose,green,inflorescence,leaf,like,lobed,long,minutely,mm,narrowly,nearly,occasionally,ovary,ovoid-reniform,pale,papillose,pedicel,petiole,pitted,pointed,pubescent,reddish-brown,rest,shaped,shining,shrub,simple,size,small,sparsely,stem,stigma,style,surface,tan,tear-drop,tree,trichome,vein,white,wide,yellowish,young	.25,.5,0.5-1,1-3,2-3,2-5,4-10,8-12,abaxially,acuminate,acute,anthesi,ape,apex,attenuate,berry,closely,deflexed,deltate,differing,difoliate,eaf,edicel,eed,ellipsoid,exserted,filament,fleshy,free,fruiting,geminat,glabrou,internodal,large,later,lateral,lenticel,less,lobe,lon,lower,main,major,margin,middle,minor,nflorescence,older,opposite,overlappin,papillo,planar,pore,poricidal,portion,ruit,scar,slender,spaced,tall,tapering,tip,tub,tube,ud,unit,widest,woody,ympodial	0.5,abaxial,branching,color,diameter,flower,form,fruit,growth,height,length,na,plant,seed,shape,texture
548	wfo-0001029811	success	225	115	94	131	21	0.418	-3,0-35,0.1-0.4,0.3-1,1.3-1.7,1.5-6,13-20,2-2.5,2.5-3,2.8-3.2,3-5,3-5.5,3-7,4-8,4.5-5,5-11,6-12,7-9,8-12,abaxial,adaxial,anther,apically,apparently,bark,base,berry,calyx,cell,chartaceous,cm,cordate,cuneate,dark,diameter,discolorous,drying,faint,flattened-reniform,flower,fruit,glabrous,herb,lateral,leaf,length,lobed,long,margin,maturity,mauve,midvein,mm,moderately,narrow-deltate,orange-brown,outline,ovate,pair,pedicel,peduncle,petiole,pit,plant,poricidal,porrect,primary,raised,ray,sessile,shrub,simple,slightly,small,smooth,sometimes,spherical,stellate,stellate-pubescent,stem,style,surface,tapering,tertiary,tip,trichome,unarmed,unbranched,vein,venation,wide,yellow,yellow-green,young	-6,-merous,.5,/3,0,0-30,0.1-0.3,0.2,0.2-0.6,0.3-1.5,0.5-2,0.8-1.5,1,1-1.5,1-2.5,1-3,1.5-2.5,1/,1/2-2/3,1/3,1/3-2/3,10-22,15-23,15-50,2-5,2-5.5,20-100,3.5-4.5,5,5-17,5-40,5-9,7-18,8-18,abaxially,acicular,alyx,andromonoecious,apar,apart,apex,articulated,blade,broad-deltate,brown,connivent,cream,densely,distal,distance,eaf,eed,elongate,elongating,equal,erect,extending,eye,fewer,filament,flattened,free,fruiting,glandular,green,green-brow,hair,hermaphrodite,heterostylous,inflated,infructescence,less,lobe,lobing,long-acuminat,long-styled,longer,lower,lowermost,marking,mature,midpoint,minute,multangulate,naked,nflorescence,obtuse,often,older,one,open,orolla,oung,pale,pendulous,per,pericarp,perpendicular,plurifoliat,portion,prickl,prickle,prickly,ruit,scandent,scar,secondary,short,short-styled,shorter,side,spaced,sparsely,spreading,stalk,stalked,staminat,stout,straight,tamen,terete,time,tube,unit,upper,usually,vary,visible,way,woody,ympodial	arrangement,branch,branching,color,corolla,dense,form,green-brown,growth,height,inflorescence,long-acuminate,main,na,number,ovary,pubescence,seed,shape,size,texture
549	wfo-0001029938	success	179	107	92	87	15	0.514	0.7-1,0.7-1.2,1-1.5,1-2.5,1-4,1.5-2,1.5-2.5,12,2-2.5,2.5-3,3-7,3/4,5,6-8,6-9,8-10,acute,along,anther,apex,base,becoming,berry,black,branching,bright,calyx,capitate,clavate,cm,conical,corolla,deciduous,dendritic,densely,diameter,drying,elliptic,entire,fine,flattened,fruit,glabrous,globose,greenish,grey,growth,leaf,length,lenticular,lobe,margin,maturity,minutely,mm,narrowly,near,occasionally,ovary,pedicel,pericarp,petiole,plane,plant,plurifoliate,pore,poricidal,pubescent,pyramidal,red,reddish-brown,shrub,slit-like,small,somewhat,sparsely,stem,stigma,style,surface,thin,time,tip,tree,trichome,upon,violet,way,white,winged,x,young	.5,0,0.5,1,1-3,1.2-1.5,1/2,10-20,12-15,4,abaxially,absent,accrescent,adaxially,anthesi,apical,appearing,ba,bark,basal,blade,broader,deflexed,deltoid,denser,dichasia,discussion,eaf,edicel,eed,elliptical,ew,exserted,filament,flower,free,fruiting,glabrate,glabrou,growing,horizontal,inserted,larger,later,lateral,lon,long,long-triangular,lower,m.,monochasial,nflorescence,older,overtopping,pair,papillo,parallel,per,perhaps,pitted,planar,portion,prominent,raised,ruit,scar,secondary,see,shade,shoot,sleeve,soon,specimen,stamen,strongly,tall,tapering,terminal,tub,tube,ud,unit,upper,vein,wide,woody,ympodial	0.5-1,abaxial,adaxial,arrangement,color,form,height,inflorescence,na,papillose,pubescence,seed,shape,size,texture
550	wfo-0001029945	success	211	110	81	130	29	0.384	0-0.6,0.2-0.3,0.7-1.2,1-1.3,1.3-3.5,1.5-4,1.8-2.4,10-17,15-24,2.1-3.3,2.5-2.8,3-17,3-6,4-5.5,4-9,5-8,6-7,7-24,9-10,abaxial,adaxial,anther,attenuate,base,broadly,calyx,chartaceous,cm,cordate,dark,deeply,densely,diameter,filament,flower,fruit,glabrous,globose,green,inflorescence,lanceolate,leaf,length,lobe,lobed,long,margin,mid-point,midvein,mm,obtuse,ovate,pale,pedicel,peduncle,perennial,petiole,plant,pseudo-racemose,purple,ray,rotate,shallowly,shrub,simple,sparsely,stellate,stellate-pubescent,stem,stigma,streak,style,surface,thick,triangular,tube,unarmed,unbranched,vein,x,yellow	%,.05,0,0-0.3,0-0.5,0-1,0-10,0-2,0.15-0.25,0.35-0.45,0.4-0.5,0.4-0.7,0.5,0.8-1,1-1.5,1-3,1-8,1.2-1.6,1.4-2.7,1.7-4,17-26,2-30,2-4,2-5,2-locular,3-5,3-9,4-10,4-7,5-merou,5.5-17,6-10,6-8,7-14,7-9,9-24,abaxially,absen,absent,accrescent,acicular,across,acute,adaxiall,adaxially,adult,alyx,andromonoecious,anvil-shape,apart,apex,armed,articulated,ba,blade,broad-based,connivent,cross-section,cylindrical,d.,directed,distall,distally,dult,eaf,eed,eglandular,erect,exocarp,extra-axillary,finger,fruiting,functional,geminate,gland-tipped,grey,hair,half,heterostylous,hig,index,juicy,juvenile,lateral,less,lobing,lon,longer,lower,markedly,mature,mesocarp,midpoint,minute,mixed,moist,nflorescence,oblique,orolla,pair,part,per,placenta,pore,porrect,present,prickle,rhizomatous,ruit,sessile,short,side,stalk,stalked,stellae,straight,tamen,thicker,throughout,time,transparent,truncat,unit,upper,vary,weakly,white,wide,yellowish,ympodial	anvil-shaped,arrangement,bark,branch,branching,color,corolla,drying,form,growth,height,history,life,main,na,number,ovary,primary,pubescence,seed,shape,size,tertiary,texture,trichome,truncate,venation,width,young
551	wfo-0001029968	success	299	160	142	157	18	0.475	.25,/3,0,0.1-0.25,0.25-0.3,0.3-1,0.4,0.7-0.9,0.7-2,0.8-1.2,1.2-5.5,1.5-2.5,1/4-1/3,1/6-1/8,2-2.3,2-3,2.5-3.5,2.8-3,3-11,3-4,4-8,6-8,abaxially,acuminate,acute,adaxially,almost,along,anther,anthesi,apex,bark,base,becoming,berry,black,branch,branched,branching,brown,calyx,capitate,chartaceous,clavate,clustered,cm,corolla,cuneate,cupular,dark,deltoid,densely,diameter,distributed,dry,drying,entire,evenly,fasciculate,filament,finely,flat,flattened-reniform,flower,fruit,glabrous,gray,grey-green,greyish,inflorescence,large,large-leaved,leaf,length,like,line,lobe,lobed,long,main,margin,mature,middle,midvein,mixture,mm,network,obconical,oblique,oblong,orange-brown,ovate,pair,pale,paler,papillose,pedicel,peduncle,per,petiole,pitted,porrect,primary,pubescent,raised,ray,red,reddish,regular,rounded,rounded-undulate,seed,shoot,shrub,simple,size,small,small-leaved,smooth,sparsely,spheroidal,stellate,stellate-pubescent,stem,stigma,strongly,style,surface,tapering,tertiary,thin,tip,toward,trichome,tube,unarmed,uneven,vein,venation,wrinkled,x,young	-2,-3,.2,.5,.7,0.15,0.2-0.4,0.25,0.3,0.3-0.4,0.4-0.6,0.5,0.7-1,0°,1,1-2.5,1-3,1.5,1.5-3,2.5-4,2.5-5.5,4,4-6,4-7,4-merou,7-9,absent,accrescent,acicular,adjacent,age,alternate,alyx,apart,apically,apparently,area,arising,armed,articulated,articulation,basally,brachyblast,ca,canaliculate,central,cordate,covered,curved,dehiscence,detaching,development,dilated,discolorous,divided,eaf,early,edge,eed,ellipsoi,elongating,equal,erect,except,extending,filiform,flattened,flexuous,forming,free,fruiting,glabrescent,increasing,indumentum,inside,invisible,irregular,irregularly,lateral,leave,leaved,lengt,lengthening,less,lobing,looping,lower,m.,maturity,midpoint,minor,nflorescence,nther,obscured,obscurely,occasionally,often,opposite,orange,orolla,outside,ovoid,patch,pendulous,perfect,pericarp,pit,plurifoliat,pore,poricidal,portion,present,prickle,prior,prominent,protruding,rachi,reduced,remnant,ridged,ruit,scar,secondary,seemingly,seen,sessile,shiny,shorter,sinus,smoot,sometimes,somewhat,sparse,specimen,spreading,stalk,stalked,straight,stump,tearing,terete,terminal,thicker,translucent,ud,unarme,undulate,unit,usually,variable,vary,virtually,visible,white,wide,widening,ympodial	2.2,abaxial,adaxial,arrangement,color,form,growth,height,history,life,na,number,ovary,plant,pubescence,shape,texture,unbranched
552	wfo-0001029978	success	208	108	75	133	33	0.361	0.3-0.4,0.5-0.6,1-2,1.4-1.5,1.5-3.1,11-19,15-27,3-7,3.2-2.5,3.5-9.5,3.7-8.1,4-11,4-7,4.2-5.2,5-16.5,8-10,anther,attenuate,base,chartaceous,clavate,cm,coarsely,conical,corolla,dark,diameter,drying,elliptic,filament,finely,flower,forked,fruit,glabrous,green,greenish,hair,herb,lanceolate,leaf,light,lobe,long,margin,medium,membranous,mm,mucilaginous,odd-pinnate,ovate,ovoid,pedicel,peduncle,pentagonal,petiole,plant,poricidal,pubescent,purple,ray,rotate,seed,simple,size,stem,stigma,style,subsessile,tip,tube,wet,whitish,x,yellow	0.3-0.7,0.7-1.9,0.8,0.9-2.3,1-10,1.3-1.5,1.8-5,2-4,3-5,3.1-6.3,5,5-merou,abaxially,acumen,acuminate,adaxially,ag,along,alyx,apart,apex,apparently,arranged,articulated,asymmetrical,axe,axillary,basiscopic,bead,berry,blade,brownish,bud,capitat,cell,ciliate,commonly,condition,connivent,covering,darker,decreasing,digestion,distal,dorsally,eaf,edge,eed,enzyme,erec,especially,exceeding,flat,folded,fourt,fresh,geminat,generally,glabrou,gradually,green-white,hair-like,half,homostylous,honeycomb-shaped,interjected,larger,lateral,leaflet,lengthening,less,like,living,lower,make,middle,midrib,minute,minutely,moniliform,mottled,multiple,narrow,necklace,nflorescence,orbicular,orolla,pair,perfect,petiolule,plurifoliate,pore,puberulent,pubescen,removed,ripe,ruit,secondary,semierect,sessile,seudostipule,side,slightly,slit,spaced,sparsely,specimen,stamen,ste,stolon,straight,subequal,subtending,symmetrical,tall,tamen,tem,terminal,testal,thick,throughout,tissue,toward,tri-,tuber,typically,unit,usually,vary,wall,wide,wing,ympodial	abaxial,adaxial,arrangement,bark,branch,branching,calyx,capitate,color,form,growth,height,history,inflorescence,length,life,main,midvein,na,number,ovary,primary,pubescence,shape,surface,tertiary,texture,trichome,unarmed,vein,venation,width,young
553	wfo-0001029980	success	173	81	68	105	13	0.393	.1,0.25-0.5,0.5-1,0.5-1.2,0.5-2.5,0.5-5,0.7-1.3,0.8-1.2,1-1.5,1.2-2.5,1.5-2,2-5,2/3,3-4,3-9,6.4-17,anther,appressed,bark,base,brown,calyx,cm,conical,corolla,dark,dia,elliptic,flattened-reniform,glabrous,globose,gray,leaf,lobed,long,minutely,mm,near,node,older,opposite,ovary,ovate,pedicel,petiole,plant,puberulent,shape,shaped,shiny,shrub,simple,size,slender,slightly,stem,tapering,tear-drop,trichome,tube,tuft,unicellular,uniseriate,way,white,winged,x,young	.5,0.1-0.25,0.25-1,0.9-4.5,1-1.7,1.5-6,2-6,5-10,5-50-flowered,abaxially,acute,adaxially,anthesi,apar,apex,appearing,axil,ba,berry,black,bright,bud,closely,curved,decurrent,deflexed,deltoid,density,differing,difoliate,dried,drying,eaf,edicel,eed,elevation,especially,exserted,filament,five,free,fruiting,geminat,greatly,green,greenish-white,high,impressed,incrassate,knob,lateral,live,lobe,lon,lower,main,major,margin,material,middle,minor,nflorescence,often,one,onto,orbicular,overlapping,pair,pale,paler,papillose,pitted,pore,poricidal,portion,prominent,proximal,race,reflexed,rounded,ruit,scar,side,small-capitate,somewhat,soon,spaced,specimen,stigma,straight,style,surface,tall,tan,tip,ud,unit,varying,vein,venezuelan,whit,widest,woody,yellowish,ympodial	abaxial,branching,color,diameter,form,fruit,growth,height,inflorescence,length,pubescence,seed,texture
554	wfo-0001029989	success	161	100	81	80	19	0.503	.5,0.25-0.5,0.5-1,0.5-1.5,1-1.5,1-2.5,1.3-2.3,10-14,2.5-3,3-5,3-8,3.5-8,4-4.5,5-6,7-20,abaxial,anther,apex,bark,base,calyx,capitate,cm,conical,corolla,dendritic,dense,densely,dia,difoliate,elliptic,flattened,glabrous,globose,golden,gray,green,greenish-black,incrassate,inflorescence,lateral,leaf,lenticular,like,lobed,long,main,margin,minutely,mm,nearly,occasionally,ovary,pair,pedicel,petiole,pitted,pubescence,pubescent,reddish-brown,rest,shaped,shining,short-style,shrub,simple,small,stem,stigma,style,surface,tear-drop,tree,tree-like,trichome,unifoliate,vein,white,wide,x,young	.2,/2,1-2,1-4,1.5-2.5,5-10-flowered,abaxially,acute,adaxially,anthesi,berry,branch,branched,broadly,brownish-re,central,closely,collection,congested,deflexed,deltoid,described,dimaeter,discussion,drying,due,eaf,edicel,eed,erect,exserted,filament,fleshy,free,fruiting,geminat,heteromorphic,inflorescenc,internodal,lamina,lobe,lon,lower,middle,nflorescence,nodding,northern,older,opposite,overlappin,papillo,peru,peruvian,perú,petal,petaloid,planar,population,pore,poricidal,portion,probably,reddish,ruit,scar,scattered,see,somewhat,spaced,sparsely,tall,tip,tube,ud,unit,way,widest,woody,yellow,ympodial	adaxial,arrangement,branching,brownish-red,color,diameter,form,fruit,growth,height,length,na,number,papillose,plant,seed,shape,size,texture
555	wfo-0001030000	success	155	140	115	40	25	0.742	-4,-50,-7,0.5-1,0.5-14,0.5-3,1,1-10,1-2,1.5-,15-25,2-2.5,2-3,2-5,2.5-,2.5-3.5,25-30,3-16,3-4,3.5-5,4-4.5,4-5,abaxially,absent,acute,adaxially,also,apart,apex,apiculate,articulated,base,calyx,chartaceous,cm,connective,connivent,conspicuous,coriaceous,cucullate,deltate,densely,dia,diameter,dilated,directed,distally,eglandular,ellipsoidal,equal,exceeding,flattened,flower,fruit,glabrous,globose,green,hair,immature,laterally,leaving,lobe,long,margin,mature,mm,moderately,narrowly,oblong,obtuse,occasionally,orange,ovoid,pedicel,pedicellar,peduncle,pilose,pore,produced,puberulent,pubescent,purplish,rachi,radiu,rarely,remnant,scar,shorter,shrub,slightly,small,sparsely,spotted,stellate,stigma,strongly,style,subcoriaceous,swelling,thecae,tinge,tip,tomentose,tree,triangular,truncate,tube,umbrella-shaped,unbranched,white,wide,x,yellow,yellow-brown,yellowish	-5,-pilose,0.5-,1-,1.5-2,10-,10-20,2-4,2.5-3,3-,30-50,4,4-foliat,7-15,aggregate,ape,axe,biglandula,cell,ciliat,creamy-whit,eed,lon,lower,nflorescence,nther,orolla,perfect,pubescen,ruit,smal,spaced,stamen,stone,tal,tem,ud,unit,vary,ympodial	10-50,anther,articulation,biglandular,branching,bud,ciliate,color,corolla,creamy-white,direction,form,growth,height,inflorescence,length,ovary,plant,pubescence,seed,shape,size,spacing,stem,texture
556	wfo-0001030000	success	178	110	88	90	22	0.494	-50,-7,-pilose,0.5-1,0.5-13,0.5-3,1,1-,1-10,1.5-,1.5-2,15-25,2-,2-2.5,2.5-,2.5-3,2.5-3.5,25-30,3-,3-16,3-4,3.5-5,30-50,4-25,4-4.5,4-5,5-25,adaxially,also,apex,apiculate,articulated,base,calyx,cm,conspicuous,deltate,densely,dia,diameter,ellipsoidal,flattened,flower,fruit,glabrescent,glabrous,globose,green,immature,leaving,long,mature,mm,moderately,oblong,occasionally,orange,ovate,pedicel,pedicellar,peduncle,petiole,pilose,puberulent,pubescent,purplish,rachi,remnant,scar,shrub,simple,small,sparsely,spotted,stellate,stigma,style,subcoriaceous,tinge,tip,tree,truncate,unbranched,white,x,yellow,yellow-brown,yellowish	-2,-4,-5,0.5-,0.5-14,1-1.5,1-2,1-5,10-,10-20,2-3,2-4,2-5,4,4-foliat,7-15,abaxially,absent,acuminate,acute,aggregate,apart,ape,axe,basal,biglandula,blade,cell,chartaceous,ciliat,connective,connivent,cordate,coriaceous,creamy-whit,cucullate,dilated,directed,distally,eaf,eed,eglandular,elliptic,entire,equal,exceeding,hair,laterally,lobe,lon,lower,margin,narrowly,nflorescence,nther,oblique,obtuse,often,orolla,ovoid,perfect,pilo,pore,produced,pubescen,radiu,rarely,ruit,shorter,slightly,smal,spaced,stamen,stone,strongly,swelling,tal,tem,thecae,time,tomentose,triangular,tube,ud,umbrella-shaped,unit,vary,vein,wide,ympodial	abaxial,adaxial,anther,arrangement,biglandular,color,corolla,form,growth,height,inflorescence,leaf,length,ovary,plant,pubescence,seed,shape,size,stem,surface,texture
557	wfo-0001030004	success	177	95	82	95	13	0.463	0-1.5,0.2-1,1-1.5,1.2-2,1.5-2.5,15,2-20,20-200-flowered,3-3.5,3-4,3.5-5,4-15,5-25,9-30,abaxially,across,adaxially,anther,axillary,bark,base,branching,broadly,calyx,capitate,cm,conical,corolla,crotaloid,dendritic,densely,dia,elliptic,flattened-reniform,glabrous,globose,green,hard,inflorescence,later,lateral,leaf,lobed,long,loose,minutely,mm,much,nearly,obovate,often,onto,ovary,pale,pedicel,petiole,plant,pubescence,pubescent,seed,shaped,shrub,small,sparsely,stem,stigma,stout,style,surface,tan,tear-drop,terminal,translucent,tree,trichome,white,wide,winged,woody,x,yellowish-green,young	.3,0-0.5,0.3-1,0.8-1.1,1-2,15-20,abaxial,acuminate,acute,along,always,anthesi,apar,apex,appearanc,barely,basal,berry,blade,body,branched,bushy,collection,cone,decurrent,deltate,dense,denser,diamete,distal,drying,eaf,edicel,eed,erect,especially,exserted,filament,flat,fleshy,free,fruiting,giving,greenish-yello,incrassate,juvenile,knob,lamina,large,like,lobe,lower,main,many,margin,middle,nflorescence,obovoid,occasionally,older,pair,papillate,papillo,pericarp,pitted,planar,plurifoliate,pore,poricidal,portion,possessing,prominent,rest,ruit,scar,sessile,simple,spaced,strongly,surpassing,tall,thick,thin,time,tip,tub,tube,tuft,ud,unevenly,variously,vein,widest,yellowish,ympodia	color,diameter,form,fruit,greenish-yellow,growth,height,length,na,papillose,shape,size,texture
558	wfo-0001030007	success	168	99	81	87	18	0.482	0.2-1,0.8-1,1-1.5,1-15,1-2,1.6-2.2,15-20,2-4,3/4,4.5-5,7-10,7-9,along,anther,bark,base,beneath,brown,calyx,campanulate,clavate,cm,corolla,dark,decurrent,densely,dia,dry,elliptic,flattened,glabrate,glabrous,globose,golden,golden-pubescent,green,impressed,leaf,live,lobed,long,material,midrib,minutely,mm,older,ovary,pale,papillose,pedicel,petiole,pitted,plant,poricidal,prominent,pubescent,reniform,shaped,shrub,simple,slender,small,soft,sparsely,stem,stigma,straight,style,surface,tapering,tear-drop,tip,tree,trichome,tube,uniseriate,way,white,winged,x,young	.05,.4,.5,0.1-0.5,0.5-1,1.5-5,2-7,3-5,6-10-flowered,abrupt,acuminate,acute,anthesi,apart,apex,ba,becoming,berry,branched,broadly,bud,closely,cork,deltoid,difoliate,edicel,eed,erect,exserted,filament,fleshy,free,fruiting,geminateleaf,gre,hooded,incrassate,inflorescenc,lateral,like,lobe,lon,longer,lower,main,major,margin,middle,minor,nflorescence,oblique,obovoid,occasionally,one,onto,opposite,outline,pair,papillo,planar,pore,portion,raised,rest,rounded,ruit,scar,short,shorter,slightly,soon,spaced,specimen,tall,thick,thickened,trunk,tub,two,type,ud,unit,vein,widening,widest,woody,ympodial	0.5,branching,color,diameter,form,fruit,grey,growth,height,inflorescence,length,midvein,na,pubescence,seed,shape,size,texture
559	wfo-0001030010	success	156	94	78	78	16	0.5	.5,.75,/4,0.5-5,0.9-1.1,1-1.3,1.2-1.5,1.5-2,10-15,10-50-flowered,2-2.2,2-7,2.5,20-40,4-4.5,5-7,anther,area,bark,base,brown,calyx,cm,corolla,cyathiform,dark,deciduous,decurrent,deflexed,dia,fleshy,fruit,furcate,glabrate,glabrous,globose,green,grey,leaf,lobed,minutely,mm,nearly,obovate,often,older,ovary,ovoid-reniform,papillose,pedicel,petiole,pitted,poricidal,puberulent,reddish,shaped,shrub,simple,size,slightly,small,smooth,stem,stigma,straight,style,surface,tear-drop,tiny,tip,tree,trichome,tube,way,white,winged,x,young	0.7-1,1-1.5,1-2,11-12,3-5,7-10,acuminate,acute,anthesi,apex,appearing,attenuate,basal,beneath,berry,bud,closely,deltate,differing,difoliate,distal,dry,eaf,edicel,eed,ellipsoid,exserted,f,filament,free,fruiting,geminat,hooded,lateral,lobe,lon,long,lower,m.,main,major,margin,materia,material,middle,midrib,minor,minute,near,nflorescence,occasionally,one,opposite,orange,overlappin,pair,persistent,planar,pore,portion,prominent,rather,ruit,scar,shin,soon,spaced,styl,tall,tapering,trunk,ud,uniseriate,unit,vein,widest,woody,ympodial	abaxial,color,diameter,flower,form,growth,height,inflorescence,length,na,plant,pubescence,seed,shape,shiny,texture
560	wfo-0001030023	success	171	122	82	89	40	0.48	0.5-1,1-2,1-8,1.5-2,1.5-7,10-25,12-18,2-3,2.5-3.5,3-4.5,3-5,30-50+,4,4-12,5-16,5-6,6-26,6-7,7-9,acute,apex,apiculate,base,branched,calyx,cm,color,connivent,cordate,cuneate,deeply,densely,diameter,ellipsoidal,elliptic,entire,especially,finely,flattened,flower,fruit,glabrous,glandular-puberulent,globose,greenish-white,highly,lobe,loosely,main,margin,membranaceous,mm,moderately,narrowly,oblong,occasionally,ovate,pedicel,peduncle,peltiform,petiole,probably,puberulent,pubescence,pubescent,purplish-,simple,sparsely,stellate,stigma,style,subcoriaceous,tip,tree,triangular,truncate,tube,unknown,vein,x,yellowish,young	-,0-100+,1,1-,10-,11-40+,13-20,2,20-30,4-10,4-foliat,5,5-,abaxially,adaxially,aggregate,apart,ape,articulated,axe,basal,beyond,blade,capitat,cell,ciliate,connective,cylindrical,denser,dilated,directed,distally,eaf,eed,exceeding,except,exserted,fleshy,forked,glandular-puberulen,hair,lanceolate,leaving,lon,long,lower,narrow,near,nflorescence,nther,oblique,obtuse,often,orolla,pedicellar,perfect,pore,presen,present,prominent,pubescen,pubescent-pilo,rachi,radiu,remnant,ripe,ruit,short-acuminate,shorter,slightly,small,somewhat,spaced,stamen,stone,swelling,tal,tem,thecae,time,ud,unbranched,unit,unknow,usually,vary,villous,wide,ympodial	50-100+,abaxial,adaxial,anther,arrangement,bark,branch,branching,capitate,corolla,drying,filament,form,growth,height,history,inflorescence,leaf,length,life,midvein,na,number,ovary,perennial,plant,primary,pubescent-pilose,ray,seed,shape,size,stem,surface,tertiary,texture,trichome,unarmed,venation,width
561	wfo-0001030032	success	250	131	106	144	25	0.424	+,0.2-0.3,0.2-0.5,0.25-0.4,0.5-0.6,0.5-0.7,0.8-1.0,1-1.3,1-1.5,1.5-2.5,11-20,13-35,2-3-locular,2-4,2-5,2-60,2-lobed,2.4-3.5,3.0-3.5,3.5-12,30,4-5,4-6-celled,4.3-5.0,60-80,8-10,8-20,adaxial,anther,base,branched,bright,brown,calyx,capitate,cm,completely,conical,corolla,decurrent,deltate,densely,diameter,elliptic,entire,filament,flower,fruit,glabrous,golden,green,hair-like,imparipinnate,interrupted,irregularly,leaf,length,lobe,long,many,margin,midvein,mm,moderately,oblanceolate,obovate,occasionally,orbicular,outgrowth,ovary,pale,pedicel,peduncle,petiole,pithy,primary,pubescence,pubescent,rotate,rotate-stellate,rough,seed,simple,slightly,soft,somewhat,sparsely,splitting,stem,stigma,style,surface,tertiary,thick,time,trichome,truncate,tube,uniseriate,vein,venation,vine,white,wide,woody,yellow	.05,.5,0.1-0.4,0.1-0.5,0.2,0.4-1.5,0.5,0.5-1,0.5-1.5,0.5-2,0.6-1.1,0.7-0.8,0.8-1.1,1-2-celled,1-3,1-celled,1.5-2,2,2-10,2-3.5,3,3-5,4-celled,5-plurifoliate,6-11,7-16,7.5-10,8-10-celled,abaxially,absent,abundant,acuminate,acute,adaxially,along,also,anthesi,apex,apical,appearance,appendage,articulated,articulation,basal,basally,basiscopically,bent,border,branche,breaking,cell,clambering,column,conspicuou,dark,densest,desne,dry,eaf,ebracteate,edicel,eed,exserted,free,fruiting,give,glandular,gree,greenish-brown,halfway,hea,head,herbarium,interjected,internode,lamina,large,larger,lateral,leaflet,leave,like,longest,lower,markedly,middle,mixed,much,multicellular,nflorescence,node,oblique,often,older,onto,opposite,pair,paler,patent,petiolule,present,pseudostipule,rachi,reflexed,rest,round,ruit,secondary,set,shorter,silky,smaller,sometimes,sparser,specimen,spreading,stamen,staminal,sterile,straight,subopposite,swollen,tall,tangled,tem,terminal,testa,thickened,tiny,tip,touch,transparent,ud,unicellular,unit,usually,vegetatio,wall,weaker-walled,well-developed,winged,ympodial,younger,½-3/4	abaxial,arrangement,bark,branch,branching,color,dense,drying,form,growth,height,history,inflorescence,life,main,na,number,perennial,plant,ray,shape,size,texture,width,young
562	wfo-0001030048	success	156	97	79	77	18	0.506	0.5-1.5,1-1.5,1.2-2,1.3-1.6,1.5-7,2-3,2-5,3-3.5,3-5,4-15,4-4.5,5-10-flowered,5-8,abaxial,acute,adaxially,anther,apically,arachnoid,bark,base,bi-lobed,blue,brown,calyx,clavate,cm,conical,corolla,decurrent,densely,dia,difoliate,drying,elliptic,felt-like,glabrate,glabrous,globose,golden,green,greyish,leaf,lobed,long,matted,minutely,mm,nearly,onto,ovary,ovoid-reniform,pale,papillose,pedicel,petiole,pitted,pointed,pubescent,reddish-brown,shaped,shiny,shrub,simple,small,somewhat,stem,stigma,style,surface,tan,tear-drop,tree,trichome,trifoliate,unit,white,wide,young	.5,1-2,1.5-3.5,10-16,5973,abaxially,along,anthesi,ape,apex,apparently,becoming,berry,bi-colored,broadly,closely,completely,covered,deflexed,deltate,eaf,edicel,eed,ellipsoid,exserted,fide,filament,fleshy,four-angle,free,fruiting,geminat,impressed,inflorescenc,internodal,lamina,lateral,lightly,like,lobe,lon,lower,main,margin,middle,nflorescence,occasionally,older,opposite,overlappin,pair,papillo,planar,pore,poricidal,portion,prominent,rather,rest,ruit,scar,solomon,spaced,sparsely,strongly,tall,thick,thickened,tip,tub,tube,ud,vein,widest,woody,yellowish,ympodial	arrangement,color,diameter,flower,form,fruit,growth,height,inflorescence,length,na,plant,pubescence,seed,shape,size,sympodial,texture
563	wfo-0001030053	success	141	107	71	70	36	0.504	0.5,0.5-1,1-1.3,1-13,1.3-3.5,1.5-5.5,1.8-2,100,2-2.5,2.5-3,3.5-4,4-,7-11,7-9,<,apex,base,branch,branched,brown,calyx,cm,coriaceous,corolla,cyathiform,decurrent,diameter,elliptic,entire,fine,flattened,flower,glabrous,greenish,growth,inflorescence,irregularly,lobe,lobed,many,margin,minutely,mm,pair,pale,parallel,pedicel,peduncle,petiole,pitted,primary,reniform,revolute,shallowly,shiny,simple,slightly,stem,strongly,surface,terminal,time,truncate,tube,vein,venation,vine,white,woody,x,yellowish	10-20,5,5-merou,abruptly,abscission,acuminate,acute,aiding,alyx,anthesi,apart,apical,apiculae,ark,around,articulated,berry,bfeore,cell,climbin,completely,eaf,eed,exserted,far,fide,filiform,fragrant,frui,fruiting,hyaline,leaving,long,lower,mentz,near,new,nflorescence,nipple,older,orolla,papilla,papillo,peg,pendant,per,perfect,plurifoliat,rectangular,rim,scar,secondary,shin,shining,sleeve,small,spaced,spreadin,spreading,support,tem,testal,tiny,tip,turbinate,twining,ud,unit,usually,ympodial	abaxial,adaxial,anther,arrangement,bark,branching,color,drying,filament,form,fruit,height,history,leaf,length,life,main,midvein,na,number,ovary,papillose,plant,pubescence,ray,seed,shape,size,stigma,style,tertiary,texture,trichome,unarmed,width,young
564	wfo-0001030057	success	141	96	54	87	42	0.383	-2,2-3-celled,2-4,2-4.5,2-6,20-30,20-80,4-10,7-14,8-19,base,cell,chartaceous,cm,cordate,covering,cuneate,diameter,drying,elliptic,flower,forked,fruit,globose,green,greenish,hair,hair-like,herb,lateral,leaf,like,long,membranous,mm,odd-pinnate,ovate,ovoid,pedicel,peduncle,petiole,plant,pubescent,seed,short,size,stem,subglabrous,testal,thick,truncate,wall,whitish,x	1-10,1-2,2.1-4.1,3-5,3.5-8,4.3-8.2,5.5-12,8,abaxially,absent,acuminate,acute,adaxially,apart,apex,apparently,articulated,axe,axillary,berry,blade,borne,broadly,brownish,bud,condition,decreasing,digestion,distal,eaf,eed,end,enzyme,erec,extremely,fresh,geminat,generally,glabrou,greatly,green-white,half,high,honeycomb-shaped,interjected,larger,leaflet,living,lunate,make,mottled,mucilaginous,narrow,nflorescence,pair,perfect,petiolule,plurifoliate,purple,removed,ruit,scale-like,seudostipule,singly,small,sometimes,spaced,specimen,ste,stolo,suborbicular,subtending,tall,tem,terminal,thir,throughout,toward,tri-,tuber,typically,unit,unwinged,usually,wet,wing,ympodial	abaxial,adaxial,anther,arrangement,bark,branch,branching,calyx,color,corolla,filament,form,glabrous,growth,height,history,inflorescence,length,life,lobe,main,margin,midvein,na,number,ovary,primary,pubescence,ray,shape,stigma,style,surface,tertiary,texture,trichome,tube,unarmed,vein,venation,width,young
565	wfo-0001030057	success	197	113	80	117	33	0.406	-10,-2,.5-3.5,1-2,2-3-celled,2-4,2-4.5,2-6,20-30,20-80,4-10,5-10,5-6,7-14,8-19,abaxially,adaxially,anther,base,brownish,cell,chartaceous,cm,condition,connivent,cordate,corolla,covering,cuneate,diameter,drying,elliptic,filament,flower,forked,fresh,fruit,glabrous,globose,green,greenish,hair,hair-like,herb,lanceolate,lateral,leaf,like,linear,lobe,margin,membranous,mm,odd-pinnate,ovate,ovate-lanceolate,ovoid,pedicel,peduncle,pentagonal,petiole,plant,pubescent,rotate,seed,short,size,stem,stigma,style,subglabrous,testal,thick,truncate,tube,wall,white,whitish,x,yellow	1-10,2-3,2-5,2.1-4.1,3-5,3.5-8,4.3-8.2,5-merou,5.5-12,8,absent,acumen,acuminate,acute,ag,along,alyx,apart,apex,apparently,articulated,axe,axillary,berry,blade,borne,broadly,bud,ciliate,decreasing,digestion,distal,dorsally,eaf,edge,eed,end,enzyme,erec,especially,exceeding,extremely,flat,folded,geminat,generally,glabrou,globo,greatly,green-white,greenish-yellow,half,high,homostylous,honeycomb-shaped,interjected,larger,leaflet,lengthening,living,long,lower,lunate,make,middle,midrib,minutely,mottled,mucilaginous,narrow,nflorescence,orolla,pair,perfect,petal,petiolule,plurifoliate,pore,poricidal,puberulent,purple,removed,ruit,scale-like,seudostipule,singly,slit,small,sometimes,spaced,specimen,stamen,star,ste,stolo,straight,striped,suborbicular,subtending,tall,tamen,tem,terminal,thir,throughout,tip,toward,tri-,tuber,typically,unit,unwinged,usually,vary,wet,wing,ympodial	abaxial,adaxial,arrangement,bark,branch,branching,calyx,color,form,growth,height,history,inflorescence,length,life,main,midvein,na,number,ovary,primary,pubescence,ray,shape,surface,tertiary,texture,trichome,unarmed,vein,venation,width,young
566	wfo-0001030067	success	206	122	88	118	34	0.427	0-1,0-1.5,0.1-0.3,0.2-0.4,0.2-1,0.4-1.1,0.5-0.8,0.9-2.8,1-3,1-7,13-15,2-2.5,2-3,2.5-3.5,2.5-7,3-8,3.5-5.5,3.6-5.3,7-8,anther,apex,basal,base,black,broad,broadly,brown,calyx,chartaceous,cm,connivent,cordate,cylindrical,deltate,densely,depressed-globose,diameter,entire,filament,flower,fruit,glabrous,gland-tipped,globose,hair,herbaceous,inflorescence,length,lobe,long,loosely,margin,midvein,mm,moderately,obscure,obtuse,orbicular,ovate,ovate-oblong,pedicel,peduncle,perennial,petiole,present,pseudo-racemose,pubescent,purple,ray,recurved,resprouter,rhizomatous,rotate,shallow,short,shrub,simple,stellate-pubescent,stem,stigma,straight,style,tube,unbranched,undulate,white,x,yellow	%,.05,.5,0-0.1,0-0.2,0-0.7,0-2,0-30,0.1-0.25,0.1-0.5,0.15-0.3,0.2-0.35,0.3-0.4,0.3-0.8,0.5-13,0.6-0.9,0.7-1.3,0.8-1.4,1-6,10-16,12-16,2-foliate,4.5-6,5-merou,6-18,8-11,9-18,?,abaxially,absen,absent,abundant,accrescent,acicular,adaxiall,adaxially,alyx,apart,armed,articulated,axe,ba,blade,capitat,coating,decimetr,directed,distall,distinct,distributed,dult,eaf,eed,eglandular,equal,erect,extra-axillary,finger,frequently,fruiting,functional,geminat,green,grey,half,homostylous,interpetalar,juic,lamina,lateral,less,longer,lower,mature,mesocarp,mid-point,midpoint,minute,moist,multiradiate,nflorescence,oblique,obscured,often,orolla,part,per,perfect,petal,pore,porrect,prickle,probably,rachi,resinous,ruit,sessile,slightly,spaced,stage,stalk,stellae,tal,tamen,thick,thickened,throughout,time,tip,tissue,triangular,unarmed,unit,unknow,uvenile,vary,wide,ympodial	abaxial,adaxial,arrangement,bark,branch,branching,capitate,color,corolla,form,growth,height,history,leaf,life,main,na,number,ovary,plant,primary,pubescence,seed,shape,size,stellate,surface,tertiary,texture,trichome,vein,venation,width,young
567	wfo-0001030080	success	186	120	84	102	36	0.452	0.3-7,0.4-1.5,0.5-4,1-2,1.5-2,1.5-2.5,2-3,2-4,2.1-7.1,3-10,4-7,5-13.5,5-7,6.5-18.6,8-16,8-23,9.9-33,abaxially,adaxially,anther,base,brownish,cell,clavate,cm,condition,coriaceous,corolla,covering,cuneate,dark,decurrent,diameter,dot,drying,elliptic,filament,flower,forked,fresh,fruit,glabrescent,glabrous,green,greenish,hair,hair-like,herb,lanceolate,lateral,leaf,light,lobe,medium,mm,odd-pinnate,ovate,ovoid,pedicel,peduncle,petiole,plant,poricidal,purple,pyriform,seed,size,sometimes,stellate,stigma,style,testal,thick,throughout,tiny,tip,tube,wall,white,whitish,width,winged,x,yellow	1-3,1.8-4.5,1999,3-5,3.3-7.7,4-12,5-merou,5.5-9.9,abaxiall,absent,acumen,acuminate,ag,along,alyx,apart,apex,apparently,arranged,articulated,axe,axillary,bead,berry,blade,bud,capitat,ccording,connivent,decreasing,digestion,distal,dorsally,eaf,edge,eed,enzyme,erec,exceeding,flat,folded,geminat,generally,glabrou,green-white,hal,half,high,homostylous,honeycomb-shaped,inconspicuous,interjected,larger,leaflet,lengthening,like,linear,living,long,lower,make,moniliform,mottled,mucilaginous,multiple,necklace,nflorescence,ochoa,onto,orolla,pair,perfect,plurifoliate,pore,rachi,removed,second,seudostipule,slightly,slit,spaced,specimen,stamen,stolon,straight,strongly,subequal,subtending,tall,tamen,tem,terminal,toward,tri-,tuber,typically,unit,unknown,usually,vary,wet,ympodial	abaxial,adaxial,arrangement,bark,branch,branching,calyx,capitate,color,form,growth,height,history,inflorescence,length,life,main,margin,midvein,na,number,ovary,perennial,primary,pubescence,ray,shape,stem,surface,tertiary,texture,trichome,unarmed,vein,venation,young
568	wfo-0001030081	success	157	113	77	80	36	0.49	.5,0.5-1,0.5-1.5,0.5-2.5,1-3,1-4,1-5,1.5,1.5-3,1.5-7,10-20,2-7,3-10,4-6,5-12,5-15,anther,base,brown,calyx,center,chartaceous,ciliate,cm,densely,diameter,dm,drying,edge,elliptic,elliptic-ovoid,entire,few-branched,filament,fine,flower,fruit,geniculate,glabrous,globose,hair,herb,immature,linear-lanceolate,lobe,margin,maturing,membranaceous,mm,moderately,oblong,obtuse,parallel,pedicel,peduncle,petiole,pubescent,radiating,raised,ridge,rotate,rounded,running,semitransparent,shallow,single-,sparsely,stigma,style,surface,tube,two-celled,unbranched,vein,white,x,yellow	0.25-0.5,1,1-2,1-2-celled,10-35,1st,2-4,2-foliate,2nd,3-6,abaxially,absent,abundant,acute,adaxiall,adaxially,along,apex,apically,axe,berry,beyond,blade,cell,connected,cordate,decurrent,dehiscing,denser,eaf,eed,emarginat,equal,explosively,exserted,flat,frui,geminat,held,interpetalar,long,longer,lower,lying,maturit,mesocarp,nearly,nfloresence,notch,often,one,orolla,other,per,placenta,pointing,pressure,pubescen,rachi,rarely,ruit,short,slightly,small,sometimes,stamen,straight,swollen,tal,tamen,tem,tissue,triangular,unit,usually,vary,watery,wid,woody,ympodial	abaxial,adaxial,arrangement,bark,branch,branching,color,corolla,form,growth,height,history,inflorescence,leaf,length,life,main,midvein,na,number,ovary,plant,primary,pubescence,ray,seed,shape,size,stem,tertiary,texture,trichome,unarmed,venation,width,young
569	wfo-0001030083	success	146	93	77	69	16	0.527	.5,0.5-1,0.5-2,0.8-1,0.8-3,1-1.5,1-2,1.5-3,10-30,2,3/4,4-15,4-6,9-11,acute,anther,apex,bark,base,broadly,calyx,cm,corolla,cup-shaped,decurrent,deeply,dia,elliptic,flower,fruit,glabrous,globose,green,greenish-white,lateral,leaf,lobed,long,long-acuminate,long-styled,main,minutely,mm,narrowly,onto,ovary,ovate,ovoid-reniform,pair,pale,papillose,pedicel,petiole,pitted,poricidal,red-papillose,shallowly,short-styled,shrub,simple,slender,small-capitate,stem,stigma,strongly,style,surface,tapering,tip,translucent,tube,vein,way,white,winged,x,young	.75,0.1,0.25-0.5,2-3,2-5-flowered,3-4,accrescent,anthesi,beginning,berry,closely,dar,deciduous,deflexed,deltoid,dry,drying,eaf,edicel,eed,elongate,exserted,fleshy,fruiting,greyish-re,hyaline,inflorescenc,internodal,lobe,lon,lower,membranous,middle,near,nflorescence,older,opposite,overlapping,paler,papillae,pore,prominent,proximal,raised,reddish-gold,reflexed,ruit,scar,shaped,single-stemmed,slightly,somewhat,soon,spaced,specimen,straight,tall,tan,tear-drop,terminal,thickened,thin,tub,ud,unifoliat,unit,widest,woody,ympodial	branching,color,diameter,form,greyish-red,growth,height,inflorescence,length,number,plant,seed,shape,size,texture,unifoliate
570	wfo-0001030093	success	181	122	88	93	34	0.486	0.2,0.2-0.5,0.2-1,0.5-1.1,0.75-1,1-1.5,1-12,1-5,2-2.5,3-4,3.5-12,4-6,5-50-flowered,7-30,7-9,8-9,anther,attenuate,bark,base,beneath,brownish-tan,calyx,campanulate,clavate,cm,corolla,cuneate,deltoid,densely,dia,elliptic,erect,filament,flower,furcate,glabrous,globose,golden,green,greenish-white,growth,hirsutulous,leaf,lobe,lobed,main,many,margin,minutely,mm,narrowly,nearly,obovate,often,opposite,ovary,ovoid-reniform,pair,pale,pedicel,petiole,pitted,plant,pubescent,shaped,shiny,shrub,simple,size,slightly,small,stem,stigma,style,surface,tear-drop,time,tiny,tree,trichome,tube,uniseriate,vein,white,x,yellowish,young	.2,.5,0,0.1-0.3,0.6-1.5,1.3-4.5,2.5-11,5-8,acuminate,acute,anthesi,apar,apex,becoming,berry,branched,case,closely,collection,commonly,continues,deflexed,differing,difoliate,eaf,edicel,eed,ellipsoid,especially,evenly,except,expanded,exserted,forest,free,fruiting,geminat,greyish-brow,guyanese,hyaline,impressed,inundated,lateral,like,lon,long,long-styled,lower,major,member,middle,minor,new,nflorescence,occasionally,older,one,onto,open,orbicular,paler,papillo,persisting,population,pore,poricidal,portion,present,puberulent,quite,reflexed,remaining,ruit,scar,shoot,short-styled,slender,soon,southern,spaced,straight,tall,tapering,terminal,thickened,tip,tub,ud,underside,unit,widest,woody,ympodial	0.5,1.5-4,abaxial,adaxial,arrangement,branch,branching,color,diameter,drying,form,fruit,greyish-brown,height,history,inflorescence,length,life,midvein,na,number,papillose,peduncle,perennial,primary,pubescence,ray,seed,shape,tertiary,texture,unarmed,venation,width
571	wfo-0001030115	success	192	153	124	68	29	0.646	-100,-30,.2,.5,0.2,0.5,1-1.2,1.5-2,1.5-3,10,12,12-22,2.5-3,3,3-4,3.5-5,30-60,5-10,5-5.5,5-8,7,9-11,<,>,anther,apex,armed,bark,base,beneath,berry,branched,c.,calyx,cm,conical,cordate,corolla,dark,densely,diameter,drying,echinoid,echinoid-stellate,elliptic,entire,erect,filament,flower,glabrescent,glabrous,glandular,globose,green,growth,impressed,inflorescence,irregular,lanceolate-elliptic,leaf,like,linear,lobe,lobed,long,long-styled,long-triangular,many,margin,minutely,mm,near,oblique,obvious,occasionally,ovary,pair,pale,papillate,pedicel,peduncle,pentagonal,petiole,prickle,primary,pubescent,purple,ray,reddish,scattered,shallowly,shiny,short-styled,shrub,simple,sinus,slightly,small,somewhat,sparsely,stellate,stem,stigma,style,surface,tapering,terminal,thin,time,tree,trichome,truncate,tube,unarmed,underside,undulate,usually,vein,violet,way,white,x,yellowish,young	0.1,0.5-0.6,1,10-,4,abaxially,acuminate,acute,adaxially,anthesi,apart,basal,basall,broad-based,brow,closely,completely,curved,deep,discolorous,distant,eaf,eed,ellipsoid,equalling,exserted,free,fruiting,heterostylous,included,irregularl,know,known,lamina,later,lengthening,lower,midpoint,new,nflorescence,obscured,often,older,papillo,pericarp,planar,plurifoliat,pore,poricidal,portion,prickly,prominent,ruit,scar,sessile,slit,spaced,splitting,stout,strongly,tearing,tip,translucent,trichoem,ud,unit,upper,ympodial	abaxial,adaxial,arrangement,branch,branching,brown,color,form,fruit,height,history,length,life,main,midvein,na,number,papillose,perennial,plant,pubescence,seed,shape,size,tertiary,texture,venation,width,ye
572	wfo-0001030145	success	153	113	95	58	18	0.621	-3,0.2-2,0.3-,0.5,0.5-1,0.5-4,1,1-1.5,1-2,1-2.5,1-3,1.5,1.5-2,1.5-7,10-12,2-3,2-4,2.5-6.5,3-10,3-4,3-5,abaxially,acute,adaxially,adpressed,also,apex,articulated,basal,base,beyond,calyx,campanulate,cm,color,compound,cuneate,cylindrical,deltate,densely,diameter,dunal,ellipsoidal,elliptic-ovate,entire,exserted,fide,fleshy,forked,fruit,glabrous,glandular,globose,hair,herb,leaf,leaving,less,lobe,long,margin,mm,moderately,narrowly,near,obtuse,ovate-elliptic,pedicel,pedicellar,peduncle,petiole,pilose,puberulent,remnant,ripe,shrub,simple,sinuate,slightly,somewhat,sparsely,stamen,stigma,style,subcordate,subcoriaceous,ternately,triangular,truncate,tube,unbranched,unknown,violet,x,yellow	-2,1-5,1.5-4.5,3,4-5,4-8,4-foliat,6-40,8-11,absent,aggregate,apart,ape,axe,blade,cell,chartaceous,connective,directed,distally,eaf,eed,elliptic,exceeding,flower,lanceolate,larger,lateral,leaflet,lon,lower,nflorescence,nther,orolla,pore,presen,puberulen,rachi,radiu,reddish,ruit,shorter,slender,spaced,stone,tal,tem,terminal,thecae,time,tomento,toward,truncat,ud,unit,vary,wide,ympodial	anther,arrangement,branching,corolla,form,growth,height,inflorescence,length,ovary,plant,seed,shape,size,stem,surface,texture,young
573	wfo-0001030146	success	210	140	102	108	38	0.486	60+,abaxial,acute,adaxial,anther,anthesi,apex,axe,base,berry,branched,branching,bright,brown,brownish,c.,calyx,capitate,center,cm,connivent,coriaceous,corolla,covered,cup-shaped,dark,deltate,densely,diameter,drying,ellipsoidal,elliptic,entire,filament,flattened-reniform,flower,fresh,glabrous,globose,golden,green,growth,inflorescence,leaf,length,like,lobe,lobed,long,loosely,many,margin,minutely,mm,narrowly,nodding,olive,pair,pale,papillose,part,pedicel,peduncle,peltate,persistent,petiole,pitted,plant,poricidal,primary,pubescence,pubescent,ray,reddish,revolute,ripe,shiny,short-stalked,simple,small,stellate,stem,stigma,stout,style,surface,tan,terminal,thin,time,tip,tree,treelet,trichome,tube,unevenly,upper,vein,way,white,wide,yellow	.1,.2,.5,0.2–0.4,0.5,0.5–1,0.6–0.7,0.6–2,0.9–1,1.2–1.5,1.5–2,16–20,1–1.1,1–1.5,2.5–9,20,20–30,2–5,3–4,3–6,40–50,4–30,4–4.5,5-merou,5–8,6.5–16,6–7,8–15,9–9.5,>,abaxially,absent,acuminate,ag,almost,along,alyx,apar,appearing,ark,articulated,beig,beneath,cell,closely,deeply,dense,dichasia,discolorous,eaf,echinoid,edge,eed,elongate,erec,exserted,free,fruiting,fused,gradually,halfway,ilament,impressed,lamina,layer,lengthening,less,lower,midpoint,multangulate,narrowing,new,nflorescence,older,orolla,per,perfect,pericarp,plurifoliate,pore,portion,projection,reflexed,regularly,rhachi,ruit,scar,scurfy,sessile,slit,spaced,sparsely,strongly,subtended,tall,tangled,tem,testal,tiny,ud,undersurface,unit,vary,varying,visible,woody,ympodial,–18	0.2-0.4,0.5-1,0.6-0.7,0.6-2,0.9-1,1.2-1.5,1.5-2,16-20,18,2,2-5,2.5-9,20-30,3-4,3-6,4-4.5,5-8,6.5-16,8-15,9-9.5,arrangement,bark,beige,color,dry,form,fruit,height,midvein,na,number,ovary,seed,shape,size,texture,width,young
574	wfo-0001030147	success	158	123	84	74	39	0.532	0.5-2,1-4,1-5,10-19,14-35,15-30,2-10.5,2-13,2-3,2-5,4-5.5,4.5-10,5-8,8-38,acute,apical,base,blue,branched,calyx,cell,cm,conical,corolla,covering,cuneate,cyme,deep,dehiscent,diameter,dichasial,dichasially,ebracteate,elliptical,filament,finely,flower,forked,green,green-white,hair-like,herbaceous,introrse,lateral,leaf,lobe,long,long-attenuate,make,maturing,medium,mm,monochasial,mucilaginous,narrowly,oblique,obtuse,odd-pinnate,often,ovate,ovoid,pedicel,peduncle,perennial,petiole,plant,poricidally,pubescent,purple,rotate,rounded,seed,short,size,slit,stigma,style,testal,thick,throughout,tip,wall,wide,yellow	-8,0-5,1.0-2.0,1.0-2.2,2,2-10,2.5-7.5,3-,3-6-foliat,4-3.,4.2-7.5,5-7,abaxiall,abaxially,acumen,acuminate,adaxially,apex,apically,articulate,attenuate,connate,digestion,diminishing,distal,dorsally,eaf,edge,eed,emoval,enzyme,exceeding,flat,folded,generally,globo,gradually,half,honeycomb,interjected,leaflet,living,lon,lower,lunat,nflorescence,nther,orolla,pair,pattern,perfect,petiolule,plan,proximal,reveal,ruit,sessile,seudostipule,specimen,stamen,straight,subequal,subsessile,tal,tem,terminal,throughou,toward,tuber-bearing,typically,unit,vary,ympodial,¼	abaxial,adaxial,anther,arrangement,bark,branch,branching,color,drying,form,fruit,globose,growth,height,history,inflorescence,length,life,main,margin,midvein,na,number,ovary,primary,pubescence,ray,shape,stem,surface,tertiary,texture,trichome,tube,vein,venation,wet,width,young
575	wfo-0001030151	success	175	97	79	96	18	0.451	-50,0.2-0.5,0.5-1,1-1.5,1-17,1-3,1.5-2.5,10-25,15-35,2-25,2-6,2-7-compound,3-14,3-5,3.5-32,4-5,5-6,6-9,abaxially,abundantly,acuminate,adaxial,adaxially,apex,base,blotch,calyx,chartaceous,cm,cordate,cuneate,cylindrical,deltate,diameter,elliptic,entire,flower,fruit,glabrate,glabrous,glandular-puberulent,globose,leaf,lilac-tinged,longitudinal,margin,membranaceous,mm,narrowly,oblong,obovate,often,pedicel,peduncle,petiole,pinnately,probably,puberulent,pyriform,ripe,sand-punctate,shallowly,simple,slender,sometimes,sparsely,stellate,stigma,stripe,style,surface,tree,truncate,unbranched,white,white-puberulent,x,yellow,yellow-green	-3,0.3-0.5,0.5,1,1-2,1-5,1.5-2,10-20,2-11,2-3,20-30,4-foliat,?,absent,acute,aggregate,apart,ape,apiculate,around,articulated,axe,basal,beyond,blade,cell,channe,ciliat,compound,connate,connective,decurrent,directed,distally,eaf,eed,eglandular,exceeding,except,exserted,glandular,hair,lanceolate,leaflet,leaving,less,line,lobe,lon,long,lower,near,nflorescence,nther,oblique,obtuse,orolla,pedicellar,perfect,pore,presence,purplish,rachi,radiu,remnant,ring,ruit,sand-punctat,scattered,short,shorter,slightly,small,somewhat,spaced,stalked,stamen,stone,tal,tem,thecae,time,tip,toward,triangular,truncat,tube,ud,unit,unknow,vary,vein,veiny,whitish,wide,ympodial	abaxial,anther,arrangement,color,corolla,form,growth,height,inflorescence,length,ovary,plant,pubescence,seed,shape,size,stem,texture
576	wfo-0001030153	success	147	116	98	49	18	0.667	.1,.2,/3,0.2-1,0.8-0.9,1-1.5,1-10,1-2,1-2.5,1.3-1.5,1.3-1.9,2-8,2-lobed,2.5-4,3-4,3-5,3-50,3.5-10.5,5-6,6-8,acuminate,acute,anther,anthesi,apart,apex,apparently,attenuate,bark,base,berry,branched,brittle,clavate,cm,conical,corolla,dark,diameter,distinct,domatia,dry,ellipsoid,elliptic,entire,filament,flower,glabrous,globose,green,growth,impressed,internodal,irregularly,lanceolate,lobed,margin,minutely,mm,narrowly,new,nodding,occasionally,older,ovary,pair,papillate,pedicel,peduncle,petiole,pit-like,plane,poricidal,primary,rachi,revolute,ripe,scar,simple,slightly,small,spaced,specimen,stem,stigma,style,terminal,thin,time,tip,tree,treelet,vein,way,white,x,yellowish,young	0.8-1.3,1-1.2,1.5-2,abaxially,absent,adaxially,age,ape,apiculate,axil,broadly,caly,calyx,campanulate,deltate,densely,dot,eaf,enlarged,erect,exerted,free,fruiting,glabrou,known,lengthening,less,lobe,lower,markedly,membranous,nflorescence,ot,paler,papillat,perfect,plurifoliat,pore,portion,resinous,ruit,slit,straight,strongly,surface,tube,ud,unit,ympodial	abaxial,adaxial,arrangement,branching,bud,color,form,fruit,height,inflorescence,leaf,length,number,plant,pubescence,shape,size,texture
577	wfo-0001030155	success	183	108	63	120	45	0.344	0,0.5,2,2.5-3,3.5,4,acute,anther,armed,base,berry,branched,brown,calyx,campanulate,chartaceous,cm,corolla,deeply,deltate,diameter,entire,filament,flattened,flower,fruit,glabrous,globose,immature,imparipinnately,light,lobe,margin,mature,minutely,mm,oblong,papillate,pedicel,peduncle,petiole,pinnatifid,pitted,plant,present,prickle,purple,recurved,rounded,size,spreading,stem,stigma,strongly,style,surface,tapering,tube,vein,vine,white,yellow,×	0.2,0.4,0.5-0.6,0.5–1.2,0.7,1-1.2,1/2,12–19,12–20,1–2,2-4,2.5,2/3,2–,2–3,3,3–5,4–5,4–6,4–8,4–9,5–10,5–6,5–8,607,6–8,abaxially,acuminate,ag,alyx,anthesi,apex,articulated,ba,basal,basally,becoming,blade,bud,cell,central,clustered,confluent,connecting,connivent,corresponding,decurrent,degree,densely,eaf,eed,ellipsoid,elongating,equal,et,exserted,fresh,glabrou,green,internode,knob,lateral,leaflet,lengthening,lobed,long,long-styled,lower,major,middle,midrib,narrowly,nflorescence,often,orolla,outline,part,pericarp,petiolulate,plurifoliat,pore,poricidal,prominent,protuberant,rachi,rectangular,recurve,robust,rodriguez,rounde,ruit,side,slender,slit,soon,stellate,stout,straight,subwoody,tamen,terminal,terminally,testal,third,time,tip,tissue,truncat,ttriangular,tub,unit,vary,way,wide,widest,wing,woody,ympodial,–17,–27	0.4-0.7,1-2,12-19,12-20,17,2-3,27,3-5,4-5,4-6,5-10,5-6,5-8,abaxial,adaxial,arrangement,bark,branch,branching,color,form,growth,history,inflorescence,leaf,length,life,main,midvein,na,number,ovary,primary,pubescence,ray,seed,shape,tertiary,texture,trichome,truncate,unarmed,venation,width,young
578	wfo-0001030160	success	177	111	89	88	22	0.503	.5,.8,0.2,1-1.5,1-2,1-3,1-5,3,3-11,3-3.5,3-4,5-6,7-10,?,anther,armed,bark,base,beneath,bluish-violet,calyx,cm,conical,coriaceous,corolla,diameter,dioecious,dry,elliptic,elongate,entire,filament,flower,fruit,glabrous,globose,growth,height,inflorescence,irregularly,lobe,lobed,long-triangular,margin,minute,minutely,mm,narrowly,nearly,oblique,orange-red,ovary,pair,pale,pedicel,peduncle,petiole,pitted,plant,poricidal,primary,prominent,pubescent,ray,red,reniform,shiny,shrub,simple,sparsely,stellate,stem,stiff,stigma,style,surface,terete,thin,tip,trichome,truncate,tube,undulate-toothed,unknown,usually,vein,x,yellow,young	.2,00,1,1.5-2,1.5-4.5,1030.,10300,2,2.5-3,4-rayed,8-9,absent,acicular,acuminate,acute,almost,amshoff,apart,apex,apparently,berry,broad-based,bud,capitat,closely,completely,consisting,conspicuous,densely,eaf,eed,ekman,exserted,female,fide,flattened,flowered,forming,free,fruiting,glabrescen,internodal,like,long,m.,male,marginal,markedly,mere,midpoint,midrib,near,new,nflorescence,occasionally,often,older,other,ower,per,pericarp,plurifoliat,portion,prickle,ruit,scar,scattered,several,shallow,short-stalked,single,small,sometimes,somewhat,spaced,strongly,stub,terminating,ti,tiny,triangular,ud,unisexual,unit,vestigial,winged,woody,ympodial	abaxial,adaxial,arrangement,branch,branching,capitate,color,form,glabrescent,leaf,length,main,midvein,na,number,pubescence,reproduction,seed,shape,size,texture,ye
579	wfo-0001030161	success	179	99	84	95	15	0.469	.5,0.1-0.2,0.2-0.5,0.2-1.3,0.4-0.8,0.5,0.8-1,1,1.1-1.3,1.5-2,1.5-5,2.5-3,3-15,3-3.5,4,4-20,4-5,8-9,9-10,acute,anther,bark,base,bearing,berry,calyx,clavate,cm,conical,coriaceous,corolla,densely,diameter,elliptic,entire,flattened,flower,fruit,furcate,glabrous,globose,growth,leaf,lobed,margin,minutely,mm,narrowly,nearly,occasionally,orange,ovary,pale,pedicel,peduncle,petiole,pitted,poricidal,prickle,prickly,pubescent,ray,red,reddish,reniform,shiny,slightly,small,sparsely,stellate,stem,stigma,style,surface,tapering,thick,tip,treelet,trichome,tube,undulate-toothed,white,x,yellowish	.1,.2,.25,0,0.1,0.5-0.6,12-16,2-2.5,2-3,5197,<,?,abaxially,acuminate,adaxially,almost,anthesi,apar,apex,apparently,articulated,beneath,breaking,broad-based,cell,curved,difoliate,eaf,eed,egger,ellipsoid,erect,especially,exserted,fide,filament,filiform,free,fruiting,fused,geminat,glabrescent,impressed,internodal,irregularly,later,leave,lengthening,lepidote,like,lobe,long,long-triangular,looping,lower,marginal,midpoint,midvein,near,new,nflorescence,older,outline,pair,papillo,per,perfect,pericarp,planar,pore,porrect,portion,primary,prominent,rhomboid,ruit,scar,scattered,sessile,shorter,simple,slit,somewhat,spaced,stalked,straight,strongly,testal,tooth,tub,ud,unit,vein,woody,ympodial	branching,color,form,height,inflorescence,length,na,number,papillose,plant,pubescence,seed,shape,size,texture
580	wfo-0001030167	success	141	107	70	71	37	0.496	.9,0.1–0.2,0.5–0.6,0.5–0.7,0.6,0.7–1.2,0.8–1,1.5–2,14–19,15–20,17–58,1–1.2,1–1.5,2–4.5,4.5–8,4–10,4–4.5,4–7,8–10,acuminate,anther,apex,base,branch,calyx,chartaceous,cm,densely,diameter,entire,filament,flattened,flower,fruit,glabrous,green,herbaceous,lanceolate,lobe,margin,membranaceous,mm,near,obtuse,ovate,ovoid,pair,pedicel,peduncle,petal,petiole,pointed,rounded,sand-punctate,simple,slender,somewhat,stellate,stigma,style,thinly,tip,tube,unbranched,vein,venation,vine,weakly,white,x	.8,0.6–0.8,1.2–2.5,1.5–7,12,2–3,4–5,5-merous,abaxially,accrescent,acute,adaxially,along,alyx,apar,apically,axe,berry,blade,c.,ciliat,ciliate,clavate,climbing,contiguously,eaf,eed,enlarged,extra-axillary,fertile,fruiting,gap,glabrou,immature,less,long,lower,m.,maturity,membranous,minutely,moderately,nearly,nflorescence,nternode,orolla,penden,perfec,pinnate,plurifoliat,rachi,reflexed,ruit,scar,secondary,seen,slightly,spaced,sparsely,subequal,symmetrical,tamen,tem,time,truncat,unit,unknown,vary,vegetation,wide,ympodial	abaxial,adaxial,arrangement,bark,branching,color,corolla,drying,form,growth,height,history,inflorescence,leaf,length,life,main,midvein,na,number,ovary,plant,primary,pubescence,ray,seed,shape,size,stem,surface,tertiary,texture,trichome,truncate,unarmed,width,young
581	wfo-0001030170	success	230	122	76	154	46	0.33	-6,/2,0,1,2,8.5,acute,anther,around,base,blue,calyx,cm,connivent,cordate,curved,densely,diameter,few-branched,filament,flattened,flower,fruit,glabrous,gland-tipped,glandular-puberulent,globose,hair,lanceolate,leaf,less,lobe,lobed,long,margin,maturity,minutely,mm,nearly,oblong-apiculate,orbicular,pair,pedicel,peduncle,perennial,petiole,puberulent,pubescence,pubescent,rarely,ray,reniform,shrub,simple,size,smooth,stellate,stem,stigma,stipitate-glandular,strongly,style,subdeltoid,surface,thin-textured,triangular,truncate,tube,unbranched,vein,violet,way,white,x,yellow,yellowish	.2,0.1,0.15–0.35,0.2–0.5,0.2–2,0.5–15,0.5–2,0–30,1.5,10–15,12.5,15–20,1–2-celled,1–2.5,1–4.5,2-foliate,2.5–3,20–25,20–30,2–3-celled,2–4,2–5,2–8,3,3.5–4,3.5–4.4,3–10,4,4–13-rayed,4–22,5,5–10,5–12,5–15,5–apiculate,abaxially,absent,accrescent,acicular,adaxially,also,apart,apex,appearing,articulated,axe,ba,blade,bud,capitat,coarse,confined,conspicuously,cylindrical,directed,disappearing,distall,eaf,eed,enlarged,entire,erect,eventually,extra-axillary,falling,fertile,few-rayed,flexuous,frui,fruiting,geminat,geminate,gland,glandular,ground,horizontal,hyaline,interpetalar,larger,like,lon,longer,longest,lower,lowest,major,male,many,mesocarp,minute,mostly,multangulate,near,nflorescence,numerous,oblique,obtuse,often,one,orolla,perfect,pore,prickle,rachi,ranging,rare,reflexed,rootstock,ruit,scarcely,scattered,senescent,sessile,shallow,short-puberulent,shorter,similar,single,slightly,small,solitary,sometimes,somewhat,spaced,spongy,spreading,stella,stellae,sterile,stiffly,stipitate,stout,straight,surfac,tall,tamen,tem,thic,thick,tissue,tooth,toward,twice,ultimately,unit,upper,usually,various,vary,vestigial,wide,without,ympodial,–4	-4,0.2-0.5,0.2-2,1-2-celled,10-15,2-4,2-5,2-8,2.5-3,3-10,3.5-4,3.5-4.4,5-12,5-15,abaxial,adaxial,arrangement,bark,branch,branching,capitate,color,corolla,drying,form,growth,height,history,inflorescence,length,life,main,midvein,na,number,ovary,plant,primary,seed,shape,tertiary,texture,trichome,unarmed,venation,young
582	wfo-0001030176	success	171	112	78	93	34	0.456	.2,.7,.75-1.5,0.5-2,0.6-0.9,0.7-1.4,0.7–0.8,1,1.2,1.2-2.5,1.5-2,1.6,2.25-3.25,2–3,3-5,3-lobed,4-9,6-8,6–8,anther,attenuate,base,bilobed,broad,broadly,calyx,chartaceous,ciliate,cm,dehiscent,depressed-globose,diameter,especially,few-branched,filament,flattened-reniform,flower,fruit,glabrous,hair,herb,lanceolate-oblong,light,lobe,long,margin,midrib,mm,nearly,oblong,ovate,pale,partially,pedicel,peduncle,petiole,plant,pore,pubescent,rarely,ripe,rotate-stellate,simple,slightly,sometimes,sparsely,stigma,style,tip,tube,unbranched,vein,violet,white,x,yellow,yellow-orange,young	-1.4,-4.25,-6.25,0.4-1.5,0.5,1-2,1-5,1.5-2.5,1/3,1/6,2-3,2-foliate,2.5,2.5–7.5,2.5–9,3.75-5,5-merou,abaxially,accrescent,acute,adaxiall,adaxially,alyx,angulate,apart,apex,apparently,articulated,asymmetrically,axe,ba,basal,berry,bi-lobed,blade,branch,capitat,connivent,contact,covering,cylindrical,decumbent,downward,eaf,eed,erec,extra-axillary,forming,fruiting,geminat,hermaphroditic,hold,interlobal,juic,lance-ovate,lateral,line,lon,longitudinall,lower,major,mesocarp,minutely,near,nflorescence,node,numerous,often,orolla,patch,perfect,prostrate,rachi,recurve,recurved,rooting,round,ruit,sinus,soil,somewhat,spaced,tamen,tem,terminal,time,triangular,unit,vary,white-puberulent,wide,winged,ympodial	2.5-7.5,2.5-9,abaxial,adaxial,arrangement,branching,capitate,color,corolla,form,growth,height,history,inflorescence,leaf,length,life,longitudinally,midvein,na,number,ovary,perennial,primary,pubescence,seed,shape,size,stem,surface,tertiary,texture,unarmed,venation
583	wfo-0001030180	success	135	91	67	68	24	0.496	.5,0.05-1,0.5-1,0.8-2,0.9-1.8,1-1.5,1.1-1.2,10-30-flowered,3-8,4.5-5,6,8.5-23,?,anther,bark,base,calyx,clavate,cm,corolla,dark,decurrent,deltoid,dia,erect,filament,fruit,furcate,glabrate,glabrous,globose,green,height,immature,leaf,linear,lobed,long,minutely,mm,nearly,ovary,papillate,papillose,pedicel,petiole,puberulent,shaped,shrub,slightly,sparsely,stem,stigma,straight,style,surface,tear-drop,tip,trichome,tube,uniseriate,unknown,white,widely,winged,x,young	.1,.75,3-4,8-10,abruptly,accrescent,anthesi,apart,apex,apiculate,appearing,attenuate,becoming,berry,clu,deflexe,eaf,edicel,eed,ellipsoid,exserted,free,fruiting,inflorescenc,interpetalar,known,lateral,lenticellat,lobe,lon,long-acuminate,lower,main,middle,minute,narrowing,nflorescence,occasionally,older,opposite,overlapping,pair,peduncl,planar,plurifoliat,pore,poricidal,portion,prominent,proximal,raised,rounded,ruit,scar,sinus,slender,soon,spaced,terminal,thin,ud,unevenly,unit,vein,widest,woody,yellowish,ympodial	0.75,abaxial,adaxial,arrangement,branching,club,color,deflexed,diameter,flower,form,growth,inflorescence,length,lenticellate,na,peduncle,plant,plurifoliate,pubescence,seed,shape,size,texture
584	wfo-0001030182	success	205	128	101	104	27	0.493	-12,0.2-0.3,0.5-1,1-1.5,1-4.5,1.2-1.5,12-15,15-20,2-15,2-2.2,2-3,2-5,2.4-2.5,3-12,3-4,3-5,3-8,4-10,angulate-lobed,anther,armed,bark,base,berry,blue,branched,brown,brownish,calyx,clavate-truncate,cm,coriaceous,corolla,dark,diameter,elliptic,entire,filament,finely,flattened,flower,fruit,glabrescent,glandular,globose,green,growth,hirsute,internodal,leaf,like,linear-lanceolate,lobe,margin,minutely,mm,oblique,obtuse,ovary,ovate,ovate-elliptic,papillose,pedicel,peduncle,petiole,plant,poricidal,porrect,pubescence,pubescent,ray,red,reddish,repand,reticulate,rounded,rusty,shrub,simple,sparsely,stellate,stem,stigma,style,subcoriaceous,subreniform,surface,tapering,terminal,tip,tomentose,treelet,triangular-lanceolate,trichome,tube,unarmed,vein,velutinous,violet,x,yellowish	0.3-0.5,1,1-1.7,1-celle,1-celled,1-multicellular,1-nerved,1.5-2,1/4,2-8,4-5,abaxially,accrescent,acute,adaxially,adult,anthesi,apex,articulated,asymmetric,basal,cell,closely,den,discolorous,distal,e,eaf,eed,eglandular,erect,evident,exserted,ferruginous-tomentose,free,fruiting,heterostylous,immature,juvenile,later,lengthening,lobed,long,long-styled,lower,many,microscope,midpoint,midrib,minute,mixed,mixture,multangulat,multicellular,nearly,new,nflorescence,older,one,ovoid,papillo,per,perfect,pericarp,plurifoliat,pore,porrect-,porrect-stellate,portion,prickle,prickly,recurved,reduced,reflexed,ripe,ruit,scar,seen,sessile,short,short-styled,similar,slightly,slit,space,sparse,stalked,staminate,stellate-glandular,strongly,subsessile,tall,testa,tub,turbinate,ud,uniseriate,unit,upper,variegated,wood,yellow,ympodial,¼	abaxial,adaxial,arrangement,branch,branching,color,drying,form,height,history,inflorescence,length,life,main,midvein,na,number,perennial,primary,seed,shape,size,tertiary,texture,venation,width,young
585	wfo-0001030185	success	206	107	85	121	22	0.413	1,1-10,1.0-1.3,10,2-3,2.0-3.0,20-65,21,3.5-4.2,35,5-7,5-lobed,8-11,9-18,apical,beyond,blue,blue-violet,branched,calyx,center,cm,color,commonly,corolla,cyme,darker,deep,dehiscent,densely,diameter,dichasial,dichasially,distal,ebracteate,elliptic,flower,forked,generally,glabrescent,glabrous,glandular-pubescent,globose,green,green-white,half,herbaceous,introrse,lanceolate,light,long,maturing,middle,mm,moderately,monochasial,narrowly,odd-pinnate,often,ovate,ovoid,pedicel,peduncle,perennial,plant,poricidally,puberulent,purple,rhizomatous,rotate,scarcely,seed,shape,short,size,slit,spot,stem,stigma,straight,style,symmetrically,violet,wide,yellow	-0.5-1.3,0.2,1-4,1-8,1.5-4,1.7,15,2,25,3-6-foliat,4,4-7,5-10,abaxially,acumen,acuminate,acute,adaxially,angular,apex,apically,apiculate,articulate,b,ba,basal,base,becoming,caudate,cell,cente,clasping,coat,collection,connate,cordate,covering,cuneate,dark,decreasing,digestion,eaf,eed,embryo,emoval,enzyme,erect,exceeding,filament,formed,gland,globo,hair,hair-like,honeycomb,interjected,lateral,leaflet,living,lobe,lon,lower,make,medium,mucilaginous,nearly,nflorescence,nther,obliquely,oblong,occasional,one,orolla,pair,pattern,pentagonal,perfect,petiolate,petiolulate,petiolule,purpl,radiating,rare,reduced,reveal,rhizome,rotate-,rounded,ruit,semi-lunate,sessile,seudostipule,slightly,sometimes,somewhat,specimen,stamen,star,ste,subequal,tem,terete,terminal,testal,thick,tinged,tip,trailing,type,typically,unbranched,unit,usually,vary,visible,wall,white,wid,wider,without,ympodial	abaxial,adaxial,anther,arrangement,branching,form,fruit,growth,height,history,inflorescence,leaf,length,life,na,ovary,petiole,pubescence,rotate-pentagonal,surface,texture,young
586	wfo-0001030189	success	188	132	107	81	25	0.569	-1/2,-4,/3,0-1,0.1-0.2,0.2-0.3,0.5-1.6,0.9-1.1,1,1-1.5,1.1-2.7,1.3-4.2,1.5-5,1/3,1/6-1/3,2-3,2-5.5,2.5-4,3-4,3.2-4.5,4-5.5,5-10,5-6,6-12,8-10,anther,apparently,bark,base,berry,blade,branched,calyx,chartaceous,cm,concolorous,cordate,densely,diameter,drying,dull,elliptic,entire,evenly,faint,filament,flattened-reniform,flower,fruit,glabrescent,glabrous,gray,green,lateral,leaf,length,lobe,lobed,long,lower,margin,maturity,mauve,midpoint,mm,moderately,oblong,orange,ovate,pair,pedicel,peduncle,petiole,poricidal,porrect,primary,purple,ray,red,rounded,sessile,shrub,simple,slender,sparsely,spherical,stalked,stellate-pubescent,stem,style,surface,tapering,terminal,tertiary,tip,trichome,tube,unarmed,upper,vein,venation,visible,way,wide,yellow,yellow-green,young	.2,0-15,0-30,0.1,0.2-0.5,1-2,1-3-cellular,1-4-cellula,1-4-cellular,1.5-2,1.5-4.5,1/,2,4-13,5-,5-merous,6-10,8,8-18,abaxially,acut,alyx,apar,apex,apically,appressed,articulated,connivent,curved,deltate,eaf,eed,elongating,equal,erect,foliaceous,free,frui,fruiting,glabrescen,gland-tipped,infructescence,longer,mature,nflorescence,obtuse,often,older,one,open,orolla,oung,per,perfec,pericarp,plurifoliat,portion,recurved,red-brow,reflexed,ruit,scandent,scar,shorter,smooth,sometimes,somewhat,spaced,spreading,stalk,stellate,strongly,tamen,terete,time,unarme,unit,variously,vary,woody,ympodial	1/4,abaxial,adaxial,arrangement,branching,color,corolla,form,growth,height,inflorescence,mentioned,midvein,number,ovary,plant,pubescence,red-brown,seed,shape,size,stigma,texture,width,ye
587	wfo-0001030195	success	255	90	64	191	26	0.251	2,2.3,acuminate,adaxial,anther,apex,attachment,bark,base,brown,calyx,capitate,channeled,chartaceous,cm,corolla,cuneate,deltate,densely,diameter,entire,extra-axillary,flattened-irregular,flattened-orbicular,fruit,glabrous,glandular,globose,green,hair,internode,leaf,margin,midvein,minute,mm,notched,ovate,pedicel,petiole,point,prickle,pubescent,red,reddish,restricted,rounded,scattered,sessile,shrub,side,spatulate,stellate,stem,stigma,style,subcoriaceous,transparent,tube,unarmed,white,yellow,yellow-ferruginous,yellow-tan	.2,.3,.5,.6,.7,/3,0.1–0.2,0.2–0.3,0.2–0.5,0.2–1.0,0.3–0.7,0.5,0.5–0.6,0.5–1.3,0.5–4.0,0.7–1.0,0.8,0.8–0.9,0.9–4.8,1,1.0,1.0–1.4,1.0–1.5,1.2–1.6,1.3–1.5,1.3–2.6,1.4–1.6,1.5–1.7,1.5–1.9,1.7–2.2,1.7–3.2,1.8–2.0,1.8–2.5,1/3,2.2–2.7,3.8–4.8,3–6,3–7.3,4-merou,4.9–7.0,5.5–6.5,6.3–7.7,6–8,6–9,abaxially,adaxially,adnate,aequilateral,ag,along,alyx,anthesi,apical,apiculate,apparently,appearing,appresse,around,articulate,attenuate,ba,based,berry,blade,borne,broad,broad-based,brochidodromous,bud,connivent,dark,dentate,developed,directed,distal,distally,distinct,dry,eaf,edge,eed,either,elliptic,emerging,endocarp,evenly,exocarp,extending,fertile,filament,filiform,flat,flexed,flower,free,glossy,gradually,gree,homostylous,hort,immature,increasing,indistinct,individually,intact,interpetalar,intersepalar,isolated,juic,lateral,layer,laying,light,lobe,lon,long,longer,lower,m.,many,markedly,mature,middle,midpoint,midrib,moderately,mottled,narrowly,nearly,nflorescence,nodding,oblique,oblong,obtuse,occasionally,opaque,orolla,per,perforated,pitted,plurifoliat,poorly,pore,porrect,portion,potentially,presen,raised,ray,reflexed,remaining,ruit,shoot,short,shot,simple,sinus,slightly,sloughing,smoot,sparsely,splitting,stamen,stellae,stellate-pubescent,straight,striped,surface,suture,tamen,tem,terminal,thin,time,tip,tissue,truncate,typically,ud,unit,vary,vein,weakly,wide,yellow-ferruginou,ympodial,young,±90°,±equal,±glabrous,×	0.1-0.2,0.2,0.3,0.5-0.6,0.5-4.0,0.9-4.8,1.0-1.5,1.2-1.6,1.3-2.6,1.5-1.7,1.5-1.9,3.8-4.8,5.5-6.5,branching,color,form,growth,height,inflorescence,length,ovary,plant,seed,shape,size,texture
588	wfo-0001030198	success	234	151	108	126	43	0.462	16,2,4,4.5,abaxially,acute,angulate,anther,apart,apical,articulated,attenuate,base,black,calyx,closely,cm,cordate,deeply,deltoid,densely,diameter,directed,distally,drying,entire,extra-axillary,finely,flattened-reniform,flower,free,fruit,glabrate,glabrous,gland-tipped,globose,green,hair,homostylous,initially,internode,interpetalar,interwoven,irregularly,lateral,leaf,like,lilac,lobe,lobed,long,margin,minute,minutely,mm,much,near,nearly,oblong-lanceolate,orange,overtopped,ovoid,pedicel,peduncle,persistently,petiole,pitted,pore,porrect,prickle,purple,rounded,sessile,shiny,short-stalked,shrub,simple,sinuate,sinus,sometimes,somewhat,soon,spaced,splitting,stellae,stellate,stellate-tomentose,stem,stigma,straight,style,surface,tan,terminal,tip,tissue,tomentose,truncate,tube,turning,unarmed,weak,well-developed,whitish,whitish-tomentose,yellow,yellowish,×	.2,0.6,0.7–,0.7–0.8,0.7–0.9,0.7–1.1,0.8,0.8–1.4,0.9–1.7,0.9–2,1,1.2,1.4–1.6,1.5–3.5,1.5–6.5,10–12,13–20,1–2.5,2.5,2.5–14,2.5–3.0,2–2.8,2–3,2–3-lobed,3.4–4.0,3.5–7,3–3.5,3–4,3–9,4–12-branched,5-merou,5.3–7,5.5–13,5–12,60–150,6–10,7.5–10,acicular,adaxiall,adaxially,alyx,ampliate,apex,apparently,appearing,axe,basal,berry,blade,branch,broad,broadly,capitat,caudate,contrasting,coroll,dark,darker,distall,eaf,eed,except,fewer,filament,filiform,formed,frui,geminat,glabrescent,gradually,hal,high,immature,larger,lon,lower,major,many,midpoint,midri,midrib,midvein,midzone,nflorescence,often,one,orolla,ovate,part,perfect,plurifoliate,principal,ray,recurved,reflexed,relatively,ruit,shorter,side,slightly,sparse,spreading,stalk,stella,stout,strongly,tamen,tem,thickened,time,triangular,ud,unit,upper,usually,vary,vein,white,white-tomentose,wide,ympodial,–17,–18,–20,–3,–3.5	0.7-1.5-3.5,0.8-1.4,0.9-1.7,1-2.5,1.4-1.6,1.5-6.5,10-12,13-20,17,18,2-2.8,2-3,2-3-lobed,2.5-14,2.5-3.0,20,3,3-3.5,3-9,3.4-4.0,3.5,4-12-branched,5-12,5-merous,5.3-7,5.5-13,7.5-10,arrangement,capitate,color,corolla,form,growth,height,inflorescence,length,ovary,plant,pubescence,seed,shape,size,texture
589	wfo-0001030212	success	188	114	92	96	22	0.489	%,0.2-0.4,0.5-0.6,0.5-7,1-1.2,1-1.5,1-6,1.2-1.8,1.5-2,15-40,2-2.5,2-4,2-5,2.1-3.4,2.4-3.3,2.5-6,2.6-6.5,20-50,25-60,3-5,3.5-5,4-23,4-9,4.5-6,6-9,abaxial,acicular,adaxial,anther,attenuate,base,broadly,brown,calyx,capitate,chartaceous,cm,compound,cuneate,deeply,deltate,depressed-globose,diameter,divided,flower,fruit,glabrous,gland-tipped,glandular-puberulent,green,hair,herbaceous,inflorescence,lamina,lateral,length,lobe,lobed,margin,midvein,mm,narrowly,ovate,pedicel,peduncle,per,petiole,pinnately,plant,present,prickle,prostrate,purple,resprouter,rotate,rotate-stellate,short,simple,slightly,sparsely,sprawling,stigma,straight,style,surface,toothed,tube,unbranched,vein,x,yellow,yellowish-green	0-4,0.5-1,0.9-1.3,1-15,1-2,1-3,1-5,1.4-1.8,12-40,28-37,30-150,4-27,4-6,5-merou,7-11,8-9,9-10,abaxially,absen,absent,abundant,accrescent,acute,adaxiall,adaxially,alyx,andromonoecious,apart,apex,apparently,armed,articulated,axe,ba,bilobe,blade,bristle-like,center,connivent,cylindrical,d.,directed,distall,eaf,eed,filament,finger,fruiting,functional,geminat,half,heterostylous,index,interpetalar,juic,leaf-opposed,lobing,lon,long,lower,mature,mesocarp,mid-point,minute,moist,nflorescence,oblique,orolla,part,plurifoliate,pore,presen,pricke,rachi,ruit,side,spaced,sparse,stage,strongly,tal,tamen,tem,thick,throughout,time,tissue,triangular,unit,unknown,uvenile,vary,weakly,wide,winged,ympodial	arrangement,bilobed,branching,color,corolla,dm,form,growth,height,history,leaf,life,na,number,ovary,presence,pubescence,seed,shape,size,stem,texture
590	wfo-0001030219	success	191	135	97	94	38	0.508	0.1–0.3,0.2–2.3,0.5,0.5–,0.7–1.1,1.0–1.2,1.0–2.0,1.0–2.2,1.3–2.9,1.5,1.6–,2.0–3.2,2.0–5.5,2.4–6.0,2–,2–3,2–4.5,3,4.5–5.5,4.8–11.5,4–5,4–7,5–,5–8,60,6–8,7–11,9–10,abaxially,adaxially,anther,anthesi,base,black,blue,brown,calyx,cm,deeply,densely,diameter,elliptic,equal,filament,flattened,flower,fruit,glabrous,globose,green,hair,incised,lanceolate,leaf,lilac,lobe,long,margin,marking,mm,moderately,multicellular,number,oblong,olive,ovate,pair,pale,paler,pedicel,peduncle,pentagonal,perennial,petiole,pitted,pubescent,purple,regularly,shallowly,shrub,simple,size,spaced,sparsely,stigma,style,surface,time,tube,unicellular,uniseriate,velutinous,x,yellow,–3.0,–7.0,–9.5	0.4–1.0,0.8–3.0,0–,1.0–1.5,1.4–2.8,10,15,1–2.5,2.0–2.5,2–2.5,5,6–,6–10,8–18,9–12,abaxiall,acut,acute,adaxiall,adnate,ag,along,anisophyllous,apart,apex,apical,apparently,appearing,arising,arranged,articulated,axe,ba,basal,blade,bract–like,branched,cell,chartaceous,clavat,concave,connivent,convex,cylindrical,decreasing,decurrent,diamete,difoliate,directed,distally,eaf,eed,erect,geminat,glabrescent,indistinct,internode,longitudinal,lower,nflorescence,opening,opposed,oppositely,orolla,perfect,pore,present,procumbent,rapidly,red–purple,rounded,ruit,serrate,sessile,sid,side,smaller,split,stone,straight,stripe,strongly,tal,tamen,tem,two,unit,vary,white,wide,wing,winged,woody,ympodial	abaxial,adaxial,arrangement,bark,branch,branching,clavate,color,corolla,decurren,drying,form,growth,height,history,inflorescence,length,life,main,midvein,na,opposite,ovary,plant,primary,pubescence,ray,seed,shape,stem,tertiary,texture,trichome,unarmed,vein,venation,width,young
591	wfo-0001030224	success	191	121	92	99	29	0.482	0.5-1,0.5-1.5,0.5-3,1-1.5,1-2,1-3.5,10-20,12-14,14-17,2-10,2-3-celled,2-4,2-5,2.5-4,2.5-4.5,2.5-8,4-10,4-4.5,4.5-5,5-10,6-10,6-15,6-8,7-10,8-12,anther,apart,armed,articulated,bark,base,black,brown,calyx,chartaceous,clavate,cm,dark,deflexed,densely,diameter,elliptic,extra-axillary,finely,flattened,flower,forked,form,fruit,globose,green,greyish,lighter,linear-lanceolate,lobe,midpoint,mm,moderately,narrowly,occasionally,orange,pedicel,peduncle,petiole,pink,plant,prickle,pseudohair,pubescent,purple,ray,recurved,red,reniform,shiny,shrub,simple,sparsely,stellate,stellate-pubescent,stem,stigma,style,subcoriaceous,suborbicular,surface,tan,triangular,tube,unbranched,x,yellow	-2.5,.25,.5,1.5-9,20-25,3-4-foliate,4-6,5-merous,abaxially,absent,accrescen,acuminate,acute,adaxiall,adaxially,ag,alyx,andromonoeciou,andromonoecious,apex,axe,ba,berry,blade,broad-based,capitat,cell,connivent,cylindrical,directed,distally,dry,eaf,eed,eglandular,equal,ferruginous,filament,fissure,free,fruiting,functionally,geminat,glabrous,gradually,hair,hermaphroditic,heteromorphic,interpetalar,lateral,like,long,long-,longer,longitudinal,lower,lowering,major,mature,maturit,midvein,nflorescence,one,opening,orolla,other,outline,part,perfect,pericarp,pore,rachi,reddish-brown,reflexed,ruit,scandent,sessile,short-styled,side,slit,small,spaced,sparse,staminate,strongly,tamen,tapered,testal,tightly,time,tissue,unit,vary,vein,wall,wide,wtih,yellowish,ympodial	0.25,0.5,abaxial,adaxial,armament,arrangement,articulation,branching,capitate,color,corolla,deflexion,fissured,growth,height,inflorescence,leaf,length,number,ovary,pubescence,seed,shape,size,spacing,staman,texture,trichome,width
592	wfo-0001030225	success	155	109	92	63	17	0.594	-30,-4,-45,-7,.5-2.5,0,1,1-4,1-6,1.5-2.5,10-15,2,2-18,2-2.5,2-3,2-6,3-11-compound,3-20,3-4,4-5,abaxially,acuminate,acute,adaxially,apex,apical,apically,articulated,basal,base,bilobed,calyx,campanulate,cm,color,conivent,cordate,cuneate,cylindrical,deltate,densely,diameter,dilated,elliptic-ovate,entire,especially,expanded,fleshy,forked,fruit,glabrate,glabrous,gland,leaf,leaving,lobe,long,margin,mm,moderately,oblong,obtuse,papillose,pedicel,peduncle,petiole,pinnately,possibly,prominent,puberulent,purple,rachi,scar,shallowly,shrub,simple,small,somewhat,sparsely,stellate,stigma,strongly,style,succulent,tip,toward,tree,truncate,two,unbranched,unknown,x	-1.5,-11,.5,0-20,0-5,1.5,10-30,3-5,3-foliat,8-15,absent,apart,ape,ature,axe,beyond,blade,compound,connective,coriaceous,directed,distally,eaf,eed,equal,exceeding,exserted,flower,globose,immature,laterally,leaflet,less,lower,minutely,narrowly,nflorescence,nther,one,orolla,perfect,pore,puberulen,radiu,see,seen,slightly,spaced,stalked,stamen,tal,tem,thecae,time,tomento,triangular,tube,ud,unit,unknow,vary,wide,ympodial	anther,arrangement,branching,corolla,form,growth,height,inflorescence,length,plant,pubescence,shape,size,stem,surface,tall,texture
593	wfo-0001030244	success	226	130	97	129	33	0.429	0-0.6,0-1,0.2,0.2-0.6,0.2-1,0.2-1.3,0.25-0.5,0.4-0.7,0.5-1,0.5-1.2,0.5-3.5,0.6-0.8,1-1.5,1-5,1-8,1.5-2,1.5-2.3,1.5-3,11-33,2.5-6.5,3.5-9,7-24,anther,articulated,attenuate,base,blue,calyx,chartaceous,cm,cuneate,cylindrical,deltate,densely,diameter,entire,erect,extra-axillary,flower,fruit,glabrous,gland-tipped,globose,hair,inflorescence,lanceolate,lateral,length,linear,lobe,long,margin,midpoint,mm,moderately,narrow,narrowly,oblong,pale,pedicel,peduncle,perennial,petiole,plant,porrect,pseudo-racemose,purple,ray,red,reniform,reticulate,rhizomatous,rotate,scattered,sessile,short,shrub,simple,solitary,sparsely,stalked,stellae,stellate,stellate-pubescent,stigma,style,surface,tan,thick,time,tube,unarmed,unbranched,white,x,yellow,yellowish	%,.05,.3,0-0.1,0-0.3,0-3,0.1-1.5,0.2-0.5,0.25-0.4,0.3-0.4,0.3-0.5,0.3-5,0.5-7,0.8-1.2,1-2,1-20,1-6,1-locular,1.5-,2-2.5,2-4,2-foliate,2.5-13.5,3.3-7.5,4-5,4-5-merou,4-6,5-6,6-8,7-15,7-16,7-8,7-9,8-18,abaxially,absen,absent,accrescent,acicular,across,acute,adaxially,alyx,andromonoecious,apart,apex,apparen,axe,ba,blade,brown,capitat,common,confined,connivent,decimetre,directed,distall,distally,distributed,eaf,eed,eglandular,exocarp,filament,finger,fruiting,geminat,green,grey,half,heterostylous,homostylous,incomplete,interpetalar,juicy,lamina,less,longer,lower,markedly,mature,mesocarp,mid-point,midrib,minute,nflorescence,oblique,obtuse,orolla,part,per,perfect,placenta,plump,pore,present,prickle,pubescent,rachi,ruit,septum,slightly,spaced,sparse,stage,stalk,straight,strongly,succulent,tal,tamen,tem,thicker,thicknes,throughout,tissu,tissue,triangular,unarme,unit,unknow,usually,uvenile,vary,weakly,wid,wide,ympodial	1.5-13.5,abaxial,adaxial,arrangement,bark,branch,branching,capitate,color,corolla,form,growth,height,history,leaf,life,main,midvein,na,number,ovary,primary,pubescence,seed,shape,size,stem,tertiary,texture,trichome,vein,venation,young
594	wfo-0001030250	success	169	108	72	97	36	0.426	0.5-1,1-1.5,1-3,1.1-1.2,1.25-1.5,1.4-1.5,1.7-7,11.2-22,11.3,2-2.5,2.5-3.25,25,3.4-6.6,3.5-4,5-6,6-8,anther,bark,base,broadly,brown,bullate,calyx,capitate,cm,corolla,cup-shaped,dark,decurrent,dia,elliptic-ovate,filament,glabrous,globose,green,greenish-white,greenish-yellow,inflorescence,leaf,lobe,main,minutely,mm,opposite,orbiculate,ovary,ovoid-reniform,pair,pale,papillose,pedicel,petiole,pitted,raised,sea-green,seed,shape,shaped,shrub,simple,size,slightly,stem,stigma,style,surface,tan,tear-drop,tube,vein,white-lenticellate,x	.5,/4,0-seeded,1.1-3.5,1.9-2.6,2.1-6,3-5,4-7,5-50-flowered,across,anthesi,apart,apex,appearing,arching,attenuate,beginning,beneath,berry,carinate-hooded,conical,consisting,cuneate,curved,deflexed,differing,difoliate,dry,eaf,edicel,eed,elliptic,exerted,five,free,fresh,fruiting,geminat,glabrou,horizontally,inflorescenc,irregularly,lateral,lobed,lon,long,long-acuminate,lower,major,maturity,middle,minor,n,nflorescence,node,occasionally,older,one,orbicular,paler,papillo,pendulous,pit,pore,poricidal,portion,projection,prominent,proximal,reflexed,rim,ruit,scar,shallow,slender,smooth,soon,spaced,specimen,spreading,straight,tall,tapering,tip,translucent,translucent-green,two,ud,unit,usually,way,white-lenticellat,wide,widest,winged,woody,ympodial	0.5,1.5,5-50,abaxial,adaxial,arrangement,branch,branching,color,diameter,drying,flower,form,fruit,growth,height,history,length,life,margin,midvein,na,number,peduncle,perennial,plant,primary,pubescence,ray,tertiary,texture,trichome,unarmed,venation,width,young
595	wfo-0001030271	success	195	123	88	107	35	0.451	0.15-0.75,0.7-9.5,0.9-2.5,1-2,1-2.5,1-3,1-7,1.4-2.1,1.9-6.6,15-61,2-4,2.4-5.6,3-10,4-22,4-7,5-8,5.6-12.3,6-15,abaxially,adaxially,anther,attenuate,base,berry,blue,brownish,cell,clavate,cm,coloration,completely,condition,coriaceous,corolla,covering,dark,deep,diameter,drying,elliptic,filament,flower,forked,fresh,fruit,glabrous,green,greenish,hair-like,herb,lanceolate,lateral,leaf,light,lilac,lobe,long,make,medium,mm,mucilaginous,odd-pinnate,ovate,ovoid,pedicel,peduncle,pentagonal,petiole,plant,purple,ripe,rotate,seed,size,spot,stigma,style,testal,thick,tube,vein,wall,wet,white,whitish,wide,x,yellow	0-2,0.5-1.2,0.9-3.6,1-4,1-6,2-2.7,2-3,2-6,3-5,3.4-7.5,5-merou,acumen,acute,adaxiall,ag,along,alyx,apart,apex,apparently,arranged,articulated,asymmetric,axe,axillary,basiscopic,bead,blade,bud,capitat,connivent,considerably,decreasing,digestion,distal,dorsally,eaf,edge,eed,enzyme,erect,exceeding,flat,folded,geminat,generally,glabrou,green-white,habi,half,homostylous,honeycomb-shaped,interjected,larger,leaflet,lengthening,like,linear,living,lower,middl,moniliform,mottled,multiple,necklace,nflorescence,orbicular,orolla,pair,perfect,petiolulate,plurifoliate,pore,poricidal,removed,rosette,rounded,ruit,sessile,seudostipule,side,slightly,slit,sometimes,spaced,specimen,stamen,stolon,straight,subtending,symmetric,tall,tamen,tem,terminal,throughout,tip,tissue,toward,tri-,tuber,typically,unit,unwinged,usually,vary,ympodial	abaxial,adaxial,arrangement,bark,branch,branching,calyx,capitate,color,form,growth,height,history,inflorescence,length,life,main,margin,midvein,na,number,ovary,primary,pubescence,ray,shape,stem,surface,tertiary,texture,trichome,unarmed,venation,width,young
596	wfo-0001030272	success	179	131	103	76	28	0.575	-6,.5,/4,0.05-1.5,0.5-1.5,0.5-2,0.6-0.9,0.65-1,0.7-2.5,0.8-1.5,1,1-2.8,1.2-1.8,1.5-2.5,1/3,10-20,2-6.5,2.5-3,2.5-3.5,2.8-3.5,3.5-5,4-6,4-8,acute,almost,anther,apically,bark,base,berry,bright,calyx,cm,deltate,densely,diameter,drying,elliptic,entire,evenly,filament,flattened-reniform,flower,fruit,glabrescent,glabrous,glandular,green,hair,lateral,leaf,length,less,lobe,lobed,long,long-attenuate,margin,maturity,mauve,membranous,minute,mm,moderately,multangulate,near,orange-brown,pair,pedicel,peduncle,petiole,poricidal,primary,ray,red,red-brown,shallowly,shrub,simple,slender,sparsely,spherical,stellate-pubescent,stem,straight,style,surface,tapering,terminal,tertiary,tip,trichome,tube,unarmed,unbranched,undulate,upper,vein,venation,visible,way,wide,young	.3,0-20,0.05-0.1,0.5-1,1-1.5,1.5-3,1/3-2/3,2-2.5,3-8,4-10,4-15,5-7,5-merous,abaxially,acut,alyx,ame,apar,apex,apparently,articulated,ba,blade,c.,concolorous,connivent,difoliate,eaf,eed,elongating,equal,erect,free,fruiting,geminat,glabrescen,gland,gra,infructescence,longer,lower,mature,midpoint,narrow-deltate,nflorescence,obtuse,older,one,open,orolla,oung,per,perfec,pericarp,porrect,portion,reduced,reflexe,rounded,ruit,scar,sessile,shorte,smooth,sometimes,spaced,spreading,stellate,tamen,terete,time,unarme,unit,vary,woody,ympodial	abaxial,adaxial,arrangement,branch,branching,color,corolla,form,gray,growth,height,history,inflorescence,life,main,midvein,na,number,ovary,perennial,plant,pubescence,seed,shape,size,stigma,texture,ye
597	wfo-0001030278	success	235	133	104	131	29	0.443	0-0.2,0-1,0.6-1,1-2,10-20,10-30,12-25,2,2-6,2.5-3,3-4,3-5,3-7,3.5-5,4-8,5-20,6-12,7-10,7-12,8-30,9-18,achlorophyllous,adaxial,anther,attenuate,base,branched,broadly,brown,calyx,cm,coarsely,cordate,corolla,dark,deltoid,densely,dentate,diameter,divergently,ellipsoid,elliptic,erect,extra-axillary,filament,flexuous,flower,fruit,glabrous,hair,hermaphroditic,hirsute,inflorescence,length,lenticular,lignescent,linear-lanceolate,lobe,long,margin,minutely,mm,moderately,narrowly,nearly,open-campanulate,orange,outline,ovate,pedicel,peduncle,perennial,petiole,pitted,prickly,pubescent,ray,ripe,sessile,simple,slender,smaller,somewhat,spreading,spreading-hirsute,stellate,stem,stigma,style,subglobose,surface,tan,thin-textured,trichome,truncate,tube,unarmed,unbranched,uniseriate,vein,weakly,white,x,yellow	0.1-0.3,1-several,1/3-1/2,15-20,2-4,2-7,2-foliate,3.5-7,4-12,4-locular,5-8,6-18,7-20,abaxially,absent,accrescent,acute,acute-,adaxiall,adaxially,along,also,apex,armed,articulated,ascending,axe,ba,basally,blade,breaking,broad-based,capitat,capitate-glandular,cauline,closely,collection,commonly,completely,compressed,concentrated,connivent,contiguous,covering,cylindrical,density,directed,distal,distall,eaf,eed,elongate,entire,female-sterile,finally,fine,flesh,fruiting,geminat,glabrou,gland-tipped,glandular-puberulen,immature,inserted,interlobal,intermixed,large,lateral,laterally,less,longer,lower,major,maturit,medium-sized,midpoint,midrib,mixed,mostly,much,nflorescence,numerous,obtuse,obtuse-tipped,occasionally,often,orolla,ovate-lanceolate,pale,per,petaloid,pore,prickle,principal,prominent,rachi,recurved,reduced,resembling,rigid,ruit,section,short-stalked,short-styled,side,similar,sinus,small,sometimes,spaced,sparsely,stalked,ste,stellae,straight,straighter,subequal,surrounding,tal,tamen,tem,termination,tip,toothlike,unit,usually,vary,varying,wide,widely,ympodial	abaxial,arrangement,bark,branch,branching,capitate,color,dense,form,growth,height,history,leaf,life,main,midvein,na,number,ovary,plant,primary,pubescence,seed,shape,size,tertiary,texture,venation,young
598	wfo-0001030281	success	193	143	117	76	26	0.606	0.5,0.5-1,0.5-1.0,0.5-1.5,0.5-3,1,1-2,1-2.5,1.5-3,10-14,12-16,12-20,2-4,2-5,2.5-3,2.5-3.5,2.5-5,3-12,3-6,4-7,5-10,5-16,abaxial,abaxially,absent,acute,adaxial,adaxially,anther,apex,apical,armed,asymmetrical,attenuate,base,brown,calyx,capitate,chartaceous,cm,connivent,cordate,curved,dark,densely,diameter,directed,distally,expanded,extra-axillary,filament,flower,fruit,functionally,glabrous,glandular,globose,green,hair,hermaphroditic,leaf,leathery,like,lobe,lobed,male,many,mature,midpoint,midvein,mm,moderately,nearly,netlike,obtuse,orange,ovate,pedicel,peduncle,petiole,pit,plant,pore,porrect-stellate,prickle,pubescent,raised,recurved,red,reniform,ridge,roselike,rusty,separated,short,simple,slightly,small,sparsely,stalk,stellate,stem,stigma,style,surface,tan,tapering,triangular,tube,unarmed,unbranched,unlobed,vine,white,whitish-green,x,yellow	0.2-0.8,1-.,1.5,10-13,10-25,2-4.5,20-30,4-6,4-8,5-merou,6-8,absen,accrescent,adaxiall,alyx,andromonoecious,anthesi,apar,axe,berry,beyond,blade,cylindrical,difoliate,discolorous,eaf,eed,either,em,exserted,flattened,frui,fruiting,geminate,glabrou,gree,heteromorphic,interpetelar,introrsel,lacking,long,long-styeld,lower,major,midrib,multicellular,multiseriate,narrowly,nflorescence,often,older,orolla,pair,per,planst,rachi,ray,reflexed,ruit,short0styled,side,spaced,stamen,staminate,ste,tamen,tissue,unequa,unicellular,unit,usually,vary,vein,wide,ympodial,young	1-4,apart,arrangement,branching,color,corolla,curvature,direction,expansion,form,glabrousnes,growth,height,inflorescence,introrsely,length,ovary,pubescence,seed,shape,size,spacing,staman,texture,width,ye
599	wfo-0001030285	success	279	108	95	184	13	0.341	.1,0.2–0.3,0.3–0.4,0.4–0.6,0.6–0.9,0.7–1.5,1.0–2.2,1.3–1.8,1.4–1.9,1.6–2.3,1.6–5.0,10.8–12.3,13.5,15.0–25.5,2.2–4.8,3.5–6.0,3.7–5.4,4,4.0–7.0,4.3–11.8,5,6.0–9.0,9.9–14.9,acuminate,anther,apex,attenuate,base,calyx,capitate,chartaceous,cm,connivent,corolla,cuneate,diameter,dry,elliptic,entire,erect,extra-axillary,flattened-irregular,flattened-orbicular,flattened-reniform,flower,fruit,glabrous,globose,green,growth,hair,internode,interpetalar,lateral,lavender,leaf,long,margin,maturing,mm,moderately,obovate,ovoid,pedicel,peduncle,petiole,poorly-developed,porrect,porrect-stellate,pubescence,pubescent,purple,red,rounded,sessile,shrub,simple,slightly,small,stellae,stellate,stem,stigma,style,tall,tissue,tree,tube,unarmed,wavy,white,yellow,yellow-ferruginous,young,×	.04,.4,.6,.8,0.1–1.1,0.3–0.6,0.3–0.7,0.4–0.5,0.5–0.7,0.7–1.1,0.7–1.3,0.7–1.7,0.9–1.5,1.0–1.3,1.2–2.1,1.2–2.3,1.4–2.0,1.9–4.0,1/3,10–14,1984,2.4–3.2,2.8–3.1,3/4,4.6–8.8,45,4–5-merou,5.7–6.5,6–10,6–8-ray,9.2–15.2,90°,abaxially,adaxial,adaxially,adnate,aequilateral,age,alveolate,alyx,anthesi,apart,apical,apiculate,apparently,appearing,appressed,area,armed,articulated,attached,attachment,axe,ba,basal,becoming,berry,bilobe,blade,branch,brochidodromous,bu,bud,central,channel,channeled,clinate,congested,conical,deciduous,dehiscence,densely,dentate,difoliate,distally,dorsally,eaf,eed,either,emerging,enclosing,endocarp,exocarp,fertile,filament,filiform,flat,flexed,fork,forking,free,frui,fully,geminat,glandular,gradually,homostylous,immature,inclined,increasing,intersepalar,juic,lanceolate,large,laying,less,line,lobe,lon,lower,major,many-flowered,mature,midpoint,midrib,midvein,minor,minute,moderate,nearly,nflorescence,notched,oblique,occasionally,often,orolla,peekel,per,perforate,point,pore,portion,potentially,prickle,protuberance,raised,ray,reduced,reported,restricted,rigid,ripe,row,ruit,shiny,shorter,side,single,sinus,smooth,soon,sparse,sparsely,splitting,spread,stellate-pubescent,straight,surface,suture,tamen,tem,thin,time,tip,toward,transparent,triangular,truncate,two,ud,unarme,unbranched,upper,vary,vein,vigorous,weakly,wide,ympodia,±90°,±90°and,±equal,±glabrous,±overlapping	arrangement,bilobed,color,form,height,inflorescence,length,ovary,plant,seed,shape,size,texture
600	wfo-0001030287	success	150	116	91	59	25	0.607	-11,-40,0-15,0.5-1,1-2,1-2.5,1-3,1-4,1-5.5,1.5-10,1.5-2.5,1966,2,2-,2-10,2-12,2-5,3-9,4-5,4.5-6,acute,apex,articulated,base,bluish,branched,calyx,chartaceous,cm,color,compound,cylindrical,deltate,dendritic,dendritically,densely,diameter,down,eglandular,ellipsoidal,elliptic-ovate,entire,fide,flattened,flower,forked,glabrous,gland,glandular,hair,herb,lanceolate,leaf,lilac,lobe,long-stalked,margin,membranaceous,mm,moderately,narrowly,oblong,ovoid,pedicel,peduncle,petiole,pinnately,puberulent,pubescent,purple,radiu,rugulose,scattered,shrub,simple,slightly,smith,sparser,stalked,stellate,stigma,strongly,style,subcordate,subcoriaceous,tip,truncate,unbranched,unknown,x,yellow	-foliat,-many,.5-2.5,1,1-10,1-15,2.5-4,3,4-6,5-10,8-13,?,abaxially,adaxiall,adaxially,aggregate,apart,axe,basiscopically,blade,cell,connivent,decurrent,dendritic-pubescen,directed,distall,eaf,eed,lateral,leaflet,leaving,lon,long,lower,nflorescence,nther,obtuse,often,orolla,pedicellar,pore,presen,rachi,ruit,scar,spaced,sparsely,stone,subcapitat,tal,tem,time,triangular,tube,unit,upper,vary,wide,ympodial	abaxial,adaxial,anther,arrangement,branching,corolla,dendritic-pubescent,form,fruit,growth,height,inflorescence,length,na,ovary,plant,presence,pubescence,seed,shape,size,stem,subcapitate,surface,texture
601	wfo-0001030299	success	179	95	74	105	21	0.413	-50,-6,1-1.5,1-10,1-5,1.5-2,1.5-3,10-20,2-,2-20,2-4,25-50,3,3-13,3-30,3-4,3-5,3-9-compound,4-5,4-6,5-10,5-40,5-8,6-22,6-9,?,acute,apex,calyx,campanulate,capitate,chartaceous,cm,color,densely,diameter,ellipsoidal,flattened,flower,forked,fruit,glabrous,leaf,lobe,mm,moderately,narrowly,ovate,pedicel,peduncle,petiole,pink,pinnately,puberulent-pubescent,pubescent,pubescent-pilose,purple,rugose-reticulate,shrub,simple,small,sparsely,stigma,style,tree,triangular,truncate,tube,unbranched,urceolate-,violet,white,x,yellow	-2,-40,.5-2,0.5-1,1-2,1-3,1.5-4,10-16,2,2-10,2.5-12,20-30,4,4-8,4-foliat,abaxially,absen,absent,acuminate,adaxially,aggregate,also,apart,ape,apiculate,articulated,axe,basal,base,basiscopically,beyond,blade,cell,compound,connective,connivent,cordate,coriaceous,cylindrical,decurrent,diamete,dilated,directed,distally,eaf,eed,entire,equal,exceeding,expanded,exserted,fide,globose,hair,lateral,laterally,leaflet,leaving,lon,long,lower,margin,midnerve,nflorescence,nther,obtuse,often,orolla,pavón,pedicellar,perfect,perhaps,pilose-hirsute,pore,present,prominent,puberulent-pubescen,pubescent-pilo,rachi,radiu,remnant,ruit,ruiz,shorter,slightly,spaced,stamen,stone,tal,tem,thecae,thickened,time,tip,tomento,tomentose,toward,ud,unequal,unit,unknow,upper,vary,wide,ympodial	abaxial,adaxial,anther,arrangement,corolla,form,growth,height,inflorescence,length,na,ovary,plant,pubescence,seed,shape,size,stem,surface,texture,width
602	wfo-0001030300	success	235	122	93	142	29	0.396	-1,-7,0.1-0.15,0.4-0.5,0.5,0.5-0.6,0.5-4,0.6-0.8,0.7-1.2,0.9-1,1,1-1.3,1-2,1-4,1.4-2.4,2-2.1,4-11,6-15,9-12,adaxial,almost,anther,articulated,base,bifid,broadly,brown,calyx,capitate,cm,cordate,corolla,crenate,densely,diameter,elliptical,entire,filament,finely,flower,fruit,glabrous,globose,golden,green,hair-like,herb,imparipinnate,inflorescence,interrupted,irregularly,large,lobe,long,margin,midvein,mm,moderately,obovate,occasionally,once-branched,orbicular,outgrowth,ovary,pale,pedicel,peduncle,pentagonal,perennial,petiole,plant,primary,pubescence,pubescent,simple,slightly,sparsely,spathulate,stem,stigma,style,surface,tertiary,thick,triangular,trichome,tube,uniseriate,vein,wide,yellow,yellowish,zygomorphic	-0.9,.5,0.1,0.15-1,0.2,0.2-0.5,0.2-1.5,0.4-1.5,0.4-4.5,0.5-1,0.5-5,0.6-0.7,0.7-0.8,0.7-1.5,0.8-1,0.8-3,0.8-4,1-2-celled,1-6,1-celled,1.2-,1.5-,1.5-2.5,2-2.5,2-3,2-4,2-foliate,2-locular,2.2-7.5,3.5-13,3/4,4-celled,6-8-celled,abaxially,absent,abundant,acute,adaxially,although,always,anthesi,apex,apical,appearance,appendage,articulation,ba,basal,bent,beyond,bract,bracteate,brittle,cell,coherent,column,crenat,curved,deltate,developed,diamete,distal,eaf,edicel,eed,eglandular,ellipsoidal,elongate,even,exserted,face,frequently,fruiting,give,glandular,glutinous-viscose,gree,halfway,head,interjected,internode,introrse,lamina,larger,lateral,leaflet,leave,less,like,lon,longer,markedly,minute,multicellular,narrowly,nflorescence,node,oblique,pair,papillae,partially,petal,petiolule,pith,population,pore,present,pseudostipule,reflexed,rest,rounded,ruit,secondary,silky,spreadin,spreading,staminal,sterile,straight,strongly,tall,tem,terminal,testa,tip,two,ud,underlying,unicellular,unit,united,upper,usually,velvety,wall,weak,well,wider,winged,woody,yellowish-green,ympodial	1-2.5,1.2-7.5,1.5-13,abaxial,arrangement,bark,branch,branching,color,drying,form,growth,height,history,leaf,length,life,main,na,number,ray,seed,shape,size,texture,unarmed,venation,width,young
603	wfo-0001030311	success	182	91	74	108	17	0.407	.2,0.5–1,0.8–1.2,1.2–7,1.5–2,1.5–5.5,1.5–8,1.8–2,15–22,1–1.5,1–2,1–2.5,2.2–2.5,2.2–3,2–2.5,2–6,3–5,3–7,5-pinnate,5–10,acuminate,acute,adaxial,anther,brown,calyx,chartaceous,clavate,cm,color,deltoid,densely,diameter,fallen,flattened,flower,fruit,glabrous,granular,green,ground,half,herbaceous,lenticular,log,lower,membranaceous,membranous,mm,orangish,ovoid-rhomboid,papillose,pedicel,peduncle,petiole,pubescent,purplish,sand-punctate,slender,sparsely,stellate,stem,stigma,style,surface,tan,terrestrial,trailing,trichome,tube,unbranched,vine,white,x	.5,.5–1.8,0.1,0.1–0.2,0.3–1.5,0.4–2,0.5–0.8,0.5–2,0.5–2.5,0.6–1,0.6–2.4,0.8–4,0.8–4.5,1.5–3,1.5–6,1–1.2,1–3,2.5–9,2–10,<,abaxially,accrescent,adaxially,along,alyx,apar,apex,apical,appearance,axe,basal,base,berry,blade,c.,capitat,ciliat,ciliate,cordate,cuneate,dense,distal,eaf,eed,elliptical,entire,especially,extra-axillary,falcate,filament,fruiting,giving,glabrou,groov,groove,hair,lanceolate,lateral,leaflet,like,lobe,lon,long,m.,margin,midvein,minutely,nflorescence,nternode,oblique,obovate,obtuse,occasionally,orolla,pair,petiolulate,petiolule,plurifoliat,present,proximal,pubescence,rachi,rhomboid,rounded,ruit,scattered,sessile,short,shortly,side,slightly,smaller,spaced,strongly,tamen,tem,thick,thickened,thinner,tip,unit,upper,vary,vein,wide,wide-diameter,widely,ympodial	abaxial,arrangement,capitate,corolla,form,growth,habit,inflorescence,leaf,length,na,ovary,plant,seed,shape,size,texture
604	wfo-0001030311	success	203	130	95	108	35	0.468	.2,.5,0.5-0.8,0.5-1,0.8-1.2,1-1.2,1-1.5,1-2.5,1-3,1.2-7,1.5-2,1.5-5.5,1.5-8,1.8-2,15-22,2-2.5,2-6,2.2-2.5,2.2-3,3-5,3-7,5-10,5-pinnate,abaxially,acuminate,acute,adaxial,adaxially,anther,basally,base,brown,chartaceous,cm,color,cordate,deltoid,densely,diameter,entire,especially,filament,flattened,flower,fruit,glabrous,granular,green,groove,hair,half,herb,lenticular,lobe,long,lower,margin,membranaceous,midvein,minutely,mm,oblique,oblong,obtuse,orangish,ovoid-rhomboid,papillose,pedicel,peduncle,petiole,pubescent,purplish,scattered,short,simple,slender,slightly,sparsely,stellate,stem,stigma,style,surface,tan,thick,thickened,tip,tube,unbranched,uniseriate,vein,white,widely,x,yellow	.5-1.8,0-2.5,0.1,0.4-2,0.5-2,0.6-1,0.6-2.4,0.8-4,0.8-4.5,1.5-3,1.5-6,2-10,2224,5-merou,8031,<,[,],absen,absent,accrescent,ag,aggregate,along,alyx,apart,apex,apical,apparently,appearance,articulated,axe,ba,basal,blade,capitat,cell,ciliat,ciliate,clavate,connivent,cuneate,dense,dig,directed,distal,distally,eaf,eed,elliptical,equal,falcate,fallen,formation,g,geminat,gh,giving,groov,ground,interjected,large,lateral,leaflet,like,log,lon,longitudinal,m.,nflorescence,node,obovate,occasionally,opening,orolla,pair,perfect,petiolulate,petiolule,pittier,plurifoliate,pore,present,proximal,rachi,rhomboid,rooting,rounded,ruit,sessile,shortly,side,sinple,slit,smaller,spaced,stone,strongly,tamayo,tamen,tem,thinner,trailing,unit,upper,vary,wide,ympodial	abaxial,arrangement,bark,branch,branching,calyx,capitate,corolla,drying,form,growth,height,history,inflorescence,leaf,length,life,main,na,number,ovary,plant,primary,pubescence,ray,seed,shape,size,tertiary,texture,trichome,unarmed,venation,width,young
605	wfo-0001030335	success	153	114	97	56	17	0.634	.25,.5,0-5,0.05-0.2,0.5-1,0.7-1,1-1.5,1-2,1-3-flowered,1.1-1.4,1.1.5,2-2.5,2-4.5,2-5,2.5-3,3/4,5-6,5-7,7-13,along,anther,bark,base,beneath,berry,bi-lobed,bud,calyx,cm,conical,corolla,dark,decurrent,deltoid,densely,dia,dry,elliptic,erect,filiform,gently,glabrous,globose,green,greyish-red,horizontally,lateral,leaf,lenticellate,lightly,like,lobe,lobed,long,main,material,minute,minutely,mm,narrowly,older,ovary,ovoid-reniform,pair,pale,papillose,pedicel,petiole,prominent,puberulent,pubescent,raised,ripe,shaped,shrub,simple,slightly,spreading,stem,stigma,straight,style,tan,tapering,tear-drop,trichome,tube,underside,uniseriate,vein,way,white,winged,x,yellow,yellowish-green,young	.1,.75,0.1-0.5,0.25-0.5,2-2.2,acuminate,acute,anthesi,apex,aspec,ba,branch,deciduous,deflexed,eaf,edicel,eed,except,expanded,exserted,filament,flattened,free,fruiting,geminate,giving,lamina,lon,lower,middle,nflorescence,obovoid,occasionally,often,onto,opposite,papillo,pitted,pore,poricidal,portion,puberulen,reflexed,ruit,soon,sparsely,strongly,surface,tall,tip,ud,unifoliat,unit,widest,woody,ympodial	branching,color,diameter,form,fruit,growth,height,inflorescence,length,na,number,plant,pubescence,seed,shape,size,texture
606	wfo-0001030336	success	266	161	132	134	29	0.496	-10,-19,0.5,0.5-0.7,0.6-0.8,0.8-0.9,1,1-1.5,1-3,1-celled,1.0-1.4,1.6-7,1.7-2.3,1.8-3.0,1/4-1/3,4-10,4-celled,8-20,8-celled,adpressed,almost,amongst,anther,apex,appearance,base,basiscopically,bent,bifurcate,branch,bright,brown,calyx,capitate,cell,cm,coat,conical,corolla,crenate,dark,darker,decurrent,deeply,densely,diameter,eglandular,elliptic,entire,filament,flower,flushed,fruit,giving,glandular,globose,grayish,green,greenish,hair-like,head,herb,imparipinnate,inflorescence,interrupted,lanceolate,lateral,leaf,leaflet,less,like,lobe,lobed,long,margin,markedly,midvein,minutely,mixed,mm,oblique,obovate,occasionally,once-branched,orbicular,outgrowth,ovary,papillate,pedicel,peduncle,perennial,petiole,primary,puberulent,pubescent,purple,rachi,rotate,scattered,shaggy,shorter,shrub,silky,simple,slightly,small,soft,sometimes,sparse,stellate,stem,stigma,style,surface,ten,tertiary,testa,thick,tip,trichome,truncate,tube,uniseriate,usually,velvety,wall,way,weak-walled,white,wide,yellow,young	-1.5,-2,.5,0-,0.1-0.3,0.1-0.5,0.1-0.7,0.1-1,0.15-0.2,0.15-0.9,0.2,0.2-0.25,0.2-0.8,0.2-1,0.2-1.5,0.3-0.4,0.3-1.1,0.5-1,0.5-1.5,0.6-1.5,0.8-1.2,0.8-1.3,0.8-3,1-1.4,1.5-,1.5-2,1.5-3.5,1.5-5,10,2-4,2-9,2-foliate,2-locular,2/3,3-5,4,4-,6,8-16,absent,acute,anthesi,apical,appearing,appendage,articulated,articulation,basal,berry,bluntly,bract,bracteate,clavat,column,completely,cordate,curved,developed,diamete,distal,divided,eaf,edicel,eed,elongate,entir,erect,essentially,exserted,extremely,first,fruiting,glandula,half,halfway,interjected,internode,investing,large,larger,largest,leave,lon,longer,loosely,lower,maturity,mere,middl,minute,mostly,narrowing,narrowly,nflorescence,node,often,pair,pale,part,petiolule,population,present,proximal,pseudostipule,range,reflexed,rest,rounded,ruit,secondary,sessile,sinus,southern,spreadin,spreading,staminal,sterile,straight,stripe,strongly,surrounding,tall,tem,terminal,two,ud,unicellular,uniformly,unit,united,upper,winged,woody,ympodial	1.5-4-10,abaxial,adaxial,arrangement,bark,branching,clavate,color,drying,form,growth,height,history,length,life,main,na,number,plant,pubescence,ray,seed,shape,size,texture,unarmed,vein,venation,width
607	wfo-0001030342	success	155	72	41	114	31	0.265	1.5,3-pinnate,anther,brown,calyx,chartaceous,cm,cylindrical,deltoid,diameter,entire,fruit,glabrous,greenish,herbaceous,lanceolate,leaf,lenticular,light,margin,membranous,mm,ovoid-rhomboid,pedicel,peduncle,petiole,pubescent,rarely,slender,stellate,stem,stigma,style,trichome,truncate,unbranched,undulate,vine,white,x,yellowish	.2,.5,0.1–0.2,0.3–1.2,0.5–1,0.5–3,0.5–5,0.8–1.5,0.8–4,1-5,1-6.5,1.2–3,1.5–13,1.5–2,1.5–5,1.5–7.5,10–25,1–1.2,1–1.5,1–2.5,1–3,1–5.5,1–6,1–7,2–,2–2.5,2–4,3,3–12,4–5,4–8,5-merous,6–7,abaxially,abundant,accrescent,acuminate,acute,adaxially,along,alyx,apar,apex,apical,apiculate,axe,base,berry,blade,broadly,c.,capitat,ciliat,cordate,cuneate,dense,eaf,eed,elliptical,extra-axillary,filament,flattened,flower,fruiting,glabrou,lateral,leaflet,like,lobe,lon,long,lower,m.,minutely,mottled,nflorescence,nternode,oblique,obtuse,often,orolla,perfec,petiolule,plurifoliat,pointed,proximal,pubescen,rachi,revolute,rhomboid,rounded,ruit,sand-punctate,scattered,side,slightly,smooth,spaced,sparsely,surface,tamen,tem,terrestria,tip,truncate-acuminat,tube,unit,vary,vein,wide,wide-diameter,widely,ympodial,–7	0.8-1.5,1-1.5,1-2.5,1.5-13,1.5-2,1.5-5,10-25,2-2.5,2-4,3-12,4-5,abaxial,adaxial,arrangement,capitate,color,corolla,form,growth,height,history,inflorescence,length,life,ovary,plant,seed,shape,size,terrestrial,texture
608	wfo-0001030342	success	153	116	79	74	37	0.516	-7,.2,.5,0.5-1,1-1.5,1-3,1-7,1.5-13,1.5-2,1.5-5,1.5-7.5,10-25,2-2.5,2-3,3,3-12,3-pinnate,4-5,acuminate,acute,adaxially,anther,basally,base,brown,calyx,chartaceous,cm,cordate,cuneate,cylindrical,deltoid,diameter,entire,extra-axillary,filament,flower,fruit,glabrous,hair,herb,leaf,lenticular,light,lobe,margin,membraceous,minutely,mm,oblique,oblong,pedicel,peduncle,petiole,pubescent,rarely,revolute,sagittate,scattered,simple,slender,smooth,stellate,stigma,style,surface,terrestrial,tip,trailing,truncate,tube,unbranched,undulate,uniseriate,vein,white,widely,x,yellow	0.5-3,0.5-5,0.8-4,1-1.2,1-5,1-5.5,1-6,1-6.5,1.2-3,2-,4-8,5-merou,6-7,abaxially,absent,abundant,accrescent,ag,along,alyx,apart,apex,apical,apiculate,apparently,articulated,axe,ba,blade,broadly,capitat,ciliat,connivent,directed,distally,eaf,eed,elliptical,equal,fruiting,geminat,interjected,lanceolate,lateral,leaflet,long,longitudinal,lower,nflorescence,node,obtuse,opening,orolla,perfect,petiolule,plurifoliate,pore,proximal,pubescen,rachi,rhomboid,rooting,rounded,side,slightly,slit,spaced,tamen,tem,truncate-acuminat,unit,vary,wide,ympodial	abaxial,adaxial,arrangement,bark,branch,branching,capitate,color,corolla,drying,form,growth,height,history,inflorescence,length,life,main,midvein,na,number,ovary,plant,primary,pubescence,ray,seed,shape,size,stem,tertiary,texture,trichome,true,unarmed,venation,young
609	wfo-0001030353	success	227	126	105	122	21	0.463	.7,0-6,0.1-0.2,0.5-0.9,1-6,1-7,1.8-2.2,1.8-3,1/2-2/3,1/3,1/5,11-16,2.5-4,2.8-3.7,3-4,3-5.5,3.5-4,4-4.5,5,6-8,abaxial,acute,adaxial,almost,anther,apically,bark,base,berry,brown,calyx,chartaceous,cm,cuneate,densely,diameter,discolorous,drying,ellipsoid,elliptic,erect,evenly,filament,flattened-reniform,flower,fruit,glabrescent,glabrous,green,leaf,length,lobed,long,long-styled,lower,margin,maturity,mauve,midvein,mm,moderately,multangulate,narrow-deltate,pair,patch,pedicel,peduncle,petiole,plant,poricidal,prickly,primary,ray,red-brown,reddish-green,sessile,shape,short-styled,shrub,simple,small,stalked,stellate-pubescent,stem,strongly,style,subentire,surface,tapering,tertiary,tip,tree,trichome,tube,unarmed,unbranched,upper,vein,venation,way,weakly,white-gray,wide,yellow,young	-0.2,-1.5,-1/2,-2,-3,-5,-6,-merous,.1,.2,.5,0,0-15,0-2,0.1-0.3,0.15-0.3,0.5,0.8,0.8-1.2,1,1-2,1-3,1.2-1.8,1/,1/6,1/6-1/4,10-15,2-10,2-7,20-200,4-,4-5,5-6,6,6-15,7-10,8-15,abaxially,alyx,andromonoecious,apar,apart,apex,apiculat,apparently,articulated,blade,broad-deltate,c.,conical,connivent,curved,deltate,development,distal,distance,eaf,eed,elongating,equal,extending,flattened,free,fruiting,half,hermaphrodite,heterostylous,infructescence,lateral,less,lobe,longer,lowermost,mature,midpoint,nflorescence,older,one,open,orange-brown,orolla,oung,pendulous,per,pericarp,plurifoliat,pointed,porrect,portion,prickle,reflexed,retaining,rounded,ruit,scar,shorter,side,smooth,sometimes,somewhat,spaced,sparsely,spreading,stalk,staminat,stellate,stout,straight,tamen,terete,terminal,throughout,time,unarme,unit,vary,visible,warty,whit,wo,woody,ympodial	4-6,apiculate,arrangement,branch,branching,color,corolla,form,growth,height,inflorescence,main,na,number,ovary,pubescence,seed,size,stigma,texture,white
610	wfo-0001030407	success	182	109	75	107	34	0.412	.2,.5,1-2,12-14,12-15,2-5,2-7,3-6.5,3-9,3.5-9.5,30-60,4-5,6-7,6.5-18.5,7-8,acuminate,anther,base,berry,brownish,cell,chartaceous,cm,condition,conical,corolla,covering,densely,diameter,drying,elliptic-lanceolate,filament,flower,forked,fresh,fruit,glabrous,green,greenish,hair-like,herb,lanceolate,lateral,leaf,light,lobe,long,margin,mm,obtuse,odd-pinnate,ovate,ovoid,pedicel,peduncle,pentagonal,petiole,plant,pubescent,purple,ray,ripe,round,seed,size,stigma,style,testal,thick,tube,wall,whitish,wide,x,yellow	0.7-3.2,1-10,1-3,1-4,1.5-5,2-2.5,2-6.7,3-10.5,3-4,5,5-merou,abaxially,absent,acumen,adaxially,ag,alyx,apart,apex,apparently,articulated,axe,axillary,blade,bud,capitat,ciliate,connivent,decreasing,digestion,distal,dorsally,eaf,edge,eed,end,enzyme,especially,exceeding,flat,folded,geminat,generally,glabrou,gradually,green-white,hair,half,homostylous,honeycomb-shaped,interjected,larger,leaflet,lengthening,like,living,lower,make,middle,minute,mottled,mucilaginous,nflorescence,one,orolla,pair,perfect,petiolule,placed,plurifoliate,pore,poricidal,proximal,pubescen,removed,ruit,secondary,semierec,seudostipule,slit,spaced,specimen,stamen,ste,stolo,subequal,subsessile,subtending,symmetrical,tall,tamen,tem,terminal,thir,throughout,tip,toward,tri-,tuber,typically,unit,unwinged,usually,vary,wet,white,ympodial	abaxial,adaxial,arrangement,bark,branch,branching,calyx,capitate,color,form,growth,height,history,inflorescence,length,life,main,midvein,na,number,ovary,primary,pubescence,shape,stem,surface,tertiary,texture,trichome,unarmed,vein,venation,width,young
611	wfo-0001030417	success	242	97	81	161	16	0.335	-5,0.05-0.1,0.25-0.5,0.5-0.7,0.5-0.8,0.7-1,1-1.3,1-2-celled,1-2.3,1.2-3,1.5-8,2-3,3,4-12,4-25,7-30,8-11,annual,anther,biennial,bright,broadly,brown,calyx,capitate,cm,conical,corolla,densely,diameter,eglandular,elliptic,flower,fruit,glabrous,glandular,globose,green,hair-like,herb,imparipinnate,inflorescence,interrupted,lanceolate,leaf,length,long,mm,obovate,occasionally,once-branched,outgrowth,ovary,ovate,pale,pedicel,peduncle,perennial,petiole,pubescence,pubescent,rarely,red,simple,size,sparsely,stellate,stem,stigma,style,surface,thick,thin,trichome,tube,type,uniseriate,velvety,white,wide,yellow	.5,0.1-0.25,0.2,0.2-0.4,0.2-0.7,0.25-0.4,0.3-0.4,0.5-1,0.5-1.2,0.5-2,0.8,1,1-1.2,1-1.5,1-2,1-3.5,1-4,1.5-2,1.5-3.5,1.5-5,1/3,2-4,2-8,2-locular,2.5-5,2/3,3-foliate,3/4,abaxially,absen,absent,abundant,acuminate,acute,along,also,anthesi,apex,apical,appearance,appendage,articulation,basal,base,basiscopically,bent,branch,cell,cente,column,common,cordate,crenate,decreasing,decurrent,dentate,distal,eaf,ebracteate,edicel,eed,elongate,entire,erect,exserted,extended,extending,extremely,filament,free,fruiting,generally,giving,gree,hal,head,hybrid,included,initially,interjected,internode,larger,largest,later,lateral,leaflet,like,lobe,lon,lower,margin,maturation,mature,minute,minutely,mixture,multicellular,narrowly,nflorescence,northern,oblique,often,pair,parallel,part,patent,pedice,peruvian,petiolule,point,population,portion,primary,procumbent,proximal,pseudostipule,putatively,rachi,range,reflexed,rest,ripe,robust,round-crenate,rounded,ruit,scattered,secondary,sessile,several,shaggy,short,silky,slightly,sometimes,somewhat,species,staminal,sterile,straight,strongly,tem,terminal,tertiary,testa,theseadpressed,third,tip,toward,truncate,ud,unicellular,unit,usually,variable,vein,viny,wall,way,winged,ympodial	0.5,0.8-5,abaxial,adaxial,arrangement,color,form,growth,height,history,life,na,plant,seed,shape,texture
612	wfo-0001030420	success	170	126	89	81	37	0.524	-20,-30,-pubescent,0.5-,0.5-1,0.5-4,0.5-8,1-1.5,1-3,1-4,1-7.5,1.5-3,1.5-5,10-,15-25,2-,2-14.5,2-3,2-9,3-7,3-lobed,4-7,5-,5-15,6-7,7-19,acute,also,apex,base,calyx,chartaceous,cm,color,connivent,cordate,deltate,densely,diameter,eglandular,ellipsoidal,elongated,entire,flower,forked,fruit,glabrate,glabrous,glandular-,glandular-puberulent,hair,lanceolate,leaf,lobe,lobed,long,margin,mm,moderately,narrowly,often,pedicel,peduncle,petiole,pilose,pinnately,puberulent,pubescent-pilose,purple,rarely,shrub,simple,small,sparsely,stellate,stigma,style,subcoriaceous,tip,tree,triangular,truncate,tube,unbranched,unknown,unlobed,vein,x,yellow	-2,-35,-4,-9,1,1-,1-2,1-6,1/2,10-25,2-5,2-6,4-foliat,5-6,7-22,7/8,abaxially,absent,acuminate,adaxially,aggregate,apart,ape,articulated,axe,basal,beyond,blade,cell,connective,cylindrical,dark,directed,distally,divided,eaf,eed,eglandular-pilo,eglandular-puberulent,elliptic-ovate,equal,exserted,leaving,lon,lower,midrib,nearly,nflorescence,nther,obtuse,orolla,ovate,pedicellar,perfect,pore,presen,puberulent-pubescent,pubescent,pubescent-pilo,rachi,radiu,remnant,ripe,ruit,shorter,sinus,spaced,stamen,stone,tal,tem,thecae,time,tomento,truncat,ud,unit,vary,wide,yello,ympodial	abaxial,adaxial,anther,arrangement,bark,branch,branching,corolla,drying,filament,form,growth,height,history,inflorescence,length,life,main,midvein,na,number,ovary,plant,primary,pubescence,ray,seed,shape,size,stem,surface,tertiary,texture,trichome,unarmed,venation,young
613	wfo-0001030426	success	158	105	86	72	19	0.544	-30,0.3-7,0.3-8,0.4-0.7,1-4.2,1.5-3,1.7-3.2,15-25,2,2-3,2.5-4,2.5-6,3-4,3-6,4-10,4-6.5,6-11.5,6-8,9,apical,apically,branched,calyx,cell,cm,connate,corolla,covering,cyme,dehiscent,diameter,dichasial,dichasially,distal,ebracteate,exceeding,forked,generally,glandular,globose,green,green-white,hair-like,half,heart-shaped,herbaceous,introrse,lateral,leaf,leaflet,long,make,maturing,mm,monochasial,mucilaginous,oblong,odd-pinnate,often,ovoid,pedicel,peduncle,perennial,petiole,pilose,plant,poricidally,seed,short,size,slit,spot,stamen,stellate,stigma,straight,stripe,style,terminal,testal,thick,throughout,wall,white,wide,yellow	1-4,1.5-6.5,10,3-12,3-6-foliat,abaxially,absen,acumen,acute,adaxially,apex,apiculate,articulate,base,caudate,decurrent,digestion,diminishing,dorsally,eaf,edge,eed,elliptic-lanceolate,emoval,enzyme,filament,flat,flower,folded,globo,gradually,honeycomb,interjected,lanceolate,larger,linear,linear-lanceolate,linear-oblong,living,lobe,lon,lower,nflorescence,nther,oblique,obtuse,orolla,pair,pattern,perfect,pinnatifi,plan,proximal,rachi,reveal,rounded,ruit,second,sessile,seudostipule,specimen,tal,tem,toward,tuber-bearing,typically,unit,vary,whit,without,ympodial,¼	anther,arrangement,branching,color,form,fruit,growth,height,history,inflorescence,length,life,ovary,pinnatifid,shape,stem,surface,texture,wet
614	wfo-0001030430	success	171	99	63	108	36	0.368	.2,anther,anthesi,base,blade,blue,branched,brittle,brown,calyx,capitate,clavate,cm,cylindrical,decurrent,densely,dentate,diameter,elliptic,erect,flattened,fleshy,fruit,glabrous,globose,green,indumentum,leaf,lobe,lobed,margin,mm,moderately,oblong,occasionally,ovate,pair,pale,pedicel,peduncle,pentagonal,perennial,petiole,pitted,pubescent,purple,regularly,serrate,shallowly,shrub,simple,stigma,straight,style,subglabrous,surface,time,tube,violet,white,woody,x,yellow	.5,0.25,0.3,0.4,0.5,0.5–12,0.6,0.6–0.8,0.6–1.0,0.8–3.0,0.8–5.6,0.9–1.0,0–20,1.0–1.2,1.0–1.5,1.0–2.0,1.2–2.0,1.3–8.0,1.4–1.5,1.5–1.7,1.6–1.8,1.8–5.0,12–20,12–30,1–3,1–9,2.0–3.0,2.0–4.2,2–3,3.0–4.5,30–200,3–17,3–24,3–4,3–5,3–8,5,5.5–12,5–10,5–6,6–10,abaxially,abundant,acute,adaxiall,adaxially,ag,apart,apex,apical,appressed,articulated,axe,axillary,ba,basal,borne,bud,cell,chartaceous,connivent,convex,diamete,eaf,eed,equal,especially,few-seeded,filament,flower,geminat,hair,lon,long,longitudinal,lower,m.,multicellular,nflorescence,opening,orolla,perfect,pore,poricidal,present,rounded,ruit,shaped,shoot,side,slit,spaced,stone,tal,tamen,tear-drop,tem,terminal,tip,toward,unifoliate,uniseriate,unit,vary,wide,ympodial,–2.7,–40	0-20,0.5-12,0.8-3.0,0.8-5.6,1.0-1.5,1.3-8.0,1.4-1.5,1.6-1.8,12-20,2-3,3-17,3-4,3-5,3-8,3.0-4.5,30-200,5-10,5-6,color,corolla,form,growth,height,history,inflorescence,length,life,na,ovary,plant,pubescence,seed,shape,size,stem,texture
615	wfo-0001030441	success	178	132	107	71	25	0.601	.5,0.5-1,0.5-3,1,1-1.4,1-1.5,1-2-celled,2,2-10,2-5.5,2.5,3-4,4-5,5-14,5-7,5-7.5,6-11,acuminate,acute,along,anther,apex,attenuate,base,berry,branched,bright,c.,calyx,capitate,cell,cm,corolla,decurrent,deltate,diameter,ellipsoid,elliptic,entire,eye,flattened,flexuous,glabrous,glandular,globose,green,growth,hair,lateral,lengthening,lobe,lobed,long,making,many,margin,membranous,midvein,minutely,mm,narrowly,new,occasionally,onto,open,pair,pale,pedicel,peduncle,petiole,plant,pore,poricidal,primary,pubescent,red,reniform,ridged,ripe,shrub,simple,slightly,slit,spot,stellate,stem,stigma,style,surface,terminal,thin,time,tip,triangular,trichome,undulate,uniseriate,usually,vein,vine,violet,wall,way,white,wide,woody,yellow	+,0.5,0.5-0.75,1.2-1.4,1.5-2,10-40,2-3,30,5-6,5-merou,<,>,ag,alyx,anthesi,apart,ark,articulated,brow,closely,distall,eaf,eed,exerted,filament,flower,free,fruiting,glabrou,glandula,ilament,impressed,irregularly,juicy,leaving,lon,lower,markedly,nflorescence,older,orolla,otherwise,papillat,papillose,peg,per,perfect,pericarp,plurifoliat,portion,reflexed,ruit,scandent,scar,shiny,short,shrubby,small,somewhat,spaced,spreadin,spreading,strongly,tem,trailing,tube,ud,unit,upper,vary,ympodial	abaxial,adaxial,age,arrangement,bark,brown,color,form,fruit,height,history,inflorescence,leaf,length,life,number,ovary,papillate,perennial,ridging,seed,shape,size,texture,width
616	wfo-0001030444	success	196	114	91	105	23	0.464	0.15-0.8,0.8-2,1,1-10,1-2,1-4,1.2-1.8,11-45,2-8,2.4-3.8,3-10,3-5,4-17,4-39,4-7,6.1-12.8,7.1-17.5,9.4-20.1,anther,berry,blue,brownish,cell,ciliate,clavate,cm,condition,coriaceous,corolla,covering,dark,deep,diameter,dot,drying,elliptic,flower,forked,fresh,fruit,glabrous,green,greenish,hair-like,herb,lanceolate,lateral,leaf,light,lilac,lobe,long,make,margin,medium,mm,mucilaginous,narrow,odd-pinnate,ovate,ovoid,pedicel,peduncle,pentagonal,petiole,plant,poricidal,purple,ripe,rotate,rough,seed,size,sometimes,stigma,style,testal,thick,tip,touch,tube,unwinged,usually,wall,wet,white,whitish,wide,wing,x,yellow	0-24,1-5,1.1-2.7,2-3,2-6,2.3-3.6,3.7-6.8,5-merou,5.3-9,abaxiall,abaxially,acumen,acuminate,acute,adaxially,ag,along,alyx,apart,apex,apparently,arranged,articulated,asymmetric,attenuate,axe,axillary,base,basiscopic,bead,blade,bud,capitat,connivent,decreasing,digestion,distal,dorsally,eaf,edge,eed,enzyme,erec,exceeding,filament,flat,folded,geminat,general,generally,glabrou,green-white,hal,half,high,homostylous,honeycomb-shaped,interjected,larger,leaflet,lengthening,like,linear,living,lower,moniliform,multiple,necklace,nflorescence,orbicular,orolla,pair,perfect,petiolulate,plurifoliate,pore,removed,rounded,ruit,sessile,seudostipule,shortly,side,slit,spaced,specimen,stamen,stolon,straight,subequal,subtending,symmetric,tall,tamen,tem,terminal,throughout,tissue,toward,tri-,tuber,typically,unit,vary,ympodial	abaxial,adaxial,arrangement,branching,calyx,capitate,color,form,growth,height,history,inflorescence,length,life,na,ovary,perennial,pseudostipule,pubescence,shape,stem,surface,texture
617	wfo-0001030445	success	226	134	115	111	19	0.509	0.2-0.4,0.2-0.5,0.6-2.2,1-1.3,1-7,1.1-4.3,1.3,1.5-2.1,1.6-2,1.7-2.4,10-14,14,15-35,2.2-2.9,2.2-3.5,2.4-4.7,3.5-4.2,4.1-8.7,4.2-10,5.2-7.1,5.9-15,6.1-9.1,7.5-16,8.2-18,abaxial,acuminate,acute,adaxially,along,anther,apex,around,bark,base,black,blade,blunt-tipped,branch,branched,bud,calyx,capitate,cm,corolla,decurrent,deltoid-reniform,diameter,drying,elliptic,elliptical,elongated,entire,erect,ferruginous,ferruginous-granular,ferruginous-tomentose,flower,fruit,glabrate,glabrous,globose,green,greyish-tan,hair,lateral,leaf,lobe,long,main,many,margin,midrib,mm,oblong,oblong-lanceolate,obovate,orange,orangish-tan,orbicular,pedicel,peduncle,petiole,poricidal,porrect-stellate,pseudoterminal,pubescence,relatively,reniform,reticulate-punctate,semi-spherical,sessile,shrub,side,simple,slightly,small,stellate,stigma,style,subcampanulate,sulcate,surface,thin,time,tip,tomentose,tree,tube,vein,white,x,yellow,yellowish,yellowish-tan,young	.1,.5,/5-2/3,0.1-0.7,0.2,0.2-0.7,0.3,0.4,0.5,0.6-3.5,0.7,0.8,1,1.3-1.8,1.3-2,1.8-3.5,10-16,2.1-5.2,3-5.4,3.1-5,3.4-5.6,5-125,5-merou,5.9-8.3,8.1-10,abaxially,accrescent,ag,alyx,apart,appressed,articulated,axillary,berry,blunt-tippe,brown,brownish-yellow,bulbous-based,concentrated,cylindrical,directed,distally,eaf,earl,edge,eed,exserted,filament,free,fruiting,geminate,glabrescen,high,homostylous,inserted,intermediate,lackin,lengthening,lobed,lon,longitudinal,lower,m.,midvein,mostly,multangulat,multangulate,nflorescence,obscured,obtuse,older,open,orolla,ovate,ovate-lanceolate,plurifoliate,pore,porrect-stellat,pubescent,rachi,ray,resorption,rounded,ruit,runk,slit,somewhat,soon,spaced,sparse,sparsely,splitting,stalk,stamen,stem,stout,suture,tamen,thick,thick-textured,thicknes,thin-,tissue,tomentum,unarme,unit,vary,vestigial-rayed,way,wide,ympodial	arrangement,color,form,glabrescent,growth,height,inflorescence,length,na,ovary,plant,seed,shape,size,texture,trunk,unarmed,width,ye
618	wfo-0001030447	success	276	168	143	133	25	0.518	.2,.3,.5,/5,0.15-0.3,0.2,0.5-0.65,0.5-10,0.7-1,0.8-3.5,1-1.5,1-2,1-5,1.8-2.5,1/3,1/3-2/3,2-4,2.2-2.8,2.5-6.5,3-4.5,3-5,6-10,6-16,6-8,6.5-9,7-8,8,abaxially,acute,adaxially,age,anther,apical,apically,apparently,bark,base,berry,calyx,cell,chartaceous,clavate,cm,corolla,cuneate,cupular,curved,deltate,diameter,discolorous,drying,filament,filiform,fine,finely,flat,flattened-reniform,flower,fruit,gently,glabrous,globose,irregular,lateral,leaf,length,lengthening,lobe,lobed,longitudinal,lower,margin,maturity,midvein,mm,moderately,obconical,oblique,oblong,often,orange,orange-brown,orange-red,outline,ovate,pair,pedicel,peduncle,persisting,petiole,pit,pore,poricidal,porrect,prickle,primary,purple,raised,ray,red-brown,ridged,rounded,sessile,shallowly,shiny,shortly,shrub,side,simple,slender,slit,small,smooth,sometimes,somewhat,sparse,sparsely,stalked,stellate,stellate-pubescent,stem,stigma,straight,style,surface,tapering,tertiary,thin,tip,translucent,trichome,tube,unarmed,unbranched,vein,venation,visible,weakly,white,x,yellow,yellow-orange,×	0,0.1,0.1-0.3,0.2-0.4,0.4-0.7,0.4-0.9,0.5,0.5-3,0.8-1.7,1,1-10,1-2.5,1-3,1-6,1.5,1.5-2.5,1.5-7,1/3-1/2,1/4-1/3,2.5-10,3,30-45°,4-8,5,5-15,5-merou,6,6-7,6-9,accrescent,always,alyx,apar,apart,apex,armed,articulated,axe,beyond,blade,branche,broad-deltate,c.,characteristically,covering,dark,densely,development,difoliate,distance,divided,eaf,eed,elongating,equal,erect,exserted,extending,finger-hair,flattened,free,fruiting,geminat,glabrescent,herbaceous,infructescence,irregula,less,long,long-ovoi,long-styled,longer,mature,midpoint,minute,mostly,narrow-deltate,nflorescence,obtuse,older,one,open,opening,orange-translucent,orolla,oung,pale,papillo,pendulous,per,perfect,pericarp,point,portion,pronounced,prostrate,pubescent,rachi,reduced,rest,ri,ridge,ruit,scar,shallow,short-styled,shorter,sinus,spaced,spherical,spreading,stalk,stout,straw-yellow,stump,subsessile,tamen,terete,terminal,thick,throughout,time,toward,ud,unequal,unit,usually,variously,vary,wide,widest,woody,ympodial	abaxial,adaxial,arrangement,branch,branching,color,form,growth,height,history,inflorescence,life,main,na,number,ovary,papillose,perennial,plant,pubescence,seed,shape,size,texture,young
619	wfo-0001030452	success	199	130	112	87	18	0.563	0.2–0.3,0.7,1.2–1.6,1.5–3,10–15,1–2,1–3-celled,1–4,2.5–3,20–30,2–2.5,2–4,2–5.5,3.7–5.2,4,5,5–6,5–7,80,acuminate,acute,adaxially,anther,apex,apparently,attenuate,base,black,broadly,calyx,cm,collected,cordate,curved,cylindrical,deflexed,diameter,directed,drying,dull,enlarged,flattened,flower,free,fruit,glabrous,gland-tipped,glandular-puberulent,globose,gradually,hair,half,hyaline,immature,internode,leaf,lobe,long,margin,mature,minutely,mm,moderately,narrowly,nearly,often,orbicular,ovate,pedicel,petiole,pilose,prickle,probably,proximal,pubescence,pubescent,reddish,sessile,shape,shrub,similar,simple,sinuate,size,slightly,small,smooth,somewhat,spreading,stellate,stem,stigma,straight,strongly,style,sulcate,surface,terete,thin-textured,tip,toward,triangular,truncate,tube,uniform,various,white,wide,x,yellow,yellowish,–9	.5–4.5,.6,0.1–0.4,0.4,0.6,0.8,1.2,100,1–1.3,2,2.5–4,2.5–6,2–foliate,3,4–5-rayed,6–12,8–11,911,abaxially,absent,accrescent,also,appressed,axe,blade,broad,canthophora,capitat,central,contiguou,counted,dense,developing,distall,eaf,eed,eglandular,enlarging,f,filament,fruiting,fully,geminat,glabrou,gland–tipped,herter,hig,imple,initially,larger,less,lon,longer,lower,major,matur,maturity,nflorescence,numerous,one,opposite,orolla,per,pore,rachi,ray,reflexed,ruit,sec,short,sof,sometimes,sparse,sprawling,ste,stellae,subopposite,tamen,tem,thin–textured,ultimately,unit,usual,vary,vein,wing,ympodial	2.5–4.5,abaxial,arrangement,branching,capitate,color,corolla,distally,form,growth,height,inflorescence,length,na,ovary,plant,seed,texture
620	wfo-0001030453	success	127	82	64	63	18	0.504	.25,.5,/4,0.8-1.5,1-1.3,1-1.5,1.5-1.6,1.5-2.5,3-3.5,4-5,9-14,adaxially,anther,arachnoid,arachnoid-pubescent,bark,base,broadly,calyx,clavate,cm,corolla,cup-shaped,dark,delicate,dendritic,divided,elliptic,filament,fine,flat,floccose,glabrous,leaf,long,minutely,mm,narrowly,nearly,occasionally,ovary,pedicel,petiole,poricidal,pubescent,reddish,shaped,shiny,shrub,simple,sparsely,stem,stigma,straight,style,surface,tear-drop,tip,trichome,tube,way,white,wide,young	0.25-0.5,9-12,abaxially,acuminate,acute,along,anthesi,apex,attenuate,axi,closely,deflexed,deltate,densely,dia,eaf,edicel,eed,ellipsoid,especially,exserted,free,glabrate,know,known,later,lateral,less,lobe,lon,lower,main,margin,middle,midrib,minute,near,nflorescence,older,opposite,overlappin,pair,papillat,papillose,planar,pore,portion,reddish-brow,rounded,ruit,scar,slender,soon,spaced,strongly,tall,tub,ud,unifoliat,unit,vein,widest,ympodial	abaxial,color,colour,diameter,form,growth,hair,height,inflorescence,length,na,papillate,plant,pubescence,reddish-brown,shape,size,texture
621	wfo-0001030486	success	141	105	74	67	31	0.525	.5,1-1.5,1-5,1.1-1.4,1.5-2,1.7-2,10-12,10-14.5,2-3,3-3.5,4-4.5,4-6.5,4.5-5,6-7,acute,anther,bark,base,beneath,brown,calyx,clavate,cm,conical,corolla,dark,deltate,dia,dry,drying,elliptic,erect,filament,fleshy,fresh,glabrous,globose,green,leaf,lobe,lobed,main,margin,material,minutely,mm,ovary,ovoid-reniform,pair,pale,papillose,pedicel,petiole,pitted,reddish,shaped,shrub,simple,size,slightly,small,stem,stigma,style,surface,tan,tear-drop,treelet,tube,vein,white,x,yellow-green,young	0.8-2.2,1/2,1/4,2-5.5,3-5,3/4,5-8-flowered,abaxially,adaxially,anthesi,apex,ba,basal,berry,closely,clustered,completely,deflexed,differing,difoliate,distal,eaf,edicel,eed,ellipsoid,exserted,f,free,fruiting,geminat,inflorescenc,internodal,later,lateral,lon,long,lower,m.,major,middle,minor,nflorescence,older,opposite,overlapping,papillo,planar,pore,poricidal,portion,ruit,scar,shin,spaced,stout,tall,tapering,thickened,tip,tub,ud,unit,usually,way,widest,woody,ympodial	5-8,abaxial,adaxial,arrangement,branch,branching,color,diameter,flower,form,fruit,growth,height,inflorescence,length,midvein,na,number,peduncle,plant,primary,pubescence,ray,seed,shape,shiny,tertiary,texture,trichome,venation,width
622	wfo-0001030489	success	196	140	122	74	18	0.622	-6.5,.5-2.8,0.25-0.4,0.5-3,0.75-0.9,0.9-1.1,1-3,1.2-1.6,1.7-2,1.75-2,1.9-2.6,12-24,2.1-2.9,3-8,4-8,5,5-6,6-8,7-15,abruptly,anther,apart,apex,appressed-pubescent,articulated,attenuate,bark,base,becoming,berry,blunt-tipped,branch,branched,broadly,brown,bud,calyx,chartaceous,cinereous,closely,cm,conical,continued,corolla,cylindrical,deltoid,densely,diameter,dichotomously,due,echinoid,elliptic,elongate,entire,fleshy,flower,fruit,glabrate,glabrous,globose,greenish,growth,hair,high,honeycombed,lateral,leaf,length,long,long-acuminate,main,margin,midvein,minutely,mm,multangulate,narrowly,oblong,obtuse,ovate-lanceolate,pale,pedicel,peduncle,petiole,porrect-stellate,probably,pseudo-terminal,puberulent,pubescent,pulverulent,reniform,reticulate-punctate,ripe,sessile,short,short-stalked,shrub,side,simple,slender,small,smooth,somewhat,spaced,stellate-pubescent,stellate-rotate,stem,stigma,style,subcampanulate,subglobose,suborbicular,tomentose,tree,tube,unarmed,vein,white,x,yellow,yellowish,young	.5-3,.75-5.25,0.6-0.9,1-1.3,1-3.75,1.1-1.3,1.2-1.5,1.6-2.1,1/3-1/2,1/5-1/2,100,3-6,4.5-9,abaxially,absen,acuminate,acute,adaxiall,adaxially,ag,anthesi,apical-lateral,apparently,appressed,axe,axillary,ba,blade,dehiscing,eaf,echinoi,eed,filament,free,inserted,introrse,large,lobe,lobed,long-exserted,longitudinal,lower,minute,mostly,nflorescence,older,orolla,ovate,perfect,plurifoliate,pore,pulverulen,rachi,ruit,runk,several,slit,sparingly,sparse,subcapitat,tamen,terete,testa,thick,time,toward,turn,unarme,unit,usually,vary,way,wide,ympodial	abaxial,adaxial,arrangement,branching,color,form,height,inflorescence,ovary,plant,seed,shape,size,subcapitate,surface,texture,trunk,type
623	wfo-0001030492	success	221	130	101	120	29	0.457	0.25-0.5,1-1.5,1.5-2,1.5-6,10-35+,10-50+,15-20,2,2-3,2-4,3-10,3-7,3-8,4-8,5-30+,5-7,7-18,9-11,?,anther,armed,base,branched,brown,calyx,caudate-acuminate,chartaceous,cm,coarsely,connivent,densely,diameter,elliptic,entire,erect,ferruginous-pubescent,filament,flattened,flower,forked,fruit,fully,glabrous,glandular,glandular-puberulent,globose,green,hair,lanceolate,leaf,light,lobe,margin,maturity,midvein,minutely,mm,moderately,near,often,ovate,pedicel,peduncle,perhaps,petiole,pinnatifid,pitted,plant,pubescent,ray,ripe,sessile,shape,short-stalked,shrub,simple,size,small,somewhat,sparsely,stellate,stellate-pubescent,stem,stigma,style,subcordate,surface,tapered,tip,toothed,tree,truncate,tube,unarmed,unbranched,vein,white,woody,x,yellow,yellowish	-2,.1,.5,0.1-0.5,0.1-1,0.3-0.5,0.5-1,1,1-8,1.5,10,12-25,2-2.5,2-5,25-50+,3-5,30-40+,4,4-6,4-7,5-6,abaxially,accrescent,acute,adaxiall,adaxially,also,apart,apex,apparently,articulated,axe,ba,blade,broad-based,capitat,coarse,covering,cylindrical,deeply,difoliate,directed,distall,divided,eaf,eed,eglandular,emerging,extra-axillary,female-sterile,ferruginous,first,frui,fruiting,geminat,gland,halfway,held,interpetalar,juvenile,larger,later,lateral,less,like,lobed,lon,long,longer,lower,lowering,major,midpoint,midrib,mostly,much,narrow,nearly,nflorescence,oblique,occasionally,orolla,pair,part,perfect,pore,prickle,rachi,rectangular,recurved,ruit,rusty,scattered,short,shorter,similar,sinus,slightly,sometimes,spaced,sparse,splitting,sprout,stalk,ste,stellae,straight,tal,tamen,time,tissue,uniform,unit,upper,uprigh,vary,wide,ympodial,younger,youngest	abaxial,adaxial,arrangement,bark,branch,branching,capitate,color,corolla,drying,form,growth,height,history,inflorescence,length,life,main,na,number,ovary,primary,pubescence,seed,tertiary,texture,trichome,venation,young
624	wfo-0001030509	success	220	124	101	119	23	0.459	0-3,0-5,0.1-0.3,0.3-2.5,0.8-1.2,1-1.5,1-2,1-4,1.3-2,2-2.5,2-4.2,2-4.5,2-6,2.8-3,2/3-3/4,3-4,4.5-12,4.5-8,7-9,8-16,anther,apparently,bark,base,berry,calyx,chartaceous,cm,cordate,cream,cuneate,dark,diameter,discolorous,drying,entire,filament,flattened-reniform,flower,fruit,glabrescent,glabrous,gray,green,herb,lateral,leaf,length,lobe,lobed,long,margin,marking,maturity,mauve,midvein,mm,moderately,narrow-deltate,narrow-oblong,orange,orange-brown,ovate,pair,pale,pedicel,peduncle,petiole,plant,poricidal,porrect,prickle,prickly,primary,purple,ray,rounded,shrub,simple,sometimes,spherical,stellate-pubescent,stem,style,surface,tapering,terminal,tertiary,tip,trichome,tube,unarmed,unbranched,vein,venation,way,weakly,wide,yellow,yellow-green,young	-10,-2,-6,/3,0,0-0.3,0-100,0-15,0.1,0.1-0.2,0.1-0.25,0.2,0.5-1.5,0.6-1,0.8-4,1,1-3,1-6,1.5-2,1.7-2,1/,1/3-2/3,1/4,2-3,3-10,4.5-10,5-10,5-merous,7-15,abaxially,alyx,andromonoecious,apar,apart,apex,apical,apically,articulated,becoming,blade,broad-deltate,brow,connivent,curved,densely,difoliate,distal,distance,eaf,eed,elongating,equal,erect,extending,eye,free,fruiting,geminat,gland,globular,half,herbaceous,hermaphrodite,heterostylous,inflated,infructescence,long-acuminat,long-styled,longer,lower,lowermost,mature,midpoint,naked,nflorescence,obtuse,occasional,occasionally,often,older,one,open,orolla,oung,pendulous,per,pericarp,perpendicular,portion,reduced,ruit,scar,short-styled,shorte,shorter,side,slender,smooth,spaced,sparsely,spreading,stalk,stalked,staminat,stellate,straight,subsessile,tamen,terete,time,unarme,unit,upper,usually,variously,vary,visible,woody,ympodial	abaxial,adaxial,arrangement,branch,branching,brown,color,corolla,form,growth,height,inflorescence,main,na,number,ovary,pubescence,seed,shape,size,stigma,texture,width
625	wfo-0001030511	success	166	104	89	77	15	0.536	-6,.5,0.1-0.15,0.4-0.5,0.5,0.5-0.6,0.5-1,0.8-1,1,1.5,1.5-4,4-8,5-7,acicular,anther,anthesi,apex,attenuate,bark,base,bright,calyx,cm,conical,corolla,densely,diameter,entire,filiform,flattened,glabrous,globose,growth,inflorescence,lanceolate,leaf,less,like,linear,lobed,margin,membranous,minute,minutely,mm,nearly,new,nodding,ovary,pair,pale,pedicel,peduncle,petiole,pitted,plant,poricidal,porrect,prickle,prickly,primary,pubescent,rarely,red,reniform,rounded,sessile,shiny,short-stalked,shrub,simple,sparsely,stellate,stem,stigma,style,surface,tan,tapering,thin,tip,trichome,tube,vein,violet,white,x,yellow,yellowish	0.1,1-2,4-7,4-merous,5-9,6-8,?,abaxially,absent,adaxially,almost,along,also,arising,articulated,barely,berry,brow,cell,closely,curved,deeply,deltate,difoliate,eaf,eed,either,ellipsoid,erect,especially,exserted,filament,flower,free,fruiting,geminat,internodal,leave,lengthening,lobe,long,lower,midpoint,midrib,midvein,nflorescence,noddin,older,overlappin,papillo,per,perfect,pericarp,planar,pore,portion,ray,rest,ripe,ruit,scar,sinuate,sometimes,spaced,strongly,tall,testal,toward,triangular,ud,unit,upper,visible,woody,ympodial,½,¾	brown,color,form,fruit,height,length,na,number,papillose,presence,pubescence,seed,shape,size,texture
626	wfo-0001030516	invalid_json	172	132	98	74	34	0.57	0.4-1.5,1-7,1.1-3.5,1.1-4.1,1.5-2,1.8-2.4,2-3,3-8,3-9.8,4-22,4-6,4-7,4.2-10.7,6-15,8-9,9-22,9-32,acute,apical,apically,branched,calyx,cell,cm,connate,corolla,covered,covering,cyme,darker,dehiscent,densely,diameter,dichasial,dichasially,distal,ebracteate,elliptical,flower,forked,generally,gland,globose,green,green-white,hair,half,herbaceous,interjected,introrse,lateral,leaf,leaflet,light,lobe,long,long-attenuate,make,maturing,mm,monochasial,mucilaginous,odd-pinnate,often,outline,ovate,ovoid,pedicel,peduncle,pentagonal,perennial,petiole,pilose,plant,poricidally,puberulent,pubescent,rotate,seed,short,short-stalked,size,slightly,slit,sometimes,spreading,stigma,straight,stripe,style,terminal,testal,thick,throughout,triangular,wall,wide,yellow	1-2.5,1-4,1.7,2-12,2-2.,2-4,3-6,3-6-foliat,4-4,abaxially,acumen,acuminate,adaxially,apex,articulate,base,cordate,cuneate,decurrent,digestion,diminished,dorsally,eaf,edge,eed,emoval,enzyme,exceeding,filament,first,flat,folded,globo,gradually,hair-like,honeycomb,less,living,lon,longer,lower,lunat,nflorescence,nther,oblique,orolla,pair,pattern,perfect,plan,proximal,rarely,reveal,ruit,second,sessile,seudostipule,short-petiolate,specimen,stamen,tal,tem,time,toward,triangulat,tuber-bearing,type,typically,unit,vary,whit,ympodial,¼,’	'','hair-like,'type,2-21,[,],``,abaxial,adaxial,anther,arrangement,branching,characteristic,color,form,fruit,growth,height,history,inflorescence,length,life,na,number,ovary,shape,stem,surface,texture,value,wet,white,{,}
627	wfo-0001030522	success	192	134	115	77	19	0.599	-4,-8,.2,.5,/4,0.05-0.15,0.3-0.7,0.5-0.6,1,1-1.4,1-1.5,1.7-3,2-lobed,2.5-6,3,3-4.5,3-5,4,4-9,5-10,6-7,7-10,absent,almost,anther,anthesi,apex,articulated,base,berry,brown,calyx,cell,cm,completely,cordate,corolla,cup-shaped,densely,diameter,dioecious,directed,elliptic,entire,erect,flattened,fleshy,fruit,glabrous,globose,green,growth,impressed,inflorescence,internodal,leaf,like,lobe,lobed,long,margin,mature,membranous,midpoint,minutely,mixture,mm,notably,oblique,obtuse,occasionally,often,orange,orbicular,ovary,ovate,pair,pedicel,petiole,pitted,plant,pore,poricidal,porrect,primary,pubescence,pubescent,ray,reddish,reniform,ripening,rounded,sessile,short-stalked,shrub,small,sparser,stellate,stem,stigma,style,surface,testal,tip,toward,treelet,trichome,tube,unarmed,upwardly,vein,vestigial,way,white,x	.7,0,0.3-0.4,0.5,0.5-1,0.7,0.9-1.3,1-5-2,1.5,2,2.5-2.8,20-30,3-4,4-10,abaxially,acute,adaxially,also,apart,armed,ba,bark,bearing,broad-based,brow,conical,consisting,dark,darker,dense,diamete,difoliate,eaf,eed,ellipsoid,female,filament,flower,free,fruiting,geminat,included,irregularly,juvenile,lamina,le,less,lon,lower,male,minute,new,nflorescence,obscured,per,pericarp,pistillate,planar,pollen-bearing,portion,prickle,ruit,scar,shallowly,single,somewhat,sparsely,staminate,straight,thin,ud,unisexual,unit,upper,usually,woody,ynpodial	abaxial,adaxial,arrangement,branching,color,form,height,history,length,life,midvein,na,number,peduncle,seed,shape,size,texture,young
628	wfo-0001030551	success	167	92	68	99	24	0.407	-5,0-2,0.5-1,0.6-1.5,1-2,1-2.5,1-3.5,1-4,1.5-2.5,10-20,10-40,2.5-4,3-12,3-5,3-8,4-5,5-17,adpressed,also,basal,base,blue,calyx,campanulate,chartaceous,cm,color,concave,cordate,densely,diameter,entire,fading,flower,fruit,glandular-puberulent,globose,lanceolate,lobe,long,margin,mm,moderately,oblong-fusiform,often,ovate,ovate-elliptic,pedicel,peduncle,petiole,puberulent,puberulent-pubescent,pubescent-pilose,shrub,simple,sparsely,stellate,stigma,style,subcoriaceous,triangular-elliptic,truncate,tube,unbranched,unknown,violet,x,yellowish	-12,-30,1,1-,1-10,1-5,1.5-,13.,2,2-3,2-6,2.5-5,20-25,3-,4-,4-7,4-foliat,5-6,9-20,abaxially,abruptly,absent,acuminate,acute,adaxially,aggregate,apart,ape,apex,articulated,axe,beyond,bilobe,blade,broad,cell,clavate,connective,dia,dilated,directed,distally,eaf,ed,ellipsoidal,equal,et,exceeding,exserted,fleshy,glabrous,hair,laterally,leaving,lon,lower,martinelli,narrow,narrowed,narrowly,nflorescence,nther,obtuse,orolla,ovoid,papillose,pedicellar,perfect,pilose,pore,puberulen,pubescent-pilo,rachi,radiu,remnant,ripe,round,ruit,seen,shorter,slightly,small,spaced,stamen,stone,tal,tem,thecae,time,tip,tomento,triangular,ud,unit,unknow,vary,wide,widening,ympodial	4-6,abaxial,adaxial,anther,arrangement,bilobed,corolla,filament,form,growth,height,inflorescence,leaf,length,na,ovary,plant,pubescence,seed,shape,size,surface,texture,width
629	wfo-0001030570	success	173	106	89	84	17	0.514	-1,.3-0.5,0.3-0.5,1-1.5,1-3,1-4,1-8,1.5,10-25,15-35,2-3,2-5,2-7-lobed,2-8,2.5-22,20-30,3-10,3-5,3-6,3.5-5,4-25,4-5,4-7,abaxially,acuminate,acute,adaxially,apex,apiculate,basal,base,calyx,campanulate,cm,color,connivent,cordate,diameter,eglandular,ellipsoidal,entire,flattened,flower,forked,fruit,glabrous,glandular-puberulent,globose,green,hair,lanceolate,leaf,lobe,lobed,long,margin,mm,occasionally,often,pedicel,peduncle,petiole,pilose,pinnately,pubescent,purplish,rarely,ripe,rounded,rugose,simple,sometimes,sparsely,stellate,stigma,style,subcoriaceous,submarginally,tip,tree,truncate,unbranched,unequal,unknown,unlobed,vein,white,x,yellow	0-,0.5-,0.5-1,1,1-,1-2,1-5,1.5-2.5,1/2,10-17,15-20,2-2.5,2-4,2-7,4-foliat,4/5,5-,8-,absent,aggregate,apart,ape,articulated,axe,beyond,blade,cell,connective,cylindrical,dilated,directed,distally,divided,eaf,eed,elliptic-oblong,exceeding,exserted,fleshy,glabrat,leaving,lon,lower,midrib,narrowly,near,nflorescence,nther,obtuse,orolla,ovate,ovoid,pedicellar,perfect,pilo,pore,presen,punctate,purpl,rachi,radiu,remnant,ruit,shorter,sinus,slightly,small,somewhat,spaced,stamen,stone,tal,tem,thecae,time,tomento,triangular,truncat,tube,ud,unit,vary,wide,ympodial	anther,arrangement,corolla,form,growth,height,inflorescence,length,ovary,plant,pubescence,seed,shape,size,stem,surface,texture
630	wfo-0001030580	success	230	143	87	143	56	0.378	.0,1/3,2,abaxially,acute,adaxially,anther,apex,appearing,area,attachment,attenuate,base,becoming,black,broad,brown,bud,calyx,caudate,central,channeled,chartaceous,cm,corolla,deltoid,densely,diameter,dramatically,dry,elliptic,entire,ferruginous,filament,filiform,flattened-orbicular,flattened-reniform,flower,fruit,glabrous,globose,hair,leaf,lobe,lower,margin,mature,midvein,mm,moderately,nearly,notched,ovate,pedicel,petiole,pitted,point,porrect,pubescent,raised,ray,rounded,scattered,sessile,shrub,simple,smooth,sparsely,stellae,stellate,stem,stigma,straight,style,surface,though,tip,toward,truncate,tube,unarmed,vein,white,yellow,young,×,–8	.0–6.2,.2,.3,.5,.7,/2,/3,0.2–0.3,0.3–0.4,0.3–0.7,0.4–0.5,0.4–0.7,0.6–1.1,0.6–2.1,0.7–0.8,0.9–1.2,1.2–1.5,1.3–1.5,1.3–3.0,1.5–,1.5–2.0,1.5–4.0,1.5–9.0,1.6–1.8,1.6–2.5,1.7–1.8,1–2,2.0–2.2,2.0–3.1,2.3–5.5,3,3.7–5.4,3–5,4–6,4–8,5-merou,5–5.4,6–8,8.3–10.0,adnate,ag,along,alyx,anthesi,apical,apparently,appresse,arching,around,articulate,ba,berry,blade,brochidodromous,capitat,connivent,curved,dentate,developed,difoliate,directed,distal,distally,distinct,eaf,edge,eed,either,emerging,endocarp,erect,exocarp,extending,extra-axillary,fertile,flat,flexed,free,geminat,glabrescent,glossy,gradually,homostylous,increasing,indistinct,inter-sepalar,internode,interpetalar,intersepalar,juic,lateral,laying,lon,long,longer,mainly,many,middle,midpoint,midrib,minute,much,nflorescence,oblong,orolla,per,perforate,persistent,pore,portion,potentially,probably,ruit,sepal,side,sinus,slightly,smoot,sometimes,splitting,spread,stamen,stellate-pubescent,strongly,suture,tamen,tardily,tem,thin,time,tissue,translucent,typically,ud,unit,vary,weakly,well,wide,ympodial,±90°,±aequilateral,–2.5	0.2-0.3,0.3,0.3-0.4,0.3-0.7,0.4-0.7,0.6-1.1,0.6-2.1,1-2,1.5-1.9,1.5-2.0,1.5-4.0,1.5-9.0,1.6-1.8,1.7-1.8,2.0-2.2,2.3-5.5,3-5,3.7-5.4,4-6,5-5.4,6.0-6.2,abaxial,adaxial,age,arrangement,bark,branch,branching,capitate,color,drying,form,growth,height,history,inflorescence,length,life,main,na,number,ovary,peduncle,perennial,plant,primary,pubescence,seed,shape,size,tertiary,texture,trichome,venation,width,ye
631	wfo-0001030581	success	187	133	86	101	47	0.46	1-4-celled,9,abaxial,acute,adaxial,aggregate,anther,apex,appressed,base,berry,black,bright,calyx,capitate,cell,central,cm,conical,corolla,decurrent,densely,diameter,ellipsoid,elliptic,entire,filament,flattened-reniform,flower,fruit,glabrous,globose,green,growth,herb,inflorescence,intermodal,lacking,lateral,leaf,lobe,long,margin,markedly,maturity,minute,minutely,mm,occasionally,once-branched,ovary,ovate,pair,papillate,pedicel,peduncle,petiole,pitted,plant,portion,primary,pubescent,purplish,ripe,rounded,shallow,shiny,simple,sparsely,spreading,stellate,stem,stigma,stone,straight,style,surface,trichome,tube,turning,uniseriate,vein,white,wide,yellow,yellowish	.3,.5,0.2–0.8,0.4–0.6,0.4–1.6,0.5,0.5–0.7,0.5–2.5,0.6–0.7,0.7–0.8,0.9–1,1,1.2–1.5,1.8–8,1–2,1–2-celled,1–2.5,1–4-celled,2,20–50,2–3-celled,35–45,3–4,3–5,4.5–12,4–7,4–9,5-merous,5–6,5–8,abaxially,adaxially,along,angle,angled,anthesi,apar,articulated,basal,becoming,beyond,branched,clustered,cone,denser,difoliate,drop,eaf,eed,exserted,florescence,free,fruiting,geminat,halfway,individual,later,leave,less,like,live,lobed,lon,lower,narrowly,near,new,often,outline,pentagonal,per,perfect,rachi,reflexe,reflexed,remaining,ridge,ruit,scar,shorter,slightly,somewhat,spaced,sprawlin,strongly,tall,tangled,tem,terete,testal,third,translucent,ud,unit,upper,usually,winged,woody,ympodial,–15,–5	0.2-0.8,0.3,0.4-1.6,0.5-0.7,0.5-2.5,0.6-0.7,0.9-1,1-2-celled,1-2.5,1.2-1.5,1.5,1.8-8,15,20-50,3-4,3-5,4-9,4.5-12,5,5-6,5-8,arrangement,bark,branch,branching,color,drying,form,height,history,length,life,main,midvein,na,number,pubescence,ray,seed,shape,size,tertiary,texture,unarmed,venation,width,young
632	wfo-0001030582	success	190	104	70	120	34	0.368	.5,1.5,5,acute,adaxially,anther,apex,attenuate,base,blue,branched,brown,cm,cordate,densely,diameter,dichotomously,ellipsoid,entire,evenly,extra-axillary,filiform,flattened-reniform,flower,fruit,glabrescent,glabrous,globose,internode,leaf,light,lighter-colored,like,linear-attenuate,lobe,margin,mm,moderately,narrowly,obscurely,orange,ovate-lanceolate,ovoid,pedicel,peduncle,petiole,red,ripe,rounded,shrub,simple,sinuate,slender,sparsely,stellae,stellate-pentagonal,stellate-tomentose,stem,stigma,style,tardily,thick-chartaceous,tomentose,triangular,tube,underside,visible,yellow,young,×	.1,0,0.1,0.2,0.4,0.4–0.5,0.4–1,0.6,0.8–1,1.4–2,1.5–3,10,10–12,12,1–1.5,2.5–3,2–10-branched,2–2.5,2–4.5,3.5–9.5,3–3.2,3–3.5,3–5,4–4.5,4–9-rayed,5-merou,5–8,6–8-rayed,7–11,7–20,abaxially,adaxiall,age,alyx,apart,apparently,articulated,axe,ba,becoming,blade,branch,broad,c.,capitat,caudate,closely,dark,directed,distall,eaf,eed,except,filament,finely,free,geminat,gland-tipped,hair,homostylous,initially,interpetalar,larger,later,lateral,lea,less,lon,long,lower,maturit,midpoint,midzone,minute,minutely,nearly,nflorescence,numerous,often,orolla,overtopped,part,per,perfect,pitted,plurifoliate,pore,principal,probably,ruit,sessile,shiny,short,short-stipitate,side,sinus,somewhat,soon,spaced,splitting,stellate-tomento,stipe,surface,tall,taller,tamen,tem,terminal,tip,tissue,truncate,ud,ultimate,unarme,unarmed,vary,vein,well-developed,wide,ympodia	0.4-1,0.8-1,1-1.5,1.4-2,1.5-3,10-12,2-10-branched,2-2.5,2-4.5,3-3.2,3-3.5,3.5-9.5,4-4.5,7-11,7-20,abaxial,arrangement,branching,calyx,capitate,color,corolla,form,growth,height,inflorescence,length,ovary,plant,pubescence,seed,shape,size,texture
633	wfo-0001030583	success	166	92	77	89	15	0.464	.5,0.1-0.5,0.2-1,0.3-1,0.4-2.7,0.9-3.5,1,1-1.5,1-2,1/2,2.5,2.5-3,3-4,3/4,5-6,abaxial,anther,bark,base,calyx,cm,conical,corolla,crisped,cultivar,dark,deep,dendritic,densely,dry,elliptic,flattened-reniform,form,fruit,glabrous,globose,golden,green,immature,incrassate,irregular,leaf,live,lobed,long,margin,minor,minutely,mm,narrowly,opposite,orange-red,ovary,pale,pedicel,petiole,pitted,plant,pubescent,ripe,shaped,shrub,simple,size,small-capitate,stem,stigma,style,surface,tan,tear-drop,trichome,way,white,x,yellow,young	.2,0.5-1,0.7-4.5,0.8-1,1-8,1.5-4,2.5-9,4-6,5-7,6-7,abaxially,acute,adaxially,along,anthesi,apex,ba,berry,brow,cell,closely,corky,cultivated,deflexed,dia,differing,difoliate,eaf,edicel,eed,ellipsoid,enlarged,erect,especially,filament,flower,free,frui,fruiting,geminat,included,lateral,leave,like,lobe,lon,long-rectangular,long-triangular,lower,main,major,midvein,nflorescence,occasionally,often,older,outline,overlapping,pair,papery,papillo,papillose,pericarp,planar,pore,poricidal,portion,prostrate,rest,rounded,ruit,scar,small,soon,spaced,spathulate,specimen,stout,tall,testal,thin,tip,tube,ud,uniseriate,unit,vein,woody,ympodial	adaxial,arrangement,branching,brown,color,diameter,growth,height,inflorescence,length,pubescence,seed,shape,specified,texture
634	wfo-0001030605	success	144	109	74	70	35	0.514	.5,0.3-0.5,1,1-4,1.5-2,1.5-5.5,1.7,12-19-flowered,2,2-3,2.5,5-12.5,7,anther,area,attenuate,base,branch,branched,brown,calyx,cinereous,cm,conical,coriaceous,corolla,dendritic-echinoid,dia,drying,filament,glabrate,glabrous,globose,green,growth,inflorescence,leaf,lobe,lobed,margin,minutely,mm,nearly,obovate,olive,ovary,ovate,ovoid-reniform,pedicel,peduncle,petiole,pitted,pubescent,rarely,revolute,shaped,shiny,shrub,simple,slightly,smooth,sparsely,stigma,style,surface,tear-drop,thickened,tip,trichome,tube,unifoliate,vein,white,x	.4,0.1,1/3-1/2,abaxially,acute,adaxially,almost,along,anthesi,apart,ape,apex,apical,beginning,beneath,berry,commonly,covered,cylindrical,dark,deflexed,densely,difoliate,dry,eaf,edicel,eed,ellipsoid,entire,exerted,free,fruiting,geminat,gold,inflorescenc,internodal,less,light,long,lower,material,midrib,new,nflorescence,obtuse,occasionally,opposite,otherwise,overlapping,papillate,papillosefruit,pore,poricidal,portion,reflexed,rounded,scar,scattered,slender,somewhat,soon,sparesly,tinged,tub,ud,unit,way,woody,yellow,ympodial	abaxial,adaxial,arrangement,bark,branching,color,diameter,entirely,flower,form,fruit,height,history,length,life,main,midvein,na,number,papillose,perennial,plant,primary,pubescence,ray,seed,shape,size,stem,tertiary,texture,unarmed,venation,width,young
635	wfo-0001030611	success	217	114	92	125	22	0.424	-35,0,0-0.5,0.5,0.5-1.5,1.5-10,1.5-2,1.5-3,1/4-1/3,1mm,2,2-3.5,2-4,2-6,2-7,2.2-2.5,3.5-5.5,4-8,6-9,7-25,9-30,anther,apart,articulated,base,blade,blunt-tipped,branched,broadly,calyx,campanulate,cm,coarsely,cylindrical,deltoid,densely,dentate,diameter,divergently,elliptic,elongated,erect,felty-pubescent,flower,fruit,glabrous,globose,hair,inflorescence,lacking,lateral,length,lenticular,less,lobe,long,margin,mm,oblong-tapering,orange,outline,ovate,pedicel,peduncle,perennial,petiole,pubescent,ray,resembling,ripe,sessile,short,slightly,spreading,stellae,stellate,stellate-pubescent,stigma,style,surface,tan,thin-textured,truncate,tube,unarmed,unbranched,usually,white,whitish,x,yellow,yellow-orange	-1.3,0.1-0.3,0.5-2.5,0.7-1.5,1,1-2,1-3,12-10,12-15,15,2-foliate,3,3-4,3-5,4-5,4-6,5-10,5-15,5-8,abaxiall,abaxially,acicular,acute,adaxiall,adaxially,along,apex,appearing,attenuate,axe,ba,basally,capitat,cauline,commonly,composed,connate,connivent,crowded,depressed-deltoid,development,directed,distal,distally,eaf,eed,elongate,entire,equaling,exceeding,female-sterile,filament,finally,flesh,free,geminat,glabrou,glandula,hermaphroditic,inserted,interlaced,interlobal,intermixed,larger,leaf-opposed,light,lon,long-stalked,longer,longest,lower,main,midpoint,midrib,midvein,minutely,much,nflorescence,numerous,obtuse,often,one,orolla,ovate-lanceolate,part,per,pitted,pore,predominantly,present,prickle,principal,prominent,rachi,radiu,reduced,round-tipped,ruit,section,short-stalked,short-styled,side,simple,sinus,small,sometimes,somewhat,spaced,spreading-hirsute,stalk,ste,stellate-woolly,stipitate,suffrutescent,tal,tamen,tem,termination,time,unit,vary,vein,wide,widely,ympodial	abaxial,adaxial,branching,capitate,color,corolla,form,growth,height,history,leaf,life,number,ovary,plant,pubescence,seed,shape,size,stem,texture,trichome
636	wfo-0001030624	success	170	94	75	95	19	0.441	.5,0.9-1,1-3,1.2-1.8,1.2-2,1.5-2,2-10,2-3,2.5-5.5,25-40-flowered,3-3.5,3.5-4,4.5-8,6-13,anther,anthesi,bark,base,calyx,cell,clavate,cm,corolla,dia,elliptic,extreme,falcate,filament,flattened-reniform,furcate,glabrate,glabrous,glandular,globose,green,greyish,leaf,lobed,longitudinally,minor,minutely,mm,narrowly,nearly,occasionally,outer,ovary,papillose,pedicel,petiole,pitted,planar,puberulent,shining,shrub,simple,size,small,soon,square,stem,stigma,style,surface,thickened,tip,tree,tube,wall,white,x,yellowish,yellowish-green,yellowish-grey,young	.25,0.5,0.5-1,0.5-1.5,2,3,7-9,acute,apart,apex,apiculate,appearing,attenuate,axil,ba,beginning,berry,branch,caly,decurrent,deflexed,differing,difoliate,dimorphic,distal,dry,eaf,edicel,eed,ellipsoid,end,erect,except,expanded,exserted,free,fruiting,geminat,hyaline,incrassate,inflorescenc,large,later,lateral,like,lobe,lon,long,lower,main,major,margin,material,middle,midrib,near,nflorescence,older,one,opposite,pair,pale,pore,poricidal,portion,prominent,raised,remaining,round,rugo,ruit,scar,short,slender,slightly,somewhat,spaced,straight,tall,tapering,three,ti,trichome,trunk,tuft,two,ud,unevenly,uniseriate,unit,vein,widest,woody,yellow,ympodial	abaxial,adaxial,alternate,arrangement,color,diameter,flower,form,fruit,growth,height,inflorescence,length,na,plant,rugose,seed,shape,texture
637	wfo-0001030628	success	229	144	99	130	45	0.432	.1,.2,.5,1,10+,4,abaxial,abaxially,adaxial,adaxially,age,anther,bark,base,becoming,branched,brown,calyx,capitate,chartaceous,cm,congested,connivent,cordate,dark,densely,diameter,ellipsoidal,elliptical,entire,filament,fissure,flattened,flower,fruit,glabrous,glandular,green,hair,inflorescence,juicy,lanceolate,leaf,length,light,like,lobe,lobed,long,margin,maturity,midvein,mm,moderately,multangulate-stellate,oblique,ovary,ovate,pedicel,peduncle,petiole,plant,porrect-stellate,pubescent,purple,ray,reddish,reddish-tan,reniform,rotate-stellate,rugose,shallow,shallowly,similar,simple,slightly,stalked,stellate,stellate-pubescent,stem,stigma,strongly,style,surface,tapered,thin,tree,tube,turbinate,unarmed,vein,violet,whitish-,whitish-golden,width,yellow,yellowish-green,young,×	.5–1.7,0.1–0.3,0.5–3,0.7–0.9,10–20,10–40,10–55,11–16,12–20,16–18,1–1.5,1–10,1–2,2.5–8,20–35,2–10,2–3,3.5–4,3.5–5,4–4.4,4–6,4–6.5,4–8,5-merous,5–,5–6,5–8.5,6–10,6–8,7–25,7–40,8–1,8–25,acuminate,acute,along,alyx,andromoneciou,andromonoecious,anthesi,apart,apex,articulated,axe,ba,berry,bilobe,blade,broad-based,broadly,central,curved,cylindrical,db,difoliate,directed,discolorous,distally,dried,eaf,eed,eglandular,either,extra-axillary,flowering,free,fresh,frui,fruiting,functionally,geminat,half,hermaphroditic,heterstylous,inclusion,inflated,interpetalar,knobby,longitudinal,lower,major,maturit,membranaceous,midpoint,moderate,multangulate,multiseriate,near,nearly,nflorescence,often,one,opening,orolla,part,pericarp,point,pore,portion,prickle,rachi,ratio,remaining,rounded,ruit,runk,sclerified,sessile,sharp,side,slit,spaced,sparsely,stalk,staminate,stout,straight,subtending,tamen,thick,tissue,unequal,unit,vary,woody,ympodial,–30,–5,–50,–9	0.7-0.9,10-20,10-40,10-55,11-16,16-18,2-10,2-3,3.5-4,30,4-6.5,5-6,5-8.5,50,6-10,6-8,7-40,8-10,8-25,9,arrangement,bilobed,branch,branching,color,corolla,drying,form,growth,height,history,life,main,na,number,perennial,primary,pubescence,seed,shape,size,tertiary,texture,trichome,venation
638	wfo-0001030638	success	177	106	77	100	29	0.435	0.1,0.5-1.5,0.5-2,0.7-1.5,1-1.2,1-1.5,1-2,1.4-1.7,1.5-2,1.6-2.2,2-5,3-10,3-13,4-6,8,8-11,8-9,acute,anther,bark,base,broadly,calyx,cm,corolla,cup-shaped,deltoid,dia,elliptic,exfoliating,filament,fruit,glabrous,glandular,globose,green,inflorescence,leaf,less,lobe,lobed,main,margin,minutely,mm,obovate,ovary,pale,papillose,pedicel,persistent,petiole,poricidal,red,red-glandular,roundish,rugose,seed,shape,shrub,simple,size,stem,stigma,style,surface,terminal,thickening,tip,transversely,tree,trichome,tube,vein,white,x,young	0.5,0.5-0.7,0.5-1,2-3,2-7-flowered,2.5-4,along,anthesi,apex,apically,appear,appearing,axi,axil,ba,beginning,beneath,berry,blade,branched,bud,closely,conspicuously,corky,cucullate,deflexed,densely,differing,difoliate,dry,eaf,eed,entire,erect,extending,flattened,fleshy,free,fruiting,geminat,geminate,glabrate,gre,impressed,irregular,known,lamina,large,later,lateral,like,lon,long,lower,major,material,middle,minor,near,nearly,nflorescence,occasionally,often,older,one,open,opposite,overlapping,ovoi,pair,paler,papillae,papillo,planar,pore,portion,present,prominent,rather,reddish,rest,ruit,scar,shaped,soon,spaced,speciman,straight,tall,tapering,tear-drop,thick,thickened,uniseriate,unit,usually,wall,widest,woody,ympodial	2-7,abaxial,adaxial,arrangement,branch,branching,color,diameter,drying,flower,form,grey,growth,height,history,length,life,midvein,na,number,peduncle,plant,primary,pubescence,tertiary,texture,unarmed,venation,width
639	wfo-0001030661	success	183	133	113	70	20	0.617	-24,.5,0.5-0.6,0.5-0.75,0.5-2,0.7-0.8,1-,1-1.3,1-1.4,1.2-7,1.5-2,1.5-7,12-16,2-,2-2.5,3-20,3-3.5,4-15,5-5.5,50-100+,acute,anther,anthesi,apex,articulated,attenuate,base,berry,branched,brown,calyx,capitate,cell,cm,conical,connivent,corolla,deltate,densely,diameter,ellipsoid,elliptic,entire,filament,flattened,flower,glabrous,globose,growth,inflorescence,lateral,leaf,lobe,lobed,long,loosely,many,margin,mature,membranous,minute,minutely,mm,narrowly,nodding,occasionally,onto,pair,pale,pedicel,peduncle,petiole,pitted,poricidal,primary,pubescent,rectangular,red,reddish,reniform,scattered,shiny,shrub,simple,sleeve,slender,small,sparsely,stellate,stem,stigma,strongly,style,surface,terminal,testal,thin,time,tinged,tip,tree,trichome,tube,uniseriate,vein,violet,way,white,winged,x,yellowish,½,¾	.2,0,1-.,1-1.2,1-1.5,3-4,4-6,5-10,5-merou,ag,along,alyx,ark,branch,brow,clustered,dar,denser,drying,eaf,eed,em,erec,erect,exserted,extending,free,fruiting,glabrescent,glabrou,group,ilament,insertion,lamina,lengthening,lon,lower,midrib,near,never,new,nflorescence,older,orolla,otherwise,papillo,per,perfect,pericarp,planar,platform,plurifoliat,point,pore,portion,ruit,scar,slightly,slit,spreading,tangled,twinin,ud,unit,upper,usually,vary,woody,yellow,ympodial	1-5,abaxial,adaxial,arrangement,bark,branching,color,form,fruit,height,length,na,number,ovary,papillose,plant,seed,shape,size,texture
640	wfo-0001030665	success	191	120	98	93	22	0.513	%,-5,-7,0.2-0.4,0.2-0.6,0.4-0.6,0.5-2,0.8-1.1,1-17,1-2,1.1-2.8,1.5-2.5,1.5-3,1.6-4.5,2-16,2-5,2.5-3.5,20-30,3-3.8,3-5,5-8,6-8,acicular,anther,base,broad-based,brown,calyx,campanulate,chartaceous,cm,cordate,cylindrical,deeply,deflexed,deltate,depressed-globose,diameter,ellipoidal,elliptical,extra-axillary,flower,flushed,fruit,glabrous,globose,green,greenish,grey,grey-green,herbaceous,inflorescence,lamina,lateral,leaf-opposed,length,light,lilac,lobed,long,longer,margin,mesocarp,midvein,minutely,mm,obtuse,ovate,pale,papery,pedicel,peduncle,petiole,present,prickle,prostrate,puberulent,purple,rather,resprouter,reticulate,rotate,sparsely,sprawling,stigma,straight,style,surface,thin,throughout,time,tube,unbranched,unifoliate,vein,wide,x,yellow	0.5-1,0.5-11,0.7-1,1-4,1.4-1.7,1.5-2,10-200,2-3,2-6,2-8,2.3-10,2.5-9,3-10,4-5,5-merou,abaxially,absen,absent,abundant,accrescent,acute,adaxiall,adaxially,adult,alyx,apex,appearance,appessed,armed,articulated,axe,ba,blade,branche,broad,capitat,cut,decimetre,depression,directed,distall,dr.,eaf,eed,filament,finally,finger,folded,fruiting,geminat,give,gland-tipped,hair,half,homostylous,index,interpetalar,inward,less,lobe,lobing,lon,lower,mature,minute,nflorescence,oblique,orolla,part,per,perfect,pore,rachi,reflexed,rounded,ruit,scarcely,short,side,simple,sinus,stage,stellate-campanulate,tal,tamen,tem,thick,tissue,unit,uvenile,vary,ympodial,¾	abaxial,adaxial,arrangement,capitate,color,corolla,dry,form,growth,height,history,leaf,life,ovary,plant,presence,seed,shape,size,stem,texture,width
641	wfo-0001030676	success	220	114	86	134	28	0.391	-1.6,0.4,0.6-1.2,1.1-1.4,1.1-1.9,1.2-1.3,1.7-2,14-17,16,19-35,2.1-2.6,2.2-5.7,2.75-3.25,3-5,3-6,4-6,4-6.5,7-8,7-9,8-10,8-12,abaxially,adaxially,anther,appressed-tomentose,branched,brown,calyx,cm,conical,corolla,deltoid,diameter,dichotomously,echinoid,finely,flower,fruit,glabrescent,glabrous,granular-tomentose,green,growth,hair,honeycombed,leaf,length,lobe,midvein,minutely,mm,nearly,oblong,oblong-elliptic,openly,ovate,pedicel,peduncle,petiole,probably,reniform,reticulate-punctate,ripe,scabrous,sessile,short-stalked,shrub,simple,small,stellate,stem,stigma,style,subcampanulate,subglobose,suborbicular,tree,tube,vein,velutinous,white,whitish,x,yellow,yellowish,young	-2.5,-3.9,-8.5,/10-1/5,0-100,1,1-1.2,1-3,1.3-1.5,1/4,11-14,2.1-2.3,2.4-3.1,2.5-5.5,3-3.5,7-10,abruptly,acute,along,angled,anthesi,apart,apex,apical-lateral,apparently,appearing,articulated,axillary,ba,bark,base,becoming,berry,blade,blunt-tipped,branch,bud,chartaceous,closely,continued,crown,cylindrical,dehiscing,densely,due,eaf,echinoi,eed,elongate,entire,except,exserted,filament,flat-topped,fleshy,forming,free,glabrescen,globose,greenish,grooved,high,horizontal,initially,inserted,introrse,lackin,lamina,large,lateral,lengthen,lined,lobed,long,longitudinal,longitudinally,lower,main,margin,midvei,minute,moderately,mostly,multangulate,nflorescence,oblique,obtuse,occasional,often,older,opening,orolla,ovate-lanceolate,parallel,perfect,plurifoliate,pore,pseudo-terminal,pubescent,pulverulent,rachi,rather,ray,ridged,ruit,runk,scattered,short-attenuate,side,slit,somewhat,spaced,sparsely,spreading,stellate-pubescent,strongly,subcapitat,tamen,tending,terete,testa,thick,thin,time,tip,tomentose,tuft,unarme,unit,usually,vary,way,wide,ympodial	3-3.9,50-100,abaxial,adaxial,arrangement,branching,color,form,height,history,inflorescence,life,na,number,ovary,perennial,plant,primary,pseudoterminally,pubescence,seed,shape,size,subcapitate,surface,texture,unarmed,ye
642	wfo-0001030686	success	182	131	106	76	25	0.582	.2,.5,1-1.1,1-1.2,1-1.5,1.2-1.5,1.5-4.5,1.6-3,15,2-2.5,2-3,2-6.5,2.5-4,2.5-8,3-3.5,5-12,5-25,5-30,5-6,8-9,acute,anther,apex,bark,basal,base,berry,bifid,black,brittle,brown,c.,calyx,centre,cm,conical,corolla,cup-shaped,dark,darker,deeply,densely,diameter,dry,drying,elliptic,entire,filament,flattened,flower,form,fruit,globose,golden,half,height,leaf,lepidote,lilac,lobe,lobed,long,margin,maturity,midvein,minutely,mm,oblique,orange,ovary,pair,pale,paler,papillose,pedicel,peduncle,petiole,pitted,plant,poricidal,primary,pubescent,purple,seed,shallowly,shiny,short,simple,sparsely,spreading,stem,stigma,style,surface,thin,time,tip,tree,trichome,tube,uniformly,usually,vein,way,x,yellow	.5-1,0.5-1,1-2,1.5-2,1972,?,abaxially,aborted,abruptly,acuminate,adam,adaxially,age,anthesi,apart,beneath,branched,breast,bu,closely,denser,different,difoliate,discolorous,eaf,edicel,eed,empty,erect,exerted,fide,fragrant,free,fruiting,geminat,glabrescen,glabrous,heteromorphic,internodal,lamina,leaf-opposed,lengthening,less,lower,many,midrib,nflorescence,noddin,older,overlapping,papillae,pericarp,planar,pore,portion,pubescen,rachi,ruit,scar,scarious,shallow,slightly,slit,somewhat,space,spaced,stellate,strongly,styl,tissue,ud,unit,visible,woody,ympodial,–	abaxial,adaxial,arrangement,branch,branching,color,glabrescent,growth,history,inflorescence,length,life,main,na,number,pubescence,ray,shape,size,tertiary,texture,unarmed,venation,width,young
643	wfo-0001030696	success	202	111	89	113	22	0.441	%,.5,0-0.1,0.1-0.3,0.4-0.6,0.8-1.2,0.8-1.5,0.8-1.8,0.9-1.5,1-2.5,1-9,1.5-2,1.5-3,10-16,12-18,2-5.5,3-4,3-6,3.8-4,4-4.5,4-7,7-10,8-18,absent,acicular,anther,armed,calyx,chartaceous,cm,cylindrical,deltate,densely,diameter,eglandular,elliptical,flower,fruit,glabrous,gland-tipped,globose,green,hair,herbaceous,inflorescence,lamina,lanceolate,lateral,length,long,longer,mid-point,midpoint,mm,moderately,nearly,ovate,pale,pedicel,peduncle,petiole,plant,porrect,prickle,prostrate,pseudo-umbellate,ray,resprouter,sessile,short,simple,solitary,sparsely,sprawling,stalk,stellae,stellate,stellate-pubescent,straight,style,thick,time,tube,unbranched,white,wide,x,yellow,yellowish	0-3,0.05-0.2,0.1-0.4,0.2-1,0.3-1.1,0.5-3,0.7-1,0.7-1.1,0.8-1.3,0.8-1.7,1,1-1.5,1-3,1-4,1.6-2.2,10-50,2-3-foliate,2-4,2-8,2-locular,2.3-4,2.5-6,20-35,4-17,4-8,5-merou,abaxially,absen,accrescent,across,acute,adaxiall,adaxially,adult,alyx,andromonoecious,apart,apex,articulated,ascending,axe,ba,base,blade,branche,brown,contiguous,cross-section,cuneate,decimetre,deeply,directed,distall,distally,distributed,eaf,eed,exocarp,extra-axillary,filament,finger,frui,fruiting,functional,geminate,half,heterostylous,index,juicy,less,lobe,lobed,lobing,lower,margin,markedly,mature,mesocarp,midvein,minute,moist,nflorescence,oblique,obtuse,onl,orolla,part,per,placenta,pore,present,probably,rachi,ruit,semi-circula,side,spaced,sparse,stage,strongly,tal,tamen,tem,thicker,thicknes,throughout,unit,usuallu,uvenile,vary,vein,winged,ympodial	abaxial,adaxial,arrangement,branching,color,corolla,form,growth,height,history,leaf,life,ovary,pubescence,seed,shape,size,specified,stem,stigma,texture,width
644	wfo-0001030699	success	195	138	110	85	28	0.564	-13,-8.5,0,0.5-0.7,1-2,12-15,2-3,2-4,2.5-3,3-10,3-5,4-5,4-6,4-7,5-6,6-,8-10,9-11,acute,anther,apical,apically,armed,bark,basal,base,berry,blue,branched,brown,calyx,clavate,cm,cordate,corolla,corymbose,cyme,densely,diameter,entire,filament,flower,glabrous,glandular,glandular-lanate,globose,green,greenish,grey,growth,half,hirsute,inflorescence,juvenile,lanate,length,like,linear-lanceolate,lobe,lobed,lobed-angulate,long-styled,many,margin,middle,minute,mm,nearly,ovary,ovate,ovate-elliptic,ovate-lanceolate,pedicel,peduncle,petiole,plant,poricidal,porrect,pubescence,pubescent,purple,ray,rusty,sessile,short-styled,shrub,simple,stalked,stellate,stellate-puberulent,stem,stigma,style,subcoriaceous,subrounded,subscabrous,subsessile,surface,tapering,time,tip,tomentose-lanate,trichome,tube,vein,velutinous,winged,x,yellow,¼	0.2-0.3,1-1.5,1.4-1,1.5-2,1/10,1/6,11-12,2-2.5,2-5,3-6,4-6-celled,5,abaxially,adaxially,anthesi,antrorse,apart,apex,articulated,brow,cell,compressed,curved,decurrent,discolorous,distal,eaf,eed,elongate,erect,exserted,foliaceous,free,fruiting,golden,heterostylous,immersed,induman,known,lengthening,long,lower,midpoint,mixed,multangulate,multicellular,new,nflorescence,older,onto,ovoid,papillat,partially,perfect,pericarp,plurifoliat,pore,portion,prickle,prickly,rarely,red,reduced,reflexed,rotate,ruit,scar,single,slightly,slit,spaced,sparsely,staminate,straight,subscandent,tall,ud,unevenly,unit,upper,villous,without,wood,yellowish,ympodial	abaxial,adaxial,arrangement,branch,branching,color,drying,form,fruit,height,history,leaf,life,main,midvein,na,number,papillate,primary,seed,shape,size,tertiary,texture,unarmed,venation,width,young
645	wfo-0001030709	success	217	120	95	122	25	0.438	-9,0.1-0.2,0.2-0.5,0.7-1,1-1.2,1-1.6,1-4.5,1.3-1.4,1.6-2.1,1.9-2.8,2-6,2.3-3,5-10,5-20,5-6,6-21,6-7,6-8,7-9,8-11,anther,apically,apparently,bark,base,branched,calyx,chartaceous,cm,cordate,diameter,discolorous,drying,dull,elliptic,erect,filament,finely,flattened-reniform,flower,fruit,glabrescent,glabrous,inflorescence,lateral,leaf,length,lobe,lobed,long,margin,maturity,mauve,midvein,mm,moderately,narrow-deltate,orange-brown,pair,pedicel,peduncle,petiole,pitted,poricidal,porrect,primary,purple,ray,red-green,seed,shrub,simple,size,sparsely,spherical,stalked,stellate-pubescent,stem,style,surface,tapering,terminal,tertiary,tip,trichome,truncate,tube,unarmed,variously,vein,venation,weakly,wide,yellow,yellow-green	-2,-5,0,0-,0-20,0-30,0.15-0.5,0.3-1.5,0.4,0.8-4,0.9-1.5,1-6,1.4-2,1/2-2/3,1/3-1/2,1/4,1/4-1/3,10-14,10-50,2-4,2-5,2-8,2/3-3/4,3-,4-5-merous,5-7,5-9,6-10,7-8,8-15,abaxially,acuminate,acute,adaxially,almost,alyx,ame,apar,apart,ape,apex,articulated,berry,blade,bright,broad-deltate,brow,c.,conical,connivent,cuspidate,deltate,distance,eaf,edge,eed,elongating,equal,extending,free,fruiting,increasing,infructescence,lanceolate,lengt,lobing,lon,long-acuminat,longer,lower,mature,middle,midpoint,nflorescence,occasionally,often,older,one,open,orolla,oung,pendulous,per,perfect,pericarp,perpendicular,pit,plurifoliat,portion,prickl,prickle,prickly,red-orange,reflexed,retrorse,rounded,ruit,scar,secondary,short-styled,shorter,side,slender,smooth,sometimes,spaced,spreading,stalk,stellate,straight,tamen,terete,time,toward,unit,upper,usually,vary,visible,way,woody,ympodial	abaxial,adaxial,arrangement,branch,branching,brown,color,corolla,form,growth,height,history,life,long-acuminate,main,na,number,ovary,perennial,plant,pubescence,shape,stigma,texture,young
646	wfo-0001030714	success	178	130	118	60	12	0.663	-3,.2,/3,0.1-0.3,0.5,0.5-0.8,0.5-1.9,0.7-0.8,1-1.2,1-1.5,1-2.5,1.2-1.5,1.2-4,1.4-3.5,1.5-2,1/3,2-2.5,2-2.6,3-3.5,3-7,5-100,5-6,7-17,acuminate,acute,adaxially,age,along,anther,apex,articulating,bark,basal,base,beneath,berry,blue,blue-black,branching,calyx,clavate,cm,conical,cordate,corolla,dark,diameter,elliptic,entire,especially,except,flattened,flower,fruit,glabrous,globose,greyish,growth,herbaceous,leaving,lengthening,liana,like,lobe,lobed,long,many,margin,membranous,midrib,minute,minutely,mm,narrowly,new,ob-ellipsoid,ob-elliptic,oblique,ovary,overall,pair,pale,papillate,pedicel,peduncle,peg,petiole,pore,poricidal,primary,pubescent,quadrate,reniform,ripe,shape,simple,slightly,slit,sparsely,stellate,stem,stigma,style,surface,thickened,time,tip,trichome,truncate,tube,uniseriate,vein,vine,violet,way,woody,x,yellow	.5,0.3-0.4,0.8-1,1-1.3,20,>,abaxial,abaxially,aid,anthesi,apar,becoming,campanulate,climbin,cup,densely,denser,eaf,eed,ellipsoid,exserted,fide,filament,free,grading,gradually,gree,howard,joined,leaf-opposed,lower,narrow,nflorescence,nodding,node,occasionally,older,paler,papillat,pedice,per,perfect,pitted,planar,plurifoliat,portion,prominent,ruit,scar,spaced,strongly,submarginal,tapering,terminal,tub,twining,ud,unit,widely,ympodial	arrangement,color,form,green,inflorescence,leaf,length,number,pubescence,seed,size,texture
647	wfo-0001030730	success	205	118	85	120	33	0.415	0.1-0.3,0.5-1,0.8-4.4,1-1.2,1-1.7,1.5-4.5,2-2.5,2-2.9,2-4,2.3-6,2.5-7,3-15,4-11,4-7,5.5-14.5,5.5-6.5,7-8,9-10.5,9-15,anther,attenuate,base,calyx,chartaceous,cm,cuneate,deltate,densely,depressed,diameter,entire,filament,finally,flower,fruit,glabrous,globose,green,grey,herbaceous,inflorescence,lanceolate,later,length,light,lobe,lobed,marbled,margin,midvein,minutely,mm,obtuse,ovate,pale,pedicel,peduncle,perennial,petiole,pink,pseudo-racemose,purple,ray,resprouter,rhizomatous,rugose,shallowly,shrub,simple,smooth,stellate,stellate-pubescent,stigma,style,subcordate,surface,toward,tube,unarmed,unbranched,vein,x,yellow,yellow-brown,yellowish-green	%,0-0.8,0-1,0-1.2,0-1.6,0-6,0.05-0.1,0.05-0.2,0.5-0.9,0.6-1.2,0.7-1.2,0.8-1.2,1-10,1-3,1-8,1.1-1.9,1.7-2.3,10,11-17,11-20,15-60,2-5,2-8,2-foliate,240-700,3-20,4-locular,5-40,5-merou,abaxially,absent,accrescent,acicular,across,acute,adaxiall,adaxially,alyx,apart,apex,armed,articulated,ascending,axe,ba,blade,bony,connivent,curved,cylindrical,d.,directed,distall,distributed,drooping,eaf,eed,eglandular,extra-axillary,finger,first,fruiting,geminate,glabrou,gland-tipped,hair,half,hard,lamina,lateral,less,lon,long,longer,loosely,lower,mature,mid-point,midpoint,minute,nflorescence,oblique,orolla,part,per,perfect,pore,porrect,presen,present,prickle,probably,rachi,ridged,ruit,rusty,short,slightly,spaced,sprawling,spreading,stage,stalk,stellae,straight,tal,tamen,tem,thick,throughout,time,truncat,unit,unknow,uvenile,vary,white,wide,yellowish,ympodial	abaxial,adaxial,arrangement,bark,branch,branching,color,corolla,drying,form,growth,height,history,leaf,life,main,na,number,ovary,plant,primary,pubescence,seed,shape,size,stem,tertiary,texture,trichome,truncate,venation,width,young
648	wfo-0001030733	success	130	92	71	59	21	0.546	/4,0.5-1,1-1.2,1-1.5,1-2,1.5-5,2-2.5,3-4,3-5,4-15,4.5-5,5-8-flowered,6-7,abaxially,adaxially,anther,bark,base,bi-lobed,broadly,brown,calyx,capitate,closely,cm,conical,coriaceous,corolla,dark,densely,dia,ellipsoid,elliptic,erect,glabrous,globose,green,later,leaf,lobed,long,minutely,mm,moderately,narrowly,ovary,ovoid-reniform,pedicel,petiole,pore,poricidal,pubescent,scar,shaped,shrub,simple,somewhat,spaced,stem,stigma,style,tear-drop,thick,tip,treelet,trichome,tube,uniseriate,way,x,young	.5,1.7-2.7,6-9,?,acuminate,acute,along,anthesi,ape,apex,berry,clearly,decurrent,deltate,denser,eaf,eed,elongate,embryo,exserted,filament,free,fruiting,grayish-brow,lamina,lateral,like,lobe,lon,lower,main,margin,middle,nflorescence,older,onto,opposite,overlappin,pair,papillo,planar,portion,rounded,ruit,smooth,sparsely,strongly,surface,tall,testa,ud,unifoliat,unit,vein,visible,white,widest,woody,ympodial	arrangement,branching,bud,color,diameter,flower,form,fruit,grayish-brown,growth,height,inflorescence,length,overlapping,plant,pubescence,seed,shape,size,texture,unifoliate
649	wfo-0001030751	success	226	116	89	137	27	0.394	-7,0,0-0.5,0-1,0.5-1mm,1,1-24,1-3,11-40,13-50,14-20,2-3.5,2.5-4,3-5,3-6.5,5-15,5-6,5-8,7-13,7-15,anther,attenuate,base,branched,broadly,calyx,campanulate,cm,coarsely,cordate,densely,dentate,diameter,divergently,elliptic,erect,felty-pubescent,filament,flower,form,fruit,glabrous,globose,inflorescence,interwoven,lanceolate,length,lenticular,light,lobe,margin,minutely,mm,orange,ovate,pedicel,peduncle,perennial,petiole,pitted,prickly,pubescence,pubescent,ripe,sessile,shallowly,simple,spreading-hirsute,stalked,stellae,stellate,stellate-woolly,stem,stigma,style,surface,tan,thin-textured,trichome,truncate,tube,unarmed,unbranched,variable,vein,white,x,yellow,young	-5,.2,.5,0.1-0.3,0.1-0.4,0.5-1.5,0.6-1.5,1-2,1-4,1/4-1/2,10-15,2,2-3,2-foliate,20-25,3.5-4.5,4-6,5-7,6-9,8-13,abaxially,accrescent,acute,acute-,adaxiall,adaxially,along,also,among,apart,apex,articulated,axe,ba,basally,blade,broad,capitat,cast,cauline,clas,closely,commonly,completely,connivent,covering,cylindrical,deciduou,deltoid,depressed-deltoid,directed,distal,distall,distinct,divergent,dominant,eaf,eed,elongate,entire,equaling,especially,essentially,female-sterile,finally,flesh,foliar,frui,fruiting,geminat,green,hair,inserted,interlobal,larger,lateral,leaf-opposed,less,lignescent,like,long,longest,lower,major,midpoint,mixture,mostly,multiseriate,nflorescence,numerous,obtuse-tipped,occasionally,often,one,orolla,ovate-lanceolate,per,petaloid,pore,present,prickl,prickle,principal,prolonged,purplish,rachi,ray,recurve,ruit,scattered,short,shorter,side,sinus,small,smaller,somewhat,spaced,sparsely,spreading,stalk,stellate-pubescent,stipitate,straight,tal,tamen,tem,termination,tip,tooth-like,typically,unit,usually,vary,vivo,wide,ympodial	abaxial,adaxial,arrangement,bark,branch,branching,capitate,color,corolla,growth,height,history,leaf,life,main,midvein,na,number,ovary,plant,primary,seed,shape,size,tertiary,texture,venation
650	wfo-0001030772	success	155	83	68	87	15	0.439	-2,0.2-0.8,0.5-1,0.75-1,0.9-1,0.9-3.1,1-2,1-2.5,1.2-5,1.4-1.6,1.5-2,3-3.5,3-5,4.2-6.5,5-6,9-15,anther,bark,base,beneath,bud,calyx,capitate,cm,corolla,dark,deflexed,dia,elliptic,fruit,gently,glabrous,globose,green,grey,leaf,lenticellate,lobed,long-acuminate,minor,minutely,mm,nearly,opposite,ovary,ovoid-reniform,pale,paler,papillose,pedicel,petiole,rounded,shape,shaped,shining,shrub,simple,size,stem,stigma,straight,style,tan,tapering,tear-drop,white,x,young	.05,.2,.25,.5,0.25-0.5,2-7,5-10-flowered,8-10,acuminate,acute,anthesi,apex,archin,attenuate,ba,becoming,beginning,berry,branch,closely,differing,difoliate,eaf,edicel,eed,ellipsoid,erect,extreme,filament,free,fruiting,geminat,impressed,inflorescenc,large,later,lateral,lobe,lon,long,long-triangular,lower,main,major,margin,methyl,middle,nflorescence,node,occasionally,older,one,overlapping,pair,papillo,per,pitted,pore,poricidal,portion,prominent,reflexed,ripe,ruit,salicylate,scar,slender,slightly,smelling,soon,spaced,strongly,surface,swollen,tall,tip,trichome,tube,ud,uniseriate,unit,usually,vein,widest,wintergreen,woody,ympodial	0.5,arching,branching,color,diameter,form,growth,height,inflorescence,length,na,plant,pubescence,seed,texture
651	wfo-0001030781	success	213	115	94	119	21	0.441	1-10,1-2,1.5-2,1.5-9,1.6-2.2,10-40,15-35,2-20,2.5-14,2.5-3.5,3-4,4-15,5-6,5-7,6-7,7.5-9,abaxially,adaxially,anther,apart,brown,brownish,cell,chartaceous,cm,condition,corolla,covering,dark,deep,densely,diameter,dot,drying,finely,forked,fresh,fruit,glabrous,glandular,globose,gray-green,green,greenish,hair,hair-like,herb,lanceolate,lateral,leaf,light,like,lobe,long,membranous,mm,obovate,odd-pinnate,ovate,ovate-lanceolate,ovoid,papillose,pedicel,peduncle,pentagonal,pilose,plant,poricidal,pubescent,purple,rotate-pentagonal,scattered,seed,size,small,sometimes,somewhat,sparsely,stem,stigma,style,subovoid,testal,thick,tip,tube,tuber,violet,wall,white,whitish,wide,x,yellow	0-5,0.2-4,0.5-6,0.5-8,1-1.5,1-12,1-4,1-8,1.5-12,2-3,3-6,5-8,5-merou,abruptly,acumen,ag,along,alyx,apex,apiculate,apparently,articulated,axe,axillary,base,berry,blade,borne,broadly,bud,caly,capitat,ciliate,connivent,cuneate,decreasing,decurrent,digestion,distal,dorsally,eaf,edge,eed,elliptic,end,enzyme,erect,especially,exceeding,filament,flat,flower,folded,geminat,generally,glabrou,gradually,green-white,half,high,homostylous,honeycomb-shaped,interjected,larger,leaflet,lengthening,living,low-growin,lower,make,margin,midrib,minutely,mucilaginous,narrowed,nflorescence,orbicular,orolla,pair,perfect,petiole,petiolulate,plurifoliate,pointed,pore,puberulent,rachi,rarely,removed,rounded,ruit,sessile,seudostipule,short,simple,singly,slightly,slit,spaced,specimen,stamen,ste,stolo,straight,subtending,tall,tamen,tem,terminal,throughout,toward,tri-,typically,unit,unwinged,usually,vary,wet,ympodial	abaxial,adaxial,arrangement,branching,calyx,capitate,color,form,growth,height,inflorescence,length,ovary,presence,present,pseudostipule,pubescence,shape,spacing,surface,texture
652	wfo-0001030782	success	198	115	98	100	17	0.495	0-7,0.4-1.5,1-3,1-6,1.3-1.6,1.5-2,1.5-7.5,1.6-4.6,11-47,12-30,13-22,15,2,2.2-4,3-10,4-11.6,4-6,4.6-26,5-20,6-8,7-15.6,abaxially,adaxially,anther,axillary,broadly,brownish,bud,clavate,cm,condition,connivent,coriaceous,corolla,dark,deep,diameter,distal,drying,elliptic,flower,forked,fresh,fruit,generally,glabrescent,glabrous,globose,green,greenish,hair,half,herb,interjected,lanceolate,lateral,leaf,leaflet,light,lilac,long,medium,mm,moniliform,mottled,odd-pinnate,ovate,ovoid,pair,pedicel,peduncle,pentagonal,petiole,plant,poricidal,prominently,purple,rachi,ripe,rotate,scarce,seed,short,size,stigma,style,subtending,terminal,tip,tube,tuber,usually,white,whitish,wide,winged,x,yellow	0-1,1-2,1-5,1.2-3.9,2-3,2.4-11.5,3-5,5-merou,abaxiall,acumen,acuminate,acute,ag,along,alyx,apart,apex,apparently,arranged,articulated,asymmetric,attenuate,axe,base,basiscopic,bead,berry,blade,capitat,cell,covering,cuneate,decreasing,digestion,dorsally,eaf,edge,eed,enzyme,exceeding,filament,flat,folded,geminat,glabrou,green-white,hair-like,hal,high,homostylous,honeycomb-shaped,inconspicuous,lengthening,like,living,lobe,lower,make,mucilaginous,multiple,necklace,nflorescence,orbicular,orolla,perfect,petiolulate,plurifoliate,pore,removed,rounded,ruit,second,sessile,seudostipule,side,slit,smaller,sometimes,spaced,specimen,stamen,stolon,straight,subequal,tal,tamen,tem,testal,thick,throughout,tissue,totally,toward,tri-,typically,unit,vary,wall,wet,ympodial	abaxial,adaxial,arrangement,calyx,capitate,color,form,growth,height,inflorescence,length,ovary,pseudostipule,shape,stem,surface,texture
653	wfo-0001030802	success	171	104	85	86	19	0.497	0.5-1,0.5-1.5,0.75-1,1,1-1.1,1-1.2,1-1.5,2-3,2-5,2.5-3,3-4,3-6,5-10-flowered,anther,anthesi,bark,base,beneath,brown,calyx,campanulate,cm,corolla,densely,dia,difoliate,evenly,filiform,flattened-reniform,fruit,glabrous,gland,glandular,globose,halfway,heart-shaped,incrassate,lamina,leaf,length,lobe,lobed,long,margin,markedly,minutely,mm,obconic,older,ovary,ovoid,pale,papillate,pedicel,petiole,pitted,plant,pore,poricidal,pubescent,red,reddish,shaped,shrub,simple,single-celled,somewhat,stem,stigma,style,subshrub,surface,tear-drop,tip,tipped,trichome,tube,unifoliate,uniseriate,variable,vein,white,x,yellowish,young	.3,.5,.5mm,0,0.25-0.4,0.5-0.75,0.7-1cm,0.9-1,2-2.5,3-3.5x,4-5mm,4-6,abaxially,abrupt,acuminate,acute,adaxially,along,apex,appearing,basal,becoming,beginning,berry,bud,cordate,cucullate,deeply,deflexed,denser,dry,eaf,edicel,eed,ellipsoid,except,exerted,exudate,filament,free,fruiting,geminat,glandurla,hanging,inflorescenc,internodal,invest,irregularly,later,lateral,line,live,long-triangular,lower,m.,main,material,midvein,near,nflorescence,pair,palmate,papillose,per,persistently,portion,prominent,pubescen,raised,ruit,scar,slender,soon,spaced,specimen,stigm,straight,strongly,tapering,trichoem,ud,unit,widely,woody,yellow,ympodial	0.7-1,3-3.5,4-5,abaxial,adaxial,arrangement,branching,color,diameter,flower,form,growth,height,inflorescence,pubescence,seed,shape,size,texture
654	wfo-0001030803	success	185	125	93	92	32	0.503	.5,0.2,0.3,0.5,0.75–1,1.5,10–15,1–2.5,1–3,2.5,20–40,3–10,3–4,3–5,5,6–12,6–8,abaxially,acute,adaxially,anther,anthesi,articulated,base,berry,branched,broadly,brown,calyx,campanulate,chartaceous,cm,corolla,diameter,elliptic,entire,filament,flattened-reniform,flower,glabrous,globose,green,hair,imparipinnately,leaf,leaflet,light,lobe,lobed,long,margin,minute,minutely,mm,ovate,papillae,pedicel,peduncle,petiole,pinnate,pinnatifid,pitted,present,puberulent,ranging,rarely,rounded,rugose,shape,side,simple,size,slender,stellate,stem,stigma,strongly,style,surface,tapering,terminal,truncate,tube,variable,variously,vein,vine,yellow,yellowish,×,–10,–16,–5	0.2–0.3,0.4,0.5–1.5,0.9–1.5,1,1-,1.5-,1.5-3,1/3,10967,2–,3-6,4–10,7–9,?,absent,acuminate,adaxiall,adjacent,ag,almost,alyx,apex,armed,axe,basal,becoming,blade,bud,confluent,connecting,connivent,corresponding,dr.,eaf,eed,elongating,equal,exserted,fruiting,hinton,internode,lanceolate,lateral,lengthening,long-styled,lower,major,middle,midri,midrib,narrowly,nflorescence,often,orolla,outline,pericarp,petiolule,plurifoliat,pointed,pore,poricidal,prickle,purple,rachi,recurve,recurved,ruit,sharply,slit,somewhat,spreading,stout,straight,subwoody,swolle,tamen,time,tip,tissue,triangular,truncat,turbinate,unit,usually,vary,wide,widest,wing,wood,woody,ympodial	abaxial,adaxial,arrangement,bark,branch,branching,color,dry,drying,form,fruit,growth,history,inflorescence,length,life,main,midvein,na,number,ovary,plant,primary,pubescence,seed,tertiary,texture,trichome,unarmed,venation,width,young
655	wfo-0001030809	success	154	86	67	87	19	0.435	0.5-1,1.2-1.4,1.4-1.5,1.5-3.5,20-60-flowered,4.5-5,6-8,8,9.9-12,anther,bark,base,beneath,branched,broadly,calyx,clavate,cm,corolla,curl-tipped,curved,deltoid,densely,dia,elliptic,falcate,filament,fruit,glabrous,globose,golden,green,leaf,like,lobed,long,minutely,mm,nearly,ovary,ovate,pedicel,petiole,poricidal,pubescent,several,shining,simple,size,slightly,stem,stigma,straight,style,time,tip,tomentose,tree,triangular,trichome,tube,unequal,uniseriate,white,x,yellow-brown,young	.5,0.2,1-1.25,1-1.5,1.5-2.4,2-2.5,2.3-5.5,5-8,across,acute,along,also,anthesi,apar,apex,appearing,berry,caly,campanulate,dark-papillo,deciduous,deflexed,dense,difoliate,distally,eaf,edicel,eed,ellipsoid,erect,especially,evenly,exserted,free,fruiting,geminat,hair,hidden,interpetalar,known,large,lateral,leave,lobe,lon,long-papillose,lower,main,major,markedly,mature,membranous,middle,midrib,minor,nflorescence,older,one,opposite,overtopping,planar,pore,portion,present,round,ruit,scar,scattered,shinin,shoot,sinus,slender,small,soon,spaced,tall,tapering,terminal,three,two,ud,underside,unit,vein,wide,widest,ympodial	0.5,2,arrangement,color,dark-papillose,diameter,flower,form,growth,height,inflorescence,length,na,plant,pubescence,seed,shape,surface,texture
656	wfo-0001030810	success	191	103	65	126	38	0.34	0.2,0.4,abaxially,adaxially,along,anther,bipinnate,blue,branched,brown,calyx,clavate,cm,cylindrical,dark,densely,denser,diameter,elliptic,elliptical,erect,flattened,fleshy,fruit,glabrous,globose,hair,leaf,long,midvein,mm,moderately,multicellular,oblong,occasionally,pale,pedicel,peduncle,pentagonal,petiole,pinnate,pitted,pubescent,shallowly,shiny,shrub,simple,size,stem,stigma,straight,style,subglabrous,surface,time,tomentose,tube,unicellular,uniseriate,unknown,violet,white,woody,x,yellow	0.2–0.3,0.3,0.5–,0.5–0.8,0.6–1.0,0.7–1.4,0.8–5.5,0.95–2.0,0–,1,1.0–1.5,1.0–2.0,1.0–3.0,1.1–2.0,1.1–2.2,1.2–1.5,1.5–1.9,1–2,1–3,1–5,2.9–4.5,20–100,2–3,2–4,3.0–5.0,3.3–5.5,3.3–8.5,3.5–4.6,3–19,4–14,4–5,4–7,5,5–15,5–30,5–32,6–10,6–22,7–10,7–11,8–10,absen,accrescent,acute,adaxiall,ag,anthesi,apart,apex,articulated,axe,axillary,ba,base,blade,borne,cell,chartaceous,colour,connivent,decreasing,divided,eaf,eed,equal,especially,filament,flower,geminat,green,greyish,half,hig,indumentum,irregular,leafy,lobe,lon,longitudinal,lower,m.,margin,midrib,narrow,nflorescence,obtu,older,opening,opposed,orolla,oung,pair,perfect,pinnae,plurifoliate,pore,poricidal,primary,rarely,reflexed,rounded,ruit,secondary,shaped,shoot,side,slit,sometimes,spaced,sparsely,stone,tamen,tardily,tear-drop,tip,unit,vary,wide,wing,ympodial,–2.5,–3,–3.4,–4.5,–5.0,–8	0.2-0.3,0.8-5.5,1-2,1.0-1.5,1.0-2.0,1.1-2.2,1.2-1.5,1.5-1.9,2.5,2.9-4.5,20-100,3,3.3-5.5,3.3-8.5,3.5-4.6,4-14,4-7,5-32,5.0,7-10,8-10,abaxial,adaxial,arrangement,color,corolla,form,growth,height,inflorescence,length,na,plant,pubescence,seed,shape,texture,young
657	wfo-0001030814	success	223	115	97	126	18	0.435	.5,.5-3,0-0.3,0.4,0.5-1.5,1.5,1.8-3.5,10-12,15-20,16-30,2-3,23-31,3-5,4-5,5-12,5-15,5-9,5.5,6-15,6-9,7-11,7.5-11,almost,anther,attenuate,base,becoming,broadly,calyx,campanulate,cm,connivent,cultivated,densely,diameter,divided,elongating,essentially,felty,flower,form,fruit,glabrescent,glabrous,globose,immature,inflorescence,interwoven,lanceolate,length,lenticular,lignescent,lobe,long,midvein,minutely,mm,narrower,obsolete,oval,ovate,ovoid,pedicel,peduncle,perennial,petiole,pitted,pubescence,pubescent,ripe,sericeous,sessile,short,short-stalked,simple,simple-,somewhat,soon,specimen,stellae,stellate,stellate-,stellate-pubescent,stem,stigma,style,tan,thin-textured,tube,unarmed,unbranched,unknown,weakly,white,x,yellow,young	-0.5,-1.5,-3.5,-4,0-0.2,0.1-0.2,0.1-0.3,0.3-0.6,1-2,1-4,1.5-2,1/8-1/3,10-25,14-15,15-16,2-foliate,3-7,4-,4-6,5,5-8,6-locular,abaxially,absent,acute,acute-tipped,adaxiall,adaxially,along,apart,apex,apiculate,appressed,articulated,ascending,asymmetric,axe,ba,basal,become,blade,branched,bulge,capitat,capitate-glandular,coarsely,cylindrical,dentate,depressed-deltoid,developed,diffusely,directly,distal,distall,divergently,eaf,eed,elongate,entire,extra-axillary,female-sterile,filament,geminat,hair,hirsute,inserted,interlobal,intermixed,invested,lateral,less,lon,lower,major,margin,mature,midpoint,minute,much,nflorescence,obtuse,obtuse-tipped,often,orolla,oung,ovate-lanceolate,per,pericarp,pore,prominent,rachi,ray,replaced,rip,rounded,ruit,scattered,shorter,side,similar,simple-haired,sinus,slightly,small,sometimes,spaced,spreading,stalk,stellate-pubescen,strongly,swollen,tal,tamen,termination,time,trichome,truncate,unarme,uniseriate,unit,usually,vary,vein,weak,wide,ympodial	abaxial,adaxial,arrangement,branching,capitate,color,corolla,growth,height,leaf,na,ovary,plant,seed,shape,size,surface,texture
658	wfo-0001030822	success	146	86	71	75	15	0.486	0.1-0.2,0.4,0.5-1.5,0.8-1,0.9-1,1-1.5,1.5-2,11-15.5,2-2.5,2-5,3-3.5,3-5,3.5-7,5-6,abaxially,adaxially,anther,base,calyx,clavate,cm,corolla,cup,dia,elliptic-obovate,erect,filament,filiform,flattened-reniform,flower,glabrous,globose,green,inflorescence,leaf,lobed,margin,minutely,mm,nearly,older,open,ovary,pale,papillose,pedicel,petiole,pitted,poricidal,red-papillose,revolute,shaped,shiny,shrub,simple,size,stem,stigma,strongly,style,surface,tan,tapering,tear-drop,tip,tube,white,winged,x,yellowish-brown,young	.2,0-0.5,0.4-1,1-1.2,2-3.8,5-7,8-9,acute,anthesi,apex,attenuate,ba,beneath,berry,broadly,closely,clustered,completely,cucullat,cucullate,decurrent,deflexed,deltate,differing,difoliate,eaf,edicel,eed,exserted,fleshy,free,fruiting,geminat,incrassate,inflorescenc,internodal,later,lateral,lobe,lon,long,long-ellipsoid,lower,main,major,middle,minor,minute,near,nflorescence,occasionally,onto,opposite,pair,papillo,perhaps,planar,pore,portion,present,ruit,scar,slightly,somewhat,spaced,sparsely,tall,ud,unit,usually,vein,widest,woody,yellowish,ympodial	branching,color,diameter,form,fruit,growth,height,length,na,plant,pubescence,seed,shape,sparingly,texture
659	wfo-0001030846	success	214	138	113	101	25	0.528	-0.8,-11,-4,0.1,0.2-0.4,0.5-0.7,0.8-1,1-2,1-2.5,1-3,1-4,1.5-2,10-15,2-3,2.5-3,3-,3-3.5,4-4.5,4-6,5-15,5-8,6-18,6-8,8-10,abaxial,adult,angulate,anther,armed,assymetric,bark,base,beige,berry,branching,brown,brownish,calyx,chartaceous,clavate,cm,corolla,cream,cuneate,dark-green,decurrent,diameter,elliptic,entire,filament,flattened,flower,fruit,glandular,glandular-viscous,grey,growth,hirsute,inflorescence,juvenile,leaf,linear-lanceolate,lobe,lobed,many,margin,mm,much-branched,nearly,oblanceolate,oblong,obovate,opposite,ovary,ovate-elliptic,pedicel,peduncle,petiole,plant,poridical,porrect,puberulent,pubescence,pubescent,ray,red,reniform,rhombic,rugose,rusty,scabrous,shrub,simple,slightly,sparsely,stellate,stem,stigma,style,subglobose,surface,time,tip,tomentose,tomentose-velutinous,trichome,tube,unarmed,undulate-reticulate,white,x,yellowish,young	.3,0.1-0.3,0.2-0.5,1-1.2,1-1.5,1-2-celled,1-multicellular,2-10,3/4,4-5,abaxially,acuminate,acute,adaxially,anthesi,anthesisflower,antrorse,apart,apex,apical,articulating,basal,curved,deciduous,densely,discolorous,distal,eaf,eed,erect,exserted,ferruginous,free,fruiting,glabrescent,gland,golden,heterostylous,lanceolate,larger,lateral,lengthening,like,linear,long,long-styled,longer,lower,midpoint,midrib,mixture,multiangulate,multicellular,near,new,nflorescence,obliqu,obverse,ochraceous,older,oval,papillat,pendant,perfect,pericarp,persistent,plurifoliat,pore,portion,prickle,prickly,prominent,rachi,raised,reddish,reflexed,relatively,rest,rotate,ruit,scar,sessile,short,short-styled,similar,slit,sometimes,stalked,staminate,stipitate,straight,terete,testa,thick,ud,unit,upper,wide,without,ympodial,¼	adaxial,arrangement,branch,color,drying,form,height,history,length,life,main,midvein,na,number,papillate,perennial,primary,seed,shape,size,tertiary,texture,vein,venation,width
660	wfo-0001030850	success	240	143	119	121	24	0.496	0-30,0.1-0.4,0.1-0.5,1-2,1-2.5,1-8,1.5,1/2-3/4,1/3,2-25,2-3,3-10,3-3.7,3-5,3.5-6,4,4-8,5-10,5-12,5-13,6-11,7-15,7-22,8-20,8.5-11.5,abaxial,adaxial,anther,apparently,bark,base,berry,branched,bright,broad-deltate,calyx,cell,chartaceous,climber,cm,connivent,cordate,cuneate,deltate,densely,diameter,discolorous,drying,elliptic,elongate,filament,flattened-reniform,flower,fruit,glabrescent,glabrous,gray,green-brown,lateral,leaf,length,lobe,lobed,long,margin,maturity,mauve,midvein,mm,moderately,often,orange,orange-brown,outline,ovate,pair,pedicel,peduncle,petiole,pit,plant,poricidal,porrect,prickle,primary,purple,raised,ray,red-green,red-orange,scandent,sessile,shrub,simple,small,smooth,sometimes,sparsely,spherical,stalked,stellate,stellate-pubescent,stem,style,surface,tapering,terminal,tertiary,tip,trichome,truncate,tube,upper,vein,venation,way,wide,yellow,young	-6,.5,/4,0-,0-0.5,0-40,0.1-0.2,0.1-0.3,0.2,0.5-2,00,1-,1-10,1-20,1-3,1-4,1-5,1.2,1.5-2.5,1/2,1/2-1/5,1/3-3/,1/3-3/4,10-100,10-20,15-20,2-15,2-4,2-6,3-15,3-4,3-6,5-merous,6-8,abaxially,acuminat,acuminate,acute,alyx,andromonoecious,apar,apart,apex,apically,articulated,blade,broadly,brow,cream,curved,dark,difoliate,distal,distance,eaf,eed,elongated,elongating,entire,equal,erect,extending,flattened,free,fruiting,geminat,gently,green,hermaphrodite,heterostylous,infructescence,lobing,long-styled,longer,lower,lowermost,marking,mature,midpoint,nflorescence,oblong,obovate,obtuse,older,one,open,orolla,oung,pale,pendulous,per,pericarp,portion,prickl,prickly,pubescent,red-brown,reduced,rounded,ruit,scar,secondary,short-styled,shorter,side,somewhat,spaced,spreading,stalk,staminat,stout,straight,tamen,terete,time,unit,variously,vary,visible,woody,ympodial	arrangement,branch,branching,brown,color,corolla,dense,form,growth,height,inflorescence,main,na,number,ovary,pubescence,seed,shape,size,stigma,texture,unarmed,width,ye
661	wfo-0001030867	success	259	147	122	137	25	0.471	.5,0.5,0.6-1.5,1-1.5,1-2,1-2.5,1.5-4.5,10,12-15,14,18,2.5-3,2.5-3.5,3-4,3-5,3.5-8.5,4-4.5,4-6,4.5-14,5-6,6-7,<,abundant,anther,armed,attenuate,bark,base,berry,branched,brown,calyx,chartaceous,cm,concolorous,corolla,cup-shaped,dark,densely,diameter,drying,elliptic,erect,expanded,filament,flower,fruit,glabrous,globose,green,greyish,growth,herbaceous,immature,inflorescence,interpetalar,lateral,leaf,leathery,length,like,lobe,lobed,long-styled,margin,markedly,mature,membranous,midvein,mm,mottled,narrowly,opposite,outline,ovary,ovoid,pair,pale,pedicel,peduncle,pentagonal,petiole,plant,primary,pubescent,ray,reniform,rest,sessile,shallowly,short-stalked,short-styled,shrub,simple,sinuate,size,slightly,somewhat,sparsely,stellate,stellate-pubescent,stem,stigma,style,subshrub,surface,tan,tapering,thick,tip,tissue,translucent,triangular,trichome,tube,vein,violet,white,whitish,x,yellow,yellowish	-1/3,-6,.25,.3,0-,0.3,0.6,1,1-5,1.5,1/4,100,2-2.5,2-3,2-5,2-6,4,4-5,5-25,5-merous,6,>,abaxially,acumen,acute,adaxially,alyx,andromonoecious,anthesi,apart,apex,approximately,area,articulated,band,bi-lobe,borne,broad-based,bud,cast,cell,curve,curved,decurrent,denser,difoliate,directed,distal,distall,distance,dry,eaf,easily,eed,either,ellipsoid,elongate,equal,exposed,exserted,flowering,free,fruiting,functionally,geminate,glabrescen,greatest,halfway,hermaphroditic,heterostylous,infructescence,internodal,lamina,larger,less,lon,long,longer,lower,lowermost,mal,maturing,maturit,midpoint,midrib,near,new,nflorescence,nodding,occasionally,often,older,onto,orolla,pendent,per,pericarp,petal,planar,pore,poricidal,portion,prickle,prickly,re,reflexed,ruit,scar,shap,side,small,spaced,splitting,still,stouter,straight,strongly,tall,tamen,testal,thickened,thinne,type,ud,unevenly,unit,upper,usually,vary,varying,visible,way,wide,winged,woody,ympodial,¼	/,0-1-2,abaxial,adaxial,arrangement,bi-lobed,branch,branching,color,form,glabrescent,height,history,life,main,na,number,pubescence,seed,shape,tertiary,texture,unarmed,venation,young
662	wfo-0001030871	success	248	133	111	137	22	0.448	.2-3,/30-1/5,0-120,0.2-0.4,0.3-4,0.7-1.3,1-18,1.3-2,1.8-2.6,2-3,2-8,2.8-4.5,3-32,3-4.4,3-6,3.5-14,30,4.5-6.5,5-33,6-40,9-13,abaxially,abruptly,acute,adaxial,anther,apart,attenuate,base,becoming,berry,blade,blunt-tipped,branched,brown,calyx,campanulate,chartaceous,closely,cm,conical,continued,corolla,deltoid,diameter,due,echinoid,entire,fleshy,flower,fruit,glabrescent,glabrous,granular-tomentose,greenish,growth,hair,honeycombed,lateral,leaf,length,lobe,long,margin,midvein,mixed,mm,mostly,multangulate,narrowly,oblong,obtuse,orbicular,ovate,pedicel,peduncle,petiole,plurifoliate,porrect-stellate,probably,prominent,purple,reniform,reticulate-punctate,ripe,rotate-stellate,scabridulous,sessile,short-stalked,shrub,spaced,stellate-tomentose,stem,stigma,style,suborbicular,terete,terminal,time,tomentose,tree,tube,unarmed,vein,velutinous,violet,white,x,yellow,yellowish,young	.8-3.5,.9-1.2,0.4-1.8,0.6-1.5,0.7-2.5,1-1.3,1.3-3,1.4-2.7,1.5-3,1.5-6,1.8-3.5,1/2,1/2-3/4,1/4,1/4-1/3,11,3-5,4.8-9.5,5-7,7-12,accrescent,acuminate,adaxially,ag,along,anthesi,apex,apical-lateral,apparently,appressed,appressed-tomentose,articulated,axe,axillary,ba,bark,branch,bud,capitat,dark,decurrent,dehiscing,dendritic-echinoi,dendritic-echinoid,dendritic-multangulate,densely,directed,distal,eaf,earl,early,echinoi,eed,elliptic,elongate,equal,erect,evident,exserted,extend,filament,free,fruiting,glabrescen,grayish,green,held,high,inserted,introrse,large,lobed,long-,long-stalked,longer,longitudinal,lower,m.,main,minute,multangulat,nearly,nflorescence,nodding,occasionally,often,older,open,orbicula,orolla,ovate-lanceolate,overlapping,pale,partly,perfect,plait,pore,present,pubescent,rachi,rather,ray,reflexed,relatively,ruit,runk,short,short-,side,simple,slit,small,sometimes,somewhat,soon,sparingly,sparsely,splitting,stamen,striate,strongly,subglobose,sulcate,suture,tamen,testa,thick,thick-stalked,thin-stalked,toward,unarme,unit,usually,vary,way,wide,ympodial	abaxial,arrangement,branching,capitate,color,form,height,history,inflorescence,life,number,ovary,perennial,plant,primary,pubescence,seed,shape,size,surface,texture,ye
663	wfo-0001030872	success	166	64	52	114	12	0.313	.5,0.5-1,0.8-1,1-1.2,1-1.5,1-2,1.2-1.5,1.5-5,12-18,2-5,4-6,4-6-flowered,6-12.5,anther,bark,base,black,broadly,brown,calyx,cm,corky,corolla,crateriform,dark,dia,elliptic,glabrate,glabrous,globose,green,large,leaf,lenticel,lobed,minutely,mm,nearly,ovate,pedicel,petiole,red-glandular-puberulent,shining,simple,size,small,soon,stem,tree,treelet,x,young	0.5,0.8-2,1.2-3,1.5-2,3-7,5-6,5.5-7,acuminate,acute,adaxial,age,along,anthesi,apex,appearing,area,beginning,berry,caly,center,closed,closely,completely,consisting,cucullate,darker,deflexed,deltoid,densely,difoliate,dry,eaf,edicel,eed,ellipsoid-ovoid,erect,exserted,filament,fleshy,free,fruiting,full,geminat,hooded,incurved,inflorescenc,known,lenticellate,less,like,live,lobe,lon,long,lower,major,margin,material,middle,minor,nerve,nflorescence,oblique,older,one,opposite,ovary,overlapping,pair,pale,paler,papillose,petal,planar,pore,poricidal,portion,primary,prominent,proximal,puberulent,raised,rather,reddish-glandular,reddish-glandular-puberulent,relative,rest,ridge,rounded,ruit,scar,shaped,shorter,side,slightly,spaced,specimen,stigma,straight,strongly,styl,style,tall,tapering,tear-drop,thickened,tip,tube,ud,unit,white,widest,woody,ympodial	color,diameter,flower,form,fruit,growth,height,inflorescence,length,plant,shape,texture
664	wfo-0001030877	success	223	124	95	128	29	0.426	0.1-0.6,0.1-1,0.3-0.4,0.5-0.8,0.5-1,0.7-1.4,1-1.5,1-2,1.5-2.4,1.5-3,17-26,2,2-15,2-3,2.2-2.7,2.9-8,4-8,5,5-11,5-6,6-11,6-15,7.5-10,absent,anther,articulated,attenuate,base,branch,broadly,calyx,chartaceous,cm,connivent,cuneate,cylindrical,densely,diameter,entire,erect,flattened,flower,fruit,glabrous,gland-tipped,globose,green,hair,inflorescence,lanceolate,leaf,length,lobe,lobed,loosely,margin,midvein,minutely,mm,obtuse,ovate,pale,pedicel,peduncle,perennial,petiole,plant,present,pseudo-racemose,pubescent,purple,ray,reticulate,rhizomatous,rotate-stellate,shallowly,short,shrub,simple,sparsely,stellate,stellate-pubescent,stem,stigma,style,surface,triangular,tube,unarmed,unbranched,vein,x,yellow,yellowish,yellowish-green	%,0-0.2,0-0.5,0-10,0-15,0-4,0-5,0.1-0.4,0.2-0.6,0.4-0.5,0.4-0.8,0.5-0.6,0.7-1.6,0.9-1.2,1-1.3,1-1.4,1-3,1.5-2,1.8-2.6,10-14,10-30,10-40,2-3-locular,2-foliate,2.9-4.8,3-10,4-10,4-6,5-merou,6-12,6-9,7-9,8-14,8-15,8-9,9-14,9-15,abaxially,absen,abundant,accrescent,acicular,across,acute,adaxially,adult,alyx,andromonoecious,anvil-shape,apart,apex,ascending,axe,ba,blade,branche,brown,capitat,cross-section,directed,distall,distributed,dm,dult,eaf,eed,eglandular,exocarp,extra-axillary,filament,finger,fruiting,functional,geminat,half,heterostylous,index,interpetalar,juicy,juvenile,lamina,lateral,less,lobing,long,longer,lower,mature,mesocarp,mid-point,midpoint,midrib,minute,moderately,moist,nflorescence,oblique,orolla,pair,part,per,placenta,pore,porrect,prickle,rachi,ruit,rusty,side,spaced,stalk,stalked,stellae,straight,tal,tamen,thick,throughout,time,tissu,tissue,unarme,unit,upper,vary,weakly,wide,ympodial	abaxial,adaxial,arrangement,bark,branching,capitate,color,corolla,drying,form,growth,height,history,life,main,na,number,ovary,primary,pubescence,seed,shape,size,tall,tertiary,texture,trichome,venation,young
665	wfo-0001030882	success	144	77	60	84	17	0.417	0.5-1,0.5-1.1,0.8-1.1,0.8-2.4,0.9-1.1,1-1.3,1-1.5,1-4,2,2-5.4,2.2-4.6,3-3.5,3/4,6.5-15.6,anther,bark,base,calyx,capitate,cm,corolla,crenulate,deltoid,dia,elliptic,fruit,glabrous,globose,green,leaf,lightly,lobe,lobed,margin,minor,minutely,mm,narrowly,ovary,ovoid-reniform,papillose,pedicel,petiole,shaped,short,shrub,simple,size,small,stem,stigma,style,tan,tear-drop,transversely,tree,tube,way,x,young	.1,.5,0.5-0.75,0.75-1,1.6-2,2-6,8-12,?,accrescent,acuminate,anthesi,apex,attenuate,beginning,beneath,berry,closely,conical,deflexed,differing,difoliate,eaf,edicel,eed,erect,exserted,extreme,filament,free,fruiting,geminat,inflorescenc,lateral,lon,long,lower,main,major,middle,nearly,nflorescence,occasionally,older,one,opposite,overlapping,ovoid,pair,pale,paler,papillo,peelin,pitted,planar,pore,poricidal,portion,prominent,raised,ruguse,ruit,scar,slender,slightly,soon,spaced,straight,surface,tall,tapering,terminal,thick,thickened,tip,truncate,tub,ud,unit,vein,white,widest,woody,yellowish,ympodial	0.5,3,5.5,color,diameter,form,growth,height,inflorescence,length,peeling,plant,pubescence,rugose,seed,shape,texture
666	wfo-0001030883	success	179	111	99	80	12	0.553	-3,.05,0.5-3,0.5-5,1-1.1,1-1.2,1-1.3,1-1.5,1-4,1.5-2,1.5-3.5,10-18,18-44.5,2-5,20-50-flowered,3/4,5-6,9.5-27.5,acuminate,acute,anther,apex,bark,base,brown,calyx,cell,clavate,cm,collapsed,corolla,dark,dia,dry,elliptic,epidermal,finely,fruit,furcate,glabrous,glandular,globose,green,inflorescence,laminar,large,lateral,leaf,like,live,lobed,long,long-acuminate,main,massive,material,midrib,minute,minutely,mm,oblique,occasionally,older,opposite,ovary,ovate,ovoid-reniform,pair,pale,papillate,papillose,pedicel,perpendicular,petiole,plant,puberulent,reticulate,russet,seed,shaped,shrub,size,stem,stigma,stout,style,surface,tan,tear-drop,time,trichome,uniseriate,upper,vein,wall,way,white,x,young	.1,.5,3-3.5,3-4,accrescent,across,anthesi,apart,appearing,approximatately,arching,becoming,berry,branched,bu,collection,deflexed,differing,difoliate,eaf,edicel,eed,erect,evenly,filament,fleshy,free,fruiting,geminat,geminate,hard,hollow,imbedded,later,lenticellat,less,little,living,lobe,lon,lower,malodorous,markedly,middle,narrowly,nflorescence,papillo,petaloid,pitted,placenta,pore,poricidal,portion,present,proximal,pulp,quite,rather,reflexed,ruit,scar,slender,slightly,sometimes,soon,spaced,straight,strongly,tall,tapering,thick,tip,triangular,tube,two,ud,unit,widest,woody,ympodial	approximately,arrangement,color,diameter,flower,form,growth,height,length,pubescence,shape,texture
667	wfo-0001030884	success	218	133	112	106	21	0.514	.5,.7,0.4-3,0.5,0.5-1.2,0.8-1,0.9-5,1-1.5,1.5,1.5-2,1.5-2.5,2-5,4-13,4-5,4.5-5,5-30,5-6,5.5-7,6-25,6-8,9-11,abaxial,abruptly,acute,adaxial,anther,anthesi,apex,bark,basal,base,berry,brown,calyx,capitate,cm,conical,dark,decurrent,densely,diameter,elliptic,filament,flower,green,greenish,growth,half,herbaceous,inflorescence,lateral,leaf,length,like,lobe,lobed,long,long-stalked,long-styled,long-triangular,margin,mature,minute,minutely,mm,moderately,ovary,ovoid-reniform,pair,pale,pedicel,peduncle,petiole,plant,poricidal,prickly,primary,pubescent,ray,red,reddish,rest,sagittate,sessile,shallowly,short,short-stalked,short-styled,shrub,simple,size,slender,sparsely,spherical,spreading,stellate,stem,stigma,style,surface,tannish,tapering,tip,treelet,trichome,tube,unarmed,vein,white,wide,winged,young	.2,0.3,0.3-0.5,1,1-1.2,1-3,10,100,2,5,5-merous,6-10,7-8,>,abaxially,adaxiall,along,also,alyx,andromonoeciou,apar,arme,articulated,blade,broad-based,c.,connivent,curved,di-,differing,directed,discolorous,distal,eaf,eed,equal,extend,extending,flowering,free,fruiting,geminate,glabrous,glandular,gray-tinged,gree,heterostylous,infructescence,leafy,lower,magnification,midpoint,midrib,mixture,new,nflorescence,node,occasionally,older,one,onto,open,orolla,oung,outlin,papillat,per,pore,porrect,portion,present,prickle,principal,reflexe,reflexed,regularly,ruit,scar,scattered,shap,similar,spaced,stellate-pubescent,stiff,still,strongly,tall,tamen,time,trifoliate,unicellular,uniformly,uniseriate,unit,upward,usually,vary,varying,visible,way,weakly,wing,without,woody,yellow,ympodial	armed,arrangement,branch,branching,color,corolla,form,fruit,height,history,life,main,midvein,na,number,outline,papillate,pubescence,seed,shape,texture
668	wfo-0001030899	success	146	104	79	67	25	0.541	.5-2,0.3-0.5,0.5-1,1,1-2,1-3,1.5-2,10-20,2,2-3,2-3.5,2.5-3.5,20-25,3-12,3-4,3-5,3.5-4,4-5,5-10,5-6.5,6.5-31,7-27,8-11,?,acuminate,apex,base,bronze,calyx,chartaceous,cm,connective,connivent,cordate,deeply,densely,diameter,ellipsoidal,end,entire,flattened,flower,fruit,glandular-puberulent,globose,green,inside,less,lobe,margin,mm,narrowly,oblong,obtuse,outside,ovate,ovoid,pedicel,peduncle,petiole,puberulent,pubescent,purple,rachi,radiu,remnant,shrub,simple,splotch,stellate,stigma,stripe,style,triangular,tube,unbranched,white,x,yellow	-45,0.5,1-1.5,1-6,10-13,3-foliate,abaxially,absent,acute,adaxially,aggregate,apart,ape,articulated,axe,basal,beyond,blade,cell,coriaceous,desc,dilated,directed,distally,eaf,eed,ex,exceeding,exserted,extrorse,glabrous,leaving,light,lon,long,lower,mucronate,nflorescence,nther,obconical,orang,orolla,pedicellar,peltifor,perfect,pore,presen,puberulen,ruit,shorter,slightly,spaced,stamen,stone,strongly,tal,tem,thecae,time,tomento,ud,unit,upward,vary,vein,wide,ympodial	abaxial,adaxial,anther,arrangement,bud,color,corolla,form,growth,height,inflorescence,leaf,length,ovary,peltiform,plant,pubescence,seed,shape,size,spacing,stem,surface,texture,width
669	wfo-0001030902	success	159	100	76	83	24	0.478	-2,0.6-1.5,1-2,1-6,1.5-13,1.5-2.5,10-15,15-50,2,2-3,2-5,2.5-4,3-13,3-20,3-4,3.5-4,30-50,4-22,4-7,5-7,5-9,6-24,acuminate,angled,apex,apiculate,base,branched,brown-pilose,calyx,cm,cordate,dark,deltate,densely,diameter,eglandular,ellipsoidal,entire,flattened,flower,forked,fruit,glabrescent,glabrous,globose,hair,long,margin,mature,mm,oblong,occasionally,orange,ovate,pedicel,peduncle,petiole,pinkish,purple,purplish,rachi,rarely,reddish,simple,stellate,stigma,style,subcoriaceous,tip,tree,truncate,tube,unbranched,x,yellow	-20,-5,0-15,1.5-,1.5-2,2.5,4,4-6,4-foliat,8-14,abaxially,absent,acute,adaxially,aggregate,along,apart,ape,apically,articulated,axe,basal,beyond,blade,brow,cell,connective,connivent,cylindrical,dilated,directed,distally,eaf,eed,equalling,exceeding,except,exserted,fleshy,glabrat,glandular,glandular-puberulen,laterally,leaving,lobe,lon,lower,narrowly,nflorescence,nther,obtuse,orolla,pedicellar,perfect,pore,presen,present,puberulence,radiu,remnant,ruit,shorter,slightly,small,somewhat,spaced,sparse,sparsely,stamen,stone,subcapitat,tal,tem,thecae,time,tomento,triangular,ud,unit,vary,vein,wide,ympodial	abaxial,adaxial,anther,arrangement,color,corolla,form,glabrate,growth,height,inflorescence,leaf,length,na,ovary,plant,pubescence,seed,shape,size,stem,subcapitate,surface,texture
670	wfo-0001030906	success	134	95	50	84	45	0.373	1-1.4,1.0-1.4,1.5-2.5,2.0-2.6,2.3-3.5,4-11,6-10,7-16,8-13,9-12,along,annual,anther,arcuate,base,branched,bristly,broadly,calyx,cm,densely,dry,flattened-ovoid,foveolate,glabrous,herb,length,linear,lobe,main,maturity,minutely,mm,ovate,pedicel,pentagonal,petiole,prickly,seed,sometimes,spherical,splitting,spreadingly,stellate-pubescent,stellate-tomentose,stem,surface,tube,vein,yellow	1,1/3-2/3,38,40-80,6-8,7-12-flowere,accrescent,across,almost,alyx,ample,anthesi,armed,ascending,bearing,berry,blade,broad-based,campanulate,cauline,da,developing,dia,difoliate,divided,eaf,essentially,exceeding,externall,faces,flat,geminat,internodal,interpetalar,invested,lateral,long,long-stalked,n,near,nearly,nflorescence,numerous,obtuse,often,orolla,partly,per,pinnatifid,pinnatisect,plicate,prickl,prickle,purple,purpli,red,rounded,ruit,sessil,short,slender,slightly,somewhat,stellae,strait,subulate,suffused,tamen,taprooted,throughout,tightly,tigma,tissue,tub,twice,tyle,ultimate,undulate,unexpande,unit,usually,vary,yello,ympodial	7-12-flowered,abaxial,adaxial,arrangement,bark,branch,branching,color,corolla,diameter,drying,externally,false,filament,flower,form,fruit,growth,height,history,inflorescence,leaf,life,margin,midvein,na,number,ovary,peduncle,plant,primary,pubescence,ray,shape,size,stigma,style,tertiary,texture,trichome,unarmed,unexpanded,venation,width,young
671	wfo-0001030914	success	186	119	101	85	18	0.543	.1,/4,0.1-0.5,0.7-1,1-1.5,1-2,1.2-1.5,1.5-3,1.5-8,2-10,2-2.5,2.5-11,2.5-3,3-4,3.5-17,5-17,7-8,9-35,along,anther,bark,base,beneath,berry,calyx,campanulate,capitate,cm,constriction,corolla,dark,decurrent,densely,dia,differing,dry,elliptic,erect,furcate,glabrate,glabrous,globose,golden,green,inflorescence,leaf,lemon-yellow,length,lobed,long,long-styled,major,many,minor,minutely,mm,obovate,occasionally,older,one,otherwise,ovary,ovoid-reniform,pale,papillose,pedicel,petiole,pitted,plant,puberulent,pubescent,reddish-brown,ripe,shape,shaped,short-styled,shrub,simple,size,small,sometimes,specimen,stem,stigma,style,surface,tapering,tear-drop,time,tree,trichome,trunk,tube,uniseriate,usually,vein,way,white,winged,x,young	.5,0-0.25,0.5-1,0.8-1,0.8-1.3,1.5-2,5-25-flowered,7-10,acute,anthesi,apex,attenuate,blade,bud,closely,deflexed,deltoid,difoliate,distal,eaf,edicel,eed,ellipsoid,equal,even,evenly,exserted,filament,flower,free,fruiting,geminat,greyish-brow,individual,later,lateral,like,live,lobe,lon,lower,main,margin,middle,narowly,nflorescence,often,onto,opposite,overlappin,pair,papillo,planar,pore,poricidal,portion,prominent,quite,raised,rest,rounded,ruit,scar,slender,slightly,soon,spaced,sparsely,straight,tall,tan,thick,third,ti,tip,tub,ud,unit,variable,weight,widest,within,woody,yellow,ympodial	0.5,abaxial,branching,color,diameter,form,fruit,greyish-brown,growth,height,history,life,na,narrowly,perennial,pubescence,seed,texture
672	wfo-0001030918	success	230	153	128	102	25	0.557	-3.2,-40,-5,-6,-9,0-25,0.1,0.25-0.45,0.6-2.5,0.7-1.2,0.7-1.7,1,1-1.5,1.5-2.5,1.5-5.5,1/2-2/3,1/3,2-2.5,2-25,2-8,2.8-3,3-4,3-6.5,3-7,3.5-6,4-7,5-8,5.5-7,6-8,abaxial,abaxially,adaxial,anther,apically,apparently,bark,base,berry,branched,calyx,cell,chartaceous,cm,connivent,cuneate,curved,densely,diameter,discolorous,drying,dull,elliptic,erect,evenly,filament,flattened-reniform,flower,fruit,glabrescent,glabrous,green,lateral,leaf,length,lobe,lobed,long,lower,margin,maturity,mauve,midvein,mm,moderately,narrow-deltate,occasionally,orange,orange-brown,outline,pair,pedicel,peduncle,per,petiole,pit,poricidal,porrect,prickly,primary,pubescent,purple,raised,ray,red,red-brown,scandent,seed,sessile,shrub,simple,slender,small,smooth,sometimes,sparsely,spherical,spreading,stalked,stellate-pubescent,stem,strongly,style,surface,tapering,terete,terminal,tertiary,tip,trichome,tube,upper,vein,venation,way,weakly,wide,yellow,young	-12,-2.3,-4,-4.5,.5,.7,0-10,0-20,0-4,0-6,0.1-0.25,0.2-0.4,0.3-1.5,0.5-0.7,0.5-2,0.5-2.5,0.6,1-1.8,1-2,1-4,1.5-2,1/2-3/4,1/3-,1/3-1/2,1/4-1/3,2-10,2-3,2-4,2-7,2/,3-15,5-7,5-merous,7-10,acicular,acute,alyx,ame,apar,apart,apex,articulated,blade,brow,c.,caudat,dark,deltate,difoliate,distance,eaf,elongated,elongating,equal,extending,faint,flattened,free,fruiting,geminat,green-brown,infructescence,lobing,longer,mature,midpoint,mixture,nflorescence,oblong,obtuse,older,one,open,orolla,oung,pale,pendulous,perfec,pericarp,perpendicular,portion,prickl,prickle,reduced,reflexed,ruit,scar,secondary,side,somewhat,spaced,stalk,stellate,straight,tamen,time,unit,usually,vary,visible,woody,ympodial	0.5,2/3,arrangement,branch,branching,brown,caudate,color,corolla,form,growth,height,inflorescence,main,na,number,ovary,plant,pubescence,shape,size,stigma,texture,unarmed,width
673	wfo-0001030919	success	219	104	74	145	30	0.338	12,2,2.5,3,abaxial,acute,adaxial,anther,apex,armed,asymmetrical,base,branched,brown,calyx,chartaceous,cm,coriaceous,densely,diameter,elliptic,entire,flower,fruit,glabrous,glandular,globose,green,hair,hard,leaf,length,like,linear-lanceolate,lobe,margin,maturity,mm,moderately,multicellular,obtuse,often,ovate,pedicel,peduncle,petiole,pinnate,plant,porrect-stellate,protrusion,pubescent,rachi,reddish,reniform,rugose,rusty,scandent,shrub,small,stellate,stellate-pubescent,stem,surface,tan,triangular,tube,twice,unbranched,uniseriate,venation,white,whitish,yellow,×	.2–0.4,.2–0.6,0.1–0.2,0.1–0.3,0.3–0.6,0.5–1,0.5–1.5,0.5–3,1.2–2,1.5,10–13,10–14,10–20,12–16,12–18,1971,1–2,1–3,25–50,2–3,2–4,2–8,3–4,3–6,3–8,4–7,4–8,5-merous,5–10,5–7,5–8,7–10,7–11,8–12,abaxially,absent,accrescent,adaxially,alyx,andromonoecious,anthesi,apart,apparently,articulated,attenuate,axe,ba,berry,beyond,blade,capitat,connected,connivent,cordate,covering,cylindrical,directed,discolorous,distally,eaf,eed,exserted,extra-axillary,festooning,filament,flattened,frui,fruiting,functionally,fused,glabrou,hermaphroditic,horizontal,incompletely,interpetalar,introrsely,lateral,lobed,long,longitudinal,lower,male,midpoint,midrib,midvein,moderate,multiseriate,narrowly,nearly,nflorescence,notch,occasionally,older,opening,orange,orolla,partially,per,perfec,petiolate,placenta,plurifoliat,pore,positioning,prickle,proximally,ray,recurved,reflexed,roe,roselike,ruit,secondary,see,shortly,side,simple,slightly,slit,spaced,sparsely,spine,stalk,stamen,ste,stigma,style,subopposite,subsessile,swollen,tal,tamen,tapering,tem,terminology,tissue,triangular-ovate,unarmed,unicellular,unit,vary,vein,wide,ympodial,young	0.5-3,1-2,1-3,1.2-2,10-13,10-20,12-18,2-3,2-8,3-4,3-6,5-8,7-10,7-11,branching,color,corolla,form,growth,height,history,inflorescence,life,ovary,pubescence,seed,shape,size,texture,ye
674	wfo-0001030921	success	185	120	92	93	28	0.497	0,0.4-0.5,1-1.5,1-3,2-2.5,2-3,3-3.5,3-4,3-5,3.5-5,4-10,6-7,7-8,9-15,acute,anther,asymmetric,bark,base,berry,branched,brown,calyx,campanulate,cm,coriaceous,corolla,corymbose,cyme,deep,diameter,elliptic,entire,filament,flattened,flower,fruit,globose,green,grey,growth,inflorescence,lanceolate-elliptic,liana,like,linear-lanceolate,lobe,lobed,many,margin,minute,mm,nearly,ovary,pedicel,peduncle,petiole,poricidal,porrect,puberulent,pubescence,pubescent,purple,ray,reddish,reniform,reticulate-undulate,rugose,rusty,scabrous,stellate,stellate-pubescent,stem,stigma,style,subequal,subspherical,subtruncate,surface,tapering,time,tip,tomentose,trichome,tube,velutinous,violet,white,woody,x,yellowish,young	.5,1-1.2,1-2,1/3,10,2-6,4-6,abaxially,acuminate,adaxially,anthesi,antrorse,apart,apex,appressed,armed,articulated,basal,caly,channelled,compressed,congested,curved,deeply,densely,diamete,discolorous,distal,eed,elongating,erec,erect,exceeding,exserted,free,fruiting,glabrescent,glabrous,half,hermaphroditic,heterostylous,included,internodal,long,long-styled,longer,lower,midpoint,multicellular,near,new,nflorescence,oblong,obverse,older,one,ovoid-conical,partially,perfect,pericarp,plurifoliateleaf,pore,porrect-stellate,portion,prickle,prickly,raise,recurved,reduced,reflexed,ruit,scar,sessile,short-styled,shorter,shrub,slightly,slit,spaced,sparse,sparsely,staminate,straight,strongly,terete,testa,triangular,ud,unevenly,unicellular,unit,upper,ympodial	abaxial,adaxial,arrangement,branch,branching,color,drying,form,height,history,leaf,length,life,main,midvein,na,number,plant,plurifoliate,primary,seed,shape,size,tertiary,texture,vein,venation,width
675	wfo-0001030941	success	259	144	117	142	27	0.452	-1.5,-6,0-100,0.02-0.4,0.04-0.08,0.1-0.3,0.8-1.1,0.8-1.3,1-9,1.1-1.7,1.1-2.8,1.2-2.1,1.2-2.2,1.3-2.5,1.4-1.6,10,10-25,2-3.2,2-5,3-4.5,3.5-10,4-6,6-22,6-9,7-10,7-23,9,acute,adaxially,anther,apex,bark,base,becoming,blunt-tipped,branch,branched,brown,calyx,campanulate,chartaceous,cm,color,conical,corolla,decurrent,deltoid,dense,diameter,elliptic,entire,fleshy,flower,fruit,glabrescent,glabrous,globose,gray,growth,honeycombed,lateral,leaf,length,lobe,long-attenuate,main,margin,midvein,minutely,mm,moderately,mostly,multangulate,narrowly,oblong,obovate,obtuse,occasionally,ovoidal,pale,pedicel,peduncle,petiole,porrect-stellate,pubescent,rarely,ray,reticulate-punctate,scabridulous,scabrous,shrub,simple,small,sparingly,sparse,sparsely,stelliform,stem,stigma,style,subcoriaceous,suborbicular,subreniform,terminal,testa,time,tomentose,tree,triangular,tube,unarmed,vein,white,x,yellow,yellowish,young	-16,-4,.01-0.3,.03-0.25,.04-0.1,.04-0.12,.04-0.22,.04-0.4,.2-0.8,.5-5,/50-1/15,0.01-0.22,0.02-0.04,0.02-0.06,0.02-0.25,0.02-0.3,0.03-0.05,0.03-0.06,0.03-0.6,0.04-0.1,0.04-0.35,0.04-0.5,0.04-0.6,0.06-0.35,0.06-0.42,0.07-0.4,0.08-0.35,0.08-0.5,0.5-1.5,1-1.4,1.1-1.3,1.3-4.5,1.4-3.5,1.5-3.5,1.5-4.5,1/3-1/2,2-3.3,3-5,3/4,4-12,4-8,4-9,5-9,5-merou,6-10,abaxially,absen,accrescent,acuminate,ag,along,alyx,anthesi,apart,apical-lateral,apparently,appressed-tomentose,articulated,axe,axillary,berry,blade,bud,continued,darker,dehiscing,densely,directed,due,eaf,eed,ellipsoid,exserted,extend,few-rayed,filament,free,fruiting,glandular,hair,high,inserted,introrse,lanceolate,large,less,lobed,lon,long,longer,longitudinal,lower,m.,midpoint,mixed,multangulat,multiseriate,nearly,nflorescence,obscured,often,older,orolla,ovate,perfect,plurifoliate,pore,porrect-stellat,rachi,rather,ripe,ruit,runk,sessile,short,short-stalked,side,slit,sometimes,somewhat,spaced,stalk,stamen,stipitate-glandular,strongly,subcapitat,suture,tamen,terete,thick,thick-stalked,tomentu,touching,toward,unarme,unit,usually,vary,way,weakly,wide,ympodial	0.2-0.8,abaxial,adaxial,arrangement,branching,drying,form,height,history,inflorescence,life,na,number,ovary,perennial,plant,primary,pubescence,seed,shape,size,subcapitate,tertiary,texture,trichome,venation,ye
676	wfo-0001030943	success	167	106	87	80	19	0.521	.5,0.5-1,1-1.2,1-1.5,1.1,1.8-2.2,1/2,12-15,2-6,3,3-4,3/4,4-4.5,4-6,7-13.5,8-10,abaxial,abaxially,adaxial,adaxially,age,along,anther,apex,base,becoming,bi-lobed,black,branching,calyx,cm,conical,corolla,dendritic,densely,diameter,drying,echinoid,elliptic,flattened,glabrous,globose,golden,golden-yellow,growth,im,leaf,lenticular,lobed,long,main,minutely,mm,narrowly,outline,ovary,pedicel,pericarp,petiole,pitted,plurifoliate,pore,poricidal,pubescent,purplish-black,reddish-brown,scattered,shrub,slit-like,small,sparsely,stem,stigma,style,surface,thin,time,tip,tree,tree-like,trichome,vein,violet,way,wide,x,young	0,0.5-3,1.5-2,10-25,4-5,7-8,absent,acuminate,acute,anthesi,apical,bark,basal,belo,berry,branch,cupulate,dark,decurrent,deflexed,denser,eaf,edicel,eed,elongate,erect,ew,exserted,fide,filament,flower,free,fruiting,glabrat,horizontal,inserted,large,lateral,lobe,lon,lower,m.,minute,monochasia,nflorescence,nodding,often,older,overtopping,pair,pale,papillo,pearce,per,planar,portion,raised,ruit,scar,secondary,shoot,showy,sleeve,slightly,somewhat,stamen,strongly,tall,tapering,terminal,triangular,tub,tube,ud,unit,upper,woody,yellow,yellowish-white,ympodial	?,arrangement,color,form,fruit,height,history,inflorescence,length,life,na,papillose,perennial,plant,pubescence,seed,shape,size,texture
677	wfo-0001030959	success	164	118	89	75	29	0.543	.05,.8,/5,0.5-1.5,0.7-1.2,1.2-1.8,1.5-3.5,10-15,2-4,2.5-4.5,2.5-5,5-6,5-9,6-8,9-12,abaxially,almost,anther,apex,apically,apparently,armed,bark,base,branched,brown-green,cm,color,concolorous,connivent,cuneate,deltate,densely,diameter,drying,elliptic,filament,flower,fresh,glabrescent,glabrous,glandular,hair,inflorescence,known,lateral,leaf,length,lobe,lobed,long,long-acuminate,margin,membranous,minute,mm,pair,pedicel,peduncle,petiole,poricidal,porrect,prickle,prickly,primary,ray,sessile,several,shrub,simple,sparsely,stellate,stellate-pubescent,stem,style,subentire,surface,tapering,tertiary,tip,toward,trichome,tube,unarmed,usually,vein,venation,way,wide	.2,0.5,1-10,1-2,1-7,1.5-2,1/5-1/10,2.5-4,4-6,4-8,5-merous,alyx,ame,apar,apart,articulated,blade,brown,c.,curved,difoliate,distributed,eaf,eed,equal,erect,evenly,free,geminat,gently,glabrou,green-brow,know,less,like,long-acuminat,longer,lower,midpoint,narrow-deltate,nflorescence,numerous,older,one,open,orolla,oung,part,perfec,perpendicular,portion,present,prickl,prominent,ruit,scar,scrambling,secondary,short,side,slender,spaced,spreading,straight,straw,tamen,terete,time,unit,vary,visible,whole,yellow,ympodial,youngest	abaxial,adaxial,arrangement,branch,branching,calyx,corolla,form,fruit,green-brown,growth,height,history,life,main,midvein,na,number,ovary,perennial,plant,pubescence,seed,shape,size,stigma,texture,width,young
678	wfo-0001030982	success	215	130	108	107	22	0.502	-2-2.5,0.05,0.05-0.5,0.1-0.15,0.2-3,0.5-0.9,0.5-1,1,1-1.5,1-8,1.5,1.5-2,1.5-3,2/3,3-21,3-8,4-12,4-5,6-8,acute,anther,base,berry,broadly,brown,brownish,calyx,capitate,chartaceous,cm,conic,conical,corolla,cuneate,dark,deltate,diameter,dry,drying,ellipsoid,elliptic,entire,filament,flattened-reniform,fleshy,flower,form,fresh,fruit,glabrous,globose,green,growth,later,leaf,less,live,lobe,lobed,long,margin,material,maturity,midvein,minutely,mm,olive,ovary,ovate,pair,pale,papillate,papillose,pedicel,peduncle,petiole,pitted,plant,poricidal,primary,pubescent,reddish,reflexed,revolute,rhizomatous,sagittate,seed,simple,sinuate,size,slightly,sparsely,stem,stigma,strongly,style,subshrub,surface,tip,trichome,tube,uniseriate,vein,way,weakly,white,x,young	.1,.2,.5,0.1,0.3-2,0.5,0.5-3,abaxially,acuminate,adaxially,age,angular,anisophyllous,anthesi,ape,apex,appressed,ba,beneath,bud,caducous,central,channelled,ciliate,closely,cream,cucullate,curved,deflexed,differing,difoliate,distall,distally,distichou,eaf,edicel,eed,enlarged,exerted,extension,external,foliage,free,fruiting,geminate,glabrescent,glandular,glandular-papillose,golden-green,greenish,hilum,impressed,inconspicuously,internal,isostylous,larger,lengthening,like,lower,major,materia,minor,mostly,near,new,nflorescence,oblique,obovate,occasionally,often,one,opposite,overlappin,packed,papillae,papillat,planar,pore,portion,projection,prominent,prominently,puberulent,rest,ruit,scar,separated,shoot,sigmoidally,situated,slit,somewhat,stamen,straight,stripe,testa,tetramerous,tightly,time,transverse,tub,ud,unit,vegetative,veined,yellowish,ympodial	abaxial,adaxial,arrangement,bark,branch,branching,color,distichous,height,history,inflorescence,length,life,main,na,number,pubescence,ray,shape,tertiary,texture,venation
679	wfo-0001030989	success	177	127	103	74	24	0.582	.5,0.5-1,1-10,1-2,12-15,15-27.5,2-3.5,3-20,3-4,3-5.5,3-7.5,4-5,4-8,5,5.5-7.9,6-13,6-6.5,9-10,abaxially,adaxially,anther,apart,articulated,berry,brownish,cell,chartaceous,ciliate,cm,condition,conical,connivent,corolla,covering,densely,diameter,distal,drying,end,flower,forked,fresh,fruit,generally,glabrous,green,green-white,greenish,hair,hair-like,half,herb,interjected,lanceolate,lateral,leaf,leaflet,light,like,lobe,long,make,margin,minute,mm,mucilaginous,occurring,odd-pinnate,ovoid,pedicel,peduncle,petiole,plant,poricidal,proximal,pubescent,ripe,rotate,seed,singly,size,spaced,sparsely,stem,stigma,style,terminal,testal,thick,throughout,tip,triangular,tube,tuber,typically,usually,violet,wall,wet,whitish,wide,x,yellow	1-1.5,4-7,5-merou,acuminate,ag,alyx,apex,apparently,axe,axillary,base,blade,bud,capitat,decreasing,digestion,dorsally,eaf,edge,eed,enzyme,erec,especially,filament,flat,folded,geminat,glabrou,gradually,homostylous,honeycomb-shaped,larger,lengthening,living,lower,nflorescence,obtuse,orbicular,orolla,ovate,ovate-lanceolate,pair,pale,perfect,petiolule,plurifoliate,pore,present,pubescen,ray,removed,ruit,secondary,semierect,seudostipule,slit,specimen,ste,stolo,subequal,subsessile,subtending,symmetrical,tall,tamen,tem,thir,toward,tri-,unit,unwinged,vary,wider,ympodial	abaxial,adaxial,arrangement,branching,calyx,capitate,color,form,growth,height,history,inflorescence,length,life,occurrence,ovary,perennial,pseudostipule,pubescence,shape,stolon,surface,texture,third
680	wfo-0001030991	success	204	132	102	102	30	0.5	.5,0.5,0.5-0.7,0.5-1.5,0.7-1.2,1-1.5,1-1.6,1-2.2,1-2.5,1-7,1.5,10-20,2.5-10,2.5-3,3-5-lobed,4-10,9-11,absent,along,anther,apparently,appressed,ascending,attenuate,base,brown,calyx,capitate,cm,color,conical,connivent,corolla,densely,diameter,drying,ellipsoidal,elliptic,entire,filament,flattened,flower,furcate,glabrous,globose,grey,growth,herb,inflorescence,lanceolate,leaf,like,lobe,lobed,long-triangular,loosely,margin,minutely,mm,narrowly,nearly,occasionally,pair,pedicel,peduncle,petiole,pinnatifid,pitted,primary,pubescent,red,reniform,rest,ripe,scattered,shiny,short,shrub,simple,small,somewhat,sparsely,spreading,stellate,stem,stigma,style,suffrutescent,surface,thin,trichome,tube,uniformly,uniseriate,variably,vein,violet,white,winged,x,yellowish,young	0,0.1,0.2,0.2-0.7,0.3-0.4,0.5-1,0.5-3.5,0.6-0.8,2-plurifoliat,2/3,3-,5-5.5,5-merou,<,abaxially,acuminate,acute,adaxiall,adaxially,ag,alyx,angled,anthesi,apex,arising,ark,articulated,basal,berry,bulbous,cell,different,distally,eaf,eed,ellipsoid,elongate,enlarged,exerted,eye,filiform,free,frui,fruiting,fusiform,glabrescen,ilament,incised,lateral,leaf-opposed,leave,lengthening,less,lower,midrib,minute,new,nflorescence,nodding,often,older,orolla,outline,packed,papillo,part,particularly,pendant,per,perfect,pericarp,platfor,pointing,pore,poricidal,portion,pseudoumbel,rectangular,reflexed,rootstoc,ruit,scar,shallowly,sleeve,slightly,slit,strongly,tangled,tem,terminal,testal,tightly,tip,twinin,ud,unit,upper,vary,weak,weight,woody,ympodial	abaxial,adaxial,arrangement,bark,branch,branching,form,fruit,glabrescent,height,history,length,life,main,midvein,na,number,ovary,papillose,plant,pubescence,ray,seed,shape,size,tertiary,texture,unarmed,venation,width
681	wfo-0001031005	success	231	115	105	126	10	0.455	.5,/3-1/2,0.1,0.8,0.9,1-1.5,1-2,1-2.5,1-3,10,2-3.2,2.5,2.5-4,3-4,3-6.5,5,5-7,5-8,abaxially,adaxially,almost,anther,anthesi,attenuate,bark,base,berry,black,blue,brachyblast,branch,branched,branching,brown,calyx,chartaceous,clustered,cm,concolorous,conical,corolla,cupular,dendritic,diameter,discolorous,drying,elliptic,entire,evenly,fine,flat,form,fruit,glabrous,greenish,leaf,length,liana,lobed,long,longitudinally,main,margin,membranous,midvein,mm,network,oblong,obovate,occasionally,older,orange-brown,ovoid,pair,pedicel,peduncle,petiole,primary,prominent,pubescent,purple,raised,ridged,short,slender,sometimes,somewhat,sparsely,stem,style,terminal,tertiary,thick-chartaceous,tip,toward,trichome,tube,unarmed,usually,vein,venation,weakly,white,x,young	.4,0-0.5,0.3-0.5,0.5-1.5,1,1.5-2.5,1.5-4,2.3-3,3-10,4-6,5°,6-12,abaxial,accrescent,acuminate,acute,age,along,alyx,apar,apex,apically,apparently,articulated,capitate,clearly,clum,common,curved,dark,datum,deeply,delineated,deltoid,dendritic-pubescent,denser,density,detaching,developing,dilated,divided,domatia,eaf,ellipsoi,elongated,equal,extending,eye,fertilisation,filament,flattened,flexuous,flower,forming,free,fruiting,immature,increasing,inside,junction,known,lateral,leave,lengthening,like,linear,lobe,loop,lower,m.,minute,much,naked,nflorescence,nther,obscure,occasional,often,onl,orolla,ou,outside,ovate,pendulous,perfec,pericarp,plurifoliat,pointed,pore,poricidal,portion,protruding,rachi,ray,region,rest,ruit,scar,secondary,seed,side,simple,smaller,smoot,smooth,soon,spread,spreading,standing,stigma,strongly,stump,surface,surrounding,tangling,tearing,terete,thin,ud,uneven,unit,vary,visible,well-developed,wide,ympodial	arrangement,color,growth,inflorescence,number,ovary,shape,size,texture,true
682	wfo-0001031007	success	207	145	127	80	18	0.614	.5,0.2,0.5,0.5-1,1,1-1.2,1-1.5,1-3.5,1.2-1.5,1.3-,1.5-2,1.9-3,15,2.5-,2.5-5,3-4,4.5-5,5-12,5.5-6,50-100,6,7-10,<,abruptly,acute,alfway,along,anther,apex,articulated,base,beginning,berry,bifid,black,branched,branching,broadly,brown,c.,calyx,capitate,chartaceous,cm,connivent,corolla,cuneate,cup-shaped,deltate,dendritic,densely,diameter,dull,elliptic,entire,extending,filament,flattened-reniform,fleshy,flower,fruit,glabrous,globose,growth,inflorescence,irregularly,lamina,lax,leaving,lengthening,lilac,lobe,lobed,long,loose,loosely,many,margin,matte,midvein,minutely,mm,narrowing,narrowly,near,occasionally,outline,papillate,pedicel,peduncle,peg,petiole,pitted,pore,poricidal,prominent,pubescent,reddish,revolute,sagittate,shiny,shrub,sleeve,slightly,slit,sparsely,splitting,stellate,stellate-pentagonal,stem,stigma,stout,style,surface,tangled,thin,time,tiny,tip,trichome,tube,usually,vein,vine,woody,x,yellow	0.5-10,0.75-1.5,1.6-2,1/3,11-14,4-6,4-7,5,5-merou,8-10,abaxiall,ag,almost,alyx,anthesi,apar,apparently,ark,becoming,broad,campanulate,cell,clustered,completely,dark,dilated,drying,eaf,eed,ellipsoid,exserted,free,fruiting,geminat,glabrescen,glabrou,herbarium,ilament,impressed,intramarginal,junction,looping,lower,m.,markedly,multi-celled,new,nflorescence,nodding,often,older,orolla,pale,papillat,per,perfect,pericarp,planar,plurifoliate,portion,primary,rat,round-rectangular,ruit,scar,simple,slender,spaced,specimen,spreading,strongly,terminal,testal,twining,ud,unit,upper,vary,way,ympodial	abaxial,abaxially,adaxial,age,bark,color,form,glabrescent,height,leaf,length,ovary,plant,pubescence,seed,shape,size,texture
683	wfo-0001031007	success	206	149	131	75	18	0.636	.5,0.2,0.5,0.5-1,1,1-1.2,1-1.5,1-3.5,1.2-1.5,1.3-,1.5-2,1.9-3,11-14,15,2.5-,2.5-5,3-4,4.5-5,5-12,5.5-6,50-100,6,7-10,<,abruptly,acute,adaxial,along,anther,apex,bark,base,beginning,berry,bifid,black,branching,broad,broadly,brown,calyx,capitate,chartaceous,cm,corolla,cuneate,cup-shaped,dark,deltate,dendritic,densely,diameter,drying,dull,elliptic,entire,extending,filament,flattened,fleshy,flower,fruit,glabrous,globose,growth,herbarium,impressed,inflorescence,irregularly,lamina,lax,leaving,lengthening,lilac,lobe,long,loose,many,margin,matte,midvein,minutely,mm,narrowing,narrowly,near,new,occasionally,papillate,pedicel,peduncle,peg,petiole,pitted,pore,poricidal,primary,prominent,pubescent,reddish,reniform,revolute,sagittate,shiny,shrub,sleeve,slit,sparsely,specimen,splitting,stellate,stellate-rotate,stem,stigma,stout,style,surface,tall,tangled,terminal,thin,time,tiny,tip,trichome,tube,usually,vein,vine,wide,woody	0.5-10,0.75-1.5,1.6-2,1/3,4-6,4-7,5,5-merou,8-10,abaxially,ag,alfway,almost,alyx,anthesi,apar,apparently,articulated,becoming,branched,c.,campanulate,cell,clustered,completely,dilated,eaf,eed,ellipsoid,exserted,free,fruiting,glabrescen,glabrou,ilament,intramarginal,junction,lobed,looping,lower,m.,markedly,multi-celled,nflorescence,nodding,often,older,orolla,outline,pale,papillat,per,perfect,pericarp,planar,plurifoliat,portion,rat,round-rectangular,ruit,scar,simple,slender,slightly,spaced,spreading,strongly,testal,twinin,ud,unit,upper,vary,way,ympodial	abaxial,age,artificially,color,form,glabrescent,height,leaf,length,na,number,ovary,plant,pubescence,seed,shape,size,texture
684	wfo-0001031022	success	287	144	123	164	21	0.429	0.2–0.3,0.3–0.6,0.5–1.4,0.5–5.8,0.6–1.0,0.6–1.2,0.6–1.6,0.6–2.4,0.7–1.7,0.8–3.4,0.9–1.9,1.0–4.5,1.1–8.3,1.2–2.3,1.4–4.0,1.8–12.1,1.9–2.8,10,12.9,14.9,2.3–3.1,2/3,3.2–4.9,3.9–6.5,4.5–21.9,5–7,6.9,abaxially,acuminate,adaxially,anther,apex,apiculate,appearing,arcuate,attenuate,bark,basal,base,becoming,black,brown,calyx,capitate,caudate,channeled,chartaceous,cm,corolla,cream,cuneate,densely,diameter,distinct,dry,entire,evenly,ferruginous,filiform,flattened-reniform,flower,forking,fruit,glabrous,globose,green,interpetalar,lanceolate,leaf,length,lobe,lobed,long,margin,markedly,mature,midvein,mm,moderately,nearly,opaque,ovate,pedicel,peduncle,petiole,poorly,porrect,pubescent,purple,raised,reddish,rounded,sessile,short,shrub,simple,small,sparsely,stellae,stellate,stem,stigma,stipitate,straight,style,surface,terete,time,tip,tissue,toward,tree,truncate,tube,unbranched,vein,well-developed,white,yellow,yellow-ferruginous,yellow-tan,±glabrous,×	.04,0.1,0.2–0.9,0.3–0.8,0.4–0.5,0.4–1.2,0.4–1.3,0.5–1.5,0.5–2.2,0.6–2.6,0.7,0.8–1.2,0.8–1.3,0.8–2.9,1.0–2.6,1.1–3.4,1.2–2.6,1.5–2.5,1.6–4.8,1/3,1/4,1/4–1/3,10.5,17–145,2.8–6.3,3.2–7.0,3.8,4–6-merou,4–9,5.1–8.7,5.8–11.4,5–8,6–10,8.2,8.8,8.9,90°,absent,acute,adnate,aequilateral,along,alyx,anthesi,apart,apical,apparently,appressed,arching,area,around,articulate,axe,ba,bent,berry,blade,branch,broad,brochidodromous,bud,bulge,central,clinate,crea,deciduous,dentate,development,difoliate,directed,directly,distal,distally,eaf,edge,eed,either,emerging,endocarp,erect,exocarp,extending,extra-axillary,fertile,filament,free,geminat,glandular,glossy,gradually,hair,heterostylous,immature,increasing,intac,internode,intersepalar,juic,large,lateral,layer,less,lon,longer,lower,major,many,midpoint,midrib,minor,minute,nflorescence,oblique,opposed,orolla,oval,ove,per,perforated,pore,portion,potentially,ray,reflexe,remaining,reticulate,ridge,rigid,row,ruit,semicraspedodromous,several,shorter,side,sinus,sloughing,smooth,sometimes,spaced,splitting,spread,spreading,stellate-pubescent,stipe,suture,tamen,tardily,tem,thin,transparent,two,ud,unarmed,unit,upper,various,vary,weakly,well,wide,ympodial,young,±90°,±equal	abaxial,adaxial,arrangement,branching,color,form,growth,height,history,inflorescence,life,number,ovary,perennial,plant,primary,pubescence,seed,shape,size,texture
685	wfo-0001031036	success	150	86	65	85	21	0.433	.25,.5,0.8-1,0.8-1.2,1-1.3,1-2.5,1.2-1.5,1.5-3,10-20-flowered,12-15,2-2.5,3-4,4.5-6.5,5-6,abaxially,adaxially,along,angle,anther,base,bi-lobed,broadly,calyx,cm,conical,corolla,crisped,decurrent,dia,elliptic,filiform,flattened-reniform,glabrous,globose,green,greenish-white,leaf,lobed,margin,minutely,mm,nearly,ovary,pedicel,petiole,pitted,sagittate,shiny,shrub,simple,size,slightly,stem,stigma,style,surface,tapering,thickened,trichome,tube,uniseriate,white,winged,x,young	.2,0.5-1,2.2-3.7,3-5,3.5-5.5,7-8,acuminate,acute,anthesi,apex,arising,axil,ba,becoming,berry,brown,closely,dark,deflexed,differing,difoliate,dry,drying,eaf,edicel,eed,ellipsoid,enlarged,erect,exserted,filament,fleshy,free,fresh,fruiting,geminat,knob-like,lamina,lateral,lobe,lon,long,lower,main,major,material,middle,minor,nflorescence,oblique,older,onto,opposite,overlappin,pair,papillo,papillose,perhaps,planar,pointed,pore,poricidal,portion,rounded,ruit,scar,shaped,short,sinus,soon,spaced,spathulate,strongly,tall,tear-drop,tip,tub,ud,unit,usually,vein,widest,woody,yellowish,ympodial	abaxial,color,colour,diameter,flower,form,fruit,growth,hair,height,history,inflorescence,length,life,perennial,plant,pubescence,seed,shape,texture,type
686	wfo-0001031040	success	217	139	96	121	43	0.442	10,6,abaxially,acute,adaxially,age,anther,apical,attenuate,base,branch,broad-based,broadly,calyx,cm,deeply,diameter,directed,dull,either,entire,flattened-reniform,flower,flowering,fruit,glabrescent,glabrous,glandular,globose,green,hair,inflorescence,lanceolate,lateral,lavender,leaf,lighter,long,longer,margin,midvein,minute,minutely,mm,much,narrowly,older,ovate,pedicel,peduncle,petiole,pinnatifid,pitted,plant,pore,porrect,prickle,purple,rarely,ray,recurved,rounded,scabrous,sessile,sessile-stellate,shape,shrub,simple,size,slightly,small,sometimes,somewhat,sparse,sparsely,sprout,stellae,stem,straight,subcordate,subcoriaceous,surface,thickened,tree,triangular,triangular-attenuate,tube,turning,unarmed,upward,vein,vigorous,violet,white,yellow,yellow-brown	.5,0.1–0.3,0.2–0.6,0.3–3,0.8–7.5,1.2–1.3,1.2–2.1,1.4–2.7,1.5–4,1.5–5,1.7,1.7–3.1,10–10.5,10–13,12–14,15–23,1–1.4,2,2.2–2.5,2.4–3,2.5–4,2.5–9,2–10,2–5-branched,3,3.5–5,3–26,3–4.5,3–5,4–6,5,5-merou,6.5–25,6–6.5,6–8,7–9,8–30,accrescent,acuminate,adaxiall,also,alyx,anthesi,apart,apex,apparently,articulated,axe,ba,becoming,berry,blade,capitat,contrasting,dark,densely,depending,difoliate,distall,eaf,eed,especially,filament,filiform,finely,free,geminat,glabrou,gland-tipped,highly,homostylous,immature,internode,interpetalar,larger,like,lobe,lobed,lon,lower,major,midpoint,midzone,nflorescence,numerous,orolla,outside,ovoid,pale,perfect,persistent,principal,probably,ruit,scarcely,several-celled,short,side,similar,soon,spaced,splitting,stellate,stellate-pubescent,stigma,style,tamen,tem,time,tissue,ud,unit,usually,variable,vary,vigor,wide,yellowish-tawny,ympodial,×,–6	0.1-0.3,0.2-0.6,0.3-3,0.8-7.5,1-1.4,1.2-2.1,1.5-4,1.7-3.1,12-14,15-23,2-10,2-5-branched,2.4-3,2.5-4,4-6,6.5-25,7-9,8-30,abaxial,adaxial,arrangement,bark,branching,color,corolla,distally,form,growth,height,history,length,life,main,na,number,perennial,primary,pubescence,seed,texture,trichome,ye,young
687	wfo-0001031062	success	216	95	56	160	39	0.259	-5.5,.5,2,20,4,anther,base,branch,calyx,campanulate,chartaceous,cm,cuneate,densely,diameter,entire,ferruginous-tomentose,flattened-reniform,flower,forked,fruit,glabrous,globose,hair,leaf,lobe,main,margin,mm,ovate-lanceolate,pedicel,per,petiole,plant,rotate-stellate,sessile,shallow,shape,shub,side,simple,size,stellate,stellate-tomentose,stem,stipitate,tapered,tomentose,treelet,truncate,unarmed,unbranched,white,x,yellow,young	0,0.3,0.5,0.5–0.6,0.7–0.8,1,1.2–1.4,1/3,13–15,15,16,17,1–2.5,1–4,2-3.5,2.5,22,2–3,2–5.5,3,3-8,3–10,4–10,4–4.5,5,5–7-rayed,7,7–15,7–8-rayed,9–11,?,abaxially,absent,accrescent,acute,adaxiall,adaxially,ag,ample,apart,apex,apiculate,appearing,armed,articulated,axe,ba,blade,bottom,brownish,bud,capitat,clustered,colored,connivent,count,curved,cylindrical,diamete,difoliate,directed,distally,eaf,eed,even,eventually,except,extra-axillary,fertile,filament,foveolate,fragrance,fruiting,fully,geminat,glabrou,grading,green,heavily,ilament,interpetalar,juvenile,larger,lateral,least,less,lighter,lobed,long,longitudinal,loosely,lower,m.,midpoint,midrib,minutely,much,nearly,nflorescence,numerous,obscuring,obsolete,often,one,opening,orolla,overtopped,part,partially,pentagonal,perfect,perhaps,pore,prickle,pubescent,rachi,rarely,recurved,rest,ripe,ruit,scabrous,short,short-stalked,slightly,slit,small,sometimes,spaced,sparsely,sprout,stellae,stigma,straight,style,surface,sweet,tall,tem,terminal,thick,thick-based,tip,tissue,toward,triangular,tube,unarme,unifoliate,uniform,unit,uppermost,usually,vary,vigorous,visible,wide,ympodial,younger,–3	0.7-0.8,1-2.5,1-4,1.2-1.4,13-15,2-5.5,4-10,4-4.5,7-15,7-8-rayed,9-11,abaxial,adaxial,arrangement,bark,branching,color,corolla,form,growth,height,history,inflorescence,length,life,midvein,na,number,ovary,peduncle,perennial,primary,pubescence,seed,tertiary,texture,trichome,vein,venation
688	wfo-0001031064	success	179	114	94	85	20	0.525	.0-2.5,.5,.5-1,0.5,0.5-0.7,1-1.2,1-2,1-3,1.2,1.5-2,10-12,10-12.5,10-17,2.5-3,3,3-5.5,3.5-4,4-5-celled,5-6,7-16,anther,anticlinal,arising,axil,base,bright,calyx,cm,completely,conical,corolla,dark,deltate,densely,diameter,elongate,fleshy,fruit,fruiting,glabrous,globose,green,half,highly,inflorescence,irregular,leaf,leaflet,lightly,lobe,lobed,long,lower,margin,minutely,mm,nearly,node,obovate,ovary,ovate,ovoid-reniform,papillate,pedicel,petiole,pinnate,poricidal,projection,pubescent,purple,rachi,rugose,scattered,short-pubescent,shrub,simple,single,sinuous,somewhat,sparsely,stem,stigma,style,surface,thickening,tip,translucent,trichome,tube,uniseriate,white,winged,without,x	.05,0,0-15,0.5-0.8,1,1.7-4.2,2,3-7,5-10.5,6-16,8-10-celled,abaxially,acroscopic,acuminate,adaxially,along,anthesi,apex,attenuate,basal,bearing,berry,blade,broader,cell,clavat,commentary,conspicuous,denser,distal,dr.,eaf,edicel,eed,epidermal,erec,exserted,filament,flower,free,irregularly,lamina,lateral,leave,lenticel,like,lon,lost,minute,narrower,near,nflorescence,nodding,occasionally,often,open,pair,per,petiolule,planar,portion,prominent,pubescen,ruit,scar,see,side,sinus,slender,smaller,splitting,strongly,swollen,tal,tem,terminal,time,tub,ud,unifoliat,unit,usually,vein,wand-like,ympodial	arrangement,branching,bud,clavate,color,form,growth,height,history,length,life,number,perennial,plant,pubescence,seed,shape,size,texture,unifoliate
689	wfo-0001031065	success	140	111	69	71	42	0.493	.4,.6,1-celled,aculeate,acute,almost,anther,armed,attenuate,base,calyx,chestnut,cm,color,concolorous,corolla,deltate,dense,dia,eglandular,entire,externally,extra-axillary,ferruginous,filament,flower,fruit,glabrous,glandular,green,green-striate,herb,indumentum,light,lilac,lobe,lobed,margin,midvein,mm,narrowly,non-glandular,nonglandular,ovary,ovate-lanceolate,ovoid,pale,pedicel,peduncle,petiole,puberulous,rough,rounded,scabrid,simple,slightly,sometimes,sparse,spheroid,stellate,stem,stigma,style,subshrub,surface,trichome,umbelliform,white,x	.1–0.3,.2,.3,.5–2,0.2–1.1,0.5–1.6,0.5–5,0–30,1,1-,1.8–7.8,2,4,4-merous,5-merous,accrescent,acicular,acuminate,also,alyx,apex,apical,apparently,asymmetrical,berry,beyond,cell,celled,central,composed,difoliate,eaf,eed,either,erect,frui,geminate,held,lamina,lateral,lower,many,many-celled,midpoint,multi-celled,nflorescence,occasionally,orolla,per,perfec,perhaps,persistent,porrect-stellate,portion,radial,rare,rarely,ruit,sessile,shor,short,short-pedunculate,solitary,spine,tall,terete,unifoliat,unit,upper,usually,ympodial	.5-2,0-30,0.2-1.1,0.3,0.5-1.6,0.5-5,1.8-7.8,abaxial,adaxial,annual,arrangement,bark,branch,branching,diameter,drying,form,growth,height,history,inflorescence,leaf,length,life,main,na,number,plant,primary,pubescence,ray,seed,shape,size,tertiary,texture,tube,unarmed,vein,venation,width,young
690	wfo-0001031071	success	186	104	83	103	21	0.446	0.2-0.8,1-1.5,1-2,1-3,2-8,2.1-3,2.4-3.4,3-10,4-25,4-6,5-9.4,6-8,7-16.5,7-8,8-28,abaxially,adaxially,anther,blue,brownish,cell,clavate,cm,color,condition,coriaceous,corolla,covering,dark,deep,diameter,distal,drying,elliptic,flower,forked,fresh,fruit,generally,glabrous,globose,green,greenish,hair-like,half,herb,lanceolate,lateral,leaf,lilac,long,medium,mm,moniliform,mottled,odd-pinnate,ovate,ovoid,pedicel,peduncle,pentagonal,petiole,plant,poricidal,purple,rotate,seed,size,spot,star,stigma,style,testal,thick,tip,tube,tuber,usually,wall,white,whitish,x,yellow	0-10,0.4-2,1-7,1.5-2.2,2-3,2-5,3-5,3-6,3.8-5.4,5-merou,5.7-8.8,abaxiall,acumen,acute,ag,along,alyx,apart,apex,apparently,arranged,articulated,asymmetric,attenuate,axe,axillary,base,basiscopic,bead,berry,blade,bud,capitat,connivent,decreasing,digestion,dorsally,eaf,edge,eed,enzyme,erec,exceeding,filament,flat,folded,geminat,glabrou,green-white,homostylous,honeycomb-shaped,interjected,leaflet,lengthening,like,living,lobe,lower,make,middl,mucilaginous,multiple,narrowly,necklace,nflorescence,orbicular,orolla,pair,perfect,petiolulate,plurifoliate,pore,removed,ripe,round,ruit,sessile,seudostipule,short,side,slightly,slit,spaced,specimen,stamen,stolon,straight,subequal,subtending,tall,tamen,tem,terminal,throughout,tissue,toward,tri-,typically,unit,vary,wet,winged,ympodial	abaxial,adaxial,arrangement,branching,calyx,capitate,form,growth,height,history,inflorescence,length,life,na,ovary,perennial,pseudostipule,shape,stem,surface,texture
691	wfo-0001031097	success	174	117	99	75	18	0.569	0.45,1-4,1-4.5,1.6-5.5,1.8-2.5,13-30,2-3,2-3.3,2-4,3-5,3.7-8.4,4-6,4-7,5-12,5-9,8-11,9-21,abaxial,abaxially,adaxially,along,apical,apically,base,branched,calyx,cm,connate,corolla,cyme,darker,deep,dehiscent,diameter,dichasial,dichasially,diminishing,distal,dotted,ebracteate,edge,elliptical,flower,forked,frequently,generally,green,green-white,half,herbaceous,introrse,lateral,leaf,leaflet,light,lighter,lobe,long,margin,maturing,medium,mm,monochasial,mottled,narrow,noticeably,obovate,odd-pinnate,often,ovate,ovoid,pedicel,peduncle,pentagonal,perennial,petiole,plant,poricidally,puberulent,pubescent,purple,rapidly,rotate,seed,short,side,size,slit,stigma,straight,strigose,style,terminal,throughout,toward,violet,violet-blue,wide,yellow	0.5,1,1-3,1.5,1.8-2.6,3-6-foliat,3.5-6,5-11,acumen,acuminate,acute,apex,articulate,cell,covering,cuneate,decurrent,digestion,dorsally,eaf,eed,emoval,enzyme,exceeding,filament,flat,folded,globo,gree,hair-like,highly,honeycomb,interjected,interpetalar,living,lon,lower,lunat,make,mucilaginous,nflorescence,nther,oblique,orolla,pair,pattern,perfect,petal,petiolulate,petiolule,plan,proximal,rachi,rarely,reveal,ruit,sessile,seudostipule,sometimes,specimen,stamen,tal,tem,testal,thick,tissu,tuber-bearing,typically,unit,vary,vbase,wall,without,ympodial,¼	anther,arrangement,color,form,fruit,globose,growth,height,history,inflorescence,length,life,na,ovary,shape,stem,surface,texture
692	wfo-0001031101	success	197	141	119	78	22	0.604	-1,-16,-30,-5,-8,/2,0.05-0.2,0.1-0.2,0.5-0.8,0.5-3,0.6-0.8,0.8-,1-,1-2,1-2.3,1.3-2,1/4-1/2,10-30,2-2.8,2-4,2-5,2-6,2.5-,2.5-3.8,3-15,3-8,3.5-4.5,4-10,8-15,abaxial,abaxially,adaxial,almost,anther,apical,apically,apparently,bark,base,berry,branched,bright,calyx,cm,concolorous,connivent,diameter,drying,dull,entire,erect,evenly,filiform,flattened-reniform,flower,glabrescent,glabrous,glandular,green,hair,lateral,leaf,length,lobe,lobed,long,margin,maturity,mauve,membranous,minute,mm,moderately,multangulate,narrow-deltate,near,obtuse,often,one,open,orange-brown,orange-red,ovate,pale,pedicel,peduncle,petiole,poricidal,porrect,ray,red,resembling,rounded,scandent,sessile,shrub,simple,sparsely,spherical,stalked,stellate,stellate-pubescent,stem,straight,style,tapering,terete,terminal,time,tip,trichome,umbel,unarmed,variously,way,white,wide,yellow,young	-20,/2-equal,0.1-0.3,0.3-0.5,0.7-0.8,1-3,1.3-2.5,1.4-1.7,1.5-3,1/3-1/2,2.5-3.5,3-10,4-5-merous,4-7,4.5-9,5-20,5-6,6-10,acuminate,alyx,ame,apar,apex,articulated,ba,blade,c.,deltate,difoliate,eaf,eed,elongating,equal,filament,free,frui,fruiting,geminat,green-brown,herbaceous,infructescence,long-acuminat,long-acute,longer,lower,mature,midpoint,nflorescence,older,orolla,oung,pair,pendulous,per,perfec,pericarp,portion,primary,red-brow,ruit,scar,smooth,spaced,spreading,stalk,stellate-pubescen,surface,tamen,tertiary,tube,unarme,unit,vary,vein,venation,visible,yellow-green,ympodial	arrangement,branching,color,corolla,form,fruit,growth,height,inflorescence,long-acuminate,midvein,na,number,ovary,plant,pubescence,red-brown,seed,shape,size,stigma,texture
693	wfo-0001031114	success	208	123	98	110	25	0.471	.2,.5,0.5,0.7-1.5,0.8-1.2,1-10,1-7,2-17,2-3,2-4,2-7,2.5-3,2/3,3-10,3-4,4-10,4-5,4.5-6,6-7,acuminate,acute,anther,apex,base,becoming,blade,branched,brown,calyx,chartaceous,cm,connivent,dark,deltate,densely,diameter,discolorous,distal,elliptic-ovate,entire,especially,first,flattened,fruit,glabrous,globose,green,hair,highly,leaf,light,long,major,margin,membanaceous,minor,mm,multangulate,oblong,obtuse,outline,ovate,pedicel,peduncle,petiole,porrect,pubescent,purple,reniform,ripe,rounded,rugulose,shrub,side,small,sparsely,stellate,stellate-pubescent,stem,stigma,strongly,style,subcoriaceous,subcuneate,surface,thickened,tip,toward,tree,truncate,tube,vein,white,white-pubescent,white-stellate,x,yellow,yellowish	.1,0-0.3,0.3-0.5,0.5-1,1-1.5,1-2,1-4.5,1-8,1.5-2.5,1.5-4,10-15,25-50,3-5,3-7,4-8,5-10,5-8,5-merou,7-15,abaxially,absen,accrescent,adaxiall,adaxially,ag,alyx,apart,apparently,articulated,axe,ba,berry,capitat,covering,cylindrical,differentiated,directed,distally,dried,eaf,echinoid,eed,equal,erect,filament,fleshy,flower,free,frui,fruiting,geminate,homostylous,impressed,interpetalar,introrsely,juic,lacking,large,leaf-opposed,like,lobe,long-stalked,longitudinal,lower,midpoint,nearly,nflorescence,nodding,often,one,opening,orolla,paired,part,perfect,pericarp,plurifoliate,pore,prominent,rachi,ray,ruit,sessile,short,short-,short-stalked,simple,slightly,slit,somewhat,spaced,stalk,ste,straight,subcucullate,subtending,tall,tamen,tem,thin,time,tissue,triangular,unarme,unit,vary,whitish,wide,without,ympodial	abaxial,adaxial,branching,capitate,color,corolla,form,growth,height,history,inflorescence,length,life,na,number,ovary,perennial,plant,pubescence,seed,shape,size,texture,unarmed,ye
694	wfo-0001031116	success	191	142	117	74	25	0.613	-10,.5,.8,/4,0,0.05-0.15,0.3-0.5,0.7-1,1-5,1/2,1/6-1/4,10-14,15-25,2-5,2.7-3.2,3.5-4,30-100,4-7,5-15,8-11,9-13,abaxial,abaxially,adaxial,almost,anther,apically,apparently,attenuate,bark,base,berry,blade,branching,bristle,broad-deltate,calyx,cm,collapsed,densely,diameter,discolorous,drying,dull,elliptic,erect,evenly,filament,flattened-reniform,flower,fragile,fruit,glabrescent,glabrous,glaucous-green,green,lateral,leaf,length,lobe,lobed,long,lower,margin,maturity,mauve,membranous,mm,moderately,multangulate,narrow-deltate,obovate,obtuse,often,orange-brown,orange-red,pair,pedicel,peduncle,petiole,poricidal,primary,ray,red-brown,reflexed,rounded,secondary,shrub,simple,slender,small,soft,sometimes,sparsely,spherical,stellate,stellate-pubescent,stem,straight,style,subentire,surface,tapering,tertiary,tip,tree,trichome,tube,unarmed,upper,vein,venation,way,weakly,wide,yellow,young	.2,0.1,0.4-0.7,0.7-0.9,1,1/3-2/,30-50,4-10,5,5-merous,acuminate,alyx,ame,apar,apart,apex,arachnoid,articulated,brow,c.,caudate,clearly,connivent,dirty-white,eaf,eed,elongated,elongating,epidermi,equal,flat,flexuous,free,fruiting,hair,infructescence,less,longer,mature,midpoint,minute,nflorescence,obtu,older,one,open,orolla,oung,per,perfec,pericarp,perpendicular,plurifoliat,portion,recurved,ruit,scar,sessile,sharply,shortly,single,smooth,spaced,stalk,stalked,tamen,terete,time,unarme,unit,vary,visible,woody,ympodial	1/3-2/3,arrangement,branch,brown,color,corolla,form,growth,height,history,inflorescence,life,main,midvein,na,number,ovary,plant,pubescence,seed,shape,size,stigma,texture,width
695	wfo-0001031127	success	196	140	114	82	26	0.582	+,.5,0.5,0.5-1.3,0.8-2,1-1.5,1.5-2,1.5-2.5,1.5-3,12268,2,2-3,2-lobed,3-4,3-5,3.5-4,3.5-7,30-100,5-8,6-6.5,7-30,8-16,?,abaxially,adaxially,almost,anther,anthesi,apex,armed,attenuate,bark,base,berry,brown,calyx,capitate,chartaceous,cm,conical,corolla,cupuliform,deep,densely,diameter,ekman,elliptic,elongate,fide,filament,flattened,flower,fruit,glabrous,globose,growth,inflorescence,lanceolate-elliptic,leaf,like,linear,lobe,lobed,long-styled,long-triangular,margin,membranous,minutely,mm,nodding,number,ovary,pair,pale,pedicel,peduncle,pentagonal,petiole,pinnatifid,pitted,poricidal,porrect,prickle,primary,prominent,pubescent,purple,ray,red-violet,reddish,reniform,sessile,shallowly,shiny,short-stalked,shrub,simple,sometimes,somewhat,sparsely,stellate,stem,stigma,style,surface,tan,tapering,thin,tip,trichome,tube,vein,x,yellowish	-2,0.3-0.4,0.4-1.5,0.5-1,0.5-3,0.8-1,1,1-5-2,3/4,4,5,8,acicular,acute,apar,apparently,articulated,cell,eaf,eed,ellipsoid,elongating,equal,even,extremely,free,fruiting,heterostylous,hyaline,included,individual,internodal,lamina,long,lower,m.,midpoint,midrib,minute,near,new,nflorescence,older,open,opposite,outline,papillat,per,pericarp,planar,plurifoliat,pore,portion,prickly,rectangular,reduced,relatively,rest,ruit,scar,scattered,shin,short-styled,sinuate,sinus,slightly,slit,spaced,spreading,stout,testal,time,ud,unit,upper,variable,way,widely,woody,yellow,ympodial,½	abaxial,adaxial,arrangement,branch,branching,color,form,height,history,length,life,main,midvein,na,papillate,plant,pubescence,seed,shape,size,tertiary,texture,unarmed,venation,width,young
696	wfo-0001031128	success	213	132	112	101	20	0.526	-10,-100,-4.5,-6.5,/4,0,0-30,0.05-0.2,0.6-1,0.8-1.7,1-,1.5-3,1.5-3.5,2-5,2-9.5,2.3-,20-50,20-60,3-4,3.5-4.5,5-19,5-30,8-12,8-23,abaxial,abaxially,acute,anther,apex,apically,apparently,base,berry,branched,branching,bristle,calyx,cm,concolorous,connivent,cuneate,deltate,densely,diameter,drying,elliptic,entire,erect,evenly,flattened-reniform,flower,fruit,glabrescent,glabrous,glandular,green,hair,inflorescence,lateral,leaf,length,lobe,lobed,long,long-acuminate,margin,maturity,mauve,membranous,minute,mm,moderately,multangulate,near,pair,pale,pedicel,peduncle,petiole,poricidal,primary,purple-black,ray,red,red-brown,sessile,shallowly,short-attenuate,shrub,simple,soft,spherical,stalked,stellate,stellate-pubescent,stem,tapering,terminal,tertiary,tip,trichome,tube,unarmed,undulate,vein,venation,way,weakly,white,wide,yellow-green,young	0.05-0.25,0.2,0.2-0.4,0.3-0.8,0.5-0.7,0.5-0.8,0.5-1.5,0.5-5,1,1-1.6,1.2-2,1/,1/6-1/3,10-20,10-35,2.5-10,2.5-3.5,4-5-merous,4-7,5-,5-15,almost,alyx,apar,apart,ape,articulated,bark,blade,brown,dull,eaf,eed,elongated,elongating,equal,eye,filament,filiform,flexuous,free,fruiting,gland,gra,infructescence,less,lon,long-acuminat,longer,lower,mature,midpoint,multangualte,naked,narrow-deltate,nflorescence,occasionally,often,older,one,open,orange-brown,orolla,oung,per,perfect,pericarp,perpendicular,plurifoliat,portion,recurved,reduced,reflexed,ruit,scar,secondary,short-styled,side,single,smooth,spaced,spreading,stalk,staminate,straight,style,surface,tamen,terete,time,unarme,unit,usually,variously,vary,visible,whitish,woody,yellow,yellow-brown,ympodial	adaxial,arrangement,color,corolla,form,growth,height,history,life,midvein,na,number,ovary,perennial,plant,pubescence,seed,shape,size,texture
697	wfo-0001031135	success	189	152	128	61	24	0.677	0-2,0.7-2,1-,1-1.5,1-10,1-3,1-4,1.5-2,1.5-3,10-20,2,2-,2-2.5,2-3,2-3.5,2-4,3-10,3-4,3-5,3.5-12,4-5,5-30,5-9-pinnate,abaxially,acuminate,acute,adaxially,adpressed,along,also,apart,apex,basal,base,basiscopically,calyx,campanulate,chartaceous,cm,color,compound,cordate,coriaceous,cuneate,cylindrical,darker,decurrent,deflexed,deltate,densely,diameter,dilated,distally,eglandular-pubescent,ellipsoidal,elliptic,entire,equal,especially,exceeding,fading,flattened,flower,frequently,fruit,fusiform,glabrous,glandular-,green,lateral,leaf,leaflet,light,lobe,lobed,long,longitudinal,margin,midrib,mm,moderately,obconical,oblique,oblong,obtuse,often,ovate,ovoid,papillose,pedicel,peduncle,peltiform,petiole,pilose,pink,pinnately,pinnatifid,puberulent,pubescent,purple,radiu,remnant,ripe,shorter,shrub,simple,slightly,spaced,sparsely,stigma,stripe,strongly,style,subcoriaceous,thecae,tip,toward,tree,truncate,unbranched,unlobed,upper,violet,white,whitish,x,yellow-green,yellowish	-7,0.5-2,1-2.5,1.5-9,2-23,2-5,2.5-28,4-foliat,5-11,7-15,absent,aggregate,ape,articulated,axe,beyond,biglandula,blade,broad,cell,connective,directed,eaf,eed,ellipsoida,exserted,hair,interstitial,irregularly,laterally,leaving,lon,lower,narrowed,nflorescence,nther,occasionally,orolla,pedicellar,perfect,pilo,pore,present,rachi,ruit,small,smaller,stamen,stone,tal,tem,time,tomento,triangular,tube,ud,unit,unknow,vary,wide,ympodial	anther,arrangement,biglandular,bud,corolla,deflexion,form,growth,height,history,inflorescence,length,life,ovary,perennial,plant,pubescence,seed,shape,size,spacing,stem,surface,texture
698	wfo-0001031143	success	217	155	94	123	61	0.433	2,3,4,acute,anther,apex,articulated,attenuate,base,bifoliate,blade,branch,broadly,cm,densely,diameter,elliptic,entire,evenly,extra-axillary,filament,filiform,flattened-reniform,flower,fruit,glabrescent,glabrous,globose,green,hair,interpetalar,irregularly,lateral,leaf,length,like,lobe,long,margin,maturing,midvein,minute,minutely,mm,moderately,narrowly,near,nearly,oblong,often,ovate,pale,pedicel,peduncle,per,petiole,pitted,porrect,prickle,rarely,ray,repand,sessile,shallow,short-caudate,shrub,side,simple,slender,smooth,soon,stellae,stellate,stellate-tomentose,stem,stigma,style,subcordate,surface,thick-chartaceous,tip,tissue,truncate,tube,unarmed,usually,vein,weak,well-developed,white,yellow,yellow-ferruginous,yellow-orange,×	0.3–0.5,0.3–0.8,0.4–0.8,0.4–1,0.7–0.9,0.9–1,0–50,1.1–2,1.4–1.7,1.5,1.5–1.9,1.5–2.5,1.5–3,1.5–5.5,10,10.5–11,15–23,1–1.2,1–1.5,1–4,2.3–2.5,2.5,2.5–4,2.5–4.5,2–2.5,2–3,2–3-branched,2–9,3–3.5,4–8-rayed,5,5-merou,5–7,6–8,7–12,8–10,9,abaxially,acicular,adaxially,alyx,apart,apical,apparently,appearing,armed,axe,ba,berry,blad,broad,broad-based,bud,capitat,contrast,dark,directed,distall,dried,eaf,eed,except,fertile,finely,forming,free,geminat,glabrou,half,high,homostylous,immature,internode,lanceolate,large,layer,leaving,lon,lower,major,material,midpoint,midrib,midvei,minor,mixed,mostly,much,nflorescence,orolla,overlapping,ovoid,pore,potentially,principal,remaining,ruit,set,several,shorter,sinus,spaced,splitting,stellate-tomento,stipe,stipitate,straight,tamen,tardily,tem,time,tomentum,ud,unarme,various,vary,wide,ympodia,–11,–2.5,–4,–4.5,–8	0-50,0.3-0.8,0.4-0.8,0.7-0.9,0.9-1,1-1.2,1-1.5,1-4,1.1-2,1.4-1.7,1.5-1.9,1.5-2.5,1.5-3,15-23,2-2.5,2-3,2-3-branched,2.3-2.5,2.5-4,2.5-4.5,3-3.5,4.5,5-7,6-8,7-12,8,8-10,abaxial,adaxial,arrangement,bark,branching,calyx,capitate,color,corolla,drying,form,geminate,growth,height,history,inflorescence,life,main,na,number,ovary,perennial,plant,primary,pubescence,seed,shape,size,tertiary,texture,trichome,venation,width,young
699	wfo-0001031144	success	231	115	102	129	13	0.442	-13,.5,0.2,0.8-1.4,1-4,1.1-2.5,2-3,2.5-3,25,3-7,3.5-10,4-4.5,6,7-10,acute,adaxially,anther,apex,asymmetric,base,berry,branch,bright,broadly,brown,calyx,capitate,cm,commonly,connivent,cordate,corolla,densely,diameter,divaricate,ellipsoid,elliptic,entire,filament,flattened,flattened-reniform,form,glabrous,globose,groove,growth,inflated,inflorescence,later,lateral,leaf,less,lobed,loosely,many,margin,membranous,minute,minutely,mm,new,oblique,occasionally,open,pale,pedicel,peduncle,petiole,pinnately,pinnatifid,pitted,poricidal,pubescent,red,reddish,ripe,seed,shiny,simple,slightly,sparsely,stellate-rotate,stem,stigma,style,surface,tan,terete,terminal,tiny,tip,triangular,trichome,truncate,tube,uniseriate,vine,violet,woody,x,yellow,yellowish	-11,.2,0.5,1-,1-1.5,100,2,2-,2-6,2-9,2/3,3-4.5,4,4-20,4-6,5,5-9,5-merou,<,acuminate,ag,alyx,anthesi,apart,apicula,apiculae,appearing,ark,around,articulated,away,axi,basal,basiscopically,blac,branche,brow,cell,closer,corresponding,cupped,curved,drying,eaf,eed,elongate,elongating,exserted,extending,flower,four,free,fruiting,geminat,ilament,irregularly,lamina,larger,leaflet,leaving,lengthening,like,lobe,long,longer,longest,lower,markedly,mere,near,nflorescence,number,often,older,one,orolla,outline,pair,papillo,peg,pendant,pentagonal,per,perfect,pericarp,plurifoliate,pore,portion,primary,progress,quite,rim,ruit,scar,sleeve,slit,small,smaller,sometimes,spaced,spreading,strongly,tangle,tem,testal,thin,third,together,tuft,twinin,twining,two,ud,unequal,unit,upper,usually,variable,vary,vein,wall,way,weight,white,widest,wing,wood,ympodial,½	abaxial,adaxial,arrangement,bark,branching,color,fruit,length,ovary,papillose,shape,size,texture
700	wfo-0001031152	success	232	125	105	127	20	0.453	-10,.4,/100-1/16,0.2-0.3,0.2-1.5,1-3,1-6,1.1-2.2,1.2-1.8,1.4-2.6,1/2-3/4,11,13-27,2-5,2.5-7.5,2.7-3.7,4-19,4-6,4-8,8-20,acute,adaxially,anther,apart,attenuate,basal,base,becoming,blade,blunt-tipped,branched,brown,bud,bullate,chartaceous,cm,conical,continued,corolla,deltoid,densely,diameter,due,entire,flower,fruit,glabrous,globose,granular-tomentose,greenish,growth,hair,honeycombed,lanceolate,lateral,lavender,leaf,length,lilac,long-,margin,mixed,mm,mostly,multangulate,oblanceolate,oblong,occasionally,openly,orbicular,pale,pedicel,peduncle,persistently,petiole,porrect-stellate,probably,pubescent,reniform,reticulate-punctate,ripe,rotate-stellate,scabrous,sessile,short-,shrub,sparingly,stellate-pubescent,stem,stigma,style,suborbicular,surface,terete,terminal,thick-stalked,time,tomentose,tree,unarmed,violet,x,yellow,yellowish,young	-1.5,-5.5,0-100,0.3-1.3,0.3-3,1-1.5,1.1-3,1.3-4,1.5-3,1.5-3.5,1/2-2/3,2.7-4.5,2.7-6,2.8-4,3.7-7,4-7,5-6,6.5-10,9-13,abaxially,accrescent,acuminate,ag,along,anthesi,apex,apical-lateral,apparently,articulated,axe,axillary,ba,berry,blister,branch,calyx,capitat,closely,decurrent,dehiscing,directed,eaf,earl,eed,evident,exserted,extend,few-rayed,filament,fleshy,free,fruiting,glabrescen,green,high,inserted,introrse,lackin,large,less,lobe,lobed,long,longer,longitudinal,lower,m.,main,midvein,moderately,multangulat,narrowly,nearly,nflorescence,obtuse,one,open,orolla,ovate,partly,perfect,pitted,plurifoliate,pore,rachi,rather,ray,reddish,reddish-brown,relatively,ruit,runk,short-stalked,side,simple,slightly,slit,somewhat,soon,spaced,sparsely,splitting,stamen,stelliform,stipitate-glandular,stout-stalked,strongly,suture,swelling,tamen,testa,thick,thin,thin-,thin-stalked,touching,toward,tube,unarme,unit,usually,variously,vary,vein,way,wide,ympodial	.3-3,abaxial,branching,capitate,color,form,glabrescent,height,history,inflorescence,life,ovary,perennial,plant,pubescence,seed,shape,size,texture,ye
701	wfo-0001031155	success	193	114	84	109	30	0.435	0.5,1-1.2,1-1.5,1.5-2,1.5-5,2-5,2.5-3.2,4-,4-6,4.5-7,5-20,5-7,7-15,8.5-13,almost,anther,armed,bark,base,beneath,bilobed,calyx,climbing,cm,corolla,cup-shaped,deeply,deltate,densely,diameter,discolorous,echinoid,elliptic,evenly,filament,flower,glabrous,growth,heavily,height,inflorescence,lanceolate,lobe,lobed,margin,minutely,mm,multangulate,narrowly,oblique,obtuse,once-branched,open,pair,pale,pedicel,peduncle,petiole,poricidal,prickly,primary,pubescent,ray,shallowly,shiny,shrub,simple,size,slightly,sparsely,stellate,stem,stigma,strongly,style,surface,tan,tip,trichome,tube,unknown,vein,white,x	.5,0,0.1,0.2,0.2-1.2,0.3-0.4,0.7,0.7-1.5,1,1.5,1.5-1.6,3-4-foliate,abaxially,acuminate,acute,adaxially,age,along,anthesi,apart,apex,apparently,appearing,articulate,axi,broader,bullate,cell,central,closely,common,cream,dark,distall,distally,due,eaf,eed,enlarged,equal,exserted,ferrugineous,fine,glabrescen,glandular,globose,halfway,heterostylous,hub-like,internodal,intertwined,know,known,larger,leaf-opposed,leaving,lengthening,like,long,longer,los,lower,midpoint,midrib,mixed,mixture,multiseriate,new,nflorescence,occasionally,older,orange,outline,papillat,part,peg,plurifoliate,pore,porrect,prickle,principal,purple,reddish,ruit,scar,seen,sessile,short-stalked,short-styled,small,somewhat,spaced,sparse,sparser,split,stalk,stout,straight,tapering,terminal,ud,unevenly,unit,variable,whitish,widely,within,yellowish,ympodial	abaxial,adaxial,arrangement,branch,branching,color,drying,form,fruit,glabrescent,history,leaf,length,life,main,midvein,na,number,ovary,papillate,plant,pubescence,seed,shape,tertiary,texture,unarmed,venation,width,young
702	wfo-0001031162	success	241	137	106	135	31	0.44	.5,0-1.5,0.5-0.7,0.5-0.8,0.5-1.5,0.7-5,0.8-1.2,1-1.5,1-2,1.5-2,1.5-2.5,1.5-3,1.7-4.5,10-30,2-,2-2.8,3-10,3-branched,3.5-10,3.5-5.5,4-6,4-8,5-10,5-7,7-17,7-9,angled,anther,armed,attenuate,base,black,branch,broadly,calyx,chartaceous,cm,cordate,cylindrical,deeply,deltate,densely,diameter,eglandular,erect,extra-axillary,filament,flower,fruit,glabrous,globose,green,inflorescence,irregularly,lanceolate,lateral,leaf,length,lobe,lobed,long,margin,midpoint,midvein,minutely,mm,moderately,obtuse,outline,ovate,pale,pedicel,peduncle,perennial,petiole,porrect,present,prickle,pseudohair,pubescent,purple,ray,reniform,reticulate,rhizomatous,shrub,simple,sparsely,stalk,stellae,stellate,stellate-pubescent,stigma,style,surface,tan,throughout,time,triangular,tube,unbranched,vein,white,x,yellow,yellowish	%,-74,0,0-1.2,0-2.5,0-25,0.05-0.1,0.1-0.15,0.1-0.2,0.1-0.8,0.15-0.4,0.25,0.4-0.8,0.5-2,0.5-3,0.5-7,0.6-0.8,0.7-1.2,1-1.7,1-10,1-13,1-15,1-5,1-locular,1.2-1.4,1.5-1.9,1.5-8,10,10-12,15-20,2-7,2-foliate,20-40,26-,3-4,35-200,4-5,4-9,5-6,5-merou,6,6-7,6-8,60,600-1400,7-70,8-14,abaxially,absent,accrescent,acicular,across,acute,adaxially,adult,alyx,apart,apex,apparen,articulated,ascending,axe,ba,blade,branche,capitat,connivent,decimetre,directed,distall,distributed,dm,eaf,eed,exocarp,finger,fruiting,geminat,generally,gland-tipped,hair,half,homostylous,incomplete,index,interpetalar,juicy,juvenile,lamina,less,lobing,lon,longer,lower,mature,mesocarp,mid-point,minute,moderate,narrow,nflorescence,oblique,orolla,pair,part,pendant,per,perfect,placenta,pore,presen,rachi,ruit,septum,sessile,short,side,somewhat,spaced,sparse,straight,succulent,tal,tamen,tem,thick,tissu,tissue,transparent,unit,upper,vary,wide,wing,ympodial	abaxial,adaxial,arrangement,bark,branching,capitate,color,corolla,drying,form,growth,height,history,life,main,na,number,ovary,plant,primary,pubescence,seed,shape,size,stem,tertiary,texture,trichome,venation,width,young
703	wfo-0001031178	success	167	93	76	91	17	0.455	%,0-0.2,0.3-0.6,0.7-1.7,0.9-1.2,1.2-1.4,1.2-1.5,1.5-5.2,1.5-6,11-18,19-30,2-3.5,3.5-9,4-4.5,4-9,5-11,6-14,7-11,7.5-8.5,acicular,adaxially,anther,articulated,attenuate,base,brown,calyx,chartaceous,cm,cylindrical,densely,diameter,flower,fruit,glabrous,globose,green,grey,inflorescence,lamina,lanceolate,length,lobe,lobed,long,longer,mesocarp,midpoint,mm,moist,ovate,pedicel,peduncle,perennial,petiole,prickle,pseudo-racemose,purple,rusty,shallowly,shrub,solitary,sparsely,stellate,stellate-pubescent,stem,straight,style,thick,time,tube,unbranched,unknown,wide,x,yellow	0-0.25,0-0.4,0-0.6,0-10,0-5,0-6,0.1-0.2,0.1-0.25,0.4-0.6,0.6-0.9,0.6-1,0.6-1.2,0.7-1,0.8-1.2,1-2,1-3,1-4,1.2-3.4,180-400,2-5,40-65,5-merou,6-8,7-8,abaxially,absent,accrescent,across,acute,adaxiall,alyx,apart,apex,armed,ascending,axe,ba,blade,cuneate,d.,directed,distall,distributed,dult,eaf,eed,eglandular,entire,erect,extra-axillary,finger,fruiting,glabrou,gland-tipped,hair,half,hig,juic,lateral,lon,lower,margin,mature,midvein,minute,nflorescence,oblique,orolla,part,per,pore,porrect,presen,present,ray,rhizomatous,ruit,short,simple,spaced,stage,stalk,stellae,tamen,throughout,unit,unknow,uvenile,vary,vein,ympodial	abaxial,adaxial,color,corolla,form,growth,height,history,juicy,leaf,life,ovary,plant,pubescence,shape,size,texture
704	wfo-0001031185	success	213	144	131	82	13	0.615	-10,-8,.2,.5,0.5,0.5-3,0.8-1,0.9-,1,1-,1-1.2,1-1.5,1-4,1-5,1.2-5,2-9,2.5-16,2/3,3-4,4.5-7.5,7-10,anther,apex,appearing,articulated,attenuate,basal,base,blade,branched,bright,broadly,brown,calyx,capitate,cell,cm,commonly,conical,connivent,corolla,curved,deeply,densely,diameter,dry,ellipsoid,elongate,entire,eye,flattened,glabrous,globose,green,growth,inflorescence,lateral,lax,leaf,like,living,lobe,lobed,long,loosely,many,margin,material,mature,meter,midrib,minutely,mm,moderately,onto,open,outline,ovate,pair,pale,papillate,pedicel,peduncle,petiole,pinnatifid,pitted,poricidal,pubescent,red,reniform,ripe,seed,several,shape,shiny,shrub,simple,size,slender,slightly,sparsely,spreading,stellate,stem,stigma,style,surface,tan,terminal,thin,third,time,tip,trichome,truncate,tube,uniseriate,variously,vine,violet,wall,way,white,whitish,wide,widest,within,woody,yellow,yellowish,½	0.5-1.5,0.8-1.3,1-10,1.5-4,10-40,20,4-6,5-merou,>,acuminate,acute,ag,alyx,anthesi,apart,apically,appressed,ark,away,axi,berry,closer,deltate,distal,eaf,eed,exserted,extremely,filament,flower,free,fruiting,glabrescen,ilament,inflorescenc,irregular,irregularly,leaving,lengthening,lobbing,lon,lower,materia,new,nflorescence,older,orolla,part,particularly,peg,per,perfect,pericarp,plurifoliat,pointing,pore,portion,reflexed,rounded,ruit,scar,sinus,slit,small,spaced,spreadin,still,strongly,tem,thickened,toward,ud,ultimate,unit,upper,usually,variable,vary,visible,weak,winged,ympodial	arrangement,bark,branching,color,form,fruit,glabrescent,height,length,na,ovary,plant,texture
705	wfo-0001031195	success	216	130	110	106	20	0.509	%,0-0.7,0.2-0.4,0.3,0.5-0.7,0.5-1,0.6-0.8,0.6-1.5,1,1-1.5,1.4-1.6,1.5-2.5,10-13,10-14,10-19,11-28,2-2.5,2.5-4,3-3.5,3-6,3.5-4,3.5-5.5,4-7,5-9,5.5-10,7.5-8,acicular,across,acute,anther,apex,articulated,attenuate,base,broadly,calyx,chartaceous,cm,cuneate,cylindrical,deeply,densely,diameter,directed,distal,ellipsoidal,entire,filiform,finely,flattened,flower,fruit,glabrous,gland-tipped,globose,green,grey,hair,half,inflorescence,lamina,leaf,length,lobe,lobed,long,longer,margin,minute,mm,moderately,narrowly,obtuse,ovate,pale,pedicel,peduncle,perennial,petiole,plant,prickle,prostrate,pseudo-racemose,purple,reticulate,rusty,shallowly,short,shrub,solitary,sparsely,stellate,stellate-pubescent,stigma,stoloniferous,straight,style,surface,thick,time,tip,tube,unbranched,white,whitish,wide,x,yellow,yellowish,yellowish-green	0-3,0-8,0.05-0.3,0.2-0.5,0.25-0.35,0.3-0.4,0.6-3,1-2,1-4,1-locular,1.4-2.9,15-35,2,2-4,2-5,20-32,3-4,3-5,4-5,4-9,5-merou,6-10,7-8,8-9,9-15,abaxially,absen,absent,accrescent,adaxially,alyx,andromonoecious,apart,axe,ba,blade,capitat,center,confined,connivent,d.,difoliate,distall,distributed,eaf,eed,eglandular,exocarp,extra-axillary,filament,finger,fruiting,functional,geminate,heterostylous,incomplete,interpetalar,irregularly,juic,lateral,less,loosely,lower,mature,mesocarp,midpoint,midrib,midvein,moist,nflorescence,oblique,orolla,part,per,pore,porrect,presen,present,probably,rachi,ray,ruit,septum,sessile,simple,spaced,sparse,splitting,stage,stellae,tal,tamen,tem,throughout,tissu,tissue,transparent,triangular,unarme,unarmed,unit,uvenile,vary,vein,weakly,ympodial	abaxial,adaxial,branching,capitate,color,corolla,distally,form,growth,height,history,life,ovary,pubescence,seed,shape,size,stem,texture,width
706	wfo-0001031202	success	198	124	110	88	14	0.556	.1,.5,0-1,0.5-1,0.6-1.1,0.8-1,1-1.5,1.5-2.5,15-40,2-3,2-8,2.5-3.5,2.5-4,2/3,20-100-flowered,3.5-4,6-25,9-20,abrupt,along,anther,bark,base,beneath,broadly,calyx,capitate,cm,complex,corolla,cup-shaped,decurrent,densely,dia,dry,erect,filament,fleshy,flower,fruit,furcate,glabrate,glabrous,globose,golden,green,hard,inflorescence,later,lateral,leaf,like,lobed,long,many,minute,minutely,mm,narrowing,obovate,occasionally,older,opposite,ovary,overtopping,ovoid-reniform,pale,paler,papillose,pedicel,petiole,pitted,plant,poricidal,puberulent,pubescent,reddish-brown,scattered,shape,shaped,shoot,shrub,size,slender,small,sparsely,specimen,stem,stigma,straight,style,surface,tan,tapering,tear-drop,terminal,thick,time,tip,tree,trichome,tube,uniseriate,vein,way,white,winged,woody,x,young	0-0.5,0.1-0.3,0.5,1-1.7,1-5,1.5-2,1.5-9,2.5-13,9-11,accrescent,acute,anthesi,apart,apex,apiculate,axi,berry,bud,completely,condition,cordate,corky,deflexed,deltoid,differing,difoliate,distal,due,eaf,edicel,eed,enclosed,exserted,extremely,free,frui,fruiting,geminat,greenish-white,greyi,irregularly,large,live,lobe,lon,long-ellipsoid,long-styled,longer,lower,main,major,margin,material,middle,minor,nflorescence,occasional,often,one,orbicular,pair,papillo,planar,pore,portion,prominent,quite,raised,rounded,ruit,scar,sessile,short-styled,slightly,spaced,tall,thickened,thicker,third,tub,ud,unit,usually,variable,weight,whitish,widest,ympodial	branching,color,diameter,form,greyish,growth,height,history,length,life,perennial,pubescence,seed,texture
707	wfo-0001031203	success	218	103	84	134	19	0.385	0-0.5,0.3-0.6,1-2,1-3,1.5-2.5,1.8-2.8,2-3.5,2-7,2.1-2.7,2.5-9.5,21-39,25-45,3-10,3.2-4,4-16,4-6.5,5-8.5,6-16,6.5-9.5,8-11,almost,anther,base,berry,broadly,calyx,campanulate,cinereous-tomentose,cm,deciduous,deep,densely,diameter,erect,essentially,first,flower,foveolate,fruit,glabrous,globose,greenish-white,hair,inflorescence,lanceolate,length,lenticular,lignescent,linear-lanceolate,maturity,minutely,mm,orange-red,outline,ovate,ovoid,pedicel,peduncle,per,perennial,perfect,petiole,pubescence,rarely,red,reniform-ovate,ripe,sericeous,smooth,sparsely,spreading,stellate,stellate-pubescent,stem,stigma,style,surface,thin-textured,tube,unbranched,usually,white,x,yellow	-1.5,-2,.2,.7-1,0-0.8,0-2.5,0.05-0.15,0.05-0.2,0.1,0.1-0.8,0.3,0.4-1,0.5-1.8,1-5,1/10-1/4,11-18,15-22,15-50,2-5,2-foliate,4-12,4-6-locular,5-7,5-8,5-9,5.5-8,8-14,abaxiall,abaxially,acute,acute-tipped,adaxiall,adaxially,along,apart,apex,apparently,articulated,asymmetric,attenuate,axe,ba,blade,capitat,coarsely,connivent,consisting,curved,cylindrical,deltoid,dentate,directed,distall,distributed,downcurved,eaf,eed,elongate,extra-axillary,filament,flesh,geminat,interlobal,interwoven,invested,lateral,less,lobe,lon,long,longer,lower,lowermost,lying,major,margin,midpoint,midvein,much,nflorescence,numerous,obsolete,obtuse,often,orolla,ovate-lanceolate,pair,parallel,plane,pore,present,prickl,projecting,prominent,rachi,ray,reduced,relatively,ruit,sessile,short,short-stalked,shorter,side,simple,sinus,smaller,somewhat,spaced,stalk,stellae,stellate-pubescen,surfac,tal,tamen,tem,terete,termination,thickened,three,time,tip,tooth-like,truncate,unarmed,unit,uppermost,upward,vary,vein,weakly,well-developed,wide,ympodial	abaxial,adaxial,capitate,color,corolla,form,growth,height,history,leaf,life,na,ovary,plant,seed,shape,size,tall,texture
708	wfo-0001031207	success	219	118	98	121	20	0.447	-1/2,-11,-4,-7,-8,/5,0,0.1-0.2,0.2-0.3,0.5-1,0.6-0.9,0.6-1.2,0.7-2,1.4-2,1.5-5,1/4-1/3,2-3,2.1-2.3,2.8-3,3.5-7,5-8,6-8,abaxially,anther,apparently,base,berry,blade,branched,bristly,calyx,cell,chartaceous,cm,concolorous,densely,diameter,discolorous,drying,dull,evenly,flattened-reniform,fruit,glabrous,green,herb,lateral,leaf,length,lobed,long,maturity,mauve,midvein,mm,moderately,multangulate,occasionally,orange-brown,outline,ovate,pale,pedicel,peduncle,petiole,pit,poricidal,porrect,prickly,raised,ray,red,scandent,shrub,simple,small,smooth,sometimes,spherical,spreading,stellate,stellate-pubescent,stem,surface,tapering,terminal,tip,trichome,tube,unarmed,upper,way,weakly,white,wide,yellow,yellow-green,young	-0.4,-5,.1,0-0.5,0-10,0-20,0.1-0.3,0.1-0.5,0.2,0.25-0.5,0.3-0.5,0.8,0.85-1.4,0.9-1.6,1,1-3,1-4,1-5,1/,1/3,1/3-equal,2-4,2.5-,3-5,5-merous,6.5-8,9,acuminat,acute,alyx,ame,apar,apart,apex,apically,articulated,bark,bristle,broad-deltate,brow,c.,cordate,curved,dark,difoliate,distance,eaf,eed,elongated,elongating,equal,erect,extending,eye,filament,filiform,flower,free,fruiting,geminat,gently,glabrescent,gray,herbaceous,infructescence,lanceolate,less,like,lobe,longer,lower,margin,mature,midpoint,naked,narrow-deltate,nflorescence,oblong,obtuse,older,one,open,orolla,oung,pair,pendulous,per,perfec,pericarp,perpendicular,persistent,portion,prickl,prickle,primary,reflexed,rounded,ruit,scar,sessile,shorter,side,spaced,stalk,stalked,straight,style,subentire,tamen,terete,tertiary,time,toward,unit,usually,variously,vary,vein,venation,visible,ympodial	abaxial,adaxial,arrangement,branching,color,corolla,form,growth,height,history,inflorescence,life,number,ovary,plant,pubescence,seed,shape,size,texture
709	wfo-0001031217	success	222	129	107	115	22	0.482	%,.5,0.1-0.3,0.2-0.3,0.25-1.3,0.35-0.6,0.4-0.7,0.5-0.75,0.6-1.8,1-1.5,1.5-2,1.5-4.2,13-21,2-2.5,2-3,2-5,2.5-4,2.6-3,3.5-4.5,4-11,5-12,5.5-7,6-12,7-17,7-9,absent,acicular,acuminate,acute,adaxially,anther,apex,articulated,base,broad-based,brown,calyx,chartaceous,cm,contiguous,cuneate,cylindrical,densely,diameter,elliptic,elliptical,entire,erect,extra-axillary,filament,flower,fruit,glabrous,gland-tipped,globose,greenish-white,hair,inflorescence,interpetalar,lamina,lanceolate,leaf,length,light,longer,margin,mid-point,mm,moderately,narrowly,nearly,ovate,overlapping,pale,pedicel,peduncle,perennial,petiole,present,prickle,pseudo-umbellate,purple,red,reticulate,rhizomatous,scattered,shape,short,shrub,simple,sparsely,stellate,stellate-pubescent,stigma,straight,style,surface,thick,throughout,time,tissue,tube,unbranched,violet,wide,x,yellow	.5-2,0-0.1,0-3.5,0-5,0-6,0.1-0.2,0.15-0.25,0.25-0.4,0.3-0.4,0.3-0.5,0.3-1,0.5-3,0.8-4,1,1-2,1-20,1-4,1-locular,1.5-4,2-8,2-9,3-4,3-4.2,4-6,5-7,5-merou,6-8,7-8,9-10,abaxially,absen,accrescent,across,adult,alyx,apart,apparen,axe,ba,blade,borwn,branch,branche,confined,connivent,directed,distall,distributed,dm,eaf,eed,eglandular,exocarp,finger,fruiting,geminate,green,half,incomplete,juicy,juvenile,lateral,less,lobe,lobed,long,loosely,lower,mature,mesocarp,midpoint,midrib,midvein,minute,much,nflorescence,oblique,orolla,pair,paired,part,pendent,per,perfect,placenta,plurifoliate,pore,porrect,rachi,ray,ruit,scarcely,septum,sessile,shallowly,smaller,sometimes,spaced,sparse,stalk,stellae,succulent,tal,tamen,tem,tissu,transparent,triangular,truncat,unarme,unarmed,unit,upper,vary,ympodial	abaxial,adaxial,arrangement,branching,color,corolla,form,growth,height,history,life,ovary,plant,presence,pubescence,seed,size,staman,stem,texture,truncate,width
710	wfo-0001031218	success	154	136	92	62	44	0.597	0.5,0.5-1,1-2,1-3,1-4,15-25,2-22,2-3,2.5-3,3-5,4-28,4-7,4-8,40-100+,5-37,5.5-7,6-10,6-7,6-9,8-17,8-20,abaxially,acute,adaxially,apex,apiculate,basal,base,branched,calyx,cm,connivent,cordate,coriaceous,cylindrical,dark,densely,diameter,eglandular,eglandular-pilose,ellipsoidal,entire,especially,flattened,flower,fruit,glabrous,glandular,glandular-puberulent,globose,greenish-purple,hair,lanceolate,lavender,less,lobe,long,margin,minutely,mm,moderately,mottled,narrowly,oblique,obtuse,orange,ovate,ovate-elliptic,ovoid,pedicel,peduncle,petiole,puberulent,pubescent,purple,ripe,simple,sometimes,sparsely,stellate,stigma,style,subcoriaceous,succulent,tip,toward,tree,triangular,tube,violet,x,yellow	-5,10-19,2-2.5,3,3-14,4-5,4-foliat,40,5-7,acuminate,aggregate,apart,ape,articulated,axe,beyond,blade,cell,connective,directed,distally,eaf,eed,equal,exceeding,exserted,glabrou,introrse,leaving,lon,lower,nflorescence,nther,orolla,papillo,pedicellar,perfect,pore,presen,present,purpl,rachi,radiu,remnant,ruit,shorter,slightly,small,spaced,stamen,stone,tal,tem,thecae,time,tomento,truncat,ud,unit,vary,wide,ympodial	abaxial,adaxial,anther,arrangement,bark,branch,branching,color,corolla,drying,filament,form,growth,height,history,inflorescence,leaf,length,life,main,midvein,na,number,ovary,papillose,perennial,plant,primary,pubescence,ray,seed,shape,size,stem,surface,tertiary,texture,trichome,truncate,unarmed,vein,venation,width,young
711	wfo-0001031225	success	163	93	71	92	22	0.436	.5,0.2-0.75,0.5,0.7-6,0.75-1,0.8-1,1-1.5,1-5,2,2.5-3,3-9,3/4,5-50-flowered,5-6,7-9,9-16,anther,bark,base,broadly,calyx,cm,corolla,cup-shaped,dia,elliptic,furcate,glabrate,glabrous,globose,green,growth,inflorescence,leaf,lobed,long,minutely,mm,often,older,ovary,ovate,ovoid-reniform,pale,papillose,pedicel,petiole,pitted,plant,pubescent,red-papillose,shape,shaped,shrub,size,slender,small,stem,stigma,style,surface,tan,tear-drop,tree,trichome,tube,uniseriate,way,white,x,young	.25,/3,0.1-0.75,0.2,0.5-1,1-1.7,1-3,1.5-5,6-8,acute,along,anthesi,apart,apex,beginning,berry,bud,characteristic,closely,conspicuous,darker,decurrent,deltoid,differentiated,differing,difoliate,dry,eaf,edicel,eed,ellipsoid,erect,exserted,filament,flattene,fragrant,free,fruiting,geminat,greyish-brow,inflorescenc,lateral,less,like,live,lobe,lon,lower,main,major,margin,middle,minor,minute,much,narrowly,nflorescence,one,opposite,outline,pair,papillo,pore,poricidal,portion,prominent,proximal,raised,reflexed,rest,rhomboidal,rounded,ruit,scar,slightly,soon,spaced,specimen,straight,strongly,sweetly,swelling,tall,tapering,tip,ud,unevenly,unit,vein,widest,woody,ympodial	0.25,abaxial,adaxial,alternate,arrangement,branching,color,diameter,flower,form,fruit,greyish-brown,height,history,length,life,na,peduncle,perennial,pubescence,seed,texture
712	wfo-0001031231	success	175	83	67	108	16	0.383	-2,.5,0.5-1.5,1-1.5,1-2,1.5-2,2-3,2.5-3,3-4,37/2,37/3,4-8,5-7,8-10,anther,base,bluntly,branched,brown,calyx,campanula,campanulate,cm,corolla,dark,discoidal,elliptic,entire,filament,globose,green,greyish,juvenile,lanceolate,leaf,len,less,long,marbled,mature,mm,oblong,occasionally,ovary,pedicel,pentagonal,pinnatisect,plant,purple,rh,ripening,rotate,rounded,rugose-ruminate,seed,shallow,shrub,simple,soft,sometimes,style,surface,tinged,triangular,violet,wooded,x	1-3,1-4,13,2-4,25-35,80-110,absent,acumen,acuminate,acute,adherent,almost,along,anthesi,apex,aromatic,aspect,axi,axillary,basal,becoming,berry,beyond,blunt,branch,cell,clonal,cluster,colour,declinate,developed,dia,eaf,eed,ellipsoid,equal,erect,exceeding,except,exerted,expanded,facetted,fleshy,flower,flowering,folded,fork,general,glabrous,glandular,gree,habit,hair,herbarium,interacuminal,lasting,lengthening,lobe,lon,loosely,lower,margin,mauve,midrib,minute,nflorescence,often,pedice,pedicellate,peduncle,petal,plurifoliat,pore,poricidal,projecting,rarely,readily,recurve,ripe,ruit,sessile,several,shed,short,sinus,slightly,slit,small,specimen,stigma,stone,stonrgly,stout,succulent,tip,tissue,toward,translucent,tub,ud,unit,usually,variable,vigorous,well,without,year,ympodial	arrangement,color,diameter,form,fruit,growth,height,history,inflorescence,length,life,perennial,shape,size,stem,texture
713	wfo-0001031252	success	170	100	77	93	23	0.453	0.2-1.5,0.3-1.1,1-3,1.3-1.9,1.75-5.2,16-33,2.5-7,2.8-3.6,3-10,3-6,5-17,5-8,5-9,5.5-6.5,7-18,abaxially,acute,adaxially,anther,apex,attenuate,base,brownish,ciliate,clavate,cm,condition,coriaceous,corolla,cuneate,dark,deep,diameter,drying,elliptic,entire,forked,fresh,fruit,glabrous,globose,green,greenish,herb,lanceolate,light,margin,medium,mm,moniliform,mottled,mucilaginous,ovate,ovoid,pedicel,peduncle,petiole,plant,poricidal,purple,rotate,rounded,seed,serrate,simple,sometimes,stigma,stripe,style,tip,tube,tuber,wet,white,whitish,x,yellow	0.4-3,1-2,12-20,2-3,3-5,5-merou,absent,acumen,adaxiall,ag,along,alyx,apart,apparently,arranged,articulated,axe,axillary,bead,berry,blade,bud,capitat,cell,connivent,covering,digestion,distal,dorsally,eaf,edge,eed,enzyme,erec,exceeding,filament,flat,flower,folded,geminat,generally,glabrou,green-white,hair-like,hal,half,high,homostylous,honeycomb-shaped,interjected,lateral,leaflet,lengthening,like,linear,living,lobe,long,lower,make,multiple,necklace,nflorescence,orolla,perfect,plurifoliate,pore,removed,ripe,ruit,seudostipule,slit,spaced,specimen,stamen,stolon,straight,subtending,tall,tamen,tem,terminal,testal,thick,throughout,tri-,typically,unit,unwinged,usually,vary,wall,ympodial	arrangement,branching,calyx,capitate,color,form,growth,height,history,inflorescence,leaf,length,life,na,ovary,perennial,pseudostipule,shape,size,stem,surface,texture,ye
714	wfo-0001031257	success	206	120	95	111	25	0.461	-22.5,-5,-6,0.5-0.8,0.7-1,0.75-2.5,1-1.3,1.1-1.2,1.5-1.7,10-16,11.5-15,2-4.5,4-10,7.5-9,8,abaxially,abundant,adaxially,aggregate,anther,anthesi,ascending,basal,base,blue-violet,bud,campanulate,cell,cm,coarsely,connectival,corolla,dark,dentate,diameter,directed,dorsally,ellipsoidal,epidermal,filament,flexuous,glabrous,glandular,globose,hair-like,half,herb,honey-combed,lateral,leaf,length,light,long,long-stalked,margin,mm,non-glandular,outward,ovate,pair,papillate,patent,petiole,prolongation,pubescent,purple,ring,robust,seed,serrate,shrub,simple,small,spur-like,stem,stigma,stone,strand,striate,style,subglobose,thickened,thickening,tip,tooth,trans-ovoidal,trichome,tube,unequal,upward,wall,white,within,x,yellow	-12,0,0.4,0.5,1-1.2,1.5,1.5-2,1/10,2-,3,3.5-,3.5-5.7,4-4.5,4.5-,5,5-,5-8.5,6-12,6-celled,7-,8-celled,accrescen,acuminate,ag,antrorse,apex,attenuate,berry,bicellular,branch,broad,calyx,coat,cotyledon,cuneate,curved,cuticle,deep,densely,diamete,difoliate,eaf,edentate,eed,elliptical,embryo,endosperm,erect,finely,foliage,free,fruiting,geminat,head,herbaceous,high,hollow,inconspicuous,inserted,lamina,like,little,lobe,lon,longer,longitudinal,longitudinally,lower,many-seeded,midvein,narrowly,odorles,opening,orolla,pericarp,pore,poricidal,portion,rarely,reduced,ree,rest,ridged,ruit,saddle-shape,scarce,scarcely,secondary,separated,short-stalked,shorter,single-celled,sinus,slightly,slit,smooth,solitary,somewhat,stalk,tem,thecae,time,triangular,unit,vary,vein,ventrifixed,verrucate,viscid,viscid-pubescen,ympodial	3.5-4.5,4.5-12,abaxial,adaxial,branching,color,form,fruit,growth,height,history,inflorescence,life,na,ovary,perennial,plant,pubescence,saddle-shaped,shape,size,surface,texture,viscid-pubescent,young
715	wfo-0001031270	success	234	133	107	127	26	0.457	+,.5,0.4-1.5,1,1-1.2,1-4,1.2-1.6,10-12,2-2.5,2-3,2-4,2-7,2.5-3,3-10,5-15,5-6,6-17,6-50,9-10,abaxial,adaxial,anther,bark,base,bipinnatifid,bright,brown,calyx,capitate,clavate,cm,conical,deeply,densely,depressed-spherical,diameter,elliptic,filament,flower,glabrous,glandular,glandular-pubescent,green,growth,heavily,herb,inflorescence,leaf,length,like,live,lobe,lobed,long,long-styled,margin,membranous,midvein,minute,minutely,mm,narrowly,obovate,ovoid,pair,pale,pedicel,peduncle,petiole,pinnatifid,pitted,plant,prickly,primary,pubescent,red,reddish,reniform,ripe,shallowly,shining,simple,size,slender,slightly,sparsely,spherical,spreading,stellate,stem,stigma,style,surface,tan,tapering,terete,thin,trichome,truncate,tube,uniseriate,usually,vein,white,wide,yellow,yellowish	0.5-1,1-3,1.5,1.5-2,1/3,10,100,2-20,3-20,3-5,4-5,5,5-10,5-merous,7-12,8,>,abaxially,accrescent,acute,adaxiall,along,alyx,anthesi,apart,apex,arme,articulated,associated,basal,beginning,berry,blade,brow,c.,cell,celled,colored,connivent,consistently,curved,differentiated,difoliate,directed,distal,eed,ellipti,entire,equal,erect,few-rayed,free,frui,fruiting,geminat,gland,heterostylous,infructescence,investing,later,lateral,leaf-opposed,leafy,lon,longer,loosely,lower,midpoint,mixture,multangulate,multiseriate,new,nflorescence,occasionally,often,older,orolla,oung,outline,papillo,per,pericarp,pore,poricidal,portion,prickle,rachi,ray,reflexed,rest,rounded,ruit,scar,scattered,secondary,sessile,shallow,short-stalked,short-styled,shrub,single,sinuate,small,stalk,staminat,straight,straw-colored,strongly,tall,tamen,testal,thus,tightly,tip,tissue,unit,upward,vary,varying,way,well,wice,wid,wing,woody,ympodial,½	armed,arrangement,branch,branching,color,corolla,drying,form,fruit,height,history,life,main,na,number,ovary,papillose,perennial,pubescence,seed,shape,tertiary,texture,unarmed,venation,young
716	wfo-0001031283	success	52	69	19	33	50	0.365	-0.25,0.1-0.15,0.4-0.5,0.7,2.2-2.8,30-40,base,brown,calyx,cm,diameter,fruit,lobe,mm,obovate,pale,pubescent,shrub,surface	.7-2.3,0.5-0.7,acute,apex,appearance,cell,eed,elongating,erect,fide,give,hair-like,lateral,lo,long,markedly,moore,narrowly,outgrowth,pleasant,silky,small,smelling,somewhat,sprawling,spreadin,tall,testa,thick,wall,wide,winged,woody	abaxial,adaxial,anther,arrangement,bark,branch,branching,color,corolla,drying,filament,flower,form,growth,height,history,inflorescence,leaf,length,life,main,margin,midvein,na,number,ovary,pedicel,peduncle,perennial,petiole,plant,primary,pubescence,ray,seed,shape,size,spreading,stem,stigma,style,tertiary,texture,trichome,tube,unarmed,vein,venation,width,young
717	wfo-0001031287	success	147	98	74	73	24	0.503	.5,0.5-1.5,0.9-1,1,1-1.2,1-1.5,1-5,1.5-2,1.5-5.5,2-2.5,3-4,4-5,4-6,4.5-5,5-14,6-10-flowered,6-7,abaxially,adaxially,anther,apex,bark,base,bi-lobed,calyx,cm,corolla,dark,deltate,dendritic,densely,dia,divergently,elliptic,erect,glabrous,globose,green,greenish-white,knob,lateral,leaf,lobe,lobed,long,main,minutely,mm,nearly,ovary,ovoid-reniform,pair,pedicel,petiole,pitted,pubescent,red-papillose,rounded,shaped,shrub,simple,small,stem,stigma,strongly,style,surface,tear-drop,trichome,tube,tuft,vein,x,young	1-1.3,3-5,acute,anthesi,apar,ape,attenuate,axil,bearing,berry,branch,conical,connective,coriaceous,deflexed,difoliate,eaf,edicel,eed,ellipsoid,elongate,enlarged,exserted,filament,fleshy,free,frui,fruiting,geminate,internodal,lamina,later,lon,lower,many,margin,membranous,middle,nflorescence,occasionally,older,onto,pale,papillo,papillose,planar,plurifoliate,pointed,pore,poricidal,portion,reddish-brow,reflexed,ruit,scar,shoot,short,sinus,somewhat,spaced,tan,thick,thin,tip,tub,ud,unevenly,unit,white,widest,winged,woody,ympodial	0.5,abaxial,branching,color,diameter,flower,form,fruit,growth,hair,height,history,inflorescence,length,life,number,perennial,plant,pubescence,reddish-brown,seed,shape,size,texture
718	wfo-0001031300	success	219	137	107	112	30	0.489	.5,/4,0.2-0.4,0.3,0.5-0.9,0.5-18,0.5-2,0.7-0.9,0.8-1.5,1-2,1.5-3.5,2-4,2-5.5,2-6,2.2-2.3,2.2-2.7,2.5-3.2,3-4,4,abaxially,acute,anther,apex,apically,apparently,articulated,attenuate,bark,base,berry,brown-green,calyx,cell,chartaceous,cm,concolorous,creeping,curved,deltate,densely,diameter,drying,dull,erect,filament,filiform,flattened-reniform,flower,fruit,glabrescent,glabrous,gray-green,lateral,leaf,length,lobe,lobed,long,margin,maturity,membranous,midvein,mm,moderately,near,oblanceolate,orange,orange-brown,orange-green,outline,pair,pedicel,peduncle,petiole,pit,poricidal,porrect,primary,pubescent,raised,ray,red,shrub,simple,small,smooth,sparsely,spherical,stellate,stellate-pubescent,stem,style,surface,tapering,tertiary,tip,trichome,tube,uniradiate,vein,venation,way,weakly,white,wide,yellow,yellow-green	-2.2,-4,-5,-6,0-15,0-20,0-3,0-8,0.1,0.1-0.5,0.1-0.6,0.15-0.7,0.2-0.5,0.2-0.7,0.2-1,0.3-0.6,0.3-1.3,0.5-1.5,0.6-0.8,0.6-1,0.6-1.2,0.7-1.2,1-4,1-5,1.2-1.7,1.3-2,1/2-3/4,1/3-1/2,1/6-1/4,10-30,2-,2-3,3-,4.5-6,5-15,5-merous,6-8,absent,also,alyx,apar,apart,ba,blade,branched,brow,bulbous,caudat,connivent,difoliate,distance,eaf,eed,elongating,equal,extending,eye,flattened,free,fruiting,geminat,geniculate,hair,herbaceous,highly,infructescence,lon,longer,lower,mature,midpoint,minute,naked,nflorescence,oblong,obtuse,older,one,open,orolla,oung,pale,pendulous,per,perfec,pericarp,portion,prickl,prickle,prickly,rarely,reduced,rounded,ruit,scar,sessile,side,spaced,spreading,stalk,stalked,tamen,terete,thin,time,unit,vary,visible,wider,winged,yellow-orange,ympodial	abaxial,adaxial,arrangement,branch,branching,brown,caudate,color,corolla,form,growth,height,history,inflorescence,life,main,na,number,ovary,perennial,plant,pubescence,seed,shape,size,stigma,texture,unarmed,ye,young
719	wfo-0001031310	success	203	113	91	112	22	0.448	.5,1-2,1-3,1-6,1.5-4,15-40,2-3,2.5-8.5,3-10,4-10,4.5-4.8,5-6,5.5-21,6-7,abaxially,adaxially,anther,blue,blue-purple,brown,brownish,cell,chartaceous,cm,condition,connivent,corolla,covering,diameter,drying,flower,forked,fresh,fruit,glabrous,globose,green,greenish,hair,hair-like,herb,lanceolate,lateral,leaf,less,light,like,lobe,long,membranous,minutely,mm,mottled,multicellular,odd-pinnate,ovate,ovate-elliptic,ovate-lanceolate,ovoid,pale,pedicel,peduncle,petiole,pilose,plant,poricidal,puberulent,pubescent,purple,rotate,seed,simple,size,slightly,sometimes,somewhat,sparsely,stem,stigma,streak,style,testal,thick,tip,tube,unwinged,wall,white,whitish,x,yellow	0-3,0-4,0.5-3,1-10,1-5.5,2.5-5.5,4-12,5-7,5-merou,absent,acumen,acuminate,ag,along,alyx,apart,apex,apparently,articulated,attenuate,axe,axillary,base,berry,blade,borne,broadly,bud,caly,ciliate,conspicuously,cuneate,decreasing,decurrent,digestion,distal,dorsally,eaf,edge,eed,elliptic,end,enzyme,erect-decumben,especially,exceeding,extremely,filament,flat,folded,geminat,generally,glabrou,gradually,green-white,half,high,homostylous,honeycomb-shaped,interjected,larger,leaflet,lengthening,living,lower,make,margin,midrib,mucilaginous,narrowly,nflorescence,obtuse,orolla,pair,perfect,petiolule,plurifoliate,pointed,pore,rachi,removed,rosette-forming,ruit,seudostipule,shortly,singly,slit,small,spaced,specimen,stamen,ste,stolo,straight,subellipsoi,subrosette-forming,subtending,tall,tamen,tem,terminal,throughout,tissue,toward,tri-,tuber,typically,unit,usually,vary,wet,ympodial	abaxial,adaxial,arrangement,branching,calyx,color,form,growth,height,history,inflorescence,length,life,na,ovary,perennial,pubescence,shape,subellipsoid,surface,texture,width
720	wfo-0001031316	success	207	135	113	94	22	0.546	-2,/3,0.05-0.1,0.3-1,0.4-0.8,0.5-2,0.8-1.2,0.8-1.8,1.3-3.5,1/3-1/2,2-3,2.5-8,3-8,3.5-3.8,3.8-5,4-7,5-10,5-6,5-8,6-20,8-25,abaxial,abaxially,acuminate,acute,adaxial,almost,anther,apically,apparently,bark,base,berry,blade,blue-mauve,branched,bright,calyx,cm,concolorous,cream,dark,densely,diameter,discolorous,drying,dull,entire,eye,flattened-reniform,flower,fruit,glabrescent,glabrous,gray,green,lateral,leaf,length,lobed,long,margin,marking,maturity,membranous,mm,moderately,multangulate,naked,narrow-deltate,obtuse,orange,orange-brown,ovate,pair,pale,pedicel,peduncle,petiole,poricidal,primary,purple,ray,red-brown,sessile,shrub,simple,sometimes,sparsely,spherical,stalked,stellate,stellate-pubescent,stem,surface,tapering,terminal,tertiary,tip,trichome,unarmed,usually,variously,vein,venation,visible,way,white,white-green,wide,yellow,yellow-green,young	.1,0.05-0.15,0.1-0.2,0.4-0.6,0.6-1,0.9-1.3,1-5,1.2-2.1,1.5-,1.5-2,1.5-3.5,1.5-5,1/3-2/3,2-20,2-4,3-10,4,4-9,5-15,5-merous,8-11,8-12,alyx,ame,apar,apex,articulated,becoming,broad,c.,colored,connivent,contrast,curved,difoliate,eaf,eed,elongating,erect,fifth,filament,foliaceou,four,free,fruiting,geminat,glabrou,hair,held,herbaceous,infructescence,inward,lobe,long-acuminat,longer,lower,lowermost,mature,midpoint,minute,nflorescence,older,one,open,orolla,oung,pendulous,per,perfec,pericarp,porrect,portion,red-brow,reflexed,ruit,scar,slender,smooth,spaced,spreading,stalk,stellate-pubescen,strongly,style,tamen,terete,time,tube,unarme,unequal,unit,vary,whitish,ympodial	arrangement,branching,color,corolla,form,growth,height,history,inflorescence,life,long-acuminate,midvein,number,ovary,perennial,plant,pubescence,seed,shape,size,texture,ye
721	wfo-0001031333	success	194	130	109	85	21	0.562	+,.5,0.5,1-1.5,1-4,1-5,1.5,1.5-2,1/2,2,2.7-7,3-4,3/4,5-7,7-10,7-9,?,abaxially,acuminate,acute,adaxially,adjacent,almost,anther,apex,appearing,base,berry,bilobed,branched,broadly,brown,calyx,capitate,cm,conical,densely,diameter,ellipsoidal,elliptic,entire,filament,flattened,glabrescent,glabrous,globose,golden,green,greenish,growth,half,immature,inflorescence,less,like,lobed,long,lower,many,margin,membranous,minute,minutely,mm,narrowly,new,outline,ovate,pair,pale,pedicel,peduncle,pentagonal,petiole,pitted,poricidal,primary,pubescent,pubescent-papillate,reniform,rest,simple,somewhat,sparsely,stellate,stem,stigma,striped,style,surface,terminal,thickened,time,tip,triangular,trichome,truncate,tube,uniseriate,vein,venation,vine,way,white,whitish,woody,x,yellow,yellowish	0.1-0.5,1.2-2,1.5-1.7,2-3,2.5-3,30-40,5-8,5-merou,50,<,>,adaxiall,ag,alyx,anthesi,apart,ark,articulated,branche,cell,clustered,collection,composed,crea,cupped,denser,eaf,eed,exserted,flower,free,fruting,glabrescen,high,ilament,lamina,leaving,lengthening,lobe,m.,matte,mere,near,nflorescence,nodding,occasionally,older,orolla,papillat,peg,penden,per,perfect,pericarp,planar,plurifoliat,pore,portion,quadrate,rhachi,ruit,scar,sinus,slightly,slit,small,soon,splitting,ste,strongly,tangled,tem,testal,thin,trailing,twining,ud,undersurface,undulation,unequal,unevenly,unit,upper,vary,ympodial	abaxial,adaxial,arrangement,bark,branching,color,corolla,cream,form,fruit,leaf,length,number,ovary,papillate,pubescence,seed,shape,size,texture,young
722	wfo-0001031333	success	194	132	101	93	31	0.521	+,.5,0.5,1-1.5,1-4,1-5,1.5,1.5-2,2.5-3,2.7-7,3-4,30-40,5-7,7-10,7-9,?,acute,adjacent,almost,anther,bark,base,berry,bilobed,branched,broadly,brown,calyx,capitate,cm,conical,corolla,densely,diameter,ellipsoid,elliptic,entire,filament,flattened,flower,glabrescent,glabrous,globose,golden,green,greenish,growth,immature,inflorescence,less,like,lobe,long,many,margin,matte,membranous,mere,minute,minutely,mm,narrowly,ovate,pair,pale,pedicel,peduncle,petiole,pitted,poricidal,primary,pubescent,pubescent-papillate,reniform,rest,rotate-stellate,simple,somewhat,sparsely,stellate,stem,stigma,style,surface,thin,time,tip,triangular,trichome,truncate,tube,undulation,unevenly,uniseriate,vein,venation,vine,white,wide,woody,yellowish	0.1-0.5,1-5-2,1.5-1.7,1/2,2,2-3,3,3/4,5-8,5-merou,50,<,>,abaxially,acuminate,adaxiall,adaxially,ag,alyx,anthesi,apart,apex,appearing,articulated,branche,cell,clustered,composed,cream,cupped,denser,eaf,eed,exserted,free,fruiting,glabrescen,half,high,ilament,lamina,leaving,lengthening,lobed,lower,m.,near,new,nflorescence,nodding,occasionally,older,orolla,outline,papillat,peg,penden,per,perfect,pericarp,planar,plurifoliat,pore,portion,quadrate,rhachi,ruit,scar,sinus,slightly,slit,small,soon,spaced,splitting,striped,strongly,tangled,terminal,testal,thickened,trailing,tub,twinin,ud,undersurface,unequal,unit,upper,vary,way,whitish,ympodial	0.5-1,abaxial,adaxial,arrangement,branch,branching,color,form,fruit,height,history,leaf,length,life,main,midvein,na,number,ovary,papillate,perennial,plant,pubescence,seed,shape,size,tertiary,texture,unarmed,ye,young
723	wfo-0001031359	success	166	85	64	102	21	0.386	0.5-1,0.5-6,0.75-1,1-4,1.1-1.6,1.2-1.6,1.2-2.5,1.3-1.6,1.5-2,12-21,2.5-3,3-3.5,3.6-8.8,5-30-flowered,5-angled,6-7,anther,bark,bi-lobed,brown,calyx,cm,corolla,dull,elliptic,filament,flattened-reniform,glabrous,globose,leaf,lobed,long,minutely,mm,narrowly,nearly,ovary,papillae,papillose,pedicel,petiole,pitted,plant,round,rusty,shaped,shrub,simple,size,stem,stigma,style,surface,tan,tear-drop,trichome,tube,tuft,uniseriate,white,x,yellow,yellow-orange,young	.02,.25,.5,/4,1.6-2.8,1.9-2.3,5-7,5.3-7.5,acuminate,angle,anthesi,apart,apex,apiculate,appearing,attenuate,axil,ba,base,beginning,beneath,berry,broadly,curled,dark,deflexed,dia,differing,difoliate,distal,dried,eaf,edicel,eed,evenly,extending,free,fruiting,geminat,green,incrassate,inflorescenc,internodal,interpetalar,lamina,lateral,live,lobe,lon,lower,main,major,margin,membraneous,middle,minor,near,nflorescence,obovoid,occasionally,often,older,one,opposite,originating,outline,pair,paler,papillo,pit,planar,pore,poricidal,portion,reflexed,ridged,ripe,ruit,scar,shiny,sinus,slender,slightly,somewhat,spaced,specimen,straight,strongly,tall,tapering,tip,triangular,tub,ud,undulate,unit,vein,way,white-lenticellat,widest,woody,ympodial	0.5,abaxial,color,diameter,flower,form,fruit,growth,height,history,inflorescence,length,life,na,peduncle,perennial,pubescence,seed,shape,texture,white-lenticellate
724	wfo-0001031362	success	138	112	82	56	30	0.594	.2,.3,.5,0.4-0.5,0.5-1,1-1.1,1-1.5,1-3,1-3-flowered,1-4,1.5-2,2-2.5,3-4,3-6,abaxially,adaxially,anther,apex,attenuate,bark,base,branch,brown,calyx,cell,cm,conical,corolla,dendritic,densely,dia,filament,flattened-reniform,glabrous,globose,golden,incrassate,lanceolate,leaf,lobe,lobed,long,long-triangular,main,margin,minutely,mm,nearly,orange-red,outline,ovary,pair,pale,papillose,pedicel,petiole,pitted,pubescent,pubesent,rectangular,red,rounded,shaped,shiny,shrub,simple,small-capitate,sparsely,stem,stigma,style,subshrub,surface,tan,tear-drop,thin,trichome,tube,vein,white,x,young	0.7-1,?,acute,along,anthesi,appearance,berry,bushy,closely,denser,eaf,edicel,eed,ellipsoid,erect,exceeding,exserted,flattened,free,fruiting,giving,golden-brow,inflorescenc,internodal,lamina,lateral,like,lon,lower,middle,nflorescence,nodding,older,opposite,overlappin,packed,papillo,pericarp,planar,plurifoliat,pore,poricidal,portion,rest,ruit,scar,slender,somewhat,spaced,straight,tip,ud,unit,widest,woody,ympodial	abaxial,adaxial,arrangement,branching,color,diameter,flower,form,fruit,golden-brown,growth,height,inflorescence,length,midvein,na,number,peduncle,plant,plurifoliate,primary,pubescence,seed,shape,size,tertiary,texture,unarmed,venation,width
725	wfo-0001031363	success	198	103	72	126	31	0.364	0.3-0.6,0.5-0.8,1-2,1-2.2,1.1-1.6,1.5-4,10-11.5,2-3,2.5-7.5,3-7,3.5-6,4.5-7.5,5-10,5-8,6.5-11,adaxially,anther,attenuate,bark,base,branch,broadly,brown,calyx,chartaceous,cm,corky,deltate,densely,diameter,flower,fruit,glabrous,globose,green,inflorescence,leaf,length,lobe,lobed,margin,midvein,mm,moderately,obtuse,ovate,pale,pedicel,peduncle,perennial,petiole,plant,pseudo-racemose,purple,ray,rhizomatous,sessile,shallowly,shrub,simple,sparsely,stellate,stellate-pubescent,style,surface,throughout,tube,unarmed,unbranched,vein,x,yellow	%,.3,.5,0-15,0-3,0-30,0-6,0.3-0.5,0.3-0.7,0.4-0.5,0.4-0.8,0.5-0.9,0.5-1,0.7-1.5,0.9-1.6,1-5,1-6,1-locular,1.1-1.4,1.6-2.1,10-12,13-25,2-foliate,2.3-2.5,3-4,3-5,3.5-5.5,30,4-7,4-8,5-6,5-7,5-merou,6-13,6-8,6.5-8.5,7-12,80-120,abaxially,absen,absent,acicular,across,acute,adaxiall,adult,alyx,andromonoecious,apart,apex,articulated,axe,ba,blade,branche,cross-section,cylindrica,decimetre,directed,distall,distributed,dm,eaf,eed,eglandular,erect,exocarp,extra-axillary,finger,fruiting,functional,furrowed,geminat,gland-tipped,hair,half,heterostylous,incomplete,index,juicy,juvenile,lamina,lateral,less,lobing,long,longer,lower,mature,mesocarp,midpoint,minute,moist,nflorescence,oblique,orolla,pair,part,per,placenta,pore,porrect,present,prickle,ruit,semi-circula,septum,short,side,spaced,stalks-0.1,stellae,straight,tal,tamen,tem,thick,time,transparent,unarme,unit,upper,vary,weakly,wide,ympodial	2.5,abaxial,adaxial,arrangement,branching,color,corolla,filament,form,growth,height,history,life,main,na,number,ovary,primary,pubescence,reproduction,seed,shape,size,stem,stigma,tertiary,texture,trichome,venation,width,young
726	wfo-0001031372	success	192	145	119	73	26	0.62	0,0-15,0.05-0.2,0.2-0.8,1,1-2,1.5,1/4-1/3,10-14,10-30,2-2.5,2-5,2-7,2.5,2.5-4.5,3,4-5,5-10,6-9,7,7-10,8-10,8-15,abaxially,adaxially,anther,apart,armed,articulated,base,blade,blunt-tipped,broad-based,broadly,brown,calyx,central,closely,cm,coarsely,compressed,cylindrical,dark,densely,diameter,elliptic,filament,flattened,flower,foliaceous,fruit,glabrous,globose,green,hair,interwoven,lanceolate,large,lateral,laterally,length,light,lighter,lilac,lobe,long,main,margin,midpoint,minutely,mm,multiseriate,ovate,ovate-lanceolate,pedicel,peduncle,perennial,petiole,pitted,prickle,prickly,pubescent,ray,recurved,reddish,repand,scattered,several,side,simple,somewhat,spaced,sparsely,spreading,stalk,star,stellae,stellate,stellate-pubescent,stellate-woolly,stelliform,stem,stigma,stipitate,style,thin-textured,tube,ultimately,unarmed,unbranched,vein,weakly,well-developed,white,whitish,widely,woolly,x,yellow	-1.5,0.4-0.6,10,10-12,2-foliate,25-30,5-20,abaxiall,accrescent,acute,acute-,adaxiall,along,apex,axe,ba,capitat,completely,concealing,connivent,covering,decurrent,deltoid,directed,distal,distally,eaf,eed,entirely,enveloping,extra-axillary,female-sterile,fruiting,geminat,glabrou,leaf-opposed,longer,lower,m.,midrib,minute,mostly,much,nflorescence,obtuse,often,onto,orolla,perfect,pore,present,probably,rachi,reaching,round-tipped,ruit,short,short-styled,shorter,similar,soft-wooded,ste,tal,tamen,tem,termination,time,unit,vary,wide,winged,ympodial,young	abaxial,armament,arrangement,branching,capitate,color,corolla,density,form,growth,height,history,inflorescence,leaf,life,number,ovary,plant,pubescence,seed,shape,size,surface,tall,texture,trichome
727	wfo-0001031389	success	242	107	86	156	21	0.355	0-2,0.25-0.75mm,0.4-0.6,0.4-1.8,0.65-1,0.8-2.5,0.9-4.5,1-1.5,1.5-2.5,1.5-3,1.9-2.2,14-30,2-6,2.5-13,4-5.5,5.5-8,6-9,8-15,absent,acicular,almost,anther,base,brown,calyx,chartaceous,cm,cylindrical,dark,deltate,densely,diameter,directed,distally,flower,fruit,glabrous,gland-tipped,globose,hair,inflorescence,lanceolate,leaf,length,lilac,lower,minute,mm,ovate,pale,part,pedicel,peduncle,perennial,petiole,plant,present,prickle,pseudo-racemose,pseudo-umbellate,purple,red,reniform,rhizomatous,rostrate,rotate-stellate,scattered,short,shrub,simple,sometimes,sparsely,stellate,stellate-pubescent,stigma,straight,style,summit,surface,tip,tube,unbranched,white,x,yellow,yellowish	%,0-0.1,0-0.4,0-0.5,0-0.6,0-1,0-10,0-3,0.05-0.1,0.25-0.4,0.25-0.5,0.3-0.5,0.3-0.6,0.3-0.8,0.5-1,0.5-1.5,0.5-3,0.6-0.7,1-2,1-3,1-4,1-5,1-locular,1.3-2.4,1.5-4,1.5-5,1.8-3.5,11-16,14-18,2-foliate,20-60,4-5,4-7,4-8,5-8,5-merou,6-10,6-12,6-7,7-8,abaxially,absen,accrescent,across,acute,adaxially,adult,alyx,andromonoecious,apart,apex,apparen,articulated,axe,ba,becoming,blade,branch,branche,capitat,confined,connivent,cuneate,decimetre,distall,distributed,dm,eaf,eed,eglandular,entire,erect,exocarp,extra-axillary,filament,finger,first,fruiting,functional,geminat,green,half,heterostylous,homo-,incomplete,interpetalar,juicy,juvenile,lamina,lateral,less,lobe,lobed,long,longer,loosely,margin,markedly,mature,mesocarp,mid-point,midpoint,midrib,midvein,minutely,moderate,narrowly,nflorescence,oblique,obtuse,often,orolla,pair,per,perfect,pitted,placenta,plump,pore,porrect,rachi,ray,reddish,reticulate,reticulately,ruit,septum,sessile,shallowly,solitary,somewhat,spaced,sparse,stalk,stellae,succulent,tal,tamen,tem,thick,thicker,thicknes,throughout,tightly,time,tissu,tissue,triangular,unarme,unarmed,unit,upper,vary,weakly,wide,ympodial	abaxial,adaxial,arrangement,branching,capitate,color,corolla,form,growth,height,history,life,na,ovary,presence,pubescence,seed,shape,size,stem,texture
728	wfo-0001031394	success	217	91	53	164	38	0.244	2,alternate,anther,calyx,cm,diameter,finely,flattened,fruit,glabrous,gland-tipped,glandular-pilosulose,glandular-pubescent,globose,hair,lanceolate,length,light,long,mm,narrowly,ovate,peduncle,petiole,pitted,plant,prickle,pubescence,pubescent,purple,recurved,red,short,simple,slightly,stellate,stem,stigma,stipitate-glandular,straight,style,subreniform,subshrub,tan,taprooted,thin-textured,triangular,tube,unbranched,white,x,yellow,yellow-orange	-celled,-rayed,0.2–0.4,0.3,0.3–1.5,0.5,0.5–1,0.6–1.6,0.8,1,1.1–1.6,1.2–3.2,1.4–2.1,1.7–4.5,1/2,1/3,1–,1–1.5,1–2,1–3,1–4,2-foliat,2.2–2.5,2.5–3,2–3,2–3-celled,2–3.2,2–4,3,3.7–7.6,33–80,3–4,3–5,3–6,4,4–8,5,5–8,64,6–11,6–8,9–13,=,?,abaxially,accrescent,acicular,acute,adaxially,additional,almost,apart,apex,apparently,appearing,armed,articulated,axe,ba,basal,base,beginning,blade,bottom,branch,branched,broadly,bulbous,caudate,crenulate,curved,cylindrical,densely,directed,distal,distall,eaf,eed,enlarging,even,eventually,extra-axillary,fertile,filament,flower,free,fruiting,glabrou,gland-tippe,halfway,hyaline,investing,leafy,least,less,lobe,lon,longest,lower,main,male,many,margin,maturity,midpoint,midrib,minute,n,nflorescence,numerous,one,orolla,overtopped,pedicel,per,pilose,pore,quite,rachi,reaching,reflexed,rounded,ruit,scattered,sessile,shorter,side,similar,single-celled,small,smaller,sometimes,somewhat,spaced,sparse,spreadin,staminate,stellae,sterile,stout,subcordate,tall,taman,tem,terminal,thick,thickened,time,tip,tooth,truncat,unit,usually,variable,vary,vein,wide,ympodial,±,–1.5,–2,–3,–5,–6	0.2-0.4,0.3-1.5,0.6-1.6,1-2,1-3,1-4,1.4-2.1,2-4,2.2-2.5,2.5-3,3-6,3.7-7.6,5-8,abaxial,adaxial,arrangement,branching,color,corolla,form,growth,height,history,inflorescence,leaf,life,midvein,na,ovary,seed,shape,size,surface,texture,trichome,truncate,ye,young
729	wfo-0001031400	success	161	82	65	96	17	0.404	0.25-0.8,0.4-1.7,0.6-1.8,0.7-6,0.8-1.1,1.2-2,1.5-5,10-11,2-3,2-5,2-9,4-,4-13,4-17,4-6.5,4-7,5-12.5,7-25,7-28,abaxial,acute,apiculate,branched,calyx,cm,corolla,cyme,deeply,diameter,dichasial,dichasially,ebracteate,flower,forked,globose,green-white,herbaceous,lateral,leaf,leaflet,lobe,long,mm,monochasial,oblong,odd-pinnate,ovoid,pedicel,peduncle,perennial,petiole,plant,puberulent,seed,size,stellate,style,subglabrous,terminal,throughout,tone,violet,white,wide,yellow	-3,1,1-,1-4,2,3-6-foliat,6-23,abaxially,abruptly,absen,acumen,adaxially,apex,apical,apically,articulate,base,cell,connate,covering,cuneate,dark,decurrent,dehiscent,digestion,diminishing,distal,dorsally,eaf,edge,eed,emoval,enzyme,exceeding,filament,flat,folded,forming,generally,globo,green,hair-like,half,honeycomb,interjected,introrse,linear,linear-lanceolate,living,lon,lower,lunat,make,maturing,mucilaginous,nflorescence,nther,oblique,occasionally,often,orolla,pair,pattern,perfect,plan,poricidally,proximal,rachi,reveal,ruit,sessile,seudostipule,short,side,slit,specimen,stamen,stigma,straight,stripe,structure,tal,tem,testal,thick,tip,toward,trilobe,tuber-bearing,typically,unit,vary,wall,without,ympodial,¼	adaxial,anther,arrangement,color,form,fruit,growth,height,history,inflorescence,length,life,ovary,shape,stem,texture,width
730	wfo-0001031401	success	182	110	93	89	17	0.511	0.5,0.6-1.2,1-1.4,1-1.5,1-6,1.1-3,1/2,2-2.4,2-5,2.5-4,3,3.5-4,3/4,5-7,5-9,7-9,abaxial,abaxially,adaxial,age,along,anther,attenuate,base,becoming,bi-lobed,branching,calyx,cm,conical,corolla,dendritic,densely,diameter,ecuadorian,elliptic,finely,flattened,fruit,glabrous,globose,golden,growth,leaf,lenticular,lobed,long,matted,minutely,mm,narrowly,near,occasionally,outline,ovary,pedicel,pericarp,petiole,plurifoliate,pore,poricidal,puberulent,pubescent,purplish-black,pyramidal,reddish-brown,roundish,short,shrub,slit-like,small,sparsely,specimen,stem,stigma,strongly,style,surface,thin,time,tip,tree,tree-like,trichome,vein,violet,way,white,wide,winged,x,yellow,young	0.8-1.2,1,1.5-2,5,8-10,acute,adaxially,anthesi,apex,apical,appearing,axi,bark,basal,berry,black,blade,branch,brown,clearly,dark,deciduous,deflexed,deltoid,denser,dichasial,differentiated,drying,eaf,ecuador,edicel,eed,ew,exserted,filament,flower,fork,free,fruiting,golden-yellow,impressed,inserted,lateral,less,lobe,long-triangular,lower,m.,mesophyll,monochasia,new,nflorescence,noddin,nodding,node,often,older,overtopping,pair,papillo,per,pitted,planar,portion,prominently,pubescen,raised,rounded,ruit,scar,secondary,shiny,shoot,sleev,sometimes,somewhat,stamen,ste,tall,tapering,terminal,tub,tube,ud,unit,usually,visible,woody,ympodial	arrangement,color,form,height,history,inflorescence,length,life,na,papillose,perennial,plant,pubescence,seed,shape,size,texture
731	wfo-0001031402	success	200	128	110	90	18	0.55	%,0-0.2,0-0.3,0-3,0.2-0.4,0.4-1.2,0.5-0.7,0.5-1,0.5-1.3,0.5-2.6,0.7-1.4,1.5-2,1.5-2.5,10-15,10-18,10-38,14-18,2-2.5,2-3,2-8,3-4,3-5.5,4-7,4-8,7.5-8.5,abaxially,absent,acicular,adaxially,anther,armed,base,calyx,chartaceous,cm,color,confined,connivent,cuneate,cylindrical,deeply,deltate,densely,diameter,distributed,eglandular,entire,fruit,glabrous,gland-tipped,globose,green,hair,herbaceous,inflorescence,lamina,lateral,leaf,leaf-opposed,length,linear,lobe,lobed,long,longer,margin,midpoint,midrib,mm,moderately,narrowly,oblique,ovate,ovoid,part,pedicel,peduncle,petiole,plant,porrect,prickle,pseudo-umbellate,purple,rachi,ray,resprouter,ripe,rotate-stellate,sessile,shallowly,short,simple,single-flowered,sparsely,stellae,stellate-pubescent,stem,stigma,straight,style,throughout,time,tube,unarmed,unbranched,unknown,wide,winged,x,yellow	0.3-0.6,0.3-1.1,0.6-1.2,0.8-2.5,0.8-3,1,1-15,1-2,1-3,1-4,1-5,2-4,2-6,2-foliate,2.2-12,3-15,3-5,5-40,5-merou,6-9,7-15,8-10,absen,abundant,accrescent,across,acute,adaxiall,adult,alyx,andromonoecious,apart,apex,articulated,axe,ba,blade,branche,capitat,contiguous,directed,distall,dm,dult,eaf,eed,erect,filament,finger,flower,fruiting,functional,geminate,glabrou,half,heterostylous,index,interpetalar,lobing,lon,lower,mature,midvein,minute,nearly,nflorescence,obtuse,orolla,per,pore,possibly,present,projecting,ruit,shorter,side,spaced,sprawling,stage,strongly,tal,tamen,thick,tissue,unit,uvenile,vary,vein,weakly,ympodial	abaxial,arrangement,capitate,corolla,form,growth,height,history,life,ovary,perennial,pubescence,seed,shape,size,surface,texture,width
732	wfo-0001031480	success	237	155	134	103	21	0.565	/3,0.1-0.4,0.4-0.8,0.5-2,0.6-0.8,0.8-1,1-1.3,1-1.5,1-2,1-3,1.7-2.2,1.8-3,1/3,1/6-1/5,2-2.7,3-10,3-7,3.5-7,4-5,4-6,6-13,7-8,abaxial,abaxially,acute,adaxial,anther,apically,apparently,bark,base,berry,blade,branched,branching,bright,calyx,cell,cm,cream,cuneate,dark,deltate,densely,diameter,discolorous,drying,dull,ellipsoid,elongate,entire,eye,faint,flattened-reniform,flower,fruit,glabrescent,glabrous,glandular,green,hair,lateral,leaf,length,lobed,long,long-styled,margin,marking,maturity,mauve,midpoint,minutely,mm,moderately,naked,often,orange-brown,outline,ovate,pair,pale,pedicel,peduncle,persistent,petiole,pit,plant,poricidal,porrect,prickle,prickly,primary,purple,raised,ray,red,red-brown,red-green,red-yellow-green,reticulate,scandent,shallowly,shrub,simple,small,smooth,somewhat,spherical,spreading,stalk,stalked,stellate,stellate-pubescent,stem,style,surface,tapering,terminal,tertiary,thick-chartaceous,tip,trichome,truncate,unarmed,upper,variously,vein,venation,visible,way,wide,yellow,young	-0.25,-2,0,0-0.5,0-1,0-2,0-30,0-5,0.1,0.1-0.3,0.15-0.3,0.2-0.35,0.4,0.5-,0.7,0.8,1-4,1.5-2.2,1/2,1/4,2-,2-3,2-5,2-6,3,3-6,5-8,5-merous,6-30,6-8,8-12,acuminat,alyx,andromonoecious,apar,apart,apex,articulated,ba,broad-deltate,curved,difoliate,distal,distance,eaf,eed,elongating,equal,erect,extending,filament,flattened,free,fruiting,geminat,hermaphrodite,heterostylous,inconspicuous,infructescence,lobe,longer,lower,lowermost,mature,midvein,near,nflorescence,obtuse,older,one,open,orolla,oung,pendulous,per,pericarp,portion,pubescent,red-brow,reduced,rounded,ruit,scar,sessile,short-styled,shorter,side,slender,slightly,spaced,sparsely,staminat,straight,tamen,terete,time,tube,unarme,unit,vary,weakly,woody,ympodial	0.1-0.7,2-6-30,acuminate,arrangement,color,corolla,form,growth,height,history,inflorescence,life,number,ovary,pubescence,seed,shape,size,staman,texture,width
733	wfo-0001031482	success	275	141	120	155	21	0.436	-1.4,-16,-18,-5,.5-5,/20-,0.2-0.3,0.7-1.3,1-4.5,1.2-1.5,1.2-3,1.3-4,1.4-2.2,1.6-2.8,1.9-2.5,1/10-1/4,2-3.3,2-4.7,2.5-10,2.5-4,3/4,4-13,4-5,4-6,4-7,5-7,6-16,8,abaxially,acute,adaxially,anther,anthesi,apart,bark,base,becoming,blade,blue,blunt-tipped,branched,brown,bud,calyx,cm,commonly,continued,corolla,deltoid,densely,diameter,due,elliptic,elongate,farinose,flower,fruit,glabrous,granular-tomentose,grayish,green,growth,lanceolate,lateral,leaf,length,lobe,long,midvein,mm,moderately,mostly,oblong,obtuse,often,pale,pedicel,peduncle,petiole,plurifoliate,possibly,prominent,pubescence,pubescent,relatively,reniform,ripe,rotate-stellate,scabridulous,shrub,slender,small,somewhat,spaced,sparsely,stellate,stelliform,stem,stigma,style,subcampanulate,subcapitate,subconical,subglobose,suborbicular,subspherical,sulcate,terete,terminal,thin,time,tomentose,tree,tube,unarmed,velutinous,x,yellow,yellowish,young	-0.06,-0.2,-0.4,-0.5,-0.6,-150,-5.3,-5.5,-6,.04-0.1,.04-0.35,.04-0.5,.06-1,.2-1.6,.5-0.7,.5-3.5,0-0.2,0-0.3,0-0.4,0-0.6,0-0.7,0.02-0.03,0.02-0.04,0.02-0.06,0.03-0.04,0.03-0.3,0.04-0.3,0.04-0.4,0.04-0.5,0.04-0.6,0.04-1.4,0.3-0.5,0.5-1.5,0.6-1.8,1,1/2-2/3,2-3.5,2-4.6,2.5-4.5,3.5-4.8,3.7-8,4.5,5-80,5-merou,6-11,9-13,accrescent,acuminate,adaxiall,ag,along,alyx,ape,apex,apical-lateral,apparently,appressed,articulated,attenuate,axe,axillary,ba,berry,beyond,branch,decurrent,dehiscing,directed,eaf,echinoid,eed,ellipti,entire,evident,exserted,extend,few-rayed,filament,free,fruiting,glabrescent,hair,high,honeycombed,immature,inserted,interpetalar,introrse,irregular,lacking,large,later,line,lobed,long-stalked,longer,longitudinal,lower,m.,main,margin,minute,mixed,multangulate,multiseriate,narrowly,nearly,nflorescence,oblong-orbicular,occasionally,older,orolla,ovate,overlapping,perfect,persistent,pore,porrect-stellate,present,rachi,rather,ray,reticulate-punctate,ribbed,rounded,ruit,runk,sessile,short-,short-stalked,side,simple,slightly,slit,sometimes,splitting,stalk,stamen,suture,tamen,testa,thick,tissue,toward,unarme,unevenly,unit,usually,vary,vein,way,weakly,white,wide,ympodial	0.5-3.5,abaxial,arrangement,branching,color,form,height,history,inflorescence,life,na,ovary,perennial,plant,seed,shape,size,surface,texture,trunk,ye
734	wfo-0001031483	success	154	64	45	109	19	0.292	.5,0.5,0.5-2,1-2,1.7-5.5,11-20.5,2-2.5,3-4,6-10,almost,anther,calyx,clavate,cm,corky,corolla,dia,filiform,flower,glabrous,green,indistinct,leaf,linear,lobed,mm,oblanceolate,obovate,ovary,ovoid-reniform,pedicel,petiole,shape,shaped,shrub,slightly,stem,stigma,style,subshrub,tear-drop,tube,turbinate,white,x	/2,0,1,1.1-2.5,1.2-1.4,1/3,2-3,2.5-3.2,3-8-flowered,7-10,across,acuminate,acute,anew,anthesi,apart,apex,attenuate,ba,base,bearing,beginning,beneath,berry,blade,ca,caly,continuous,cork,decurrent,deflexed,deltoid,difoliate,distal,dry,eaf,edicel,eed,end,evenly,exserted,filament,free,fresh,fruiting,fusiform,geminat,indistinc,internode,larger,lateral,lea,lenticellate,less,lobe,long,lower,main,major,markedly,minor,minutely,nflorescence,oblong,obovoid,often,opposite,orbiculate,pair,pale,paler,papillo,papillose,per,planar,pointed,pore,poricidal,portion,prominent,quite,raised,rounded,ruit,scar,short,short-triangular,simple,slender,somewhat,soon,spaced,straight,strongly,tall,tan,tapering,third,tip,ud,unit,variable,vein,way,widest,wing,winged,woody,ympodial	3-8,alternate,arrangement,bark,color,diameter,form,fruit,growth,height,history,inflorescence,length,life,perennial,plant,seed,size,texture
735	wfo-0001031486	success	166	114	97	69	17	0.584	0-4.5,0.2-0.7,0.9-1.7,1-2.2,1.5-4,1.8-3.3,11-37,2-3,2-3.5,2-6,2.5-3.2,2.8-6,3-26,3.4-10,3.5-6.5,3.5-8,5-10,7.5-22,9-37,abaxially,acute,adaxially,almost,apical,apically,branched,calyx,cm,commonly,connate,corolla,cyme,darker,deep,dehiscent,diameter,dichasial,dichasially,distal,ebracteate,exceeding,flower,forked,generally,globose,green,green-white,half,herbaceous,interjected,introrse,lateral,leaf,leaflet,less,light,lightly,lobe,long,long-attenuate,maturing,mm,monochasial,odd-pinnate,often,ovoid,pedicel,peduncle,pentagonal,perennial,petiole,plant,poricidally,puberulent,pubescent,pure,purple,rotate,seed,short,size,slit,sometimes,spot,stamen,stigma,straight,strigose,stripe,style,terminal,throughout,tinged,tip,white,wide,yellow	0-1.,1-3,1-4,1.5-6,3-6-foliat,5-16,abruptly,acumen,acuminate,apex,articulate,base,cell,cordate,covering,cuneate,decurrent,digestion,diminishing,dorsally,eaf,edge,eed,elliptic,emoval,enzyme,filament,flat,folded,globo,hair-like,highly,honeycomb,living,lon,lower,lunat,make,mucilaginous,nflorescence,nther,oblique,obovate,orolla,ovate,pair,pattern,perfect,petiolule,plan,proximal,reveal,ruit,seudostipule,specimen,tal,tem,testal,thick,throughou,toward,tuber-bearing,typically,unit,usually,vary,wall,ympodial,¼	0-15,anther,arrangement,color,form,fruit,growth,height,history,inflorescence,length,life,lunate,ovary,shape,stem,texture
736	wfo-0001031492	success	175	123	101	74	22	0.577	/4,0.5,0.7-1.3,0.9-1.1,1-1.3,1-1.5,1.3-2,1.5-1.8,1.5-2.5,10-15,2-10,2-3,2-5,20,3-4,3-5,4-10,4-4.5,6-8,8-11,abaxially,absent,adaxially,age,anther,apical,attenuate,base,becoming,bi-lobed,bitter,branching,calyx,cm,conical,corolla,dark,decurrent,dendritic,densely,diameter,drying,dull,echinoid,elliptic,filament,flattened,flower,fruit,glabrous,globose,golden,growth,juice,leaf,lenticular,lightly,lobed,long,medium,minutely,mm,narrowly,ovary,pair,pedicel,pericarp,petiole,pitted,pore,poricidal,pubescent,purplish-black,pyramidal,reddish-brown,scattered,shiny,short,shrub,size,slit-like,sparsely,stem,sticky,stigma,style,surface,thin,time,tip,tree,tree-like,trichome,tube,vein,violet,way,wide,winged,x,young	.5,08,8-9,acuminate,acute,anthesi,apex,appearing,axe,ba,bark,basal,beneath,berry,dbh,deciduous,deltoid,denser,distinguishable,eaf,edicel,eed,erect,ew,exserted,free,fruiting,grey,inserted,lamina,lateral,lobe,lower,m.,monochasia,nflorescence,nodding,occasionally,older,overtopping,papillo,per,planar,plurifoliate,portion,predominantly,prominent,rather,remaining,ruit,scar,scarcely,secondary,shoot,sleeve,slightly,sometimes,somewhat,stamen,ste,strongly,sunken,tall,tapering,terminal,tub,ud,undersurface,unit,upper,upturned,woody,ympodial,younger	abaxial,adaxial,arrangement,color,form,height,history,inflorescence,length,life,midvein,na,number,papillose,peduncle,perennial,plant,primary,pubescence,seed,shape,texture
737	wfo-0001031497	success	264	119	89	175	30	0.337	-35,0.1-0.2,0.1-0.8,0.2-0.5,0.5-2.5,1-2,1.2-2.4,1.5-2.5,12-30,2.25-3,2.25-4.75,2.5-4,2.8-3.5,20-30,3-10,3-5,3-6,3-9,4.5-7,4.5-9,5-8,6-9,actinomorphic,anther,attenuate,base,broadly,calyx,campanulate,cm,coarsely,deeply,densely,diameter,erect,filament,flower,fruit,glabrous,globose,incised,inflorescence,lanceolate,leaf,length,lenticular,light,lobe,main,margin,minutely,mm,obtuse,orange,ovate,ovate-lanceolate,pedicel,peduncle,perennial,petiole,pitted,prickly,pubescence,pubescent,ray,red,reniform-ovate,scabrous,simple,spreading,stellate,stellate-puberulent,stellate-pubescent,stem,stigma,style,surface,tan,thin-textured,truncate,tube,unarmed,unbranched,vein,weakly,white,x,yellow,zygomorphic	-1.4,-30,-7,.1,.1-0.2,0.05-0.2,0.2-0.4,0.4-1,1,1.2-2,1.5-4,1/3,1/5-1/3,10-25,14-,15-,18-25,2-5,2-foliate,2.5-5,3-15,4-12,4-locular,5-15,6-13,7-12,abaxially,acuminate,acute,adaxially,along,apart,ape,apex,appearance,appearing,appressed,articulated,axe,ba,berry,blade,broa,c.,cast,cauline,clearly,close,closely,compressed,connivent,curved,cylindrical,deciduous,deltoid,dense,denser,depressed-deltoid,directed,distal,distall,distributed,downcurved,due,eaf,eed,entire,equaling,essentially,external,extra-axillary,falcate,female-sterile,foliar,geminat,giving,glabrescent,green,hair,high,interlobal,intermixed,large,largely,larger,lateral,laterally,less,lignescent,lon,long,longer,lower,major,mature,maturity,midpoint,minute,nectary,never,nflorescence,numerous,oblique,obsolete,occasionally,often,one,orolla,other,otherwise,oung,outer,outline,pair,per,perfect,persistent,pigmented,pore,presence,present,prickle,projecting,purple,purplish,rachi,readily,recurved,reduced,rigid,ring,ripe,ruit,scattered,section,seldom,sessile,sharp-tipped,short,short-stalked,short-stipitate,side,similar,sinus,slightly,small,smaller,sometimes,somewhat,spaced,species,stalk,stellae,strongly,subcapitat,summi,tamen,thickened,three,time,tip,toothlike,two,type,unit,unlobed,uppermost,upward,usually,vary,varyingly,vestiture,wide,widely,ympodial	abaxial,adaxial,arrangement,bark,branch,branching,color,corolla,drying,form,growth,height,history,life,midvein,na,number,ovary,plant,primary,seed,shape,size,subcapitate,tertiary,texture,trichome,venation,width,young
738	wfo-0001031503	success	142	126	85	57	41	0.599	-10,-15,-25,-30,-7,0.3-3,0.5-1,0.5-4,1-,1-2.5,1-3,1-5,1.5-2,1.5-3,1.5-7,2-3,2.5-10,3-15,3-4,3-5,3-6,6-7,7-10,7-15,abaxially,acute,angled,apex,articulated,base,branched,calyx,chartaceous,cm,cuneate,decurrent,deltate,densely,diameter,eglandular,elliptic,entire,flower,forked,glabrous,gland,globose,hair,lanceolate,lobe,margin,mm,moderately,narrowly,occasionally,often,orange,ovate,pedicel,peduncle,petiole,puberulent,pubescent,rarely,reddish,ripe,rounded,rugose-pubescent,shrub,simple,slightly,sparsely,stalked,stellate,stigma,style,triangular,truncate,tube,unbranched,unequal,vein,white,x,yellow	-6,1-7,1.5-8,1.7-3.5,10-19,5613,6-many-foliat,abruptly,absen,acuminate,adaxially,aggregate,apart,axe,ba,blade,cell,connivent,curled,cylindrical,directed,distall,distally,eaf,eed,except,fide,long,lower,mostly,narrowed,nflorescence,nther,obtuse,orolla,perfect,pore,present,rachi,radiu,ruit,spaced,stone,subcapitat,subclavate,tal,tem,time,tip,toward,uniseriate,unit,usually,vary,venturi,wide,ympodial	abaxial,adaxial,anther,arrangement,bark,branch,branching,color,corolla,drying,filament,form,fruit,growth,height,history,inflorescence,leaf,length,life,main,midvein,na,number,ovary,plant,primary,pubescence,ray,seed,shape,size,stem,subcapitate,surface,tertiary,texture,trichome,unarmed,venation,young
739	wfo-0001031511	success	231	98	80	151	18	0.346	-15,-3.5,-5,-7,0.5-0.7,0.7-2.1,0.8-2,1-1.5,1-2,1.8-2.6,10-25,2-6,2.2-4.3,2.5-3,2.8-3.5,3-5,4-10,4.5-7,4.5-9,5-15,7-11,9-15,anther,armed,base,black,brown,calyx,chartaceous,cm,conspicuously,deltate,densely,diameter,discoid,ellipsoidal,erect,forked,fruit,globose,green,inflorescence,lanceolate,length,light,lobed,longer,mm,moderately,orange,ovate,pale,pedicel,peduncle,perennial,petiole,plant,present,prickle,pseudo-racemose,purple,rhizomatous,ripe,rotate,shallowly,shrub,stellate-pubescent,stem,stigma,style,surface,time,tomentose,tube,unbranched,violet,white,wide,x,yellow	%,-12,0,0-0.3,0-1.1,0-2,0-3,0.1-0.2,0.3-0.5,0.3-0.8,0.3-1.7,0.4-0.7,0.5-0.9,0.5-1,0.5-5,0.6-1.5,1,1-3,1-7,1.1-1.6,1.7-2.4,10-12,10-18,15-25,17-25,2-3,2-4,2-locular,2.2-3,25-45,5-10,5-6,5-7,5-9,5-merou,6-8,6-9,7-8,8-15,9-20,abaxially,absen,absent,accrescent,acicular,across,acute,adaxiall,adaxially,alyx,ample,andromonoecious,anvil-shape,apart,apex,articulated,axe,ba,basal,bisexual,blade,broadly,connivent,contiguous,cordate,cross-section,cuneate,cylindrical,dense,directed,distal,distall,dm,dult,eaf,eed,eglandular,entire,exocarp,extra-axillary,filament,finger,flower,fruiting,functional,geminat,glabrous,gland-tipped,hair,half,heterostylous,hig,interpetalar,juicy,lamina,lateral,less,lobe,lon,long,lower,male,margin,mature,mesocarp,mid-point,midpoint,midrib,midvein,minute,minutely,moist,nearly,nflorescence,oblique,obtuse,orolla,part,per,pitted,placenta,plurifoliate,pore,porrect,pubescent,rachi,ray,ruit,rusty,short,simple,somewhat,spaced,sparsely,stage,stalk,stalked,stellae,straight,strongly,tamen,thick,throughout,tissue,triangular,unit,unknow,uvenile,vary,wid,ympodial	abaxial,adaxial,color,corolla,form,growth,height,history,leaf,life,na,ovary,pubescence,seed,shape,size,texture,width
740	wfo-0001031512	success	199	123	104	95	19	0.523	%,-3,0.3-0.5,0.3-1,0.3-1.5,0.5-0.8,0.5-1.5,0.5-1.8,0.8-1,0.9-1.5,1-1.5,1-2.5,1.5-3,12-16,15-25,3-4,3-5.1,4-8,4.5-6,4.5-7,7-10,7-12,absent,acute,and/or,anther,apex,articulated,base,black,brown,brownish-black,calyx,chartaceous,cm,connivent,cuneate,cylindrical,deltate,densely,diameter,entire,flat,flower,fruit,glabrous,gland-tipped,globose,green,grey,grey-green,hair,inflorescence,lamina,lanceolate,later,lateral,length,lilac,lobe,long,loosely,marbled,margin,mid-point,midpoint,minute,mm,moderately,obtuse,pedicel,peduncle,perennial,petiole,plant,pseudo-racemose,pubescent,purple,raised,ray,rotate-stellate,short,shrub,slightly,sometimes,stellae,stellate,stellate-pubescent,stem,stigma,straight,style,surface,thick,though,tube,tubercle,twisted,unbranched,undulate,white,x,yellow,yellowish	0-10,0-3,0.05-0.1,0.1-0.2,0.15-0.2,0.15-0.25,0.15-0.3,0.2-0.3,0.5-0.6,1-2,1-3,12-15,13-15,13-16,2-6,2-foliate,3.8-5.7,5-12,5-7,5-merou,6-13,8-10,abaxially,absen,abundant,accrescent,adaxiall,adaxially,alyx,andromonoecious,apart,axe,ba,blade,broad,broad-based,capitat,decimetr,directed,distall,distinct,distributed,dr.,dult,eaf,eed,erect,extra-axillary,filament,finger,first,fruiting,functional,geminat,half,heterostylous,interpetalar,less,longer,lower,mature,mesocarp,nflorescence,oblique,orolla,part,per,pore,porrect,present,prickle,rachi,rhizomatous,rounded,ruit,scarcely,sessile,simple,smooth,spaced,stage,strongly,tal,tamen,throughout,time,tissue,unarmed,unit,unknow,uvenile,vary,weakly,wide,ympodial	abaxial,adaxial,articulation,branching,capitate,color,corolla,form,growth,height,history,leaf,life,ovary,pubescence,seed,shape,size,texture
741	wfo-0001031586	success	167	80	64	103	16	0.383	-2,0.1-1,0.5-0.8,0.5-1,1-1.2,1-1.5,1-2,1.3-5,1.4-2.5,1.5-2,2,3-11,5-6,7-10-flowered,anther,bark,base,bright,broadly,calyx,capitate,cm,conical,corolla,cream-colored,drying,elliptic,filament,flower,glabrous,green,greenish,inflorescence,leaf,lobed,mm,nearly,olive,open,ovary,pale,paler,papillate,pedicel,petiole,ridged,shaped,shiny,shrub,simple,size,sparsely,stem,stigma,straight,style,surface,tear-drop,thickened,tube,white,x,yellowish,young	.25,1,2-2.5,5-10,abrupt,absent,acute,anthesi,apart,apex,apparently,appearing,attenuate,becoming,beneath,borne,branch,bud,campanulate,closer,completely,cucullate,deflexed,deltate,dia,differing,difoliate,distance,eaf,edicel,eed,ellipsoid,exerted,exfoliatin,fleshy,free,fresh,geminate,globose,gree,inflorescenc,know,known,later,lateral,leave,lobe,long,lower,main,major,margin,material,may,minor,minutely,mucro,near,new,nflorescence,notched,occasionally,older,one,onto,opposite,overtopping,pair,papillose,planar,pore,poricidal,portion,present,prominent,raised,remaining,rounded,ruit,scar,shap,shin,slender,small,sometimes,somewhat,soon,spaced,swollen,tall,tapering,thick,tip,trichome,truncate,trunk,ud,uniseriate,unit,vein,widely,yellow,ympodial	0.25,color,diameter,exfoliating,form,growth,height,history,length,life,na,perennial,plant,pubescence,shape,texture
742	wfo-0001031587	success	142	97	77	65	20	0.542	.5,0.8-1,1-1.5,1.5-2,1.7-2,12-16,17-30,2-2.5,2-9-celled,2/3,3-4,5,6-7,abaxially,adaxially,anther,apart,apex,bark,base,bi-lobed,broadly,calyx,clavate,cm,conical,corolla,decurrent,deflexed,dendritic,densely,drying,elliptic-ovoid,filament,fleshy,furcate,glabrous,globose,golden-red,inflorescence,leaf,lobed,loose,minutely,mm,occasional,ovary,pale,papillate,pedicel,petiole,pubescent,rarely,reddish-grey,shape,shaped,simple,size,soft,somewhat,stem,stigma,style,surface,tear-drop,thick,thickened,tree,trichome,tube,uniseriate,verrucose,way,white,winged,x,young	10-15,2,6-8,7-9,acute,along,anthesi,attenuate,axi,closely,cone,deltate,denser,dia,differing,eaf,edicel,eed,elliptic,erect,evenly,exserted,fide,free,included,irregular,know,known,lamina,later,lateral,like,lobe,long,lower,lowered,main,major,middle,minor,mostly,oblique,ocasionally,older,overlappin,pair,papillo,parallel,perpendicular,persisten,pore,poricidal,portion,rect,rest,ruit,scar,spaced,steinbach,tall,tip,tub,ud,vein,widest	abaxial,adaxial,branching,color,dense,diameter,form,growth,height,history,length,life,na,papillose,perennial,persistent,plant,pubescence,spacing,texture
743	wfo-0001031589	success	222	140	111	111	29	0.5	-0.5,-15,-6.5,0.1,0.1-0.5,0.2-0.4,0.4,0.5-1,0.55-0.7,0.9-1.3,1-1.8,1.2-1.5,1.8-2.9,1/3,1/3-1/4,2-3.5,2.5-6,2.8-4,3-5,4-6.5,anther,apparently,attenuate,bark,base,berry,bright,brown-green,calyx,cell,chartaceous,cm,concolorous,deltate,densely,diameter,discolorous,drying,dull,elliptic,filament,flattened-reniform,flower,fruit,glabrescent,glabrous,gray-green,lateral,leaf,length,lobe,lobed,long,long-obovate,margin,maturity,mauve,membranous,midvein,mm,moderately,multangulate,narrow-cuneate,occasionally,often,orange-brown,orange-green,outline,pair,pale,pedicel,petiole,pit,plant,poricidal,porrect,prickly,primary,raised,ray,scandent,shiny,shrub,simple,small,smooth,solitary,sparsely,spherical,stellate,stellate-pubescent,stem,stout,straight,style,subentire,surface,tapering,tertiary,tip,trichome,tube,upper,vein,venation,way,weakly,white,yellow,yellow-green,young	-6,.5,/6,0,0-1,0-10,0-3,0-30,0.15-0.3,0.2-0.5,0.2-3,0.6-1.2,0.7,0.8-2.3,0.9-1.6,1,1-5,1.5-5,1.7-2.5,1/3-1/2,10-30,2-,2-10,2.5-4.5,3-4,3/4,4/5,5-8,5-merous,6-8,8-14,8-30,abaxially,acute,alyx,ame,apart,apex,apically,articulated,blade,broadly,brow,c.,caudat,connivent,cream,dark,density,difoliate,distance,eed,elongating,equal,erect,extending,eye,free,fruiting,geminat,green,higher,infructescence,lengt,lon,longer,lower,marking,mature,midpoint,naked,narrow,nflorescence,oblong,obovate,older,orolla,oung,part,pendulous,per,perfec,pericarp,portion,prickl,prickle,reflexed,rounded,ruit,sessile,shorter,side,sometimes,somewhat,spaced,spreading,stalk,stalked,subsessile,tamen,terete,time,unit,vary,visible,whole,wide,winged,woody,yellow-orange,ympodial	0.5,8,abaxial,adaxial,arrangement,branch,branching,brown,color,corolla,form,growth,height,history,inflorescence,life,main,na,number,ovary,peduncle,pubescence,seed,shape,size,stigma,texture,unarmed,width
744	wfo-0001031609	success	154	117	78	76	39	0.506	0-30,0.5-3,1-10,1-6,1.3-3,1.5-2,1.5-3,10-25,2-3,2.5-4,3-24,3-5,4,4-5,4-6,4.5-60,8-20,abaxially,acute,adaxially,apex,around,base,branch,brownish,calyx,campanulate,cm,connivent,cuneate,deltate,dia,diameter,dilated,distally,elliptic,entire,flattened,fleshy,flower,forked,fruit,glabrous,globose,green,inflorescence,leaf,lobe,lobed,margin,mm,obconical,obovate,orange,papillose,pedicel,peduncle,petiole,pinnately,puberulent,reticulate,ripe,shallowly,shrub,simple,small,stellate,stigma,strongly,style,succulent,tree,triangular,truncate,tube,unbranched,x,yellow	.5,/4,0.4-3,0.5-1,2,2-,20-25,3-9-lobed,3-foliat,5-25,5/6,absen,absent,aggregate,ape,apiculate,articulated,axe,barely,beyond,bilobe,blade,brow,cell,connective,conspicuous,contiguous,dark,directed,divided,eaf,eed,ellipsoidal,elliptic-ovate,emerging,equal,exceeding,exserted,glabrou,laterally,leaving,long,lower,midrib,minutely,nearly,nflorescence,nther,obtuse,occasionally,orolla,pedicellar,point,pore,rachi,radiu,rounded,ruit,scar,sinus,stamen,stone,succulen,tal,tem,thecae,time,tip,tomento,two,ud,unit,unlobed,vary,wide,ympodial	abaxial,adaxial,anther,arrangement,bark,bilobed,branching,color,corolla,drying,filament,form,growth,height,history,length,life,main,midvein,na,number,ovary,plant,primary,pubescence,ray,seed,shape,size,stem,surface,tertiary,texture,trichome,unarmed,vein,venation,width,young
745	wfo-0001031615	success	154	90	74	80	16	0.481	.5,0.5,0.5-1,0.8-1,0.9-1.1,1-1.6,1.3-1.8,1.5,1.5-5,11-15.5,2-4.2,3.8-6.1,4-6.5,5-6,anther,bark,base,berry,bilobed,brown,calyx,capitate,cm,corolla,decurrent,deep,dia,elliptic,flattened-reniform,fruit,furcate,glabrous,glandular,globose,green,inflorescence,leaf,lobed,long,minor,minutely,mm,nearly,occasionally,older,ovary,paler,pedicel,petiole,poricidal,shrub,simple,size,slender,small,somewhat,stem,stigma,style,subumbellate,tapering,terminal,thickened,tip,tree,trichome,tube,tuft,uniseriate,urceolate,white,winged,x,young	0,2-3,5-20-flowered,6-8,8-10,acuminate,acute,anthesi,apex,arising,attenuate,axil,ba,becoming,caly,closely,dark,dark-papillo,deflexed,deltoid,differing,difoliate,distal,eaf,edicel,eed,expanded,exserted,filament,free,fruiting,geminat,impressed,incrassate,interpetalar,lamina,lateral,less,lobe,lon,lower,main,major,margin,maroo,middle,minute,nflorescence,one,opposite,overlappin,packed,pair,papillae,papillose,per,pitted,pore,portion,prominent,reflexed,ruit,scar,scarcely,shaped,shiny,sinus,slightly,straight,surface,tall,tear-drop,thin,ud,unicellular,unit,vein,widest,woody,ympodial	branching,color,dark-papillose,diameter,form,growth,height,history,length,life,maroon,perennial,plant,seed,shape,texture
746	wfo-0001031618	success	184	82	59	125	23	0.321	-2,0-3,1-1.5,1.5-2,10-18,2-2.5,2-3,3-4,3-8,4-5,anther,broadly,calyx,capitate,cm,corolla,cyme,darker,discoidal,finely,glabrous,glandular,green,greyish,hair,lavender-purple,leaf,marbled,maturity,minute,mm,oblong,obovoid,ovary,ovoid,pale,pedicel,peduncle,petiole,pinatisect,purple,reddish-brown,reticulate,ripe,rotate,rugose,scorpioid,shrub,simple,somewhat,stem,stigma,stripe,succulent,surface,tinged,triangular,variable,x	0.5-1.5,1-7,1.5-3.5,10-lobed,13,3,40-60,5,5-12,90-110,acuman,acute,almost,also,anthesi,apex,appearance,appearing,aspect,axil,base,becoming,berry,beyond,blunt,bluntly,branch,c.,cell,clonal,cluster,column,conical,covering,cuneate,cut,developed,dia,eaf,eed,ellipsoid,elliptic,emarginate,enlarged,equal,erect,except,exerted,extending,facetted,filament,fleshy,floral,flower,fork,forked,frui,general,giving,greatly,gree,growing,habit,half,interacuminal,lanceolate,lasting,lengthening,less,lobe,lobed,lon,long,loosely,lower,mauve,may,mid-vein,midrib,narrowly,nflorescence,occasional,occur,often,ovate-lanceolate,pal,pedicellate,petal,plurifoliat,point,pore,poricidal,rarely,rhachi,rounded,ruit,sessile,several,shallowly,side,single,sinus,slit,soft-wooded,sometimes,specimen,stone,stout,strongly,styl,tapering,terete,tip,tissue,tub,ud,unequal,unit,vigorous,way,well,year,ympodial,young,younger	abaxial,adaxial,branching,color,diameter,form,fruit,growth,height,history,inflorescence,length,life,na,perennial,plant,pubescence,seed,shape,size,style,texture,tube
747	wfo-0001031646	success	171	120	84	87	36	0.491	-7,-pinnate,.2,.5,0.8-1.5,1-1.8,1-6,1.2-2.5,15-25,18-38,2-2.5,2-3,2.5-10,20,3.5-4,4-18,4-20,4-5,5,5-6,7-8,8-15,abaxially,adaxially,anther,base,blue,branched,brown,calyx,chartaceous,cm,cuneate,darker,densely,diameter,ellipsoidal,entire,filament,flattened,flower,fruit,glabrous,glandular,globose,green,hair,highly,immature,leaf,light,lobe,margin,maroon,mature,mm,multicellular,oblique,oblong,ovate-lanceolate,pedicel,peduncle,petiole,pubescence,pubescent,red,rotate-pentagonal,rounded,rugulose,scandent,shrub,simple,size,smooth,stem,stigma,style,surface,tube,uniseriate,vine,violet,x,yellow	0.2-0.8,0.5-2,1-10,1.5-3.5,1.5-4,1962,2-10,4-8,4-foliate,5-7,5-7.5,5-merou,absen,absent,accrescent,acuminate,acut,acute,aggregate,alyx,apart,apex,apical,apparently,articulated,axe,ba,basally,berry,blade,cell,ciliat,climbing,connivent,correll,covered,cylindrical,decreasing,directed,distall,eaf,eed,elliptic,elliptic-lanceolate,equal,fide,fruiting,geminat,high,homostylous,hyaline,interjected,lateral,leaflet,long,lower,nflorescence,obliquely,obtuse,orolla,ovate-lanceolat,part,perfect,petiolule,pore,present,pubescen,rachi,ruit,seudostipule,shortly,slightly,small,spaced,spreading,stone,stout,tamen,tawny,tem,tip,toward,tree,truncat,unit,vary,ympodial	abaxial,adaxial,arrangement,bark,branch,branching,color,corolla,drying,form,growth,height,history,inflorescence,length,life,main,midvein,na,number,ovary,perennial,plant,primary,ray,seed,shape,tertiary,texture,trichome,truncate,unarmed,vein,venation,width,young
748	wfo-0001031651	success	201	145	118	83	27	0.587	-3,-3.5,.6,.7,/5,0.1-0.2,0.3-0.5,0.3-0.8,0.3-1.5,0.6-1,0.6-1.3,0.7-1,1-1.7,1-2,1.2-2,1.2-3,1.5-2,1/5,1/6-1/4,2-3.5,3-5,4-5,4-6,abaxial,acute,adaxial,anther,apically,apparently,bark,base,berry,blade,branched,calyx,cell,chartaceous,cm,concolorous,cordate,dark,deltate,densely,diameter,discolorous,drying,dull,elliptic,entire,faint,filament,flattened-reniform,flower,fruit,glabrescent,gray,herb,lateral,leaf,length,lobe,lobed,long,margin,maturity,mm,obtuse,orange-brown,outline,ovate,pair,pedicel,peduncle,persistent,petiole,pit,poricidal,porrect,prickly,primary,purple,raised,ray,red,red-green,rounded,shrub,simple,small,smooth,sometimes,spherical,spreading,stalk,stalked,stellate,stellate-pubescent,stem,style,subentire,surface,tapering,terminal,tertiary,tip,trichome,tube,unarmed,upper,variously,vein,venation,way,weakly,white,wide,yellow,yellow-green	-2,.1,/3,0-20,0.1,0.1-0.15,0.1-0.25,0.15-0.2,0.2-0.5,1,1-4,1.3-1.6,2-10,2-3,2/3-3/,4.5-7,5-merous,abaxially,absent,acuminat,alyx,ame,apar,apart,apex,articulated,brown,c.,curved,difoliate,eaf,eed,elongating,equal,erect,eye,filiform,free,fruiting,geminat,glabrous,gra,herbaceous,infructescence,lanceolate,longer,lower,mature,midpoint,naked,nflorescence,oblong,older,one,open,orolla,oung,pendulous,per,perfec,pericarp,portion,prickl,prickle,reflexed,ruit,scandent,scar,shorter,spaced,straight,subsessile,tamen,terete,thick,thick-stalked,time,toward,unarme,unit,vary,visible,ympodial	acuminate,arrangement,branch,branching,color,corolla,form,growth,height,history,inflorescence,life,main,midvein,na,number,ovary,perennial,plant,pubescence,seed,shape,size,stigma,texture,width,young
749	wfo-0001031654	success	191	132	110	81	22	0.576	0.5,0.5-0.75,0.5-1,0.5-1.5,0.5-2,1-1.5,1-2,1-3,1-4,1.5-2,1.5-2.0,1/3-1/2,2-3,2-5,2-6,2-8,3-10,3-6,4-16,4-6,4-7,5-8,abaxial,abaxially,absent,acute,adaxial,adaxially,anther,armed,attenuate,base,brown,bud,calyx,chartaceous,cm,connivent,contiguous,cream,cut,cylindrical,dark,decurrent,densely,diameter,filament,flower,fruit,glabrous,globose,green,hair,immature,leaf,less,lobe,lobed,many,margin,mature,midvein,mm,moderately,multicellular,multiseriate,narrowly,nearly,netlike,obtuse,ovate,pedicel,peduncle,per,petiole,pit,prickle,pubescent,raised,ray,recurved,red,reniform,ridge,separated,shrub,side,simple,slightly,small,spaced,sparsely,spreading,stalk,stellate,stem,stigma,style,surface,tapering,triangular,tube,unarmed,unbranched,unicellular,way,white,whitish,x,yellow	0.5-3.5,1,1-.,1.5-3,10-20,2-ranked,3,5-merou,8-15,accrescent,adaxiall,alyx,apar,apex,apical,apparently,axe,berry,beyond,blade,cordate,cylindrica,difoliate,directed,discolorous,eaf,eed,either,em,equa,exserted,extra-axillary,flattened,frui,fruiting,geminate,glabrou,interpetaler,introrsel,lacking,leaf-opposed,like,long,lower,m.,major,midpoint,midrib,nflorescence,obscure,occasional,occasionally,often,onto,orolla,pair,parallel,perfect,perpendicular,pore,porrect-stellate,rachi,ruit,rusty,scandent,secondary,sinus,spine,stamen,ste,straight,tamen,tan,thin-skinned,tissue,unit,usually,vary,vein,wide,ympodial	apart,armament,arrangement,branching,color,corolla,form,growth,height,history,inflorescence,length,life,number,ovary,perennial,plant,seed,shape,size,staman,texture
750	wfo-0001031656	success	154	96	75	79	21	0.487	/4,0.5-1,1-1.5,1-2,1-2.5,1.2-1.5,1.5-2,1.5-5,10-20,3-3.5,4-9,5-ribbed,6-8,anther,bark,base,bright,calyx,capitate,cm,corolla,dia,drying,ellipsoid,elliptic,filament,fleshy,flower,fruit,glabrous,globose,green,greyish,leaf,live,lobe,lobed,long-acuminate,matte,minute,minutely,mm,opposite,ovary,ovate,papillose,pedicel,petiole,plant,poricidal,rather,red-papillose,reddish,sessile,shaped,shiny,shrub,size,specimen,stem,stigma,straight,strongly,style,surface,tear-drop,thick,tip,transversely,tube,visible,way,white,x,young	.5,0.5,2.5-3.5,3-5,5-7,acuminate,acute,also,anthesi,apex,arising,ba,berry,closely,cork,densely,differing,difoliate,directly,eaf,edicel,eed,enclosing,erect,extremely,free,fruiting,geminat,hooded,known,lateral,lon,long,lower,main,major,margin,mature,middle,minor,nflorescence,node,oblique,often,older,one,pair,pale,paler,papillo,peelin,persistent,planar,pore,portion,prominent,proximal,reflexed,rib,ridged,rounded,ruit,scar,slightly,somewhat,spaced,swollen,tall,terminal,thickened,top,ud,unit,upper,vein,wide,widest,woody,ympodial	abaxial,adaxial,branching,color,diameter,form,growth,height,history,inflorescence,length,life,na,peduncle,peeling,perennial,pubescence,seed,shape,texture,width
751	wfo-0001031667	success	153	96	76	77	20	0.497	0.6-1,0.6-1.5,1-1.5,1.4-3,1.5-2,10-13,12-35,2-3,2.5-5,3-13,3-5,5-15,5-9,6-10,8-13,8-15,abaxially,adaxially,branched,calyx,cell,cm,connate,corolla,covering,cyme,dark,diameter,dichasial,dichasially,distal,ebracteate,elliptic-lanceolate,flower,forked,generally,globose,green,green-white,hair-like,half,herbaceous,interjected,irregularly,lanceolate,lateral,leaf,leaflet,lobed,long,mm,monochasial,odd-pinnate,ovoid,pedicel,peduncle,perennial,petiole,pilose,plant,seed,size,spot,stellate,stigma,straight,stripe,style,terminal,testal,thick,throughout,wall,white,wide,yellow	1-4,2-5,2-6,3-6-foliat,3-8,4-1.,abruptly,acumen,acuminate,acute,apex,apical,apically,apiculate,articulate,base,caudate,cordate,cuneate,dehiscent,digestion,diminishing,dorsally,eaf,edge,eed,emoval,enzyme,exceeding,filament,flat,folded,globo,honeycomb,introrse,living,lobe,lon,lower,lunat,make,maturing,mucilaginous,nflorescence,nther,oblique,oblong,often,orolla,pair,pattern,perfect,petiolate,petiolule,plan,poricidally,proximal,reveal,rounded,ruit,sessile,seudostipule,short,slit,specimen,stamen,tal,tem,toward,tuber-bearing,typically,unit,vary,whit,without,ympodial,¼	4-10,anther,arrangement,branching,color,form,fruit,growth,height,history,inflorescence,length,life,na,number,ovary,shape,stem,surface,texture
752	wfo-0001031672	success	157	98	75	82	23	0.478	0.3-0.5,0.5,0.5-1.5,1,1-5,1.5-2,1.5-2.5,1.5-3.5,1.5-5,10-20,15-20,15-50,2-12,2-28,4,4-34,4.5-5,6,9-lobed,abaxially,acute,apex,apiculate,articulated,base,calyx,chartaceous,cm,cylindrical,densely,diameter,flattened,fleshy,flower,fruit,glabrous,glandular-puberulent,globose,green,greenish-brown,leaf,mature,membranaceous,mm,moderately,narrowly,near,often,ovate,ovoid,pedicel,peduncle,petiole,pilose,pinnately,puberulent,pubescent,rounded,simple,sparsely,stellate,stigma,style,subcoriaceous,tip,toward,tree,triangular,truncate,tube,unbranched,white,whitish,x,yellow	0,0-2,0.5-1,1-,1-1.5,1-10,1-2,3-4-foliat,3/4,4/5,5-6,absent,acuminate,adaxially,aggregate,apart,ape,aublet,axe,basal,beyond,blade,cell,ciliat,connective,cordate,directed,distally,divided,eaf,eed,entire,exceeding,exserted,fide,hair,lanceolate,leaving,lobe,lobed,lon,long,lower,margin,midrib,nflorescence,nther,obtuse,occasionally,one,orolla,pedicellar,perfect,pilo,pore,presen,present,purple,rachi,radiu,remant,represented,ruit,shorter,sinus,slightly,small,spaced,stamen,stone,tal,tem,thecae,time,truncat,ud,unit,unlobed,vary,wide,yello,ympodial	abaxial,adaxial,anther,arrangement,color,corolla,form,growth,height,history,inflorescence,length,life,ovary,perennial,plant,pubescence,seed,shape,size,stem,surface,texture
753	wfo-0001031684	success	161	94	74	87	20	0.46	.5,/4,0.4-1.5,0.5-0.8,0.7-1,0.75-1,1-1.2,1-5,2,2-9,3-30,4-17,anther,bark,base,branched,calyx,clavate,cm,corolla,curly,decurrent,densely,dia,difoliate,elliptic,geminate,glabrous,globose,green,inflorescence,irregularly,leaf,lobed,long,minutely,mm,obconic,occasionally,older,ovary,ovoid-reniform,pale,papillose,pedicel,persistently,petiole,pitted,poricidal,pubescent,short,shrub,size,slender,slightly,small,sparsely,stem,stigma,straight,style,surface,tan,tip,tipped,tree,trichome,unifoliate,uniseriate,way,white,winged,x,young	.25,.75,0.1,0.5-0.7,0.5-1,10-100,3-3.5,5-7,acuminate,acute,along,anthesi,apar,apex,bearing,beneath,berry,black,borne,causing,deflexed,denser,differing,drying,eaf,edicel,eed,elongated,except,expanded,exserted,extremely,filament,filiform,flower,free,fruiting,gre,greatly,internodal,lateral,less,like,lobe,lon,long-triangular,lower,main,major,middle,midrib,minor,nflorescence,one,opposite,pair,papillo,planar,pore,portion,present,previously,pulled,raised,reflexe,reflexed,rest,ruit,scar,shaped,single,siz,soon,spaced,tall,tapering,tear-drop,time,tube,ud,unevenly,unit,varying,vein,widely,widest,ympodial	0.25,arrangement,branching,color,diameter,form,fruit,grey,growth,height,history,length,life,na,perennial,plant,pubescence,seed,shape,texture
754	wfo-0001031690	success	140	121	92	48	29	0.657	.5,1.2-2.0,1/2-2/3,2-3,2-5,2-8,2.5-3.5,2.7-3.6,4-9,7-10,acute,along,anther,apex,apically,arcuate,bearing,beneath,berry,blade,blue,broadly,brown,calyx,campanulate,cauline,cm,da,dark,depressed-spherical,developing,dm,dry,eglandular,foveolate,glabrate,glabrous,green,hair,herb,internodal,invested,lanceolate,length,linear,lobe,long,main,maturity,minutely,mm,numerous,obtuse,often,ovate,perennial,petiole,pinnatifid,prickle,prickly,rarely,reflexed,reniform,rounded,scattered,sessile,shape,slender,slightly,splitting,spreading,stellae,stellate,stem,stipitate-glandular,strait,tapering,terete,thrice,tightly,tube,twice,ultimate,uniseriate,usually,variable,vein,violet,violet-tinged,viscid-glandular,young,zygomorphic	2/3,6-9-flowere,8-40,accrescent,acro,always,alyx,anthesi,base,completely,corky,covered,difoliate,divided,eaf,eed,emerging,erect,exceeded,geminat,least,lon,nflorescence,orolla,pedicel,per,persistent,rhizome,root,ruit,separated,short,slende,somewhat,space,tall,tamen,throughout,tigma,tub,tyle,unexpande,unit,vary,widely,yearly,yellow,ympodial	6-9-flowered,across,color,corolla,diameter,flower,form,fruit,growth,height,history,inflorescence,leaf,life,ovary,pinnation,plant,pricklines,pubescence,seed,size,staman,stigma,stipule,straith,style,surface,texture,unexpanded
755	wfo-0001031695	success	185	118	92	93	26	0.497	0.5-1,1-2,1-9,1.5-8,10-35,2-3,2-5,2.5-5,20-30,3-19,3-7,30-40,4-10,4-5,4-6,5,5-20,5-7,6-10,6-20,abruptly,acuminate,also,apex,base,branched,broadened,calyx,campanulate,chartaceous,cm,color,cordate,dark,deep,densely,diameter,eglandular-pilose,ellipsoidal,entire,flattened,fleshy,flower,fruit,glabrescent,glabrous,glandular-puberulent,green,greenish,hair,hard,immature,lateral,lavender,leaf,lobe,lobed,long,margin,mm,moderately,mottled,narrowly,oblique,oblong,occasionally,ovate,pedicel,peduncle,petiole,pilose,pilose-hirsute,puberulent,puberulent-pubescent,pubescent,purple,purplish,shrub,simple,sometimes,sparsely,stigma,stripe,style,subcoriaceous,tree,triangular,unbranched,unit,unlobed,x,yellow	0.5-2,1,1-3,1.5-2,1/2,1/3,10-,10-15,15-20,2-4,3-,3-10,3-17,4-foliat,6-8,7-,?,abaxially,acute,adaxially,aggregate,apart,ape,apically,apiculate,articulated,axe,basal,beyond,blade,capitat,cell,connective,connivent,cylindrical,d,dilated,directed,divided,eaf,eed,eglandular,exceeding,exserted,glabrate,lanceolate,laterally,leaving,lilac,lon,lower,midrib,nflorescence,nther,obtuse,often,orolla,ovoid,pedicellar,perfect,pilo,pilose-hirsut,pore,presen,present,rachi,radiu,remnant,ripe,rounded,ruit,shorter,sinus,slight,slightly,small,somewhat,spaced,stamen,stone,swelling,tal,tem,thecae,time,tip,tomento,tube,unequal,unknown,vary,wide,ympodial	4-foliate,abaxial,adaxial,anther,branching,capitate,corolla,form,growth,height,history,inflorescence,length,life,ovary,perennial,pilosity,plant,pubescence,seed,shape,size,stem,surface,sympodial,texture
756	wfo-0001031697	success	185	125	90	95	35	0.486	.4,.5,.7,0.4,0.5,1,1.2,10-celled,15,2-celled,3,3.5,4,4.5,?,anther,apex,around,attenuate,base,calyx,cm,cordate,densely,diameter,divergent,entire,except,face,few-celled,flattened,flower,foveolate,fruit,glabrous,gland-tipped,globose,hair,herbaceous,hyaline,lacking,less,lobe,long,lowest,margin,minute,mm,mostly,non-glandular,ovate,ovate-lanceolate,pedicel,peduncle,petiole,pilose,plant,pore,prickle,pubescence,pubescent,purple,raised,scattered,shallowly,sharp,shiny,simple,size,slender,somewhat,sparsely,stellate,stem,stigma,straight,style,subreniform,subshrub,terminal,thin-textured,tip,tube,tuberculate,unarmed,unbranched,white,x,yellow,yellow-brown	-celled,.6,.8,0.1,0.3,0.6–1.0,0.8,1.2–2.5,1.4,1.5–7,15–60,1–1.6,1–2,2-foliate,2.2,2–3,2–4,3–4,3–8,4-rayed,4–5,5,6–13,abaxially,accrescent,acute,adaxially,apparently,axe,blade,branch,completely,consistently,covering,cylindrical,directed,distall,eaf,eed,especially,fertile,filament,flowering,free,frui,fruiting,geminat,glabrou,gland-tippe,hilum,indentation,linear,lon,longer,longest,lower,lowermost,major,many,midpoint,mixed,nflorescence,often,orolla,part,per,pigment,ruit,sessile,several-celled,short,shorter,similar,single,small,smaller,ste,stellae,tall,tamen,taproo,tem,thick,time,truncat,ultimate,unarme,unit,upper,vary,varying,vein,wide,ympodial,–3	.3,1-1.6,1.2-2.5,1.5-7,15-60,3-4,3-8,4-5,6-13,abaxial,adaxial,arrangement,branching,cell,color,corolla,form,growth,height,history,inflorescence,leaf,length,life,na,number,ovary,seed,shape,surface,texture,thicknes,trichome,truncate,width
757	wfo-0001031698	success	58	47	33	25	14	0.569	2-2.5,2.5,2.5-3,4-4.5,bark,base,branch,cm,dull,elliptic,flattened,fruiting,glabrous,green,leaf,minutely,mm,pale,papillae,pedicel,pitted,reddish-brown,reniform,repandly,rugose,shrub,stem,strongly,surface,winged,x,yellowish,young	'',``,ape,decurrent,deflexed,dia,difoliate,eaf,eed,fide,geminat,incrassate,long,maguire,margin,older,otherwise,paler,persistin,stout,tall,unit,wing,woody,ympodial	1,apex,color,diameter,form,growth,height,length,plant,pubescence,seed,shape,size,texture
758	wfo-0001031707	success	178	142	105	73	37	0.59	/4,1-1.2,1-1.3,1-1.5,1.2-1.8,1.2-2,1.5-2,1.5-6,16-20,2,2-3,2-4,2-6,4-5,4-6,6-7,8-12,9-15,abaxially,adaxially,almost,along,anther,anthesi,apical,apically,attenuate,axil,axillary,base,basiscopically,brown,calyx,capitate,climbing,cm,conical,corolla,cucullate,dense,densely,diameter,distinct,drying,enlarged,erect,filament,flap-like,flattened,flower,glabrous,globose,green,greenish,high,leaf,leaflet,lobe,lobed,long,margin,minutely,mm,oblique,occasionally,open,ovary,pair,papillate,pedicel,per,petiole,pink,pinnate,planar,plant,pointed,poricidal,primary,pubescent,quadrate,reddish,round,sagittate,scattered,simple,slightly,smooth,sparsely,stigma,style,surface,ternate,thickening,time,tip,trichome,tube,uniseriate,vein,vine,way,white,woody,x	-3,.5,0.5-1,1-3,1.5-1.7,1/3,2-10,24,3,5-10-celled,80-140,absent,acuminate,acute,apex,basal,bearing,berry,c.,cateniform,cell,clavat,conspicuously,distal,eaf,edicel,eed,elliptic,endrophilum,epidermal,exserted,flat,fleshy,four-lobed,free,fruiting,horizonta,inflorescenc,lanceolate,lateral,less,like,lon,lower,narrower,narrowly,nflorescence,obovate,penden,petiolule,portion,quite,raised,regular,rest,ruit,scar,smaller,somewhat,spaced,stout,strongly,tem,terminal,tub,type,ud,unifoliat,unit,usually,white-lenticellate,widely,ympodial	0.5,8,abaxial,adaxial,arrangement,bark,branch,branching,cateniforme,clavate,color,form,fruit,growth,height,history,horizontal,inflorescence,length,life,main,midvein,na,number,peduncle,pubescence,ray,seed,shape,size,stem,tertiary,texture,unarmed,venation,width,young
759	wfo-0001031714	success	201	144	118	83	26	0.587	-3.5,-6,-8,0.2-0.5,0.3-0.5,0.4-,0.5,0.5-,0.5-0.8,0.7-2.2,1,1-1.4,1-2,1-3,1-4,1.5-2,1.5-2.4,2-3,3-3.5,3-6,6-8.5,7-10,<,abaxial,abaxially,anther,apex,armed,bark,base,berry,bright,broadly,calyx,capitate,cell,cm,conical,corolla,cup-shaped,dense,densely,diameter,elliptic,elongate,entire,equal,filament,flattened,flower,glabrous,globose,greyish,growth,inflorescence,juicy,leaf,lengthening,less,lobe,lobed,margin,membranous,minutely,mm,narrowly,nearly,oblique,often,orbicular,ovary,pair,pale,pedicel,peduncle,petiole,pitted,pore,poricidal,primary,pubescence,pubescent,rarely,ray,rectangular,red,reniform,ripe,rounded,shallowly,shoot,short,shrub,simple,sinuate,size,slightly,slit,sparsely,stellate,stem,stigma,stout,style,surface,tapered,terminal,testal,thin,tip,trichome,truncate,tube,unarmed,vein,white,x,yellow	.25,0.15-0.3,0.5-0.6,0.8-1.2,2,2-3.5,2-4,3-4,4-merous,6,7,7-8,?,absent,adaxially,anthesi,appearing,arising,articulated,axi,basal,broad,broad-based,caly,closely,eaf,eed,ellipsoid,enlarged,erect,especially,exserted,extending,foliose,free,frui,fruiting,irregular,leafy,like,lon,long,longer,lower,markedly,midpoint,midrib,mixture,new,nflorescence,numerous,obvious,occasionally,older,papillo,per,perfect,pericarp,planar,plate,plurifoliat,portion,prickle,prickly,ruit,scar,sessile,short-stalked,shorter,smaller,sometimes,spaced,spreading,stalked,straight,strongly,tiny,ud,unit,upper,usually,woody,ympodial	adaxial,arrangement,branch,branching,color,drying,form,fruit,height,history,length,life,main,midvein,na,number,papillose,perennial,plant,seed,shape,tertiary,texture,venation,width,young
760	wfo-0001031721	success	208	100	80	128	20	0.385	%,0.2-0.5,0.3-1.1,0.4-2.2,0.8-1.3,1-1.5,1.1-3.2,1.2-1.7,11-30,2-4,2.5-3,2.7-3.5,3-10,3-4.5,3-7,4-7,5-20,5-7,6-15,8.5-12.5,acicular,anther,black,brown,calyx,chartaceous,cm,cylindrical,dark,deltate,densely,diameter,elliptic,flattened,fruit,glabrous,gland-tipped,globose,green,grey,hair,herbaceous,inflorescence,lamina,lanceolate,lavender,length,longer,mm,moderately,ovate,pale,pedicel,peduncle,petiole,plant,prickle,pseudo-racemose,purple,resprouter,short,simple,solitary,sparsely,stellate,stellate-pubescent,stem,stigma,straight,streak,style,time,tube,unbranched,white,wide,x,yellow,yellowish,yellowish-green	.1,0-0.1,0-1,0-3,0-5,0.1-0.2,0.1-0.5,0.25-0.4,0.25-0.5,0.4-0.6,0.4-0.7,0.4-1.6,0.6-1.1,0.6-1.2,0.7-1.2,0.7-1.3,1,1-20,1-3,1-3.5,1.5,2.2-3.2,3-foliate,4-5,4-locular,5-11,5-merou,6-9,7-10,7-8,7-9,8-15,8-20,abaxially,absen,absent,accrescent,across,adaxiall,adaxially,alyx,andromonoecious,anvil-shape,apart,apex,articulated,axe,ba,base,blade,capitat,confined,connivent,cross-section,cuneate,curved,d.,directed,distall,distributed,dult,eaf,eed,eglandular,entire,erect,exocarp,extra-axillary,filament,finger,flower,fruiting,functional,geminat,half,heterostylous,hig,juicy,lateral,leaf-opposed,less,lobe,long,lower,margin,mature,mesocarp,mid-point,midpoint,midrib,midvein,minute,minutely,moist,nflorescence,oblique,obtuse,orolla,part,per,placenta,pore,porrect,possibly,present,rachi,ray,reticulate,ruit,semi-circular,sessile,somewhat,spaced,stage,stalk,stalked,stellae,surface,tamen,thick,throughout,unarme,unarmed,unit,uvenile,vary,weakly,ympodial	abaxial,adaxial,arrangement,capitate,color,corolla,form,growth,height,history,leaf,life,ovary,perennial,pubescence,seed,shape,size,texture,width
761	wfo-0001031723	success	228	159	135	93	24	0.592	-1.5,-16,-5,-6,-6.5,-8,-merous,0.1-0.2,0.1-0.3,0.4,0.4-,0.4-1,0.55-0.9,0.6-1,1-,1-2,1-2.5,1-3,1.2-2,1.5-,10-30,15-45,2-,2-3.5,2-5.5,2.5-4.5,2.5-5,2/3-3/4,4-10,4-11,4-5,4-6,5-9,8-20,abaxial,abaxially,acute,adaxial,ame,anther,apex,apically,apparently,bark,base,berry,branched,branching,brown,c.,calyx,chartaceous,cm,connivent,cuneate,dark,deltate,densely,diameter,drying,dull,elongated,entire,erect,evenly,flattened-reniform,flower,fruit,glabrescent,glabrous,glandular,gray,green,hair,lateral,leaf,length,lobe,lobed,long,margin,marking,maturity,mauve,midpoint,minute,mm,moderately,multangulate,narrow-deltate,near,obtuse,orange-brown,ovate,pair,pale,pedicel,peduncle,petiole,poricidal,prickly,primary,ray,red,reflexed,rounded,secondary,sessile,shrub,simple,sometimes,sparsely,spherical,spreading,stalked,stellate-pubescent,stem,style,subentire,tapering,terminal,tertiary,tip,trichome,unarmed,vein,venation,way,weakly,white,whitish,wide,yellow,yellow-green,young	-1/2,-15,-2,0,0.05-0.2,0.1-0.5,0.15,0.2-1,0.4-0.9,0.7-1,0.8-1.5,1-5,1.5-10,1.5-2.5,1/3-1/2,1/4-1/3,1/6-,2-7,2/3,3-10,3-15,4-,4-20,5-40,acuminate,acut,alyx,apar,apart,articulated,ba,blade,brow,conical,curved,discolorous,eaf,eed,elongating,equal,eye,filament,filiform,finely,free,fruiting,gently,gland,gland-tipped,herbaceous,inflated,infructescence,longer,lower,mature,naked,nflorescence,older,one,open,orange,orolla,oung,per,perfec,pericarp,perpendicular,plurifoliat,porrect,portion,prickle,recurved,ruit,scar,smooth,spaced,stalk,stellate,straight,strongly,surface,tamen,terete,time,tube,unarme,unit,usually,variously,vary,visible,woody,ympodial	arrangement,branch,color,corolla,form,growth,height,history,inflorescence,life,main,midvein,na,number,ovary,perennial,perfect,plant,pubescence,seed,shape,size,stigma,texture
762	wfo-0001031729	success	161	123	100	61	23	0.621	-0.5,-2,-45,..,0.5,0.5-1,0.6-,1-1.5,1-2,1-2.5,1.5,1.5-2,11-30,2-3,2.5-,2.5-5,3-4,3.5-4,4.1-16,5-6,5-7,abruptly,acuminate,along,anther,apex,apiculate-deltate,attenuate,base,beneath,branched,calyx,cell,cm,conical,corolla,dark,darker,deltate,diameter,drying,elliptic,elongate,filament,flattened,fruit,glabrous,globose,green,greenish,less,lobe,lobed,long,markedly,middle,mm,mottling,nearly,obovate,occasionally,outer,outline,ovary,ovate-reniform,pair,pale,papillae,papillate,pedicel,peduncle,petiole,pink,point,purplish,quadrate,reddish,regularly,scattered,short,shrub,single,sinuate,small,smooth,somewhat,stem,stigma,striate,stripe,surface,tan,testa,time,trichome,tube,vein,wall,white,x	0.5-4,1.0-1.3,10-20,12-13,2-2.5,3-celled,5-,50,8-9,anthesi,apicula,branc,branch,brittle,brow,c.,cucullate,curve,dry,eaf,edicel,eed,erec,flattened-capitat,flower,fruiting,glandular,gradually,later,lower,membranous,minute,minutely,narrowly,never,nflorescence,noddin,open,papillose,per,pericarp,planar,plurifoliat,pointed,primary,ruit,scar,single-stemmed,thin,thing,tip,toward,triangular,tuft,ud,unit,usually,wand-like,widening,ympodial,young	arrangement,branching,color,flattened-capitate,form,growth,height,history,inflorescence,leaf,length,life,na,nodding,perennial,plant,plurifoliate,pubescence,seed,shape,size,texture,width
763	wfo-0001031738	success	231	135	115	116	20	0.498	-15,-5,0.1-0.25,0.7-1,0.7-1.1,1-1.5,1-1.8,1-4,1.4-1.7,1.5-4,1/2-2/3,1/3,1/6-1/4,10-15,15-40,2.3-3,3-4,3-7,3.5-3.8,3.5-4.5,4-6,4-8,6-15,7-12.5,8-10,8-18,abaxial,abaxially,adaxial,adaxially,anther,apically,apparently,auriculate,base,berry,blade,branched,calyx,chartaceous,cm,connivent,cordate,curved,dark,densely,diameter,dull,equal,erect,evenly,flattened-reniform,flower,frequently,fruit,glabrescent,glabrous,gray,green,lateral,leaf,length,lobed,long,margin,maturity,midpoint,mm,multangulate,narrow-deltate,orange,orange-brown,ovate,pair,pale,pedicel,peduncle,petiole,plant,poorly,poricidal,porrect,prickle,prickly,primary,ray,shorter,shrub,small,sometimes,spherical,stellate-pubescent,stem,straight,style,tapering,terminal,tertiary,tip,tree,trichome,truncate,unarmed,upper,vein,venation,visible,way,weakly,white,wide,yellow,yellow-green,yellowish,young	-6,-merous,.5,0,0-2,0-3,0.2-0.3,0.25-0.8,0.3-1,0.9-2.1,1-3,1.5-,1/,1/3-2/3,1/4-1/3,2-,2-4,20-200,3-6,4,4-10,4-5,5,5-8,7-12,acuminat,acute,almost,always,alyx,andromonoecious,apar,apart,apex,articulated,bark,cell,deltate,discolorous,distal,distance,drying,eaf,eed,elongating,extending,filament,flattened,free,fruiting,held,hermaphrodite,heterostylous,infructescence,inside,lobe,lobing,long-styled,longer,lower,lowermost,mature,midvein,nflorescence,oblong,obovate,often,older,one,open,orolla,oung,outline,per,pericarp,pit,plurifoliat,portion,prickl,prominent,pubescent,raised,reflexed,resin,rounded,ruit,scar,secondary,sessile,short-styled,side,simple,smooth,spaced,sparsely,spreading,stalk,stalked,staminat,stellate,sticky,stout,strongly,surface,tamen,terete,time,tube,unit,usually,variously,vary,white-brow,woody,yellow-orange,ympodial	acuminate,branching,color,corolla,form,growth,height,history,inflorescence,life,number,ovary,perennial,pubescence,seed,shape,size,staman,texture,width
764	wfo-0001031752	success	172	141	101	71	40	0.587	-10,-100,-47,-6,-pubescent,0.5-1,0.5-1.5,1-1.5,1-2,1-4,1.5-2,1.5-3,1.5-3.5,15-25,15-40,2-2.5,2-5,3-11.5,3-4,3-7,3.5-15,3.5-5,5-23,5-6,5-8,8-15,abaxially,acute,adaxially,apex,apiculate,base,calyx,chartaceous,ciliate,cm,connivent,cuneate,darker,deltate,densely,diameter,ellipsoidal,elliptic,entire,flattened,flower,fruit,fusiform,glabrate,glabrescent,glabrous,gland,glandular-puberulent,green,immature,lanceolate,light,lobe,margin,membranaceous,mm,moderately,narrowly,oblong,often,older,ovate,pedicel,peduncle,petiole,pink,puberulent,pubescent,purplish,ripe,rounded,rugose,shrub,simple,small,sparsely,stalked,stellate,stigma,stripe,style,subcordate,subcoriaceous,tip,tomentose,tree,triangular,truncate,tube,unbranched,white,wide,x,yellow,young	-3,-44,1,1-,1-3,1.5-10.5,1.5-2.5,2-3,20-35,3-4-foliat,9-16,acuminate,aggregate,apart,ape,articulated,axe,basal,beyond,blade,cell,ciliat,connective,cylindrical,directed,distally,eaf,eed,equal,exceeding,exserted,fleshy,glandular-puberulen,leaving,less,linear,lon,long,lower,near,nearly,nflorescence,nther,obtuse,olde,orolla,ovoid,pedicellar,perfect,pore,presen,present,purpl,rachi,radiu,remnant,ruit,slightly,spaced,stamen,stone,swelling,tal,tem,thecae,time,truncat,ud,unit,vary,ympodial	abaxial,adaxial,anther,arrangement,bark,branch,branching,color,corolla,drying,filament,form,growth,height,history,inflorescence,leaf,length,life,main,midvein,na,number,ovary,plant,primary,pubescence,ray,seed,shape,size,stem,surface,tertiary,texture,trichome,unarmed,vein,venation,width
765	wfo-0001031756	success	186	145	121	65	24	0.651	-1,-5,.5,.8,/2,0,0-2,0-5,0.1,0.4-1.6,0.5-1,0.5-1.3,0.6-1.2,0.7-1.7,0.8-1,1-1.8,1-3,1-4,1.5-2,1.5-3.5,1.8-2.5,1/3,2-6,3-5,3-7,4-5,9-14,abaxially,anther,apart,apex,apically,bark,base,berry,blade,branched,calyx,chartaceous,cm,color,concolorous,conical,connivent,cordate,curved,deltate,densely,diameter,drying,entire,erect,evenly,eye,finely,flattened-reniform,flower,fruit,glabrescent,glabrous,gray,green,known,leaf,lobe,lobed,long,margin,mature,mauve,midpoint,mm,moderately,naked,orange-brown,ovate,pair,pale,pedicel,peduncle,petiole,pitted,poricidal,porrect,prickle,prickly,primary,ray,red-brown,scandent,scar,shoot,short,shorter,shrub,simple,slender,spaced,spherical,stalked,stellate,stellate-pubescent,stem,straight,style,surface,tapering,terminal,tip,trichome,truncate,tube,unarmed,variously,vein,visible,way,white,wide,yellow-green,young	.1,0.02-0.2,0.15-0.25,0.2,0.6-1.6,00,1-2,1/2,10,3-15,4.5,5-merous,6-9,7-10,accrescent,acut,alyx,apar,apparently,articulated,broad-deltate,eaf,eed,elongating,enclosing,equal,filament,free,fruiting,fully,glabrou,herbaceous,inflated,infructescence,invested,longer,lower,nflorescence,older,one,open,orolla,oung,pendulous,per,perfec,pericarp,perpendicular,plurifoliat,portion,prickl,rounded,ruit,sessile,small,smooth,sparsely,spreading,stalk,tamen,terete,time,unit,vary,ympodial	abaxial,acute,adaxial,arrangement,branching,corolla,form,growth,height,history,inflorescence,length,life,midvein,number,ovary,perennial,plant,pubescence,seed,shape,size,texture,width
766	wfo-0001031761	success	207	141	119	88	22	0.575	-12,-6.5,.5,0-10,0-12,0-4,0-5,0.3-0.4,0.3-2.8,0.5-0.7,0.5-1.5,0.7-1.3,0.75-1.7,0.9-2,1-8,1.5-4.2,1.5-6,1.8-2.3,1/2,1/3,2-3.5,2-8,2.5-3.1,2.5-5.5,3-5,3.2-3.5,4-7,7-9,abaxially,anther,apparently,bark,base,berry,branched,calyx,cell,cm,concolorous,connivent,cordate,curved,deltate,densely,diameter,discolorous,drying,dull,erect,faint,filament,flattened-reniform,flower,fruit,glabrous,gray-green,lateral,leaf,length,lobe,lobed,long,lower,margin,maturity,mauve,midvein,mm,moderately,narrow-oblong,orange,orange-brown,outline,ovate,pair,pale,pedicel,peduncle,petiole,pit,poricidal,porrect,prickle,primary,purple,raised,ray,red,red-green,rounded,scandent,shrub,simple,slender,small,smooth,sometimes,sparsely,spherical,stalked,stellate,stellate-pubescent,stem,style,surface,tapering,thick-chartaceous,tip,trichome,tube,unarmed,upper,variously,vein,visible,weakly,wide,yellow,yellow-green	-20,-3/,-7,.4,0,0-0.4,0-15,0-25,0.2-0.4,0.3,0.5,0.6-1.2,0.7-1.6,1,1-3,1-4,1.5,1/2-2/3,1/3-2/3,1/4-1/3,2,2-4,3-15,4-6,5-merous,acicular,acut,acute,alyx,ame,apar,apart,apex,apically,articulated,blade,brow,c.,difoliate,distance,eaf,eed,elongating,equal,extending,flattened,free,fruiting,fully,geminat,infructescence,longer,mature,midpoint,nflorescence,older,one,open,opening,orolla,oung,per,perfec,pericarp,perpendicular,portion,prickly,recurved,scar,sessile,shallow,side,spaced,spreading,stalk,straight,tamen,terete,tertiary,time,uit,unarme,unit,vary,venation,way,woody,ympodial	-3/4,abaxial,adaxial,arrangement,branching,brown,color,corolla,form,growth,inflorescence,mentioned,number,ovary,pubescence,seed,shape,size,stigma,texture,width,young
767	wfo-0001031786	success	209	132	107	102	25	0.512	.5,/3,0.1-0.4,0.2-2.5,0.5-1.5,0.7-1.6,0.7-4,0.8-1.2,1-3,1-6,1.2-1.6,1.5-2.5,1/3-1/2,2-3,2-7,2-8,2.5-3.5,4-5,6-8,abaxially,anther,apparently,bark,base,berry,blade,branched,calyx,cell,chartaceous,cm,concolorous,cuneate,curved,dark,deep,densely,diameter,drying,elliptic,evenly,filiform,flattened-reniform,flower,fruit,glabrescent,glabrous,green,herb,lateral,leaf,length,lobed,long,margin,maturity,mauve,membranous,midpoint,midvein,minute,mm,orange,outline,ovate,pair,pale,pedicel,peduncle,petiole,pit,poricidal,porrect,prickle,prickly,primary,raised,ray,red,red-brown,sessile,shiny,shrub,simple,small,smooth,sparsely,spherical,stellate,stellate-pubescent,stem,stigma,style,surface,tapering,terete,tip,trichome,truncate,unarmed,vein,way,weakly,white,wide,yellow-orange,young	-5,.4,/2,0,0-2,0-20,0-3,0-5,0.1,0.2-0.3,0.25-0.5,0.7-1,0.8,1,1-2,1-4,1.5-1.9,2-13,3-4,3-5.5,5-7,5-merous,8-12,acut,acute,almost,alyx,ame,apar,apart,apex,apically,articulated,becoming,c.,clavat,connivent,deltate,distance,eaf,eed,elongating,equal,erect,extending,eye,filament,flattened,free,fruiting,gray,gray-brow,herbaceous,inconspicuous,infructescence,lobe,lon,longer,lower,mature,naked,nflorescence,obtuse,older,one,open,orange-brown,orolla,oung,pendulous,per,perfec,pericarp,plurifoliat,portion,prickl,reflexed,rounded,ruit,scandent,scar,shorter,side,slightly,sometimes,spaced,spreading,stalk,stalked,straight,tamen,tertiary,thick,time,tube,unit,variously,vary,venation,visible,woody,ympodial	0.1-1,abaxial,adaxial,arrangement,branching,clavate,color,corolla,form,gray-brown,growth,height,history,inflorescence,life,number,ovary,perennial,plant,pubescence,seed,shape,size,texture,width
768	wfo-0001031791	success	288	118	97	191	21	0.337	.3,.5,.9,0.4–0.6,0.5–1.0,0.7–1.0,1.5–1.9,1.5–3.0,1.9–2.2,13.0–30.0,15.0,2.0–11.0,2.0–2.5,2.8–3.3,3,3.0–3.5,6.0–14.0,6.2–8.5,7.0–9.0,8.0–11.0,anther,anthesi,apex,apical,apiculate,attenuate,backward,base,calyx,chartaceous,cm,connivent,corolla,diameter,dry,extra-axillary,flattened-reniform,flattened-suborbicular,flower,fruit,glabrous,glandular,globose,green,hair,inclined,inflorescence,internode,lanceolate,lateral,lavender,leaf,length,lobe,maturing,midvein,minute,mm,moderately,nearly,obscured,orange-red,oval,ovoid,pedicel,peduncle,petiole,pore,prickle,pubescent,rugose,shiny,shrub,simple,slender,slightly,small,sometimes,sparsely,stellate,stem,stigma,straight,style,subcoriaceous,surface,thrice-branched,totally,tree,tube,twice,unarmed,white,yellow,yellow-tan,young,×	.08,.2,.4,0.04,0.2,0.3–0.5,0.3–0.6,0.3–0.7,0.5,0.5–0.6,0.7,0.7–0.8,1.1–1.4,1.3–1.8,1.5,1.5–2.3,1.6,1.6–2.2,1.7–2.3,1.8,1/3,11–14,11–15,2.6–3.4,2/3,3.0,33–54,4.6–5.4,4.9,4.9–7.4,5-merou,6.0,7–10,7–8,8–12,9.0–16.0,abaxially,across,acute,adaxiall,adaxially,adnate,alveolate,alyx,apparently,appearing,appressed,area,around,articulated,attachment,axe,ba,berry,blade,branch,broad,broad-based,brochidodromous,bud,capitat,central,channeled,congested,cordate,curved,dehiscence,densely,dentate,developed,development,difoliate,distally,distinct,dorsally,drying,eaf,eed,either,emerging,endocarp,entir,entire,erect,especially,fertile,filament,filiform,first,flexed,fork,free,frui,geminat,glabrescent,gradually,homostylous,immature,increasing,interpetalar,intersepalar,juic,juvenile,lamina,large,largest,light,like,line,lon,long,longer,lower,m.,major,margin,material,mature,membranaceous,middle,midpoint,midrib,minor,multangulate,nflorescence,notched,numerous,oblique,often,one,orolla,oung,particularly,persisting,point,poorly,porrect,porrect-stellate,portion,potentially,preserved,project,raised,ray,rigid,ripe,rounded,row,ruit,scarcely,scattered,sessile,short,shorter,side,single,sinus,smaller,smooth,somewhat,splitting,stamen,stellae,stellate-pubescen,stipe,stipitate,suture,tamen,tardily,time,tip,tissue,translucent,triangular,truncate,two,ud,undulate,various,vary,vein,wavy,weakly,well,wide,yellow-brown,ympodia,±90°at,±equal,±glabrous,±laterally	abaxial,adaxial,arrangement,branching,capitate,color,dense,form,growth,height,history,life,na,ovary,perennial,plant,pubescence,seed,shape,size,texture
769	wfo-0001031793	success	188	119	98	90	21	0.521	-4,.5,0,1-1.5,1-2,1.5-4,10-15,13-20,15-20,2-3,2-5,26,3-8,40,8-11,abundant,acumen,aging,almost,anther,apex,armed,base,black,branched,broadly,brown,brownish,calyx,capitate,chartaceous,cm,cuneate,densely,diameter,elliptic,erect,extra-axillary,flattened,flower,forked,fruit,glandular,globose,hair,inflorescence,interpetalar,leaf,linear,lobe,long,margin,minutely,mm,mucilaginous,oblique,oblong-lanceolate,often,orange-yellow,orbicular-ovate,ovate,pedicel,peduncle,petiole,porocidal,prickle,pubescent,reddish,reduced,rounded,scattered,shallow,shrub,side,simple,size,small,sparsely,stellate,stellate-pubescent,stem,stigma,stout,style,thickened,tip,tissue,tree,triangular,trichome,tube,unbranched,upward,well-developed,white,x,yellow,yellow-brown	1,1-3,1-8,1.5-2,1/3,1/4,1/5,20,3-4,3/4,4,5-merous,7,absent,accrescent,acuminate,acute,adult,alyx,apparently,articulated,aspect,axe,ba,berry,bilobe,blade,branche,broad,central,cut,difoliate,distal,eaf,eed,elongatin,erec,evident,extreme,ferrugineous,filament,fruiting,geminat,general,homostylou,larger,lobing,lon,lower,main,many,maturing,midpoint,midrib,mostly,nflorescence,obtuse,older,orolla,per,perfect,pore,porrect,principal,rachi,reticulation,ruit,rusty,scarcely,sessile,similar,single,sinus,smaller,stellate-pubescen,stipitate,surface,tall,tamen,tem,testa,triangular-acuminat,unarmed,unit,usually,uvenile,vary,way,woody,ympodial	abaxial,adaxial,bilobed,branching,color,corolla,form,growth,height,history,juvenile,length,life,ovary,perennial,plant,pubescence,seed,shape,staman,texture
770	wfo-0001031795	success	234	145	118	116	27	0.504	0.5,0.5-2,1-1.2,1-1.3,1-4,1.5-2,1.5-4,10-12,2-2.5,2-6,2.5-3,2/3,3,3-4,4-5,4-6,50,6-8,9-17,<,abaxial,adaxial,anther,armed,bark,base,berry,branched,brownish,calyx,capitate,cm,conical,dark,densely,diameter,discolorous,elliptic,entire,evenly,filament,flattened,flower,glabrous,gland-tipped,glandular,globose,grayish,green,growth,lateral,leaf,leaf-opposed,live,lobe,lobed,long,long-stalked,margin,matte,membranous,midpoint,midvein,minutely,mm,oblique,occasionally,ovate,pair,pale,pedicel,peduncle,petiole,pitted,plant,poricidal,porrect,primary,pubescent,ray,reniform,ripe,sessile,shallowly,shape,shiny,short-,shrub,simple,size,slender,slightly,smooth,somewhat,sparsely,stellate,stellate-pubescent,stem,stigma,style,surface,tan,tapering,thin,time,tip,trichome,truncate,tube,unarmed,unicellular,vein,way,white,wide,yellowish,young,½	..,.2,.5,0.5-1,1,1-3,1/3,10,100,4-,5,5-12,5-40+,5-merous,5.5-,7-9,>,abaxially,absent,acuminate,acute,adaxiall,alf,almost,along,always,alyx,anthesi,apar,apex,around,articulated,blade,broad-based,broadly,c.,caudate,cell,clearly,connivent,curved,deeply,denser,differing,difoliate,directed,distally,dry,eaf,eed,equal,free,fruiting,geminat,geminate,glabrescent,gra,infructescence,irregularly,lamina,like,lon,longer,lower,major,many-branched,midrib,minor,mixture,much,multangulate,multiseriate,never,new,nflorescence,often,older,orolla,oung,outline,papillat,pendant,per,perfec,pericarp,persistent,pore,portion,prickle,prickly,reduced,reflexed,ruit,scar,scattered,short,short-stalked,sinuate,spaced,spreading,stalk,straigh,tamen,terete,testal,thicker,toward,triangular,unarme,unit,upward,usually,vary,visible,woody,ympodial	4-12,arrangement,branch,branching,color,corolla,drying,form,fruit,gray,height,history,inflorescence,length,life,main,na,number,ovary,papillate,perennial,pubescence,seed,tertiary,texture,venation,width
771	wfo-0001031829	success	138	79	59	79	20	0.428	.5,0.7-1,1-2,1.3-1.5,1.5-2,1.5-2.5,1.5-3.5,2-4,4-4.5,4-8.5,adaxial,anther,bark,base,branched,broadly,calyx,capitate,cm,conical,corolla,elliptic,globose,green,greenish-brown,growth,inflorescence,leaf,leathery,lobed,long,margin,minutely,mm,occasionally,ovary,papillose,pedicel,petiole,poricidal,pubescent,revolute,shrub,simple,size,somewhat,sparsely,stem,stigma,style,surface,thick,tip,trichome,uniseriate,waxy,white,x,young	.25,0.5-2.1,1,1.5-4.5,3-5-flowered,3/4,7-10,abaxially,absent,acute,adaxially,along,anthesi,ape,apex,apiculae,bae,berry,crystalline,deflexed,densely,denser,dia,differing,difoliate,drying,eaf,edicel,eed,epidermi,erect,exserted,filament,free,fruiting,geminat,glabrat,glabrous,immature,known,large-celled,lateral,like,lobe,lon,lower,main,major,minor,minute,nflorescence,often,older,opposite,overlappin,packed,pair,papillo,planar,pore,portion,quadrate,ruit,scar,shaped,soft,tall,tapering,tear-drop,tub,tube,tuft,ud,unit,vein,way,woody,yellowish,ympodial	0.5-1,3-5,abaxial,branching,color,diameter,flower,form,fruit,glabrate,height,history,length,life,na,perennial,plant,seed,shape,texture
772	wfo-0001031832	success	232	149	128	104	21	0.552	/50-1/10,0-150,0.1-0.3,0.2-1.5,0.7-1.5,0.7-1.6,0.8-1.2,1-12,1.2-1.6,1.2-2,1.2-2.5,14,2-3.6,2-6,3-6.5,3-7,4-20,4-7,5-21,8-25,9,adaxially,anther,anthesi,apart,apex,apical-lateral,attenuate,basal,base,becoming,blade,blister,blunt-tipped,branched,brown,brownish,bullate,calyx,chartaceous,cm,conical,continued,corolla,dehiscing,deltoid,diameter,due,entire,extend,ferrugineous,few-rayed,flower,fruit,glabrescent,glabrous,globose,granular-tomentose,greenish,growth,hair,half,honeycombed,introrse,lanceolate,large,lateral,leaf,length,long,long-,longitudinal,margin,mixed,mm,mostly,multangulate,oblanceolate,oblong,obovoid,orbicular,pale,partly,pedicel,peduncle,petiole,pitted,pore,porrect-stellate,probably,pubescence,pubescent,reniform,reticulate-punctate,ripe,rotate-stellate,rough,scabrous,sessile,short-,short-stalked,shrub,simple,slit,somewhat,soon,sparingly,stellate-pubescent,stem,stigma,style,suborbicular,surface,swelling,terete,terminal,thick-stalked,time,translucent,tree,tube,unarmed,violet,white,x,yellow,yellowish,young	-8,.5-1,0.2-0.6,0.3-0.8,0.3-3,0.7-2,1.1-2.4,1.3-4.2,1.5-4,1.7-4,1.8-4,1/2-3/4,2-4,2.5-6.5,2.8-4.8,3.5-7,5.5-10,7-10,abaxially,accrescent,acuminate,acute,ag,apice,apparently,articulated,axe,axillary,ba,bark,berry,branch,bud,capitat,closely,connate,dark,decurrent,directed,eaf,eed,evident,exserted,filament,fleshy,forming,free,fruiting,glabrescen,green,high,indument,inserted,lackin,line,lobe,lobed,longer,lower,m.,main,midvein,minute,nearly,nflorescence,obtuse,occasionally,older,orolla,ovate,perfect,persistent,plurifoliate,porrect-stellat,rachi,rather,ray,relatively,ruit,runk,side,smooth,sometimes,spaced,sparse,splitting,stamen,stipitate-glandular,subcampanulate,suture,tamen,testa,thick,toward,unarme,unit,usually,vary,vein,way,weakly,whitish,wide,ympodial	.3-3,abaxial,age,arrangement,branching,capitate,color,form,height,history,inflorescence,life,na,ovary,perennial,plant,seed,shape,size,texture,ye
773	wfo-0001031834	success	150	65	47	103	18	0.313	.5,0.5-1,0.5-3,0.5-3.5,0.6-1.4,0.8-1,0.8-1.3,1.5,1.6-2,1.9-6.5,6-7,6.5-14,anther,calyx,cm,corolla,deltoid,few-flowered,flattened-reniform,fruit,glabrous,globose,green,greenish-yellow,hooked,leaf,lobed,mm,ovary,ovate,pale,pedicel,petiole,pubescent,scabrous,shaped,shrub,simple,stem,style,tan,tear-drop,trichome,white,x,yellow,young	0.5,0.9-1.4,1,1.5-4,2.9-7,2/3,accrescent,across,acuminate,acute,anthesi,apar,apex,apically,apiculate,appear,attenuate,base,berry,bi-cellular,borne,campanulate,covered,deciduou,deciduous,decurrent,deflexed,depression,dia,difoliate,eaf,edicel,eed,expanded,eye,filament,free,fruiting,geminat,glabrou,hook,incrassate,lamina,larger,leaving,less,like,lobe,lon,long,lower,major,margin,markedly,middle,minor,minute,minutely,mound-like,multicellular,naked,nflorescence,often,opposite,papillo,papillose,persistent,pitted,planar,pore,poricidal,portion,proximal,ruit,scar,short,slender,slightly,small,soon,spaced,sparsely,speck,stigma,straight,surface,tall,tapering,tip,tube,tufted,ud,unevenly,uni-,uniseriate,unit,upper,usually,vein,way,widest,woody,ympodial	abaxial,adaxial,branching,color,diameter,form,growth,height,history,inflorescence,length,life,perennial,plant,seed,shape,size,texture
774	wfo-0001031839	success	138	122	71	67	51	0.514	.5,1-1.4,1.2-1.5,1/3-2/3,2.5-3.5,3-7,6-15,8-14-rayed,8-15,9-12,anther,apically,arcuate,armed,base,beneath,berry,blade,blue,blue-tinged,broadly,brown,calyx,cm,dark,deltoid,densely,developing,dry,foveolate,glabrous,green,herb,internodal,invested,lenticular,linear-lanceolate,lobe,long,main,maturity,minutely,mm,olivaceous,otherwise,ovary,ovate,pale,perennial,petiole,pinnatifid,pubescent,smooth,spherical,splitting,stellae,stellate-pentagonal,stellate-pubescent,stellate-tomentose,stem,stipitate,tawny,tightly,tube,twice,vein,velvety-tomentose,weakly,white,whitish,yellow	1,2/3,4-8,7-10,9-13-flowere,accrescent,across,along,alyx,annually,anthesi,becoming,bristly,broad,campanulate,cauline,confluent,da,dark-based,density,dia,difoliate,divided,eaf,eed,emerging,erect,extended,externall,fully,geminat,ligneous,lon,long-stalked,long-stipitate,nearly,nflorescence,often,orolla,persisting,prickle,prickly,purple,root,rounded,ruit,several,short,slende,somewhat,spreading,stella,stellate-tomento,subulate,tamen,throughout,tigma,tub,tyle,ultimate,unexpande,unit,usually,varying,year,ympodial,zygomorphic	0.5,8-14,9-13-flowered,abaxial,adaxial,arrangement,bark,branch,branching,color,corolla,diameter,drying,externally,filament,flower,form,fruit,growth,height,history,inflorescence,leaf,length,life,margin,midvein,na,number,pedicel,peduncle,plant,primary,pubescence,ray,seed,shape,size,slender,stellate,stigma,style,surface,tertiary,texture,trichome,unarmed,unexpanded,venation,width,young
775	wfo-0001031842	success	161	123	92	69	31	0.571	.4,.5,0.6-1,0.7-1,1,1-1.5,1-1.8,10-12,10-20,10-30-flowered,2-10,2-3,2.5-3,2.5-6,3-8,3/4,4.5-6,7-9,9-15,acute,anther,attenuate,bark,base,beneath,bi-lobed,brown,calyx,capitate,cm,corolla,cup-shaped,cusp,dark,deeply,dia,dry,elliptic,filament,flattened-reniform,glabrous,globose,green,lateral,leaf,leaf-opposed,lobe,lobed,long,main,margin,minutely,mm,opposite,ovary,pair,pale,papillose,pedicel,petiole,pitted,prominent,pubescent,quadrate,reddish-resinous,shaped,shiny,shrub,simple,size,somewhat,sparsely,specimen,stem,stigma,strongly,style,surface,tear-drop,terminal,tree,trichome,tube,tuft,uniseriate,vein,way,white,woody,x,yellowish,young	.1,.75,0.1-0.5,0.5-1,0.5-2,1-3.5,1.5-2,anthesi,apart,apex,axil,ba,bearing,beginning,berry,decurrent,deflexed,densely,differing,difoliate,eaf,edicel,eed,ellipsoid,exserte,exsertion,free,fruiting,geminat,incrassate,inflorescenc,irregularly,later,lon,lower,major,middle,minor,near,new,nflorescence,often,older,one,onto,overtopping,paler,papillo,pore,poricidal,portion,reddish,reflexed,ruit,scar,shoot,slender,soon,spaced,straight,tall,tapering,time,tip,ud,unit,widest,yellowish-whit,ympodial	abaxial,adaxial,arrangement,branch,branching,color,diameter,flower,form,fruit,growth,height,history,inflorescence,length,life,midvein,na,number,peduncle,plant,primary,pubescence,seed,shape,tertiary,texture,unarmed,venation,width,yellowish-white
776	wfo-0001031843	success	245	139	126	119	13	0.514	.5,0.6-1.2,0.7-2,1-2,1-7,1.2-2,1.2-2.2,1.5,1.8-2.5,1/6-1/4,2-3,2.5,3-4,3-7,4-12,5-10,5-12,6-9,abaxially,adaxially,almost,along,anther,anthesi,apex,apically,appressed,attenuate,bark,basal,base,berry,black,branch,branched,branching,brown,calyx,canaliculate,capitate,cm,completely,conical,corolla,cupular,curved,dark,diameter,dilated,discoid,distributed,drying,dull,equal,erect,evenly,fine,finely,flat,flower,glabrous,green,leaf,length,liana,like,lobed,long,longitudinally,lower,main,margin,midvein,mm,network,oblique,oblong,obovate,orange,orange-brown,orange-yellow,pair,part,partly,pedicel,peduncle,petiole,poricidal,primary,pubescent,raised,rarely,red,reddish,ridged,seed,shallowly,shiny,shortly,shrub,side,slender,slightly,smooth,sometimes,sparsely,spheroidal,stem,stigma,straight,style,surface,terminal,tertiary,thick-chartaceous,tip,trichome,tube,twice,unarmed,vein,venation,violet,visible,x,young	.2,.3,.6,0-4,0.2-2,0.4-0.5,0.5-1,0.5-1.5,0.7-1.2,0.8-2,1.5-2,1mm,2-4,45-60°,accrescent,acuminate,age,always,alyx,apar,apice,apparently,around,articulated,becoming,broadly,caudate,clearly,collapsing,cuspidate,deeply,delineated,deltoid,dendritic,density,detaching,discolorous,domatia,eaf,eed,ellipsoi,entire,even,eye,fertilisation,filament,flexuous,forming,free,fruiting,hand,honeycomb,inner,largely,leave,len,lengthening,lignified,lobe,loop,looping,m.,much,multiseriate,naked,never,nflorescence,nther,obscure,older,opening,orolla,outline,ovate,papillo,pattern,pendulous,perfec,pericarp,pit,pitted,plurifoliat,pore,portion,present,prominent,pronounced,protruding,rachi,recurve,reveal,ribbed,rounded,ruit,scar,see,simple,sinus,small,smaller,soon,spreading,strongly,stump,surfac,tearing,thickened,thin,tuft,ud,unit,variable,vary,weakly,white,wide,wider,without,ympodial	arrangement,color,form,fruit,growth,inflorescence,number,ovary,papillose,pubescence,shape,size,texture
777	wfo-0001031852	success	155	114	74	81	40	0.477	-8,0.1-1,1-4,1-4.2,1-9,1.3-2.5,1.4-3,1.5-3,12-35,2-3,2.6-9.5,3-9,4-5,4-6,5-15,7-,9-11,acumen,apical,apiculate,base,branched,calyx,cm,conical,corolla,cyme,dehiscent,diameter,dichasial,dichasially,ebracteate,elliptic,elliptic-lanceolate,filament,flower,forked,green,green-white,herbaceous,introrse,lanceolate,leaf,light,lobe,long,maturing,mm,monochasial,mucilaginous,oblique,oblong,odd-pinnate,often,ovate-elliptic,ovoid,pedicel,peduncle,perennial,petiole,plant,poricidally,pubescent,seed,short,size,slit,stellate,stigma,style,throughout,white,wide,yellow	0.5-1.3,0.5-3,1-,2-5.5,3-4,3-6-foliat,3.5-10,4-,4-10,abaxially,abruptly,absen,acuminate,acute,adaxially,apex,apically,articulate,attenuate,cell,connate,covering,decurrent,digestion,diminishing,distal,dorsally,eaf,edge,eed,emoval,enzyme,exceeding,flat,folded,generally,globo,hair-like,half,honeycomb,interjected,lateral,leaflet,living,lon,lower,lunat,make,nflorescence,nther,orolla,pair,pattern,perfect,plan,proximal,rachi,reveal,ruit,sessile,seudostipule,shortly,specimen,stamen,straight,tal,tem,terminal,testal,thick,throughou,toward,tuber-bearing,typically,unit,vary,wall,white-crea,without,ympodial,¼	abaxial,adaxial,anther,arrangement,bark,branch,branching,color,drying,form,fruit,globose,growth,height,history,inflorescence,length,life,main,margin,midvein,na,number,ovary,primary,pubescence,ray,shape,stem,surface,tertiary,texture,trichome,tube,vein,venation,wet,white-cream,width,young
778	wfo-0001031864	success	140	114	79	61	35	0.564	.25,.5,0.2-0.5,0.5-13.5,0.7-0.8,0.8-1,1-1.8,1-2,1-5,1-6.5,1.2-1.5,1.5-2.5,15-60,2-3,2.5-6,3-3.5,3-pinnate,abaxially,acute,adaxially,anther,apex,base,calyx,chartaceous,ciliate,cm,color,cuneate,deltoid,dense,diameter,entire,filament,fine,flattened,fleshy,flower,fruit,glabrous,hair,herbaceous,lenticular,lobe,long,margin,middle,mm,moderately,near,oblique,ovoid-deltoid,papillose,pedicel,peduncle,petiole,pointed,pubescence,pubescent,rotate,rounded,sand-punctate,short,slender,slightly,sparsely,stem,stigma,style,surface,tip,trichome,tube,unbranched,unknown,vein,vine,violet,x	.2,0.4-3,0.5-4,0.6-3.5,0.6-4,1-1.2,1-3,1.5,1.5-10,2,5-15,5-9,5-merous,7.5-8,accrescent,acuminate,alyx,apar,apical,apiculate,axe,berry,blade,c.,capitat,clavate,densely,eaf,eed,emarginate,extra-axillary,fruiting,glabrou,lateral,leaflet,like,lon,lower,m.,minutely,nflorescence,nternode,orolla,perfec,petiolule,plurifoliat,pubescenc,rachi,ruit,scattered,spaced,tamen,tem,terrestria,truncate,typical,unit,vary,wide-diameter,widely,ympodial	abaxial,adaxial,arrangement,bark,branch,branching,capitate,corolla,drying,form,growth,height,history,inflorescence,leaf,length,life,main,midvein,na,number,ovary,plant,primary,ray,seed,shape,size,terrestrial,tertiary,texture,unarmed,venation,width,young
779	wfo-0001031864	success	148	114	76	72	38	0.514	.2,.25,.5,0.5-13.5,1-1.2,1-1.8,1-2,1-3,1-5,1-6.5,1.2-1.5,1.5-2.5,15-60,2-3,2.5-6,3-3.5,3-5-celled,3-pinnate,abaxially,acute,adaxially,anther,basally,base,blue-purple,calyx,center,ciliate,cm,color,cordate,cuneate,deltoid,dense,diameter,entire,extra-axillary,filament,fine,fleshy,flower,fruit,glabrous,hair,herb,lenticular,lobe,long,margin,mm,oblique,oblong,papillose,pedicel,peduncle,pubescence,pubescent,rotate,rounded,short,simple,slender,somewhat,sparsely,stigma,style,surface,terrestrial,tip,trailing,tube,unbranched,unknown,woody,x,yellow	0.4-3,0.5-4,0.6-3.5,0.6-4,1.5,2,5-15,5-9,5-merou,7.5-8,absent,accrescent,acuminate,ag,alyx,apart,apex,apical,apiculate,apparently,articulated,axe,ba,blade,capitat,clavate,connivent,densely,directed,distally,eaf,eed,emarginate,equal,etiole,fruiting,geminat,interjected,large,lateral,leaflet,longitudinal,lower,m.,minutely,near,nflorescence,node,opening,orolla,perfect,petiolule,plurifoliate,pore,pubescenc,rachi,rooting,scattered,slightly,slit,spaced,tamen,tem,thick,truncate,uniseriate,unit,vary,weakly,widely,wiry,ympodial	abaxial,adaxial,arrangement,bark,branch,branching,capitate,corolla,drying,form,growth,height,history,inflorescence,leaf,length,life,main,midvein,na,number,ovary,petiole,plant,primary,ray,seed,shape,size,stem,tertiary,texture,trichome,unarmed,vein,venation,width,young
780	wfo-0001031871	success	185	111	90	95	21	0.486	0.4-2,0.6-1.2,1.5-11,1.5-2,1.5-2.1,2-4,3-10,3.5-4,33-40,4-6,5.4-12.3,6-12,6-7,6.5-20.5,7-9,7.5-23,abaxially,adaxially,anther,articulated,brownish,cell,chartaceous,clavate,cm,condition,corolla,covering,dark,deep,diameter,distal,dot,drying,elliptic,forked,fresh,fruit,glabrous,globose,green,green-white,greenish,hair,hair-like,half,herb,high,lanceolate,lateral,long,make,medium,mm,mottled,mucilaginous,narrowly,odd-pinnate,ovate,ovoid,pedicel,peduncle,petiole,plant,poricidal,pubescent,purple,ripe,rotate,seed,short,size,stigma,style,subglabrous,testal,thick,throughout,tiny,tip,tube,usually,wall,wet,white,whitish,wide,winged,x,yellow	1-2,1.4-2.1,1.6-2.7,14-22,2-3,2.9-6,3-4,3-5,36-44,4-7,5-merou,acumen,acute,adaxiall,ag,alyx,apart,apex,apparently,asymmetric,attenuate,axe,axillary,base,basiscopic,berry,blade,bud,capitat,connivent,digestion,dorsally,eaf,edge,eed,end,enzyme,erec,exceeding,filament,flat,flower,folded,geminat,generally,glabrou,hal,homostylous,honeycomb-shaped,interjected,leaflet,lengthening,linear,living,lobe,lower,nflorescence,one,orbicular,orolla,pair,perfect,petiolulate,placed,plurifoliate,pore,removed,round,rounded,ruit,sessile,seudostipule,side,slit,sometimes,spaced,specimen,stamen,stolo,straight,subequal,subglabrou,subtending,symmetric,tall,tamen,tem,terminal,tissue,tri-,tuber,typically,unit,vary,ympodial	arrangement,branching,calyx,capitate,color,form,growth,height,history,inflorescence,leaf,length,life,na,ovary,perennial,pseudostipule,shape,stem,surface,texture
781	wfo-0001031874	success	197	120	87	110	33	0.442	-1.2,0.2,0.5-1,0.5-1.5,1.2,1.2-1.8,1/10,1/3,1/5,2-5,3-8,3-lobed,abaxially,adaxially,anther,base,bifurcation,bilobed,blade,blue,broad,broadly,calyx,chartaceous,cm,completely,connivent,cylindrical,dehiscent,diameter,downward,elliptic,especially,extra-axillary,flattened-reniform,flower,fruit,fully,glabrous,globose,green,herb,hold,length,light,lobed,long-attenuate,margin,mesocarp,midrib,minutely,mm,near,nearly,oblong,often,orange,ovate,partially,pedicel,peduncle,petiole,pitted,pore,puberulent,pubescent,rarely,recurved,red,ripe,rotate-stellate,slightly,somewhat,sparsely,stem,stigma,style,surface,tip,tube,violet,way,white,white-puberulent,x,yellow,young	-1.5,-3.5,-4,-7,.5-1.2,0.2–0.8,0.4,0.5–0.9,0.6-1,1-4,1.3–1.4,1.4–1.5,1.5-,1.8,1.8–2.3,2,2-3,2-3.5,2-4,2-foliate,2–2.5,2–9-branched,3.5–11,3–5,4.5-6,5,5-merou,6–7,7–8,9–11,accrescent,acute,adaxiall,always,alyx,angulate,apart,apex,articulated,asymmetrically,axe,ba,barely,berr,bi-lobed,branch,capitat,ciliate,contact,covering,decumbent,eaf,eed,erect,even,filament,fruiting,geminat,generally,hair,hermaphroditic,juic,lanceolate,lateral,least,level,line,lobe,long,longitudinall,lower,lowermost,main,nflorescence,node,numerous,obtuse,one,orolla,ovate-triangular,passing,petiol,prostrate,rachi,rooting,ruit,several,short,side,simple,soil,sometimes,spaced,spreading,swollen,tall,tamen,tem,terete,terminal,time,triangular,unit,usually,vary,vein,well,wide,winged,ympodial	0.5-0.9,1.3-1.4,1.4-1.5,1.5-4,1.8-2.3,2-2.5,2-9-branched,3-5,3.5-11,6-7,7-8,9-11,branching,capitate,color,corolla,form,growth,height,history,inflorescence,juicy,leaf,life,longitudinally,na,ovary,perennial,plant,seed,shape,size,texture
782	wfo-0001031876	success	140	66	47	93	19	0.336	.1,.5,0-flowered,0.8-1,1,1-1.5,1-1.6,1.5-2.2,27-35,9-15,anther,bark,base,beneath,bright,calyx,cm,corolla,elliptic,flower,glabrous,globose,green,leaf,lightly,lobed,mm,nearly,oblanceolate,oblique,ovary,pedicel,petiole,prominent,raised,shaped,shrub,simple,stem,style,tear-drop,tube,venation,winged,x,yellow,young	0.5,1-4,3,5,?,across,acute,anthesi,apex,apiculate,arc,arising,ba,bearing,berry,closely,convergence,corky,cup-like,decurrent,dia,differing,eaf,edicel,eed,erect,family,filament,free,fruiting,glabrou,granular,greenish-yellow,immature,irregularity,known,lateral,lenticellat,less,lobe,long,long-acuminate,lower,main,major,margin,melastomataceae,member,middle,minute,minutely,nflorescence,often,opposite,otherwise,overlappin,pair,papillose,parallel,perpendicular,persistent,point,pore,poricidal,portion,present,primary,recurved,reflexed,resemble,ruit,running,scar,secondary,slender,slightly,spaced,stigma,straight,styl,tall,tapering,time,tip,ud,unifoliat,unit,vein,white,wide,widest,woody,ympodial	arrangement,color,diam,diameter,form,fruit,growth,height,history,inflorescence,length,life,perennial,plant,shape,size,texture,unifoliate,width
783	wfo-0001031877	success	216	149	127	89	22	0.588	+,.5,0.3-,0.3-1,0.3-1.2,0.5,0.6-1.2,1,1-1.5,1-3,1-3.5,1.1-,1.5,1.5-1.9,1.8-5,2,2.5,3-5,3.5-4,6-8,abaxially,abruptly,acuminate,acute,adaxially,along,anther,apex,basal,basally,base,bright,brown,calyx,capitate,cell,clavate,cm,conical,connivent,corolla,deltate,densely,diameter,distal,ellipsoid,ellipsoidal,entire,especially,exposed,flattened,fruit,furcate,glabrous,globose,greenish,growth,hastate,lateral,lengthening,line,lobe,lobed,long,loosely,margin,mature,minutely,mm,nearly,occasionally,outline,pair,pale,papillate,pedicel,peduncle,petiole,pitted,plant,plump,pore,poricidal,primary,prominently,pubescence,pubescent,purple,red,reddish,reniform,ripe,rounded,scrambler,seed,semi-woody,shiny,silky,simple,slender,slightly,slit,sometimes,somewhat,sparsely,stellate,stem,stigma,style,surface,terminal,testal,thin,tinged,tip,triangular,trichome,truncate,tube,uniseriate,usually,vein,vine,wall,weak,white,x	.3,0.2,0.5-1,0.8-0.9,1-4,1.5-2,2-,3-6,5-merou,6-10,adaxiall,ag,alyx,angled,anthesi,apar,apparently,ark,articulated,ascending,berry,deep,deflexed,dried,eaf,eed,enlarged,erect,exserted,eye,filament,fleshy,flower,free,fruiting,green,ilament,impressed,internal,irregularly,lamina,later,like,linear,long-acuminate,lower,material,midvein,minute,new,nflorescence,often,older,orolla,papillo,parallel,part,per,perfect,pericarp,plurifoliat,pointing,portion,purplish,rectangular,reflexed,rest,ruit,scar,short,shorte,sinuate,sleeve,spaced,spreadin,strongly,subshru,tem,twinin,ud,uniformly,unit,upper,vary,visible,woody,yello,ympodial,young	abaxial,adaxial,age,arrangement,bark,branching,color,form,height,history,inflorescence,leaf,length,life,na,number,ovary,papillose,shape,size,texture,yellow
784	wfo-0001031880	success	180	103	90	90	13	0.5	.5,0.7-0.8,1,1-1.3,1-1.5,1.5,2-3,2-9,2.5-8,3-3.5,3-4-pluri-foliate,3-foliate,3-lobed,4,4-8,7-9,anther,base,berry,broadly,brown,calyx,capitate,ciliate,cm,color,conical,cordate,corolla,cup-shaped,curved,dark,densely,diameter,entire,filament,flattened,fleshy,fruit,glabrous,glandular,globose,green,herb,heteromorphic,hollow,inflorescence,leaf,less,long,lower,margin,minutely,mm,orange,ovary,ovoid,pale,papillose,pedicel,petiole,pitted,poricidal,pubescent,purple,red,reddish,reflexed,shallowly,simple,slightly,sparsely,stem,stigma,strongly,style,subshrub,surface,thin,tip,toothed,triangular,trichome,truncate,tube,upper,upward,x,yellow,–5	0.5-1,0.5-2,1-2,2,2-4,5,5-6,6-9,abaxially,acuminate,acute,adaxially,age,anthesi,apart,apex,basal,bearing,becoming,c.,cell,crenate,crowded,eaf,edicel,eed,ellipsoid,elliptic,enlarged,erect,exerted,flower,flush,free,fruiting,gland,gland-tipped,growing,horn,internodal,irregularly,lamina,lengthening,lobe,lon,longest,markedly,mature,maturit,mid-length,middle,narrowly,near,nflorescence,nodding,ovate,pair,papillo,peduncle,pericarp,plan,pore,portion,primary,pubescen,rachi,ruit,scar,shortest,single,slender,slit,sometimes,spaced,sparse,spreading,straight,terminal,testal,ud,unicellula,uniseriate,unit,unlobed,vein,wall,widely,widest,woody,ympodial	arrangement,branching,density,form,growth,height,length,plant,seed,shape,size,texture,unicellular
785	wfo-0001031881	success	168	95	80	88	15	0.476	.5,0.5-1,1-1.3,1-1.5,1-7,1.2-6,1.5-2.5,1/3,10-30,2,3.5-4,3/4,5-6,7-14,anther,bark,base,beneath,branch,branched,broadly,brown,calyx,campanulate,capitate,cm,corolla,dark,decurrent,densely,dia,distal,dry,elliptic,erect,fruit,glabrous,globose,golden-pubescent,green,inflorescence,leaf,lightly,like,lobed,long,material,minutely,mm,obovate,opposite,ovary,ovoid-reniform,papillose,pedicel,petiole,puberulent,pubescent,rest,shape,shaped,shrub,simple,size,small,soon,sparsely,stem,stigma,style,tear-drop,tree,trichome,uniseriate,usually,way,white,winged,x,young	0.1-0.5,0.2,0.2-0.6,0.4-1,0.5-0.7,10-12,2-9,3-19,absent,acute,along,anthesi,apar,apex,apparent,attenuate,axil,ba,bud,constriction,deflexed,deltoid,differing,difoliate,drying,eaf,edicel,eed,either,ellipsoid,evenly,exserted,filament,fleshy,free,fruiting,geminat,golden,golden-puberulent,greyish-brow,incrassate,inflorescenc,junction,lateral,lobe,lon,lower,main,major,margin,maturity,middle,midrib,minor,minute,nflorescence,occasionally,older,one,orbicular,pair,papillo,pitted,planar,pore,poricidal,portion,puberulen,rounded,ruit,scar,slender,slightly,somewhat,spaced,straight,strong,surface,tall,tapering,tip,tube,ud,unit,vein,widest,woody,ympodial	branching,color,diameter,form,greyish-brown,growth,height,history,length,life,perennial,plant,pubescence,seed,texture
786	wfo-0001031886	success	169	120	97	72	23	0.574	-25,-4,-9,.5,1-1.5,1-4,1.2-2.5,10-40,2,2-2.5,2-3,2-4,2-5,2.0-2.5,3-6,3.0,4,4-15,5-10,5-6,5-ridged,9-10,acuminate,anther,anticlinal,apex,arising,attenuate,axil,base,bright,brown,calyx,capitate,cm,commonly,completely,conical,corolla,diameter,dry,elliptic,fleshy,flower,fruit,glabrous,green,greenish,half,irregular,lanceolate,leaflet,long,lower,margin,minutely,mm,near,node,occasionally,open-conical,ovary,ovoid-reniform,pair,papillae,papillose,pedicel,petiole,pinnate,poricidal,portion,projection,raised,reddish,rugose,scattered,seed,shape,shrub,simple,single,sinuous,somewhat,sparse,specimen,stigma,strongly,style,surface,thickening,tip,trichome,tube,uniseriate,white,without,x	-1.2,0,0.1,0.5-1,1.5-2,20-30,6-20,6-8,abaxially,abruptly,absent,adaxially,along,anthesi,axillary,basal,beak,bearing,berry,broadly,bud,cell,clavat,deltate,distinctly,eaf,earl,edicel,eed,either,em,epidermal,equal,erec,exserted,filament,free,fruiting,lateral,le,lobe,lobed,narrowed,nearly,nflorescence,noddin,oblique,papillate,per,petiolule,primary,purple,rachi,reflexed,ripe,ruit,scar,similar,smaller,smelling,terminal,time,triangular,tub,ud,unifoliat,unit,usually,vein,wintergreen,woody,ympodial	1,1-1.2,arrangement,branching,clavate,color,form,growth,height,history,inflorescence,leaf,length,life,na,number,peduncle,perennial,plant,pubescence,size,stem,texture
787	wfo-0001031895	success	160	94	77	83	17	0.481	-1.5,1-1.5,1.5-3,1.5-6,2-2.5,2.5-3,3-4,3-8,3.5-6,4,4-5,4.5-16.5,5,6-7,anther,attenuate,bark,base,beneath,berry,bluish,calyx,capitate,cm,conical,corolla,dark,densely,diameter,drying,elliptic,entire,exfoliating,fleshy,glabrous,globose,green,growth,lobed,margin,matte,minutely,mm,occasionally,once-branched,ovary,ovoid,pale,papillate,pedicel,peduncle,peeling,petiole,pitted,poricidal,reniform,revolute,shiny,shrub,simple,slightly,small,stem,stigma,stout,style,surface,tan,thin,tip,tree,tube,violet,way,white,x,¼-1/2	0.5,0.5-1,0.5-2,1.5-2,3-10,5-6,5-8,6-9,acute,age,anthesi,apex,apparently,articulating,blac,broadly,campanulate,cell,completely,cup-shaped,deltate,eaf,eed,ellipsoid,emarginated,enlarging,erec,erect,exerted,expand,filament,flower,fragrant,free,fruiting,glabrou,immature,inflorescenc,intensely,irregular,leaf-opposed,leafy,leaving,lengthening,less,lobe,lower,new,nflorescence,older,overlapping,pair,papillat,part,patch,peg,perfect,pericarp,planar,plurifoliat,pore,portion,primary,reddish,ruit,scar,shoot,short,sinuate,slender,slit,somewhat,straight,strongly,terminal,testal,thick,tub,ud,unit,vein,woody,ympodial	branching,color,form,fruit,height,history,inflorescence,leaf,length,life,na,perennial,plant,seed,shape,size,texture
788	wfo-0001031896	success	196	139	115	81	24	0.587	0.1-0.6,0.4-0.8,0.5-1,0.5-2,1-1.5,1-10,1-3,10-20,13,15-20,2,2-2.5,2-3,2-4.5,2-5,2-7,3-30+,3-5,5,5-15,6-30+,6-9,7-10,abaxially,acute,adaxially,anther,apart,apex,armed,base,branched,broad-based,brown,calyx,chartaceous,cm,coarsely,connivent,contiguous,curved,cylindrical,densely,diameter,directed,elliptic,entire,erect,extra-axillary,ferruginous,ferruginous-pubescent,flattened,flower,forked,fruit,glabrous,glandular-puberulent,globose,green,hair,lateral,less,lobe,long,long-stalked,margin,midpoint,midvein,minutely,mm,moderately,nearly,oblique,orange,pedicel,peduncle,perfect,petiole,pinnatifid,pitted,pore,prickle,pubescence,pubescent,rachi,ray,recurved,rounded,shape,shrub,simple,size,slightly,small,sometimes,spaced,sparsely,stellate,stellate-pubescent,stem,stigma,straight,style,subcordate,surface,tapered,toothed,tree,truncate,tube,unbranched,white,whitish,x,yellow	-1.5,0-1.2,0.3-0.5,0.3-0.7,0.3-0.8,0.3-1,1-1.2,1-2,1.5,10-20+,4-7,5-10,5-6,5-9,6-10,9-18,accrescent,adaxiall,ample,apparently,articulated,axe,ba,blade,capitat,conspicuously,covering,denser,difoliate,distall,eaf,eed,eglandular,equal,filament,frequently,frui,fruiting,geminate,gland-tipped,glandular,held,interpetalar,lanceolate,like,lon,long-acuminate,longer,lower,midrib,mixed,mostly,multangulate,nflorescence,occasional,occasionally,often,orolla,porrect,ruit,sessile,short,shorter,stalk,stalked,ste,stellae,tal,tamen,tem,time,tip,tissue,unarmed,uniform,unit,uprigh,vary,vein,wide,ympodial	abaxial,adaxial,armament,arrangement,branching,capitate,colour,corolla,direction,distally,form,growth,height,history,inflorescence,leaf,length,life,ovary,perennial,plant,seed,spacing,texture
789	wfo-0001031897	success	264	128	116	148	12	0.439	.1,.5,.8,0.1-0.5,0.15,0.5-3,0.6,1.1,1.3-2,1.5-8,1.7-3,13,2-4,5-6,6-9,abaxial,abaxially,absent,adaxial,adaxially,almost,along,anther,apex,bark,base,bendy,berry,black,brachyblast,branch,branched,brown,calyx,chartaceous,clavate,clustered,cm,concolorous,conical,coriaceous,corolla,curved,dark,densely,diameter,distributed,dorsal,drying,dull,elliptic,epiphyte,erect,evenly,except,filiform,fruit,glabrous,green,grey,hair,lanceolate,lateral,leaf,least,light,lobed,long,longitudinal,longitudinally,main,mauve,midvein,minute,mm,multicellular,obconical,oblong,one,orange-brown,ovoid,papillose,pedicel,peduncle,petiole,pore,pubescent,raised,reddish,ribbed,ridge,ridged,short,shrub,side,simple,slender,slightly,smooth,sometimes,sparse,sparsely,stem,stigma,style,sunk,surface,terminal,thick,trichome,unarmed,weakly,white,winged,x,young	0-1,0.2-0.4,0.4-1.1,0.5-1,0.8-1.5,0°,1,1-1.5,1-2,1-2.5,1.5,2/3,4-5,462.,8,accrescent,acute,age,alyx,anthesi,apar,apically,apparently,appearing,appendage,arising,aristate,articulated,attenuate,axillary,boiteau,cell,clearly,condensed,connate,covering,cuneate,datum,dehiscing,delineated,dendritic,dense,developed,developing,development,dilated,divided,domatia,dorsifixed,dry,eaf,earliest,ed,enlarged,entire,equal,even,extending,eye,faint,filament,fine,flower,foliaceous,free,fruiting,immature,indistinc,inner,inside,known,lamina,larger,lengthening,like,linear,lobe,looped,lower,m.,margi,margin,membranous,minutely,multiseriate,naked,never,nflorescence,nther,oblon,obtuse,occasional,occasionally,orange,orolla,outside,ovate,overlapping,pair,part,partly,pendulous,perfec,pericarp,persisting,plant,plurifoliat,pointed,poricidal,portion,primary,prominent,pronounced,protruding,rarely,reach,revolute,ruit,scar,secondary,see,seen,shoot,sinus,smaller,smoot,stump,subulate,tearing,terete,tertiary,thin,tip,toward,tube,ud,unbranched,unicellular,unit,usually,vary,vein,venation,visible,well-developed,wide,wrinkle,ympodial	arrangement,branching,color,form,growth,inflorescence,length,ovary,pubescence,shape,size,texture
790	wfo-0001031908	success	213	155	121	92	34	0.568	0-22,0-25,0-9,0.4-1.4,1-10,1-2,1-4,10-35,2-6,3-8,5-11,5-13,5-19,8-22,9-13,abaxially,acute,adaxially,along,anther,attenuate,axillary,band,base,blue,broadly,brownish,bud,cell,chartaceous,ciliate,cm,color,condition,connivent,cordate,corolla,covering,cuneate,dark,densely,diameter,distal,drying,elliptic,elliptic-lanceolate,especially,filament,flower,forked,fresh,fruit,generally,glabrous,globose,green,green-white,greenish,hair,hair-like,half,herb,lanceolate,lateral,leaf,like,lilac,lobe,long,make,margin,medium,membranous,midrib,minutely,mm,mucilaginous,nearly,oblique,odd-pinnate,ovate,ovoid,papillose,pedicel,peduncle,petiole,pink,plant,puberulent,pubescent,purple,rarely,red-purple,ripe,rotate,rotate-pentagonal,rounded,seed,short,size,spot,stem,stigma,style,subtending,surface,terminal,testal,thick,throughout,tinged,tip,truncate,tube,usually,wall,wet,white,whitish,x,yellow	0-45,1-5.5,1-8,1.5-5.5,3-5,3.5-9,4-25,5,5-merou,7,absent-10,acumen,acuminate,ag,almost,alyx,apart,apex,apparently,approximately,articulated,ascending,auriculate,axe,berry,blade,capitat,decreasing,decumbent,digestion,dorsally,dull,eaf,edge,eed,enzyme,erect,exceeding,falcate,flat,folded,geminat,glabrou,homostylous,honeycomb-shaped,interjected,leaflet,lengthening,living,lower,middle,mottle,nflorescence,often,orolla,pair,perfect,petiolulate,plurifoliate,pore,poricidal,prominent,prostrat,removed,ruit,secondary,semi-elliptic,semi-erect,sessile,seudostipule,shiny,shortly,slightly,slit,spaced,specimen,stamen,star,ste,stippled,straight,tall,tamen,tem,thir,tri-,uniform,unit,unwinged,vary,wing,ympodial	abaxial,adaxial,arrangement,bark,branch,branching,calyx,capitate,form,growth,height,history,inflorescence,length,life,main,midvein,mottled,na,number,ovary,perennial,primary,pubescence,ray,shape,tertiary,texture,trichome,unarmed,vein,venation,width,young
791	wfo-0001032157	success	136	85	68	68	17	0.5	.5,0.5-1,0.6-1,0.75-1,1-3,2-3,2-5,2.2,3-6,5-15-flowered,7-9,9-17,anther,bark,base,becoming,beneath,bi-lobed,calyx,cm,completely,corolla,crystalline,deltoid,dia,dry,elliptic,glabrous,globose,golden,green,leaf,live,lobe,lobed,long,longitudinal,minor,minutely,mm,nearly,ovary,ovoid-reniform,paler,papillose,pedicel,peeling,petiole,pitted,plant,reddish,shaped,shiny,shrub,simple,size,stem,stigma,strip,style,surface,tear-drop,tip,tube,white,x,yellowish,young	.75,0.25,1.9-2.2,5-8,5-9,acute,anthesi,apart,apex,beginning,berry,caly,decurrent,deflexed,differing,difoliate,eaf,edicel,eed,evenly,exserted,filament,free,frui,fruiting,geminat,glabrou,incrassate,inflorescenc,lateral,less,living,lon,lower,main,major,margin,middle,nflorescence,obscure,older,one,opposite,pair,papillo,persistent,pore,poricidal,portion,raised,reflexed,rounded,ruit,scar,slender,slightly,soon,spaced,straight,tall,tapering,translucen,ud,unit,vein,widest,woody,ympodial	color,diameter,flower,form,fruit,growth,height,history,inflorescence,length,life,perennial,seed,shape,texture,translucent,width
792	wfo-0001032161	success	146	100	80	66	20	0.548	.5,0.4-1.2,0.5-1,0.7-4,0.75-1,0.8-1,1-1.5,1-11,1-3,1.2-1.3,2-7,2-8-flowered,2.5-3,3.5-4,?,adaxially,anther,apex,area,bark,base,calyx,cm,color,conical,coriaceous,corolla,dark,delicate,dendritic,densely,dia,drying,elliptic,glabrous,globose,golden,green,inflorescence,leaf,lobed,long,merely,minute,minutely,mm,mustard,nearly,ovary,ovoid-reniform,pale,papillose,pedicel,pericarp,petiole,pitted,plant,pubescent,shaped,shiny,shrub,simple,sparsely,stem,stigma,style,sulcate,surface,tan,tear-drop,thin,tip,trichome,tube,uniseriate,white,x,yellow,yellowish,young	1.4-2,abaxially,acute,adaxiall,anthesi,apical,ba,beneath,berry,branched,brownish-blac,closely,deflexed,deltate,difoliate,eaf,edicel,eed,ellipsoid,exserted,filament,filiform,free,fruiting,giving,hanging,internodal,lamina,later,like,lobe,lower,many,margin,middle,nflorescence,obovate,occasionally,older,opposite,overlappin,persistent,plurifoliate,pore,poricidal,portion,projection,quadrate,reflexed,rest,revolute,ruit,scar,shoot,short,spaced,strongly,styl,tall,tub,ud,unit,usually,vein,widest,ympodial	abaxial,adaxial,branching,brownish-black,diameter,flower,form,fruit,growth,height,history,length,life,na,perennial,pubescence,seed,shape,size,texture
793	wfo-0001032165	success	197	111	89	108	22	0.452	0.1,0.3-1,0.75-1,1-1.2,1-1.5,1-2,1.5-4,10-25,2-2.5,2.5-3.5,3-6,5-15,5-30-flowered,5-6,5-7,anther,bark,base,berry,broadly,brown,calyx,capitate,center,cm,continued,corolla,cup-shaped,dark,deltoid,densely,dia,dry,due,dull,elliptic,erect,filament,glabrous,globose,golden,golden-puberulent,golden-pubescent,green,greyish-brown,inflorescence,leaf,less,lobe,lobed,long,minute,minutely,mm,nearly,obovate,occasionally,once-furcate,ovary,ovoid-reniform,papillose,pedicel,petiole,plant,presence,puberulent,purplish,ripe,shape,simple,size,small,specimen,stem,stigma,straight,style,surface,tapering,tear-drop,tinged,tree,trichome,tube,uniseriate,white,woody,x,young	.25,.5,0.1-0.3,0.25-0.5,3-4,3.5-8.5,4-6,5-9.5,8-9,abaxial,acute,adaxial,along,anthesi,apex,apparent,appearing,ba,beginning,beneath,bud,closely,cucullate,deciduous,decurrent,denser,differing,difoliate,distal,eaf,edged,edicel,eed,ellipsoid,end,entire,even,expansion,exserted,exsertion,free,fruiting,geminat,immature,inflorescenc,later,lateral,like,live,lon,lower,main,major,margin,markedly,medial,middle,midrib,minor,near,nflorescence,node,older,one,onto,opposite,orbicular,overlapping,pair,pale,paler,papillo,pitted,planar,pore,poricidal,portion,prominent,rather,rest,ridge,rounded,ruit,scar,shaepd,single,slender,slightly,slow,smoot,spaced,stout,stripe,strongly,swollen,tall,terminal,thickened,time,tip,tub,ud,unit,vein,widest,winged,yellowish,ympodial	0.25,0.5,branching,color,diameter,flower,form,fruit,growth,height,history,length,life,na,peduncle,perennial,pubescence,seed,shaped,smooth,texture,width
794	wfo-0001032167	success	163	105	84	79	21	0.515	.5,0.5-1,0.5-2.5,0.75-3,1-2,1-2-celled,1-2.5,1-3,1-7,1.5,10-20,12-20,2-7,2-foliate,3-6,4-6,5-15,7-10,absent,anther,appressed,base,brown,calyx,cell,chartaceous,ciliate,closely,cm,densely,diameter,dm,drying,elliptic,elliptic-ovoid,entire,flower,forming,fruit,geniculate,glabrous,globose,growth,hair,herb,immature,larger,linear-lanceolate,margin,maturing,membranaceous,mm,moderately,nearly,netlike,oblong,obtuse,one-celled,pedicel,peduncle,petiole,projection,pubescent,purple,raised,rotate,rounded,seed,semitransparent,sparsely,staman,stigma,straight,style,surface,tube,twisted,two-celled,unbranched,usually,wall,white,x,yellow	0.5-1.5,1,1-5,10-35,2-4,3-7,4-10,abaxially,abundant,acute,adaxiall,adaxially,along,apex,axe,berry,blade,common,connected,cordate,curved,decurrent,dehiscing,dense,denser,eaf,eed,emarginat,explosively,few-,filament,flat,flattened,frui,geminat,growt,held,interpetalar,lobe,long,longer,lower,lowermost,lying,many-branched,maturit,mesocarp,near,new,nfloresence,notch,often,older,orolla,per,placenta,pressure,pubescen,rachi,ruit,shorter,slightly,small,smaller,sometimes,stamen,tal,tamen,tem,tissue,triangular,unit,upper,vary,vein,watery,wid,woody,ympodial	arrangement,branching,color,corolla,form,geminate,height,history,inflorescence,leaf,length,life,na,ovary,perennial,plant,pubescence,shape,size,stem,texture
795	wfo-0001032176	success	177	94	73	104	21	0.412	.5,0.42,0.5-0.7,0.5-1,1-1.2,1-10,1.5-1.6,1.5-2.5,1.5-6,100,2.5-10,3-15,3-3.5,3-4,5-6-celled,6,6-10,7,anther,axillary,base,branched,calyx,cm,conical,corolla,densely,denser,diameter,elliptic,filiform,flower,glabrous,green,greenish,grey-brown,greyish,herb,leaf,leaflet,lobed,long-papillose,minute,minutely,mm,nearly,obovate,occasionally,ovary,ovoid-reniform,papillose,pedicel,pinnate,poricidal,projection,pubescent,scar,seed,simple,sinuous,size,sparsely,stem,stigma,style,thickening,tip,trichome,tube,uniseriate,white,without,x	0,0.5,0.5-0.75,0.8-1,0.8-6,1/2,2-3,3-7,adaxially,adhering,along,anthesi,apart,apex,apical,arising,attaining,attenuate,axil,basal,beak,becoming,berry,capitat,cateniform,cell,containing,copiously,creeping,cucullate,drying,eaf,edicel,eed,ellipsoid,epidermal,equal,especially,exserted,fallen,filament,free,fruiting,globose,hangin,inflorescenc,lateral,lengt,lengthening,like,lobe,log,long,lower,margin,nflorescence,nodding,node,obtuse,often,onto,open,pair,pale,per,petiole,petiolule,pore,portion,quadrate,rachi,reflexed,rest,rooting,rounded,ruit,separate,single,slightly,slit,smaller,somewhat,soon,spaced,strait,strongly,tem,terminal,tightly,time,tree,truncate,trunk,tub,ud,ultimate,unevenly,unifoliat,unit,vein,wall,whit,winged,ympodial	abaxial,adaxial,arrangement,branching,capitate,color,form,fruit,growth,height,history,inflorescence,length,life,perennial,plant,pubescence,shape,straith,surface,texture
796	wfo-0001032183	success	162	85	62	100	23	0.383	0.3-0.6,0.5-1.5,0.6-0.9,0.7-1.4,0.9-1,1.1-2.3,2.4-2.7,3.5-4.5,4-6,4.5-7,5-9,5.5-7,7-12,absent,adaxially,anther,calyx,chartaceous,cm,densely,diameter,distally,elliptic,flower,fruit,glabrous,gland-tipped,globose,grey,hair,inflorescence,lanceolate,length,long,markedly,mm,ovate,pale,pedicel,peduncle,perennial,petiole,pubescent,purple,red,rotate-stellate,sessile,short,shrub,simple,sparsely,stellate-pubescent,stigma,style,thick,thicker,throughout,tube,unbranched,white,x,yellow	%,0-0.1,0-1.5,0.1-0.2,0.2-0.8,0.25-0.4,0.4-0.5,0.4-0.6,0.4-0.8,0.4-4,0.5-1,1-2,1-3,1.5-1.9,16-23,2-foliate,2.7-3.6,4-,5-merou,7-8,7-9,8-9,abaxially,absen,accrescent,across,acute,adaxiall,alyx,apart,apex,articulated,axe,ba,base,blade,capitat,confined,contiguous,cuneate,cylindrical,directed,distall,distributed,eaf,eed,eglandular,entire,erect,exceeding,extra-axillary,finger,fruiting,geminat,glaberous,green,homostylous,juicy,lamina,lateral,lobe,lower,margin,mature,mesocarp,mid-point,midpoint,midrib,minute,nearly,nflorescence,oblique,obtuse,orolla,part,per,perfect,pore,porrect,prickle,pseudo-umbellate,rachi,ray,rhizomatous,ruit,solitary,spaced,stalk,stellae,succulen,tal,tamen,tem,time,unarme,unarmed,unit,vary,wide,ympodial	abaxial,adaxial,arrangement,branching,capitate,color,corolla,form,growth,height,history,leaf,life,na,ovary,plant,pubescence,seed,shape,size,stem,surface,texture
797	wfo-0001032187	success	139	95	74	65	21	0.532	-11,-4,-4.2,-5,-9,0.1–1.4,0.5,0.5-,0.6–1.3,1.1–3.2,1.3–1.8,1.6–2.1,1.8–2,1.8–2.8,2–9,3.1–3.5,3–3.2,3–4,5-merous,5–7,7–11,acuminate,acute,angular,anther,apex,appressed,aromatic,base,blade,brown,brownish,cm,corolla,cyme,dark,eglandular,elliptic,entire,flowered,forked,globose,hair,herb,leaf,light,long,margin,marked,mm,obovate,ovate,pedicel,peduncle,pentagonal,persistent,petiole,plant,purple,rarely,ridge,simple,soft,sparse,stellate,stem,style,texture,truncate,well,yellow,yellowish,±,×	-2.1,0.5–1,100,1–1.7,22,24.6–26.3,9,adherent,alyx,ape,berry,branch,broadly,changing,consisting,di-foliate,dia,dull,eaf,eed,equal,erect,filament,fully,geminat,glabrescent,granule,green,hite,hooked,hydrated,lobe,lower,many,mature,nflorescence,numerous,occasionally,penden,per,perfec,petiolate,pollen,predominantly,presen,protruding,ruit,running,sclerotic,short,small,sometimes,spreading,stage,straight,sub-glabrous,tinged,tooth,triangular,unit,widest,wing,ympodial,±1,µm	arrangement,calyx,color,colour,diameter,flower,form,fruit,growth,height,history,inflorescence,length,life,number,perennial,seed,shape,size,white,width
798	wfo-0001032190	success	230	169	139	91	30	0.604	-1,-3.4,-6,0-0.6,0-80,0.2-0.3,0.5-3,0.7-1.1,0.8-1.1,1-1.5,1-1.7,1-6,1.2-2.1,1.2-3,1.5-3.5,1.8-3,1.9-4.5,10,2-6,2.5-10,3-21,4-5,4.5-7,5-22,7-11,7-28,acute,anther,apart,apical-lateral,articulated,bark,base,becoming,blunt-tipped,branch,branched,brown,calyx,campanulate,chartaceous,closely,cm,coarse-stalked,conical,coriaceous,corolla,decurrent,dehiscing,deltoid,densely,diameter,entire,exserted,extend,few-rayed,filament,fleshy,flower,fruit,glabrescent,glabrous,globose,granular-pubescent,growth,hair,hirsute,honeycombed,introrse,lanceolate,large,lateral,leaf,length,lobe,long-,long-attenuate,longitudinal,main,margin,midvein,mixed,mm,moderately,mostly,multangulate,near,oblong,occasional,openly,ovate,pale,partly,pedicel,peduncle,petiole,plurifoliate,pore,porrect-stellate,pubescent,relatively,reniform,reticulate-punctate,ripe,rotate-stellate,scabridulous,scabrous,sessile,short-,shrub,simple,slit,small,somewhat,spaced,sparsely,stamen,stelliform,stem,stigma,style,subcoriaceous,suborbicular,terete,terminal,thin-stalked,time,tree,truncate,tube,unarmed,usually,vein,white,whitish,x,yellow,yellowish,young	.5-6,/100-1/20,0.4-1.5,0.6-1.5,1.3-5,1.5-4,1.6-4.4,1/2-3/4,2.5-4.3,2.7-6.8,3.5-8,4-6,6-11,6x,abaxially,absent,accrescent,acuminate,adaxially,ag,along,anthesi,apex,apparently,appressed-tomentose,attenuate,axe,axillary,ba,berry,blade,bud,continued,due,eaf,eed,ellipsoid,elliptic,evident,free,fruiting,glabrou,green,high,inserted,line,lobed,long,long-stalked,lower,m.,magnification,minute,multangulat,multiseriate-stalked,nearly,nflorescence,oblanceolate,obtuse,occasionally,older,orolla,ovat,overlapping,perfect,porrect-stellat,present,rachi,rarely,rather,ruit,runk,short-stalked,side,sparse,stipitate-glandular,strongly,subcapitat,suture,tamen,testa,thick,tomentose,touching,toward,unarme,unit,vary,way,wide,ympodial	abaxial,adaxial,age,arrangement,branching,color,form,height,history,inflorescence,life,na,number,ovary,perennial,plant,primary,pubescence,ray,seed,shape,size,subcapitate,surface,tertiary,texture,trichome,venation,width,ye
799	wfo-0001032206	success	216	127	103	113	24	0.477	-20,.2,0.2,0–20,0–5,1.1–1.2,1/4–1/2,11–22,1–2.3,1–3,2.5–3.3,2.7–3.5,2–2.5,3.5–9,4–6,5–15,5–6,6–15,6–8,7–10,8–20,anther,apex,apparently,bark,base,berry,branched,calyx,chartaceous,cm,concolorous,connivent,cream,cuneate,dark,deltate,diameter,discolorous,drying,elliptic,filament,flattened-reniform,flower,foliaceous,fruit,glabrescent,glabrous,green,green-brown,lateral,leaf,length,lobe,lobed,long,margin,marking,maturity,midvein,mm,moderately,orange-brown,ovate,pair,pale,pedicel,peduncle,petiole,plant,poricidal,porrect,prickle,primary,purple,rarely,ray,sessile,shrub,smooth,spherical,stalked,stellate,stellate-pubescent,stem,style,surface,tapering,tertiary,tip,toward,trichome,truncate,tube,usually,variously,vein,venation,weakly,white,wide,yellow,young	-0.8,-2,-5,..,.5,0,0.2–0.4,0.2–0.5,0.5–1,0.8–1.2,00–200,0–30,1,1.2–2.2,1.5–2,1.5–2.5,1/3,1/4–1/3,1/6,10–80,1–2,1–4,2–3,2–8,30–80,3–4,4.5–5.8,5-merous,5–20,5–8,5–9,6–10,abaxially,accrescent,acute,adaxially,alyx,andromonoecious,apar,apart,apically,approximately,armed,articulated,blade,bluntly,broad-deltate,brow,clearly,covering,curved,distal,distance,eaf,eed,equal,erect,extending,flattened,free,fruiting,functionally,gently,hermaphroditic,heterostylous,infructescence,lengt,lobing,long-styled,longer,lowermost,mal,mature,mauve,midpoint,nflorescence,obtuse,often,older,one,open,orolla,ower,pendent,pendulous,per,pericarp,plurifoliat,portion,reflexed,scar,secondary,short-styled,side,slender,sometimes,spaced,sparsely,spreading,stalk,stout,straight,tamen,time,uit,unarmed,ung,unit,vary,visible,woody,yellow-orange,ympodial	0.5–1.5,abaxial,adaxial,arrangement,branch,branching,brown,color,corolla,form,growth,height,inflorescence,main,na,number,ovary,pubescence,seed,shape,size,stigma,texture,width
