	coreid	status	nwords_original	nwords_result	nwords_val	nwords_recovered	nwords_omitted	nwords_created	nwords_recovered_val	nwords_created_val	common_words	original_only	result_only	common_words_val	val_only
0	wfo-0001025652	success	156	93	59	73	83	20	57	2	.3,0.5-1,1.5-2,2-3,2-6,4,4-7,acuminate,acute,anther,anthesi,apex,bark,base,bilobed,blade,calyx,closed,cm,completely,corolla,decurrent,densely,elliptic,emerge,envelope,fleshy,fruit,furcate,glabrous,green,greyish,growth,leaf,lobe,matte,middle,mm,nearly,new,occasionally,onto,opposite,ovary,ovoid,ovoid-reniform,pale,paler,papillose,pedicel,petiole,pinkish-grey,plant,poricidal,shape,shiny,shrub,simple,size,small,stem,stigma,strongly,style,surface,tan,tear,tip,tree,white,widest,winged,x	.5,1,1-1.5,10-20,15-17,15-19,2-5,20-50,3-3.5,3-5,3-5-flowered,4-6,9-11,abruptly,appearing,broad,campanulate,closely,connate,dia,differing,difoliate,dry,eaf,edicel,eed,filament,flower,free,geminat,glabrate,greyi,growing,irregular,lateral,like,live,lobed,lon,long,lower,main,major,margin,minor,minute,minutely,narrowing,nflorescence,older,one,overlappin,pair,papillae,papillo,parallel,pitted,planar,pore,portion,rather,red-papillose,ry,scar,shaped,soon,spaced,specimen,straight,tall,tapering,tear-drop,thick,thicker,tightly,tube,ud,unit,vein,wider,wing,ympodial,young	arrangement,berry,bud,characteristic,colour,diameter,exertion,form,glabrousnes,height,history,inflorescence,length,life,lobing,peduncle,perennial,seed,texture,type	.3,0.5-1,1.5-2,2-3,2-6,4,4-7,acuminate,acute,anthesi,base,bilobed,blade,closed,cm,completely,decurrent,densely,elliptic,emerge,envelope,fleshy,furcate,glabrous,green,greyish,leaf,lobe,matte,middle,mm,nearly,occasionally,onto,opposite,ovoid,ovoid-reniform,pale,paler,papillose,petiole,pinkish-grey,poricidal,shiny,shrub,simple,small,stem,strongly,tan,tear,tip,tree,white,widest,winged,x	berry,perennial
1	wfo-0001025657	success	239	105	72	84	155	21	71	1	0.1-0.4,0.2-0.4,0.5-2.5,1-1.1,1-3,1.5-1.8,2-10,25-60,3-6,4-4.4,5-14,5-16,6-12,7-27,8.3-12,also,anther,anthesi,berry,bluish,blunt-tipped,branched,brown,bud,calyx,cm,conical,corolla,dark,deltoid,dendritic-multangulate,diameter,dried,elliptic,exserted,fleshy,flower,fruit,glandular,granular,green,hair,leaf,length,light,long-stalked,mixed,mm,multangulate,narrowly,oblong,orbicular,ovate,pedicel,peduncle,persistently,petiole,pseudo-terminal,rachi,reportedly,reticulate-punctate,ripe,short-,shrub,simple,soft,stellate,stem,stigma,style,suborbicular,surface,tan,terete,tomentose,tomentose-pubescent,tree,unarmed,velutinous-pubescent,weakly,white,x,yellow,yellowish	-2,/3,1-1.3,1-1.6,1.2-1.5,1.3-2,1.7-1.9,12x,2-3.5,2.2-5.5,2.5-9.3,2.7-4.3,2/3,3-4,3-4.8,3.2-6,4-4.5,4-7,6-8,6.5-10,7-9,7-9.5,8-10.5,abaxially,accrescent,acute,adaxially,ag,apart,apex,apparently,appearing,ark,around,articulated,ascending,axe,axillary,ba,base,blade,branch,broadly,capitat,central,chartaceous,closely,cordate,cylindrical,dendritic-multangulat,dense,densely,directed,distally,due,eaf,earl,edge,eed,entire,especially,evident,exerted,expanded,farinose,few-rayed,filament,free,fruiting,glabrous,glandula,half,inserted,lanate-pubescent,lanceolate,lateral,lengthening,lobe,lobed,long,longitudinal,lower,m.,magnification,main,margin,midrib,minutely,nearly,nflorescence,obtuse,occasional,often,older,open,orolla,ovat,ovate-lanceolate,overlapping,pale,part,parted,partly,perfect,persistent,plurifoliate,pore,poricidal,porrect-stellate,present,pubescence,pubescent,ray,ruit,scented,semi-ovate,sessile,short,short-stalked,side,slightly,slit,somewhat,spaced,splitting,stamen,stellate-pubescent,stipitate-glandular,stipitate-multangulate,strongly,subcampanulate,subcoriaceous,suture,tall,tamen,thick-stalked,thickened,thin-stalked,time,tip,tomentum,transparent,tube,two-third,ud,unarme,unit,upper,usually,vary,vein,way,wide,ympodial,young	abaxial,adaxial,arrangement,bark,capitate,characteristic,colour,exertion,form,growth,height,history,inflorescence,life,ovary,plant,seed,shape,size,texture,type	0.1-0.4,0.2-0.4,0.5-2.5,1-1.1,1-3,1.5-1.8,2-10,25-60,3-6,4-4.4,5-14,5-16,6-12,7-27,8.3-12,also,anthesi,berry,bluish,blunt-tipped,branched,brown,calyx,cm,conical,dark,deltoid,dendritic-multangulate,diameter,dried,elliptic,exserted,fleshy,flower,fruit,glandular,granular,green,hair,light,long-stalked,mixed,mm,multangulate,narrowly,oblong,orbicular,ovate,persistently,pseudo-terminal,reportedly,reticulate-punctate,ripe,short-,shrub,simple,soft,stellate,suborbicular,tan,terete,tomentose,tomentose-pubescent,tree,unarmed,velutinous-pubescent,weakly,white,x,yellow,yellowish	capitate
2	wfo-0001025669	success	214	137	102	116	98	21	99	3	.5,0-7,0.1-0.3,0.8-2.4,1,1-2,1-2.2,1-4,1.3-4.2,1.4-2.5,1.6-4.4,13-35,2-3,2-4,2.2-6,2.2-6.5,2.4-7,3-5,3-7,9-24.5,abaxially,absent,adaxially,along,anther,base,berry,blade,blue,brownish,cell,chartaceous,ciliate,clavate,cm,condition,corolla,covering,diameter,drying,end,especially,extra,filament,flower,forming,fresh,fruit,glabrous,globose,green,green-white,greenish,hair,hair-like,herb,interjected,lateral,leaflet,like,long,make,margin,membranous,midrib,minute,minutely,mm,moderately,monochasium,mottled,mucilaginous,multicellular,odd-pinnate,one,orbicular,ovate,ovoid,pedicel,peduncle,petiole,petiolulate,placed,plant,puberulent,pubescent,purple,rarely,ripe,rosette,scale-like,seed,sessile,short,size,slightly,sometimes,stem,stigma,streaked,style,subglabrous,terminal,testal,thick,throughout,tinged,tuber,typically,unwinged,wall,wet,white,whitish,wide,x	0-1,0-5,1-10,1-3,2,4-6,5-merou,absen,acumen,acuminate,acute,ag,alyx,apart,apex,apparently,articulation,axe,broadly,capitat,clearly,connivent,contracted,cuneate,decurrent,digestion,discussion,distal,distinct,dorsally,eaf,edge,eed,elliptic,enzyme,erec,exceeding,except,flat,flowered,folded,geminat,glabrou,greatly,half,highly,homostylous,honeycomb-shaped,lanceolate,larger,lengthening,living,lobe,lower,near,nflorescence,oblique,obovate,obtuse,often,orolla,pair,perfect,petiolule,plurifoliate,pore,poricidal,proximal,reduced,removed,rotate,rounded,ruit,see,seudostipule,single,slit,spaced,species,specimen,stamen,ste,stolo,straight,subequal,tall,tamen,tem,tip,tri-,truncate,tube,unbranched,unequal,unit,vary,yellow,ympodial	arrangement,calyx,capitate,colour,erect,form,growth,height,history,inflorescence,leaf,length,life,ovary,placement,pseudostipule,shape,stolon,surface,texture,type	.5,0-7,0.1-0.3,0.8-2.4,1,1-2,1-2.2,1-4,1.3-4.2,1.4-2.5,1.6-4.4,13-35,2-3,2-4,2.2-6,2.2-6.5,2.4-7,3-5,3-7,9-24.5,abaxially,absent,adaxially,along,base,berry,blue,brownish,cell,chartaceous,ciliate,clavate,cm,condition,covering,drying,end,especially,extra,flower,forming,fresh,glabrous,globose,green,green-white,greenish,hair,hair-like,herb,lateral,like,long,make,margin,membranous,midrib,minute,minutely,mm,moderately,monochasium,mottled,mucilaginous,multicellular,odd-pinnate,one,orbicular,ovate,ovoid,petiolulate,placed,puberulent,pubescent,purple,rarely,ripe,rosette,scale-like,seed,sessile,short,slightly,sometimes,stem,streaked,subglabrous,testal,thick,throughout,tinged,typically,unwinged,wall,wet,white,whitish,wide,x	capitate,erect,stolon
3	wfo-0001025697	success	181	112	69	86	95	26	64	5	0-14,0.15-0.75,0.6-3.5,1-1.7,1-2,1-3,1.5-1.8,1.7-8.6,2-10.5,2-2.6,2-6,25-35,3-10,3-4,3-6,3.3-11,4-7.5,5.5-11.5,6.5-13.5,abaxially,adaxially,anther,berry,blade,blue,brownish,clavate,cm,condition,connivent,coriaceous,corolla,dark,deep,diameter,drying,filament,flower,fresh,fruit,glabrescent,glabrous,globose,green,green-white,greenish,hair,herb,homostylous,interjected,lanceolate,lateral,leaf,leaflet,light,lilac,lobe,long,medium,mm,mucilaginous,odd-pinnate,ovate,ovoid,pedicel,peduncle,pentagonal,petiole,plant,purple,ripe,rotate,seed,short,size,stigma,stripe,style,terminal,throughout,tube,unwinged,wet,whitish,x,yellow	-9,0.8-2,10-26,2-4,3-5,5-merou,acumen,acuminate,acute,adaxiall,ag,alyx,apart,apex,apparently,articulated,asymmetric,attenuate,axe,axillary,base,basiscopic,bud,capitat,cell,covering,decreasing,decurrent,digestion,distal,dorsally,eaf,edge,eed,elliptic,enzyme,erec,exceeding,flat,folded,forked,geminat,generally,glabrou,hair-like,hal,half,high,honeycomb-shaped,lengthening,linear,living,lower,make,nflorescence,orbicular,orolla,pair,perfect,petiolulate,plurifoliate,pore,poricidal,rachi,removed,rounded,ruit,sessile,seudostipule,side,slightly,slit,spaced,specimen,stamen,straight,subequal,subglabrou,subtending,tall,tamen,tem,testal,thick,tip,tissue,toward,tri-,typically,unit,usually,vary,wall,wood,ympodial	5-merous,abaxial,adaxial,arrangement,calyx,capitate,characteristic,colour,erect,form,growth,height,history,inflorescence,length,life,ovary,pseudostipule,shape,staman,stem,subglabrous,surface,texture,type,woody	0-14,0.15-0.75,0.6-3.5,1-1.7,1-2,1-3,1.5-1.8,1.7-8.6,2-10.5,2-2.6,2-6,25-35,3-10,3-4,3-6,3.3-11,4-7.5,5.5-11.5,6.5-13.5,abaxially,adaxially,berry,blue,brownish,clavate,cm,condition,connivent,coriaceous,dark,deep,drying,fresh,glabrescent,glabrous,globose,green,green-white,greenish,hair,herb,homostylous,lanceolate,light,lilac,long,medium,mm,mucilaginous,odd-pinnate,ovate,ovoid,pentagonal,purple,ripe,rotate,short,stripe,throughout,unwinged,wet,whitish,x,yellow	5-merous,capitate,erect,subglabrous,woody
4	wfo-0001025699	success	181	128	87	105	76	23	84	3	.2,.5,0.5,1,1-2.5,1-3,1.5-2,1/3,10,15-20,2,2-2.5,2-6,2cm,3-15,3-5.5,5-8,5-winged,5.5-14,8-9,absent,acute,adaxially,almost,anther,apex,attenuate,bark,base,becoming,berry,branching,brown,c.,calyx,capitate,cm,completely,conical,corolla,dark,darker,diameter,drying,ellipsoid,elliptic,entire,erect,exerted,filament,flower,fruiting,glabrous,globose,green,grey-brown,growth,immature,inflorescence,leaf,leaf-opposed,leafy,less,lobe,margin,markedly,midrib,minutely,mm,new,older,ovary,pair,pale,pedicel,peduncle,petiole,poricidal,primary,red,reddish,reniform,reticulate-pitted,rounded,rounded-sagittate,shoot,short,simple,slightly,somewhat,stem,stigma,style,surface,time,tip,tree,tube,vein,way,white,x,yellow,young,Â½	1-1.5,1-2,1.5,3-3.5,3-8,4-5,499,abaxially,age,anthesi,apart,apparently,appearing,articulating,campanulate,conspicuously,continuing,corrugate,crystal,cup-shaped,deltate,densely,difoliate,dorsal,dry,eaf,eed,face,fide,free,glabrou,included,inclusion,inflorescenc,irregularly,lanceolate,leaving,lengthening,lobed,lower,narrowly,nflorescence,nodding,one,onto,oxalate,papillat,papillose,peg,penden,per,perfect,plurifoliate,pore,portion,ruit,sand,scar,slit,small,spaced,stearn,straight,strongly,tangled,thickened,triangular,trichome,ud,unit,white-spotted,wide,wing,winged,woody,ympodial	arrangement,bud,characteristic,colour,corrugated,corrugation,exertion,form,fruit,glabrousnes,height,history,length,life,lobing,na,papillate,plant,seed,shape,size,texture,type	.2,.5,0.5,1,1-2.5,1-3,1.5-2,1/3,10,15-20,2,2-2.5,2-6,2cm,3-15,3-5.5,5-8,5-winged,5.5-14,8-9,absent,acute,adaxially,almost,attenuate,base,becoming,berry,branching,brown,c.,calyx,capitate,cm,completely,conical,dark,darker,ellipsoid,elliptic,entire,erect,exerted,flower,glabrous,globose,green,grey-brown,immature,leaf,leaf-opposed,leafy,less,lobe,markedly,midrib,minutely,mm,older,pair,pale,poricidal,red,reddish,reniform,reticulate-pitted,rounded,rounded-sagittate,shoot,short,simple,slightly,somewhat,surface,time,tip,tree,tube,way,white,x,yellow,young,Â½	corrugated,na,papillate
5	wfo-0001025700	success	189	113	80	92	97	21	77	3	0-16,0.30-2.0,0.7-2.7,0.8-2.6,1.1-2.3,1.5-2,10.5-12,15-40,2-12,2.5-4,3-8,3.5-10.5,3.7-8.6,5-15,5-20,5.3-17.5,5.5-18,9-31,abaxially,adaxially,anther,apiculate,berry,brownish,cell,chartaceous,clavate,cm,condition,connivent,corolla,covering,diameter,dot,drying,flower,fresh,fruit,glabrescent,glabrous,globose,green,green-white,greenish,hair,hair-like,herb,homostylous,interjected,lanceolate,lateral,leaf,leaflet,light,lilac,long,make,medium,mm,mucilaginous,narrowly,odd-pinnate,ovate,ovoid,pedicel,peduncle,pentagonal,petiole,plant,poricidal,purple,ripe,rotate-pentagonal,seed,short,size,sometimes,stigma,style,terminal,testal,thick,throughout,tip,unwinged,wall,wet,white,whitish,winged,x,yellow	0.5-2,0.8-4,1-2,1-3,10-40,2-7,3-4,4-5,5-merou,5.5-8,acuman,acumen,acuminate,acute,ag,alyx,apex,apparently,articulated,asymmetric,attenuate,axe,axillary,basal,base,basiscopic,blade,bud,capitat,considerably,decrease,decreasing,digestion,distal,dorsally,eaf,edge,eed,elliptic,enzyme,erec,exceeding,except,filament,flat,folded,forked,geminat,generally,glabrou,hal,half,high,honeycomb-shaped,larger,lengthening,linear,living,lobe,lower,nflorescence,orbicular,orolla,pair,par,perfect,petiolulate,plurifoliate,pore,proximal,removed,rounded,ruit,sessile,seudostipule,side,slightly,slit,specimen,stamen,straight,subequal,subglabrou,subtending,tall,tamen,tem,tissue,toward,tri-,tube,typically,unit,usually,vary,whose,ympodial	5-merous,arrangement,calyx,capitate,characteristic,colour,form,growth,height,history,inflorescence,length,life,ovary,pseudostipule,shape,stem,subglabrous,surface,texture,type	0-16,0.30-2.0,0.7-2.7,0.8-2.6,1.1-2.3,1.5-2,10.5-12,15-40,2-12,2.5-4,3-8,3.5-10.5,3.7-8.6,5-15,5-20,5.3-17.5,5.5-18,9-31,abaxially,adaxially,apiculate,berry,brownish,cell,chartaceous,clavate,cm,condition,connivent,covering,diameter,dot,drying,fresh,glabrescent,glabrous,globose,green,green-white,greenish,hair,hair-like,herb,homostylous,lanceolate,lateral,light,lilac,long,make,medium,mm,mucilaginous,narrowly,odd-pinnate,ovate,ovoid,pentagonal,poricidal,purple,ripe,rotate-pentagonal,seed,short,sometimes,testal,thick,throughout,tip,unwinged,wall,wet,white,whitish,winged,x,yellow	5-merous,capitate,subglabrous
6	wfo-0001025704	success	247	149	105	125	122	24	103	2	0-100,0-2,0-3.5,0.3-0.8,0.5-1.5,0.7-1,1-3.5,1-6,1.2-3,1.5-3.2,1.5-4.5,1.8-3.5,1/2-4/5,2-10,2-3,2-4.5,2.5-4.5,2.7-4,3-15,3-5,3-6,4-5,abaxial,acute,adaxial,almost,anther,apex,apparently,articulated,auriculate,bark,base,berry,branched,calyx,cell,chartaceous,cm,connivent,cordate,densely,diameter,discolorous,drying,ellipsoid,elliptic,erect,evenly,filament,flattened-reniform,flower,fruit,fruiting,glabrescent,gray,green,green-yellow,irregular,lateral,leaf,length,lobe,lobed,lobing,long,long-styled,margin,maturity,mauve,mm,near,often,orange-brown,outline,ovate,pale,pedicel,peduncle,per,petiole,pit,plant,poricidal,prickle,prickly,raised,rarely,red-brown,red-green,round,rounded,shape,short-styled,shrub,side,small,smooth,sometimes,somewhat,sparsely,spherical,stellate,stellate-pubescent,stem,strongly,style,surface,tapering,terminal,tip,tree,truncate,tube,unarmed,unbranched,way,white,white-gray,wide,yellow,yellow-green,yellowish,young,Ã	/6,0-10,0-5,0.1,0.1-0.3,0.1-0.5,0.15-0.8,1,1-2,1-3,1-4,1-5,1.5-2,1/4-3/4,1/5,2,2-5,2-7,3-10,4-12,4.5-6.5,5-20,5-merous,6-12,6-15,8-12,8-15,8-17,abaxially,age,alyx,andromonoecious,apar,apart,apically,apiculate,axe,ba,blade,broad-deltate,brow,covering,curved,deltate,development,distal,distance,eaf,eed,elongating,end,equal,extending,flattened,free,glabrous,half,hermaphrodite,heterostylous,infructescence,less,longer,lower,lowermost,mature,midpoint,midvein,moderately,multangulate,nflorescence,obtuse,occasionally,older,one,open,orange,orolla,oung,pair,pendulous,pericarp,plurifoliat,porrect,portion,prickl,primary,prominent,ray,recurved,reflexed,retaining,ruit,scar,secondary,sessile,shorter,slender,spaced,spreading,stalk,stalked,staminat,stellate-pubescen,stout,straight,tamen,terete,tertiary,throughout,time,trichome,unit,upper,variously,vary,vein,venation,visible,warty,widening,woody,ympodial	arrangement,branch,brown,bud,characteristic,colour,corolla,corrugation,exertion,form,glabrousnes,growth,hair,height,inflorescence,na,new,number,ovary,seed,size,stigma,texture,type	0-100,0-2,0-3.5,0.3-0.8,0.5-1.5,0.7-1,1-3.5,1-6,1.2-3,1.5-3.2,1.5-4.5,1.8-3.5,1/2-4/5,2-10,2-3,2-4.5,2.5-4.5,2.7-4,3-15,3-5,3-6,4-5,acute,almost,apparently,articulated,auriculate,base,berry,branched,cell,chartaceous,cm,connivent,cordate,densely,diameter,discolorous,drying,ellipsoid,elliptic,erect,evenly,flattened-reniform,flower,glabrescent,gray,green,green-yellow,irregular,lateral,lobe,lobed,long,long-styled,maturity,mauve,mm,near,often,orange-brown,outline,ovate,pale,per,pit,poricidal,prickle,prickly,raised,rarely,red-brown,red-green,round,rounded,short-styled,shrub,side,small,smooth,sometimes,somewhat,sparsely,spherical,stellate,stellate-pubescent,strongly,tapering,terminal,tip,tree,truncate,unarmed,unbranched,way,white,white-gray,wide,yellow,yellow-green,yellowish,young,Ã	brown,na
7	wfo-0001025729	success	177	137	107	115	62	22	103	4	.5,/4,0.25-0.5,0.7-1.2,1-1.5,1-5,1.1-1.5,1.2-1.8,1.75,2,2-3.5,20,3-6,4-5,4-8,5-50-flowered,9-17,abaxial,abaxially,abrupt,adaxially,anther,apiculate,appearing,axil,bark,basal,base,berry,black,blackish,bright,bristly,bud,calyx,cm,corolla,covering,densely,dia,diam,difoliate,dirty,drying,elliptic,enclosed,f,filament,flattened-reniform,fleshy,fruiting,furcate,glabrous,globose,green,greenish-yellow,greyish-brown,growing,lamina,lateral,leaf,like,live,lobed,long,main,minor,minutely,mm,occasionally,often,opposite,ovary,overtopping,pale,papillose,pedicel,petiole,pit,pitted,plant,pore,poricidal,pubescent,quite,ripening,shaped,shiny,short,simple,size,sparsely,stem,stigma,stout,style,surface,tapering,tear-drop,terminal,tip,tree,treelet,trichome,tube,tuft,uniseriate,unit,usually,vein,way,white,widening,x,yellow	-20,1.5-2,6-8,7-8,acute,along,anthesi,apar,apex,apical,branched,covered,cyathiform,dark,deflexed,deltoid,denser,differing,eaf,edicel,eed,expanded,free,geminat,gently,glabrou,incrassate,lat,lobe,lon,lower,m.,mainly,major,margin,member,middle,minute,nflorescence,oblique,older,one,overlapping,pair,papillo,partially,portion,prominent,raised,reflexed,rounded,ruit,scar,straight,tall,touching,tub,ud,widest,woody,ympodial,young	4-20,arrangement,characteristic,colour,diameter,exertion,form,fruit,geminate,growth,height,history,inflorescence,late,length,life,lobing,seed,shape,sympodial,texture,type	.5,/4,0.25-0.5,0.7-1.2,1-1.5,1-5,1.1-1.5,1.2-1.8,1.75,2,2-3.5,20,3-6,4-5,4-8,5-50-flowered,9-17,abaxial,abaxially,abrupt,adaxially,apiculate,appearing,axil,basal,base,berry,black,blackish,bright,bristly,bud,calyx,cm,corolla,covering,densely,dia,diam,difoliate,dirty,drying,elliptic,enclosed,f,flattened-reniform,fleshy,furcate,glabrous,globose,green,greenish-yellow,greyish-brown,growing,lamina,lateral,leaf,like,live,lobed,long,main,minutely,mm,occasionally,often,opposite,overtopping,pale,papillose,pit,pitted,plant,pore,poricidal,pubescent,quite,ripening,shaped,shiny,short,simple,sparsely,stem,stout,tapering,tear-drop,terminal,tip,tree,treelet,trichome,tube,tuft,uniseriate,unit,usually,vein,way,white,widening,x,yellow	4-20,geminate,late,sympodial
8	wfo-0001025749	success	215	109	72	87	128	22	70	2	/5,0.2-1.5,0.3-1.5,0.4-0.7,0.5-0.8,0.5-0.9,0.5-1.3,0.5-3,0.8-0.9,1-10,1-2,1.5-2.5,2-2.5,5-10-12,abaxial,acute,adaxial,anther,apex,apparently,bark,base,berry,calyx,chartaceous,cm,cuneate,curved,dark,densely,diameter,dull,flattened,flattened-reniform,fruit,fruiting,gently,glabrescent,glabrous,gray,green-brown,lateral,leaf,length,light,lobed,long,long-ovate,lower,margin,maturity,mauve,mm,moderately,narrow-deltate,orange-brown,orange-red,orbicular,ovate,pale,pedicel,peduncle,petiole,poricidal,prickle,red-brown,rounded,shrub,sometimes,sparsely,spherical,spreading,stellate,stellate-pubescent,straight,straw-yellow,style,surface,tapering,tip,way,white,wide,yellow,yellow-green,yellow-orange,yellowish	.5,0-10,0-3,0-5,0-6,0-8,0.1,0.1-0.2,0.1-0.3,0.1-0.4,0.2,0.5-1,0.6-4.5,1,1-13,1-3,1-6,1-8.5,1-9,1.5,1.5-2,1/4-1/3,1/5-1/2,2-10,2.5-6,2/3,3-20,3-5,4-8,5-20,5-6-8,5-merous,6-8,abaxially,acuminat,adaxially,adnate,almost,alyx,apar,apart,apically,articulated,blade,branched,broad-deltate,concolorous,difoliate,discolorous,distance,drying,eaf,eed,elongating,equal,erect,extending,filament,filiform,flower,free,geminat,herbaceous,indistinct,infructescence,lobe,lon,longer,magnification,markedly,mature,midpoint,midvein,narrow-ovate,nflorescence,oblong,obtuse,occasionally,older,one,open,orange-brow,orolla,oung,pair,pendulous,per,perfec,pericarp,porrect,portion,prickl,prickly,primary,procumbent,purple,rarely,ray,recurved,reduced,ruit,scar,sessile,shorter,side,smooth,spaced,stalk,stalked,stem,strongly,tamen,terete,tertiary,time,toward,trichome,tube,unit,usually,variously,vary,vein,venation,visible,without,ympodial,Â½-2/	arrangement,characteristic,colour,corolla,form,growth,height,history,inflorescence,life,lobing,ovary,perennial,plant,seed,shape,size,staman,texture,type,width,Â½-2/3	/5,0.2-1.5,0.3-1.5,0.4-0.7,0.5-0.8,0.5-0.9,0.5-1.3,0.5-3,0.8-0.9,1-10,1-2,1.5-2.5,2-2.5,5-10-12,acute,apparently,base,berry,chartaceous,cm,cuneate,curved,dark,densely,diameter,dull,flattened,flattened-reniform,gently,glabrescent,glabrous,gray,green-brown,lateral,light,lobed,long,long-ovate,lower,maturity,mauve,mm,moderately,narrow-deltate,orange-brown,orange-red,orbicular,ovate,pale,poricidal,red-brown,rounded,shrub,sometimes,sparsely,spherical,spreading,stellate,stellate-pubescent,straight,straw-yellow,tapering,tip,way,white,wide,yellow,yellow-green,yellow-orange,yellowish	perennial,Â½-2/3
9	wfo-0001025754	success	164	106	71	81	83	25	69	2	.5,0.5-1,0.5-1.5,1,1-3,1.5,10-20,2-4,2-foliate,3-10,4-6,5-12,5-15,absent,acuminate,acute,anther,apex,asymmetrical,base,berry,branch,brown,calyx,center,chartaceous,ciliate,cm,cordate,cordiform,decumbent,decurrent,densely,diameter,dm,drying,edge,entire,filament,fine,flower,fruit,glabrous,globose,hair,herb,immature,leaf,linear-lanceolate,margin,maturing,membranaceous,mm,moderately,nearly,oblong,often,parallel,pedicel,peduncle,petiole,pubescent,radiating,raised,ridge,rotate,running,semitransparent,shallow,slightly,sparsely,stem,stigma,style,surface,truncate,unbranched,upright,white,x,yellow	-celled,0.1-0.2,1-2,1-3.5,1.5-3,1.5-4,10-35,2-5-celled,2-7,3-5,3-6,4,abaxially,abundant,adaxiall,adaxially,along,axe,barely,beyond,blade,connected,dehiscing,denser,dried,eaf,eed,eglandular,emarginat,equal,erect,explosively,exserted,flat,geminat,glandular,held,interpetalar,leaving,like,lobe,long,lower,lying,main,material,maturit,mesocarp,mixed,much-branched,nfloresence,notch,orolla,palmately,penden,per,placenta,pressure,probably,pubescen,rachi,ruit,short,small,solitary,sometimes,stamen,straight,swollen,tal,tamen,tem,tissue,triangular,tube,unit,vary,vein,visible,watery,wid,woody,ympodial	abaxial,adaxial,arrangement,characteristic,colour,corolla,form,glabrousnes,growth,height,history,inflorescence,length,life,na,new,ovary,plant,seed,shape,size,staman,texture,type,wide	.5,0.5-1,0.5-1.5,1,1-3,1.5,10-20,2-4,2-foliate,3-10,4-6,5-12,5-15,absent,acuminate,acute,apex,asymmetrical,berry,brown,center,chartaceous,ciliate,cm,cordate,cordiform,decumbent,decurrent,densely,diameter,dm,drying,edge,entire,fine,flower,fruit,glabrous,globose,hair,herb,immature,linear-lanceolate,margin,maturing,membranaceous,mm,moderately,nearly,oblong,often,parallel,petiole,pubescent,radiating,raised,ridge,rotate,running,semitransparent,shallow,slightly,sparsely,truncate,unbranched,upright,white,x,yellow	na,wide
10	wfo-0001025760	success	207	135	93	109	98	26	91	2	.5,/3,0-0.5,0-100,0.3-1,0.4-0.8,0.45-0.9,0.5-1.5,0.5-2,0.7-2.5,0.8-1.8,1-1.5-2.5-5,1-1.8,1-4,1.5,1/5,2-2.5,2.1-3.5,2.5-10,2/3,3,3-6,5-18,acute,almost,annual,anther,apex,apically,apparently,articulated,bark,base,berry,black,broad-deltate,calyx,chartaceous,cm,cream,cultivar,cuneate,curved,dark,diameter,dull,elliptic,filament,flattened-reniform,fruit,fruiting,gently,glabrous,green,herb,infructescence,lateral,leaf,length,lobe,lobed,long,margin,marking,maturity,membranous,mm,moderately,orange,orange-brown,ovate,pair,pale,pedicel,peduncle,per,perennial,petiole,poricidal,primary,red-brown,rounded,shape,shrub,side,sometimes,spherical,stellate-pubescent,stem,style,subentire,surface,tapering,terete,tip,tube,unarmed,unbranched,upper,usually,various,vein,way,weakly,white,wide,yellow,yellow-green,young	-10,-12,-6,0.1,0.1-0.2,0.15-0.3,0.2-0.35,1-2,1-3,1.5-4.5,1.5-5,1/4,1/4-1/2,1/4-1/3,2-3,2.3-4,2.5-8,3.5-17,3.5-9,5-10-merous,8-10-12,abaxial,abaxially,acut,adaxial,alyx,apar,blade,brow,concolorous,connivent,deltate,difoliate,discolorous,distance,drying,eaf,eed,elongating,equal,erect,extending,flower,free,geminat,geminate,glabrescent,hair,lengt,longer,lower,mature,midpoint,midvein,minute,nflorescence,often,older,one,open,orolla,oung,pendulous,perfec,pericarp,porrect,portion,ray,recurved,reflexe,ruit,scar,sessile,shorter,simple,slender,smooth,spaced,spreading,stalk,stalked,stellate,stellate-pubescen,stout,straight,tamen,tertiary,thick-stalked,time,trichome,unarme,unit,variously,vary,venation,visible,woody,ympodial	arrangement,branch,brown,bud,characteristic,colour,corolla,exertion,form,glabrousnes,growth,height,history,inflorescence,life,lobing,na,new,number,ovary,plant,seed,size,stigma,texture,type	.5,/3,0-0.5,0-100,0.3-1,0.4-0.8,0.45-0.9,0.5-1.5,0.5-2,0.7-2.5,0.8-1.8,1-1.5-2.5-5,1-1.8,1-4,1.5,1/5,2-2.5,2.1-3.5,2.5-10,2/3,3,3-6,5-18,acute,almost,annual,apically,apparently,articulated,base,berry,black,broad-deltate,chartaceous,cm,cream,cultivar,cuneate,curved,dark,diameter,dull,elliptic,flattened-reniform,gently,glabrous,green,herb,infructescence,lateral,length,lobe,lobed,long,marking,maturity,membranous,mm,moderately,orange,orange-brown,ovate,pair,pale,per,perennial,poricidal,red-brown,rounded,shape,shrub,side,sometimes,spherical,stellate-pubescent,subentire,tapering,terete,tip,unarmed,unbranched,upper,usually,various,way,weakly,white,wide,yellow,yellow-green,young	brown,na
11	wfo-0001025782	success	199	150	92	112	87	38	89	3	.5,0-10,0-5,0.1-0.2,0.4-0.6,0.55-0.75,0.9-1.3,1-2.5,1-4,1.2-6,1.3-1.6,1.5-3,10-13,2-10,2-2.5,2-3,2-5,2.5-3.5,2/3-3/4,3-4,3-5,4,4-4.5,4.5-9,5-20,5.5-6,6-14,abaxially,acuminate,anther,apart,apex,apparently,articulated,bark,base,berry,brown,calyx,chartaceous,cm,concolorous,conical,cuneate,curved,densely,diameter,discolorous,distal,drying,dull,elliptic,evenly,filament,flattened,flattened-reniform,flower,fruit,fruiting,gently,glabrous,green,green-brown,lateral,leaf,length,lobe,lobed,long,long-styled,margin,maturity,membranous,midpoint,mm,moderately,orange-brown,pair,pedicel,peduncle,per,petiole,plant,poricidal,prickle,prickly,primary,ray,shrub,spaced,sparsely,spherical,stellate,stellate-pubescent,stem,style,surface,tapering,terete,tip,toward,trichome,tube,unbranched,vein,way,weakly,white,wide,yellow,yellow-green,young	0.1-0.15,0.1-0.25,0.3-1,0.5-1,1,1-1.7,1-2,1/4-1/2,1/4-1/3,1/6,2-7,20,5-6.5,5-8,5-merous,6-8,abaxial,acuminat,adaxial,also,alyx,andromonoecious,apar,apically,blade,climbing,connivent,deltate,difoliate,distance,eaf,eed,elongated,elongating,equal,extending,free,geminat,geminate,glabrescent,hair,hermaphrodite,heterostylous,infructescence,lengt,less,longer,lower,lowermost,mature,midvein,minute,nflorescence,occasionally,older,one,open,orolla,oung,pendulous,pericarp,porrect,portion,prickl,red-brow,reduced,ruit,scar,sessile,short-styled,shorter,side,simple,smooth,spreading,staminat,stout,straight,tamen,tertiary,time,unit,vary,venation,visible,woody,ympodial	appearance,arrangement,border,branch,bud,characteristic,colour,corolla,corrugation,exertion,form,giving,glabrousnes,growth,height,history,inflorescence,interjected,leaflet,life,lobing,na,new,number,ovary,perennial,pseudostipule,red-brown,seed,shape,size,stigma,terminal,texture,thicknes,type,variation,width	.5,0-10,0-5,0.1-0.2,0.4-0.6,0.55-0.75,0.9-1.3,1-2.5,1-4,1.2-6,1.3-1.6,1.5-3,10-13,2-10,2-2.5,2-3,2-5,2.5-3.5,2/3-3/4,3-4,3-5,4,4-4.5,4.5-9,5-20,5.5-6,6-14,abaxially,acuminate,apart,apex,apparently,articulated,base,berry,brown,chartaceous,cm,concolorous,conical,cuneate,curved,densely,diameter,discolorous,dull,elliptic,evenly,flattened,flattened-reniform,flower,gently,glabrous,green,green-brown,lateral,length,lobed,long,long-styled,maturity,membranous,mm,moderately,orange-brown,pair,per,poricidal,prickle,prickly,shrub,spaced,sparsely,spherical,stellate,stellate-pubescent,tapering,terete,tip,toward,trichome,unbranched,way,weakly,white,wide,yellow,yellow-green,young	na,perennial,red-brown
12	wfo-0001025783	success	179	120	79	93	86	27	77	2	.5,0.5-1.5,1-1.2,1-3,1.8-2,2-3+,2-5,5,abaxially,acute,anther,anthesi,apex,articulated,base,berry,branched,brown,bud,c.,calyx,cm,coriaceous,corolla,dendritic,diameter,ellipsoid,elliptic,entire,erect,expanded,exserted,filiform,flattened,fleshy,flexuous,fruiting,glabrous,globose,greyish,growth,inserted,lateral,lax,less,lobed,long,margin,minutely,mm,narrowly,new,nodding,obtuse,pale,pedicel,peduncle,petiole,pitted,pubescent,purple,reniform,revolute,ripe,sagittate,shiny,shoot,short,shrub,simple,sleeve,slightly,sometimes,somewhat,sparsely,stem,stigma,strongly,style,surface,terminal,thin,time,trichome,truncate,tube,type,uniseriate,vine,violet,way,wide,woody	0.5,0.5-1,0.8-3.5,1-1.5,2,2-6.5,3-4,5-merou,7-10,<,abaxiall,adaxiall,adaxially,along,alyx,apart,ape,ark,axil,branching,cell,cluster,completely,confined,conical,densely,eaf,eed,exposed,flower,free,glabrou,green,groove,hromosome,ilament,keeled,known,lobe,long/tall,lower,mature,midrib,midvein,minute,mmm,near,nflorescence,number,obscured,occasionally,older,orolla,outlin,pair,penden,pentagonal,perfect,pericarp,plurifoliat,point,portion,possibly,primary,ruit,scar,scarious,see,spaced,sparse,stellate,suture,testal,transparent,triangular,tuft,twinin,ud,unit,upper,vary,vein,weak,within,yellowish,ympodial	abaxial,adaxial,arrangement,bark,characteristic,colour,exertion,filament,form,fruit,glabrousnes,hair,height,history,inflorescence,leaf,length,life,lobing,ovary,plant,seed,seen,shape,size,texture,white	.5,0.5-1.5,1-1.2,1-3,1.8-2,2-3+,2-5,5,abaxially,acute,anthesi,apex,articulated,base,berry,branched,brown,c.,calyx,cm,coriaceous,dendritic,diameter,ellipsoid,elliptic,entire,erect,expanded,exserted,filiform,flattened,fleshy,flexuous,glabrous,globose,greyish,inserted,lateral,lax,less,lobed,long,minutely,mm,narrowly,nodding,obtuse,pale,pitted,pubescent,purple,reniform,revolute,ripe,sagittate,shiny,shoot,short,shrub,simple,sleeve,slightly,sometimes,somewhat,sparsely,strongly,terminal,thin,time,trichome,truncate,uniseriate,vine,violet,way,wide,woody	seen,white
13	wfo-0001025788	success	156	68	32	47	109	21	31	1	0.5-2,1-4,1-5,10-24,14-48,15-30,2-10,2-13,2-3,2-5,2.8-9.5,4-5.5,4.5-10.1,4.5-12.5,5-8,6.2-12.5,blue,branched,calyx,cm,conical,corolla,diameter,dichasially,filament,finely,forked,green-white,herbaceous,interjected,lateral,leaf,leaflet,mm,odd-pinnate,ovoid,pedicel,peduncle,perennial,petiole,plant,pubescent,purple,seed,size,style,terminal	0-6,1.8-2.7,1.8-3.9,2m,3-6-7-8,3-6-foliat,4-3.,8-38,abaxiall,abaxially,acumen,acuminate,acute,adaxially,apex,apical,apically,articulate,attenuate,base,cell,connate,covering,cuneate,cyme,deep,dehiscent,dichasial,digestion,diminishing,distal,dorsally,eaf,ebracteate,edge,eed,elliptical,emoval,enzyme,exceeding,flat,flower,folded,generally,globo,gradually,green,hair-like,half,honeycomb,introrse,living,lobe,lon,long,long-attenuate,lower,lunat,make,maturing,medium,monochasial,mucilaginous,narrowly,nflorescence,nther,oblique,obtuse,often,orolla,ovate,pair,pattern,perfect,petiolule,plan,poricidally,proximal,reveal,rotate,rounded,ruit,sessile,seudostipule,short,slit,specimen,stamen,stigma,straight,subequal,subsessile,tal,tem,testal,thick,throughou,throughout,tip,toward,tuber-bearing,typically,unit,vary,wall,wide,yellow,ympodial,Â¼	4-31,abaxial,adaxial,anther,arrangement,branching,colour,form,fruit,growth,height,history,inflorescence,length,life,ovary,pseudostipule,shape,stem,texture,width	0.5-2,1-4,1-5,10-24,14-48,15-30,2-10,2-13,2-3,2-5,2.8-9.5,4-5.5,4.5-10.1,4.5-12.5,5-8,6.2-12.5,blue,branched,cm,conical,dichasially,finely,forked,green-white,herbaceous,mm,odd-pinnate,ovoid,perennial,pubescent,purple	4-31
14	wfo-0001025792	success	203	105	64	80	123	25	62	2	0.4-0.7,1-2,10-15,2-3,2-3.5,2.5-3.5,2.5-4,21-28,3-5,3.5-6,4-12,4-6,4.5-7,5,5-10,5-9,7-10,7.5-8,8-10,9-12,anther,auriculate,berry,blade,blue-mauve,blue-purple,brownish,chartaceous,cm,condition,corolla,dark,densely,diameter,drying,elliptic,filament,flower,forked,fresh,fruit,glabrous,globose,green,green-white,greenish,herb,interjected,lanceolate,lateral,leaflet,long,mauve,membranous,minute,mm,mucilaginous,narrowly,odd-pinnate,ovoid,pedicel,peduncle,plant,pubescent,purple,rotate-pentagonal,seed,size,stem,stigma,straight,streak,style,terminal,throughout,tinged,wet,white,whitish,x	1-10,1-3,1-4,2-11,3-4,5-6,5-merou,abaxially,acumen,acuminate,acute,adaxially,ag,along,alyx,apart,apex,apparently,articulated,articulation,axe,axillary,base,basiscopic,broadly,bud,capitat,cell,ciliate,connivent,covering,decurrent,developing,digestion,distal,distinct,distinctly,dorsally,eaf,edge,eed,enzyme,especially,exceeding,except,flat,folded,geminat,generally,glabrou,greatly,hair,hair-like,hal,half,high,homostylous,honeycomb-shaped,indistinct,lengthening,like,living,lobe,lower,make,margin,midrib,minutely,mottle,narrow,nflorescence,oblique,often,onto,orolla,pair,papillose,perfect,petiole,petiolulate,plurifoliate,pore,poricidal,proximal,puberulent,rachi,reduced,removed,ripe,rounded,ruit,semi-erec,semi-rosette,sessile,seudostipule,short,shortly,side,slightly,slit,spaced,specimen,stamen,ste,sub-rosette,subequal,subtending,tall,tamen,tem,testal,thick,tip,tri-,tube,unit,usually,vary,wall,wing,yellow,ympodial,young	abaxial,adaxial,arrangement,calyx,capitate,characteristic,colour,form,glabrousnes,growth,height,history,inflorescence,leaf,length,life,mottled,number,ovary,pseudostipule,shape,staman,surface,texture,type	0.4-0.7,1-2,10-15,2-3,2-3.5,2.5-3.5,2.5-4,21-28,3-5,3.5-6,4-12,4-6,4.5-7,5,5-10,5-9,7-10,7.5-8,8-10,9-12,auriculate,berry,blue-mauve,blue-purple,brownish,chartaceous,cm,condition,dark,densely,diameter,drying,elliptic,forked,fresh,glabrous,globose,green,green-white,greenish,herb,lanceolate,long,mauve,membranous,minute,mm,mucilaginous,narrowly,odd-pinnate,ovoid,pubescent,purple,rotate-pentagonal,straight,streak,throughout,tinged,wet,white,whitish,x	capitate,mottled
15	wfo-0001025804	success	155	116	83	92	63	24	81	2	.25,.5,0.5-1,1-3,1.2-1.5,1.4-1.7,1.5-2,16-35,3.5-12,4-10,6-8,7-10,abaxially,acute,adaxially,anther,apex,attenuate,bark,base,berry,bilobed,branched,calyx,clavate,cm,corolla,cream,dark,decurrent,deflexed,dia,difoliate,drying,ellipsoid,elliptic,erect,exserted,filament,flattened,fleshy,fruiting,glabrous,globose,green,incrassate,internodal,lateral,leaf,light,lobed,long,main,many,margin,minutely,mm,near,nearly,obovate,occasionally,often,onto,opposite,ovary,pair,paler,pedicel,pitted,plurifoliate,poricidal,red-papillose,reddish-brown,reniform,sessile,shrub,size,somewhat,stem,stigma,strongly,style,surface,thick,time,tip,tube,vein,white,whitish-green,winged,x	1-1.5,10-20,11-20,2-2.5,2.5-4,3-4.5,5,?,age,anthesi,apar,ape,apiculate,ba,c.,conical,covered,cucullate,densely,differing,eaf,edicel,eed,flower,free,geminat,glandular,later,lengthening,lobe,lower,major,mere,middle,minor,minute,nflorescence,older,papillae,papillat,papillate,papillose,planar,pore,portion,projection,red,reddish-brow,regularly,rim,ruit,scar,slit,spaced,tall,tub,ud,unit,widest,wing,woody,ympodial,young	arrangement,bud,characteristic,colour,diameter,exertion,form,fruit,geminate,growth,height,history,inflorescence,length,life,lobing,na,peduncle,plant,primary,seed,shape,texture,type	.25,.5,0.5-1,1-3,1.2-1.5,1.4-1.7,1.5-2,16-35,3.5-12,4-10,6-8,7-10,abaxially,acute,adaxially,apex,attenuate,base,berry,bilobed,branched,calyx,clavate,cm,cream,dark,decurrent,deflexed,dia,difoliate,drying,ellipsoid,elliptic,erect,exserted,flattened,fleshy,glabrous,globose,green,incrassate,internodal,lateral,leaf,light,lobed,long,main,many,margin,minutely,mm,near,nearly,obovate,occasionally,often,onto,opposite,pair,paler,pitted,plurifoliate,poricidal,red-papillose,reddish-brown,reniform,sessile,shrub,somewhat,stem,strongly,thick,time,tip,tube,vein,white,whitish-green,winged,x	geminate,na
16	wfo-0001025813	success	195	109	68	86	109	23	66	2	0-2,0.7-1.7,1-1.5,1-10,1-2,1-4,1.2-4.5,1.3-7,1.5-1.8,1.5-6.5,15-30,2-4,3-3.5,3-4,3-5,3-6,3-7,5-18.5,5-6,6-7,abaxially,absent,adaxially,anther,base,berry,blade,blue,borne,brownish,chartaceous,cm,condition,corolla,dark,densely,diameter,drying,end,extra,filament,flower,fresh,fruit,glabrous,globose,green,green-white,greenish,hair,herb,homostylous,interjected,lateral,leaflet,light,lobe,long,membranous,minute,mm,monochasium,mucilaginous,odd-pinnate,ovoid,pedicel,peduncle,pilose,pubescent,rarely,seed,singly,size,stem,stigma,style,terminal,throughout,tube,tuber,typically,violet,wet,white,whitish,x	1.5-2,2-3,2-5,5-merou,acumen,acuminate,acute,ag,along,alyx,apart,apex,apparently,articulated,axe,broadly,cell,ciliate,connivent,contracted,covering,cuneate,decreasing,decurrent,digestion,discussion,distal,distinct,dorsally,eaf,edge,eed,elliptic,enzyme,especially,exceeding,flat,folded,geminat,glabrou,hair-like,half,highly,honeycomb-shaped,lanceolate,larger,lengthening,like,living,longer,lower,make,margin,midrib,minutely,near,nflorescence,obtuse,often,orbicular,orolla,ovate,ovoi,pair,perfect,petiole,petiolulate,plant,plurifoliate,pore,poricidal,puberulent,rachi,removed,rosette-formin,rotate,ruit,see,sessile,seudostipule,short,single-flowered,slit,sometimes,spaced,species,specimen,stamen,ste,stolo,straight,strongly,suborbicular,tamen,tem,testal,thick,thir,tip,toward,tri-,unforked,unit,unwinged,vary,vein,wall,yellow,ympodial	arrangement,calyx,colour,form,growth,history,inflorescence,leaf,length,life,ovary,presence,pseudostipule,pubescence,rosette-forming,shape,spacing,staman,stolon,surface,symmetry,texture,type	0-2,0.7-1.7,1-1.5,1-10,1-2,1-4,1.2-4.5,1.3-7,1.5-1.8,1.5-6.5,15-30,2-4,3-3.5,3-4,3-5,3-6,3-7,5-18.5,5-6,6-7,abaxially,absent,adaxially,base,berry,blue,borne,brownish,chartaceous,cm,condition,dark,densely,drying,end,extra,flower,fresh,glabrous,globose,green,green-white,greenish,hair,herb,homostylous,light,long,membranous,minute,mm,monochasium,mucilaginous,odd-pinnate,ovoid,pilose,pubescent,rarely,singly,throughout,typically,violet,wet,white,whitish,x	rosette-forming,stolon
17	wfo-0001025825	success	187	141	97	113	74	28	94	3	0-0.21,0.4-1,0.5-10.4,0.9-2,1-2,1.1-1.4,10-24,10.5-26,14-85,2-3.7,3-10,3-5,3.7-6.5,4-8,4-9,5-10,5-7,6-10,6.6-14,abaxially,acuminate,acute,adaxially,anther,apex,axillary,back,base,berry,blade,brownish,bud,cell,clavate,cm,condition,connivent,coriaceous,corolla,covering,cuneate,dark,diameter,distal,drying,elliptic,filament,flower,forked,fresh,fruit,generally,glabrescent,glabrous,green,green-white,greenish,hair,hair-like,half,herb,homostylous,interjected,lanceolate,lateral,leaf,leaflet,lengthening,light,lilac,lobe,long,make,medium,mm,mucilaginous,odd-pinnate,ovate,ovoid,pair,pedicel,peduncle,pentagonal,plant,pore,poricidal,rotate-pentagonal,seed,shiny,short,size,slit,stigma,straight,streak,style,subtending,terminal,testal,thick,throughout,tip,tube,unwinged,usually,wall,wet,white,whitish,wing,winged,x,yellow	0.4-3,0.5-0.8,0.7-2.2,0.9-4,1-3,1-5.5,2-5,22-86,3-8.5,5-merou,acumen,adaxiall,ag,alyx,apart,apparently,articulated,asymmetric,attenuate,axe,basiscopic,capitat,decreasing,decurrent,digestion,dorsally,eaf,edge,eed,enzyme,erec,exceeding,flat,folded,geminat,glabrou,hal,high,honeycomb-shaped,increasing,living,lower,middle,nflorescence,orbicular,orolla,perfect,petiole,petiolulate,plurifoliate,rachi,removed,rounded,ruit,sessile,seudostipule,side,slightly,smaller,spaced,specimen,stamen,subequal,subglabrou,tall,tamen,tem,tissue,toward,tri-,unit,vary,wide,ympodial	abaxial,adaxial,age,arrangement,calyx,capitate,characteristic,colour,connivence,form,glabrousnes,growth,height,history,inflorescence,length,life,ovary,poricity,pseudostipule,shape,spacing,stem,subglabrous,surface,texture,type,width	0-0.21,0.4-1,0.5-10.4,0.9-2,1-2,1.1-1.4,10-24,10.5-26,14-85,2-3.7,3-10,3-5,3.7-6.5,4-8,4-9,5-10,5-7,6-10,6.6-14,abaxially,acuminate,acute,adaxially,axillary,back,berry,brownish,bud,cell,clavate,cm,condition,connivent,coriaceous,covering,cuneate,dark,diameter,distal,drying,elliptic,forked,fresh,generally,glabrescent,glabrous,green,green-white,greenish,hair,hair-like,half,herb,homostylous,lanceolate,lateral,lengthening,light,lilac,lobe,long,make,medium,mm,mucilaginous,odd-pinnate,ovate,ovoid,pentagonal,plant,pore,poricidal,rotate-pentagonal,seed,shiny,short,slit,straight,streak,subtending,terminal,testal,thick,throughout,tip,unwinged,usually,wall,wet,white,whitish,winged,x,yellow	age,capitate,subglabrous
18	wfo-0001025838	success	215	126	85	103	112	23	83	2	0.5-1,0.7-2,1-1.2,1.5-1.7,1.5-3.5,1.5-5,1.8-2,2-2.5,2.5-3,2/3,20-40,4-15,6.5-7,acuminate,adaxial,anther,anthesi,apex,attenuate,base,berry,black,branch,brown,calyx,capitate,clavate,cm,corolla,dark,dendritic,dense,densely,diameter,ellipsoidal,elliptic,entire,erect,exserted,filament,flattened,fleshy,fruit,fruiting,glabrous,globose,greenish,growth,inflorescence,lanceolate,lateral,leaf,like,long,margin,membranous,minute,minutely,mm,narrowly,new,nodding,often,onto,ovoid,pale,pedicel,peduncle,per,petiole,pitted,pointed,pubescent,purple,reddish,reniform,revolute,ripe,seed,shrub,simple,slender,slightly,sometimes,sparsely,stem,stigma,strongly,style,surface,terminal,tinged,tree,trichome,tube,tuft,turbinate,way,white,winged,x,yellow,Â¾	.5,0.5,1-1.5,1.2-5,1.5-2,1.5-2.5,10-15-20,10-60,2-5,3.5-6-15,4.5-5.5,5,5-merou,abruptly,adaxially,ag,along,alyx,apart,apiculate,appearing,archin,ark,articulated,axil,basall,branched,broad,cell,clustered,connivent,cucullate,cup-shaped,decurrent,denser,disintegrating,drying,eaf,eed,extending,flower,free,glabrescent,hairy,ilament,inserted,insertion,irregularly,keeled,lamina,lengthening,less,lobe,lobed,loosely,lower,m.,many,midrib,mostly,narrowing,never,nflorescence,occasionally,older,orolla,pair,papillat,papillo,perfect,pericarp,platform,plurifoliat,point,pore,poricidal,portion,primary,quadrate,ruit,scar,shin,shiny,short,sinus,sleeve,slit,small,spaced,spreading,square,stellate,tall,tem,testal,thi,thin,time,tip,twinin,ud,uniseriate,unit,upper,vary,vein,wall,weight,wing,woody,yellowish,ympodial	abaxial,arching,arrangement,bark,bud,characteristic,colour,exertion,form,glabrousnes,height,history,length,life,lobing,number,ovary,perennial,plant,shape,size,texture,type	0.5-1,0.7-2,1-1.2,1.5-1.7,1.5-3.5,1.5-5,1.8-2,2-2.5,2.5-3,2/3,20-40,4-15,6.5-7,acuminate,anthesi,attenuate,base,berry,black,brown,calyx,capitate,clavate,cm,dark,dendritic,dense,densely,diameter,ellipsoidal,elliptic,entire,erect,exserted,flattened,fleshy,glabrous,globose,greenish,lanceolate,lateral,like,long,membranous,minute,minutely,mm,narrowly,nodding,often,onto,ovoid,pale,per,pitted,pointed,pubescent,purple,reddish,reniform,revolute,ripe,shrub,simple,slender,slightly,sometimes,sparsely,stem,strongly,terminal,tinged,tree,trichome,tube,tuft,turbinate,way,white,winged,x,yellow,Â¾	arching,perennial
19	wfo-0001025845	success	180	128	84	101	79	27	83	1	0.3-0.5,0.4-1.5,0.5-11,0.5-2.5,1-1.8,1-4.5,1.5,1.5-13,1.5-2,1.5-2.5,2,2-15,2-5-lobed,2.5-4,3,3-13,3-4,4-5,4-6,6-6.5,6-9,abundantly,acuminate,acute,adaxial,anther,apart,apex,apiculate,articulated,base,branch,brown,calyx,chartaceous,cm,compressed,corolla,cuneate,cylindrical,deltate,diameter,distally,eglandular,ellipsoidal,entire,extra-axillary,filament,flattened,fork,fruit,glabrous,greenish,herb,laterally,leaf,light,lobe,lobed,located,margin,membranaceous,minutely,mm,narrowly,near,obtuse,orange,ovate,ovoid,patch,pedicel,peduncle,petiole,pinnately,puberulent,pubescent,rachi,rotate-stellate,rugose-verrucate,sagittate,sand-punctate,shrub,side,simple,sparsely,stigma,strongly,style,subcordate,tapered,tip,triangular,truncate,tube,unbranched,vein,white,x,yellow,yellowish	.5,1,1-2,1.5-7,2-3,3-6,3-foliat,5-6,7-10,abaxially,adaxially,aggregate,along,around,ascending,axe,ba,blade,cell,channe,connivent,dark,decurrent,diamete,directed,distall,divided,eaf,eed,elliptic,especially,flower,free,glabrou,green,inserted,lateral,long,longitudinal,lower,major,mesocarp,midrib,nearly,nflorescence,obovate,often,orolla,part,perfect,pore,purple,radiu,rarely,rounded,ruit,shorter,sinus,small,spaced,stone,stripe,tal,tamen,tem,terminal,thecae,thick,tightly,time,tomento,truncat,unit,unlobed,vary,veiny,wide,ympodial,youn	abaxial,arrangement,articulation,characteristic,colour,form,glabrousnes,growth,height,history,inflorescence,length,life,new,ovary,plant,primary,seed,shape,size,spacing,stem,surface,texture,thicknes,tomentose,type	0.3-0.5,0.4-1.5,0.5-11,0.5-2.5,1-1.8,1-4.5,1.5,1.5-13,1.5-2,1.5-2.5,2,2-15,2-5-lobed,2.5-4,3,3-13,3-4,4-5,4-6,6-6.5,6-9,abundantly,acuminate,acute,apart,apex,apiculate,articulated,base,branch,brown,chartaceous,cm,compressed,cuneate,cylindrical,deltate,distally,eglandular,ellipsoidal,entire,extra-axillary,flattened,fork,glabrous,greenish,herb,laterally,light,lobed,located,membranaceous,minutely,mm,narrowly,near,obtuse,orange,ovate,ovoid,patch,pinnately,puberulent,pubescent,rotate-stellate,rugose-verrucate,sagittate,sand-punctate,shrub,side,simple,sparsely,strongly,subcordate,tapered,tip,triangular,truncate,unbranched,white,x,yellow,yellowish	tomentose
20	wfo-0001025850	success	195	120	81	97	98	23	80	1	.5,.8,0.5-1,0.5-1-3-5,0.5-1.5-5,0.5-3,0.6-1,1,1-1.5,15-20,2,2-6.5,6-7,acute,anther,anthesi,apex,articulated,basal,base,berry,branched,brown,calyx,capitate,cm,corolla,cyathiform,diameter,divaricate,ellipsoid,elliptic,entire,erect,exserted,filament,flattened,fruiting,glabrous,glandular,globose,green,growth,half,inflorescence,later,lateral,lax,lobed,many,margin,minute,minutely,mm,narrowly,nearly,new,nodding,often,openly,orange,pale,pedicel,peduncle,per,petiole,pinnatifid,pitted,pubescent,reddish,reniform,rhomboid,ripe,rounded,scattered,shallowly,shrub,simple,sleeve,slender,small,spreading,stem,stigma,strongly,style,surface,tan,terminal,time,trichome,tube,uniseriate,vine,white,woody,x	-7,0.5,1-celled,1.5,2-12,3-4,30,4-5,5-7,5-merou,abaxial,ag,along,alyx,apar,apparently,ark,axi,broadly,cell,connivent,cupped,deciduous,deflexed,deltate,densely,denser,divided,drying,eaf,eed,elongate,em,extending,fleshy,flower,free,geminat,glabrou,gland,halfway,ilament,irregularly,lamina,leaving,lengthening,less,lobe,long,loosely,lower,membranous,midrib,nflorescence,node,occasionally,older,orolla,outline,pair,papillate-puberulent,papillo,peg,perfect,planar,plurifoliate,pore,poricidal,portion,primary,puberulen,ruit,scar,shiny,sinuate,sinus,slightly,slit,sometimes,soon,spaced,splitting,spreadin,stellate,surfac,testal,thin,tiny,tip,truncate,twinin,ud,unit,vary,vein,yellow,ympodial,young	arrangement,bark,characteristic,colour,exertion,form,fruit,glabrousnes,height,history,leaf,length,life,lobing,number,ovary,plant,puberulent,seed,shape,size,texture,type	.5,.8,0.5-1,0.5-1-3-5,0.5-1.5-5,0.5-3,0.6-1,1,1-1.5,15-20,2,2-6.5,6-7,acute,anthesi,articulated,basal,base,berry,branched,brown,calyx,capitate,cm,cyathiform,diameter,divaricate,ellipsoid,elliptic,entire,erect,exserted,flattened,glabrous,glandular,globose,green,half,later,lateral,lax,lobed,many,minute,minutely,mm,narrowly,nearly,nodding,often,openly,orange,pale,per,pinnatifid,pitted,pubescent,reddish,reniform,rhomboid,ripe,rounded,scattered,shallowly,shrub,simple,sleeve,slender,small,spreading,strongly,tan,terminal,time,trichome,uniseriate,vine,white,woody,x	puberulent
21	wfo-0001025872	success	160	105	70	81	79	24	65	5	.5,0.25-0.5,0.6-1,1-1.3,1-2,1.2-1.5,1.2-1.6,1.7-3,2-2.5,2-5,2/3,3.5-4,4.5-13,6-10,6-8,anther,apically,bark,base,becoming,berry,brownish,calyx,capitate,cm,corolla,crinkled,dark,deeply,densely,dia,dry,elliptic,exserted,filament,flattened,flattened-reniform,fleshy,fruiting,glabrous,glandular-resinous,globose,green,greenish-tan,later,lateral,leaf,live,main,margin,mm,narrowly,occasionally,older,opposite,ovary,pair,pedicel,petiole,pitted,plant,poricidal,pubescent,red-papillose,revolute,shrub,soon,stem,stigma,style,surface,tapering,terminal,thick,tip,tube,vein,way,white,x,young	.1,0.5,0.5-1,1,1-1.5,10-25-flowered,4-4.5,acute,along,anthesi,apart,apex,auriculate,ba,beginning,beneath,blade,branched,bright,broadly,coriaceous,crowded,cup-shaped,decurrent,deflexed,dense,eaf,edicel,eed,flower,free,grayish-brow,incrassate,inflorescenc,irregularly,junction,lobe,lobed,lon,long,lower,material,midrib,minutely,nflorescence,often,onto,paler,papillae,papillo,papillose,planar,plurifoliat,pore,portion,prominent,rounded,rounded-triangular,ruit,scar,several,shaped,simple,somewhat,spaced,specimen,straight,tall,tear-drop,thickened,time,trichome,tub,ud,uniseriate,unit,visible,woody,ympodial	arrangement,bud,characteristic,colour,diameter,exertion,form,fruit,grayish-brown,growth,height,history,inflorescence,length,life,lobing,perennial,plurifoliate,primary,seed,shape,size,texture,type	.5,0.25-0.5,0.6-1,1-1.3,1-2,1.2-1.6,1.7-3,2-2.5,2-5,2/3,3.5-4,4.5-13,6-10,6-8,apically,base,becoming,berry,brownish,calyx,capitate,cm,crinkled,dark,deeply,densely,dry,elliptic,exserted,flattened,flattened-reniform,fleshy,glabrous,glandular-resinous,globose,green,greenish-tan,later,lateral,leaf,live,main,mm,narrowly,occasionally,older,opposite,pair,pitted,poricidal,pubescent,red-papillose,revolute,shrub,soon,tapering,terminal,thick,tip,tube,vein,way,white,x,young	.2-1.5,di,grayish-brown,perennial,plurifoliate
22	wfo-0001025893	success	157	97	65	74	83	23	60	5	.4,0.5-1.5,0.8-1,1-1.2,1-1.5,1-4,1.5-1.7,1.5-2,11-20,2-3,5-6,anther,apex,attenuate,bark,base,berry,bi-lobed,branched,broadly,brownish-green,calyx,capitate,cm,corolla,cup-shaped,decurrent,densely,dia,elliptic,faintly,fruit,fruiting,glabrate,glabrous,globose,golden-puberulent,green,greyish,internodal,leaf,long,long-acuminate,longitudinally,minutely,mm,narrowly,nearly,obovate,occasionally,older,opposite,ovary,ovoid-reniform,pale,pedicel,petiole,pitted,red-papillose,shaped,shrub,slender,sometimes,stem,stigma,style,surface,tapering,tear-drop,tube,white,winged,x,young	.25,.5,1-2.5,2-2.5,3-5,6-10,accrescent,along,anthesi,bank,barely,bearing,beginning,beneath,blade,closely,deflexed,deltoid,difoliate,dry,eaf,early,eed,ellipsoid,erect,even,exserted,filament,flower,free,geminate,gravelly,growing,impressed,inflorescenc,lateral,lobe,lobed,lon,lower,main,many,margin,material,middle,nflorescence,overlapping,pair,papillo,papillose,planar,plurifoliat,pore,poricidal,portion,puberulent,reflexed,river,rocky,ruit,sandy,scar,slightly,spaced,specimen,straight,stream,striat,tall,thickened,time,tip,trichome,ud,unicellular,unit,usually,vein,visible,widest,woody,yellowish,ympodial	abaxial,adaxial,alternate,arrangement,characteristic,colour,diameter,form,growth,height,history,inflorescence,length,life,lobing,perennial,plant,seed,shape,size,striate,texture,type	.4,0.5-1.5,0.8-1,1-1.2,1-1.5,1-4,1.5-2,11-20,2-3,5-6,attenuate,base,berry,bi-lobed,branched,broadly,brownish-green,calyx,capitate,cm,cup-shaped,decurrent,densely,dia,elliptic,faintly,glabrate,glabrous,globose,golden-puberulent,green,greyish,internodal,leaf,long,long-acuminate,longitudinally,minutely,mm,narrowly,nearly,obovate,occasionally,older,opposite,ovoid-reniform,pale,pitted,red-papillose,shaped,shrub,slender,sometimes,tapering,tear-drop,tube,white,winged,x,young	.5-1.7,alternate,di,perennial,striate
23	wfo-0001025896	success	146	99	64	72	74	27	62	2	-3,0.5,0.5-2,1-25,1-6.5,1-8,1.5-2,10-15,4,4-5,5-15,6-10,7743,abaxial,acosta,acuminate,adaxially,also,angled,apart,apex,articulated,base,brownish,chartaceous,cm,cuneate,densely,diameter,eglandular,elliptic-ovate,entire,forked,fruit,glabrous,gland,globose,greenish,hair,like,margin,membranaceous,mm,moderately,nearly,often,orange,ovate,pale,pedicel,peduncle,petiole,pubescent,purple,red,ripe,rotate-stellate,rugose,short-stalked,shrub,simple,smooth,solÃ­,stem,stigma,style,subcordate,surface,unbranched,white,x,yellow	-30,.5-2.5,1-1.5,1-3,1.5-9,10-25,2-14,2-2.5,2.5-14,2.5-5,4-12,4-23,4-6,5-7,6-13,7-,abaxially,absen,acute,adaxiall,aggregate,axe,ba,blade,branched,calyx,cell,connivent,constricted,cylindrical,deltate,dendritically,directed,distall,eaf,eed,especially,flower,inflated,lobe,long,lower,many-foliat,near,nflorescence,nther,obtuse,occasionally,orolla,perfect,pore,present,puberulent,pubescen,rachi,radiu,ruit,spaced,sparsely,stalked,stone,tal,tem,time,tip,triangular-ovate,triangular-subulate,truncat,tube,unit,vary,vein,wide,ympodial	adaxial,anther,arrangement,articulation,characteristic,colour,corolla,form,glabrousnes,growth,height,history,inflorescence,leaf,length,life,new,ovary,perennial,plant,seed,shape,size,spacing,texture,truncate,type	-3,0.5,0.5-2,1-25,1-6.5,1-8,1.5-2,10-15,4,4-5,5-15,6-10,7743,acosta,acuminate,adaxially,also,angled,apart,articulated,base,brownish,chartaceous,cm,cuneate,densely,diameter,eglandular,elliptic-ovate,entire,forked,glabrous,gland,globose,greenish,hair,like,membranaceous,mm,moderately,nearly,often,orange,ovate,pale,pubescent,purple,red,ripe,rotate-stellate,rugose,short-stalked,shrub,simple,smooth,solÃ­,stem,subcordate,unbranched,white,x,yellow	perennial,truncate
24	wfo-0001025902	success	211	115	77	96	115	19	76	1	/2,0.1-0.5,0.5-2.5,1-1.2,1-1.5,1.2-1.5,1.5,11-15,1983,2.5-4,4,4-13,40,>,acute,adaxially,anther,anthesi,apex,attenuate,bark,base,becoming,berry,black,cabrera,calyx,clavate,cm,completely,conical,corolla,diameter,dull,ellipsoid,entire,fide,filament,flattened-reniform,fruiting,glabrous,globose,green,growth,inflorescence,lanceolate,lateral,leaf,leaf-opposed,length,linear,lobed,long,margin,mature,minute,minutely,mm,new,occasionally,ovary,pale,papillose,pedicel,peduncle,per,petiole,pitted,pubescent,ridged,rounded,scattered,scrambling,simple,slender,sometimes,spreading,stem,stigma,strongly,style,surface,tangled,tapering,terminal,trichome,tube,uniseriate,vine,violet,way,whitish,wing,woody,yellow,yellowish	.2,.5,0.5-2,1.5-2,1.5-3,1/3,2-6,3-10,4-5,4-6,5-6,5-merou,8-10,8-15,8-9,abaxially,absent,accompanied,ag,aid,along,always,alyx,apar,ark,articulated,axi,beginning,berr,branch,branched,branching,broadly,c.,cell,chartaceous,circular,climbin,connivent,deciduou,deltate,densely,eaf,eed,either,except,exfoliatin,exserted,fleshy,flower,free,geminat,ilament,leaving,lengthening,less,lobe,loosely,low,lower,markedly,midvei,nflorescence,obscured,often,older,one,orolla,pair,papillat,peg,pendant,perfect,pericarp,planar,plurifoliate,pore,poricidal,portion,primary,prominent,revolute,rotate-stellate,ruit,scar,semi-aquati,semi-circular,shallow,sleeve,slit,small,somewhat,soon,spaced,sparsely,tem,testal,thin,time,tip,twining,ud,ultimate,unit,usually,vary,vegetation,vein,water,weak,weight,widely,x,ympodial,Â½	arrangement,characteristic,colour,form,fruit,glabrousnes,height,history,life,lobing,na,number,plant,pubescence,seed,shape,size,texture,type	/2,0.1-0.5,0.5-2.5,1-1.2,1-1.5,1.2-1.5,1.5,11-15,1983,2.5-4,4,4-13,40,>,acute,adaxially,anthesi,apex,attenuate,base,becoming,berry,black,cabrera,clavate,cm,completely,conical,diameter,dull,ellipsoid,entire,fide,flattened-reniform,glabrous,globose,green,lanceolate,lateral,leaf-opposed,linear,lobed,long,mature,minute,minutely,mm,occasionally,pale,papillose,per,pitted,pubescent,ridged,rounded,scattered,scrambling,simple,slender,sometimes,spreading,strongly,surface,tangled,tapering,terminal,trichome,uniseriate,vine,violet,way,whitish,wing,woody,yellow,yellowish	na
25	wfo-0001025906	success	188	130	88	105	83	25	84	4	0-14,0.1-2,0.15-0.6,0.20-0.60,1-2,1.1-2,1.6-12.4,16-51,2-4.4,2-6,2.6-5.2,3-10,4-10,4-5,4-7,5-6,5-7,5.2-9,8-16,8.5-12.5,abaxially,acumen,adaxially,anther,base,berry,blade,blue,brownish,cell,clavate,cm,condition,connivent,coriaceous,corolla,covering,cuneate,dark,decurrent,diameter,drying,filament,flower,fresh,fruit,glabrous,globose,green,green-white,greenish,hair,hair-like,herb,homostylous,interjected,lanceolate,lateral,leaf,leaflet,light,lilac,linear,lobe,long,make,mm,mucilaginous,odd-pinnate,ovoid,pair,pedicel,peduncle,pentagonal,petiole,plant,poricidal,pubescent,purple,rachi,ripe,rotate,seed,shiny,short,size,stigma,straight,stripe,style,sub-glabrous,subglabrous,terminal,testal,thick,throughout,tip,tube,unwinged,wall,wet,white,whitish,x,yellow	0.2-0.6,1-3,1-6,1.8-4.8,3-5,4-12,5-merou,acute,adaxiall,ag,alyx,apart,apex,apparently,articulated,axe,axillary,bud,capitat,decreasing,decurrency,delimited,digestion,diminishing,distal,dorsally,eaf,edge,eed,enzyme,erec,exceeding,falcate,first,flat,folded,forked,geminat,generally,glabrou,hal,half,high,honeycomb-shaped,lengthening,living,lower,next,nflorescence,obtuse,orolla,perfect,plurifoliate,pore,removed,ruit,second,sessile,seudostipule,slightly,slit,smaller,spaced,sparsely,specimen,stamen,subequal,subglabrou,subtending,tall,tamen,tem,third,toward,tri-,typically,unit,usually,vary,well,width,wood,ympodial	5-merous,abaxial,adaxial,arrangement,calyx,capitate,characteristic,colour,erect,form,growth,height,history,inflorescence,length,life,ovary,pseudostipule,shape,staman,stem,surface,texture,type,woody	0-14,0.1-2,0.15-0.6,0.20-0.60,1-2,1.1-2,1.6-12.4,16-51,2-4.4,2-6,2.6-5.2,3-10,4-10,4-5,4-7,5-6,5-7,5.2-9,8-16,8.5-12.5,abaxially,acumen,adaxially,berry,blue,brownish,cell,clavate,cm,condition,connivent,coriaceous,covering,cuneate,dark,decurrent,diameter,drying,fresh,glabrous,globose,green,green-white,greenish,hair,hair-like,herb,homostylous,lanceolate,lateral,light,lilac,linear,long,make,mm,mucilaginous,odd-pinnate,ovoid,pentagonal,poricidal,pubescent,purple,rachi,ripe,rotate,seed,shiny,short,straight,stripe,sub-glabrous,subglabrous,testal,thick,throughout,tip,unwinged,wall,wet,white,whitish,x,yellow	5-merous,capitate,erect,woody
26	wfo-0001025907	success	147	92	55	72	75	20	52	3	.05,.5,.5-1,0,0.8-1.8,1,1-1.2,1-2.3,1-3,1-5,1.5-2,1.5-2.2,12-45,2,2-3.5,2/3,3-5-15,4-5,acuminate,acute,anther,apex,attenuate,axillary,base,berry,brown,c,cm,conical,densely,diameter,elliptic,filament,flattened,fruit,fruiting,glabrous,globose,green,greenish,growth,lobed,long,lower,minutely,mm,new,obovate,ovary,ovoid-reniform,papillate,papillose,pedicel,per,petiole,plant,poricidal,pubescent,red-papillate,round,seed,shrub,simple,size,stigma,style,surface,tip,trichome,tube,x	-4,0-60,10-15,2-8,3-4,3/2,absent,along,anthesi,anthesis5-7,anticlinal,appearing,axil,beak,bearing,breaking,calyx,cell,clavat,conspicuously,deciduous,eaf,edicel,eed,epidermal,erec,flower,free,highly,included,iquito,irregular,isolated,lamina,lobe,lon,margin,near,nearly,nflorescence,occasionally,open,pair,population,portion,primary,projection,raised,reflexed,remaining,rugose,ruit,scar,scattered,single-stemmed,sinuous,slender,soon,sparsely,tal,tem,thickening,time,truncate,tub,ud,unifoliat,uniseriate,unit,variable,vein,white,white-lenticellate,without,ympodial	5-7,abaxial,arrangement,bud,clavate,colour,form,glabrousnes,height,history,inflorescence,leaf,length,life,number,perennial,shape,stem,texture,type	.05,.5,.5-1,0,0.8-1.8,1,1-1.2,1-2.3,1-3,1-5,1.5-2,1.5-2.2,12-45,2,2-3.5,2/3,3-5-15,4-5,acuminate,acute,attenuate,axillary,berry,brown,c,cm,conical,densely,diameter,elliptic,flattened,glabrous,globose,green,greenish,lobed,long,lower,minutely,mm,obovate,ovoid-reniform,papillate,papillose,poricidal,pubescent,red-papillate,round,shrub,simple,tip,x	5-7,clavate,perennial
27	wfo-0001026203	success	197	101	58	78	119	23	56	2	0-39,0.06-0.86,0.3-11,0.38-11.3,0.4-3,0.5-2.3,0.5-3.2,0.7-2.6,1-13,1-2,1-9,1.1-7.9,1.2-5.5,2-10,2-4.9,2-5,2-8.5,3-10,3-11,3.2-23,7-47,anther,berry,blue,clavate,cm,coriaceous,corolla,dark,deep,diameter,elliptic,filament,flower,fruit,glabrescent,glabrous,globose,green,greenish,hair,herb,homostylous,interjected,lanceolate,lateral,leaf,leaflet,light,lilac,lobe,long,medium,mm,moniliform,mucilaginous,odd-pinnate,ovate,ovoid,pedicel,peduncle,pentagonal,petiole,plant,rotate,seed,short,size,stigma,style,subglabrous,terminal,tube,tuber,unwinged,whitish,wide,x	0-7,0.3-6,1-4,1-5,2-43,2.2-13.3,3-5,3.2-22,5-merou,abaxially,acumen,acuminate,acute,adaxially,ag,along,alyx,apart,apex,apparently,arranged,articulated,asymmetric,attenuate,axe,axillary,base,basiscopic,bead,blade,brownish,bud,capitat,cell,condition,connivent,covering,decreasing,decurrent,digestion,distal,dorsally,drying,eaf,edge,eed,enzyme,erect,exceeding,flat,folded,forked,fresh,geminat,generally,glabrescen,glabrou,green-white,hair-like,hal,half,high,honeycomb-shaped,lengthening,like,linear,living,lower,make,middle,multiple,necklace,nflorescence,orbicular,orolla,pair,perfect,plurifoliate,pore,poricidal,rachi,removed,ripe,rosett,rounded,ruit,sessile,seudostipule,side,slightly,slit,sometimes,spaced,specimen,stamen,stolon,straight,stripe,subequal,subtending,tall,tamen,tem,testal,thick,throughout,tip,tissue,toward,tri-,typically,unit,usually,vary,wall,wet,white,yellow,ympodial	5-merous,abaxial,adaxial,arrangement,calyx,capitate,characteristic,colour,form,growth,height,history,inflorescence,length,life,ovary,pseudostipule,shape,staman,stem,surface,texture,type	0-39,0.06-0.86,0.3-11,0.38-11.3,0.4-3,0.5-2.3,0.5-3.2,0.7-2.6,1-13,1-2,1-9,1.1-7.9,1.2-5.5,2-10,2-4.9,2-5,2-8.5,3-10,3-11,3.2-23,7-47,berry,blue,clavate,cm,coriaceous,dark,deep,elliptic,glabrescent,glabrous,globose,green,greenish,hair,herb,homostylous,lanceolate,light,lilac,long,medium,mm,moniliform,mucilaginous,odd-pinnate,ovate,ovoid,pentagonal,rotate,short,subglabrous,unwinged,whitish,wide,x	5-merous,capitate
28	wfo-0001026208	success	210	119	76	90	120	29	71	5	.5,/3,0.5-0.8,0.5-1.2,0.6-0.8,0.6-0.9,0.7-2,0.8-1.3,0.8-1.5,1-5,1.8-2.3,1.8-2.5,2.5-6,4-7,5-17,acuminate,acute,anther,apex,apparently,bark,base,berry,bright,calyx,chartaceous,cm,cuneate,dark,deltate,densely,diameter,dull,elliptic,erect,evenly,filament,flattened-reniform,fruit,fruiting,glabrous,gray-greenish,green,green-brown,lateral,leaf,length,lobed,long,lower,margin,maturity,mauve,membranous,mm,moderately,orange,orange-brown,ovate,pair,pale,pedicel,peduncle,petiole,poricidal,prickly,primary,recurved,red,rounded,shrub,sometimes,somewhat,spherical,stellate,stellate-pubescent,stem,style,surface,tapering,terminal,tip,tube,unarmed,vein,way,white,wide,yellow,young	0-20,0-4,0-5,0-8,0.1,0.1-0.2,0.1-0.25,0.1-0.3,1-2,1-4,1.5,1.5-2.5,1/3,1/3-1/2,1/4-1/3,1/4-1/6,2,2-20,2-3,2-4,2.5-5,3-30,3-5,3-6,3.5-5,3/,4-9,5,5-10,5-11-25,5-22,5-merous,6-22,6-8,abaxial,abaxially,acut,adaxial,alyx,apar,apart,apically,articulated,becoming,blade,branched,broad-deltate,brown,conical,connivent,curved,difoliate,discolorous,distance,drying,eaf,eed,elongated,elongating,equal,extending,flattened,flower,free,geminat,geminate,glabrescent,infructescence,lobe,longer,mature,midpoint,midvein,nflorescence,older,one,open,orolla,oung,pendulous,per,perfec,pericarp,porrect,portion,prickle,pubescent,ray,red-brow,ruit,scar,sessile,shorter,side,slender,smooth,spaced,sparsely,spreading,stalk,stalked,stout,straight,straw-yellow,subentire,tamen,terete,tertiary,time,toward,trichome,unarme,unit,usually,variously,vary,venation,visible,woody,ympodial	11-25,3/4,arrangement,branch,bud,characteristic,colour,corolla,exertion,form,glabrousnes,growth,height,history,inflorescence,life,lobing,na,new,ovary,perennial,plant,red-brown,seed,shape,size,stigma,texture,type	.5,/3,0.5-0.8,0.5-1.2,0.6-0.8,0.6-0.9,0.7-2,0.8-1.3,0.8-1.5,1-5,1.8-2.3,1.8-2.5,2.5-6,4-7,5-17,acuminate,acute,apparently,base,berry,bright,chartaceous,cm,cuneate,dark,deltate,densely,diameter,dull,elliptic,erect,evenly,flattened-reniform,glabrous,gray-greenish,green,green-brown,lateral,lobed,long,lower,maturity,mauve,membranous,mm,moderately,orange,orange-brown,ovate,pair,pale,poricidal,prickly,recurved,red,rounded,shrub,sometimes,somewhat,spherical,stellate,stellate-pubescent,tapering,terminal,tip,unarmed,way,white,wide,yellow,young	11-25,3/4,na,perennial,red-brown
29	wfo-0001026215	success	150	130	96	107	43	23	92	4	-3,.05,.5,0,0.5-1,1-3,1.5,1.5-2,1.5-2.2,13-35,2-3,2-3.5,2-4,3/4,4-15,4-5,7-8,abruptly,absent,acuminate,along,anther,anthesi,anticlinal,apex,base,beak,berry,broadly,brown,calyx,cell,clavate,cm,completely,conical,conspicuously,corolla,deltate,densely,diameter,elliptic,enlarged,entire,epidermal,erect,filament,flattened-round,fruit,fruiting,glabrous,green,greenish,herb,highly,horizontal,internode,irregular,kink,length,lobe,lobed,long,marked,markedly,mm,narrowing,nearly,nodding,occasionally,often,ovary,ovoid-reniform,papillae,papillate,pedicel,per,petiole,poricidal,portion,projection,purple,raised,red-papillose,reflexed,rounded,rugose,seed,shrub,simple,sinuous,stem,stigma,strongly,style,surface,thickening,tip,tube,usually,way,white,white-lenticellate,white-pubescent,winged,without,x	0.05,1,15-2,18-20,2,abaxially,ape,axil,axillary,bifi,continually,eaf,edicel,eed,exserted,flower,free,globose,less,lower,minutely,nflorescence,noddin,onto,pair,papillat,primary,ruit,scar,shortsympodial,single-stemmed,small,ste,tal,tem,time,tub,ud,unifoliat,unit,vein,wide,wing	abaxial,arrangement,bifid,colour,form,glabrousnes,growth,height,inflorescence,leaf,lenticellate,lobing,number,plant,pubescent,reflexion,shape,short,size,tall,texture,type,unifoliate	-3,.05,.5,0,0.5-1,1-3,1.5,1.5-2,1.5-2.2,13-35,2-3,2-3.5,2-4,3/4,4-15,4-5,7-8,abruptly,absent,acuminate,along,anthesi,anticlinal,apex,base,berry,broadly,brown,clavate,cm,completely,conical,conspicuously,deltate,densely,diameter,elliptic,enlarged,entire,erect,flattened-round,fruit,glabrous,green,greenish,herb,highly,horizontal,irregular,kink,length,lobe,lobed,long,marked,markedly,mm,narrowing,nearly,nodding,occasionally,often,ovoid-reniform,papillae,papillate,per,poricidal,portion,projection,purple,raised,red-papillose,reflexed,rounded,rugose,seed,shrub,simple,sinuous,stem,strongly,surface,thickening,tip,usually,way,white,white-lenticellate,white-pubescent,winged,without,x	bifid,short,tall,unifoliate
30	wfo-0001026229	success	299	115	77	86	213	29	67	10	1,35,5,acute,anther,apex,asymmetric,attenuate-caudate,base,beneath,berry,black,brown,calyx,clavate,cm,corolla,cuneate,cyme,dark,densely,developed,diameter,elliptic,elongated,entire,even,flattened,flower,fruit,fully,glabrescent,glabrous,globose,golden,green,growth,hirsute,hispid,immature,included,inflorescence,irregular,lanceolate,leaf,lobe,long,margin,mature,membranaceous,mm,moderately,narrow-ovate,narrowly,nearly,new,oblong,ovate-elliptic,pale,pedicel,peduncle,per,petiole,pit,pubescent,purple,reniform,revolute,rounded,shiny,shrub,simple,size,slightly,small,stem,stigma,style,surface,tree,tube,type,unbranched,white,wide,Â¾	0.1â1.47,0.2â0.8,0.35,0.3â0.9,0.3â1.2,0.4,0.8â1.2,0.8â2,0.9,0.9â4.3,1-celled,1.2â4.8,1.3â1.5,1.3â1.7,1.4,1.7â11.8,1.7â2.3,1.8,1.8â5.5,1.9â2.5,1/3,13,1â1.4,1â2,1â4,2,2.3â3.4,2.8â4,2â3,2â3-celled,2â4-celled,3,3â4,3â5,4.5â6.5,4â6,5-merou,5â9,6â15,6â7,6â8,8.6â12,8â10,9â31,abaxial,abaxially,accrescent,acuminate,adaxial,adaxiall,adaxially,ag,almost,also,always,alyx,anthesi,ark,articulated,associated,axe,ba,barely,blade,branch,branching,broadly,broken,camptodromous,capitate,celled,central,changing,commentary,commonly,completely,concentrated,connivent,cordate,covered,creating,cylindrical,deltoid,develope,differing,directed,discolorous,diÂ­,dried,drying,eaf,eed,eglandular,ellipsoidal,faces,few-rayed,found,free,frequently,fresh,geminate,gland,glandular,glandular-capitate,hair,head,hyaline,ilament,impressed,insertion,internodal,introrsely,involute,lamina,larger,lateral,less,like,lobed,long-stalked,longer,longitudinal,lower,mainly,material,maturit,midpoint,midri,midvein,minute,mixed,much,multangulate,multangulate-stellate,multiseriate,near,nflorescence,often,old,older,one,open,opening,orientation,orolla,other,oung,ovate,pair,paired,papillose,pedunculate,perfect,pink,plurifoliate,point,poorly,pore,poricidal,porrect-stellate,portion,primary,purplish,ra,rachi,raised,rarely,ray,remnant,ruit,secondary,see,sessile,shin,short-,short-stalked,shorter,slit,smaller,solitary,sometimes,somewhat,sparsely,spread,spreadin,spreading,stalk,stellate,strongly,subopposite,subsessile,supported,surfac,terminal,three,trichome,trifoliate,tuft,ud,unequal,unit,upper,usually,vary,vein,venation,vestiture,visible,weakly,whitish-green,yellow,yellowish-white,ympodial	0.3-1.2,0.35-4.3,1-1.4,1.3-1.7,1.7-2.3,1.8-5.5,1.9-2.5,2.3-3.4,6-7,9-31,arrangement,bud,characteristic,colour,exertion,filament,form,glabrousnes,height,history,length,life,lobing,number,ovary,plant,seed,shape,texture	1,35,5,acute,asymmetric,attenuate-caudate,base,beneath,berry,black,brown,calyx,clavate,cm,cuneate,cyme,dark,densely,developed,diameter,elliptic,elongated,entire,even,flattened,flower,fruit,fully,glabrescent,glabrous,globose,golden,green,hirsute,hispid,immature,included,irregular,lanceolate,lobe,long,mature,membranaceous,mm,moderately,narrow-ovate,narrowly,nearly,oblong,ovate-elliptic,pale,pit,pubescent,purple,reniform,revolute,rounded,shiny,shrub,simple,slightly,small,tree,unbranched,white,wide,Â¾	0.3-1.2,0.35-4.3,1-1.4,1.3-1.7,1.7-2.3,1.8-5.5,1.9-2.5,2.3-3.4,6-7,9-31
31	wfo-0001026230	success	144	90	63	70	74	20	59	4	.5,.8,0.3-1.5,0.75-1,0.9-2,1-1.4,1.1-1.8,1.8-2.3,12.6-20.8,2-4,3-4,4.6-9.3,5-20-flowered,anisomorphic,anther,anthesi,area,bark,base,berry,bud,calyx,cm,corolla,dia,distal,elliptic,erect,except,fruit,fruiting,glabrous,globose,green,grey,immature,leaf,lobe,long,long-acuminate,minutely,mm,older,opposite,ovary,papillose,pedicel,petiole,reflexed,rusty-papillose,shaped,shrub,simple,slender,small,stem,stigma,strongly,style,surface,tapering,tear-drop,tip,tree,tube,umbonate,white,woody,x,young	.25,0.5-3,1-1.5,1-4,1.9-4.1,2-5,5-10,acuminate,acute,anisophyllou,apart,apex,apiculate,appears,back,beginning,beneath,broadly,clavate,clu,completely,cordate,coroll,deflexed,deltoid,difoliate,eaf,edicel,eed,enclosing,evenly,filament,free,geminate,inflorescenc,large,lateral,lobed,lon,long-triangular,lower,main,major,margin,middle,minor,nearly,nflorescence,obtuse,orbicular,ovoid,pair,pointed,pore,poricidal,portion,raised,rounded,ruit,scar,sinus,slightly,spaced,straight,tall,thickened,ud,unit,unknown,vein,white-lenticellat,widest,winged,ympodial	arrangement,characteristic,club,colour,diameter,exertion,form,growth,height,inflorescence,length,na,number,per,plant,seed,shape,size,texture,type	.5,.8,0.3-1.5,0.75-1,0.9-2,1-1.4,1.1-1.8,12.6-20.8,2-4,3-4,4.6-9.3,5-20-flowered,anisomorphic,anthesi,area,base,berry,bud,calyx,cm,dia,distal,elliptic,erect,except,fruit,glabrous,globose,green,grey,immature,leaf,long,long-acuminate,minutely,mm,older,opposite,papillose,reflexed,rusty-papillose,shaped,shrub,simple,slender,small,stem,strongly,surface,tapering,tear-drop,tip,tree,tube,umbonate,white,woody,x,young	.8-2.3,club,di,na
32	wfo-0001026233	success	157	100	61	71	86	29	59	2	.25,0.7-0.8-1,0.8-1.55-1.9,0.8-4,1-,1.1,1/2,2-,2.1,2.3-7,2.6,2/3,3.5-4.5-5.5,5-30-50,6,acute,annual,anther,apex,ascending,basal,bearing,berry,broadly,calyx,capitate,cm,conspicuous,densely,diameter,ellipsoidal,elliptic,entire,few-,filament,glabrous,globose,herb,herbaceous,leaf,less,lilac,longitudinally,margin,mm,moderately,narrowly,non-glandular,ovate,pale,petiole,pinnatisect,present,protuberance,pubescent,ridged,seed,simple,slender,sparsely,stigma,style,subglobose,surface,trans-ovoidal,trichome,tube,tuberculate,winged,x,yellow	.75,0.3,0.5,0.7-0.8-1.3,1,1.2-2.7,1.5,2,2.4-3.5-3.8,3.2-3.7,3.2-4.7,4-5-6.2-8.1,abundant,accrescent,ag,annular,antrorse,articulated,base,campanulate,coat,cuneate-attenuate,curved,cylindrical,difoliat,dimorphic,eaf,eed,embryo,evident,fruiting,hair,hig,interlobular,investing,lamina,larger,lobe,lobed,long,longitudinal,lower,membrane,minutely,multicellular,near,obtuse,occasionally,opening,orolla,other,outer,ovule,papery-scarious,partially,pinnatipartite,pore,poricidal,portion,pubescen,ree,reticulate,rounded,ruit,scarcely,seede,serrate,shorter,slightly,slit,small,smaller,striate,strongly,styl,tem,tip,unequal,unifoliate,uniseriate,unit,vary,venatio,verrucose,wider,ympodial	arrangement,bud,characteristic,colour,corolla,dimorphism,exertion,form,fruit,growth,height,history,inflorescence,length,life,lobing,na,number,ovary,pedicel,peduncle,per,plant,seeded,shape,size,stem,texture,type	.25,0.7-0.8-1,0.8-1.55-1.9,0.8-4,1-,1.1,1/2,2-,2.1,2.3-7,2.6,2/3,3.5-4.5-5.5,5-30-50,6,acute,annual,ascending,basal,bearing,berry,broadly,capitate,cm,conspicuous,densely,diameter,ellipsoidal,elliptic,entire,few-,glabrous,globose,herb,herbaceous,less,lilac,longitudinally,mm,moderately,narrowly,non-glandular,ovate,pale,pinnatisect,present,protuberance,pubescent,ridged,simple,slender,sparsely,subglobose,trans-ovoidal,trichome,tuberculate,winged,x,yellow	na,seeded
33	wfo-0001026241	success	220	136	91	96	124	40	75	16	.5,10-20,109,2-flowered,abaxially,adaxially,anther,apex,appearing,appears,base,basiscopically,berry,black,branching,brown,calyx,capitate,cell,cm,conical,cordate,corolla,covered,cup,densely,depressed-globose,dia,dry,drying,entire,erect,erose,et,extended,filament,fruit,fruiting,galiano,glabrous,glandular-pubescent,globose,herb,inflorescence,internodal,irregularly,leaf,lobed,margin,mm,near,oblique,open,orangish,outline,ovary,ovate,ovoid,papillate,pedicel,peduncle,per,perennial,petiole,pinnatifid,pitted,pubescent,pulp,rachi,remain,reniform,robust,seed,shallowly,sinuate,slightly,somewhat,stellate,stem,stigma,stout,style,subshrub,surface,ternate,testa,thickened,triangular,truncate,tube,tuberculate,usually,vein,way,white,x	.2,.3,0.1â0.15,0.2â,0.3â,0.3â0.4,0.3â0.6,0.3â1,0.5,0.5â0.7,0.5â0.8,0.5â1,0.7â1.1,1-,1-celled,1.2â1.5,1.2â2,1.5â1.7,1.5â2.5,1.5â3.5,1.9â2.1,1/3â1/2,1â,1â1.1,1â1.4,1â1.5,1â2,2.5â3,2â2.1,2â3,3,3-,30â50,3â3.1,4-,4.5â5,5,5-celled,5-merous,6,always,anthesi,apical,articulated,attenuate,ba,basal,beak,brittle,broader,campanulate,center,connecting,curved,curving,darker,decurrent,deflexe,dehiscing,deltate,denser,difoliate,discrete,dwarf,eaf,eglandular,elliptic,enclosed,equal,flower,foliat,foliose,free,geminate,gland,glandular,intially,larger,lateral,leaflet,like,lobe,lon,long,longitudinal,main,midvein,mixture,much,nflorescence,one,onto,papillat,perfect,pericarp,pore,portion,prolonged,pubescen,ruit,shiny,simple,slit,small,smaller,sometimes,spatulate,stamen,strongly,succulent,sulcate,taproot,terminal,thick,tip,tissue,trichome,ud,uniseriate,unit,wide,wing,woody,ympodial	0.1-0.15,0.5-0.7,1-1.1,1-1.4,1-2,1-2.5,1-3.5,1.2-1.5,1.5-1.7,1.9-2.1,1/3-1/2,3-3.1,30-50,4.5-5,arrangement,branch,bud,characteristic,colour,corrugation,decurrenct,diameter,exertion,form,glabrousnes,growth,height,history,length,life,lobing,na,new,number,plant,primary,shape,size,texture,type	.5,10-20,109,2-flowered,abaxially,adaxially,appearing,appears,base,basiscopically,berry,black,branching,brown,capitate,cell,cm,conical,cordate,covered,cup,densely,depressed-globose,dia,dry,entire,erect,erose,et,extended,fruit,galiano,glabrous,glandular-pubescent,globose,herb,internodal,irregularly,lobed,mm,near,oblique,open,orangish,outline,ovate,ovoid,papillate,per,perennial,pinnatifid,pitted,pubescent,pulp,rachi,remain,reniform,robust,shallowly,sinuate,slightly,somewhat,stellate,stout,subshrub,ternate,testa,thickened,triangular,truncate,tuberculate,usually,way,white,x	0.1-0.15,0.5-0.7,1-1.1,1-1.4,1-2,1-2.5,1-3.5,1.2-1.5,1.5-1.7,1.9-2.1,1/3-1/2,3-3.1,30-50,4.5-5,decurrenct,na
34	wfo-0001026242	success	205	140	100	115	90	25	97	3	-1.5,-6,/4,0-2,0.3-0.5,0.4-0.5,0.4-2,0.5-0.7,0.5-1,0.55-0.9,0.7-1.3,1-1.5,1-2.5,1-3,1.2-2,1.5-3,1.5-4,1/5-1/3,10-20,2-2.5,2.5-2.8,3-6.5,4.5-5.5,5-7,6.5-8,7-17,abaxially,acute,anther,apex,apically,apparently,articulated,bark,base,berry,branched,bright,broad-deltate,calyx,cm,concolorous,cuneate,deltate,densely,diameter,distance,drying,dull,elliptic,erect,evenly,extending,filament,flattened-reniform,flower,fruit,fruiting,glabrescent,glabrous,green,irregularly,lateral,leaf,length,lobe,lobed,long,margin,maturity,membranous,midvein,mm,moderately,narrow-deltate,obtuse,one,open,orange-brown,pair,pedicel,peduncle,petiole,poricidal,prickle,prickly,primary,recurved,red,red-brown,reflexed,rounded,shrub,side,sometimes,sparsely,spherical,spreading,stellate-pubescent,stem,style,surface,tapering,terete,time,tip,tube,unarmed,vein,way,weakly,white,wide,yellow,young	0,0-5,0.05-0.2,0.1,0.35-0.4-0.55-0.9,0.5,0.7,1/2,1/6-1/4,10-30-80,2-5,2.5-4.5,4-10,4-13,4-5-merous,5-18,5-8-20,abaxial,acut,almost,alyx,ame,apar,apart,blade,c.,connivent,curved,difoliate,eaf,eed,elongating,equal,eye,filiform,flattened,free,geminat,glabrou,glandular,green-gra,hair,infructescence,largely,longer,lower,mature,midpoint,minute,multangulate,naked,nflorescence,occasionally,older,orolla,oung,pale,pale-brown,per,perfec,pericarp,porrect,portion,prickl,ray,ruit,scar,sessile,shorte,shorter,simple,smooth,spaced,stalk,stalked,stellate,straight,subentire,tamen,tertiary,trichome,unarme,unit,upper,variously,vary,venation,visible,woody,ympodial	0.35-0.55-0.9,arrangement,branch,bud,characteristic,colour,corolla,exertion,form,glabrousnes,green-gray,growth,height,inflorescence,lobing,na,new,ovary,plant,seed,shape,size,stigma,texture,type	-1.5,-6,/4,0-2,0.3-0.5,0.4-0.5,0.4-2,0.5-0.7,0.5-1,0.55-0.9,0.7-1.3,1-1.5,1-2.5,1-3,1.2-2,1.5-3,1.5-4,1/5-1/3,10-20,2-2.5,2.5-2.8,3-6.5,4.5-5.5,5-7,6.5-8,7-17,abaxially,acute,apically,apparently,articulated,base,berry,branched,bright,broad-deltate,cm,concolorous,cuneate,deltate,densely,diameter,distance,drying,dull,elliptic,erect,evenly,extending,flattened-reniform,flower,glabrescent,glabrous,green,irregularly,lateral,lobe,lobed,long,maturity,membranous,midvein,mm,moderately,narrow-deltate,obtuse,one,open,orange-brown,pair,poricidal,prickle,prickly,recurved,red,red-brown,reflexed,rounded,shrub,side,sometimes,sparsely,spherical,spreading,stellate-pubescent,surface,tapering,terete,time,tip,unarmed,way,weakly,white,wide,yellow,young	0.35-0.55-0.9,green-gray,na
35	wfo-0001026259	success	233	133	94	111	122	22	92	2	.1,.7,0.3â1.2,0.4â0.6,1.0â1.2,1.0â3.3,1.2â8.4,1.4â4.0,1.5,11â22,12â24,1m,2-ridged,2â17,35â45,6,7â10,8â11,acuminate,acute,anther,anthesi,apex,base,becoming,berry,branch,branching,broadly,brown,calyx,central,cm,concave-reniform,conical-ellipsoid,corolla,cream-coloured,cylindrical,decurrent,deltate,densely,diameter,ellipsoid,entire,exerted,filament,fruit,fruiting,glabrous,globose,green,green-orange,halfway,herb,inflorescence,internodal,lateral,leaf,length,less,lilac,long,margin,minutely,mm,much,nearly,often,once-branched,ovary,ovate-lanceolate,pair,papillate,pedicel,peduncle,per,petiole,plant,primary,pubescent,purple,purple-coloured,rarely,recurving,ripe,rounded,shiny,simple,slightly,smooth,sparsely,spreading,star,stem,stigma,straight,strongly,style,surface,tinged,translucent,tube,turning,vein,white,wide,winged,woody,yellow,yellow-green,young	.8,0.1â0.2,0.2â0.4,0.5,0.5â0.6,0.7â0.9,0404,0â2,1,1-celled,1.5â2.0,1â2,1â2-celled,1â3-celled,2/3,2â3-celled,3.0â3.4,4â5,5-merous,5â14,5â7-celled,?,abaxial,abaxially,adaxial,adaxially,affected,age,apar,appressed,arising,beyond,branched,cell,close,coloured,cone,congested,dehiscing,difoliate,drop,eaf,eed,elongating,end,especially,et,fleshy,flower,free,geminat,gradually,growt,hilum,individual,knapp,larger,leave,lengthening,like,live,lobe,lobed,lon,longer,lower,lowermost,membranous,narrower,narrowly,near,nflorescence,node,occasionally,one,outline,pale,pathogen,pentagonal,perfect,pericarp,pore,poricidal,portion,positioned,purple-black,rachi,reduced,reflexed,relatively,remaining,ruit,scar,short,shorter,shrub,similar,slit,sometimes,somewhat,spaced,splitting,stellate,stone,stout,sub-laterally,tall,tapering,tem,testal,thick,tightly,tip,together,toward,trichome,two,ud,uniseriate,unit,ympodial,â15	arrangement,bark,bud,characteristic,colour,exertion,form,glabrousnes,growth,height,history,life,lobing,new,number,perennial,seed,shape,size,sparingly,texture,type	.1,.7,0.3â1.2,0.4â0.6,1.0â1.2,1.0â3.3,1.2â8.4,1.4â4.0,1.5,11â22,12â24,1m,2-ridged,2â17,35â45,6,7â10,8â11,acuminate,acute,anthesi,apex,base,becoming,berry,branching,broadly,brown,calyx,central,cm,concave-reniform,conical-ellipsoid,cream-coloured,cylindrical,decurrent,deltate,densely,diameter,ellipsoid,entire,exerted,fruit,glabrous,globose,green,green-orange,halfway,herb,internodal,lateral,less,lilac,long,minutely,mm,much,nearly,often,once-branched,ovate-lanceolate,pair,papillate,per,petiole,pubescent,purple,purple-coloured,rarely,recurving,ripe,rounded,shiny,simple,slightly,smooth,sparsely,spreading,star,straight,strongly,tinged,translucent,tube,turning,white,wide,winged,woody,yellow,yellow-green,young	perennial,sparingly
36	wfo-0001026267	success	162	115	79	93	69	22	78	1	.25,.5,0.6-1.7,0.7-1.1,1-1.2,1-2.6,1.5-2,1.5-2.3,2.5-3,20-30-flowered,3-15,5-7,acuminate,acute,anther,apex,attenuate,axil,bark,base,beneath,berry,blackish,bright,calyx,cm,corolla,crateriform,cuneate,dia,distally,drying,except,exerted,filament,flattened-reniform,fruiting,glabrous,globose,green,greenish-white,lateral,lavender,leaf,lobed,long,main,middle,minutely,mm,narrowly,nearly,occasionally,often,ovary,ovate,papillose,pedicel,petiole,pitted,pore,poricidal,ripening,rough,scattered,shaped,shrub,simple,size,slender,slightly,small,soon,stem,stigma,straight,style,surface,tan,tapering,tear-drop,tinge,tip,tree,trichome,tube,tuft,uniseriate,vein,white,widest,x,yellow-green	0.1-1,0.5-1,1-1.5,1-4,3-6.1,3.2-8.6,4-8,8-10,8.5-15,anthesi,ba,beginning,body,broadly,closely,decurrent,deflexed,densely,depressed,differing,difoliate,distinct,eaf,edicel,eed,free,geminat,greyish-green,hard,incrassate,inflorescenc,larger,lobe,lon,longinflorescence,lower,major,margin,maturity,minor,older,one,opposite,overlapping,pair,pale,papillo,pitting,portion,pubescent,quickly,raised,reflexed,remaining,ruit,scar,scarious,softening,spaced,sparsely,tall,triangular,ud,unit,wing,winged,woody,ympodial,young	arrangement,characteristic,colour,diameter,exertion,form,fruit,growth,height,history,inflorescence,length,life,lobing,na,number,per,plant,seed,shape,texture,type	.25,.5,0.6-1.7,0.7-1.1,1-1.2,1-2.6,1.5-2,1.5-2.3,2.5-3,20-30-flowered,3-15,5-7,acuminate,acute,attenuate,axil,base,beneath,berry,blackish,bright,calyx,cm,crateriform,cuneate,dia,distally,drying,except,exerted,flattened-reniform,glabrous,globose,green,greenish-white,lateral,lavender,lobed,long,main,middle,minutely,mm,narrowly,nearly,occasionally,often,ovate,papillose,pitted,pore,poricidal,ripening,rough,scattered,shaped,shrub,simple,slender,slightly,small,soon,straight,tan,tapering,tear-drop,tinge,tip,tree,trichome,tube,tuft,uniseriate,vein,white,widest,x,yellow-green	na
37	wfo-0001026279	success	244	124	85	102	142	22	83	2	0.2-0.4,0.8-2.3,0.9-1,1-10,1-3.5,1.1-1.9,11.5-19.7-34.3,2.6-4.8,3-4,3.4-5.2-5.9,4-7.5,8,abaxially,acuminate,adaxially,anther,anthesi,apex,attenuate,base,berry,black,blunt-tipped,branch,branched,brown,bud,calyx,capitate,cm,conical,corolla,cuneate,dark,deltoid,diameter,drying,elliptic,elongated,entire,exerted,filament,fleshy,flower,fruit,fruiting,glabrescent,glabrous,globose,granular,grayish,grayish-green,green,immature,lanceolate,lavender,leaf,length,lilac,long,many,margin,mature,mm,narrowly,oblong,obovate,occasionally,orbicular,ovate-lanceolate,pale,pedicel,peduncle,petiole,plant,pubescence,reticulate-punctate,rounded,scabridulous,scabrous,scattered,short,shrub,simple,slowly,stem,stigma,style,suborbicular,sulcate,surface,time,tomentose,tomentose-pubescent,tree,tube,unarmed,white,whitish,x,yellowish,yellowish-tan	-4,/14-1/8,0.25-0.4,0.9-1.8-2.9,1-1.4,1.1-1.6,1.5-1.8,1.5-3,1.7-2.3,1.9-3,1.9-3.2,1/2,14-27,2.4-3.2,2.5-3.2,2/3,3.1-3.6,3.1-4.2,3.5-7.8,3.8-5.1,5-200,5-8,8-11,8.5-10.5-11.4,9-22,accrescent,acute,adaxiall,ag,apart,apparently,appearing,appressed,ark,around,articulated,axe,axillary,ba,blade,chartaceous,closely,completely,covering,cylindrical,dendritic-echinoi,dendritic-echinoid,dense,directed,distally,due,eaf,earl,echinoi,echinoid,edge,eed,enveloping,equal,evident,expanded,farinose,few-rayed,free,glabrescen,hair,half,inserted,lateral,lengthening,lobe,lobed,long-stalked,longer,longitudinal,longitudinall,lower,m.,main,midrib,minute,mixed,multangulate,multangulate-pubescent,multiseriate,nflorescence,occasional,often,older,open,orolla,overlapping,partly,perfect,plurifoliate,pore,poricidal,porrect-stellate,present,prominent,pseudo-terminal,rachi,ruit,secondary,semi-ovate,sessile,short-,short-decurrent,short-stalked,side,slightly,slit,somewhat,spaced,splitting,stalk,stamen,stellate,subcampanulate,subcoriaceous,subsessile,suture,tall,tamen,tertiary,thickened,thin,thin-stalked,tip,ud,unarme,unit,unwinged,upper,usually,vary,vein,way,wide,yellow,ympodial,young	arrangement,bark,characteristic,colour,exertion,form,glabrousnes,growth,height,history,inflorescence,life,lobing,longitudinally,new,ovary,pseud-terminal,seed,shape,size,texture,type	0.2-0.4,0.8-2.3,0.9-1,1-10,1-3.5,1.1-1.9,11.5-19.7-34.3,2.6-4.8,3-4,3.4-5.2-5.9,4-7.5,8,abaxially,acuminate,adaxially,anthesi,apex,attenuate,berry,black,blunt-tipped,branched,brown,calyx,capitate,cm,conical,cuneate,dark,deltoid,diameter,drying,elliptic,elongated,entire,exerted,fleshy,flower,fruit,glabrescent,glabrous,globose,granular,grayish,grayish-green,green,immature,lanceolate,lavender,lilac,long,many,mature,mm,narrowly,oblong,obovate,occasionally,orbicular,ovate-lanceolate,pale,pubescence,reticulate-punctate,rounded,scabridulous,scabrous,scattered,short,shrub,simple,slowly,suborbicular,sulcate,time,tomentose,tomentose-pubescent,tree,unarmed,white,whitish,x,yellowish,yellowish-tan	longitudinally,pseud-terminal
38	wfo-0001026299	success	236	157	99	121	115	36	96	3	-10,0-8,0.1-0.4,0.1-0.5,0.2-0.25,0.25-0.5,0.4-0.5,0.5-0.6,0.5-0.6-0.8,0.5-1,0.5-2.5-3.5,0.8-1,0.9-1,1,1-1.4,1.1-1.7,1.2-1.6,1.5-2.3,1.8-2,2.2-3.2,2.5-7,5-20,6-20,acute,almost,anther,anthesi,apex,appearance,approximately,articulated,basal,base,beneath,broadly,brown,calyx,capitate,cell,change,cm,conical,corolla,could,crenate-serrate,dark,densely,diameter,distal,elliptic,entire,exserted,filament,flower,fruit,fruiting,glabrous,glandular,globose,green,hair-like,half,herb,imparipinnate,inflorescence,interjected,interrupted,irregularly,lanceolate,lateral,leaf,leaflet,lobe,lobed,long,margin,maturity,middle,minute,minutely,mm,obovate,outgrowth,ovary,pale,pedicel,peduncle,pentagonal,perennial,petiole,primary,pseudostipule,pubescent,purple,regularly,short,silky,simple,size,sparsely,stem,stigma,straight,stripe,style,surface,terminal,testa,thick,tip,trichome,truncate,tube,variously,vein,velvety,wall,way,white,wide,yellow	--,-2.5,.5,0.1-0.2,0.1-0.2-1,0.1-0.25,0.1-0.4-1,0.15-0.2,0.2-1,0.3-0.4,0.4-2,0.5,0.5-0.7,0.6-2,0.7-3.5-5,0.8-0.9,1-celled,1.2-5,1.5-3.5-10,2-4,2-6,2-foliate,2-locular,2.5,25,3-5-15,5,7-12,abaxially,absent,abundant,acroscopically,adaxially,along,angled,apical,appendage,axi,basiscopically,berr,bract,bracteate,chota,column,crenat,decurrent,developed,diamete,eaf,ebracteate,edicel,eed,eglandular,erect,give,gree,hal,head,intermixed,internode,investing,jequetepeque,lacking,larger,less,like,lon,long-acuminate,longer,loosely,lower,maraÃ±Ã³n,mixture,multicellular,narrowly,nearly,nflorescence,node,oblique,occasionally,often,pair,patent,petiolule,population,present,prostrate,pubescence,rachi,reflexed,rest,ruit,scarcely,scattered,secondary,sessile,sparse,spreading,staminal,sterile,stout,tall,tem,tertiary,toward,ud,unicellular,uniseriate,unit,usually,valley,weak-walled,winged,woody,ympodial	1.5-10,arrangement,bark,berry,border,branch,bud,characteristic,colour,corrugation,drying,exertion,form,giving,glabrousnes,growth,height,history,length,life,lobing,midpoint,na,new,number,per,plant,prickle,ray,seed,shape,texture,thicknes,type,variation,width	-10,0-8,0.1-0.4,0.1-0.5,0.2-0.25,0.25-0.5,0.4-0.5,0.5-0.6,0.5-0.6-0.8,0.5-1,0.5-2.5-3.5,0.8-1,0.9-1,1,1-1.4,1.1-1.7,1.2-1.6,1.5-2.3,1.8-2,2.2-3.2,2.5-7,5-20,6-20,acute,almost,anthesi,apex,approximately,articulated,basal,base,beneath,broadly,brown,calyx,capitate,cell,change,cm,conical,could,crenate-serrate,dark,densely,diameter,distal,elliptic,entire,exserted,flower,glabrous,glandular,globose,green,hair-like,half,herb,imparipinnate,interrupted,irregularly,lanceolate,lateral,lobed,long,margin,maturity,middle,minute,minutely,mm,obovate,outgrowth,pale,pentagonal,perennial,pubescent,purple,regularly,short,silky,simple,sparsely,straight,stripe,testa,thick,tip,trichome,truncate,variously,velvety,wall,way,white,wide,yellow	1.5-10,berry,na
39	wfo-0001026305	success	135	95	65	76	59	19	63	2	.25,/4,0.2-1,0.25-0.5,0.5-2,0.6-1,0.7-1,1-1.5,1.3-1.5,2-6-flowered,3-8.5,5-7,6-9,7-16,abaxial,acute,anther,apex,area,attenuate,base,beige-tan,berry,calyx,cm,congested,corolla,deflexed,dendritic,densely,dia,elliptic,exserted,filament,fruiting,glabrate,glabrous,globose,green,greenish-white,leaf,leaf-opposed,like,lobed,long,minute,minutely,mm,ovary,ovoid-reniform,pale,papillose,pedicel,petiole,pitted,pore,poricidal,pubescent,rounded,shaped,shining,shrub,simple,stem,stigma,strongly,style,surface,tan,tear-drop,tip,trichome,tube,way,x,young	2-2.5,2.5-3,4-4.5,7-9,abaxially,adaxially,along,anthesi,apical,ba,bark,closely,conical,dark,deltate,difoliate,drying,eaf,edicel,eed,free,geminat,interlocking,knob-like,lamina,lateral,lobe,lon,lower,main,margin,middle,midrib,nflorescence,occasionally,older,overlappin,pair,planar,portion,projection,reddish-brow,ruit,scar,scattered,slender,spaced,sparsely,styl,tall,tub,ud,unifoliate,unit,vein,visible,widest,woody,ympodial	adaxial,bud,characteristic,colour,diameter,exertion,form,fruit,growth,height,inflorescence,length,lobing,plant,seed,shape,size,texture,type	.25,/4,0.2-1,0.25-0.5,0.5-2,0.6-1,0.7-1,1-1.5,2-6-flowered,3-8.5,5-7,6-9,7-16,acute,area,attenuate,base,beige-tan,berry,calyx,cm,congested,deflexed,dendritic,densely,elliptic,exserted,glabrate,glabrous,globose,green,greenish-white,leaf,leaf-opposed,like,lobed,long,minute,minutely,mm,ovoid-reniform,pale,papillose,pitted,pore,poricidal,pubescent,rounded,shaped,shining,shrub,simple,stem,strongly,style,tan,tear-drop,tip,trichome,tube,way,x,young	.3-1.5,di
40	wfo-0001026307	success	193	150	107	119	74	31	104	3	.6,0.2â0.5,0.2â1.5,0.5â0.7,0.5â5.0,0.8â2,1.0â1.2,1.0â2.0,1.0â2.4,1â3-celled,1â6-celled,2.0,2.0â3.5,2/3,3.5â7.0,35â45,3â8,3â8-celled,4â5.7,8â12,9,abaxial,acute,acute-acuminate,adaxial,angled,anther,anthesi,apex,appressed,articulated,base,berry,black,broadly,calyx,central,clavate,cm,corolla,cuneate,cylindrical,decurrent,densely,diameter,ellipsoid,entire,exerted,eye,facing,filament,flattened-reniform,flower,fruit,fruiting,glabrous,glandular,globose,green,growth,herb,internodal,lateral,length,like,lobe,lobed,long,margin,membranous,minutely,mm,narrowing,new,ovary,ovate,paler,pedicel,peduncle,per,petiole,pubescent,purple,purple-yellow,reflexed,restricted,ripe,shallow,shallowly,shape,shrub,side,simple,sparsely,spreading,stem,stigma,straight,strongly,style,surface,tinged,tip,toward,translucent,triangular,trichome,tube,turning,undulate,uniseriate,variable,vein,vigorous,weak-stemmed,white,wide,yellow,yellow-green	.0â1.2,.3,.5,.5â4.0,.8,0.4,0.5â0.6,0.6,0.8â0.9,0.8â5,1.0â1.5,1.0â2.5,2.0â3.0,2.6â13,3.0â4.0,5-merous,5â7,abaxially,adaxially,age,apar,becoming,beyond,cell,cone,difoliate,eaf,eed,end,free,geminat,gradually,hilum,later,lengthening,longer,lower,middle,narrower,nflorescence,one,outline,pair,papillat,pentagonal,perfect,pore,poricidal,portion,positioned,primary,recurved,reflexe,ruit,scar,shorter,slightly,slit,spaced,ste,stellate,stone,sub-laterally,tal,tem,testal,three,two,ud,unequal,unevenly,unit,upper,ympodial	0.8,arrangement,bark,branch,bud,characteristic,colour,distal,exertion,form,glabrousnes,height,history,inflorescence,interjected,leaf,leaflet,life,lobing,na,number,papillate,plant,prickle,pseudostipule,seed,size,terminal,texture,type,variation	.6,0.2â0.5,0.2â1.5,0.5â0.7,0.5â5.0,0.8â2,1.0â1.2,1.0â2.0,1.0â2.4,1â3-celled,1â6-celled,2.0,2.0â3.5,2/3,3.5â7.0,35â45,3â8,3â8-celled,4â5.7,8â12,9,acute,acute-acuminate,angled,anthesi,apex,appressed,articulated,base,berry,black,broadly,calyx,central,clavate,cm,cuneate,cylindrical,decurrent,densely,diameter,ellipsoid,entire,exerted,eye,facing,flattened-reniform,flower,glabrous,glandular,globose,green,herb,internodal,lateral,length,like,lobe,lobed,long,membranous,minutely,mm,narrowing,ovary,ovate,paler,per,petiole,pubescent,purple,purple-yellow,reflexed,restricted,ripe,shallow,shallowly,shape,shrub,side,simple,sparsely,spreading,stem,straight,strongly,tinged,tip,toward,translucent,triangular,trichome,tube,turning,undulate,uniseriate,variable,vein,vigorous,weak-stemmed,white,wide,yellow,yellow-green	0.8,na,papillate
41	wfo-0001026317	success	167	111	66	88	79	23	63	3	/4,0.3-1.2,0.5,0.5-0.6,0.7-0.9,0.8-1,1-1.2,10-12,2-2.5,2-3-foliate,2-4,2.5-10,3-3.5,4-5,6x,absent,acuminate,acute,anther,anthesi,apex,approximately,attenuate,bark,base,berry,branched,bright,brown,capitate,clonal,cm,conical,corolla,dark,dendritic,densely,diameter,drying,elliptic,entire,essentially,filament,flattened,fruiting,glabrous,globose,growth,inflorescence,less,many,margin,minutely,mm,narrowly,new,nodding,orange,ovary,pair,pale,pedicel,peduncle,petiole,pitted,plant,poricidal,primary,pubescence,pubescent,red,reniform,shiny,shrub,sparsely,stem,stigma,style,surface,time,tip,tube,unit,vein,way,white,x,yellowish	.5,0.25-1,0.5-0.8,0.5-1,0.6-1-5.7,1-1.5,2-3.5-15,3,50-200,6-8,?,abaxially,adaxially,age,apart,apically,calyx,closely,correlated,deltate,dense,distally,eaf,eed,em,erec,erect,exerted,extremely,flower,found,free,geminat,halfwa,internodal,lamina,lengthening,like,lobe,lobed,longer,lower,maturity,nflorescence,occasionally,often,packed,papillat,papillate,per,perfect,pericarp,planar,plane,population,pore,portion,pubescen,pulp,rachi,reflexed,ruit,scar,simple,slightly,slit,sticky,straight,swollen,terminal,thin,toward,triangular,trichome,ud,uniseriate,variable,woody,ympodial	2,abaxial,adaxial,arrangement,branching,bud,colour,exertion,form,fruit,halfway,height,history,leaf,length,life,lobing,seed,shape,size,sympodial,texture,type	/4,0.3-1.2,0.5,0.5-0.6,0.7-0.9,0.8-1,1-1.2,10-12,2-2.5,2-3-foliate,2-4,2.5-10,3-3.5,4-5,6x,absent,acuminate,acute,anthesi,approximately,attenuate,base,berry,branched,bright,brown,capitate,clonal,cm,conical,dark,dendritic,densely,elliptic,entire,essentially,flattened,glabrous,globose,less,many,minutely,mm,narrowly,nodding,orange,pair,pale,pitted,poricidal,pubescent,red,reniform,shiny,shrub,sparsely,time,tip,unit,way,white,x,yellowish	2,halfway,sympodial
42	wfo-0001026335	success	157	143	82	98	59	45	80	2	.5,0.1-0.3,0.25-0.5,0.5-1,0.6-1,0.8-1.3,1-1.5,1-2,1-4,1.5-2,10-20,2,2-3,2-4,2-7.5,3-18,3-5,5-15,5-7,7-8,abaxially,acuminate,adaxially,anther,apart,apex,articulated,base,branched,calyx,chartaceous,cm,connivent,covering,cuneate,curved,dense,densely,diameter,elliptic,elliptic-ovate,entire,erect,especially,filament,flattened,flower,forked,fruit,fruiting,glabrescent,glabrous,globose,green,hair,lanceolate,leaf,leaf-opposed,like,lobe,long,margin,midpoint,mm,moderately,oblong,pedicel,peduncle,petiole,probably,pubescence,pubescent,ray,reticulate,ripe,rounded,scattered,shrub,simple,spaced,stellate,stellate-pubescent,stem,stigma,straight,style,subtending,surface,tip,toward,tube,unripe,usually,vein,white,x,yellow,yellowish	.5-3.5,1,1-3,1.5-4,10-30,4-5,5-,accrescent,acute,adaxiall,ag,apparently,axe,ba,blade,capitat,cylindrical,deltate,directed,distally,eaf,eed,equal,frui,geminate,glandula,glandular,held,large,longitudinal,lower,many-foliate,much,multangulate,nflorescence,often,opening,orolla,paired,perfect,pore,rachi,ruit,sessile,slightly,slit,smaller,sometimes,ste,tal,tamen,tem,time,unit,uprigh,vary,whitish,wide,ympodial	appearance,arrangement,bark,border,branch,bud,capitate,characteristic,colour,corolla,corrugation,distal,drying,exertion,form,giving,glabrousnes,growth,height,history,inflorescence,interjected,lateral,leaflet,length,life,lobing,na,new,number,ovary,per,plant,prickle,primary,pseudostipule,seed,shape,size,terminal,texture,thicknes,type,variation,width	.5,0.1-0.3,0.25-0.5,0.5-1,0.6-1,0.8-1.3,1-1.5,1-2,1-4,1.5-2,10-20,2,2-3,2-4,2-7.5,3-18,3-5,5-15,5-7,7-8,abaxially,acuminate,adaxially,apart,articulated,base,branched,chartaceous,cm,connivent,covering,cuneate,curved,dense,densely,diameter,elliptic,elliptic-ovate,entire,erect,especially,flattened,flower,forked,fruit,glabrescent,glabrous,globose,green,hair,lanceolate,leaf-opposed,like,long,mm,moderately,oblong,probably,pubescence,pubescent,reticulate,ripe,rounded,scattered,shrub,simple,spaced,stellate,stellate-pubescent,stem,straight,subtending,tip,toward,unripe,usually,white,x,yellow,yellowish	capitate,na
43	wfo-0001026343	success	218	144	86	110	108	34	84	2	-4,-7,.5,/5,0-2,0-4,0-40,0-5,0.05-0.5,0.45-1,0.5-1.5,0.8-1.5,1.3-1.7,1.5-2,1.5-2.5-3.5,1.8-2.2,1.8-3,1/3,2-3,2-3.2,2-4,2-6,2.2-3.2,3-5,5-10,5.5-9,acute,anther,apex,apparently,articulated,bark,base,berry,branched,broadly,calyx,chartaceous,cm,concolorous,cream,cuneate,curved,dark,densely,diameter,distal,drying,dull,elliptic,erect,filament,flattened,flattened-reniform,fruit,fruiting,glabrous,green,green-brown,lateral,leaf,length,lobe,lobed,lobing,long,lower,margin,marking,maturity,mauve,midpoint,mm,orange,orange-brown,pair,pale,pedicel,peduncle,per,petiole,plant,poricidal,prickle,prickly,primary,purple,ray,reddish,rounded,shrub,small,sparsely,spherical,stellate-pubescent,stem,style,surface,tapering,terete,tip,tree,tube,unarmed,vein,way,weakly,wide,yellow,young	-15,/2,0-1,0-10,0.05-0.2,0.1-0.2,0.15,0.2,0.2-0.3,0.2-0.7-1.5,0.3,0.5,1-2,1-3,1-4,1/,1/4-2/3,1/5,10-30,2-5,2-8,2.5-8,3-4,3.5-4.5,5-merous,6-9,7-12,7-14,7-8,7-9,abaxial,abaxially,acuminat,adaxial,alyx,andromonoecious,apar,apart,apically,blade,brow,connivent,deltate,distance,eed,elongating,equal,extending,faint,flower,free,glabrescent,hermaphrodite,heterostylous,infructescence,less,lon,long-styled,longer,lowermost,mature,midvein,moderately,multangulate,narrow-deltate,nflorescence,obtuse,older,one,open,orolla,oung,ovate,pendulous,pericarp,plurifoliat,porrect,portion,prickl,reduced,reflexed,ruit,scar,secondary,sessile,short-styled,side,smooth,sometimes,spaced,spreading,stalk,stalked,staminat,stellate,stout,tamen,tertiary,time,trichome,unit,upper,variously,vary,venation,visible,woody,ympodial	appearance,arrangement,border,branch,brown,bud,characteristic,colour,corolla,corrugation,exertion,form,giving,glabrousnes,growth,height,inflorescence,interjected,leaflet,na,new,number,ovary,pseudostipule,seed,shape,size,stigma,terminal,texture,thicknes,type,variation,width	-4,-7,.5,/5,0-2,0-4,0-40,0-5,0.05-0.5,0.45-1,0.5-1.5,0.8-1.5,1.3-1.7,1.5-2,1.5-2.5-3.5,1.8-2.2,1.8-3,1/3,2-3,2-3.2,2-4,2-6,2.2-3.2,3-5,5-10,5.5-9,acute,apparently,articulated,base,berry,branched,broadly,chartaceous,cm,concolorous,cream,cuneate,curved,dark,densely,diameter,dull,elliptic,erect,flattened,flattened-reniform,glabrous,green,green-brown,lateral,lobed,long,lower,marking,maturity,mauve,mm,orange,orange-brown,pair,pale,per,poricidal,prickle,prickly,purple,reddish,rounded,shrub,small,sparsely,spherical,stellate-pubescent,tapering,terete,tip,tree,unarmed,way,weakly,wide,yellow,young	brown,na
44	wfo-0001026352	success	207	113	80	97	110	16	79	1	.3,.5,0.5,0.5-0.8,0.5-1.5,0.5-3,0.7-2,0.9-1,1-2-celled,1.2-1.7,1.5,10+,3-15,5-6,<,?,acuminate,acute,anther,anthesi,antrorsely,apex,bark,base,berry,blue,branching,brown,calyx,capitate-truncate,cm,conical,cordate,corolla,curved,deciduous,densely,diameter,ellipsoid,entire,evenly,exserted,filament,flattened,fruiting,glabrous,globose,green,greenish,growth,immature,inflorescence,lamina,leafy,length,like,long,many,margin,minutely,mm,narrowly,nearly,new,outline,ovate,pale,pedicel,peduncle,per,petiole,pink,pubescent,reniform,revolute,shallowly,shoot,short,simple,spreading,stem,stigma,strongly,style,surface,terminal,time,trichome,truncate,tube,tuberculate,uniseriate,vein,vine,violet,white,yellowish	0.5-1,0.6-1.5-4.6,1-1.5,1-10,1-3.5-9,1.5-2,12-60,2,2-3-celled,4-4.5,5-merou,6-7,7-9,abaxially,adaxiall,ag,almost,alyx,angle,apart,apparently,appearance,arising,articulated,articulation,axi,basal,bending,branch,broadly,cell,chartaceous,deltate,denser,discolorous,eaf,eed,eventually,expanded,few-celled,flower,free,giving,half,heigh,herbarium,ilament,impressed,inflorescenc,irregularly,junction,large,largest,leave,leaving,lengthening,lobe,lobed,lower,mature,membranous,near,nflorescence,older,orolla,pair,papillate,papillo,peg,perfect,pericarp,plurifoliat,point,pore,poricidal,portion,primary,principal,rachi,reflexed,rest,right,ruit,scar,seen,shiny,sleeve,slit,small,spaced,sparser,specimen,spreadin,stellate,straw-colored,tem,thin,third,tip,tub,ud,unit,unspecified,upper,vary,weak,wide,widest,woody,ympodial	arrangement,characteristic,colour,exertion,form,fruit,glabrousnes,leaf,lobing,number,ovary,seed,shape,size,texture,type	.3,.5,0.5,0.5-0.8,0.5-1.5,0.5-3,0.7-2,0.9-1,1-2-celled,1.2-1.7,1.5,10+,3-15,5-6,<,?,acuminate,acute,anthesi,antrorsely,base,berry,blue,branching,brown,calyx,capitate-truncate,cm,conical,cordate,curved,deciduous,densely,diameter,ellipsoid,entire,evenly,exserted,flattened,glabrous,globose,green,greenish,immature,lamina,leafy,like,long,many,minutely,mm,narrowly,nearly,outline,ovate,pale,pink,pubescent,reniform,revolute,shallowly,shoot,short,simple,spreading,stem,strongly,terminal,time,trichome,truncate,tube,tuberculate,uniseriate,vein,vine,violet,white,yellowish	leaf
45	wfo-0001026352	success	212	132	95	112	100	20	93	2	.3,.5,0.5,0.5-0.8,0.5-1,0.5-3,0.7-2,0.9-1,1-1.5,1-2-celled,1.2-1.7,1.5,10+,3-15,5-6,<,?,acuminate,acute,anther,anthesi,antrorsely,apex,articulated,axi,base,berry,blue,branch,branching,broadly,brown,calyx,capitate-truncate,chartaceous,cm,conical,connivent,cordate,corolla,curved,deltate,densely,diameter,discolorous,ellipsoid,entire,evenly,exserted,filament,flattened-reniform,form,fruiting,glabrous,globose,green,greenish,growth,immature,inflorescence,leaf,leafy,leaving,length,lobe,long,many,margin,membranous,minutely,mm,narrowly,near,nearly,new,outline,ovate,pale,pedicel,peduncle,peg,per,petiole,pink,plurifoliate,pubescent,revolute,shallowly,shiny,shoot,short,simple,sleeve,small,spreading,stem,stigma,strongly,style,surface,terminal,time,trichome,truncate,tube,uniseriate,vine,violet,weak,white,woody,yellowish	0.5-1.5,0.6-1.5-4.6,1-10,1-3.5-9,1.5-2,12-60,2,2-3-celled,4-4.5,5-merou,6-7,7-9,abaxially,adaxially,ag,almost,alyx,angle,apart,apparently,appearance,arising,ark,articulation,basal,bending,cell,deciduous,denser,eaf,eed,eventually,expanded,few-celled,flower,free,geminat,giving,half,heigh,herbarium,ilament,impressed,inflorescenc,irregularly,junction,lamina,large,largest,lengthening,like,lobed,lower,mature,nflorescence,older,orolla,pair,papillate,papillo,perfect,pericarp,point,pore,poricidal,portion,primary,principal,rachi,reflexed,rest,right,ruit,scar,seen,slit,spaced,sparser,speciman,specimen,spreadin,stellate,straw-colored,tem,thin,third,tip,tub,tuberculate,twining,ud,unit,unspecified,upper,vary,vein,widest,x,yellow,ympodial	arrangement,bark,bud,characteristic,colour,exertion,fruit,glabrousnes,history,life,lobing,na,number,ovary,papillose,seed,shape,size,texture,type	.3,.5,0.5,0.5-0.8,0.5-1,0.5-3,0.7-2,0.9-1,1-1.5,1-2-celled,1.2-1.7,1.5,10+,3-15,5-6,<,?,acuminate,acute,anthesi,antrorsely,articulated,axi,base,berry,blue,branching,broadly,brown,calyx,capitate-truncate,chartaceous,cm,conical,connivent,cordate,curved,deltate,densely,diameter,discolorous,ellipsoid,entire,evenly,exserted,flattened-reniform,form,glabrous,globose,green,greenish,immature,leafy,leaving,lobe,long,many,membranous,minutely,mm,narrowly,near,nearly,outline,ovate,pale,peg,pink,plurifoliate,pubescent,revolute,shallowly,shiny,shoot,short,simple,sleeve,small,spreading,strongly,surface,terminal,time,trichome,truncate,tube,uniseriate,vine,violet,weak,white,woody,yellowish	na,papillose
46	wfo-0001026379	success	218	117	80	95	123	22	77	3	0.2-0.4,0.7-1,0.8-1.2,0.9-1.2,1-1.7,1-10,1-2,1.3-2.1,1.5-2.3-4.5,1.8-2.6,1.9-3.4,13,2-7,2.9-4,2/3,5.3-10.2,6-10.6,8.3-10,acute,along,anther,anthesi,apart,apex,articulated,attenuate,bark,basal,base,berry,blunt-tipped,branch,branched,brown,calyx,closely,cm,conical,corolla,dark,diameter,dried,ellipsoid,entire,filament,finely,fleshy,flower,fruit,fruiting,glabrous,globose,granular,gray-brown,grayish,growth,included,leaf,length,long-attenuate,many,margin,minutely,mm,nearly,oblong,obovate,ovate,ovate-lanceolate,pale,pedicel,peduncle,petiole,pitted,plant,reniform,rich,scabrous,shrub,simple,size,spaced,stellate-tomentose,stelliform,stem,stigma,style,terete,time,tomentose-pubescent,tube,velutinous-pubescent,violet,whitish,x	0.2-0.38,0.7-2.5,1-3.7,1.7-4.9,1.8-3.2,1.8-5,1/2,2-2.8,2.4-5.1,2.6-3.7,3-11,3/4,4-5,4.1-7,50-450,8-13,8-15,8-29,9-14,abaxially,accrescent,adaxiall,adaxially,ag,apparently,around,axillary,ba,blade,capitat,chartaceous,completely,covering,cylindrical,dendritic-echinoid,densely,directed,distal,distally,eaf,echinoi,echinoid,echinoid-pubescent,edge,eed,enveloping,evident,farinose,few-rayed,free,hair,hig,inserted,lacking,large,lateral,lengthening,line,lobe,lobed,long,lower,m.,main,mature,midrib,minute,mostly,multangulat,multangulate,multangulate-pubescent,nflorescence,obtuse,often,older,orolla,partly,perfect,persistently,plurifoliate,pore,poricidal,porrect-stellate,present,pubescen,rachi,rather,recent,ruit,runk,scattered,semi-ovate,sessile,short-stalked,side,slit,small,sometimes,somewhat,sparse,stellate,stellate-,stellate-pubescent,suture,tamen,testa,thin,tip,translucent,tree,ud,uneven,unit,upper,usually,vary,vein,vestigial,way,whitish-brown,yellow,ympodial,young	arrangement,bud,capitate,characteristic,colour,exertion,form,glabrousnes,height,history,inflorescence,life,lobing,na,new,ovary,perennial,seed,shape,surface,texture,type	0.2-0.4,0.7-1,0.8-1.2,0.9-1.2,1-1.7,1-10,1-2,1.3-2.1,1.5-2.3-4.5,1.8-2.6,1.9-3.4,13,2-7,2.9-4,2/3,5.3-10.2,6-10.6,8.3-10,acute,along,anthesi,apart,articulated,attenuate,basal,base,berry,blunt-tipped,branched,brown,calyx,closely,cm,conical,dark,diameter,dried,ellipsoid,entire,finely,fleshy,flower,fruit,glabrous,globose,granular,gray-brown,grayish,included,length,long-attenuate,many,minutely,mm,nearly,oblong,obovate,ovate,ovate-lanceolate,pale,petiole,pitted,reniform,rich,scabrous,shrub,simple,spaced,stellate-tomentose,stelliform,terete,time,tomentose-pubescent,velutinous-pubescent,violet,whitish,x	capitate,na,perennial
47	wfo-0001026400	success	187	151	114	126	61	25	110	4	0.2-0.8,0.4-1,0.5-1,0.7-1.1,1-10,1-2,1.3-2.6,1.7-2.2,10-18,10-28,12-27,13-30,2-6,2-8,2.4-5.9,3.4-4.8,3.5-5.9,30-55,4-7,5-7,6-13,6-15,6.5-20,8-12,9-13,abaxially,acumen,adaxially,anther,apparently,axe,axillary,berry,blade,blue,brownish,bud,cell,clavate,cm,condition,connivent,coriaceous,corolla,covering,dark,deep,diameter,distal,dorsally,drying,edge,filament,finely,flat,flower,folded,forked,fresh,fruit,generally,glabrescent,glabrous,globose,green,green-white,greenish,hair,hair-like,half,herb,high,homostylous,interjected,lanceolate,lateral,leaf,leaflet,lengthening,light,lilac,linear,lobe,long,make,mm,moderately,mucilaginous,odd-pinnate,ovoid,pedicel,peduncle,pentagonal,perfect,plant,pore,poricidal,puberulent,pubescent,purple,ripe,seed,semi-stellate,short,simple,size,slit,stigma,straight,stripe,style,subtending,terminal,testal,thick,throughout,tip,tube,unwinged,usually,wall,wet,white,whitish,x,yellow	0.5-1.2,3-6,5-merou,acuminate,acute,adaxiall,ag,alyx,apart,apex,articulated,asymmetric,attenuate,base,basiscopic,capitat,decreasing,decurrent,digestion,eaf,eed,elliptic,enzyme,erec,exceeding,geminat,glabrou,gree,hal,honeycomb-shaped,living,lower,nflorescence,orbicular,orolla,ovate,pair,petiole,petiolulate,plurifoliate,removed,rounded,ruit,sessile,seudostipule,side,slightly,spaced,specimen,stamen,subequal,tall,tamen,tem,tissue,toward,tri-,typically,unit,vary,ympodial	5-merous,age,arrangement,articulation,calyx,capitate,characteristic,colour,erect,form,growth,height,history,inflorescence,length,life,ovary,pseudostipule,shape,spacing,staman,stem,surface,texture,type	0.2-0.8,0.4-1,0.5-1,0.7-1.1,1-10,1-2,1.3-2.6,1.7-2.2,10-18,10-28,12-27,13-30,2-6,2-8,2.4-5.9,3.4-4.8,3.5-5.9,30-55,4-7,5-7,6-13,6-15,6.5-20,8-12,9-13,abaxially,acumen,adaxially,apparently,axe,axillary,berry,blue,brownish,bud,cell,clavate,cm,condition,connivent,coriaceous,covering,dark,deep,diameter,distal,dorsally,drying,finely,flat,flower,folded,forked,fresh,generally,glabrescent,glabrous,globose,green,green-white,greenish,hair,hair-like,half,herb,high,homostylous,lanceolate,lateral,lengthening,light,lilac,linear,long,make,mm,moderately,mucilaginous,odd-pinnate,ovoid,pentagonal,perfect,plant,pore,poricidal,puberulent,pubescent,purple,ripe,seed,semi-stellate,short,simple,slit,straight,stripe,subtending,terminal,testal,thick,throughout,tip,unwinged,usually,wall,wet,white,whitish,x,yellow	5-merous,age,capitate,erect
48	wfo-0001026406	success	219	129	84	98	121	31	78	6	.5,0.4-0.9,0.5-1.5,00-200,1-2,1.3-1.5,1.8-2.4,1/3,1/4-1/2,2-2.7,2-3,2.5-8,2.9-3.2,3-10.5,3.2-3.8,5-25,5-6,6-12,9-15,acute,anther,apex,apparently,bark,base,berry,calyx,chartaceous,cm,connivent,cordate,cream,dark,deltate,densely,diameter,discolorous,drying,erect,filament,flattened-reniform,flower,foliaceous,fruit,fruiting,green,herb,lateral,leaf,length,lobed,long,long-styled,lower,margin,marking,maturity,mauve,midvein,mm,moderately,oblong,obtuse,orange-brown,ovate,pair,pale,pedicel,peduncle,pendent,per,petiole,plant,poricidal,prickly,primary,purple,red-brown,short-styled,shrub,spherical,stellate-pubescent,stem,style,surface,tapering,terete,terminal,tip,tube,vein,velvety,way,weakly,white,wide,yellow,young	.2,0,0-3,0-30,0-5,0.3,0.3-0.5,0.3-0.5-1,0.3-0.7,0.4-0.8,0.5,0.5-2.5,0.8,1,1.5-2,1.5-5,1/,1/4,1/4-1/3,10-30,12-19,2-6,20-60,3-4,30-60,5,5-50,5-7,5-8,5-merous,6-15,6.5-7,7-10,7-8,7-9,abaxial,abaxially,adaxial,adaxially,alyx,ame,andromonoecious,apar,apart,apically,articulated,blade,branched,broad-deltate,c.,conical,curved,dirty-whitish,distal,distance,eaf,eed,elongated,elongating,equal,extending,flattened,free,fully,gently,glabrous,hermaphrodite,heterostylous,infructescence,least,lobe,lon,longer,lowermost,mature,midpoint,nflorescence,older,one,open,opening,orolla,oung,pendulous,pericarp,plurifoliat,porrect,portion,prickl,prickle,ray,reflexed,rounded,ruit,scar,sessile,side,smooth,sometimes,spaced,sparsely,spreading,stalk,stalked,staminat,stellate,stout,straight,tamen,tertiary,time,trichome,unit,upper,variously,vary,venation,visible,woody,yellow-brow,ympodial	arrangement,branch,bud,characteristic,colour,corolla,corrugation,exertion,form,glabrousnes,growth,height,history,inflorescence,life,lobing,na,new,number,ovary,perennial,plurifoliate,seed,shape,size,stelate,stigma,texture,type,ye,yellow-brown	.5,0.4-0.9,0.5-1.5,00-200,1-2,1.3-1.5,1.8-2.4,1/3,1/4-1/2,2-2.7,2-3,2.5-8,2.9-3.2,3-10.5,3.2-3.8,5-25,5-6,6-12,9-15,acute,apparently,base,berry,chartaceous,cm,connivent,cordate,cream,dark,deltate,densely,diameter,discolorous,drying,erect,flattened-reniform,flower,foliaceous,green,herb,lateral,lobed,long,long-styled,lower,marking,maturity,mauve,midvein,mm,moderately,oblong,obtuse,orange-brown,ovate,pair,pale,pendent,per,poricidal,prickly,purple,red-brown,short-styled,shrub,spherical,stellate-pubescent,tapering,terete,terminal,tip,velvety,way,weakly,white,wide,yellow,young	na,perennial,plurifoliate,stelate,ye,yellow-brown
49	wfo-0001026407	success	221	126	87	102	119	24	86	1	.5,/3,0.5-0.6,0.5-2,1-1.2,1.5-1.7,2.5-3,20-30,3.5,5,7-8,acute,anther,anthesi,apex,appearing,base,becoming,berry,black,branched,broadly,brown,brownish,calyx,capitate,chartaceous,cm,congested,connivent,corolla,deep,dendritic,dense,densely,diameter,discolorous,ellipsoid,elliptic,entire,exserted,filament,flattened-reniform,fleshy,fruiting,glabrous,globose,golden,golden-pubescent,growth,inflorescence,internodal,lateral,loosely,many,margin,markedly,membranous,minutely,mm,narrowly,new,oblique,occasionally,outline,pale,papillate,pedicel,peduncle,per,petiole,pitted,pubescence,pubescent,purple,purplish,reddish,revolute,ripe,shiny,short,shrub,simple,slightly,stem,stiff,stigma,stout,strongly,style,surface,terminal,time,trichome,truncate,tube,vine,violet,way,woody,x,yellow	+,-11,-6,0.5,0.5-1,0.9-3,1,1-10,1.2-1.5,1.3,1.5-2,1.5-7,2-2.5,20-40,3.5-5.5,4-5,5-10,5-7,5-merou,7-10,abaxially,adaxially,ag,aid,along,always,alyx,apart,area,ark,around,articulated,axi,basal,beneath,berr,blunt,branch,cell,clear,climbin,conical,deltate,denser,eaf,eed,erect,evenly,flower,free,geminat,glabrescen,glabrou,ilament,interpetalar,irregularly,lamina,lax,leafy,leaving,lengthening,like,lobe,lobed,long,lower,midvein,mixture,near,nflorescence,numerous,obscured,often,older,open,orolla,pair,paler,papillat,pedice,peg,pentagonal,perfect,pericarp,persistent,planar,plurifoliate,pore,poricidal,portion,primary,pubescenc,ruit,scar,sinus,sleeve,slit,small,spaced,sparsely,sparser,spreading,stellate,tangled,tem,testal,thin,tip,transition,twining,ud,undulate,unit,upper,usually,vary,vein,weak,ympodial	arrangement,bark,bud,characteristic,colour,exertion,form,fruit,glabrescent,glabrousnes,height,history,leaf,length,life,lobing,number,ovary,plant,seed,shape,size,texture,type	.5,/3,0.5-0.6,0.5-2,1-1.2,1.5-1.7,2.5-3,20-30,3.5,5,7-8,acute,anthesi,appearing,base,becoming,berry,black,branched,broadly,brown,brownish,calyx,capitate,chartaceous,cm,congested,connivent,deep,dendritic,dense,densely,diameter,discolorous,ellipsoid,elliptic,entire,exserted,flattened-reniform,fleshy,glabrous,globose,golden,golden-pubescent,internodal,lateral,loosely,many,markedly,membranous,minutely,mm,narrowly,oblique,occasionally,outline,pale,papillate,per,pitted,pubescence,pubescent,purple,purplish,reddish,revolute,ripe,shiny,short,shrub,simple,slightly,stiff,stout,strongly,terminal,time,trichome,truncate,tube,vine,violet,way,woody,x,yellow	glabrescent
50	wfo-0001026424	success	135	97	69	76	59	21	65	4	0.75-1.5,1-1.5,1-10,1-2,1.5-2,10,10-15,12-60,15,15-30,3-4,637/1,acuminate,acute,age,apex,aspect,base,becoming,blush-violet,broadly,calyx,campanulate,cell,clonal,close,cm,conspicuous,corolla,cuneate,cyme,ellipsoid,elliptic,erect,facetted,flower,general,glabrous,glandular,growing,hair,lanceolate,lanceolate-elliptic,lasting,lavender,leaf,lobed,long,minute,mm,oblique,obovate,pedicel,petiole,pinnatisect,point,rarely,rh,rotate-stellate,rounded,scorpioid,several,shrub,simple,soft-wooded,stem,stone,straggly,tip,toward,triangular,violet,woody,x,year,young	-3.5,-4,1,3-11,8-10-25,acuman,acumen,angular,anthesi,axil,ba,blunt,bluntly,broad,common,cut,dia,distinct,downard,eaf,exceeding,except,exerted,facing,floral,fork,forked,gree,interacuminal,lacking,larger,line,lobe,lon,lower,midvein,nflorescence,often,part,pedicellate,peduncle,plurifoliat,rachi,raised,second,shallowly,short,sinus,slightly,soon,time,tissue,tub,ud,unit,unwinged,usually,within,ympodial	1-3.5,1-4,8-25,arrangement,bud,characteristic,colour,diameter,form,green,growth,height,history,inflorescence,length,life,plant,shape,size,texture,type	0.75-1.5,1-1.5,1-10,1-2,1.5-2,10,10-15,12-60,15,15-30,3-4,637/1,acuminate,acute,age,base,becoming,blush-violet,broadly,campanulate,clonal,close,cm,conspicuous,corolla,cuneate,cyme,ellipsoid,elliptic,erect,facetted,flower,glabrous,glandular,growing,hair,lanceolate,lanceolate-elliptic,lasting,lavender,long,minute,mm,oblique,obovate,pinnatisect,point,rarely,rh,rotate-stellate,rounded,scorpioid,several,shrub,simple,soft-wooded,straggly,tip,toward,triangular,violet,woody,x,year,young	1-3.5,1-4,8-25,green
51	wfo-0001026440	success	181	136	97	108	73	28	94	3	1-5,1.1-1.4,1.1-1.5,1.3-1.7,1.5-2.1,1/2-2/3,14-30,3-7,3-8,3/4,4-12,7-14,9,abaxially,acute,adaxially,along,anther,anthesi,apex,articulated,bark,basal,base,berry,blunt-tipped,bract-like,branch,branched,broadly,brown,calyx,chartaceous,closely,cm,conical,corolla,diameter,dichotomy,elliptic,entire,filament,first,fleshy,flower,free,fruiting,globose,granular,green,greenish-yellow,hair,included,leaf,length,lobed,long-attenuate,many,margin,minutely,mm,multangulate,multangulate-pubescent,nearly,oblong,obovate,obovoid-oblong,obtuse,openly,ovate,pair,pale,pedicel,peduncle,petiole,pitted,poricidal,porrect-stellate,reniform,ripe,scabrous,sessile,short-acuminate,short-stalked,shrub,simple,size,small,sometimes,spaced,sparse,stellate,stem,stigma,style,terete,time,tip,tomentose,tomentose-pubescent,tree,truncate,tube,turning,way,white,x,yellow	0-15,1.8-4.5,1.9-3.7,1/2,2-2.8,2-4,2.9-4.4,3-5,3.9-6.5,5-7,accrescent,adaxiall,ag,always,apparently,appressed,axillary,ba,blade,branche,capitat,dendritic-echinoid,dense,developed,directed,distal,distally,eaf,echinoi,echinoid,eed,high,inserted,large,lengthening,lobe,long,lower,m.,minute,mostly,multangulat,nflorescence,obscure,often,older,orolla,perfect,persistently,plurifoliate,pore,pubescen,rather,ruit,runk,semi-ovate,slit,somewhat,stellate-pubescent,suture,tamen,testa,thick,thin,tomentum,translucent,ud,uneven,unit,usually,vary,ympodial,young	arrangement,bud,capitate,characteristic,colour,drying,exertion,form,fruit,glabrousnes,growth,height,history,inflorescence,life,lobing,na,new,ovary,plant,primary,seed,shape,surface,texture,tommentose-pubescent,type,vein	1-5,1.1-1.4,1.1-1.5,1.3-1.7,1.5-2.1,1/2-2/3,14-30,3-7,3-8,3/4,4-12,7-14,9,abaxially,acute,adaxially,along,anthesi,apex,articulated,basal,base,berry,blunt-tipped,bract-like,branched,broadly,brown,calyx,chartaceous,closely,cm,conical,diameter,dichotomy,elliptic,entire,first,fleshy,flower,free,globose,granular,green,greenish-yellow,hair,included,leaf,length,lobed,long-attenuate,many,minutely,mm,multangulate,multangulate-pubescent,nearly,oblong,obovate,obovoid-oblong,obtuse,openly,ovate,pair,pale,petiole,pitted,poricidal,porrect-stellate,reniform,ripe,scabrous,sessile,short-acuminate,short-stalked,shrub,simple,small,sometimes,spaced,sparse,stellate,terete,time,tip,tomentose,tomentose-pubescent,tree,truncate,turning,way,white,x,yellow	capitate,na,tommentose-pubescent
52	wfo-0001026441	success	197	112	71	91	106	21	68	3	0-2,0.3-0.7,0.5-1.5,1-2,1.5-2.5,10,10-14,15-20,2-2.5,2-5.5,2-8,4-6,4-8,4-8.5,4.5-6.5,5,5-10.5,7-20,7-8,9-14,abaxially,adaxially,anther,berry,blade,brownish,chartaceous,ciliate,cm,condition,conical,connivent,corolla,diameter,drying,end,filament,flower,fresh,fruit,glabrous,green,green-white,greenish,hair,herb,interjected,lanceolate,lateral,leaf,leaflet,light,like,lobe,long,margin,minute,minutely,mm,mottled,mucilaginous,odd-pinnate,one,ovoid,pale,pedicel,peduncle,petiole,placed,plant,puberulent,pubescent,purple,ripe,seed,semierect,size,sparsely,stem,stigma,style,terminal,throughout,tube,tuber,typically,usually,violet,wet,whitish,x	.5,0.4-3,0.8,1-1.5,1-10,1.5-2,3-5,5-merou,6-15,absent,acumen,acuminate,ag,alyx,apart,apex,apparently,articulated,attenuate,axe,axillary,base,bud,capitat,cell,covering,decreasing,digestion,distal,dorsally,eaf,edge,eed,elliptic-lanceolate,enzyme,equal,erec,especially,exceeding,flat,folded,forked,fourt,geminat,generally,glabrou,gradually,hair-like,half,homostylous,honeycomb-shaped,internal,larger,lengthening,living,lower,make,middle,narrow,nflorescence,obtuse,orbicular,orolla,ovate,pair,perfect,petiolule,plurifoliate,pore,poricidal,removed,rotate,rounded,ruit,secondary,seudostipule,short,slightly,slit,spaced,specimen,stamen,star,ste,stolo,straight,subequal,subsessile,subtending,symmetrical,tall,tamen,tem,testal,thick,tip,toward,tri-,unit,vary,wall,white,wide,wing,yellow,ympodial	arrangement,calyx,capitate,colour,erect,form,growth,height,history,inflorescence,length,life,number,ovary,placement,pseudostipule,shape,stolon,surface,texture,type	0-2,0.3-0.7,0.5-1.5,1-2,1.5-2.5,10,10-14,15-20,2-2.5,2-5.5,2-8,4-6,4-8,4-8.5,4.5-6.5,5,5-10.5,7-20,7-8,9-14,abaxially,adaxially,berry,brownish,chartaceous,ciliate,cm,condition,conical,connivent,drying,end,fresh,glabrous,green,green-white,greenish,hair,herb,lanceolate,light,like,long,margin,minute,minutely,mm,mottled,mucilaginous,odd-pinnate,one,ovoid,pale,placed,puberulent,pubescent,purple,ripe,semierect,sparsely,stem,throughout,typically,usually,violet,wet,whitish,x	capitate,erect,stolon
53	wfo-0001026460	success	131	96	65	74	57	22	62	3	.1,.5,0.5-1.5,1-1.5,10-15,13.5-21,2-2.5,2.5-3,4.5-5,6-7,6-9,7-9,abaxially,acute-acuminate,adaxially,anther,apex,base,becoming,berry,branched,brown,calyx,capitate,cm,completely,corolla,dark,dia,drying,elliptic,erect,filiform,floccose,flower,fruiting,glabrous,globose,green,greenish,inflorescence,leaf,lobed,long,long-exserted,minutely,mm,nearly,older,ovary,ovoid-reniform,pale,pedicel,pitted,puberulent,reddish,shaped,shrub,simple,soon,stem,stigma,style,subshrub,surface,tapering,tear-drop,tiny,trichome,tube,vein,white,x,yellow	1.5-2,1/2,5,513,8-10,acut,anthesi,axi,closely,conical,deflexed,deltate,distal,do,eaf,edicel,eed,fide,filament,free,frui,inflorescenc,internodal,less,like,lobe,lower,major,membraneous,middle,nflorescence,often,opposite,pair,papillo,papillose,pore,poricidal,portion,reddish-brow,reflexed,ruit,santo,scar,slightly,somewhat,spaced,tall,tip,tub,ud,unifoliat,unit,widest,woody,ympodial,young	acute,arrangement,bud,characteristic,colour,diameter,exertion,form,fruit,growth,height,length,lobing,peduncle,plant,reddish-brown,seed,shape,size,texture,type,unifoliate	.1,.5,0.5-1.5,1-1.5,10-15,13.5-21,2-2.5,2.5-3,4.5-5,6-7,6-9,7-9,abaxially,acute-acuminate,adaxially,apex,base,becoming,berry,branched,brown,calyx,capitate,cm,completely,dark,dia,elliptic,erect,filiform,floccose,flower,glabrous,globose,green,greenish,lobed,long,long-exserted,minutely,mm,nearly,older,ovoid-reniform,pale,pitted,puberulent,reddish,shaped,shrub,simple,soon,stem,subshrub,tapering,tear-drop,tiny,trichome,tube,white,x,yellow	acute,reddish-brown,unifoliate
54	wfo-0001026489	success	153	136	97	105	48	31	93	4	.3,0.05-0.1,0.25-0.5,0.5,0.5-0.75,0.5-2,0.8-1.2,0.8-1.3,0.8-3.7,1-1.5,1.5-5,2-3,2-4,2-5,2-8-flowered,2.5-13,2/3,5-6,8-13,acute,along,anther,apex,area,axil,bark,base,beneath,berry,branched,broadly,brown,calyx,cm,corolla,cup-shaped,dark,densely,dia,difoliate,elliptic,exserted,filament,flattened,flattened-reniform,fruiting,glabrous,globose,green,later,lateral,leaf,lobed,long,main,margin,minutely,mm,occasionally,often,opposite,ovary,pair,paler,papillose,parallel,pedicel,perpendicular,petiole,pitted,pore,poricidal,prominent,pubescent,rhachi,shaped,shiny,shrub,simple,size,slender,soon,stem,stigma,straight,strongly,style,surface,tapering,tear-drop,terminal,thickened,tip,trichome,tube,uniseriate,unit,usually,vein,way,white,whitish,widened,x,young	0.5-1,0.6-1.4,1.3-3,2.5-4,anthesi,appearing,ba,closely,deflexed,deltoid,differing,dry,eaf,edicel,eed,erect,extending,fleshy,free,geminat,gra,incrassate,lamina,lobe,lon,lower,major,middle,minor,nflorescence,older,one,overlappin,papillo,planar,portion,red-papillose,ruit,scar,somewhat,spaced,specimen,tall,tub,ud,widest,woody,ympodial	arrangement,branch,bud,characteristic,colour,diameter,exertion,form,fruit,geminate,glabrousnes,gray,growth,height,history,inflorescence,length,life,lobing,na,new,number,peduncle,per,plant,primary,seed,shape,sympodial,texture,type	.3,0.05-0.1,0.25-0.5,0.5,0.5-0.75,0.5-2,0.8-1.2,0.8-1.3,0.8-3.7,1-1.5,1.5-5,2-3,2-4,2-5,2-8-flowered,2.5-13,2/3,5-6,8-13,acute,along,area,axil,base,beneath,berry,branched,broadly,brown,calyx,cm,cup-shaped,dark,densely,dia,difoliate,elliptic,exserted,flattened,flattened-reniform,glabrous,globose,green,later,lateral,leaf,lobed,long,main,minutely,mm,occasionally,often,opposite,pair,paler,papillose,parallel,pedicel,perpendicular,pitted,pore,poricidal,prominent,pubescent,rhachi,shaped,shiny,shrub,simple,slender,soon,straight,strongly,style,surface,tapering,tear-drop,terminal,thickened,tip,trichome,tube,uniseriate,unit,usually,vein,way,white,whitish,widened,x,young	geminate,gray,na,sympodial
55	wfo-0001026490	success	270	179	121	144	126	35	118	3	0.1â0.2,0.1â2.5,0.4â0.8,0.5â1,0.5â1.5,0.5â8,0.8â1.5,0.8â12,1.5â2,1.5â3.5,1.5â5,10â20,1â1.2,1â3,2â2.5,2â4,3,3â4.2,3â4.5,3â5,3â5-pinnate,4â4.5,5â7,7-pinnate,7â15,abaxially,absent,acute,adaxially,along,anther,anthesi,apex,axillary,base,brown,calyx,chartaceous,cm,commonly,connivent,corolla,covered,crisped,darker,densely,diameter,distal,distally,ellipsoidal,entire,expanded,extra-axillary,filament,flat,flattened,flower,fruit,fruiting,glabrous,green,immature,incurved,inflorescence,interjected,irregularly,lateral,leaf,leaflet,length,lenticular,light,lobe,long,lower,main,margin,mature,medium,middle,midvein,mm,moderately,mottled,nearly,oblique,oblong,obtuse,obtusely,orange,ovate-lanceolate,papillose,pedicel,peduncle,per,petiole,plurifoliate,pointed,pseudostipule,pubescence,pubescent,punctate,reflexed,resulting,revolute,rounded,sand,seed,shape,shoot,short,simple,size,slender,slightly,smooth,sometimes,somewhat,sparsely,spur,stem,stigma,striping,strongly,style,surface,tawny,teardrop-shaped,terminal,tip,trailing,transparent,trichome,truncate,tube,undulate,vine,violet,white,woody,yellow,Â½,Ã,â4.5	.5,0.2â1,0.2â1.5,0.3â3.5,0.5â3.5,0.7â3,1.2â8,1.5,1.8â2.2,1.9,1â15,1â2.5,1â8,2,2.5â3.5,2â6,2â8,3â8,4.6,4â5,5-merous,6,7,=,accrescent,acuminate,ag,alyx,apart,apical,apicall,apparently,around,articulated,axe,ba,becoming,blade,bract,bracteate,branched,broadly,capitat,cauline,ciliate,climbing,completely,contiguously,cordate,cylindrical,decreasing,directed,eaf,eed,eglandular,elliptic,equal,exceeding,free,fused,geminat,ground,lacking,large,latrorse-introrse,lobed,longitudinal,lowermost,lunate,markedly,match,mean,mean=,minute,multicellular,near,nflorescence,node,obliqu,obliquely,oblon,occasionally,one,opening,orolla,ovate,pair,part,pentagonal,perfec,perfect,petiolule,pore,present,pubescen,pur,rachi,radial,reniform,rooting,ruit,seudostipule,shorter,similar,slit,smaller,spaced,stamen,striation,tamen,tem,thickened,toward,trichomessympodial,typically,unbranched,unit,vary,vegetation,wide,wing,yellowish-tan,youn,â4,â8,â9.5	appearance,arrangement,border,branch,bud,capitate,characteristic,colour,corrugation,drying,exertion,form,geminate,giving,glabrousnes,growth,height,history,life,lobing,midpoint,na,new,number,ovary,plant,prickle,primary,ray,texture,thicknes,type,variation,vein,width	0.1â0.2,0.1â2.5,0.4â0.8,0.5â1,0.5â1.5,0.5â8,0.8â1.5,0.8â12,1.5â2,1.5â3.5,1.5â5,10â20,1â1.2,1â3,2â2.5,2â4,3,3â4.2,3â4.5,3â5,3â5-pinnate,4â4.5,5â7,7-pinnate,7â15,abaxially,absent,acute,adaxially,along,anthesi,apex,axillary,brown,chartaceous,cm,commonly,connivent,covered,crisped,darker,densely,distally,ellipsoidal,entire,expanded,extra-axillary,flat,flattened,flower,fruit,glabrous,green,immature,incurved,irregularly,lenticular,light,lobe,long,lower,main,margin,mature,medium,middle,midvein,mm,moderately,mottled,nearly,oblique,oblong,obtuse,obtusely,orange,ovate-lanceolate,papillose,plurifoliate,pointed,pubescence,pubescent,punctate,reflexed,resulting,revolute,rounded,sand,shoot,short,simple,slender,slightly,smooth,sometimes,somewhat,sparsely,spur,stem,striping,strongly,tawny,teardrop-shaped,terminal,tip,trailing,transparent,trichome,truncate,undulate,vine,violet,white,woody,yellow,Â½,Ã,â4.5	capitate,geminate,na
56	wfo-0001026491	success	165	114	80	89	76	25	77	3	.5,1,1.5-2,1.5-2.5,1.5-3.5,1.7,10-50,3,3-pinnate,5-6,5-8,6-8,abaxially,absent,acuminate,acute,adaxially,anther,apex,appressed,articulated,averaging,base,berry,branched,broadly,cellular-papillose,cellular-pilose,central,cm,conspicuously,cuneate,deciduous,deep,diameter,elliptic-lanceolate,entire,filament,flower,glistening,globose,green,hair,highly,inflorescence,interjected,lanceolate,leaf,leaflet,less,light,margin,middle,minutely,mm,oblong-elliptic,often,ovate-elliptic,ovoid,pale,pedicel,peduncle,petiole,pilose,porrect-incurved,pubescent,purple,readily,rotate-pentagonal,rotate-substellate,rounded,row,sharp,shortly,shrub,simple,slender,spotted,stigma,strigose,strong,suborbicular-ovate,surface,tawny,ventral,white,whitish,x,yellow	1-2,1977,2-3,2-4,2-celled,2.5-3.5,5-merou,7-8,abaxiall,alyx,anderson,apparently,axe,ba,bayonet,bent,blade,bract,branching,capitat,connivent,crinkly,deltoid,densely,directed,distall,eaf,eed,equal,first,geminat,greatly,growing,homostylous,lateral,lobe,long,lower,lunulat,mean,near,nflorescence,obtuse,orolla,ovate,perfect,plurifoliate,point,pore,poricidal,present,rachi,rarely,reduced,ruit,scandent,seudostipule,similar,small,straight,strigo,strongly,subacute,tal,tamen,tem,terminal,tightly,tip,tube,tyle,uniseriate,unit,upright,usually,ympodial	abaxial,adaxial,arrangement,articulation,capitate,characteristic,colour,corolla,direction,distally,form,fruit,growth,height,length,lunulate,plant,pseudostipule,seed,shape,size,stem,style,texture,type	.5,1,1.5-2,1.5-2.5,1.5-3.5,1.7,10-50,3,3-pinnate,5-6,5-8,6-8,abaxially,absent,acuminate,acute,adaxially,appressed,articulated,averaging,base,berry,branched,broadly,cellular-papillose,cellular-pilose,central,cm,conspicuously,cuneate,deciduous,deep,diameter,elliptic-lanceolate,entire,flower,glistening,globose,green,hair,highly,lanceolate,less,light,middle,minutely,mm,oblong-elliptic,often,ovate-elliptic,ovoid,pale,pilose,porrect-incurved,pubescent,purple,readily,rotate-pentagonal,rotate-substellate,rounded,row,sharp,shortly,shrub,simple,slender,spotted,strigose,strong,suborbicular-ovate,surface,tawny,ventral,white,whitish,x,yellow	capitate,distally,lunulate
57	wfo-0001026501	success	194	120	81	97	97	23	81	0	.35,.5,.6,/3,0-1,0.27-0.7,0.5-0.6,0.5-0.9,0.5-1,0.6-1,0.9-2.2,1,1-2.5,1.8-2.2,1/4,2.5-4,2.8-3,3-5,4-7,?,abaxially,acute,anther,apex,articulated,bark,base,berry,branched,brown,brown-green,calyx,chartaceous,cm,cuneate,deltate,densely,diameter,dull,elliptic,elongated,entire,erect,filament,flattened-reniform,fruit,fruiting,glabrous,gray,green,known,leaf,length,light,lobed,long,margin,mauve,midpoint,mm,moderately,orange-brown,orbicular,ovate,pale,pedicel,peduncle,petiole,poricidal,prickly,rounded,scandent,shoot,short,shrub,simple,sometimes,sparsely,spherical,spreading,stellate-pubescent,stem,style,surface,tapering,terete,terminal,tip,trichome,tube,unarmed,upper,way,white,wide,yellow,yellow-green	.1,.7,0,0-2,0-3,0.05-0.3,0.1,0.2-1.8,0.5,0.6-1.1-1.7,0.6-2,1-2,1/2-2/3,1/6-1/2,2-10,3-4,3-9,3.5-4,4-5,5-merous,6-9,7-9,acicular,almost,alyx,apar,apart,apically,apparently,becoming,blade,borne,color,concolorous,curved,discolorous,drying,eaf,eed,elongating,equal,eye,filiform,filiform-acuminat,flattened,flower,free,glabrou,infructescence,lobe,longer,lower,mature,naked,nflorescence,often,older,one,open,orolla,oung,pair,pendulous,per,perfec,pericarp,plurifoliat,porrect,portion,prickl,prickle,primary,ray,reddish,ruit,scar,sessile,shorter,slender,small,smooth,somewhat,spaced,stalk,stalked,stellate,straight,subsessile,tamen,time,unarme,unit,variously,vary,vein,visible,ympodial	arrangement,branch,characteristic,colour,corolla,exertion,form,glabrousnes,growth,height,history,inflorescence,life,lobing,new,ovary,plant,seed,shape,size,stigma,texture,type	.35,.5,.6,/3,0-1,0.27-0.7,0.5-0.6,0.5-0.9,0.5-1,0.6-1,0.9-2.2,1,1-2.5,1.8-2.2,1/4,2.5-4,2.8-3,3-5,4-7,?,abaxially,acute,articulated,base,berry,branched,brown,brown-green,chartaceous,cm,cuneate,deltate,densely,diameter,dull,elliptic,elongated,entire,erect,flattened-reniform,glabrous,gray,green,known,light,lobed,long,mauve,midpoint,mm,moderately,orange-brown,orbicular,ovate,pale,poricidal,prickly,rounded,scandent,shoot,short,shrub,simple,sometimes,sparsely,spherical,spreading,stellate-pubescent,surface,tapering,terete,terminal,tip,trichome,unarmed,upper,way,white,wide,yellow,yellow-green	
58	wfo-0001026513	success	138	82	51	58	80	24	42	9	.1,0.8-2,1-3,2-2.2,3-5,3-6-flowered,4-5,6-8,acute,anther,apex,area,bark,base,berry,calyx,cm,completely,corolla,decurrent,dia,elliptic,exserted,fruit,fruiting,glabrous,globose,green,hirsute,lanceolate,leaf,less,long,long-styled,minute,minutely,mm,ovary,pale,papillose,pedicel,petiole,plant,shaped,shiny,short-styled,shrub,simple,soon,stem,stigma,style,surface,tear-drop,tip,trichome,uniseriate,white	.25,.3,.75,/3,1-1.5,2-5,7-9,8-16,anthesi,apiculate,ba,broadly,caly,closely,darkish,deflexed,delicate,deltoid,differentiated,dry,eaf,edicel,eed,erect,except,filament,flower,free,gre,immature,known,lateral,leave,live,lobe,lobed,longer,lower,main,mature,middle,much,nflorescence,obscure,older,opposite,overlappin,pair,pore,poricidal,portion,prominent,raised,reflexed,rest,ruit,scar,slender,small,somewhat,spaced,specimen,straight,styl,tall,treelet,tube,ud,undersurface,unifoliat,unit,vein,venation,way,wide,widest,woody,x,ympodial,young	0.3,0.75,1,3,arrangement,bud,characteristic,colour,diameter,exertion,form,grey,growth,height,history,inflorescence,length,life,perennial,shape,size,texture,type,unifoliate	.1,0.8-2,1-3,3-5,3-6-flowered,4-5,6-8,acute,area,berry,calyx,cm,completely,decurrent,elliptic,exserted,glabrous,globose,green,hirsute,lanceolate,less,long,long-styled,minute,minutely,mm,pale,papillose,petiole,shaped,shiny,short-styled,shrub,simple,soon,style,tear-drop,tip,trichome,uniseriate,white	-2.2,0.3,0.75,1,3,di,grey,perennial,unifoliate
59	wfo-0001026529	success	219	133	103	114	105	19	100	3	0-25,0.3-1,1,1-4.5,1.1-2.5,1.5-2.5,1.5-4,11-14,12-22,120-210,2-7.5,20-60,3-12,3-5,3-6,3-9.5,5-15,5-17,5-9,50-70,600-950,?,abaxially,adaxially,anther,berry,blue,brownish,cell,chartaceous,clavate,cm,condition,corolla,covering,creamy,dark,deep,densely,diameter,distal,dot,drying,faintly,flower,fresh,fruit,glabrous,gland,glandular,globose,greatly,green,green-white,greenish,hair,hair-like,head,herb,homostylous,interjected,lateral,leaflet,length,light,like,lilac,long,longer,lunate,make,medium,membranous,mm,moderately,mucilaginous,non-glandular,odd-pinnate,often,ovoid,pair,pedicel,peduncle,plant,pubescent,pure,rarely,ripe,scattered,seed,shape,short,size,slightly,stem,stigma,style,terminal,testal,tetralobulate,thick,throughout,tip,trichome,unwinged,varying,wall,wet,white,whitish,wide,wing,x,yellowish	0.5-4.5,1-10,1-2,1-3,10,10-28,2,2-5,4-8,5-merou,6-20,acumen,acuminate,acute,ag,along,alyx,apart,apex,apparently,articulated,attenuate,axe,axillary,base,blade,broadly,bud,capitat,ciliate,connivent,cordate,digestion,dorsally,eaf,edge,eed,elliptic,enzyme,erec,especially,exceeding,except,filament,flat,folded,forked,geminat,generally,glabrou,gree,hal,half,honeycomb-shaped,lanceolate,lengthening,living,lobe,lower,margin,midrib,minutely,narrowly,nflorescence,oblique,orbicular,orolla,ovate,pentagonal,perfect,petiole,petiolulate,petiolule,plurifoliate,pore,poricidal,proximal,puberulent,reduced,removed,rounded,ruit,sessile,seudostipule,slit,spaced,specimen,stamen,ste,straight,subequal,subsessile,substellate,subtending,tall,tamen,tem,tri-,tube,typically,unit,usually,vary,yellow,ympodial	5-merous,arrangement,calyx,capitate,characteristic,colour,erect,form,growth,height,history,inflorescence,leaf,life,ovary,pseudostipule,surface,texture,type	0-25,0.3-1,1,1-4.5,1.1-2.5,1.5-2.5,1.5-4,11-14,12-22,120-210,2-7.5,20-60,3-12,3-5,3-6,3-9.5,5-15,5-17,5-9,50-70,600-950,?,abaxially,adaxially,berry,blue,brownish,cell,chartaceous,clavate,cm,condition,covering,creamy,dark,deep,densely,diameter,dot,drying,faintly,fresh,glabrous,gland,glandular,globose,greatly,green,green-white,greenish,hair,hair-like,head,herb,homostylous,lateral,length,light,like,lilac,long,longer,lunate,make,medium,membranous,mm,moderately,mucilaginous,non-glandular,odd-pinnate,often,ovoid,pubescent,pure,rarely,ripe,scattered,seed,shape,short,size,slightly,stem,testal,tetralobulate,thick,throughout,tip,trichome,unwinged,varying,wall,wet,white,whitish,wide,wing,x,yellowish	5-merous,capitate,erect
60	wfo-0001026534	success	149	116	73	88	61	28	71	2	0.5-1,1-3,1.5-6,1.5-9,10-20,10-50,15-50,2-2.5,2-7,2-8,2.5-15,3-10,3-25,3-4,3-5,3.5-4,4-10,5-6,acuminate,adaxially,apart,apex,apiculate,auriculate,basal,base,branched,bright,calyx,chartaceous,cm,connective,connivent,cordate,cylindrical,deltate,densely,diameter,distally,eglandular,ellipsoidal,entire,flattened,fleshy,flower,fruit,glabrous,glandular,hair,lanceolate,lobe,long,margin,mm,moderately,narrowly,obtuse,orange,ovate,ovoid,pale,pedicel,pedicellar,peduncle,petiole,pinkish,pore,puberulent,pubescent,purple,rachi,radiu,red,remnant,simple,sparsely,stellate,stigma,style,subcoriaceous,tip,tree,triangular,truncate,unbranched,white,x,yellow	-1.5,1-2,1-2.5,10-15,2-3,2.5-4,3-4-foliat,4.5-5,6-35,7-12,7-40,abaxially,absent,acute,aggregate,ape,articulated,axe,beyond,blade,cell,darker,directed,eaf,eed,equal,exserted,leaving,lemon-yello,lon,longitudinal,lower,m.,nflorescence,nther,often,orolla,perfect,presen,puberulen,ruit,shorter,slightly,small,spaced,stamen,stone,stripe,tal,tem,thecae,time,tomento,truncat,tube,ud,unit,vary,vein,wide,ympodial	abaxial,adaxial,anther,arrangement,bud,characteristic,colour,corolla,direction,form,growth,height,history,inflorescence,leaf,lemon-yellow,length,life,ovary,perennial,plant,seed,shape,size,spacing,stem,surface,texture	0.5-1,1-3,1.5-6,1.5-9,10-20,10-50,15-50,2-2.5,2-7,2-8,2.5-15,3-10,3-25,3-4,3-5,3.5-4,4-10,5-6,acuminate,adaxially,apart,apiculate,auriculate,basal,branched,bright,chartaceous,cm,connivent,cordate,cylindrical,deltate,densely,distally,eglandular,ellipsoidal,entire,flattened,fleshy,flower,glabrous,glandular,hair,lanceolate,lobe,long,mm,moderately,narrowly,obtuse,orange,ovate,ovoid,pale,pinkish,puberulent,pubescent,purple,red,simple,sparsely,stellate,subcoriaceous,tip,tree,triangular,truncate,unbranched,white,x,yellow	lemon-yellow,perennial
61	wfo-0001026535	success	248	155	125	141	107	14	124	1	.1,.2,.5,0.15,0.7-1.5,1,1-3,1.2-2,1.3,1.5-3,1/3,2-5,2.5,3-5,3.5-4,4-15,5-7,5Â°,7-8,abaxial,abaxially,accrescent,acute,adaxially,age,almost,along,anther,apex,around,bark,base,becoming,berry,black,brachyblast,branch,branched,branching,broadly,brown,calyx,chartaceous,clavate,clustered,cm,condensed,conical,corolla,cuneate,cup,cupular,dendritic,dendritic-pubescent,dense,developed,developing,diameter,distributed,drying,elliptic,elongated,entire,evenly,except,fine,flat,flexuous,flower,forming,fruit,fruiting,glabrous,green-brown,leaf,length,liana,like,lobe,lobed,long,loop,loose,lower,main,margin,membranous,midvein,mm,network,oblong,obovate,older,orange-brown,ovate,ovoid,pair,partly,pedicel,peduncle,petiole,plant,primary,prominent,pubescent,rachi,raised,rarely,ray,rounded,short,shrub,side,slightly,spaced,sparsely,spreading,stem,stigma,style,terete,terminal,tertiary,tissue,trichome,truncate,two,unarmed,unevenly,unlignified,vein,venation,violet,visible,white,widely,wider,x,yellowish,young,youngest	.4,.8,0-0.5,0.1-0.2,0.2,0.2-0.3,0.2-1.5,0.5-1,1-2,1-5,1.5-2,1/2-2/3,2-3,3,3-4.5,5-10,absent,alternate,alyx,anthesi,apar,apically,apparently,area,articulated,clearly,concolorous,curved,dark,deeply,delineate,delineated,deltoid,detaching,dilated,discolorous,divided,domatia,dorsal,dry,eaf,eed,ellipsoi,equal,eye,fertilisation,filament,free,frui,increasing,inside,known,leave,lengthening,linear,lon,m.,marginal,minute,minutely,mostly,much,naked,nflorescence,nther,number,obscure,orolla,outside,papillo,pendulous,perfec,pericarp,plurifoliat,pointed,pore,poricidal,portion,protruding,reaching,ridged,ruit,scar,secondary,see,simple,sinus,slender,smaller,smooth,soon,stump,surface,tearing,thin,tip,toward,translucent,tube,tufted,ud,uneven,unit,vary,weakly,wide,ympodial	arrangement,bud,characteristic,colour,ellipsoid,form,growth,inflorescence,lobing,ovary,shape,size,texture,type	.1,.2,.5,0.15,0.7-1.5,1,1-3,1.2-2,1.3,1.5-3,1/3,2-5,2.5,3-5,3.5-4,4-15,5-7,5Â°,7-8,abaxial,abaxially,accrescent,acute,adaxially,age,almost,along,apex,around,base,becoming,berry,black,brachyblast,branch,branched,branching,broadly,brown,chartaceous,clavate,clustered,cm,condensed,conical,cuneate,cup,cupular,dendritic,dendritic-pubescent,dense,developed,developing,distributed,drying,elliptic,elongated,entire,evenly,except,fine,flat,flexuous,flower,forming,fruit,glabrous,green-brown,leaf,liana,like,lobe,lobed,long,loop,loose,lower,membranous,midvein,mm,network,oblong,obovate,older,orange-brown,ovate,ovoid,pair,partly,plant,prominent,pubescent,rachi,raised,rarely,ray,rounded,short,shrub,side,slightly,spaced,sparsely,spreading,stem,terete,terminal,tissue,trichome,truncate,two,unarmed,unevenly,unlignified,vein,violet,visible,white,widely,wider,x,yellowish,young,youngest	ellipsoid
62	wfo-0001026604	success	192	107	74	90	102	17	74	0	0.8-0.9,1-1.2,1.1-1.3,1.2-1.7,1.5-2,1.5-9,2-2.3,2.3-3.5,3-3.5,5,50-100,acuminate,along,anther,apex,bark,base,berry,branching,brown,c.,calyx,capitate,cm,conical,cordate,corolla,dark,diameter,ellipsoid,entire,exserted,flattened,flexuous,flower,fruit,fruiting,glabrous,globose,growth,inflated,later,leaf-opposed,liana,margin,midrib,minute,minutely,mm,narrowly,new,oblique,ovary,ovate,overall,ovoid,pale,pedicel,peduncle,petiole,pitted,poricidal,purple,red,reddish,reniform,ripe,shape,shrub,simple,slender,somewhat,stem,stigma,stout,strongly,style,surface,terminal,time,tip,trichome,truncate,tube,uniseriate,vining,violet,way,woody,x	.4,.5,.75,0,0.1,0.4-0.6,0.8-1,10-30,2-2.5,3-5,3.5-4,4-4.5,4.5-7,5-7,<,?,absent,age,aid,always,anthesi,apart,appearing,articulated,articulation,atop,basal,brow,cell,clearly,climbing,comical,cucullate,cupped,deflexed,densely,differentiated,distal,distinct,drying,due,eaf,eed,elongate,expanding,filament,free,leaving,lengthening,lobe,lobed,lower,mere,nflorescence,nodding,occasionally,older,outline,pair,papillo,papillose,part,particularly,peg,per,perfect,pericarp,planar,plurifoliat,poin,point,pore,portion,primary,pubescent,quarter,receptacle-like,rim,ruit,scar,series,shiny,sinuate,slightly,slit,spaced,stellate,structure,support,swolle,testal,thin,tub,twisting,ud,undulation,unit,upper,vein,widely,ympodial,Â½	arrangement,bud,characteristic,colour,exertion,form,glabrousnes,history,inflorescence,leaf,length,life,lobing,seed,size,texture,type	0.8-0.9,1-1.2,1.1-1.3,1.2-1.7,1.5-2,1.5-9,2-2.3,2.3-3.5,3-3.5,5,50-100,acuminate,along,base,berry,branching,brown,c.,calyx,capitate,cm,conical,cordate,dark,diameter,ellipsoid,entire,exserted,flattened,flexuous,flower,glabrous,globose,inflated,later,leaf-opposed,liana,midrib,minute,minutely,mm,narrowly,oblique,ovate,overall,ovoid,pale,pitted,poricidal,purple,red,reddish,reniform,ripe,shape,shrub,simple,slender,somewhat,stout,strongly,surface,terminal,time,tip,trichome,truncate,tube,uniseriate,vining,violet,way,woody,x	
63	wfo-0001026607	success	204	98	59	77	127	21	56	3	0-3,0.1-0.3,0.3-1.8,0.5-5.8,0.8-3.4,0.8-4.5,0.8-5,1-2,1-3.8,1-8,1.5-4,10-30,2-2.5,2.4-5.8,2.5-3.8,2.7-19,4-10,4-6,5.8-19.8,6-10,anther,berry,blade,brownish,chartaceous,clavate,cm,coarse,condition,corolla,deep,diameter,drying,filament,finely,forming,fresh,fruit,globose,green,greenish,hair,herb,interjected,lateral,leaf,leaflet,long,medium,membranous,mm,moderately,odd-pinnate,ovoid,pedicel,peduncle,petiole,petiolulate,plant,puberulent,pubescent,rachi,ripe,rosette,seed,sessile,short,simple,size,stem,stigma,style,terminal,unwinged,violet,whitish,x	0-4,1-10,1-5,2-10,2-3,3-8,5,5-merou,abaxially,absent,acumen,acute,adaxially,ag,along,alyx,apart,apex,apparently,articulated,attenuate,axe,axillary,base,basiscopic,bud,capitat,cell,ciliate,clearly,connivent,covering,decreasing,decurrent,digestion,distal,dorsally,dot,eaf,edge,eed,elliptic,enzyme,especially,exceeding,flat,flower,folded,forked,geminat,generally,glabrou,glabrous,greatly,gree,green-white,hair-like,hal,half,high,homostylous,honeycomb,lanceolate,larger,lengthening,like,living,lobe,lower,make,margin,marked,midrib,minute,minutely,much,mucilaginous,nflorescence,obtuse,often,orbicular,orolla,ovate,pair,pentagonal,perfect,plurifoliate,pore,poricidal,present,rarely,removed,rounded,ruit,scattered,semierec,seudostipule,shaped,side,slit,sometimes,spaced,specimen,stamen,ste,straight,subtending,tall,tamen,tem,testal,thick,throughout,tip,toward,tri-,tube,typically,unit,usually,vary,wall,wet,white,without,yellow,ympodial	0-5,abaxial,adaxial,arrangement,calyx,capitate,characteristic,colour,form,growth,height,history,inflorescence,length,life,ovary,pseudostipule,semierect,shape,texture,type	0-3,0.1-0.3,0.3-1.8,0.5-5.8,0.8-3.4,0.8-4.5,0.8-5,1-2,1-3.8,1-8,1.5-4,10-30,2-2.5,2.4-5.8,2.5-3.8,2.7-19,4-10,4-6,5.8-19.8,6-10,berry,brownish,chartaceous,clavate,cm,coarse,condition,deep,drying,finely,forming,fresh,globose,green,greenish,hair,herb,long,medium,membranous,mm,moderately,odd-pinnate,ovoid,petiolulate,puberulent,pubescent,ripe,rosette,sessile,short,simple,unwinged,violet,whitish,x	0-5,capitate,semierect
64	wfo-0001026613	success	159	117	85	97	62	20	81	4	1-10,1-2,1.5-4,11-19.5,2-7.5,2.5-2.8,3-5,4-5,4.5-8.5,5,5-6,5-7,6-8,6.2-9.5,8-18,8.5-10,8.5-9,9.5-13.5,abaxially,absent,adaxially,along,anther,apart,axillary,berry,blade,borne,bud,chartaceous,ciliate,cm,conical,connivent,corolla,densely,diameter,distal,end,especially,filament,flower,forked,fruit,generally,glabrous,green,hair,half,herb,homostylous,immature,interjected,lanceolate,lateral,leaf,leaflet,lengthening,like,lobe,long,margin,mature,membranous,midrib,minute,minutely,mm,mottled,odd-pinnate,ovate,pedicel,peduncle,plant,pore,poricidal,puberulent,pubescent,purple,rotate-pentagonal,singly,size,slit,stem,stigma,style,subtending,terminal,tip,tube,tuber,typically,unknown,unwinged,usually,x,yellow	0.5-1,0.6,2.3-8,3-10,5-merou,5.5-7,6-12,acumen,acuminate,ag,alyx,apex,apparently,articulated,attenuate,axe,base,capitat,cordate,decreasing,dorsally,eaf,edge,eed,erec,flat,folded,geminat,greatly,hal,larger,lower,m-1.2,middle,nflorescence,orolla,pair,perfect,petiole,petiolule,plurifoliate,proximal,pubescen,ruit,secondary,semierect,seudostipule,spaced,sparsely,ste,stolo,subequal,symmetrical,tall,tamen,tem,toward,tri-,unit,unknow,vary,ympodial	0.6-1.2,age,arrangement,calyx,capitate,colour,form,growth,height,inflorescence,length,ovary,presence,pseudostipule,seed,shape,spacing,stolon,texture,type	1-10,1-2,1.5-4,11-19.5,2-7.5,2.5-2.8,3-5,4-5,4.5-8.5,5,5-6,5-7,6-8,6.2-9.5,8-18,8.5-10,8.5-9,9.5-13.5,abaxially,absent,adaxially,along,apart,axillary,berry,borne,bud,chartaceous,ciliate,cm,conical,connivent,corolla,densely,distal,end,especially,flower,forked,fruit,generally,glabrous,green,hair,half,herb,homostylous,immature,lanceolate,lengthening,like,long,margin,mature,membranous,midrib,minute,minutely,mm,mottled,odd-pinnate,ovate,plant,pore,poricidal,puberulent,pubescent,purple,rotate-pentagonal,singly,slit,stem,subtending,terminal,tip,typically,unknown,unwinged,usually,x,yellow	0.6-1.2,age,capitate,stolon
65	wfo-0001026614	success	199	136	98	110	89	26	97	1	.8,0.2â0.3,0.4-0.7,0.5,0.5â2,1-2â4-branched,15â30,1â2,1â3,1â5,2.2,2.5,2.5â3,20â25,3â10,5.3-8.2,50,8â10,9â16,>,abaxially,acuminate,acute,adaxially,anther,apex,armed,base,berry,black,broad-based,brown,calyx,campanulate,cm,commonly,dark,diameter,dried,entire,erect,especially,evenly,extra-axillary,filament,flattened-reniform,fleshy,flower,foveolate,fruit,glabrescent,glabrous,gland-tipped,globose,hair,irregularly,leaf,linear,lobe,lobed,long,margin,minute,minutely,mm,mottled,nearly,oblique,orange,orange-red,ovate,ovoid,pair,pedicel,peduncle,per,petiole,prickle,pubescent,rarely,reflexed,repand,ripe,rotate-pentagonal,rounded,sessile,shallowly,shrub,simple,smaller,sometimes,somewhat,soon,sparsely,spreading,stellate-pubescent,stem,stigma,style,surface,tapering,tube,unarmed,usually,weakly,white,x,yellow,yellowish,young	0.2,1.3-1.8,1.5â2,11-15,2.2-5.5,2â4,2â6.5,3-foliate,3.2-5.2,4-7,4.5â11,4.5â5.5,5,5-merou,6.4-8.4,6â8,7.2-9.8,absent,across,adaxiall,alyx,apart,apparently,articulated,axe,ba,blade,blunt-tipped,capitat,chartaceous,clavate,closely,concentrated,cylindrical,densely,denser,developed,directed,distally,eaf,eed,expanded,fruiting,geminate,globo,golden,homostylous,internode,interpetalar,lanceolate-attenuate,lateral,less,lon,lower,midpoint,midvein,nflorescence,obtuse,often,orolla,ovate-lanceolate,perfect,pore,pubescence,rachi,ray,ruit,scattered,shin,side,similar,slightly,spaced,stellae,stellate,tall,tamen,tem,time,tissu,tissue,ud,unarme,vary,vein,well,wide,ympodia,â5	arrangement,branch,bud,capitate,characteristic,colour,corolla,exertion,form,glabrousnes,growth,height,history,inflorescence,length,life,lobing,new,number,ovary,plant,seed,shape,size,texture,type	.8,0.2â0.3,0.4-0.7,0.5,0.5â2,1-2â4-branched,15â30,1â2,1â3,1â5,2.2,2.5,2.5â3,20â25,3â10,5.3-8.2,50,8â10,9â16,>,abaxially,acuminate,acute,adaxially,apex,armed,berry,black,broad-based,brown,campanulate,cm,commonly,dark,diameter,dried,entire,erect,especially,evenly,extra-axillary,flattened-reniform,fleshy,flower,foveolate,fruit,glabrescent,glabrous,gland-tipped,globose,hair,irregularly,leaf,linear,lobe,lobed,long,minute,minutely,mm,mottled,nearly,oblique,orange,orange-red,ovate,ovoid,pair,per,prickle,pubescent,rarely,reflexed,repand,ripe,rotate-pentagonal,rounded,sessile,shallowly,shrub,simple,smaller,sometimes,somewhat,soon,sparsely,spreading,stellate-pubescent,tapering,unarmed,usually,weakly,white,x,yellow,yellowish,young	capitate
66	wfo-0001026642	success	193	92	57	58	135	34	43	14	5,6,abaxial,annual,anther,articulated,base,bipinnate,black,blue,branched,brown,calyx,clavate,cm,dark,decumbent,diameter,elliptic,erect,filament,flattened,flower,fruit,glabrous,globose,green-purple,hair,herb,lavender,leaf,length,lilac,long,mm,number,oblong,ovate,pale,pedicel,peduncle,perennial,pinnate,pitted,pubescent,shallowly,sparsely,stigma,style,subglabrous,surface,time,tube,violet,white,woody,x,yellow	.05,.1,.8,0.1,0.1â0.3,0.2,0.25,0.4,0.4â2.2,0.5,0.5â,0.5â0.7,0.5â1.7,0.5â2.0,0.5â3.5,0.6,0.6â1.0,0.75â1.0,0.75â2.0,0.7â1.6,0.8â1.2,1.0,1.0â2.0,1.2â1.7,1.2â2.0,1.2â3.5,1.2â6.2,1.6â8.0,1.9â3.0,12â30,1â10,1â3,2.0â4.0,2.5â3.5,2.5â4.0,2.8â3.0,3.0â5.1,3â5,4.0â6.0,4â7,5.0â7.0,50â100,<,abaxially,acute,adaxiall,adaxially,ag,along,anthesi,apart,apex,appressed,axe,axillary,ba,blade,borne,cell,chartaceous,circular,connivent,cylindrical,decreasing,densely,denser,divided,eaf,eed,either,equal,fleshy,geminat,glabrescen,gland,glandular,half,indumentum,lobe,lon,longitudinal,lower,m.,moderately,multicellular,narrow,nflorescence,obtuse,occasionally,often,opening,orolla,pair,pentagonal,perfect,petiole,pinnae,pore,poricidal,present,primary,probably,rapidly,rounded,ruit,secondary,sessile,shoot,side,simple,slit,sometimes,spaced,stone,straight,tal,tamen,tem,tip,unicellular,unifoliate,uniseriate,unit,usually,vary,vein,wide,wing,ympodial,â1.2,â11.0,â2.0,â4.5,â6,â7	0.1-0.3,0.5-3.5,0.5-6.2,0.5-8.0,0.75-1.0,0.8-1.2,1-3,1.2-1.7,12-30,2.8-3.0,3.0-5.1,4.0-6.0,5.0-7.0,50-100,adaxial,arrangement,characteristic,colour,corolla,form,growth,height,history,inflorescence,life,ovary,plant,seed,shape,size,staman,stem,texture,type	5,6,annual,articulated,base,bipinnate,black,blue,branched,brown,clavate,cm,dark,decumbent,diameter,elliptic,erect,flattened,flower,glabrous,globose,green-purple,herb,lavender,lilac,long,mm,oblong,ovate,pale,perennial,pinnate,pitted,pubescent,shallowly,sparsely,subglabrous,time,violet,white,woody,x,yellow	0.1-0.3,0.5-3.5,0.5-6.2,0.5-8.0,0.75-1.0,0.8-1.2,1-3,1.2-1.7,12-30,2.8-3.0,3.0-5.1,4.0-6.0,5.0-7.0,50-100
67	wfo-0001026651	success	222	143	112	112	110	31	98	14	1.8,8,abaxially,acuminate,acute,adaxially,anther,antrorsely,apex,articulated,asymmetric,attenuate,base,beneath,berry,beyond,brown,calyx,capitate,chartaceous,ciliate,connivent,cordate,cyme,dark,decurrent,densely,diameter,directed,discolorous,drying,dull,emarginate,entire,erect,exfoliating,exserted,filament,flattened,flower,fruit,glabrescent,glabrous,globose,green,herb,hilum,hollow,introrsely,lanceolate,lateral,leaf,length,light,long,longitudinal,lying,margin,matte,mm,moderate,narrowly-elliptic,new,normally,oblong-ellipsoid,onto,opening,ovate-deltate,ovate-lanceolate,ovate-reniform,parallel,pedicel,peduncle,pedunculate,per,petiole,plant,pore,poricidal,pubescence,pubescent,region,revolute,ripe,rounded,seed,shape,shiny,similar,simple,size,slightly,slit,small,sometimes,spaced,stamen,stem,stigma,style,sub-opposite,subapical,surface,terminal,translucent,trichome,unbranched,undulate,white,woody,yellow,Ã	-celled,0.2â1.3,0.35â2.6,0.9â3,1,1â2,2.2â10,2.8,2â11.5,2â13,2â3,2â3.3,2â4,2â4.5,2â8,3,3-plurifoliate,3â5,3â7,4,4â6,4â7.8,5-merou,6â10,6â14,absent,accrescent,adaxiall,along,alyx,anisophyllous,antror,antrorse,apar,appressed,arcuate,ark,axi,branch,broadly,brochidodromous,brownish-green,capitat,cell,circular,cm,cylindrical,decumbent,differing,eaf,eed,elliptic,equal,eye,flexuous,frui,geminate,geniculate,glabrou,glandular,growt,hair,head,highly,impressed,less,like,lobe,lower,major,markedly,membranaceous,midrib,minor,moderately,mostly,much-branched,multicellular,naked,nflorescence,obtuse,older,one,orolla,perfect,prominent,reduce,ruit,secondary,shrub,single-celled,smaller,stalk,stellate,straight,tall,tamen,tem,turning,uniseriate,unit,upper,usually,vary,vein,venation,visible,wide,ympodial,young	2-13,2-3,2-3.3,2-4,2-4.5,2-8,2.2-10,3-5,3-7,4-6,4-7.8,6-10,6-14,apart,arrangement,characteristic,colour,corolla,exertion,form,glabrousnes,growth,height,history,inflorescence,life,lobing,number,ovary,texture,type	1.8,8,abaxially,acuminate,acute,adaxially,antrorsely,apex,articulated,asymmetric,attenuate,base,beneath,berry,beyond,brown,capitate,chartaceous,ciliate,connivent,cordate,cyme,dark,decurrent,densely,diameter,directed,discolorous,drying,dull,emarginate,entire,erect,exfoliating,exserted,flattened,flower,fruit,glabrescent,glabrous,globose,green,herb,hilum,hollow,introrsely,lanceolate,lateral,leaf,light,long,longitudinal,lying,margin,matte,mm,moderate,narrowly-elliptic,normally,oblong-ellipsoid,onto,opening,ovate-deltate,ovate-lanceolate,ovate-reniform,parallel,pedunculate,per,petiole,pore,poricidal,pubescence,pubescent,region,revolute,ripe,rounded,shiny,similar,simple,slightly,slit,small,sometimes,spaced,stamen,stem,sub-opposite,subapical,terminal,translucent,trichome,unbranched,undulate,white,woody,yellow,Ã	2-13,2-3,2-3.3,2-4,2-4.5,2-8,2.2-10,3-5,3-7,4-6,4-7.8,6-10,6-14,apart
68	wfo-0001026656	success	211	115	71	89	122	26	68	3	0-4,0.7-10.5,0.9-13,1-1.8,1-10,1-2,1-3.8,1.1-8.1,2-6,2.5-17,20-60,4-10,4-13,4-8,5-35,5.5-27,9-11,acute,anther,attenuate,blade,blue,broadly,brownish,capitate,chartaceous,cm,condition,connate,connivent,corolla,dark,densely,diameter,distal,dot,drying,filament,flower,fresh,fruit,glabrous,glaucous,globose,green,green-white,greenish,herb,homostylous,interjected,lanceolate,lateral,leaflet,light,long,lunate,membranous,mm,moderately,mottled,mucilaginous,narrowly,odd-pinnate,ovate,ovoid,pair,pedicel,peduncle,pentagonal,plant,pubescent,purple,rotate-pentagonal,scale-like,scattered,seed,stem,stigma,style,subglabrous,terminal,throughout,tinged,tuber,unwinged,violet,wet,white,whitish	0.3-3,0.3-4.2,0.4-6.5,1,1-4,1-5,1.5-7,10,2-8,5,5-18,5-merou,abaxially,absent,acumen,acuminate,adaxially,ag,along,alyx,apart,apex,articulated,base,bearing,borne,bud,cell,ciliate,clavat,covering,cuneate,curved,decurrent,digestion,dorsally,eaf,edge,eed,elliptic,end,enzyme,erec,especially,exceeding,flat,folded,forked,geminat,generally,greatly,greenish-yellow,hair,hair-like,half,honeycomb-shaped,larger,lengthening,like,living,lobe,lower,make,margin,middl,midvein,minutely,nflorescence,non-glandular,oblique,occasionally,often,orolla,petiole,petiolulate,petiolule,plurifoliate,pore,poricidal,puberulent,pubescen,rachi,ranging,removed,ruit,seudostipule,short,singly,slightly,slit,sometimes,somewhat,spaced,specimen,stamen,star,ste,stolo,straight,subequal,subtending,symmetrical,tall,tamen,tem,tertiary,testal,therefore,thick,tip,tri-,truncate,tube,typically,unit,vary,wall,wide,wing,without,yellow,ympodial	abaxial,adaxial,arrangement,calyx,characteristic,clavate,colour,form,growth,height,inflorescence,leaf,length,ovary,presence,present,pseudostipule,pubescence,shape,size,staman,surface,texture,type,width,winged	0-4,0.7-10.5,0.9-13,1-1.8,1-10,1-2,1-3.8,1.1-8.1,2-6,2.5-17,20-60,4-10,4-13,4-8,5-35,5.5-27,9-11,acute,attenuate,blue,broadly,brownish,capitate,chartaceous,cm,condition,connate,connivent,dark,densely,dot,drying,fresh,glabrous,glaucous,globose,green,green-white,greenish,herb,homostylous,lanceolate,light,long,lunate,membranous,mm,moderately,mottled,mucilaginous,narrowly,odd-pinnate,ovate,ovoid,pentagonal,pubescent,purple,rotate-pentagonal,scale-like,scattered,subglabrous,throughout,tinged,unwinged,violet,wet,white,whitish	clavate,present,winged
69	wfo-0001026663	success	247	122	83	95	152	27	78	5	-2.9,1,1-3.2,1-5,1.1,1.1-2.1,1.2-2,1.6-2.3,10-26,12-14,2-12,2.1-2.6,2.8-5.3,24-45,31,4.7-25.9,5.5-8.8-9.7,abaxially,acuminate,adaxially,angled,anther,anthesi,apex,attenuate,bark,base,becoming,berry,blunt-tipped,branch,branched,brown,bud,calyx,cm,conical,corolla,dark,densely,diameter,distributed,drying,echinoid-pubescent,elongated,entire,exserted,filament,fleshy,flower,fruit,globose,granular,green,greenish-brown,grooved,hair,immature,lanceolate,leaf,length,less,long,longitudinally,margin,midrib,mm,obtuse,ovate-lanceolate,pale,pedicel,peduncle,petiole,rich,scabrous,short,shrub,side,simple,small,stem,stigma,strongly,style,subglobose,terete,tip,tomentose,tree,unarmed,vein,violet,white,whitish,x	.5-2.5,/25-1/15,/3,0-160,0.2-0.6,0.3-0.8,0.4-2.2,0.9-1.5,1-2.5,1.4-2.6,1.4-3.1,1.9-2.6,1/2,1/3,1/4-1/2,10.3-13.2-15,2.5-3.7,2.9-5,2/3,3-5,3.5-5,3.8-5.7,4.5-5.7-8,5-8,5.5-7.5-9,8-17,accrescent,acute,adaxiall,ag,along,apart,apparently,appressed,around,articulated,ascending,axe,axillary,blade,broadly,capitat,chartaceous,closely,completely,constricted,covering,cylindrical,directed,distally,eaf,echinoi,echinoid,edge,eed,enveloping,especially,evident,farinose,flared,free,fruiting,glabrescen,glabrescent,glabrous,granular-tomentose,inserted,lateral,lengthening,light,line,lined,lobe,lobed,long-stalke,long-stalked,longer,longitudinal,lower,m.,main,many,matur,midvein,minute,multangulate,multangulate-pubescent,nearly,nflorescence,occasional,occuring,older,opening,openly,orolla,ovate,ovate-lanceolat,perfect,persistent,plurifoliate,pore,poricidal,porrect-stellate,present,pseudo-terminal,pubescence,pubescent,rachi,rather,ray,ridged,robust,ruit,runk,sessile,short-stalked,slightly,slit,sometimes,somewhat,soon,spaced,sparsely,stalk,stalked,stamen,stellate,subcampanulate,subcoriaceous,subglabrous,suture,tall,tamen,tangled,thick,thin,time,tomentose-pubescent,tomentum,touching,tube,ud,unarme,unit,upper,usually,vary,way,wide,yellow,ympodial,young	5.5-9,arrangement,capitate,characteristic,colour,exertion,form,glabrousnes,growth,height,history,inflorescence,life,lobing,na,new,ovary,perennial,plant,primary,pseudoterminally,seed,shape,size,surface,texture,type	-2.9,1,1-3.2,1-5,1.1,1.1-2.1,1.2-2,1.6-2.3,10-26,12-14,2-12,2.1-2.6,2.8-5.3,24-45,31,4.7-25.9,5.5-8.8-9.7,abaxially,acuminate,adaxially,angled,anthesi,apex,attenuate,becoming,berry,blunt-tipped,branched,brown,calyx,cm,conical,dark,densely,diameter,distributed,drying,echinoid-pubescent,elongated,entire,exserted,fleshy,flower,fruit,globose,granular,green,greenish-brown,grooved,hair,immature,lanceolate,less,long,longitudinally,midrib,mm,obtuse,ovate-lanceolate,pale,rich,scabrous,short,shrub,side,simple,small,strongly,subglobose,terete,tip,tomentose,tree,unarmed,violet,white,whitish,x	5.5-9,capitate,na,perennial,pseudoterminally
70	wfo-0001026686	success	196	133	96	109	87	24	91	5	.4,0.6-0.9,1-2,1-2.5,1.2-3.4,1.5-7,1.7-2.5,10-28,2-10,2.4-3.6,2.5-8,3-4,3-5,3.7-8,4-6,5,5-16.5,5-8,6.5-12.7,7-9,8-10,8-27,abaxially,acumen,adaxially,anther,axillary,berry,blade,borne,brownish,bud,cell,chartaceous,cm,condition,conical,connivent,corolla,covering,densely,diameter,distal,drying,end,filament,flower,forked,fresh,fruit,generally,glabrous,green,green-white,greenish,hair,hair-like,half,herb,homostylous,interjected,lanceolate,lateral,leaf,leaflet,light,like,lobe,long,make,minute,mm,mottled,mucilaginous,odd-pinnate,orbicular,ovate,ovoid,pedicel,peduncle,petiole,plant,pubescent,purple,purple-violet,ripe,rotate-stellate,seed,semierect,singly,size,sparsely,stigma,style,subsessile,subtending,terminal,testal,thick,throughout,tube,tuber,typically,usually,wall,wet,whitish,wide,x	0.2-0.5,1,1-10,1.2-3.6,2-9,5-merou,8-14,absent,acuminate,ag,along,alyx,apart,apex,apparently,articulated,axe,base,capitat,ciliate,decreasing,digestion,dorsally,eaf,edge,eed,elliptic-lanceolate,enzyme,equal,erec,especially,exceeding,flat,folded,geminat,glabrou,gradually,honeycomb-shaped,larger,lengthening,living,lower,margin,middle,midrib,minutely,nflorescence,obtuse,often,orolla,pair,perfect,petiolule,plurifoliate,pore,poricidal,puberulent,pubescen,removed,round,ruit,secondary,seudostipule,slightly,slit,spaced,specimen,stamen,star,ste,stolo,straight,stripe,subequal,symmetrical,tall,tamen,tem,tip,toward,tri-,unit,vary,white,wing,yellow,ympodial	5-merous,arrangement,calyx,capitate,colour,erect,form,growth,height,history,inflorescence,length,life,ovary,presence,pseudostipule,shape,staman,stem,stolon,surface,texture,type,width	.4,0.6-0.9,1-2,1-2.5,1.2-3.4,1.5-7,1.7-2.5,10-28,2-10,2.4-3.6,2.5-8,3-4,3-5,3.7-8,4-6,5,5-16.5,5-8,6.5-12.7,7-9,8-10,8-27,abaxially,adaxially,axillary,berry,borne,brownish,bud,cell,chartaceous,cm,condition,conical,connivent,covering,densely,distal,drying,end,flower,forked,fresh,fruit,generally,glabrous,green,green-white,greenish,hair,hair-like,half,herb,homostylous,lanceolate,lateral,light,like,long,make,minute,mm,mottled,mucilaginous,odd-pinnate,orbicular,ovate,ovoid,plant,pubescent,purple,purple-violet,ripe,rotate-stellate,seed,semierect,singly,sparsely,subsessile,subtending,terminal,testal,thick,throughout,typically,usually,wall,wet,whitish,wide,x	5-merous,capitate,erect,stem,stolon
71	wfo-0001026696	success	139	98	65	75	64	23	63	2	0.3-4.5,0.8-7,0.9-7.2,1,1-1.3,1-4,1.3-2.1,2-17,2-3,3-17,3-3.5,3-6,3-8.5,4-16,9,abaxially,acumen,acute,adaxially,apex,apical,apically,apiculate,base,branched,broadly,calyx,cm,connate,corolla,cuneate,cyme,decurrent,dehiscent,densely,diameter,dichasial,dichasially,ebracteate,filament,forked,globose,green,herbaceous,introrse,lanceolate,light,linear,long,maturing,mm,monochasial,mucilaginous,oblong,obtuse,odd-pinnate,often,ovate,ovoid,pedicel,peduncle,perennial,petiole,plant,poricidally,pubescent,rounded,seed,short,slit,stellate,style,throughout,white-cream,yellow	1.5-3,3-6-foliat,5-35,articulate,cell,covering,digestion,distal,dorsally,eaf,edge,eed,emoval,entire,enzyme,exceeding,flat,flower,folded,generally,globo,green-white,hair-like,half,honeycomb,lateral,light-yello,living,lobe,lon,lower,lunat,make,margin,nflorescence,nther,orolla,pattern,perfect,plan,proximal,reveal,ruit,seudostipule,simple,sinuate,specimen,stamen,stigma,straight,tal,tem,testal,thick,throughou,tuber-bearing,typically,unit,vary,wall,wide,without,ympodial,Â¼	anther,arrangement,colour,form,fruit,growth,height,history,inflorescence,leaf,length,life,light-yellow,ovary,pseudostipule,shape,size,stem,surface,texture,type,wet,width	0.3-4.5,0.8-7,0.9-7.2,1,1-1.3,1-4,1.3-2.1,2-17,2-3,3-17,3-3.5,3-6,3-8.5,4-16,9,abaxially,acumen,acute,adaxially,apical,apically,apiculate,branched,broadly,cm,connate,cuneate,cyme,decurrent,dehiscent,densely,dichasial,dichasially,ebracteate,forked,globose,green,herbaceous,introrse,lanceolate,light,linear,long,maturing,mm,monochasial,mucilaginous,oblong,obtuse,odd-pinnate,often,ovate,ovoid,perennial,poricidally,pubescent,rounded,short,slit,stellate,throughout,white-cream,yellow	light-yellow,wet
72	wfo-0001026706	success	228	118	87	98	130	20	83	4	-5.5,0-240,0.2-0.3,0.8-1.2,0.8-2.8-4.4,0.9-2,1-2.2-3.1,1-5,1.5-3,12,2.7-4,4,4.5-5.5,5.3-6.4,6-10,abaxially,acute,adaxially,anther,apart,apex,appearing,articulated,attenuate,bark,base,berry,blunt-tipped,branch,branched,brown,bud,calyx,closely,cm,corolla,crisped,cuneate,diameter,entire,exserted,filament,fleshy,flower,fruit,glabrate,globose,golden,grayish,green,herbarium,lanceolate,leaf,length,many,margin,mm,oblong,obtuse,occasionally,ovate,ovate-elliptic,ovate-lanceolate,pale,pedicel,peduncle,petiole,reddish,reticulate-punctate,shrub,simple,slightly,small,softly,soon,spaced,specimen,stem,stigma,strongly,style,subconical,subglobose,suborbicular,sulcate,surface,tall,time,tomentose-pubescent,tree,velutinous,wavy,white,whitish,x,yellow,yellowish-tan,young	.5,/14-1/6,0.2-0.5,0.6-2.2-6.1,0.8-1.5,0.9-1.9,1.1-4,1/2-2/3,10-15,14-32,2.2-3.3,2.3-3.8,2.5-3,2.9-6,2/3-3/4,3-4.6,3.1-3.8,3.6-5.7,4.2-12,5-6.5,6-8,6.1-9.8-15.4,7-16,8-14,accrescent,adaxiall,ag,anthesi,apparently,around,axe,axillary,ba,becoming,blade,capitat,chartaceous,completely,coriaceous,covering,cylindrical,dark,dendritic-echinoid,dendritic-multangulate,densely,directed,distally,eaf,edge,eed,enveloping,farinose,fourth,free,fruiting,furfuraceou,glabrous,hair,indument,inserted,lackin,lacking,lateral,lengthening,lobe,lobed,long,long-stalked,longitudinal,lower,m.,main,matted,midrib,minute,mixed,multangulat,multangulate,nearly,nflorescence,obscured,often,older,orolla,perfect,persistent,plurifoliate,pore,poricidal,porrect-stellate,pseudo-terminal,pubescence,pubescent,rachi,rather,ruit,runk,semi-ovate,sessile,short-,short-stalked,side,slit,somewhat,sparsely,splitting,stalked,stamen,stellate,subcampanulate,suture,tamen,thin-walled,tip,tomentu,touching,translucent,transparent,tube,ud,unarme,unarmed,unevenly,unit,upper,vary,vein,way,wide,ympodial	6.1-15.4,arrangement,capitate,characteristic,colour,exertion,form,growth,height,inflorescence,lobing,ovary,plant,pseud-terminal,seed,shape,size,texture,trunk,type	-5.5,0-240,0.2-0.3,0.8-1.2,0.8-2.8-4.4,0.9-2,1-2.2-3.1,1-5,1.5-3,12,2.7-4,4,4.5-5.5,5.3-6.4,6-10,abaxially,acute,adaxially,apart,apex,appearing,articulated,attenuate,base,berry,blunt-tipped,branch,branched,brown,calyx,closely,cm,crisped,cuneate,diameter,entire,exserted,fleshy,flower,fruit,glabrate,globose,golden,grayish,green,herbarium,lanceolate,many,mm,oblong,obtuse,occasionally,ovate,ovate-elliptic,ovate-lanceolate,pale,reddish,reticulate-punctate,shrub,simple,slightly,small,softly,soon,spaced,specimen,strongly,subconical,subglobose,suborbicular,sulcate,tall,time,tomentose-pubescent,tree,velutinous,wavy,white,whitish,x,yellow,yellowish-tan,young	6.1-15.4,capitate,pseud-terminal,trunk
73	wfo-0001026707	success	194	110	78	91	103	19	76	2	.5,/3,0.3-0.8,0.5-1,0.5-3,0.6-0.7,0.6-0.8,0.7-1,0.7-1.4,1-1.7,1.5-1.8,1.6-2,1/3,2-2.3,2.5-4,2.5-6,3-4,3-4.5,3-7,4,5-25,8-15,?,acute,anther,apex,apically,apparently,articulated,bark,base,berry,branched,broad-deltate,calyx,clustered,cm,connivent,diameter,entire,erect,filament,flattened-reniform,fruit,fruiting,glabrous,gray,green,lateral,leaf,length,long,lower,mauve,mm,moderately,narrow-deltate,narrow-oblong,obtuse,orange-brown,pedicel,peduncle,per,petiole,poricidal,prickle,pubescent,red-brown,rounded,shrub,simple,small,sometimes,sparsely,spherical,stellate-pubescent,stem,straight,style,surface,tapering,terete,terminal,tip,tree,unarmed,upper,way,white,wide,Â¼	.8,0-20,0-3,0-5,0.05,0.05-0.15,0.1-0.2,0.7-1.5,1-3,1-5,1/3-1/2,1/3-3/4,1/4-1/3,1/8-1/4-1/3,11-16,2-10,2-6,2.5-3,3-8,5-10,5-7,5-8,5-merous,abaxially,alyx,apar,apart,attenuate,blade,branche,broadly,chartaceous,color,concolorous,curved,cuspidat,decurrent,densely,discolorous,drying,eaf,eed,elongating,equal,eye,flower,foliaceous,free,fused,gently,glabrescent,glabrou,inflated,infructescence,juvenil,known,less,lobe,lobed,longer,margin,mature,midpoint,naked,nflorescence,older,one,open,orolla,oung,perfec,pericarp,plurifoliat,porrect,porrect-lepidote,portion,prickly,ray,reflexed,ruit,scar,sessile,shorter,slender,smooth,spaced,spreading,stalk,stalked,stellate,stout,tamen,time,trichome,tube,unit,variously,vary,venation,visible,weakly,yellow-green,ympodial	arrangement,branch,characteristic,colour,corolla,cuspidate,form,growth,height,inflorescence,lobing,ovary,plant,seed,shape,size,texture,type,width	.5,/3,0.3-0.8,0.5-1,0.5-3,0.6-0.7,0.6-0.8,0.7-1,0.7-1.4,1-1.7,1.5-1.8,1.6-2,1/3,2-2.3,2.5-4,2.5-6,3-4,3-4.5,3-7,4,5-25,8-15,?,acute,apically,apparently,articulated,base,berry,branched,broad-deltate,clustered,cm,connivent,diameter,entire,erect,flattened-reniform,glabrous,gray,green,lateral,long,lower,mauve,mm,moderately,narrow-deltate,narrow-oblong,obtuse,orange-brown,per,poricidal,pubescent,red-brown,rounded,shrub,simple,small,sometimes,sparsely,spherical,stellate-pubescent,straight,surface,tapering,terete,terminal,tip,tree,unarmed,upper,way,white,wide,Â¼	branch,cuspidate
74	wfo-0001026711	success	207	158	124	137	70	21	122	2	-7,.8,0-0.2,0-25,0-4,0-5,0-6,0.15,0.2-0.3,0.3-1,0.5-1.5,0.7-0.9,0.7-0.9-1.1,0.7-1.4,0.75-1,0.9-1.5,1-2,1-2-4-6,1.5-2.2,1/2-2/3,1/3,1/4,2-2.2,2-3.5,2-6,2.1-2.5,3-4,3-4.5,3-5,4-8,4.5-7,7-8,abaxially,acute,ame,anther,apex,apically,apparently,articulated,bark,base,berry,branched,c.,calyx,cell,cm,connivent,cuneate,curved,deltate,densely,diameter,distance,dull,elliptic,erect,evenly,extending,filament,flattened-reniform,flower,fruit,fruiting,glabrous,green,infructescence,lateral,leaf,length,lobe,lobed,long,lower,margin,maturity,mauve,midpoint,midvein,mm,narrow-deltate,obtuse,occasionally,one,open,orange,orange-brown,outline,pale,pedicel,peduncle,per,petiole,pit,poricidal,porrect,prickle,prickly,purple,raised,ray,red,reduced,rounded,shallowly,shrub,side,slender,small,smooth,sometimes,spherical,spreading,stalk,stalked,stellate,stellate-pubescent,stem,style,surface,tapering,terminal,time,tip,trichome,tube,unarmed,uniform,upper,variously,way,weakly,wide,yellow,yellow-green,young	-15,-5,.2,.5,0-2,0-7,0.1,0.8,0.8-2.2,1-30,1.5-2-2.5,1.7-4,1/,1/4-1/3,3-7,3.5-5.2,5-merous,acicular,acuminat,alyx,apar,apart,blade,brow,concolorous,difoliate,discolorous,drying,eaf,eed,elongating,equal,faint,free,geminat,less,longer,mature,moderately,nflorescence,older,orolla,oung,pair,pendulous,perfec,pericarp,perpendicular,portion,prickl,primary,reflexed,ruit,scar,sessile,shorter,somewhat,spaced,straight,tamen,terete,tertiary,thick-chartaceous,unit,vary,vein,venation,visible,woody,ympodial	acuminate,arrangement,branch,brown,characteristic,colour,corolla,exertion,form,glabrousnes,growth,height,inflorescence,lobing,new,ovary,plant,seed,shape,texture,type	-7,.8,0-0.2,0-25,0-4,0-5,0-6,0.15,0.2-0.3,0.3-1,0.5-1.5,0.7-0.9,0.7-0.9-1.1,0.7-1.4,0.75-1,0.9-1.5,1-2,1-2-4-6,1.5-2.2,1/2-2/3,1/3,1/4,2-2.2,2-3.5,2-6,2.1-2.5,3-4,3-4.5,3-5,4-8,4.5-7,7-8,abaxially,acute,ame,apically,apparently,articulated,base,berry,branched,c.,cell,cm,connivent,cuneate,curved,deltate,densely,diameter,distance,dull,elliptic,erect,evenly,extending,flattened-reniform,flower,glabrous,green,infructescence,lateral,length,lobe,lobed,long,lower,maturity,mauve,midpoint,midvein,mm,narrow-deltate,obtuse,occasionally,one,open,orange,orange-brown,outline,pale,per,pit,poricidal,porrect,prickle,prickly,purple,raised,ray,red,reduced,rounded,shallowly,shrub,side,slender,small,smooth,sometimes,spherical,spreading,stalk,stalked,stellate,stellate-pubescent,surface,tapering,terminal,time,tip,trichome,unarmed,uniform,upper,variously,way,weakly,wide,yellow,yellow-green,young	acuminate,brown
75	wfo-0001026717	success	207	160	121	135	72	25	116	5	0.3-0.6,0.6-1.5,1-10,1-2,1-2.5,1.3-2.5,1.4-2.2,1.8-3,13-28,14-22,2.5-4.5,2.5-5.5,3-4,3-6,3.3-11,4-6,4-8,4-9,5,5-11,5-13.5,5-6,5.3-9,7-11,abaxially,acuminate,adaxially,along,anther,apart,apex,attenuate,axillary,base,berry,blade,borne,brownish,bud,cell,chartaceous,ciliate,cm,condition,conical,connivent,corolla,covering,dark,diameter,distal,dorsally,drying,edge,elliptic,end,especially,filament,flat,flower,folded,forked,fresh,fruit,generally,glabrous,green,green-white,greenish,hair,hair-like,half,herb,homostylous,interjected,lanceolate,lateral,leaf,leaflet,light,like,lobe,long,make,margin,medium,membranous,midrib,minute,minutely,mm,mottled,mucilaginous,obtuse,odd-pinnate,orbicular,ovate,ovoid,pedicel,peduncle,pentagonal,petiole,plant,puberulent,pubescent,purple,ripe,rotate,round,seed,semierect,sessile,singly,size,sparsely,stigma,straight,style,subtending,terminal,testal,thick,throughout,tip,tube,tuber,typically,usually,violet,wall,wet,whitish,wide,x,yellow	0.3-2.5,0.3-5,0.8,1-3,15-34,2.2-5,3-5,5-merou,acumen,ag,alyx,apparently,articulated,axe,capitat,darker,decreasing,decurrent,digestion,eaf,eed,enzyme,equal,erec,exceeding,geminat,glabrou,gradually,honeycomb-shaped,larger,lengthening,living,lower,middle,narrow,nflorescence,often,one-quarte,orolla,pair,perfect,petiolule,plurifoliate,pore,poricidal,present,pubescen,removed,ruit,secondary,seudostipule,slightly,slit,spaced,specimen,stamen,ste,stolo,stripe,subequal,subglabrous,subsessile,symmetrical,tall,tamen,tem,toward,tri-,unit,vary,wing,ympodial	5-merous,arrangement,calyx,capitate,colour,erect,form,growth,height,history,inflorescence,length,life,ovary,presence,pseudostipule,pubescence,shape,spacing,stem,stolon,surface,texture,type,width	0.3-0.6,0.6-1.5,1-10,1-2,1-2.5,1.3-2.5,1.4-2.2,1.8-3,13-28,14-22,2.5-4.5,2.5-5.5,3-4,3-6,3.3-11,4-6,4-8,4-9,5,5-11,5-13.5,5-6,5.3-9,7-11,abaxially,acuminate,adaxially,along,apart,attenuate,axillary,berry,borne,brownish,bud,cell,chartaceous,ciliate,cm,condition,conical,connivent,corolla,covering,dark,distal,dorsally,drying,elliptic,end,especially,flat,flower,folded,forked,fresh,fruit,generally,glabrous,green,green-white,greenish,hair,hair-like,half,herb,homostylous,lanceolate,lateral,light,like,long,make,margin,medium,membranous,midrib,minute,minutely,mm,mottled,mucilaginous,obtuse,odd-pinnate,orbicular,ovate,ovoid,pentagonal,plant,puberulent,pubescent,purple,ripe,rotate,round,seed,semierect,sessile,singly,sparsely,straight,subtending,terminal,testal,thick,throughout,tip,typically,usually,violet,wall,wet,whitish,wide,x,yellow	5-merous,capitate,erect,stem,stolon
76	wfo-0001026725	success	166	88	55	67	99	21	50	5	/4,0.7-1.2,1-1.2,1-1.5,1-4.5,1-5,1.2-1.7,1.6-2,5-20-flowered,anther,bark,base,beneath,berry,black,bluish,broadly,calyx,capitate,cm,corolla,cup-shaped,dark,dia,difoliate,drying,ellipsoid,elliptic,flattened-reniform,fruit,fruiting,glabrous,glandular-papillose,globose,green,greenish-white,large,leaf,lobed,long,minutely,mm,ovary,ovate,ovoid,paler,papillose,pedicel,petiole,pitted,pubescent,reddish-brown,shaped,shrub,simple,size,slender,stem,stigma,stretching,style,subshrub,surface,tear-drop,unit,way,white	.3,.5,0.2,1.5,1.5-2,1/2,2,2.2-4,3.5-4,3.6-7.7,5-5.5,5-6,8-18.6,8-9,accrescent,acute,anthesi,apart,apex,attenuate,axil,becoming,brownish-papillose,character,crackin,deflexed,differing,dry,eaf,edicel,eed,evenly,extremely,filament,free,geminat,geographically,incrassate,inflorescenc,interpetalar,lateral,less,lobe,lon,lower,main,major,margin,margine,material,middle,minor,nflorescence,occasionally,often,older,one,onto,open,opposite,pair,pale,papillo,planar,pore,poricidal,portion,prominent,proximal,reflexed,rounded,ruit,scar,scarious,short,sinus,slightly,spaced,split,straight,tall,tan,tapering,tip,triangular,trichome,tube,tuft,ud,uniseriate,upper,varying,vein,widest,winged,woody,x,ympodial,young	arrangement,bud,characteristic,colour,cracking,diameter,exertion,form,geminate,growth,height,history,inflorescence,length,life,plant,seed,shape,sympodial,texture,type	/4,0.7-1.2,1-1.2,1-1.5,1-4.5,1-5,1.6-2,5-20-flowered,base,beneath,berry,black,bluish,broadly,capitate,cm,cup-shaped,dark,difoliate,drying,ellipsoid,elliptic,flattened-reniform,glabrous,glandular-papillose,globose,green,greenish-white,large,lobed,long,minutely,mm,ovate,ovoid,paler,papillose,pitted,pubescent,reddish-brown,shaped,shrub,simple,slender,stretching,subshrub,tear-drop,unit,way,white	.2-1.7,cracking,di,geminate,sympodial
77	wfo-0001026733	success	183	152	90	98	85	54	87	3	0.3-0.5,0.3-2,0.5-2,1-3,1-7,1.5-14,10-20,15-20-50,2-2.5,2.5-7.5,25-40,3-15,3-3.5,4,4-23,4-5,5-8,abaxially,acuminate,acute,acute-acuminate,adaxially,apex,axe,basal,base,calyx,chartaceous,cm,color,connivent,cordate,deltate,densely,diameter,eglandular-pubescent,eglandular-villous,ellipsoidal,elliptic-ovate,entire,especially,flattened,flower,forked,fruit,fusiform,glabrate,glabrous,glandular-,glandular-puberulent,glandular-tomentose,green,greyish,hair,hirsute,immature,lanceolate,lobe,long,longitudinal,margin,midrib,mm,moderately,narrowly,oblique,ovate,ovoid,pedicel,peduncle,perfect,petiole,pilose,pubescent,pubescent-pilose,ripe,shining,simple,sometimes,sparsely,stigma,stripe,style,submarginally,toward,tree,triangular,truncate,tube,unbranched,unknown,vein,white,white-puberulent,wide,x,yellow,yellowish	-11,-13,-4,-7,-8,.5-3,0.3-0.5-1,0.5,0.5-1,0.5-4,1-1.5,1-2,1.5-2,1.5-2.5,2-3,2-4,2-6,3-4-foliat,3-7,4.5-5,7-10-14,8-12-15,aggregate,apart,ape,articulated,beyond,blade,capitat,cell,ciliat,connective,curled,cylindrical,dense,dia,directed,distally,eaf,eed,eglandular-pilose,equal,exceeding,exserted,gland-tipped,glandula,leaving,linear-triangular,lon,lower,membranaceous,near,nflorescence,nther,orolla,ovum,pedicellar,pore,present,pubescent-pilo,rachi,radiu,remnant,round,ruit,shorter,slightly,small,smooth,spaced,stamen,stellate,stone,swelling,tal,tem,thecae,time,ud,unit,unknow,usually,vary,villous,ympodial	anther,appearance,arrangement,bark,border,branch,bud,capitate,characteristic,colour,corolla,corrugation,distal,drying,exertion,filament,form,fruiting,giving,glabrousnes,glandular,growth,height,history,inflorescence,interjected,lateral,leaf,leaflet,length,life,lobing,midpoint,na,new,number,ovary,per,plant,prickle,primary,pseudostipule,ray,seed,shape,size,stem,surface,terminal,texture,thicknes,type,variation,width	0.3-0.5,0.3-2,0.5-2,1-3,1-7,1.5-14,10-20,15-20-50,2-2.5,2.5-7.5,25-40,3-15,3-3.5,4,4-23,4-5,5-8,abaxially,acuminate,acute,acute-acuminate,adaxially,apex,axe,basal,chartaceous,cm,color,connivent,cordate,deltate,densely,eglandular-pubescent,eglandular-villous,ellipsoidal,elliptic-ovate,entire,especially,flattened,flower,forked,fruit,fusiform,glabrate,glabrous,glandular-,glandular-puberulent,glandular-tomentose,green,greyish,hair,hirsute,immature,lanceolate,lobe,long,longitudinal,midrib,mm,moderately,narrowly,oblique,ovate,ovoid,perfect,pilose,pubescent,pubescent-pilose,ripe,shining,simple,sometimes,sparsely,stripe,submarginally,toward,tree,triangular,truncate,unbranched,unknown,white,white-puberulent,wide,x,yellow,yellowish	capitate,glandular,na
78	wfo-0001026734	success	266	125	87	94	172	31	77	10	0.5,0.6,1,3,abaxial,absent,acuminate,anther,anthesi,apex,base,becoming,berry,bright,broadly,brown,calyx,chartaceous,clavate,cm,congested,corolla,cuneate,cylindrical,cyme,densely,diameter,distally,elliptic,emergent,entire,flattened,flower,fruit,glabrescent,glabrous,globose,green,growth,immature,irregular,lanceolate,leaf,length,less,lobe,lobed,long,long-attenuate,margin,mature,maturity,membranaceous,mm,moderately,narrow,new,oblong,observed,obtuse,ovary,pale,pedicel,peduncle,petiole,pit,plane,porrect-stellate,pubescent,purple,purplish,reniform,scandent,sessile,shape,short-stalked,shrub,simple,size,slightly,sparsely,spreading,stem,stigma,style,subsessile,surface,trichome,tube,unbranched,white,wide,yellowish,Â¾	0.1,0.2,0.3,0.7â0.9,0.7â1,0.8â1,1.6â2,1.6â2.5,1.8â2.2,1.8â3,1/4,1â1.2,1â3,2.2â7,2.3â5,2.5â3,2â2.4,2â3,3.2â3.8,3â4,3â4-celled,3â8,4â6,4â7,4â8,4â9,5-merou,5â9,8,abaxially,accrescent,acute,adaxial,adaxiall,adaxially,ag,also,always,alyx,apical,apice,archin,ark,articulated,associated,asymmetric,axi,barely,beneat,beneath,blade,branch,branched,caly,camptodromous,capitate,celled,central,closely,commonly,connivent,covered,covering,dark,dense,denser,differing,directed,discolorous,downward,dried,drying,due,eaf,eed,eglandular,erect,f.,fewer,flat,foliate,forked,found,free,frequently,geminate,glabrescen,glandular,gray,hair,held,ilament,initially,internodal,introrsely,j,lamina,large,lateral,longer,longitudinal,lower,lying,material,maturit,midpoint,midri,minute,mostly,much,multiseriate,near,nflorescence,normally,obovate,often,old,older,one,one-celled,opening,orolla,other,oung,ovate,pair,paired,papillose,perfect,pointing,pore,poricidal,porrect,portion,pubescence,rachi,raised,rarely,ray,rayed,reaching,rounded,ruit,secondary,shiny,shorter,slit,smaller,sometimes,spaced,sparse,spread,stalk,stellate,still,subopposite,surfac,terminal,tuft,ud,unequal,uniseriate,unit,upward,vary,vein,venation,vestiture,visible,whole,yellow,ympodial	0.7-0.9,0.8-1,1.8-3,2-2.4,2-3,2.3-5,2.5-3,3-8,5-9,arrangement,bark,bud,characteristic,colour,exertion,filament,form,fruiting,glabrousnes,height,history,inflorescence,life,lobing,midrib,number,per,plant,seed,texture,type	0.5,0.6,1,3,abaxial,absent,acuminate,anthesi,base,becoming,berry,bright,broadly,brown,calyx,chartaceous,clavate,cm,congested,cuneate,cylindrical,cyme,densely,diameter,distally,elliptic,emergent,entire,flattened,flower,fruit,glabrescent,glabrous,globose,green,immature,irregular,lanceolate,length,less,lobe,lobed,long,long-attenuate,mature,maturity,membranaceous,mm,moderately,narrow,oblong,observed,obtuse,pale,pit,plane,porrect-stellate,pubescent,purple,purplish,reniform,scandent,sessile,short-stalked,shrub,simple,slightly,sparsely,spreading,stem,subsessile,trichome,unbranched,white,wide,yellowish,Â¾	0.7-0.9,0.8-1,1.8-3,2-2.4,2-3,2.3-5,2.5-3,3-8,5-9,midrib
79	wfo-0001026740	success	171	142	79	90	81	52	78	1	0-10,0.5-1,1-2,1-5,10-20,10-30,2-3,2.5-27,2.5-4.5,2.5-6,3-15,3-3.5,3.5-40,4-5,4.5-10,5-40,6-10,abaxially,acuminate,acute,acute-acuminate,adaxially,also,apex,apiculate,basal,base,beyond,branched,calyx,cm,connivent,cordate,curled,darker,deltate,densely,diameter,eglandular,ellipsoidal,elliptic,entire,exserted,flattened,fleshy,flower,fruit,glabrate,glabrous,greenish,hair,immature,lanceolate,lobe,long,margin,mature,mm,moderately,narrowly,oblong,obtuse,often,ovate,ovoid,pedicel,peduncle,petiole,pilose,present,puberulent,purple,reticulate,simple,sparsely,stamen,stigma,stripe,style,tree,triangular,truncate,tube,unbranched,vein,violet,white-puberulent,whitish,x,yellow	-17,-2,1-10,1-12,1-3,1-4,2-4,2.5-3,20-50,3-5,3-foliat,5-8,8-19,absen,absent,aggregate,apart,ape,articulated,axe,blade,browni,cell,ciliate,connective,corky,cylindrical,directed,distally,eaf,eed,equal,especially,exceeding,glandular-puberulent,leaving,lon,lower,near,nearly,nflorescence,nther,orange,orolla,pedicellar,perfect,pilo,pore,pubescent,rachi,radiu,rarely,remnant,ruit,scar,sessile,shorter,slightly,small,sometimes,spaced,stellate,stone,subcoriaceous,swelling,tal,tems,thecae,time,tomentose,toward,truncat,ud,unit,unlobed,vary,villous,wide,woody,ympodial,young	anther,appearance,arrangement,bark,border,branch,bud,characteristic,colour,corolla,corrugation,distal,drying,exertion,filament,form,fruiting,giving,glabrousnes,growth,height,history,inflorescence,interjected,lateral,leaf,leaflet,length,life,lobing,midpoint,na,new,number,ovary,per,plant,prickle,primary,pseudostipule,ray,seed,shape,size,stem,surface,terminal,texture,thicknes,type,variation,width	0-10,0.5-1,1-2,1-5,10-20,10-30,2-3,2.5-27,2.5-4.5,2.5-6,3-15,3-3.5,3.5-40,4-5,4.5-10,5-40,6-10,abaxially,acuminate,acute,acute-acuminate,adaxially,also,apex,apiculate,basal,beyond,branched,cm,connivent,cordate,curled,darker,deltate,densely,eglandular,ellipsoidal,elliptic,entire,exserted,flattened,fleshy,flower,glabrate,glabrous,greenish,hair,immature,lanceolate,lobe,long,mature,mm,moderately,narrowly,oblong,obtuse,often,ovate,ovoid,pilose,present,puberulent,purple,reticulate,simple,sparsely,stamen,stripe,tree,triangular,truncate,unbranched,violet,white-puberulent,whitish,x,yellow	na
80	wfo-0001026752	success	166	139	76	85	81	54	73	3	-4,1,1-12,1-5,1-6,1.5-2.5,10-20-25,2,2-2.5,2.5-20,2.5-5,3.5-4,4-45,4-5,abaxially,abruptly,acute,adaxially,apex,apiculate,basal,base,beyond,black,branched,calyx,chartaceous,cm,connivent,cordate,cuneate,darker,deltate,densely,diameter,ellipsoidal,elliptic-oblong,elliptic-ovate,entire,exserted,finely,flattened,fleshy,forked,fruit,glabrous,globose,green,greenish-brown,immature,lanceolate,lobe,margin,mm,narrowly,obtuse,ovoid,pedicel,peduncle,petiole,pilose,possibly,pubescent,pubescent-pilose,purplish,rarely,rather,ripe,short-acuminate,simple,stamen,stigma,stripe,style,tree,triangular,truncate,tube,unbranched,vein,violet,white,whitish,x,yellow	0-1-2-3,1-1.5,1-2,1-3,1.5-12,1.5-2,15-35-50,2-3,2-4,20-30,3,3-18,3-4,3-5,3-foliat,7-15,8-16,absent,aggregate,also,apart,ape,articulated,axe,blade,campanulate,capitat,cell,connective,coriaceous,cylindrical,dilated,directed,distally,eaf,eed,equal,exceeding,flower,hair,laterally,leaving,less,lon,long,lower,moderately,near,nearly,nflorescence,nther,orolla,papillose,pedicellar,perfect,pilo,pore,presence,present,rachi,radiu,remnant,ruit,slightly,small,somewhat,spaced,stellate,stone,tal,tem,thecae,time,tomento,ud,unit,unknow,vary,wide,yello,ympodial	anther,appearance,arrangement,bark,border,branch,bud,capitate,characteristic,colour,corolla,corrugation,distal,drying,exertion,filament,form,fruiting,giving,glabrousnes,growth,height,history,inflorescence,interjected,lateral,leaf,leaflet,length,life,lobing,midpoint,na,new,number,ovary,per,perennial,plant,prickle,primary,pseudostipule,ray,seed,shape,size,stem,surface,terminal,texture,thicknes,type,variation,width	-4,1,1-12,1-5,1-6,1.5-2.5,10-20-25,2,2-2.5,2.5-20,2.5-5,3.5-4,4-45,4-5,abaxially,abruptly,acute,adaxially,apex,apiculate,basal,beyond,black,branched,chartaceous,cm,connivent,cordate,cuneate,darker,deltate,densely,ellipsoidal,elliptic-oblong,elliptic-ovate,entire,exserted,finely,flattened,fleshy,forked,glabrous,globose,green,greenish-brown,immature,lanceolate,lobe,mm,narrowly,obtuse,ovoid,pilose,possibly,pubescent,pubescent-pilose,purplish,rarely,rather,ripe,short-acuminate,simple,stamen,stripe,tree,triangular,truncate,unbranched,violet,white,whitish,x,yellow	capitate,na,perennial
81	wfo-0001026754	success	175	86	51	66	109	20	49	2	0.5-1,0.9-1.1,1/2,10,2-2.5,2/3,5-lobed,acute,anther,anthesi,apex,asymmetric,base,berry,broadly,calyx,clavate,cm,corolla,deeply,densely,diameter,ellipsoid,elliptic,entire,exerted,filament,glabrous,globose,growth,halfway,inflorescence,later,lateral,leaf,lobed,margin,membranous,minute,minutely,mm,narrowly,new,oblique,pedicel,peduncle,petiole,puberulent,pubescent,scandent,simple,slender,sparsely,spreading,stem,stigma,style,surface,terminal,truncate,tube,vine,way,white,yellow,yellowish	-6+,.5,0.5,1,1-1.5-3,198.,2,2-3,2-4,2.5-3.5,3-4-celled,30+,4-5,5,5-merou,5.5-9,7-9,9,9-11,abaxially,adaxially,ag,along,alyx,apar,apparently,ark,articulated,axi,basal,branched,brow,cabrera,complete,conical,connivent,cucullat,dendritic,denser,distal,divided,eaf,ed,especially,extending,fide,flower,free,half,ilament,irregularly,lamina,leaving,lengthening,like,lobe,long,loosely,lower,many,mature,midvein,mixture,mostly,nflorescence,older,orolla,outline,pair,papillo,peg,perfect,pinnate,planar,plurifoliat,pore,poricidal,portion,primary,ruit,scar,seen,sleeve,slit,small,sometimes,spaced,splitting,stellate-rotate,tangled,tem,time,tip,transparent,trichome,tub,twinin,twining,ud,uniseriate,unit,upper,vary,vein,weak,within,woody,x,ympodial	1-6,abaxial,adaxial,arrangement,bark,brown,bud,characteristic,colour,exertion,form,fruit,glabrousnes,length,lobing,ovary,shape,size,texture,type	0.5-1,0.9-1.1,1/2,10,2-2.5,2/3,5-lobed,acute,anthesi,asymmetric,base,berry,broadly,calyx,clavate,cm,deeply,densely,diameter,ellipsoid,elliptic,entire,exerted,glabrous,globose,halfway,later,lateral,lobed,membranous,minute,minutely,mm,narrowly,oblique,puberulent,pubescent,scandent,simple,slender,sparsely,spreading,terminal,truncate,vine,way,white,yellow,yellowish	1-6,brown
82	wfo-0001026756	success	147	101	66	79	68	22	63	3	.25,.5,0-7-1.2,0.5-1,0.5-3,1.5-1.7,1.5-10,1.5-2,1.5-3,1.8-3,3-4,3.5-8.5,5-10,5-10-flowered,5-5.5,6-16,abaxial,acute,anther,apex,attenuate,bark,base,berry,bilobed,brown,calyx,cm,corolla,dark,dendritic,densely,dia,difoliate,elliptic,erect,exserted,filament,fruiting,glabrous,globose,green,lax,leaf,like,long,minutely,mm,occasionally,ovary,ovate,ovoid-reniform,pale,pedicel,petiole,pinkish-white,pitted,pubescence,pubescent,rest,shape,shaped,shrub,simple,sparsely,stem,stigma,strongly,style,surface,tear-drop,thick,tree,trichome,tube,unifoliate,uniseriate,white,wide	0.25-0.5,1-1.5,1-2,6-10,abaxially,adaxially,along,anthesi,apiculate,ba,broadly,closely,conical,corresponding,deflexed,deltate,denser,differing,distal,eaf,edicel,eed,fleshy,free,geminat,glabrescent,grayish-brow,hard,inflorescenc,irregular,lamina,lateral,lobe,lobed,lower,main,major,middle,minor,nearly,nflorescence,older,opposite,overlappin,pair,papillo,perhaps,pericarp,planar,pore,poricidal,portion,present,ruit,scar,somewhat,soon,spaced,tall,tip,tub,ud,unit,vein,widest,woody,ympodial,young	adaxial,arrangement,bud,characteristic,colour,diameter,exertion,form,fruit,geminate,grayish-brown,growth,height,history,inflorescence,length,life,plant,seed,size,texture,type	.25,.5,0-7-1.2,0.5-1,0.5-3,1.5-1.7,1.5-10,1.5-2,1.5-3,1.8-3,3-4,3.5-8.5,5-10,5-10-flowered,5-5.5,6-16,acute,attenuate,base,berry,bilobed,brown,calyx,cm,dark,dendritic,densely,dia,difoliate,elliptic,erect,exserted,glabrous,globose,green,lax,like,long,minutely,mm,occasionally,ovate,ovoid-reniform,pale,pinkish-white,pitted,pubescent,rest,shaped,shrub,simple,sparsely,stem,strongly,tear-drop,thick,tree,trichome,tube,unifoliate,uniseriate,white,wide	geminate,grayish-brown,inflorescence
83	wfo-0001026777	success	168	126	91	98	70	28	86	5	.5,0.25-0.5,0.5-1,0.5-1.5,1-1.3,1-10,1-2,1-4,1.2-1.8,1.5-3,2-4,5-50-flowered,5-7,acuminate,acute,anther,apex,axil,base,beneath,berry,blue,branching,brown,calyx,capitate,cm,corolla,cup,decurrent,deflexed,dense,dia,difoliate,distal,elliptic,end,exserted,fide,filament,filiform,flattened,flattened-reniform,flexuous,fruiting,glabrate,glabrous,globose,green,growth,lateral,leaf,lobed,long,main,minutely,mm,narrowly,near,nearly,new,occasionally,often,older,onto,opposite,ovary,overtopping,papillose,pedicel,petiole,pubescent,russet,seed,shaped,shiny,shrub,size,slightly,smooth,soon,sparsely,stem,stigma,straight,style,surface,tear-drop,trichome,tube,tuft,uniseriate,unit,vein,vellozo,white,x,young	.25,/3,0.5-5,0.9-3,1-1.5,1.5-5,2-4.5,2-5,3-3.5,4-8,5-14,anthesi,apart,apiculate,ba,beginning,body,campanulate,cell,differing,eaf,edicel,eed,free,geminat,greyi,hyaline,incrassate,inflorescenc,irregularly,like,lobe,lon,lower,major,margin,matted,middle,minor,nflorescence,one,outline,pair,papillo,pitted,planar,pore,poricidal,portion,prominent,quadrate-deltoid,quite,rest,ruit,scar,sinuate,somewhat,spaced,tall,tapering,testa,thread-like,tip,ud,wall,way,widest,woody,yellowish,ympodial	alternate,arrangement,branch,bud,characteristic,colour,diameter,exertion,form,fruit,geminate,glabrousnes,greyish,height,history,inflorescence,length,life,lobing,na,number,peduncle,per,plant,shape,sympodial,texture,type	.5,0.25-0.5,0.5-1,0.5-1.5,1-1.3,1-10,1-2,1-4,1.2-1.8,1.5-3,2-4,5-50-flowered,5-7,acuminate,acute,axil,base,beneath,berry,blue,branching,brown,calyx,capitate,cm,cup,decurrent,deflexed,dense,dia,difoliate,distal,elliptic,end,exserted,fide,filiform,flattened,flattened-reniform,flexuous,glabrate,glabrous,globose,green,growth,lateral,leaf,lobed,long,main,minutely,mm,narrowly,near,nearly,new,occasionally,often,older,onto,opposite,overtopping,papillose,petiole,pubescent,russet,shaped,shiny,shrub,slightly,smooth,soon,sparsely,stem,straight,tear-drop,trichome,tube,tuft,uniseriate,unit,vein,vellozo,white,x,young	alternate,geminate,greyish,na,sympodial
84	wfo-0001026819	success	218	138	107	116	102	22	104	3	0.3-4.7,1-2,1.2-36,1.5-10,1.5-12,1.5-3.0,1.5-3.3,1.6-3.5,10-26,2-6,2.5-5,3-120,3-18,3-35,3-38,4,4-10,4-7,5-30,6-11,abaxially,acute,anther,apex,articulated,ascending,attenuate,blue,brownish,capitate,cell,chartaceous,cm,condition,connate,connivent,corolla,covering,curved,dark,densely,diameter,distal,dot,drying,especially,filament,flower,fresh,fruit,glabrous,glaucous,globose,green,green-white,greenish,greenish-yellow,hair,hair-like,herb,homostylous,lanceolate,lateral,leaflet,light,like,long,lunate,make,membranous,middle,mm,moderately,mottled,mucilaginous,non-glandular,odd-pinnate,often,ovoid,pair,pedicel,peduncle,pentagonal,plant,pubescent,purple,rotate-pentagonal,scale-like,scattered,seed,short,slightly,sometimes,somewhat,star,stem,stigma,straight,stripe,style,subglabrous,subrosette,terminal,testal,thick,throughout,tinged,unwinged,violet,wall,wet,white,whitish,wide,wing,within	0-27,0.5-1.5,1-10,1-2.3,1-5,1.5-3.5,10,2-5,3-20,5-merou,7,absent,acumen,acuminate,adaxially,ag,along,alyx,apart,base,bearing,blade,borne,broadly,bud,ciliate,clavat,cuneate,decurrent,digestion,dorsally,eaf,edge,eed,elliptic,end,enzyme,erec,exceeding,flat,folded,forked,geminat,generally,glabrou,greatly,half,honeycomb-shaped,interjected,larger,lengthening,living,lobe,lower,margin,midvein,minutely,narrowly,nflorescence,oblique,orolla,ovate,pedice,petiole,petiolule,plurifoliate,pore,poricidal,puberulent,rachi,ranging,removed,ruit,seudostipule,singly,slit,spaced,specimen,stamen,ste,stolo,subequal,suborbicular,subtending,symmetrical,tall,tamen,tem,tertiary,therefore,tip,tri-,truncate,tube,tuber,typically,unit,usually,vary,without,yellow,ympodial	5-merous,arrangement,calyx,characteristic,clavate,colour,erect,form,growth,height,history,inflorescence,leaf,length,life,ovary,pseudostipule,shape,size,surface,texture,type	0.3-4.7,1-2,1.2-36,1.5-10,1.5-12,1.5-3.0,1.5-3.3,1.6-3.5,10-26,2-6,2.5-5,3-120,3-18,3-35,3-38,4,4-10,4-7,5-30,6-11,abaxially,acute,apex,articulated,ascending,attenuate,blue,brownish,capitate,cell,chartaceous,cm,condition,connate,connivent,covering,curved,dark,densely,diameter,distal,dot,drying,especially,fresh,glabrous,glaucous,globose,green,green-white,greenish,greenish-yellow,hair,hair-like,herb,homostylous,lanceolate,lateral,light,like,long,lunate,make,membranous,middle,mm,moderately,mottled,mucilaginous,non-glandular,odd-pinnate,often,ovoid,pedicel,pentagonal,pubescent,purple,rotate-pentagonal,scale-like,scattered,seed,short,slightly,sometimes,somewhat,star,stem,straight,stripe,subglabrous,subrosette,testal,thick,throughout,tinged,unwinged,violet,wall,wet,white,whitish,wide,wing,within	5-merous,clavate,erect
85	wfo-0001026821	success	204	122	84	100	104	22	82	2	.2,0.2-1.5,0.3-1.2,0.3-2.5,0.4-1.5,0.5-3.5,0.7-1.8,1-1.5,1-2,1-3,1-5,1.5-2.5,10-15,2-6,2-celled,2.5-18,3-11,3-18,3-7,3-branched,4-4.5,5-12,5-20,5-34,adaxial,angular,anther,apically,appressed,auriculate,base,bayonet,blade,broadly,brown,cm,cordate,dark,diameter,distal,due,ellipsoidal,filament,flattened,flower,forked,fruit,gglobose,glabrous,green,hair,herb,incurved,interjected,lateral,leaflet,length,light,long,mature,membranous,mm,moderately,narrowly,obliquely,oblong,odd-pinnate,pair,pale,pedicel,peduncle,petiole,petiolule,pilose,puberulent,pubescent,rachi,rarely,remnant,reniform,rounded,slender,small,somewhat,sparsely,stellate,stigma,stripe,style,subglabrous,substellate,surface,terminal,thickening,unbranched,wall,white,winged,x,yellow	/3,0-20,0.5-1.2,0.8-1,1-20,1.2-1.5,17,1977,2-15,2-3.5,3-6,3-celled,5-10,5-merou,abaxially,acuminate,acut,adaxially,ag,alyx,anderson,apart,apex,apical,apiculate,articulated,axe,ba,basal,berry,bract,cell,chartaceous,ciliat,cuneate,deltate,directed,distally,eaf,eed,elliptic,equal,especially,exceeding,frequent,fused,geminat,glabrou,gland-tipped,greatly,homostylous,interstaminal,lanceolate,large,leaf-opposed,lobe,long-attenuate,longitudinal,lower,lowermost,many,margin,mean,membrane,minute,minutely,much,nflorescence,oblique,obtuse,occasional,occasionally,one-celled,opening,orolla,paired,per,perfect,plurifoliate,pore,present,pseudostipular,pubescen,reduced,ruit,scandent,seudostipule,short,slightly,slit,smaller,spaced,stamen,subtended,tamen,tem,time,tri-,truncat,tube,unit,vary,wide,ympodial	10-20,abaxial,arrangement,calyx,characteristic,colour,corolla,form,glabrousnes,growth,inflorescence,leaf,number,ovary,pseudostipule,seed,shape,size,stem,texture,truncate,width	.2,0.2-1.5,0.3-1.2,0.3-2.5,0.4-1.5,0.5-3.5,0.7-1.8,1-1.5,1-2,1-3,1-5,1.5-2.5,10-15,2-6,2-celled,2.5-18,3-11,3-18,3-7,3-branched,4-4.5,5-12,5-20,5-34,angular,apically,appressed,auriculate,base,bayonet,broadly,brown,cm,cordate,dark,diameter,due,ellipsoidal,flattened,flower,forked,fruit,gglobose,glabrous,green,hair,herb,incurved,lateral,light,long,mature,membranous,mm,moderately,narrowly,obliquely,oblong,odd-pinnate,pale,pilose,puberulent,pubescent,rarely,remnant,reniform,rounded,slender,small,somewhat,sparsely,stellate,stripe,subglabrous,substellate,thickening,unbranched,wall,white,winged,x,yellow	10-20,truncate
86	wfo-0001026827	success	142	115	73	91	51	24	70	3	/3,0.2-0.5,0.4-0.6,0.5-2,0.6-1,1-1.1,1-1.5,1-2.1,1.3-1.6,2-2.2,2-4,3-9,7-9,acute,age,and/or,anther,anthesi,apex,appearing,arachnoid,attenuate,bark,base,branched,calyx,clavate,cm,conical,corolla,dendritic,densely,diameter,drying,ellipsoid,erect,exerted,filament,flower,glabrescent,glabrous,growth,inflorescence,internodal,lamina,lanceolate,leaf,lengthening,less,like,margin,minutely,mm,narrowly,new,nodding,oblanceolate,ovary,pair,paler,papillate,pedicel,peduncle,petiole,pore,poricidal,primary,pubescent,reddish,revolute,shrub,simple,slender,slit,soon,sparsely,stem,stigma,stout,strongly,style,surface,terminal,tip,trichome,tube,uniseriate,vein,way,white,x	.5,1-2,1-2-2.5,1.5-2,5-6,?,abaxially,adaxiall,apart,branch,broadly,crowded,deciduou,deltate,dense,distally,dry,eaf,especially,fleshy,free,irregularly,know,known,lobe,lobed,lower,near,nflorescence,ot,papillat,perfect,planar,plane,plurifoliat,portion,rachi,scar,sinus,small,straight,surfac,thick,thickened,third,tub,ud,unit,upper,widest,ympodial	adaxially,arrangement,bud,characteristic,colour,deciduous,exertion,form,fruit,glabrousnes,height,history,length,life,lobing,na,number,per,plant,seed,shape,size,texture,type	/3,0.2-0.5,0.4-0.6,0.5-2,0.6-1,1-1.1,1-1.5,1-2.1,1.3-1.6,2-2.2,2-4,3-9,7-9,acute,age,and/or,anthesi,appearing,arachnoid,attenuate,base,branched,calyx,clavate,cm,conical,dendritic,densely,ellipsoid,erect,exerted,flower,glabrescent,glabrous,inflorescence,internodal,lamina,lanceolate,lengthening,less,like,minutely,mm,narrowly,nodding,oblanceolate,pair,paler,papillate,pore,poricidal,pubescent,reddish,revolute,shrub,simple,slender,slit,soon,sparsely,stout,strongly,terminal,tip,trichome,tube,uniseriate,way,white,x	adaxially,deciduous,na
87	wfo-0001026830	success	198	109	68	89	109	20	67	1	0-10,0.3-1.3,0.4-1,0.9-1.9,1-10,1-11,1-2,1.1-2.7,1.4-4,1.5-4,10-57,2.5-5,2.7-8,3.5-8.5,4-10,4-14.5,4-7,4.4-14.5,4.5-17.5,5-11,6-13,abaxially,adaxially,anther,berry,blade,brown,brownish,ciliate,clavate,cm,condition,connivent,coriaceous,corolla,deep,diameter,drying,finely,flower,fresh,fruit,glabrescent,glabrous,globose,green,green-white,greenish,hair,herb,homostylous,interjected,lanceolate,lateral,leaf,leaflet,light,lobe,margin,medium,mm,moderately,moniliform,mucilaginous,odd-pinnate,ovoid,pedicel,peduncle,plant,puberulent,pubescent,purple,seed,short,size,stigma,stripe,style,subglabrous,terminal,throughout,tube,tuber,wet,white,whitish,x,yellow,yellowish	0.5-1.0,0.5-1.2,2-4,2-6,2.5-4.4,5-merou,7-18,acumen,acuminate,acute,adaxiall,ag,along,alyx,apart,apex,apparently,arranged,articulated,asymmetric,attenuate,axe,axillary,base,basiscopic,bead,bud,capitat,cell,covering,decreasing,digestion,distal,dorsally,eaf,edge,eed,elliptic,enzyme,erec,exceeding,filament,flat,folded,forked,geminat,generally,glabrou,hair-like,hal,half,high,honeycomb,lengthening,like,linear,living,long,lower,make,multiple,necklace,nflorescence,orbicular,orolla,ovate,pair,pentagonal,perfect,petiole,petiolulate,plurifoliate,pore,poricidal,removed,ripe,rotate,rounded,ruit,sessile,seudostipule,shaped,side,simple,slit,spaced,specimen,stamen,stolon,straight,subequal,subglabrou,subtending,tall,tamen,tem,testal,thick,tip,tissue,toward,tri-,typically,unit,unwinged,usually,vary,wall,ympodial	arrangement,calyx,capitate,ciliation,colour,form,growth,height,history,inflorescence,length,life,ovary,pseudostipule,shape,spacing,stem,surface,texture,type	0-10,0.3-1.3,0.4-1,0.9-1.9,1-10,1-11,1-2,1.1-2.7,1.4-4,1.5-4,10-57,2.5-5,2.7-8,3.5-8.5,4-10,4-14.5,4-7,4.4-14.5,4.5-17.5,5-11,6-13,abaxially,adaxially,berry,brown,brownish,ciliate,clavate,cm,condition,connivent,coriaceous,deep,drying,finely,fresh,glabrescent,glabrous,globose,green,green-white,greenish,hair,herb,homostylous,lanceolate,light,medium,mm,moderately,moniliform,mucilaginous,odd-pinnate,ovoid,puberulent,pubescent,purple,short,stripe,subglabrous,throughout,wet,white,whitish,x,yellow,yellowish	capitate
88	wfo-0001026831	success	205	121	82	98	107	23	79	3	-6.5,.5,/4,0-6,0.2-1,0.3-0.6,0.3-0.65,0.5-1.2,0.6,0.6-2,0.65-1,0.7-1.1,1-2.2,1.5-2.5-9,1/3,2-2.5,2-4,2.3-2.9,acute,anther,apex,apically,articulated,attenuate,bark,base,berry,bright,calyx,cell,chartaceous,cm,cream,curved,dark,deltate,densely,diameter,dull,elliptic,erect,filament,flattened-reniform,fruit,fruiting,glabrous,green,lateral,leaf,length,lobed,long,lower,margin,marking,maturity,mauve,membranous,mm,moderately,narrow-cuneate,orange,orange-brown,outline,pair,pale,pedicel,peduncle,petiole,poricidal,prickly,primary,raised,red-brown,rounded,shiny,shrub,slender,smooth,sparsely,spherical,stellate-pubescent,stem,style,surface,tapering,tip,tube,upper,usually,vein,way,white,white-gray,wide,yellow,yellow-green,young	-5,0-10,0-20,0-3,0.1,0.1-0.2-0.25,0.1-0.25,0.15-0.25,0.2-0.4,0.7-2,1-10,1-2,1-2.5,1-3,1-4,1-6,1.2-2,1/3-1/,1/3-2/3,1/5-1/4,2-3,2.5-4.5,3-5,3-6,3.5-10,5-merous,7-10,7-8,abaxially,alyx,apar,apart,apparently,blade,branched,broad-deltate,brow,caudat,concolorous,connivent,difoliate,distance,drying,eaf,eed,elongating,equal,extending,eye,flower,free,fully,geminat,glabrescent,gray-brown,herbaceous,infructescence,less,lobe,longer,mature,midpoint,midvein,multangulate,naked,nflorescence,oblong,occasionally,older,one,open,opening,orolla,oung,ovate,pendulous,per,perfec,pericarp,porrect,portion,prickl,prickle,ray,reduced,ruit,scandent,scar,sessile,shorter,side,sometimes,spaced,spreading,stalk,stellate,subsessile,tamen,terete,tertiary,time,trichome,unit,vary,venation,visible,ympodial	1/3-1/2,arrangement,branch,brown,caudate,characteristic,colour,corolla,exertion,form,glabrousnes,growth,height,inflorescence,lobing,new,ovary,plant,seed,shape,size,texture,type	-6.5,.5,/4,0-6,0.2-1,0.3-0.6,0.3-0.65,0.5-1.2,0.6,0.6-2,0.65-1,0.7-1.1,1-2.2,1.5-2.5-9,1/3,2-2.5,2-4,2.3-2.9,acute,apically,articulated,attenuate,base,berry,bright,cell,chartaceous,cm,cream,curved,dark,deltate,densely,diameter,dull,elliptic,erect,flattened-reniform,glabrous,green,lateral,lobed,long,lower,marking,maturity,mauve,membranous,mm,moderately,narrow-cuneate,orange,orange-brown,outline,pair,pale,poricidal,prickly,raised,red-brown,rounded,shiny,shrub,slender,smooth,sparsely,spherical,stellate-pubescent,tapering,tip,upper,usually,way,white,white-gray,wide,yellow,yellow-green,young	1/3-1/2,brown,caudate
89	wfo-0001026841	success	139	88	48	60	79	28	42	6	/4,0.25-0.3,0.5-0.75,0.6-1,0.8-1,0.8-3,1.5,2-2.5,3.5-5,4-8,5-8-flowered,6-8,acute,anther,apex,bark,base,berry,bi-lobed,clavate,cm,corolla,curly-tipped,decurrent,dia,ellipsoid,elliptic,filament,filiform,fruiting,glabrate,glabrous,globose,green,inflorescence,later,leaf,lobed,long,mm,ovary,pedicel,petiole,poricidal,pubescent,shining,shrub,simple,slightly,sparsely,stem,stigma,style,tip,trichome,tube,uniseriate,way,white,young	.25,.5,0.05,0.25-0.5,0.5-1,0.5-2,0.75-1,1.5-2,3-6.5,7-9,9.2-18,along,anthesi,apart,arch,axi,ba,beneath,broadly,calyx,conical,coroll,deflexed,deltoid,eaf,edicel,eed,exsertion,free,greyish-gree,hyaline,immature,joined,known,lateral,like,lobe,lon,lower,main,margin,middle,minutely,nflorescence,older,opposite,pair,paler,papillo,papillose,pore,portion,prominent,raised,reddish,reflexed,rest,ruit,scar,series,shaped,slender,spaced,straight,tall,tapering,tear-drop,terminal,thickened,ud,unevenly,unifoliat,unit,vein,widest,winged,woody,x,ympodial	abaxial,arrangement,bud,characteristic,colour,diameter,exertion,form,fruit,greyish-green,growth,height,history,length,life,lobing,na,number,per,plant,seed,shape,size,surface,texture,type,unifoliate,ye	/4,0.25-0.3,0.5-0.75,0.6-1,0.8-1,0.8-3,1.5,3.5-5,4-8,5-8-flowered,6-8,acute,base,berry,bi-lobed,clavate,cm,curly-tipped,decurrent,ellipsoid,elliptic,filiform,glabrous,globose,green,later,lobed,long,mm,poricidal,pubescent,shining,shrub,simple,slightly,sparsely,tip,trichome,uniseriate,way,white,young	-2.5,di,greyish-green,na,unifoliate,ye
90	wfo-0001026849	success	177	122	75	95	82	27	68	7	0-10,0.5-1,1,1-2,1-6,1.5-2.5,1.75-2,11,2,2-3,38/2,5,5-10,637/2,7-8,acute,adult,anther,apex,aster,base,berry,brown,calyx,capitate,cell,cm,colour,conical,corolla,cut,cyme,deflexed,discoidal,distinctly,ellipsoid,entire,expanded,facetted,filament,floral,flowered,fruiting,glabrous,glandular,globose,globular,green,grey-brown,growth,hair,half,inflorescence,lavender,leaf,linear-lanceolate,lobe,long-cuneate,margin,mid-vein,minute,minutely,mm,oblong,oblong-lanceolate,ovary,pale,pedicel,peduncle,petiole,purple,rarely,reticulate,rh,rhachi,rounded,sea,seed,shallow,short-lived,shrub,simple,sinus,slightly,soft-wooded,stem,stigma,stone,style,surface,unarmed,undulate,violet,way,x	1-1.5,30-40-50,80-100-130,adherent,amongst,appearing,aspect,australian,axil,composed,conspicuous,curved,developed,dia,distinct,eed,emarginate,enlarge,erect,exceeding,except,exerted,filled,flesh,flower,fork,free,general,granule,greater,gree,interacuminal,large,leave,lengthening,less,little,lon,long,loosely,lower,mature,maturity,native,nflorescence,occasionally,often,pal,pedicellate,petal,plurifoliat,pore,poricidal,preparation,pruinose,relatively,reproducing,rotate,ruit,ruiting,shed,slende,slit,solanum,solitary,sometimes,somewhat,soon,stony,stout,thus,tip,tissue,tub,tube,ud,unit,uvenile,vegetatively,well,ympodial,young	30-50,8,arrangement,bud,characteristic,depth,diameter,enlarged,form,fruit,glabrousnes,glandularnes,greyish,height,history,juvenile,length,life,new,plant,plurifoliate,shape,size,slender,texture,type,white	0-10,0.5-1,1,1-2,1-6,1.5-2.5,1.75-2,11,2,2-3,38/2,5,5-10,637/2,7-8,acute,aster,berry,brown,capitate,cm,conical,cut,cyme,deflexed,discoidal,distinctly,ellipsoid,entire,expanded,facetted,flowered,glabrous,glandular,globose,globular,green,grey-brown,hair,half,lavender,linear-lanceolate,lobe,long-cuneate,mid-vein,minute,minutely,mm,oblong,oblong-lanceolate,pale,purple,rarely,reticulate,rh,rounded,sea,shallow,short-lived,shrub,simple,slightly,soft-wooded,unarmed,undulate,violet,way,x	30-50,8,enlarged,greyish,plurifoliate,slender,white
91	wfo-0001026858	success	150	85	48	62	88	23	45	3	0.8,0.8-1,1-10,1-11.5,1-4,1-5,1.3-1.5,1.5-4,2-3,2-4,2.5-3,3-4,4.5-10.5,6-10,6-18,6-7,branched,calyx,cm,corolla,cyme,diameter,dichasial,dichasially,distal,ebracteate,filament,forked,glabrescent,glabrous,globose,green,green-white,herbaceous,interjected,lateral,leaf,leaflet,light,lobe,long,mm,monochasial,oblong,odd-pinnate,ovate,ovate-lanceolate,ovoid,pedicel,peduncle,perennial,petiole,plant,seed,shiny,size,stellate,style,throughout,triangular,wide,yellow	0-.,0.5,1-2-3-4,2-2.5,3-5-15-30,3-6-foliat,4-24,abaxially,abruptly,acumen,acute,adaxially,apex,apical,apically,articulate,base,cell,connate,cordate,covering,cuneate,dehiscent,digestion,diminishing,dorsally,eaf,edge,eed,emoval,enzyme,exceeding,flat,flower,folded,generally,globo,hair-like,half,honeycomb,introrse,living,lon,lower,lunat,make,maturing,minute,mucilaginous,mucronate,nflorescence,nther,oblique,obtuse,often,orolla,pair,pattern,perfect,plan,poricidally,proximal,reveal,rounded,ruit,seudostipule,short,slightly,slit,specimen,stamen,stigma,straight,tal,tem,testal,thick,throughou,toward,tuber-bearing,typically,unit,vary,wall,white-crea,without,ympodial,Â¼	0-2,3-15-30,abaxial,adaxial,anther,arrangement,branching,colour,form,fruit,growth,height,history,inflorescence,length,life,ovary,pseudostipule,shape,stem,texture,white-cream,width	0.8,0.8-1,1-10,1-11.5,1-4,1-5,1.3-1.5,1.5-4,2-3,2-4,2.5-3,3-4,4.5-10.5,6-10,6-18,6-7,branched,cm,cyme,dichasial,dichasially,ebracteate,forked,glabrescent,glabrous,globose,green,green-white,herbaceous,light,long,mm,monochasial,oblong,odd-pinnate,ovate,ovate-lanceolate,ovoid,perennial,shiny,stellate,throughout,triangular,wide,yellow	0-2,3-15-30,white-cream
92	wfo-0001026895	success	166	129	98	112	54	17	96	2	0-0.5,0.5-1,0.5-1.2,0.5-1.5,0.5-2,0.8-1,1-1.5,1-5,1.4-2.1,2-2.3,2-2.5,2-3,2.5-3.2,2/3,3-12,5-8-flowered,abaxial,acute,adaxial,along,anther,apex,apically,appearing,attenuate,bark,base,berry,borne,brown,calyx,capitate,cm,contracted,corolla,dark,deflexed,dendritic,denser,dia,drying,ellipsoid,elliptic,erect,filament,filiform,flattened,fruiting,glabrate,glabrous,globose,green,incrassate,internodal,lamina,leaf,like,lobed,long,long-exserted,margin,minute,minutely,mm,mustard,narrowly,obovate,often,ovary,pale,pedicel,petiole,pitted,pointed,pore,poricidal,pubescent,reddish,reniform,scattered,shape,shaped,shoot,short,shrub,shrublet,side,simple,size,small,somewhat,soon,sparsely,stem,stigma,style,surface,swollen,swollen-based,tan,tear-drop,tip,toothed,trichome,tube,type,uniseriate,vein,way,white,x,yellow	.5,1.5-2,4.5-5,5-6,anthesi,apical,ba,broad,broadly,campanulate,closely,conical,deltoid,differing,difoliate,eaf,edicel,eed,elongate,free,geminat,hard,lateral,lobe,lon,lower,main,major,middle,minor,nflorescence,older,overlappin,pair,papillo,pericarp,portion,present,projection,reddish-brow,ruit,scar,spaced,tall,thin,tub,tuft,ud,unit,usually,widest,woody,ympodial,young	bud,characteristic,colour,diameter,exertion,form,fruit,growth,height,inflorescence,length,lobing,papillose,plant,reddish-brown,seed,texture	0-0.5,0.5-1,0.5-1.2,0.5-1.5,0.5-2,0.8-1,1-1.5,1-5,1.4-2.1,2-2.3,2-2.5,2-3,2.5-3.2,2/3,3-12,5-8-flowered,acute,along,apically,appearing,attenuate,base,berry,borne,brown,calyx,capitate,cm,contracted,dark,deflexed,dendritic,denser,dia,drying,ellipsoid,elliptic,erect,filiform,flattened,glabrate,glabrous,globose,green,incrassate,internodal,lamina,like,lobed,long,long-exserted,margin,minute,minutely,mm,mustard,narrowly,obovate,often,pale,pitted,pointed,pore,poricidal,pubescent,reddish,reniform,scattered,shaped,shoot,short,shrub,shrublet,side,simple,small,somewhat,soon,sparsely,stem,surface,swollen,swollen-based,tan,tear-drop,tip,toothed,trichome,tube,type,uniseriate,vein,way,white,x,yellow	papillose,reddish-brown
93	wfo-0001026905	success	199	127	85	101	98	26	81	4	.5,0-2,0-25,0.4-0.9,0.4-1,0.5-0.7,0.5-1.5,0.6-0.7,0.7-1.4,0.75-1.1,0.9-1.3,1-2.5,1-3.7,1.9-2.5,1/2-3/4,2.5-2.9,3-5,3-8,5-6,acute,anther,apex,articulated,attenuate,bark,base,berry,branched,calyx,cell,chartaceous,cm,cream,dark,densely,diameter,dull,erect,filament,flattened-reniform,fruit,fruiting,gray-green,green,inflorescence,lateral,leaf,length,lobed,long,lower,margin,marking,maturity,mauve,mm,moderately,oblong,orange,orange-brown,outline,ovate,pair,pale,pedicel,peduncle,per,petiole,pit,poricidal,prickly,primary,raised,red,rounded,shallowly,shrub,small,smooth,sometimes,sparsely,spherical,stellate,stellate-pubescent,stem,style,surface,tapering,terete,tip,tube,unarmed,usually,vein,way,weakly,white,wide,yellow,yellow-green,young	-4,.2,0-10,0-20,0-3,0.1,0.15,0.2-0.3,0.2-0.5,0.3-0.4,0.4-1.5,1-2,1-20,1-4,1-6,1/3,1/4-2/3,1/5-1/3,2-3,2.5-3.5,2/3-3/,5-merous,6-8,7-8,abaxially,acuminat,alyx,ame,apar,apart,apically,apparently,blade,brow,c.,connivent,curved,deltate,difoliate,discolorous,distance,drying,eaf,eed,elongating,equal,extending,eye,flower,free,geminat,glabrous,infructescence,lobe,longer,mature,midpoint,midvein,naked,older,one,open,orolla,oung,pendulous,perfec,pericarp,porrect,portion,prickl,prickle,ray,reduced,ruit,scar,sessile,shorter,side,slender,somewhat,spaced,spreading,stalk,stalked,straight,subentire,tamen,tertiary,time,trichome,unit,upper,variously,vary,venation,visible,woody,ympodial	2/3-3/4,alternate,arrangement,branch,brown,bud,characteristic,colour,corolla,exertion,form,glabrousnes,growth,height,lobing,na,new,number,ovary,plant,seed,shape,size,stigma,texture,type	.5,0-2,0-25,0.4-0.9,0.4-1,0.5-0.7,0.5-1.5,0.6-0.7,0.7-1.4,0.75-1.1,0.9-1.3,1-2.5,1-3.7,1.9-2.5,1/2-3/4,2.5-2.9,3-5,3-8,5-6,acute,articulated,attenuate,base,berry,branched,cell,chartaceous,cm,cream,dark,densely,diameter,dull,erect,flattened-reniform,gray-green,green,lateral,lobed,long,lower,marking,maturity,mauve,mm,moderately,oblong,orange,orange-brown,outline,ovate,pair,pale,per,pit,poricidal,prickly,raised,red,rounded,shallowly,shrub,small,smooth,sometimes,sparsely,spherical,stellate,stellate-pubescent,tapering,terete,tip,unarmed,usually,way,weakly,white,wide,yellow,yellow-green,young	2/3-3/4,alternate,brown,na
94	wfo-0001026923	success	177	114	84	97	80	17	83	1	.5,0.25-0.5,0.5-1,0.6-0.8,0.8-1,1,1-1.5,1-7,1.5-4,2,2-2.5,2-6,20-50,3-5,4-18,5-10,5-15,5-6,5-9,abaxially,acuminate,acute,adaxially,anther,apex,base,black,branched,brown,calyx,chartaceous,cm,connivent,cuneate,curved,cylindrical,deltate,densely,diameter,elliptic,elliptic-ovate,entire,filament,flattened,flower,forked,fruit,glabrous,globose,green,hair,intermediate,leaf,leaf-opposed,light,like,lobe,long,margin,mm,moderately,oblong,orange,pedicel,peduncle,peltate,petiole,possibly,pubescent,purple,rachi,red,ripening,rounded,rugulose,scale,sessile,shrub,simple,small,sparsely,stellate,stem,stigma,straight,strongly,style,surface,tip,tree,trichome,tube,usually,white,x,yellow,yellowish	-5,.1-0.3,0-5,0.5,1-3,1-4,1.5-2,10,2-3,3-4,4-5-,absent,accrescent,adaxiall,ag,apart,apparently,articulated,axe,ba,blade,capitat,center,covering,denser,directed,distally,eaf,eed,eglandular,equal,erect,frui,fruiting,fused,geminate,glabrescent,gland-tippe,glandular,held,lanceolate,large,lateral,longitudinal,lower,many-foliate,midpoint,midvein,much,multangulate,nearly,nflorescence,opening,orolla,paired,perfect,pore,pubescence,ray,relatively,ruit,short,slightly,slit,smaller,sometimes,somewhat,spaced,ste,subtending,tal,tamen,tem,time,unit,uprigh,vary,whitish,wide,ympodial	arrangement,capitate,characteristic,colour,corolla,form,growth,height,inflorescence,length,ovary,plant,seed,shape,size,texture,type	.5,0.25-0.5,0.5-1,0.6-0.8,0.8-1,1,1-1.5,1-7,1.5-4,2,2-2.5,2-6,20-50,3-5,4-18,5-10,5-15,5-6,5-9,abaxially,acuminate,acute,adaxially,black,branched,brown,chartaceous,cm,connivent,cuneate,curved,cylindrical,deltate,densely,diameter,elliptic,elliptic-ovate,entire,flattened,flower,forked,fruit,glabrous,globose,green,hair,intermediate,leaf-opposed,light,like,lobe,long,mm,moderately,oblong,orange,peltate,possibly,pubescent,purple,red,ripening,rounded,rugulose,scale,sessile,shrub,simple,small,sparsely,stellate,stem,straight,strongly,tip,tree,trichome,tube,usually,white,x,yellow,yellowish	capitate
95	wfo-0001026925	success	215	137	80	103	112	34	77	3	.5,0-7,0.5-1.5,0.9-1.8,00-200,1-1.3,1-1.4,1-25,1-3.5,1.5-2,1.8-2,1/3,1/3-1/2,2.4-2.6,2.4-3,3-20,3-7,4-14,4-5,6-17,acute,anther,apart,apex,apparently,attenuate,bark,base,berry,calyx,chartaceous,cm,concolorous,connivent,cream,dark,deltate,diameter,distal,drying,elliptic,erect,filament,flattened,flattened-reniform,fruit,fruiting,glabrescent,glabrous,green,green-brown,lateral,leaf,length,lobe,lobed,lobing,long,lower,margin,marking,maturity,mauve,membranous,midpoint,mm,moderately,narrow-deltate,orange-brown,ovate,pair,pale,pedicel,peduncle,pendent,per,petiole,plant,poricidal,prickle,prickly,primary,ray,red-brown,shrub,spaced,spherical,stellate-pubescent,stem,style,surface,tapering,terminal,tip,tube,upper,vein,way,white,wide,yellow,yellow-orange,young	/6,0,0-10,0-2,0-20,0-5,0.1,0.1-0.2,0.1-0.3,0.2,0.5-4,0.7-1.8,1-3,1-4,1.5-2.5,1.5-4.5,1.8-2.5,1/4-2/3,1/6-1/3,2-4,2-5,2.5-6,2/,4-10,4-7,5-6,5-8,5-merous,5.5-10,6-10,6-8,7-12,abaxially,acuminat,alyx,ame,andromonoecious,apar,apically,articulated,blade,branched,broad-deltate,brow,c.,curved,distance,eaf,eed,elongating,equal,extending,flower,free,gently,hair,hermaphrodite,heterostylous,infructescence,long-styled,longer,lowermost,mature,midvein,minute,nflorescence,oblong,older,one,open,orolla,oung,pendulous,pericarp,plurifoliat,porrect,portion,prickl,rarely,reduced,reflexed,rounded,ruit,scar,secondary,sessile,short-styled,side,simple,smooth,sometimes,sparsely,spreading,stalk,stalked,staminat,stellate,stout,straight,tamen,terete,tertiary,time,translucent,trichome,unarmed,unit,vary,venation,visible,woody,ympodial	2/3,appearance,arrangement,border,branch,brown,bud,characteristic,colour,corolla,corrugation,exertion,form,giving,glabrousnes,growth,height,inflorescence,interjected,leaflet,na,new,number,ovary,pseudostipule,seed,shape,size,stigma,texture,thicknes,type,variation,width	.5,0-7,0.5-1.5,0.9-1.8,00-200,1-1.3,1-1.4,1-25,1-3.5,1.5-2,1.8-2,1/3,1/3-1/2,2.4-2.6,2.4-3,3-20,3-7,4-14,4-5,6-17,acute,apart,apparently,attenuate,base,berry,chartaceous,cm,concolorous,connivent,cream,dark,deltate,diameter,elliptic,erect,flattened,flattened-reniform,glabrescent,glabrous,green,green-brown,lateral,lobed,long,lower,marking,maturity,mauve,membranous,mm,moderately,narrow-deltate,orange-brown,ovate,pair,pale,pendent,per,poricidal,prickle,prickly,red-brown,shrub,spaced,spherical,stellate-pubescent,tapering,terminal,tip,upper,way,white,wide,yellow,yellow-orange,young	2/3,brown,na
96	wfo-0001026946	success	205	113	74	90	115	23	71	3	0.5-2,0.9-3.5,0.9-4.3,1-2,1-4,1.5-2,1.6-3.7,10-39,12-23,2-15,2.5-10.5,2.7-9,3-20,3-5,3.5-10,4.1-9.4,5-7,6-24,8-15,anther,berry,blade,borne,brownish,cell,chartaceous,clavate,cm,condition,corolla,covering,creamy,deeply,densely,diameter,drying,end,filament,flower,fresh,fruit,glabrous,globose,green,greenish,hair,hair-like,herb,homostylous,lateral,leaflet,like,lobe,long,membranous,mm,mottled,odd-pinnate,ovoid,pedicel,peduncle,pentagonal,petiole,plant,pubescent,pure,purple,ripe,seed,short,short-pubescent,singly,size,slightly,stellate,stem,stigma,streak,style,terminal,testal,thick,tube,tuber,typically,wall,white,whitish,x,yellow-white	0-20,0-5,1,1-10,2,2-5,3-6,4-7,5-merou,8-25,abaxially,acumen,acuminate,acute,adaxially,ag,along,alyx,apart,apex,apparently,articulation,attenuate,axe,axillary,base,broadly,bud,capitat,ciliate,connivent,digestion,distal,dorsally,dot,eaf,edge,eed,elliptic,enzyme,erec,especially,exceeding,except,extremely,flat,folded,forked,geminat,generally,glabrou,greatly,green-white,half,honeycomb-shaped,interjected,lanceolate,lengthening,living,lower,make,margin,midrib,minutely,mucilaginous,narrowly,nflorescence,oblique,often,orbicular,orolla,ovate,pair,perfect,petiolulate,petiolule,plurifoliate,pore,poricidal,proximal,puberulent,pubescen,reduced,removed,rounded,ruit,scattered,sessile,seudostipule,slit,spaced,specimen,stamen,ste,stolo,straight,subequal,subtending,tall,tamen,tem,thir,throughout,tip,tri-,truncate,unit,unwinged,usually,variable,vary,wet,wing,yellow,ympodial	abaxial,adaxial,arrangement,calyx,capitate,colour,erect,form,growth,height,history,inflorescence,leaf,length,life,ovary,presence,pseudostipule,shape,stolon,surface,texture,type	0.5-2,0.9-3.5,0.9-4.3,1-2,1-4,1.5-2,1.6-3.7,10-39,12-23,2-15,2.5-10.5,2.7-9,3-20,3-5,3.5-10,4.1-9.4,5-7,6-24,8-15,berry,borne,brownish,cell,chartaceous,clavate,cm,condition,covering,creamy,deeply,densely,diameter,drying,end,fresh,glabrous,globose,green,greenish,hair,hair-like,herb,homostylous,lateral,like,long,membranous,mm,mottled,odd-pinnate,ovoid,pentagonal,pubescent,pure,purple,ripe,short,short-pubescent,singly,slightly,stellate,stem,streak,testal,thick,typically,wall,white,whitish,x,yellow-white	capitate,erect,stolon
97	wfo-0001026962	invalid_json	205	107	NA	81	124	26	NA	NA	.05,0.3-0.7,0.8-1,1-1.2,1-2,1-3,1-4.5,1.5-2,10-12,10-20,2-2.5,2-6,2/3-3/4,3-3.5,6-7,acute,anther,apex,bark,base,calyx,chartaceous,cm,corolla,densely,diameter,difoliate,dry,elliptic,entire,exerted,filament,flattened-reniform,flower,fruit,glabrate,glabrous,globose,green,inflorescence,leaf,lobe,margin,material,minutely,mm,narrowly,obconic,oblong,pale,pedicel,peduncle,petiole,pitted,pubescent,purplish,rachi,rounded,sagittate,shrub,size,slightly,small,sometimes,soon,stem,stigma,style,surface,tinged,tip,tree,tube,unarmed,unbranched,unifoliate,way,white,x,yellow,yellowish	.5,0,0.5,0.5-0.8,0.5-1,0.5-1.5,1,1-1.5,1-6,1.5-17,1.5-3,1.5-5,15-22,2-5,3-6,4-5,9-12,9-17,abaxially,abrupt,abruptly,accrescent,adaxially,ag,alyx,anthesi,apparently,appearing,arising,articulated,axe,basebud,becoming,beneath,blade,brittle,broadly,bud,capitat,cell,closely,composed,connivent,constricted,cucullat,cylindrical,darker,deflexed,deltate,denser,differing,dimorphic,eaf,eed,elongate,evenly,except,free,fruiting,geminat,glabrou,ilament,incrassate,internodal,later,lateral,like,lobed,long,longitudinal,main,major,minor,nflorescence,obovoid,occasionally,often,older,one,opening,opposite,orolla,oung,outline,ovate-lanceolate,overlapping,packed,pair,papillose,paten,pendent,perfect,pore,portion,prominent,pubescen,raised,reflexed,remaining,rest,rounder,ruit,shaped,simple,slender,slit,somewhat,stellate,straight,tal,tapering,tear-drop,tooth,triangular,trichome,trunk,uniseriate,unit,vary,vein,whit,woody,ympodial,young	abaxial,adaxial,arrangement,branch,capitate,characteristic,colour,exertion,form,geminate,glabrousnes,growth,height,history,length,life,lobing,new,ovary,perennial,plant,seed,shape,texture,type,value	NA	NA
98	wfo-0001026964	success	128	117	83	94	34	23	79	4	.2,.5,0.5-1,1-1.2,1-2.5,10-30,2-2.5,2-4,3-5,3.5-7,4.5-8.5,7-8,?,acuminate,acute,along,anther,anthesi,apex,attenuate,axillary,base,bearing,berry,cm,conical,conspicuously,corolla,diameter,differentiated,distinct,elliptic,filament,filiform,fleshy,flower,free,fruiting,glabrous,globose,green,greenish,herb,horizontal,lateral,leaflet,lenticellate,line,lobe,long,long-attenuate,margin,minutely,mm,nearly,obovate,often,one,onto,open,ovary,pair,papillate,pedicel,petiole,petiolule,pinnate,poricidal,portion,primary,pubescent,purple,rachi,reflexed,scar,shape,side,simple,size,slender,small,sparsely,stigma,style,terminal,time,tip,trichome,tube,uniseriate,vein,winged,x,yellow	0,0.5,10,basal,beak,calyx,capitat,eaf,edicel,equal,erec,exserted,glabrou,immature,known,lightly,lobed,lower,nflorescence,noddin,ot,purpli,rugose,ruit,smooth,somewhat,surface,tal,tem,tub,ud,unifoliat,unit,ympodial	arrangement,bud,capitate,characteristic,colour,erect,form,fruit,growth,height,history,inflorescence,leaf,length,life,lobing,nodding,number,plant,purplish,stem,texture,type	.2,.5,0.5-1,1-1.2,1-2.5,10-30,2-2.5,2-4,3-5,3.5-7,4.5-8.5,7-8,?,acuminate,acute,along,anthesi,attenuate,axillary,base,bearing,berry,cm,conical,conspicuously,diameter,differentiated,distinct,elliptic,filament,filiform,fleshy,flower,free,glabrous,globose,green,greenish,herb,horizontal,lenticellate,line,lobe,long,long-attenuate,margin,minutely,mm,nearly,obovate,often,one,onto,open,pair,papillate,petiole,pinnate,poricidal,portion,pubescent,purple,rachi,reflexed,scar,side,simple,slender,small,sparsely,time,tip,trichome,tube,uniseriate,vein,winged,x,yellow	capitate,erect,nodding,purplish
99	wfo-0001026981	success	249	121	65	99	150	22	62	3	-2.5,0.1-0.2,0.1-0.3,0.2-0.4,0.2-2,0.25-0.4,0.3-0.5,0.4-0.5,0.4-0.7,0.4-2,0.45-1.3,0.5-0.3,0.6-1.4,0.6-2,0.8-1.2,0.8-6,0.9-1.4,0.9-1.5,1-2,1-3,1-3.3,1-4,1.5-2.0,1.5-8.5,1.8-2.8,3.5-14,4,6-10,7.5,absent,accrescent,anther,apical,appendage,brown,calyx,capitate,cm,coastal,column,conical,corolla,dark,deltate,densely,diameter,filament,fruit,fruiting,glabrescent,glandular,globose,green,hair-like,herb,imparipinnate,interjected,interrupted,lateral,leaf,leaflet,lime,lobe,minutely,mm,narrowly,obovate,orange,orbicular,outgrowth,ovary,ovate,pale,pedicel,peduncle,perennial,petiole,petiolule,plant,population,primary,pseudostipule,pubescence,pubescent,secondary,sparsely,staminal,stem,sterile,stigma,style,surface,terminal,tertiary,tube,type,variously,velvety,yellow	-0.4,-14,-4,-8,.2,.2-0.2,0-5,0.05-0.1,0.15-0.2,0.2,0.3.6-0.8,0.5,0.5-30-35,0.7-0.8,1,1-2-cellular,1-3-celled,1.5-5,1/3,11,196.,2-3,2-3-branched,2-locular,3-foliate,4-8,4-celled,<,abaxially,absen,abundant,academy,acute,adaxially,adpressed,along,amongst,angled,anthesi,apex,appearance,appressed,articulated,articulation,asymmetric,axi,base,basiscopically,bay,beak,becoming,bract,bracteole-like,cell,citrus-like,composed,cone,cordate,d,distal,eaf,ebracteate,edicel,eed,entire,erect,exserted,flower,giving,gree,half,halfway,head,included,initially,internode,irregularly,jointles,larger,later,less,like,linear,lobed,lon,long,lower,mainly,margin,maturity,mixed,much,multicellular,nflorescence,occasionally,pair,patent,pentagonal,per,present,procumbent,pronounced,proximal,rachi,reflexed,rick,robust,rounded,ruit,scen,see,sessile,several,shaggy,shaped,short,shorter,silky,simple,slender,smaller,sometimes,sparser,specimen,spreadin,straight,strong,tangled,tem,testa,thick,tightly,transparent,trichome,tub,uni-,unicellular,uniseriate,unit,upto,usually,villous,viny,wall,wide,winged,without,ympodial,â,â	0.2-0.2,0.3-0.6-0.8,0.5-30,abaxial,adaxial,arrangement,bud,colour,form,glandularity,growth,height,history,inflorescence,length,life,presence,seed,shape,texture,thicknes,width	-2.5,0.1-0.2,0.1-0.3,0.2-0.4,0.2-2,0.25-0.4,0.3-0.5,0.4-0.5,0.4-0.7,0.4-2,0.45-1.3,0.5-0.3,0.6-1.4,0.6-2,0.8-1.2,0.8-6,0.9-1.4,0.9-1.5,1-2,1-3,1-3.3,1-4,1.5-2.0,1.5-8.5,1.8-2.8,3.5-14,4,6-10,7.5,absent,accrescent,brown,capitate,cm,conical,dark,deltate,densely,glabrescent,glandular,globose,green,hair-like,herb,imparipinnate,interrupted,lime,minutely,mm,narrowly,obovate,orange,orbicular,outgrowth,ovate,pale,perennial,pubescent,sparsely,variously,velvety,yellow	0.2-0.2,0.3-0.6-0.8,0.5-30
100	wfo-0001026992	success	243	113	75	92	151	21	73	2	0.2-0.5,1-4,1.2-1.4,1.2-1.7,1.4-1.6,1.7-4.3,2-10,3-4,5.3-12.1,6-10,8,abaxially,abruptly,acuminate,acute,adaxially,angled,anther,anthesi,apex,attenuate,bark,base,berry,blunt-tipped,branch,branched,broadly,brown,calyx,cm,corolla,cylindrical,deltoid,diameter,elliptic,entire,exserted,filament,fleshy,flower,fruit,globose,granular-tomentose,greenish,grooved,lance-ovate,lanceolate,leaf,length,longitudinally,many,margin,mm,oblong,orange-tan,ovate,pedicel,peduncle,petiole,plant,pubescent,reniform,reticulate-punctate,ripe,scabridulous-,short,shrub,simple,size,small,sometimes,stem,stigma,style,subcampanulate,subglobose,surface,terete,terminal,time,tomentose,tree,unarmed,velutinous,violet,weakly,white,whitish,x,yellow,yellowish	-2.5,/7,0.25-0.45,0.5-1.2,0.6-1.5,0.8-3.4,00-170,1.3-2.6,1.3-4.3,1.4-1.9,1.5-3.4,1.7-1.9,1.7-2.4,1/2,10-12,12-33,2-5.6,2.3-3.3,2.6-4.6,2.8-4.6,2.8-4.7,3.3-5.5,3.3-5.6,4-8,5-15,5-merou,8-11,8-14,abaxial,accrescent,adaxiall,ag,along,alyx,apart,apparently,appressed,approximately,around,articulated,axe,axillary,ba,blade,capitat,chartaceous,completely,coriaceous,covering,crown,dark,densely,directed,distally,drying,eaf,echinoi,echinoid,edge,eed,enveloping,equal,evident,farinose,flat-topped,forming,free,fruiting,geminate,glabrescen,glabrous,hair,high,homostylous,immature,inserted,lacking,lateral,lengthening,less,line,lobe,lobed,long,long-stalked,longitudinal,lower,m.,main,mature,maturity,midrib,minute,moderately,mostly,multangulate,nearly,nflorescence,obtuse,occasional,occasionally,often,older,orolla,ovate-lanceolate,overlapping,perfect,plurifoliate,pore,poricidal,porrect-stellate,pubescence,rachi,rare,rather,ruit,runk,semi-ovate,sessile,short-,short-stalked,shorter,side,slit,somewhat,spaced,sparingly,split,spreading,stalked,stamen,stellate,stout-stalked,suture,tamen,tan,thin-textured,tip,tube,ud,unarme,unequal,unit,usually,vary,vein,way,wide,ympodial,young,Â½	arrangement,bud,capitate,characteristic,colour,exertion,form,glabrousnes,growth,height,history,inflorescence,life,new,ovary,perennial,seed,shape,texture,trunk,type	0.2-0.5,1-4,1.2-1.4,1.2-1.7,1.4-1.6,1.7-4.3,2-10,3-4,5.3-12.1,6-10,8,abaxially,abruptly,acuminate,acute,adaxially,angled,anthesi,attenuate,berry,blunt-tipped,branched,broadly,brown,calyx,cm,cylindrical,deltoid,diameter,elliptic,entire,exserted,fleshy,flower,fruit,globose,granular-tomentose,greenish,grooved,lance-ovate,lanceolate,longitudinally,many,mm,oblong,orange-tan,ovate,pubescent,reniform,reticulate-punctate,ripe,scabridulous-,short,shrub,simple,small,sometimes,subcampanulate,subglobose,terete,terminal,time,tomentose,tree,unarmed,velutinous,violet,weakly,white,whitish,x,yellow,yellowish	capitate,perennial
101	wfo-0001026994	success	260	128	83	97	163	31	78	5	0.5,0.5-0.7,0.5-2,1,1-1.4,1-1.5,1-1.6,1.2-1.6,1.4-2.1,2-2.6,2-5-locular,2.2-3.2,4-15,acuminate,acute,anther,anthesi,apex,basal,base,bifurcate,branched,bright,broadly,brown,calyx,capitate,cell,cm,conical,corolla,crenate,dark,darker,deeply,densely,diameter,elliptic,exserted,filament,fruit,fruiting,globose,grayish,green,greenish,hair-like,half,halfway,herb,imparipinnate,inflorescence,interrupted,irregularly,lateral,leaf,less,lobe,lobed,locule,long,margin,medial,midvein,mm,narrowly,obovate,outgrowth,ovary,pedicel,peduncle,perennial,petiole,primary,pubescent,purple,rachi,regularly,ripe,size,slightly,stem,stigma,straight,stripe,style,surface,testa,thick,tube,usually,velvety,wall,white,wide,woody,yellow	-foliate,.2,.5,0.05-0.1,0.05-0.2,0.1,0.1-0.2,0.1-0.3,0.15-0.2,0.2-0.4,0.2-0.5,0.25,0.3-0.4,0.4-0.5-0.7,0.4-1.2,0.5-0.6,0.5-0.6-0.7,0.5-0.8,0.5-0.9,0.5-1.2,0.5-1.3,0.7-2.5,0.9-1.2,0.9-1.3,1-1.2,1-2,1.2-3.5,10-20,12-20-50,2,2-2.5-6.5-10,2-4,3,3-branched,4,4-celled,5,5-7,5-7-13-20,6-20-30,8,8-12,abaxially,absent,abundant,acroscopically,additional,adpressed,along,also,amongst,andscattered,apical,apically,appearance,appendage,articulate,articulation,basally,basiscopically,becoming,beneath,bent,berry,bifurcation,bract,bracteate,broader,celled,column,crenat,crowded,decreasing,decumbent,decurrent,developed,distal,eaf,ebracteate,edicel,eed,eglandular,erect,especially,essentially,fewer,flower,giving,glabrous,glandular,gree,habitat,hal,head,interjected,internode,investing,lamina,lanceolate,large,larger,largest,leaflet,leave,like,lon,loosely,lower,markedly,minutely,moderately,much,narrower,narrowing,nearly,nflorescence,node,oblique,occasionally,often,pair,paler,papillate,petiolule,present,pseudostipule,puberulent,rarely,reflexed,robust,rocky,rotate-stellate,secondary,sessile,set,shaggy,short,silky,simple,sinus,sometimes,sparsely,specimen,spreadin,spreading,staminal,sterile,tall,tem,terminal,tertiary,tip,toward,trichome,ud,unicellular,uniseriate,unit,weak-walled,well,winged,ympodial,young	2.5-6.5,5-13,6-20,arrangement,bark,branch,bud,characteristic,colour,corrugation,decurren,drying,exertion,form,glabrousnes,growth,height,history,length,life,lobing,na,new,number,per,plant,seed,shape,texture,type,vein	0.5,0.5-0.7,0.5-2,1,1-1.4,1-1.5,1-1.6,1.2-1.6,1.4-2.1,2-2.6,2-5-locular,2.2-3.2,4-15,acuminate,acute,anthesi,basal,base,bifurcate,branched,bright,broadly,brown,calyx,capitate,cell,cm,conical,crenate,dark,darker,deeply,densely,diameter,elliptic,exserted,globose,grayish,green,greenish,hair-like,half,halfway,herb,imparipinnate,interrupted,irregularly,lateral,less,lobe,lobed,locule,long,margin,medial,midvein,mm,narrowly,obovate,outgrowth,perennial,pubescent,purple,rachi,regularly,ripe,slightly,straight,stripe,testa,thick,usually,velvety,wall,white,wide,woody,yellow	2.5-6.5,5-13,6-20,decurren,na
102	wfo-0001026996	success	188	118	75	95	93	23	71	4	0-6,0.6-1,0.9-2.7,1-2,1-3,1.2-1.8,1.3-7.7,1.8-4.4,15-28,2-3,3-10,3-7,3.3-6,3.8-14.1,4-4.4,4-8,4.5-10.5,5-8,6-8,6.9-10.9,8.7-18.6,acumen,acuminate,acute,anther,apex,attenuate,base,berry,blade,blue,brownish,clavate,cm,condition,connivent,coriaceous,corolla,dark,deep,diameter,drying,filament,flower,fresh,fruit,glabrous,globose,green,green-white,greenish,herb,homostylous,interjected,lanceolate,lateral,leaf,leaflet,lilac,lobe,long,medium,mm,moniliform,mottled,mucilaginous,odd-pinnate,ovate,ovoid,pedicel,peduncle,pentagonal,petiole,petiolulate,plant,purple,ripe,rotate,rounded,seed,size,stigma,straight,stripe,style,terminal,throughout,tube,tuber,unwinged,wet,white,whitish,x,yellow	1-4,1-5,14-33,3-5,5-merou,abaxiall,abaxially,adaxially,ag,along,alyx,apart,apparently,arranged,articulated,asymmetric,axe,axillary,basiscopic,bead,bud,capitat,cell,considerably,covering,decreasing,digestion,distal,dorsally,eaf,edge,eed,elliptic,enzyme,erec,exceeding,flat,folded,forked,geminat,generally,glabrou,hair-like,half,honeycomb-shaped,larger,lengthening,like,linear,living,lower,make,middl,multiple,necklace,nflorescence,orbicular,orolla,pair,perfect,plurifoliate,pore,poricidal,removed,ruit,sessile,seudostipule,side,slightly,slit,sometimes,spaced,specimen,stamen,stolon,subglabrou,subtending,symmetric,tall,tamen,tem,testal,thick,tip,tissue,toward,tri-,typically,unit,usually,vary,wall,ympodial	5-merous,abaxial,adaxial,arrangement,calyx,capitate,colour,erect,form,growth,height,history,inflorescence,length,life,ovary,pseudostipule,shape,staman,stem,subglabrous,surface,texture	0-6,0.6-1,0.9-2.7,1-2,1-3,1.2-1.8,1.3-7.7,1.8-4.4,15-28,2-3,3-10,3-7,3.3-6,3.8-14.1,4-4.4,4-8,4.5-10.5,5-8,6-8,6.9-10.9,8.7-18.6,acumen,acuminate,acute,attenuate,berry,blue,brownish,clavate,cm,condition,connivent,coriaceous,dark,deep,diameter,drying,fresh,glabrous,globose,green,green-white,greenish,herb,homostylous,lanceolate,lilac,long,medium,mm,moniliform,mottled,mucilaginous,odd-pinnate,ovate,ovoid,pentagonal,petiolulate,purple,ripe,rotate,rounded,straight,stripe,throughout,unwinged,wet,white,whitish,x,yellow	5-merous,capitate,erect,subglabrous
103	wfo-0001027010	success	198	121	75	99	99	22	72	3	0-2,0-2.5,0.4-5.1,0.5-1.5,1-10,1-2,1.2-1.7,1.2-1.9,1.4-6.9,14-46,2-9.4,2.1-15.3,2.1-4.3,2.2-12.9,3-10,3-5,3-6,3-8,3.5-13.6,4-12,4-8,4.4-29,4.9-31,5-13,5-14,acuminate,acute,anther,apex,attenuate,axillary,base,blade,brownish,bud,clavate,cm,condition,coriaceous,corolla,deep,diameter,drying,filament,flower,fresh,fruit,glabrescent,glabrous,green,greenish,herb,homostylous,interjected,lanceolate,lateral,leaf,leaflet,light,lobe,long,mm,moniliform,mucilaginous,odd-pinnate,ovate,ovoid,pedicel,peduncle,pentagonal,petiole,petiolulate,plant,purple,ripe,rotate,rounded,scabrous,seed,sessile,size,sometimes,spot,stigma,straight,stripe,style,subtending,terminal,tube,tuber,wet,white,whitish,wide,wing,winged,x,yellow	0-3,1-4,1-7,10-60,2-6,5-merou,abaxially,acumen,adaxiall,adaxially,ag,along,alyx,apart,apparently,arranged,articulated,asymmetric,axe,basiscopic,bead,capitat,cell,coloration,connivent,covering,decreasing,digestion,distal,dorsally,eaf,edge,eed,elliptic,enzyme,erec,exceeding,flat,folded,forked,geminat,generally,glabrescen,glabrou,green-white,hair,hair-like,hal,half,high,honeycomb-shaped,larger,lengthening,like,living,lower,make,multiple,narrow,necklace,nflorescence,occasionally,orbicular,orolla,pair,perfect,plurifoliate,pore,poricidal,present,removed,ruit,scabrou,seudostipule,short,side,slightly,slit,spaced,specimen,stamen,stolon,subequal,tall,tamen,tem,testal,thick,throughout,tip,tissue,toward,tri-,typically,unit,usually,vary,wall,ympodial	5-merous,abaxial,adaxial,arrangement,calyx,capitate,colour,erect,form,growth,height,history,inflorescence,length,life,ovary,pseudostipule,shape,spacing,staman,stem,texture	0-2,0-2.5,0.4-5.1,0.5-1.5,1-10,1-2,1.2-1.7,1.2-1.9,1.4-6.9,14-46,2-9.4,2.1-15.3,2.1-4.3,2.2-12.9,3-10,3-5,3-6,3-8,3.5-13.6,4-12,4-8,4.4-29,4.9-31,5-13,5-14,acuminate,acute,attenuate,axillary,brownish,bud,clavate,cm,condition,coriaceous,deep,drying,fresh,glabrescent,glabrous,green,greenish,herb,homostylous,lanceolate,light,long,mm,moniliform,mucilaginous,odd-pinnate,ovate,ovoid,pentagonal,petiolulate,purple,ripe,rotate,rounded,scabrous,sessile,sometimes,straight,stripe,subtending,terminal,wet,white,whitish,wide,x,yellow	5-merous,capitate,erect
104	wfo-0001027019	success	142	109	81	90	52	19	80	1	.5,/4,0.5-1,1-1.5,1.5-2,1.5-3,10,10-40-flowered,12-30,2-3,2-5,2-8,4-8.5,7-14,abaxially,acute,adaxially,along,anther,apex,apparent,attenuate,bark,base,berry,branched,bright,calyx,capitate,cm,constriction,corolla,densely,dia,ellipsoid,elliptic,even,exserted,flattened,fruiting,glabrate,glabrous,globose,golden,green,inflorescence,later,leaf,like,live,lobed,long,midrib,minor,minutely,mm,obovate,older,onto,opposite,ovary,ovoid-reniform,papillose,pedicel,petiole,pitted,plant,pubescent,shaped,shrub,small,somewhat,sparsely,stem,stigma,straight,strongly,style,surface,tapering,tear-drop,tree,trichome,tube,way,white,wing,winged,x,young	0-0.5,1-2,1/2,4-5,abaxial,abruptly,anthesi,ba,cyathiform,deflexed,deltoid,difoliate,distal,eaf,edicel,eed,erect,filament,fleshy,free,geminat,inflorescenc,largely,lobe,lon,lower,major,narrowed,nflorescence,overlapping,pale,papillo,planar,pore,poricidal,portion,reddish-brow,rest,ruit,scar,spaced,tall,tan,third,tip,tub,ud,unit,waxy,widest,woody,ympodial	bud,characteristic,colour,diameter,exertion,form,fruit,growth,height,history,length,life,lobing,reddish-brown,seed,shape,size,texture,type	.5,/4,0.5-1,1-1.5,1.5-2,1.5-3,10,10-40-flowered,12-30,2-3,2-5,2-8,4-8.5,7-14,abaxially,acute,adaxially,along,apparent,attenuate,bark,base,berry,branched,bright,calyx,capitate,cm,constriction,densely,dia,ellipsoid,elliptic,even,exserted,flattened,glabrate,glabrous,globose,golden,green,later,leaf,like,live,lobed,long,midrib,minutely,mm,obovate,older,onto,opposite,ovary,ovoid-reniform,papillose,petiole,pitted,plant,pubescent,shaped,shrub,small,somewhat,sparsely,stem,straight,strongly,tapering,tear-drop,tree,trichome,tube,way,white,wing,winged,x,young	reddish-brown
105	wfo-0001027030	success	228	175	135	148	80	27	133	2	-15,.5,0.2,0.6-0.8,0.7-1,0.8-0.9,1,1-1.3,1-2-4-11,1-3,1.2-1.6,1.6-2,2-6,2-7,2-foliate,2-locular,2.2-3.2,3-4-celled,3-8,4-celled,5-12,8-celled,abaxial,abaxially,abundant,acute,adpressed,anther,anthesi,apex,appearance,articulated,axi,basal,base,basiscopically,beneath,berry,bract,branched,bright,brown,calyx,capitate,cell,cm,conical,corolla,crenate,crenation,dark,darker,decurrent,deeper,deeply,densely,denser,diameter,distal,due,eglandular,elliptic,entire,evenly,exserted,filament,flower,fruit,fruiting,giving,gland,glandular,globose,grayish,green,hair-like,half,halfway,herb,imparipinnate,inflorescence,internode,interrupted,interspersed,lamina,lanceolate,lateral,leaflet,less,like,lobe,long,longer,margin,minutely,mm,multicellular,narrowly,near,node,oblique,obovate,occasionally,often,outgrowth,ovary,pale,paler,papillate,pedicel,peduncle,perennial,petiole,primary,pubescence,pubescent,robust,rotate-stellate,silky,similar,simple,size,small,soft,sometimes,sparsely,spread,stem,stigma,stripe,style,surface,testa,thick,tiny,trichome,truncate,tube,unicellular,uniseriate,unit,vein,velvety,wall,white,wide,woody,yellow	.2,0-4,0.05-0.1,0.1-0.7,0.1-0.9,0.15-0.2,0.2-0.3,0.2-1,0.3-0.4-1.5,0.3-0.5,0.3-0.7,0.4-0.5,0.4-0.8,0.5,0.5-0.6-1.8,0.5-0.7,0.5-0.8,0.5-1,0.5-1-3.4,0.6-0.7,0.8-1,0.9-1.1,1-1.2,1.5-2-4.8,2-3,2-3-9,absent,acuminate,adaxially,angled,apical,appendage,articulation,beyond,column,crenat,diamete,eaf,edicel,eed,extremely,gree,growt,hal,interjected,investing,irregularly,larger,lon,loosely,lower,nflorescence,pair,petiolule,present,pseudostipule,reflexed,ruit,secondary,sessile,slender,slightly,smaller,somewhat,spreadin,spreading,staminal,sterile,straight,tall,tem,terminal,tertiary,trailing,ud,usually,weak,winged,ympodial,young	arrangement,branch,bud,characteristic,colour,corrugation,drying,exertion,form,glabrousnes,growth,height,history,leaf,length,life,lobing,na,new,number,per,plant,seed,shape,sympodial,texture,type	-15,.5,0.2,0.6-0.8,0.7-1,0.8-0.9,1,1-1.3,1-2-4-11,1-3,1.2-1.6,1.6-2,2-6,2-7,2-foliate,2-locular,2.2-3.2,3-4-celled,3-8,4-celled,5-12,8-celled,abaxial,abaxially,abundant,acute,adpressed,anthesi,apex,appearance,articulated,axi,basal,base,basiscopically,beneath,berry,bract,branched,bright,brown,calyx,capitate,cell,cm,conical,crenate,crenation,dark,darker,decurrent,deeper,deeply,densely,denser,diameter,distal,due,eglandular,elliptic,entire,evenly,exserted,flower,giving,gland,glandular,globose,grayish,green,hair-like,half,halfway,herb,imparipinnate,inflorescence,internode,interrupted,interspersed,lamina,lanceolate,lateral,leaflet,less,like,lobe,long,longer,minutely,mm,multicellular,narrowly,near,node,oblique,obovate,occasionally,often,outgrowth,pale,paler,papillate,perennial,pubescence,pubescent,robust,rotate-stellate,silky,similar,simple,small,soft,sometimes,sparsely,spread,stem,stripe,surface,testa,thick,tiny,trichome,truncate,unicellular,uniseriate,unit,vein,velvety,wall,white,wide,woody,yellow	na,sympodial
106	wfo-0001027035	success	199	122	77	99	100	23	74	3	0-36,0.1-0.9,0.3-2.3,0.4-12.8,0.5-3.4,0.5-7,0.8-3,0.8-4.2,0.9-3.1,1-2,1-3,1-3.4,1-8,1.5-5.9,1.7-8,1.8-5.2,10-80,2.8-10.3,3-10,3-5,4-18,4-18.5,4.9-23.5,acuminate,acute,anther,apex,attenuate,base,blade,blue,brownish,cell,clavate,cm,completely,condition,corolla,covering,deep,diameter,drying,elliptic,filament,flower,fresh,fruit,glabrescent,glabrous,globose,green,greenish,hair,hair-like,herb,homostylous,interjected,lanceolate,lateral,leaf,leaflet,light,lilac,lobe,long,medium,mm,moniliform,odd-pinnate,ovate,ovoid,pedicel,peduncle,pentagonal,petiole,petiolulate,plant,rotate,rounded,seed,sessile,shape,short,size,stigma,straight,style,terminal,testal,thick,tube,tuber,usually,wall,white,whitish,wide,x,yellow	0-7,0.5-5,2-38,2-7,5-merou,abaxially,acumen,adaxiall,adaxially,ag,along,alyx,apart,apparently,arranged,articulated,asymmetric,axe,axillary,basiscopic,bead,bud,capitat,coloration,connivent,decreasing,digestion,distal,dorsally,eaf,edge,eed,enzyme,erec,exceeding,flat,folded,forked,geminat,generally,glabrescen,glabrou,green-white,hal,half,high,honeycomb,larger,lengthening,like,living,lower,make,mucilaginous,multiple,necklace,nflorescence,orbicular,orolla,pair,perfect,plurifoliate,pore,poricidal,present,purple,removed,ripe,ruit,second,seudostipule,shaped,side,slightly,slit,smaller,sometimes,spaced,specimen,stamen,stolon,stripe,subequal,subglabrous,subtending,tall,tamen,tem,throughout,tip,tissue,toward,tri-,typically,unit,unwinged,variable,vary,wet,ympodial	5-merous,abaxial,adaxial,arrangement,calyx,capitate,colour,erect,form,glabrousnes,growth,height,history,inflorescence,length,life,ovary,pseudostipule,spacing,staman,stem,surface,texture	0-36,0.1-0.9,0.3-2.3,0.4-12.8,0.5-3.4,0.5-7,0.8-3,0.8-4.2,0.9-3.1,1-2,1-3,1-3.4,1-8,1.5-5.9,1.7-8,1.8-5.2,10-80,2.8-10.3,3-10,3-5,4-18,4-18.5,4.9-23.5,acuminate,acute,attenuate,blue,brownish,cell,clavate,cm,completely,condition,covering,deep,drying,elliptic,fresh,glabrescent,glabrous,globose,green,greenish,hair,hair-like,herb,homostylous,lanceolate,lateral,light,lilac,long,medium,mm,moniliform,odd-pinnate,ovate,ovoid,pentagonal,petiolulate,rotate,rounded,sessile,short,straight,testal,thick,usually,wall,white,whitish,wide,x,yellow	5-merous,capitate,erect
107	wfo-0001027050	success	244	134	89	109	135	25	84	5	-12,-9,/3,0.3-1.5,0.5-3,0.9-2.1,1-1.5,1-2,1.5-6,10-13.5,2-2.5,2-5,2.5-3,abaxial,acuminate,acute,adaxial,anther,apex,bark,base,berry,branch,branched,broadly,brown,calyx,capitate,chartaceous,cm,coarsely,conical,cordate,cuneate,densely,diameter,distally,drying,elliptic,entire,erect,ferruginous,filament,flattened-reniform,fruit,fruiting,glabrous,glandular-puberulent,green,growth,inflorescence,lanceolate,lateral,leaf,leaf-opposed,length,lobed,long,margin,markedly,minute,minutely,mm,moderately,narrowly,numerous,oblique,obtuse,often,ovate,pale,pedicel,peduncle,per,petiole,plant,present,pubescent,ripe,rounded,several,shallowly,shiny,shrub,small,sparsely,spherical,stellate-pubescent,stem,stigma,style,surface,terete,thicker,time,toothed,tree,triangular,truncate,tube,unbranched,usually,way,white,whitish,wide,woody,yellow,yellowish-green	.2,.5,0-0.2,0-3,0.1-0.3,0.1-3,0.2-0.5,0.2-1,0.8,1,1.5-2,12-15,15-50+,2-3,2-4,2-8,3-5,4-20,4-8,5,5-10,5-6,5-7,5-9,5-merous,50,6-8,7-30+,8-26,abaxially,absen,absent,abundant,adaxiall,adult,alyx,andromonoeciou,apar,arme,articulated,axe,basal,blade,broad,broad-based,brow,closely,connivent,curved,deeply,difoliate,directed,distal,distall,eaf,eed,eglandular,equal,erec,except,flattened,flower,free,geminat,hair,half,heterostylous,infructescence,inside,interpetalar,juicy,juvenile,larger,least,less,like,lobe,long-styled,longer,lower,mature,mid-way,midpoint,midrib,midvein,moist,mucilaginous,multiseriate,near,nflorescence,occasionally,older,orolla,oung,ovate-lanceolate,papillat,pericarp,pore,poricidal,porrect,portion,prickle,pricklier,prickly,ray,rest,ruit,scar,scattered,secondary,sessile,short-stalked,short-styled,shorter,side,slightly,somewhat,spaced,stalk,stalked,stellate,straight,tall,tamen,tip,tissue,touching,trichome,unarmed,unit,vary,weakly,ympodial,young,younger	alternate,armed,arrangement,bud,characteristic,colour,corolla,exertion,form,glabrousnes,height,history,life,lobing,na,new,number,ovary,papillate,perennial,seed,shape,size,texture,type	-12,-9,/3,0.3-1.5,0.5-3,0.9-2.1,1-1.5,1-2,1.5-6,10-13.5,2-2.5,2-5,2.5-3,acuminate,acute,base,berry,branched,broadly,brown,capitate,chartaceous,cm,coarsely,conical,cordate,cuneate,densely,diameter,distally,drying,elliptic,entire,erect,ferruginous,flattened-reniform,glabrous,glandular-puberulent,green,lanceolate,lateral,leaf-opposed,lobed,long,markedly,minute,minutely,mm,moderately,narrowly,numerous,oblique,obtuse,often,ovate,pale,present,pubescent,ripe,rounded,several,shallowly,shiny,shrub,small,sparsely,spherical,stellate-pubescent,terete,thicker,time,toothed,tree,triangular,truncate,unbranched,usually,way,white,whitish,wide,woody,yellow,yellowish-green	alternate,armed,na,papillate,perennial
108	wfo-0001027050	success	234	116	85	94	140	22	82	3	0.5-1,0.5-3,1-1.5,1-2,1.5-2,1.5-6,10-13.5,11-21,14-20,2-10,2-2.5,2-5,2-8,2.5-3,3-15,5-9,absent,abundant,acuminate,acute,adult,anther,apex,base,branched,broadly,brown,chartaceous,cm,coarsely,connivent,cordate,cuneate,densely,diameter,drying,elliptic,entire,extra-axillary,ferruginous,filament,flattened,flower,forked,fruit,glabrous,glandular-puberulent,globose,green,growth,hair,inflorescence,lanceolate,leaf,leaf-opposed,length,like,lobed,margin,mm,moderately,oblique,obtuse,often,ovate,pale,pedicel,peduncle,petiole,plant,rounded,scattered,shallowly,shrub,simple,small,somewhat,sparsely,stellate-pubescent,stem,stigma,style,surface,toothed,tree,truncate,unbranched,usually,white,whitish,x,yellow,yellowish-green,younger	.2,0-0.2,0-0.5,0-1,0-3,0.1-3,0.2-0.6,0.2-1,0.3-0.6,0.4-1,0.5-0.8,0.8,1-5,10-30,12-15,15-50+,16-40,2-3,2-3-locular,2-4,2-6,2-foliate,23-40+,3-5,4-19,4-40,4-8,5,5-10,5-6,5-7,5-merous,6-8,7-30+,8-26,8-40+,abaxially,absen,accrescent,across,adaxiall,adaxially,andromonoecious,anvil-shape,apart,armed,articulated,axe,ba,blade,branche,broad-based,calyx,capitat,contiguous,cross-section,curved,cylindrical,deeply,directed,distall,distally,distributed,eaf,eed,eglandular,erect,except,exocarp,fruiting,functional,geminat,half,held,interpetalar,juicy,juvenile,lateral,less,lobe,long,longer,lower,markedly,mature,mesocarp,midpoint,midvein,minute,minutely,moist,mucilaginous,multiseriate,narrowly,nearly,nflorescence,orolla,ovate-lanceolate,pair,per,pinnatifid,pitted,placenta,pore,porrect,present,prickle,rachi,ray,ruit,sessile,shorter,side,slightly,spaced,stalk,stalked,stellae,stellate,straight,tal,tamen,tem,thick,thicker,throughout,time,tip,tissue,triangular,tube,unarme,unarmed,unit,upper,upright,vary,weakly,wide,ympodial	abaxial,adaxial,arrangement,branch,capitate,characteristic,colour,corolla,form,glabrousnes,height,history,life,new,ovary,perennial,seed,shape,size,staman,texture,type	0.5-1,0.5-3,1-1.5,1-2,1.5-2,1.5-6,10-13.5,11-21,14-20,2-10,2-2.5,2-5,2-8,2.5-3,3-15,5-9,absent,abundant,acuminate,acute,adult,anther,base,branched,broadly,brown,chartaceous,cm,coarsely,connivent,cordate,cuneate,densely,diameter,drying,elliptic,entire,extra-axillary,ferruginous,filament,flattened,flower,forked,fruit,glabrous,glandular-puberulent,globose,green,growth,hair,lanceolate,leaf-opposed,like,lobed,mm,moderately,oblique,obtuse,often,ovate,pale,rounded,scattered,shallowly,shrub,simple,small,somewhat,sparsely,stellate-pubescent,stem,toothed,tree,truncate,unbranched,usually,white,whitish,x,yellow,yellowish-green,younger	branch,capitate,perennial
109	wfo-0001027091	success	142	141	105	106	36	35	99	6	.3,0.7,0.8,1-1.6,1.1-1.6,1.8-2.6,1/2-2/3,2.3-2.9,2.5-3.5,3-8,3-9,30-60,4-10,5-11,8.5-11.5,9-13,accrescent,across,acute-tipped,along,annual,anther,arcuate,base,beneath,berry,blade,blue,bristly,broadly,brown,calyx,campanulate,capitate-glandular,cm,dark,deltoid,densely,dia,dm,dry,enveloped,extended,few-rayed,fully,glabrous,gland,glandular,green,hair,herb,lenticular,linear-lanceolate,lobe,long,longer,low,main,maturity,mm,mostly,narrowly,near,obtuse,occasionally,oriented,ovate,pedicel,per,petiole,pinnatifid,pinnatisect,prickly,radially,reticulately,ridge,rounded,scattered,sessile,short-stipitate,simple,sometimes,sparsely,spherical,splitting,stellae,stellate-pentagonal,stem,strait,suffused,surface,tapering,terete,terminally,tightly,tube,twice,undulate,uniseriate,usually,variously,vein,vestiture,violet,wholly,wrinkled	6-10,6-10-flowere,alyx,anthesi,armed,branched,cauline,developing,difoliate,divided,eaf,eed,geminat,high,internodal,invested,lon,nflorescence,orolla,ruit,short,slende,somewhat,spreadingly,ste,tamen,taprooted,tigma,tub,tyle,unexpande,unit,vary,yello,ympodial,younger	characteristic,colour,corolla,diameter,drying,envelopment,form,fruit,glabrousnes,glandularity,growth,height,history,inflorescence,leaf,length,life,lobing,na,number,ovary,plant,pricklines,seed,shape,size,slender,staman,stigma,style,texture,type,unexpanded,variation,yellow	.3,0.7,0.8,1-1.6,1.1-1.6,1.8-2.6,1/2-2/3,2.3-2.9,2.5-3.5,3-8,3-9,30-60,4-10,5-11,8.5-11.5,accrescent,across,acute-tipped,along,annual,arcuate,base,beneath,berry,blade,blue,bristly,broadly,brown,calyx,campanulate,capitate-glandular,cm,dark,deltoid,densely,dia,dm,dry,enveloped,extended,few-rayed,fully,glabrous,gland,glandular,green,hair,herb,lenticular,linear-lanceolate,lobe,long,longer,low,main,maturity,mm,mostly,narrowly,near,obtuse,occasionally,oriented,ovate,per,pinnatifid,pinnatisect,prickly,radially,reticulately,ridge,rounded,scattered,sessile,short-stipitate,simple,sometimes,sparsely,spherical,splitting,stellae,stellate-pentagonal,strait,suffused,tapering,terete,terminally,tightly,tube,twice,undulate,uniseriate,usually,variously,vein,violet,wholly,wrinkled	-13,di,na,slender,unexpanded,yellow
110	wfo-0001027102	success	167	131	70	88	79	43	68	2	.5,0.2-2,0.5,0.5-1,0.5-2,0.5-3,1-1.5,1-2.5,10-20,15,15-35,3,3-12,4-5,<,abaxially,absent,acuman,acuminate,acute,adaxially,almost,anther,apex,appearance,base,broadly,calyx,ciliate,cm,connivent,cuneate,curved,deltate,densely,diameter,elliptic,entire,few-,filament,flattened,flower,forked,fruit,fruiting,giving,glabrous,globose,lanceolate,leaf,leaf-opposed,lobe,long-tapered,margin,mm,moderately,narrowly,oblong,obtuse,orange,ovate,pedicel,peduncle,per,petiole,pubescent,rarely,ripe,rugulose,shrub,simple,size,slender,small,somewhat,stem,stigma,style,subcoriaceous,surface,tip,triangular,truncate,tube,unbranched,white,x,yellow-brown	.5-6,1-2,1-3,1-4,1-6,1.5-2,2-2.5,2-3,3-4,3-5,4-7,5-12,absen,accrescent,adaxial,adaxiall,ag,aggregate,alyx,apart,articulated,axe,ba,blade,broad,cell,channe,chartaceous,congested,corky,cylindrical,differing,difoliate,dimorphic,directed,distally,eaf,eed,free,geminat,hair,ilament,long,longitudinal,m.,major,minor,multiseriate,nflorescence,often,one,opening,orolla,perfect,pore,portion,rachi,roughened,ruit,short,slit,spaced,sparsely,stellate,stone,straight,tal,tem,time,tomentose,truncat,unarme,unit,usually,vary,wide,yellow,ympodial,young	arrangement,border,branch,bud,characteristic,colour,corolla,corrugation,distal,drying,exertion,form,glabrousnes,growth,height,history,inflorescence,interjected,lateral,leaflet,length,life,lobing,midpoint,na,new,number,ovary,plant,prickle,primary,pseudostipule,ray,seed,shape,terminal,texture,thicknes,type,unarmed,variation,vein,width	.5,0.2-2,0.5,0.5-1,0.5-2,0.5-3,1-1.5,1-2.5,10-20,15,15-35,3,3-12,4-5,<,abaxially,absent,acuman,acuminate,acute,adaxially,almost,apex,broadly,ciliate,cm,connivent,cuneate,curved,deltate,densely,diameter,elliptic,entire,few-,flattened,flower,forked,fruit,glabrous,globose,lanceolate,leaf-opposed,long-tapered,mm,moderately,narrowly,oblong,obtuse,orange,ovate,pubescent,rarely,ripe,rugulose,shrub,simple,slender,small,somewhat,subcoriaceous,tip,triangular,truncate,unbranched,white,x,yellow-brown	na,unarmed
111	wfo-0001027104	success	141	93	62	69	72	24	60	2	0.15-0.35,0.5-0.8,1-3,1-4,1.2-6,1.5-2.3,10-15,2-3,2.2-5,3-5.5,5-15,6-7.5,acuminate,acute,apex,apical,attenuate,base,branched,calyx,cm,cordate,corolla,cyme,dehiscent,diameter,dichasial,dichasially,ebracteate,exceeding,filament,finely,globose,green,herbaceous,honeycomb,introrse,long,maturing,mm,monochasial,mucilaginous,mucronate,odd-pinnate,often,ovate,ovoid,pattern,pedicel,peduncle,perennial,petiole,plant,poricidally,pubescent,seed,short,slit,stamen,stellate,stigma,straight,style,throughout,tone,truncate,tuber-bearing,white,yellow-green	1-1.5,1.5-4.2,2-6,3-6-foliat,4-15,abaxially,acumen,adaxially,apically,articulate,cell,condition,connate,covering,digestion,distal,dorsally,eaf,edge,eed,emoval,enzyme,epiphyti,epiphytic-like,flat,flower,folded,forked,generally,globo,green-white,growing,hair-like,half,lateral,linear,living,lobe,lon,lower,make,mos,narrowly,nflorescence,nther,orolla,ovat,perfect,plan,proximal,rarely,reveal,ruit,seudostipule,simple,specimen,tall,tem,terrestrial,testal,thick,throughou,typically,unit,vary,viole,wall,wide,without,yellow,ympodial,Â¼	anther,arrangement,characteristic,colour,dehiscence,form,fruit,growth,height,history,inflorescence,leaf,length,life,lobing,ovary,pseudostipule,shape,size,stem,surface,texture,violet,wet	0.15-0.35,0.5-0.8,1-3,1-4,1.2-6,1.5-2.3,10-15,2-3,2.2-5,3-5.5,5-15,6-7.5,acuminate,acute,apical,attenuate,base,branched,cm,cordate,cyme,dehiscent,diameter,dichasial,dichasially,ebracteate,exceeding,finely,globose,green,herbaceous,honeycomb,introrse,long,maturing,mm,monochasial,mucilaginous,mucronate,odd-pinnate,often,ovate,ovoid,pattern,perennial,poricidally,pubescent,short,slit,stamen,stellate,stigma,straight,style,throughout,tone,truncate,tuber-bearing,white,yellow-green	violet,wet
112	wfo-0001027114	success	152	91	58	72	80	19	57	1	-17,.5,1-1.1-2,1-1.2,1.5-1.7,1/2,13-21-30,2-3,20-40,3-4,3-7,6-8,6-9,abaxial,acute,anther,apex,appearing,bark,base,berry,branched,calyx,capitate,cm,corolla,dark,dendritic,densely,dia,elliptic,exserted,flattened-reniform,flowered,fruiting,glabrous,globose,green,halfway,inflorescence,leaf,lobed,long,many,margin,minutely,mm,opposite,ovary,pedicel,petiole,pitted,poricidal,pubescent,reddish,reddish-brown,shoot-terminal,shrub,size,soft,stem,stigma,style,surface,thickened,time,tip,trichome,tube,way,white,wide	0.5-1,1-1.5,1-2,1.5-2,2-2.5,5,7-10,7-9,abaxially,adaxially,along,alternating,anthesi,apar,axillary,ba,bushy,closely,commonly,conical,deltate,differing,difoliate,drying,due,eaf,edicel,eed,erect,filament,free,geminate,glabrou,growt,inflorescenc,investing,lamina,lateral,like,lobe,lon,lower,main,major,minor,minute,nflorescence,occasionally,older,opening,pair,papillo,planar,plurifoliate,pore,portion,projection,rapid,rest,ruit,scar,scattered,several,shoot,simple,slit,spaced,tall,tapering,triangular,tub,ud,unevenly,uniseriate,unit,vein,woody,yellowish,ympodial,young	bud,characteristic,colour,diameter,exertion,form,fruit,growth,height,history,length,life,lobing,perennial,plant,seed,shape,texture,type	-17,.5,1-1.1-2,1-1.2,1.5-1.7,1/2,13-21-30,2-3,20-40,3-4,3-7,6-8,6-9,acute,appearing,base,berry,branched,calyx,capitate,cm,dark,dendritic,densely,dia,elliptic,exserted,flattened-reniform,flowered,glabrous,globose,green,halfway,leaf,lobed,long,many,margin,minutely,mm,opposite,pitted,poricidal,pubescent,reddish,reddish-brown,shoot-terminal,shrub,soft,thickened,time,tip,trichome,tube,way,white,wide	perennial
113	wfo-0001027117	success	229	128	92	107	122	21	91	1	-11,-2.8,.5,/3,0-10,0-20,0-40,0-5,0.1-0.7,0.5-1.5,0.6-0.9,0.7-0.9-1.5,0.7-1.3,0.7-1.5,1-2,1.5-2.3,1.7-2.5,1/3,2-3,2.3-2.8,3-6,4-7,4.5-8,5-11,acute,almost,anther,apex,apparently,articulated,attenuate,bark,base,berry,black,branched,brown,calyx,cell,chartaceous,cm,concolorous,cordate,dark,deltate,densely,diameter,discolorous,drying,erect,evenly,filament,fine,flattened-reniform,fruit,fruiting,green,herb,lateral,leaf,length,lobe,lobed,long,lower,margin,maturity,mauve,mm,narrow-elliptic,narrow-lanceolate,oblong,outline,ovate,pedicel,peduncle,petiole,pit,poricidal,prickle,prickly,raised,red-brown,reflexed,rounded,shallowly,shiny,side,small,smooth,sometimes,sparsely,spherical,stellate-pubescent,stem,style,surface,tapering,tip,tube,upper,way,weakly,wide,yellow,yellow-green,young	-12,0-15,0-25,0.1,0.1-0.2-0.45,0.15-0.25,0.15-0.35,0.2,0.5,0.8-1.5-6.5,1-4,1-6,1.2,1.5-5-14,1.8-2.5,1/,1/4-3/4,1/8-1/2,10-20,2-6,2-8,25-100,3-10,3-15,4-6.5,4-8,4.5-6.5,5-merous,6-10,6-9,7-8,abaxially,accrescent,acicular,alyx,ame,apar,apart,apically,beyond,blade,brittle,c.,connivent,curved,distance,eaf,eed,elongating,enclosing,extending,fifth,flower,four,free,gently,glabrescent,glabrous,gra,herbarium,infructescence,irregularly,less,lon,long-acuminat,longer,mature,membranous,midpoint,midvein,moderately,narrow-deltate,nflorescence,obovate,older,one,open,orolla,oung,pair,pale,pendulous,per,perfec,pericarp,perpendicular,plurifoliat,porrect,portion,prickl,primary,ray,reduced,ruit,scar,sessile,shorter,spaced,specimen,spreading,stalk,stalked,staman,stellate,straight,tamen,tearing,terete,tertiary,time,tissue,translucent,trichome,unequal,unit,variously,vary,vein,venation,visible,woody,ympodial	arrangement,branch,characteristic,colour,corolla,exertion,form,glabrousnes,gray,growth,height,inflorescence,lobing,new,ovary,plant,seed,shape,size,texture,type	-11,-2.8,.5,/3,0-10,0-20,0-40,0-5,0.1-0.7,0.5-1.5,0.6-0.9,0.7-0.9-1.5,0.7-1.3,0.7-1.5,1-2,1.5-2.3,1.7-2.5,1/3,2-3,2.3-2.8,3-6,4-7,4.5-8,5-11,acute,almost,apparently,articulated,attenuate,base,berry,black,branched,brown,cell,chartaceous,cm,concolorous,cordate,dark,deltate,densely,diameter,discolorous,drying,erect,evenly,fine,flattened-reniform,green,herb,lateral,lobe,lobed,long,lower,maturity,mauve,mm,narrow-elliptic,narrow-lanceolate,oblong,outline,ovate,pit,poricidal,prickle,prickly,raised,red-brown,reflexed,rounded,shallowly,shiny,side,small,smooth,sometimes,sparsely,spherical,stellate-pubescent,surface,tapering,tip,upper,way,weakly,wide,yellow,yellow-green,young	gray
114	wfo-0001027123	success	180	112	68	85	95	27	64	4	-10,0.5,0.8-1.3,1,1-1.2,1.5-2,2-2.6,2-5.5,2-lobed,2.5-6,3-4,4-5,4-6,5-10,5-6,abaxial,acute,anther,apex,attenuate,base,branched,brown,calyx,clavate,cm,commonly,completely,conical,corolla,dark,darker,diameter,drying,elliptic,exerted,filament,flattened,glabrous,globose,inflorescence,lamina,leaf,less,long,margin,mauve-purple,minutely,mm,narrowly,ovary,pair,papillate,pedicel,peduncle,petiole,pitted,primary,pubescent,reddish,reniform,revolute,shining,shiny,simple,soon,sparsely,stellate,stem,stigma,stoutish,strongly,style,subshrub,surface,terminal,time,tube,vein,violet,warty,way,x,young,Â¾	.3,.5,0.3-1.6cm,0.5-0.8,0.7-3.5,0.9-1.3,1-1.5,2-2.2,2-2.5,2-3,2.5-10.4,2.5-4,3-15-20,adaxial,adaxially,along,anthesi,appearing,axe,axi,bark,bright,broadly,campanulate,cell,constricted,coriaceous,cup-shaped,deltate,dendritic,densely,denser,eaf,edge,eed,enlarged,erect,fide,flower,free,fruiting,glandular,green,inserted,lax,lewi,like,lobe,lobed,lon,loose,loosely,lower,midvein,minute,monopodia,nflorescence,nodding,older,outline,papillae,perfect,perhaps,petal,planar,plurifoliate,portion,prominent,scar,scatted,scattered,shin,shinin,short,sinuate,sleeve,slightly,sometimes,spaced,straight,testal,thick,tip,trailing,trichome,tub,turned,ud,unit,upper,usually,white,widely,wood,ympodial	0.3-1.6,arrangement,bud,characteristic,colour,exertion,form,fruit,glabrousnes,growth,hair,height,history,length,life,lobing,na,new,number,per,plant,seed,shape,size,texture,type,ye	-10,0.5,0.8-1.3,1,1-1.2,1.5-2,2-2.6,2-5.5,2-lobed,2.5-6,3-4,4-5,4-6,5-10,5-6,acute,attenuate,base,branched,brown,calyx,clavate,cm,commonly,completely,conical,dark,darker,elliptic,exerted,flattened,glabrous,globose,lamina,less,long,mauve-purple,minutely,mm,narrowly,pair,papillate,pitted,pubescent,reddish,reniform,revolute,shining,shiny,simple,soon,sparsely,stellate,stoutish,strongly,subshrub,terminal,time,tube,violet,way,x,young,Â¾	0.3-1.6,na,seed,ye
115	wfo-0001027146	success	213	131	94	111	102	20	91	3	0-11,0.3-2.2,0.5-3.2,0.7-2.4,0.8,0.8-5.8,1-2,1-2.5,1-9.5,1.9-10,10,13-36,2-12.2,2-13,2-4.2,3.3-6.1,3.5-22,4-11,4-12.5,4-8,6-10,6-17.5,6.5-52,abaxially,adaxially,along,anther,berry,blade,brownish,cell,chartaceous,ciliate,clavate,cm,coarsely,condition,conical,corolla,covering,dark,deep,diameter,drying,especially,filament,finely,flower,fresh,fruit,glabrous,green,green-white,greenish,hair,hair-like,herb,homostylous,interjected,lateral,leaf,leaflet,like,lobe,long,make,margin,medium,membranous,midrib,minute,minutely,mm,moniliform,mottled,mucilaginous,odd-pinnate,ovoid,pedicel,peduncle,petiole,plant,puberulent,pubescent,purple,ripe,seed,semierect,simple,size,stem,stigma,style,subglabrous,terminal,testal,thick,throughout,tinged,tip,tube,tuber,unwinged,violet,wall,wet,white,whitish,wide,wing,x	0.6-3.3,0.8-3.1,1-10,2-5,4-38,5-merou,6,acumen,acuminate,ag,alyx,apart,apex,apparently,arranged,articulated,asymmetrical,attenuate,axe,axillary,base,basiscopic,bead,bud,capitat,commonly,connivent,darker,decreasing,digestion,distal,dorsally,eaf,edge,eed,elliptic,enzyme,erec,exceeding,flat,folded,forked,fourt,fourth,geminat,generally,glabrou,gradually,half,honeycomb-shaped,lanceolate,lengthening,living,lower,multiple,necklace,nflorescence,orbicular,orolla,ovate,pair,pentagonal,perfect,petiolule,plurifoliate,pore,poricidal,proximal,rarely,ray,removed,rotate,ruit,secondary,sessile,seudostipule,side,slit,sometimes,spaced,specimen,stamen,ste,stolon,straight,subequal,subglabrou,subsessile,subtending,symmetrical,tall,tamen,tem,tissue,toward,tri-,typically,unit,usually,vary,yellow,ympodial	5-merous,arrangement,calyx,capitate,colour,erect,form,growth,height,history,inflorescence,length,life,ovary,pseudostipule,shape,surface,texture,type,width	0-11,0.3-2.2,0.5-3.2,0.7-2.4,0.8,0.8-5.8,1-2,1-2.5,1-9.5,1.9-10,10,13-36,2-12.2,2-13,2-4.2,3.3-6.1,3.5-22,4-11,4-12.5,4-8,6-10,6-17.5,6.5-52,abaxially,adaxially,along,berry,brownish,cell,chartaceous,ciliate,clavate,cm,coarsely,condition,conical,corolla,covering,dark,deep,drying,especially,finely,fresh,glabrous,green,green-white,greenish,hair,hair-like,herb,homostylous,lateral,like,long,make,margin,medium,membranous,midrib,minute,minutely,mm,moniliform,mottled,mucilaginous,odd-pinnate,ovoid,puberulent,pubescent,purple,ripe,seed,semierect,simple,stem,subglabrous,testal,thick,throughout,tinged,tip,unwinged,violet,wall,wet,white,whitish,wide,wing,x	5-merous,capitate,erect
116	wfo-0001027157	success	207	137	96	113	94	24	93	3	0-3,0.15-0.3,1,1-10,1-2,1-3,1-6,1.5-6.5,10-30,2,2-15,2-2.5,2-3,2-5,2.3-4,2.5-3,3-7,3.3-7.8,3.8-8.3,6.5-14.5,9-12,absent,acumen,acute,anther,apart,attenuate,axillary,blade,broadly,brownish,bud,cell,chartaceous,clavate,cm,condition,conical,connivent,corolla,covering,deeply,densely,diameter,distal,drying,elliptic,end,filament,flower,forked,fresh,fruit,generally,glabrous,green,green-white,greenish,hair,hair-like,half,herb,homostylous,interjected,lanceolate,lateral,leaf,leaflet,like,lobe,long,make,membranous,mm,mucilaginous,odd-pinnate,one,ovate,ovoid,pair,pedicel,peduncle,placed,plant,puberulent,pubescent,ripe,seed,size,sometimes,stellate,stem,stigma,straight,style,subtending,terminal,testal,thick,throughout,tinged,tube,tuber,typically,usually,violet,wall,wet,white,whitish,wide,x,yellow	0.7-2,0.9-2.8,1-3.8,3-12,4-5,5-merou,abaxially,acuminate,adaxially,ag,along,alyx,among,apex,apparently,articulated,axe,base,berry,capitat,ciliate,cordate,cuneate,decreasing,decurrent,digestion,dorsally,eaf,edge,eed,enzyme,erec,especially,exceeding,flat,folded,geminat,glabrou,grassland,greatly,honeycomb-shaped,lengthening,living,low-growing,lower,margin,markedly,middl,midrib,minutely,narrowly,nflorescence,oblique,obtuse,orbicular,orolla,perfect,petiole,petiolulate,petiolule,plurifoliate,pore,poricidal,rarely,removed,rounded,ruit,semi-rosette,sessile,seudostipule,shady,short,situation,slightly,slit,spaced,specimen,stamen,ste,stolo,subsessile,sunny,tall,tamen,tem,tip,toward,tri-,unequal,unit,unwinged,vary,woodland,ympodial	5-merous,abaxial,adaxial,arrangement,calyx,capitate,colour,form,growth,height,history,inflorescence,length,life,ovary,placement,pseudostipule,shape,spacing,staman,stolon,surface,texture,variation	0-3,0.15-0.3,1,1-10,1-2,1-3,1-6,1.5-6.5,10-30,2,2-15,2-2.5,2-3,2-5,2.3-4,2.5-3,3-7,3.3-7.8,3.8-8.3,6.5-14.5,9-12,absent,acute,apart,attenuate,axillary,broadly,brownish,bud,cell,chartaceous,clavate,cm,condition,conical,connivent,covering,deeply,densely,distal,drying,elliptic,end,forked,fresh,generally,glabrous,green,green-white,greenish,hair,hair-like,half,herb,homostylous,lanceolate,lateral,like,long,make,membranous,mm,mucilaginous,odd-pinnate,one,ovate,ovoid,placed,plant,puberulent,pubescent,ripe,seed,sometimes,stellate,stem,straight,subtending,terminal,testal,thick,throughout,tinged,typically,usually,violet,wall,wet,white,whitish,wide,x,yellow	5-merous,capitate,stolon
117	wfo-0001027184	success	218	139	107	112	106	27	96	11	.3,.5,.8,0-0.2,0.2-0.4,0.4-2,1-2,1.5-5,19,5,5-7,acute,along,anther,apex,axi,axillary,blue,borne,bract-like,broad,brown,calyx,chartaceous,cm,connivent,covered,cylindrical,diameter,directed,entire,epidermal,extension,filament,flattened,fleshy,flower,foliaceous,fruit,glabrescent,glabrous,globose,hair,hairlike,half,herbaceous,imparipinnate,introrsely,lanceolate,leaf,leaflet,leafy,light,long,longitudinal,lower,margin,membranous,meter,midrib,mm,oblong,often,older,opening,opposite,orange,pedicel,peduncle,per,petiole,pilose,pore,prominent,pseudostipule,pubescent,rachi,raised,red,reticulate,revolute,ripe,secondary,several,shape,shoot,short,simple,size,slightly,slit,small,soft-woody,somewhat,sparsely,stellate,stem,stigma,straight,style,subopposite,sulcate,surface,tertiary,unbranched,vein,vine,wall,white,x,yellow,young	.7,0-0.5-2,0.4â0.9,0.8,0.8â1.6,0â3,1.5,1.8â3.5,13â18,1â2,1â2.5,1â4,2,2.8â4.1,2â4-celled,3-4-,3-foliolate,3.5â8,3â,3â4-celled,4,4â12,7,9,abaxially,absent,accrescent,adaxiall,adaxially,adventitious,ag,always,alyx,apart,appressed,articulated,axe,ba,basal,base,blade,branch,broadly,cell,clavat,cluster,cordat,densely,eaf,eed,elliptic,especially,fasciculate,free,fruiting,geminat,generally,glabrou,grading,ilament,larger,largest,lateral,least,less,like,lobe,m.,minutely,mostly,much,narrowly,nearly,nflorescence,node,obtuse,orolla,ovate,ower,petiolule,plurifoliate,portion,prominently,puberulent,rarely,root,ruit,scarcely,spaced,terminal,tightly,tip,tree,truncate,trunk,tube,unarme,unequal,uniform,unit,usually,vary,visible,weak,ympodial,â9	0.5-2,1-4,13-18,2-4-celled,3-9,3.5-8,4-12,age,arrangement,characteristic,clavate,colour,cordate,corolla,form,growth,height,history,inflorescence,length,life,number,ovary,plant,seed,texture,unarmed	.3,.5,.8,0-0.2,0.2-0.4,0.4-2,1-2,1.5-5,19,5,5-7,acute,along,apex,axi,axillary,blue,borne,bract-like,broad,brown,chartaceous,cm,connivent,covered,cylindrical,diameter,directed,entire,epidermal,extension,flattened,fleshy,flower,foliaceous,fruit,glabrescent,glabrous,globose,hair,hairlike,half,herbaceous,imparipinnate,introrsely,lanceolate,leaf,leafy,light,long,longitudinal,lower,membranous,meter,midrib,mm,oblong,often,older,opening,opposite,orange,pilose,pore,prominent,pubescent,raised,red,reticulate,revolute,ripe,secondary,several,shoot,short,simple,slightly,slit,small,soft-woody,somewhat,sparsely,stellate,straight,subopposite,sulcate,surface,tertiary,unbranched,vein,vine,wall,white,x,yellow,young	0.5-2,1-4,13-18,2-4-celled,3-9,3.5-8,4-12,age,clavate,cordate,unarmed
118	wfo-0001027186	success	168	116	75	93	75	23	74	1	.4,.5,1-1.5,1-2.5,1.4-1.6,1.5,1.5-2,15,2-6,2-lobed,2.5-3,5-10,6-7,9-10,?,abaxial,acute,anther,apex,attenuate,bark,base,berry,broadly,brown,calyx,clavate,cm,conical,corolla,dark,dendritic,diameter,ellipsoid,elliptic,entire,exerted,filament,filiform,fruit,fruiting,glabrescent,glabrous,globose,green,growth,immature,less,longer,margin,maturity,minutely,mm,much,narrowly,new,ovary,ovoid,pair,pale,pedicel,peduncle,petiole,pitted,pointed,poridical,primary,pubescent,reddish,reniform,seed,shiny,simple,slightly,soon,sparsely,spreading,stem,stigma,strongly,style,surface,terminal,tip,tree,treelet,tube,variably,vein,way,white,x,yellow	-6,0.5-1,1.5-2.5,1.6-5,3-4,3.5-4,30-40,4-15,4-9,abaxially,adaxially,age,always,anthesi,apart,apparently,axil,branch,branched,dbh,deflexed,deltate,denditic,densely,denser,dry,eaf,enlarging,flower,free,golden,incrassat,irregularly,keeled,lamina,lengthening,like,lobe,lobed,loose,lower,m.,midrib,nflorescence,occasionally,papillat,papillate,pendent,perfect,pericarp,planar,plane,plurifoliat,pore,portion,pubescen,rachi,rough,ruit,scar,scattered,short,slit,small,spaced,stalk,straight,time,trichome,tub,ud,uniseriate,unit,woody,ympodial	arrangement,bud,characteristic,colour,drying,exertion,form,glabrousnes,height,history,inflorescence,leaf,length,life,lobing,na,number,per,plant,shape,size,texture,type	.4,.5,1-1.5,1-2.5,1.4-1.6,1.5,1.5-2,15,2-6,2-lobed,2.5-3,5-10,6-7,9-10,?,acute,apex,attenuate,base,berry,broadly,brown,calyx,clavate,cm,conical,dark,dendritic,diameter,ellipsoid,elliptic,entire,exerted,filiform,glabrescent,glabrous,globose,green,growth,immature,less,longer,maturity,minutely,mm,much,narrowly,new,ovoid,pair,pale,pitted,pointed,poridical,pubescent,reddish,reniform,shiny,simple,slightly,soon,sparsely,spreading,strongly,terminal,tip,tree,treelet,tube,variably,way,white,x,yellow	na
119	wfo-0001027198	success	191	156	106	112	79	44	101	5	.4,.5,0.05-1.0,0.8-1,1-1.5,1-10,1.5-10,1.5-2,10-11,11-20,3/4,5-120-flowered,5-6,7.5-9,abruptly,acuminate,acute,anther,apex,attenuate,axil,base,beneath,berry,broadening,bushy,calyx,channeled,clavate,cm,complex,corolla,cyathiform,decurrent,dendritic,dia,elliptic,entire,exserted,extremely,filament,flower,fruiting,furcate,glabrate,glabrous,globose,golden,green,inflorescence,large,lateral,leaf,like,lobe,lobed,long,main,many,margin,medium,minute,minutely,mm,obovate,often,older,opposite,ovary,ovoid,ovoid-reniform,pale,paler,papillose,pedicel,petiole,pitted,plant,puberulent,pubescent,rest,set,shaped,shining,short,shrub,size,slender,slightly,small,soon,speciman,stem,stigma,style,styled,surface,tannish-yellow,tear-drop,time,tree,trichome,tube,two,type,uniseriate,vein,way,white,x,yellowish,young	0.5-0.75,0.5-1,0.7-1,1-5,2-5.5,4-9,always,anthesi,apart,ba,beginning,caly,closely,constriction,corky,corresponding,deltoid,densely,differing,difoliate,dry,eaf,edge,edicel,eed,erect,evenly,eye,female,found,free,geminat,impressed,inflorescenc,invisible,live,lon,lower,major,male,meet,middle,minor,naked,nearly,nflorescence,overlapping,papillo,pendan,planar,pore,poricidal,portion,pubescence,rather,reddi,reflexed,rounded,ruit,scar,sessile,simple,spaced,specimen,straight,strong,tall,testae,thickened,thin,tip,top,ud,undersurface,unit,usually,widest,woody,ympodial	alternate,appearance,arrangement,bark,border,branch,bud,characteristic,colour,corrugation,diameter,distal,drying,exertion,form,fruit,giving,glabrousnes,growth,height,history,interjected,leaflet,length,life,lobing,midpoint,na,new,number,peduncle,per,prickle,primary,pseudostipule,ray,reddish,seed,shape,terminal,texture,thicknes,variation,width	.4,.5,0.05-1.0,0.8-1,1-1.5,1-10,1.5-10,1.5-2,10-11,11-20,3/4,5-120-flowered,5-6,7.5-9,abruptly,acuminate,acute,attenuate,axil,base,beneath,berry,broadening,bushy,calyx,channeled,clavate,cm,complex,cyathiform,decurrent,dendritic,dia,elliptic,entire,exserted,extremely,flower,furcate,glabrate,glabrous,globose,golden,green,inflorescence,large,lateral,leaf,like,lobed,long,main,many,medium,minute,minutely,mm,obovate,often,older,opposite,ovoid,ovoid-reniform,pale,paler,papillose,petiole,pitted,puberulent,pubescent,rest,set,shaped,shining,short,shrub,size,slender,slightly,small,soon,speciman,stem,style,styled,surface,tannish-yellow,tear-drop,time,tree,trichome,tube,two,type,uniseriate,vein,way,white,x,yellowish,young	-1.5,alternate,di,na,reddish
120	wfo-0001027200	success	139	98	67	77	62	21	65	2	0.05-0.25,0.5-0.75,0.6-1,0.7-2.5,1-1.4,1.2-1.5,1.5-2,1.5-5,1.6-6,2-3,2.5-3,3.5-6,6-8,8-15,acute,anther,apex,base,beneath,berry,branch,brown,capitate,cm,corolla,dark,decurrent,deeply,densely,dia,elliptic,except,flattened,fruiting,giving,glabrous,globose,golden,green,horizontally,inflorescence,leaf,lobed,long,major,minor,minute,mm,nearly,non-reproductive,onto,ovary,ovoid-reniform,pedicel,petiole,pitted,puberulent,shaped,shrub,size,slightly,small,sparsely,spreading,stem,stigma,style,surface,tear-drop,tree,trichome,unicellular,unifoliate,uniseriate,vein,white,x	0.25-0.5,0.5-1,1-1.5,3-3.5,9-11,across,anthesi,aspec,ba,bark,branche,broadly,calyx,conical,converging,deflexed,deltoid,differing,eaf,eed,filament,free,geminate,grey-brown,impressed,lateral,lightly,like,lobe,lon,lower,main,margin,middle,minutely,near,node,occasionally,older,papillo,papillose,planar,pore,poricidal,portion,prominent,reflexed,rest,ruit,sparse,straight,tall,tip,tube,unit,widened,widest,winged,woody,yellowish,ympodial,young	arrangement,aspect,characteristic,colour,diameter,exertion,form,fruit,growth,height,history,length,life,lobing,na,peduncle,plant,seed,shape,texture,type	0.05-0.25,0.5-0.75,0.6-1,0.7-2.5,1-1.4,1.2-1.5,1.5-2,1.5-5,1.6-6,2-3,2.5-3,3.5-6,6-8,8-15,acute,base,beneath,berry,branch,brown,capitate,cm,dark,decurrent,deeply,densely,dia,elliptic,except,flattened,giving,glabrous,globose,golden,green,horizontally,leaf,lobed,long,major,minor,minute,mm,nearly,non-reproductive,onto,ovoid-reniform,petiole,pitted,puberulent,shaped,shrub,slightly,small,sparsely,spreading,tear-drop,tree,trichome,unicellular,unifoliate,uniseriate,vein,white,x	aspect,na
121	wfo-0001027213	invalid_json	227	112	NA	86	141	26	NA	NA	0-2.5-3.3,0.2-0.4,1-2,1-5,1.1-1.7,1.2-2.5,12.3-16.3-19,2-5,2.5-5.1,4-9.5,5-7.5,5.7-6.2,abaxially,acute,adaxially,anther,anthesi,apex,attenuate,base,blunt-tipped,branch,branched,broadly,brown,cm,conical,corolla,cuneate,dark,deltoid,diameter,early,elliptic,entire,eventually,exserted,filament,flower,fruit,glabrescent,globose,granular,grayish-brown,green,lanceolate,leaf,length,many,margin,mm,moderately,oblanceolate,obovate,orbicular,ovate,ovate-lanceolate,pale,pedicel,peduncle,petiole,pubescent,relatively,reniform,reticulate-punctate,scabrous,short-attenuate,shrub,simple,stem,stigma,style,surface,terete,time,tomentose,tree,unarmed,violet,white,whitish,whitish-green,x,yellow-green,yellow-tan,yellowish	/10,0-160-230,0.2-0.5,0.7-2.3-4.5,0.8-1.8,1.2-1.6,1.2-1.7,1.3-2.2,1.7-3.6,1.7-3.9,1.8-2.8,1.8-3.2,1/2-2/3,10-24,2.4-4.7,2.9-3.8,2.9-4.8,2/3,3.5-5,3.5-8,4.2-5.9,5-8,5-merou,8-24,8.2-10.5,9-13,accrescent,acuminate,ag,along,alyx,apart,apparently,ark,around,articulated,axe,axillary,ba,basal,blade,calyx,capitat,cell,completely,covering,cylindrical,decurrent,directed,distally,drying,eaf,edge,eed,enveloping,epidermal,farinose,few-rayed,free,fruiting,glabrescen,glabrous,group,hair,high,homostylous,immature,inserted,lackin,lateral,lengthening,lobe,lobed,long,long-,long-stalked,longitudinal,lower,m.,main,midrib,mixed,mostly,multangulat,multangulate,nearly,nflorescence,obscured,obtuse,often,older,orolla,partly,perfect,plurifoliate,pore,poricidal,porrect-stellat,porrect-stellate,prominent,pseudo-terminal,pubescence,rachi,rather,ruit,sessile,short,short-,short-stalked,side,slit,sometimes,somewhat,spaced,sparsely,stamen,stellate,subcampanulate,suture,tamen,thick,thick-stalked,thin-stalked,ti,tip,tomentose-pubescent,tomentu,touching,tube,ud,unarme,unit,unwinged,vary,vein,vestigial-rayed,way,wide,yellow,ympodial,young	arrangement,bark,bud,capitate,characteristic,colour,exertion,form,glabrousnes,growth,height,history,inflorescence,life,lobing,new,ovary,perennial,plant,pseudoterminal,seed,shape,size,texture,type,value	NA	NA
122	wfo-0001027214	success	175	108	63	84	91	24	60	3	.25,.5,0,0.5-0.8,0.7-2.5,0.8-1,1-2.8,10-13,2,2-9,3-4-5-9,5-6,6-12,absent,anther,anticlinal,apex,base,berry,cell,climbing,cm,composed,conical,corolla,densely,diameter,drying,elliptic,epidermal,erect,filament,finely,flattened-round,fruit,fruiting,glabrous,globose,green,greenish,height,herb,inflorescence,irregular,leaflet,length,lobed,long-acuminate,long-conical,minutely,mm,nearly,oblique,obovate,occasionally,once-branched,ovary,pedicel,per,petiole,pinnate,pointed,poricidal,projection,pubescent,rachi,rugose,rugosity,seed,sharply,simple,sinuous,somewhat,stigma,style,thickening,tip,trichome,truncate,tube,uniseriate,white,without,x	..,0-16,0.25,0.3-1.5,0.3-1.7,0.5-1,0.7-2,1-1.5,1.2-3,1.5,1.5-1.8,1.5-6,10-15-25-38,3-6,6-12-17-20,7-12,8-9,abaxially,acuminate,acute,adaxially,along,anthesi,apical,basal,broadly,calyx,capitat,conspicuously,decurrent,deltate,dr.,eaf,edicel,eed,exserted,extending,flower,free,groove,grown,horizontal,inflorescenc,lamina,lanceolate,lateral,less,like,lobe,lon,long,lower,margin,markedly,midrib,narrowly,nflorescence,noddin,nodding,often,onto,open,opposite,pair,paired,papilla,papillate,perfectly,petiolule,portion,reflexed,rest,ruit,scar,scattered,scrambling,smaller,surface,tem,terminal,time,triangular,tub,ud,unevenly,unifoliat,unit,vein,white-lenticellate,whitish,ympodial	.0,2.0,arrangement,branching,bud,capitate,colour,composition,form,glabrousnes,growth,history,leaf,lenticellate,life,lobing,number,plant,pubescence,shape,size,stem,texture,type	.25,.5,0,0.5-0.8,0.7-2.5,0.8-1,1-2.8,10-13,2,2-9,3-4-5-9,5-6,6-12,absent,anticlinal,base,berry,cell,climbing,cm,composed,conical,densely,elliptic,erect,finely,flattened-round,glabrous,globose,green,greenish,herb,irregular,lobed,long-acuminate,long-conical,minutely,mm,nearly,oblique,obovate,occasionally,once-branched,pinnate,pointed,poricidal,projection,pubescent,rugose,sharply,simple,sinuous,somewhat,thickening,tip,truncate,uniseriate,white,without,x	.0,2.0,capitate
123	wfo-0001027219	success	143	128	88	104	39	24	85	3	.5,/4,0.3,0.4-0.6,0.5,0.5-0.8,1-15,1-3,1.5-2,2,2-3,2-3.5,2-4,3-5,6-8,7-8,absent,acuminate,acute,age,anther,anthesi,apex,axillary,bark,base,berry,bright,broadly,brown,c.,capitate,cm,completely,conical,corolla,densely,diameter,drying,edge,elliptic,entire,erect,filament,flower,fruiting,glabrescent,glabrous,globose,green,greyish,growth,hard,leaf-opposed,lengthening,less,long-conical,long-styled,margin,maturity,minutely,mm,new,ovary,pair,pale,pedicel,peduncle,pericarp,petiole,pointed,pore,poricidal,primary,pubescent,purple,sharply,shoot,short,short-styled,shrub,simple,slightly,slit,soon,stem,stigma,stout,style,surface,terminal,thickened,tip,trichome,tube,uniseriate,vein,violet,way,white,woody,x,yellowish,â1/3	1,1-2,1.5-2.5,2-2.5,3-6,berr,calyx,closely,cup-shaped,deltate,eaf,eed,exerte,exfoliatin,free,glabrou,heterostylous,known,lobe,lobed,lower,nflorescence,overlappin,papillo,papillose-pubescent,pendent,planar,plurifoliat,portion,ruit,scar,sometimes,somewhat,spaced,tuft,ud,unit,weight,ympodial	arrangement,bud,characteristic,colour,exerted,exertion,form,fruit,glabrousnes,height,inflorescence,leaf,length,lobing,na,number,papillose,per,plant,seed,shape,size,texture,type	.5,/4,0.3,0.4-0.6,0.5,0.5-0.8,1-15,1-3,1.5-2,2,2-3,2-3.5,2-4,3-5,6-8,7-8,absent,acuminate,acute,age,anthesi,apex,axillary,base,berry,bright,broadly,brown,c.,capitate,cm,completely,conical,densely,diameter,edge,elliptic,entire,erect,flower,glabrescent,glabrous,globose,green,greyish,hard,leaf-opposed,lengthening,less,long-conical,long-styled,maturity,minutely,mm,pair,pale,pericarp,pointed,pore,poricidal,pubescent,purple,sharply,shoot,short,short-styled,shrub,simple,slightly,slit,soon,stout,surface,terminal,thickened,tip,trichome,uniseriate,violet,way,white,woody,x,yellowish,â1/3	exerted,na,papillose
124	wfo-0001027223	success	189	130	88	105	84	25	83	5	.5,0.19-0.75,0.3-1.2,1-2,1-3,1.5-3.5,1.8-3.5,16-41,3-10,3-11,3-5,3-5.2,3.5-4,3.5-7,3.7-9.3,4-6,5-21,5-8,5.9-12.2,9-15,9-22,abaxially,adaxially,anther,berry,blade,brownish,cell,clavate,cm,condition,conical,corolla,covering,deep,densely,diameter,dot,drying,elliptic,end,filament,flower,forked,fresh,fruit,glabrous,green,green-white,greenish,hair,hair-like,herb,homostylous,hyaline,interjected,lanceolate,lateral,leaf,leaflet,light,like,lobe,long,make,mm,mucilaginous,odd-pinnate,one,ovate,ovoid,pair,pedicel,peduncle,pentagonal,petiole,placed,plant,pubescent,purple,ripe,rotate,seed,size,sometimes,stigma,straight,stripe,style,terminal,testal,thick,throughout,tube,tuber,typically,unwinged,usually,wall,wet,white,whitish,wide,x,yellow	1.3-2,2-4,2-7,3.5-6,5-10,5-merou,9-35,acumen,acuminate,adaxiall,ag,alyx,apart,apex,apparently,articulated,asymmetric,attenuate,axe,axillary,base,basiscopic,bud,capitat,connivent,decreasing,digestion,distal,dorsally,eaf,edge,eed,enzyme,erec,exceeding,flat,folded,geminat,generally,glabrou,hal,half,honeycomb-shaped,larger,lengthening,living,lower,middle,nflorescence,orbicular,orolla,perfect,petiolulate,plurifoliate,pore,poricidal,present,removed,rounded,ruit,sessile,seudostipule,short,shortly,side,slightly,slit,spaced,specimen,stamen,ste,stolo,subequal,subtending,tall,tamen,tem,tip,tissue,toward,tri-,unit,vary,ympodial	5-merous,abaxial,adaxial,arrangement,calyx,capitate,characteristic,colour,erect,form,growth,height,history,inflorescence,length,life,ovary,placement,pseudostipule,shape,stem,stolon,surface,texture,type	.5,0.19-0.75,0.3-1.2,1-2,1-3,1.5-3.5,1.8-3.5,16-41,3-10,3-11,3-5,3-5.2,3.5-4,3.5-7,3.7-9.3,4-6,5-21,5-8,5.9-12.2,9-15,9-22,abaxially,adaxially,berry,brownish,cell,clavate,cm,condition,conical,covering,deep,densely,dot,drying,elliptic,end,forked,fresh,glabrous,green,green-white,greenish,hair,hair-like,herb,homostylous,hyaline,lanceolate,lateral,light,like,long,make,mm,mucilaginous,odd-pinnate,one,ovate,ovoid,pentagonal,placed,pubescent,purple,ripe,rotate,seed,sometimes,straight,stripe,testal,thick,throughout,typically,unwinged,usually,wall,wet,white,whitish,wide,x,yellow	5-merous,capitate,erect,stem,stolon
125	wfo-0001027237	success	122	102	67	76	46	26	65	2	.5,/4,1-1.2,1.5-2,2-3,3-3.5,3-4,30-100-flowered,6-11,6-8,8,anther,anthesi,bark,base,berry,black,branched,brown,calyx,clavate,cm,completely,corolla,cucullate,cup-shaped,dark,deflexed,dia,drying,ellipsoid,exsertion,filament,flattened,fruiting,glabrous,globose,green,greenish-white,inflorescence,internodal,later,leaf,lobe,lobed,long,many,margin,minutely,mm,ovary,paler,papillose,pedicel,pitted,reflexed,regularly,reniform,shaped,shining,shrub,slender,small,stem,stigma,style,surface,tapering,tear-drop,time,tip,tree,tube,way,white,x	0.5-1,1.5-2.5,5,apart,apiculae,apiculate,appearing,ba,blac,branc,broadly,deltoid,difoliate,edicel,eed,erect,free,geminate,greyi,lower,nflorescence,occasionally,older,papillate,papillo,part,plurifoliat,pore,poricidal,portion,regulary,ruit,scar,spaced,straight,tall,terminal,ud,unit,upper,usually,widely,woody,x.,ympodial,young	apex,arrangement,bud,characteristic,colour,diameter,exertion,form,fruit,greyish,growth,height,history,length,life,lobing,na,peduncle,plant,primary,seed,shape,size,texture,type,vein	.5,/4,1-1.2,1.5-2,2-3,3-3.5,3-4,30-100-flowered,6-11,6-8,8,anthesi,base,berry,black,branched,brown,calyx,clavate,cm,completely,corolla,cucullate,cup-shaped,dark,deflexed,dia,drying,ellipsoid,exsertion,flattened,glabrous,globose,green,greenish-white,internodal,later,lobe,lobed,long,many,margin,minutely,mm,paler,papillose,pitted,reflexed,regularly,reniform,shaped,shining,shrub,slender,small,surface,tapering,tear-drop,time,tip,tree,tube,way,white,x	greyish,na
126	wfo-0001027238	success	203	134	98	107	96	27	94	4	.3,.5,0-1,0-1.5,0.3-0.8,0.5-1,1-1.5,1-2,1.5-4,10,15-30,3-6,4-5,5-15,6-15-25,abaxially,acuminate,acute,adaxially,anther,apex,articulated,base,berry,black,branch,brown,chartaceous,cm,connivent,contiguous,cuneate,dark,densely,diameter,elliptic,elliptic-ovate,entire,extra-axillary,filament,flattened,fleshy,flower,fruit,glabrous,globose,green,greenish,hair,homostylous,lavender,leaf,light,lighter,like,long,margin,membranaceous,minutely,mm,multangulate,narrowly,near,nearly,new,oblique,oblong,obtuse,outline,pale,pedicel,peduncle,petiole,pitted,porrect-stellate,pubescent,purple,reniform,ripe,rounded,scandent,sessile,shiny,short-stalked,shrub,similar,simple,small,sometimes,sparsely,sprawling,stellate-pubescent,stem,stigma,strongly,style,surface,tip,tree,triangular,tube,unbranched,white,whitish,x,yellow,yellowish	-5,0-0.7,0.3-0.5,0.3-1,0.3-5,0.5-16,0.5-2,1.5-3,1.5-7,2-3,2-4,3-4,3-5,4-,4-10,4-16,4-8,5-7,5-merou,6-8,accrescent,adaxiall,ag,alyx,apparently,axe,ba,blade,calyx,capitat,covering,cylindrical,deltate,differentiated,directed,discolorous,distally,eaf,eed,equal,foliaceous,fork,free,frui,fruiting,geminate,glabrescent,gland,gland-tipped,growt,interpetalar,introrsely,juic,large,lobe,longitudinal,lower,major,midpoint,minor,mixed,nflorescence,often,one,opening,orolla,paired,part,perfect,pericarp,plurifoliate,pore,rachi,ray,ruit,side,slit,somewhat,sparse,ste,stellate,straight,subtending,tamen,tem,time,tissue,toward,unarme,unequal,unit,vary,vein,wide,without,ympodial	5-merous,abaxial,adaxial,arrangement,capitate,characteristic,colour,corolla,exertion,form,glabrousnes,growth,height,history,inflorescence,length,life,lobing,ovary,perennial,plant,seed,shape,size,texture,type,unarmed	.3,.5,0-1,0-1.5,0.3-0.8,0.5-1,1-1.5,1-2,1.5-4,10,15-30,3-6,4-5,5-15,6-15-25,abaxially,acuminate,acute,adaxially,apex,articulated,base,berry,black,brown,chartaceous,cm,connivent,contiguous,cuneate,dark,densely,diameter,elliptic,elliptic-ovate,entire,extra-axillary,flattened,fleshy,flower,fruit,glabrous,globose,green,greenish,hair,homostylous,lavender,light,lighter,like,long,membranaceous,minutely,mm,multangulate,narrowly,near,nearly,oblique,oblong,obtuse,outline,pale,pitted,porrect-stellate,pubescent,purple,reniform,ripe,rounded,scandent,sessile,shiny,short-stalked,shrub,similar,simple,small,sometimes,sparsely,sprawling,stellate-pubescent,stem,strongly,tip,tree,triangular,unbranched,white,whitish,x,yellow,yellowish	5-merous,capitate,perennial,unarmed
127	wfo-0001027244	success	285	145	84	111	174	34	81	3	-12,-2,0.05,0.15-0.2,0.2-1,0.4-1,0.45-0.6,0.5,0.5-0.8,0.7-1.5,0.9-1.3,0.9-1.7,1,1.1-1.3,1.2-1.6,1.5-2.1,1.5-2.4-3.2,1.5-6.5,1.7-3.0,2.1-8,4-12,acute,anther,anthesi,apex,appearance,articulated,base,berry,bifurcate,branched,broadly,brown,calyx,capitate,cm,conical,cordate,corolla,crenate,curved,dark,densely,dentate,diameter,distal,elliptic,exserted,filament,fruit,fruiting,giving,globose,green,greenish,hair-like,half,halfway,herb,imparipinnate,inflorescence,interjected,interrupted,irregularly,lateral,leaflet,length,lobe,lobed,lobing,long,margin,middle,minute,mm,obovate,often,orbicular,outgrowth,ovary,pedicel,peduncle,perennial,petiole,primary,pseudostipule,pubescent,purple,rotate-stellate,rounded,shaggy,silky,simple,size,stem,stigma,stripe,strongly,style,surface,terminal,thick,truncate,tube,vein,velvety,vivid,white,wide,woody,yellow	.5,0-5-10,0.02-0.1-0.3,0.04-0.1-0.3,0.05-1,0.07-0.15,0.1-0.5,0.1-0.6,0.1-0.7-2,0.2,0.2-0.7-3,0.25-0.4,0.3,0.3-0.4,0.3-0.5,0.3-0.6,0.3-0.8,0.4-0.6,0.4-1-3.5,0.5-1,0.6-0.9-1.2,0.6-09,0.7-1,0.8-1.2,1-2-celled,1-2.5,1-celled,1.5-2,1/2,2-3.5-13,2-4,2-4-celled,2-9,2-foliate,2-locular,3-5,3/4,4-celled,5-8-16,5-9-celled,7-12,8-celled,abaxially,absent,abundance,abundant,acroscopically,acuminate,adaxially,adpressed,alfway,along,also,always,amongst,angled,apical,apparently,appendage,arequipa,around,articulatio,articulation,axi,basal,berr,bract,bracteate,c.,cage,cell,column,common,deciduous,decumbent,decurrent,deeper,deltate,dense,density,developed,diamete,eaf,edicel,eed,eglandular,either,elliptical,erect,extremely,flower,flushed,forming,general,glabrescent,glabrous,gland,glandular,gree,head,hyaline,internode,investing,lamina,lanceolate,larger,largest,leave,like,lon,longer,lower,midvein,mixed,mixture,multicellular,narrowly,near,node,oblique,occasionally,onto,pair,papillate-pubescent,patent,petiolule,population,present,rachi,reflexed,rest,ripe,ruit,scattered,secondary,sessile,short,shorter,sinus,slender,small,sometimes,somewhat,sparse,sparsely,sparser,spreading,staminal,sterile,stout,straight,tall,tem,tertiary,testa,tiny,tip,tipped,toward,trichome,two,ud,undulate,unicellular,uniseriate,unit,united,upper,usually,variable,variety,wall,winged,ympodial	3.5-13,5-10,arrangement,bark,border,branch,bud,characteristic,colour,corrugation,drying,exertion,form,glabrousnes,growth,height,history,leaf,life,midpoint,na,new,number,per,plant,prickle,ray,seed,shape,texture,thicknes,type,variation,width	-12,-2,0.05,0.15-0.2,0.2-1,0.4-1,0.45-0.6,0.5,0.5-0.8,0.7-1.5,0.9-1.3,0.9-1.7,1,1.1-1.3,1.2-1.6,1.5-2.1,1.5-2.4-3.2,1.5-6.5,1.7-3.0,2.1-8,4-12,acute,anthesi,articulated,base,berry,bifurcate,branched,broadly,brown,calyx,capitate,cm,conical,cordate,crenate,curved,dark,densely,dentate,diameter,distal,elliptic,exserted,globose,green,greenish,hair-like,half,halfway,herb,imparipinnate,interrupted,irregularly,lobed,long,middle,minute,mm,obovate,often,orbicular,outgrowth,perennial,pubescent,purple,rotate-stellate,rounded,shaggy,silky,simple,stripe,strongly,thick,truncate,velvety,vivid,white,wide,woody,yellow	3.5-13,5-10,na
128	wfo-0001027248	success	158	117	83	97	61	20	82	1	.5,0.5-1,0.5-2.5,0.7-1.2,1-1.5,1-2,1-5,2-2.5,2-4.5,3-7-flowered,3.5-4,4-8,5-5.5,6.5-8,abaxially,adaxially,anther,apex,appearing,arachnoid,arachnoid-pubescent,area,bark,base,beige,berry,broadened,brown,calyx,cm,corolla,dark,densely,dia,difoliate,dirty,ellipsoid,elliptic,erect,exserted,felty,filament,fleshy,fruit,fruiting,geminate,glabrescent,glabrous,globose,grayish-green,green,later,leaf,lightly,lobed,long,merely,minor,minutely,mm,nearly,node,occasionally,ovary,ovoid-reniform,pale,patch,pedicel,petiole,pitted,pubescence,pubescent,scattered,shaped,shoot,shrub,simple,size,small,somewhat,soon,sparsely,stem,stigma,strongly,style,surface,tear-drop,top,tree,trichome,tube,unifoliate,white,wide,winged,young	0,1-3,3-4,3-7,6-13,7-9,abaxial,acute,along,anthesi,ape,arachnoid-pubescen,beneath,broadly,brownish,brownish-gra,closely,conical,deflexed,deltate,denser,differing,eaf,edicel,eed,free,impressed,lamina,lateral,lobe,lower,main,major,margin,nflorescence,older,opposite,overlappin,pair,papillo,papillose,per,planar,pore,poricidal,portion,present,ruit,scar,spaced,specimen,tall,thick,tip,tub,ud,unit,vein,wid,woody,ympodial	arrangement,brownish-gray,bud,characteristic,colour,diameter,exsertion,form,growth,height,history,inflorescence,length,life,lobing,plant,seed,shape,texture,type	.5,0.5-1,0.5-2.5,0.7-1.2,1-1.5,1-2,1-5,2-2.5,2-4.5,3-7-flowered,3.5-4,4-8,5-5.5,6.5-8,abaxially,adaxially,apex,appearing,arachnoid,arachnoid-pubescent,area,base,beige,berry,broadened,brown,calyx,cm,dark,densely,dia,difoliate,dirty,ellipsoid,elliptic,erect,exserted,felty,fleshy,geminate,glabrescent,glabrous,globose,grayish-green,green,later,lightly,lobed,long,merely,minutely,mm,nearly,node,occasionally,ovoid-reniform,pale,patch,pitted,pubescence,pubescent,scattered,shaped,shoot,shrub,simple,small,somewhat,soon,sparsely,strongly,style,tear-drop,top,tree,trichome,tube,unifoliate,white,wide,winged,young	brownish-gray
129	wfo-0001027258	success	178	118	83	92	86	26	80	3	.25,/4,0.5-1,0.6-2,0.9-1.3,1-2.3,1-4,1.2-2,1.5-1.6,2-2.5,2.5-8,3.5-4,4-5,5-10-flowered,6-8,abaxially,acuminate,acute,adaxially,age,along,anther,apex,attenuate,base,berry,broadly,calyx,capitate,cm,corolla,decurrent,densely,dia,difoliate,ellipsoid,elliptic,entire,flattened-reniform,fruit,fruiting,glabrous,globose,green,greenish-yellow,large,leaf,length,lengthening,lenticel,lobed,long,minor,minutely,mm,onto,ovary,ovate,pale,papillose,pedicel,petiole,pitted,pore,poricidal,pubescent,reddish,scattered,shrub,simple,size,slightly,slit,small,sparsely,stem,stigma,style,surface,swollen,tip,treelet,trichome,tuft,uniseriate,unit,urceolate,way,white,winged,x,yellowish-tan	.5,0.25-0.5,1-1.5,3-4,3-6,4.5-5,7-13,7-9,abruptly,anthesi,apar,apical,apiculae,axil,ba,bark,beneath,crystal,darker,deflexed,deltate,dense,deposit,differing,dissecting,drying,eaf,edicel,eed,enlarge,evenly,exserted,extending,fide,filament,fragrant,free,geminat,glabrou,incrassate,internodal,lamina,lateral,lobe,lower,main,major,margin,microscope,middle,minute,nee,nflorescence,occasionally,often,older,opposite,pair,papillo,planar,portion,projection,prominent,red-papillose,ruit,sand,scar,slender,spaced,speck,straight,strongly,sweetly,tall,tiny,tub,tube,ud,vein,visible,widening,widest,woody,yellowish,ympodial,young	arrangement,branch,bud,characteristic,colour,diameter,exertion,form,geminate,glabrousnes,growth,height,history,inflorescence,life,lobing,na,new,number,per,plant,seed,shape,sympodial,texture,type	.25,/4,0.5-1,0.6-2,0.9-1.3,1-2.3,1-4,1.2-2,1.5-1.6,2-2.5,2.5-8,3.5-4,4-5,5-10-flowered,6-8,abaxially,acuminate,acute,adaxially,age,along,attenuate,base,berry,broadly,capitate,cm,decurrent,densely,dia,difoliate,ellipsoid,elliptic,entire,flattened-reniform,glabrous,globose,green,greenish-yellow,large,leaf,length,lengthening,lenticel,lobed,long,minutely,mm,onto,ovate,pale,papillose,petiole,pitted,pore,poricidal,pubescent,reddish,scattered,shrub,simple,slightly,slit,small,sparsely,stem,surface,swollen,tip,treelet,trichome,tuft,uniseriate,unit,urceolate,way,white,winged,x,yellowish-tan	geminate,na,sympodial
130	wfo-0001027260	success	170	141	78	87	83	54	76	2	0.25-1,0.5-3,0.5-6.5,0.8-2,1-2,1-2.5-14,1-3,1-4,1.5-13,2-18,2-2.5,2.5-3.5,3-4.5,3-6,3.5-25,4-25,4-32,5-40-60,abaxially,acuminate,acute-,adaxially,age,also,apex,basal,base,berry,beyond,branched,clavate,cm,cordate,darker,densely,diameter,eglandular,ellipsoidal,elliptic,elliptic-ovate,entire,exserted,fading,flattened,flower,fruit,glabrous,globose,greenish,hair,lanceolate,lavender,lobe,long,longitudinal,margin,mm,moderately,obtuse,often,ovate,pedicel,peduncle,petiole,pilose,pink,puberulent,pubescent,pubescent-pilose,purple,shrub,simple,small,sparsely,stamen,stigma,stripe,style,tree,truncate,tube,unbranched,vein,white,x,yellow-green,yellowish	-2,-7,0.5-1,0.75-1,1-3-10-17,1-4.5-14,1-6,1-7,1.5-2,15-30,2-10,2-6-20,3-11,3-4-6,4-5-foliat,5-10-25,5-25,5-merous,absent,acute,aggregate,alyx,apart,ape,articulated,axe,blade,cell,chartaceous,connective,connivent,cylindrical,diamete,directed,distally,eaf,eed,equal,exceeding,glabrate,leaving,lon,lower,membranaceous,narrowly,nearly,nflorescence,nther,orolla,pedicellar,perfec,perfect,pilo,pore,presen,puberulent-pubescen,puberulent-pubescent,rachi,radiu,remnant,ruit,shorter,slightly,spaced,stellate,stone,strongly,subcoriaceous,tal,tapered,tem,thecae,time,tomento,triangular,ud,unit,usually,vary,wide,yellow,yellow-orang,ympodial	5-10,anther,appearance,arrangement,bark,border,branch,bud,calyx,characteristic,colour,corolla,corrugation,distal,drying,exertion,filament,form,fruiting,giving,glabrousnes,growth,height,history,inflorescence,interjected,lateral,leaf,leaflet,length,life,lobing,midpoint,na,new,number,ovary,per,plant,prickle,primary,pseudostipule,ray,seed,shape,size,stem,surface,terminal,texture,thicknes,type,variation,width	0.25-1,0.5-3,0.5-6.5,0.8-2,1-2,1-2.5-14,1-3,1-4,1.5-13,2-18,2-2.5,2.5-3.5,3-4.5,3-6,3.5-25,4-25,4-32,5-40-60,abaxially,acuminate,acute-,adaxially,age,also,apex,basal,berry,beyond,branched,clavate,cm,cordate,darker,densely,eglandular,ellipsoidal,elliptic,elliptic-ovate,entire,exserted,fading,flattened,flower,glabrous,globose,greenish,hair,lanceolate,lavender,lobe,long,longitudinal,mm,moderately,obtuse,often,ovate,pilose,pink,puberulent,pubescent,pubescent-pilose,purple,shrub,simple,small,sparsely,stamen,stripe,tree,truncate,unbranched,white,x,yellow-green,yellowish	5-10,na
131	wfo-0001027265	success	158	115	68	79	79	36	60	8	.2,0.2-0.4,0.5,0.5-1,1-3,1.2-1.3,1.2-2,2,2-3,2/3,4-5,acute,anther,apart,apex,articulated,base,berry,broad,calyx,chartaceous,cm,diameter,entire,filament,flattened-reniform,flower,fruit,glabrous,globose,granule,herb,hermaphroditic,light,lobe,long,long-attenuate,lower,margin,minutely,mm,near,nearly,numerous,oblong,obtuse,orange,ovate-lanceolate,partially,pedicel,peduncle,petiole,pitted,pore,present,prominent,puberulent,pubescent,purple,rachi,recurved,red,ripe,rotate-stellate,sclerotic,seed,simple,sometimes,sparsely,stigma,style,subcoriaceous,surface,tip,triangular,tube,white,x,yellow	-2.5,.3,.5,0.1â2,0.5â0.6,1-1.3,1-2.5,1.2â1.4,1.5-2.5,1.5â1.8,1.5â2,1.5â4,2-3-,2-4,20-30,2â2.5,2â3,3-lobed,30â50,4.5â8,4â6,4â7-branched,5-merou,58409,abaxially,accrescent,adaxiall,adaxially,alyx,apparently,axe,ba,blade,capitat,ciliate,connivent,covering,croat,cylindrical,dehiscent,eaf,eed,erect,extra-axillary,foliate,frui,fruiting,geminat,hair,juic,larger,leaf-opposed,lon,longitudinall,low,mesocarp,nflorescence,node,orolla,paired,rarely,rooting,ruit,scarcely,slightly,somewhat,spaced,tall,tamen,tem,time,unit,usually,vary,weak,white-puberulent,wide,winged,ympodial	0.1-2,1.2-1.4,1.5-1.8,1.5-2,2-2.5,30-50,abaxial,adaxial,arrangement,articulation,capitate,characteristic,colour,corolla,dehiscence,form,glabrousnes,growth,height,history,inflorescence,leaf,length,life,longitudinally,new,number,ovary,per,plant,shape,size,spacing,stem,texture,type	.2,0.2-0.4,0.5,0.5-1,1-3,1.2-1.3,1.2-2,2,2-3,2/3,4-5,acute,apart,apex,articulated,base,berry,broad,chartaceous,cm,entire,flattened-reniform,glabrous,globose,herb,hermaphroditic,light,long,long-attenuate,lower,minutely,mm,near,nearly,numerous,oblong,obtuse,orange,ovate-lanceolate,partially,pitted,pore,present,prominent,puberulent,pubescent,purple,recurved,red,ripe,rotate-stellate,simple,sometimes,sparsely,subcoriaceous,tip,triangular,white,x,yellow	0.1-2,1.2-1.4,1.5-1.8,1.5-2,2-2.5,30-50,capitate,longitudinally
132	wfo-0001027265	success	155	99	59	66	89	33	53	6	.2,0.2-0.4,0.5,0.5-1,1-3,1.2-2,1.2â1.4,1.5â1.8,2,2-3,2/3,3-lobed,4-5,acute,anther,apart,apex,articulated,base,chartaceous,cm,diameter,entire,filament,flattened-reniform,fruit,glabrous,globose,herb,light,long,long-attenuate,lower,margin,minutely,mm,nearly,numerous,oblong,obtuse,orange,ovate-lanceolate,pedicel,peduncle,petiole,pitted,puberulent,pubescent,purple,rachi,rarely,recurved,red,ripe,rotate-stellate,seed,simple,slightly,sparsely,stigma,style,subcoriaceous,surface,white,x,yellow	-2.5,.3,.5,0.1â2,0.5â0.6,1-1.3,1-2.5,1.2-1.3,1.5-2.5,1.5â2,1.5â4,2-3-,2-4,20-30,2â2.5,2â3,30â50,4.5â8,4â6,4â7-branched,5-merou,58409,abaxially,accrescent,adaxiall,adaxially,alyx,apparently,axe,ba,blade,broad,calyx,capitat,ciliate,connivent,covering,croat,cylindrical,dehiscent,eaf,eed,erect,extra-axillary,flower,foliate,frui,fruiting,geminat,granule,hair,hermaphroditic,juic,larger,leaf-opposed,lobe,lon,longitudinall,low,mesocarp,near,nflorescence,node,orolla,paired,partially,pore,prominent,rooting,ruit,scarcely,sclerotic,sometimes,somewhat,spaced,tall,tamen,tem,time,tip,triangular,tube,unit,vary,weak,white-puberulent,wide,winged,ympodial	0.1-2,1.5-2,2-2.5,30-50,abaxial,adaxial,arrangement,articulation,capitate,characteristic,colour,corolla,form,glabrousnes,growth,height,history,inflorescence,leaf,length,life,new,number,ovary,per,perennial,plant,shape,size,spacing,stem,texture,type	.2,0.2-0.4,0.5,0.5-1,1-3,1.2-2,1.2â1.4,1.5â1.8,2,2-3,2/3,3-lobed,4-5,acute,apart,apex,articulated,base,chartaceous,cm,entire,flattened-reniform,glabrous,globose,herb,light,long,long-attenuate,lower,minutely,mm,nearly,numerous,oblong,obtuse,orange,ovate-lanceolate,pitted,puberulent,pubescent,purple,rarely,recurved,red,ripe,rotate-stellate,simple,slightly,sparsely,subcoriaceous,white,x,yellow	0.1-2,1.5-2,2-2.5,30-50,capitate,perennial
133	wfo-0001027284	success	172	119	83	94	78	25	79	4	.3,0.1â0.5,0.1â2,0.7â0.9,0.7â1,1.2â1.5,1.5â2,1.5â8,1â1.5,2.5â3,2â16,3.5â14,3â4,4,4â12,4â6,5-merous,5â8,9â18,acuminate,acute,adaxially,anther,anthesi,apex,axillary,base,berry,branched,brownish,calyx,cm,cordate,deltoid,densely,diameter,elliptic,entire,extra-axillary,filament,flattened-reniform,fleshy,flower,fruit,glabrous,globose,green,herbaceous,inflorescence,margin,maturity,minutely,mm,nearly,oblique,orangish,ovate,ovoid,pale,pedicel,peduncle,petiole,pink,planar,pubescent,rachi,rarely,reticulate-rugulose,rounded,sand-punctate,scandent,scar,shortly,shrub,simple,size,sometimes,somewhat,soon,sparsely,stem-terminal,stigma,style,surface,tan,thickly,tip,truncate,unbranched,vine,weakly,white,woody,x	0.2â,1.5â2.5,1.5â5.5,1.8â2,1â2,1â3,2.5â3.5,2â2.2,5â7,abaxially,accrescent,alyx,axe,blade,branch,c.,capitat,ciliat,climbing,conspicuous,contiguousl,cylindrical,deflected,distally,eaf,eed,enlarged,fine,flattened,fruiting,glabrescen,glabrou,gradually,immature,leafy,lobe,long,lower,m.,midvein,near,nflorescence,nternode,one,orolla,pair,pendulou,perfec,pinnate,plurifoliate,pointed,prominent,pubescence,reduced,ruit,sand-punctat,secondary,seen,side,slightly,spaced,spreading,stellate,tamen,tem,thickened,time,toward,tree,tube,understory,unifoliat,unit,vary,vein,venation,wide,ympodial	0.2â1.5,abaxial,adaxial,arrangement,capitate,characteristic,colour,corolla,form,glabrescent,growth,height,history,leaf,length,life,lobing,ovary,perfect,plant,seed,shape,stem,texture,type	.3,0.1â0.5,0.1â2,0.7â0.9,0.7â1,1.2â1.5,1.5â2,1.5â8,1â1.5,2.5â3,2â16,3.5â14,3â4,4,4â12,4â6,5-merous,5â8,9â18,acuminate,acute,adaxially,anthesi,apex,axillary,berry,branched,brownish,cm,cordate,deltoid,densely,elliptic,entire,extra-axillary,flattened-reniform,fleshy,flower,fruit,glabrous,globose,green,herbaceous,maturity,minutely,mm,nearly,oblique,orangish,ovate,ovoid,pale,pink,planar,pubescent,rarely,reticulate-rugulose,rounded,sand-punctate,scandent,scar,shortly,shrub,simple,sometimes,somewhat,soon,sparsely,stem-terminal,tan,thickly,tip,truncate,unbranched,vine,weakly,white,woody,x	0.2â1.5,capitate,glabrescent,perfect
134	wfo-0001027302	success	188	148	112	124	64	24	110	2	.5,0.4-5,0.5,0.5-1,0.6-1,0.8-1,1,1-1.3,1-1.5,1-3,1.2-1.6,1.2-2.5,1.5-2,10,10-20,2-3,2-6,2.2,2.7-7.5,3/4,5-7,7,7/8,abaxial,acuminate,acute,adaxial,age,along,anther,apex,apical,appearing,bark,basal,base,becoming,berry,branching,bright,brownish-yellow,calyx,capitate,clavate,cm,cordate,corolla,crispate,dendritic,densely,denser,diameter,elliptic,especially,exserted,filament,fine,flat-topped,flattened,flower,fruiting,glabrous,globose,growth,later,lateral,leaf,length,lenticular,less,like,long,main,margin,minutely,mm,narrowly,occasionally,otherwise,ovary,ovate,overtopping,pale,per,petiole,plant,plurifoliate,pore,poridical,prominent,puberulent,pubescent,pyramidal,red,scar,shoot,shrub,simple,slit-like,small,somewhat,sparsely,stem,stigma,strongly,style,surface,tapering,terminal,time,tiny,tip,tree,trichome,truncate,tube,undulate,usually,vein,violet,way,winged,x,young	1-2,2,3.5-5,6-12,abaxially,adaxially,anthesi,ba,blade,broader,conical,cultivation,decurrent,deflexed,deltoid,dichasia,discussion,eaf,edicel,eed,entire,ew,free,growing,inserted,juvenile,larger,lax,lobe,lobed,lon,long-triangular,lower,m.,monochasial,nflorescence,nodding,older,pair,papillo,pedicle,pericarp,pitted,planar,portion,reddish-brown,reflexed,ruit,scattered,scrambling,secondary,see,shade,shin,sleeve,stamen,tall,thin,tub,ud,unit,wide,woody,ympodial	arrangement,bud,characteristic,colour,exertion,form,fruit,glabrousnes,height,history,inflorescence,life,lobing,new,number,papillose,pedicel,peduncle,seed,shape,shiny,size,texture,type	.5,0.4-5,0.5,0.5-1,0.6-1,0.8-1,1,1-1.3,1-1.5,1-3,1.2-1.6,1.2-2.5,1.5-2,10,10-20,2-3,2-6,2.2,2.7-7.5,3/4,5-7,7,7/8,acuminate,acute,age,along,apex,apical,appearing,basal,base,becoming,berry,branching,bright,brownish-yellow,calyx,capitate,clavate,cm,cordate,crispate,dendritic,densely,denser,diameter,elliptic,especially,exserted,fine,flat-topped,flattened,flower,glabrous,globose,later,lateral,leaf,lenticular,less,like,long,main,minutely,mm,narrowly,occasionally,otherwise,ovate,overtopping,pale,per,petiole,plant,plurifoliate,pore,poridical,prominent,puberulent,pubescent,pyramidal,red,shoot,shrub,simple,slit-like,small,somewhat,sparsely,stem,strongly,surface,tapering,terminal,time,tiny,tip,tree,trichome,truncate,tube,undulate,usually,vein,violet,way,winged,x,young	papillose,shiny
135	wfo-0001027310	success	213	117	80	95	118	22	78	2	.8,/3,0.6-1,0.7-2,1-1.2,1-1.7,1-6,1.1-1.5,1.5-2.2,2-3.1,2.2-2.5,2.8-3,20-60,4.5-7,5-10,5-7,abaxially,acute,anther,apex,apparently,articulated,bark,base,berry,calyx,chartaceous,cm,connivent,cuneate,dark,deltate,densely,diameter,entire,erect,evenly,filament,flattened-reniform,flower,fruit,fruiting,glabrous,gray,green,green-brown,hair,lanceolate,lateral,leaf,length,lobed,long,long-styled,margin,maturity,mauve,minutely,mm,moderately,orange-brown,pale,pedicel,peduncle,petiole,pitted,plant,poricidal,prickly,purple,reflexed,rounded,shallowly,shrub,simple,sometimes,sparse,spherical,spreading,stellate-pubescent,stem,style,surface,tapering,terminal,tip,toward,tree,truncate,tube,unarmed,way,wide,yellow,young	0,0-20,0-5,0.05,0.05-0.15,0.1,0.1-0.2,0.15-0.3,0.9-0.17-2.2,1.5-5,1/10-1/6,1/3-1/2,1/3-3/4,11-16,2-10,2-4,2-5,2/3,22-30,3-15,4-10,4-9,4.5-5.5,5-20,5-merous,6-8,7-10,8-10,9-13-20,abaxial,acut,adaxial,alyx,andromonoecious,apar,apart,apically,blade,branched,branching,broadly,curved,discolorous,distal,drying,eaf,eed,elongating,equal,faint,flattened,foliaceous,free,fused,gently,glabrescent,glabrou,glaucous,hermaphrodite,heterostylous,inflated,infructescence,less,lobe,longer,lower,lowermost,mature,midpoint,nflorescence,older,one,open,orolla,oung,pair,pendulous,per,pericarp,plurifoliat,porrect,porrect-lepidote,portion,prickle,primary,pubescent,ray,red,reddi,ruit,scar,secondary,sessile,short-styled,shorter,smooth,spaced,sparsely,stalk,stalked,staminat,stellate,stout,straight,strongly,tamen,terete,tertiary,time,trichome,unarme,unit,vary,vein,venation,visible,woody,ympodial	arrangement,branch,characteristic,colour,corolla,exertion,form,glabrousnes,growth,height,inflorescence,lobing,na,new,ovary,reddish,seed,shape,size,stigma,texture,type	.8,/3,0.6-1,0.7-2,1-1.2,1-1.7,1-6,1.1-1.5,1.5-2.2,2-3.1,2.2-2.5,2.8-3,20-60,4.5-7,5-10,5-7,abaxially,acute,apex,apparently,articulated,base,berry,chartaceous,cm,connivent,cuneate,dark,deltate,densely,diameter,entire,erect,evenly,flattened-reniform,flower,glabrous,gray,green,green-brown,hair,lanceolate,lateral,lobed,long,long-styled,maturity,mauve,minutely,mm,moderately,orange-brown,pale,pitted,poricidal,prickly,purple,reflexed,rounded,shallowly,shrub,simple,sometimes,sparse,spherical,spreading,stellate-pubescent,tapering,terminal,tip,toward,tree,truncate,unarmed,way,wide,yellow,young	na,reddish
136	wfo-0001027317	success	144	99	64	74	70	25	58	6	.5,0.1-0.2,0.3-1,0.4-1.5,0.5-3,1,1-1.5,1-2,1-5,1.5-2,2-3-flowered,4.5-5,?,acuminate,acute,adaxially,along,anther,apex,apically,bark,base,beneath,berry,bilobed,calyx,cm,corolla,deciduous,densely,dia,difoliate,drying,ellipsoid,elliptic,erect,fruit,fruiting,glabrous,globose,golden,green,leaf,lobed,long,long-exserted,minor,mm,nearly,offset,opposite,ovary,pale,pedicel,petiole,pointed,pubescent,shaped,shrub,simple,size,slightly,soon,stem,stigma,style,surface,tear-drop,trichome,tube,uniseriate,vein,white,x	.25,0.5-1,0.8-3.5,1.4-1.6,2-9,3-3.5,7-9,abaxial,anthesi,apical,arch,ba,broadly,closely,conical,cucullate,deflexed,deltoid,differing,eaf,edicel,eed,elongated,expanded,filament,filiform,free,geminat,greyish-whit,immature,inflorescenc,joined,known,lateral,like,lobe,lon,lower,main,major,margin,mature,minute,minutely,nflorescence,older,overlappin,pair,papillo,papillose,pore,poricidal,portion,projection,prominent,reflexed,rest,ruit,scar,series,spaced,sparsely,strongly,tall,tip,tub,ud,woody,ympodia,young	arrangement,bud,characteristic,colour,diameter,exertion,form,geminate,greyish-white,growth,height,history,inflorescence,length,life,lobing,na,number,per,plant,seed,shape,sympodia,texture,type	.5,0.1-0.2,0.3-1,0.4-1.5,0.5-3,1,1-1.5,1-2,1-5,2-3-flowered,4.5-5,?,acuminate,acute,adaxially,along,apically,base,beneath,berry,bilobed,calyx,cm,deciduous,densely,dia,difoliate,drying,ellipsoid,elliptic,erect,glabrous,globose,golden,green,leaf,lobed,long,long-exserted,mm,nearly,offset,opposite,pale,pointed,pubescent,shaped,shrub,simple,slightly,soon,tear-drop,trichome,tube,uniseriate,vein,white,x	.5-2,di,geminate,greyish-white,na,sympodia
137	wfo-0001027323	success	175	106	74	85	90	21	69	5	/3,0.5-1,1-1.5,1.2-1.5,10-15,14-21,2-3,2-6,2.5-3,20-45,5-20-flowered,5-7,6-11,acute,anther,apex,area,asymmetric,attenuate,bark,base,berry,broadened,calyx,campanulate,cm,corolla,decurrent,deflexed,densely,dia,difoliate,elliptic,erect,filament,fleshy,flower,fruit,fruiting,furcate,glabrate,globose,grey,held,higher,immature,leaf,lobed,long,minor,minutely,mm,occasionally,older,onto,opposite,ovary,ovoid-reniform,papillose,partially,pedicel,petiole,pinkish-grey,pitted,plant,red-papillose,reddish-grey,rest,size,slightly,stem,stigma,style,surface,tan,tip,treelet,tube,two,unit,way,white,winged,x,young	.75,1-2,3-5,7-9,adaxial,along,anthesi,apparent,appearing,arising,ba,bud,character,closed,closely,cork,differing,dried,dry,eaf,edicel,eed,elongate,entire,erose,exserted,five-pointed,flopping,free,geminat,glabrous,growing,hood,hooded,interpetalar,lateral,like,live,lobe,lon,long-triangular-deltoid,lower,main,major,margin,matte,mature,measured,middle,nflorescence,one,overlapping,ovoid,pair,papillae,papillo,persistent,planar,pore,poricidal,portion,prominent,proximal,rather,ridge,ruit,scar,secondary,seen,shaped,sinus,small,smoot,soon,spaced,specimen,straight,tall,tear-drop,thickened,thin,tiny,trunk,ud,upper,vein,visible,widest,woody,ympodial	0.75,arrangement,characteristic,colour,diameter,form,geminate,growth,height,history,inflorescence,length,life,lobing,perennial,seed,shape,smooth,sympodial,texture,type	/3,0.5-1,1-1.5,1.2-1.5,10-15,14-21,2-3,2-6,2.5-3,20-45,5-20-flowered,5-7,6-11,acute,area,asymmetric,attenuate,base,berry,broadened,campanulate,cm,decurrent,deflexed,densely,dia,difoliate,elliptic,erect,fleshy,flower,furcate,glabrate,globose,grey,held,higher,immature,leaf,lobed,long,minutely,mm,occasionally,older,onto,opposite,ovoid-reniform,papillose,partially,petiole,pinkish-grey,pitted,red-papillose,reddish-grey,rest,slightly,stem,style,tan,tip,treelet,two,unit,way,white,winged,x,young	0.75,geminate,perennial,smooth,sympodial
138	wfo-0001027340	success	189	102	63	81	108	21	61	2	0.5-0.9,1-2,1.5-2.7,10-16,16-22,2-3,2-4,2.5-4.5,2.7-4.5,3.5-5,3.5-9,4-6,4-7.5,5-11,5-6,6-8.5,7-18,7-8,8-9.5,abaxially,absent,adaxially,anther,berry,blade,brownish,cell,chartaceous,cm,condition,corolla,covering,dark,diameter,drying,filament,flower,fresh,fruit,glabrous,globose,green,greenish,hair-like,herb,homostylous,interjected,lateral,leaflet,lilac-purple,lobe,long,membranous,minute,mm,narrow,odd-pinnate,ovoid,pedicel,peduncle,petiole,plant,pubescent,purple,ripe,seed,size,sparsely,splotched,stem,stigma,style,terminal,testal,thick,tinged,tube,wall,whitish,wing,x	1-10,1-3,2-3.5,3-4,5-merou,8-14,abruptly,acumen,acuminate,ag,along,alyx,apart,apex,apparently,articulated,articulation,auriculate,axe,axillary,base,bud,capitat,ciliate,connivent,cordate,decreasing,developing,digestion,distal,distinct,dorsally,eaf,edge,eed,elliptic,enzyme,especially,exceeding,flat,folded,forked,geminat,generally,glabrou,green-white,hair,hal,half,high,honeycomb-shaped,indistinct,lanceolate,lengthening,like,living,lower,make,margin,midrib,minutely,mucilaginous,narrowed,nflorescence,orolla,ovate,pair,papillose,perfect,petiolulate,plurifoliate,pointed,pore,poricidal,puberulent,purpl,removed,rotate,rounded,ruit,semi-erec,semi-rosette,sessile,seudostipule,short,shortly,slightly,slit,spaced,specimen,stamen,ste,straight,subtending,tall,tamen,tem,throughout,tip,tri-,truncate,unit,usually,vary,wet,yellow,ympodial,young	5-merous,arrangement,calyx,capitate,characteristic,colour,form,growth,height,history,inflorescence,leaf,length,life,ovary,pseudostipule,shape,staman,surface,texture,type	0.5-0.9,1-2,1.5-2.7,10-16,16-22,2-3,2-4,2.5-4.5,2.7-4.5,3.5-5,3.5-9,4-6,4-7.5,5-11,5-6,6-8.5,7-18,7-8,8-9.5,abaxially,absent,adaxially,berry,brownish,cell,chartaceous,cm,condition,covering,dark,diameter,drying,fresh,glabrous,globose,green,greenish,hair-like,herb,homostylous,lateral,lilac-purple,long,membranous,minute,mm,narrow,odd-pinnate,ovoid,pubescent,purple,ripe,sparsely,splotched,testal,thick,tinged,wall,whitish,wing,x	5-merous,capitate
139	wfo-0001027354	success	166	141	111	118	48	23	108	3	0,0.5,0.5-2,0.7-1.3,1,1-1.2,1-1.5,1-7,1.5-1.8,1.5-2,1.7-5,10,10-20,2.5-3.5,3-4,3.4-4,3/4,4-10,5-7,6.5-13,abaxially,absent,acute,age,along,anther,anthesi,apex,apical,appearing,basal,base,becoming,berry,bi-lobed,branch,branching,calyx,cm,conical,corolla,covered,dendritic,densely,denser,diameter,elliptic,entire,exserted,filament,flattened,flower,fork,fruit,fruiting,glabrate,glabrous,globose,golden,growth,later,lateral,leaf,length,lenticular,like,lobe,long,loose,loosely,minutely,mm,monochasial,mostly,narrowly,near,occasionally,ovary,pedicel,per,petiole,pitted,planar,plurifoliate,pore,poricidal,pubescent,purplish-black,pyramidal,reddish-brown,shrub,slightly,slit-like,small,sparsely,stem,stigma,strongly,style,surface,tapering,terminal,time,tiny,tip,tree,tree-like,trichome,tube,type,vein,violet,way,white,wide,winged,x,young	.5,8-12,abaxial,adaxial,ba,bark,belo,blade,dark,deltoid,dichasia,drying,eaf,edicel,eed,erect,ew,free,inserted,less,lobed,lower,m.,nflorescence,nodding,older,pair,papillo,pericarp,portion,pubescen,raised,ruit,scar,secondary,side,simple,sleeve,somewhat,stamen,tall,thecalyx,thin,tub,ud,unit,woody,ympodial	arrangement,bud,characteristic,colour,dichasial,exertion,form,glabrousnes,height,history,inflorescence,life,lobing,na,new,number,papillose,peduncle,plant,seed,shape,size,texture	0,0.5,0.5-2,0.7-1.3,1,1-1.2,1-1.5,1-7,1.5-1.8,1.5-2,1.7-5,10,10-20,2.5-3.5,3-4,3.4-4,3/4,4-10,5-7,6.5-13,abaxially,absent,acute,age,along,anthesi,apex,apical,appearing,basal,base,becoming,berry,bi-lobed,branch,branching,calyx,cm,conical,corolla,covered,dendritic,densely,denser,diameter,elliptic,entire,exserted,flattened,flower,fork,fruit,glabrate,glabrous,globose,golden,later,lateral,length,lenticular,like,lobe,long,loose,loosely,minutely,mm,monochasial,mostly,narrowly,near,occasionally,per,petiole,pitted,planar,plurifoliate,pore,poricidal,pubescent,purplish-black,pyramidal,reddish-brown,shrub,slightly,slit-like,small,sparsely,stem,strongly,surface,tapering,terminal,time,tiny,tip,tree,tree-like,trichome,tube,vein,violet,way,white,wide,winged,x,young	dichasial,na,papillose
140	wfo-0001027359	success	220	125	82	99	121	26	79	3	.5,/3,0-3,0-9,0.3-1.2,0.5-2,0.6-1,1-1.2,1.2-1.5-2,1.2-2,1.5-2.5,2.5-5.5,4-5,6-8,acute,anther,apex,apparently,bark,base,berry,branched,bright,calyx,cell,chartaceous,cm,concolorous,cuneate,densely,diameter,distinctive,drying,dull,entire,filament,flattened-reniform,fruit,fruiting,glabrous,gray,lateral,leaf,length,lobed,long,margin,maturity,membranous,minutely,mm,moderately,obtuse,occasional,orange-brown,outline,ovate,ovoid,pair,pedicel,peduncle,petiole,pit,poricidal,prickle,prickly,primary,purple,raised,red,reflexed,reticulate,shallowly,shrub,small,smooth,sometimes,sparsely,spherical,spreading,stellate,stellate-pubescent,stem,style,surface,tapering,terminal,tinge,tip,trichome,tube,unarmed,undulate,vein,way,white,wide,yellow,yellow-brown	-20,-3,-4,-7,.1,.2,/4,0-2,0-5,0.1,0.1-0.2,0.1-0.2-0.25,0.1-1.5,0.3-0.5,0.5,0.5-1,0.6-0.8,1-2,1-3,1-4,1-5,1.5-2,1.8-3.2,1/5-1/4,2-10,2-3,2-4,2.5-3.5,3-10,4-5-6.5,5-6-8-9,5-merous,7-8,abaxially,acut,alyx,apar,apart,apically,articulated,ba,blade,brow,coroll,cream,curved,dark,deltate,difoliate,eaf,eed,elongate,elongating,equal,erect,eye,filiform,flattened,flower,free,geminat,glabrescent,green,herbaceous,infructescence,less,like,lobe,longer,lower,marking,mature,midpoint,naked,narrow-deltate,narrow-ovate,near,nflorescence,often,older,one,open,orolla,oung,pale,per,perfec,pericarp,porrect,portion,rachi,rarely,ray,ruit,scandent,scar,sessile,shorter,simple,slender,slightly,spaced,stalk,stalked,stump,tamen,terete,tertiary,time,ud,unarme,unit,usually,variously,vary,venation,visible,weakly,woody,ympodial,young	alternate,arrangement,branch,brown,bud,characteristic,colour,corolla,exertion,form,glabrousnes,growth,height,history,inflorescence,life,lobing,new,ovary,perennial,plant,seed,shape,size,texture,type	.5,/3,0-3,0-9,0.3-1.2,0.5-2,0.6-1,1-1.2,1.2-1.5-2,1.2-2,1.5-2.5,2.5-5.5,4-5,6-8,acute,apparently,base,berry,branched,bright,cell,chartaceous,cm,concolorous,cuneate,densely,diameter,distinctive,dull,entire,flattened-reniform,glabrous,gray,lateral,lobed,long,maturity,membranous,minutely,mm,moderately,obtuse,occasional,orange-brown,outline,ovate,ovoid,pair,pit,poricidal,prickle,prickly,purple,raised,red,reflexed,reticulate,shallowly,shrub,small,smooth,sometimes,sparsely,spherical,spreading,stellate,stellate-pubescent,tapering,terminal,tinge,tip,trichome,unarmed,undulate,way,white,wide,yellow,yellow-brown	alternate,brown,perennial
141	wfo-0001027366	success	136	108	71	82	54	26	68	3	/4,0.7-1,1-1.5,1-2,1-3,1.5-2,11-21,2-2.5,3-10-flowered,3-9,4-4.5,4-5,5-7,6-19,abaxially,acute,adaxially,anther,apex,axe,bark,base,berry,bright,broadly,brown,calyx,capitate,cm,conical,conspicuously,corolla,dark,deflexed,dia,drying,elliptic,except,fruiting,glabrous,globose,golden,green,greenish-white,lateral,leaf,lobed,long,main,minutely,mm,orbicular,ovary,ovoid,ovoid-reniform,pair,pale,papillose,parallel,pedicel,petiole,pitted,pointed,reddish,rounded,secondary,shaped,shining,shrub,simple,somewhat,stem,stigma,style,surface,tear-drop,tip,trichome,vein,venation,way,wide	.5,/2,0.25-0.5,0.5-1,603,anthesi,ape,ba,closely,deltate,eaf,edicel,eed,erect,et,exserted,fide,filament,free,internodal,lamina,less,lobe,lon,long-triangular,lower,margin,middle,nflorescence,older,opposite,overlappin,packed,papillo,planar,pore,poridical,portion,ramo,ruit,scar,sometimes,straight,tall,tub,tube,ud,unifoliat,unit,widest,woody,yellowish-gre,ympodial,young	arrangement,bud,characteristic,colour,diameter,exertion,form,fruit,growth,height,history,inflorescence,length,life,lobing,na,peduncle,plant,primary,seed,shape,size,texture,type,unifoliate,yellowish-grey	/4,0.7-1,1-1.5,1-2,1-3,1.5-2,11-21,2-2.5,3-10-flowered,3-9,4-4.5,4-5,5-7,6-19,abaxially,acute,adaxially,axe,base,berry,bright,broadly,brown,capitate,cm,conical,conspicuously,dark,deflexed,dia,drying,elliptic,except,glabrous,globose,golden,green,greenish-white,lateral,lobed,long,main,minutely,mm,orbicular,ovoid,ovoid-reniform,pair,pale,papillose,parallel,pitted,pointed,reddish,rounded,secondary,shaped,shining,shrub,simple,somewhat,tear-drop,tip,trichome,vein,venation,way,wide	na,unifoliate,yellowish-grey
142	wfo-0001027368	success	143	140	78	86	57	54	75	3	-15,.5,0.3-2.5,0.5-3.5,0.8-2,1-2,1.5-2,1.5-2.5,2,2-2.5,2-4,3-12.5,5-10,5-15-20,5-6,abaxially,abruptly,acuminate,acute,apart,apex,articulated,base,branched,calyx,chartaceous,cm,contiguous,cuneate,darker,decurrent,deltate,dendritically,densely,diameter,distally,ellipsiodal,elliptic,elliptic-ovate,entire,forked,glabrous,globose,hair,lanceolate,lenticular,lighter,lobe,margin,mm,moderately,narrowed,narrowly,nearly,oblong,obtuse,occasionally,often,otherwise,ovoid-fusiform,pedicel,peduncle,petiole,puberulent,pubescent,purple,ray,shrub,simple,small,spaced,sparsely,star,stigma,style,subcoriaceous,subhastate,terminal,triangular,truncate,tube,unbranched,unknown,vein,white,x	-10,-2-5,0.5-5,1-15-flower,1-6,2-3,2-9,3,4-6,4-many-foliat,8-13,absen,adaxiall,adaxially,aggregate,also,axe,ba,blade,cell,color,connivent,cylindrical,denser,directed,eaf,eed,except,gland,long,long-stalked,lower,midvein,nflorescence,nther,orolla,pore,pubescen,rachi,radiu,ruit,sometimes,stalked,stellate,stone,subcapitat,tal,tem,three,time,tip,unit,usually,vary,wide,yellow,ympodial	-5,abaxial,adaxial,anther,appearance,arrangement,bark,border,branch,bud,characteristic,colour,corolla,distal,drying,exertion,filament,form,fruit,fruiting,giving,glabrousnes,growth,height,history,inflorescence,interjected,lateral,leaf,leaflet,length,life,lobing,midpoint,na,new,number,ovary,per,plant,prickle,primary,pseudostipule,seed,shape,size,stem,subcapitate,surface,texture,thicknes,type,variation,width	-15,.5,0.3-2.5,0.5-3.5,0.8-2,1-2,1.5-2,1.5-2.5,2,2-2.5,2-4,3-12.5,5-10,5-15-20,5-6,abaxially,abruptly,acuminate,acute,apart,apex,articulated,base,branched,chartaceous,cm,contiguous,cuneate,darker,decurrent,deltate,dendritically,densely,distally,ellipsiodal,elliptic,elliptic-ovate,entire,forked,glabrous,globose,hair,lanceolate,lenticular,lighter,lobe,margin,mm,moderately,narrowed,narrowly,nearly,oblong,obtuse,occasionally,often,otherwise,ovoid-fusiform,puberulent,pubescent,purple,shrub,simple,small,spaced,sparsely,star,subcoriaceous,subhastate,triangular,truncate,unbranched,unknown,white,x	-5,na,subcapitate
143	wfo-0001027369	success	188	109	65	80	108	29	62	3	.4,.5,.7,/4,0-1,0.5-0.8,0.6-0.8,1-2.5,1-4,1.2-2.5,1.2-3,1.5-2,2-3,almost,anther,apex,apically,apparently,articulated,bark,base,berry,calyx,cm,cordate,curved,densely,diameter,erect,eye,filament,filiform,fruit,fruiting,glabrous,glaucous,green,known,lanceolate,lateral,leaf,length,lobed,long,margin,mauve,membranous,mm,moderately,naked,narrowly,orbicular,pedicel,peduncle,per,petiole,poricidal,prickly,reniform,rounded,shrub,simple,slender,sparsely,spherical,spreading,stellate,stellate-pubescent,stem,strongly,style,surface,tapering,terminal,tip,tube,visible,way,wide,winged	-10,-11,.1,0-15,0-2,0-3,0-5,0-6,0.05-0.15,0.1,0.1-0.2,0.1-0.3,0.2-0.5-1,0.25-0.4,0.3-1.5,0.5,0.5-1.5,1-2,1-2-4,1-3,1/3,2-5,3,3-10,3-4,4-5,4-8,5,5-merous,7-15,abaxially,acut,alyx,ame,apar,apart,blade,branched,broad-deltate,c.,color,concolorous,deltate,difoliate,distance,drying,eaf,eed,elongating,equal,extending,flower,free,geminat,glabrou,gra,hair,herbaceous,infructescence,know,less,lobe,lon,lower,mature,midpoint,midvein,multangulate,nflorescence,older,one,open,orolla,oung,pale,pendulous,perfec,pericarp,perpendicular,porrect,portion,prickl,prickle,ray,reflexed,ruit,scandent,scar,sessile,side,slightly,smooth,spaced,stalk,stalked,straight,tamen,terete,time,trichome,unarmed,unequal,unit,vary,venation,wider,yellow,ympodial	acute,arrangement,branch,bud,characteristic,colour,corolla,corrugation,exertion,form,glabrousnes,gray,growth,height,inflorescence,lobing,na,new,number,ovary,plant,primary,seed,shape,size,stigma,texture,type,vein	.4,.5,.7,/4,0-1,0.5-0.8,0.6-0.8,1-2.5,1-4,1.2-2.5,1.2-3,1.5-2,2-3,almost,apically,apparently,articulated,base,berry,cm,cordate,curved,densely,diameter,erect,eye,filiform,glabrous,glaucous,green,known,lanceolate,lateral,lobed,long,mauve,membranous,mm,moderately,naked,narrowly,orbicular,poricidal,prickly,reniform,rounded,shrub,simple,slender,sparsely,spherical,spreading,stellate,stellate-pubescent,strongly,tapering,terminal,tip,visible,way,wide,winged	acute,gray,na
144	wfo-0001027378	success	149	131	67	84	65	47	65	2	.2,0.7â1,1.2â1.8,1.5â1.8,1.5â8,15â35,2.3â5,2.5â7,2â11,2â2.2,2â2.5,3â5,3â6,4â6,6â7,acuminate,acute,anther,apex,base,berry,blue,broadly,calyx,chartaceous,cm,cordate,deeply,deltoid,diameter,extra-axillary,filament,flattened,fleshy,flower,fruit,fruiting,glabrous,half,herbaceous,lanceolate,leaf,light,lobe,lower,margin,markedly,minutely,mm,narrowly,ovate,ovoid,palmate,papillose,pedicel,peduncle,pentagonal,petiole,primary,pubescent,revolute,rotate-stellate,rounded,sand-punctate,simple,slender,slightly,small,somewhat,spaced,sparsely,stem,stigma,style,tip,tooth,tube,unbranched,unknown,vein,vine,white,widely,x	0.5â1,0.8â2.5,1.2â1.5,1â1.5,1â3,3â4.5,4â9,5-8,5-merous,5â10,5â13,5â7,6â10,abaxially,adaxial,adaxially,alyx,apar,apicall,axe,blade,c.,capitat,ciliate,clavate,climbin,color,cylindrical,densely,eaf,eed,glabrou,hair,hair-tipped,like,lon,long,longer,m.,membranous,moderately,nflorescence,nternode,obscure,often,orolla,perfec,plurifoliat,pointed,rachi,ruit,sand-punctat,scattered,short,side,tamen,tem,terrestrial,trichome,unit,unknow,vary,venation,wide,ympodial	appearance,arrangement,bark,border,branch,bud,capitate,characteristic,colour,corolla,corrugation,distal,drying,exertion,form,giving,glabrousnes,growth,height,history,inflorescence,interjected,lateral,leaflet,length,life,lobing,midpoint,na,new,number,ovary,per,plant,prickle,pseudostipule,ray,seed,shape,size,surface,terminal,texture,thicknes,type,variation,width	.2,0.7â1,1.2â1.8,1.5â1.8,1.5â8,15â35,2.3â5,2.5â7,2â11,2â2.2,2â2.5,3â5,3â6,4â6,6â7,acuminate,acute,berry,blue,broadly,chartaceous,cm,cordate,deeply,deltoid,extra-axillary,flattened,fleshy,flower,fruit,glabrous,half,herbaceous,lanceolate,light,lower,markedly,minutely,mm,narrowly,ovate,ovoid,palmate,papillose,pentagonal,pubescent,revolute,rotate-stellate,rounded,sand-punctate,simple,slender,slightly,small,somewhat,spaced,sparsely,tip,tooth,unbranched,unknown,vine,white,widely,x	capitate,na
145	wfo-0001027378	success	141	129	101	108	33	21	97	4	.2,0.7-1,0.8-2.5,1-1.5,1-3,1.2-1.5,1.5-1.8,1.5-8,15-35,2-11,2-2.2,2-4,2.5-7,3-4.5,3-5,3-6,4-6,5-13,5-8,6-10,abaxially,acuminate,acute,adaxially,anther,apart,apex,apparently,basally,base,blade,blue,broadly,calyx,chartaceous,ciliate,clavate,climbing,cm,connivent,cordate,cylindrical,deeply,densely,diameter,directed,distally,equal,extra-axillary,filament,fleshy,flower,fruit,glabrous,hair,hair-tipped,herb,lanceolate,large,leaf,light,lobe,long,longitudinal,margin,minutely,mm,multicellular,node,oblong,obscure,often,opening,ovate,pedicel,peduncle,perfect,petiole,pore,pubescent,rachi,revolute,rooting,rotate-pentagonal,rounded,scattered,short,simple,slender,slit,small,somewhat,spaced,sparsely,stigma,style,terrestrial,tip,tooth,trailing,tube,unbranched,unknown,weakly,white,widely,x,yellow	2.3-5,4-9,5-merou,6-7,ag,alyx,apicall,articulated,axe,ba,capitat,deltoid,eaf,eed,fruiting,geminat,longer,lower,moderately,narrowly,nflorescence,orolla,plurifoliate,pubescen,slightly,tamen,tem,unit,unknow,vary,vein,wide,ympodial	5-merous,age,apically,arrangement,capitate,characteristic,corolla,form,growth,habit,history,inflorescence,length,life,ovary,shape,size,spacing,staman,stem,texture	.2,0.7-1,0.8-2.5,1-1.5,1-3,1.2-1.5,1.5-1.8,1.5-8,15-35,2-11,2-2.2,2-4,2.5-7,3-4.5,3-5,3-6,4-6,5-13,5-8,6-10,abaxially,acuminate,acute,adaxially,apart,apparently,basally,blade,blue,broadly,chartaceous,ciliate,clavate,climbing,cm,connivent,cordate,cylindrical,deeply,densely,diameter,directed,distally,equal,extra-axillary,filament,fleshy,flower,fruit,glabrous,hair,hair-tipped,herb,lanceolate,large,leaf,light,lobe,long,longitudinal,minutely,mm,multicellular,node,oblong,obscure,often,opening,ovate,perfect,pore,pubescent,revolute,rooting,rotate-pentagonal,rounded,scattered,short,simple,slender,slit,small,somewhat,spaced,sparsely,terrestrial,tip,tooth,trailing,tube,unbranched,unknown,weakly,white,widely,x,yellow	5-merous,age,apically,capitate
146	wfo-0001027384	success	155	114	78	90	65	24	76	2	.5,.75,0.4-1.1,0.5-1,0.9-1,1-1.3,1-1.5,1-3,1-4,1.5-2,2.5-6.5,3-3.5,3-4,3/4,4-7,5-15-flowered,7-14,7.5-8,acute,anther,apex,bark,base,berry,brown,bud,calyx,capitate,clavate,cm,corolla,cuneate,deep,dia,drying,ellipsoid,filament,flattened-reniform,fruiting,glabrous,globose,green,hard,later,lateral,leaf,lobed,long,long-exserted,main,minutely,mm,mustard,narrowly,obovate,opposite,ovary,pair,pale,papillose,pedicel,petiole,pitted,pore,poricidal,pseudo-terminal,reddish-purple,rounded,shaped,shining,shrub,simple,slender,small,stem,stigma,style,sulcate,surface,tapering,tear-drop,tip,tree,tube,vein,way,white,x,yellow,young	.25,/3,5-5.5,abov,anothe,anthesi,apart,ba,beginning,beneath,breaking,broadly,closely,difoliate,distal,eaf,edicel,eed,equal,erect,free,geminate,herbarium,incrassate,inflorescenc,lobe,lower,margin,member,middle,nflorescence,occasionally,older,overlapping,paler,papillo,peeling,planar,portion,prominent,rarely,ruit,scar,section,siz,spaced,specimen,straight,subcoriaceous-fleshy,tall,thick,transverse,triangular,trichome,tub,tuft,ud,uniseriate,unit,widely,widest,without,woody,yellowish,ympodial	alternate,arrangement,characteristic,colour,diameter,form,fruit,growth,height,history,inflorescence,length,life,lobing,na,number,per,plant,primary,seed,shape,size,texture,type	.5,.75,0.4-1.1,0.5-1,0.9-1,1-1.3,1-1.5,1-3,1-4,1.5-2,2.5-6.5,3-3.5,3-4,3/4,4-7,5-15-flowered,7-14,7.5-8,acute,base,berry,brown,calyx,capitate,clavate,cm,cuneate,deep,dia,ellipsoid,flattened-reniform,glabrous,globose,green,hard,later,lateral,leaf,lobed,long,long-exserted,main,minutely,mm,mustard,narrowly,obovate,opposite,pair,pale,papillose,pitted,pore,poricidal,pseudo-terminal,reddish-purple,rounded,shaped,shining,shrub,simple,slender,small,sulcate,surface,tapering,tear-drop,tip,tree,tube,vein,way,white,x,yellow,young	alternate,na
147	wfo-0001027389	success	154	88	51	65	89	23	47	4	.1,.5,0.25-0.3,0.5-0.75,0.5-1.5,0.6-1,1-1.5,1.8-1.9,11-14,2-2.5,3-3.5,3-4.5,5-7,acuminate,acute,anther,apex,base,berry,broadening,broadly,brown,calyx,cm,conical,corolla,dark,dia,elliptic,filament,foetid,fruiting,glabrous,globose,hispidulous,inflorescence,leaf,lobed,minutely,mm,nearly,ovary,ovate,ovoid-reniform,pedicel,petiole,pitted,puberulent,shaped,shrub,simple,slight,sparsely,stem,stigma,style,surface,tear-drop,top,trichome,truncate,tube,white,winged,x	.25,0.25-0.5,1,1-2,4-5-flowered,7-8,along,anthesi,apart,ba,bark,beneath,bud,decurrent,deflexed,deltoid,dry,eaf,edicel,eed,ellipsoid,erect,evenly,except,expanded,exserted,filiform,foliage,free,geminate,green,lateral,like,lobe,lon,long,lower,main,making,margin,material,middle,nflorescence,node,non-reproductive,obovoi,occasionally,often,older,one,opposite,pair,paler,papillo,papillose,pore,poricidal,portion,prominent,prominently,proximal,raise,raised,reddish-golden,reflexed,rest,ruit,scar,shin,side,slender,slightly,soon,spaced,straight,tall,tapering,thread-like,tip,ud,unifoliat,uniseriate,unit,vein,widest,woody,yellowish,ympodial,young	0.1,arrangement,characteristic,colour,diameter,form,fruit,glabrousnes,growth,height,history,length,life,lobing,new,plant,seed,shape,size,texture,type,unifoliate,variation	.1,.5,0.25-0.3,0.5-0.75,0.5-1.5,0.6-1,1-1.5,11-14,2-2.5,3-3.5,3-4.5,5-7,acuminate,acute,base,berry,broadening,broadly,brown,cm,conical,dark,elliptic,foetid,glabrous,globose,hispidulous,lobed,minutely,mm,nearly,ovate,ovoid-reniform,pitted,puberulent,shaped,shrub,simple,slight,sparsely,style,tear-drop,top,truncate,white,winged,x	.8-1.9,0.1,di,unifoliate
148	wfo-0001027395	success	153	118	79	94	59	24	78	1	.25,.5,0.25-0.5,0.75-1,1-1.5,1-5,1.1-1.5,1.5-1.9,10-20-flowered,12.5-17.3,2-3,5-6.5,8,acute,anther,apex,apically,attenuate,bark,base,beneath,berry,black,calyx,capitate,cm,conical,constricted,corolla,decurrent,deflexed,densely,dia,drying,erect,exfoliating,exserted,filament,fleshy,fruit,fruiting,glabrous,globose,green,immature,imperceptibly,large,leaf,lobe,lobed,long,margin,minutely,mm,narrowly,nearly,obovate,occasionally,once-furcate,ovary,ovoid,papillose,partially,pedicel,petiole,piece,pointed,primary,pubescent,raised,robust,rusty-papillate,secondary,shaped,shining,shiny,shrub,simple,size,small,somewhat,stem,stigma,straight,style,tapering,tear-drop,transverse,trichome,tube,uniseriate,vein,white,x	0.6-1.1,1-2,1.5-2.5,1.6-2.9,11-15,2.2-7,3.5-4,4-6,anthesi,apiculate,becoming,beginning,caly,closely,cucullate,deltoid,depressed,differing,difoliate,eaf,edicel,eed,enlarging,free,geminat,inflorescenc,known,lateral,lon,lower,main,major,midrib,minor,nflorescence,older,opposite,overlapping,pair,papillo,planar,pore,poricidal,portion,restricted,ruit,scar,spaced,tall,thick,thickened,tip,ud,unit,within,without,woody,ympodial,young	arrangement,bud,characteristic,colour,diameter,exertion,form,growth,height,history,inflorescence,length,life,lobing,na,number,peduncle,per,plant,seed,shape,surface,texture,type	.25,.5,0.25-0.5,0.75-1,1-1.5,1-5,1.1-1.5,1.5-1.9,10-20-flowered,12.5-17.3,2-3,5-6.5,8,acute,apically,attenuate,base,beneath,berry,black,calyx,capitate,cm,conical,constricted,decurrent,deflexed,densely,dia,drying,erect,exfoliating,exserted,fleshy,glabrous,globose,green,immature,imperceptibly,large,lobe,lobed,long,minutely,mm,narrowly,nearly,obovate,occasionally,once-furcate,ovoid,papillose,partially,petiole,piece,pointed,primary,pubescent,raised,robust,rusty-papillate,secondary,shaped,shining,shiny,shrub,simple,small,somewhat,straight,tapering,tear-drop,transverse,trichome,uniseriate,vein,white,x	na
149	wfo-0001027396	success	241	170	111	132	109	38	107	4	0-100,0-3,0-4,0.5-1,0.5-1.5,0.7-2.5,0.8-1.3,1.5-3,1.5-3.5,1.8-3,1/3,1/4-1/3,10-35,2-3,2-3.5,2-7,2.5-4,2.8-4.5,20-100,3.5-6,4-7,5-50,5-8,6-20,abaxially,acute,almost,anther,apart,apex,apparently,articulated,attenuate,bark,base,berry,black,brown,calyx,chartaceous,cm,concolorous,connivent,cream,cuneate,dark,densely,diameter,discolorous,distal,drying,elliptic,elongate,erect,filament,flattened,flattened-reniform,flower,fruit,fruiting,glabrous,glandular,green,hair,herb,lateral,leaf,length,lobe,lobed,lobing,long,long-styled,margin,marking,maturity,mauve,midpoint,mm,moderately,near,obtuse,often,orange,pair,pale,pedicel,peduncle,per,perpendicular,petiole,plant,poricidal,porrect,prickle,prickly,primary,pubescent,purple,ray,red-brown,rotate,short-styled,shrub,simple,sometimes,somewhat,spaced,sparsely,spherical,stalked,stellate-pubescent,stem,straight,style,surface,tapering,tearing,tip,trichome,tube,unbranched,upper,variously,vein,way,white,wide,yellow,yellow-green,yellowish,young	/3,0-30,0-5,0.1-0.5,0.1-1,0.4-0.7,0.5-2,0.5-2.5,0.8,1,1-2,1-4,1.2-2,1/2-2/3,1/6,10-15,10-25,10-30,12-25,15-40,3-4-5-6,3-9,4-5,4-6,5-10,5-20,5-30,5-merous,5.5-7.5,6.5-7.5,7-10,7-15,8-20,abaxial,adaxial,alyx,ame,andromonoecious,apar,apically,ba,blade,broad,broad-deltate,bulbous,c.,curved,decurrent,deltate,difoliate,distance,eaf,eed,elongating,equal,extending,extensive,fewer,free,fully,geminat,glabrescent,gray-brow,hermaphrodite,heterostylous,infructescence,less,lignified,lon,long-acuminat,longer,lower,lowermost,mature,midvein,nflorescence,older,one,open,opening,orolla,oung,pendulous,pericarp,portion,prickl,reflexed,ruit,scar,secondary,sessile,side,smooth,spreading,stalk,staminat,stout,tamen,terete,tertiary,time,unarmed,unit,usually,vary,venation,visible,woody,ympodial	appearance,arrangement,border,branch,bud,characteristic,colour,corolla,corrugation,decurren,exertion,form,giving,glabrousnes,gray-brown,growth,height,history,inflorescence,interjected,leaflet,life,na,new,number,ovary,perennial,pseudostipule,seed,shape,size,stigma,terminal,texture,thicknes,type,variation,width	0-100,0-3,0-4,0.5-1,0.5-1.5,0.7-2.5,0.8-1.3,1.5-3,1.5-3.5,1.8-3,1/3,1/4-1/3,10-35,2-3,2-3.5,2-7,2.5-4,2.8-4.5,20-100,3.5-6,4-7,5-50,5-8,6-20,abaxially,acute,almost,apart,apparently,articulated,attenuate,base,berry,black,brown,chartaceous,cm,concolorous,connivent,cream,cuneate,dark,densely,diameter,discolorous,elliptic,elongate,erect,flattened,flattened-reniform,flower,glabrous,glandular,green,hair,herb,lateral,lobed,long,long-styled,marking,maturity,mauve,mm,moderately,near,obtuse,often,orange,pair,pale,per,perpendicular,poricidal,porrect,prickle,prickly,pubescent,purple,red-brown,rotate,short-styled,shrub,simple,sometimes,somewhat,spaced,sparsely,spherical,stalked,stellate-pubescent,stem,straight,tapering,tearing,tip,trichome,unbranched,upper,variously,way,white,wide,yellow,yellow-green,yellowish,young	decurren,gray-brown,na,perennial
150	wfo-0001027449	success	160	101	65	76	84	25	61	4	/3,0.5-1,0.8-1.5,0.9-1.1,1.4-1.5,1.5-2.5,10-15-flowered,2-4,5-6,anther,area,bark,base,berry,brown,bud,calyx,cm,corolla,dark,densely,dia,difoliate,elliptic,exserted,fruit,fruiting,glabrate,glabrous,globose,green,inflorescence,leaf,lobe,lobed,long,long-acuminate,minutely,mm,narrowly,older,ovary,ovoid-reniform,pale,papillose,pedicel,petiole,pitted,pointed,pubescent,red-papillose,shaped,shrub,simple,size,slender,small,soon,sparsely,stem,stigma,straight,style,surface,tapering,tear-drop,tip,tree,trichome,tube,tuft,uniseriate,unit,way,white,young	.4,.5,.75,0.5-1.5,1.2-1.5,2-3,3,3-3.5,3-7,4-6,8-15,acuminate,acute,anthesi,apex,appearing,arising,around,axil,becoming,beginning,beneath,closely,cup,deciduous,deflexed,dense,density,differing,dry,eaf,edicel,eed,ellipsoid,erect,extreme,filament,forming,free,frui,geminat,inflorescenc,lamina,later,lateral,like,lon,long-triangular,lower,main,major,material,minor,nflorescence,obconic,oblique,often,one,opposite,orangish,overlapping,packed,pair,persistent,pore,poricidal,portion,prominent,raised,reddish-brow,reflexed,rest,ruit,scar,sparse,styl,tall,trunk,ud,varying,vein,woody,x,ympodial	abaxial,adaxial,arrangement,characteristic,colour,diameter,exertion,form,geminate,growth,hair,height,history,length,life,lobing,na,plant,reddish-brown,seed,shape,sympodial,texture,type,variation	/3,0.5-1,0.8-1.5,0.9-1.1,1.4-1.5,1.5-2.5,10-15-flowered,2-4,5-6,area,base,berry,brown,calyx,cm,dark,densely,dia,difoliate,elliptic,exserted,glabrate,glabrous,globose,green,lobe,lobed,long,long-acuminate,minutely,mm,narrowly,older,ovoid-reniform,pale,papillose,pitted,pointed,pubescent,red-papillose,shaped,shrub,simple,slender,small,soon,sparsely,straight,style,tapering,tear-drop,tip,tree,trichome,tube,tuft,uniseriate,unit,way,white,young	geminate,na,reddish-brown,sympodial
151	wfo-0001027452	success	152	104	72	80	72	24	70	2	.5,0.5-1,0.5-2,1,1-3,1-5,1.5,10-20,2-4,2-foliate,3-9,4,4-6,5-12,absent,acute,anther,apex,base,berry,brown,calyx,cell,center,chartaceous,ciliate,cm,connected,densely,diameter,dm,drying,elliptic,elliptic-ovoid,entire,filament,flower,fruit,glabrous,globose,herb,immature,large,linear-lanceolate,margin,maturing,membranaceous,mm,moderately,nearly,new,oblong,obtuse,outer,parallel,pedicel,peduncle,perpendicular,petiole,pubescent,raised,ridge,rotate,rounded,running,seed,semitransparent,slightly,smaller,smoother,sometimes,sparsely,stigma,style,swollen,wall,white,woody,x,yellow	0.5-1.5,0.5-2.5,1-2,1-4.5,1.5-3,2-6,3-6,5-20,abaxially,abundant,adaxiall,adaxially,along,axe,beyond,blade,branched,celled,cordate,decurrent,dehiscing,denser,eaf,eed,emarginat,equal,explosively,exserted,flat,frui,geminat,growt,hair,held,interpetalar,lobe,long,lower,lying,maturit,mesocarp,nfloresence,notched,often,one-,orolla,per,placenta,pressure,pubescen,rachi,ruit,short,significantly,single,stamen,straight,tal,tamen,tem,tissue,triangular,tube,two-celled,unbranched,unit,usually,vary,vein,watery,wid,ympodial	abaxial,adaxial,arrangement,characteristic,colour,corolla,form,glabrousnes,growth,height,inflorescence,leaf,length,mentioned,ovary,plant,shape,size,staman,stem,surface,texture,type,wide	.5,0.5-1,0.5-2,1,1-3,1-5,1.5,10-20,2-4,2-foliate,3-9,4,4-6,5-12,absent,acute,base,berry,brown,cell,center,chartaceous,ciliate,cm,connected,densely,diameter,dm,drying,elliptic,elliptic-ovoid,entire,flower,fruit,glabrous,globose,herb,immature,large,linear-lanceolate,margin,maturing,membranaceous,mm,moderately,nearly,oblong,obtuse,outer,parallel,perpendicular,pubescent,raised,ridge,rotate,rounded,running,seed,semitransparent,slightly,smaller,smoother,sometimes,sparsely,swollen,wall,white,woody,x,yellow	mentioned,wide
152	wfo-0001027471	success	165	122	83	101	64	21	80	3	.5,/4,0.1-0.2,0.2-0.5,0.4-1,0.5,0.5-0.6,0.5-0.7,0.5-1.5,0.9-1,1-1.2,1.4-3,2-3,2-lobed,3-4,3-7,4-5,6-7,acute,anther,anthesi,apex,base,berry,bifid,calyx,cm,conical,corolla,dendritic,densely,diameter,difoliate,distant,drying,elliptic,entire,erect,filament,flattened,flower,fruiting,geminate,glabrous,globose,growth,herb,included,inflorescence,internodal,lamina,leaf,leaf-opposed,less,like,lobe,margin,maturity,minutely,mm,new,nodding,node,occasionally,open-conical,ovary,ovate,pair,pedicel,peduncle,petiole,pitted,poridical,primary,pubescent,red-orange,reniform,shape,shrub,simple,size,slender,small,somewhat,sparsely,stem,stigma,style,subshrub,surface,tan,tip,trichome,tube,unit,usually,vein,way,white,x,yellowish	0.2-0.4,0.7-0.9,1-1.5,1-1.6,1.5-2,2-2.5,abaxially,adaxially,age,along,appressed,ascending,bark,branched,brittle,c.,closely,deltate,desnsely,differing,eaf,eed,erec,especially,free,furcate-dendritic,lengthening,lobed,long-triangular,lower,major,midvein,minor,mixture,nflorescence,orbicular,overlapping,pale,papillat,perfect,pericarp,petal,planar,plane,pore,portion,pubscent,rachi,reflexed,ruit,scar,scattered,similar,slightly,slit,spaced,straight,thickened,thin,trifoliat,ud,uniseriate,woody,ympodial	arrangement,branch,bud,characteristic,colour,exertion,form,fruit,glabrousnes,height,history,length,life,lobing,na,plant,seed,sympodial,texture,trifoliate,type	.5,/4,0.1-0.2,0.2-0.5,0.4-1,0.5,0.5-0.6,0.5-0.7,0.5-1.5,0.9-1,1-1.2,1.4-3,2-3,2-lobed,3-4,3-7,4-5,6-7,acute,anthesi,base,berry,bifid,calyx,cm,conical,dendritic,densely,diameter,difoliate,distant,elliptic,entire,erect,flattened,flower,geminate,glabrous,globose,herb,included,internodal,lamina,leaf,leaf-opposed,less,like,lobe,maturity,minutely,mm,nodding,node,occasionally,open-conical,ovate,pair,pitted,poridical,pubescent,red-orange,reniform,shrub,simple,slender,small,somewhat,sparsely,stem,subshrub,tan,tip,trichome,unit,usually,vein,way,white,x,yellowish	na,sympodial,trifoliate
153	wfo-0001027473	success	138	105	72	82	56	23	69	3	.25,/2,0.25-0.5,0.5-1,0.8-1,1.3-2,1.5-2,1.8-2,4.5-13,5,8.5-37,?,abaxially,acute,adaxially,along,anther,apex,bark,base,berry,brown,clavate,cm,corolla,deccurent,decurrent,deep,dendritic,densely,denser,di-,dia,erect,filament,flattened-reniform,fruiting,glabrous,globose,green,incrassate,later,leaf,like,long,margin,minutely,mm,near,obovate,occasionally,ovary,pale,pedicel,petiole,pitted,pointed,pubescent,pubesent,rusty,sessile,shape,shrub,somewhat,sparsely,stem,stigma,strongly,style,subshrub,surface,thick,trichome,trifoliate,tube,vein,way,white,wide,wing,winged,young	1-1.5,1-2,1/3,2-2.5,2.5-3,3.5-5,6-9,absen,anthesi,ape,apparently,calyx,conical,deflexed,differing,drying,eaf,eed,empty,free,geminat,giving,lateral,less,lobe,lobed,long-triangular,lower,main,major,middle,minor,minute,older,overall,pair,papillo,planar,pore,poricidal,portion,rootstock,ruit,sac,shaped,sterile,tall,tear-drop,tip,unit,usually,widest,woody,yellowish,yellowish-brow,ympodial	absent,arrangement,characteristic,colour,diameter,exertion,form,fruit,growth,height,history,inflorescence,length,life,lobing,na,peduncle,plant,seed,size,texture,type,yellowish-brown	.25,/2,0.25-0.5,0.5-1,0.8-1,1.3-2,1.5-2,1.8-2,4.5-13,5,8.5-37,?,abaxially,acute,adaxially,along,apex,base,berry,brown,clavate,cm,deccurent,decurrent,deep,dendritic,densely,denser,di-,dia,erect,flattened-reniform,glabrous,globose,green,incrassate,later,leaf,like,long,margin,minutely,mm,near,obovate,occasionally,pale,pitted,pointed,pubescent,pubesent,rusty,sessile,shrub,somewhat,sparsely,stem,strongly,subshrub,thick,trichome,trifoliate,vein,way,white,wide,wing,winged,young	absent,na,yellowish-brown
154	wfo-0001027483	success	164	80	43	58	106	22	42	1	0.2-1.9,0.6,1-2.5,1-4,1-5,1.2-2.5,1.5-10,1.5-2.6,1.5-3,2-3,2-4,2-4.5,3-15,3-6,3.5-20,4.5-8,5-6,branched,calyx,cm,coarsely,corolla,cyme,diameter,dichasial,dichasially,ebracteate,filament,finely,forked,globose,green,herbaceous,interjected,lateral,leaf,leaflet,light,long,medium,mm,monochasial,mucilaginous,odd-pinnate,ovoid,pedicel,peduncle,perennial,petiole,plant,pubescent,seed,size,style,terminal,violet,violet-purple,wide	0-1.,1,1-2,2,3-6-foliat,5-10,abaxially,acumen,acute,adaxially,apex,apical,apically,articulate,basal,base,cell,connate,covering,cuneate,decurrent,dehiscent,digestion,diminishing,distal,dorsally,dot,eaf,edge,eed,elliptical,emoval,enzyme,erec,exceeding,flat,flower,folded,generally,globo,gradually,green-white,hair-like,half,honeycomb,interpetiolar,introrse,lighter,living,lobe,lon,lower,lunat,make,maturing,minute,nflorescence,nther,obtuse,often,orolla,ovate,pair,pattern,perfect,petiolule,plan,poricidally,proximal,purple,rachi,ray,reveal,rosette,rotate,rounded,ruit,sessile,seudostipule,short,slit,smooth,sometimes,specimen,stamen,stigma,straight,subsessile,tall,tem,testal,thick,throughout,tissu,toward,tuber-bearing,typically,uniform,unit,vary,varying,wall,white,yellow,ympodial,Â¼	0-10,abaxial,adaxial,anther,arrangement,colour,form,fruit,growth,height,history,inflorescence,length,life,ovary,pseudostipule,shape,stem,surface,texture,type,width	0.2-1.9,0.6,1-2.5,1-4,1-5,1.2-2.5,1.5-10,1.5-2.6,1.5-3,2-3,2-4,2-4.5,3-15,3-6,3.5-20,4.5-8,5-6,branched,cm,coarsely,cyme,dichasial,dichasially,ebracteate,finely,forked,globose,green,herbaceous,light,long,medium,mm,monochasial,mucilaginous,odd-pinnate,ovoid,perennial,pubescent,violet,violet-purple,wide	0-10
155	wfo-0001027506	success	213	112	75	93	120	19	75	0	.2,.5,/6,0-10,0.5-1.5,0.5-6,0.7-1.3,0.8-1.5,1-2,1.2-1.5,1.5-2.2,1.8,1/3,2-3.2,2.2-3.5,acuminate,acute,anther,apex,apically,apparently,articulated,bark,base,berry,brown,calyx,cell,chartaceous,cm,cordate,cream,cuneate,dark,densely,diameter,entire,erect,filament,fine,flattened-reniform,fruit,fruiting,green,lateral,leaf,length,lobed,long,margin,marking,maturity,mauve,mm,narrow-deltate,occasionally,orange-brown,outline,ovate,pale,pedicel,peduncle,petiole,pit,plant,poricidal,prickly,purple,raised,reddish,shrub,simple,small,smooth,sometimes,spherical,stellate-pubescent,stem,style,subentire,surface,tapering,terminal,tip,tree,truncate,tube,upper,way,wide,yellow,yellow-green,young	-20,-3,-7,-7.5,/2,0-1,0-2,0-6,0-60,0.1-0.2-0.3-0.35,0.1-0.3,0.2,0.2-0.3,0.25,1-3,1-4,1/6-1/4,10-40,2.5-5,2.5-8,3-10,3-5,3-6,3.5-5,5-10,5-7,5-merous,6-13,6.5-10,7-8,7-9,8-10,9-13,abaxially,acuminat,alyx,ame,andromonoecious,apar,apart,becoming,blade,branched,brow,c.,concolorous,connivent,curved,distal,dry,drying,eaf,eed,elongating,equal,flattened,flower,free,glabrescent,glabrous,hard,hermaphrodite,heterostylous,infructescence,lengt,lobe,long-styled,longer,lower,lowermost,mature,midpoint,moderately,multangulate,nflorescence,older,one,open,orange,orolla,oung,pair,pendulous,per,pericarp,plurifoliat,porrect,portion,prickl,prickle,primary,ray,reduced,reflexed,ruit,scar,sessile,short-styled,spaced,spreading,stalk,stalked,staminat,stellate,stout,tamen,terete,tertiary,time,trichome,twice,unarmed,unit,variously,vary,vein,venation,visible,woody,ympodial	arrangement,branch,characteristic,colour,corolla,exertion,form,glabrousnes,growth,height,inflorescence,lobing,new,ovary,seed,shape,size,texture,type	.2,.5,/6,0-10,0.5-1.5,0.5-6,0.7-1.3,0.8-1.5,1-2,1.2-1.5,1.5-2.2,1.8,1/3,2-3.2,2.2-3.5,acuminate,acute,apically,apparently,articulated,base,berry,brown,cell,chartaceous,cm,cordate,cream,cuneate,dark,densely,diameter,entire,erect,fine,flattened-reniform,green,lateral,lobed,long,marking,maturity,mauve,mm,narrow-deltate,occasionally,orange-brown,outline,ovate,pale,pit,poricidal,prickly,purple,raised,reddish,shrub,simple,small,smooth,sometimes,spherical,stellate-pubescent,subentire,tapering,terminal,tip,tree,truncate,upper,way,wide,yellow,yellow-green,young	
156	wfo-0001027548	success	216	99	62	80	136	19	60	2	0.3-1.2,0.5-2,1-1.5,1.5-2,10-12,4.5,6-9,acuminate,acute,almost,anther,apex,attenuate,base,berry,black,brown,c.,calyx,capitate,cm,conical,corolla,dark,densely,depressed-elliptic,diameter,ellipsoid,elliptic,entire,exserted,filament,flattened-reniform,flexuous,fruiting,glabrous,globose,green,growth,immature,inflorescence,leaf,like,lilac,lobed,loosely,margin,membranous,minute,minutely,mm,narrowly,new,pedicel,peduncle,per,petiole,pitted,puberulent,pubescent,revolute,ripe,simple,size,slender,sparsely,stem,stigma,strongly,style,surface,terminal,tinged,tube,type,vine,warty,way,white,x	-11.5,.3,0.2,0.5,1,1-10,1-2.5,1-3.5,1.2,1.5,1.5-2.5,10-50,3-7,4-6,4-8,5-merou,7-10,8-9,abaxiall,adaxially,ag,along,also,although,alyx,anthesi,apart,apical,apparently,appearing,area,ark,articulated,articulation,axi,basal,beneath,bent,branch,branched,branching,bu,cell,connivent,darker,deflexe,deltate,dendritic,denser,drying,dull,eaf,early,eed,elongate,em,extending,flower,free,geminat,glabrescen,glandular,half,herbarium,ilament,irregularly,lamina,leaving,lengthening,less,lobe,lon,long,long-styled,loose,lower,many,matte,mixed,near,nflorescence,occasionally,older,orolla,outline,pair,pale,papillae,papillate,papillo,perfect,pericarp,planar,plurifoliate,point,pore,poricidal,portion,primary,prominent,rachi,rectangular,reddish,ruit,scar,scattered,slit,small,sometimes,somewhat,spaced,sparse,specimen,spreading,stellate,swollen,tapering,testal,thickened,thin,time,tiny,tip,transparent,trichome,twinin,ud,uniseriate,unit,upper,usually,vary,vein,woody,yellow,ympodial	1.2-2.5,8,arrangement,bud,characteristic,colour,exertion,form,fruit,glabrousnes,height,length,lobing,number,ovary,plant,seed,shape,texture	0.3-1.2,0.5-2,1-1.5,1.5-2,10-12,4.5,6-9,acuminate,acute,almost,attenuate,base,berry,black,brown,c.,capitate,cm,conical,dark,densely,depressed-elliptic,diameter,ellipsoid,elliptic,entire,exserted,flattened-reniform,flexuous,glabrous,globose,green,immature,like,lilac,lobed,loosely,membranous,minute,minutely,mm,narrowly,per,pitted,puberulent,pubescent,revolute,ripe,simple,slender,sparsely,stem,strongly,terminal,tinged,vine,warty,way,white,x	1.2-2.5,8
157	wfo-0001027581	success	200	119	87	88	112	31	73	14	100+,abaxial,acute,adaxial,along,anther,anthesi,apex,axe,base,berry,branched,broadly,brown,c.,calyx,clavate,cm,corolla,cup-shaped,dark,densely,diameter,echinoid,ellipsoidal,elliptic,entire,evenly,exserted,filament,flattened-reniform,flower,fruiting,glabrous,globose,golden,gradually,green,greyish,growth,inflorescence,leaf,length,like,lobed,long,many,margin,minute,minutely,mm,moderately,multangulate,multiseriate,narrowing,new,nodding,pedicel,peduncle,petiole,pitted,plane,pubescent,purple,ray,reddish,ripe,scarcely,sessile,shrub,simple,size,small,sparsely,stalk,stellate,stem,stigma,stout,style,surface,terminal,time,tree,trichome,tube,undersurface,way	0.2â0.3,0.3,0.3â1,0.5â1,0.5â1.5,1,1.2â1.5,1.3â1.5,1.5,1.5â2,1.5â3,10,10â16,12,12â30,15â20,1â1.5,1â3-rayed,2.5â3,200,3.5â4.5,3â3.5,4.5â16,4â8,5-merou,6â7,7â10,7â9,8,8â10,9â11,9â9.5,>,abaxially,ag,alyx,apar,ark,articulated,beneath,branching,brow,bulbous,clearly,closely,connivent,deltate,dichasia,discolorous,distally,drying,eaf,eed,erec,free,glabrescent,ilament,lamina,largest,lengthening,less,lobe,longest,loosely,lower,midvei,mixed,near,nflorescence,older,orolla,pair,papillo,part,per,perfect,pericarp,plurifoliate,pore,poricidal,porrect-stellate,portion,primary,reflexed,rhachi,ruit,scar,shiny,short-stalked,slit,smaller,spaced,spreading,tall,tem,thin,tip,ud,unevenly,unit,upper,vary,varying,vein,visible,weak,whit,wide,woody,yellow,yellowish,ympodial	0.5-1,0.5-1.5,1-1.5,1-3-rayed,1.2-1.5,1.3-1.5,1.5-3,15-20,2.5-3,4-8,7-10,7-9,9-9.5,arrangement,bark,bud,characteristic,colour,exertion,form,fruit,glabrousnes,height,lobing,ovary,plant,seed,shape,texture,type,white	100+,acute,along,anthesi,axe,base,berry,branched,broadly,brown,c.,calyx,clavate,cm,cup-shaped,dark,densely,diameter,echinoid,ellipsoidal,elliptic,entire,evenly,exserted,flattened-reniform,flower,glabrous,globose,golden,gradually,green,greyish,inflorescence,leaf,length,like,lobed,long,many,minute,minutely,mm,moderately,multangulate,multiseriate,narrowing,nodding,pedicel,pitted,plane,pubescent,purple,ray,reddish,ripe,scarcely,sessile,shrub,simple,size,small,sparsely,stalk,stellate,stem,stout,terminal,time,tree,trichome,tube,undersurface,way	0.5-1,0.5-1.5,1-1.5,1-3-rayed,1.2-1.5,1.3-1.5,1.5-3,15-20,2.5-3,4-8,7-10,7-9,9-9.5,white
158	wfo-0001027584	success	142	106	72	83	59	23	69	3	..,.5,0.5-1.5-2,0.9-1,0.9-2.5,1-1.2,1.2-1.4,1.5-2,1.6-1.9,10-15,11.5-45,2,2-10,2.5-3,3,3-.,4-6,4-7,4.5-20,7-10-16,abruptly,acuminate,anther,anthesi,apex,attenuate,bark,base,becoming,beneath,branched,calyx,cm,conical,corolla,darker,diameter,ellipsoid,elliptic,filament,flattened,four,fruit,fruiting,glabrous,green,herb,lamina,long,minutely,mm,nearly,ovary,ovate,pair,pale,papillate,pedicel,peduncle,per,petiole,pointed,primary,reddish,reniform,scattered,shrub,small,smooth,sparsely,stem,stigma,stripe,style,suffruticose,surface,tan,time,trichome,uniseriate,vein,white,x	0.5-1,1.5-8,100,8-9,absent,apical,beginning,branch,brittle,broadly,brow,c.,capitat,cell,cucullate,deflexe,deltate,densely,dry,eaf,edicel,eed,erec,flower,irregular,lobe,lobed,lower,margin,markedly,narrowly,nflorescence,open,outer,outline,pericarp,planar,plurifoliat,present,regularly,ruit,scar,single,single-stemmed,sinuate,sparse,striate,testal,thickening,thin,tip,triangular,tube,tuft,ud,unit,wall,without,ympdoial	arrangement,brown,bud,capitate,characteristic,colour,form,growth,height,history,inflorescence,leaf,length,life,lobing,number,plant,plurifoliate,seed,shape,size,texture,type	..,.5,0.5-1.5-2,0.9-1,0.9-2.5,1-1.2,1.2-1.4,1.5-2,1.6-1.9,10-15,11.5-45,2,2-10,2.5-3,3,3-.,4-6,4-7,4.5-20,7-10-16,abruptly,acuminate,anther,anthesi,attenuate,base,becoming,beneath,branched,cm,conical,darker,ellipsoid,elliptic,filament,flattened,four,fruit,glabrous,green,herb,lamina,long,minutely,mm,nearly,ovate,pair,pale,papillate,per,pointed,reddish,reniform,scattered,shrub,small,smooth,sparsely,stripe,suffruticose,surface,tan,time,trichome,uniseriate,vein,white,x	brown,capitate,plurifoliate
159	wfo-0001027600	success	183	104	74	82	101	22	73	1	0.5-1.5,1,1-14,1-4,1-5,1.5-2,10-15-25,10-20,2-11,2-18,2-3,2-4,2-4.5,2-6,2.5-21,20-30,3-15,3-5-lobed,acuminate,acute,adpressed,apex,apical,apiculate,basal,base,calyx,cm,concave,cordate,cuneate,deltate,densely,diameter,ellipsoidal,entire,fading,flattened,flower,forked,fruit,glabrous,gland,greenish-white,leaf,lobe,lobed,margin,mature,minutely,mm,moderately,oblong,obtuse,occasionally,orange,ovoid,pedicel,peduncle,petiole,pilose,pinnately,puberulent,purple,purplish,rachi,rarely,rounded,simple,stigma,style,surface,tip,tree,truncate,two,unbranched,unlobed,white,x,yellow,yellow-green	-10,0.5-1,1-2,1.5-2.5-3,1/2-3/4,2-3.5,2-5,2.5-6,3-5,3-6,4-6,4-foliat,5-13,8-17,abaxially,abruptly,absen,absent,adaxial,adaxially,aggregate,along,apart,ape,articulated,axe,beyond,blade,brow,campanulate,cell,channe,collection,connective,coriaceous,cream,dilated,directed,distally,divided,eaf,eed,elliptic,especially,exceeding,except,exserted,fleshy,glabrescent,glandular-puberulent,laterally,leaving,lon,long,lower,main,midrib,narrowed,nflorescence,nther,obconical,older,orolla,ovate,papillose,pedicellar,perfect,pilo,pore,puberulen,puberulence,pubescent,radiu,remnant,ruit,shorter,sinus,slightly,small,somewhat,spaced,sparsely,stamen,stone,strongly,subcoriaceous,tal,tem,thecae,time,tomento,triangular,tube,ud,unit,vary,vein,wide,yellowish,ympodial,young	anther,arrangement,bud,characteristic,colour,corolla,form,growth,height,history,inflorescence,length,life,ovary,perennial,plant,seed,shape,size,stem,texture,type	0.5-1.5,1,1-14,1-4,1-5,1.5-2,10-15-25,10-20,2-11,2-18,2-3,2-4,2-4.5,2-6,2.5-21,20-30,3-15,3-5-lobed,acuminate,acute,adpressed,apex,apical,apiculate,basal,base,cm,concave,cordate,cuneate,deltate,densely,diameter,ellipsoidal,entire,fading,flattened,flower,forked,fruit,glabrous,gland,greenish-white,lobe,lobed,mature,minutely,mm,moderately,oblong,obtuse,occasionally,orange,ovoid,pilose,pinnately,puberulent,purple,purplish,rarely,rounded,simple,style,tip,tree,truncate,two,unbranched,unlobed,white,x,yellow,yellow-green	perennial
160	wfo-0001027607	success	167	119	91	101	66	18	91	0	.1,.5,0.25-0.5,0.5,0.8-1,1-4,1.2-1.5,1.5-3,2-2.5,2-3,2-4,2.5-3,3-3.5,3/4,4-10-flowered,5-10,8-9,acuminate,acute,anther,anthesi,apex,arching,area,aspect,bark,basal,base,berry,branch,brown,calyx,cm,corolla,curling,dark,decurrent,deltoid,densely,dia,dry,elliptic,erect,exserted,f,filiform,flattened,fruiting,gently,giving,glabrous,globose,golden,green,leaf,less,like,lobe,long,material,minute,minutely,mm,narrowly,occasionally,older,ovary,ovoid-reniform,pagoda-like,papillose,pedicel,petiole,pitted,plant,pubescent,reddish-brown,reflexed,shaped,shrub,simple,slender,soon,stem,stigma,strongly,style,surface,tan,tapering,tear-drop,tip,trichome,tube,unifoliate,uniseriate,way,white,widened,winged,x,zig-zag	.25,0.5-1,1,5-7,age,apar,ba,becoming,branche,corky,deflexed,eaf,edicel,eed,ellipsoid,elongate,evenly,except,filament,free,geminate,glabrate,lamina,lateral,lenticellat,lobed,lon,lower,m.,main,middle,midrib,narrow,nflorescence,non-reproductive,obovoid,opposite,pair,pore,poricidal,portion,present,prominent,raised,rarely,ruit,scar,short,slight,slightly,small,spaced,straight,styl,tall,treelet,tub,ud,unit,vein,widening,widest,woody,yellowish,ympodial,young	arrangement,characteristic,colour,diameter,exertion,form,fruit,growth,height,inflorescence,length,lobing,margin,seed,shape,size,texture,type	.1,.5,0.25-0.5,0.5,0.8-1,1-4,1.2-1.5,1.5-3,2-2.5,2-3,2-4,2.5-3,3-3.5,3/4,4-10-flowered,5-10,8-9,acuminate,acute,anthesi,arching,area,aspect,basal,base,berry,branch,brown,calyx,cm,curling,dark,decurrent,deltoid,densely,dia,dry,elliptic,erect,exserted,f,filiform,flattened,gently,giving,glabrous,globose,golden,green,less,like,lobe,long,material,minute,minutely,mm,narrowly,occasionally,older,ovoid-reniform,pagoda-like,papillose,petiole,pitted,plant,pubescent,reddish-brown,reflexed,shaped,shrub,simple,slender,soon,stem,strongly,style,tan,tapering,tear-drop,tip,trichome,tube,unifoliate,uniseriate,way,white,widened,winged,x,zig-zag	
161	wfo-0001027618	success	201	125	89	98	103	27	86	3	-pubescent,0.5,0.5-1,1,1-1.5,1-13,1-14,1-23,1-3,1-5,11-16,11-pinnate,15-35,2-12,2-27,2-5,2.5-6,3-30,3-5,3-7-pinnate,3.5-6,4,4-8,5-20,5-30,5-7.5,5.5-12,6-40,8-16,8-35,also,apart,apex,basal,base,branched,bud,campanulate,capitate,cm,compound,connective,cordate,cuneate,densely,dia,diameter,ellipsoidal,elliptic-ovate,entire,flower,fruit,fusiform,glabrous,globose,greenish,leaf,length,less,lobe,long,margin,minutely,mm,oblong,obtuse,orange,ovate,pedicel,peduncle,per,pilose,pinnately,puberulent,puberulent-pubescent,pubescent-pilose,purple,rachi,reticulate,ripe,shallowly,shrub,simple,sometimes,sparsely,stigma,style,sympodial,tree,truncate,tube,unbranched,unit,urceolate,white,wide,x,yellow	-10,0-10,0.5-6,1-2-8.5,1-9,1.4-4,1.5-13,1.5-3,1.5-7,1.5-8.5,11-22,12-27,15-30,2-11,2-11.5,2-9,3-18,3-7,5-18,5-merous,6-25,7-25,abaxially,acuminat,acut,acute,adaxially,aggregate,alyx,ape,articulated,ascending,axe,beyond,blade,cell,chartaceous,cylindrical,darker,deltate,diamete,dilated,directed,distally,eaf,eed,elliptic,exceeding,exserted,fleshy,lateral,laterally,leaflet,leaving,lon,longitudinal,lower,membranaceous,mesocarp,moderately,near,nflorescence,nther,obovate,obtu,often,orolla,papillose,pedicellar,perfec,perfect,petiole,petiolule,pilo,pore,presen,puberulent-pilo,pubescent,radiu,ranch,ratio,remnant,rown,ruit,runk,shorter,slightly,small,somewhat,spaced,spreading,stamen,stone,stripe,tal,terminal,thecae,tomentose,triangular,uni,vary,width,without	2-8.5,abaxial,acuminate,adaxial,anther,arrangement,branch,characteristic,colour,corolla,crown,form,glabrousnes,growth,height,history,inflorescence,life,ovary,perennial,plant,seed,shape,size,spacing,texture,trunk	-pubescent,0.5,0.5-1,1,1-1.5,1-13,1-14,1-23,1-3,1-5,11-16,11-pinnate,15-35,2-12,2-27,2-5,2.5-6,3-30,3-5,3-7-pinnate,3.5-6,4,4-8,5-20,5-30,5-7.5,5.5-12,6-40,8-16,8-35,also,apart,apex,basal,branched,campanulate,capitate,cm,compound,cordate,cuneate,densely,dia,diameter,ellipsoidal,elliptic-ovate,entire,flower,fruit,fusiform,glabrous,globose,greenish,less,lobe,long,minutely,mm,oblong,obtuse,orange,ovate,per,pilose,pinnately,puberulent,puberulent-pubescent,pubescent-pilose,purple,reticulate,ripe,shallowly,shrub,simple,sometimes,sparsely,sympodial,tree,truncate,unbranched,unit,urceolate,white,wide,x,yellow	2-8.5,acuminate,perennial
162	wfo-0001027622	success	203	121	87	102	101	19	85	2	.5,0-14,0-16,0.3-10,1,1-2,1.5-3.5,1.5-4.2,1.6-4.5,12-23,2-25,2-6,2.5-3.5,3-4,3-4.5,3.5-11,4-9.5,5-11,6-17,6-7,8-16,abaxially,adaxially,anther,berry,blue,blue-purple,brownish,cell,chartaceous,clavate,cm,condition,connivent,corolla,covering,diameter,drying,filament,flower,fresh,fruit,glabrescent,glabrous,globose,green,green-white,greenish,hair,hair-like,herb,homostylous,interjected,lanceolate,lateral,leaflet,light,like,lobe,long,make,membranous,middle,mm,mottled,mucilaginous,odd-pinnate,ovoid,pale,pedicel,peduncle,pentagonal,petal,petiole,plant,poricidal,pubescent,purple,seed,size,slightly,star,stellate,stem,stigma,striped,style,subglabrous,terminal,testal,thick,throughout,tip,tube,unwinged,wall,wet,whitish,wide,wing,x,yellow	1-10,1/,2-3,3-16,4-5,5-merou,8-20,acumen,acuminate,acute,ag,along,alyx,apart,apex,apparently,articulated,axe,axillary,base,blade,borne,broadly,bud,capitat,ciliate,decumben,different,digestion,distal,dorsally,eaf,edge,eed,elliptic,elliptical,end,enzyme,erect,especially,exceeding,except,flat,folded,forked,geminat,generally,glabrou,greatly,half,honeycomb-shaped,lengthening,living,lower,margin,midrib,minutely,narrowly,nflorescence,oblique,often,orolla,ovate,ovate-lanceolate,pair,perfect,petiolule,plurifoliate,population,pore,proximal,puberulent,reduced,removed,rounded,ruit,seudostipule,shortly,singly,slit,sometimes,spaced,specimen,stamen,ste,stolo,straight,subequal,subtending,tall,tamen,tem,tri-,truncate,tuber,typically,unit,usually,vary,varying,ympodial	5-merous,arrangement,calyx,capitate,colour,form,growth,height,history,inflorescence,leaf,length,life,ovary,pseudostipule,shape,surface,texture,type	.5,0-14,0-16,0.3-10,1,1-2,1.5-3.5,1.5-4.2,1.6-4.5,12-23,2-25,2-6,2.5-3.5,3-4,3-4.5,3.5-11,4-9.5,5-11,6-17,6-7,8-16,abaxially,adaxially,berry,blue,blue-purple,brownish,cell,chartaceous,clavate,cm,condition,connivent,covering,diameter,drying,fresh,glabrescent,glabrous,globose,green,green-white,greenish,hair,hair-like,herb,homostylous,lanceolate,lateral,light,like,long,make,membranous,middle,mm,mottled,mucilaginous,odd-pinnate,ovoid,pale,pentagonal,petal,poricidal,pubescent,purple,seed,slightly,star,stellate,stem,striped,subglabrous,testal,thick,throughout,tip,unwinged,wall,wet,whitish,wide,wing,x,yellow	5-merous,capitate
163	wfo-0001027624	success	189	117	81	96	93	21	78	3	0-7,0.1-0.9,0.3-1,0.4-3,0.5-1.5,0.8-5.6,1-2,1.1-8.4,1.2-2.6,1.3-2.9,1.5-6.6,2.4-4.8,2.9-12,3-10,3-11,4-15.2,4-7,4-8,5-9,6-18.5,9-41,acumen,anther,berry,blade,brownish,cell,clavate,cm,condition,connivent,corolla,covering,deep,densely,diameter,drying,entirely,erect,filament,flower,fresh,fruit,glabrous,globose,green,green-white,greenish,hair,hair-like,herb,homostylous,interjected,lanceolate,lateral,leaf,leaflet,light,like,long,make,mm,moniliform,mottled,mucilaginous,odd-pinnate,ovoid,pedicel,peduncle,petiole,plant,poricidal,pubescent,purple,seed,short,size,slightly,sometimes,stigma,style,terminal,testal,thick,throughout,tip,tuber,unwinged,usually,wall,wet,white,whitish,wide,x,yellow	0-3,1-3,1-5,2-20,2-5,2-7,3-4,3-5,5-merou,abaxially,acuman,acuminate,acute,adaxially,ag,along,alyx,apart,apex,apparently,arranged,articulated,axe,axillary,base,bead,bud,capitat,considerably,cuneate,decreasing,decumben,decurrent,digestion,distal,dorsally,eaf,edge,eed,elliptic,enzyme,exceeding,flat,folded,forked,geminat,glabrou,half,honeycomb-shaped,larger,leave,lengthening,living,lobe,lower,middl,multiple,necklace,nflorescence,onto,orbicular,orolla,ovate,pair,pentagonal,perfect,plurifoliate,pore,present,rachi,removed,rotate,ruit,sessile,seudostipule,slit,spaced,specimen,stamen,stolon,straight,subtending,tall,tamen,tem,toward,tri-,tube,typically,unit,vary,widely,ympodial	5-merous,abaxial,adaxial,arrangement,calyx,capitate,colour,decumbent,form,growth,height,history,inflorescence,length,life,ovary,pseudostipule,shape,stem,surface,texture	0-7,0.1-0.9,0.3-1,0.4-3,0.5-1.5,0.8-5.6,1-2,1.1-8.4,1.2-2.6,1.3-2.9,1.5-6.6,2.4-4.8,2.9-12,3-10,3-11,4-15.2,4-7,4-8,5-9,6-18.5,9-41,acumen,berry,brownish,cell,clavate,cm,condition,connivent,covering,deep,densely,drying,entirely,erect,fresh,glabrous,globose,green,green-white,greenish,hair,hair-like,herb,homostylous,lanceolate,lateral,leaf,light,like,long,make,mm,moniliform,mottled,mucilaginous,odd-pinnate,ovoid,poricidal,pubescent,purple,seed,short,slightly,sometimes,testal,thick,throughout,tip,unwinged,usually,wall,wet,white,whitish,wide,x,yellow	5-merous,capitate,decumbent
164	wfo-0001027626	success	152	103	66	79	73	24	65	1	.3,.5,0.2â0.6,0.5-1,0.7â1,1,1.5â2,13â14,14â116,2â49,2â5,3â4,3â4.5,4â6,5â6,8,9â18,acuminate,acute,adaxially,anther,apex,arrangement,base,berry,calyx,chartaceous,cm,cordate,coriaceous,diameter,distant,distichous,elliptical,entire,extra-axillary,filament,fleshy,flower,fruit,glabrous,greenish-white,lamina,lanceolate,leaf-opposed,liana,margin,membranous,minutely,mm,moderately,nearly,oblique,ovate,pedicel,peduncle,petiole,pinnate,possibly,pubescent,rachi,sand-punctate,shrub,side,slender,somewhat,sparsely,spindle-shaped,stellate,stigma,style,terminal,tip,unbranched,unknown,venation,white,wiry-woody,x	0.1â0.2,0.5â1,0.7â2.8,1.3â4.5,1.5â8,2â3,3â5,3â55,4.4â11,5-merous,abaxially,accrescen,along,alyx,apar,axe,blade,broadly,c.,capitat,center,ciliat,clavate,climbing,color,densely,distinct,eaf,eed,frequently,fruiting,glabrou,immature,line,lobe,long,lower,m.,maturity,midvein,mor,nflorescence,nternode,orolla,pair,perfec,petal,plurifoliat,pointed,reflexed,rounded,ruit,sand-punctat,scandent,scar,secondary,seen,shortly,simple,spaced,ste,tamen,tem,time,trichome,truncate,tube,two,unit,vary,vein,wide,ympodial	abaxial,adaxial,capitate,characteristic,colour,corolla,form,growth,height,inflorescence,leaf,length,lobing,number,ovary,plant,seed,shape,size,staman,stem,surface,texture,type	.3,.5,0.2â0.6,0.5-1,0.7â1,1,1.5â2,13â14,14â116,2â49,2â5,3â4,3â4.5,4â6,5â6,8,9â18,acuminate,acute,adaxially,berry,chartaceous,cm,cordate,coriaceous,distant,distichous,elliptical,entire,extra-axillary,fleshy,flower,fruit,glabrous,greenish-white,lamina,lanceolate,leaf-opposed,liana,membranous,minutely,mm,moderately,nearly,oblique,ovate,petiole,pinnate,possibly,pubescent,sand-punctate,shrub,side,slender,somewhat,sparsely,spindle-shaped,stellate,terminal,tip,unbranched,unknown,white,wiry-woody,x	capitate
165	wfo-0001027630	success	149	114	64	83	66	31	56	8	0.5-1,0.5-1.2,0.5-2,1-1.5,1-5,1.4-1.7,1.5-2,2-3,3/4,4-6,5.5-11.2,6-10,8-9,acute,anther,anthesi,apex,bark,base,berry,blunt,broadly,calyx,ciliate,climbing,cm,corolla,deflexed,deltoid,densely,erose,filament,fruit,fruiting,glabrate,glabrous,globose,golden,green,hirsute,lanceolate,lateral,leaf,linear,lobe,long-acuminate,main,margin,midrib,minutely,mm,ovary,pair,papillose,partially,pedicel,petiole,prominent,puberulent,pubescent,reflexed,rounded,scar,shaped,shrub,simple,slender,sparsely,stem,stigma,straight,style,tapering,tear-drop,tip,trichome,tube,vein,way,white,winged,yellowish,young	.1,.2,.5,0.05-0.1,2-6-flowered,also,apart,arising,beginning,branchlet,de,decurrent,dia,distinguishable,eaf,edicel,eed,elongat,except,extreme,free,globo,immature,indistinct,inflorescenc,internodal,irregularly,knob-like,known,lobed,lon,long,lower,middle,near,nflorescence,novo,occasionally,older,opposite,paler,pore,poricidal,portion,proximal,raised,rest,ruit,seen,spaced,strongly,swollen,tall,terminal,thickened,ti,ud,ultimate,unifoliat,uniseriate,unit,wide,widest,wing,x,ympodial	0.1,0.5,1,2-6,4,bud,characteristic,colour,diameter,elongate,flower,form,growth,height,inflorescence,length,lobing,na,number,plant,point,prominence,seed,shape,size,spacing,starting,surface,texture,type,width	0.5-1,0.5-1.2,0.5-2,1-1.5,1-5,1.4-1.7,1.5-2,2-3,3/4,4-6,5.5-11.2,6-10,8-9,acute,base,berry,blunt,broadly,ciliate,climbing,cm,deflexed,deltoid,densely,erose,glabrate,glabrous,globose,golden,green,hirsute,lanceolate,linear,long-acuminate,minutely,mm,pair,papillose,partially,prominent,puberulent,pubescent,reflexed,rounded,shaped,shrub,simple,slender,sparsely,straight,tapering,tear-drop,way,white,winged,yellowish	0.1,0.5,1,2-6,4,elongate,inflorescence,na
166	wfo-0001027661	success	220	169	135	149	71	20	134	1	+,0.5,0.5-1-7,0.5-2,0.6-1.1,0.6-1.5,1-4-15,1.2-6,1.3,1.5,1.5-2,2,2.5-7,4-8-celled,4.5-6,40,5-9,6-12,6-9,8-10,acuminate,acute,along,anther,anthesi,apex,basal,base,berry,branch,branched,bright,calyx,capitate,cell,cm,column,commonly,connivent,cordate,corolla,creeping,deeply,dendritic,densely,denser,diameter,ellipsoid,entire,even,extremely,filament,flattened,flower,fruiting,fused,glabrous,globose,green,grey,growth,herbaceous,hue,lamina,lateral,leaf,leaf-opposed,like,lobe,lobed,long,long-exserted,lower,many,margin,membraneous,minute,minutely,mixture,mm,moderately,narrowing,near,new,often,open,pair,pale,pedicel,peduncle,pentagonal,petiole,pinnatifid,pitted,poricidal,primary,pubescence,pubescent,purple,purplish,rachi,rarely,red,reniform,ripe,shape,short,simple,single,sinus,size,slender,sparsely,spreading,stellate,stem,stigma,style,surface,tan,tangled,terminal,ternately,testa,tightly,time,tip,trailing,trichome,truncate,tube,turbinate,two,type,underground,uniseriate,upper,usually,variable,vein,vine,violet,way,white,wide,woody,yellow,yellowish,Â¾	-10,1-1.5,1-5,2.5-3,30,5-merou,6-8,<,>,abaxially,adaxiall,ag,alyx,apart,ark,articulate,axi,broadly,conical,density,eaf,eed,elliptic,free,gre,ground,ilament,irregularly,leaving,lengthening,markedly,nflorescence,occasionally,older,orolla,outline,ovate,papillat,papillate,papillo,peg,per,perfect,pericarp,plurifoliat,pointed,pore,portion,prominent,pubescen,reflexed,ruit,scar,shiny,sleeve,slit,small,spaced,spot,spreadin,strongly,swollen,tem,thin,triangular,ud,unieriate,unit,vary,ympodial,zig-za	arrangement,bark,bud,characteristic,colour,exertion,form,fruit,glabrousnes,height,history,inflorescence,length,life,lobing,ovary,papillose,plant,seed,texture	+,0.5,0.5-1-7,0.5-2,0.6-1.1,0.6-1.5,1-4-15,1.2-6,1.3,1.5,1.5-2,2,2.5-7,4-8-celled,4.5-6,40,5-9,6-12,6-9,8-10,acuminate,acute,along,anthesi,basal,base,berry,branch,branched,bright,calyx,capitate,cell,cm,column,commonly,connivent,cordate,creeping,deeply,dendritic,densely,denser,diameter,ellipsoid,entire,even,extremely,flattened,flower,fused,glabrous,globose,green,grey,herbaceous,hue,lamina,lateral,leaf,leaf-opposed,like,lobe,lobed,long,long-exserted,lower,many,membraneous,minute,minutely,mixture,mm,moderately,narrowing,near,often,open,pair,pale,pentagonal,pinnatifid,pitted,poricidal,pubescent,purple,purplish,rachi,rarely,red,reniform,ripe,shape,short,simple,single,sinus,size,slender,sparsely,spreading,stellate,stem,surface,tan,tangled,terminal,ternately,testa,tightly,time,tip,trailing,trichome,truncate,tube,turbinate,two,type,underground,uniseriate,upper,usually,variable,vein,vine,violet,way,white,wide,woody,yellow,yellowish,Â¾	papillose
167	wfo-0001027714	success	248	107	69	93	155	14	69	0	.5,/3,1-1.6,1-2,1-2-8,1.5-2.5,1.5-3,1.5-5,14-16,2-2.5,2-2.5-4,2.5-4-10,4-5,5,5-6,6-7,acuminate,acute,almost,anther,apex,basal,base,berry,bright,brown,capitate,cm,cordate,corolla,deep,densely,diameter,drying,ellipsoid,elliptic,entire,exserted,filament,flattened,fruit,fruiting,glabrous,globose,growth,hairy,inflated,inflorescence,juicy,lateral,leaf,lobe,margin,minutely,mm,new,obovate,occasionally,ovary,pair,pale,papillate,pedicel,peduncle,petiole,pitted,primary,pubescent,purple,red,reddish,reniform,seed,shiny,simple,slender,small,somewhat,sparsely,stem,stigma,strongly,style,surface,terminal,truncate,tube,vein,vine,violet,way,x,yellowish	+,0,0.4,0.5,0.5-0.7,0.6-0.7,0.9-1.5,1,1-1.5,1.5-2,2373.,3-3.5,4.5-5,5-10,5-merou,7-20,80,<,abaxial,abaxially,adaxial,adaxially,age,aid,along,alyx,angle,anthesi,apar,apice,appearance,ark,around,articulated,axi,branched,calyx,canop,cell,channelled,climbin,confined,conical,connected,connivent,corky,creating,cucullate,cupped,deflexed,dendritic,denser,eaf,eed,elongate,enlarged,especially,fide,fleshy,flower,free,furcate,giving,glabrate,glabrou,groove,hanging,ilament,immature,individual,irregularly,lamina,large,leaving,lengthening,like,lobed,lon,long,longer,loosely,lower,many,marginal,mature,mere,minute,mpodial,nee,nflorescence,nodding,often,older,orolla,otherwise,outline,papillo,peg,per,perfect,pericarp,petal,petiolule,pinnatifid,plat,plurifoliat,pore,poricidal,portion,prominent,pubescence,reaching,rectangular,rim,ripe,ruit,scar,showy,similar,sleeve,slightly,slit,spaced,spreading,stellate-rotate,tangled,tem,testa,testal,thecae,thick,thickened,thin,third,time,tiny,tip,tooth,trichome,twining,ud,uniformly,uniseriate,unit,upper,usually,visible,wall,weak,weight,widest,wing,woody,yellow,younger	arrangement,bark,bud,characteristic,colour,exertion,form,glabrousnes,length,lobing,shape,size,texture,type	.5,/3,1-1.6,1-2,1-2-8,1.5-2.5,1.5-3,1.5-5,14-16,2-2.5,2-2.5-4,2.5-4-10,4-5,5,5-6,6-7,acuminate,acute,almost,basal,base,berry,bright,brown,capitate,cm,cordate,deep,densely,diameter,ellipsoid,elliptic,entire,exserted,flattened,glabrous,globose,hairy,inflated,juicy,lateral,lobe,minutely,mm,obovate,occasionally,pair,pale,papillate,pitted,pubescent,purple,red,reddish,reniform,shiny,simple,slender,small,somewhat,sparsely,strongly,terminal,truncate,vine,violet,way,x,yellowish	
168	wfo-0001027720	success	184	87	51	64	120	23	50	1	0.25-0.35,0.5-0.8,0.8-1,1-1.5,1-2,1-3.5,15-25,2-3,2-4,2-branched,4-7,7-8,8-16,acute,anther,apex,berry,brown,calyx,chartaceous,cm,deltate,diameter,distally,elliptic,entire,extra-axillary,filament,flower,fruit,glabrous,globose,green,inflorescence,lanceolate,leaf,length,lilac,long,margin,markedly,mm,narrowly,ovate,pale,pedicel,peduncle,perennial,petiole,pubescent,red,shrub,simple,sparsely,stellae,stellate,stigma,style,subreniform,surface,thicker,triangular,white,yellow	%,.25-0.3,0,0-15,0.15-0.25,0.3-5,0.4-0.7,0.4-0.8,0.5-1,0.6-1.2,1-locular,1.5-2,13-23,13-35,2-7,2-foliate,2.8-3.1,23-35,3-13,4-,4-5.5,4.3-15,4.3-7.5,5-merous,6,7-10,7-9,8-11,9-15,abaxially,absen,absent,adaxiall,adaxially,adult,alyx,apparently,articulated,axe,ba,base,blade,capitat,confined,connivent,cuneate,cylindrical,densely,directed,distall,eaf,eed,eglandular,erect,finger,flattened,fruiting,geminat,gland-tipped,hair,half,hig,homostylous,incomplete,intepetalar,juicy,juvenile,lamina,lateral,less,lobe,loosely,lower,mature,mesocarp,mid-point,midpoint,midrib,minute,nflorescence,notched,oblique,orolla,part,per,perfec,perfect,pore,porrect,present,prickle,rachi,ray,rhizomatous,ruit,scarce,septum,sessile,short,slightly,stellate-pubescent,straight,succulen,tamen,tem,thick,time,tissue,toward,tube,unarme,unarmed,unit,upper,vary,wide,without,x,yellowi,ympodial	abaxial,adaxial,arrangement,capitate,characteristic,colour,corolla,form,glabrousnes,growth,height,history,life,lobing,new,ovary,plant,seed,shape,size,stem,texture,type	0.25-0.35,0.5-0.8,0.8-1,1-1.5,1-2,1-3.5,15-25,2-3,2-4,2-branched,4-7,7-8,8-16,acute,berry,brown,chartaceous,cm,deltate,diameter,distally,elliptic,entire,extra-axillary,flower,fruit,glabrous,globose,green,lanceolate,lilac,long,markedly,mm,narrowly,ovate,pale,perennial,pubescent,red,shrub,simple,sparsely,stellae,stellate,subreniform,thicker,triangular,white,yellow	capitate
169	wfo-0001027720	success	272	156	123	133	139	23	119	4	.2,0,1.5â3.3,1.5â9.0,1.7â2.5,1.8â2.0,1/3,2.0,2.5â2.8,2â3,3.2,3.6,4.0â12.6,5.1â18.6,6.5â9.5,6â8,8.0â11.9,acuminate,acute,aequilateral,anther,apex,apical,apparently,appearing,attachment,attenuate,base,berry,bilobed,branch,broad,broad-based,calyx,cancellate,capitate,channel,cm,concave,conical,connivent,corolla,cream,crisped,curved,deciduous,developed,diameter,dry,elliptic,entire,erect,especially,extra-axillary,fertile,flattened-irregular,flattened-orbicular,flattened-reniform,flower,fruit,glabrous,glandular,globose,growth,hair,heavily,internode,interpetalar,juvenile,lateral,lavender,leaf,long,margin,mature,midpoint,minute,mm,narrowly,notched,oblique,often,orange,ovate,pedicel,peduncle,petiole,point,poorly,pore,porrect,portion,potentially,prickle,ray,red,scattered,sessile,short,shorter,shrub,side,simple,slightly,small,soon,stellae,stellate,stem,stigma,straight,style,subacute,subcoriaceous,surface,tall,tissue,tree,triangular,twice-branched,unarmed,upper,violet,wavy,white,wide,yellow,yellow-ferruginous,yellow-tan,young,Â±equal,Ã,â4	.0,.04,.3,.5,.9,0.1â0.6,0.2â0.4,0.3â0.4,0.7â0.9,0.7â1.1,0.7â1.2,0.8â1.3,0.8â1.9,0.8â2.0,0.9,1.4â1.9,1.5â1.7,1.5â2.0,1.5â2.5,1.7â1.8,1.7â2.0,1.9â2.2,1/2,1/3â1/2,10.0,10.8â18.2,12â16,13.0,19.7â30.0,2.5,2.5â2.9,3.7â5.7,3.9,4.0â18.0,4â5-merou,8.0,8.2â10.5,8.5â9.4,9.5â16.0,abaxially,adaxially,adnate,alyx,anthesi,apiculate,armed,articulated,axe,ba,becoming,blade,brochidodromous,bud,channeled,colore,congested,dehiscence,densely,dentate,difoliate,distally,dorsally,eaf,eed,either,emerging,endocarp,exocarp,filament,filiform,free,geminat,glossy,gradually,homostylous,hooked,inclined,increasing,intersepalar,juic,lamina,large,least,like,line,lobe,lon,longer,lower,m.,major,midrib,midvein,minor,moderately,nearly,nflorescence,oblong,occasionally,orolla,part,per,perforate,porrect-stellate,presumably,proximal,pubescent,raised,reflexed,rigid,rip,row,ruit,sinus,sparsely,splitting,spread,stamen,stellate-pubescen,stellate-pubescent,suture,tamen,tem,thin,time,tip,toward,translucent,truncate,tube,two,ud,vary,vein,way,weakly,yellow-ferruginou,ympodia,youngest	abaxial,adaxial,arrangement,characteristic,colored,colour,exertion,form,green,greyish,height,hirsute,history,inflorescence,length,life,ovary,plant,seed,shape,size,texture,type	.2,0,1.5â3.3,1.5â9.0,1.7â2.5,1.8â2.0,1/3,2.0,2.5â2.8,2â3,3.2,3.6,4.0â12.6,5.1â18.6,6.5â9.5,6â8,8.0â11.9,acuminate,acute,aequilateral,apical,apparently,appearing,attachment,attenuate,base,berry,bilobed,broad,broad-based,cancellate,capitate,channel,cm,concave,conical,connivent,cream,crisped,curved,deciduous,developed,diameter,dry,elliptic,entire,erect,especially,extra-axillary,fertile,flattened-irregular,flattened-orbicular,flattened-reniform,flower,fruit,glabrous,glandular,globose,growth,hair,heavily,internode,interpetalar,juvenile,lateral,lavender,long,mature,midpoint,minute,mm,narrowly,notched,oblique,often,orange,ovate,point,poorly,pore,porrect,portion,potentially,prickle,ray,red,scattered,sessile,short,shorter,shrub,side,simple,slightly,small,soon,stellae,stellate,straight,subacute,subcoriaceous,tall,tissue,tree,triangular,twice-branched,unarmed,upper,violet,wavy,white,wide,yellow,yellow-ferruginous,yellow-tan,young,Â±equal,Ã,â4	colored,green,greyish,hirsute
170	wfo-0001027757	success	186	96	64	63	123	33	50	14	0.5,abaxially,anther,anthesi,axillary,base,blue,borne,brown,calyx,clavate,cm,colour,dark,decurrent,deeply,diameter,elliptic,erect,filament,flattened,fruit,glabrous,globose,hair,irregularly,lanceolate,leaf,leafy,lilac,lobed,long,margin,mm,moderately,multicellular,narrowly,oblong,occasionally,often,ovate,pale,pedicel,peduncle,perennial,petiole,pitted,pubescent,regularly,shoot,shrub,simple,sparsely,stigma,style,surface,unicellular,uniseriate,unknown,violet,white,woody,x	0.2,0.2â0.3,0.3â2.0,0.6,0.6â1.0,0.7,0â1.4,1.0â1.1,1.0â2.5,1.2â4.0,1.5â1.6,1.5â2.5,1.6â2.4,1.9â2.7,12,1â1.5,1â11,1â2,1â3,2,2.5,2.5â4,2.5â5.5,2.5â7,2â,2â10,3â12,3â5,4â9,5,5â,60â100,6â9,7â8,8â16,absen,accrescent,acute,adaxiall,adaxially,ag,along,apart,apex,apical,arising,articulated,axe,ba,basal,blade,branching,campanulate,cell,chartaceous,concave,connivent,convex,cylindrical,densely,directed,distally,eaf,eed,entire,equal,erose,fleshy,flower,geminat,glabrescen,glabrou,lobe,lon,longitudinal,lower,m.,nflorescence,obtuse,opening,opposed,orolla,pair,perfect,plurifoliate,pore,poricidal,primary,probably,rootstock,rotate,ruit,secondary,serrate,side,slit,smaller,sometimes,spaced,stone,straight,tall,tamen,tem,thic,thickened,time,tip,toward,tube,unbranched,unit,vary,wide,yellow,ympodial,â19,â2.7,â3.2,â4.0,â5.5,â6,â9	0-1.4,0.2-0.3,1.0-1.1,1.5-1.6,1.5-2.5,19,2-10,2.5-4,3.2,4-9,6,6-9,60-100,8-16,arrangement,characteristic,corolla,form,growth,height,history,inflorescence,length,life,lobing,ovary,plant,seed,shape,size,stem,texture,type	0.5,abaxially,anthesi,axillary,blue,borne,brown,clavate,cm,dark,decurrent,deeply,diameter,elliptic,erect,flattened,fruit,glabrous,globose,hair,irregularly,lanceolate,leafy,lilac,lobed,long,mm,moderately,multicellular,narrowly,oblong,occasionally,often,ovate,pale,perennial,pitted,pubescent,regularly,shoot,shrub,simple,sparsely,unicellular,uniseriate,unknown,violet,white,woody,x	0-1.4,0.2-0.3,1.0-1.1,1.5-1.6,1.5-2.5,19,2-10,2.5-4,3.2,4-9,6,6-9,60-100,8-16
171	wfo-0001027765	success	163	108	76	86	77	22	73	3	0.8,1,1-10,1-11.5,1-2,1-4,1-5,1.5-6,10-13,2-2.5,2-3,2-4,2.5-4,2.5-4.2,20-30-44,3-12,3-5-15-30,5-6,5-8,7-20,acumen,apical,apically,apiculate,branched,calyx,cell,cm,connate,corolla,covering,dehiscent,diameter,dichasially,elliptic,exceeding,filament,forked,glandular,globose,green,hair,hair-like,herbaceous,interjected,introrse,lateral,leaf,leaflet,light,lobe,long,make,maturing,mm,mucilaginous,odd-pinnate,often,ovoid,pedicel,peduncle,perennial,petiole,pilose,plant,poricidally,seed,short,simple,size,slit,stamen,stellate,stigma,straight,style,terminal,testal,thick,throughout,tone,violet,wall,white,wide,yellow	0-.,1-2-3-4,3-20,3-6-foliat,5,abaxial,abaxially,abruptly,acuminate,acute,apex,articulate,base,cordate,cuneate,cyme,dichasial,digestion,diminishing,distal,dorsally,eaf,ebracteate,edge,eed,elliptic-lanceolate,emoval,enzyme,flat,flower,folded,generally,globo,green-white,half,honeycomb,living,lon,lower,lunat,monochasial,nflorescence,nther,oblique,obtuse,orolla,ovate,ovate-elliptic,ovate-lanceolate,pair,pattern,perfect,petiolate,petiolule,plan,proximal,reveal,rounded,ruit,sessile,seudostipule,side,slightly,specimen,tal,tem,throughou,tip,toward,truncate,tuber-bearing,typically,unit,vary,without,ympodial,Â¼	0-2,anther,arrangement,branching,colour,form,fruit,growth,height,history,inflorescence,length,life,lunate,ovary,pseudostipule,shape,stem,surface,texture,wet,width	0.8,1,1-10,1-11.5,1-2,1-4,1-5,1.5-6,10-13,2-2.5,2-3,2-4,2.5-4,2.5-4.2,20-30-44,3-12,3-5-15-30,5-6,5-8,7-20,acumen,apical,apically,apiculate,branched,cell,cm,connate,covering,dehiscent,diameter,dichasially,elliptic,exceeding,forked,glandular,globose,green,hair-like,herbaceous,introrse,lateral,light,lobe,long,make,maturing,mm,mucilaginous,odd-pinnate,often,ovoid,perennial,pilose,poricidally,seed,short,simple,slit,stamen,stellate,stigma,straight,style,testal,thick,throughout,tone,violet,wall,white,wide,yellow	0-2,lunate,wet
172	wfo-0001027807	success	116	95	64	78	38	17	64	0	.5,0-0.2,0.1-1,0.2-0.9,0.9-1,1-1.5,15-30,2-5,2-6,acuminate,acute,apex,attenuate,bark,base,berry,brittle,brown,bud,closely,cm,decurrent,deflexed,diameter,dry,drying,elliptic,flattened,flower,fruiting,glabrous,globose,gray,grayish,green,growth,internodal,known,lanceolate,leaf,leaf-opposed,margin,material,maturity,minutely,mm,narrowly,new,occasionally,pair,pale,papillae,papillate,parallel,pedicel,peduncle,petiole,pitted,primary,reddish,reniform,revolute,seemingly,shrub,simple,slender,slightly,small,somewhat,spaced,sparsely,stem,surface,tree,vein,white,winged,yellowish	0.2-0.3,0.3-0.4,0.9-2.5,3.5-9,abaxially,adaxially,almost,barely,deflexe,difoliate,eaf,eed,ellipti,geminat,know,midrib,nflorescence,older,ot,overlapping,paler,plane,prominent,rachi,reddi,reproductive,ruit,scar,shoot,thickened,ud,unifoliate,unit,usually,visible,x,ympodial,young	arrangement,characteristic,colour,form,fruit,glabrousnes,height,history,inflorescence,length,life,plant,seed,shape,size,texture,type	.5,0-0.2,0.1-1,0.2-0.9,0.9-1,1-1.5,15-30,2-5,2-6,acuminate,acute,apex,attenuate,base,berry,brittle,brown,closely,cm,decurrent,deflexed,diameter,dry,elliptic,flattened,flower,glabrous,globose,gray,grayish,green,internodal,known,lanceolate,leaf,leaf-opposed,material,maturity,minutely,mm,narrowly,occasionally,pair,pale,papillate,parallel,pitted,reddish,reniform,revolute,seemingly,shrub,simple,slender,slightly,small,somewhat,spaced,sparsely,surface,tree,white,winged,yellowish	
173	wfo-0001027816	success	187	136	96	112	75	24	94	2	.5,0.5-1,0.5-2,0.6-0.8,0.7-1,1-1.5,1-3,1.2-2,1.8-6,12-14,2-4,2/3,3-3.5,3.5-4,4-5,5-30,6-9,acuminate,acute,anther,anthesi,apex,attenuate,base,becoming,berry,bluish,branched,brown,calyx,capitate,cm,conical,corolla,dark,dense,densely,diameter,drying,ellipsoid,entire,erect,exserted,filament,filiform,flattened,flower,fruiting,glabrous,gland-tipped,glandular,globose,growth,half,inflorescence,lanceolate,lateral,leaf,less,like,linear,lobed,lower,margin,minute,minutely,mm,new,occasionally,often,orange,pair,patent,pedicel,peduncle,per,petiole,pitted,plant,primary,pubescent,purple,red,reddish,reniform,ripe,rounded,several,shrub,simple,slightly,sometimes,sparse,sparsely,stem,stigma,style,surface,terminal,time,tip,trichome,tube,ultimate,uniformly,uniseriate,vein,viscous,way,x,yellowish,Â½	..,0.2,0.5,1,1-1,1-4,1.5-2,2-2.5,5-merou,<,ag,almost,along,alyx,apar,ark,articulated,axi,cell,confined,connivent,cupped,eaf,eed,em,fleshy,free,ilament,irregularly,leaving,lengthening,lobe,loosely,m.,markedly,nflorescence,nodding,older,orolla,papillo,peg,perfect,perhaps,pericarp,plurifoliat,pore,poricidal,portion,prominen,pubescen,rectangular,ruit,scar,shiny,sleeve,slit,small,somewhat,spaced,spreadin,spreading,square,stellate,testal,thin,triangular,twinin,ud,unit,upper,usually,variable,vary,woody,ympodial	arrangement,bark,branch,bud,characteristic,colour,exertion,form,fruit,glabrousnes,height,history,length,life,lobing,na,number,ovary,papillose,seed,shape,size,texture,type	.5,0.5-1,0.5-2,0.6-0.8,0.7-1,1-1.5,1-3,1.2-2,1.8-6,12-14,2-4,2/3,3-3.5,3.5-4,4-5,5-30,6-9,acuminate,acute,anthesi,attenuate,base,becoming,berry,bluish,branched,brown,calyx,capitate,cm,conical,dark,dense,densely,diameter,ellipsoid,entire,erect,exserted,filiform,flattened,flower,glabrous,gland-tipped,glandular,globose,half,lanceolate,lateral,less,like,linear,lobed,lower,minute,minutely,mm,occasionally,often,orange,pair,patent,per,pitted,plant,pubescent,purple,red,reddish,reniform,ripe,rounded,several,shrub,simple,slightly,sometimes,sparse,sparsely,stem,surface,terminal,time,tip,trichome,tube,ultimate,uniformly,uniseriate,viscous,way,x,yellowish,Â½	na,papillose
174	wfo-0001027819	success	198	122	87	96	102	26	85	2	0.5-1,1-2,1-5,10-20,10-50,12-21,16-25,2-15,2-3-5-lobed,20-35,22-35,25-35,3-40,3-5,4,4-10,4-15,4-25,4-5,5,5-6,8-10,9-12,abaxially,acute,adaxially,apex,apical,basal,base,branched,cm,concave,cordate,cuneate,deeply,densely,diameter,ellipsoidal,entire,especially,fading,finely,fleshy,forked,fruit,glabrous,globose,green,leaf,length,lobe,lobed,long,margin,mm,narrowly,oblique,oblong,obtuse,often,pedicel,peduncle,per,petiole,pilose,pinnately,probably,protuberance,puberulent,purple,rachi,rarely,rugose,simple,sometimes,sparsely,stigma,style,sympodial,tree,triangular,truncate,tube,two,umbrella-shaped,unbranched,unit,unknown,unlobed,usually,whitish,wide,without,x,yellow	1,1-4-10,1.5-2,15-22,2,2-3,20-25,20-40,20-40-100,5-merous,aggregate,also,alyx,apart,ape,apiculat,articulated,axe,ba,beyond,blade,cell,ciliate,color,connective,cylindrical,denser,dia,diamete,dilated,directed,distally,divided,eaf,eed,eglandular,eglandular-pilose,elliptic,elliptic-ovate,equal,exceeding,except,exserted,flower,hair,halfway,leaving,lon,lower,main,mesocarp,midrib,moderately,narrow,near,nflorescence,nther,obtu,occasionally,orolla,ovate,pedicellar,perfec,perfect,pore,present,prominent,puberulen,puberulence,purplish,radiu,ranch,ratio,remnant,ripe,rounded,rown,ruit,runk,shallowly,short-acuminat,shorter,sinus,slightly,small,spaced,stamen,stellate,stone,strongly,subcoriaceous,swelling,tal,thecae,toward,ud,uni,vary,vein,villous,width,young	anther,arrangement,branch,bud,calyx,characteristic,colour,corolla,crown,form,growth,height,history,inflorescence,life,ovary,perennial,plant,seed,shape,short-acuminate,size,stem,surface,texture,trunk	0.5-1,1-2,1-5,10-20,10-50,12-21,16-25,2-15,2-3-5-lobed,20-35,22-35,25-35,3-40,3-5,4,4-10,4-15,4-25,4-5,5,5-6,8-10,9-12,abaxially,acute,adaxially,apex,apical,basal,branched,cm,concave,cordate,cuneate,deeply,densely,diameter,ellipsoidal,entire,especially,fading,finely,fleshy,forked,glabrous,globose,green,lobe,lobed,long,margin,mm,narrowly,oblique,oblong,obtuse,often,per,pilose,pinnately,probably,protuberance,puberulent,purple,rarely,rugose,simple,sometimes,sparsely,sympodial,tree,triangular,truncate,two,umbrella-shaped,unbranched,unit,unknown,unlobed,usually,whitish,wide,without,x,yellow	perennial,short-acuminate
175	wfo-0001027834	success	235	93	52	70	165	23	48	4	0.2-0.6,0.4-1.1,0.9-1.8,1-1.9,1-10,1.1-1.8,2-8,25,4-5.2-6.1,5-20,5-merous,6.9-18.1,abaxial,acuminate,acute,adaxial,anther,anthesi,apex,attenuate,bark,base,berry,brown,bud,calyx,cm,corolla,deltoid,diameter,ellipsoid,entire,filament,finely,fruit,fruiting,globose,granular-tomentose,gray,hair,included,leaf,lenticular,margin,mm,obtuse,ovate,ovate-elliptic,pedicel,peduncle,petiole,reticulate-punctate,rounded,scabridulous,semi-spherical,short,shrub,simple,soft,stem,stigma,style,subcampanulate,surface,turbinoid,velutinous-tomentose,white,whitish,yellow,yellowish-tan	.5-3,0-110,0.2-0.3,0.2-0.4,0.5-2,1-1.6,1-2.5,1.1-1.6,1.4-2,1.6-2.7,1.8-4.9,1/2,10-25,2-3.8,2.2-4.3,2.3-3.4,2.4-6.2,2.7-7.3,2.9-4.2,3-15,3-4.3,4-6,4.8-6.9,5.1-8,9-11.9,9-13,abaxially,absent,accrescent,adaxially,ag,alyx,angled,apar,apical,around,articulated,axillary,ba,becoming,blade,blunt-tipped,branch,branched,branching,capitat,closely,completely,concentrated,connivent,coriaceous,covering,crown,cylindrical,dendritic-echinoi,dendritic-echinoid,densely,dichasia,directed,discolorous,distally,drying,eaf,echinoi,echinoid,edge,eed,enclosing,enveloping,equal,erec,exserted,farinose,flat-topped,fleshy,flower,forming,glabrescent,glabrous,grooved,high,inserted,lengthening,less,light,lobe,lobed,long,long-stalked,longitudinal,longitudinally,lower,many,mostly,multangulat,multangulate,near,nflorescence,numerous,obovate,obscured,older,orbicular,orolla,ovate-lanceolate,pair,perfec,persistent,plurifoliate,pore,poricidal,porrect-stellate,primary,pseudo-terminal,pubescence,pubescent,rachi,rarely,ray,ripe,ruit,runk,scar,semi-ovate,sessile,short-stalked,slit,small,sometimes,somewhat,spaced,sparsely,spreading,stalked,stamen,stellate,stellate-pubescent,subcoriaceous,suture,tamen,though,time,tip,tomentose,tomentu,tomentum,toward,tree,trichome,tube,ud,unarme,unit,usually,vary,vein,villous,way,whitish-tomentose,wide,x,yellowish,yellowish-tomentose,ympodial,young	arrangement,capitate,characteristic,colour,exertion,form,growth,height,history,inflorescence,length,life,lobing,ovary,perennial,plant,pseud-terminal,seed,shape,size,texture,type,unarmed	0.2-0.6,0.4-1.1,0.9-1.8,1-1.9,1-10,1.1-1.8,2-8,25,4-5.2-6.1,5-20,5-merous,6.9-18.1,acuminate,acute,anthesi,attenuate,berry,brown,calyx,cm,deltoid,ellipsoid,entire,finely,globose,granular-tomentose,gray,included,lenticular,mm,obtuse,ovate,ovate-elliptic,reticulate-punctate,rounded,scabridulous,semi-spherical,short,shrub,simple,soft,subcampanulate,turbinoid,velutinous-tomentose,white,whitish,yellow,yellowish-tan	capitate,perennial,pseud-terminal,unarmed
176	wfo-0001027843	success	154	148	96	104	50	44	92	4	.5,.75,0.5-0.75,0.5-1,0.8-3.5,1-1.2,1-1.3,1-1.5,1.2-1.5,3-15-flowered,3-6,5-6,6-13,6-9,acute,along,anther,anthesi,apex,bark,base,bearing,becoming,beneath,berry,broadly,calyx,clavate,cm,conical,corolla,curly,densely,dia,distally,ellipsoid,erose,exsertion,filament,flower,fruiting,glabrate,glabrous,globose,green,lamina,later,lateral,leaf,like,lobe,lobed,long,long-acuminate,main,margin,minutely,mm,near,nearly,older,one,ovary,ovate,pair,papillose,pedicel,petiole,pleated,pore,poricidal,pubescent,reflexed,shape,shaped,shrub,simple,sinus,size,slender,slightly,somewhat,sparser,stem,stiff,stigma,straight,strongly,style,surface,tapering,tear-drop,time,tip,tipped,trichome,tube,two,uniseriate,vein,white,winged,x,young	/3,1.2-2.5,2-2.5,2-4,apart,apiculate,ba,beginning,coroll,deflexed,deltoid,denser,differing,difoliate,eaf,edicel,eed,free,geminat,hairy,impressed,irregularly,known,larger,lon,lower,major,middle,minor,nflorescence,occasionally,opposite,orbicular,papillo,portion,prominent,proximal,reddish-gre,rounded,ruit,scar,spaced,sparsely,tall,ud,unit,way,widest,woody,ympodial	appearance,arrangement,border,branch,bud,characteristic,colour,corrugation,diameter,distal,drying,exertion,form,fruit,giving,glabrousnes,growth,height,history,inflorescence,interjected,leaflet,length,life,lobing,midpoint,na,new,number,peduncle,per,plant,prickle,primary,pseudostipule,ray,reddish-grey,seed,terminal,texture,thicknes,type,variation,width	.5,.75,0.5-0.75,0.5-1,0.8-3.5,1-1.2,1-1.3,1-1.5,1.2-1.5,3-15-flowered,3-6,5-6,6-13,6-9,acute,along,anthesi,bark,base,bearing,becoming,beneath,berry,broadly,calyx,clavate,cm,conical,corolla,curly,densely,dia,distally,ellipsoid,erose,exsertion,flower,glabrate,glabrous,globose,green,lamina,later,lateral,leaf,like,lobe,lobed,long,long-acuminate,main,minutely,mm,near,nearly,older,one,ovate,pair,papillose,pleated,pore,poricidal,pubescent,reflexed,shaped,shrub,simple,sinus,slender,slightly,somewhat,sparser,stem,stiff,straight,strongly,surface,tapering,tear-drop,time,tip,tipped,trichome,tube,two,uniseriate,vein,white,winged,x,young	-1.2,di,na,reddish-grey
177	wfo-0001027847	success	215	121	86	100	115	21	84	2	-2.5,-6,.35,0-2,0.4-1,0.8-0.9,0.8-1.2,1-2.5-4,1.5-2,1.5-2.5,1.5-5,1.9-2.3,1/4,2-2.8,2-3,2-4,2-5,2.2-3,3-6,abaxially,acute,almost,anther,apex,apparently,articulated,bark,base,berry,calyx,chartaceous,cm,deltate,densely,diameter,discolorous,drying,dull,elliptic,erect,evenly,finely,flattened,flattened-reniform,fruit,fruiting,glabrescent,glabrous,gray,green,lateral,leaf,length,lobe,lobed,long,margin,maturity,mauve,middle,mm,moderately,narrow-deltate,orange,orange-brown,ovate,pedicel,peduncle,perpendicular,petiole,pitted,poricidal,prickle,purple,red,red-brown,retrorse,rounded,seed,shrub,side,size,smooth,sometimes,sparsely,spherical,stellate-pubescent,stem,strongly,style,surface,tapering,terminal,tip,upper,weakly,white,wide,yellow,young	-3,-5,.7,/2,/3,0-7,0.1-0.4,0.15-0.2,0.2,0.5,0.5-0.8,0.5-1,0.8,1-2,1/2,1/6-1/3,2.5-3.5,2/,3-15,3-5,3.5-6,4-5-merous,5-25,5-6,5.5-8,6-11,6-8,7-10,alyx,ame,apar,apart,apically,blade,branched,broadly,brow,c.,connivent,cordate,curved,dimorphic,distance,eaf,edge,eed,elongating,equal,extending,faint,filament,filiform,filiform-acuminat,flower,free,geminate,increasing,infructescence,lon,longer,lower,mature,midpoint,midvein,minor,nflorescence,older,one,open,orbicular,orolla,oung,pair,pendulous,per,perfec,pericarp,pit,plurifoliat,porrect,portion,prickl,prickly,primary,ray,reddish,ruit,scandent,scar,sessile,simple,slender,spaced,spreading,stalk,stalked,stellate,straight,tamen,terete,tertiary,time,toward,trichome,tube,unarmed,unit,usually,variously,vary,vein,venation,visible,way,ympodial	abaxial,adaxial,brown,characteristic,colour,corolla,form,growth,height,history,inflorescence,life,lobing,ovary,perennial,plant,shape,staman,texture,type,width	-2.5,-6,.35,0-2,0.4-1,0.8-0.9,0.8-1.2,1-2.5-4,1.5-2,1.5-2.5,1.5-5,1.9-2.3,1/4,2-2.8,2-3,2-4,2-5,2.2-3,3-6,abaxially,acute,almost,apparently,articulated,base,berry,chartaceous,cm,deltate,densely,diameter,discolorous,drying,dull,elliptic,erect,evenly,finely,flattened,flattened-reniform,glabrescent,glabrous,gray,green,lateral,lobe,lobed,long,maturity,mauve,middle,mm,moderately,narrow-deltate,orange,orange-brown,ovate,perpendicular,pitted,poricidal,purple,red,red-brown,retrorse,rounded,seed,shrub,side,smooth,sometimes,sparsely,spherical,stellate-pubescent,stem,strongly,tapering,terminal,tip,upper,weakly,white,wide,yellow,young	brown,perennial
178	wfo-0001027872	success	190	114	85	90	100	24	81	4	1,1-8,1.0-1.3,15,2,2.2-3.5,20,35,5-7,5-8,5-lobed,6-20,8-11,angular,apical,apically,apiculate,articulate,base,branched,ca,calyx,caudate,clasping,cm,connate,cyme,deep,dehiscent,densely,diameter,dichasial,dichasially,ebracteate,elliptic,externally,glabrescent,glandular-pubescent,globose,gray-green,green,green-white,homogeneously,introrse,lanceolate,light,lobe,long,maturing,middle,mm,moderately,monochasial,mottled,narrowly,oblong,odd-pinnate,often,ovate,ovoid,pedicel,peduncle,perennial,plant,poricidally,purple,rarely,rhizomatous,rotate,seed,semi-lunate,shape,short,size,slightly,slit,sometimes,stigma,straight,style,symmetrically,terete,tinged,type,typically,uniformly,usually,wide,yellow,yellowish-green	0.5,1-1.2,1-4,1.5-4,10,12-35,2-3,2.8,3-6-foliat,4-6,5-10,abaxially,acumen,acuminate,acute,adaxially,apex,b,ba,basal,becoming,cell,celled,commonly,cordate,covering,cuneate,decreasing,digestion,distal,eaf,eed,emoval,enzyme,erect,exceeding,filament,flower,forked,four-celled,generally,gland,glandular,globo,hair-like,half,herbaceous,honeycomb,interjected,lateral,leaflet,living,lon,longer,lower,make,mucilaginous,nearly,nflorescence,nther,obliquely,orolla,pair,pattern,pentagonal,perfect,petiolate,petiolulate,petiolule,puberulent,pubescent,purpl,reduced,reveal,rhizome,rotate-,rounded,ruit,sessile,seudostipule,single,somewhat,specimen,stamen,ste,subequal,tem,terminal,testal,thick,tip,trailing,unbranched,unit,vary,viole,wall,wid,wider,ympodial	abaxial,adaxial,anther,arrangement,characteristic,colour,corolla,form,fruit,growth,height,herb,history,inflorescence,leaf,length,life,ovary,pseudostipule,rotate-pentagonal,stem,texture,violet,width	1,1-8,1.0-1.3,15,2,2.2-3.5,20,35,5-7,5-8,5-lobed,6-20,8-11,angular,apical,apically,apiculate,articulate,base,branched,ca,caudate,clasping,cm,connate,cyme,deep,dehiscent,densely,diameter,dichasial,dichasially,ebracteate,elliptic,externally,glabrescent,glandular-pubescent,globose,gray-green,green,green-white,homogeneously,introrse,lanceolate,light,lobe,long,maturing,middle,mm,moderately,monochasial,mottled,narrowly,oblong,odd-pinnate,often,ovate,ovoid,perennial,poricidally,purple,rarely,rhizomatous,rotate,semi-lunate,short,slightly,slit,sometimes,stigma,straight,symmetrically,terete,tinged,typically,uniformly,usually,wide,yellow,yellowish-green	herb,rotate-pentagonal,stem,violet
179	wfo-0001027880	success	185	136	75	91	94	45	73	2	.25,0.3-3,0.5-5,0.6-1,0.6-1.5,0.8-1.5,1-15,1-2,1-3,1.5-2,10-15,2-3,3-4,4-10,4-6,5-11,acute,anther,apex,apiculate,base,branch,calyx,clavate,cm,conical,cordate,coriaceous,cylindrical,densely,diameter,discolorous,entire,extra-axillary,filament,flattened,flower,fruit,fruiting,glabrous,globose,green,greenish,inflorescence,leaf,leaf-opposed,lobe,lower,margin,minutely,mm,nearly,oblique,oblong,oblong-ovate,often,ovate,ovoid,pair,papillose,pedicel,peduncle,petiole,pink,pubescent,purple,red-brown,reddish,revolute,ripe,rounded,rugulose,secondary,shrub,simple,size,slender,slightly,somewhat,stigma,style,surface,tan,truncate,tube,unbranched,undulate,vein,vine,white,x	-3,0.5-1.5,0.5-1.5-3.5,1-14,1-2.5,1.5-3,2-80,2/,5-8,5-merou,8,abaxially,absen,accrescen,acuminate,adaxially,ag,aggregate,along,alyx,apart,apparently,articulated,axe,ba,blade,branching,cell,chartaceous,ciliat,connivent,contiguously,curled,deltate,dense,diminishing,directed,distally,distichous,distinct,distinctly,eaf,eed,epiphytic,equal,geminat,growing,hair,increasing,internode,line,long,longer,longitudinal,midvein,multicellular,nflorescence,node,occasionally,opening,orolla,pale,perfect,plurifoliate,point,pore,pubescen,rachi,rooting,ruit,scar,slit,sometimes,spaced,sparsely,ste,stellate,stone,tamen,tem,thickened,time,tip,trailing,tree,trunk,typically,uniseriate,unit,usually,vary,wide,yellow,ympodial	2/3,appearance,arrangement,bark,border,bud,characteristic,colour,corolla,corrugation,distal,drying,exertion,form,giving,glabrousnes,growth,height,history,interjected,lateral,leaflet,length,life,lobing,midpoint,na,new,number,ovary,per,plant,prickle,primary,pseudostipule,ray,seed,shape,stem,terminal,texture,thicknes,type,variation,width	.25,0.3-3,0.5-5,0.6-1,0.6-1.5,0.8-1.5,1-15,1-2,1-3,1.5-2,10-15,2-3,3-4,4-10,4-6,5-11,acute,apex,apiculate,clavate,cm,conical,cordate,coriaceous,cylindrical,densely,diameter,discolorous,entire,extra-axillary,flattened,flower,fruit,glabrous,globose,green,greenish,leaf-opposed,lower,minutely,mm,nearly,oblique,oblong,oblong-ovate,often,ovate,ovoid,pair,papillose,pink,pubescent,purple,red-brown,reddish,revolute,ripe,rounded,rugulose,secondary,shrub,simple,slender,slightly,somewhat,tan,truncate,unbranched,undulate,vein,vine,white,x	2/3,na
180	wfo-0001027880	success	170	115	77	89	81	26	74	3	.25,0.3â3,0.5,0.5â5,0.6â1,0.6â1.5,0.8â1.5,1.5â2,10â15,1â2,2/3,2â3,4â10,4â6,5â11,absent,acuminate,acute,anther,apex,apiculate,arrangement,base,berry,bluish-purple,calyx,chartaceous,clavate,cm,conical,cordate,coriaceous,cylindrical,densely,diameter,distichous,entire,extra-axillary,filament,flattened,flower,fruit,glabrous,globose,greenish,lanceolate,leaf,leaf-opposed,lower,margin,minutely,mm,mottled,nearly,oblique,oblong-ovate,often,ovate,ovoid,papillose,pedicel,peduncle,petiole,pink,pinnate,pubescent,red,reddish-brown,revolute,rounded,rugulose,shrubby,slender,slightly,sometimes,somewhat,stigma,style,surface,tan,truncate,tube,unbranched,undulate,vein,vine,white,woody,x	0.2-0.5,0.5â1.5,1.5â3,1â14,1â15,1â2.5,1â3,2-80,3â4,5-merous,5â8,8,abaxially,accrescen,adaxially,along,alyx,apar,axe,blade,c.,capitat,ciliat,climbing,contiguously,curled,deltate,dense,discolored,distinct,distinctly,eaf,eed,fruiting,green,hair,line,lobe,long,longer,m.,membranous,midvein,nflorescence,nternode,occasionally,orolla,pair,pale,perfec,plurifoliat,rachi,reddish,rip,ruit,sand-punctat,sand-punctate,scar,secondary,simple,spaced,sparsely,ste,stellate,tamen,tem,thickened,time,tip,tree,trichome,trunk,typically,uniseriate,unit,vary,vegetatio,venation,wide,ympodial,â3.5	bud,capitate,characteristic,colour,corolla,drying,exertion,form,glabrousnes,growth,history,inflorescence,length,life,lobing,na,new,ovary,primary,ripe,seed,shape,size,stem,texture,type	.25,0.3â3,0.5,0.5â5,0.6â1,0.6â1.5,0.8â1.5,1.5â2,10â15,1â2,2/3,2â3,4â10,4â6,5â11,absent,acuminate,acute,apex,apiculate,berry,bluish-purple,chartaceous,clavate,cm,conical,cordate,coriaceous,cylindrical,densely,diameter,distichous,entire,extra-axillary,flattened,flower,fruit,glabrous,globose,greenish,lanceolate,leaf-opposed,lower,minutely,mm,mottled,nearly,oblique,oblong-ovate,often,ovate,ovoid,papillose,pink,pinnate,pubescent,red,reddish-brown,revolute,rounded,rugulose,shrubby,slender,slightly,sometimes,somewhat,tan,truncate,unbranched,undulate,vine,white,woody,x	capitate,na,ripe
181	wfo-0001027881	success	214	129	72	75	139	54	57	15	acute,almost,anther,apex,articulated,attenuate,base,berry,blackish,calyx,camptodromous,chartaceous,ciliate,cm,connivent,contiguous,cordate,cordiform,densely,diameter,drying,entire,extra-axillary,few-,filament,flattened,flower,fruit,giving,glabrous,globose,greenish,groove,herb,immature,impression,lateral,leaf,light-brown,lobe,many-branched,margin,maturity,membranaceous,mm,moderately,netlike,ovate-elliptic,parallel,pedicel,peduncle,per,petiole,primary,projection,pubescent,raised,reniform,rotate,seed,sessile,simple,size,stem,stigma,style,subopposite,surface,translucent,triangular,tube,vein,white,yellow,Ã	.3â0.5,0.5â2.2,0.8â1.5,1-celled,1.3â2,1.8â2.9,10â25,1â2,1â2-celled,1â2.5-3,1â2.6,1â3,1â3-celled,1â4,2.5â3.6,20â40,2â4,2â6,2â7,4â6,4â9.5,5,5-merous,6â10,7â14,7â9,8,abaxially,absent,abundant,accrescent,acuminate,adaxiall,adaxially,alyx,appressed,asymmetric,axe,ba,barely,blade,bulge,capitat,case,central,closely,commonly,connected,curved,cylindrical,decurrent,dehiscing,denser,difoliate,directed,dorsally,eaf,ed,eglandular,emarginate,emerging,equal,erect,exceeding,exclusively,explosively,eye,fewer,forming,frequent,geminate,glandular,hair,half,held,hollow,interpetalar,introrsely,larger,less,like,long,longer,longitudinal,lower,mainly,maturit,mesocarp,mixed,much,multicelled,multicellular,naked,near,nflorescence,normally,one,opening,orolla,other,pair,part,perfec,placenta,pore,pressure,prominent,pubescence,rachi,ruit,secondary,short,side,similar,slightly,slit,small,smaller,solitary,sometimes,sparsely,stalk,staman,stamen,subapically,tal,tamen,tem,tissue,two,unbranched,unit,vary,venation,visible,watery,winged,woody,ympodial	0.5-2.2,0.8-1.5,1-2,1-2.5-3,1-3,1-4,1.8-2.9,10-25,2.5-3.6,20-40,6-10,7-14,7-9,appearance,arrangement,bark,border,branch,bud,capitate,characteristic,colour,corolla,corrugation,distal,exertion,form,fruiting,glabrousnes,growth,height,history,inflorescence,interjected,leaflet,length,life,lobing,midpoint,na,new,number,ovary,plant,prickle,pseudostipule,ray,shape,terminal,texture,thicknes,type,variation,width	acute,almost,apex,articulated,attenuate,base,berry,blackish,camptodromous,chartaceous,ciliate,cm,connivent,contiguous,cordate,cordiform,densely,diameter,drying,entire,extra-axillary,few-,flattened,flower,fruit,giving,glabrous,globose,greenish,groove,herb,immature,impression,lateral,light-brown,many-branched,margin,maturity,membranaceous,mm,moderately,netlike,ovate-elliptic,parallel,projection,pubescent,raised,reniform,rotate,sessile,simple,subopposite,translucent,triangular,white,yellow,Ã	0.5-2.2,0.8-1.5,1-2,1-2.5-3,1-3,1-4,1.8-2.9,10-25,2.5-3.6,20-40,6-10,7-14,7-9,capitate,na
182	wfo-0001027882	success	183	147	107	126	57	21	106	1	.25,.5,0.1,0.5-1,1,1-5,1.5-2.2,1.5-3-4,1.5-6,10-40,2-3,2-lobed,2.1-2.6,2.5-3,3-4,6-9,9-13,abaxially,acuminate,adaxially,age,along,anther,anthesi,apex,apparently,appearing,attenuate,axil,bark,base,berry,branch,branched,broadly,brown,c.,calyx,clavate,cm,completely,conical,corolla,dark,diameter,dry,drying,elliptic,entire,erect,exerted,filament,flattened,flower,fork,fruiting,fusiform,glabrous,globose,green,growth,hairy,hollow,inflorescence,junction,lamina,leaf-opposed,lengthening,less,lobed,margin,maturity,midrib,minutely,mm,new,nodding,occasionally,ovary,ovoid,pair,pale,paulo,pedicel,peduncle,petiole,pitted,pointed,population,pore,poricidal,primary,rarely,reddish,reniform,shattering,shiny,shrub,simple,slender,slit,small,sometimes,sparse,sparsely,specimen,stem,stigma,stout,strongly,structurally,style,surface,sÃ£o,time,tip,tree,trichome,tube,uniseriate,usually,vein,way,white,yellow,yellowish	06a,1-1.5,1.5-2,1.5-3.2-6,1.6-2.2,2-6,3.5-4,3.5-5,4-5,7-10-25,absent,apart,branching,caly,cucullate,deltate,dense,densely,difoliate,eaf,eed,et,fide,free,geminat,glabrou,hooked,irregularly,kallunki,lobe,lower,markedly,nflorescence,papillat,papillate,penden,perfect,planar,plane,portion,pulp,rachi,red-papillat,ruit,scar,spaced,sticky,straight,sweet-scented,swollen,thickened,tuft,ud,unit,woody,x,ympodial	arrangement,bud,characteristic,colour,exertion,form,fruit,glabrousnes,height,history,leaf,length,life,lobing,plant,red-papillate,seed,shape,size,texture,type	.25,.5,0.1,0.5-1,1,1-5,1.5-2.2,1.5-3-4,1.5-6,10-40,2-3,2-lobed,2.1-2.6,2.5-3,3-4,6-9,9-13,abaxially,acuminate,adaxially,age,along,anthesi,apex,apparently,appearing,attenuate,axil,base,berry,branch,branched,broadly,brown,c.,calyx,clavate,cm,completely,conical,dark,diameter,dry,elliptic,entire,erect,exerted,flattened,flower,fork,fusiform,glabrous,globose,green,hairy,hollow,junction,lamina,leaf-opposed,lengthening,less,lobed,maturity,midrib,minutely,mm,nodding,occasionally,ovoid,pair,pale,paulo,pitted,pointed,population,pore,poricidal,rarely,reddish,reniform,shattering,shiny,shrub,simple,slender,slit,small,sometimes,sparse,sparsely,specimen,stout,strongly,structurally,sÃ£o,time,tip,tree,trichome,uniseriate,usually,vein,way,white,yellow,yellowish	red-papillate
183	wfo-0001027889	success	151	111	72	83	68	28	69	3	-pubescent,0.5-1,0.5-11,0.7-2,1-3.5,1.5,10-12,10-20,10-30,3-4,3-8,abaxially,acuminate,acute,acute-acuminate,adaxially,apex,apiculate,basal,base,calyx,chartaceous,cm,connective,connivent,darker,deltate,densely,diameter,directed,eglandular-puberulent,eglandular-pubescent,elliptic,entire,equal,flower,fruit,glabrous,glandular-,green,greenish,immature,introrse,laterally,length,light,lobe,longitudinal,margin,mm,moderately,oblong,ovate,ovoid,pedicel,peduncle,petiole,pore,probably,puberulent,puberulent-pubescent,rachi,ripe,shrub,simple,somewhat,sparsely,stigma,stripe,style,subcordate,thecae,tip,tomentose,tree,triangular,truncate,unbranched,unknown,violet,white,x,yellowish	-2.5,.5,.5-2,0,1,1-10,1-3,1.5-2,2-20,2-3,3-9,4-foliat,5-10,aggregate,apart,ape,articulated,axe,beyond,blade,capitat,cell,color,cylindrical,dilated,distally,eaf,eed,exceeding,exserted,extending,finely,leaving,lon,long,lower,narrow,nflorescence,nther,orolla,pedicellar,perfect,presen,present,puberulen,puberulent-pubescen,radiu,remnant,ruit,slightly,small,spaced,stamen,stellate,stone,subcoriaceous,swelling,tal,tem,time,tomento,tube,ud,unit,vary,wide,yello,ympodial	1-2.5,abaxial,adaxial,anther,arrangement,bud,capitate,characteristic,colour,corolla,direction,form,growth,height,history,inflorescence,leaf,life,lobing,na,plant,seed,shape,size,stem,surface,texture,type	-pubescent,0.5-1,0.5-11,0.7-2,1-3.5,1.5,10-12,10-20,10-30,3-4,3-8,abaxially,acuminate,acute,acute-acuminate,adaxially,apex,apiculate,basal,chartaceous,cm,connivent,darker,deltate,densely,directed,eglandular-puberulent,eglandular-pubescent,elliptic,entire,equal,flower,glabrous,glandular-,green,greenish,immature,introrse,laterally,light,lobe,longitudinal,mm,moderately,oblong,ovate,ovoid,probably,puberulent,puberulent-pubescent,ripe,shrub,simple,somewhat,sparsely,stripe,subcordate,thecae,tip,tomentose,tree,triangular,truncate,unbranched,unknown,violet,white,x,yellowish	1-2.5,capitate,na
184	wfo-0001027901	success	156	106	76	88	68	18	75	1	.25,.5,0.3-1.2,0.8-1,0.8-2,0.9-2.3,1-1.5,1-2,1-2.5,1.5-1.8,3-5,4-5,abaxial,abaxially,acuminate,acute,adaxially,anther,apex,area,attenuate,bark,base,berry,bright,broadened,brown,calyx,cm,conical,corolla,curled,dark,densely,dia,dry,drying,elliptic,fresh,fruiting,glabrous,globose,green,immature,inflorescence,leaf,like,lobe,lobed,long,material,minor,minutely,mm,nearly,orbicular,ovary,ovoid-reniform,papillose,pedicel,petiole,pitted,pubescent,reddish,rest,ripe,rounded,shape,shaped,shiny,shrub,simple,size,sparsely,stem,stigma,style,surface,tear-drop,tip,translucent,trichome,tube,uniseriate,white,x,yellow,young	0.5-1,1.8-4.5,2.5-3,4-10-flowered,4.7-12,6-7,?,anthesi,ba,beneath,brow,closely,deflexed,differing,difoliate,direction,eaf,edicel,eed,ellipsoid,exserted,filament,firm,fleshy,free,geminat,imbedded,keeled,later,lateral,lon,lower,main,major,matrix,middle,midrib,nflorescence,older,opposite,oriented,overlappin,pair,papillo,planar,pore,poricidal,portion,prominently,reflexed,ruit,scar,single,slender,spaced,straight,strongly,swollen,tall,triangular,tub,ud,unit,usually,vein,widest,woody,ympodial	alternate,arrangement,characteristic,colour,diameter,form,fruit,growth,height,history,length,life,lobing,plant,pubescence,seed,texture,type	.25,.5,0.3-1.2,0.8-1,0.8-2,0.9-2.3,1-1.5,1-2,1-2.5,1.5-1.8,3-5,4-5,abaxial,abaxially,acuminate,acute,adaxially,apex,area,attenuate,base,berry,bright,broadened,brown,cm,conical,curled,dark,densely,dia,dry,drying,elliptic,fresh,glabrous,globose,green,immature,inflorescence,leaf,like,lobe,lobed,long,material,minutely,mm,nearly,orbicular,ovoid-reniform,papillose,pitted,pubescent,reddish,rest,ripe,rounded,shaped,shiny,shrub,simple,sparsely,stem,style,surface,tear-drop,tip,translucent,trichome,uniseriate,white,x,yellow,young	alternate
185	wfo-0001027902	success	128	110	72	87	41	23	72	0	-2.5,0.5-1,1-1.5,1-2,1-6,10-15,10-20,15-30,2-12,2-15,2-3,2-8,2-9,3-4,3-5,4-25,4-5,5-20,6-37,7-9,abaxially,acuminate,acute,adaxially,angled,apart,apex,base,branched,calyx,chartaceous,cm,cordate,cylindrical,deeply,densely,diameter,directed,distally,eglandular,entire,forked,fruit,glabrous,glandular,globose,hair,lobe,long,margin,mm,moderately,narrowly,nearly,ovate,pedicel,pedicellar,peduncle,petiole,pore,puberulent,pubescent,purple,purplish,rachi,radiu,remnant,reticulate,shrub,simple,small,sparsely,stellate,stigma,style,subcoriaceous,tip,tree,triangular,truncate,tube,unbranched,unknown,usually,whitish,x,yellow	1.5-3,2,20-50,3-foliat,8-13,absen,adaxiall,aggregate,articulated,axe,blade,cell,color,connivent,distall,eaf,eed,flower,inflated,leaving,like,lon,lower,nflorescence,nther,obtuse,orolla,pubescen,ripe,ruit,spaced,ste,stone,tal,tem,time,truncat,unit,vary,wide,ympodial	abaxial,adaxial,anther,arrangement,characteristic,colour,corolla,direction,form,growth,height,inflorescence,leaf,length,ovary,plant,seed,shape,size,spacing,stem,texture,type	-2.5,0.5-1,1-1.5,1-2,1-6,10-15,10-20,15-30,2-12,2-15,2-3,2-8,2-9,3-4,3-5,4-25,4-5,5-20,6-37,7-9,abaxially,acuminate,acute,adaxially,angled,apart,apex,branched,chartaceous,cm,cordate,cylindrical,deeply,densely,diameter,directed,distally,eglandular,entire,forked,glabrous,glandular,globose,hair,long,margin,mm,moderately,narrowly,nearly,ovate,puberulent,pubescent,purple,purplish,reticulate,shrub,simple,small,sparsely,stellate,subcoriaceous,tip,tree,triangular,truncate,unbranched,unknown,usually,whitish,x,yellow	
186	wfo-0001027929	success	193	133	103	111	82	22	102	1	1,1-10,1.0-1.3,10,2,2-3,2.0-3.0,3.5-5,4-30,5-lobed,6-15,abaxially,acuminate,acute,adaxially,along,angular,apex,apical,apically,apiculate,base,beyond,branched,calyx,caudate,cell,center,cm,connate,cordate,corolla,covering,cuneate,cyme,dark,darker-violet-blue,deep,dehiscent,diameter,dichasial,dichasially,distal,ebracteate,elliptic,except,flower,forked,generally,glabrous,globose,green,green-white,hair,hair-like,half,herbaceous,introrse,lanceolate,lateral,light,lobe,long,make,maturing,middle,mm,monochasial,mucilaginous,narrowly,obliquely,oblong,occasional,odd-pinnate,often,ovate,ovoid,pedicel,peduncle,perennial,plant,poricidally,puberulent,purple,rarely,rhizomatous,rounded,seed,shape,short,size,slit,sometimes,spot,star,stigma,style,symmetrically,terete,testal,thick,tinged,usually,vein,violet,violet-blue,wall,white,wide,without,yellow	0.2-0.9,1-4,1-8,1.5-4,15,20,3-6-foliat,35,4-5,4-6,5-10,5-6,acumen,articulate,ba,basal,becoming,cente,clasping,coat,color,decreasing,digestion,eaf,eed,embryo,emoval,enzyme,erect,exceeding,filament,formed,globo,honeycomb,included,interjected,leaflet,living,lon,lower,mostly,nearly,nflorescence,nther,orolla,pair,pattern,pentagonal,perfect,petiolate,petiolulate,petiolule,purpl,radiating,reduced,reveal,rhizome,rotate,rotate-,ruit,semi-lunate,sessile,seudostipule,slightly,somewhat,specimen,stamen,ste,straight,subequal,tem,terminal,tip,trailing,typically,unbranched,unit,vary,visible,wid,wider,ympodial	abaxial,adaxial,anther,arrangement,characteristic,colour,form,fruit,growth,height,history,inflorescence,leaf,length,life,ovary,petiole,stem,surface,texture,type,wet	1,1-10,1.0-1.3,10,2,2-3,2.0-3.0,3.5-5,4-30,5-lobed,6-15,abaxially,acuminate,acute,adaxially,along,angular,apical,apically,apiculate,base,beyond,branched,caudate,cell,center,cm,connate,cordate,covering,cuneate,cyme,dark,darker-violet-blue,deep,dehiscent,diameter,dichasial,dichasially,distal,ebracteate,elliptic,except,flower,forked,generally,glabrous,globose,green,green-white,hair,hair-like,half,herbaceous,introrse,lanceolate,lateral,light,lobe,long,make,maturing,middle,mm,monochasial,mucilaginous,narrowly,obliquely,oblong,occasional,odd-pinnate,often,ovate,ovoid,perennial,plant,poricidally,puberulent,purple,rarely,rhizomatous,rounded,seed,short,slit,sometimes,spot,star,symmetrically,terete,testal,thick,tinged,usually,vein,violet,violet-blue,wall,white,wide,without,yellow	wet
187	wfo-0001027948	success	180	94	61	68	112	26	55	6	.5,0-,0.5-2,1-2,1.3-1.8,1.5-4.5,10-14,13-15,7,7.5-10,acuminate,anther,apex,berry,branch,calyx,cm,corolla,diameter,directed,dorsally,edentate,ellipsoidal,elliptical,erect,filament,glabrous,globose,herb,herbaceous,hollow,ill-smelling,leaf,length,light,longer,longitudinally,margin,mm,narrowly,ovate,ovoid,pair,papillate,petiole,pubescent,purple,ridged,seed,serrulate,shorter,simple,slightly,small,stem,stigma,straight,style,sub-shrub,thickened,tooth,triangular,tube,unequal,upward,violet,viscid-pubescent,x	0.4,0.5-0.7,0.6,0.8-1.2-2.2,1-1.2,1.6,1/10,14,2-,2.2-3-8.2,2.5-3.2-5.2-6,3.5,3.7-4,5,5-,5-7-15-16,6-celled,8-celled,abaxially,abundant,accrescen,adaxially,ag,aggregate,antrorse,ape,articulate,attenuate,ature,basal,base,bicellular,c.,campanulate,cell,connectival,crushed,cuticle,dark,delicate,diamete,difoliate,eaf,finely,flexuous,fragrance,free,fruiting,generally,glandular,head,hig,inconspicuous,inserted,lamina,lobe,long,long-stalked,longitudinal,lower,many-,midvein,narrow,near,non-glandular,occasionally,odorles,opening,orolla,patent,pericarp,pore,poricidal,portion,prolongation,pubescence,reduced,ree,ruit,saddle-shape,scarce,scarcely,secondary,seeded,seen,separated,short-stalked,single-celled,sinus,slit,smooth,solitary,spur-like,stalk,stone,striat,striate,sub-opposite,tem,thecae,time,tip,trichome,twice,unit,vary,vein,ventrifixed,verrucate,ympodial,Â¼,Â½	2.2-8.2,2.5-5.2-6,7-15-16,abaxial,adaxial,arrangement,characteristic,colour,form,fruit,growth,height,history,life,na,number,ovary,per,perennial,plant,saddle-shaped,shape,size,surface,texture,type	.5,0-,0.5-2,1-2,1.3-1.8,1.5-4.5,10-14,13-15,7,7.5-10,acuminate,berry,cm,diameter,directed,dorsally,edentate,ellipsoidal,elliptical,erect,filament,glabrous,globose,herb,herbaceous,hollow,ill-smelling,light,longer,longitudinally,mm,narrowly,ovate,ovoid,pair,papillate,pubescent,purple,ridged,serrulate,shorter,simple,slightly,small,straight,sub-shrub,thickened,tooth,triangular,tube,unequal,upward,violet,viscid-pubescent,x	2.2-8.2,2.5-5.2-6,7-15-16,na,perennial,saddle-shaped
188	wfo-0001027961	success	177	99	61	75	102	24	60	1	0.9-1,1-1.5,1-5,2-2.5,2.3-2.5,3-3.5,8-10,?,acute,anther,anthesi,apex,asymmetric,base,berry,c.,calyx,clavate,cm,cordate,corolla,densely,diameter,ellipsoid,elliptic,entire,exserted,fading,filament,fruiting,fusiform,glabrous,globose,green,growth,immature,inflorescence,lateral,lobed,margin,membranous,minute,mm,new,obovate,occasionally,often,one,other,pedicel,peduncle,petiole,pinnatifid,pubescent,purple,simple,slender,slightly,sparsely,stem,stigma,style,surface,terminal,triangular,trichome,truncate,tube,uniseriate,vine,violet,way,white,white-pubescent,woody	.5,0.25,0.25-0.5,0.5-1,1,1-3,1-4,1-9,10-50,2.5-9,4.5-5,5-8,5-merou,6-9,7-9,<,abaxially,adaxiall,adaxially,age,always,alyx,apar,ark,articulated,axil,branched,broadly,brow,clear,conical,connivent,curling,deltate,distributed,eaf,early,eed,equalling,flower,free,geminat,ilament,irregularly,lamina,lengthening,lobe,lon,long,loosely,lower,many,mature,maturity,midrib,minutely,nflorescence,observed,older,orolla,pair,papillo,pendan,perfect,pericarp,pinched,planar,plurifoliate,pore,poricidal,portion,present,primary,probably,pubescen,reddish,rotate-stellate,ruit,scar,shiny,sleeve,slit,small,spaced,spreading,tem,thin,time,tip,transition,tuft,twinin,twining,ud,unequal,unit,upper,vary,vein,x,yellow,ympodial	abaxial,adaxial,arrangement,bud,characteristic,colour,exertion,form,fruit,glabrousnes,history,leaf,length,life,lobing,na,number,ovary,per,seed,shape,size,texture,type	0.9-1,1-1.5,1-5,2-2.5,2.3-2.5,3-3.5,8-10,?,acute,anthesi,asymmetric,base,berry,c.,calyx,clavate,cm,cordate,densely,diameter,ellipsoid,elliptic,entire,exserted,fading,filament,fusiform,glabrous,globose,green,immature,lateral,lobed,membranous,minute,mm,obovate,occasionally,often,one,other,pinnatifid,pubescent,purple,simple,slender,slightly,sparsely,terminal,triangular,trichome,truncate,tube,uniseriate,vine,violet,way,white,white-pubescent,woody	na
189	wfo-0001027966	success	207	111	67	90	117	21	65	2	0.8-2.5,1-1.8,1-2,1-3,1-4.2,1-5,1.2-4.5,1.3-2.2,1.5-5.2,10,10-30,2.2-2.9,2.5-10.5,2.8-9,3-5,3-7,4,40-80,5-6,5-9.5,5.5-14,6-11,absent,acumen,anther,attenuate,base,blade,blue-violet,brownish,chartaceous,cm,condition,conical,corolla,densely,diameter,drying,filament,flower,fresh,fruit,green,greenish,herb,homostylous,interjected,lanceolate,lateral,leaf,leaflet,light,lobe,long,medium,membranous,minute,mm,moniliform,mottled,mucilaginous,odd-pinnate,ovate,ovoid,pedicel,peduncle,pentagonal,petiole,plant,pubescent,purple,rarely,ripe,rotate,seed,semierect,size,sparsely,stem,stigma,straight,terminal,tube,tuber,usually,wet,whitish,wide,x,yellow	0.4-0.5,0.7-3,0.8,1-10,1.5-3,3-4,5-10,5-merou,abaxially,acuminate,adaxially,ag,along,alyx,apart,apex,apparently,arranged,articulated,asymmetrical,axe,axillary,basiscopic,bead,berry,bud,capitat,cell,ciliate,commonly,connivent,covering,decreasing,digestion,distal,dorsally,eaf,edge,eed,elliptic,enzyme,erec,especially,exceeding,flat,folded,forked,geminat,generally,glabrou,glabrous,gradually,green-white,hair,hair-like,half,honeycomb-shaped,larger,lengthening,less,like,living,lower,make,margin,middle,multiple,narrow,necklace,nflorescence,orbicular,orolla,pair,pale,perfect,petiolule,plurifoliate,pore,poricidal,proximal,ray,removed,ruit,secondary,sessile,seudostipule,shorter,side,slightly,slit,somewhat,spaced,specimen,stamen,ste,stolon,subequal,subsessile,subtending,symmetrical,tall,tamen,tem,testal,thick,throughout,tip,tissue,tri-,tyle,typically,unit,violet,wall,white,wing,ympodial	abaxial,adaxial,arrangement,calyx,capitate,colour,erect,form,growth,height,history,inflorescence,length,life,pseudostipule,pubescence,shape,staman,style,surface,texture	0.8-2.5,1-1.8,1-2,1-3,1-4.2,1-5,1.2-4.5,1.3-2.2,1.5-5.2,10,10-30,2.2-2.9,2.5-10.5,2.8-9,3-5,3-7,4,40-80,5-6,5-9.5,5.5-14,6-11,absent,attenuate,blue-violet,brownish,chartaceous,cm,condition,conical,densely,drying,fresh,green,greenish,herb,homostylous,lanceolate,light,long,medium,membranous,minute,mm,moniliform,mottled,mucilaginous,odd-pinnate,ovate,ovoid,pentagonal,pubescent,purple,rarely,ripe,rotate,semierect,sparsely,straight,usually,wet,whitish,wide,x,yellow	capitate,erect
190	wfo-0001028014	success	218	116	75	93	125	23	73	2	-15,-4,-6,.5,/5,0.2-1,0.2-1.6-2.5,0.3-0.4,0.5-1,0.5-3,0.6-0.9,0.7-1,0.7-1.6,0.9-1.2,1-4,1.3-2.4,1.5-2,2-3,2-4.5,6-11,almost,anther,apex,apparently,articulated,bark,base,berry,black,brown,brown-green,calyx,cell,chartaceous,cm,cordate,densely,diameter,erect,filament,flattened-reniform,fruit,fruiting,glabrous,gray,gray-green,lateral,leaf,length,lobed,long,margin,maturity,mauve,membranous,mm,moderately,obtuse,orange,outline,ovate,pair,pedicel,peduncle,petiole,pit,poricidal,prickly,primary,purple,raised,red,rough,rounded,seed,shiny,shrub,simple,spherical,stellate-pubescent,stem,style,surface,tapering,terminal,tip,tube,vein,visibly,way,weakly,wide,yellow-green	0-10,0-3,0-5,0-6,0.1-0.2,0.15,0.15-0.3-0.5,0.2,0.2-0.4,0.2-0.4-1,0.25,0.5,0.5-1.5,0.5-2,1-10,1-2,1-2-20,1-3,1.5,1.8-3,1/4,1/4-1/2,1/4-2/3,2-6.5,2.5-4,3-10,4-10,4.5-7,5-merous,6-10,abaxially,acuminat,alyx,ame,apar,apart,apically,around,blade,branched,broad-deltate,c.,concolorous,connivent,curved,decurrent,deltate,difoliate,discolorous,distance,drying,eaf,edge,eed,elongating,equal,extending,eye,flattened,flower,free,geminat,glabrescent,glabrou,gland,globular,herbaceous,infructescence,lobe,lon,longer,lower,mature,midpoint,midvein,naked,nflorescence,occasionally,older,one,open,orange-gra,orolla,oung,outer,pale,pendulous,per,perfec,pericarp,porrect,portion,prickl,prickle,ray,reduced,reflexed,ruit,scandent,scar,sessile,shorter,side,slender,smooth,sometimes,spaced,spreading,stalk,stalked,stellate,straight,strongly,tamen,terete,tertiary,time,trichome,unit,vary,venation,visible,winged,yellow,ympodial	arrangement,branch,characteristic,colour,corolla,exertion,form,glabrousnes,growth,height,history,inflorescence,life,lobing,new,orange-gray,ovary,perennial,plant,shape,size,texture,type	-15,-4,-6,.5,/5,0.2-1,0.2-1.6-2.5,0.3-0.4,0.5-1,0.5-3,0.6-0.9,0.7-1,0.7-1.6,0.9-1.2,1-4,1.3-2.4,1.5-2,2-3,2-4.5,6-11,almost,apparently,articulated,base,berry,black,brown,brown-green,cell,chartaceous,cm,cordate,densely,diameter,erect,flattened-reniform,glabrous,gray,gray-green,lateral,lobed,long,maturity,mauve,membranous,mm,moderately,obtuse,orange,outline,ovate,pair,pit,poricidal,prickly,purple,raised,red,rough,rounded,shiny,shrub,simple,spherical,stellate-pubescent,tapering,terminal,tip,visibly,way,weakly,wide,yellow-green	orange-gray,perennial
191	wfo-0001028017	success	158	112	80	88	70	24	77	3	0.3-1,1-10,15-35,15-50-flower,2-4,2.5-5,3-12,40-50,6-8,abaxially,acuminate,acute,adaxially,apex,apiculate,axe,basal,base,brown,calyx,chartaceous,clavate,cm,connivent,cuneate,densely,diameter,directed,distally,eglandular,eglandular-puberulent,eglandular-pubescent,ellipsoidal,elliptic,entire,flattened,fleshy,flower,forked,fruit,fusiform,glabrous,glandular,glandular-,glandular-puberulent,green,greenish,hair,immature,introrse,lanceolate,lobe,margin,mm,moderately,narrowly,oblique,obtuse,ovate,ovoid,pedicel,peduncle,perfect,petiole,pointed,pore,pubescent,purplish,rachi,rarely,ripe,short-acuminate,simple,sometimes,sparsely,stellate,stellate-campanulate,stigma,style,subcoriaceous,tip,tree,truncate,unbranched,white,without,x,yellow	-2.5,1,1-2,1-3,1.5-2,10-22,13-40,2,2-3,3,3-14,3-4,3-foliat,5,5-7,5-9,6-7,9-11,absen,absent,aggregate,apart,ape,articulated,beyond,blade,cell,ciliat,connective,cream,cylindrical,eaf,eed,exceeding,exserted,leaving,lon,long,lower,near,nflorescence,nther,orolla,pedicellar,puberulen,purple,radiu,remnant,ruit,shorter,slightly,small,spaced,stamen,stone,tal,tan,tem,thecae,time,tomentose,triangular,truncat,tube,ud,unit,vary,vein,wide,ympodial	1-2.5,anther,arrangement,bud,characteristic,colour,corolla,direction,form,growth,height,history,inflorescence,leaf,length,life,perennial,plant,puberulent,seed,shape,stem,surface,texture	0.3-1,1-10,15-35,15-50-flower,2-4,2.5-5,3-12,40-50,6-8,abaxially,acuminate,acute,adaxially,apex,apiculate,axe,basal,brown,chartaceous,clavate,cm,connivent,cuneate,densely,directed,distally,eglandular,eglandular-puberulent,eglandular-pubescent,ellipsoidal,elliptic,entire,flattened,fleshy,flower,forked,fruit,fusiform,glabrous,glandular,glandular-,glandular-puberulent,green,greenish,hair,immature,introrse,lanceolate,lobe,mm,moderately,narrowly,oblique,obtuse,ovate,ovoid,perfect,pointed,pubescent,purplish,rarely,ripe,short-acuminate,simple,sometimes,sparsely,stellate,stellate-campanulate,subcoriaceous,tip,tree,truncate,unbranched,white,without,x,yellow	1-2.5,perennial,puberulent
192	wfo-0001028033	success	157	137	104	111	46	26	100	4	.6,1.4â1.8,1.5,1â4,2â3,3,3â5,4â12,4â5,50,5â7,6â12,abaxially,acuminate,acute,adaxially,along,anther,apex,ascending,attenuate,base,becoming,blade,brochidodromous,brown,calyx,cell,chartaceous,ciliate,cm,connivent,cordate,cylindrical,cyme,darker,decurrent,deeply,densely,denser,diameter,directed,discolorous,drying,elliptic,emarginate,entire,few-branched,filament,flower,fruit,glabrescent,glabrous,green,growth,herb,hispid-pubescent,introrsely,lateral,length,light,like,lobed,long,longitudinal,mainly,margin,membranaceous,midrib,mm,nearly,new,oblong,onto,opening,order,ovate-lanceolate,pedicel,petiole,pore,poricidal,pubescence,pubescent,rhizomatous,sessile,shiny,shorter,simple,slightly,slit,solitary,sparsely,spreading,stellate,stem,stigma,straight,style,subapical,surface,trichome,unbranched,uniseriate,unknown,upright,vein,venation,white,woody,yellow,Ã	1â5,2â4,2âfoliate,3â11,3â4,5-merou,adaxiall,alyx,anthesi,ark,branch,capitat,contiguou,eaf,eed,equal,eye,florescence,geminat,greenish,high,know,known,linear-lanceolate,lobe,lower,naked,older,orolla,perfect,prominent,prostrat,recurved,ruit,secondary,shin,shrub,strongly,tamen,tem,tube,unit,vary,visible,wide,ympodial	arrangement,bark,capitate,characteristic,colour,contiguous,corolla,form,glabrousnes,height,inflorescence,leaf,lobing,na,number,ovary,per,plant,prostrate,seed,shape,size,staman,texture,type,width	.6,1.4â1.8,1.5,1â4,2â3,3,3â5,4â12,4â5,50,5â7,6â12,abaxially,acuminate,acute,adaxially,along,apex,ascending,attenuate,base,becoming,blade,brochidodromous,brown,calyx,cell,chartaceous,ciliate,cm,connivent,cordate,cylindrical,cyme,darker,decurrent,deeply,densely,denser,directed,discolorous,drying,elliptic,emarginate,entire,few-branched,flower,fruit,glabrescent,glabrous,green,herb,hispid-pubescent,introrsely,lateral,light,like,lobed,long,longitudinal,mainly,membranaceous,midrib,mm,nearly,oblong,onto,opening,order,ovate-lanceolate,petiole,pore,poricidal,pubescence,pubescent,rhizomatous,sessile,shiny,shorter,simple,slightly,slit,solitary,sparsely,spreading,stellate,stem,straight,subapical,surface,trichome,unbranched,uniseriate,unknown,upright,vein,white,woody,yellow,Ã	capitate,contiguous,na,prostrate
193	wfo-0001028067	success	138	101	65	78	60	23	64	1	0.5-1,0.5-1.5,0.5-2,1-10-30,1-11,1-7,10-25,2,2-2.5,2.5-3,3-5,3-7,6-12,6-18,7-11-compound,7-9,abaxially,acuminate,acute,adaxially,along,apart,apex,base,calyx,chartaceous,cm,connivent,cuneate,dark,diameter,elliptic-fusiform,elliptic-ovate,entire,especially,flattened,flower,fruit,glabrous,hair,leaf,margin,midrib,mm,moderately,narrowly,obtuse,often,pedicel,peduncle,petiole,pink,pinnately,pore,puberulent,purple,rachi,rarely,ripe,shrub,simple,sparsely,stellate,stigma,strongly,style,tip,tomentulose,triangular,triangular-deltate,truncate,unbranched,unequal,unknown,usually,x,yellow,zigzag	1,1-2,1-3,1.5-2.5,2-3,3-17,3-4,4-foliat,5-7,7-20,8-13,adaxiall,aggregate,articulated,axe,basiscopically,blade,cell,color,compound,cylindrical,decurrent,directed,distall,eaf,eed,glabrou,lateral,leaflet,leaving,lobe,lon,long,lower,nearly,nflorescence,nther,orolla,pedicellar,per,puberulen,radiu,remnant,ruit,several,slightly,smal,spaced,stone,subcoriaceous,tal,tem,time,truncat,tube,unit,upper,vary,wide,ympodial	anther,arrangement,characteristic,colour,corolla,direction,distally,form,growth,height,history,inflorescence,length,life,ovary,plant,seed,shape,size,spacing,stem,surface,texture	0.5-1,0.5-1.5,0.5-2,1-10-30,1-11,1-7,10-25,2,2-2.5,2.5-3,3-5,3-7,6-12,6-18,7-11-compound,7-9,abaxially,acuminate,acute,adaxially,along,apart,chartaceous,cm,connivent,cuneate,dark,elliptic-fusiform,elliptic-ovate,entire,especially,flattened,flower,glabrous,hair,midrib,mm,moderately,narrowly,obtuse,often,pink,pinnately,puberulent,purple,rarely,ripe,shrub,simple,sparsely,stellate,strongly,tip,tomentulose,triangular,triangular-deltate,truncate,unbranched,unequal,unknown,usually,x,yellow,zigzag	distally
194	wfo-0001028069	success	249	115	68	89	160	26	66	2	0.3-0.45,0.4-0.5,0.4-0.8,0.5-0.7,0.5-1.8,0.6-1.1,0.6-4,0.7-1.5,0.8-1.2,1-2.7,1-3.5,1.5-2.0,1.6-3.2,10-12,2-17,2-3-branched,2-locular,3,5-25,acute,anther,apex,articulated,base,basioscopically,bilaterally,bright,brown,calyx,cm,conical,corolla,decurrent,deep,deeply,densely,diameter,exserted,filament,fruit,fruiting,glandular-villous,globose,green,hair-like,halfway,herb,imparipinnate,interrupted,leaf,length,linear,lobed,long,margin,minute,minutely,mm,oblique,obovate,occasionally,orange,outgrowth,ovary,ovate,pale,pedicel,peduncle,pentagonal,per,perennial,petiole,plant,primary,pubescent,rounded,simple,size,somewhat,stem,stigma,straight,style,surface,symmetric,thick,tube,wide,yellow	.1,.1-0.2,.2,.5,0.05-0.1,0.1-0.15,0.1-0.2,0.1-0.2-0.4,0.1-0.3,0.1-0.5,0.1-0.6,0.2-0.3,0.2-0.5,0.3,0.3-0.4,0.3-0.6,0.3-0.7,0.3-1,0.4,0.4-1,0.5,0.5-2,0.7-1,0.7-1.3,1-2-celled,1-4.5,1.4,1.5-3.5-6,10,12,2-4,2-7,3-5-22-30,3-foliate,4-celled,6-10-30,<,abaxially,absen,abundant,accrescent,adjacent,adpressed,along,alternate,always,among,anthesi,apical,appearance,appendage,appressed,axi,ba,basal,becoming,berry,bract,bracteole-like,cell,citru,column,composed,cone-shaped,cordate,cuneate,curving,dense,due,eaf,ebracteate,edicel,eed,eglandular,erect,flower,forming,fusion,giving,glabrescent,gland,gland-tippe,gland-tipped,glandular,gree,half,head,included,initially,interjected,internode,larger,later,lateral,leaflet,less,like,lime,lobe,lon,longer,longest,lower,maturity,middl,midvein,multicellular,narrowly,nflorescence,often,one,pair,patent,petiolule,population,present,procumbent,pseudostipule,pubescence,quaternary,rarely,reflexed,robust,ruit,scarcely,scent,secondary,sessile,several,shaggy,short,shorter,silky,single-celled,slender,smaller,staminal,sterile,strong,subopposite,tangled,tem,terminal,tertiary,testa,tightly,toward,transparent,trichome,ud,unicellular,uniseriate,unit,usually,varying,viny,wall,weak,winged,ympodial	arrangement,bark,branch,bud,characteristic,colour,corrugation,drying,exertion,form,glabrousnes,growth,height,history,inflorescence,life,lobing,middle,na,new,number,seed,shape,texture,type,vein	0.3-0.45,0.4-0.5,0.4-0.8,0.5-0.7,0.5-1.8,0.6-1.1,0.6-4,0.7-1.5,0.8-1.2,1-2.7,1-3.5,1.5-2.0,1.6-3.2,10-12,2-17,2-3-branched,2-locular,3,5-25,acute,articulated,basioscopically,bilaterally,bright,brown,calyx,cm,conical,decurrent,deep,deeply,densely,diameter,exserted,glandular-villous,globose,green,hair-like,halfway,herb,imparipinnate,interrupted,linear,lobed,long,minute,minutely,mm,oblique,obovate,occasionally,orange,outgrowth,ovate,pale,pentagonal,perennial,pubescent,rounded,simple,somewhat,straight,symmetric,thick,wide,yellow	middle,na
195	wfo-0001028075	success	196	83	46	63	133	20	43	3	1.5-2.5,1.5-7,1.6-2.7,10-35,2-6,2.5-10,3-11,3-23.5,5-14,5-17,5-7,5-8,5-9,7-13,7-30,8-12,anther,blade,chartaceous,ciliate,cm,corolla,dark,diameter,filament,flower,forked,fruit,glabrescent,glabrous,globose,green,greenish,herb,homostylous,lanceolate,lateral,leaf,leaflet,light,long,margin,membranous,mm,mucilaginous,odd-pinnate,ovoid,pale,pedicel,peduncle,pentagonal,plant,rotate,seed,size,stigma,style,terminal,tuber,white,whitish,wide,x	.5,1-10,1-2,1-2.7,1-3,2-3,2-4.5,4-12,4-7,5-12,5-merou,abaxially,absent,acuman,acumen,acuminate,acute,adaxially,ag,along,alyx,apart,apex,apparently,articulated,axe,axillary,base,berry,borne,broadly,brownish,bud,capitat,cell,condition,connivent,covering,cuneate,decreasing,differentiated,digestion,distal,distally,distinctively,dorsally,dot,drying,eaf,edge,eed,elliptic-lanceolate,end,enzyme,erec,especially,exceeding,flat,folded,fresh,geminat,generally,glabrescen,green-white,hair-like,half,honeycomb-shaped,interjected,larger,lengthening,ligulate,living,lobe,lower,make,middl,midrib,minutely,much,narrow,nflorescence,oblique,obtuse,often,orolla,ovate,ovate-elliptic,pair,perfect,petiole,petiolule,plurifoliate,pore,poricidal,puberulent,purple,reflexed,removed,rounded,ruit,scattered,seudostipule,singly,slightly,slit,sometimes,spaced,specimen,stamen,star,stolo,straight,subcordate,subtending,tall,tamen,tem,testal,thick,throughout,tip,toward,tri-,tube,typically,unit,usually,vary,wall,wet,wing,yellow,ympodial	arrangement,calyx,capitate,colour,erect,form,growth,height,history,inflorescence,length,life,ovary,presence,present,pseudostipule,shape,stem,surface,texture	1.5-2.5,1.5-7,1.6-2.7,10-35,2-6,2.5-10,3-11,3-23.5,5-14,5-17,5-7,5-8,5-9,7-13,7-30,8-12,chartaceous,ciliate,cm,dark,forked,glabrescent,glabrous,globose,green,greenish,herb,homostylous,lanceolate,light,long,membranous,mm,mucilaginous,odd-pinnate,ovoid,pale,pentagonal,rotate,white,whitish,wide,x	capitate,erect,present
196	wfo-0001028076	success	195	148	97	119	76	29	93	4	.5,0.5,1-1.3,1-10,1-2,1.2-2.2,1.8-2.2,110,12-22,13-14,2-5.4,2.2-2.6,2.2-3.7,2.5-4,2.6-3.8,4-5,4.5-7,5,5-20,5-6,5-6.5,7-8,abaxially,absent,acuminate,adaxially,anther,apart,apex,articulated,attenuate,axillary,base,berry,blade,borne,brownish,bud,chartaceous,ciliate,cm,condition,conical,connivent,corolla,densely,diameter,distal,dorsally,drying,edge,end,filament,flat,flower,folded,forked,fresh,fruit,generally,glabrous,green,green-white,greenish,half,herb,homostylous,interjected,lanceolate,lateral,leaf,leaflet,less,light,lobe,long,margin,medium,membranous,minute,mm,mucilaginous,odd-pinnate,ovoid,pedicel,peduncle,pentagonal,petiole,plant,proximal,pubescent,purple,rarely,ripe,rotate,seed,sessile,singly,size,slightly,stem,stigma,straight,style,subsessile,subtending,symmetrical,terminal,throughout,tube,tuber,typically,usually,wet,whitish,wide,wing,x,yellow	0.4-0.5,1-3,2-12,2-3,2.5-3,5-merou,?,acumen,ag,alyx,apparently,axe,capitat,cell,covering,decreasing,digestion,eaf,eed,elliptic,enzyme,erec,especially,exceeding,geminat,glabrou,gradually,hair,hair-like,honeycomb-shaped,larger,lengthening,like,living,lower,make,nflorescence,obtuse,orolla,ovate,pair,perfect,petiolule,plurifoliate,pore,poricidal,pubescen,ray,removed,round,ruit,secondary,semierect,seudostipule,slit,spaced,specimen,stamen,ste,stolo,subequal,tall,tamen,tem,testal,thick,thir,tip,toward,tri-,unit,unwinged,vary,wall,white,ympodial	5-merous,abaxial,adaxial,arrangement,articulation,calyx,capitate,ciliation,colour,form,growth,height,history,inflorescence,length,life,ovary,presence,pseudostipule,shape,spacing,stolon,surface,symmetry,texture,third,type,variation,width	.5,0.5,1-1.3,1-10,1-2,1.2-2.2,1.8-2.2,110,12-22,13-14,2-5.4,2.2-2.6,2.2-3.7,2.5-4,2.6-3.8,4-5,4.5-7,5,5-20,5-6,5-6.5,7-8,abaxially,absent,acuminate,adaxially,apart,articulated,attenuate,axillary,berry,borne,brownish,bud,chartaceous,ciliate,cm,condition,conical,connivent,densely,distal,dorsally,drying,end,flat,folded,forked,fresh,generally,glabrous,green,green-white,greenish,half,herb,homostylous,lanceolate,less,light,long,margin,medium,membranous,minute,mm,mucilaginous,odd-pinnate,ovoid,pentagonal,plant,proximal,pubescent,purple,rarely,ripe,rotate,sessile,singly,slightly,straight,subsessile,subtending,symmetrical,terminal,throughout,typically,usually,wet,whitish,wide,x,yellow	5-merous,capitate,stolon,third
197	wfo-0001028105	success	150	97	66	76	74	21	64	2	.5,0.3-1.5,0.5-2,0.6-1,1-1.2,1-1.5,1.5,1.5-1.8,2,2-2.2,3-5-celled,3-6,5-7-flowered,9.5-15,abaxially,acuminate,adaxially,anther,apex,attenuate,axil,base,berry,bilobed,calyx,clavate,cm,conical,corolla,dark,dense,dia,difoliate,elliptic,filiform,flattened-reniform,fruiting,glabrous,glandular,globose,green,incrassate,leaf,lobed,long,margin,minutely,mm,nearly,opposite,ovary,pedicel,petiole,pitted,pubescent,reddish-brown,shaped,shrub,simple,size,slightly,small,stem,stigma,style,surface,tear-drop,tip,tree,trichome,tuft,uniseriate,unit,vein,white,x	.1,.4,0.5,0.5-1,1-2.5,1.5-2,1.5-4.5,2-5,3.5-4,6-7,acute,anthesi,apar,apical,axi,ba,bark,deflexed,differing,distinct,drying,eaf,edicel,eed,ellipsoid,erect,evenly,exserted,filament,free,geminat,greenish-yello,lamina,lateral,like,lobe,lon,lower,main,major,middle,minor,nflorescence,occasionally,older,olive-green,pair,pale,papillo,papillose,planar,pore,poricidal,portion,projection,quadrate,reflexed,ruit,scar,scattered,spaced,sparsely,spreading,straight,strongly,tall,tub,tube,ud,widest,woody,yellowish,ympodial,young	arrangement,characteristic,colour,diameter,form,fruit,geminate,growth,height,history,inflorescence,length,life,lobing,peduncle,plant,seed,shape,sympodial,texture,type	.5,0.3-1.5,0.5-2,0.6-1,1-1.2,1-1.5,1.5,1.5-1.8,2,2-2.2,3-5-celled,3-6,5-7-flowered,9.5-15,abaxially,acuminate,adaxially,apex,attenuate,axil,base,berry,bilobed,clavate,cm,conical,dark,dense,dia,difoliate,elliptic,filiform,flattened-reniform,glabrous,glandular,globose,green,incrassate,leaf,lobed,long,margin,minutely,mm,nearly,opposite,pitted,pubescent,reddish-brown,shaped,shrub,simple,slightly,small,tear-drop,tip,tree,trichome,tuft,uniseriate,unit,vein,white,x	geminate,sympodial
198	wfo-0001028109	success	202	108	76	91	111	17	75	1	-7,0.4-0.8,0.4-1.5,0.45-0.65,0.5-1.2,0.6-0.8,0.8-1.5,0.8-1.6,1.5-2.5,1.5-5.5,12-40,2-4,2.3-2.9,2.5-5,2/3-3/4,20-60,3-4-13,3-7,5-13-20,abaxial,acuminate,acute,adaxial,almost,anther,apex,articulated,bark,base,berry,bright,calyx,cm,connivent,cuneate,curved,deltate,densely,diameter,dull,elliptic,entire,erect,evenly,flattened-reniform,fruit,fruiting,glabrescent,glabrous,gray-green,green,green-brown,leaf,length,light,lobed,long,margin,maturity,mauve,mm,moderately,occasionally,orange-brown,pedicel,peduncle,petiole,poricidal,prickle,recurved,red,red-brown,shrub,simple,small,sometimes,spherical,stellate,stellate-pubescent,straight,style,tapering,tip,tree,unarmed,way,weakly,white,wide,yellow,young	.5,/3,0.05-0.15,0.05-0.2,0.1,0.1-0.2,0.3,0.5-2.5-4,0.7,1.5-10,1/8-1/4,10-25,10-30,15-100,2-15,2.5-3,3.5-6,3/4,30-150,4-5-merous,5-30,8-12,8-15,8-25,abaxially,acut,alyx,ame,apar,apart,apically,apparently,blade,branching,brow,c.,chartaceous,dimorphic,discolorous,drying,eaf,eed,elongating,equal,filament,flower,free,fully,geminate,gently,glabrou,infructescence,lateral,lobe,long-styled,longer,lower,mature,midpoint,minor,multangulate,nflorescence,obtuse,older,one,open,opening,orolla,oung,pair,per,perfec,pericarp,perpendicular,plurifoliat,porrect,portion,prickl,prickly,primary,ray,reflexed,ruit,scar,secondary,sessile,slender,smooth,spaced,spreading,stalk,stalked,stem,strongly,surface,tamen,terete,terminal,tertiary,time,trichome,tube,unarme,unit,usually,vary,vein,venation,visible,woody,ympodial	brown,colour,corolla,form,growth,hair,height,inflorescence,ovary,plant,seed,shape,size,staman,texture,type,width	-7,0.4-0.8,0.4-1.5,0.45-0.65,0.5-1.2,0.6-0.8,0.8-1.5,0.8-1.6,1.5-2.5,1.5-5.5,12-40,2-4,2.3-2.9,2.5-5,2/3-3/4,20-60,3-4-13,3-7,5-13-20,acuminate,acute,almost,articulated,base,berry,bright,cm,connivent,cuneate,curved,deltate,densely,diameter,dull,elliptic,entire,erect,evenly,flattened-reniform,glabrescent,glabrous,gray-green,green,green-brown,light,lobed,long,maturity,mauve,mm,moderately,occasionally,orange-brown,poricidal,recurved,red,red-brown,shrub,simple,small,sometimes,spherical,stellate,stellate-pubescent,straight,tapering,tip,tree,unarmed,way,weakly,white,wide,yellow,young	brown
199	wfo-0001028115	success	159	117	83	94	65	23	81	2	.6,0.42,0.7-0.8-1.1,1-3,1.1-1.8,1.4-1.7,1.7-2.2,2-3.2,2.5-3-4.5-5.2,3-5,4.7-5-8.5,5-15,6-10,9-17,abaxially,abundant,acute,adaxially,alternate,annular,anther,antrorse,apex,attenuate,basal,base,berry,blue,calyx,capitate,cm,diameter,ellipsoidal,elliptical,embryo,entire,especially,filament,glabrescent,glandular,globose,half,herb,herbaceous,length,light,linear,lobe,long,longitudinally,margin,mixed,mm,moderately,narrowly,nerve,non-glandular,oblong,one,opposite,ovate,pair,pale,petiole,pinnatifid,pinnatipartite,pinnatisect,prostrate,pubescent,rarely,ridged,scarce,seed,segment,similar,simple,slender,small,stem,stigma,style,trans-ovoidal,triangular,trichome,tube,tuberculate,unequal,unifoliate,uniseriate,violet,wide,winged,x,yellow	.2,0.2-0.3,0.5,0.6-0.7,0.8-1-2.4,1.1-1.8-2.5,1.3-1.8,1.8-3.5,12-13.5,2-3-6.5,7-7.5,accrescent,acuminat,ag,amply,articulate,blade,campanulate,coat,connectival,curved,difoliat,dorsal,eaf,eed,evident,exceeding,fruiting,glabrous,growing,hig,inflated,longer,longitudinal,lower,much,multi-seeded,near,opening,orolla,papery-scarious,papillo,pore,poricidal,portion,prolongation,ree,reticulate,ruit,slightly,slit,smooth,sometimes,strongly,styl,subsessil,tem,time,tip,unit,vary,venation,wider,width,ympodial	acuminate,arrangement,characteristic,colour,corolla,difoliate,form,fruit,growth,height,history,inflorescence,leaf,life,number,ovary,per,plant,shape,size,surface,texture,type	.6,0.42,0.7-0.8-1.1,1-3,1.1-1.8,1.4-1.7,1.7-2.2,2-3.2,2.5-3-4.5-5.2,3-5,4.7-5-8.5,5-15,6-10,9-17,abaxially,abundant,acute,adaxially,alternate,annular,antrorse,attenuate,basal,berry,blue,capitate,cm,ellipsoidal,elliptical,entire,especially,filament,glabrescent,glandular,globose,half,herb,herbaceous,light,linear,long,longitudinally,mixed,mm,moderately,narrowly,nerve,non-glandular,oblong,one,opposite,ovate,pair,pale,pinnatifid,pinnatipartite,pinnatisect,prostrate,pubescent,rarely,ridged,scarce,seed,segment,similar,simple,slender,small,stem,trans-ovoidal,triangular,trichome,tuberculate,unequal,unifoliate,uniseriate,violet,wide,winged,x,yellow	acuminate,difoliate
200	wfo-0001028131	success	207	127	86	103	104	24	84	2	.5,/5,0.1-0.3,0.2-1.5,0.3-0.7,0.4-0.8,0.5-1.1,0.7-1.1,0.8-1,0.8-1.1,1.5-3,1.8-2.2,1/5,2-2.8,2-6.5,3-6,4-6,5-6.5,absent,anther,apex,apparently,articulated,attenuate,bark,base,berry,branched,calyx,cell,chartaceous,cm,concolorous,connivent,cream,dark,densely,diameter,drying,dull,erect,filament,flattened-reniform,fruit,fruiting,glabrescent,green,herb,lateral,leaf,length,like,lobed,long,margin,marking,maturity,mauve,membranous,mm,narrow-obovate,narrow-ovate,obtuse,orange,orange-brown,outline,pair,pale,pale-brown,pedicel,peduncle,petiole,pit,poricidal,prickly,primary,purple,raised,red,rounded,shiny,simple,small,smooth,sparsely,spherical,spreading,stellate-pubescent,stem,style,surface,tapering,tip,tube,unarmed,upper,vein,visible,way,wide,yellow,yellow-green,young	.1,0-0.6-1.2,0-2,0-3,0-30,0-4,0.05-0.2,0.1-0.15,1-10,1-3,1-4,1-5,1.5-5,1.8-2,1/4-2/3,2-4,2-5,2/3,5-8,5-merous,6-7,7-8,abaxial,abaxially,acuminat,adaxial,alyx,apar,apart,apically,blade,broad-deltate,curved,deltate,difoliate,distance,eaf,eed,elongating,epidermi,equal,extending,eye,filiform,flattened,flower,free,geminat,glabrous,gland,infructescence,lanceolate,lengt,lobe,longer,lower,mature,midpoint,midvein,moderately,naked,nflorescence,oblong,often,older,one,open,orolla,oung,pale-gra,pendulous,per,perfec,pericarp,porrect,portion,prickl,prickle,ray,reduced,reflexed,ruit,scar,sessil,sessile,shorter,side,sometimes,spaced,stellate,straight,strongly,sunk,tamen,terete,tertiary,time,trichome,unarme,unit,vary,venation,woody,ympodial	arrangement,branch,characteristic,colour,corolla,exertion,form,glabrousnes,growth,height,history,inflorescence,life,lobing,new,ovary,pale-gray,perennial,plant,seed,shape,size,texture,type	.5,/5,0.1-0.3,0.2-1.5,0.3-0.7,0.4-0.8,0.5-1.1,0.7-1.1,0.8-1,0.8-1.1,1.5-3,1.8-2.2,1/5,2-2.8,2-6.5,3-6,4-6,5-6.5,absent,apparently,articulated,attenuate,base,berry,branched,cell,chartaceous,cm,concolorous,connivent,cream,dark,densely,diameter,dull,erect,flattened-reniform,glabrescent,green,herb,lateral,like,lobed,long,marking,maturity,mauve,membranous,mm,narrow-obovate,narrow-ovate,obtuse,orange,orange-brown,outline,pair,pale,pale-brown,pit,poricidal,prickly,purple,raised,red,rounded,shiny,simple,small,smooth,sparsely,spherical,spreading,stellate-pubescent,stem,tapering,tip,unarmed,upper,visible,way,wide,yellow,yellow-green,young	pale-gray,perennial
201	wfo-0001028148	success	157	93	58	67	90	26	56	2	-6,0.25-0.5,1-15,1-3.5,1.5,12-15,2-7,2.5-4,3.5-4,5-20,5-7,acute,angled,apart,apex,base,blue-black,branched,calyx,chartaceous,cm,dark,decurrent,deltate,diameter,elliptic,entire,except,fruit,glaucous,globose,less,light-colored,margin,mature,minute,mm,narrowly,obtuse,orange,ovate,pedicel,peduncle,petiole,pink,plicate,puberulence,purple,rachi,rhizomatous,ridge,ripe,rotate-stellate,scalloped,shrub,simple,smooth,sparse,stigma,style,surface,tapered,treelet,violet,whitish,x,yellow	.5-4,0.5-1.5,0.6-3.5,0.75-2,1.5-2.5,10-30,15,2,2-3,20-50,3.5-9,4-10,4.5-10,5,5-10,5-8,6-18,abaxially,absen,adaxially,aggregate,apiculate,articulated,axe,ba,blade,broadly,cell,central,connivent,cylindrical,densely,directed,distal,distall,eaf,eed,especially,fleshy,flower,fresh,glabrous,hair,highly,lobe,long,lower,many-foliat,margi,material,midrib,moderately,nflorescence,nther,often,orolla,part,perfect,plicae,pore,puberulent,puberulent-pubescent,radiu,rarely,ruit,slender,slightly,smoot,sometimes,spaced,star,stone,succulent,tal,tem,thickened,time,tip,triangular,truncat,tube,unbranched,unit,usually,vary,white,wide,winge,ympodial,young	0.5-4,anther,arrangement,characteristic,colour,corolla,form,glabrousnes,growth,height,history,inflorescence,leaf,length,life,new,ovary,plant,seed,shape,size,spacing,stem,texture,truncate,type	-6,0.25-0.5,1-15,1-3.5,1.5,12-15,2-7,2.5-4,3.5-4,5-20,5-7,acute,angled,apart,apex,blue-black,branched,chartaceous,cm,dark,decurrent,deltate,elliptic,entire,except,glaucous,globose,less,light-colored,margin,mature,minute,mm,narrowly,obtuse,orange,ovate,pink,plicate,puberulence,purple,rhizomatous,ridge,ripe,rotate-stellate,scalloped,shrub,simple,smooth,sparse,tapered,treelet,violet,whitish,x,yellow	0.5-4,truncate
202	wfo-0001028161	success	124	73	52	60	64	13	52	0	.5,0.1-0.25,0.7-1.7,1-1.3,1-1.5,1-2.3,2-5-flowered,2-9,2.5-3,3-4,3-7,4-5,abaxially,acuminate,acute,adaxially,apex,attenuate,bark,base,berry,branched,cell,closely,cm,dendritic,densely,dia,elliptic,globose,incrassate,lanceolate,leaf,like,long,margin,minor,minutely,mm,narrowly,outline,ovoid-reniform,pale,pedicel,petiole,pitted,pubescent,reddish-brown,shape,shrub,simple,sinuate,size,somewhat,sparsely,stem,surface,tan,trichome,x	0.25-0.5,1-2,1.5-4.5,1/3,6-9,7.5-12,9-11,along,anthesi,arising,ba,branch,brown,calyx,congested,consisting,corolla,deflexed,denser,differing,difoliate,distal,eaf,edicel,eed,exserted,fruiting,geminat,glabrescen,green,inflorescenc,later,lateral,lon,main,major,middle,nflorescence,obovoid,often,older,opposite,orbicular,overlappin,pair,probably,pubescence,rest,rounded,ruit,scar,short,spaced,strongly,tall,tapering,thin,tub,ud,unit,vein,widest,ympodial,young	characteristic,colour,diameter,form,fruit,growth,height,inflorescence,length,plant,seed,texture,type	.5,0.1-0.25,0.7-1.7,1-1.3,1-1.5,1-2.3,2-5-flowered,2-9,2.5-3,3-4,3-7,4-5,abaxially,acuminate,acute,adaxially,attenuate,base,berry,branched,cell,closely,cm,dendritic,densely,dia,elliptic,globose,incrassate,lanceolate,leaf,like,long,margin,minutely,mm,narrowly,outline,ovoid-reniform,pale,pitted,pubescent,reddish-brown,shrub,simple,sinuate,somewhat,sparsely,stem,tan,trichome,x	
203	wfo-0001028164	success	196	132	95	108	88	24	92	3	/4,0.3-0.8,0.4-0.8-1,0.5-0.8,0.5-1,0.7-1.1,0.8-1.5,0.9-1.6,1-1.5,1-4.5,1.8-2.5,1/3,2.5-4.5,2.5-4.5-6,2.8-4,3-17,3.6-4.8,abaxially,acuminate,acute,anther,apex,apically,apparently,articulated,attenuate,bark,base,berry,branched,bright,calyx,cm,concolorous,connivent,dark,deltate,densely,diameter,drying,dull,elliptic,entire,erect,evenly,filament,flattened-reniform,fruit,fruiting,glabrescent,glabrous,glandular,gray,green,hair,lateral,leaf,length,lobe,long,margin,maturity,mauve,membranous,midvein,minute,mm,moderately,multangulate,obtuse,orange-brown,pale,pedicel,peduncle,petiole,poricidal,recurved,red,red-brown,sessile,shallowly,shrub,simple,sometimes,sparsely,spherical,spreading,stalked,stellate-pubescent,stem,style,surface,tapering,terete,terminal,tip,trichome,tube,unarmed,undulate,upper,variously,way,white,wide,yellow,yellow-green,young	-14,-8,0-20,0.05-0.2,0.05-1.5,0.1,1,1.5-2.5,1/6-1/4,12-20,2-2.5,2.5-4,3-7,4-13,4-5-merous,4-7,4-8,6-8,8-15,8-17,abaxial,almost,alyx,ame,apar,blade,c.,curved,difoliate,eaf,eed,elongating,equal,eye,filiform,flower,free,geminat,glabrescen,glabrou,infructescence,less,lobed,long-acuminat,longer,lower,mature,midpoint,naked,narrow-deltate,nflorescence,often,older,one,open,orolla,oung,pair,per,perfec,pericarp,porrect,portion,primary,ray,reflexe,ruit,scar,shorte,shorter,side,smooth,spaced,stalk,stellate,straight,tamen,tertiary,time,unarme,unit,vary,vein,venation,visible,woody,yellow-gra,ympodial	arrangement,branch,characteristic,colour,corolla,exertion,form,glabrousnes,growth,height,inflorescence,lobing,long-acuminate,na,new,ovary,plant,seed,shape,size,stigma,texture,type,yellow-gray	/4,0.3-0.8,0.4-0.8-1,0.5-0.8,0.5-1,0.7-1.1,0.8-1.5,0.9-1.6,1-1.5,1-4.5,1.8-2.5,1/3,2.5-4.5,2.5-4.5-6,2.8-4,3-17,3.6-4.8,abaxially,acuminate,acute,apically,apparently,articulated,attenuate,base,berry,branched,bright,cm,concolorous,connivent,dark,deltate,densely,diameter,drying,dull,elliptic,entire,erect,evenly,flattened-reniform,glabrescent,glabrous,glandular,gray,green,hair,lateral,lobe,long,maturity,mauve,membranous,midvein,minute,mm,moderately,multangulate,obtuse,orange-brown,pale,poricidal,recurved,red,red-brown,sessile,shallowly,shrub,simple,sometimes,sparsely,spherical,spreading,stalked,stellate-pubescent,surface,tapering,terete,terminal,tip,trichome,unarmed,undulate,upper,variously,way,white,wide,yellow,yellow-green,young	long-acuminate,na,yellow-gray
204	wfo-0001028180	success	147	119	90	98	49	21	85	5	.5,/2,1-1.2,1-1.5,1-1.8,1-3,15-28,2-2.2,2-3,2.5-3,20-30-flowered,3-4,5-6,5-8,7,abaxially,acute,adaxially,along,anther,anthesi,apex,attenuate,bark,base,berry,calyx,capitate,closely,cm,conical,corolla,cucullate,dark,darker,densely,dia,distinctly,drying,elliptic,elongate,erect,falcate,fleshy,four-angled,fruiting,glabrous,globose,golden,green,larger,lateral,leaf,lobe,lobed,long,main,margin,midrib,minutely,mm,nearly,onto,ovary,ovoid-reniform,pale,papillose,pedicel,petiole,pinkish-white,pitted,planar,puberulent,pubescent,shaped,shiny,simple,size,small,somewhat,spaced,sparsely,stem,stigma,style,surface,tan,tear-drop,tip,tree,trichome,uniseriate,vein,way,white,winged,x,yellow-gray	.05,0.7-1,1.5-5,3-10,4.5-5,8-10,ba,beginning,c.,deflexed,deltate,differing,difoliate,eaf,eed,filament,free,geminat,glabrat,gold,irregularly,know,leathery,lon,lower,major,minor,nflorescence,obscure,older,opposite,overlappin,pair,pore,poricidal,portion,ruit,scar,straight,styl,tall,thick,tube,ud,underside,unit,woody,ympodial,young	bud,characteristic,colour,diameter,form,fruit,glabrate,growth,height,history,inflorescence,known,length,life,lobing,overlapping,plant,seed,shape,texture,type	.5,/2,1-1.2,1-1.5,1-1.8,1-3,15-28,2-3,2.5-3,20-30-flowered,3-4,5-6,5-8,7,abaxially,acute,adaxially,along,anthesi,attenuate,base,berry,capitate,closely,cm,conical,cucullate,dark,darker,densely,dia,distinctly,drying,elliptic,elongate,erect,falcate,fleshy,four-angled,glabrous,globose,golden,green,larger,lateral,lobe,lobed,long,main,margin,midrib,minutely,mm,nearly,onto,ovoid-reniform,pale,papillose,petiole,pinkish-white,pitted,planar,puberulent,pubescent,shaped,shiny,simple,small,somewhat,spaced,sparsely,style,surface,tan,tear-drop,tip,tree,trichome,uniseriate,vein,way,white,winged,x,yellow-gray	-2.2,di,glabrate,known,overlapping
205	wfo-0001028182	success	150	110	69	80	70	30	65	4	.5,0.1-0.2,0.5-0.6,0.5-1,0.8-1,0.9-1,1-1.5,2-2.5,2-6.5,3-5,4-6,6-9,anther,apex,arching,bark,base,beneath,branch,calyx,capitate,ciliate,cm,conical,cordate,corolla,deflexed,ellipsoid,filament,filiform,glabrous,globose,inflorescence,later,lateral,lax,leaf,like,lobed,long,long-acuminate,main,margin,minutely,mm,narrowly,nearly,obovoid,ovary,ovate,pair,papillose,pedicel,petiole,pore,poricidal,pubescent,scar,shaped,shiny,shrub,simple,slender,somewhat,sparsely,stem,stigma,style,surface,tear-drop,tip,trichome,truncate,tube,uniseriate,vein,white,x,young,zig-zag	0-90,0.5,2,3,5-15-flowered,5-ribbed,along,anthesi,apart,apiculae,apiculate,axi,bending,black,blade,brown,deltoid,densely,dia,dry,eaf,edicel,eed,evenly,except,extreme,flower,free,gre,hemiepiphyte,internodal,keeled,know,known,less,lobe,lower,material,midrib,minute,nflorescence,older,opposite,papillo,planar,portion,present,prominent,proximal,purplish,reflexed,rib,rounded,ruit,sca,slightly,spaced,sparser,specimen,spindly,still,strongly,tapering,third,time,ud,unifoliat,unit,widest,ympodial	arrangement,bud,characteristic,colour,diameter,exertion,form,fruit,glabrousnes,grey,growth,height,hemicryptophyte,history,length,life,lobing,na,new,number,peduncle,per,plant,primary,seed,shape,size,texture,type,unifoliate	.5,0.1-0.2,0.5-0.6,0.5-1,0.8-1,0.9-1,1-1.5,2-2.5,2-6.5,3-5,4-6,6-9,arching,base,beneath,capitate,ciliate,cm,conical,cordate,deflexed,ellipsoid,filiform,glabrous,globose,later,lateral,lax,like,lobed,long,long-acuminate,main,minutely,mm,narrowly,nearly,obovoid,ovate,pair,papillose,pedicel,pore,poricidal,pubescent,scar,shaped,shiny,shrub,simple,slender,somewhat,sparsely,stem,surface,tear-drop,tip,trichome,truncate,uniseriate,vein,white,x,young,zig-zag	grey,hemicryptophyte,na,unifoliate
206	wfo-0001028183	success	235	129	84	100	135	29	79	5	-10,0.2-0.5,0.5-2.5,0.7-1.2,0.7-2,1.1-1.8,1.2-1.4,1.3-1.4,1.3-1.7,1.7-2.7,10-15,11-30,2-4.2,2-5,4.5-9,5.2-6.2,6.6-20,9-13,adaxially,along,anther,apart,apex,attenuate,axi,bark,base,berry,blunt-tipped,branch,branched,bud,calyx,capitate,central,closely,cm,corolla,cuneate,deltoid,diameter,drying,dull,elliptic,elongated,entire,exserted,filament,flower,fruit,fruiting,glabrescent,glabrous,globose,lanceolate,leaf,many,margin,midrib,mm,narrowly,nearly,oblong,obovoid,orangish-tan,ovate-lanceolate,pedicel,peduncle,petiole,pseudoterminal,pubescent,purple,reticulate-punctate,ripe,scabrous,shrub,side,simple,soon,spaced,sparingly,spherical,stem,stigma,streak,style,sub-lenticular,subcampanulate,surface,tan,terete,time,tomentose,tree,tube,vein,violet,white,x,yellowish	.5-3,0.1,0.1-0.2,0.1-0.4,0.1-0.9,0.2-0.3,0.2-0.4,0.5,0.6,0.8-1.4,0.8-3.1-5.3,1.4-2.8,1.5-3.4,1.6-2.3,1.9-3.7,1/3-1/2,2.2-5.7,2.5-4.1,2.6-4.4,2.8-4.2,3.2-4.6-6.4,3.5-6.6,5-8,5-8.5,50-400,7.5-23,8-9.1,abaxial,abaxially,accrescent,acute,ag,alyx,anthesi,apparently,around,articulated,axillary,blade,brown,cell,chartaceous,cylindrical,dark,dendritic-multangulate,directed,distally,distantly,eaf,earl,edge,eed,epidermal,especially,evident,except,farinose,few-rayed,free,glabrescen,granular-punctate,group,hair,half,high,inserted,lackin,lateral,lengthening,lobe,lobed,lon,long,long-decurrent,longitudinal,lower,m.,main,multangulate,nflorescence,older,open,orolla,overlapping,perfec,plurifoliate,pore,poricidal,porrect-stellat,porrect-stellate,present,prominent,pubescence,rachi,rarely,relatively,reportedly,ruit,runk,sessile,short,short-,slit,small,somewhat,sparse,splitting,stage,stalk,stamen,stellate,stipitate-glandular,stout,strongly,suture,tamen,thick,thin,thin-textured,tip,touching,translucent,ud,unarme,unit,upper,usually,vary,way,whitish,wide,yellow,yellowish-tomentose,ympodial,young	3.2-6.4,arrangement,characteristic,colour,exertion,form,glabrousnes,growth,height,history,inflorescence,length,life,lobing,na,new,number,ovary,per,perennial,plant,primary,seed,shape,size,sparely,texture,type,unarmed	-10,0.2-0.5,0.5-2.5,0.7-1.2,0.7-2,1.1-1.8,1.2-1.4,1.3-1.4,1.3-1.7,1.7-2.7,10-15,11-30,2-4.2,2-5,4.5-9,5.2-6.2,6.6-20,9-13,adaxially,along,apart,attenuate,axi,berry,blunt-tipped,branched,calyx,capitate,central,closely,cm,cuneate,deltoid,diameter,dull,elliptic,elongated,entire,exserted,flower,fruit,glabrescent,glabrous,globose,lanceolate,many,midrib,mm,narrowly,nearly,oblong,obovoid,orangish-tan,ovate-lanceolate,pseudoterminal,pubescent,purple,reticulate-punctate,ripe,scabrous,shrub,side,simple,soon,spaced,sparingly,spherical,streak,sub-lenticular,subcampanulate,tan,terete,time,tomentose,tree,violet,white,x,yellowish	3.2-6.4,na,perennial,sparely,unarmed
207	wfo-0001028227	success	235	131	91	107	128	24	89	2	0.2-0.3,0.2-0.4,0.8-1.4,0.9-1.2,1-1.7,1-4.2-6.2,1.2-2,1.3-4,1.4,1/2,1/2-3/4,10,10-24,11-15,2-12,2.5-7.8,3.7-7,4.8-7.6,6.7-15,abaxially,acuminate,acute,adaxially,anther,anthesi,apex,attenuate,bark,base,berry,blunt-tipped,branch,branched,brown,brownish,bud,c.,calyx,cm,corolla,cuneate,dark,decurrent,deltoid,diameter,early,elliptic,elongate,ength,entire,exserted,filament,fleshy,fruit,glabrous,globose,granular-tomentose,gray,green,leaf,less,lobe,long,many,margin,midrib,mm,oblong,oblong-lanceolate,obtuse,orangish-tan,orbicular,ovate-lanceolate,pale,pedicel,peduncle,petiole,pseudoterminal,pubescent,purple,reticulate-punctate,ripe,scabridulous,shrub,side,simple,slightly,sparsely,stem,stigma,style,subcampanulate,sublenticular,subspherical,sulcate,surface,time,tomentose,tree,tube,vein,velutinous,violet,way,x,yellow,yellowish	-2/3,.5-4,0-250,0.1,0.2,0.2-0.5,0.3,0.4,0.5,0.7-2.1,0.8,0.9,0.9-1.4,1,1-2.5,1.1-3.1,1.4-2.6,1.5-2.3,1.7-2.8,1.9,1.9-4.2,1.9-5.8,2-3.8,2.6-5.9,2.9-4.7,3-4.9,3.7-6.3,4-13,5-7.5,6-16,8.1-18,8.5-22,abaxial,accrescent,ag,age,along,alyx,apart,apparently,appressed,around,articulated,axillary,becoming,blade,blunt-tippe,closely,cylindrical,dendritic-echinoid,directed,distally,drying,eaf,echinoi,echinoid,edge,eed,farinose,flower,free,fruiting,glabrescent,grayish,hair,high,inserted,lacking,lanceolate,lateral,lengthening,lobed,lon,longitudinal,lower,m.,main,midvein,mostly,multangulate,nflorescence,obscured,occasionally,often,older,orolla,ovate-orbicula,overlapping,perfec,plurifoliate,pore,poricidal,porrect-stellate,present,prominent,pubescence,quarter,rachi,relatively,rounded,ruit,runk,sessile,slit,somewhat,spaced,stalk,stamen,stellate,stout,suture,tamen,thick,thicker,thin,tip,tomentu,touching,ud,unarme,unit,upper,usually,vary,well,wide,ympodial,young	arrangement,characteristic,colour,exertion,form,glabrousnes,growth,height,history,inflorescence,length,life,lobing,new,ovary,perennial,plant,primary,seed,shape,size,texture,type,unarmed	0.2-0.3,0.2-0.4,0.8-1.4,0.9-1.2,1-1.7,1-4.2-6.2,1.2-2,1.3-4,1.4,1/2,1/2-3/4,10,10-24,11-15,2-12,2.5-7.8,3.7-7,4.8-7.6,6.7-15,abaxially,acuminate,acute,adaxially,anthesi,attenuate,base,berry,blunt-tipped,branched,brown,brownish,c.,calyx,cm,cuneate,dark,decurrent,deltoid,diameter,early,elliptic,elongate,ength,entire,exserted,fleshy,fruit,glabrous,globose,granular-tomentose,gray,green,less,lobe,long,many,midrib,mm,oblong,oblong-lanceolate,obtuse,orangish-tan,orbicular,ovate-lanceolate,pale,pseudoterminal,pubescent,purple,reticulate-punctate,ripe,scabridulous,shrub,side,simple,slightly,sparsely,subcampanulate,sublenticular,subspherical,sulcate,time,tomentose,tree,velutinous,violet,way,x,yellow,yellowish	perennial,unarmed
208	wfo-0001028228	success	143	112	73	86	57	26	72	1	.5,0.1-1.7,0.75,1-1.5,1.1-1.2,1.2-1.8,1.5-2,1.8-3.4,10-30-flowered,2,2-8,2.8-6.5,3/4,6-7,6-8,7.5-12.5,abruptly,acute,age,anther,apex,area,bark,base,becoming,berry,brown,calyx,campanulate,cm,coriaceous,corolla,dark,deflexed,dia,dry,elliptic,exserted,filament,fruiting,glabrous,globose,green,greenish-yellow,lateral,leaf,lobed,long,main,margin,material,minute,minutely,mm,narrowing,obovate,occasionally,ovary,ovoid,ovoid-reniform,pair,papillose,pedicel,petiole,reticulate,rounded,shaped,shining,shrub,simple,slender,small,stem,stigma,style,surface,tapering,tear-drop,tip,tree,tube,vein,way,white,x,young	1.1-2.5,2-5,2.1-4.2,anthesi,ba,beginning,beneath,caly,clavate,closely,deltoid,difoliate,distal,eaf,edicel,eed,erect,fragrant,free,geminat,impressed,inflorescenc,lobe,lon,lower,major,middle,minor,nflorescence,older,opposite,overlapping,pale,planar,pore,poricidal,portion,prominent,ruit,scar,shinin,slightly,spaced,straight,styl,sweetly,tall,terminal,thick-margined,thickened,ud,unit,usually,weight,widest,woody,ympodial	arrangement,bud,characteristic,colour,corrugation,diameter,drying,exertion,form,fruit,growth,height,history,inflorescence,length,life,lobing,na,peduncle,plant,primary,seed,shape,size,texture,type	.5,0.1-1.7,0.75,1-1.5,1.1-1.2,1.2-1.8,1.5-2,1.8-3.4,10-30-flowered,2,2-8,2.8-6.5,3/4,6-7,6-8,7.5-12.5,abruptly,acute,age,area,base,becoming,berry,brown,calyx,campanulate,cm,coriaceous,dark,deflexed,dia,dry,elliptic,exserted,glabrous,globose,green,greenish-yellow,lateral,lobed,long,main,material,minute,minutely,mm,narrowing,obovate,occasionally,ovoid,ovoid-reniform,pair,papillose,reticulate,rounded,shaped,shining,shrub,simple,slender,small,style,tapering,tear-drop,tip,tree,tube,vein,way,white,x,young	na
209	wfo-0001028263	success	156	97	60	76	80	21	58	2	0.25,1-3,1-4,11-13,11-23,14-44,2-3,2-4,2.6,3,3.4,3.5-4.2,4,4-5,5-7,5-7.5,6,9,abaxially,adaxially,apical,apically,branched,calyx,cm,conical,corolla,cyme,darker,deep,dehiscent,diameter,dichasial,dichasially,distal,ebracteate,filament,forked,green,green-white,herbaceous,interjected,introrse,lateral,leaf,leaflet,light,long,maturing,medium,mm,monochasial,mucilaginous,odd-pinnate,often,pair,pedicel,peduncle,perennial,petiole,plant,poricidally,puberulent,pubescent,rotate,seed,short,size,slit,strigose,style,terminal,throughout,tuber-bearing,violet,wide	1-2,2,3-6-foliat,6-8,8-1.,8-14,abaxiall,acumen,acuminate,acute,apex,articulate,atenuate,base,broadly,cell,connate,cordate,covering,cuneate,digestion,diminishing,dorsally,eaf,edge,eed,elliptical,emoval,enzyme,equal,exceeding,first,flat,flower,folded,generally,globo,gradually,hair-like,half,honeycomb,living,lobe,lon,lower,lunat,make,nflorescence,nther,oblique,orolla,ovate,ovoid,pattern,perfect,plan,proximal,reveal,ruit,sessile,seudostipule,specimen,stamen,stigma,straight,tal,tem,testal,thick,throughou,toward,truncate,two,typically,unit,vary,wall,yellow,ympodial,Â¼	8-19,anther,arrangement,branching,colour,dehiscence,form,fruit,growth,height,history,inflorescence,length,life,ovary,shape,stem,surface,texture,wet,width	0.25,1-3,1-4,11-13,11-23,14-44,2-3,2-4,2.6,3,3.4,3.5-4.2,4,4-5,5-7,5-7.5,6,9,abaxially,adaxially,apical,apically,branched,cm,conical,cyme,darker,deep,dehiscent,dichasial,dichasially,ebracteate,forked,green,green-white,herbaceous,introrse,light,long,maturing,medium,mm,monochasial,mucilaginous,odd-pinnate,often,perennial,poricidally,puberulent,pubescent,rotate,short,slit,strigose,throughout,tuber-bearing,violet,wide	8-19,wet
210	wfo-0001028280	success	87	61	34	38	49	23	29	5	.5,1-2,1-2-flowered,2-2.5,2-3,acuminate,apex,arching,attenuate,bark,base,berry,ciliate,cm,completely,dark,decurrent,elliptic,flattened,fruiting,glabrous,globose,green,lanceolate,leaf,long,margin,minutely,mm,narrowly,new,pedicel,petiole,shrub,simple,stem,surface,winged	0.7-1,1.5-2.7,6-9,7-8,almost,anthesi,ape,axil,branch,brow,closely,dia,eaf,eed,immature,know,known,lateral,lon,lower,main,middle,nflorescence,older,onto,opposite,pair,papillae,pendant,present,rounded,ruit,scar,sessil,small,somewhat,spaced,tall,tip,ud,ultimate,unifoliat,unit,vein,widest,woody,x,ympodial,young	0.5,2,arrangement,brown,characteristic,colour,diameter,form,fruit,glabrousnes,growth,height,history,inflorescence,length,life,na,peduncle,plant,shape,texture,type,unifoliate	.5,1-2,1-2-flowered,2-2.5,2-3,acuminate,apex,arching,attenuate,base,berry,ciliate,cm,completely,dark,decurrent,elliptic,flattened,glabrous,globose,green,lanceolate,long,minutely,mm,narrowly,shrub,simple,winged	0.5,2,brown,na,unifoliate
211	wfo-0001028281	success	258	154	107	132	126	22	103	4	-3,-5,.2,.5,0.15-0.2,0.2-0.3,0.2-0.5-1,0.2-0.7-0.9,0.3-0.5,0.3-1,0.5-0.6,0.5-0.7,0.5-1,0.5-1.2-1.5,0.7-1.2,0.7-2.5-7,0.75-1,1,1-1.5,1-5,1.0-1.6,1.1-1.4,1.1-2.4,1.2-1.6,1.7-2.5,10-30-45,2-4,2-6.5-10,2.1-3.0,20-30,3-16-20,3-5,3-8.5,6,7-30-36,acuminate,acute,almost,anther,apex,apical,appendage,articulation,axi,base,basiscopically,bent,bract,branching,broadly,brown,calyx,capitate,cell,cm,column,conical,corolla,dark,decurrent,deep,densely,diameter,distal,doubly,elliptic,elongate,entire,extended,filament,flower,form,fruit,fruiting,glabrous,glandular,globose,golden,green,hair-like,half,head,imparipinnate,inflorescence,interrupted,lateral,leaf,leaflet,like,lobe,margin,mm,multi-cellular,narrowly,oblique,obovate,occasionally,once-branched,outgrowth,ovary,ovate,pair,pedicel,peduncle,petiolule,point,primary,proximal,pubescent,rachi,regularly,rotate,serrate,shrub,small,sometimes,sparsely,staminal,stem,sterile,stigma,strongly,style,terminal,testa,toward,trichome,tube,usually,vine,wall,yellow	+,-8,.4,0.05-0.4,0.1-0.15,0.2-0.5,0.5-1.1,0.5-1.2,0.7-1-1.5,0.8-1,1-1.5-2,1-1.5-6,1-3,1.4-4,10-18,2-13,2-4-celled,2-locular,2.5-6-15,3-foliate,5-8-celled,abaxial,abaxially,absent,adaxial,alternate,anthesi,appearance,appressed,arising,autogamous,berr,blade,bracteate,composed,covering,darker,decreasing,developed,dry,eaf,edicel,eed,eglandular,either,elongate-triangular,enclosing,exerted,exserted,fragile,free,generally,giving,gland,gree,hal,halfway,included,interjected,internode,large,largest,less,lon,long,longest,lower,material,medial,midvein,minute,mixture,multi-celled,multicellular,nflorescence,node,opposite,orbicular,other,pale,paler,patent,petiole,population,portion,present,primarily,probably,pseudostipule,rest,ruit,secondary,serrat,sessile,set,shorter,silky,size,smaller,smooth,sparser,sprawling,stiff,straight,stripe,subopposite,surface,tem,tertiary,thick,thin,three,tip,transparent,type,ud,unicellular,uniseriate,unit,vein,weak,weak-walled,well,wide,winged,ympodial	0.7-1.5,1-2,2.5-15,arrangement,bend,bud,colour,decurrence,growth,height,history,length,life,number,perennial,plant,pubescence,seed,shape,thicknes,width,wing	-3,-5,.2,.5,0.15-0.2,0.2-0.3,0.2-0.5-1,0.2-0.7-0.9,0.3-0.5,0.3-1,0.5-0.6,0.5-0.7,0.5-1,0.5-1.2-1.5,0.7-1.2,0.7-2.5-7,0.75-1,1,1-1.5,1-5,1.0-1.6,1.1-1.4,1.1-2.4,1.2-1.6,1.7-2.5,10-30-45,2-4,2-6.5-10,2.1-3.0,20-30,3-16-20,3-5,3-8.5,6,7-30-36,acuminate,acute,almost,articulation,axi,basiscopically,bent,broadly,brown,capitate,cell,cm,conical,dark,decurrent,deep,densely,distal,doubly,elliptic,elongate,entire,extended,glabrous,glandular,globose,golden,green,hair-like,half,head,imparipinnate,inflorescence,interrupted,lateral,like,mm,multi-cellular,narrowly,oblique,obovate,occasionally,once-branched,outgrowth,ovary,ovate,pair,pedicel,point,proximal,pubescent,rachi,regularly,rotate,serrate,shrub,small,sometimes,sparsely,stem,strongly,testa,toward,trichome,usually,vine,wall,yellow	0.7-1.5,1-2,2.5-15,perennial
212	wfo-0001028317	success	204	129	94	108	96	21	92	2	-1.5,0-1,0.3-0.4,0.3-1,0.5-3.5,0.6-0.8,0.6-1.2,0.6-1.5,0.8-1.1,0.8-2.5,1-1.3,1-3,1-4,1.1-1.9,1.4-2,1.8-2.5,1/5,2-2.8,2-4,2-4.5,2.5-6.5,2.8-3.3,4-6,6-10,absent,acute,almost,anther,apex,apically,apparently,articulated,bark,base,berry,branched,bright,brown,calyx,chartaceous,cm,concolorous,cream,cuneate,curved,dark,deltate,densely,diameter,drying,dull,erect,filament,flattened-reniform,fruit,fruiting,glabrous,gray,green,herb,lanceolate,lateral,leaf,length,lobe,lobed,long,lower,margin,marking,maturity,mauve,mm,moderately,oblong,obtuse,orange-brown,ovate,pale,pedicel,peduncle,petiole,poricidal,prickle,purple,red,shrub,side,simple,sometimes,sparsely,spherical,spreading,stellate-pubescent,straight,style,surface,tapering,terminal,tip,truncate,tube,upper,white,wide,yellow,yellow-green,young	-5,/5,0,0-5,0.1,0.1-0.25,0.1-0.3,0.1-0.4,1/,1/3-1/4,1/4-2/3,2/3,3-10,3-4,3-5,4-5-merous,4-8,5-8,abaxially,acuminat,alyx,apar,apart,blade,broad-deltate,brow,difoliate,distance,eaf,eed,elongating,equal,extending,eye,filiform,flower,free,geminat,hair,herbaceous,infructescence,longer,mature,midpoint,midvein,minute,naked,nflorescence,older,one,open,orolla,oung,pair,pendulous,per,perfec,pericarp,porrect,portion,prickl,prickly,primary,ray,reduced,reflexed,rounded,ruit,scandent,scar,sessile,shorter,smooth,spaced,stalk,stalked,stellate,stem,subsessile,tamen,terete,tertiary,time,toward,translucent,trichome,unarme,unarmed,unit,variously,vary,vein,venation,visible,way,ympodial	1/2,abaxial,acuminate,adaxial,arrangement,characteristic,colour,corolla,form,growth,height,inflorescence,lobing,ovary,plant,seed,shape,size,texture,type,width	-1.5,0-1,0.3-0.4,0.3-1,0.5-3.5,0.6-0.8,0.6-1.2,0.6-1.5,0.8-1.1,0.8-2.5,1-1.3,1-3,1-4,1.1-1.9,1.4-2,1.8-2.5,1/5,2-2.8,2-4,2-4.5,2.5-6.5,2.8-3.3,4-6,6-10,absent,acute,almost,apically,apparently,articulated,base,berry,branched,bright,brown,chartaceous,cm,concolorous,cream,cuneate,curved,dark,deltate,densely,diameter,drying,dull,erect,flattened-reniform,glabrous,gray,green,herb,lanceolate,lateral,length,lobe,lobed,long,lower,marking,maturity,mauve,mm,moderately,oblong,obtuse,orange-brown,ovate,pale,poricidal,purple,red,shrub,side,simple,sometimes,sparsely,spherical,spreading,stellate-pubescent,straight,tapering,terminal,tip,truncate,upper,white,wide,yellow,yellow-green,young	1/2,acuminate
213	wfo-0001028323	success	164	132	95	109	55	23	92	3	0.2-0.5,0.2-1,0.4-1.3,0.5,0.6-1,0.9-1.2,1,1-1.2,1-1.5,2-3,3,3-6,5-6,7.5-9,abaxially,absent,acute,along,anther,anthesi,apex,appressed,attenuate,bark,base,berry,blue-green,brown,c.,cm,conical,corolla,dark,dendritic,densely,diameter,drying,ellipsoid,elliptic,entire,erect,fading,filament,fleshy,flower,fruiting,glabrescent,glabrous,globose,grey,growth,included,inflorescence,internodal,leaf-opposed,lengthening,less,like,lobe,longer,main,margin,maturity,minute,minutely,mm,new,occasionally,ovary,ovoid,pair,pale,papillose,pedicel,peduncle,petiole,pitted,pore,poricidal,primary,proceed,pubescent,reddish,revolute,rounded,scattered,shiny,shoot,short,shrub,simple,sometimes,somewhat,soon,sparsely,splitting,stem,stigma,style,surface,tip,trichome,tube,uniseriate,vein,violet,way,white,x	-2,0.5-1,0.8,1-2,1.1-4.5,1.5,1.5-2.5,2-9,3-5,3.5-4,abscissio,apart,apparently,articulated,ba,calyx,capiatate,cell,coriaceous,cup-shaped,deltate,eaf,eed,free,glabrescen,lanceolate,lobed,lower,nflorescence,ovate,papillat,peg,perfect,pericarp,planar,plurifoliat,portion,remaining,ruit,scar,sinus,small,soft,sparely,straight,tearing,testal,thick,thin,tuft,ud,unit,wall,woody,ympodial	arrangement,bud,capitate,characteristic,colour,exertion,form,fruit,glabrousnes,height,history,leaf,length,life,lobing,na,papillate,plant,seed,shape,size,texture,type	0.2-0.5,0.2-1,0.4-1.3,0.5,0.6-1,0.9-1.2,1,1-1.2,1-1.5,2-3,3,3-6,5-6,7.5-9,abaxially,absent,acute,along,anthesi,apex,appressed,attenuate,base,berry,blue-green,brown,c.,cm,conical,dark,dendritic,densely,diameter,ellipsoid,elliptic,entire,erect,fading,fleshy,flower,glabrescent,glabrous,globose,grey,included,inflorescence,internodal,leaf-opposed,lengthening,less,like,lobe,longer,main,maturity,minute,minutely,mm,occasionally,ovoid,pair,pale,papillose,pitted,pore,poricidal,proceed,pubescent,reddish,revolute,rounded,scattered,shiny,shoot,short,shrub,simple,sometimes,somewhat,soon,sparsely,splitting,stem,surface,tip,trichome,uniseriate,vein,violet,way,white,x	capitate,na,papillate
214	wfo-0001028329	success	215	135	99	111	104	24	96	3	.5-3,0.2-0.3,0.8-1.4,0.9-1.3,1-6,1.3-1.8,1.5-2.3,12,2-4,3-8,4-15,5-10,6-8,abaxially,acuminate,acute,adaxially,angled,anther,anthesi,apart,apex,articulated,asperous,bark,base,becoming,berry,blunt-tipped,branch,branched,brown,calyx,chartaceous,closely,cm,conical,continued,corolla,deltoid,diameter,dichotomously,due,entire,filament,finely,fleshy,flower,fruit,glabrous,granular,granular-tomentose,gray,green,grooved,growth,honeycombed,inserted,lateral,leaf,length,long-attenuate,longitudinally,margin,minutely,mm,moderately,mostly,obelliptic,oblong,obovate,obtuse,ovate,ovate-elliptic,pale,pedicel,peduncle,petiole,pubescent,reniform,reticulate-punctate,ripe,several,short-,shrub,simple,slightly,small,sometimes,spaced,sparsely,stellate-pubescent,stellate-rotate,stelliform,stem,stigma,style,subglobose,suborbicular,time,tomentose,tree,tube,turning,unarmed,velutinous,white,whitish,x,yellow,yellowish	.75-2,.75-5.75,/10-3/10,0-100,0.8-1.1,1.0-1.4,1.1-2.5,1.3-2,1.5-2.75,1.5-3.5,1.5-8,10-34,2-3,2.2-3.9,2.6-5,2.75-4.5,3-14,3.75-7,3/4,4-5,6-11,6-9,7-19,absen,ag,apical-lateral,apparently,axe,axillary,ba,blade,bud,cylindrical,dehiscing,dendritic-echinoi,dendritic-echinoid,distantly,distinct,eaf,echinoid,eed,free,glabrescen,hair,high,introrse,large,lengthening,lobe,lobed,long,lower,main,midvein,multangulat,multangulate,nflorescence,obscured,occasional,older,orbicular,orolla,perfect,plurifoliate,pore,porrect-stellate,present,pseudo-terminal,rachi,rather,receptacle,relatively,ruit,runk,sessil,sessile,short-stalked,side,slit,sparse,stalked,stellat,stellate,subcapitat,suture,swollen,tamen,testa,thick,thickened,thin,tomentu,touching,toward,unarme,unit,usually,vary,vein,vestigial,way,wide,ympodial,young	arrangement,characteristic,colour,exertion,form,fruiting,glabrousnes,height,history,inflorescence,life,lobing,new,ovary,perennial,plant,pseud-terminal,seed,shape,size,subcapitate,surface,texture,type	.5-3,0.2-0.3,0.8-1.4,0.9-1.3,1-6,1.3-1.8,1.5-2.3,12,2-4,3-8,4-15,5-10,6-8,abaxially,acuminate,acute,adaxially,angled,anthesi,apart,apex,articulated,asperous,base,becoming,berry,blunt-tipped,branched,brown,calyx,chartaceous,closely,cm,conical,continued,deltoid,dichotomously,due,entire,finely,fleshy,flower,fruit,glabrous,granular,granular-tomentose,gray,green,grooved,growth,honeycombed,inserted,lateral,long-attenuate,longitudinally,minutely,mm,moderately,mostly,obelliptic,oblong,obovate,obtuse,ovate,ovate-elliptic,pale,pubescent,reniform,reticulate-punctate,ripe,several,short-,shrub,simple,slightly,small,sometimes,spaced,sparsely,stellate-pubescent,stellate-rotate,stelliform,stem,subglobose,suborbicular,time,tomentose,tree,turning,unarmed,velutinous,white,whitish,x,yellow,yellowish	perennial,pseud-terminal,subcapitate
215	wfo-0001028337	success	192	131	89	104	88	27	85	4	.5,.8,/3,0-6,0.3-0.5,0.4-0.8,0.7-0.9,0.7-1,1-1.8,1-2,1-3,1.8-2,2-2.2-2.5,2-4,5-25,5-6,abaxial,abaxially,adaxial,anther,apex,apically,apparently,articulated,bark,base,berry,branched,calyx,chartaceous,cm,color,connivent,cuneate,dark,deltate,densely,diameter,discolorous,drying,entire,erect,evenly,filament,flattened-reniform,flower,fruit,fruiting,glabrescent,glabrous,glaucous,gray,green,green-brown,hair,inflorescence,juvenile,known,lateral,leaf,length,lobed,long,margin,marking,mature,mauve,minutely,mm,moderately,narrow-oblong,orange-brown,pale,pedicel,peduncle,per,petiole,pitted,poricidal,prickly,reddish,rounded,shallowly,shrub,simple,smooth,sparse,spherical,stellate-pubescent,stem,strongly,style,surface,tapering,terete,terminal,tip,toward,tube,unarmed,way,white,wide,young	-4,0.05-0.15,0.05-1,0.1-0.3,0.4-0.7-2,1,1.5-3,1.5-4,1/2,1/3-2/3,1/4-1/3,1/8-1/4,11-16,15-50,3-4,4-5,5-8,5-merous,6-7,8-10,8-14,acut,alyx,apar,apart,ape,blade,conical,curved,eaf,eed,elongating,equal,eye,free,fused,gently,glabrou,gray-brown,infructescence,juvenil,lobe,long-styled,longer,lower,midpoint,naked,nflorescence,occasionally,older,one,open,orolla,oung,perfect,pericarp,plurifoliat,porrect,porrect-lepidote,portion,prickle,primary,ray,reflexed,ruit,scar,sessile,shoot,short,short-styled,shorter,slender,small,spaced,staminate,stellate,stout,straight,tamen,time,trichome,unarme,unit,usually,vary,vein,visible,ympodial	acute,arrangement,branch,characteristic,colour,corolla,exertion,form,glabrousnes,growth,height,history,life,lobing,na,new,number,ovary,perennial,plant,seed,shape,size,stigma,texture,type,ye	.5,.8,/3,0-6,0.3-0.5,0.4-0.8,0.7-0.9,0.7-1,1-1.8,1-2,1-3,1.8-2,2-2.2-2.5,2-4,5-25,5-6,abaxially,apex,apically,apparently,articulated,base,berry,branched,chartaceous,cm,color,connivent,cuneate,dark,deltate,densely,diameter,discolorous,drying,entire,erect,evenly,flattened-reniform,flower,glabrescent,glabrous,glaucous,gray,green,green-brown,hair,juvenile,known,lateral,lobed,long,marking,mature,mauve,minutely,mm,moderately,narrow-oblong,orange-brown,pale,per,pitted,poricidal,prickly,reddish,rounded,shallowly,shrub,simple,smooth,sparse,spherical,stellate-pubescent,strongly,tapering,terete,terminal,tip,toward,unarmed,way,white,wide,young	acute,na,perennial,ye
216	wfo-0001028339	success	195	121	85	97	98	24	81	4	.5,0.05-0.1,1-1.2,1-2,1-5,1.1-1.4,1.2-1.5,1.7-3.2,10-30-flowered,5-7,8182,acuminate,acute,anther,apex,appressed,bark,base,beneath,berry,blue,broadly,brown,bud,calyx,capitate,cm,corolla,covered,cuneate,cup-shaped,dark,decurrent,densely,dia,dried,enclosed,exserted,filament,filiform,flattened,fruiting,glabrate,glabrous,globose,growth,later,leaf,lobed,long,margin,minutely,mm,mustard,nearly,oblique,ovary,ovate,ovoid,ovoid-reniform,papillate,papillose,pedicel,petiole,pitted,red-brown,schwarz,shaped,shining,shrub,simple,size,slender,slightly,small,somewhat,sparsely,specimen,stem,stigma,strongly,style,surface,tapering,tear-drop,texture,tip,tree,trichome,tube,uniseriate,urceolate,vein,white,white-speckled,winged,yellow	0.8-1.2,1-1.5,1.5,1.5-2,10.2-18.5,2.5-5,3.4-5.5,3.5-4,43191,5-angled,5.8-7.9,7-11,8-10,across,almost,anthesi,appearance,appearing,attenuate,becoming,carinate,carpel,closely,connate,crystalline,deflexed,differing,difoliate,distinctly,dry,eaf,edicel,eed,epidermi,erect,evenly,fide,first,floccose,flower,free,frui,geminat,grainy,greyish-brown,irregular,large-celled,lateral,leave,like,little,lobe,lon,long-triangular,lower,main,major,middle,minor,nee,nflorescence,obscure,occasionally,older,one,opposite,overlappin,papery,planar,pore,poricidal,portion,proximal,pulp,reflexed,ruit,scar,secondary,septum,spaced,speckled,straight,strong,tall,tightly,tub,ud,unit,venation,white-lenticellat,white-papillo,wide,widest,woody,x,yellowish,ympodial,young	alternate,arrangement,characteristic,colour,diameter,exertion,form,fruit,glabrousnes,green,height,history,inflorescence,length,life,lobing,new,peduncle,plant,seed,shape,type,white-lenticellate,white-papillose	.5,0.05-0.1,1-1.2,1-2,1-5,1.1-1.4,1.2-1.5,1.7-3.2,10-30-flowered,5-7,8182,acuminate,acute,appressed,base,beneath,berry,blue,broadly,brown,bud,calyx,capitate,cm,covered,cuneate,cup-shaped,dark,decurrent,densely,dia,dried,enclosed,exserted,filiform,flattened,glabrate,glabrous,globose,later,leaf,lobed,long,margin,minutely,mm,mustard,nearly,oblique,ovate,ovoid,ovoid-reniform,papillate,papillose,pitted,red-brown,schwarz,shaped,shining,shrub,simple,slender,slightly,small,somewhat,sparsely,specimen,strongly,tapering,tear-drop,tip,tree,trichome,tube,uniseriate,urceolate,vein,white,white-speckled,winged,yellow	alternate,green,white-lenticellate,white-papillose
217	wfo-0001028351	success	175	129	68	79	96	50	63	5	.2,.8,0,0.2,1.0â2.0,2,2.0â2.5,3,3â4,40,5.0,6â12,8â15,abaxially,acute,adaxially,along,annual,anther,anthesi,apex,base,becoming,blue,branching,brown,calyx,capitate,clavate,cm,colour,densely,diameter,filament,flattened,fruit,glabrous,globose,green,herb,lanceolate,leaf,lobe,lobed,long,margin,midvein,mm,moderately,number,oblong,opposed,ovate,pale,pedicel,peduncle,perennial,petiole,pitted,pubescent,regularly,shallowly,shiny,simple,slender,sparsely,stem,stigma,style,surface,truncate,tube,unbranched,unknown,velutinous,woody,x,young,â3.0	.8â1.0,0.1,0.5,0.6,0â,1.0â,1.0â1.6,1.0â2.5,1.4â1.5,1.5â4.0,1.6â,10,2.0â5.0,2.1â3.5,2/3,2â2.5,2â4,3.4â5.0,4,5,5.0â5.5,5.5â10.5,5â7,6.5â8.5,absent,adaxiall,ag,apart,apical,articulated,axe,ba,basal,blade,cell,chartaceous,connivent,convex,cylindrical,directed,distally,eaf,eed,equal,erect,fleshy,flower,geminat,glandular,hair,indumentum,lamin,like,lon,longitudinal,lower,m.,multicellular,narrowly,nfloresence,obtuse,occasionally,opening,orolla,pair,pentagonal,perfect,plurifoliate,pore,present,probably,ruit,serrate,shaped,side,slit,smaller,spaced,stone,straight,tal,tamen,tardily,teardrop,tem,time,unicellular,uniseriate,unit,vary,white,wide,wing,winged,ympodial,â	0â2.5,1.0â4.0,1.6â5.0,appearance,arrangement,bark,border,branch,bud,characteristic,corolla,corrugation,distal,drying,exertion,form,fruiting,giving,glabrousnes,growth,height,history,inflorescence,interjected,lateral,leaflet,length,life,lobing,mentioned,midpoint,na,new,ovary,per,plant,prickle,primary,pseudostipule,ray,seed,shape,size,terminal,texture,thicknes,type,variation,vein,width	.2,.8,0,0.2,1.0â2.0,2,2.0â2.5,3,3â4,40,5.0,6â12,8â15,abaxially,acute,adaxially,along,annual,anthesi,becoming,blue,branching,brown,capitate,clavate,cm,densely,diameter,flattened,fruit,glabrous,globose,green,herb,lanceolate,leaf,lobed,long,midvein,mm,moderately,oblong,opposed,ovate,pale,perennial,pitted,pubescent,regularly,shallowly,shiny,simple,slender,sparsely,stem,truncate,unbranched,unknown,velutinous,woody,x,young,â3.0	0â2.5,1.0â4.0,1.6â5.0,mentioned,na
218	wfo-0001028353	success	177	125	89	105	72	20	89	0	/3,0.2-0.4,0.5,0.9-1.2,1,1-4,1.4-2,1.5-2,1.5-5,2,2-3,2-4,3,3-5,4-7,6-8,7,acute,along,anther,apex,base,beneath,berry,bluntly,bright,capitate,cell,centre,ciliate,clasping,cm,coarsely,conical,cordate,corolla,dark,deep,deeply,densely,diameter,ellipsoid,elliptic,emarginated,filament,fleshy,flower,fruiting,glabrous,globose,greenish,herb,heteromorphic,hollow,honey-comb,internodal,leaf,less,like,lobe,long,margin,midrib,minute,minutely,mm,ovary,ovoid,pale,papery,papillate,papillose,pedicel,peduncle,petiole,pitted,plant,plump,pubescent,purple,rhomboid,ripe,sessile,shallow,short,simple,size,somewhat,sparsely,stem,stigma,style,surface,tan,testal,tip,toothed,trichome,truncate,tube,uniseriate,vein,way,x,yellow	.5,0.5-1-2,1-2,8-10,abaxially,accrescent,age,anthesi,apart,area,becoming,calyx,campanulate,cup-shaped,curved,decreasing,decumben,difoliate,distally,dry,drying,eaf,edicel,eed,erect,exerted,fracturing,free,frui,geminat,gree,green,growing,horn,horned,inserted,lengthening,lon,lower,m.,material,nflorescence,nodding,often,open,outline,pair,pericarp,point,pore,poricidal,portion,primary,principal,reddish,ruit,scar,scattered,sessil,sleeve,slender,slightly,slit,straight,strongly,thin,toward,ud,unit,wall,wrinkled,ympodial	abaxial,adaxial,arrangement,bud,characteristic,colour,form,fruit,growth,height,history,inflorescence,length,life,lobing,pubescence,seed,shape,texture,type	/3,0.2-0.4,0.5,0.9-1.2,1,1-4,1.4-2,1.5-2,1.5-5,2,2-3,2-4,3,3-5,4-7,6-8,7,acute,along,anther,beneath,berry,bluntly,bright,capitate,cell,centre,ciliate,clasping,cm,coarsely,conical,cordate,dark,deep,deeply,densely,diameter,ellipsoid,elliptic,emarginated,fleshy,flower,glabrous,globose,greenish,herb,heteromorphic,hollow,honey-comb,internodal,leaf,less,like,lobe,long,margin,midrib,minute,minutely,mm,ovoid,pale,papery,papillate,papillose,pitted,plump,pubescent,purple,rhomboid,ripe,sessile,shallow,short,simple,somewhat,sparsely,tan,testal,tip,toothed,trichome,truncate,uniseriate,vein,way,x,yellow	
219	wfo-0001028390	success	147	124	89	96	51	28	85	4	0,0.5,0.5-1,0.5-1.5,0.5-2.5,1-2.5,1.5-3.5,10-15,2,2.5,3-4,4-5,7,7-8,abaxially,acute,adaxially,angled,apex,apiculate,base,branched,calyx,chartaceous,cm,connivent,cuneate,curled,cylindrical,deltate,dendritically,dendritically-branched,densely,diameter,directed,divided,eglandular,elliptic,entire,felty-pubescent,flower,forked,glabrous,gland,globose,hair,lanceolate,like,lobe,margin,mixed,mm,moderately,mostly,narrowly,obtuse,occasionally,often,orange,ovate,pedicel,peduncle,perfect,petiole,pore,pseudohair,puberulent,pubescent,rachi,rarely,ripe,short,shrub,simple,slightly,small,sparsely,stalked,stellate,stigma,style,subclavate,subcordate,subcoriaceous,tip,triangular,truncate,tube,unbranched,unequally,usually,violet,white,white-pubescent,x,yellow	-10,.5-3.3,1,1-3,1-5,1.5-2,1.5-5.5,3-5,4-11,5-7,6-many-foliat,9,absen,adaxiall,aggregate,apart,articulated,axe,blade,cell,dense,distall,eaf,eed,leaving,less,lon,long,lower,midvein,near,nflorescence,nther,orolla,peg,presen,pubescen,radiu,ruit,scar,spaced,ste,stone,subcapitat,tal,tem,time,unit,vary,wide,ympodial	abaxial,adaxial,anther,arrangement,characteristic,colour,corolla,distally,form,fruit,growth,height,history,inflorescence,leaf,length,life,ovary,plant,present,seed,shape,size,stem,subcapitate,surface,texture,type	0,0.5,0.5-1,0.5-1.5,0.5-2.5,1-2.5,1.5-3.5,10-15,2,2.5,3-4,4-5,7,7-8,abaxially,acute,adaxially,angled,apex,apiculate,base,branched,chartaceous,cm,connivent,cuneate,curled,cylindrical,deltate,dendritically,dendritically-branched,densely,directed,divided,eglandular,elliptic,entire,felty-pubescent,flower,forked,glabrous,gland,globose,hair,lanceolate,like,mixed,mm,moderately,mostly,narrowly,obtuse,occasionally,often,orange,ovate,perfect,pore,pseudohair,puberulent,pubescent,rarely,ripe,short,shrub,simple,slightly,small,sparsely,stalked,stellate,subclavate,subcordate,subcoriaceous,tip,triangular,truncate,unbranched,unequally,usually,violet,white,white-pubescent,x,yellow	distally,present,stem,subcapitate
220	wfo-0001028405	success	149	106	74	81	68	25	69	5	0.4-0.5,0.5-3,1-4,1-9,1.3-8,1.5-6.5,10-11,2,2-2.5,2-3,3-4,3.5-10,3.5-6.5,4-11.5,4-6,6-7,7-14.5,8-15,9-15,apical,apically,branched,calyx,cell,cm,conical,connate,corolla,covering,cyme,dehiscent,diameter,dichasial,dichasially,ebracteate,elliptic,exceeding,filament,forked,green,hair-like,herbaceous,interjected,introrse,lateral,leaf,leaflet,long,make,maturing,mm,monochasial,mucilaginous,oblong,odd-pinnate,often,ovate-elliptic,ovoid,pedicel,peduncle,perennial,petiole,plant,poricidally,puberulent,seed,short,size,slit,stamen,stellate,stigma,straight,style,terminal,testal,thick,throughout,wall,wide,yellow	2-4,3-20,3-6-foliat,abaxially,absen,acumen,acute,adaxially,apex,apiculate,articulate,attenuate,base,decurrent,digestion,diminishing,distal,dorsally,eaf,edge,eed,elliptic-lanceolate,emoval,enzyme,flat,flower,folded,generally,globo,gradually,green-white,half,honeycomb,lanceolate,living,lobe,lon,lower,lunat,nflorescence,nther,oblique,orolla,pair,pattern,perfect,plan,proximal,rachi,reveal,ruit,seudostipule,short-acuminate,short-petiolate,specimen,subsessile,tal,tem,throughou,toward,tuber-bearing,typically,unit,vary,whit,without,ympodial,Â¼	abaxial,absent,adaxial,anther,arrangement,colour,form,fruit,globose,growth,height,history,inflorescence,length,life,lunate,ovary,pseudostipule,shape,stem,surface,texture,wet,white,width	0.4-0.5,0.5-3,1-4,1-9,1.3-8,1.5-6.5,10-11,2,2-2.5,2-3,3-4,3.5-10,3.5-6.5,4-11.5,4-6,6-7,7-14.5,8-15,9-15,apical,apically,branched,cell,cm,conical,connate,covering,cyme,dehiscent,diameter,dichasial,dichasially,ebracteate,elliptic,exceeding,forked,green,hair-like,herbaceous,introrse,lateral,long,make,maturing,mm,monochasial,mucilaginous,oblong,odd-pinnate,often,ovate-elliptic,ovoid,perennial,poricidally,puberulent,seed,short,slit,stamen,stellate,stigma,straight,style,testal,thick,throughout,wall,wide,yellow	absent,globose,lunate,wet,white
221	wfo-0001028429	success	162	123	92	101	61	22	89	3	0.2-0.4,0.8-1.2,0.9-2.3,1-2.5,1-4,1.5-3,10-11,10-27,10.5-21,2-3,2-4,2-8,2.5-12,2.5-4,2.5-7.5,2.7-3.6,3-6,4-14,5-12,6-28,abaxially,acumen,acute,adaxially,apical,apically,branched,calyx,cell,cm,connate,corolla,covering,cyme,darker,dehiscent,diameter,dichasial,dichasially,distal,ebracteate,exceeding,filament,forked,generally,glabrescent,glabrous,globose,green,greenish,hair,hair-like,half,herbaceous,interjected,introrse,lateral,leaf,leaflet,light,lobe,long,long-attenuate,make,maturing,medium,mm,monochasial,mucilaginous,odd-pinnate,often,ovoid,pedicel,peduncle,pentagonal,perennial,petiole,plant,poricidally,rotate,scattered,seed,short,size,slightly,slit,spot,stamen,stigma,straight,style,terminal,testal,thick,throughout,tuber-bearing,violet,wall,white,wide,yellow	1.5-4,2-1.,3-6-foliat,6-18,7-7,abaxiall,acuminate,apex,articulate,base,broadly,cordate,cuneate,digestion,diminishing,dorsally,eaf,edge,eed,elliptical,emoval,enzyme,especially,flat,flower,folded,globo,gradually,green-white,honeycomb,living,lon,lower,lunat,narrowly,nflorescence,nther,oblique,obovate,orolla,ovate,pair,pattern,perfect,petiolule,plan,proximal,reveal,ruit,seudostipule,specimen,tal,tem,throughou,toward,typically,unit,vary,vein,ympodial,Â¼	2-19,anther,arrangement,colour,form,fruit,growth,height,history,inflorescence,length,life,lunate,ovary,pseudostipule,shape,stem,surface,texture,type,wet,width	0.2-0.4,0.8-1.2,0.9-2.3,1-2.5,1-4,1.5-3,10-11,10-27,10.5-21,2-3,2-4,2-8,2.5-12,2.5-4,2.5-7.5,2.7-3.6,3-6,4-14,5-12,6-28,abaxially,acumen,acute,adaxially,apical,apically,branched,cell,cm,connate,covering,cyme,darker,dehiscent,dichasial,dichasially,distal,ebracteate,exceeding,forked,generally,glabrescent,glabrous,globose,green,greenish,hair,hair-like,half,herbaceous,introrse,lateral,light,lobe,long,long-attenuate,make,maturing,medium,mm,monochasial,mucilaginous,odd-pinnate,often,ovoid,pentagonal,perennial,plant,poricidally,rotate,scattered,seed,short,slightly,slit,spot,stamen,stigma,straight,style,testal,thick,throughout,tuber-bearing,violet,wall,white,wide,yellow	2-19,lunate,wet
222	wfo-0001028436	success	150	95	59	69	81	26	57	2	.5,0.2-0.4,0.5,1-3,1.5,1.5-2,10-20,2-4,2.5-3,4,5-10,5-12,5-15,5-8,8-12,absent,acute,anther,apex,base,berry,brown,calyx,center,chartaceous,ciliate,decurrent,diameter,dm,dried,edge,elliptic,entire,filament,fine,flower,fruit,glabrous,globose,leaf,linear,linear-lancolate,margin,membranaceous,mm,moderately,nearly,oblong,often,parallel,pedicel,peduncle,per,petiole,pubescent,radiating,raised,ridge,rotate,running,shallow,shrub,stem,stigma,style,surface,unifoliate,white,x	0.5-1,0.8-1.5,1-2,1-2-celled,1.5-2.5,1st,2-3,2nd,7,abaxially,abundant,adaxiall,adaxially,along,apically,appearance,appearing,axe,beyond,blade,cell,cm,connected,cordat,deflated,dehiscent,difficult,due,eaf,eed,evaluat,explosively,exserted,flat,frui,fruiting,geniculate,glabrescen,hair,interpetalar,lengt,like,lobe,long,lower,lying,much-branched,nflorescence,notch,older,orolla,oung,placenta,pointing,presence,pubescen,rachi,reaching,rhizomatous,ruit,small,sparsely,stamen,structure,swollen,tal,tamen,taproot,tear,thick,tissue,triangular,tube,two-celled,unbranched,unit,vary,wid,woody,wrinkled,ympodial	abaxial,adaxial,arrangement,characteristic,colour,corolla,form,glabrousnes,growth,height,history,inflorescence,length,life,new,number,ovary,perennial,plant,seed,shape,size,staman,texture,type,wide	.5,0.2-0.4,0.5,1-3,1.5,1.5-2,10-20,2-4,2.5-3,4,5-10,5-12,5-15,5-8,8-12,absent,acute,berry,brown,center,chartaceous,ciliate,decurrent,diameter,dm,dried,edge,elliptic,entire,fine,flower,fruit,glabrous,globose,linear,linear-lancolate,margin,membranaceous,mm,moderately,nearly,oblong,often,parallel,per,petiole,pubescent,radiating,raised,ridge,rotate,running,shallow,shrub,unifoliate,white,x	perennial,wide
223	wfo-0001028465	success	159	114	81	92	67	22	77	4	0.75,1-2,1-4,1.2-2,10-24,11-23,2-3,2-6,2-9.3,2.4-2.8,2.5-4,3-4,3-5,3-8,3.8-7,4-8,4.5-5.5,5-7,7-15,8-10,acumen,apical,apically,attenuate,branched,broadly,calyx,cell,cm,connate,corolla,covering,cyme,dehiscent,diameter,dichasial,dichasially,distal,ebracteate,elliptical,exceeding,filament,forked,globose,green,hair-like,herbaceous,interjected,interpetalar,introrse,lateral,leaf,leaflet,lobe,long,make,maturing,medium,mm,monochasial,mucilaginous,odd-pinnate,often,ovoid,pair,pedicel,peduncle,perennial,petiole,plant,poricidally,puberulent,pubescent,purple,rotate,seed,short,size,slit,spot,stamen,stigma,straight,strigose,style,terminal,testal,thick,throughout,wall,white,yellow	1.5-2.9,10,2,2-4,3-6-foliat,4-1.,9-19,abaxially,acuminate,acute,adaxially,apex,articulate,base,cuneate,decurrent,digestion,diminishing,dorsally,eaf,edge,eed,emoval,enzyme,equal,first,flat,flower,folded,generally,globo,gradually,green-white,half,honeycomb,living,lon,lower,lunat,nflorescence,nther,oblique,orolla,pattern,perfect,petiolule,plan,proximal,rachi,rarely,reveal,ruit,sessile,seudostipule,specimen,tal,tem,tissu,toward,tuber-bearing,two,typically,unit,vary,wide,ympodial,Â¼	4-18,anther,arrangement,colour,form,fruit,growth,height,history,inflorescence,length,life,lunate,ovary,pseudostipule,shape,stem,surface,texture,tissue,wet,width	0.75,1-2,1-4,1.2-2,10-24,11-23,2-3,2-6,2-9.3,2.4-2.8,2.5-4,3-4,3-5,3-8,3.8-7,4-8,4.5-5.5,5-7,7-15,8-10,acumen,apical,apically,attenuate,branched,broadly,cell,cm,connate,covering,cyme,dehiscent,dichasial,dichasially,ebracteate,elliptical,exceeding,forked,globose,green,hair-like,herbaceous,interpetalar,introrse,lateral,lobe,long,make,maturing,medium,mm,monochasial,mucilaginous,odd-pinnate,often,ovoid,perennial,poricidally,puberulent,pubescent,purple,rotate,seed,short,slit,spot,stamen,stigma,straight,strigose,style,testal,thick,throughout,wall,white,yellow	4-18,lunate,tissue,wet
224	wfo-0001028468	success	255	115	75	89	166	26	73	2	.3-0.4,.6-1,0.2-0.3,0.7-2.5,1.2-1.5,16,2-9,4-6,5-21,5-9,6-9,acute,anther,apex,attenuate,base,berry,blue,brown,bud,calyx,campanulate,chartaceous,cm,corolla,dark,densely,diameter,ellipsoid,exserted,extra-axillary,filament,flattened,flower,foveate,fruit,glabrescent,gray,green,greenish,interpetalar,length,light,lobed,long,margin,midvein,mm,moderately,narrowly,oblique,oblong-conical,oblong-lanceolate,orange,ovate,ovoid,pale,pedicel,peduncle,petiole,purple,reticulate,rhombic,shallowly,short,shrub,side,simple,sparsely,stellate-pubescent,stelliform,stem,stigma,style,subcapitate,subcuneate,subelliptic,subglobose,sublenticular,subreniform,subshrub,surface,terete,tissue,unarmed,unbranched,vein,x,yellowish	-1.3,-10,-3,-4,-5.5,-7,.1-0.2,.1-0.3,.1-0.4,.2,.2-0.4,.3,.5,.5-1.5,.5-1.6,/10-1/5,/4-1/3,0.05,0.1,0.2-0.6,0.2-1.5,0.4-1,0.4-4,0.5-2,0.5-3,0.5-3.3,0.5-3.5,0.5-8,0.6-1.2,0.6-2,0.8-3.5,1,1.3-2,1.5-2.2,1.5-3.1,1.6,1/3-1/2,1/5-1/2,2,2.2-3,2.5-4,2.8-4.1,2/3-3/4,20,3-4,4-9,6-10,abaxially,accrescent,acuminate,adaxially,along,apart,appressed,ark,armed,articulated,axe,becoming,beyond,blade,broad-based,broadly,bu,c.,cauline,central,clavate,commonly,compresse,compressed,connivent,d.,decreasing,density,directed,distal,distally,distantly,dry,eaf,eed,equal,fruiting,geminat,glabrous,gradually,hair,half,increasing,inserted,introrsel,lamin,lateral,laterally,lobe,longer,lower,m.,main,midpoint,minutely,mixed,mostly,multangulat,multangulate,nflorescence,obtuse,occasionally,older,orangish,orolla,overlapping,pair,papillo,per,perfect,pore,porrect-stellate,prickle,proximal,pubescence,pubescent,rachi,ray,recurved,reduced,relatively,rotate-stellate,ruit,sessile,short-,short-stalked,similar,similarly,slightly,somewhat,spaced,specimen,stalk,stamen,straight,subacuminate,subchartaceous,subsessile,tal,tamen,testa,thick,thick-stalked,thicknes,time,touching,toward,triangular,tube,unifoliate,unit,upper,usually,vary,way,wide,yellow,ympodial,young	0-1.3,0.5-1.5,arrangement,bark,branch,characteristic,colour,exertion,form,glabrousnes,growth,height,history,inflorescence,leaf,life,lobing,new,ovary,plant,primary,seed,shape,size,texture,type	.3-0.4,.6-1,0.2-0.3,0.7-2.5,1.2-1.5,16,2-9,4-6,5-21,5-9,6-9,acute,attenuate,berry,blue,brown,calyx,campanulate,chartaceous,cm,dark,densely,diameter,ellipsoid,exserted,extra-axillary,flattened,flower,foveate,fruit,glabrescent,gray,green,greenish,interpetalar,light,lobed,long,midvein,mm,moderately,narrowly,oblique,oblong-conical,oblong-lanceolate,orange,ovate,ovoid,pale,purple,reticulate,rhombic,shallowly,short,shrub,side,simple,sparsely,stellate-pubescent,stelliform,subcapitate,subcuneate,subelliptic,subglobose,sublenticular,subreniform,subshrub,terete,tissue,unarmed,unbranched,x,yellowish	0-1.3,0.5-1.5
225	wfo-0001028470	success	185	119	76	93	92	26	72	4	0-18,0.25-0.75,0.9-2.2,0.9-2.3,1-12.3,1-2,1-3,1.5-2.8,1.6-3.2,11.8-21,12-44,2-10,2-7,2-8,2.1-3.9,3-10,3-5,3.2-5.5,3.5-16,3.5-7,4-7,5.5-11.6,abaxially,adaxially,anther,berry,blade,brownish,cell,chartaceous,clavate,cm,condition,connivent,corolla,covering,dark,deep,diameter,dot,drying,end,filament,flower,forked,fresh,fruit,glabrous,green,greenish,hair-like,herb,homostylous,interjected,lanceolate,lateral,leaf,leaflet,light,lobe,long,medium,mm,mottled,odd-pinnate,one,ovoid,pedicel,peduncle,pentagonal,placed,plant,purple,ripe,seed,size,stigma,straight,style,substellate,terminal,testal,thick,tube,tuber,typically,usually,wall,white,whitish,wide,x,yellow	2-5,4-6,5-merou,6-33,acumen,acute,adaxiall,ag,alyx,apart,apex,apparently,articulated,asymmetric,attenuate,axe,axillary,base,basiscopic,bud,capitat,decreasing,digestion,distal,dorsally,eaf,edge,eed,elliptic,enzyme,erec,exceeding,flat,folded,geminat,generally,glabrescent,glabrou,green-white,hair,hal,half,high,honeycomb-shaped,lengthening,living,lower,make,mucilaginous,nflorescence,orbicular,orolla,ovate,pair,perfect,petiole,petiolulate,plurifoliate,pore,poricidal,pubescent,removed,rounded,ruit,scarce,sessile,seudostipule,short,side,slit,sometimes,spaced,specimen,stamen,stolo,subequal,subglabrou,subtending,tall,tamen,tem,throughout,tip,tissue,toward,tri-,unit,unwinged,vary,wet,wing,ympodial	5-merous,abaxial,adaxial,arrangement,calyx,capitate,colour,form,glabrousnes,growth,height,history,inflorescence,length,life,ovary,placement,pseudostipule,shape,spacing,staman,stem,stolon,subglabrous,surface,texture	0-18,0.25-0.75,0.9-2.2,0.9-2.3,1-12.3,1-2,1-3,1.5-2.8,1.6-3.2,11.8-21,12-44,2-10,2-7,2-8,2.1-3.9,3-10,3-5,3.2-5.5,3.5-16,3.5-7,4-7,5.5-11.6,abaxially,adaxially,berry,brownish,cell,chartaceous,clavate,cm,condition,connivent,covering,dark,deep,dot,drying,end,forked,fresh,glabrous,green,greenish,hair-like,herb,homostylous,lanceolate,lateral,light,long,medium,mm,mottled,odd-pinnate,one,ovoid,pentagonal,placed,purple,ripe,straight,substellate,testal,thick,typically,usually,wall,white,whitish,wide,x,yellow	5-merous,capitate,stolon,subglabrous
226	wfo-0001028476	success	242	196	145	160	82	36	142	3	-6,-8,.05-0.1,0.1-0.15,0.15-0.2,0.2-0.5,0.25-0.5,0.3-0.4,0.4-0.6,0.5,0.5-0.6,0.8-1.2,0.8-1.6,1,1-1.4,1-2,1-2-celled,1-4,1-6,1.1-1.5,1.1-1.6,1.8-2.5,2-6,2-foliate,2-locular,2.4-3,3-foliate,3.5-13-16,4-celled,5-15,8-30,abaxially,abundant,acuminate,acute,age,almost,along,anther,anthesi,apex,appearance,articulated,basal,base,basiscopically,bifurcate,bracteate,branched,bright,brown,calyx,capitate,cell,cm,conical,corolla,curved,dark,deeply,diameter,distal,ebracteate,elliptic,entire,especially,exserted,filament,flower,fortaleza,fruit,fruiting,give,glabrescent,glandular,globose,green,hair-like,half,head,herb,hyaline,imparipinnate,inflorescence,interjected,internode,interrupted,irregularly,lanceolate,lateral,leaf,leaflet,less,like,lobe,lobed,long,margin,maturity,minute,minutely,mixed,mm,narrowly,node,numerous,oblique,obovate,occasionally,often,outgrowth,ovary,pale,pedicel,peduncle,perennial,petiole,population,present,primary,prominent,pseudostipule,puberulent,pubescence,pubescent,purple,rarely,regularly,rounded,rÃ­o,scattered,silky,simple,sinus,sparsely,spreading,stellate,stem,stiff,stigma,straight,stripe,style,surface,terminal,testa,thick,tip,trichome,truncate,tube,unicellular,uniseriate,unit,usually,vein,wall,wide,woody,yellow	.5,0-0.5,0-3-12-20,0.1-0.4,0.15-0.4,0.2-0.3,0.2-0.5-1,0.2-0.6,0.25-0.4,0.3-0.5,0.3-0.7,0.3-1.2,0.4-0.5,0.4-1.5,0.5-1.7,0.7-2.5,1-1.2,1-1.5,1-celled,1.2-2.5,2,3-7,6-12-30,7-10,absent,acroscopically,also,alternate,ape,apical,appendage,axi,becoming,bifurcation,bract,column,decurrent,diamete,eaf,edicel,eed,elongate,first,gradually,gree,hal,incurved,largest,lon,lower,main,midvein,nflorescence,pair,petiolule,rachi,recurve,reflexed,rest,ruit,secondary,sessile,set,short,slightly,smaller,sprawling,staminal,sterile,subopposite,tall,tem,tertiary,toward,ud,uniformly,unpaired,weak-walled,white,wid,winged,ympodial	arrangement,border,branch,bud,characteristic,colour,corrugation,drying,exertion,form,giving,glabrousnes,growth,height,history,length,life,lobing,midpoint,na,new,number,per,plant,prickle,ray,recurved,seed,shape,size,sympodial,texture,thicknes,type,variation,width	-6,-8,.05-0.1,0.1-0.15,0.15-0.2,0.2-0.5,0.25-0.5,0.3-0.4,0.4-0.6,0.5,0.5-0.6,0.8-1.2,0.8-1.6,1,1-1.4,1-2,1-2-celled,1-4,1-6,1.1-1.5,1.1-1.6,1.8-2.5,2-6,2-foliate,2-locular,2.4-3,3-foliate,3.5-13-16,4-celled,5-15,8-30,abaxially,abundant,acuminate,acute,age,almost,along,anthesi,apex,appearance,articulated,basal,base,basiscopically,bifurcate,bracteate,branched,bright,brown,calyx,capitate,cell,cm,conical,curved,dark,deeply,diameter,distal,ebracteate,elliptic,entire,especially,exserted,flower,fortaleza,fruit,give,glabrescent,glandular,globose,green,hair-like,half,head,herb,hyaline,imparipinnate,internode,interrupted,irregularly,lanceolate,lateral,leaflet,less,like,lobe,lobed,long,maturity,minute,minutely,mixed,mm,narrowly,node,numerous,oblique,obovate,occasionally,often,outgrowth,pale,perennial,population,present,prominent,puberulent,pubescence,pubescent,purple,rarely,regularly,rounded,rÃ­o,scattered,silky,simple,sinus,sparsely,spreading,stellate,stem,stiff,straight,stripe,surface,testa,thick,tip,trichome,truncate,unicellular,uniseriate,unit,usually,vein,wall,wide,woody,yellow	na,recurved,sympodial
227	wfo-0001028481	success	194	118	88	104	90	14	85	3	.1,.5,0.5-1,0.6-1,0Â°,1-2,1-3,1-4,1.5,1.8-2.5,1/2-2/3,2.5-3,3,3-4,3-6,5.5-7.5,8,acuminate,almost,along,anther,anthesi,apex,attenuate,bark,base,branch,branched,brown,chartaceous,clavate,cm,colour,corolla,cuneate,cupular,deeply,dendritic,dendritic-pubescent,diameter,distributed,divided,drying,elliptic,entire,equal,evenly,filament,flaking,flower,glabrous,green,leaf,length,less,liana,like,long,longitudinally,main,margin,midvein,mm,oblique,oblong,occasional,often,orange-brown,pair,pedicel,peduncle,petiole,primary,pubescent,ray,reddish,ridged,scar,shortly,shrub,side,size,slender,small,sparsely,spreading,stem,stigma,stump,style,terminal,tertiary,thickly,trichome,tube,unarmed,unknown,vein,venation,visible,white,x,yellowish,young	.3,0-2,0.1-0.2,0.15,1-1.4,1.5-2,2-3,3-3.5,3-4.5,abaxially,absent,acute,adaxially,age,alyx,apar,apically,apparently,articulated,canaliculate,clearly,close,conical,delineated,deltoid,density,different,dilated,discolorous,domatia,dorsifixed,dry,eaf,eed,ellipsoi,erect,except,extending,extent,eye,faint,flat,flexuous,free,increasing,know,known,lamina,lengthening,linear,lobe,lobed,lon,long-acuminate,longer,lower,m.,mostly,naked,narrowly,nflorescence,nther,orolla,ovate,perfec,plurifoliat,pore,poricidal,portion,protruding,rachi,raised,ribbed,ruit,see,simple,sinus,smoot,smoothly,surface,tearing,tip,together,toward,ud,uneven,unit,vary,wide,ympodial	apart,arrangement,bud,calyx,characteristic,ellipsoid,form,growth,inflorescence,lobing,pubescence,shape,smooth,texture	.1,.5,0.5-1,0.6-1,0Â°,1-2,1-3,1-4,1.5,1.8-2.5,1/2-2/3,2.5-3,3,3-4,3-6,5.5-7.5,8,acuminate,almost,along,anthesi,apex,attenuate,base,branch,branched,brown,chartaceous,clavate,cm,corolla,cuneate,cupular,deeply,dendritic,dendritic-pubescent,distributed,divided,drying,elliptic,entire,equal,evenly,flaking,flower,glabrous,green,length,less,liana,like,long,longitudinally,main,midvein,mm,oblique,oblong,occasional,often,orange-brown,pair,pubescent,ray,reddish,ridged,shortly,shrub,side,slender,small,sparsely,spreading,stem,stump,terminal,thickly,trichome,unarmed,unknown,visible,white,x,yellowish,young	apart,ellipsoid,smooth
228	wfo-0001028482	success	224	180	140	160	64	20	139	1	.1,.5,/3,0,0.2,0.5,0.5-1,0.5-5,00,1-1.5,1-11,1-2,1-4,1.2-1.6,1.5-2,1.5-3,10,2-3,2-celled,3-4,4-5,6-50,7-14,abaxially,acuminate,acute,adaxially,age,alternate,angled,anther,anthesi,apex,ascending,asymmetric,bark,base,becoming,berry,bifid,bifurcate,bilobed,bright,broadly,brochiodromous,brownish,bud,calyx,campanulate,capitate,channeled,chartaceous,cm,corky,corolla,corrugated,creamy,cymose,deciduous,deltate,diameter,dry,drying,ellipsoid,elliptic,emarginate,entire,exerted,exfoliating,filament,flattened-reniform,fleshy,flower,fresh,fruit,fruiting,glabrous,glandular,globose,golden,green,growth,halfway,hard,impressed,internodal,irregular,keeled,leaf-opposed,lengthening,less,lobe,long,margin,material,maturity,midrib,minutely,mm,new,nodding,obovate,occasionally,olive,ovary,pair,pale,pedicel,peduncle,per,petiole,pitted,pore,poricidal,primary,pubescent,reddish,revolute,scandent,shaped,shiny,short,simple,size,slightly,slit,small,sometimes,somewhat,soon,sparsely,stem,stigma,style,subcoriaceous,subglobose,subpyramidal,surface,tan,tear-drop,tip,transparent,transversely,tree,trichome,truncate,tube,tuberculate,tuft,uniseriate,usually,vein,venation,way,white,x,yellow,yellowish,young,Âµm	0.7-1.1,1.1-5,3-12,5-25,apiculae,basal,berr,branched,circinate,closely,constriction,coriaceous,cucullate,curved,deflexed,densely,diffusely,difoliate,discolorous,distally,distinct,eaf,eed,embryo,enlarged,expanding,free,geminat,glabrou,grayish,heterostylous,incrassate,individual,investing,lobed,lower,markedly,materia,midvein,minute,nflorescence,overlappin,papillat,pentamerous,pericarp,petal,portion,row,ruit,scar,spaced,stout,straight,tightly,tiny,tub,twice,two,ud,unifoliate,unit,vegetative,woody,ympodial	arrangement,characteristic,colour,exertion,form,glabrousnes,height,history,inflorescence,leaf,length,life,lobing,number,papillate,plant,seed,shape,texture,type	.1,.5,/3,0,0.2,0.5,0.5-1,0.5-5,00,1-1.5,1-11,1-2,1-4,1.2-1.6,1.5-2,1.5-3,10,2-3,2-celled,3-4,4-5,6-50,7-14,abaxially,acuminate,acute,adaxially,age,alternate,angled,anthesi,apex,ascending,asymmetric,base,becoming,berry,bifid,bifurcate,bilobed,bright,broadly,brochiodromous,brownish,calyx,campanulate,capitate,channeled,chartaceous,cm,corky,corrugated,creamy,cymose,deciduous,deltate,dry,drying,ellipsoid,elliptic,emarginate,entire,exerted,exfoliating,flattened-reniform,fleshy,flower,fresh,glabrous,glandular,globose,golden,green,halfway,hard,impressed,internodal,irregular,keeled,leaf-opposed,lengthening,less,lobe,long,material,maturity,midrib,minutely,mm,nodding,obovate,occasionally,olive,pair,pale,pitted,pore,poricidal,pubescent,reddish,revolute,scandent,shaped,shiny,short,simple,slightly,slit,small,sometimes,somewhat,soon,sparsely,style,subcoriaceous,subglobose,subpyramidal,surface,tan,tear-drop,tip,transparent,transversely,tree,trichome,truncate,tube,tuberculate,tuft,uniseriate,usually,venation,way,white,x,yellow,yellowish,young,Âµm	papillate
229	wfo-0001028487	success	195	134	95	111	84	23	91	4	0-9,0.3-0.7,0.4-1.5,0.9-3,1-2,1-3,1.1-1.5,1.4-1.7,10-4.3,15-28,2-4,2-4.8,2-6,2.5-3.5,3-10,3-19,3.4-7.8,4-7,4.6-13.6,5-6,7.8-16.4,acumen,anther,axillary,berry,blade,brownish,bud,cell,central,clavate,cm,condition,connivent,coriaceous,corolla,covering,dark,deep,diameter,distal,drying,elliptic,filament,flower,forked,fresh,fruit,generally,glabrescent,glabrous,green,green-white,greenish,hair-like,half,herb,homostylous,interjected,lanceolate,lateral,leaf,leaflet,light,lobe,long,make,medium,mm,moniliform,mucilaginous,narrow,odd-pinnate,ovate,ovoid,pair,pedicel,peduncle,pentagonal,petiole,plant,poricidal,purple,ripe,seed,short,size,sometimes,star,stigma,straight,style,substellate,subtending,terminal,testal,thick,throughout,tip,tube,tuber,unwinged,usually,wall,wet,white,whitish,wide,wing,x,yellow	1-3.2,1.7-7,10-41,3-4,3-5,5-merou,abaxially,acuminate,acute,adaxiall,adaxially,ag,along,alyx,apart,apex,apparently,arranged,articulated,asymmetric,attenuate,axe,base,basiscopic,bead,capitat,considerably,decreasing,digestion,dorsally,eaf,edge,eed,enzyme,erec,exceeding,flat,folded,geminat,glabrou,hair,hal,high,honeycomb-shaped,lengthening,like,living,lower,multiple,necklace,nflorescence,orbicular,orolla,perfect,petiolulate,plurifoliate,pore,removed,rounded,ruit,scabrous,scarce,second,sessile,seudostipule,side,slit,smaller,spaced,specimen,stamen,stolon,subequal,subglabrou,tall,tamen,tem,tissue,toward,tri-,typically,unit,vary,ympodial	5-merous,abaxial,adaxial,arrangement,calyx,capitate,colour,erect,form,growth,height,history,inflorescence,length,life,ovary,presence,pseudostipule,shape,stem,subglabrous,surface,texture	0-9,0.3-0.7,0.4-1.5,0.9-3,1-2,1-3,1.1-1.5,1.4-1.7,10-4.3,15-28,2-4,2-4.8,2-6,2.5-3.5,3-10,3-19,3.4-7.8,4-7,4.6-13.6,5-6,7.8-16.4,acumen,axillary,berry,brownish,bud,cell,central,clavate,cm,condition,connivent,coriaceous,covering,dark,deep,distal,drying,elliptic,forked,fresh,generally,glabrescent,glabrous,green,green-white,greenish,hair-like,half,herb,homostylous,lanceolate,lateral,light,long,make,medium,mm,moniliform,mucilaginous,narrow,odd-pinnate,ovate,ovoid,pentagonal,plant,poricidal,purple,ripe,seed,short,sometimes,star,straight,substellate,subtending,terminal,testal,thick,throughout,tip,unwinged,usually,wall,wet,white,whitish,wide,wing,x,yellow	5-merous,capitate,erect,subglabrous
230	wfo-0001028489	success	222	125	87	104	118	21	86	1	-10,-5,-6,/4,0-3,0.3-1,0.3-1.2-2.5,0.4-0.8,0.5-0.8,0.5-1.1,0.5-1.5,0.6-1.2,0.7-3,1-3,1.5-4,1.8-4,1/3,2-3,2-4,3-7,7.5,acute,anther,apex,apparently,articulated,bark,base,berry,calyx,cell,chartaceous,cm,connivent,cordate,cream,cuneate,dark,diameter,dull,elliptic,erect,filament,flattened-reniform,fruit,fruiting,glabrous,green,lateral,leaf,length,lobe,lobed,long,margin,marking,maturity,mauve,membranous,mm,moderately,obtuse,occasionally,orange,orange-brown,orange-green,outline,ovate,pair,pale,pedicel,peduncle,petiole,poricidal,prickly,primary,purple,raised,red-brown,rounded,shiny,shrub,side,simple,smooth,sometimes,sparsely,spherical,stellate-pubescent,stem,style,surface,tapering,tip,truncate,unarmed,upper,vein,way,white,wide,yellow,yellow-green,young	-4,0-10,0-15,0-20,0-50,0.1,0.1-0.6,0.2,0.2-0.3-0.5,0.2-0.4-0.6,0.2-0.5,0.2-0.6,0.2-0.7,0.3-0.5,0.3-0.7,0.5-1,1-4,1-6,1-7,1.5-3,1.8-2.2,1.8-5.5,1/3-1/2,1/4-1/2,2-6,2.1-3,3.5-6,4-10,4-13,4-8,5-25,5-8,5-merous,abaxially,acicular,alyx,apar,apart,apically,ba,beyond,blade,branched,broad-deltate,caudat,concolorous,curved,deltate,densely,difoliate,distance,drying,eaf,eed,elongating,equal,extending,eye,flower,free,geminat,gray,hair,herbaceous,infructescence,less,lon,longer,lower,mature,midpoint,midvein,minute,naked,nflorescence,often,older,one,open,orolla,oung,pendulous,per,perfec,pericarp,perpendicular,porrect,portion,prickle,protruding,ray,ruit,scar,sessile,slender,spaced,spreading,stalk,stellate,straight,subsessile,tamen,terete,tertiary,time,toward,trichome,tube,unarme,unit,vary,venation,visible,weakly,white-gra,woody,yellow-orange,ympodial	arrangement,branch,characteristic,colour,corolla,exertion,form,glabrousnes,growth,height,inflorescence,lobing,new,ovary,plant,seed,shape,size,texture,type,white-gray	-10,-5,-6,/4,0-3,0.3-1,0.3-1.2-2.5,0.4-0.8,0.5-0.8,0.5-1.1,0.5-1.5,0.6-1.2,0.7-3,1-3,1.5-4,1.8-4,1/3,2-3,2-4,3-7,7.5,acute,apparently,articulated,base,berry,cell,chartaceous,cm,connivent,cordate,cream,cuneate,dark,diameter,dull,elliptic,erect,flattened-reniform,glabrous,green,lateral,lobe,lobed,long,marking,maturity,mauve,membranous,mm,moderately,obtuse,occasionally,orange,orange-brown,orange-green,outline,ovate,pair,pale,poricidal,prickly,purple,raised,red-brown,rounded,shiny,shrub,side,simple,smooth,sometimes,sparsely,spherical,stellate-pubescent,tapering,tip,truncate,unarmed,upper,way,white,wide,yellow,yellow-green,young	white-gray
231	wfo-0001028492	success	130	91	58	68	62	23	56	2	0.2-2,0.5-1,1-2.5,1-4,1-5,1.5-2.5,1.5-3,1.5-6,15-20,2-2.5,2-5,3,3-6,4,5-15,5-25-flower,5-8,6-11,acute,angled,apart,apex,base,calyx,cell,cm,colored,containing,crystal,dark,deltate,diameter,elliptic-ovate,entire,forked,fruit,glabrous,globose,herb,lobe,margin,mm,narrowly,pedicel,peduncle,petiole,pubescent,punctate,purple,rachi,radiu,rarely,reticulate,ripe,rounded,shrub,simple,stellate,stigma,style,subcordate,triangular,unbranched,white,white-punctate,whitish,wide,x	-5-foliat,1.75-3.5,2-3,2-4,2.5-9,6-12,8-15,abaxially,absen,adaxially,aggregate,apiculate,articulated,axe,axi,blade,chartaceous,ciliolate,color,connivent,cylindrical,directed,distall,eaf,eed,except,glabrou,hair,irregularly,leaving,long,lower,nflorescence,nther,obtuse,orolla,pore,ruit,san,sand-punctate,scar,somewhat,spaced,sparse,splitting,stone,subcoriaceous,succulent,tal,tem,time,tip,triangular-ovate,truncat,tube,unevenly,unit,unknown,vary,veiny,x1-3,ympodial	anther,arrangement,characteristic,colour,corolla,form,glabrousnes,growth,height,inflorescence,leaf,length,ovary,plant,sand,seed,shape,size,spacing,stem,surface,texture,truncate	0.2-2,0.5-1,1-2.5,1-4,1-5,1.5-2.5,1.5-3,1.5-6,15-20,2-2.5,2-5,3,3-6,4,5-15,5-25-flower,5-8,6-11,acute,angled,apart,cell,cm,colored,containing,crystal,dark,deltate,diameter,elliptic-ovate,entire,forked,fruit,glabrous,globose,herb,mm,narrowly,pubescent,punctate,purple,rarely,reticulate,ripe,rounded,shrub,simple,stellate,subcordate,triangular,unbranched,white,white-punctate,whitish,wide,x	sand,truncate
232	wfo-0001028501	success	195	99	57	77	118	22	53	4	0-3,0-3.2,0-4,0.3-0.7,0.8-1.6,0.8-1.7,1-2,1-8,1.8-10.7,13-41,2-4,2.8-18,2.8-4.9,3-10,3-7,3.1-10.4,3.1-12,4-8,4.8-18,6.6-21.1,8-10,anther,blade,broadly,clavate,cm,coriaceous,corolla,dark,diameter,filament,flower,forked,fruit,glabrescent,glabrous,green,greenish,herb,homostylous,interjected,lanceolate,lateral,leaf,leaflet,light,lobe,long,medium,mm,moniliform,mottled,mucilaginous,odd-pinnate,ovate,ovoid,pair,pedicel,peduncle,petiole,plant,purple,pyriform,rotate,seed,simple,size,stigma,straight,style,terminal,tube,tuber,white,whitish,wide,x	0.3-3.3,0.6-5.8,1,1-3,2-5,3-5,5-merou,8-34,abaxially,acumen,acuminate,acute,adaxiall,adaxially,ag,along,alyx,apart,apex,apparently,arranged,articulated,attenuate,axe,axillary,base,bead,berry,brownish,bud,capitat,cell,condition,connivent,considerably,covering,decreasing,decurrent,digestion,distal,dorsally,drying,eaf,edge,eed,elliptic,enzyme,erec,exceeding,flat,folded,fresh,geminat,generally,glabrou,green-white,hair,hair-like,hal,half,high,honeycomb-shaped,larger,lengthening,like,linear,living,lower,make,multiple,narrow,narrowly,necklace,nflorescence,onto,orbicular,orolla,perfect,plurifoliate,pore,poricidal,present,rachi,removed,ripe,ruit,scarce,sessile,seudostipule,short,slit,sometimes,spaced,specimen,spot,stamen,stolon,subglabrou,subtending,tall,tamen,tem,testal,thick,throughout,tip,toward,tri-,typically,unit,unwinged,usually,vary,wall,wet,wing,yellow,ympodial	5-merous,abaxial,adaxial,arrangement,calyx,capitate,colour,erect,form,growth,height,history,inflorescence,length,life,ovary,pseudostipule,shape,stem,subglabrous,surface,texture	0-3,0-3.2,0-4,0.3-0.7,0.8-1.6,0.8-1.7,1-2,1-8,1.8-10.7,13-41,2-4,2.8-18,2.8-4.9,3-10,3-7,3.1-10.4,3.1-12,4-8,4.8-18,6.6-21.1,8-10,broadly,clavate,cm,coriaceous,dark,forked,glabrescent,glabrous,green,greenish,herb,homostylous,lanceolate,light,long,medium,mm,moniliform,mottled,mucilaginous,odd-pinnate,ovate,ovoid,purple,pyriform,rotate,simple,straight,white,whitish,wide,x	5-merous,capitate,erect,subglabrous
233	wfo-0001028502	success	158	122	79	91	67	31	75	4	/2,0.5-1,1-2,1.5-2,1.5-2.5,1.5-6,1.6-2.4,2-4,2-5,2-7,2-8,3.5-15,5-15,6-8,abaxially,acute,adaxially,anther,apex,bark,base,beige,branch,branched,brown,calyx,campanulate,clavate,closely,cm,congested,constricted,corolla,dark,dendritic,densely,dia,elliptic,exserted,fawn,filament,flattened-reniform,flower,fruiting,glabrous,globose,included,inflorescence,later,lateral,leaf,light,like,lobed,long,main,margin,minutely,mm,obovate,ovary,packed,pair,pedicel,petiole,pitted,pubescent,reddish-brown,rest,seed,shining,shrub,small,stem,stigma,structure,style,surface,terminal,thick,time,tree,tree-like,trichome,tube,unclear,vein,warty,way,white,wide	.5,1.5-3,2-2.5,3.5-4,5-6,?,abaxial,age,along,anthesi,apar,ba,blade,body,cazalet,christmas-tree-like,cone,deltate,denser,eaf,edicel,eed,erect,fide,flat,fleshy,free,glabrat,heteromorphic,impressed,incrassate,inflorescenc,lengthening,lobe,lon,long-styled,lower,matted,middle,narrower,nflorescence,often,older,papillo,papillose,planar,plurifoliat,pore,poricidal,portion,prominent,ruit,scar,scattered,short-styled,slit,spaced,tall,tip,tub,ud,unevenly,widest,within,woody,ympodia,young	0.5,4-6,arrangement,bud,characteristic,colour,corrugation,diameter,drying,exertion,form,fruit,glabrousnes,growth,height,history,length,life,lobing,na,new,number,peduncle,per,plant,plurifoliate,primary,shape,size,texture,type	/2,0.5-1,1-2,1.5-2,1.5-2.5,1.5-6,1.6-2.4,2-4,2-5,2-7,2-8,3.5-15,5-15,6-8,abaxially,acute,adaxially,base,beige,branch,branched,brown,calyx,campanulate,clavate,closely,cm,congested,constricted,dark,dendritic,densely,dia,elliptic,exserted,fawn,flattened-reniform,flower,glabrous,globose,included,inflorescence,later,lateral,light,like,lobed,long,main,minutely,mm,obovate,packed,pair,pitted,pubescent,reddish-brown,rest,shining,shrub,small,structure,terminal,thick,time,tree,tree-like,trichome,tube,unclear,vein,warty,way,white,wide	0.5,4-6,na,plurifoliate
234	wfo-0001028505	success	168	108	67	87	81	21	65	2	.1,.3,.5,/3,0.25-0.5,0.8-1,0.8-1.5,1-3,10-14-flowered,10-15,2,3.5-5,acuminate,acute,anther,apex,aspect,bark,basal,base,beneath,berry,branch,bud,calyx,characteristic,cm,corolla,decurrent,delicate,dia,dry,drying,erect,exserted,f,filament,flattened,fruiting,gently,glabrous,globose,green,grey,leaf,long,margin,minutely,mm,narrowly,ovary,ovate,ovoid-reniform,pale,pedicel,petiole,pitted,plant,prominent,pubescent,rounded,seed,shape,shaped,short,shrub,simple,size,soon,specimen,stem,stigma,style,surface,tan,tapering,tear-drop,trichome,truncate,tube,unicellular,uniseriate,vein,way,white,x,yellowish	.01,1,1.2-2.5,1/3,2.5-4.5,3-5,7-8,anthesi,ba,barely,black,blade,body,bright,broadly,conical,darker,deciduous,deflexed,deltoid,differentiated,differing,difoliate,distance,distinct,dried,eaf,edicel,eed,elliptic,expanded,exsertion,free,geminat,greatly,incrassate,lateral,live,lobe,lobed,lon,lower,m.,main,major,materia,material,member,minor,minute,nflorescence,obovoid,obvious,older,opposite,overlapping,pair,papillose,pore,poricidal,portion,proximal,purple,reflexed,ruit,scar,slightly,somewhat,straight,strongly,tall,tip,touching,ud,unit,usually,whit,widest,woody,ympodial,young	alternate,arrangement,colour,diameter,exertion,form,fruit,growth,height,history,inflorescence,length,life,lobing,na,number,peduncle,per,primary,texture,type	.1,.3,.5,/3,0.25-0.5,0.8-1,0.8-1.5,1-3,10-14-flowered,10-15,2,3.5-5,acuminate,acute,apex,aspect,basal,base,beneath,berry,calyx,cm,decurrent,delicate,dia,dry,drying,erect,exserted,f,flattened,gently,glabrous,globose,green,grey,long,minutely,mm,narrowly,ovate,ovoid-reniform,pale,petiole,pitted,prominent,pubescent,rounded,shaped,short,shrub,simple,soon,specimen,tan,tapering,tear-drop,trichome,truncate,unicellular,uniseriate,way,white,x,yellowish	alternate,na
235	wfo-0001028524	success	236	143	100	112	124	31	94	6	0.3,0.6-1.4,1-5,1.1-1.2,1.5-1.6,10-20,11,2-6,2.5-3.8,2.8-3.5,3-10,3-15,3.4-3.6,4-6,4-8,6-9,7-11,8-13,acuminate,acute,anther,anthesi,apex,bark,base,becoming,berry,blunt-tipped,branch,branched,brown,bud,calyx,chartaceous,cm,conical,continued,corolla,cream,dark,deltoid,densely,diameter,dm,due,entire,exserted,ferrugineous,filament,flower,fruit,fruiting,glabrescent,glabrous,granular-tomentose,gray,green,greenish,growth,honeycombed,lanceolate,late,lateral,leaf,length,margin,midvein,mm,nearly,oblong,obtuse,orbicular,ovate,ovate-lanceolate,pale,pedicel,peduncle,persistent,petiole,probably,pubescent,rather,reniform,reticulate-punctate,ripe,rounded,scabridulous,side,simple,slightly,somewhat,stelliform,stem,stigma,strongly,style,subcoriaceous,subglobose,suborbicular,sulcate,terete,thin,time,translucent,tree,tube,unarmed,vein,velutinous,x,yellow,yellowish	-2.7,-3,.5-1,/10-3/10,0-150,0.3-0.8,0.5-3.5,1.2-1.3,1.5-3,1.8-2.5,1/3-2/3,2-3.8,2.5-3.4,2.5-4,3-4.3,3.3-4,4.3-6,6-7,7-10,9-14,abaxially,accrescent,adaxially,ag,along,apart,apical-lateral,apparently,articulated,ascending,axe,axillary,ba,blade,capitat,closely,dehiscing,distal,eaf,echinoi,echinoid,eed,elliptic,extend,few-,few-rayed,first,fleshy,free,glabrescen,hair,half,high,indument,inserted,interpetalar,introrse,lacking,lanceolat,large,later,lobe,lobed,long,longitudinal,lower,m.,main,many-rayed,matted,midvei,mixed,multangulate,nflorescence,obscured,often,older,orolla,overlapping,partly,perfect,plurifoliate,pore,porrect-stellate,present,prominent,pseudo-terminal,rachi,ray,relatively,ruit,runk,sessile,short,short-stalked,slit,small,spaced,sparingly,sparsely,stalked,stamen,stellate,stout-stalked,suture,tamen,testa,thick,thick-stalked,thin-stalked,tissue,tomentose,tomentu,touching,unarme,unit,usually,vary,warty,way,wide,yellowish-green,ympodial,young	1-3,arrangement,capitate,characteristic,colour,corrugation,drying,exertion,form,glabrousnes,height,history,inflorescence,life,lobing,na,new,number,ovary,per,perennial,plant,primary,pseud-terminal,seed,shape,size,sparing,surface,texture,type	0.3,0.6-1.4,1-5,1.1-1.2,1.5-1.6,10-20,11,2-6,2.5-3.8,2.8-3.5,3-10,3-15,3.4-3.6,4-6,4-8,6-9,7-11,8-13,acuminate,acute,anthesi,apex,becoming,berry,blunt-tipped,branched,brown,chartaceous,cm,conical,continued,cream,dark,deltoid,densely,diameter,dm,due,entire,exserted,ferrugineous,flower,fruit,glabrescent,glabrous,granular-tomentose,gray,green,greenish,growth,honeycombed,lanceolate,late,lateral,midvein,mm,nearly,oblong,obtuse,orbicular,ovate,ovate-lanceolate,pale,persistent,probably,pubescent,rather,reniform,reticulate-punctate,ripe,rounded,scabridulous,side,simple,slightly,somewhat,stelliform,stem,stigma,strongly,subcoriaceous,subglobose,suborbicular,sulcate,terete,thin,time,translucent,tree,unarmed,velutinous,x,yellow,yellowish	1-3,capitate,na,perennial,pseud-terminal,sparing
236	wfo-0001028525	success	257	107	73	90	167	17	72	1	.25,0.2-0.3,0.5,0.5-1.5,0.5-2.5,1-2.5,1.1-1.7,1.2-1.6,1.5,10,10-13,2,2-2.5,3,3-5,3-7,4-15,4-5,6,almost,anther,apex,apically,bark,base,berry,black,branch,branched,broadly,brown,calyx,capitate,chartaceous,clavate,cm,conical,corolla,dendritic,dendritic-pubescent,developed,diameter,dilated,drying,elongated,form,frequently,fruit,fruiting,green-brown,grey,lateral,leaf,liana,light,lobed,long,lumpy,main,mature,mauve,membranous,mm,obconical,oblong,orange-brown,ovate,partly,pedicel,peduncle,petiole,pubescent,pyriform,ray,red-brown,shrub,simple,size,slender,spheroidal,stem,stigma,style,surface,terminal,trichome,unarmed,whitish,wide,x	.4,0.2-0.6,0Â°,1-1.5,1-2,1-4,1.5-3,1/3-3/4,1mm,2-3,2.5-5,4,4-7,7,7-13,7.5,accrescent,acuminate,acute,age,along,alternate,alyx,anthesi,apar,apart,apice,apparently,around,articulated,attenuate,axil,becoming,brachyblast,branching,centre,clearly,clum,clustered,cordate,cup,curved,dark,deeply,delineated,deltoid,densely,density,detaching,developing,discolorous,divided,domatia-like,dorsal,dorsifixed,eaf,eed,ellipsoi,entire,equal,erect,eye,fertilisation,fewer,filament,fine,flat,flattened,flexible,flexuous,flower,formed,forming,free,frui,glabrescent,glabrous,increasing,inside,known,lamina,laterally,leave,lengthening,less,like,linear,lobe,longer,longitudinally,loop,loose,lower,m.,margin,midvein,minute,much,multicellular-dendritic,naked,narrowly,nflorescence,nther,obscuring,often,one,orolla,outside,overlapping,ovoid,pair,pendulous,perfec,pericarp,plurifoliat,pore,poricidal,portion,primary,prominent,protruding,puberulous,rachi,ridged,rounded,ruit,scar,scattered,sessile,side,sinus,slightly,small,smaller,smoot,smooth,sometimes,somewhat,soon,sparsely,spreading,stripe,structure,stump,tangling,tearing,terete,tertiary,thick,thin,tip,toward,truncate,tube,ud,uneven,unit,vary,vein,venation,visible,weakly,well-developed,white,wider,ympodial,young	arrangement,characteristic,colour,growth,inflorescence,length,lobing,na,number,ovary,per,pubescence,seed,shape,texture,type,width	.25,0.2-0.3,0.5,0.5-1.5,0.5-2.5,1-2.5,1.1-1.7,1.2-1.6,1.5,10,10-13,2,2-2.5,3,3-5,3-7,4-15,4-5,6,almost,apex,apically,base,berry,black,branch,branched,broadly,brown,capitate,chartaceous,clavate,cm,conical,dendritic,dendritic-pubescent,developed,diameter,dilated,drying,elongated,frequently,fruit,green-brown,grey,lateral,liana,light,lobed,long,lumpy,mature,mauve,membranous,mm,obconical,oblong,orange-brown,ovate,partly,pubescent,pyriform,red-brown,shrub,simple,slender,spheroidal,terminal,unarmed,whitish,wide,x	na
237	wfo-0001028528	success	155	125	87	97	58	28	84	3	.5,0.9-1.2,1-2,1.1-1.2,1.8-2,2-4,2.5-3,3.5-4,3.5-6,3/4,4-6,6-7,8-9,?,abaxial,absent,acute,age,anther,anthesi,apex,apical,attenuate,bark,basal,base,becoming,berry,bi-lobed,blackish,branch,branching,calyx,cm,conical,corolla,decurrent,dendritic,diameter,elliptic,except,exserted,filament,flattened,fork,fruiting,glabrous,globose,growth,immature,later,leaf,lobed,long,margin,minutely,mm,mucronate,narrowly,nodding,obovate,occasionally,outline,ovary,pair,pedicel,per,petiole,pitted,plurifoliate,pore,poricidal,pubescent,reddish-brown,revolute,round,secondary,shiny,shrub,slit-like,somewhat,sparsely,stem,stigma,strongly,style,surface,tapering,terminal,tip,trichome,tube,vein,violet,way,white,x	1.5,2-3,4-5,6-10,acuminate,adaxial,adaxially,along,ba,coriaceous,densely,denser,dichasia,eaf,edicel,eed,erect,ew,flower,free,glabrat,glandular,impressed,inserted,leave,like,lobe,lower,m.,midvein,minute,nflorescence,older,papillo,pericarp,petal,planar,portion,prominent,pyramidal,ruit,scar,short,sleeve,stamen,ste,tall,thin,time,triangular,tub,ud,unit,wide,winged,woody,ympodial,young	arrangement,bud,characteristic,colour,dichasial,drying,exertion,form,fruit,glabrousnes,height,history,inflorescence,length,life,lobing,na,new,number,papillose,peduncle,plant,primary,seed,shape,size,texture,type	.5,0.9-1.2,1-2,1.1-1.2,1.8-2,2-4,2.5-3,3.5-4,3.5-6,3/4,4-6,6-7,8-9,?,absent,acute,age,anthesi,apical,attenuate,basal,base,becoming,berry,bi-lobed,blackish,branch,branching,calyx,cm,conical,decurrent,dendritic,diameter,elliptic,except,exserted,flattened,fork,glabrous,globose,immature,later,lobed,long,margin,minutely,mm,mucronate,narrowly,nodding,obovate,occasionally,outline,pair,per,petiole,pitted,plurifoliate,pore,poricidal,pubescent,reddish-brown,revolute,round,secondary,shiny,shrub,slit-like,somewhat,sparsely,stem,strongly,surface,tapering,terminal,tip,trichome,tube,vein,violet,way,white,x	dichasial,na,papillose
238	wfo-0001028529	success	164	115	82	88	76	27	76	6	.2,0.1,0.5,0.5-2,0.8-1.3,1-1.2,1-1.5,1.5,2/3,5-6,across,anther,attenuate,bark,base,berry,bluish,brown,bud,calyx,capitate,cast,cm,corolla,dark,decurrent,dia,erect,exfoliating,exserted,filament,fruiting,furcate,glabrous,globose,green,hyaline,internodal,lanceolate,leaf,less,lobe,lobed,metallic,minute,minutely,mm,narrowly,nearly,oblanceolate,occasionally,older,opposite,ovary,ovoid-reniform,paler,papillae,papillose,pedicel,petiole,pitted,scattered,shape,shaped,shrub,simple,size,slender,slightly,small,smooth,somewhat,soon,stem,stigma,straight,style,surface,tapering,tear-drop,tip,tube,way,white,winged,woody,x,yellowish	0.8-3,0.8-3.2,1,2.5-3,3-40-flowered,3-5,6-9,7-8,8-14,acuminate,acute,age,anthesi,apart,apex,apiculate,becoming,beginning,beneath,close,cork,course,deflexe,deltoid,distal,eaf,edicel,eed,ellipsoi,elliptic,evenly,flower,free,growing,heterostylous,hrub,immature,indistinct,inflorescenc,lateral,lenticellat,linear,lon,long,lower,main,major,middle,minor,much,nflorescence,one,pair,papillo,planar,pore,poricidal,portion,present,prominent,range,reflexed,river,ruit,scar,short,spaced,species,subshrub,tall,ud,umbonate,variable,vein,widest,young	2,abaxial,adaxial,alternate,arrangement,characteristic,colour,deflexed,diameter,ellipsoid,exertion,form,fruit,growth,height,history,inflorescence,length,lenticellate,life,lobing,na,peduncle,plant,seed,texture,type	.2,0.1,0.5,0.5-2,0.8-1.3,1-1.2,1-1.5,1.5,2/3,5-6,across,attenuate,base,berry,bluish,brown,bud,calyx,capitate,cast,cm,dark,decurrent,dia,erect,exfoliating,exserted,furcate,glabrous,globose,green,hyaline,internodal,lanceolate,leaf,less,lobe,lobed,metallic,minute,minutely,mm,narrowly,nearly,oblanceolate,occasionally,older,opposite,ovoid-reniform,paler,papillae,papillose,petiole,pitted,scattered,shaped,shrub,simple,slender,slightly,small,smooth,somewhat,soon,stem,straight,tapering,tear-drop,tip,tube,way,white,winged,woody,x,yellowish	2,alternate,deflexed,ellipsoid,lenticellate,na
239	wfo-0001028532	success	186	121	80	100	86	21	77	3	0-19,0.2-1,1-1.7,1-2,1-3,1.3-8.7,1.4-1.6,17-42,2-3,2-8,2.2-4.2,3-10,3-7,3.9-5,4-7,5-9,5.5-15,6.5-9.2,7.5-15.2,acuminate,acute,anther,apex,attenuate,base,berry,blade,brownish,cell,chartaceous,clavate,cm,condition,connivent,corolla,covering,dark,deep,diameter,drying,filament,flower,fresh,fruit,glabrous,globose,green,green-white,greenish,hair-like,herb,homostylous,interjected,lanceolate,lateral,leaf,leaflet,lobe,long,make,medium,mm,moniliform,mottled,mucilaginous,odd-pinnate,ovate,ovate-lanceolate,ovoid,pair,pedicel,peduncle,pentagonal,petiole,petiolulate,plant,purple,ripe,rotate,rounded,seed,size,sometimes,spot,stigma,straight,style,terminal,testal,thick,throughout,tube,tuber,unwinged,wall,wet,white,whitish,x,yellow	1-1.6,1-5,15-36,2-6,3-5,3.3-4.4,5-merou,abaxiall,abaxially,acumen,adaxially,ag,along,alyx,apart,apparently,arranged,articulated,asymmetric,axe,axillary,basiscopic,bead,bud,capitat,decreasing,digestion,distal,dorsally,eaf,edge,eed,enzyme,erec,exceeding,flat,folded,forked,geminat,generally,glabrou,half,honeycomb-shaped,larger,lengthening,like,linear,living,lower,middl,multiple,necklace,nflorescence,orbicular,orolla,perfect,plurifoliate,pore,poricidal,removed,ruit,second,sessile,seudostipule,side,slightly,slit,spaced,specimen,stamen,stolon,subequal,subtending,symmetric,tall,tamen,tem,tip,tissue,toward,tri-,typically,unit,usually,vary,ympodial	5-merous,abaxial,adaxial,arrangement,calyx,capitate,colour,erect,form,growth,height,history,inflorescence,length,life,ovary,pseudostipule,shape,stem,surface,texture	0-19,0.2-1,1-1.7,1-2,1-3,1.3-8.7,1.4-1.6,17-42,2-3,2-8,2.2-4.2,3-10,3-7,3.9-5,4-7,5-9,5.5-15,6.5-9.2,7.5-15.2,acuminate,acute,attenuate,berry,brownish,cell,chartaceous,clavate,cm,condition,connivent,covering,dark,deep,diameter,drying,fresh,glabrous,globose,green,green-white,greenish,hair-like,herb,homostylous,lanceolate,lateral,long,make,medium,mm,moniliform,mottled,mucilaginous,odd-pinnate,ovate,ovate-lanceolate,ovoid,pentagonal,petiolulate,purple,ripe,rotate,rounded,seed,sometimes,spot,straight,testal,thick,throughout,unwinged,wall,wet,white,whitish,x,yellow	5-merous,capitate,erect
240	wfo-0001028547	success	221	117	77	94	127	23	75	2	.2,.5,.8,/5,0,0.3-0.4,1-2.5,1.2-1.4,1.7-2,2-1.5,2-2.5,2.5-2.8,2.8-3.2,3.5-4.5-6,4-5,7-10-13,absent,acute,anther,apex,apically,apparently,articulated,bark,base,berry,bright,calyx,cell,cm,cuneate,densely,diameter,dull,elongate,entire,erect,filament,flattened-reniform,fruit,fruiting,glabrous,inflorescence,lateral,leaf,length,lobed,long,long-acuminate,margin,maturity,mauve,mm,moderately,narrow-deltate,often,orange,orange-brown,outline,ovate,pair,pedicel,peduncle,petiole,pit,poricidal,prickly,primary,purple,raised,red,reddish,scandent,shallowly,shrub,simple,small,smooth,somewhat,spherical,stellate-pubescent,stem,style,surface,tapering,terminal,tip,truncate,vein,way,wide,yellow,yellow-green,young	-3,.7,/2,0-1,0-10,0-15,0-2,0-30,0-5,0.05-0.15,0.1-0.2,0.15,0.2-0.35,0.5-1.5-2.5-3,0.7-1,0.8-1,1-2,1-4,1-5,1.5-2.5,1/3-1/2,1/5-1/4,10-12,2-4,2-6,3-5,4-6,5-merous,6-8,7-9,abaxial,abaxially,adaxial,alyx,apar,apart,ape,appearing,blade,branched,branching,bulbous,chartaceous,conical,connivent,cream,curved,dark,deltate,discolorous,distance,drying,eaf,eed,elongating,equal,extending,faint,flattened,flower,free,gently,glabrescent,glabrou,gray-brow,green,infructescence,lobe,lon,long-styled,longer,lower,marking,mature,midpoint,midvein,nflorescence,oblong,occasionally,older,one,open,orolla,oung,pale,pendulous,per,perfect,pericarp,plurifoliat,porrect,portion,prickl,prickle,ray,reflexed,rounded,ruit,scar,sessile,short-styled,side,slender,sometimes,spaced,spreading,stalk,stalked,staminate,stellate,straight,subsessile,tamen,terete,tertiary,thin-acuminat,time,trichome,tube,unit,usually,vary,venation,villous,woody,yellow-orange,ympodial	arrangement,branch,characteristic,colour,corolla,exertion,form,glabrousnes,gray-brown,growth,height,history,life,lobing,new,ovary,plant,seed,shape,size,texture,thin-acuminate,type	.2,.5,.8,/5,0,0.3-0.4,1-2.5,1.2-1.4,1.7-2,2-1.5,2-2.5,2.5-2.8,2.8-3.2,3.5-4.5-6,4-5,7-10-13,absent,acute,apically,apparently,articulated,base,berry,bright,cell,cm,cuneate,densely,diameter,dull,elongate,entire,erect,flattened-reniform,glabrous,lateral,lobed,long,long-acuminate,maturity,mauve,mm,moderately,narrow-deltate,often,orange,orange-brown,outline,ovate,pair,pit,poricidal,prickly,purple,raised,red,reddish,scandent,shallowly,shrub,simple,small,smooth,somewhat,spherical,stellate-pubescent,tapering,terminal,tip,truncate,way,wide,yellow,yellow-green,young	gray-brown,thin-acuminate
241	wfo-0001028587	success	178	89	48	67	111	22	45	3	.5,0,0.3-1,0.5-1,0.8-1.6,0.8-1.8,0.8-2.9,1-1.3,1-2,1-4,1.3-5.1,2.5,6-8,anther,bark,base,berry,brown,calyx,cm,corolla,densely,dia,ellipsoid,filament,fruit,fruiting,geminate,glabrous,globose,green,greenish-white,leaf,length,lobed,long,minor,minutely,mm,nearly,obovate,obovoid,ovary,ovate,ovoid-reniform,papillose,pedicel,per,petiole,puberulent,pubescent,pubesent,scattered,seed,shrub,simple,sparsely,stem,stigma,style,subumbellate,trichome,tube,type,uniseriate,white,x	.4,.75,0.3,0.5,0.7-1.2,1-1.5,1/4,2-5,2.1-6.9,3-8,6.5-17.7,8-10,8-10-flowered,abruptly,accrescent,across,acuminate,acute,anthesi,apex,baseflower,becoming,ca,chartaceou,closely,coat,cracking,cup,deflexed,degree,different,difoliate,distal,drying,eaf,edicel,eed,erect,flower,forming,free,geminat,impressed,keeled,lamina,lateral,layer,like,lobe,lon,long-styled,lower,main,major,middle,midrib,minute,narrowing,nflorescence,obe,occasionally,often,older,open,opposite,outer,overlappin,pair,paler,papillo,peeling,persistent,pitted,pore,poricidal,portion,pubescence,reflexed,ruit,scar,short,slender,slightly,slit-like,spaced,stiff,straight,straw-colored,surface,tall,terminal,thickened,thin,tip,transversel,triangular,two,ud,umbonate,unicellular,unit,upon,upper,usually,variable,vein,wide,widest,woody,ympodial,young	abaxial,adaxial,arrangement,bud,characteristic,colour,diameter,form,glabrousnes,growth,hair,height,history,inflorescence,life,lobing,number,perennial,plant,shape,size,texture	.5,0,0.3-1,0.5-1,0.8-1.8,0.8-2.9,1-1.3,1-2,1-4,1.3-5.1,2.5,6-8,base,berry,brown,cm,densely,ellipsoid,geminate,glabrous,globose,green,greenish-white,lobed,long,minutely,mm,nearly,obovate,obovoid,ovate,ovoid-reniform,papillose,puberulent,pubescent,pubesent,scattered,shrub,simple,sparsely,subumbellate,trichome,uniseriate,white,x	.8-1.6,di,perennial
242	wfo-0001028594	success	142	104	64	84	58	20	63	1	.5,0-100,0.8-1.8,1-1.2,1-1.3,1-1.5,1-2,1.5-9,12,12-14,2,3-4,3-9,5-6,6-20,6-7,acute,anther,axillary,becoming,berry,black,bottle-shaped,calyx,climbing,cm,conical,corolla,densely,diameter,drying,ellipsoid,elliptic,exserted,filament,flattened-reniform,fruit,fruiting,glabrous,globose,green,hair-like,herb,inflorescence,lax,leaf,length,lobe,long,maturity,minute,minutely,mm,obtuse,orange-brown,ovary,ovate,pair,pedicel,per,petiole,primary,projection,pubescent,purple,quit,rectangular,reddish,regular,rounded,simple,slightly,soft,somewhat,sparsely,spreading,stigma,strongly,style,surface,tube,vein,violet,x	0.3-1.0,1-3,3-6,abaxially,acuminate,adaxially,along,anthesi,apex,axil,base,bearing,capitat,cell,denser,eaf,edicel,eed,epidermal,especially,floo,flower,forest,free,glabrat,immature,inflorescenc,like,lon,lower,margin,nflorescence,noddin,often,open,papillate,pendent,planar,portion,reflexed,rest,ruit,scar,scattered,side,smooth,strait,tem,time,tip,trailing,trichome,tub,ud,unifoliat,uniseriate,unit,ympodial	abaxial,adaxial,arrangement,bud,capitate,colour,exsertion,form,growth,history,life,number,plant,pubescence,seed,shape,size,stem,texture,type	.5,0-100,0.8-1.8,1-1.2,1-1.3,1-1.5,1-2,1.5-9,12,12-14,2,3-4,3-9,5-6,6-20,6-7,acute,axillary,becoming,berry,black,bottle-shaped,climbing,cm,conical,densely,drying,ellipsoid,elliptic,exserted,flattened-reniform,glabrous,globose,green,hair-like,herb,lax,long,maturity,minute,minutely,mm,obtuse,orange-brown,ovate,pair,projection,pubescent,purple,quit,rectangular,reddish,regular,rounded,simple,slightly,soft,somewhat,sparsely,spreading,strongly,violet,x	capitate
243	wfo-0001028660	success	204	148	111	124	80	24	107	4	0.2-1.1,0.3-1.1,0.5-2.8,0.5-5.5,0.7-4.2,0.8-1,0.9-2.5,1-2,1.5-2.8,1.5-4,1.5-7.6,2-11,2-6,2-9,3-30,3-7,3.8-13,4-6,5-8,6,7-10,abaxially,absent,adaxially,along,anther,axillary,berry,blade,blue,borne,brownish,bud,cell,chartaceous,ciliate,clavate,cm,condition,connivent,corolla,covering,decumbent,densely,diameter,distal,dot,drying,elliptic,end,entirely,especially,filament,flower,forked,fresh,fruit,generally,glabrous,globose,green,green-white,greenish,hair-like,half,herb,homostylous,interjected,lanceolate,lateral,leaflet,linear,lobe,long,make,margin,membranous,midrib,minutely,mm,mucilaginous,narrowly,odd-pinnate,often,ovoid,pedicel,peduncle,pentagonal,petiole,plant,puberulent,pubescent,purple,rarely,ripe,rotate,scattered,seed,singly,size,sparsely,stem,stigma,straight,style,substellate,subtending,terminal,testal,thick,throughout,tinged,tip,tube,tuber,typically,unwinged,usually,wall,wet,white,whitish,x,yellow	0-5,0.1-0.3,1-10,2-5,20,3-5,3-9,5-merou,acumen,acute,ag,alyx,apart,apex,apparently,articulated,attenuate,axe,base,broadly,capitat,decurrent,digestion,dorsally,eaf,edge,eed,enzyme,erec,exceeding,except,flat,folded,geminat,glabrou,greatly,hair,honeycomb-shaped,lengthening,less,like,living,lower,middl,nflorescence,oblique,obtuse,orbicular,orolla,ovate,pair,perfect,petiolulate,petiolule,plurifoliate,pore,poricidal,proximal,reduced,removed,ruit,scabrous,sessile,seudostipule,short,slit,spaced,specimen,stamen,ste,stolo,subequal,sunny,tall,tamen,tem,tri-,unit,vary,ympodial	5-merous,abaxial,adaxial,arrangement,calyx,capitate,colour,erect,form,growth,height,history,inflorescence,leaf,length,life,ovary,presence,pseudostipule,shape,stolon,surface,texture,type	0.2-1.1,0.3-1.1,0.5-2.8,0.5-5.5,0.7-4.2,0.8-1,0.9-2.5,1-2,1.5-2.8,1.5-4,1.5-7.6,2-11,2-6,2-9,3-30,3-7,3.8-13,4-6,5-8,6,7-10,abaxially,absent,adaxially,along,axillary,berry,blue,borne,brownish,bud,cell,chartaceous,ciliate,clavate,cm,condition,connivent,corolla,covering,decumbent,densely,diameter,distal,dot,drying,elliptic,end,entirely,especially,forked,fresh,generally,glabrous,globose,green,green-white,greenish,hair-like,half,herb,homostylous,lanceolate,lateral,linear,long,make,margin,membranous,midrib,minutely,mm,mucilaginous,narrowly,odd-pinnate,often,ovoid,pentagonal,plant,puberulent,pubescent,purple,rarely,ripe,rotate,scattered,seed,singly,sparsely,straight,substellate,subtending,terminal,testal,thick,throughout,tinged,tip,typically,unwinged,usually,wall,wet,white,whitish,x,yellow	5-merous,capitate,erect,stolon
244	wfo-0001028667	success	128	116	77	88	40	28	73	4	0.4-0.7-2.6,0.7-4,1-1.5,1-2-1.5,1-4.5,1-6,1.3-2,3-11,5,8-10,acute,anthesi,apex,appearing,articulated,axillary,base,berry,branch,calyx,cell,clustered,cm,completely,conical,corolla,creamy,deciduous,diameter,dry,ellipsoid,elliptic,entire,exfoliating,exserted,flattened,flower,fragrant,fruiting,glabrous,growth,inflorescence,irregularly,leaf,like,margin,midrib,minutely,mm,narrowly,new,occasionally,other,outer,pale,pedicel,peduncle,perfect,petiole,pitted,primary,reniform,revolute,scar,shiny,shoot,short,simple,sleeve,slender,small,soon,spaced,stem,straw-colored,strongly,surface,terminal,tip,triangular,vein,vine,visible,white,woody,wrinkling,x,yellow	.5,3,5-20,5-merou,aid,alyx,apar,ark,around,branched,climbin,climbing,coriaceous,curling,discolorous,eaf,eed,exfoliatin,fide,lobe,long,lower,mentz,nflorescence,older,orolla,papilla,papillat,pendan,per,plurifoliat,slightly,support,tem,tube,twice,twining,ud,unit,ympodial	5-merous,apart,arrangement,bark,bud,characteristic,colour,corrugation,exertion,exfoliation,form,fragrance,fruit,glabrousnes,height,history,length,life,lobing,na,papillae,papillate,plant,seed,shape,size,texture,type	0.4-0.7-2.6,0.7-4,1-1.5,1-2-1.5,1-4.5,1-6,1.3-2,3-11,5,8-10,acute,anthesi,appearing,articulated,axillary,base,berry,branch,calyx,cell,clustered,cm,completely,conical,creamy,deciduous,dry,ellipsoid,elliptic,entire,exfoliating,exserted,flattened,fragrant,glabrous,inflorescence,irregularly,leaf,like,midrib,minutely,mm,narrowly,occasionally,other,outer,pale,perfect,pitted,reniform,revolute,shiny,shoot,short,simple,sleeve,slender,small,soon,spaced,stem,straw-colored,strongly,terminal,tip,triangular,vine,visible,white,woody,wrinkling,x,yellow	5-merous,apart,na,papillate
245	wfo-0001028688	success	137	99	60	69	68	30	57	3	0.4-1,0.5,0.5-0.75,0.5-1,0.9-1,1-5,1.1-1.2,1.4-2.8,2-3,5-11,5-6,acuminate,acute,anther,apex,area,bark,base,branch,calyx,clavate,cm,corolla,curl-tipped,deciduous,elliptic,exserted,filament,furcate,glabrous,globose,golden,lanceolate,leaf,lobed,mm,near,nearly,occasionally,older,opposite,ovary,overtopping,papillose,pedicel,petiole,pilose,pubescent,reddish-brown,shaped,shiny,shoot,shrub,size,slender,slightly,soon,sparsely,stem,stigma,straight,style,tapering,tear-drop,tip,trichome,tube,uniseriate,white	.5,0.5-1.5,1-1.5,1-1.8,1-3,2.2-4.8,across,along,anthesi,apar,beneath,bi-cellular,decreasing,deflexed,deltoid,densely,densest,dia,differing,difoliate,eaf,edicel,eed,exfoliatin,free,geminat,interpetalar,irregularly,know,known,like,lobe,lon,long,lower,major,markedly,membraneous,middle,minor,minutely,nflorescence,often,paler,planar,pore,poricidal,portion,proximal,ruit,scar,sinus,spaced,styl,tall,terminal,thickened,thin,tub,ud,unit,usually,vein,wide,widest,x,ympodial,young	abaxial,adaxial,bud,characteristic,colour,deciduousnes,diameter,exertion,exfoliating,form,fruit,growth,height,history,inflorescence,length,life,lobing,na,number,per,perennial,plant,seed,shape,surface,texture,type,variation,width	0.4-1,0.5,0.5-0.75,0.5-1,0.9-1,1-5,1.1-1.2,1.4-2.8,2-3,5-11,5-6,acuminate,acute,area,base,branch,calyx,clavate,cm,curl-tipped,deciduous,elliptic,exserted,furcate,glabrous,globose,golden,lanceolate,leaf,lobed,mm,near,nearly,occasionally,older,opposite,overtopping,papillose,pilose,pubescent,reddish-brown,shaped,shiny,shoot,shrub,slender,slightly,soon,sparsely,straight,style,tapering,tear-drop,tip,tube,uniseriate,white	exfoliating,na,perennial
246	wfo-0001028698	success	166	85	47	62	104	23	45	2	0.3-0.75,1-2,1-9.8,1.9-4,13-25,2-10,2-3,2-4,3-5,4-14,5-15,5-6,5-8,6-13,6-27,8-10,9-35,branched,calyx,cm,conical,corolla,cyme,dark,diameter,dichasial,dichasially,distal,ebracteate,ellipsoid,forked,green,herbaceous,interjected,lateral,leaf,leaflet,light,medium,mm,monochasial,mucilaginous,odd-pinnate,ovoid,pair,pedicel,peduncle,pentagonal,perennial,petiole,plant,puberulent,pubescent,rotate,seed,size,strigose,style,terminal,violet,white,yellow	0-1.,1-4,1.8-5,3-17,3-6-foliat,3.5,6,abaxiall,abaxially,acumen,acuminate,acute,adaxially,apex,apical,apically,articulate,base,broadly,cell,commonly,connate,covering,cuneate,darker,decurrent,dehiscent,digestion,diminishing,dorsally,dot,eaf,edge,eed,elliptical,emoval,enzyme,equal,exceeding,filament,first,flat,flower,folded,generally,globo,gradually,green-white,hair-like,half,honeycomb,introrse,living,lobe,lon,long,long-attenuate,lower,lunat,make,maturing,minute,nflorescence,nther,oblique,often,orolla,ovate,pattern,perfect,petiolule,plan,poricidally,proximal,rachi,raised,rarely,reveal,ruit,sessile,seudostipule,short,slit,smooth,specimen,stamen,stigma,straight,tal,tem,testal,thick,throughout,toward,tuber-bearing,two,typically,unit,usually,vary,wall,wide,ympodial,Â¼	0-10,abaxial,adaxial,anther,arrangement,branching,colour,form,fruit,growth,height,history,inflorescence,length,life,ovary,pseudostipule,shape,stem,surface,texture,wet,width	0.3-0.75,1-2,1-9.8,1.9-4,13-25,2-10,2-3,2-4,3-5,4-14,5-15,5-6,5-8,6-13,6-27,8-10,9-35,branched,cm,conical,cyme,dark,dichasial,dichasially,ebracteate,ellipsoid,forked,green,herbaceous,light,medium,mm,monochasial,mucilaginous,odd-pinnate,ovoid,pentagonal,perennial,puberulent,pubescent,rotate,strigose,violet,white,yellow	0-10,wet
247	wfo-0001028716	success	145	92	67	70	75	22	61	6	.2,.5,0.6-1.9,1-2,10-40-flowered,11-16.4,2.5-8,3.6-8.8,7-8,8-9,acuminate,anther,anthesi,apex,appearing,bark,base,bi-cellular,brown,calyx,cm,corolla,cuneate,dark,decurrent,dia,ellipsoid,except,filiform,glabrous,glandular,hirsute,leaf,like,lobe,lobed,long,long-triangular,minutely,mm,nearly,node,often,ovary,ovate,papillose,pedicel,petiole,pointed,puberulent,pubescent,reflexed,shape,shaped,shrub,simple,size,slightly,sparsely,stem,straight,style,tear-drop,trichome,truncate,uniseriate,white,widening,x,young	0.5,0.75,1.9-5.5,2-4,2.2-7.9,5-6,9-10,across,anisophyllou,apart,asymmetric,ba,becoming,beginning,beneath,branched,deflexed,differing,difoliate,eaf,edicel,eed,elliptic,evenly,fertilization,fifth,filament,free,fruit,geminate,inflorescenc,intermediate,know,known,lateral,lengthening,lenticellat,less,lon,lower,main,major,markedly,middle,minor,much,nflorescence,older,one,opposite,orbicular,pair,pore,poricidal,portion,prominent,proximal,raised,remaining,rounded,ruit,scar,spaced,stigm,strongly,tall,tip,triangular,tube,two,ud,unit,vein,widest,ympodial	alternate,arrangement,bud,characteristic,colour,diameter,exertion,form,growth,height,history,inflorescence,length,lenticellate,life,lobing,peduncle,perennial,plant,stigma,surface,texture	.2,.5,0.6-1.9,1-2,10-40-flowered,11-16.4,2.5-8,3.6-8.8,7-8,8-9,acuminate,anthesi,appearing,base,bi-cellular,brown,calyx,cm,cuneate,dark,decurrent,dia,ellipsoid,except,filiform,glabrous,glandular,hirsute,leaf,like,lobe,lobed,long,long-triangular,minutely,mm,nearly,node,often,ovate,papillose,petiole,pointed,puberulent,pubescent,reflexed,shaped,shrub,simple,slightly,sparsely,stem,straight,tear-drop,trichome,truncate,uniseriate,white,widening,x,young	alternate,inflorescence,lenticellate,perennial,surface,texture
248	wfo-0001028723	success	211	166	136	145	66	21	130	6	-1.5,.3,0.2,0.8-1,0Â°,1-1.8,1-2.2,1-2.5,1/3-1/2,1/5-1/3,10-15,10-16,2-2.5,2-2.7,2-4,3.5-4,4,4-5,5,5-6,5-7,abaxial,abaxially,acute,adaxially,age,almost,anther,anthesi,apex,apically,apparently,bark,base,becoming,brachyblast,branch,branched,branching,broadly,brown,calyx,capitate,clearly,clustered,cm,concolorous,corolla,dark,decurrent,delineated,dendritic,densely,density,developed,diameter,dilated,divided,drying,elliptic,entire,equal,except,faint,filament,fine,flat,flexuous,flower,frequent,glabrous,gradual,green,increasing,inner,leaf,length,lengthening,liana,like,long,long-attenuate,longitudinally,main,margin,membranous,middle,midvein,minutely,mm,mostly,multiply,narrowly,obconical,oblong,obovate,occasional,orange-brown,outer,ovate,overlapping,pair,pale,pedicel,peduncle,petiole,poorly,poricidal,primary,pubescent,raised,ray,region,ridged,scar,short,shrub,side,simple,slender,small,sparsely,spreading,stem,stigma,stump,style,surface,terminal,tertiary,tip,toward,transition,trichome,tube,unarmed,unevenly,vein,venation,white,widely,wrinkled,x,yellow,youngest	.5,0-0.5,0.8-2,1,1-1.5,2.5,3-4,alternate,alyx,another,apar,apice,articulated,common,conical,curved,deltoid,domatia,dorsifixed,eaf,eed,ellipsoi,ey,formed,free,junction,know,known,less,lobe,lobed,lower,m.,much,naked,nflorescence,nther,obtuse,one,orolla,papillo,perfec,plurifoliat,pore,portion,prominent,protruding,rachi,regular,ruit,separated,sinus,smaller,smooth,surrounding,tearing,tissu,tuft,ud,uneven,unit,vary,visible,wide,ympodial,young	apart,arrangement,bud,characteristic,colour,ellipsoid,form,fruit,growth,inflorescence,lobing,na,papillose,perfect,presence,seed,shape,size,texture,type,ye	-1.5,.3,0.2,0.8-1,0Â°,1-1.8,1-2.2,1-2.5,1/3-1/2,1/5-1/3,10-15,10-16,2-2.5,2-2.7,2-4,3.5-4,4,4-5,5,5-6,5-7,abaxial,abaxially,acute,adaxially,age,almost,anthesi,apex,apically,apparently,becoming,brachyblast,branch,branched,branching,broadly,brown,calyx,capitate,clearly,clustered,cm,concolorous,corolla,dark,decurrent,delineated,dendritic,densely,density,developed,diameter,dilated,divided,drying,elliptic,entire,equal,except,faint,fine,flat,flexuous,flower,frequent,glabrous,gradual,green,increasing,inner,leaf,length,lengthening,liana,like,long,long-attenuate,longitudinally,margin,membranous,middle,midvein,minutely,mm,mostly,multiply,narrowly,obconical,oblong,obovate,occasional,orange-brown,outer,ovate,overlapping,pair,pale,pedicel,poorly,poricidal,pubescent,raised,ray,region,ridged,scar,short,shrub,side,simple,slender,small,sparsely,spreading,stem,stump,surface,terminal,tip,toward,transition,trichome,unevenly,white,widely,wrinkled,x,yellow,youngest	apart,ellipsoid,na,papillose,perfect,ye
249	wfo-0001028736	success	180	108	79	89	91	19	79	0	0.2-0.4,0.5,0.5-1.5,1,1-2,1-3,10-15,2-5,4-12,4-6,40-70,5-10,5-15,6-13x3-8,abaxially,absent,adaxially,anther,armed,attenuate,base,berry,brown,cm,connivent,created,cylindrical,dark,densely,diameter,extra-axillary,filament,flower,fruit,glandular,green,hair,immature,leaf,length,light,like,lobe,lobed,long,many,mature,mm,moderately,mottled,multicellular,nearly,netlike,occasionally,orange,pedicel,peduncle,per,petiole,pit,porrect-stellate,prickle,pubescent,raised,recurved,red,reniform,rhombic,ridge,roselike,shrub,side,simple,small,sparsely,stellate,stem,stigma,style,surface,tapering,unarmed,unbranched,uniseriate,unlobed,white,x,yellow,yellow-white	0.5-1,0.5-1mm,0.5-2,1-1.5,1.5,1.5-3,1/6,2-4,2-7,3-5,3-6,3-8,3.5-5,4-9,5-merou,6-8,accrescent,acute,adaxiall,alyx,apar,apex,apical,apparently,axe,beyond,blade,calyx,chartaceous,contiguous,cordate,cut,decurrent,difoliate,directed,discolorous,eaf,eed,either,exserted,filiform,flattened,frui,fruiting,geminate,glabrou,glabrous,globose,gree,introsel,less,lower,m.,major,midpoint,midrib,midvein,multiseriate,narrowly,nflorescence,obtuse,occasional,onto,orolla,pair,perfect,pore,purple,rachi,ray,ruit,scanden,sinus,slightly,spaced,stalk,stamen,ste,tamen,tem,thin-skinned,triangular,tube,unequa,unicellular,unit,vary,vein,way,wide,ympodial	arrangement,characteristic,colour,corolla,form,growth,height,inflorescence,lobing,number,ovary,plant,pubescence,seed,shape,size,staman,texture,type	0.2-0.4,0.5,0.5-1.5,1,1-2,1-3,10-15,2-5,4-12,4-6,40-70,5-10,5-15,6-13x3-8,abaxially,absent,adaxially,armed,attenuate,base,berry,brown,cm,connivent,created,cylindrical,dark,densely,diameter,extra-axillary,flower,fruit,glandular,green,hair,immature,light,like,lobe,lobed,long,many,mature,mm,moderately,mottled,multicellular,nearly,netlike,occasionally,orange,per,pit,porrect-stellate,prickle,pubescent,raised,recurved,red,reniform,rhombic,ridge,roselike,shrub,side,simple,small,sparsely,stellate,stem,tapering,unarmed,unbranched,uniseriate,unlobed,white,x,yellow,yellow-white	
250	wfo-0001028737	success	151	102	67	80	71	22	64	3	0.2-0.5,0.7-2,1,1-2.5,1-4,1-6,1.5-3.5,10,12-14,16-30,2-3,2-5,2.8-3.5,3-4,3-5,4-6.5,4-9,5-6,6,7-15,apical,apically,apiculate,branched,calyx,caudate,cm,connate,corolla,cyme,dehiscent,diameter,dichasial,dichasially,distal,ebracteate,exceeding,filament,forked,glabrescent,glandular,globose,green,green-white,herbaceous,interjected,introrse,lateral,leaf,leaflet,lobe,long,maturing,mm,monochasial,oblong,odd-pinnate,often,ovoid,pair,pedicel,peduncle,perennial,petiole,plant,poricidally,seed,short,size,slit,stamen,stellate,stigma,straight,style,terminal,throughout,tuber-bearing,wide,yellow	3-6-foliat,4-10,abaxially,absen,acumen,acuminate,acute,adaxially,apex,articulate,attenuate,base,cell,covering,decurrent,digestion,diminishing,dorsally,eaf,edge,eed,elliptic-lanceolate,emoval,enzyme,flat,flower,folded,generally,globo,gradually,hair-like,half,honeycomb,lanceolate,larger,living,lon,lower,make,mucilaginous,nflorescence,nther,oblique,orolla,pattern,perfect,pinnatifi,plan,proximal,rachi,reveal,ruit,second,sessile,seudostipule,specimen,strongly,tal,tem,testal,thick,throughou,toward,typically,unit,vary,wall,whit,without,ympodial,Â¼	abaxial,absent,adaxial,anther,arrangement,colour,form,fruit,growth,height,history,inflorescence,length,life,ovary,pinnatifid,pseudostipule,shape,stem,texture,white,width	0.2-0.5,0.7-2,1,1-2.5,1-4,1-6,1.5-3.5,10,12-14,16-30,2-3,2-5,2.8-3.5,3-4,3-5,4-6.5,4-9,5-6,6,7-15,apical,apically,apiculate,branched,caudate,cm,connate,cyme,dehiscent,diameter,dichasial,dichasially,ebracteate,exceeding,forked,glabrescent,glandular,globose,green,green-white,herbaceous,introrse,lobe,long,maturing,mm,monochasial,oblong,odd-pinnate,often,ovoid,perennial,poricidally,short,slit,stamen,stellate,stigma,straight,style,throughout,tuber-bearing,wide,yellow	absent,pinnatifid,white
251	wfo-0001028777	success	203	141	85	102	101	39	82	3	-4,.5,.9,0-2,0-30,0.4-0.8,0.5-1.3,0.6-1,0.7-1.2,0.7-1.3,0.8-1,0.8-2.2-2.5,1-2.5-4,1.5-3,1.5-4,1.8-2.5,2-3,2.5,3/4-4/5,acute,anther,apex,apically,articulated,attenuate,bark,base,berry,branched,calyx,chartaceous,cm,concolorous,curved,dark,deltate,diameter,discolorous,drying,entire,erect,filament,flattened-reniform,fruit,fruiting,glabrescent,glabrous,green,green-brown,inflorescence,leaf,length,lobe,lobed,long,margin,marking,maturity,mauve,mm,moderately,obovate,orange,orange-brown,ovate,pair,pale,pedicel,peduncle,per,petiole,poricidal,primary,red-brown,reflexed,retuse,rounded,shoot,short,shrub,simple,sometimes,sparsely,spherical,stellate-pubescent,stem,stout,style,surface,tapering,terete,terminal,tip,truncate,tube,unarmed,vein,way,white,wide,yellow-green,young	-10,-3,.8,0.1-0.2,0.1-0.3,0.2,1,1-2,1-2.5,1-3,1.5,1/4,1/4-1/2,2.5-3,2.5-5,3.5-5,4-5-merous,4.5-8,6-10,7-11,8-12,8-15,abaxially,acuminat,alyx,ame,apar,ape,blade,briefly,c.,connivent,deciduou,eaf,eed,elongating,equal,faint,flower,free,glabrescen,infructescence,lengt,less,long-styled,longer,lower,mature,midpoint,minute,multangulate,narrow-deltate,nflorescence,occasionally,older,one,open,orolla,oung,perfect,pericarp,plurifoliat,porrect,portion,present,ray,recurved,reflexe,ruit,scar,sessile,short-styled,shorte,shorter,small,smooth,somewhat,soon,spaced,spreading,stalk,stalked,staminate,stellate,strongly,tamen,tertiary,time,tree,trichome,unarme,unit,usually,variously,vary,venation,visible,whole,wider,woody,ympodial	acuminate,appearance,arrangement,border,branch,bud,characteristic,colour,corolla,corrugation,distal,exertion,form,giving,glabrousnes,growth,height,history,interjected,lateral,leaflet,life,lobing,na,new,number,ovary,perennial,plant,prickle,pseudostipule,seed,shape,size,stigma,texture,type,variation,width	-4,.5,.9,0-2,0-30,0.4-0.8,0.5-1.3,0.6-1,0.7-1.2,0.7-1.3,0.8-1,0.8-2.2-2.5,1-2.5-4,1.5-3,1.5-4,1.8-2.5,2-3,2.5,3/4-4/5,acute,apex,apically,articulated,attenuate,base,berry,branched,chartaceous,cm,concolorous,curved,dark,deltate,diameter,discolorous,drying,entire,erect,flattened-reniform,glabrescent,glabrous,green,green-brown,lobed,long,marking,maturity,mauve,mm,moderately,obovate,orange,orange-brown,ovate,pair,pale,per,poricidal,red-brown,reflexed,retuse,rounded,shoot,short,shrub,simple,sometimes,sparsely,spherical,stellate-pubescent,stout,tapering,terete,terminal,tip,truncate,unarmed,way,white,wide,yellow-green,young	acuminate,na,perennial
252	wfo-0001028791	success	252	165	112	130	122	35	107	5	+,-9,0-6,0.05-0.2,0.2-0.3,0.3-0.5,0.3-0.6,0.4-0.6,0.4-0.65,0.6-0.8,0.8-1.3,1-1.5,1.5-2,1.7-2.1,1.8-3.3,10,2-3,2-7,2-locular,2.8-3.0,4-5+,5-15,50-80,9-30,absent,acuminate,acute,along,anther,anthesi,apex,appearance,articulated,basal,base,beneath,border,branched,broadly,brown,calyx,capitate,cell,clambering,cm,conical,corolla,dark,deciduous,deltate,densely,developed,diameter,dichotomously,elliptic,entire,exserted,filament,fruit,fruiting,glabrescent,glabrous,globose,green,hair-like,half,halfway,imparipinnate,interjected,interrupted,lateral,leaf,leaflet,less,liana,lobe,long,many,margin,middle,minutely,mm,near,oblique,obovate,occasionally,outgrowth,ovary,pale,paler,pedicel,peduncle,per,petiole,plant,poorly,present,primary,pseudostipule,pubescence,pubescent,round,scandent,seed,silky,slightly,somewhat,sparsely,stellate,stem,stigma,style,surface,terminal,testa,thick,thickened,time,truncate,tube,upper,usually,vein,vine,wall,white,wide,winged,woody,yellow	.5,0.05,0.2-0.4-0.6,0.2-0.8-1.5,0.25-0.3,0.3-0.4,0.3-0.8,0.4-0.5,0.4-1.1,0.45-0.55,0.5,0.6-0.9,0.7-1.5,0.8-1,1-2,1-2-celled,1-3,1-3-celled,1-celled,1.5-2.5-4.5,1.6-4.5,100,2-3.5,2-7-celled,20-to,3-4,3-5-10,3-5-22,4-11.5,4-15,4-celled,5-9-35,5-plurifoliate,8-10-celled,abaxially,absen,abundant,adaxially,addition,ag,apical,appendage,articulation,basiscopically,berr,breaking,bullate,colo.,column,consistently,darker,densest,eaf,ebracteate,edicel,eed,eglandular,elongating,enlarged,even,extended,flower,free,give,glandular,gree,grow,growing,head,internode,lamina,large,leaving,like,lon,lower,midvein,mixture,much,multicellular,nflorescence,often,pair,papillate,petiolule,protuberance,rachi,reflexed,rest,rough,ruit,sandpapery,secondary,sessile,short,shorter,simple,single,small,smaller,sometimes,sparse,spreading,stamen,staminal,sterile,stiff,straight,tal,tem,tertiary,tip,touch,transparent,trichome,ud,unicellular,uniseriate,unit,vegetation,ympodial,â1-2-celled	3-22,5-35,age,arrangement,bud,characteristic,colour,corrugation,dense,distal,drying,exertion,form,giving,glabrousnes,growth,height,history,inflorescence,length,life,lobing,midpoint,na,new,number,prickle,ray,shape,size,texture,thicknes,type,variation,width	+,-9,0-6,0.05-0.2,0.2-0.3,0.3-0.5,0.3-0.6,0.4-0.6,0.4-0.65,0.6-0.8,0.8-1.3,1-1.5,1.5-2,1.7-2.1,1.8-3.3,10,2-3,2-7,2-locular,2.8-3.0,4-5+,5-15,50-80,9-30,absent,acuminate,acute,along,anthesi,articulated,basal,base,beneath,border,branched,broadly,brown,calyx,capitate,cell,clambering,cm,conical,dark,deciduous,deltate,densely,developed,diameter,dichotomously,elliptic,entire,exserted,glabrescent,glabrous,globose,green,hair-like,half,halfway,imparipinnate,interrupted,lateral,leaf,less,liana,long,many,middle,minutely,mm,near,oblique,obovate,occasionally,outgrowth,pale,paler,per,poorly,present,pubescence,pubescent,round,scandent,seed,silky,slightly,somewhat,sparsely,stellate,stem,testa,thick,thickened,time,truncate,upper,usually,vein,vine,wall,white,wide,winged,woody,yellow	3-22,5-35,age,dense,na
253	wfo-0001028798	success	214	141	88	102	112	39	85	3	0-1,0.2-0.4,0.9-1.2,1-4.5,1.5-1.8,10,15-19,2-6,2-7,2.5-3.5,2/3,3-5,5-8,7-8,8-18,acuminate,acute,anther,apex,attenuate,base,becoming,berry,branch,bud,calyx,chartaceous,cm,conical,continued,corolla,decurrent,densely,diameter,distal,dm,due,entire,filament,flower,fruit,fruiting,glabrous,granular,granular-tomentose,green,greenish,growth,hair,lanceolate,lateral,leaf,length,lined,lobe,long,margin,midvein,mixed,mm,nearly,oblanceolate,oblong,obovate,orbicular,ovate-lanceolate,pale,pedicel,peduncle,persistently,petiole,probably,pseudo-terminal,rather,ripe,rotate-stellate,rough,rough-granular,sessile,short,shrub,side,simple,slightly,sparingly,stalked,stellate-pubescent,stem,stigma,style,subcampanulate,subcoriaceous,subglobose,sulcate,tomentose,tube,unarmed,vein,way,x,yellow,yellowish	.5-5,0-60,0.5-2,1-3,1-6,1.1-2,1/2-2/3,1/20,2-3,2-3.75,2.4-4.4,2.6-4,3-4,3.3-5.6,3.8-4.2,4-5.4,5.25-7.5,6-10,6-8,8.5-13,abaxially,accrescent,adaxially,ag,anthesi,apart,apical-lateral,apparently,articulated,axe,axillary,ba,blade,blunt-tipped,boat-shaped,branched,capitat,curved,cylindrical,dehiscing,downward,eaf,echinoi,echinoid,eed,exserted,extend,fleshy,free,hal,high,included,inserted,introrse,irregularly,lacking,large,less,lobed,longitudinal,lower,m.,main,many,minutely,multangulat,multangulate,nflorescence,oblanceolat,obscured,obtuse,often,orolla,oung,overlapping,perfect,persistent,plurifoliate,pore,porrect-stellate,present,prominent,pubescent,quite,rachi,ray,ruit,semi-ovate,short-stalked,slit,small,somewhat,spaced,splitting,stamen,strongly,suture,tamen,thick,time,tip,tomentu,tomentum,toward,translucent,unarme,unit,unknow,vary,velutinous,wide,ympodial	appearance,arrangement,bark,border,capitate,characteristic,colour,corrugation,drying,exertion,form,giving,glabrousnes,height,history,inflorescence,interjected,leaflet,life,lobing,na,new,number,ovary,per,perennial,plant,prickle,primary,pseudostipule,seed,shape,size,surface,terminal,texture,type,variation,width	0-1,0.2-0.4,0.9-1.2,1-4.5,1.5-1.8,10,15-19,2-6,2-7,2.5-3.5,2/3,3-5,5-8,7-8,8-18,acuminate,acute,apex,attenuate,base,becoming,berry,chartaceous,cm,conical,continued,decurrent,densely,diameter,dm,due,entire,flower,fruit,glabrous,granular,granular-tomentose,green,greenish,growth,hair,lanceolate,lateral,length,lined,long,midvein,mixed,mm,nearly,oblanceolate,oblong,obovate,orbicular,ovate-lanceolate,pale,persistently,petiole,probably,pseudo-terminal,rather,ripe,rotate-stellate,rough,rough-granular,sessile,short,shrub,side,simple,slightly,sparingly,stalked,stellate-pubescent,stem,subcampanulate,subcoriaceous,subglobose,sulcate,tomentose,unarmed,way,x,yellow,yellowish	capitate,na,perennial
254	wfo-0001028815	success	196	97	62	79	117	18	60	2	0.4-0.8,0.5-1,1-3.5,1-4,1-5,10-15,14-28,2-4,2.5-6.5,22-35,3-4,3-5,3-7,4-10,5-6,5-7,6-10,6-8,7-16,abaxially,adaxially,anther,berry,broadly,brownish,chartaceous,cm,condition,corolla,dark,diameter,distal,drying,elliptic,flower,fresh,fruit,glabrous,globose,green,greenish,herb,homostylous,interjected,lateral,leaflet,lilac-purple,long,medium,membranous,mm,narrowly,odd-pinnate,ovate,ovoid,pair,pedicel,peduncle,petiole,petiolulate,plant,pubescent,purple,red-purple,rugose,seed,sessile,short,size,sparsely,splotched,stem,stigma,style,terminal,unwinged,whitish,winged,x	1-10,1-2,2-4.5,2-9,5-merou,acumen,acute,ag,along,alyx,apart,apex,apparently,articulated,articulation,auriculate,axe,axillary,base,basiscopic,blade,bud,capitat,cell,ciliate,connivent,covering,cuneate,decreasing,decurrent,developing,digestion,distinct,dorsally,eaf,edge,eed,elliptic-lanceolate,enzyme,especially,exceeding,filament,flat,folded,forked,geminat,generally,glabrou,green-white,hair,hair-like,hal,half,high,honeycomb-shaped,indistinct,lanceolate,lengthening,like,living,lobe,lower,make,margin,midrib,minutely,mucilaginous,nflorescence,obtuse,onto,orolla,papillose,perfect,plurifoliate,pointed,pore,poricidal,puberulent,purpl,rachi,removed,ripe,rotate,rounded,ruit,semi-erec,semi-rosette,seudostipule,side,slightly,slit,spaced,specimen,stamen,ste,straight,subtending,tall,tamen,tem,terminated,testal,thick,throughout,tinged,tip,tri-,triangular-lanceolate,tube,unit,usually,vary,wall,wet,yellow,ympodial,young	5-merous,arrangement,calyx,capitate,characteristic,colour,form,growth,height,history,inflorescence,leaf,length,life,ovary,pseudostipule,shape,type	0.4-0.8,0.5-1,1-3.5,1-4,1-5,10-15,14-28,2-4,2.5-6.5,22-35,3-4,3-5,3-7,4-10,5-6,5-7,6-10,6-8,7-16,abaxially,adaxially,berry,broadly,brownish,chartaceous,cm,condition,dark,diameter,drying,elliptic,fresh,glabrous,globose,green,greenish,herb,homostylous,lilac-purple,long,medium,membranous,mm,narrowly,odd-pinnate,ovate,ovoid,petiolulate,pubescent,purple,red-purple,rugose,sessile,short,sparsely,splotched,unwinged,whitish,winged,x	5-merous,capitate
255	wfo-0001028876	success	127	89	63	70	57	19	59	4	.5,/4,0.4-1,0.5-2,1-2,1.5-2,2-2.3,3-5,4-5,5-6,abaxially,adaxially,along,anther,bark,base,brown,calyx,capitate,cm,conical,corolla,dark,dendritic,densely,dia,difoliate,drying,elliptic,filament,flower,glabrous,golden,hroughout,internodal,leaf,like,lobed,long,midrib,mm,occasionally,opposite,pedicel,petiole,pubescent,reddish,rest,sagittate,shining,shrub,simple,small,sparsely,speciman,stem,stigma,style,subshrub,surface,tall,trichome,tube,type,uniseriate,unit,way,white,x,young	1.5-3,3-8,4-8,abaxial,acute,anthesi,apex,attenuate,branched,closely,eaf,edicel,eed,ellipsoid,free,geminat,glabrat,included,inflorescenc,know,known,lamina,lateral,leave,lobe,long-triangular,lower,main,middle,minutely,nflorescence,nodding,older,ovary,overlappin,pair,papillae,papillo,papillose,planar,pore,poricidal,portion,rounded,ruti,scar,shaped,slender,spaced,straight,tear-drop,tip,tub,ud,vein,widest,ympodial	arrangement,characteristic,colour,diameter,form,fruit,geminate,growth,history,inflorescence,length,life,lobing,na,seed,shape,size,sympodial,texture	.5,/4,0.4-1,0.5-2,1-2,1.5-2,2-2.3,3-5,4-5,5-6,abaxially,adaxially,along,base,brown,capitate,cm,conical,dark,dendritic,densely,dia,difoliate,drying,elliptic,flower,glabrous,golden,hroughout,internodal,leaf,like,lobed,long,midrib,mm,occasionally,opposite,pubescent,reddish,rest,sagittate,shining,shrub,simple,small,sparsely,speciman,stem,subshrub,tall,trichome,type,uniseriate,unit,way,white,x,young	geminate,inflorescence,na,sympodial
256	wfo-0001028883	success	207	103	68	78	129	25	61	7	50,abaxially,acute,adaxially,anther,apex,articulated,attenuate,base,berry,blade,brochidodromous,calyx,capitate,chartaceous,ciliate,cm,concolorous,connivent,coriaceous,cylindrical,dark,deltate,densely,diameter,drying,dull,elliptic,entire,flattened,flower,fruit,glabrescent,glabrous,glandular,globose,green,growth,herb,lateral,leaf,length,margin,midrib,mm,moderately,narrowly,new,oblong,pedicel,peduncle,per,petiole,prominent,pubescent,reniform,ripe,seed,sessile,simple,size,slightly,sparsely,stellate,stem,stigma,straight,style,subopposite,subsessile,surface,trichome,undulate,venation,white,woody,yellow,Ã	0.3â0.6,0.4â1.2,0.5â2,0.6,1,1.5â7,1â2,1â6,2,2â3,2â5,3â5,4,4â6,5,5-merou,6,6â10,6â12,absent,accrescent,acuminate,adaxiall,almost,along,alyx,antrorse,antrorsely,apar,arched,ark,ascending,axi,becoming,branch,brow,capitat,cell,circular,common,completely,curved,cyme,decurrent,differing,directed,eaf,eed,elliptic-ovate,emarginate,equal,erect,exfoliating,eye,filament,frui,geminate,geniculat,glabrou,greenish,head,hilum,hollow,impressed,introrsely,less,light,like,lobe,long,longitudinal,lower,lying,membranaceous,minor,multicellular,naked,nflorescence,normally,notably,obtuse,often,older,onto,opening,orolla,ovate-lanceolate,parallel,pendan,perfect,plurifoliate,pore,poricidal,present,primarily,pubescence,rachi,rarely,region,rounded,ruit,secondary,shap,shiny,shrub,similar,single,single-celled,slit,small,sometimes,spaced,sparse,spreading,stalk,subapical,swollen,tall,tamen,tem,unbranched,uniseriate,unit,vary,vein,visible,whitish,wide,ympodial	1-2,2-3,2-5,3-5,4-6,6-10,6-12,arrangement,characteristic,colour,corolla,form,glabrousnes,height,history,inflorescence,life,number,ovary,plant,prominence,shape,staman,texture,type	50,abaxially,acute,adaxially,articulated,attenuate,base,berry,blade,brochidodromous,capitate,chartaceous,ciliate,cm,concolorous,connivent,coriaceous,cylindrical,dark,deltate,densely,diameter,drying,dull,elliptic,entire,flattened,flower,fruit,glabrescent,glabrous,glandular,globose,green,herb,lateral,leaf,margin,mm,moderately,narrowly,oblong,prominent,pubescent,reniform,ripe,sessile,simple,slightly,sparsely,stellate,straight,subopposite,subsessile,surface,trichome,undulate,white,woody,yellow,Ã	1-2,2-3,2-5,3-5,4-6,6-10,6-12
257	wfo-0001028885	success	212	128	93	107	105	21	91	2	0.3-0.5-1,0.5-1,0.7-2,1-1.2,1-2,1.5-1.7,1.5-3.5,10-20,2.3-2.5,2/3,3-5,7-8,9-11,?,acute,adaxially,along,anther,anthesi,apex,attenuate,basal,base,berry,black,branched,brown,calyx,capitate,cm,corolla,cup-shaped,dark,decurrent,densely,diameter,ellipsoid,elliptic,entire,erect,exserted,extending,filament,flower,fruiting,furcate,glabrescent,glabrous,globose,golden,gradually,groove,growth,height,immature,inflorescence,lamina,lanceolate,lateral,leaf,like,lobed,long,margin,midvein,minute,mm,mostly,multicellular,narrowing,narrowly,new,nodding,occasionally,pedicel,peduncle,petiole,plant,pubescent,purple,quarter,reddish,revolute,rhachi,ripe,scandent,shrub,simple,slender,slightly,sometimes,sparsely,stem,stigma,strongly,style,surface,terminal,third,time,trichome,tube,uniseriate,vine,way,winged,Â¾	.5,0.5-5,1-1.5,1-3,2,2-2.5,2-3.5-8.5,2.5-3.5,3.5-4.5,4-5,5-merou,7-9,9-12,abaxial,adaxial,ag,alyx,apart,apiculate,apparently,archin,ark,articulated,blackish,branch,broadly,cell,collapsing,connivent,dark-pigmented,deltate,dendriti,distal,dried,drying,eaf,eed,fleshy,free,glabrou,glandular,groupe,ilament,inserted,irregularly,known,leaving,lengthening,less,live,lobe,loosely,lower,material,minutely,nflorescence,noddin,often,older,orolla,pair,papillo,part,peg,perfect,pericarp,pigmentation,plurifoliat,pore,poricidal,portion,primary,recorded,retaining,ruit,scar,scattered,shin,shiny,short,sleeve,slit,small,smaller,spaced,spheroidal,spreading,stellate,tangled,tem,thin,tip,twinin,ud,unit,upper,usually,vary,vein,wall,weak,weak-walled,wide,woody,ympodial	arrangement,bark,bud,characteristic,colour,dendritic,exertion,form,fruit,glabrousnes,length,lobing,na,number,ovary,per,seed,shape,size,texture,type	0.3-0.5-1,0.5-1,0.7-2,1-1.2,1-2,1.5-1.7,1.5-3.5,10-20,2.3-2.5,2/3,3-5,7-8,9-11,?,acute,adaxially,along,anthesi,attenuate,basal,base,berry,black,branched,brown,calyx,capitate,cm,cup-shaped,dark,decurrent,densely,diameter,ellipsoid,elliptic,entire,erect,exserted,extending,flower,furcate,glabrescent,glabrous,globose,golden,gradually,groove,immature,lamina,lanceolate,lateral,leaf,like,lobed,long,midvein,minute,mm,mostly,multicellular,narrowing,narrowly,nodding,occasionally,pedicel,petiole,pubescent,purple,quarter,reddish,revolute,rhachi,ripe,scandent,shrub,simple,slender,slightly,sometimes,sparsely,strongly,terminal,third,time,trichome,tube,uniseriate,vine,way,winged,Â¾	dendritic,na
258	wfo-0001028888	success	207	138	105	115	92	23	101	4	0-7,0.15-0.5,1-1.5,1-10,1-2,1.5-4,10-25,12.5-25,2-6,2.3-5,2.3-7,2.5-3.3,3-4,3.6-12.5,3.8-8.3,4-7,5-10,5-7,6-11,8-11,8-13.5,abaxially,adaxially,anther,apart,axillary,berry,blade,brownish,bud,cell,center,chartaceous,clavate,cm,condition,connivent,corolla,covered,covering,diameter,distal,dot,drying,end,filament,flower,forked,fresh,fruit,generally,glabrous,glaucous,globose,green,green-white,greenish,hair,hair-like,half,herb,homostylous,interjected,lanceolate,lateral,leaflet,like,lobe,long,make,membranous,mm,mottled,mucilaginous,odd-pinnate,often,one,ovoid,pedicel,peduncle,pentagonal,placed,plant,pubescent,purple,ripe,scattered,seed,short,size,slightly,sparsely,stem,stigma,straight,streak,style,subglabrous,substellate,subtending,terminal,testal,thick,throughout,tube,tuber,typically,usually,violet,wall,wet,white,whitish,x,yellow	0-3.5,0-5,1,1-3,2-5,3-5,4-25,5-merou,acumen,acuminate,acute,ag,along,alyx,apex,apiculate,apparently,articulated,axe,base,broadly,capitat,central,ciliate,cuneate,digestion,dorsally,eaf,edge,eed,elliptic,enzyme,erec,especially,exceeding,except,flat,folded,geminat,glabrou,greatly,hal,honeycomb-shaped,lengthening,less,living,low,lower,margin,middle,midrib,minutely,nflorescence,oblique,orbicular,orolla,ovate,pair,perfect,petiole,petiolulate,petiolule,plurifoliate,pore,poricidal,proximal,puberulent,reduced,removed,rounded,ruit,sessile,seudostipule,slit,sometimes,spaced,specimen,stamen,ste,stolo,subequal,tall,tamen,tem,tip,tri-,truncate,unit,unwinged,vary,wing,ympodial	5-merous,arrangement,calyx,capitate,colour,erect,form,growth,height,history,inflorescence,leaf,length,life,ovary,placement,pseudostipule,shape,spacing,stolon,surface,texture,type	0-7,0.15-0.5,1-1.5,1-10,1-2,1.5-4,10-25,12.5-25,2-6,2.3-5,2.3-7,2.5-3.3,3-4,3.6-12.5,3.8-8.3,4-7,5-10,5-7,6-11,8-11,8-13.5,abaxially,adaxially,apart,axillary,berry,brownish,bud,cell,center,chartaceous,clavate,cm,condition,connivent,corolla,covered,covering,diameter,distal,dot,drying,end,forked,fresh,generally,glabrous,glaucous,globose,green,green-white,greenish,hair,hair-like,half,herb,homostylous,lanceolate,lateral,like,lobe,long,make,membranous,mm,mottled,mucilaginous,odd-pinnate,often,one,ovoid,pentagonal,placed,plant,pubescent,purple,ripe,scattered,seed,short,slightly,sparsely,stem,straight,streak,subglabrous,substellate,subtending,terminal,testal,thick,throughout,typically,usually,violet,wall,wet,white,whitish,x,yellow	5-merous,capitate,erect,stolon
259	wfo-0001028920	success	152	104	73	82	70	22	70	3	.25,.5,0.2-1,0.5-1,0.8-1.1,1-1.2,1-1.5,1-2.4,1-3,3-15-flowered,6-6.5,abaxially,acuminate,acute,adaxially,anther,apex,arachnoid,arachnoid-pubescent,area,attenuate,bark,base,berry,brown,calyx,cm,congested,corolla,dark,decurrent,dia,difoliate,ellipsoid,elliptic,erect,exserted,flower,fruiting,glabrous,globose,green,later,leaf,lightly,lobed,long,long-styled,minutely,mm,nearly,obovate,obovoid,occasionally,ovary,ovoid-reniform,papillose,pedicel,petiole,pitted,pubescent,shape,shaped,short-styled,shrub,simple,size,small,sparsely,stem,stigma,strongly,style,surface,tear-drop,tip,tree,trichome,tube,unifoliate,white,winged	1.5-2,2-2.5,2-7,3-3.5,3-4,5-9,6-15,anthesi,axil,ba,broadly,brownish,closely,conical,cucullate,deflexed,deltate,dendritic,dense,densely,differing,eaf,edicel,eed,felty,filament,fleshy,free,geminat,glabrate,gray-brow,lateral,lobe,lon,lower,main,major,middle,minor,nflorescence,older,opposite,overlappin,pair,planar,pore,poricidal,portion,present,pubescence,ruit,scar,somewhat,soon,spaced,styl,tall,tapering,thick,tub,tuft,ud,uniseriate,unit,vein,widest,woody,x,ympodial,young	arrangement,bud,characteristic,colour,diameter,exertion,form,fruit,geminate,gray-brown,growth,height,history,inflorescence,length,life,lobing,perennial,plant,seed,texture,type	.25,.5,0.2-1,0.5-1,0.8-1.1,1-1.2,1-1.5,1-2.4,1-3,3-15-flowered,6-6.5,abaxially,acuminate,acute,adaxially,apex,arachnoid,arachnoid-pubescent,area,attenuate,base,berry,brown,calyx,cm,congested,dark,decurrent,dia,difoliate,ellipsoid,elliptic,erect,exserted,flower,glabrous,globose,green,later,leaf,lightly,lobed,long,long-styled,minutely,mm,nearly,obovate,obovoid,occasionally,ovoid-reniform,papillose,pitted,pubescent,shaped,short-styled,shrub,simple,small,sparsely,strongly,style,tear-drop,tip,tree,trichome,tube,unifoliate,white,winged	geminate,gray-brown,perennial
260	wfo-0001028929	success	209	125	85	103	106	22	83	2	.5,.7,.9,/5,0-1,0-10,0-3,0.3-0.6,0.4-0.8,0.5-2,0.7-2,0.8-1,1-1.1,1.5-2.4,2-3,2.2-2.3,2.7-3,4-6,5-6,abaxial,abaxially,acute,adaxial,anther,apex,apparently,articulated,bark,base,berry,branched,calyx,cell,chartaceous,cm,concolorous,connivent,curved,densely,diameter,discolorous,drying,dull,elliptic,erect,filament,flattened-reniform,fruit,fruiting,gently,glabrescent,glabrous,inflorescence,lateral,leaf,length,lobed,long,margin,maturity,minutely,mm,obovate,obtuse,orange-brown,outline,pedicel,peduncle,petiole,pit,poricidal,porrect,prickle,prickly,raised,red,red-brown,red-green,reticulate,sessile,shrub,simple,slender,small,smooth,sometimes,spherical,stalked,stellate-pubescent,stem,style,surface,tapering,terete,tip,trichome,tube,unarmed,way,white,wide,yellow,yellow-green	-2,0-2,0-20,0.1,0.15-0.3,0.2-0.3,0.2-0.4,0.2-0.8,0.5-1.5,0.7-1,1,1-3,1/2-2/3,1/4-1/3,2-4,2-6,2-9,2.5-4,2/3-3/4,3-20,3-4,5-25,5-7.5,5-merous,6-8,7-9,8-10,acicular,alyx,apar,apart,ape,apically,blade,cuneate,difoliate,distance,eaf,eed,elongating,equal,extending,flower,foliaceous,free,geminat,glabrou,gra,hair,infructescence,lobe,lon,long-styled,longer,lower,mature,midpoint,midvein,minute,narrow-deltate,narrow-ovate,nflorescence,oblong,obtu,occasionally,older,one,open,orolla,oung,pair,pale,patch,pendulous,per,perfect,pericarp,perpendicular,portion,prickl,primary,ray,rounded,ruit,scar,short-styled,side,spaced,spreading,stalk,staminate,stellate,straight,subsessile,tamen,tertiary,time,unit,usually,variously,vary,vein,venation,visible,woody,ympodial	arrangement,branch,characteristic,colour,corolla,exertion,form,glabrousnes,gray,growth,height,lobing,na,new,ovary,plant,seed,shape,size,stigma,texture,type	.5,.7,.9,/5,0-1,0-10,0-3,0.3-0.6,0.4-0.8,0.5-2,0.7-2,0.8-1,1-1.1,1.5-2.4,2-3,2.2-2.3,2.7-3,4-6,5-6,abaxially,acute,apparently,articulated,base,berry,branched,cell,chartaceous,cm,concolorous,connivent,curved,densely,diameter,discolorous,drying,dull,elliptic,erect,flattened-reniform,gently,glabrescent,glabrous,lateral,lobed,long,maturity,minutely,mm,obovate,obtuse,orange-brown,outline,pit,poricidal,porrect,prickle,prickly,raised,red,red-brown,red-green,reticulate,sessile,shrub,simple,slender,small,smooth,sometimes,spherical,stalked,stellate-pubescent,tapering,terete,tip,trichome,unarmed,way,white,wide,yellow,yellow-green	gray,na
261	wfo-0001028963	success	197	116	78	90	107	26	74	4	/2,0-0.4,0-2,0.3-0.6,0.3-0.7,0.3-1,0.45-0.6,0.6-0.9,0.6-1,0.8-1.8,0.9-1.5,1/5,2-4,abaxially,acute,anther,apex,apically,apparently,articulated,attenuate,bark,base,berry,bright,broad-deltate,brown,calyx,cell,chartaceous,cm,densely,diameter,dull,entire,erect,evenly,filament,flattened-reniform,fruiting,gray-green,green,herb,inflorescence,lanceolate,lateral,leaf,length,light,long,lower,margin,maturity,mauve,mm,moderately,narrow-cuneate,narrow-elliptic,obtuse,orange,outline,pale,pedicel,peduncle,petiole,pit,poricidal,purple,raised,red,shrub,simple,small,smooth,spherical,stellate-pubescent,stem,style,surface,tapering,terete,terminal,tip,tube,unarmed,unbranched,upper,way,yellow-orange,young	.5,0.1,0.1-0.2,0.1-0.25,0.15-0.3,0.3-1.5,1-4,1.5-2,1/,1/4-1/3,1/6,2-2.3,2-3,2-5,2-9,2.4-2.8,3-4.5,3.5-4.2,4-10,4-8,5-25,5-merous,6-10,7-8,alyx,apar,ape,becoming,blade,concolorous,connivent,curved,cuspidat,deltate,difoliate,discolorous,drying,eaf,eed,elongating,equal,eye,flower,free,frui,geminat,glabrescent,glabrous,gra,herbaceous,infructescence,less,lobe,lobed,long-styled,longer,mature,midpoint,naked,narrowly,nflorescence,occasionally,older,one,open,orolla,oung,pair,pendulous,per,perfect,pericarp,porrect,portion,primary,ray,ruit,scar,sessile,short-styled,shorter,slender,slightly,spaced,spreading,stalk,stalked,staminate,stellate,straight,subsessile,tamen,tertiary,time,trichome,unarme,unit,usually,variously,vary,vein,venation,visible,wide,winged,woody,ympodial	1/2,arrangement,branch,characteristic,colour,corolla,cuspidate,exertion,form,fruit,glabrousnes,gray,growth,height,history,life,lobing,new,ovary,perennial,plant,seed,shape,size,texture,type	/2,0-0.4,0-2,0.3-0.6,0.3-0.7,0.3-1,0.45-0.6,0.6-0.9,0.6-1,0.8-1.8,0.9-1.5,1/5,2-4,abaxially,acute,apically,apparently,articulated,attenuate,base,berry,bright,broad-deltate,brown,cell,chartaceous,cm,densely,diameter,dull,entire,erect,evenly,flattened-reniform,gray-green,green,herb,lanceolate,lateral,light,long,lower,maturity,mauve,mm,moderately,narrow-cuneate,narrow-elliptic,obtuse,orange,outline,pale,pit,poricidal,purple,raised,red,shrub,simple,small,smooth,spherical,stellate-pubescent,surface,tapering,terete,terminal,tip,unarmed,unbranched,upper,way,yellow-orange,young	1/2,cuspidate,gray,perennial
262	wfo-0001028971	success	224	132	87	103	121	29	84	3	.1-0.2,0.1-0.4,0.25-0.6,0.4-0.9,1-2,1.75-2.5,10-15,15-30,2.2-3.5,2.5-3.5,20-35,3-14,3-6,4-5,4-9,5-10,6-16,6-9,acute,acute-,adaxially,anther,apex,appearance,attenuate,base,branched,broadly,calyx,campanulate,close,cm,coarsely,connivent,deltoid,dentate,diameter,erect,essentially,extra-axillary,farinaceous,filament,flower,form,frequently,fruit,glabrous,globose,inflorescence,invested,lanceolate,leaf,length,lenticular,linear-lanceolate,lobe,margin,minutely,mixture,mm,narrowly,numerous,obtuse,often,orange,outline,ovate,ovate-lanceolate,pair,pedicel,peduncle,per,perennial,petiole,pitted,prickly,pubescent,reniform-ovate,ripe,round-tipped,sericeous,sessile,short,side,simple,spreadingly,stellate,stellate-pubescent,stem,stigma,stipitate,style,surface,tan,thin-textured,trichome,truncate,tube,unbranched,usually,vein,white,x	-1.4,0.1-0.5,0.2-0.5-0.8,0.25-1.25,0.3-0.6,0.4-1.5,0.8-2.5,05-2.5,1-5,1.5-2.2,1.5-4,1/5-1/2,2-5,2-foliate,2.5-4.5,2.5-5,3-5,5-15,5-8,6-8.5,7-16,abaxially,adaxiall,along,also,apart,appearing,armed,articulated,ascending,axe,ba,bearing,becoming,blade,broad-based,capitat,cauline,compressed,cylindrical,delicate,densely,directed,distal,distall,eaf,eed,elongate,elongate-deltoid,entire,felty,felty-pubescent,female-sterile,geminat,grading,growt,hair,inserted,interlobal,largest,later,lateral,laterally,least,lignescent,like,lon,long,longer,longest,lower,major,manifestly,maturit,midpoint,midrib,minute,much,multiseriate,nflorescence,occasionally,one,orolla,other,ovate-apiculate,persistent,pore,prickle,principal,rachi,ray,reduced,ruit,scattered,short-stalked,shorter,similar,sinus,smaller,sometimes,spaced,sparse,spreading-hirsute,stalk,ste,stellae,tal,tamen,tem,termination,time,tooth-like,underdeveloped,unit,variable,variously,vary,well-developed,wide,yellow,ympodial	arrangement,bark,branch,bud,capitate,characteristic,colour,corolla,corrugation,exertion,fruiting,glabrousnes,growth,height,herb,history,life,lobing,na,new,number,ovary,plant,primary,seed,shape,size,texture,type	.1-0.2,0.1-0.4,0.25-0.6,0.4-0.9,1-2,1.75-2.5,10-15,15-30,2.2-3.5,2.5-3.5,20-35,3-14,3-6,4-5,4-9,5-10,6-16,6-9,acute,acute-,adaxially,appearance,attenuate,branched,broadly,campanulate,close,cm,coarsely,connivent,deltoid,dentate,diameter,erect,essentially,extra-axillary,farinaceous,flower,frequently,fruit,glabrous,globose,invested,lanceolate,leaf,lenticular,linear-lanceolate,lobe,minutely,mixture,mm,narrowly,numerous,obtuse,often,orange,outline,ovate,ovate-lanceolate,pair,perennial,pitted,prickly,pubescent,reniform-ovate,ripe,round-tipped,sericeous,sessile,short,side,simple,spreadingly,stellate,stellate-pubescent,stipitate,tan,thin-textured,trichome,truncate,unbranched,usually,white,x	capitate,herb,na
263	wfo-0001028975	success	163	134	104	111	52	23	98	6	.5,0.1-1,1,1-3,1-5,1.2-1.5,1.5-1.8,1.5-2,3-10-flowered,3-6.5,5-ribbed,6-6.5,7.5-15,8-9,?,acuminate,acute,along,anther,anthesi,apex,appearing,area,bark,base,beneath,berry,broad,brown,calyx,cm,conical,conically,corolla,cup-shaped,dark,decurrent,densely,denser,dia,difoliate,elliptic,epidermi,erect,exserted,extension,filament,fruit,fruiting,glabrous,globose,golden,green,hyaline,immature,large-celled,late,leaf,length,like,lobe,lobed,long,mere,minutely,mm,narrowly,nearly,older,once-furcate,opposite,ovary,ovoid-reniform,pedicel,petiole,pitted,pubescent,reflexed,remaining,rib,shaped,shiny,shrub,simple,sinus,size,slender,small,somewhat,sparsely,stem,stigma,strongly,style,surface,tapering,tear-drop,tip,tree,triangular,trichome,tube,uniseriate,unit,upper,varying,vein,white,wide,x,young	.2,0.5-1,2.2-6,3-3.5,5.5-10,apart,closely,corky,deflexed,differing,eaf,edicel,eed,entire,equal,free,geminat,lateral,lon,lower,main,mainly,major,margin,member,middle,minor,nflorescence,obscured,occasionally,one,pair,papillo,pore,poricidal,portion,prominent,pubescenc,raised,reddi,ruit,scar,short,slightly,spaced,straight,tall,tub,ud,widest,woody,ympodial	arrangement,bud,characteristic,colour,diameter,exertion,form,geminate,growth,height,history,inflorescence,life,lobing,papillose,peduncle,plant,reddish,seed,shape,sympodial,texture,type	.5,0.1-1,1,1-3,1-5,1.2-1.5,1.5-2,3-10-flowered,3-6.5,5-ribbed,6-6.5,7.5-15,8-9,?,acuminate,acute,along,anthesi,appearing,area,base,beneath,berry,broad,brown,calyx,cm,conical,conically,cup-shaped,dark,decurrent,densely,denser,dia,difoliate,elliptic,epidermi,erect,exserted,extension,glabrous,globose,golden,green,hyaline,immature,large-celled,late,leaf,length,like,lobe,lobed,long,mere,minutely,mm,narrowly,nearly,older,once-furcate,opposite,ovoid-reniform,petiole,pitted,pubescent,reflexed,remaining,rib,shaped,shiny,shrub,simple,sinus,slender,small,somewhat,sparsely,stem,strongly,style,tapering,tear-drop,tip,tree,triangular,trichome,tube,uniseriate,unit,upper,varying,vein,white,wide,x,young	.5-1.8,di,geminate,papillose,reddish,sympodial
264	wfo-0001028980	success	168	106	70	83	85	23	67	3	.5,1-1.2,1.2-1.8,1.5-1.8,1.5-2,1.5-6,2.5,3/4,5-6,6,acuminate,acute,anther,apex,bark,base,berry,black,calyx,capitate,cm,coarsely,conical,corolla,deflexed,densely,dia,drying,elliptic,exserted,filament,flattened-reniform,fleshy,fruiting,furcate,glabrate,glabrous,glandular,globose,green,leaf,lobe,lobed,long,minutely,mm,opposite,ovary,ovate,ovoid,paler,pedicel,peduncle,petiole,pitted,pubescent,reddish,seed,shaped,sharply,shrub,simple,size,small,soon,speciman,stem,stigma,style,surface,tall,tear-drop,thick,tree,tube,type,usually,way,white,woody,x,yellowish,young	.1,.75,/3,0.5-1.5,1.2-3,2.5-5,20-25-flowered,3-4,4-5,5-8,6-8,7-12,along,anthesi,apart,axil,basal,beginning,beneath,broadly,clearly,corky,cucullate,deltoid,differentiated,differing,difoliate,dry,eaf,edicel,eed,expanded,extending,f,free,frui,geminat,impressed,incrassate,inflorescenc,lamina,lateral,lenticellat,like,lon,lower,m.,main,major,margin,material,member,middle,minor,nflorescence,occasionally,older,one,pair,pale,papillose,pit,planar,pore,poricidal,portion,prominent,reflexed,ruit,scar,scarious,shining,slightly,sparsely,strongly,tapering,ti,tip,trichome,ud,uniseriate,unit,vein,widest,ympodial	alternate,arrangement,bud,characteristic,colour,diameter,exertion,form,fruit,growth,height,history,inflorescence,length,lenticellate,life,lobing,na,number,per,plant,shape,texture	.5,1-1.2,1.2-1.8,1.5-1.8,1.5-2,1.5-6,2.5,3/4,5-6,6,acuminate,acute,base,berry,black,calyx,capitate,cm,coarsely,conical,deflexed,densely,dia,drying,elliptic,exserted,flattened-reniform,fleshy,furcate,glabrate,glabrous,glandular,globose,green,leaf,lobe,lobed,long,minutely,mm,opposite,ovate,ovoid,paler,pitted,pubescent,reddish,shaped,sharply,shrub,simple,small,soon,speciman,stem,tall,tear-drop,thick,tree,type,usually,way,white,woody,x,yellowish,young	alternate,lenticellate,na
265	wfo-0001028984	success	173	110	76	85	88	25	73	3	0.5-1,1-1.7,1-6,1-9,1.2-4,1.5,10-20,15-35-65,2-16,2-2.5,2-3,20-40,3-26,4-6,4-6.3,7-14,acuminate,acute,age,almost,also,apart,apex,apical,basal,base,broadly,calyx,campanulate,cm,concave,cordate,densely,diameter,dilated,distally,ellipsoid-fusiform,entire,flower,forked,fruit,gland,globose,greenish,lanceolate,lobe,long,margin,mm,moderately,obconical,obtuse,often,ovate,ovoid,pale,pedicel,peduncle,petiole,pilose,puberulent,puberulent-pubescent,pubescent-pilose,purple,rachi,radiu,rarely,remnant,shrub,simple,small,sparsely,stigma,strongly,style,tip,tree,truncate,turning,two,unbranched,unknown,violet,x,yellow	-2,-2.5,-3,-9,1-2,1-2-4-6,1-2.5,12-20,2-3-10-14,2-3-28,3-6,4-30,4-5,4-7,4-foliat,5-10,5-6,8-15,abaxially,abruptly,absen,adaxially,adpressed,aggregate,ape,articulated,axe,blade,broad,cell,chartaceous,color,connective,directed,eaf,eed,eglandular,equalling,especially,exceeding,fleshy,glabrous,glandular-puberulent,hair,laterally,leaving,lon,longer,lower,minutely,narrowed,near,nflorescence,nther,orolla,papillose,pedicellar,perfect,pilo,pore,possibly,presence,present,pubescent-pilo,ripe,ruit,shorter,slightly,spaced,stamen,stone,subcoriaceous,swelling,tal,tem,thecae,time,tomento,tomentose,toward,triangular,tube,ud,unit,unknow,vary,wide,ympodial	-6,1-4,2-10-14,abaxial,adaxial,anther,arrangement,bud,characteristic,colour,corolla,form,growth,height,inflorescence,leaf,length,ovary,plant,seed,shape,size,spacing,stem,texture	0.5-1,1-1.7,1-6,1-9,1.2-4,1.5,10-20,15-35-65,2-16,2-2.5,2-3,20-40,3-26,4-6,4-6.3,7-14,acuminate,acute,age,almost,also,apart,apex,apical,basal,base,broadly,campanulate,cm,concave,cordate,densely,dilated,distally,ellipsoid-fusiform,entire,flower,forked,gland,globose,greenish,lanceolate,lobe,long,mm,moderately,obconical,obtuse,often,ovate,ovoid,pale,pilose,puberulent,puberulent-pubescent,pubescent-pilose,purple,rarely,shrub,simple,small,sparsely,strongly,tip,tree,truncate,turning,two,unbranched,unknown,violet,x,yellow	-6,1-4,2-10-14
266	wfo-0001028997	success	136	106	72	80	56	26	69	3	0.5-0.7,0.8-1.1,1-1.2,1-1.5,2-2.5,2-3.5,4-10,4-angled,5-6,6-10,6-7,acute,anther,apex,appearing,area,attenuate,bark,base,berry,broadened,calyx,cm,coriaceous,corolla,difoliate,dry,drying,elliptic,elliptic-obovate,erect,exserted,filiform,flattened-reniform,fruiting,glabrous,globose,golden,green,height,later,lateral,leaf,lobed,main,margin,matte,merely,minutely,mm,mustard,nearly,opposite,ovary,pair,pale,papillose,pedicel,petiole,pitted,revolute,shaped,shiny,shrub,stem,stigma,strongly,style,surface,tan,tear-drop,terminal,trifoliate,tube,unknown,vein,white,x,yellow,young	.5,0.5-1,0.5-1.5,20-50-flowered,3-4,3.3.5,4-4.5,abaxially,adaxially,anthesi,apar,ba,branched,conical,cucullate,deflexed,dia,eaf,edicel,eed,filament,fragrant,free,geminat,glabrou,greenish-brow,incrassate,lobe,lon,long,lower,many,middle,nflorescence,older,partially,pericarp,pore,poricidal,portion,quadrate,ruit,scar,spaced,specimen,styl,thick,thickened,time,tip,tub,ud,unevenly,widest,woody,ympodia	abaxial,adaxial,arrangement,bud,characteristic,colour,diameter,exertion,form,fruit,greenish-brown,growth,history,inflorescence,length,life,lobing,na,plant,primary,seed,shape,size,sympodia,texture,type	0.5-0.7,0.8-1.1,1-1.2,1-1.5,2-2.5,2-3.5,4-10,4-angled,5-6,6-10,6-7,acute,apex,appearing,area,attenuate,base,berry,broadened,calyx,cm,coriaceous,difoliate,dry,drying,elliptic,elliptic-obovate,erect,exserted,filiform,flattened-reniform,glabrous,globose,golden,green,later,lateral,leaf,lobed,main,margin,matte,merely,minutely,mm,mustard,nearly,opposite,pair,pale,papillose,pitted,revolute,shaped,shiny,shrub,strongly,style,tan,tear-drop,terminal,trifoliate,tube,unknown,vein,white,x,yellow,young	greenish-brown,na,sympodia
267	wfo-0001029003	success	207	155	114	132	75	23	111	3	0-6,0.4-3,0.5,1-10,1-2,1-3,1-5,1.2-1.9,1.2-2.5,1.5-2.3,11-32,12.2-30,13-36,2-6,2.5-7.5,3,3-20,3.5-7.5,4-8,5,5-10.5,5-12.5,7-15.5,7-9,9-14,abaxially,acuminate,adaxially,anther,apart,apex,articulated,attenuate,axillary,base,berry,blade,blue-violet,brownish,bud,cell,chartaceous,ciliate,cm,condition,conical,connivent,corolla,covering,diameter,distal,dorsally,drying,edge,elliptic,elongated,filament,flat,flower,folded,forked,fourth,fresh,fruit,generally,glabrous,green,green-white,greenish,hair,hair-like,half,herb,highly,homostylous,interjected,lanceolate,lateral,leaf,leaflet,light,like,lobe,long,make,margin,medium,membranous,middle,minute,mm,mottled,mucilaginous,obtuse,odd-pinnate,ovoid,pale,pedicel,peduncle,pentagonal,petiolule,plant,prostrate,proximal,pubescent,purple,rarely,ripe,rotate,rounded,seed,size,stem,stigma,straight,style,subcapitate,subglabrous,subtending,symmetrical,terminal,testal,thick,throughout,tube,usually,violet,wall,wet,whitish,x,yellow	0.3-0.5,1,1-2.5,2.5-10,3-5,5-merou,absent,acumen,ag,alyx,apparently,axe,capitat,decreasing,digestion,eaf,eed,end,enzyme,equal,erec,especially,exceeding,geminat,glabrou,gradually,hal,honeycomb-shaped,larger,lengthening,living,lower,nflorescence,one,orbicular,orolla,ovate,pair,perfect,petiole,pigmentation,placed,plurifoliate,pore,poricidal,ray,removed,ruit,secondary,sessile,seudostipule,slightly,slit,sometimes,spaced,sparsely,specimen,stamen,ste,stolo,subequal,tall,tamen,tem,tip,toward,tri-,tuber,typically,unit,vary,white,wide,wing,ympodial	5-merous,arrangement,articulation,calyx,capitate,colour,erect,form,growth,height,history,inflorescence,length,life,number,ovary,pseudostipule,shape,spacing,surface,texture,type,width	0-6,0.4-3,0.5,1-10,1-2,1-3,1-5,1.2-1.9,1.2-2.5,1.5-2.3,11-32,12.2-30,13-36,2-6,2.5-7.5,3,3-20,3.5-7.5,4-8,5,5-10.5,5-12.5,7-15.5,7-9,9-14,abaxially,acuminate,adaxially,apart,articulated,attenuate,axillary,berry,blue-violet,brownish,bud,cell,chartaceous,ciliate,cm,condition,conical,connivent,covering,distal,dorsally,drying,elliptic,elongated,flat,folded,forked,fourth,fresh,generally,glabrous,green,green-white,greenish,hair,hair-like,half,herb,highly,homostylous,lanceolate,lateral,light,like,long,make,margin,medium,membranous,middle,minute,mm,mottled,mucilaginous,obtuse,odd-pinnate,ovoid,pale,pentagonal,plant,prostrate,proximal,pubescent,purple,rarely,ripe,rotate,rounded,seed,stem,straight,subcapitate,subglabrous,subtending,symmetrical,terminal,testal,thick,throughout,usually,violet,wall,wet,whitish,x,yellow	5-merous,capitate,erect
268	wfo-0001029006	success	217	149	113	127	90	22	112	1	-+,0.2,0.4-2.5,0.5-2,0.5-4,1,1-1.5,1-5,1.2-1.5,1.8-2.2,10,2.5,4-6,5,7-8,<,>,acuminate,acute,adaxial,along,anther,anthesi,apex,area,articulated,asymmetrical,axil,base,berry,bilobed,blackish,c.,calyx,chartaceous,cm,connivent,corolla,deeply,dense,diameter,ellipsoid,elliptic,entire,exserted,extending,filament,filiform,flattened,fruiting,glabrous,globose,green,groove,growth,inflated,inflorescence,lamina,later,lateral,lobe,lobed,long,loosely,margin,membranous,midrib,minute,minutely,mm,narrowly,nearly,new,nodding,oblique,occasionally,often,pair,pale,papillate,pedicel,peduncle,petiole,pinnatifid,pitted,primary,puberulent,pubescent,purple,purplish,reaching,reddish,reniform,ripe,sagittate,simple,size,sleeve,small,sometimes,somewhat,sparsely,spreading,stem,stigma,strongly,style,surface,tan,terminal,tip,trichome,truncate,tube,tuft,uniseriate,variously,vein,vine,violet,way,white,within,woody,x,young,zig-zag	.5,0.5,1-4,1/3,10-20,2-3,2-6,3.5-4,5-6,5-merou,50,7-9,abaxially,adaxiall,ag,age,alyx,apar,ark,axi,basal,beyond,black,branched,bright,broadest,cell,clavat,conical,deltate,depending,drying,eaf,eed,elongate,flower,free,growing,ilament,intramarginal,irregular,irregularly,keeled,leaving,lengthening,lower,many,markedly,nflorescence,obvious,older,one,orolla,part,peg,pendan,pentagonal,per,perfect,pericarp,planar,plurifoliat,pore,poricidal,portion,puberulen,rotate-stellate,ruit,scar,shiny,slit,smaller,spaced,strong,sunligh,tem,testal,thin,time,tiny,twinin,twining,ud,unit,upper,usually,variable,vary,widest,ympodial	abaxial,arrangement,bark,bud,characteristic,clavate,colour,exertion,form,fruit,glabrousnes,history,leaf,length,life,lobing,ovary,plant,seed,shape,texture,type	-+,0.2,0.4-2.5,0.5-2,0.5-4,1,1-1.5,1-5,1.2-1.5,1.8-2.2,10,2.5,4-6,5,7-8,<,>,acuminate,acute,adaxial,along,anther,anthesi,area,articulated,asymmetrical,axil,base,berry,bilobed,blackish,c.,calyx,chartaceous,cm,connivent,deeply,dense,diameter,ellipsoid,elliptic,entire,exserted,extending,filiform,flattened,glabrous,globose,green,groove,inflated,lamina,later,lateral,lobe,lobed,long,loosely,membranous,midrib,minute,minutely,mm,narrowly,nearly,nodding,oblique,occasionally,often,pair,pale,papillate,pinnatifid,pitted,puberulent,pubescent,purple,purplish,reaching,reddish,reniform,ripe,sagittate,simple,sleeve,small,sometimes,somewhat,sparsely,spreading,strongly,style,surface,tan,terminal,tip,trichome,truncate,tube,tuft,uniseriate,variously,vein,vine,violet,way,white,within,woody,x,young,zig-zag	clavate
269	wfo-0001029031	success	211	134	95	119	92	15	93	2	-8,.5-1.2,0.1-0.5,0.5,0.5-1.5,0.5-4,0.6-1.2,0.7-1.1,1-3,1-5,1-9.4-11.4,1.8-2.7,10,13.5,2-10.7,2-3.3,2-5,2.5-5.5,3-10,3-10-12.3,4-7.5,5-17,6-12,6-21,abaxially,absent,acuminate,acute,adaxially,angle,anther,apex,base,becoming,berry,black,bluish,brown,calyx,capitate,cm,corolla,cuneate,deltate,densely,diameter,elliptic,elliptic-ovate,entire,erect,filament,flattened,fleshy,flower,fruit,glabrescent,glabrous,globose,green,held,immature,lateral,leaf,leaf-opposed,length,light,lobe,long,major,margin,midpoint,mm,nearly,oblong,obtuse,occasionally,orange,outline,pedicel,peduncle,peltate,peltate-stellate,petiole,possibly,pseudoterminal,pubescence,pubescent,rachi,rarely,ray,reniform,ripening,rounded,rugulose,shrub,side,silvery,simple,small,sparsely,stellate,stellate-pubescent,stem,stigma,strongly,style,suborbicular,surface,tip,tree,trichome,tube,usually,vein,white,whitish,x,yellow,yellowish	.1-0.3,0-5,1-1.5,1-2,1-2.5,1-2.6-3.6,1.3-3.3,1.5-2.8,1.5-3.5,1.8-4,1/3,2-3,2.5-5.6,20-150,4-5-,accrescent,adaxiall,ag,apart,apexacute,apparently,around,articulated,axe,ba,bilobe,blade,branched,center,chartaceous,connivent,covering,curved,cylindrical,denser,directed,distally,eaf,edge,eed,eglandula,eglandular,equal,farinose,forked,frui,fruiting,fused,geminate,hair,impressed,inserted,lanceolate,large,least,like,longitudinal,lower,many-foliate,midvein,nflorescence,opening,orolla,paired,perfect,pore,porrect-stellate,prominent,pubescen,ruit,sessile,short,short-stalked,slightly,slit,smaller,sometimes,somewhat,spaced,ste,straight,subtending,tall,tamen,tem,time,unarme,unbranched,unit,vary,wide,ympodial	0.1-0.3,arrangement,bilobed,colour,form,growth,height,inflorescence,ovary,plant,seed,shape,size,texture,type	-8,.5-1.2,0.1-0.5,0.5,0.5-1.5,0.5-4,0.6-1.2,0.7-1.1,1-3,1-5,1-9.4-11.4,1.8-2.7,10,13.5,2-10.7,2-3.3,2-5,2.5-5.5,3-10,3-10-12.3,4-7.5,5-17,6-12,6-21,absent,acuminate,acute,angle,apex,becoming,berry,black,bluish,brown,capitate,cm,cuneate,deltate,densely,diameter,elliptic,elliptic-ovate,entire,erect,flattened,fleshy,flower,fruit,glabrescent,glabrous,globose,green,held,immature,lateral,leaf-opposed,light,long,mm,nearly,oblong,obtuse,occasionally,orange,outline,peltate,peltate-stellate,possibly,pseudoterminal,pubescent,rarely,reniform,ripening,rounded,rugulose,shrub,side,silvery,simple,small,sparsely,stellate,stellate-pubescent,strongly,suborbicular,tip,tree,usually,white,whitish,x,yellow,yellowish	0.1-0.3,bilobed
270	wfo-0001029048	success	162	115	72	83	79	32	69	3	.5,/3,0.5,0.5-1.7,0.8-1,1-2,1-8,1.5-2,11,14,2,26,3-4,3.5-4,4-6,5-8,8-10,9-15,acuminate,anther,apex,arching,attenuate,base,berry,branch,broadly,calyx,cm,conical,corolla,decurrent,dia,elliptic,filament,filiform,fruiting,glabrous,globose,greenish-white,greenish-yellow,hanging,lateral,leaf,less,lobed,long,main,margin,matte,minutely,mm,obtuse,ovary,ovoid-reniform,pair,pale,papillose,pedicel,petiole,pitted,planar,puberulent,shaped,sharply,shrub,slender,slightly,small-capitate,stem,stigma,style,surface,tan,tear-drop,thread-like,tip,tube,unifoliate,vein,way,winged,x	.01,.2,0.5-1,1,25,3-7,angle,another,anthesi,apar,apparent,basal,bearing,becoming,beneath,bicellular,blade,bright,eaf,edicel,eed,elongated,except,expanded,f,flower,free,geminate,glabrate,golden,greatly,green,greenish-yello,hispidulous,incrassate,like,live,lobe,lower,middle,midrib,minute,much,nflorescence,node,non-reproductive,obovoid,older,one,opposite,papillo,parallel,pore,poricidal,portion,reflexed,right,ripe,rounded,ruit,scar,somewhat,spaced,specimen,straight,tall,tapering,time,translucent,trichome,ud,unevenly,uni-,unit,widely,widest,ympodial,young,zig-zag	arrangement,bark,bud,characteristic,colour,decument,diameter,drying,exertion,form,fruit,glabrousnes,growth,height,history,inflorescence,length,life,lobing,na,new,number,peduncle,per,perennial,plant,primary,seed,shape,size,texture,type	.5,/3,0.5,0.5-1.7,0.8-1,1-2,1-8,1.5-2,11,14,2,26,3-4,3.5-4,4-6,5-8,8-10,9-15,acuminate,arching,attenuate,base,berry,broadly,cm,conical,decurrent,dia,elliptic,filiform,glabrous,globose,greenish-white,greenish-yellow,hanging,lateral,leaf,less,lobed,long,main,matte,minutely,mm,obtuse,ovoid-reniform,pair,pale,papillose,petiole,pitted,planar,puberulent,shaped,sharply,shrub,slender,slightly,small-capitate,stem,tan,tear-drop,thread-like,tip,unifoliate,vein,way,winged,x	decument,na,perennial
271	wfo-0001029055	success	169	67	33	47	122	20	31	2	0.4-1.5,1-4,1-5,1.8-3.5,14-50,2-3,2.2-3,2.5-8,3-10,4-10,4-6,4-7,5.5-9,6-14,8-9,9-22,calyx,cm,corolla,diameter,filament,forked,green,herbaceous,interjected,lateral,leaf,leaflet,long,mm,mucilaginous,odd-pinnate,ovoid,pedicel,peduncle,pentagonal,perennial,petiole,pilose,plant,pubescent,rotate,seed,size,style,terminal,triangular	1-2.6,1.6-3.5,1.7-2.2,2-1.,2-4,3,3-6,3-6-foliat,5-24,abaxially,acumen,acuminate,acute,adaxially,apex,apical,apically,articulate,attenuate,base,branched,cell,connate,cordate,covered,covering,cuneate,cyme,dark,decurrent,dehiscent,densely,dichasial,dichasially,digestion,diminishing,distal,dorsally,eaf,ebracteate,edge,eed,elliptcal,elliptical,emoval,enzyme,exceeding,first,flat,flower,folded,generally,gland,globo,green-white,hair,hair-like,half,honeycomb,introrse,living,lobe,lon,long-attenuate,longer,longitudional,lower,lunat,make,maturing,monochasial,near,nflorescence,nther,oblique,often,orolla,outline,ovate,pair,pattern,perfect,plan,poricidally,proximal,purple,rarely,reveal,ruit,second,sessile,seudostipule,short,short-petiolate,short-stalked,slit,sometimes,specimen,spreading,stamen,stigma,straight,stripe,tal,tem,testal,thick,throughout,time,toward,tuber-bearing,type,typically,unit,vary,wall,whit,wide,widest,yellow,ympodial,Â¼	2-11,anther,arrangement,colour,form,fruit,globose,growth,height,history,inflorescence,length,life,ovary,pseudostipule,shape,stem,surface,texture,width	0.4-1.5,1-4,1-5,1.8-3.5,14-50,2-3,2.2-3,2.5-8,3-10,4-10,4-6,4-7,5.5-9,6-14,8-9,9-22,cm,forked,green,herbaceous,long,mm,mucilaginous,odd-pinnate,ovoid,pentagonal,perennial,pilose,pubescent,rotate,triangular	2-11,globose
272	wfo-0001029059	invalid_json	199	102	NA	80	119	22	NA	NA	.5,0.1-1,0.2,1-1.5,1-4,1-6,1.2-3,1.3-1.7,1.5-2,1.5-2.8,10-19,2.5,3-3.5,3-6.5,3.5-8,4-10.5,5-15-flowered,7-9,along,anther,apiculate,bark,base,berry,calyx,clavate,cm,corolla,deltoid,densely,dia,dirty,elliptic,flattened-reniform,fruiting,glabrous,globose,hispidulous,inflorescence,leaf,long,minor,minute,minutely,mm,nearly,occasionally,orbiculate,ovary,pale,papillose,pedicel,petiole,purplish,ripe,shallowly,shape,shaped,shrub,simple,size,slender,small,stem,stigma,style,tapering,tear-drop,tinge,tree,trichome,tube,unicellular,uniseriate,vein,waxy,white,x,yellowish-green,yellowish-tan	0.1-0.5,0.2-0.5,0.5,0.5-1,1-1.2,1-3,3.5-6,5,6-10,acute,anisophyllou,anthesi,apar,ape,apex,apiculae,arising,beneath,bout,branched,bud,closely,coiba,connivent,cordate,covered,cuneate,de,deep,deflexed,dense,differing,difoliate,eaf,edicel,eed,ellipsoid,expanded,exserted,extending,extremely,filament,foetid,free,geminate,glabrate,greatly,impressed,incrassate,interpetalar,isla,lamina,lateral,lobe,lobed,lon,longest,lower,main,major,margin,member,membranous,middle,narrowly,nflorescence,oblique,often,older,one,opposite,orange,orangish-yellow,pair,paler,panama,papillo,partially,pitted,planar,pointed,population,pore,poricidal,portion,prominent,pubescence,pubescent,reddish-gre,rest,rounded,ruit,scar,sinus,somewhat,soon,spaced,sparse,specimen,straight,surface,tall,terminal,thickened,ti,tightly,tip,triangular,ud,underside,unit,usually,variable,wide,widest,woody,yellowish,ympodial,young	abaxial,adaxial,alternate,arrangement,characteristic,colour,diameter,form,fruit,growth,height,history,length,life,lobing,perennial,plant,reddish-grey,seed,texture,type,value	NA	NA
273	wfo-0001029072	success	233	145	88	111	122	34	85	3	.5,0.4-0.9,0.5-2,0.8-1.5,00-200,1-1.2,1-1.5,1-25,1.5-2.6,1.5-3.2,1/3,1/4-1/2,12-19,2-7,2.2-2.5,2.2-3.2,2.5-3.5,2.5-3.8,2.5-4.5,3-20,3-5,4.2-6.5,4.5-9,5-7,7-15,8-27,acute,anther,apex,apparently,bark,base,berry,bright,calyx,chartaceous,cm,conical,connivent,cordate,cuneate,curved,densely,diameter,dirty,discolorous,distal,drying,dull,erect,filament,flattened,flattened-reniform,flower,fruit,fruiting,glabrous,green-brown,herb,lateral,leaf,length,lobe,lobed,long,long-styled,lower,margin,maturity,mauve,midpoint,mm,moderately,orange-brown,ovate,pair,pale,pedicel,peduncle,pendent,per,petiole,plant,poricidal,prickle,prickly,primary,ray,reflexed,rounded,short-styled,shrub,simple,sometimes,spherical,stellate-pubescent,stem,strongly,style,surface,tapering,terminal,tip,tube,upper,vein,way,weakly,white,wide,yellow	-15,/6,0,0-2,0-20,0-4,0-8,0.1-0.4,0.2-0.3,0.2-0.4,0.3,0.5-3,0.7,0.8-2.5,1,1-3,1.5-2.5,1/4-1/3,1/4-1/3-1/2,2-10,2-5,2-8,20-50,3-10,3-50,3-8,3.5-6,3/,4-10,4-5-merous,5-10,5-50,5-9,7-10,8-20,abaxial,abaxially,adaxial,adaxially,alyx,ame,andromonoecious,angled,apar,apart,apically,articulated,blade,branched,broad-deltate,broadly,c.,clearly,cream,dark,deltate,distance,eaf,eed,elongated,elongating,equal,extending,free,gently,gra,green,hermaphrodite,heterostylous,infructescence,least,longer,longitudinal,lowermost,marking,mature,midvein,multangulate,narrow-deltate,nflorescence,obtu,older,one,open,orolla,oung,pendulous,pericarp,plurifoliat,porrect,portion,prickl,raised,ridge,ruit,scar,sessile,side,smooth,spaced,sparsely,spreading,stalk,stalked,staminat,stellate,stout,straight,tamen,tertiary,time,trichome,unarmed,unit,variously,vary,venation,visible,whitish,woody,ympodial,young	3/4,appearance,arrangement,border,branch,bud,characteristic,colour,corolla,exertion,form,giving,glabrousnes,gray,growth,height,inflorescence,interjected,leaflet,lobing,na,new,number,ovary,pseudostipule,seed,shape,size,stigma,texture,thicknes,type,variation,width	.5,0.4-0.9,0.5-2,0.8-1.5,00-200,1-1.2,1-1.5,1-25,1.5-2.6,1.5-3.2,1/3,1/4-1/2,12-19,2-7,2.2-2.5,2.2-3.2,2.5-3.5,2.5-3.8,2.5-4.5,3-20,3-5,4.2-6.5,4.5-9,5-7,7-15,8-27,acute,apparently,base,berry,bright,chartaceous,cm,conical,connivent,cordate,cuneate,curved,densely,diameter,dirty,discolorous,dull,erect,flattened,flattened-reniform,flower,glabrous,green-brown,herb,lateral,lobed,long,long-styled,lower,maturity,mauve,mm,moderately,orange-brown,ovate,pair,pale,pendent,per,poricidal,prickly,reflexed,rounded,short-styled,shrub,simple,sometimes,spherical,stellate-pubescent,strongly,tapering,terminal,tip,upper,way,weakly,white,wide,yellow	3/4,gray,na
274	wfo-0001029073	success	211	119	84	101	110	18	84	0	0.3-1,0.5,0.6-2,1-1.2,1-1.5,1.1-1.5,1.5-2,10-16,2,2-3,2/3,4-6,5-6,5-8,acuminate,acute,anther,anthesi,apex,armed,base,berry,broad-based,brown,calyx,chartaceous,cm,corolla,curved,dark,dense,densely,diameter,dimorphic,elliptic,entire,exserted,filament,flattened,fruiting,glabrous,globose,golden,growth,hooked,inflorescence,internodal,lanceolate,leaf,length,lobed,long,margin,maturity,minutely,mm,narrowly,new,nodding,oblique,occasionally,opposite,orange,pale,papillose,pedicel,peduncle,per,petiole,prickle,pubescence,pubescent,purple,reniform,reticulate,shallowly,shrub,simple,sinuate,slightly,somewhat,sparsely,stellate,stem,stigma,straight,strongly,style,surface,tan,tapering,tip,trichome,truncate,tube,unequally,way,woody,x,yellowish,Â½	.5,.7,0.5-1,0.6-0.7,1-2.5,1-3,1.2-1.6,10-15,2-4,3.5-9,4-5,5-merous,6-9,7-10,8-14,abaxially,adaxially,along,another,apart,articulated,away,awn-like,ba,bark,basal,beneath,cell,conical,cream,darker,difoliate,discolorous,drying,eaf,eed,enlarged,equal,erect,except,flower,four,free,frui,geminat,gre,interpetalar,lamina,lengthening,like,linear,lobe,long-styled,lower,midpoint,midvein,mixture,multangulate,nflorescence,older,one,pair,paler,perfect,pericarp,planar,plurifoliate,pore,poricidal,porrect,portion,prickly,primary,ray,rectangular,ruit,scar,sessile,shiny,short,short-stalked,shorter,slit,sometimes,spaced,splitting,styled,testal,thin,three,ti,tissue,triangular,two,ud,unarmed,underside,unequal,unisexual,unit,upper,upward,vein,visible,wall,whitish,wide,yellow,ympodial,zygomorphic	arrangement,bud,characteristic,colour,exertion,form,fruit,glabrousnes,height,lobing,number,ovary,plant,seed,shape,size,texture,type	0.3-1,0.5,0.6-2,1-1.2,1-1.5,1.1-1.5,1.5-2,10-16,2,2-3,2/3,4-6,5-6,5-8,acuminate,acute,anthesi,apex,armed,base,berry,broad-based,brown,calyx,chartaceous,cm,curved,dark,dense,densely,diameter,dimorphic,elliptic,entire,exserted,flattened,glabrous,globose,golden,hooked,internodal,lanceolate,leaf,lobed,long,maturity,minutely,mm,narrowly,nodding,oblique,occasionally,opposite,orange,pale,papillose,per,pubescence,pubescent,purple,reniform,reticulate,shallowly,shrub,simple,sinuate,slightly,somewhat,sparsely,stellate,straight,strongly,tan,tapering,tip,trichome,truncate,tube,unequally,way,woody,x,yellowish,Â½	
275	wfo-0001029074	success	173	116	79	92	81	24	78	1	.5,0,0.2-1,0.3-0.8,0.5-1,0.5-1.2,0.7-0.8,1,1-1.2,1-2,1-3-6,1.4-1.8,11,2-2.3,acute,anther,apart,apex,base,berry,black,broadly,calyx,capitate,cm,conical,corolla,cuneate,densely,diameter,ellipsoid,entire,exerted,flattened,flower,fruiting,glabrous,globose,green,grey,growth,herb,immature,internodal,leaf,less,lignescent,like,margin,minutely,mixture,mm,new,opposite,ovary,ovate,pale,pedicel,peduncle,per,petiole,pitted,poricidal,pubescent,purplish,reniform,ripening,rounded,sagittate,sessile,simple,sparsely,stalked,stellate,stem,stigma,strongly,style,subshrub,surface,tip,trichome,truncate,tube,underside,uniformly,way,white,x,yellow,yellowish,Â¾	.1,0.3-0.4,0.7-0.95,1-1.5,1.5-2,1.5-4,2-4,2-5,2-7,3-,3.5-5,5-6,5-7,abaxially,absent,adaxially,age,almost,along,anthesi,apparently,appearing,articulation,bark,basa,deflexed,denser,eaf,eed,expanding,filament,free,frui,glabrescen,lacking,lengthening,lobe,lobed,longest,lower,markedly,midpoint,midvein,nflorescence,obscuring,often,older,pair,papillat,perfect,pericarp,petal,planar,plurifoliat,pore,portion,primary,prominent,pulp,ray,reflexed,ruit,scar,scattered,slit,small,somewhat,stalk,stellate-pubescent,swollen,thin,triangular,tub,ud,uniseriate,unit,usually,vein,watery,woody,ympodial	abaxial,adaxial,arrangement,bud,characteristic,colour,exertion,form,fruit,glabrousnes,height,history,inflorescence,length,life,lobing,na,number,plant,seed,shape,size,texture,type	.5,0,0.2-1,0.3-0.8,0.5-1,0.5-1.2,0.7-0.8,1,1-1.2,1-2,1-3-6,1.4-1.8,11,2-2.3,acute,apart,apex,base,berry,black,broadly,calyx,capitate,cm,conical,cuneate,densely,diameter,ellipsoid,entire,exerted,flattened,flower,glabrous,globose,green,grey,herb,immature,internodal,leaf,less,lignescent,like,minutely,mixture,mm,opposite,ovate,pale,per,pitted,poricidal,pubescent,purplish,reniform,ripening,rounded,sagittate,sessile,simple,sparsely,stalked,stellate,strongly,subshrub,tip,trichome,truncate,tube,underside,uniformly,way,white,x,yellow,yellowish,Â¾	na
276	wfo-0001029075	success	217	144	112	123	94	21	108	4	.3,.5,0-8,0.8-1.2,0.8-1.5,1-2,1-2.5,10-20,2-5,2.5-3,2.7-4.2,30-60,4-14,4-7,5-10,5-8,5-8.5,6-12,7-17,7-9,8-9,abaxially,abruptly,acumen,adaxially,along,anther,berry,broadly,brown,brownish,canescent,cell,ciliate,cm,condition,connivent,corolla,covering,dark,densely,diameter,dot,drying,end,erect,especially,flecked,flower,fresh,fruit,glabrescent,glabrous,glandular-pilose,glandular-puberulent,gray-green,green,green-white,greenish,hair,hair-like,herb,homostylous,interjected,lanceolate,lateral,leaf,leaflet,light,like,lobe,long,long-spatulate,make,margin,midrib,minutely,mm,mucilaginous,narrowed,odd-pinnate,orne,ovoid,pedicel,peduncle,pentagonal,petal,petiole,plant,poricidal,puberulent,pubescent,purple,seed,short,singly,size,small,sometimes,stem,stigma,style,subquadrate,substellate,terminal,testal,thick,throughout,tip,tube,tuber,unwinged,upper,wall,wet,white,whitish,whitish-gray,wide,x,yellow,yellow-green,yellowish-white	0-3,0.5-0.8,1-10,1-3,2-4,4-10,4-5,4.5-6.5,5-merou,ag,alyx,apart,apex,apparently,articulated,attenuate-acuminate,atypically,axe,axillary,base,blade,bud,clavifor,cuneate,decreasing,decurrent,digestion,distal,dorsally,eaf,edge,eed,elliptic-lanceolate,enzyme,erect-ascendin,etota,exceeding,filament,flat,folded,forked,geminat,generally,glabrou,gradually,greatly,half,honeycomb-shaped,larger,lengthening,living,lower,middl,narrowly,nflorescence,orbicular,orolla,ovate,pair,perfect,petiolulate,petiolule,plurifoliate,pointed,pore,rachi,removed,rounded,ruit,sec,sessile,seudostipule,slightly,slit,spaced,specimen,stamen,ste,stolo,straight,subequal,subobtuse,subtending,tall,tamen,tem,toward,tri-,typically,unit,usually,vary,woody,ympodial	5-merous,abaxial,adaxial,arrangement,calyx,claviform,colour,erect-ascending,form,growth,height,history,inflorescence,length,life,ovary,pseudostipule,shape,staman,stolon,texture	.3,.5,0-8,0.8-1.2,0.8-1.5,1-2,1-2.5,10-20,2-5,2.5-3,2.7-4.2,30-60,4-14,4-7,5-10,5-8,5-8.5,6-12,7-17,7-9,8-9,abaxially,abruptly,acumen,adaxially,along,berry,broadly,brown,brownish,canescent,cell,ciliate,cm,condition,connivent,corolla,covering,dark,densely,diameter,dot,drying,end,erect,especially,flecked,fresh,glabrescent,glabrous,glandular-pilose,glandular-puberulent,gray-green,green,green-white,greenish,hair,hair-like,herb,homostylous,lanceolate,lateral,light,like,lobe,long,long-spatulate,make,margin,midrib,minutely,mm,mucilaginous,narrowed,odd-pinnate,orne,ovoid,pentagonal,petal,poricidal,puberulent,pubescent,purple,seed,short,singly,small,sometimes,stem,subquadrate,substellate,testal,thick,throughout,tip,tube,unwinged,upper,wall,wet,white,whitish,whitish-gray,wide,x,yellow,yellow-green,yellowish-white	5-merous,claviform,erect-ascending,stolon
277	wfo-0001029084	success	192	119	84	99	93	20	81	3	.5,0.8-2,0.8-2.1,1-2,1.1-2.2,1.5-2.5,10-50,2-3.5,2-5,3-6,3.5-7.5,3.5-8,4-7,4.5-10,4.5-6.5,5,5-7,6-13,7-9,8-23,acuminate,anther,apex,axillary,base,berry,blade,brownish,bud,cell,chartaceous,cm,condition,conical,connivent,corolla,covering,diameter,distal,drying,filament,flower,forked,fresh,fruit,generally,glabrous,green,green-white,greenish,hair-like,half,herb,homostylous,lanceolate,lateral,leaf,leaflet,light,lilac,lobe,long,make,minute,mm,moniliform,mottled,mucilaginous,odd-pinnate,ovoid,pedicel,peduncle,petiole,petiolule,plant,pubescent,purple,ripe,rotate,seed,size,sparsely,stigma,style,subglabrous,subsessile,subtending,terminal,testal,thick,throughout,tube,tuber,usually,wall,wet,whitish,wide,x	1-10,1-3,1-4,2-4,4-17,5-merou,abaxially,absent,acumen,adaxially,ag,along,alyx,apart,apparently,arranged,articulated,axe,bead,capitat,ciliate,darker,decreasing,digestion,dorsally,eaf,edge,eed,enzyme,especially,exceeding,flat,folded,geminat,glabrou,gradually,honeycomb-shaped,interjected,interpetalar,larger,lengthening,like,living,lon,lower,margin,middle,midrib,minutely,multiple,narrow,necklace,nflorescence,obtuse,orolla,ovate-lanceolate,pair,perfect,pilose,plurifoliate,pore,poricidal,proximal,puberulent,ray,removed,ruit,secondary,semierec,seudostipule,slit,spaced,specimen,stamen,stolon,subequal,subglabrou,symmetrical,tall,tamen,tem,thir,tip,tissue,toward,tri-,typically,unit,unwinged,vary,wing,yellow,ympodial	5-merous,arrangement,calyx,capitate,colour,form,growth,height,history,inflorescence,length,life,ovary,pseudostipule,semierect,shape,staman,stem,surface,texture	.5,0.8-2,0.8-2.1,1-2,1.1-2.2,1.5-2.5,10-50,2-3.5,2-5,3-6,3.5-7.5,3.5-8,4-7,4.5-10,4.5-6.5,5,5-7,6-13,7-9,8-23,acuminate,axillary,berry,brownish,bud,cell,chartaceous,cm,condition,conical,connivent,covering,distal,drying,flower,forked,fresh,fruit,generally,glabrous,green,green-white,greenish,hair-like,half,herb,homostylous,lanceolate,lateral,light,lilac,long,make,minute,mm,moniliform,mottled,mucilaginous,odd-pinnate,ovoid,petiolule,plant,pubescent,purple,ripe,rotate,seed,sparsely,subglabrous,subsessile,subtending,terminal,testal,thick,throughout,usually,wall,wet,whitish,wide,x	5-merous,capitate,semierect
278	wfo-0001029088	success	149	124	96	101	48	23	93	3	.2,.3,0.1,0.6â3.2,1.3â4.5,1.5â2,1.5â3,15â25,1â1.5,1â1.6,1â3,2.5â4.2,25â30,2â2.5,2â3,3.5â7,3.5â8,3â16,4â8,5-merous,5â8,6-10,<,abaxially,acuminate,acute,adaxially,anther,apex,base,berry,bronze-brown,calyx,capitate,ciliate,cm,cordate,cylindrical,densely,diameter,emarginate,entire,extra-axillary,filament,flattened,fleshy,flower,fruit,glabrous,greenish-brown,hair,half,herbaceous,immature,lanceolate,leaf,lenticular,light,lobe,long,lower,margin,mature,membranous,minutely,mm,moderately,narrowly,near,obtuse,ovoid-rhomboid,papillose,pedicel,peduncle,petiole,pubescent,purplish,reddish-brown,revolute,rounded,rugose,sand-punctate,shortly,simple,slender,slightly,somewhat,sparsely,stellate,stigma,stout,straight,style,surface,tip,truncate,tube,unbranched,vine,white,x	0.9â1.5,1â1.2,2-lobe,2.5â20,5,accrescent,alyx,apar,apicall,axe,blade,c.,climbing,eaf,eed,flavor,fragrant,fruiting,glabrou,groun,heavy,juicy,m.,nflorescence,nternode,orolla,palmate,perfec,plurifoliat,primary,rachi,ruit,scent,spaced,strongly,swee,sweet,tamen,tem,terrestrial,truncate-acuminat,unit,vary,vein,venation,wider,ympodial,â7	2-lobed,apically,arrangement,characteristic,colour,corolla,form,growth,height,history,inflorescence,length,life,ovary,perfect,plant,seed,shape,size,staman,stem,texture,type	.2,.3,0.1,0.6â3.2,1.3â4.5,1.5â2,1.5â3,15â25,1â1.5,1â1.6,1â3,2.5â4.2,25â30,2â2.5,2â3,3.5â7,3.5â8,3â16,4â8,5-merous,5â8,6-10,<,abaxially,acuminate,acute,adaxially,apex,berry,bronze-brown,capitate,ciliate,cm,cordate,cylindrical,densely,diameter,emarginate,entire,extra-axillary,filament,flattened,fleshy,flower,fruit,glabrous,greenish-brown,hair,half,herbaceous,immature,lanceolate,leaf,lenticular,light,lobe,long,lower,margin,mature,membranous,minutely,mm,moderately,narrowly,near,obtuse,ovoid-rhomboid,papillose,pubescent,purplish,reddish-brown,revolute,rounded,rugose,sand-punctate,shortly,simple,slender,slightly,somewhat,sparsely,stellate,stout,straight,surface,tip,truncate,tube,unbranched,vine,white,x	2-lobed,apically,perfect
279	wfo-0001029089	success	177	120	91	97	80	23	89	2	.75,/4,0.1-0.25,0.5-0.6,0.5-1,0.8-1,1,1-1.5,1.5-2,1.5-6,5-20-flowered,5-9,6-7,abrupt,anther,apiculate,bark,base,beneath,berry,bilobed,branched,bud,calyx,campanulate,caniculate,cm,completely,corolla,covered,dark,densely,dia,difoliate,drying,elliptic,enclosed,exserted,filament,flattened-reniform,fruiting,furcate,glabrous,globose,golden,green,incrassate,later,leaf,like,lobed,long,margin,minutely,mm,obovoid,occasionally,opposite,ovary,papillose,pedicel,persistent,petiole,pinkish,pitted,pore,poricidal,pubescent,purplish,reddish-grey,resinous,secretion,shaped,shiny,shrub,simple,small,somewhat,stem,stigma,style,surface,tan,tapering,tear-drop,tip,tree,tube,uniseriate,unit,usually,varnish,way,white,widening,x,young	.5,0.8-1.2,1/2,10-25,2.5-3.5,4.5-5,5-10,5-6,8-9,acute,along,anthesi,apart,apex,axil,ba,beginning,closely,covering,cracking,decurrent,deflexed,differing,eaf,edicel,eed,either,entire,erect,expand,free,geminat,glabrou,impressed,inflorescenc,lamina,lateral,lobe,lon,lower,main,major,material,member,middle,minor,nflorescence,older,one,otherwise,overlapping,pair,papillo,part,peeling,planar,portion,primary,prominent,resinou,rounded,rounded-deltoid,ruit,scar,size,slightly,smooth,spaced,still,straight,tall,trichome,tub,ud,underside,varnished,vein,widest,woody,ympodial	abaxial,adaxial,arrangement,characteristic,colour,diameter,form,fruit,geminate,growth,hair,height,history,inflorescence,length,life,lobing,plant,seed,shape,sympodial,texture,type	.75,/4,0.1-0.25,0.5-0.6,0.5-1,0.8-1,1,1-1.5,1.5-2,1.5-6,5-20-flowered,5-9,6-7,abrupt,apiculate,base,beneath,berry,bilobed,branched,bud,calyx,campanulate,caniculate,cm,completely,corolla,covered,dark,densely,dia,difoliate,drying,elliptic,enclosed,exserted,flattened-reniform,furcate,glabrous,globose,golden,green,incrassate,later,leaf,like,lobed,long,margin,minutely,mm,obovoid,occasionally,opposite,papillose,persistent,pinkish,pitted,pore,poricidal,pubescent,purplish,reddish-grey,resinous,secretion,shaped,shiny,shrub,simple,small,somewhat,stem,style,surface,tan,tapering,tear-drop,tip,tree,tube,uniseriate,unit,usually,varnish,way,white,widening,x,young	geminate,sympodial
280	wfo-0001029091	success	207	98	64	79	128	19	64	0	-4,-4.5,1-2,1.5-2-3,10,2-3,2.5-4,3,3-11-lobed,3-4,7-8,acuminate,acute,anther,apex,base,berry,broadly,buff,calyx,capitate,cm,colour,corolla,cuneate,cyme,discoidal,ellipsoid,elliptic,erect,filament,flattened,flower,flushed,fruiting,globose,globular,grey,intense,irregular,irregularly,larger,leaf,light,long,minutely,mm,oblong,obovate,ochre-yellow,ovate,overlain,ovoid,pale,pattern,pedicel,pentagonal,petiolate,petiole,pubescent,reddish-purple,reticulate-concentric,ridge,ridged,several,shortly,shrub,slightly,soft-wooded,sparsely,speckled,stellate-rotate,stem,stigma,style,surface,transverse,violet-purple,year	0.3-0.5-0.8-1,0.5-1,1,1-10,1.5-2,10-20,10-toothed,15-40,170-210,2-12,2-2.5,20-30,3-5-7-15,46/1,5,635/1,age,appearing,aromatic,articulated,articulation,aspect,axil,ba,becoming,blunt,bluntly,brownish,campanulate,cell,clonal,close,common,conspicuous,cut,dark,deeply,develop,developed,dia,downward,eed,effect,emarginated,exceeding,exerted,floral,fork,forked,fresh,general,giving,glandular,gree,growing,hair,half,interacuminal,juvenile,lacking,lasting,later,lateral,lavende,lavender,lengthening,line,linear,linear-lanceolate,lobe,long-triangular,lower,may,mid-vein,mineral,narrowly,nflorescence,obscure,occasionally,ower,pedicellate,peduncle,petiol,plurifoliat,point,pore,poricidal,rachi,raised,readily,relatively,rh,ripe,rounded,ruit,scarcely,separate,shallowly,shed,sigmoid,simple,sinus,slender,slit,soft,soon,stone,straggly,subulate,succulent,swollen,tall,tip,tissue,toward,triangular,tub,ud,unit,upper,usually,violet,well,winged,without,woody,x,ympodial	bud,characteristic,diameter,duration,form,fruit,growth,height,history,inflorescence,length,life,lobing,plant,pubescence,seed,shape,texture,type	-4,-4.5,1-2,1.5-2-3,10,2-3,2.5-4,3,3-11-lobed,3-4,7-8,acuminate,acute,berry,broadly,buff,capitate,cm,cuneate,cyme,discoidal,ellipsoid,elliptic,erect,flattened,flower,flushed,globose,globular,grey,intense,irregular,irregularly,larger,light,long,minutely,mm,oblong,obovate,ochre-yellow,ovate,overlain,ovoid,pale,pattern,pentagonal,petiolate,pubescent,reddish-purple,reticulate-concentric,ridge,ridged,several,shortly,shrub,slightly,soft-wooded,sparsely,speckled,stellate-rotate,transverse,violet-purple,year	
281	wfo-0001029101	success	230	127	86	102	128	25	84	2	.5,/3,0-2,0.4-1.5,0.5-1,00-200,1-1.5,1-3,1.3-2,1.3-2.6,1.4-2.2,1.5-2.5,1.8-3,2-6,2.5-3.5,2.5-6,2.8-3.3,3-4,3-5-9,5-7-13,anther,apex,apparently,articulated,bark,base,berry,brown-green,calyx,cell,chartaceous,cm,concolorous,cream,cuneate,dark,darker,diameter,discolorous,drying,dull,elliptic,erect,filament,flattened-reniform,flower,fruit,fruiting,glabrous,green,lateral,leaf,length,lobed,long,long-styled,margin,marking,maturity,mauve,mm,moderately,obovate,obtuse,orange-brown,outline,ovate,pair,pale,pedicel,peduncle,per,petiole,pit,plant,poricidal,prickle,prickly,primary,raised,rounded,short-styled,shrub,simple,small,smooth,sometimes,sparsely,spherical,stellate-pubescent,stem,style,surface,tapering,tip,tube,vein,way,wide,yellow,yellow-green,young	-15,/4,0-100,0-20,0-5,0-8,0.1,0.1-0.4,0.1-0.5,0.1-0.7,0.1-1,0.2,0.7-1.5-2,0.8-3.5,1,1-4,1-8,1.5-2,1.7,1/5-1/4,10-14,10-20,2-20,2-3-4,2/3-3/4,3-10,3-7,30-100,4-12,4-7,5-20,5-6,5-7,5-8,5-merous,5.5-8,6-8,8-15,abaxial,abaxially,acute,adaxial,almost,always,alyx,andromonoecious,apar,apart,apically,blade,branched,broad-deltate,connivent,deltate,distal,distance,eaf,eed,elongating,equal,extending,flattened,free,glabrescent,green-brow,hermaphrodite,heterostylous,infructescence,lengt,like,lobe,lon,longer,lower,lowermost,mature,midpoint,midvein,multangulate,narrow-deltate,nflorescence,oblong,often,older,one,open,orolla,oung,pendulous,pericarp,plurifoliat,porrect,portion,present,prickl,rarely,ray,reduced,reflexed,rounde,ruit,scar,secondary,sessile,side,spaced,spreading,stalk,stalked,staminat,stellate,straight,suborbicular,tamen,terete,tertiary,thick,time,trichome,unit,variously,vary,venation,visible,well-developed,woody,yellow-orange,ympodial	arrangement,branch,bud,characteristic,colour,corolla,corrugation,exertion,form,glabrousnes,green-brown,growth,height,inflorescence,lobing,na,new,number,ovary,seed,shape,size,stigma,texture,type	.5,/3,0-2,0.4-1.5,0.5-1,00-200,1-1.5,1-3,1.3-2,1.3-2.6,1.4-2.2,1.5-2.5,1.8-3,2-6,2.5-3.5,2.5-6,2.8-3.3,3-4,3-5-9,5-7-13,apex,apparently,articulated,base,berry,brown-green,cell,chartaceous,cm,concolorous,cream,cuneate,dark,darker,diameter,discolorous,drying,dull,elliptic,erect,flattened-reniform,flower,glabrous,green,lateral,length,lobed,long,long-styled,marking,maturity,mauve,mm,moderately,obovate,obtuse,orange-brown,outline,ovate,pair,pale,per,pit,poricidal,prickle,prickly,raised,rounded,short-styled,shrub,simple,small,smooth,sometimes,sparsely,spherical,stellate-pubescent,tapering,tip,way,wide,yellow,yellow-green,young	green-brown,na
282	wfo-0001029106	success	198	114	74	92	106	22	73	1	.5,/3,0.2-1,0.25-0.7,0.5-0.8,0.5-0.9,0.5-1,0.9-1.2,1-1.6,1.5-3.5,2-4,2-5.5,2-8,2.2-3,3-3.5,3-4,anther,apex,apparently,articulated,bark,base,berry,calyx,cell,cm,concolorous,cuneate,densely,diameter,discolorous,drying,elliptic,erect,filament,flattened-reniform,fruit,fruiting,glabrous,lateral,leaf,length,light,lobed,long,margin,maturity,mauve,membranous,mm,obtuse,orange,orange-brown,orbicular,outline,ovate,pair,pale,pedicel,peduncle,petiole,pit,poricidal,prickly,primary,raised,red,rounded,shiny,shrub,simple,size,small,smooth,sometimes,sparsely,spherical,spreading,stellate-pubescent,stem,style,subentire,surface,tapering,tip,vein,way,weakly,white,wide,yellow-orange,yellowish-green	.1,0-0.3,0-10,0-2,0-20,0-5,0-6,0.1,0.2-0.4,0.5,0.5-2.5,1-2,1-5,1.5-1.8,1.5-2,1/4,1/5-1/4,2-3.5,2-6,2/,3-25,4-6,4-8,5-14,5-8,5-merous,6-8,abaxially,acuminat,acute,alyx,ame,apar,apart,apically,appearing,blade,branched,c.,curved,deltate,distance,eaf,eed,elongating,equal,extending,eye,flattened,flower,free,gently,glabrescent,infructescence,lobe,lon,longer,lower,mature,midpoint,midvein,naked,nflorescence,older,one,open,orange-brow,orolla,oung,pendulous,per,perfec,pericarp,plurifoliat,porrect,portion,prickl,prickle,ray,reflexed,scandent,scar,sessile,shallow,shorter,side,slender,spaced,stalk,stalked,stellate,straight,tamen,terete,tertiary,time,trichome,tube,uit,unit,variously,vary,venation,visible,woody,ympodial	arrangement,branch,characteristic,colour,corolla,exertion,form,glabrousnes,growth,height,history,inflorescence,life,lobing,new,ovary,perennial,plant,seed,shape,texture,type	.5,/3,0.2-1,0.25-0.7,0.5-0.8,0.5-0.9,0.5-1,0.9-1.2,1-1.6,1.5-3.5,2-4,2-5.5,2-8,2.2-3,3-3.5,3-4,apparently,articulated,base,berry,cell,cm,concolorous,cuneate,densely,diameter,discolorous,drying,elliptic,erect,flattened-reniform,glabrous,lateral,light,lobed,long,maturity,mauve,membranous,mm,obtuse,orange,orange-brown,orbicular,outline,ovate,pair,pale,pit,poricidal,prickly,raised,red,rounded,shiny,shrub,simple,small,smooth,sometimes,sparsely,spherical,spreading,stellate-pubescent,subentire,tapering,tip,way,weakly,white,wide,yellow-orange,yellowish-green	perennial
283	wfo-0001029112	success	190	103	64	84	106	19	61	3	0.9-1.7,1-2,1.4-2.5,1.5-1.8,1.5-2,10-21,2-3.5,2.5-4.5,2.6-3,2.7-3.5,2.7-4.2,2.7-5.7,20,3-6,3-7,3.5-4.5,3.5-7,5,5-8,6.5-5.5,9.5-13,abaxially,adaxially,anther,berry,blade,brownish,chartaceous,ciliate,cm,condition,conical,connivent,corolla,densely,diameter,drying,filament,flower,fresh,fruit,glabrous,green,green-white,greenish,herb,homostylous,interjected,lanceolate,lateral,leaf,leaflet,light,lobe,long,margin,minute,mm,moniliform,mottled,mucilaginous,odd-pinnate,ovoid,pale,pedicel,peduncle,petiole,plant,pubescent,purple,ripe,seed,size,stigma,style,terminal,throughout,tube,tuber,violet,wet,whitish,wide,x	0-2,0.5,1-10,1-3,1-4,10-17,3-4,3-5,5-merou,acumen,acuminate,ag,along,alyx,apart,apex,apparently,arranged,articulated,axe,axillary,base,bead,bud,capitat,cell,covering,decreasing,digestion,distal,dorsally,eaf,edge,eed,elliptic-lanceolate,enzyme,equal,especially,exceeding,flat,folded,forked,geminat,generally,glabrou,gradually,hair,hair-like,half,honeycomb-shaped,larger,lengthening,like,living,lower,make,middle,multiple,narrow,necklace,nflorescence,obtuse,orolla,ovate,pair,perfect,petiolule,plurifoliate,pore,poricidal,present,pubescen,ray,removed,rotate,ruit,secondary,semierec,seudostipule,slightly,slit,spaced,specimen,stamen,ste,stolon,subequal,subtending,symmetrical,tall,tamen,tem,testal,thick,thir,tip,toward,tri-,typically,unit,usually,vary,wall,wing,yellow,ympodial	5-merous,arrangement,calyx,capitate,colour,form,growth,height,history,inflorescence,length,life,ovary,pseudostipule,semierect,shape,stem,surface,texture	0.9-1.7,1-2,1.4-2.5,1.5-1.8,1.5-2,10-21,2-3.5,2.5-4.5,2.6-3,2.7-3.5,2.7-4.2,2.7-5.7,20,3-6,3-7,3.5-4.5,3.5-7,5,5-8,6.5-5.5,9.5-13,abaxially,adaxially,berry,brownish,chartaceous,ciliate,cm,condition,conical,connivent,densely,drying,fresh,glabrous,green,green-white,greenish,herb,homostylous,lanceolate,light,long,margin,minute,mm,moniliform,mottled,mucilaginous,odd-pinnate,ovoid,pale,pubescent,purple,ripe,throughout,violet,wet,whitish,wide,x	5-merous,capitate,semierect
284	wfo-0001029120	success	168	98	63	71	97	27	60	3	.5,0.1-0.5,0.5-1.5,0.7-1,1.1-1.5,1.1-2,5-10-flowered,6-8,abrupt,acuminate,acute,anther,apex,bark,basal,base,beneath,bud,calyx,cm,corolla,dark,decurrent,densely,dia,erose,especially,f,filament,glabrous,globose,golden,greenish-brown,hirsute,larger,leaf,long,margin,minutely,mm,narrowly,nearly,occasionally,ovary,ovate,pale,pedicel,peduncle,petiole,pubescent,shaped,shrub,simple,slightly,sparsely,stem,stigma,style,surface,tapering,tear-drop,trichome,tube,unifoliate,uniseriate,vein,white,widening,yellow,yellow-green,young	.05,.75,/2,1-1.5,2.5-3.5,2.6-7,3-3.5,5-8,6.5-16.5,8511,anthesi,apart,beginning,black,bullate,cell,deflexed,difoliate,dry,drying,eaf,edicel,eed,epidermi,evenly,fide,fleshy,free,geminat,inflorescenc,infloresence,internodal,know,known,lanceolate,large,later,lateral,lehmann,like,lobe,lobed,lon,long-triangular,lower,main,middle,midrib,minor,narrow,narrower,nflorescence,often,older,opposite,outer,pair,paler,papillose,peduncl,petaloid,point,pore,poricidal,portion,present,prominently,proximal,raised,reproductive,rest,ruit,scar,scattered,slender,spaced,specimen,speckle,straight,sympodial,tall,terminal,thickened,tip,tub,ud,unbranched,unit,upper,urceolate,venation,way,white-papillo,wide,widest,x,ympodial	arrangement,characteristic,colour,decument,diameter,exertion,form,fruit,glabrousnes,growth,height,history,inflorescence,length,life,lobing,na,new,number,per,plant,seed,shape,size,texture,type,white-papillose	.5,0.1-0.5,0.5-1.5,0.7-1,1.1-1.5,1.1-2,5-10-flowered,6-8,abrupt,acuminate,acute,basal,base,beneath,bud,calyx,cm,dark,decurrent,densely,dia,erose,especially,f,glabrous,globose,golden,greenish-brown,hirsute,larger,leaf,long,minutely,mm,narrowly,nearly,occasionally,ovate,pale,petiole,pubescent,shaped,shrub,simple,slightly,sparsely,stem,style,tapering,tear-drop,trichome,tube,unifoliate,uniseriate,vein,white,widening,yellow,yellow-green,young	decument,na,white-papillose
285	wfo-0001029121	success	159	77	40	55	104	22	39	1	0,0.2-2,1-4,1-5,1.1-3.9,1.2-2.5,1.2-3.3,15-30,2-10,2-13,2-3,3.6-9,3.8-11,4-10,4-5.5,4.5-10.0,5-20,5-8,9-33,blue,branched,calyx,cm,conical,corolla,deep,diameter,dichasially,filament,forked,glabrous,green,herbaceous,interjected,lateral,leaf,leaflet,long,medium,mm,mucilaginous,odd-pinnate,ovoid,pedicel,peduncle,perennial,petiole,plant,purple,rarely,seed,size,style,terminal,wide	0-2,10,2-3-5-6,2-3-celled,3-6-foliat,8-16,abaxiall,abaxially,acumen,acuminate,acute,adaxially,apex,apical,apically,articulate,attenuate,base,cell,commonly,connate,covering,cuneate,cyme,dehiscent,dichasial,digestion,diminishing,distal,dorsally,eaf,ebracteate,edge,eed,elliptical,emoval,enzyme,exceeding,flat,flower,folded,generally,globo,gradually,green-white,hair,hair-like,half,honeycomb,introrse,living,lobe,lon,lower,lunat,make,maturing,monochasial,narrowly,nflorescence,nther,oblique,obtuse,often,orolla,ovate,pair,pattern,perfect,petiolule,plan,poricidally,proximal,reveal,rotate,rounded,ruit,scattered,sessile,seudostipule,short,short-attenuate,slit,specimen,stamen,stigma,straight,subequal,tal,tem,testal,thick,throughou,throughout,tip,toward,tuber-bearing,typically,unit,vary,wall,yellow,ympodial,Â¼	6,abaxial,adaxial,anther,arrangement,branching,colour,form,fruit,growth,height,history,inflorescence,length,life,ovary,pseudostipule,shape,stem,surface,texture,width	0,0.2-2,1-4,1-5,1.1-3.9,1.2-2.5,1.2-3.3,15-30,2-10,2-13,2-3,3.6-9,3.8-11,4-10,4-5.5,4.5-10.0,5-20,5-8,9-33,blue,branched,cm,conical,deep,dichasially,forked,glabrous,green,herbaceous,long,medium,mm,mucilaginous,odd-pinnate,ovoid,perennial,purple,rarely,wide	6
286	wfo-0001029125	success	196	136	95	92	104	44	73	22	2/3,abaxially,acuminate,acute,adaxially,anther,anthesi,apex,appressed,attenuate,base,berry,black,branching,brownish,calyx,central,cm,concave-reniform,conical,corolla,cuneate,deltate,densely,diameter,ellipsoid,entire,exerted,filament,fruit,fruiting,glabrous,globose,green,herb,internodal,lateral,leaf,long,lower,margin,maturity,minutely,mm,nearly,oblique,occasionally,often,orange,ovary,ovate-lanceolate,pair,papillate,pedicel,peduncle,per,petiole,plant,primary,pubescent,purple,purple-tinged,purplish,ridged,ripe,scattered,seed,simple,single,slightly,sparsely,spreading,star,stem,stemmed,stigma,straight,strongly,style,subshrub,surface,terete,trichome,tube,turning,unequal,uniseriate,vein,white,wide,yellow,Â¼	.0â3.5,.1,.1â1.4,.2,.4,.5â2.0,.6,0.5,0.5â0.6,0.5â1.0,0.8â0.9,0.9,1,1.0â1.2,1.0â1.5,1.0â4.0,1.5â2.0,1.5â3.0,1.7-3.0â3.4,1.8â3.5,1â2-celled,2.5â12.0,20â100,2â3-celled,2â4,3.5â4,35â45,3â5,3â5-celled,4â8,5-merous,5â6,6,6â7,abaxial,adaxial,age,along,apar,apparently,arising,articulated,ba,beyond,cell,closely,cone,delicate,difoliate,eaf,eed,end,especially,flower,free,geminat,growt,hilum,later,lengthening,like,live,lobe,lobed,lon,maximum,narrower,nflorescence,one,outline,pale,pentagonal,perfect,place,pore,poricidal,portion,positioned,reflexe,reflexed,ruit,scar,shiny,shorter,slit,small,spaced,stellate,stone,sub-lateral,tall,tem,testal,tinged,tip,toward,traingular,ud,unit,usually,whitewith,woody,ympodial,young	0.5-0.6,0.5-1.0,1-2-celled,1.0-1.2,1.0-1.5,1.0-4.0,1.1,1.1-1.4,1.2,1.5-3.0,2-3-celled,2-4,2.5-12.0,20-100,3-5-celled,3.5-4,35-45,4-8,5-6,6-7,arrangement,bark,branch,bud,characteristic,colour,exertion,form,glabrousnes,growth,height,history,inflorescence,length,life,lobing,na,new,number,shape,size,texture,triangular,type	2/3,abaxially,acuminate,acute,adaxially,anthesi,apex,appressed,attenuate,base,berry,black,branching,brownish,calyx,central,cm,concave-reniform,conical,cuneate,deltate,densely,diameter,ellipsoid,entire,exerted,glabrous,globose,green,herb,internodal,lateral,long,lower,maturity,minutely,mm,nearly,oblique,occasionally,often,orange,ovate-lanceolate,pair,papillate,per,pubescent,purple,purple-tinged,purplish,ridged,ripe,scattered,simple,single,slightly,sparsely,spreading,star,stemmed,straight,strongly,subshrub,terete,trichome,tube,turning,unequal,uniseriate,white,wide,yellow,Â¼	0.5-0.6,0.5-1.0,1-2-celled,1.0-1.2,1.0-1.5,1.0-4.0,1.1,1.1-1.4,1.2,1.5-3.0,2-3-celled,2-4,2.5-12.0,20-100,3-5-celled,3.5-4,35-45,4-8,5-6,6-7,na,triangular
287	wfo-0001029150	success	177	122	80	98	79	24	79	1	.5,0.3,0.3â0.5,0.5â1.1,0.8-1,0.8â1,0.8â1.5,0.8â3.5,1.2â1.5,1.5,1.5â2.2,1â1.5,1â11,1â5,2.5â3,2.5â5,2.5â8,2â10,3-5,3â10,3â50,6,8-shaped,9â12,acute,adaxially,anther,apex,apically,apiculate,base,berry,branched,calyx,ciliate,cm,conical,cros,cylindrical,diameter,ellipsoidal,elliptical,enlarged,entire,except,extra-axillary,filament,flower,fruit,glabrous,larger,leaf,light,lobe,margin,membranaceous,midvein,minutely,mm,nearly,oblique,opposed,ovate,pale,pedicel,peduncle,petiole,pinkish-white,pinnate,pubescent,rachi,rarely,rounded,rounded-deltoid,rugose,section,shortly,simple,slender,slightly,sparsely,stellate,stem,stigma,strong,style,surface,tan,teardrop-shaped,tip,trichome,truncate,venation,vine,white,wiry,woody,x	0.3-0.5,1.5â2,15,1â2,1â6,2â2.5,2â3,3â4,5-merous,7â8,abaxially,accrescent,across,adaxiall,alyx,apar,apicall,attenuate,axe,blade,c.,canopy,capitat,climbing,color,delicate,distant,dried,eaf,eed,flattened,fleshy,flush,fruiting,glabrou,inconspicuous,lamina,lanceolate,living,lon,long,lower,m.,material,moderately,mor,nflorescence,nternode,older,orolla,pair,perfec,plurifoliat,pointed,reaching,ruit,sand-punctate,scar,secondary,side,small,somewhat,spaced,specimen,tamen,tem,thick,thickened,time,translucent,tree,tube,understory,unit,vary,vegetation,vein,wide,ympodial	abaxial,arrangement,branching,capitate,characteristic,colour,corolla,form,glabrousnes,growth,history,inflorescence,internode,length,life,number,ovary,position,seed,shape,size,texture,thicknes,type	.5,0.3,0.3â0.5,0.5â1.1,0.8-1,0.8â1,0.8â1.5,0.8â3.5,1.2â1.5,1.5,1.5â2.2,1â1.5,1â11,1â5,2.5â3,2.5â5,2.5â8,2â10,3-5,3â10,3â50,6,8-shaped,9â12,acute,adaxially,apically,apiculate,berry,branched,ciliate,cm,conical,cylindrical,ellipsoidal,elliptical,enlarged,entire,except,extra-axillary,flower,fruit,glabrous,larger,leaf,light,margin,membranaceous,midvein,minutely,mm,nearly,oblique,opposed,ovate,pale,pinkish-white,pinnate,pubescent,rarely,rounded,rounded-deltoid,rugose,shortly,simple,slender,slightly,sparsely,stellate,strong,tan,teardrop-shaped,tip,truncate,vine,white,wiry,woody,x	capitate
288	wfo-0001029152	success	197	113	84	96	101	17	82	2	.1,0.25-0.5,0.5-1,0.75-1,0.8-1,0.9-1.3,1-1.5,1-4,1.1-1.3,1.5-1.7,2-5,3-8-flowered,acuminate,acute,anther,apex,appressed,area,attenuate,bark,base,berry,broadened,broadly,brown,bud,calyx,cm,completely,conical,corolla,cuneate,dark,deciduous,decurrent,deep,densely,dia,dry,elliptic,enclosing,exsertion,filament,fruit,fruiting,glabrous,globose,green,greyish-red,inflorescence,late,leaf,lightly,lobed,long,material,minutely,mm,nearly,obovate,ovary,ovoid-reniform,pale,papillose,pedicel,petiole,pitted,plane,plant,pore,poricidal,quite,red-floccose,reddish-floccose,shape,shaped,shiny,shrub,simple,single,size,slender,small,soon,stem,stigma,style,surface,tapering,tear-drop,tip,tree,tube,weak,white,winged	.5,1,1-2,1-3,1.5-2,2-2.5,2-3,2-4,2.5-3,3-5,4-6,6-8,61-25,8.5-16,anthesi,appearanc,appearing,ba,beginning,beneath,blade,branch,citronella,closely,corky,deflexed,deltoid,differing,difoliate,distal,eaf,edicel,eed,ellipsoi,erect,et,fide,flattened,floccose,flower,fragrance,free,geminat,giving,held,hyaline,inflorescenc,keeled,large-lenticellate,lateral,live,lobe,lon,long-styled,longer,lower,main,major,margin,middle,midrib,minor,nflorescence,often,older,one,opposite,overlapping,pair,per,planar,portion,prominent,prominently,red,reddish,reflexed,reminiscent,rounded,ruit,scar,short-styled,slightly,somewhat,spaced,straight,styl,tall,terminal,third,tillett,trichome,ud,unit,usually,vein,widest,woody,x,ympodial,young	1.5-4-6,arrangement,characteristic,colour,diameter,ellipsoid,exertion,form,growth,height,history,length,life,lobing,seed,texture,type	.1,0.25-0.5,0.5-1,0.75-1,0.8-1,0.9-1.3,1-1.5,1-4,1.1-1.3,1.5-1.7,2-5,3-8-flowered,acuminate,acute,appressed,area,attenuate,base,berry,broadened,broadly,brown,bud,calyx,cm,completely,conical,corolla,cuneate,dark,deciduous,decurrent,deep,densely,dia,dry,elliptic,enclosing,exsertion,glabrous,globose,green,greyish-red,late,lightly,lobed,long,material,minutely,mm,nearly,obovate,ovoid-reniform,pale,papillose,petiole,pitted,plane,pore,poricidal,quite,red-floccose,reddish-floccose,shaped,shiny,shrub,simple,single,slender,small,soon,stem,style,surface,tapering,tear-drop,tip,tree,tube,weak,white,winged	1.5-4-6,ellipsoid
289	wfo-0001029156	success	65	72	45	52	13	20	42	3	0.5,1.5-2,10-12,4-6,6,6-8,<,almost,apex,bark,berry,cell,center,cm,completely,deeply,diameter,exfoliating,flattened,fruiting,glabrous,golden,growth,lateral,liana,long,margin,markedly,minutely,mm,multiseriate,new,pale,pedicel,per,pitted,rectangular,reniform,rib-like,seed,shiny,sinuate,stem,surface,tan,testal,thickening,trichome,vine,wall,wide,woody	-3,1,2,apparently,eed,epiphytic,fide,minute,nee,noddin,occasionally,older,shreddy	2-3,characteristic,colour,exfoliation,form,fruit,glabrousnes,height,history,length,life,na,nodding,number,plant,shape,texture,type,variation,width	0.5,1.5-2,10-12,4-6,6,6-8,<,almost,apex,berry,center,cm,completely,deeply,diameter,exfoliating,flattened,glabrous,golden,lateral,liana,long,margin,markedly,minutely,mm,multiseriate,pale,per,pitted,rectangular,reniform,rib-like,seed,shiny,sinuate,tan,thickening,vine,wall,wide,woody	2-3,na,nodding
290	wfo-0001029156	success	65	64	36	45	20	19	34	2	-3,0.5,1.5-2,10-12,<,almost,cell,center,cm,completely,deeply,diameter,exfoliating,flattened,fruiting,glabrous,golden,growth,lateral,liana,margin,markedly,minutely,mm,multiseriate,new,pale,pedicel,per,pitted,rectangular,reniform,rib-like,seed,shiny,sinuate,stem,surface,tan,testal,thickening,trichome,vine,wall,woody	1,2,4-6,6-8,apex,apparently,ark,berry,eed,em,epiphytic,fide,lon,minute,nee,noddin,occasionally,older,shreddy,x	6,bark,characteristic,colour,exfoliation,form,fruit,glabrousnes,height,history,length,life,nodding,number,plant,shape,texture,type,variation	-3,0.5,1.5-2,10-12,<,almost,center,cm,completely,deeply,exfoliating,flattened,glabrous,golden,lateral,liana,margin,markedly,minutely,mm,multiseriate,pale,pitted,rectangular,reniform,rib-like,seed,shiny,sinuate,tan,thickening,vine,wall,woody	6,nodding
291	wfo-0001029163	success	148	116	73	88	60	28	72	1	0.3-2.5,0.5-1,1,1.5-2,10-20-30,2,2-18,2-3,2-6,2.5-3,3-14,3-4,3-5,4-6,5-8,7-9,9-15,abaxial,acuminate,acute,apart,apex,band,base,calyx,chartaceous,cm,connivent,cuneate,cylindrical,decurrent,deltate,densely,diameter,distally,elliptic,elliptic-ovate,entire,free,fruit,glabrous,globose,herb,lanceolate,lenticular,lobe,long,margin,mm,moderately,narrowed,narrowly,nearly,obtuse,papillose,pedicel,peduncle,perennial,petiole,pseudohair,puberulent,puberulent-pubescent,pubescence,purple,rachi,radiu,remnant,roughened,scale-like,shrub,simple,sparsely,stellate,stem,stigma,style,subcoriaceous,surface,thickened,tip,triangular,tube,unbranched,unknown,white,whitish,x,yellow	-4,-9,1-2,1.5-2.5,1.5-3,13-18,2-7,20-30,4-20,4-5-foliat,4.5-23,5-12-25,abaxially,absen,adaxiall,adaxially,aggregate,articulated,axe,blade,cell,color,denser,directed,distall,eaf,eed,eglandular,flower,glandular,hair,leaving,like,lon,lower,nflorescence,nther,orolla,pedicellar,pore,projection,puberulent-pubescen,ripe,ruit,slightly,small,sometimes,spaced,stalked,stone,subapical,tal,tem,time,truncat,unit,vary,vein,wide,ympodial	adaxial,anther,arrangement,branch,characteristic,colour,corolla,form,glabrousnes,growth,height,history,inflorescence,leaf,length,life,new,ovary,plant,seed,shape,size,spacing,texture,thicknes,truncate,type,width	0.3-2.5,0.5-1,1,1.5-2,10-20-30,2,2-18,2-3,2-6,2.5-3,3-14,3-4,3-5,4-6,5-8,7-9,9-15,acuminate,acute,apart,apex,band,base,chartaceous,cm,connivent,cuneate,cylindrical,decurrent,deltate,densely,distally,elliptic,elliptic-ovate,entire,free,fruit,glabrous,globose,herb,lanceolate,lenticular,long,mm,moderately,narrowed,narrowly,nearly,obtuse,papillose,perennial,pseudohair,puberulent,puberulent-pubescent,pubescence,purple,roughened,scale-like,shrub,simple,sparsely,stellate,subcoriaceous,thickened,tip,triangular,unbranched,unknown,white,whitish,x,yellow	truncate
292	wfo-0001029171	success	137	117	82	91	46	26	79	3	-,-10,-10-15,0.5,1-3,1-4.5,1-5,1.5-2,10-25,10-35,2-3,3-4,3.5-6.5,4-5,5-6,5-8,7-9,8-17,abruptly,acuminate,acute,also,angled,apart,apex,articulated,base,branched,calyx,chartaceous,cm,connivent,cuneate,decurrent,deltate,dendritically,densely,diameter,eglandular,elliptic,entire,flower,forked,fruit,glabrous,gland,glandular,globose,hair,lanceolate,like,lobe,margin,mm,moderately,narrowed,narrowly,obtuse,often,orange,ovate-elliptic,pedicel,peduncle,perfect,petiole,puberulent,pubescent,purple,rachi,rarely,red,ripe,rugose,shoot,short-stalked,shrub,simple,slightly,smooth,sometimes,stellate,stigma,style,tip,triangular,tube,unbranched,usually,white,x,yellow	1.5-7.5,11-20,3.5-18,4-10-15,6-,abaxially,absen,adaxially,aggregate,and/or,axe,ba,blade,cell,cylindrical,dense,directed,distall,eaf,eed,except,glandula,long,lower,many-foliat,midrib,near,nearly,nflorescence,nther,orolla,pore,radiu,ruit,spaced,sparsely,ste,stone,tal,tem,time,truncat,unit,vary,wide,ympodial	abaxial,adaxial,anther,arrangement,articulation,characteristic,colour,corolla,form,growth,height,history,inflorescence,leaf,length,life,ovary,perennial,plant,seed,shape,spacing,stem,surface,texture,truncate	-,-10,-10-15,0.5,1-3,1-4.5,1-5,1.5-2,10-25,10-35,2-3,3-4,3.5-6.5,4-5,5-6,5-8,7-9,8-17,abruptly,acuminate,acute,also,angled,apart,apex,articulated,base,branched,chartaceous,cm,connivent,cuneate,decurrent,deltate,dendritically,densely,eglandular,elliptic,entire,flower,forked,glabrous,gland,glandular,globose,hair,lanceolate,like,mm,moderately,narrowed,narrowly,obtuse,often,orange,ovate-elliptic,perfect,puberulent,pubescent,purple,rarely,red,ripe,rugose,shoot,short-stalked,shrub,simple,slightly,smooth,sometimes,stellate,tip,triangular,unbranched,usually,white,x,yellow	perennial,stem,truncate
293	wfo-0001029215	success	49	44	22	26	23	18	20	2	0.3-0.5,0.5-0.7,0.5-2.5,1,2.3-2.9,appearance,brown,calyx,cm,coarse,diameter,elongating,fruit,hair-like,herb,lobe,markedly,mm,obovate,outgrowth,pubescent,shrub,silky,smelling,strong,surface	-1.8-2.3,.2,border,cell,eed,entire,fide,give,lateral,long,narrowly,round,small,spreadin,tall,testa,thick,wall,weigend,wide,winged,woody,xyledecor	0.2,1.8-2.3,characteristic,colour,form,giving,growth,height,history,length,life,plant,seed,shape,stem,texture,thicknes,width	0.3-0.5,0.5-0.7,0.5-2.5,1,2.3-2.9,brown,cm,coarse,elongating,hair-like,herb,markedly,mm,obovate,outgrowth,pubescent,shrub,silky,smelling,strong	0.2,1.8-2.3
294	wfo-0001029216	success	240	101	62	87	153	14	62	0	+,.8-1,0.2-0.25,0.5-0.8,0.6-0.8,1-1.2,1-2,1-3,1-4,1.2-6,1.5-2.3,1.5-2.5-10,10,10-14,10-20-35,2-4.5,2.5-3.3,3,3-5,3-7,3-7-10,4,absent,acute,annual,apex,attenuate,base,basiscopically,biennial,bright,brown,calyx,capitate,cm,column,conical,corolla,cultivar,decurrent,deep,diameter,elliptic,fruit,fruiting,globose,green,hair-like,herb,imparipinnate,inflorescence,interrupted,lateral,leaflet,length,less,lobe,long,mm,oblique,obovate,orange,outgrowth,ovate,pale,pedicel,peduncle,pentagonal,perennial,petiole,plant,primary,pseudostipule,pubescent,red,shape,sparsely,staminal,stem,stigma,straight,surface,terminal,usually,villous,wide,yellow	-5,.5,0.1-0.3,0.1-0.5,0.1-0.6,0.1-0.8,0.2-0.3,0.2-0.3-0.5,0.2-0.4,0.2-0.8,0.3-0.4,0.3-0.5,0.3-2,0.4,0.4-0.5,0.5,0.5-1.5,0.5-2,0.6-1,0.8-2.5,1-6,1.5-3,1/,2,2-locular,3-4,3-foliate,5,5-15-flower,6-10,<,absen,accrescent,acroscopically,adpressed,allogamous,always,and/or,angeld,anther,anthesi,apical,appearance,appendage,articulated,articulation,axi,basal,becoming,branch,cell,cente,composed,cone,cordate,crenate,deeply,dentate,distal,eaf,edicel,eed,entire,erect,exserted,extending,facultatively,fasciated,filament,fruited,giving,glabrescent,gland-tipped,glandular,gree,half,halfway,included,initially,interjected,internode,lanceolate,large,larger,later,like,linear,lobulate,lon,longer,lower,mainly,margin,maturity,minute,minutely,mixture,multicellular,multilocular,narrowly,near,nflorescence,numerous,often,one,ovary,pair,particularly,petiolule,population,present,procumbent,rarely,reflexe,ruit,scen,secondary,sessile,shaggy,shaped,short,silky,simple,sometimes,somewhat,sparse,spreading,sterile,strong,strongly,style,tangled,tem,tertiary,testa,thick,thickening,tip,total,toward,trichome,truncate,tube,ud,unicellular,uniseriate,unit,variety,varying,viny,wall,winged,ympodial	arrangement,bud,colour,form,growth,height,history,leaf,life,seed,size,texture,thicknes,width	+,.8-1,0.2-0.25,0.5-0.8,0.6-0.8,1-1.2,1-2,1-3,1-4,1.2-6,1.5-2.3,1.5-2.5-10,10,10-14,10-20-35,2-4.5,2.5-3.3,3,3-5,3-7,3-7-10,4,absent,acute,annual,attenuate,basiscopically,biennial,bright,brown,capitate,cm,conical,cultivar,decurrent,deep,elliptic,globose,green,hair-like,herb,imparipinnate,interrupted,less,long,mm,oblique,obovate,orange,outgrowth,ovate,pale,pentagonal,perennial,pubescent,red,sparsely,straight,usually,villous,wide,yellow	
295	wfo-0001029226	success	206	108	74	89	117	19	74	0	.5,1-1.5,1-3,10-40+,2-6,2.5-10,4,5-7,7-11,8-13,acuminate,acute,anther,anthesi,apex,base,berry,branched,bright,calyx,capitate,cm,cordate,corolla,densely,diameter,ellipsoid,exserted,filament,flattened,flexuous,flower,fruiting,glabrous,glandular,globose,growth,herbaceous,lateral,lavender,leaf,like,lobed,long,lyrate,many,minute,minutely,mm,new,open,pale,pedicel,peduncle,petiole,pinnatifid,pitted,pubescent,red,reniform,seed,short-glandular,shrub,simple,slender,sparsely,spreading,stem,stigma,strongly,style,surface,tan,terminal,time,translucent,trichome,tube,uniformly,uniseriate,vine,way,weak,white,wide,winged,woody,yellowish,Â¾	-7,-9,.75,0-1,0.5,0.5-5,1-2,1-celled,2,2-3,2-9,3-3.5,3-6,30,4-6,5-merou,>,ag,alyx,apart,apparently,ark,articulated,ba,basal,black,blue,breaking,cell,completely,congested,conical,connivent,dark,decurrent,deltate,distall,divided,dry,eaf,eed,elongate,enation,entire,free,glabrescent,gland,green,hairy,ilament,irregularly,juice,lengthening,lobe,longer,loosely,lower,margin,material,mature,membranous,mere,nflorescence,occasionally,often,older,one,orolla,overtopping,pair,papillat,papillate,papillo,per,perfect,pinnate,plurifoliat,pore,poricidal,portion,primary,reflexed,remainin,rim,ripe,ruit,sagittate,scar,scarlet,shiny,shorter,sleeve,slit,small,sometimes,spaced,spot,sprawling,spreadin,staining,stellate,tangled,tem,testal,thin,third,tip,truncate,twinin,ud,unit,usually,vary,vein,wall,widest,ympodial	arrangement,bark,bud,characteristic,colour,exertion,form,fruit,glabrousnes,history,inflorescence,length,life,lobing,ovary,shape,size,texture,type	.5,1-1.5,1-3,10-40+,2-6,2.5-10,4,5-7,7-11,8-13,acuminate,acute,anthesi,base,berry,branched,bright,calyx,capitate,cm,cordate,densely,diameter,ellipsoid,exserted,flattened,flexuous,flower,glabrous,glandular,globose,herbaceous,lateral,lavender,like,lobed,long,lyrate,many,minute,minutely,mm,open,pale,pinnatifid,pitted,pubescent,red,reniform,short-glandular,shrub,simple,slender,sparsely,spreading,stem,strongly,tan,terminal,time,translucent,trichome,tube,uniformly,uniseriate,vine,way,weak,white,wide,winged,woody,yellowish,Â¾	
296	wfo-0001029236	success	159	106	73	84	75	22	71	2	0.2-0.7,0.2-1,0.45-0.5,0.5-1.5,0.9-2.3,1-1.5,1-2,1.4-1.7,1/2,3,6-9,absent,anther,anthesi,apex,apically,appearing,base,berry,calyx,cm,coriaceous,corolla,deflexed,dendritic,densely,diameter,elliptic,except,exserted,filament,flattened,fleshy,fruit,fruiting,glabrous,globose,growth,later,lateral,leaf,lenticular,lobed,long,margin,mm,narrowly,near,nodding,obscure,obscurely,occasionally,ovary,overtopping,pale,pedicel,per,petiole,pointed,poricidal,pubescent,purplish-black,reddish-brown,revolute,scattered,secondary,shiny,shoot,shrub,slightly,stem,stigma,strongly,style,surface,terminal,tip,trichome,tube,venation,violet,way,wide,x	.5,0.5,2-4,2-5,abaxially,adaxial,age,apical,apparently,axi,ba,bark,basal,becoming,bi-lobe,branch,branching,branchlet,broadly,compact,completely,conical,cupulate,decurrent,deltate,dichasial,eaf,edicel,eed,erect,ew,flower,free,grey-brown,inserted,less,lobe,lower,m.,many,middle,midvein,minutely,nflorescence,older,packe,pericarp,persistent,pitted,plurifoliate,pore,portion,prominent,purplish,ruit,scar,short,simple,sleeve,slit-like,sparsely,stamen,tall,tapering,thin,time,trongly,tub,ud,unit,usually,winged,woody,ympodial,young	bi-lobed,bud,characteristic,colour,exertion,form,glabrousnes,height,history,inflorescence,length,life,lobing,new,number,perennial,plant,seed,shape,size,texture,type	0.2-0.7,0.2-1,0.45-0.5,0.5-1.5,0.9-2.3,1-1.5,1-2,1.4-1.7,1/2,3,6-9,absent,anthesi,apex,apically,appearing,base,berry,calyx,cm,coriaceous,deflexed,dendritic,densely,diameter,elliptic,except,exserted,flattened,fleshy,fruit,glabrous,globose,growth,later,lateral,leaf,lenticular,lobed,long,margin,mm,narrowly,near,nodding,obscure,obscurely,occasionally,overtopping,pale,per,pointed,poricidal,pubescent,purplish-black,reddish-brown,revolute,scattered,shiny,shoot,shrub,slightly,strongly,terminal,tip,trichome,tube,violet,way,wide,x	bi-lobed,perennial
297	wfo-0001029246	success	207	171	131	147	60	24	129	2	/5,0-1,0-15,0-5,0.1-0.4-1.5,0.15-0.3,0.2-1.5,0.3-0.5,0.3-0.8,0.5,0.7-1.3,0.7-1.5,0.7-2,0.8-1.1,0.9-1.3,1-1.5,1-1.8,1-10,1-3,1-5,1.2-2,1.5-2.3,1.5-2.5,1.5-6,1.8-3,1/3,2,2.5-3.2,2.8-4,2/3,3-5,3.5-5,4-6,5-20,5-6-8,6-10,6-8,7-12,8-16,abaxial,abaxially,acuminate,acute,adaxial,anther,apart,apex,apically,apparently,articulated,bark,base,berry,broad-deltate,calyx,chartaceous,cm,concolorous,connivent,cuneate,deltate,densely,diameter,discolorous,distance,drying,dull,elliptic,entire,erect,extending,filament,flattened,flattened-reniform,flower,fruit,fruiting,glabrescent,glabrous,lateral,leaf,length,less,lobe,lobed,long,lower,margin,maturity,mauve,midpoint,midvein,mm,moderately,narrow-deltate,narrow-ovate,oblong,obtuse,one,open,orange-brown,orange-red,pale,pedicel,peduncle,per,petiole,poricidal,porrect,prickle,prickly,procumbent,pubescent,purple,ray,recurved,rounded,sessile,shrub,side,simple,sometimes,spaced,sparsely,spherical,spreading,stellate,stellate-pubescent,stem,straight,style,surface,tapering,terete,time,tip,trichome,tube,unarmed,unbranched,upper,way,white,wide,yellow,yellow-orange,Â¼	-4,0.1-0.3,0.5-1.5,0.8-3,1-4,1-8,1.7-6,1/10-1/5,2-3,2-3.5,2-5,2/3-3/,3-20,5-merous,acuminat,almost,alyx,apar,blade,c.,curved,eaf,eed,elongating,equal,eye,free,infructescence,lon,longer,mature,naked,nflorescence,older,orange-brow,orolla,oung,pair,pendulous,perfec,pericarp,plurifoliat,portion,prickl,primary,ruit,scar,smooth,stout,strongly,tamen,tertiary,unit,usually,vary,vein,venation,visible,woody,ympodial	2/3-3/4,arrangement,branch,bud,characteristic,colour,corolla,exertion,form,glabrousnes,growth,height,inflorescence,lobing,na,new,ovary,plant,seed,shape,size,stigma,texture,type	/5,0-1,0-15,0-5,0.1-0.4-1.5,0.15-0.3,0.2-1.5,0.3-0.5,0.3-0.8,0.5,0.7-1.3,0.7-1.5,0.7-2,0.8-1.1,0.9-1.3,1-1.5,1-1.8,1-10,1-3,1-5,1.2-2,1.5-2.3,1.5-2.5,1.5-6,1.8-3,1/3,2,2.5-3.2,2.8-4,2/3,3-5,3.5-5,4-6,5-20,5-6-8,6-10,6-8,7-12,8-16,abaxially,acuminate,acute,apart,apically,apparently,articulated,base,berry,broad-deltate,chartaceous,cm,concolorous,connivent,cuneate,deltate,densely,diameter,discolorous,distance,drying,dull,elliptic,entire,erect,extending,flattened,flattened-reniform,flower,glabrescent,glabrous,lateral,less,lobe,lobed,long,lower,maturity,mauve,midpoint,midvein,mm,moderately,narrow-deltate,narrow-ovate,oblong,obtuse,one,open,orange-brown,orange-red,pale,per,poricidal,porrect,prickle,prickly,procumbent,pubescent,purple,ray,recurved,rounded,sessile,shrub,side,simple,sometimes,spaced,sparsely,spherical,spreading,stellate,stellate-pubescent,straight,surface,tapering,terete,time,tip,trichome,unarmed,unbranched,upper,way,white,wide,yellow,yellow-orange,Â¼	2/3-3/4,na
298	wfo-0001029286	success	224	118	80	101	123	17	78	2	0-0.5,0.4-1.2,0.8,0Â°,1-2,1.5-2,1.5-4,2-3,2.5-3,4-5,4-6,4.5-7,5-6,6-9,7-10,abaxial,abaxially,acute,adaxially,almost,anther,apart,apex,apiculate,articulation,attenuate,bark,base,branch,branching,broadly,brown,capitate,chartaceous,clustered,cm,corolla,crenulate,dendritic,diameter,domatia,entire,except,faint,filament,flat,flexuous,formed,glabrous,green,grey,junction,leaf,length,liana,light,lilac,lobed,long,main,margin,mauve,membranous,midvein,minutely,mm,obconical,oblong,obovate,occasional,pair,pedicel,peduncle,petiole,primary,prominent,rachi,raised,scar,shallowly,side,simple,sometimes,sparsely,spreading,stem,stigma,stump,style,surface,terete,tertiary,time,tip,trichome,tube,unarmed,vein,venation,widely,x	.4,.5,0.1,0.15-0.4,0.6-1.2,1-1.5,1.5-8,1/8,15-50,3-4,4.5,5,6-8,abscising,age,along,altered,alyx,another,anthesi,apar,apically,apice,apparently,arising,around,articulated,axil,becoming,branched,canaliculate,clearly,closer,concave,concolorous,conical,curved,cuspidate,delineated,deltoid,density,dilated,distributed,drying,eaf,eed,equal,extending,fertilization,flower,forming,free,fresh,glabrescent,globo,hair,increasing,inflorescenc,inside,isolated,know,known,lamina,lengthening,less,lobe,lower,m.,margi,mas,meeting,middle,much,multicellular,narrowly,nflorescence,nther,often,one,orolla,outside,ovate,papillo,perfec,plurifoliat,pore,poricidal,portion,protruding,rarely,regular,rounded,ruit,separated,slender,smaller,smooth,somewhat,soon,specimen,stretchy,tangled,tearing,terminal,textur,thick,thickened,thinner,tissue,together,toward,translucent,translucent-violet,tuft,ud,uneven,unit,vary,visible,wide,yellowish,ympodial,young	arrangement,bud,calyx,characteristic,colour,form,glabrousnes,globose,growth,history,inflorescence,life,lobing,papillose,prominence,shape,texture	0-0.5,0.4-1.2,0.8,0Â°,1-2,1.5-2,1.5-4,2-3,2.5-3,4-5,4-6,4.5-7,5-6,6-9,7-10,abaxial,abaxially,acute,adaxially,almost,apart,apiculate,articulation,attenuate,base,branch,broadly,brown,capitate,chartaceous,clustered,cm,crenulate,dendritic,entire,except,faint,flat,flexuous,formed,glabrous,green,grey,junction,leaf,liana,light,lilac,lobed,long,mauve,membranous,midvein,minutely,mm,obconical,oblong,obovate,occasional,pair,primary,prominent,raised,shallowly,side,simple,sometimes,sparsely,spreading,stump,terete,time,tip,trichome,unarmed,vein,widely,x	globose,papillose
299	wfo-0001029310	success	214	120	90	101	113	19	88	2	.5,.6,/4,0-20,0-5,0.2-0.8,0.6-1.1,1-1.5,1-2,1.2-1.5,1.8-3,10-13-16,15-20-25,2-3.5,2-4,20-40,3-4,3.5,4-10,5-10,5-12,5-20,5-6,5-merous,7-12,8,acute,andromonoecious,anther,apex,apparently,articulated,bark,base,berry,blade,branched,brown,calyx,cm,concolorous,conical,dark,diameter,drying,dull,elliptic,equal,erect,filament,flattened-reniform,flower,free,fruit,fruiting,glabrescent,glabrous,gray,hair,herb,heterostylous,lateral,leaf,length,lobed,long,long-styled,margin,maturity,mauve,membranous,mm,moderately,orange-green,ornately,pedicel,peduncle,pendent,perpendicular,petiole,pinnatifid,plant,portion,prickle,retrorse,short-styled,shrub,simple,sometimes,spherical,stellate,stellate-pubescent,stem,straight,style,surface,toward,tube,way,wide,yellow	.1,/6,0.1-0.2,0.2-0.3,0.5,0.5-3,00,1,1-4,1/,10,10-15,10-20,2.5-6,2/3-3/4,20-60,200-500,3-5,4-8,45-60,5,5-30,5-7,5-8,6-8,7-13,abaxially,accrescent,alyx,ame,apar,apart,apically,beyond,c.,connivent,cordate,deltate,difoliate,distal,distance,eaf,eed,elongating,enclosing,extending,filifor,geminat,gently,hermaphrodite,inflated,infructescence,lobe,lobing,lon,longer,lower,lowermost,mature,midpoint,midvein,minute,narrow-deltate,nflorescence,older,one,open,orolla,oung,pair,pendulous,per,pericarp,poricidal,porrect,prickl,prickly,primary,ray,recurved,red-brow,ruit,scar,secondary,sessile,shorter,side,smooth,spaced,sparsely,spreading,stalk,stalked,staminat,stout,strongly,tamen,tapering,terete,tertiary,time,tip,tissue,trichome,truncate,unit,variously,vary,vein,venation,visible,woody,ympodial	arrangement,characteristic,colour,corolla,form,growth,history,inflorescence,life,ovary,perennial,red-brown,seed,shape,size,staman,texture,type,width	.5,.6,/4,0-20,0-5,0.2-0.8,0.6-1.1,1-1.5,1-2,1.2-1.5,1.8-3,10-13-16,15-20-25,2-3.5,2-4,20-40,3-4,3.5,4-10,5-10,5-12,5-20,5-6,5-merous,7-12,8,acute,andromonoecious,apex,apparently,articulated,base,berry,branched,brown,cm,concolorous,conical,dark,diameter,drying,dull,elliptic,equal,erect,filament,flattened-reniform,flower,free,glabrescent,glabrous,gray,hair,herb,heterostylous,lateral,lobed,long,long-styled,maturity,mauve,membranous,mm,moderately,orange-green,ornately,pendent,perpendicular,pinnatifid,plant,portion,prickle,retrorse,short-styled,shrub,simple,sometimes,spherical,stellate,stellate-pubescent,stem,straight,surface,toward,tube,way,wide,yellow	perennial,red-brown
300	wfo-0001029317	success	151	104	64	73	78	31	58	6	.5,0.5,0.8-1,1-1.5,1.5-3.5,10-16,11-14,2-3,2.5-5,6.5-11,7-8,8-9,acuminate,anther,apex,area,attenuate,barely,base,bud,ca,calyx,channeled,cm,corolla,dry,erect,exserted,filament,fruiting,glabrate,glabrous,globose,grayish,immature,inflorescence,lateral,leaf,lobed,long,main,minor,minutely,mm,narrowly,nearly,ovary,ovate,pair,papillose,pedicel,petiole,poricidal,probably,pubescent,shrub,simple,size,soon,specimen,stem,stigma,style,tapering,tip,trichome,tube,uniseriate,vein,visible,white,x,yellowish	0.25,0.5-0.75,0.5-1,1,10-30-flowered,6-8,along,anthesi,apar,beneath,broadly,brow,closely,cup-like,deciduou,deflexed,deltoid,densely,denser,dia,differing,difoliate,eaf,edicel,eed,ellipsoi,epidermi,extreme,free,frui,geminate,known,like,lobe,lon,lower,major,margin,middle,nflorescence,occasionally,often,older,one,opposite,otherwise,overlapping,ovoid,paler,pore,portion,prominent,proximal,rachi,raised,reflexed,remaining,rest,rounded,ruit,scar,shaped,slender,slightly,soft,spaced,sparsely,straight,styl,tall,tear-drop,thickened,tuft,ud,unit,widest,ympodial,young	.25,10-30,arrangement,brown,characteristic,colour,diameter,drying,exertion,flower,form,fruit,glabrousnes,growth,height,history,length,life,lobing,na,new,number,per,perennial,plant,primary,seed,shape,surface,texture,type	.5,0.5,0.8-1,1-1.5,1.5-3.5,10-16,11-14,2-3,2.5-5,6.5-11,7-8,8-9,acuminate,area,attenuate,barely,base,ca,calyx,channeled,cm,dry,erect,exserted,glabrate,glabrous,globose,grayish,immature,lateral,lobed,long,main,minutely,mm,narrowly,nearly,ovate,pair,papillose,poricidal,probably,pubescent,shrub,simple,soon,specimen,style,tapering,tip,trichome,tube,uniseriate,vein,visible,white,x,yellowish	.25,10-30,brown,fruit,na,perennial
301	wfo-0001029332	success	196	116	76	93	103	23	73	3	.5,0-2,0-20,0-4,0.5-1,0.8-1,1-2,1-4,1.3-1.5,1.5-2,1/2,2,2-2.5,2.5-3.5,2.8-3.7,2/3-3/4,3-4,3-6,4-10,5-6,5-8,6-8,abaxially,anther,apex,apparently,articulated,bark,base,berry,calyx,chartaceous,cm,connivent,cordate,curved,densely,diameter,erect,filament,flattened-reniform,flower,fruit,fruiting,glabrous,lateral,leaf,length,lobed,long,long-styled,lower,margin,maturity,mauve,mm,moderately,narrow-deltate,orange-brown,ovate,pair,pedicel,peduncle,petiole,plant,poricidal,prickle,prickly,primary,rounded,shrub,simple,slender,spherical,spreading,stellate-pubescent,stem,style,surface,tapering,terete,terminal,tip,tube,unbranched,upper,vein,way,weakly,wide,yellow,yellow-green,yellow-orange	/3,0,0-0.5,0-100,0-5,0.1,0.1-0.2,0.15-0.2,0.15-0.25,1-1.5,1-3,1/3,1/4,1/4-1/3,10-30,2-4,2/,3.5-5,4-15,5-merous,8.5-9.5,abaxial,adaxial,alyx,andromonoecious,apar,apart,apically,becoming,blade,broad-deltate,concolorous,conical,difoliate,distal,distance,drying,eaf,eed,elongating,equal,extending,flattened,free,geminat,glabrescent,gland,globular,grayi,herbaceous,hermaphrodite,heterostylous,infructescence,less,lobe,long-acuminat,longer,lowermost,mature,midpoint,midvein,nflorescence,often,older,one,open,orolla,oung,pale,pendulous,per,pericarp,porrect,portion,prickl,pubescent,ray,reduced,ruit,scandent,scar,sessile,short-styled,shorter,side,smooth,spaced,stalk,stalked,staminat,stellate,subsessile,tamen,tertiary,time,trichome,unit,variously,vary,venation,visible,woody,ympodial	2/3,arrangement,branch,characteristic,colour,corolla,exertion,form,glabrousnes,grayish,growth,height,inflorescence,lobing,na,new,ovary,seed,shape,size,stigma,texture,type	.5,0-2,0-20,0-4,0.5-1,0.8-1,1-2,1-4,1.3-1.5,1.5-2,1/2,2,2-2.5,2.5-3.5,2.8-3.7,2/3-3/4,3-4,3-6,4-10,5-6,5-8,6-8,abaxially,apparently,articulated,base,berry,chartaceous,cm,connivent,cordate,curved,densely,diameter,erect,flattened-reniform,flower,glabrous,lateral,lobed,long,long-styled,lower,maturity,mauve,mm,moderately,narrow-deltate,orange-brown,ovate,pair,poricidal,prickle,prickly,rounded,shrub,simple,slender,spherical,spreading,stellate-pubescent,tapering,terete,terminal,tip,unbranched,upper,way,weakly,wide,yellow,yellow-green,yellow-orange	2/3,grayish,na
302	wfo-0001029333	success	155	102	70	80	75	22	64	6	.5,0.5,0.7-1,1-1.2,1-1.5,1-15,1-2,1-3,1-7,1.5-2.5,10-15-flowered,17-26,3-7,3-7.5,8-15,abaxial,acuminate,acute,anther,apex,auriculate,base,berry,calyx,clavate,cm,corolla,dendritic,densely,dia,difoliate,elliptic-obovate,exserted,flattened-reniform,fruiting,geminate,glabrous,globose,green,heteromorphic,incrassate,leaf,long,margin,minor,minutely,mm,obovate,occasionally,orbicular,ovary,pale,paler,pedicel,petiole,pitted,pubescent,reddish-brown,rounded,sessile,shape,shaped,shining,shrub,simple,size,somewhat,stem,stigma,strongly,style,surface,tear-drop,time,trichome,truncate,tube,type,unit,wide	.25,/4,0.5-1,1.5-2,1.5-3,100,2-2.5,5-6,9-13,abaxially,adaxially,along,anisophyllou,anthesi,ba,bark,beige,beneath,broadly,conical,contracted,deflexed,dendritic-pubescent,denser,differing,dry,eaf,edicel,eed,erect,filament,flower,free,fresh,golden,inflorescenc,lateral,like,lobe,lobed,lon,long-styled,lower,main,major,nflorescence,older,opposite,overlappin,pair,papillo,planar,pore,poricidal,portion,present,pubescence,rest,ruit,scar,short-styled,slender,small,spaced,sparsely,tall,tip,tree,triangular,ud,vein,way,woody,ympodial,young	1,adaxial,anisophyllous,arrangement,bud,characteristic,colour,diameter,exertion,form,fruit,growth,height,history,inflorescence,length,life,perennial,plant,seed,sympodial,texture	.5,0.5,0.7-1,1-1.2,1-1.5,1-15,1-2,1-3,1-7,1.5-2.5,10-15-flowered,17-26,3-7,3-7.5,8-15,acuminate,acute,apex,auriculate,base,berry,calyx,clavate,cm,dendritic,densely,dia,difoliate,elliptic-obovate,exserted,flattened-reniform,geminate,glabrous,globose,green,heteromorphic,incrassate,long,margin,minutely,mm,obovate,occasionally,orbicular,pale,paler,pitted,pubescent,reddish-brown,rounded,sessile,shaped,shining,shrub,simple,somewhat,strongly,tear-drop,time,trichome,truncate,tube,unit,wide	.7-1,1,anisophyllous,di,perennial,sympodial
303	wfo-0001029334	success	211	99	62	79	132	20	61	1	0-4,0.15-0.3,1,1-2,1-3,1.3-4.5,1.5-3.9,1.5-6,1.8-2.9,2-2.5,2-4,2.5-3,3.2-5.8,3.3-6.5,4-5.5,4-8.5,5-10,7.5-15.5,8-30,9-12,abaxially,absent,adaxially,almost,anther,brownish,chartaceous,clavate,cm,condition,corolla,densely,diameter,drying,flower,fresh,fruit,glabrous,globose,green,green-white,greenish,herb,interjected,lanceolate,lateral,leaflet,long,membranous,minutely,mm,mucilaginous,odd-pinnate,orbicular,ovate,ovoid,pedicel,peduncle,petiole,plant,puberulent,pubescent,pure,ripe,seed,size,stellate,stem,stigma,style,terminal,throughout,tinged,violet,wet,white,whitish,wide,x	.2,1-10,1-6,2,2-5,2-8,3-5,3-7,5-merou,acumen,acute,ag,along,alyx,among,apart,apex,apparently,articulated,attenuate,axe,axillary,base,berry,blade,borne,broadly,bud,capitat,cell,ciliate,connivent,cordate,covering,cuneate,decreasing,decurrent,digestion,distal,dorsally,eaf,edge,eed,elliptic,end,enzyme,erect,especially,exceeding,except,filament,flat,folded,forked,geminat,generally,glabrou,gradually,grassland,greatly,hair,hair-like,half,homostylous,honeycomb-shaped,lengthening,like,living,lobe,low-growin,lower,make,margin,middl,midrib,narrowly,nflorescence,oblique,obtuse,often,orolla,pair,perfect,petiolulate,petiolule,plurifoliate,pore,poricidal,proximal,rarely,reduced,removed,rounded,ruit,semi-rosette,sessile,seudostipule,shady,short,singly,situation,slightly,slit,spaced,specimen,stamen,ste,stolo,straight,subequal,subsessile,subtending,sunny,tall,tamen,tem,testal,thick,tip,toward,tri-,tube,tuber,typically,unit,unwinged,usually,vary,wall,woodland,yellow,ympodial	abaxial,adaxial,arrangement,capitate,colour,form,growth,height,history,inflorescence,leaf,length,life,ovary,pseudostipule,shape,staman,surface,texture,variation	0-4,0.15-0.3,1,1-2,1-3,1.3-4.5,1.5-3.9,1.5-6,1.8-2.9,2-2.5,2-4,2.5-3,3.2-5.8,3.3-6.5,4-5.5,4-8.5,5-10,7.5-15.5,8-30,9-12,abaxially,absent,adaxially,almost,brownish,chartaceous,clavate,cm,condition,densely,drying,fresh,glabrous,globose,green,green-white,greenish,herb,lanceolate,long,membranous,minutely,mm,mucilaginous,odd-pinnate,orbicular,ovate,ovoid,puberulent,pubescent,pure,ripe,stellate,throughout,tinged,violet,wet,white,whitish,wide,x	capitate
304	wfo-0001029344	success	147	101	63	73	74	28	61	2	.5,0.4-1,0.5-1,1,1-5,1.5,1.5-4,10-20,10-35,2-4,3-10,4-6,5-12,5-15,absent,acute,anther,apex,base,berry,brown,calyx,center,chartaceous,ciliate,cm,densely,diameter,dm,drying,edge,elliptic,elliptic-ovoid,entire,filament,fine,flower,fruit,glabrous,globose,herb,immature,linear-lanceolate,margin,maturing,membranaceous,mm,moderately,nearly,oblong,obtuse,parallel,pedicel,peduncle,per,petiole,pubescent,radiating,raised,rhizomatous,ridge,rotate,rounded,running,semitransparent,shallow,sparsely,stigma,style,surface,white,x,yellow	0.5-1.5,0.5-3,1-2,1-3,1-6,1.5-3,2-3,2-3-celled,2-7,abaxially,abundant,adaxiall,adaxially,along,axe,beyond,blade,connected,cordate,decurrent,dehiscing,denser,difoliate,eaf,eed,emarginat,equal,explosively,exserted,flat,frui,geminat,hair,held,interpetalar,lacking,lobe,long,lower,lying,maturit,mesocarp,nflorescence,notch,obvious,often,one-,orolla,placenta,pressure,pubescen,rachi,ruit,short,slightly,sometimes,stamen,straight,swollen,tal,tamen,tem,tissue,triangular,tube,two-celled,unbranched,unit,vary,vein,watery,wid,woody,ympodial	abaxial,adaxial,arrangement,characteristic,colour,corolla,form,geminate,glabrousnes,growth,height,history,inflorescence,leaf,length,life,new,number,ovary,plant,seed,shape,size,staman,stem,texture,type,wide	.5,0.4-1,0.5-1,1,1-5,1.5,1.5-4,10-20,10-35,2-4,3-10,4-6,5-12,5-15,absent,acute,berry,brown,center,chartaceous,ciliate,cm,densely,diameter,dm,drying,edge,elliptic,elliptic-ovoid,entire,fine,flower,fruit,glabrous,globose,herb,immature,linear-lanceolate,margin,maturing,membranaceous,mm,moderately,nearly,oblong,obtuse,parallel,pubescent,radiating,raised,rhizomatous,ridge,rotate,rounded,running,semitransparent,shallow,sparsely,white,x,yellow	geminate,wide
305	wfo-0001029363	success	152	101	63	76	76	25	61	2	.75,/4,0.2-1.1,1-1.2,1.5-1.7,1.5-3.5,2-6,3-7,4-11,5-7-flowered,6-7,6-8,7-10,acuminate,acute,anther,apex,bark,base,becoming,beneath,berry,bi-lobed,bud,calyx,capitate,cm,corolla,cup-shaped,deep,deflexed,densely,dia,elliptic,exsertion,fruit,fruiting,glabrous,globose,green,greyish,immature,lateral,leaf,lobed,long,main,maroon,minutely,mm,narrowly,obtuse,ovary,pair,pale,pedicel,petiole,poricidal,pubescent,shiny,shrub,simple,small,sparsely,stem,stigma,style,surface,tapering,tip,tree,vein,way,white,white-papillose,wide	.25,0-0.1,0.1-0.5,0.5,0.5-1,1,anthesi,axil,ba,beginning,closely,coroll,deltoid,drying,eaf,edge,edicel,eed,erect,except,filament,free,inflorescenc,internodal,known,lamina,larger,later,lobe,lon,lower,margin,mature,meeting,middle,minute,much,near,nflorescence,occasionally,often,older,opposite,overlapping,paler,papillo,papillose,pore,portion,prominent,reflexed,ruit,scar,slender,slit-like,somewhat,spaced,sparse,straight,tall,terminal,thickened,trichome,tube,tuft,ud,unifoliat,uniseriate,unit,upon,usually,widest,woody,yellowish,ympodial,young	arrangement,characteristic,colour,diameter,exertion,form,growth,height,history,inflorescence,length,life,lobing,na,number,peduncle,per,plant,primary,seed,shape,size,texture,type,unifoliate	.75,/4,0.2-1.1,1-1.2,1.5-1.7,1.5-3.5,2-6,3-7,4-11,5-7-flowered,6-7,6-8,7-10,acuminate,acute,base,becoming,beneath,berry,bi-lobed,capitate,cm,corolla,cup-shaped,deep,deflexed,densely,dia,elliptic,exsertion,glabrous,globose,green,greyish,immature,lateral,lobed,long,main,maroon,minutely,mm,narrowly,obtuse,pair,pale,poricidal,pubescent,shiny,shrub,simple,small,sparsely,tapering,tip,tree,vein,way,white,white-papillose,wide	na,unifoliate
306	wfo-0001029364	success	151	102	65	77	74	25	62	3	-2,0.2-0.5,1-2-6,1-3,1-4,1-5,1.5-2,2,2-6,4-9,5-9,7-9,8-15,?,abaxially,acuminate,adaxially,anther,apart,apex,articulated,base,calyx,cm,corolla,cream,cuneate,cylindrical,diameter,distally,elliptic,entire,extra-axillary,filament,finger,flower,fruit,glabrous,gland-tipped,globose,green,greenish,hair,herb,immature,lobe,margin,minutely,mm,narrowly,nearly,obtuse,ovate,pedicel,peduncle,petiole,puberulent,pubescent,rachi,radiu,sagittate,shallow,shrub,simple,sparsely,spot,stellate,stigma,strongly,style,tapered,triangular,tube,unbranched,unknown,white,x	-3,-6,.5,1,191.,2-4-12,2-foliat,3-4,5-10-27,5-11,6-8,8-10,according,acute,aggregate,around,axe,ba,bitter,blade,blue,cell,center,chartaceous,color,connivent,curled,darker,deep,directed,distall,eaf,ed,fide,free,glandular-puberulen,inserted,long,lower,major,membranaceous,mesocarp,moderately,nflorescence,orolla,part,perfect,pore,presence,present,puberulen,ripe,ruit,rusby,short-tomentose,shorter,side,small,spaced,stone,tal,tamen,tem,thecae,tightly,time,tomento,truncat,unit,vary,vein,wide,yellow,ympodial	10-27,2-12,abaxial,adaxial,arrangement,articulation,characteristic,colour,form,growth,height,inflorescence,insertion,leaf,length,ovary,plant,seed,shape,size,spacing,staman,stem,texture,truncate	-2,0.2-0.5,1-2-6,1-3,1-4,1-5,1.5-2,2,2-6,4-9,5-9,7-9,8-15,?,abaxially,acuminate,adaxially,apart,articulated,base,cm,corolla,cream,cuneate,cylindrical,distally,elliptic,entire,extra-axillary,finger,flower,glabrous,gland-tipped,globose,green,greenish,hair,herb,immature,lobe,minutely,mm,narrowly,nearly,obtuse,ovate,puberulent,pubescent,sagittate,shallow,shrub,simple,sparsely,spot,stellate,strongly,tapered,triangular,unbranched,unknown,white,x	10-27,2-12,truncate
307	wfo-0001029368	success	139	85	47	57	82	28	43	4	.2,.5,0.5-2,1.5-3,1.5-4,11-13,16-25,2-5,2.5-4,5-6,acuminate,acute,anther,anthesi,apex,bark,base,berry,broadly,calyx,capitate,cm,corolla,crumpled,densely,dia,elliptic,erect,exserted,fruit,fruiting,glabrous,globose,golden,green,herb,inflorescence,leaf,long,minutely,mm,ovary,pedicel,petiole,puberulent,shaped,simple,stem,stigma,strongly,style,tear-drop,trichome,tube,uniseriate,white,x	.25,0,0.9-1,1.5-1.6,1.5-2,?,abaxially,adaxially,along,apparently,bearing,bitter,borne,breaking,brow,closely,coarse,conical,cup,deflexed,distal,eaf,edicel,eed,few-branched,fide,filament,flattened,flower,free,half,indistinct,inflorescenc,internodal,known,lamina,lanceolate,lateral,leaving,like,lobe,lower,main,margi,margin,middle,midrib,minute,nflorescence,non-flower,obtuse,older,one,opposite,overlappin,pair,papillo,papillose,parallel,pore,poricidal,portion,reflexed,rest,ruit,scar,shrub,somewhat,spaced,straight,tall,tip,ud,unifoliat,unit,upper,vein,widest,winged,woody,ympodial,young	abaxial,adaxial,arrangement,brown,bud,characteristic,colour,diameter,exertion,form,growth,height,history,length,life,na,number,peduncle,per,perennial,plant,seed,shape,size,surface,texture,type,unifoliate	.2,.5,0.5-2,1.5-3,1.5-4,11-13,16-25,2-5,2.5-4,5-6,acuminate,acute,anthesi,apex,berry,broadly,calyx,capitate,cm,crumpled,densely,dia,elliptic,erect,exserted,glabrous,globose,golden,green,herb,long,minutely,mm,puberulent,shaped,simple,strongly,tear-drop,trichome,tube,uniseriate,white,x	brown,na,perennial,unifoliate
308	wfo-0001029370	success	223	140	96	111	112	29	90	6	.3,0-35,0.5-1,0.5-2.2,1-2,1.5-6,1.8-2.5,1.8-2.8,1/4-1/3,2-3,2.5-3.5,3-4,3.5-4,3.5-8,4-6,7-13,8-14,8-23,abaxial,abaxially,adaxial,almost,anther,apically,apparently,articulated,bark,basal,base,berry,branched,broad-deltate,calyx,chartaceous,cm,cordate,cream,dark,densely,diameter,discolorous,drying,elongate,erect,filament,fine,flattened-reniform,flower,fruit,fruiting,fully,glabrescent,green,greenish,herb,lateral,leaf,length,lobe,lobed,long,long-styled,lower,margin,marking,maturity,mauve,mm,moderately,often,opening,orange-brown,ornate,ovate,overlapping,pair,pale,pattern,pedicel,peduncle,petiole,plant,poricidal,prickly,primary,red-brown,reticulate,rotate,shiny,short-styled,shrub,simple,smooth,spherical,spreading,stellate-pubescent,stem,strongly,style,surface,tapering,terete,tip,tube,vein,way,white,whitish,wide,yellow,young	.1,.5,/4,0-10,0-100,0-3,0.1,0.1-0.15,0.2,0.3,1,1-3,1-4,1/3-1/2,10-17,10-17-20,10-40,10-50,12-17,15-30,2-10,2-20,2-6,3/,4-7,4-9,5-10,5-12,5-merous,5.5-7,6-15-32,7-11,8-20,acut,alyx,ame,andromonoecious,apar,apart,apex,blade,c.,clearly,conical,connivent,curved,distal,distance,eaf,eed,elongating,equal,extending,fewer,flattened,free,gently,glabrous,hermaphrodite,heterostylous,infructescence,longer,lowermost,mature,midpoint,midvein,mixture,multangulate,nflorescence,obtuse,older,one,open,orange,orolla,oung,pendulous,per,pericarp,perpendicular,plurifoliat,porrect,portion,prickl,prickle,ray,rounded,ruit,scar,sessile,side,slightly,sometimes,spaced,stalk,stalked,staminat,stout,straight,tamen,tertiary,time,trichome,unarmed,unit,variously,vary,venation,visible,white-gra,woody,ympodial	3/4,acute,arrangement,branch,bud,characteristic,colour,corolla,exertion,form,glabrousnes,growth,height,history,inflorescence,life,lobing,na,new,ovary,perennial,plurifoliate,seed,shape,size,stigma,texture,type,white-gray	.3,0-35,0.5-1,0.5-2.2,1-2,1.5-6,1.8-2.5,1.8-2.8,1/4-1/3,2-3,2.5-3.5,3-4,3.5-4,3.5-8,4-6,7-13,8-14,8-23,abaxially,almost,apically,apparently,articulated,basal,base,berry,branched,broad-deltate,chartaceous,cm,cordate,cream,dark,densely,diameter,discolorous,drying,elongate,erect,fine,flattened-reniform,flower,fully,glabrescent,green,greenish,herb,lateral,lobe,lobed,long,long-styled,lower,marking,maturity,mauve,mm,moderately,often,opening,orange-brown,ornate,ovate,overlapping,pair,pale,pattern,poricidal,prickly,red-brown,reticulate,rotate,shiny,short-styled,shrub,simple,smooth,spherical,spreading,stellate-pubescent,strongly,tapering,terete,tip,way,white,whitish,wide,yellow,young	3/4,acute,na,perennial,plurifoliate,white-gray
309	wfo-0001029373	success	199	107	65	74	125	33	50	15	6.8,acute,anther,anthesi,apex,articulated,bark,base,berry,broadly,bud,calyx,clavate,cm,conical,corolla,curved,deltate,densely,diameter,ellipsoid,entire,exerted,filament,flattened-reniform,fruit,fruiting,globose,green,grey-brown,growth,halfway,herb,internodal,lateral,leaf,less,long,margin,minute,minutely,mm,moderately,new,obtuse,ovary,ovate-lanceolate,pair,papillate,pedicel,peduncle,per,petiole,pitted,plant,primary,pubescent,rounded,shape,simple,slightly,stem,stigma,straight,style,surface,terete,tip,trailing,tube,vein,white,wide,yellowish	.0â1.2,.2,.3,.5,.5â2.0,0.3â0.5,0.4â1.6,0.5â1.2,0.5â1.8,0.6â0.7,1.0â1.2,1.0â1.6,1.2â1.5,1.3â2.2,1.4â3.5,1.5â2.0,1.5â2.5,1.5â2.7,1.8â2.0,1.8â2.3,180Â°,2-celled,2.0â2.5,2.7â3.0,20â30,2â4-celled,3,3.5â4.0,30â40,3â5,4â5,4â6,5,5-merous,5â6,8â9,abaxial,abaxially,accrescent,acuminate,adaxial,adaxially,age,apar,appearanc,appressed,arising,basal,bayonet,beyond,capped,cell,cone,developing,distal,eaf,eed,elongate,enclosed,enclosing,finger,flower,free,fully,geminat,glabrous,glandular-tipped,hair,half,hilum,immature,individual,laterally,lengthening,like,live,lobe,lobed,lon,lower,mature,mesocarp,middle,mouth,nflorescence,node,older,outline,pentagonal,perfect,plurifoliate,pore,poricidal,portion,positioned,reflexed,resembling,root,ruit,scar,seen,seudostipule,shallowly,short,slit,smoot,spaced,spreading,stellate,still,tall,tem,testal,thicker-walled,trichome,tub,ud,uniseriate,unit,upper,woody,yellow,yellow-green,ympodial,â5	0.4-1.6,0.5-1.2,0.6-0.7,1.0-1.2,1.0-1.6,1.2-1.5,1.4-3.5,1.5-2.5,1.8-2.3,20-30,30-40,4-6,5-6,8-9,arrangement,branch,characteristic,colour,exertion,form,glabrousnes,height,history,inflorescence,length,life,lobing,mentioned,number,seed,size,texture,type	6.8,acute,anthesi,articulated,base,berry,broadly,calyx,clavate,cm,conical,curved,deltate,densely,diameter,ellipsoid,entire,exerted,flattened-reniform,globose,green,grey-brown,halfway,herb,internodal,lateral,less,long,minute,minutely,mm,moderately,obtuse,ovate-lanceolate,pair,papillate,per,pitted,pubescent,rounded,simple,slightly,straight,terete,tip,trailing,tube,white,wide,yellowish	0.4-1.6,0.5-1.2,0.6-0.7,1.0-1.2,1.0-1.6,1.2-1.5,1.4-3.5,1.5-2.5,1.8-2.3,20-30,30-40,4-6,5-6,8-9,mentioned
310	wfo-0001029402	success	113	90	54	68	45	22	53	1	0.5-1,0.5-2,15-30,2,2-10,2-3,3-5,3-6,4-6,4-7,5-25,7-8,abaxial,acuminate,acute,apart,apex,band,base,branched,calyx,chartaceous,ciliolate,cm,connivent,cylindrical,deltate,diameter,elliptic,flower,free,glabrate,glabrous,inrolled,lanceolate,lobe,margin,mm,moderately,narrowed,narrowly,often,papillose,pedicel,peduncle,petiole,pubescence,pubescent,rachi,radiu,roughened,scale-like,shrub,simple,somewhat,sparsely,stellate,stigma,style,surface,tapered,thickened,tip,triangular,tube,unknown,violet,x	1-2.5,11-17,3-4,4-8,6-16,7-11,7-9,8-15,abaxially,adaxially,articulated,axe,blade,color,denser,directed,distall,eaf,eed,fleshy,forked,glabrou,hair,leaving,long,lower,many-foliat,nearly,nflorescence,nther,orolla,pore,rachise,ruit,scar,spaced,tal,tem,time,truncat,unit,unknow,vary,wide,ympodial	anther,arrangement,characteristic,colour,corolla,form,fruit,growth,height,history,inflorescence,leaf,length,life,plant,seed,shape,spacing,stem,texture,truncate,type	0.5-1,0.5-2,15-30,2,2-10,2-3,3-5,3-6,4-6,4-7,5-25,7-8,acuminate,acute,apart,apex,band,branched,chartaceous,ciliolate,cm,connivent,cylindrical,deltate,elliptic,flower,free,glabrate,glabrous,inrolled,lanceolate,mm,moderately,narrowed,narrowly,often,papillose,pubescence,pubescent,roughened,scale-like,shrub,simple,somewhat,sparsely,stellate,tapered,thickened,tip,triangular,unknown,violet,x	truncate
311	wfo-0001029404	success	154	149	89	95	59	54	85	4	0-60-flower,0.5-1,1,1-4,2,2-3,2-5,2.5-22,2.5-3,20-35,3-4,3-8.5,5-10,5-20,5-24,6-8,6.5-34,abaxially,acuminate,acute,adaxially,anther,apex,apiculate,auriculate,basal,base,beyond,branched,calyx,center,chartaceous,cm,connivent,cordate,cream,dark,darker,deltate,densely,diameter,directed,distally,eglandular,ellipsoidal,entire,exserted,flattened,fleshy,flower,fruit,glabrous,glandular,green,hair,lanceolate,less,light,lobe,long,longitudinal,margin,mm,moderately,mottling,obtuse,orange,ovate,ovoid,pedicel,peduncle,perfect,petiole,pink,pore,puberulent,pubescent,purple,ripe,shrub,simple,somewhat,sparsely,star,stigma,style,toward,tree,triangular,tube,unbranched,vein,white,x,yellow	-1.5,-10,-3,-5,1.5-2,15-25,2-4,2-8,3-5,4-foliat,5-6,6-9,8-12,absent,aggregate,apart,ape,articulated,axe,blade,cell,connective,cylindrical,eaf,eed,glandular-puberulen,leaving,lemon,lon,lower,narrowly,nflorescence,nther,orang,orolla,pedicellar,presen,rachi,radiu,remnant,ruit,shorter,slightly,small,spaced,stellate,stone,subcoriaceous,tal,tem,thecae,time,tomento,truncat,ud,unit,vary,wide,ympodial	appearance,arrangement,bark,border,branch,bud,characteristic,colour,corolla,corrugation,distal,drying,exertion,filament,form,fruiting,giving,glabrousnes,glandular-puberulent,growth,height,history,inflorescence,interjected,lateral,leaf,leaflet,length,life,lobing,midpoint,na,new,number,ovary,per,plant,prickle,primary,pseudostipule,ray,seed,shape,size,stem,surface,terminal,texture,thicknes,tomentose,truncate,type,variation,width	0-60-flower,0.5-1,1,1-4,2,2-3,2-5,2.5-22,2.5-3,20-35,3-4,3-8.5,5-10,5-20,5-24,6-8,6.5-34,abaxially,acuminate,acute,adaxially,anther,apex,apiculate,auriculate,basal,beyond,branched,center,chartaceous,cm,connivent,cordate,cream,dark,darker,deltate,densely,directed,distally,eglandular,ellipsoidal,entire,exserted,flattened,fleshy,flower,fruit,glabrous,glandular,green,hair,lanceolate,less,light,lobe,long,longitudinal,margin,mm,moderately,mottling,obtuse,orange,ovate,ovoid,perfect,pink,pore,puberulent,pubescent,purple,ripe,shrub,simple,somewhat,sparsely,star,toward,tree,triangular,unbranched,white,x,yellow	glandular-puberulent,na,tomentose,truncate
312	wfo-0001029406	success	136	106	66	80	56	26	65	1	.5,0.5-1,0.6-1,0.7-1.5,1-1.5,1-10,1.5-2.2,1.5-2.5,2,2-11,2-3,2.5-3.5,28,30,4-18,7-12,acute,anther,apex,arachnoid-pubescent,base,berry,broadly,brown,brownish,calyx,clavate,cm,conical,corolla,dark,deciduous,deltate,densely,dia,elliptic,filament,fruiting,glabrous,globose,grayish-green,green,greenish-white,lateral,leaf,lobed,long,main,margin,maturity,middle,minutely,mm,nearly,often,ovary,ovoid,ovoid-reniform,pair,papillose,pedicel,petiole,pitted,shaped,shiny,shrub,size,slightly,small,stem,stigma,style,surface,tear-drop,tree,tube,vein,white,wide,widest	0.3-1,1-2,1.5-5,3-9,4-6,abaxially,adaxially,along,anthesi,arachnoid,ba,bark,bullate,conspicuously,deflexed,differing,difoliate,dry,eaf,eed,felt-like,free,geminat,grayish-brown,impressed,large,lenticel,lilac,lobe,lon,lower,major,matted,minor,occasionally,older,pale,papillo,planar,pointed,population,pore,poricidal,portion,pubescent,ruit,soon,tall,tinge,tip,trichome,unit,waxy,woody,ympodial,young	arrangement,bud,characteristic,colour,diameter,drying,exertion,form,fruit,glabrousnes,growth,height,history,inflorescence,length,life,lobing,na,new,peduncle,plant,primary,seed,shape,texture,type	.5,0.5-1,0.6-1,0.7-1.5,1-1.5,1-10,1.5-2.2,1.5-2.5,2,2-11,2-3,2.5-3.5,28,30,4-18,7-12,acute,arachnoid-pubescent,base,berry,broadly,brown,brownish,calyx,clavate,cm,conical,dark,deciduous,deltate,densely,dia,elliptic,glabrous,globose,grayish-green,green,greenish-white,lateral,lobed,long,main,maturity,middle,minutely,mm,nearly,often,ovoid,ovoid-reniform,pair,papillose,pitted,shaped,shiny,shrub,slightly,small,tear-drop,tree,tube,vein,white,wide,widest	na
313	wfo-0001029407	success	204	119	79	94	110	25	77	2	-6,.5,/3,0-15,0-4,0.4-0.7,0.4-1,0.5-0.7,0.5-1.5,0.5-2,0.6-0.9,0.7-1.2,1-1.4,1-4,1-4.5-7,1.8-2.5,2.5-3,3-4,3-6,4-15-25,5-7,acute,almost,anther,apex,articulated,bark,base,berry,bright-red,calyx,cm,cuneate,dark,densely,diameter,dull,elliptic,entire,erect,evenly,filament,flattened-reniform,fruit,fruiting,gray-greenish,green,green-brown,lateral,leaf,length,lobed,long,margin,mature,maturity,mauve,mm,moderately,obtuse,orange,orange-brown,ovate,pair,pedicel,peduncle,per,petiole,poricidal,prickle,prickly,primary,rarely,rounded,shrub,simple,sometimes,spherical,stellate,stellate-pubescent,stem,style,surface,tapering,tip,tube,unbranched,vein,way,white,wide,yellow,yellow-green,young	-10,-2,0-2,0-5,0.1-0.2,0.1-0.25,0.15-0.4,0.2-0.3,0.6,1,1-2,1-3,1.5,1/3,1/3-1/2,1/5,1/8-1/5,2-3,2-4,2-5,3.5-4.5,4-9,4.5-6,5-merous,6-13,6-20,7-8,abaxial,abaxially,acut,adaxial,alyx,apar,apart,apically,apparently,blade,brow,chartaceous,connivent,curved,deltate,difoliate,discolorous,drying,eaf,eed,elongating,equal,flattened,flower,free,geminat,geminate,glabrescent,glabrous,infructescence,lengt,lobe,longer,lower,midpoint,nflorescence,occasionally,older,one,open,orolla,oung,pale,pendulous,perfec,pericarp,porrect,portion,prickl,pubescent,ray,recurved,reflexed,ruit,scar,sessile,shorter,side,slender,smooth,spaced,sparsely,spreading,stalk,stalked,stout,straight,straw-yellow,strongly,tamen,terete,tertiary,thick,time,trichome,unit,upper,vary,venation,visible,weakly,woody,ympodial	arrangement,branch,brown,bud,characteristic,colour,corolla,exertion,form,glabrousnes,growth,height,inflorescence,lobing,na,new,number,ovary,plant,seed,shape,size,stigma,texture,type	-6,.5,/3,0-15,0-4,0.4-0.7,0.4-1,0.5-0.7,0.5-1.5,0.5-2,0.6-0.9,0.7-1.2,1-1.4,1-4,1-4.5-7,1.8-2.5,2.5-3,3-4,3-6,4-15-25,5-7,acute,almost,articulated,base,berry,bright-red,cm,cuneate,dark,densely,diameter,dull,elliptic,entire,erect,evenly,flattened-reniform,gray-greenish,green,green-brown,lateral,leaf,length,lobed,long,mature,maturity,mauve,mm,moderately,obtuse,orange,orange-brown,ovate,pair,per,poricidal,prickle,prickly,rarely,rounded,shrub,simple,sometimes,spherical,stellate,stellate-pubescent,tapering,tip,unbranched,way,white,wide,yellow,yellow-green,young	brown,na
314	wfo-0001029408	success	243	145	104	116	127	29	100	4	0,0.2-0.3,0.9-1.3,0.9-1.6,1-8,1.1-1.5,1.4-1.9,1.5-3,1.7-2.4,1/2,11-31,2-12,2-3.5,2-5,2/3,3-5,4-14,4-20,5-6.5,5-8,7-12,abaxially,acute,adaxially,anther,anthesi,apex,barely,bark,base,becoming,berry,blade,blunt-tipped,branch,branched,broadly,brown,bud,calyx,clavate,cm,conical,continued,corolla,cuneate,dark,decurrent,deltoid,diameter,due,elliptic,entire,exserted,filament,fleshy,flower,fruit,fruiting,glabrous,globose,gray,green,growth,honeycombed,lanate,lateral,leaf,length,lilac,long,long-attenuate,margin,midvein,mm,moderately,mostly,oblong,orbicular,ovate,pale,pedicel,peduncle,petiole,pubescent,purplish,rarely,reniform,reticulate-punctate,ripe,short-attenuate,shrub,side,simple,slightly,stelliform,stem,stigma,style,subcampanulate,suborbicular,terete,time,tomentose,top,tube,turbinate,unarmed,vein,velutinous,way,white,whitish,x,yellow,yellowish	-1.5,-10.5,.2-3.5-4.5,/10,0-100,0.3-5,0.5-2.5,0.7-1.2,1.6-2.8,1.8-3.5,1/2-3/4,1/4,2-4,2.2-3.7,2.5-7,3.5-5,4-7.5,5-24,5-6,5-merou,accrescent,acuminate,adaxiall,ag,alyx,apart,apical-lateral,articulated,axe,axillary,ba,capitat,chartaceous,dehiscing,dendritic-echinoi,dendritic-multangulate,densely,develope,directed,distal,distall,eaf,echinoi,echinoid,eed,extend,faintly,few-rayed,free,hair,high,homostylous,indument,inserted,interpetalar,introrse,lacking,lanceolate,large,lobe,lobed,long-,long-stalked,longitudinal,lower,m.,main,many,mixed,multangulate,near,nearly,nflorescence,obscured,obtuse,often,older,orolla,ovate-lanceolate,overlapping,part,partly,perfect,persistent,plurifoliate,pore,porrect-stellate,present,pseudo-terminal,rachi,rather,ray,relatively,ribbed,rotate-stellate,ruit,runk,sessile,short-,short-stalked,slit,small,sometimes,spaced,stamen,subovate,suture,tamen,testa,thick,thick-stalked,thick-textured,thin-stalked,tissue,tomentu,tomentum,touching,toward,tree,unarme,unit,usually,vary,well,wide,ympodial,young	arrangement,capitate,characteristic,colour,corrugation,drying,exertion,form,glabrousnes,height,history,inflorescence,life,lobing,na,new,number,ovary,per,perennial,plant,primary,pseud-terminal,seed,shape,size,surface,texture,type	0,0.2-0.3,0.9-1.3,0.9-1.6,1-8,1.1-1.5,1.4-1.9,1.5-3,1.7-2.4,1/2,11-31,2-12,2-3.5,2-5,2/3,3-5,4-14,4-20,5-6.5,5-8,7-12,abaxially,acute,adaxially,anthesi,barely,base,becoming,berry,blade,blunt-tipped,branched,broadly,brown,bud,calyx,clavate,cm,conical,continued,cuneate,dark,decurrent,deltoid,diameter,due,elliptic,entire,exserted,fleshy,flower,fruit,glabrous,globose,gray,green,growth,honeycombed,lanate,lateral,lilac,long,long-attenuate,midvein,mm,moderately,mostly,oblong,orbicular,ovate,pale,petiole,pubescent,purplish,rarely,reniform,reticulate-punctate,ripe,short-attenuate,shrub,side,simple,slightly,stelliform,stem,subcampanulate,suborbicular,terete,time,tomentose,top,turbinate,unarmed,velutinous,way,white,whitish,x,yellow,yellowish	capitate,na,perennial,pseud-terminal
315	wfo-0001029417	success	213	158	122	135	78	23	119	3	.5,0-7,0.2-0.6,0.7-3,1-10,1-2,1-4,1-8,1.3-8,1.5-1.8,1.5-8,12,2.5-10,2.8-3.5,3-14,3-5,5-15,6-11,8-15,8-9,abaxially,adaxially,along,anther,apart,attenuate,axillary,blue,borne,broadly,brownish,bud,cell,central,chartaceous,ciliate,clavate,cm,coarsely,condition,connivent,corolla,covering,dark,deep,diameter,distal,dot,drying,end,erect,especially,filament,flower,forked,fresh,fruit,generally,glabrous,globose,green,green-white,greenish,hair-like,half,herb,homostylous,interjected,lanceolate,lateral,leaflet,linear,long,lunate,make,margin,medium,membranous,midrib,minute,minutely,mm,moderately,mucilaginous,narrowly,non-glandular,odd-pinnate,often,orbicular,ovate,ovoid,pair,pedicel,peduncle,pentagonal,petiole,pilose,plant,poricidal,puberulent,pubescent,purple,rarely,ripe,rotate,scattered,seed,singly,size,slightly,sometimes,star,stem,stigma,straight,style,subtending,terminal,testal,thick,throughout,tinged,tip,trichome,tuber,typically,usually,violet,wall,wet,white,whitish,wide,x,yellow	0.4-8,1,1-1.5,1.5-10,2-4,4-7,5-merou,acumen,acuminate,acute,ag,alyx,apex,apiculate,apparently,articulated,axe,base,basiscopic,berry,blade,capitat,decreasing,decurrent,digestion,dorsally,eaf,edge,eed,enzyme,erec,exceeding,flat,folded,geminat,glabrou,greatly,hair,hal,honeycomb-shaped,lengthening,like,living,lobe,lower,nflorescence,orolla,perfect,petiolulate,plurifoliate,pore,rapidly,removed,rounded,ruit,sessile,seudostipule,short,short-petiolulate,side,slit,spaced,specimen,stamen,ste,stolo,subequal,tall,tamen,tem,tri-,tube,unit,unwinged,vary,widely,wing,ympodial	5-merous,abaxial,adaxial,arrangement,calyx,capitate,colour,form,growth,height,history,inflorescence,leaf,length,life,ovary,presence,pseudostipule,shape,spacing,stolon,surface,texture	.5,0-7,0.2-0.6,0.7-3,1-10,1-2,1-4,1-8,1.3-8,1.5-1.8,1.5-8,12,2.5-10,2.8-3.5,3-14,3-5,5-15,6-11,8-15,8-9,abaxially,adaxially,along,apart,attenuate,axillary,blue,borne,broadly,brownish,bud,cell,central,chartaceous,ciliate,clavate,cm,coarsely,condition,connivent,corolla,covering,dark,deep,distal,dot,drying,end,erect,especially,forked,fresh,generally,glabrous,globose,green,green-white,greenish,hair-like,half,herb,homostylous,lanceolate,lateral,linear,long,lunate,make,margin,medium,membranous,midrib,minute,minutely,mm,moderately,mucilaginous,narrowly,non-glandular,odd-pinnate,often,orbicular,ovate,ovoid,pentagonal,pilose,plant,poricidal,puberulent,pubescent,purple,rarely,ripe,rotate,scattered,seed,singly,slightly,sometimes,star,straight,subtending,terminal,testal,thick,throughout,tinged,tip,trichome,typically,usually,violet,wall,wet,white,whitish,wide,x,yellow	5-merous,capitate,stolon
316	wfo-0001029461	success	210	112	74	86	124	26	71	3	-1.5,-3,.5,0-2,0.6-1,0.7-1,0.8-1.5,1-1.6,1.2-1.7,1.2-1.8,1.3-2.2-3.2,1.5-2-4-5,1/4-1/2,2-2.4,2-2.8,2.5-3,5-25,almost,anther,apex,attenuate,bark,base,berry,black,broad-deltate,calyx,cell,chartaceous,cm,cuneate,dark,densely,diameter,dull,elliptic,evenly,filament,fine,flattened-reniform,fruit,fruiting,green,leaf,length,lobed,long,margin,maturity,mauve,mm,moderately,oblong,outline,ovate,pedicel,per,petiole,pit,plant,poricidal,prickle,prickly,raised,reddish,rounded,shiny,shrub,simple,small,smooth,sometimes,sparsely,spherical,stellate-pubescent,stem,style,subentire,surface,terete,tip,tube,way,wide,yellow,young	-4.5,0-4,0.1,0.1-0.25,0.15-0.25,0.8,1-1.5-2,1-2,1-3,1-3-6,1-4,1-6,1/3,1/3-2/3,1/4-3/4,2-3,3-20,4-10-14,4-6.5,4-7,4.5-7,4.7-7.2,5-10,5-merous,7-10,7-12,8-9,abaxially,acuminat,alyx,ame,andromonoecious,apart,apically,becoming,blade,breaking,brittle,brown,c.,concolorous,curved,discolorous,distal,distance,drying,eaf,eed,elongating,erect,extending,faint,fifth,flattened,flower,four,free,glabrescent,glabrous,gra,hermaphrodite,heterostylous,infructescence,lengt,lobe,long-styled,longer,lower,lowermost,mature,midpoint,midvein,obovate,obtuse,older,orange,orolla,oung,pair,pendulous,pericarp,plurifoliat,porrect,portion,prickl,primary,ray,reduced,reflexed,ruit,sessile,shallow,short-styled,shorter,side,slender,slightly,spaced,spreading,stalk,stalked,staman,staminat,stellate,straight,strongly,tamen,tertiary,time,trichome,unarme,unarmed,unequal,unit,upper,variously,vary,vein,venation,visible,weakly,woody,ympodial,zygomorphic	arrangement,branch,bud,characteristic,colour,corolla,exertion,form,glabrousnes,gray,growth,height,inflorescence,lobing,na,new,number,ovary,peduncle,plurifoliate,seed,shape,size,stigma,texture,type	-1.5,-3,.5,0-2,0.6-1,0.7-1,0.8-1.5,1-1.6,1.2-1.7,1.2-1.8,1.3-2.2-3.2,1.5-2-4-5,1/4-1/2,2-2.4,2-2.8,2.5-3,5-25,almost,attenuate,base,berry,black,broad-deltate,cell,chartaceous,cm,cuneate,dark,densely,diameter,dull,elliptic,evenly,fine,flattened-reniform,green,length,lobed,long,maturity,mauve,mm,moderately,oblong,outline,ovate,per,pit,poricidal,prickle,prickly,raised,reddish,rounded,shiny,shrub,simple,small,smooth,sometimes,sparsely,spherical,stellate-pubescent,subentire,surface,terete,tip,way,wide,yellow,young	gray,na,plurifoliate
317	wfo-0001029462	success	163	113	48	59	104	54	46	2	-4,0.5-1,0.5-2,1-3,1-6,1.5-7,10-15-25,2-6.5,2.5-3.5,2.5-5.5,3-18,6-9,acuminate,apex,base,calyx,chartaceous,cm,cuneate,dark,densely,diameter,ellipsoidal,elliptic,entire,flattened,fruit,glabrous,green,lanceolate,laterally,light,lobe,longitudinal,margin,membranaceous,mm,narrowly,ovate,ovoid,pedicel,peduncle,petiole,pubescent-pilose,purplish,reticulate,rounded,simple,somewhat,stigma,stripe,style,tree,triangular,truncate,tube,unbranched,white,x	-2,-5,1,1-2,1-4-15-30,1.5,1.5-2,1.5-3,10-22,2-3,20-35,3,3-27,3-4,3-5,3-6,3-7,4-20-30,4-foliat,5-30,7-19,7-8,8-9,abaxially,abruptly,absent,acute,adaxially,aggregate,apart,ape,articulated,axe,basal,beyond,blade,broad,campanulate,cell,ciliate,connective,connivent,constricted,curled,cylindrical,dentate,directed,eaf,eed,eglandular,equal,exceeding,exserted,flower,hair,leaving,lon,long,lower,m.,minutely,moderately,near,nflorescence,nther,obtuse,occasionally,often,orolla,oval,pedicellar,perfect,pore,puberulent,pubescent,pubescent-pilo,purpl,rachi,radiu,remnant,ruit,shorter,slightly,small,smooth,spaced,sparsely,stamen,stellate-,stone,tal,tem,thecae,time,tip,tomentose,truncat,ud,unit,vary,wide,without,yellow,ympodial	anther,appearance,arrangement,bark,border,branch,bud,characteristic,colour,corolla,corrugation,distal,drying,exertion,filament,form,fruiting,giving,glabrousnes,growth,height,history,inflorescence,interjected,lateral,leaf,leaflet,length,life,lobing,midpoint,na,new,number,ovary,per,plant,prickle,primary,pseudostipule,ray,seed,shape,size,stellate-campanulate,stem,surface,terminal,texture,thicknes,type,variation,vein,width	-4,0.5-1,0.5-2,1-3,1-6,1.5-7,10-15-25,2-6.5,2.5-3.5,2.5-5.5,3-18,6-9,acuminate,chartaceous,cm,cuneate,dark,densely,ellipsoidal,elliptic,entire,flattened,glabrous,green,lanceolate,laterally,light,longitudinal,membranaceous,mm,narrowly,ovate,ovoid,pubescent-pilose,purplish,reticulate,rounded,simple,somewhat,stripe,tree,triangular,truncate,unbranched,white,x	na,stellate-campanulate
318	wfo-0001029464	success	232	132	95	110	122	22	93	2	.9,0-2,0-5,0-80,0.2-0.5,0.5,0.8-2,1-10,1-3,1.2-3,1/4,1/4-1/2,10-50,2-3.5,2-4,2.2-2.5,2.4-4,2.5-5,2.5-8,2.9-3.2,3-20,3-7,3.5-5,5-17,abaxial,acicular,acute,adaxial,annual,anther,apart,apex,apparently,bark,base,berry,black,brown,calyx,chartaceous,cm,connivent,cordate,curved,dark,diameter,ellipsoid,erect,flattened-reniform,flower,fruit,fruiting,glabrescent,glaucous,globular,green,green-brown,herb,lateral,leaf,length,less,lobed,long,long-styled,margin,maroon,maturity,mauve,mm,moderately,mottled,oblong,obtuse,orange-brown,ovate,ovoid,pedicel,peduncle,pendent,petiole,pink,plant,poricidal,prickle,purple,red-brown,short-styled,simple,sometimes,spaced,stellate,stellate-pubescent,straight,striped,style,surface,tapering,terminal,tip,unarmed,upper,usually,variously,way,white,wide,yellow-green,yellow-orange,young	0-30,0.2,0.2-0.7,0.3-0.7,0.3-1,0.5-2,00-200,1,1-8,1.5-2,1/,1/4-1/3,1/4-1/3-2/3,10-15,10-23,10-40,12-50,2-3,3-5,4-7,4-8,4-8-merous,5-8,5.5-6,5.5-7.5,6-15,7-10,8-13,8-15,9-15,abaxially,alyx,ame,andromonoecious,apar,apically,around,articulated,blade,branched,broad,broad-deltate,brow,c.,cultivar,cup-shaped,deltate,difoliate,discolorous,distal,distance,drying,eaf,eed,elongated,elongating,equal,extending,filament,free,fully,geminat,glabrous,hair,hermaphrodite,heterostylous,infructescence,lobe,long-acuminat,longer,lower,lowermost,mature,midpoint,midvein,minute,narrow-deltate,nflorescence,occasionally,often,older,one,open,opening,orolla,oung,pair,pendulous,per,pericarp,porrect,portion,prickl,prickly,primary,ray,rounded,ruit,scar,sessile,side,smooth,sparsely,spreading,stalk,stalked,staminat,stem,tamen,terete,tertiary,time,translucent,trichome,tube,unit,vary,vein,venation,visible,woody,ympodial	arrangement,characteristic,colour,corolla,corrugation,form,glaubrescent,glaubrous,growth,height,history,inflorescence,life,lobing,ovary,seed,shape,size,staman,texture,type,width	.9,0-2,0-5,0-80,0.2-0.5,0.5,0.8-2,1-10,1-3,1.2-3,1/4,1/4-1/2,10-50,2-3.5,2-4,2.2-2.5,2.4-4,2.5-5,2.5-8,2.9-3.2,3-20,3-7,3.5-5,5-17,acicular,acute,annual,apart,apparently,base,berry,black,brown,chartaceous,cm,connivent,cordate,curved,dark,diameter,ellipsoid,erect,flattened-reniform,flower,glabrescent,glaucous,globular,green,green-brown,herb,lateral,less,lobed,long,long-styled,maroon,maturity,mauve,mm,moderately,mottled,oblong,obtuse,orange-brown,ovate,ovoid,pendent,pink,poricidal,prickle,purple,red-brown,short-styled,simple,sometimes,spaced,stellate,stellate-pubescent,straight,striped,tapering,terminal,tip,unarmed,upper,usually,variously,way,white,wide,yellow-green,yellow-orange,young	glaubrescent,glaubrous
319	wfo-0001029546	success	203	132	100	112	91	20	97	3	0-2,0.3-1,1-2,1-4.5,1.5-2,1.5-6.2,2-9,2.2-2.8,3-8,3.5-5,4-10,4.5-12.5,4.5-7,5,5-10,6.3-19.5,7-10,8-17,8-19.5,abaxially,adaxially,anther,apiculate,attenuate,base,blue,brownish,cell,chartaceous,clavate,cm,condition,connivent,corolla,covered,covering,curved,decreasing,densely,diameter,dot,drying,erect,flower,frequently,fresh,fruit,glabrous,glandular,globose,greatly,green,green-white,greenish,hair-like,herb,homostylous,lanceolate,lateral,leaf,leaflet,lobe,long,longer,make,membranous,mm,mucilaginous,non-glandular,odd-pinnate,often,ovoid,pair,pedicel,peduncle,pentagonal,petiole,plant,poricidal,pubescent,rachi,rarely,ripe,rotate-pentagonal,seed,short,simple,size,slightly,soft,stem,stigma,straight,style,subequal,terminal,testal,thick,throughout,tinged,tip,trichome,tube,unwinged,wall,wet,white,whitish,wide,wing,x,yellow	1-10,1-3.2,1-5,1.6-6.5,2-4,5-18,5-8,5-merou,8,absent,acumen,acuminate,acute,adaxiall,ag,alyx,apart,apex,apparently,articulated,axe,axillary,berry,blade,broadly,bud,capitat,cordate,decumben,decurrent,digestion,distal,dorsally,eaf,edge,eed,elliptic,elliptical,enzyme,exceeding,filament,flat,folded,forked,geminat,generally,glabrou,hair,half,honeycomb-shaped,interjected,lengthening,like,living,lower,lunate,middl,minutely,mottle,nearly,nflorescence,oblique,orbicular,ovate,perfect,petiolule,plurifoliate,pore,purple,regular,removed,ruit,sessile,seudostipule,slit,sometimes,spaced,specimen,stamen,ste,subtending,tall,tamen,tem,tri-,truncate,typically,unit,usually,vary,ympodial	5-merous,arrangement,calyx,capitate,characteristic,colour,decumbent,form,growth,height,history,inflorescence,length,life,ovary,pseudostipule,shape,staman,surface,texture	0-2,0.3-1,1-2,1-4.5,1.5-2,1.5-6.2,2-9,2.2-2.8,3-8,3.5-5,4-10,4.5-12.5,4.5-7,5,5-10,6.3-19.5,7-10,8-17,8-19.5,abaxially,adaxially,apiculate,attenuate,base,blue,brownish,cell,chartaceous,clavate,cm,condition,connivent,covered,covering,curved,decreasing,densely,diameter,dot,drying,erect,frequently,fresh,glabrous,glandular,globose,greatly,green,green-white,greenish,hair-like,herb,homostylous,lanceolate,lateral,leaf,lobe,long,longer,make,membranous,mm,mucilaginous,non-glandular,odd-pinnate,often,ovoid,pentagonal,poricidal,pubescent,rarely,ripe,rotate-pentagonal,seed,short,simple,size,slightly,soft,straight,subequal,testal,thick,throughout,tinged,tip,trichome,tube,unwinged,wall,wet,white,whitish,wide,wing,x,yellow	5-merous,capitate,decumbent
320	wfo-0001029552	success	161	116	89	97	64	19	84	5	.25,.5,0.5,0.6-1,1-1.3,1-1.5,1-2,1-3,1-5,1.5-6.5,12,2-9,5-10-flowered,abaxially,acuminate,acute,adaxially,along,anther,apex,area,bark,base,berry,branched,broadened,calyx,cm,corolla,decurrent,dendritic,densely,dia,elliptic,erect,exserted,filament,flattened-reniform,fruiting,glabrous,globose,green,incrassate,inflorescence,later,leaf,like,lobed,long,long-styled,margin,minor,minutely,mm,nearly,occasionally,older,onto,opposite,orbicular,ovary,pale,paler,pedicel,persistent,petiole,pitted,pore,poricidal,pubescent,rounded,shape,shaped,shining,short-styled,shrub,simple,size,small,somewhat,sparsely,stem,stigma,strongly,style,surface,tan,tear-drop,tip,tree,tree-like,trichome,tube,vein,white,x,young	0.1-0.5,1.5-2,10-20,2-2.5,2.5-3,5.5-8,6-9,abaxial,abruptly,anthesi,broadly,clavate,closely,conical,contracted,deflexed,deltate,denser,differing,difoliate,drying,eaf,edicel,eed,flower,free,geminat,greyish-brow,heteromorphic,inflorescenc,lamina,lateral,lobe,lon,lower,main,major,middle,minute,nflorescence,overlappin,pair,papillo,planar,portion,present,reflexed,rest,ruit,scar,scattered,slender,slightly,spaced,swollen,tall,tub,ud,unit,wide,widest,woody,yellowish,ympodial	alternate,arrangement,bud,characteristic,colour,diameter,exertion,form,fruit,greyish-brown,growth,height,length,lobing,papillose,plant,seed,texture,type	.25,.5,0.5,0.6-1,1-1.3,1-1.5,1-2,1-3,1-5,1.5-6.5,12,2-9,5-10-flowered,abaxially,acuminate,acute,adaxially,along,area,base,berry,branched,broadened,calyx,cm,decurrent,dendritic,densely,elliptic,erect,exserted,flattened-reniform,glabrous,globose,green,incrassate,inflorescence,later,leaf,like,lobed,long,long-styled,margin,minutely,mm,nearly,occasionally,older,onto,opposite,orbicular,pale,paler,persistent,petiole,pitted,pore,poricidal,pubescent,rounded,shaped,shining,short-styled,shrub,simple,small,somewhat,sparsely,stem,strongly,style,surface,tan,tear-drop,tip,tree,tree-like,trichome,tube,vein,white,x,young	-1.5,alternate,di,greyish-brown,papillose
321	wfo-0001029584	success	180	117	80	93	87	24	76	4	0-30,1,1-2,1-6,1.5-6.5,16.2-33,2-3,3-10,3-7,4-14,4.5-11.5,6-7,6.1-9.4,7-14,8-15,9.7-23.4,9.8-17,anther,axillary,borne,brownish,bud,cell,clavate,cm,condition,coriaceous,corolla,covering,dark,densely,diameter,distal,drying,end,filament,flower,forked,fresh,fruit,generally,glabrescent,glabrous,green,green-white,greenish,hair,hair-like,half,herb,homostylous,interjected,lateral,leaf,leaflet,light,make,mm,mucilaginous,oblong-lanceolate,odd-pinnate,ovate,ovoid,pair,pedicel,peduncle,pentagonal,petiole,plant,pubescent,purple,seed,short,simple,singly,size,stigma,straight,style,substellate,subtending,terminal,testal,thick,throughout,tuber,typically,usually,wall,wet,white,whitish,x	1-3,2-4,2.4-6.3,3-5,4-15,4-5,5-merou,5.3-13.3,abaxially,acumen,acuminate,acute,adaxially,ag,alyx,apart,apex,apparently,articulated,asymmetric,attenuate,axe,base,basiscopic,blade,capitat,connivent,considerably,decreasing,dense,digestion,dorsally,eaf,edge,eed,elliptic,enzyme,erry,finer,flat,folded,geminat,hal,honeycomb-shaped,larger,lengthening,linear,living,lobe,long,lower,margin,middle,nflorescence,orbicular,orolla,perfect,petiolulate,plurifoliate,pore,poricidal,present,proximal,removed,second,semi-erec,sessile,seudostipule,side,slit,spaced,specimen,stolo,tall,tamen,tem,tip,tissue,toward,tri-,tube,unit,unknow,unwinged,vary,yellow,ympodial	5-merous,abaxial,adaxial,arrangement,berry,calyx,capitate,colour,form,growth,height,history,inflorescence,length,life,ovary,presence,pseudostipule,shape,stem,stolon,surface,texture,type	0-30,1,1-2,1-6,1.5-6.5,16.2-33,2-3,3-10,3-7,4-14,4.5-11.5,6-7,6.1-9.4,7-14,8-15,9.7-23.4,9.8-17,axillary,borne,brownish,bud,cell,clavate,cm,condition,coriaceous,covering,dark,densely,distal,drying,end,forked,fresh,generally,glabrescent,glabrous,green,green-white,greenish,hair,hair-like,half,herb,homostylous,lateral,light,make,mm,mucilaginous,oblong-lanceolate,odd-pinnate,ovate,ovoid,pentagonal,plant,pubescent,purple,seed,short,simple,singly,straight,substellate,subtending,terminal,testal,thick,throughout,typically,usually,wall,wet,white,whitish,x	5-merous,berry,capitate,stolon
322	wfo-0001029593	success	181	128	90	111	70	17	87	3	-10,0.05,0.5-5,0.8-1,0.8-1.2,1,1-1.2,1-1.5,1-8,1.6-2.3,2,2-3,2-5,2.3,2.3-3.0,3-4,3.5-8,35-60,4-6,5-15,7.5-15,9-15,abaxially,abruptly,acuminate,acute,anther,anticlinal,apex,apically,arising,attenuate,axil,basal,base,basiscopically,broadly,brown,calyx,capitate,cm,conical,decurrent,deltate,densely,diameter,drying,elliptic,enlarged,extremely,filament,filiform,fruit,fruiting,glabrous,globose,green,half,hollow,irregular,lateral,leaf,leaflet,lobe,long,lower,markedly,minutely,mm,narrowing,oblique,obovate,occasionally,onto,ovoid-reniform,pair,papillose,pedicel,per,petiole,petiolule,pinnate,plant,pointed,poricidal,projection,pubescence,pubescent,rachi,seed,shape,shrub,sinuous,slightly,smaller,smooth,somewhat,stigma,style,surface,terminal,thickening,tip,tube,usually,variable,white-lenticellate,winged,without,woody,x	0.5-1,1-2,10-50,100,2-14,5-10,7-25,adaxially,age,always,anthesi,axillary,bearing,berry,cateniform,cell,clavat,colony,cone,dry,eaf,edicel,eed,entire,epidermal,exserted,flower,free,glabrescent,growing,included,lamina,large,much,nflorescence,noddin,often,once-branched,open,opposite,ovary,perfectly,place,portion,primary,pubescen,purple,rarely,reflecting,rest,ruit,scar,short-styled,similar,simple,single-stemmed,small,sparsely,tall,tem,trichome,tub,ud,unifoliat,uniseriate,unit,vein,white,wider,ympodial	arrangement,bud,clavate,colour,form,growth,height,history,inflorescence,length,life,nodding,number,perennial,size,stem,texture	-10,0.05,0.5-5,0.8-1,0.8-1.2,1,1-1.2,1-1.5,1-8,1.6-2.3,2,2-3,2-5,2.3,2.3-3.0,3-4,3.5-8,35-60,4-6,5-15,7.5-15,9-15,abaxially,abruptly,acuminate,acute,anticlinal,apically,arising,attenuate,axil,basiscopically,broadly,brown,capitate,cm,conical,decurrent,deltate,densely,diameter,elliptic,enlarged,extremely,filiform,glabrous,globose,green,half,hollow,irregular,lateral,long,lower,markedly,minutely,mm,narrowing,oblique,obovate,occasionally,onto,ovoid-reniform,pair,papillose,pedicel,pinnate,pointed,poricidal,projection,pubescent,rachi,shrub,sinuous,slightly,smaller,smooth,somewhat,thickening,tip,usually,variable,white-lenticellate,winged,without,woody,x	clavate,nodding,perennial
323	wfo-0001029601	success	187	118	75	93	94	25	70	5	0-37,0.2-0.8,0.5-5.8,1-2,1-3,1-4,1.1-2.7,1.7-6.5,2,2-12,2-7,2-9,2.3-5.9,2.8-10.5,3-10,3-7,4-13.5,5-41,6-10,6.6-22,6.8-14.5,abaxially,adaxially,anther,berry,blade,borne,brownish,clavate,cm,condition,connivent,coriaceous,corolla,dark,diameter,dot,drying,elliptic,end,filament,flower,forked,fresh,fruit,glabrous,globose,green,green-white,greenish,herb,homostylous,interjected,lanceolate,lateral,leaf,leaflet,light,lobe,long,mm,mucilaginous,narrow,odd-pinnate,ovate,ovoid,pair,pedicel,peduncle,pentagonal,petiole,plant,puberulent,ripe,rotate,seed,singly,size,small,stigma,straight,style,terminal,throughout,tube,tuber,typically,wet,white,whitish,wing,x,yellow	0.5-8,1-53,1.2-2.3,2-3,2.2-4.5,3-5,5-merou,abaxiall,acumen,acuminate,acute,ag,alyx,apart,apex,apparently,articulated,asymmetric,attenuate,axe,axillary,base,basiscopic,bud,capitat,cell,covering,decreasing,digestion,distal,dorsally,eaf,edge,eed,enzyme,erec,exceeding,flat,folded,geminat,generally,glabrescent,glabrou,hair,hair-like,half,honeycomb-shaped,larger,lengthening,linear,living,lower,make,middl,middle,nflorescence,orbicular,orolla,perfect,petiolulate,plurifoliate,pore,poricidal,removed,rounded,ruit,sessile,seudostipule,short,side,slightly,slit,spaced,specimen,stamen,stolo,subequal,subglabrou,subtending,tall,tamen,tem,testal,thick,tip,tissue,toward,tri-,unit,unwinged,usually,vary,wall,ympodial	5-merous,abaxial,adaxial,arrangement,calyx,capitate,colour,erect,form,growth,height,history,inflorescence,length,life,ovary,presence,pseudostipule,shape,stem,stolon,subglabrous,surface,texture,type	0-37,0.2-0.8,0.5-5.8,1-2,1-3,1-4,1.1-2.7,1.7-6.5,2,2-12,2-7,2-9,2.3-5.9,2.8-10.5,3-10,3-7,4-13.5,5-41,6-10,6.6-22,6.8-14.5,abaxially,adaxially,berry,borne,brownish,clavate,cm,condition,connivent,coriaceous,dark,diameter,dot,drying,elliptic,end,forked,fresh,glabrous,globose,green,green-white,greenish,herb,homostylous,lanceolate,light,long,mm,mucilaginous,narrow,odd-pinnate,ovate,ovoid,pentagonal,puberulent,ripe,rotate,singly,small,straight,terminal,throughout,typically,wet,white,whitish,x,yellow	5-merous,capitate,erect,stolon,subglabrous
324	wfo-0001029621	success	165	115	72	86	79	29	70	2	0.5-0.75,0.5-1.2,0.7-1.1,0.8-1,0.8-4.5,1-1.5,1-2,1.5-2,1.5-5,2/3,3-3.5,6-20,6-8,7-9,acute,anther,apex,area,attenuate,bark,base,becoming,berry,branched,brown,calyx,cm,corolla,cup-shaped,dark,decurrent,dia,dry,ellipsoid,erect,filament,fruit,fruiting,glabrous,globose,green,lanceolate,late,later,lateral,leaf,live,main,many,margin,material,merely,minutely,mm,oblanceolate,often,ovary,ovoid-reniform,pair,pale,pedicel,pitted,plant,puberulent,ripe,sessile,shaped,shrub,stem,stigma,style,surface,tan,tear-drop,terminal,time,tip,tube,vein,way,white,whorl-like,widened,x,yellow,yellowish	.1,0.5-1,0.5-1.5,1.5-2.5,1/3,2.5-3,3.5-4.5,5-20-flowered,accrescent,along,anthesi,apar,appearing,appressed,beneath,borne,caudate,cluster,completely,constricted,course,deltoid,densely,distal,eaf,edicel,eed,elongate,enclosed,exsertio,fleshy,free,geminate,glabrate,irregularly,like,lobe,lobed,lon,long,lower,middle,nflorescence,occasionally,older,onto,papillate,papillo,papillose,planar,plurifoliat,pore,poricidal,portion,prominent,quite,rarely,reddish,reddish-gre,river,ruit,scar,shiny,small,somewhat,spaced,ste,straight,tall,tapering,thick,trichome,ud,uniseriate,unit,widest,woody,ympodial,young	arrangement,branch,bud,characteristic,colour,corrugation,diameter,drying,exertion,form,glabrousnes,growth,height,history,inflorescence,length,life,lobing,na,new,peduncle,petiole,primary,reddish-grey,seed,shape,size,texture,type	0.5-0.75,0.5-1.2,0.7-1.1,0.8-1,0.8-4.5,1-1.5,1-2,1.5-2,1.5-5,2/3,3-3.5,6-20,6-8,7-9,acute,area,attenuate,base,becoming,berry,branched,brown,cm,cup-shaped,dark,decurrent,dia,dry,ellipsoid,erect,glabrous,globose,green,lanceolate,late,later,lateral,live,main,many,material,merely,minutely,mm,oblanceolate,often,ovoid-reniform,pair,pale,pitted,plant,puberulent,ripe,sessile,shaped,shrub,style,tan,tear-drop,terminal,time,tip,vein,way,white,whorl-like,widened,x,yellow,yellowish	na,reddish-grey
325	wfo-0001029622	success	182	105	62	75	107	30	57	5	.1,.5,/3,0.5-1,0.8-1,1-1.2,1-4,1.5,2-11,3-4,30-35,45-50,5-6,abaxially,acute,adaxially,anther,apex,attenuate,base,beneath,bud,calyx,chartaceous,cm,consisting,corolla,deflexed,diameter,elliptic,elongate,entire,filament,flower,fruit,fruiting,glabrous,globose,green,included,inflorescence,leaf,lobe,long-acuminate,margin,mm,narrowly,obconic,oblong,onto,ovate,pair,pedicel,peduncle,petiole,reddish,rounded,sagittate,shiny,shrub,simple,single,size,slightly,stem,stigma,style,tapering,tip,tube,vein,way,white,within,x	.2,0.3,0.5,0.5-0.7,0.6-0.9,1-1.5,1-2.7,2-4,2-5,2.5-3,3-5,4-6.5,40,7-11,absent,accrescent,ag,alyx,anthesi,apparently,appearing,arising,axe,axil,bark,blade,brown,capitat,connivent,cylindrical,deciduous,differing,difoliate,dimorphic,eaf,eed,except,free,geminate,glabrou,ilament,immature,interlaced,internodal,jointed,known,lamina,lateral,less,lobed,long,long-triangular,longitudinal,m.,main,major,mature,measured,midrib,minor,minute,minutely,nflorescence,occasionally,often,older,one,opening,opposite,orolla,oung,ovate-lanceolate,papillose,pendent,pore,portion,present,probably,rachi,raised,reflexed,remaining,ruit,scar,second,shaped,slende,slender,slit,somewhat,stellate,straight,tal,tear-drop,thin,thus,trichome,tuft,ud,unarme,unifoliat,uniseriate,unit,vary,yellow,ympodial,young	.5-1,arrangement,berry,branch,capitate,characteristic,colour,drying,exertion,form,glabrousnes,growth,height,history,length,life,lobing,na,new,number,ovary,per,plant,primary,seed,shape,surface,texture,type,unarmed	.1,.5,/3,0.5-1,0.8-1,1-1.2,1-4,1.5,2-11,3-4,30-35,45-50,5-6,abaxially,acute,adaxially,attenuate,base,beneath,calyx,chartaceous,cm,consisting,deflexed,diameter,elliptic,elongate,entire,flower,glabrous,globose,green,included,lobe,long-acuminate,mm,narrowly,obconic,oblong,onto,ovate,pair,petiole,reddish,rounded,sagittate,shiny,shrub,simple,single,slightly,tapering,tip,way,white,within,x	.5-1,berry,capitate,na,unarmed
326	wfo-0001029625	success	166	158	125	135	31	23	122	3	..,.1-0.2,.5,0.5-1.3,0.5-2,0.5-2mm,0.8-1.4,0.8-1.8,1-1.5,1-2,1-3,1.2-1.6,2,2.5-.,3,3-3,3-3.5,3-5-8,4-10,4-4,4-5-celled,4-7-celled,4-9,5,5-10-15,5-6,6-9,9-25,abaxial,along,anther,anthesi,apical,bark,base,beneath,branch,branched,calyx,cell,cm,conical,corolla,cucullate,darker,deflexed,deltate,densely,denser,diameter,distinct,elliptic,erect,filament,flattened,four,fruit,fruiting,glabrescent,glabrous,gland,gland-tipped,globose,green,greenish,growth,herb,hyaline,inflorescence,lamina,later,lighter,like,lobe,lobed,long,margin,markedly,middle,midline,mixed,mm,narrowly,nearly,occasionally,outer,outline,ovary,ovate-reniform,pair,pale,papillate,pedicel,peduncle,per,planar,point,pointed,pubescent,purplish,rarely,reddish,regularly,scattered,shrub,single,sinuate,slightly,small,smooth,sparsely,stem,stigma,striate,stripe,strongly,style,surface,tan,testa,time,tinged,tip,triangular,trichome,tube,tuft,uniseriate,vein,wall,weight,white,without,x,young	0.5-1,100,8-13,branc,brittle,brow,capitat,cel,deflexe,dry,eaf,edicel,eed,flower,frui,glandular,lower,minute,new,nflorescence,open,pericarp,plurifoliat,primary,ruit,scar,single-stemmed,thin,ud,unit,ympodial	adaxial,arrangement,brown,bud,capitate,characteristic,colour,form,glabrousnes,hair,height,history,leaf,length,life,lobing,plant,plurifoliate,seed,shape,size,texture,type	..,.1-0.2,.5,0.5-1.3,0.5-2,0.5-2mm,0.8-1.4,0.8-1.8,1-1.5,1-2,1-3,1.2-1.6,2,2.5-.,3,3-3,3-3.5,3-5-8,4-10,4-4,4-5-celled,4-7-celled,4-9,5,5-10-15,5-6,6-9,9-25,abaxial,along,anther,anthesi,apical,base,beneath,branched,cell,cm,conical,cucullate,darker,deflexed,deltate,densely,denser,diameter,distinct,elliptic,erect,filament,flattened,four,fruit,glabrescent,glabrous,gland,gland-tipped,globose,green,greenish,herb,hyaline,inflorescence,lamina,later,lighter,like,lobe,lobed,long,margin,markedly,middle,midline,mixed,mm,narrowly,nearly,occasionally,outer,outline,ovate-reniform,pair,pale,papillate,per,planar,point,pointed,pubescent,purplish,rarely,reddish,regularly,scattered,shrub,single,sinuate,slightly,small,smooth,sparsely,striate,stripe,strongly,surface,tan,testa,time,tinged,tip,triangular,trichome,tuft,uniseriate,vein,wall,weight,white,without,x,young	brown,capitate,plurifoliate
327	wfo-0001029645	success	160	129	92	103	57	26	90	2	.5-1,0.2-0.5,0.5-2.5,0.5-7,1,1-2,1-4,1.3-7,1.5,1.5-2,2-4,2.5-17,3-10,3-15,3-7,3.5-4,337,5,5-8,6-12,7-12,750,?,abaxially,acuminate,acute,adaxially,anther,apart,apex,articulated,base,blue,brown,calyx,chartaceous,cm,corolla,cuneate,cylindrical,deltate,diameter,distally,entire,et,except,extra-axillary,fide,filament,finger,flattened,flower,fruit,glabrous,gland-tipped,globose,green,greenish,hair,herb,immature,kayap,line,lobe,margin,membranaceous,minutely,mm,moderately,nearly,obtuse,ovate,ovate-elliptic,pedicel,peduncle,petiole,puberulent,purple,rachi,radiu,rarely,red,rotate-stellate,rugose-verrucate,sagittate,short,short-tomentose,simple,smith,sparsely,stigma,strongly,style,subcordate,tapered,triangular,truncate,tube,unbranched,white,x,yellow,Â±	-1,0.3-0.5,1-1.5,2-3-foliat,2.5-4,4-5,4-8,abundantly,aggregate,along,around,axe,ba,blade,cell,connivent,decurrent,directed,distall,eaf,eed,free,glabrou,inserted,knapp,long,lower,major,mesocarp,nflorescence,orolla,part,perfect,pore,puberulen,ruit,sand-punctate,shorter,shru,side,small,spaced,stone,tal,tamen,tem,thecae,tightly,time,tomento,truncat,unit,vary,vein,veiny,wide,ympodial	0.5-1,abaxial,adaxial,arrangement,articulation,characteristic,colour,form,growth,height,history,inflorescence,leaf,length,life,ovary,plant,seed,shape,shrub,size,spacing,stem,surface,texture,type	.5-1,0.2-0.5,0.5-2.5,0.5-7,1,1-2,1-4,1.3-7,1.5,1.5-2,2-4,2.5-17,3-10,3-15,3-7,3.5-4,337,5,5-8,6-12,7-12,750,?,abaxially,acuminate,acute,adaxially,apart,apex,articulated,base,blue,brown,chartaceous,cm,cuneate,cylindrical,deltate,distally,entire,et,except,extra-axillary,fide,finger,flattened,flower,glabrous,gland-tipped,globose,green,greenish,hair,herb,immature,kayap,line,lobe,margin,membranaceous,minutely,mm,moderately,nearly,obtuse,ovate,ovate-elliptic,puberulent,purple,radiu,rarely,red,rotate-stellate,rugose-verrucate,sagittate,short,short-tomentose,simple,smith,sparsely,strongly,subcordate,tapered,triangular,truncate,unbranched,white,x,yellow,Â±	0.5-1,shrub
328	wfo-0001029646	success	141	108	71	78	63	30	67	4	0.1-0.6,0.5-0.8,0.7-2.2,1-4,1.5-2,10-15,2-3,4-5.5,5-15,6-8,acuminate,acute,apex,apical,apically,attenuate,base,branched,calyx,cell,cm,corolla,covering,cyme,dehiscent,diameter,dichasial,dichasially,ebracteate,elliptic,epiphytic,filament,finely,free,globose,green,hair-like,herbaceous,introrse,lateral,leaf,linear,lobe,long,make,maturing,mm,monochasial,mucilaginous,mucronate,narrowly,often,ovate,ovoid,pedicel,peduncle,perennial,petiole,plant,poricidally,pubescent,seed,short,simple,slit,stellate,stigma,straight,style,testal,thick,throughout,tone,typically,unit,wall,white,yellow-green	0.5,1.5-4.9,3-14,3-6-foliat,7-15,abaxially,acumen,adaxially,articulate,commonly,digestion,distal,dorsally,eaf,edge,eed,emoval,enzyme,equaling,flat,flower,folded,forked,generally,globo,green-white,ground,growing,half,honeycomb,living,lon,lower,mos,mould,nflorescence,nther,oak,orolla,ovat,pattern,perfect,pine,plan,proximal,rarely,reveal,ruit,seudostipule,specimen,stamen,tall,tem,throughou,tree,tuber-bearing,vary,viole,wide,without,yellow,ympodial,Â¼	3-6-foliate,abaxial,adaxial,anther,arrangement,branch,characteristic,colour,dehiscence,form,fruit,glabrousnes,growth,height,history,inflorescence,length,life,new,ovary,pseudostipule,shape,size,stem,surface,sympodial,texture,type,violet,wet	0.1-0.6,0.5-0.8,0.7-2.2,1-4,1.5-2,10-15,2-3,4-5.5,5-15,6-8,acuminate,acute,apical,apically,attenuate,branched,cell,cm,covering,cyme,dehiscent,diameter,dichasial,dichasially,ebracteate,elliptic,epiphytic,finely,free,globose,green,hair-like,herbaceous,introrse,lateral,linear,long,make,maturing,mm,monochasial,mucilaginous,mucronate,narrowly,often,ovate,ovoid,perennial,poricidally,pubescent,seed,short,simple,slit,stellate,stigma,straight,style,testal,thick,throughout,tone,typically,unit,wall,white,yellow-green	3-6-foliate,sympodial,violet,wet
329	wfo-0001029652	success	160	108	70	85	75	23	69	1	.5,0.5-4,0.8-1,1-3,1.5-2,2-2.5,2-4,3/4,4-4.5,6-15,7-9,abaxially,adaxially,along,anther,apex,attenuate,bark,base,berry,calyx,cm,corolla,curling,deflexed,drying,elliptic-ovate,exserted,filament,filiform,fruiting,glabrous,globose,golden,golden-red,green,greenish-white,hispid,lateral,leaf,lobed,long,long-acuminate,long-styled,main,margin,middle,minute,minutely,mm,narrowly,near,occasionally,ovary,ovoid-reniform,pair,pale,papillose,pedicel,petiole,pitted,pubescent,reddish-brown,shaped,short-styled,shrub,simple,size,slender,stem,stigma,style,surface,tan,tear-drop,tip,trichome,tube,undulate,uniseriate,vein,way,white,widest,x	.25,.3,0.5-1,0.75-1,1,1-2,2,2.5-3,25,3.5-4,anthesi,apar,ape,apical,arch,arching,ba,bearing,broadly,cone,conical,deciduous,deltate,denser,dia,differing,difoliate,eaf,edicel,eed,evenly,flower,free,geminat,hard,heteromorphic,included,joining,lamina,like,lobe,lon,lower,major,maturity,midrib,minor,nflorescence,older,opposite,papillo,pericarp,pore,poricidal,portion,projection,reflexed,ruit,scar,series,slende,slightly,soon,spaced,sparsely,swollen,tall,thickened,time,tub,ud,unit,within,ympodial,young	arrangement,bud,characteristic,colour,diameter,exertion,form,fruit,growth,height,history,inflorescence,length,life,lobing,na,peduncle,plant,primary,seed,shape,texture,type	.5,0.5-4,0.8-1,1-3,1.5-2,2-2.5,2-4,3/4,4-4.5,6-15,7-9,abaxially,adaxially,along,apex,attenuate,base,berry,calyx,cm,curling,deflexed,elliptic-ovate,exserted,filiform,glabrous,globose,golden,golden-red,green,greenish-white,hispid,lateral,lobed,long,long-acuminate,long-styled,main,middle,minute,minutely,mm,narrowly,near,occasionally,ovoid-reniform,pair,pale,papillose,pitted,pubescent,reddish-brown,shaped,short-styled,shrub,simple,slender,tan,tear-drop,tip,trichome,tube,undulate,uniseriate,vein,way,white,widest,x	na
330	wfo-0001029673	success	159	104	69	84	75	20	69	0	.5,0.5-1,0.7-1.1,0.8-1,1-10,1-2,1-5,1.2-3.5,1.5-1.8,1.5-2,4-6,5.5-15,absent,acuminate,acute,age,anther,anthesi,apex,appearing,base,becoming,berry,black,branch,calyx,clavate,cm,corolla,deep,dendritic,densely,diameter,elliptic,exserted,filament,fork,fruit,fruiting,glabrous,globose,greyish,greyish-yellow,growth,later,lateral,leaf,length,lenticular,minutely,mm,narrowly,occasionally,ovary,overtopping,pedicel,petiole,pitted,planar,plurifoliate,pore,poricidal,pubescent,purple,reddish-brown,reflexed,shoot,shrub,slightly,slit-like,small,sparsely,stem,stigma,strongly,style,surface,terminal,tip,tree,trichome,tube,violet,x	0.75-1,10-20,2-2.5,2-3,2-4,2.5,3-5,3/4,5-25,abaxial,abaxially,accrescent,adaxial,adaxially,along,apical,bark,basal,blade,branching,broadly,conical,decurrent,deflexed,deltoid,denser,dichasia,eaf,edicel,eed,ew,flower,free,greyish-yello,individual,inserted,lamina,like,lobe,lon,long,longer,lower,m.,monochasial,nflorescence,nodding,older,pair,papillo,pericarp,petal,portion,prominent,pyramidal,ruit,scar,secondary,sleeve,somewhat,stamen,tall,tapering,thin,time,triangular,tub,ud,unit,vein,wide,winged,woody,ympodial,young	arrangement,bud,characteristic,colour,exertion,form,glabrousnes,height,history,inflorescence,life,lobing,new,peduncle,plant,seed,shape,size,texture,type	.5,0.5-1,0.7-1.1,0.8-1,1-10,1-2,1-5,1.2-3.5,1.5-1.8,1.5-2,4-6,5.5-15,absent,acuminate,acute,age,anthesi,apex,appearing,base,becoming,berry,black,branch,calyx,clavate,cm,deep,dendritic,densely,diameter,elliptic,exserted,fork,glabrous,globose,greyish,greyish-yellow,later,lateral,lenticular,minutely,mm,narrowly,occasionally,overtopping,pitted,planar,plurifoliate,pore,poricidal,pubescent,purple,reddish-brown,reflexed,shoot,shrub,slightly,slit-like,small,sparsely,strongly,terminal,tip,tree,trichome,tube,violet,x	
331	wfo-0001029680	success	212	116	85	99	113	17	85	0	0.1,1.0â1.1,1.0â1.5,1.1â1.2,1.4â7.5,1.7â7,11â16,11â25,12,1â2,3â6,4.0â16,4.0â6.5,4.5â20,4.5â7.0,50,5â11,8â32,acute,annual,anther,anthesi,apex,axillary,base,becoming,bipinnate,blue,borne,branched,brown,calyx,clavate,cm,connivent,decurrent,diameter,divided,filament,flattened,fleshy,flower,fruit,glabrous,globose,green,herb,indistinct,leaf,length,light,long,margin,mm,oblong,obovate,obtuse,ovate,pair,pale,pedicel,peduncle,pentagonal,petiole,pinnae,pinnate,pitted,poricidal,primary,pubescent,purple,rarely,red,ripe,rotate,shallowly,shoot,size,sometimes,sparsely,stem,stigma,style,surface,terminal,time,tip,tripinnate,turning,violet,white,winged,woody,x,yellow,â10,â12.5,â19,â3	.0,0.4,0.5â1.5,0.6,0.6â1.2,0.6â2.0,0.9â1.0,1,1.0,1.0â1.8,1.4â2.5,1.5,1.6â2.7,1.8â3.8,10,1â3,1â6,1â8,2.2â4.2,2â20,3.0â4.2,3.3â5.5,3â22,4â10,4â30,5,5.5â8.5,7â10,abaxially,absen,adaxiall,adaxially,ag,along,apart,appressed,arequipa,arranged,articulated,asymmetrically,axe,ba,beyond,blade,cell,cylindrical,decreasing,densely,difoliate,eaf,eed,entire,equal,erect,extending,flange,forming,geminat,hair,irregularly,lobe,lon,longitudinal,lower,m.,midrib,moderately,multicellular,narrow,nflorescence,node,occasionally,often,opening,orolla,parallel,pendant,perfect,plurifoliate,pore,prostrate,rapidly,ruit,running,secondary,shaped,side,simple,spaced,specimen,split,stone,straight,subglabrous,tacna,tal,tamen,tear-drop,tem,tertiary,tube,unicellular,uniseriate,unit,usually,vary,wide,wing,winge,ympodial,â3.2,â46,â48	arrangement,characteristic,colour,corolla,form,growth,height,history,inflorescence,life,lobing,ovary,plant,seed,shape,texture,type	0.1,1.0â1.1,1.0â1.5,1.1â1.2,1.4â7.5,1.7â7,11â16,11â25,12,1â2,3â6,4.0â16,4.0â6.5,4.5â20,4.5â7.0,50,5â11,8â32,acute,annual,anthesi,axillary,base,becoming,bipinnate,blue,borne,branched,brown,clavate,cm,connivent,decurrent,diameter,divided,flattened,fleshy,flower,fruit,glabrous,globose,green,herb,indistinct,light,long,mm,oblong,obovate,obtuse,ovate,pair,pale,pentagonal,petiole,pinnae,pinnate,pitted,poricidal,primary,pubescent,purple,rarely,red,ripe,rotate,shallowly,shoot,sometimes,sparsely,terminal,time,tip,tripinnate,turning,violet,white,winged,woody,x,yellow,â10,â12.5,â19,â3	
332	wfo-0001029704	success	144	106	70	80	64	26	67	3	0-1.5,1-2,1.5-2.5,1.5-3,1000-1200,15-25,2-2.5,2-3,3-4-celled,3-5,4,5,7-10,9-20,acuminate,acute,along,anther,apex,base,berry,blue,branch,broadly,brown,cm,composed,conical,corolla,cuneate,cut,dark,deeply,dia,ellipsoid,extra-axillary,few-flowered,filament,flower,fork,fruiting,globose,green,leaf,midrib,minute,minutely,mm,mottled,obovate,obovoid,occasionally,one,ovary,pedicel,peduncle,petiole,pinnatisect,poricidal,pubescent,purple,record,reddish,reticulate,shrub,simple,single,stigma,stout,striped,style,subdiscoidal,surface,tip,trichome,variously,vein,white,within,x	.5,0.5,1,1-4,1.5,1.5-2.5-3,140-185,2-5,4-7,7-10-14-17,acuman,also,anthesi,apparently,aspect,axi,c.,calyx,cell,cunate,deflexed,diam,eaf,eed,enlarged,erect,especially,exerted,flowering,glabrous,gradually,halfway,lanceolate,lengthening,less,lobe,lobed,long,lower,moderately,nflorescence,plurifoliat,pore,rounded,ruit,shoot,short,sinus,slit,sombre,sprawling,stellate,stone,straight,subglobo,swollen,tub,tube,twig,ud,unit,variable,ympodial,young	arrangement,bud,characteristic,colour,diameter,form,fruit,growth,height,history,inflorescence,length,life,margin,number,per,perennial,plant,plurifoliate,seed,shape,size,stem,subglobose,texture,type	0-1.5,1-2,1.5-2.5,1.5-3,1000-1200,15-25,2-2.5,2-3,3-4-celled,3-5,4,5,7-10,9-20,acuminate,acute,along,berry,blue,branch,broadly,brown,cm,composed,conical,cuneate,cut,dark,deeply,dia,ellipsoid,extra-axillary,few-flowered,flower,fork,globose,green,midrib,minute,minutely,mm,mottled,obovate,obovoid,occasionally,one,pinnatisect,poricidal,pubescent,purple,record,reddish,reticulate,shrub,simple,single,stout,striped,subdiscoidal,surface,tip,trichome,variously,vein,white,within,x	perennial,plurifoliate,subglobose
333	wfo-0001029727	success	257	113	72	92	165	21	71	1	-3,/3,0-30,0-4,0.4-1,0.7-0.9,1-1.2,1-4,1.5-5.5-10,1.6-3,1/3-1/2,2.5-3.2,2.8-4,3-11,3-6,acuminate,acute,anther,anthesi,apex,apparently,articulated,bark,base,berry,brown,calyx,chartaceous,clavate,climber,cm,colourles,cordate,corolla,cupular,densely,diameter,drying,erect,filament,finely,flattened-reniform,glabrous,lateral,leaf,length,lobed,long,margin,mauve,mm,obconical,oblong,occasional,orange-brown,ovate,pair,papillose,pedicel,peduncle,per,petiole,pitted,poricidal,prickly,primary,red-brown,reddish,rounded,seed,shallowly,shape,shrub,simple,size,smooth,stellate,stellate-pubescent,stem,stigma,style,subentire,surface,tapering,terminal,tip,trichome,tube,vein,way,wide,yellowish	.5,0-15,0-2,0-20,0-40,0-5,0-8,0.1-5,0.15-0.2,0.15-0.3,0.2,0.2-0.5,0.2-2.5,0.3,0.4,0.5,0.5-1.2,0.5-3,0.7-1,1,1-2,1-2-5,1.2-2,1.5-2.3,1.5-2.5,1.5-3,1/2-2/3,1/4,1/8-1/5-1/3,2.5,2.5-5.5,3-7,3/,4-7,4-merou,4-merous,4.5,4.5-5.5-7,5-12,5-8,5-9,5.5-7,6-11,7-10,abaxial,abaxially,acicular,adaxial,age,almost,along,alternate,alyx,ame,apar,apart,apically,blade,branched,bristle,c.,connivent,covered,curved,darker,deltate,deltoid,developing,different,dimorphic,discolorous,divided,eaf,edge,eed,elongating,equal,except,extending,ferrugineous,filiform,filiform-acuminat,fissure,flower,free,geminate,increasing,inside,lengthening,less,like,lobe,lon,longer,lower,m.,mature,middle,midpoint,midvein,minor,minutely,mixture,moderately,narrow-deltate,nflorescence,nther,older,one,open,orolla,oung,outside,papillo,perfec,perfect,pit,plurifoliat,pore,porrect,portion,prickl,prickle,protruding,pubescent,raised,rarely,ray,red-brow,reduced,regular,scandent,scar,series,sessile,short,sinus,sometimes,spaced,spreading,stalk,stalked,straight,strongly,tamen,tearing,terete,tertiary,time,toward,translucent,transverse,unarmed,uneven,unit,upper,variable,variously,vary,venation,violet,visible,x,ympodial,young	arrangement,branch,characteristic,colour,exertion,form,fruit,glabrousnes,growth,height,history,inflorescence,life,lobing,new,number,ovary,perennial,plant,texture,type	-3,/3,0-30,0-4,0.4-1,0.7-0.9,1-1.2,1-4,1.5-5.5-10,1.6-3,1/3-1/2,2.5-3.2,2.8-4,3-11,3-6,acuminate,acute,anthesi,apparently,articulated,base,berry,brown,chartaceous,clavate,climber,cm,colourles,cordate,corolla,cupular,densely,diameter,drying,erect,finely,flattened-reniform,glabrous,lateral,lobed,long,mauve,mm,obconical,oblong,occasional,orange-brown,ovate,pair,papillose,per,pitted,poricidal,prickly,red-brown,reddish,rounded,shallowly,shrub,simple,smooth,stellate,stellate-pubescent,subentire,tapering,terminal,tip,trichome,way,wide,yellowish	perennial
334	wfo-0001029731	success	246	129	90	103	143	26	88	2	.5,.6,1-2,1-2.5,1.5,1.5-2.5,10-20,2.5,2.5-4.5,3-4,31,4,6,6-7,7-11,8-9,acquiring,acuminate,acute,almost,along,anther,apex,apically,bark,base,berry,black,branch,branched,brown,calyx,clavate,cm,concolorous,conical,coriaceous,corolla,cuneate,diameter,dilated,distributed,drying,elliptic,entire,epiphyte,erect,evenly,exserted,filament,flaring,fruit,fruiting,glabrous,ground,lateral,leaf,liana,linear,lobed,long,long-ellipsoid,longitudinal,margin,maturity,mauve,midvein,mm,obconical,oblong,obovate,orange-brown,pedicel,peduncle,petiole,primary,pyriform,revolute,ribbed,ridge,ridged,rounded,several,slender,sometimes,sparsely,stem,stigma,style,succulent,surface,terminal,thick,toward,tube,vein,white,wide,widely,winged,woody,x,yellow-green	0.05,0.1-0.8,0.25-0.3,1,1-1.5,1.5-3,1/3,1994,2,2-3,2-6,3,3-10,4-5,4-9,abaxially,accrescent,adaxially,age,alyx,anthesi,apar,apparently,arcy,articulated,basal,basally,beak,becoming,boundary,branching,broadly,bumpy,clearly,connate,crinkled,darker,delimited,delineated,deltoid,dense,development,different,domatia,dorsal,dorsifixed,dry,dull,eaf,early,elongating,enlarge,equal,even,faint,filiform,fine,finely,flattened,fleshy,flower,free,hair,iscoid,lamina,large,later,lengthening,less,like,lobe,lon,longitudinally,lower,main,mature,much,narrowly,nflorescence,nther,obtuse,occasionally,often,orolla,pair,papillae,papillose,part,pendulous,perfec,pericarp,persisting,plurifoliat,pore,poricidal,portion,prominent,protruding,rachi,raised,rakotozafy,rarely,reflexed,reported,ruit,scar,see,shallowly,shorter,simple,sinus,slightly,small,smaller,smoot,straight,stretched,stump,sunk,tearing,thickened,thinner,though,time,tip,trichome,tub,tuft,ud,unit,usually,vary,venation,ventral,visibl,visible,well-developed,wing,wrinkling,yellow,ympodial,young,â	arrangement,bud,characteristic,colour,exertion,form,glabrousnes,growth,height,history,inflorescence,length,life,lobing,na,new,number,ovary,per,plant,seed,shape,size,smooth,texture,type	.5,.6,1-2,1-2.5,1.5,1.5-2.5,10-20,2.5,2.5-4.5,3-4,31,4,6,6-7,7-11,8-9,acquiring,acuminate,acute,almost,along,apex,apically,base,berry,black,branch,branched,brown,calyx,clavate,cm,concolorous,conical,coriaceous,corolla,cuneate,diameter,dilated,distributed,drying,elliptic,entire,epiphyte,erect,evenly,exserted,flaring,glabrous,ground,lateral,liana,linear,lobed,long,long-ellipsoid,longitudinal,maturity,mauve,midvein,mm,obconical,oblong,obovate,orange-brown,pyriform,revolute,ribbed,ridge,ridged,rounded,several,slender,sometimes,sparsely,succulent,surface,terminal,thick,toward,tube,white,wide,widely,winged,woody,x,yellow-green	na,smooth
335	wfo-0001029741	success	137	102	71	85	52	17	69	2	.4,.5,0.9-1.2,1-3.5,1.1-1.3,1.5-4,1.5-6,10-50-flowered,2-2.5,2.5-7.8,3,9.5-22.5,?,accrescent,acute,age,anther,apex,attenuate,base,becoming,berry,black,calyx,capitate,cm,completely,corolla,dark,dia,drying,early,elliptic,exserted,filament,fruit,fruiting,furcate,glabrous,globose,green,growth,inflorescence,leaf,lenticellate,lighter,lobe,lobed,long,middle,minutely,mm,nearly,new,opposite,ovary,ovate,papillose,pedicel,petiole,pore,poricidal,proximal,quite,shaped,shrub,size,slender,slightly,stem,stigma,straight,style,tapering,tear-drop,tip,tree,tube,usually,variable,weak,white,widest,woody,x	0.5-1.5,0.8-3.5,1-1.5,1.5,2.2-9,anthesi,apiculate,branched,ca,caly,closely,deflexed,deltoid,differing,difoliate,divisio,dry,eaf,edicel,eed,erect,flower,free,geminat,glabrou,immature,known,lateral,lon,lower,main,major,minor,nflorescence,overlapping,pair,papillo,planar,portion,produced,prominent,raised,reddish-brown,ruit,scar,spaced,tall,ud,unit,vein,wood,ympodial	arrangement,bud,characteristic,colour,diameter,exertion,form,glabrousnes,height,history,length,life,lobing,plant,shape,texture,type	.4,.5,0.9-1.2,1-3.5,1.1-1.3,1.5-4,1.5-6,10-50-flowered,2.5-7.8,3,9.5-22.5,?,accrescent,acute,age,attenuate,base,becoming,berry,black,calyx,capitate,cm,completely,dark,dia,drying,early,elliptic,exserted,fruit,furcate,glabrous,globose,green,leaf,lenticellate,lighter,lobed,long,middle,minutely,mm,nearly,opposite,ovate,papillose,pore,poricidal,proximal,quite,shaped,shrub,size,slender,slightly,straight,tapering,tear-drop,tip,tree,tube,usually,variable,weak,white,widest,woody,x	-2.5,di
336	wfo-0001029744	success	113	82	53	65	48	17	51	2	0.3-0.6,1.5,2-4,5-8,50,8-10-flowered,acute,apart,apex,bark,base,blunt,branch,calyx,cm,deltate,densely,difoliate,elliptic,entire,extreme,flattened,flexuous,form,fruit,geminate,glabrescent,glabrous,golden,incrassate,lanceolate,leaf,lobe,long-acuminate,margin,minutely,mm,narrowly,oblanceolate,oblique,occasionally,older,ovoid-reniform,pale,pedicel,petiole,pitted,pubescent,revolute,scar,shape,shrub,simple,single-celled,slightly,sometimes,somewhat,stem,surface,thin,tip,trichome,unifoliate,uniseriate,young	0.5-1,1,1.5-3.2,2,7-15,8-11,abaxially,adaxially,along,beginning,brow,dendritic,denser,distinct,eaf,eed,examined,fide,inflorescenc,lamina,leave,looping,lower,major,marginal,mature,minor,nflorescence,node,non-reproductive,opposite,pair,primary,pubescence,see,similar,small,smaller,smith,spaced,thee,ud,unicellular,unit,vein,white,x,ympodial	3,abaxial,adaxial,arrangement,brown,characteristic,colour,growth,hair,height,inflorescence,length,plant,seed,spacing,texture,width	0.3-0.6,1.5,2-4,5-8,50,8-10-flowered,acute,apart,blunt,branch,cm,deltate,densely,difoliate,elliptic,entire,extreme,flattened,flexuous,geminate,glabrescent,glabrous,golden,incrassate,lanceolate,leaf,long-acuminate,minutely,mm,narrowly,oblanceolate,oblique,occasionally,older,ovoid-reniform,pale,pitted,pubescent,revolute,shrub,simple,single-celled,slightly,sometimes,somewhat,stem,thin,tip,unifoliate,uniseriate,young	3,brown
337	wfo-0001029746	success	179	116	81	96	83	20	80	1	0.7-1,1,1-1.3,1-1.5,1.2-1.5,1.5,2-2.5,2-7,2-8,3,3-4,4-9,8-11,acuminate,acute,anther,anthesi,apex,base,berry,broadly,brown,calyx,capitate,centre,cm,conical,cordate,corolla,crenate,cup-shaped,curved,dark,darker,densely,diameter,ellipsoid,enlarged,entire,erect,filament,flattened,fleshy,fruit,fruiting,glandular,globose,greenish,herb,heteromorphic,hollow,inflorescence,internodal,irregularly,leaf,less,lobe,margin,mature,minutely,mm,nodding,orange,ovary,ovate,ovoid,pale,papillose,pedicel,petiole,pitted,principal,pubescent,purple,red,reddish,reflexed,shallowly,simple,slender,slightly,somewhat,spreading,stem,stigma,strongly,style,subshrub,surface,tip,triangular,tube,upward,vein,x,â3	.5,0.3-2,0.5-1,2,2-4,3-4-pluri-foliate,3-4.5,3-6,6,6-7,8-10,abaxially,adaxially,age,apart,bearing,becoming,blackish,c.,cell,ciliate,color,crowded,eaf,edicel,eed,elliptic,exerted,flower,flush,free,glabrous,gland-tipped,growing,horn,lamina,lengthening,lon,long,longer,longest,lower,markedly,maturit,mid-length,mixed,narrowly,near,nflorescence,occasionally,pair,papillo,peduncle,pericarp,plan,pore,poricidal,portion,primary,pubescen,rachi,ruit,scar,shortest,single,slit,spaced,sparse,sparsely,straight,testal,thin,third,trichome,ud,uniseriate,unit,upper,wall,widely,widest,woody,ympodial	appearance,arrangement,bud,characteristic,colour,form,giving,growth,height,history,length,life,lobing,maturity,plant,seed,shape,size,texture,type	0.7-1,1,1-1.3,1-1.5,1.2-1.5,1.5,2-2.5,2-7,2-8,3,3-4,4-9,8-11,acuminate,acute,anthesi,berry,broadly,brown,capitate,centre,cm,conical,cordate,crenate,cup-shaped,curved,dark,darker,densely,diameter,ellipsoid,enlarged,entire,erect,flattened,fleshy,fruit,glandular,globose,greenish,herb,heteromorphic,hollow,internodal,irregularly,leaf,less,lobe,margin,mature,minutely,mm,nodding,orange,ovate,ovoid,pale,papillose,pitted,principal,pubescent,purple,red,reddish,reflexed,shallowly,simple,slender,slightly,somewhat,spreading,strongly,subshrub,tip,triangular,upward,vein,x,â3	maturity
338	wfo-0001029769	success	142	110	78	86	56	24	75	3	.25,.5,1-1.2,1-3,1.5-2,30-60-flowered,4,5-8,6-17,7-8,abaxially,acuminate,acute,adaxially,along,anther,anthesi,apex,bark,base,bearing,berry,branch,brown,calyx,capitate,cm,corolla,curl-tipped,dark,densely,dia,elliptic,exserted,flower,fresh,fruiting,glabrous,globose,golden,green,hen,horizontally,leaf,less,lobe,lobed,long,main,margin,midrib,minutely,mm,nearly,onto,ovary,ovoid-reniform,papillose,pedicel,petiole,pitted,puberulent,pubescent,reflexed,ried,scattered,shaped,shrub,simple,smooth,sparsely,stem,stigma,style,surface,tear-drop,three,time,tip,trichome,tube,two,uniseriate,vein,white,winged	0.5-1.5,1.5-2.5,2.5-3,2.5-8,3.5-4,4-5,8-9,8.5-17,apar,ape,archin,ba,brochidodromu,cerro,conical,cyathiform,deflexed,deltoid,eaf,edicel,eed,filament,filiform,free,inglÃ©,internodal,lateral,like,lon,lower,nflorescence,older,opposite,pair,papillo,pore,poricidal,portion,ruit,scar,somewhat,spaced,straight,swollen,tall,tub,ud,unevenly,unifoliat,unit,wide,widely,woody,x,ympodial,young	arching,arrangement,bud,characteristic,colour,diameter,exertion,form,fruit,growth,height,history,inflorescence,length,life,lobing,perennial,plant,seed,shape,size,texture,type,unifoliate	.25,.5,1-1.2,1-3,1.5-2,30-60-flowered,4,5-8,6-17,7-8,abaxially,acuminate,acute,adaxially,along,anthesi,apex,base,bearing,berry,brown,calyx,capitate,cm,curl-tipped,dark,densely,dia,elliptic,exserted,flower,fresh,glabrous,globose,golden,green,hen,horizontally,less,lobe,lobed,long,main,margin,midrib,minutely,mm,nearly,onto,ovoid-reniform,papillose,petiole,pitted,puberulent,pubescent,reflexed,ried,scattered,shaped,shrub,simple,smooth,sparsely,surface,tear-drop,three,time,tip,trichome,tube,two,uniseriate,vein,white,winged	arching,perennial,unifoliate
339	wfo-0001029780	success	204	101	65	82	122	19	63	2	1-1.2,1-2,1.4-1.9,11-24,15-22,15-45,2-2.5,2-2.8,2-3.5,2-5.5,2.4-4.2,3,3-6,3.5-7.3,4-6,4.5-6,5.5-13,8-12,abaxially,absent,adaxially,anther,berry,blade,brownish,chartaceous,cm,condition,corolla,decumbent,densely,diameter,drying,filament,fresh,fruit,glabrous,globose,green,green-white,greenish,herb,interjected,invested,lateral,leaflet,length,membranous,minute,minutely,mm,mucilaginous,non-glandular,odd-pinnate,ovoid,pale,pedicel,peduncle,petiole,pinkish,plant,puberulent,pubescent,rarely,rotate,seed,short,size,stem,stigma,streak,style,terminal,throughout,trichome,typically,unwinged,wet,white,whitish,x,yellow	1-10,1.5-2,120-210,2-12,20-60,5-7,5-merou,5.5,50-70,600-950,?,acumen,acute,ag,along,alyx,apart,apex,apparently,articulated,attenuate,axe,axillary,base,borne,bud,capitat,cell,ciliate,connivent,cordate,covering,cuneate,dark,digestion,distal,dorsally,eaf,edge,eed,end,enzyme,erec,especially,exceeding,except,flat,flower,folded,forked,geminat,generally,glabrou,gland,glandular,greatly,hair,hair-like,hal,half,head,high,homostylous,honeycomb-shaped,lanceolate,lengthening,like,living,lobe,long,longer,lower,make,margin,midrib,nflorescence,obtuse,often,orbicular,orolla,ovate,pair,perfect,petiolulate,petiolule,plurifoliate,pore,poricidal,proximal,reduced,removed,ripe,ruit,sessile,seudostipule,singly,slit,spaced,specimen,stamen,ste,stolo,straight,stripe,subequal,subtending,tall,tamen,tem,testal,tetralobulate,thick,tip,tri-,truncate,tube,tuber,unit,usually,vary,wall,ympodial	arrangement,calyx,capitate,colour,erect,form,growth,height,history,inflorescence,leaf,life,ovary,pseudostipule,pubescence,shape,surface,texture,type	1-1.2,1-2,1.4-1.9,11-24,15-22,15-45,2-2.5,2-2.8,2-3.5,2-5.5,2.4-4.2,3,3-6,3.5-7.3,4-6,4.5-6,5.5-13,8-12,abaxially,absent,adaxially,berry,brownish,chartaceous,cm,condition,decumbent,densely,drying,fresh,glabrous,globose,green,green-white,greenish,herb,invested,membranous,minute,minutely,mm,mucilaginous,non-glandular,odd-pinnate,ovoid,pale,pinkish,puberulent,pubescent,rarely,rotate,short,stem,streak,throughout,trichome,typically,unwinged,wet,white,whitish,x,yellow	capitate,erect
340	wfo-0001029784	success	229	116	72	89	140	27	69	3	.5,0.2-0.3,0.4-0.45,0.4-0.6,0.5-1.5,0.6-1,1-1.1,1-1.2,1-1.5,1-4,1.0-1.3,1.7-2.6,2,2-2.5-5,2/3,5-10-12,acuminate,acute,anther,anthesi,apex,articulated,base,berry,broadly,brown,calyx,capitate,cm,conical,corolla,crenate-serrate,dark,densely,diameter,distal,eglandular,elliptic,exserted,filament,flower,fruit,fruiting,globose,golden,green,hair-like,half,halfway,herb,imparipinnate,inflorescence,interrupted,lanceolate,like,long,margin,mm,narrowly,obovate,outgrowth,ovary,pale,pedicel,peduncle,perennial,petiole,plant,primary,proximal,pubescent,reflexed,simple,soft,sparsely,stem,stigma,stripe,strongly,style,surface,thick,trichome,truncate,tube,vein,velvety,wide,yellow	.1,.2,0-4,0.1-0.15,0.1-0.2-0.3,0.1-0.5,0.2,0.2-0.5,0.2-0.7-1.2,0.25-0.3,0.3-0.35,0.3-0.4,0.3-0.5,0.3-1,0.4-0.5,0.4-1-2,0.5,0.5-1.2-2.5,0.9-1.2,1,1-2,1-2-4.5,1-2-celled,1-2.5-3.5,1.5-3-5,1/3,2-3-celled,2-4,2-5-14,2-foliate,2-locular,3-5-8,abaxial,abaxially,absent,abundant,adaxially,adpressed,along,angled,apical,appearance,appendage,arising,articulation,axi,basal,basicopically,beneath,bract,cell,column,crenation,decurrent,deeper,developed,distributed,due,eaf,edicel,eed,enclosing,entire,evenly,giving,glabrescent,glabrous,glandular,gree,hal,head,included,interjected,internode,interspersed,irregularly,lamina,larger,lateral,leaflet,live,lobe,lon,long-acuminate,loosely,lower,markedly,maturing,mostly,multicellular,nflorescence,node,northern,occasionally,often,orbicular,pair,paler,patent,pentagonal,petiolule,population,present,pseudostipule,pubescence,rarely,ripe,robust,ruit,scattered,secondary,sessile,silky,smaller,sometimes,somewhat,sparse,spreadin,staminal,sterile,stout,straight,tem,terminal,tertiary,testa,trailing,ud,undulate,unicellular,uniseriate,unit,unseriate,usually,wall,white,winged,woody,x,ympodial	1.5-3.5,5-8,arrangement,bud,characteristic,colour,corrugation,drying,exertion,form,glabrousnes,growth,height,history,leaf,length,life,lobing,na,new,number,per,seed,shape,size,texture,type	.5,0.2-0.3,0.4-0.45,0.4-0.6,0.5-1.5,0.6-1,1-1.1,1-1.2,1-1.5,1-4,1.0-1.3,1.7-2.6,2,2-2.5-5,2/3,5-10-12,acuminate,acute,anthesi,articulated,berry,broadly,brown,calyx,capitate,cm,conical,crenate-serrate,dark,densely,diameter,distal,eglandular,elliptic,exserted,flower,globose,golden,green,hair-like,half,halfway,herb,imparipinnate,interrupted,lanceolate,like,long,mm,narrowly,obovate,outgrowth,pale,perennial,proximal,pubescent,reflexed,simple,soft,sparsely,stem,stripe,strongly,thick,trichome,truncate,velvety,wide,yellow	1.5-3.5,5-8,na
341	wfo-0001029785	success	223	145	116	127	96	18	113	3	0-2,0-3,0.1-0.5,0.8-1,1-1.2,1-2,1-5,1.2-3.2,1.5-3.6,1.8-3.5,1.8-7,10-26,2-4,3-6,3.8-7.2,4-10.5,5-16,5-9,6,8-11,abaxially,absent,acute,adaxially,along,anther,attenuate,axillary,berry,broadly,brownish,bud,cell,chartaceous,clavate,cm,commonly,condition,connivent,corolla,covering,dark,darker,decumbent,denser,diameter,distal,drying,elliptic,flower,forked,fresh,fruit,generally,glabrous,globose,green,green-white,greenish,hair,hair-like,half,herb,homostylous,interjected,invested,lanceolate,lateral,leaf,leaflet,lobe,long,make,margin,membranous,minute,mm,mottled,mucilaginous,multiple-celled,non-glandular,obovate,odd-pinnate,outer,ovate,ovoid,pair,pedicel,peduncle,pentagonal,petiole,plant,poricidal,pubescent,purple,purple-tinged,ripe,rotate,rounded,scale-like,seed,short,size,slightly,sparsely,stem,stigma,style,subglabrous,subtending,terminal,testal,thick,throughout,tip,tube,unbranched,unwinged,usually,vein,violet,wall,wet,whitish,wide,x,yellow	0.3-2.2,0.4-4.9,1-10,3-4,3-8,3.5-5,5-merou,acumen,ag,alyx,apart,apex,apparently,articulation,axe,base,blade,borne,capitat,cordate,cuneate,decreasing,digestion,dorsally,eaf,edge,eed,end,enzyme,erec,especially,exceeding,filament,flat,folded,geminat,glabrou,greatly,honeycomb-shaped,larger,lengthening,like,living,lower,markedly,medium,middle,midrib,minutely,much,nflorescence,oblique,obtuse,one-quarte,orbicular,orolla,pale,perfect,petiolulate,petiolule,plurifoliate,point,pore,present,puberulent,quite,rarely,removed,ruit,sessile,seudostipule,shallowly,singly,slit,sometimes,spaced,specimen,stamen,ste,stolo,straight,stripe,tall,tamen,tem,toward,tri-,truncate,tuber,typically,unequal,unit,variable,vary,white,ympodial	5-merous,arrangement,calyx,capitate,colour,erect,form,growth,height,history,inflorescence,length,life,ovary,pseudostipule,shape,staman,texture	0-2,0-3,0.1-0.5,0.8-1,1-1.2,1-2,1-5,1.2-3.2,1.5-3.6,1.8-3.5,1.8-7,10-26,2-4,3-6,3.8-7.2,4-10.5,5-16,5-9,6,8-11,abaxially,absent,acute,adaxially,along,attenuate,axillary,berry,broadly,brownish,bud,cell,chartaceous,clavate,cm,commonly,condition,connivent,corolla,covering,dark,darker,decumbent,denser,distal,drying,elliptic,forked,fresh,generally,glabrous,globose,green,green-white,greenish,hair,hair-like,half,herb,homostylous,invested,lanceolate,lateral,lobe,long,make,margin,membranous,minute,mm,mottled,mucilaginous,multiple-celled,non-glandular,obovate,odd-pinnate,outer,ovate,ovoid,pentagonal,plant,poricidal,pubescent,purple,purple-tinged,ripe,rotate,rounded,scale-like,seed,short,slightly,sparsely,stem,subglabrous,subtending,terminal,testal,thick,throughout,tip,tube,unbranched,unwinged,usually,vein,violet,wall,wet,whitish,wide,x,yellow	5-merous,capitate,erect
342	wfo-0001029789	success	167	101	62	77	90	24	58	4	0-2,0.2-0.5,0.5-2.8,0.8-3.5,1-3,1.7-8.5,1.8-6.5,12,2-6,2-6.5,2.7-4.7,3-8.5,4-10,4-13,5-7,6-7,7-16.6,7-21,8-9,abaxially,adaxially,anther,axillary,blade,blue,broadly,bud,chartaceous,clavate,cm,corolla,diameter,filament,fruit,glabrous,green,hair,herb,interjected,lanceolate,lateral,leaf,leaflet,light,like,lilac,linear,long-attenuate,lunate,membranous,minute,minutely,mm,narrowly,odd-pinnate,orbicular,ovary,ovate,pedicel,peduncle,pentagonal,petiole,plant,pubescent,rachi,rotate,size,sparsely,stigma,straight,style,subglabrous,subtending,terminal,white,x,yellow	1-10,1-2,1.5-2,2-25,2-3,3-5,5-merou,6,acumen,acuminate,acute,adaxiall,ag,alyx,apart,apex,apparently,articulated,attenuate,axe,base,basiscopic,capitat,connivent,dark,decreasing,decurrent,distal,dorsally,eaf,edge,eed,erec,exceeding,flat,flower,folded,forked,formed,geminat,generally,greatly,hal,half,homostylous,lant,lengthening,lobe,long,lower,maturing,mottled,never,nflorescence,orolla,pair,perfect,petiolulate,plurifoliate,pore,poricidal,pubescen,purpl,rarely,sessile,seudostipule,short,side,simple,slightly,slit,spaced,stamen,star,ste,sterile,subequal,tall,tamen,tem,tinged,tip,toward,tri-,tube,typically,unit,usually,vary,ympodial	abaxial,adaxial,arrangement,calyx,capitate,characteristic,colour,erect,form,growth,height,history,inflorescence,length,life,na,number,pseudostipule,seed,shape,stem,surface,texture,type	0-2,0.2-0.5,0.5-2.8,0.8-3.5,1-3,1.7-8.5,1.8-6.5,12,2-6,2-6.5,2.7-4.7,3-8.5,4-10,4-13,5-7,6-7,7-16.6,7-21,8-9,abaxially,adaxially,axillary,blue,broadly,bud,chartaceous,clavate,cm,glabrous,green,hair,herb,lanceolate,light,like,lilac,linear,long-attenuate,lunate,membranous,minute,minutely,mm,narrowly,odd-pinnate,orbicular,ovate,pentagonal,pubescent,rotate,sparsely,straight,subglabrous,subtending,terminal,white,x,yellow	capitate,erect,na,stem
343	wfo-0001029810	success	149	107	78	88	61	19	77	1	.5,0.5-3,1-1.3,1-10,1-2,1-3,1.1-2.3,1.5-3,2-3,3-6,5-15-flowered,5-16,5-6,acuminate,acute,adaxially,along,anther,apex,apically,arachnoid,attenuate,base,berry,calyx,capitate,cm,compact,compressed,congested,corolla,dark,dendritic,densely,dia,ellipsoid,elliptic,exserted,fruiting,glabrous,globose,green,inflorescence,internodal,later,leaf,like,lobed,long,minutely,mm,narrowly,nearly,occasionally,opposite,ovary,ovoid-reniform,pale,papillose,pedicel,petiole,pitted,pointed,pubescent,reddish-brown,rest,shaped,shining,shrub,simple,size,slender,small,sparsely,stem,stigma,style,surface,tan,tapering,tear-drop,tree,trichome,tube,vein,white,wide,young	.25,0.5-1,1-1.5,2-5,2.5-3,3-3.5,3-4,4-10,8-12,abaxially,anthesi,ape,bark,brown,closely,conical,deflexed,deltate,differing,difoliate,drying,eaf,edicel,eed,filament,fleshy,free,geminat,glabrou,large,lateral,lenticel,less,lobe,lon,lower,main,major,margin,middle,minor,nflorescence,older,overlappin,papillo,planar,pore,poricidal,portion,ruit,scar,spaced,tall,tip,tub,ud,unit,widest,woody,yellowish,ympodial	bud,characteristic,colour,diameter,exertion,form,fruit,growth,height,history,length,life,lobing,perennial,plant,seed,shape,texture,type	.5,0.5-3,1-1.3,1-10,1-2,1-3,1.1-2.3,1.5-3,2-3,3-6,5-15-flowered,5-16,5-6,acuminate,acute,adaxially,along,apex,apically,arachnoid,attenuate,base,berry,calyx,capitate,cm,compact,compressed,congested,dark,dendritic,densely,dia,ellipsoid,elliptic,exserted,glabrous,globose,green,inflorescence,internodal,later,leaf,like,lobed,long,minutely,mm,narrowly,nearly,occasionally,opposite,ovoid-reniform,pale,papillose,pitted,pointed,pubescent,reddish-brown,rest,shaped,shining,shrub,simple,slender,small,sparsely,tan,tapering,tear-drop,tree,trichome,tube,vein,white,wide,young	perennial
344	wfo-0001029811	success	224	152	107	127	97	25	104	3	-3,0,0-30,0-35,0.3-1,0.5-2,0.8-1.5,1-1.5,1-3,1.3-1.7,1.5-6,1/2-2/3,1/3,1/3-2/3,13-20,2-2.5,2-5,2-5.5,2.5-3,2.8-3.2,3-5,3-5.5,3-7,3.5-4.5,4.5-5,5-11,6-12,7-18,8-12,abaxial,adaxial,anther,apex,apparently,articulated,bark,base,berry,calyx,cell,chartaceous,cm,connivent,cordate,cuneate,dark,densely,diameter,discolorous,distance,drying,erect,extending,filament,flattened-reniform,flower,fruit,fruiting,glabrous,glandular,hair,herb,lateral,leaf,length,lobe,lobed,lobing,long,long-styled,lower,margin,maturity,mauve,midvein,minute,mm,moderately,multangulate,obtuse,orange-brown,outline,ovate,pair,pedicel,peduncle,per,petiole,pit,plant,poricidal,porrect,prickle,prickly,primary,raised,scandent,sessile,short-styled,shrub,side,simple,slightly,small,smooth,sometimes,spherical,stalked,stellate,stellate-pubescent,stem,stout,straight,style,surface,tapering,terete,tip,trichome,tube,unbranched,upper,vein,way,wide,yellow,yellow-green	-merous,.5,/3,0.1-0.3,0.1-0.4,0.2,0.2-0.6,0.3-1.5,1,1-2.5,1.5-2.5,1/,10-22,15-23,15-50,20-100,4-8,5-17,5-40,5-6,5-9,7-9,8-18,abaxially,acicular,alyx,andromonoecious,apar,apart,apically,blade,broad-deltate,brown,cream,distal,eaf,eed,elongate,elongating,equal,eye,faint,fewer,flattened,free,green,green-brow,hermaphrodite,heterostylous,inflated,infructescence,less,long-acuminat,longer,lowermost,marking,mature,midpoint,naked,narrow-deltate,nflorescence,often,older,one,open,orolla,oung,pale,pendulous,pericarp,perpendicular,plurifoliat,portion,prickl,ray,ruit,scar,secondary,short,shorter,spaced,sparsely,spreading,stalk,staminat,tamen,tertiary,time,unarmed,unit,usually,vary,venation,visible,woody,ympodial,young	1/2,arrangement,branch,characteristic,colour,corolla,exertion,form,glabrousnes,green-brown,growth,height,history,inflorescence,life,na,new,number,ovary,seed,shape,size,stigma,texture,type	-3,0,0-30,0-35,0.3-1,0.5-2,0.8-1.5,1-1.5,1-3,1.3-1.7,1.5-6,1/2-2/3,1/3,1/3-2/3,13-20,2-2.5,2-5,2-5.5,2.5-3,2.8-3.2,3-5,3-5.5,3-7,3.5-4.5,4.5-5,5-11,6-12,7-18,8-12,apparently,articulated,base,berry,cell,chartaceous,cm,connivent,cordate,cuneate,dark,densely,diameter,discolorous,distance,drying,erect,extending,flattened-reniform,flower,glabrous,glandular,hair,herb,lateral,lobe,lobed,long,long-styled,lower,maturity,mauve,midvein,minute,mm,moderately,multangulate,obtuse,orange-brown,outline,ovate,pair,per,pit,poricidal,porrect,prickle,prickly,raised,scandent,sessile,short-styled,shrub,side,simple,slightly,small,smooth,sometimes,spherical,stalked,stellate,stellate-pubescent,stout,straight,tapering,terete,tip,trichome,unbranched,upper,way,wide,yellow,yellow-green	1/2,green-brown,na
345	wfo-0001029978	success	208	126	85	106	102	20	82	3	0.5-0.6,0.7-1.9,0.9-2.3,1-10,1-2,1.3-1.5,1.4-1.5,1.5-3.1,1.8-5,15-27,2-4,3-5,3-7,3.1-6.3,3.2-2.5,3.5-9.5,3.7-8.1,4-11,4-7,4.2-5.2,5,5-16.5,8-10,abaxially,acuminate,adaxially,anther,apart,apex,axillary,base,berry,blade,brownish,bud,chartaceous,clavate,cm,coarsely,condition,conical,connivent,corolla,dark,diameter,distal,drying,filament,finely,flower,forked,fresh,fruit,generally,glabrous,green,greenish,hair,half,herb,homostylous,interjected,lanceolate,lateral,leaf,leaflet,light,lobe,long,medium,membranous,minute,minutely,mm,moniliform,mottled,odd-pinnate,ovoid,pedicel,peduncle,pentagonal,petiole,plant,puberulent,pubescent,purple,ripe,rotate,seed,semierect,simple,size,sparsely,stem,stigma,straight,style,subsessile,subtending,terminal,tube,tuber,usually,whitish,wide,x	0.3-0.4,0.3-0.7,0.8,11-19,5-merou,acumen,ag,along,alyx,apparently,arranged,articulated,asymmetrical,attenuate,axe,basiscopic,bead,capitat,cell,ciliate,commonly,covering,darker,decreasing,digestion,dorsally,eaf,edge,eed,elliptic,enzyme,erec,especially,exceeding,flat,folded,fourt,geminat,glabrou,gradually,green-white,hair-like,honeycomb-shaped,larger,lengthening,less,like,living,lower,make,margin,middle,midrib,mucilaginous,multiple,narrow,necklace,nflorescence,orbicular,orolla,ovate,pair,perfect,petiolule,plurifoliate,pore,poricidal,pubescen,ray,removed,ruit,secondary,sessile,seudostipule,side,slightly,slit,spaced,specimen,stamen,ste,stolon,subequal,symmetrical,tall,tamen,tem,testal,thick,throughout,tip,tissue,toward,tri-,typically,unit,vary,wall,wet,wing,yellow,ympodial	5-merous,abaxial,adaxial,arrangement,calyx,capitate,colour,erect,form,growth,height,history,inflorescence,length,life,ovary,pseudostipule,shape,spacing,texture	0.5-0.6,0.7-1.9,0.9-2.3,1-10,1-2,1.3-1.5,1.4-1.5,1.5-3.1,1.8-5,15-27,2-4,3-5,3-7,3.1-6.3,3.2-2.5,3.5-9.5,3.7-8.1,4-11,4-7,4.2-5.2,5,5-16.5,8-10,abaxially,acuminate,adaxially,apart,axillary,berry,brownish,bud,chartaceous,clavate,cm,coarsely,condition,conical,connivent,dark,distal,drying,finely,forked,fresh,generally,glabrous,green,greenish,hair,half,herb,homostylous,lanceolate,light,long,medium,membranous,minute,minutely,mm,moniliform,mottled,odd-pinnate,ovoid,pentagonal,plant,puberulent,pubescent,purple,ripe,rotate,semierect,simple,sparsely,straight,subsessile,subtending,terminal,usually,whitish,wide,x	5-merous,capitate,erect
346	wfo-0001029980	success	173	140	113	121	52	19	109	4	.1,0.25-0.5,0.5-1,0.5-1.2,0.5-2.5,0.5-5,0.7-1.3,0.8-1.2,1-1.7,1.5-2,2-5,2/3,3-4,3-9,5-50-flowered,6.4-17,abaxially,acute,anther,anthesi,apex,appearing,appressed,axil,bark,base,berry,black,bright,brown,bud,calyx,cm,corolla,curved,dark,decurrent,deflexed,density,dia,difoliate,dried,drying,elliptic,especially,exserted,five,flattened-reniform,fruiting,glabrous,globose,gray,greatly,green,greenish-white,knob,lateral,leaf,live,lobe,lobed,long,main,margin,material,minutely,mm,near,node,often,older,one,onto,opposite,ovary,ovate,pale,papillose,pedicel,petiole,pitted,plant,pore,poricidal,puberulent,reflexed,rounded,shape,shaped,shiny,shrub,side,simple,size,slender,slightly,small-capitate,somewhat,soon,stem,stigma,straight,style,surface,tan,tapering,tear-drop,tip,trichome,tube,tuft,unicellular,uniseriate,unit,varying,vein,way,white,winged,x,young	.5,0.1-0.25,0.25-1,0.9-4.5,1-1.5,1.2-2.5,1.5-6,2-6,5-10,adaxially,apar,ba,closely,conical,deltoid,differing,eaf,edicel,eed,elevation,filament,free,geminat,high,impressed,incrassate,lon,lower,major,middle,minor,nflorescence,orbicular,overlapping,pair,paler,portion,prominent,proximal,race,ruit,scar,spaced,specimen,tall,ud,venezuelan,whit,widest,woody,yellowish,ympodial	arrangement,characteristic,colour,diameter,exertion,form,fruit,geminate,growth,height,history,inflorescence,length,life,lobing,seed,sympodial,texture,type	.1,0.25-0.5,0.5-1,0.5-1.2,0.5-2.5,0.5-5,0.7-1.3,0.8-1.2,1.5-2,2-5,2/3,3-4,3-9,5-50-flowered,6.4-17,abaxially,acute,anthesi,appearing,appressed,axil,bark,base,berry,black,bright,brown,bud,calyx,cm,curved,dark,decurrent,deflexed,density,dia,difoliate,dried,drying,elliptic,especially,exserted,five,flattened-reniform,glabrous,globose,gray,greatly,green,greenish-white,knob,lateral,leaf,live,lobe,lobed,long,main,margin,material,minutely,mm,near,node,often,older,one,onto,opposite,ovate,pale,papillose,petiole,pitted,plant,pore,poricidal,puberulent,reflexed,rounded,shaped,shiny,shrub,side,simple,slender,slightly,small-capitate,somewhat,soon,stem,straight,tan,tapering,tear-drop,tip,trichome,tube,tuft,unicellular,uniseriate,unit,varying,vein,way,white,winged,x,young	-1.7,di,geminate,sympodial
347	wfo-0001029989	success	161	118	79	91	70	27	77	2	.2,.5,/2,0.5-1,0.5-1.5,1-1.5,1-2.5,1.3-2.3,1.5-2.5,10-14,3-8,3.5-8,5-10-flowered,5-6,7-20,abaxially,acute,adaxially,anther,apex,bark,base,berry,branch,calyx,capitate,cm,conical,corolla,dendritic,densely,dia,difoliate,drying,elliptic,exserted,filament,flattened,fruiting,glabrous,globose,golden,gray,green,greenish-black,incrassate,inflorescence,internodal,lateral,leaf,lenticular,like,lobed,long,main,margin,minutely,mm,nearly,nodding,occasionally,opposite,ovary,pair,pedicel,petiole,pitted,pubescent,reddish,reddish-brown,rest,shaped,shining,short-style,shrub,simple,small,stem,stigma,style,surface,tear-drop,tree,tree-like,trichome,tube,unifoliate,vein,way,white,x	0.25-0.5,1-2,1-4,2.5-3,3-5,4-4.5,abaxial,anthesi,branched,broadly,brownish-re,central,closely,collection,congested,deflexed,deltoid,dense,described,dimaeter,discussion,due,eaf,edicel,eed,erect,fleshy,free,geminat,heteromorphic,inflorescenc,lamina,lobe,lon,lower,middle,nflorescence,northern,older,overlappin,papillo,peru,peruvian,perÃº,petal,petaloid,planar,population,pore,poricidal,portion,probably,pubescence,ruit,scar,scattered,see,somewhat,spaced,sparsely,tall,tip,ud,unit,wide,widest,woody,yellow,ympodial,young	arrangement,brownish-red,bud,characteristic,colour,corrugation,diameter,exertion,form,fruit,glabrousnes,growth,height,history,length,life,lobing,na,new,peduncle,plant,primary,seed,shape,size,texture,type	.2,.5,/2,0.5-1,0.5-1.5,1-1.5,1-2.5,1.3-2.3,1.5-2.5,10-14,3-8,3.5-8,5-10-flowered,5-6,7-20,abaxially,acute,adaxially,base,berry,calyx,capitate,cm,conical,dendritic,densely,dia,difoliate,elliptic,exserted,flattened,glabrous,globose,golden,gray,green,greenish-black,incrassate,inflorescence,internodal,lateral,leaf,lenticular,like,lobed,long,main,margin,minutely,mm,nearly,nodding,occasionally,opposite,pair,pitted,pubescent,reddish,reddish-brown,rest,shaped,shining,short-style,shrub,simple,small,style,tear-drop,tree,tree-like,trichome,tube,unifoliate,vein,way,white,x	brownish-red,na
348	wfo-0001030000	success	146	88	58	68	78	20	57	1	-pilose,0.5-1,0.5-14,0.5-2-2.5,0.5-3,1-10,1-2,1-2.5-3,1.5-2,1.5-2.5-3.5,10-30-50,15-25,2-2.5,2-3,2-4,2-5,2.5-4-4.5-7,25-30-50,3-4,3.5-5,4-5,7-15,acute,also,apex,axe,base,calyx,cm,connective,connivent,densely,dia,diameter,eglandular,ellipsoidal,flattened,flower,fruit,glabrous,globose,hair,lobe,long,mm,moderately,oblong,obtuse,occasionally,ovoid,pedicel,peduncle,perfect,pilose,puberulent,pubescent,rachi,radiu,shrub,small,sparsely,stigma,style,tree,truncate,tube,unbranched,x	-4,1,1.5-3-16,10-20,3-4-foliat,abaxially,absent,adaxially,aggregate,apart,ape,apiculate,articulated,biglandula,cell,chartaceous,ciliat,conspicuous,coriaceous,creamy-whit,cucullate,deltate,dilated,directed,distally,eed,equal,exceeding,green,immature,laterally,leaving,lon,lower,margin,mature,narrowly,nflorescence,nther,orange,orolla,pedicellar,pore,produced,pubescen,purplish,rarely,remnant,ruit,scar,shorter,slightly,smal,spaced,spotted,stamen,stellate,stone,strongly,subcoriaceous,swelling,tal,tem,thecae,tinge,tip,tomentose,triangular,ud,umbrella-shaped,unit,vary,white,wide,yellow,yellow-brown,yellowish,ympodial	anther,biglandular,bud,characteristic,corolla,form,glabrousnes,growth,height,inflorescence,length,ovary,plant,seed,shape,size,stem,surface,texture,theca	-pilose,0.5-1,0.5-14,0.5-2-2.5,0.5-3,1-10,1-2,1-2.5-3,1.5-2,1.5-2.5-3.5,10-30-50,15-25,2-2.5,2-3,2-4,2-5,2.5-4-4.5-7,25-30-50,3-4,3.5-5,4-5,7-15,acute,also,apex,axe,base,cm,connivent,densely,dia,eglandular,ellipsoidal,flattened,flower,fruit,glabrous,globose,hair,long,mm,moderately,oblong,obtuse,occasionally,ovoid,perfect,pilose,puberulent,pubescent,shrub,small,sparsely,tree,truncate,unbranched,x	biglandular
349	wfo-0001030000	success	167	149	89	96	71	53	87	2	-pilose,0.5-1,0.5-1-5,0.5-13,0.5-3,1-10,1-2,1.5-2.5-3.5,1.5-3-16,10-30-50,15-25,2-2.5,2-4,2-4-25,2.5-4-4.5-7,25-30-50,3-4,3-5-25,3.5-5,4-5,7-15,abaxially,acuminate,acute,adaxially,also,apex,apiculate,axe,basal,base,calyx,cm,connivent,cordate,cucullate,deltate,densely,dia,diameter,eglandular,ellipsoidal,entire,flattened,flower,fruit,glabrescent,glabrous,globose,green,hair,immature,lobe,long,margin,mature,mm,moderately,narrowly,oblique,oblong,obtuse,occasionally,often,orange,ovate,ovoid,pedicel,peduncle,perfect,petiole,pilose,puberulent,pubescent,purplish,shrub,simple,slightly,small,sparsely,spotted,stigma,style,subcoriaceous,tinge,tip,tree,triangular,truncate,tube,unbranched,vein,white,x,yellow,yellow-brown	-4,0.5-14,0.5-2-2.5,1,1-1.5-2,1-2.5-3,1.5-2,10-20,2-3,2-5,3-4-foliat,absent,aggregate,apart,ape,articulated,biglandula,blade,cell,chartaceous,ciliat,connective,conspicuous,coriaceous,creamy-whit,dilated,directed,distally,eaf,eed,elliptic,equal,exceeding,laterally,leaving,lon,lower,nflorescence,nther,orolla,pedicellar,pilo,pore,produced,pubescen,rachi,radiu,rarely,remnant,ruit,scar,shorter,smal,spaced,stamen,stellate,stone,strongly,swelling,tal,tem,thecae,time,tomentose,ud,umbrella-shaped,unit,vary,wide,yellowish,ympodial	anther,appearance,arrangement,bark,biglandular,border,branch,bud,characteristic,colour,corolla,corrugation,distal,drying,exertion,filament,form,fruiting,giving,glabrousnes,growth,height,history,inflorescence,interjected,lateral,leaf,leaflet,length,life,lobing,midpoint,na,new,number,ovary,per,plant,prickle,primary,pseudostipule,ray,seed,shape,size,stem,surface,terminal,texture,thicknes,type,variation,width	-pilose,0.5-1,0.5-1-5,0.5-13,0.5-3,1-10,1-2,1.5-2.5-3.5,1.5-3-16,10-30-50,15-25,2-2.5,2-4,2-4-25,2.5-4-4.5-7,25-30-50,3-4,3-5-25,3.5-5,4-5,7-15,abaxially,acuminate,acute,adaxially,also,apex,apiculate,axe,basal,base,cm,connivent,cordate,cucullate,deltate,densely,dia,eglandular,ellipsoidal,entire,flattened,flower,fruit,glabrescent,glabrous,globose,green,hair,immature,lobe,long,mature,mm,moderately,narrowly,oblique,oblong,obtuse,occasionally,often,orange,ovate,ovoid,perfect,pilose,puberulent,pubescent,purplish,shrub,simple,slightly,small,sparsely,spotted,subcoriaceous,tinge,tip,tree,triangular,truncate,unbranched,vein,white,x,yellow,yellow-brown	biglandular,na
350	wfo-0001030004	success	177	104	70	83	94	21	69	1	0-1.5,0.2-1,0.8-1.1,1-1.5,1-2,1.2-2,1.5-2.5,15,2-20,20-200-flowered,3-3.5,3.5-5,4-15,5-25,9-30,abaxial,across,anther,bark,base,berry,branched,calyx,capitate,cm,corolla,dendritic,densely,dia,elliptic,exserted,flattened-reniform,fruiting,glabrous,globose,green,inflorescence,later,lateral,leaf,lobed,long,loose,many,minutely,mm,nearly,obovate,obovoid,ovary,pale,pedicel,petiole,pitted,plant,plurifoliate,pubescent,seed,shaped,shrub,small,sparsely,stem,stigma,stout,strongly,style,surface,tan,tear-drop,terminal,thick,time,translucent,tree,trichome,tube,variously,white,wide,x,yellowish-green,young	.3,0-0.5,0.3-1,15-20,3-4,abaxially,acuminate,acute,adaxially,along,always,anthesi,apar,apex,appearanc,axillary,barely,basal,blade,body,branching,broadly,bushy,collection,cone,conical,crotaloid,decurrent,deltate,dense,denser,diamete,distal,drying,eaf,edicel,eed,erect,especially,filament,flat,fleshy,free,giving,greenish-yello,hard,incrassate,juvenile,knob,lamina,large,like,lobe,lower,main,margin,middle,much,nflorescence,occasionally,often,older,onto,pair,papillate,papillo,pericarp,planar,pore,poricidal,portion,possessing,prominent,pubescence,rest,ruit,scar,sessile,simple,spaced,surpassing,tall,thin,tip,tub,tuft,ud,unevenly,vein,widest,winged,woody,yellowish,ympodia	adaxial,arrangement,bud,characteristic,colour,diameter,exertion,form,fruit,greenish-yellow,growth,height,history,length,life,lobing,shape,size,texture,thicknes,type	0-1.5,0.2-1,0.8-1.1,1-1.5,1-2,1.2-2,1.5-2.5,15,2-20,20-200-flowered,3-3.5,3.5-5,4-15,5-25,9-30,across,base,berry,branched,calyx,capitate,cm,dendritic,densely,dia,elliptic,exserted,flattened-reniform,glabrous,globose,green,later,lateral,leaf,lobed,long,loose,many,minutely,mm,nearly,obovate,obovoid,pale,pitted,plurifoliate,pubescent,shaped,shrub,small,sparsely,stem,stout,strongly,tan,tear-drop,terminal,thick,time,translucent,tree,trichome,tube,variously,white,wide,x,yellowish-green,young	greenish-yellow
351	wfo-0001030007	success	168	126	93	101	67	25	89	4	.4,.5,0.2-1,0.8-1,1-1.5,1-15,1-2,1.6-2.2,15-20,2-4,3/4,6-10-flowered,7-10,7-9,abrupt,acuminate,acute,along,anther,apex,bark,base,becoming,beneath,berry,brown,bud,calyx,campanulate,clavate,cm,corolla,decurrent,densely,dia,dry,elliptic,exserted,filament,flattened,fruiting,glabrate,glabrous,globose,golden,golden-pubescent,green,lateral,leaf,live,lobed,long,main,margin,material,midrib,minutely,mm,oblique,obovoid,onto,ovary,pair,pale,papillose,pedicel,petiole,pitted,plant,pore,poricidal,pubescent,reniform,shaped,shrub,simple,slender,slightly,small,soft,soon,sparsely,stem,stigma,style,surface,tapering,tear-drop,tip,tree,trichome,tube,type,uniseriate,vein,way,white,widening,winged,x,young	.05,0.1-0.5,0.5-1,1.5-5,2-7,3-5,4.5-5,anthesi,apart,ba,branched,broadly,closely,cork,dark,deltoid,difoliate,edicel,eed,erect,fleshy,free,geminateleaf,gre,hooded,impressed,incrassate,inflorescenc,like,lobe,lon,longer,lower,major,middle,minor,nflorescence,occasionally,older,one,opposite,outline,papillo,planar,portion,prominent,raised,rest,rounded,ruit,scar,short,shorter,spaced,specimen,straight,tall,thick,thickened,trunk,tub,two,ud,unit,widest,woody,ympodial	alternate,arrangement,branch,characteristic,colour,diameter,exertion,form,fruit,glabrousnes,grey,growth,height,history,inflorescence,length,life,lobing,new,peduncle,primary,seed,shape,size,texture	.4,.5,0.2-1,0.8-1,1-1.5,1-15,1-2,1.6-2.2,15-20,2-4,3/4,6-10-flowered,7-10,7-9,abrupt,acuminate,acute,along,base,becoming,beneath,berry,brown,bud,calyx,campanulate,clavate,cm,corolla,decurrent,densely,dia,dry,elliptic,exserted,flattened,glabrate,glabrous,globose,golden,golden-pubescent,green,lateral,leaf,live,lobed,long,main,material,midrib,minutely,mm,oblique,obovoid,onto,pair,pale,papillose,petiole,pitted,plant,pore,poricidal,pubescent,reniform,shaped,shrub,simple,slender,slightly,small,soft,soon,sparsely,stem,tapering,tear-drop,tip,tree,trichome,tube,uniseriate,vein,way,white,widening,winged,x,young	-1.5,alternate,di,grey
352	wfo-0001030010	success	156	109	82	91	65	18	81	1	.5,.75,/4,0.5-5,0.9-1.1,1-1.3,1.5-2,10-15,10-50-flowered,2-2.2,2-7,2.5,20-40,5-7,acuminate,acute,anther,apex,area,attenuate,bark,basal,base,beneath,berry,brown,calyx,cm,corolla,cyathiform,dark,deciduous,decurrent,dia,exserted,f,fruit,fruiting,furcate,glabrate,glabrous,globose,green,grey,leaf,lobed,long,midrib,minute,minutely,mm,near,nearly,obovate,occasionally,often,older,opposite,ovary,ovoid-reniform,papillose,pedicel,petiole,pitted,puberulent,reddish,shaped,shrub,simple,size,slightly,small,smooth,soon,stem,stigma,style,surface,tapering,tear-drop,tiny,tip,tree,trichome,tube,uniseriate,way,white,winged,x,young	0.7-1,1-1.5,1-2,1.2-1.5,11-12,3-5,4-4.5,7-10,anthesi,appearing,bud,closely,deflexed,deltate,differing,difoliate,distal,dry,eaf,edicel,eed,ellipsoid,filament,fleshy,free,geminat,hooded,lateral,lobe,lon,lower,m.,main,major,margin,materia,material,middle,minor,nflorescence,one,orange,overlappin,pair,persistent,planar,pore,poricidal,portion,prominent,rather,ruit,scar,shin,spaced,straight,styl,tall,trunk,ud,unit,vein,widest,woody,ympodial	characteristic,colour,diameter,exertion,form,growth,height,history,inflorescence,length,life,lobing,plant,seed,shape,shiny,texture,type	.5,.75,/4,0.5-5,0.9-1.1,1-1.3,1.5-2,10-15,10-50-flowered,2-2.2,2-7,2.5,20-40,5-7,acuminate,acute,area,attenuate,basal,base,beneath,berry,brown,calyx,cm,cyathiform,dark,deciduous,decurrent,dia,exserted,f,furcate,glabrate,glabrous,globose,green,grey,leaf,lobed,long,midrib,minute,minutely,mm,near,nearly,obovate,occasionally,often,older,opposite,ovoid-reniform,papillose,petiole,pitted,puberulent,reddish,shaped,shrub,simple,slightly,small,smooth,soon,stem,style,surface,tapering,tear-drop,tiny,tip,tree,trichome,tube,uniseriate,way,white,winged,x,young	shiny
353	wfo-0001030023	success	168	133	71	79	89	54	68	3	0.5-1,1-8,1.5-7,10-25,2.5-3.5,20-30,3-4.5,3-5,4,4-12,5,5-16,5-6,6-26,7-9,abaxially,acute,adaxially,apex,apiculate,basal,base,calyx,cm,connivent,cordate,cuneate,deeply,densely,diameter,ellipsoidal,elliptic,entire,finely,flattened,fleshy,fruit,glabrous,glandular-puberulent,globose,greenish-white,lanceolate,lobe,long,loosely,margin,membranaceous,mm,moderately,narrowly,oblique,oblong,obtuse,occasionally,often,ovate,pedicel,peduncle,peltiform,petiole,probably,puberulent,pubescent,purplish-,short-acuminate,simple,sparsely,stellate,stigma,style,tip,tree,triangular,truncate,tube,unknown,vein,x,yellowish	-,0-100+,1,1-2,1-4-10,1.5-2,10-30-50+,12-18,13-20,2,2-3,4-foliat,5-11-40+,6-7,aggregate,apart,ape,articulated,axe,beyond,blade,branched,capitat,cell,ciliate,color,connective,cylindrical,denser,dilated,directed,distally,eaf,eed,especially,exceeding,except,exserted,flower,forked,glandular-puberulen,hair,highly,leaving,lon,lower,main,narrow,near,nflorescence,nther,orolla,pedicellar,perfect,pore,presen,present,prominent,pubescen,pubescence,pubescent-pilo,rachi,radiu,remnant,ripe,ruit,shorter,slightly,small,somewhat,spaced,stamen,stone,subcoriaceous,swelling,tal,tem,thecae,time,ud,unbranched,unit,unknow,usually,vary,villous,wide,ympodial,young	anther,appearance,arrangement,bark,border,branch,bud,capitate,characteristic,colour,corolla,corrugation,distal,drying,exertion,filament,form,fruiting,giving,glabrousnes,growth,height,history,inflorescence,interjected,lateral,leaf,leaflet,length,life,lobing,midpoint,na,new,number,ovary,per,plant,prickle,primary,pseudostipule,pubescent-pilose,ray,seed,shape,size,stem,surface,terminal,texture,thicknes,type,variation,width	0.5-1,1-8,1.5-7,10-25,2.5-3.5,20-30,3-4.5,3-5,4,4-12,5,5-16,5-6,6-26,7-9,abaxially,acute,adaxially,apex,apiculate,basal,cm,connivent,cordate,cuneate,deeply,densely,ellipsoidal,elliptic,entire,finely,flattened,fleshy,fruit,glabrous,glandular-puberulent,globose,greenish-white,lanceolate,lobe,long,loosely,membranaceous,mm,moderately,narrowly,oblique,oblong,obtuse,occasionally,often,ovate,peltiform,probably,puberulent,pubescent,purplish-,short-acuminate,simple,sparsely,stellate,tip,tree,triangular,truncate,unknown,x,yellowish	capitate,na,pubescent-pilose
354	wfo-0001030032	success	250	123	77	99	151	24	76	1	0.5,0.5-1.5,0.8-1.0,0.8-1.1,1-1.3,1-1.5,1.5-2,1.5-2.5,11-20,13-35,2-3-locular,2-4,2-5,2-lobed,2.4-3.5,3.0-3.5,3.5-12,30,4-5,4.3-5.0,5-plurifoliate,8-10,8-20,acuminate,acute,anther,apex,articulated,base,branched,bright,brown,calyx,capitate,cm,completely,conical,corolla,dark,decurrent,deltate,densely,diameter,elliptic,entire,exserted,filament,fruit,fruiting,glabrous,golden,green,greenish-brown,hair-like,halfway,imparipinnate,interrupted,irregularly,leaf,length,long,many,margin,middle,mm,oblanceolate,obovate,occasionally,orbicular,outgrowth,ovary,pale,pedicel,peduncle,petiole,pithy,present,primary,pseudostipule,pubescent,seed,somewhat,splitting,stem,stigma,straight,style,surface,thick,time,truncate,tube,unit,vein,vine,white,wide,woody,yellow	+,.05,.5,0.1-0.4,0.1-0.5,0.2,0.2-0.3,0.2-0.5,0.25-0.4,0.4-1.5,0.5-0.6,0.5-0.7,0.5-1,0.5-2,0.6-1.1,0.7-0.8,1-2-celled,1-3,1-celled,2,2-10,2-3.5,2-60,3,3-5,4-6-celled,4-celled,6-11,60-80,7-16,7.5-10,8-10-celled,abaxially,absent,abundant,adaxial,adaxially,along,also,anthesi,apical,appearance,appendage,articulation,basal,basally,basiscopically,bent,border,branche,breaking,cell,clambering,column,conspicuou,densest,desne,dry,eaf,ebracteate,edicel,eed,flower,free,give,glandular,gree,hea,head,herbarium,interjected,internode,lamina,large,larger,lateral,leaflet,leave,like,lobe,longest,lower,markedly,midvein,mixed,moderately,much,multicellular,nflorescence,node,oblique,often,older,onto,opposite,pair,paler,patent,petiolule,pubescence,rachi,reflexed,rest,rotate,rotate-stellate,rough,round,ruit,secondary,set,shorter,silky,simple,slightly,smaller,soft,sometimes,sparsely,sparser,specimen,spreading,stamen,staminal,sterile,subopposite,swollen,tall,tangled,tem,terminal,tertiary,testa,thickened,tiny,tip,touch,transparent,trichome,ud,unicellular,uniseriate,usually,vegetatio,venation,wall,weaker-walled,well-developed,winged,ympodial,younger,Â½-3/4	arrangement,branch,bud,characteristic,colour,drying,exertion,form,glabrousnes,growth,height,history,inflorescence,life,lobing,new,number,per,plant,shape,size,sympodial,texture,type	0.5,0.5-1.5,0.8-1.0,0.8-1.1,1-1.3,1-1.5,1.5-2,1.5-2.5,11-20,13-35,2-3-locular,2-4,2-5,2-lobed,2.4-3.5,3.0-3.5,3.5-12,30,4-5,4.3-5.0,5-plurifoliate,8-10,8-20,acuminate,acute,articulated,branched,bright,brown,calyx,capitate,cm,completely,conical,dark,decurrent,deltate,densely,diameter,elliptic,entire,exserted,glabrous,golden,green,greenish-brown,hair-like,halfway,imparipinnate,interrupted,irregularly,long,many,middle,mm,oblanceolate,obovate,occasionally,orbicular,outgrowth,pale,pithy,present,pubescent,somewhat,splitting,straight,thick,time,truncate,unit,vine,white,wide,woody,yellow	sympodial
355	wfo-0001030048	success	156	122	92	98	58	24	89	3	0.5-1.5,1-1.5,1.2-2,1.3-1.6,1.5-3.5,1.5-7,2-3,2-5,3-3.5,3-5,4-15,4-4.5,5-10-flowered,5-8,abaxial,acute,adaxially,along,anther,anthesi,apex,apically,arachnoid,bark,base,becoming,berry,bi-colored,bi-lobed,blue,brown,calyx,clavate,cm,completely,corolla,covered,decurrent,densely,dia,difoliate,drying,ellipsoid,elliptic,exserted,felt-like,fruiting,glabrous,globose,golden,green,greyish,internodal,lamina,leaf,lobe,lobed,long,main,matted,minutely,mm,nearly,occasionally,onto,opposite,ovary,ovoid-reniform,pale,pedicel,petiole,pitted,planar,pointed,pubescent,reddish-brown,shaped,shiny,shrub,simple,small,somewhat,stem,stigma,strongly,style,surface,tan,tear-drop,tree,trichome,trifoliate,tube,unit,vein,white,wide,young	.5,1-2,10-16,5973,abaxially,ape,apparently,broadly,closely,conical,deflexed,deltate,eaf,edicel,eed,fide,filament,fleshy,four-angle,free,geminat,glabrate,impressed,inflorescenc,lateral,lightly,like,lon,lower,margin,middle,nflorescence,older,overlappin,pair,papillo,papillose,pore,poricidal,portion,prominent,rather,rest,ruit,scar,solomon,spaced,sparsely,tall,thick,thickened,tip,tub,ud,widest,woody,yellowish,ympodial	arrangement,bud,characteristic,colour,diameter,exertion,form,fruit,geminate,growth,height,history,inflorescence,length,life,lobing,perennial,plant,seed,shape,size,sympodial,texture,type	0.5-1.5,1-1.5,1.2-2,1.3-1.6,1.5-3.5,1.5-7,2-3,2-5,3-3.5,3-5,4-15,4-4.5,5-10-flowered,5-8,abaxial,acute,adaxially,along,anthesi,apex,apically,arachnoid,base,becoming,berry,bi-colored,bi-lobed,blue,brown,calyx,clavate,cm,completely,covered,decurrent,densely,dia,difoliate,drying,ellipsoid,elliptic,exserted,felt-like,glabrous,globose,golden,green,greyish,internodal,lamina,leaf,lobe,lobed,long,main,matted,minutely,mm,nearly,occasionally,onto,opposite,ovoid-reniform,pale,petiole,pitted,planar,pointed,pubescent,reddish-brown,shaped,shiny,shrub,simple,small,somewhat,stem,strongly,tan,tear-drop,tree,trichome,trifoliate,tube,unit,vein,white,wide,young	geminate,perennial,sympodial
356	wfo-0001030053	success	140	80	49	60	80	20	47	2	0.5-1,1-1.3,1.3-3.5,1.8-2,2.5-3,3.5-4,abruptly,acuminate,acute,apex,apical,base,berry,branched,brown,calyx,cm,corolla,decurrent,diameter,elliptic,entire,exserted,far,filiform,flattened,fragrant,glabrous,greenish,growth,inflorescence,many,margin,minutely,mm,new,nipple,pale,pedicel,peduncle,petiole,pitted,reniform,revolute,shining,shiny,simple,slightly,stem,surface,terminal,time,truncate,tube,turbinate,vine,white,woody,x,yellowish	0.5,1-13,1.5-5.5,10-20,100,2-2.5,4-7-11,5,5-merou,7-9,<,abscission,aiding,alyx,anthesi,apart,apiculae,ark,around,articulated,bfeore,branch,cell,climbin,completely,coriaceous,cyathiform,eaf,eed,fide,fine,flower,frui,fruiting,hyaline,irregularly,leaving,lobe,lobed,long,lower,mentz,near,nflorescence,older,orolla,pair,papilla,papillo,parallel,peg,pendant,per,perfect,plurifoliat,primary,rectangular,rim,scar,secondary,shallowly,shin,sleeve,small,spaced,spreadin,spreading,strongly,support,tem,testal,tiny,tip,twining,ud,unit,usually,vein,venation,ympodial	4-11,arrangement,bark,bud,characteristic,colour,exertion,form,fruit,glabrousnes,history,leaf,length,life,papillose,seed,shape,size,texture,type	0.5-1,1-1.3,1.3-3.5,1.8-2,2.5-3,3.5-4,abruptly,acuminate,acute,apical,berry,branched,brown,calyx,cm,decurrent,elliptic,entire,exserted,far,filiform,flattened,fragrant,glabrous,greenish,many,minutely,mm,nipple,pale,pitted,reniform,revolute,shining,shiny,simple,slightly,terminal,time,truncate,tube,turbinate,vine,white,woody,x,yellowish	4-11,papillose
357	wfo-0001030057	success	141	117	87	99	42	18	85	2	-2,2-3-celled,2-4,2-4.5,2-6,2.1-4.1,20-30,20-80,3-5,3.5-8,4-10,4.3-8.2,5.5-12,7-14,8,8-19,abaxially,absent,acuminate,acute,adaxially,apex,axillary,base,berry,blade,borne,brownish,bud,cell,chartaceous,cm,condition,cordate,covering,cuneate,diameter,distal,drying,end,extremely,flower,forked,fresh,fruit,generally,globose,green,green-white,greenish,hair,hair-like,half,herb,interjected,lateral,leaf,leaflet,like,long,lunate,make,membranous,mm,mottled,mucilaginous,narrow,odd-pinnate,ovoid,pedicel,peduncle,petiole,petiolule,plant,pubescent,purple,scale-like,seed,short,singly,size,small,stem,subglabrous,subtending,terminal,testal,thick,throughout,truncate,tuber,typically,unwinged,usually,wall,wet,whitish,wing,x	1-10,1-2,apart,apparently,articulated,axe,broadly,decreasing,digestion,eaf,eed,elliptic,enzyme,erec,geminat,glabrou,greatly,high,honeycomb-shaped,larger,living,nflorescence,ovate,pair,perfect,plurifoliate,removed,ruit,seudostipule,sometimes,spaced,specimen,ste,stolo,suborbicular,tall,tem,thir,toward,tri-,unit,ympodial	arrangement,colour,erect,form,growth,height,history,inflorescence,length,life,number,pattern,presence,pseudostipule,shape,stolon,texture,type	-2,2-3-celled,2-4,2-4.5,2-6,2.1-4.1,20-30,20-80,3-5,3.5-8,4-10,4.3-8.2,5.5-12,7-14,8,8-19,abaxially,absent,acuminate,acute,adaxially,axillary,berry,borne,brownish,bud,cell,chartaceous,cm,condition,cordate,covering,cuneate,diameter,distal,drying,end,extremely,forked,fresh,generally,globose,green,green-white,greenish,hair,hair-like,half,herb,lateral,like,long,lunate,make,membranous,mm,mottled,mucilaginous,narrow,odd-pinnate,ovoid,plant,pubescent,purple,scale-like,seed,short,singly,small,stem,subglabrous,subtending,terminal,testal,thick,throughout,truncate,typically,unwinged,usually,wall,wet,whitish,wing,x	erect,stolon
358	wfo-0001030057	success	197	138	101	118	79	20	99	2	-10,-2,.5-3.5,1-10,1-2,2-3-celled,2-4,2-4.5,2.1-4.1,20-30,20-80,3-5,3.5-8,4-10,4.3-8.2,5-10,5-6,5.5-12,7-14,8,8-19,abaxially,absent,adaxially,anther,apart,axillary,berry,blade,borne,brownish,bud,cell,chartaceous,cm,condition,connivent,corolla,covering,diameter,distal,drying,end,extremely,filament,flower,forked,fresh,fruit,generally,glabrous,globose,green,green-white,greenish,greenish-yellow,hair,hair-like,half,herb,homostylous,interjected,lanceolate,lateral,leaf,leaflet,like,lobe,long,lunate,make,membranous,middle,mm,mottled,mucilaginous,odd-pinnate,ovoid,pedicel,peduncle,pentagonal,petal,petiole,petiolule,plant,poricidal,pubescent,purple,rotate,scale-like,seed,short,singly,size,small,sometimes,star,stem,stigma,striped,style,subglabrous,subtending,terminal,testal,thick,throughout,tip,tube,tuber,typically,usually,wall,wet,white,whitish,x,yellow	2-3,2-5,2-6,5-merou,acumen,acuminate,acute,ag,along,alyx,apex,apparently,articulated,axe,base,broadly,ciliate,cordate,cuneate,decreasing,digestion,dorsally,eaf,edge,eed,elliptic,enzyme,erec,especially,exceeding,flat,folded,geminat,glabrou,globo,greatly,high,honeycomb-shaped,larger,lengthening,linear,living,lower,margin,midrib,minutely,narrow,nflorescence,orolla,ovate,ovate-lanceolate,pair,perfect,plurifoliate,pore,puberulent,removed,ruit,seudostipule,slit,spaced,specimen,stamen,ste,stolo,straight,suborbicular,tall,tamen,tem,thir,toward,tri-,truncate,unit,unwinged,vary,wing,ympodial	arrangement,calyx,colour,erect,form,growth,height,history,inflorescence,length,life,ovary,presence,pseudostipule,shape,spacing,stolon,surface,texture,type	-10,-2,.5-3.5,1-10,1-2,2-3-celled,2-4,2-4.5,2.1-4.1,20-30,20-80,3-5,3.5-8,4-10,4.3-8.2,5-10,5-6,5.5-12,7-14,8,8-19,abaxially,absent,adaxially,apart,axillary,berry,borne,brownish,bud,cell,chartaceous,cm,condition,connivent,covering,diameter,distal,drying,end,extremely,forked,fresh,generally,glabrous,globose,green,green-white,greenish,greenish-yellow,hair,hair-like,half,herb,homostylous,lanceolate,lateral,like,long,lunate,make,membranous,middle,mm,mottled,mucilaginous,odd-pinnate,ovoid,pentagonal,petal,plant,poricidal,pubescent,purple,rotate,scale-like,seed,short,singly,small,sometimes,star,stem,striped,subglabrous,subtending,terminal,testal,thick,throughout,tip,typically,usually,wall,wet,white,whitish,x,yellow	erect,stolon
359	wfo-0001030080	success	186	144	101	118	68	26	96	5	0.3-7,0.4-1.5,0.5-4,1-2,1-3,1.5-2,1.5-2.5,1.8-4.5,2-3,2-4,2.1-7.1,3-10,3-5,3.3-7.7,4-12,4-7,5-13.5,5-7,5.5-9.9,6.5-18.6,8-23,9.9-33,abaxially,acuminate,adaxially,anther,apex,articulated,axillary,base,blade,brownish,bud,cell,clavate,cm,condition,coriaceous,corolla,covering,cuneate,dark,decurrent,diameter,distal,dorsally,dot,drying,edge,elliptic,filament,flat,flower,folded,forked,fresh,fruit,generally,glabrous,green,green-white,greenish,hair-like,half,herb,high,homostylous,inconspicuous,lanceolate,lateral,leaf,leaflet,lengthening,light,lobe,make,mm,moniliform,mottled,mucilaginous,odd-pinnate,ovate,ovoid,pedicel,peduncle,petiole,plant,pore,poricidal,purple,pyriform,seed,size,slit,sometimes,stellate,stigma,straight,strongly,style,subtending,terminal,testal,thick,throughout,tiny,tip,tube,tuber,usually,wall,wet,white,whitish,width,winged,x,yellow	1999,5-merou,8-16,abaxiall,absent,acumen,ag,along,alyx,apart,apparently,arranged,axe,bead,berry,capitat,ccording,connivent,decreasing,digestion,eaf,eed,enzyme,erec,exceeding,geminat,glabrescent,glabrou,hair,hal,honeycomb-shaped,interjected,larger,like,linear,living,long,lower,medium,multiple,necklace,nflorescence,ochoa,onto,orolla,pair,perfect,plurifoliate,rachi,removed,second,seudostipule,slightly,spaced,specimen,stamen,stolon,subequal,tall,tamen,tem,toward,tri-,typically,unit,unknown,vary,ympodial	5-merous,abaxial,adaxial,age,arrangement,articulation,calyx,capitate,colour,erect,form,growth,height,history,inflorescence,length,life,na,ovary,porosity,pseudostipule,shape,spacing,stem,surface,texture	0.3-7,0.4-1.5,0.5-4,1-2,1-3,1.5-2,1.5-2.5,1.8-4.5,2-3,2-4,2.1-7.1,3-10,3-5,3.3-7.7,4-12,4-7,5-13.5,5-7,5.5-9.9,6.5-18.6,8-23,9.9-33,abaxially,acuminate,adaxially,articulated,axillary,brownish,bud,cell,clavate,cm,condition,coriaceous,covering,cuneate,dark,decurrent,distal,dorsally,dot,drying,elliptic,flat,folded,forked,fresh,generally,glabrous,green,green-white,greenish,hair-like,half,herb,high,homostylous,inconspicuous,lanceolate,lateral,lengthening,light,make,mm,moniliform,mottled,mucilaginous,odd-pinnate,ovate,ovoid,plant,pore,poricidal,purple,pyriform,seed,slit,sometimes,stellate,straight,strongly,subtending,terminal,testal,thick,throughout,tiny,tip,usually,wall,wet,white,whitish,winged,x,yellow	5-merous,age,capitate,erect,na
360	wfo-0001030081	success	157	118	85	91	66	27	81	4	.5,0.5-1,0.5-1.5,0.5-2.5,1,1-2,1-4,1-5,1.5,10-20,2-4,2-7,2-foliate,3-10,3-6,4-6,5-12,5-15,absent,abundant,acute,anther,apex,base,berry,brown,calyx,center,chartaceous,ciliate,cm,cordate,decurrent,densely,diameter,dm,drying,edge,elliptic,elliptic-ovoid,entire,filament,fine,flower,fruit,geniculate,glabrous,globose,hair,herb,immature,interpetalar,linear-lanceolate,lobe,long,margin,maturing,membranaceous,mm,moderately,nearly,oblong,obtuse,often,parallel,pedicel,peduncle,petiole,pubescent,radiating,raised,ridge,rotate,rounded,running,semitransparent,shallow,short,sparsely,stigma,style,surface,tissue,triangular,tube,two-celled,unbranched,usually,white,x,yellow	0.25-0.5,1-2-celled,1-3,1.5-3,1.5-7,10-35,1st,2nd,abaxially,adaxiall,adaxially,along,apically,axe,beyond,blade,cell,connected,dehiscing,denser,eaf,eed,emarginat,equal,explosively,exserted,few-branched,flat,frui,geminat,held,longer,lower,lying,maturit,mesocarp,nfloresence,notch,one,orolla,other,per,placenta,pointing,pressure,pubescen,rachi,rarely,ruit,single-,slightly,small,sometimes,stamen,straight,swollen,tal,tamen,tem,unit,vary,vein,watery,wid,woody,ympodial	abaxial,adaxial,arrangement,characteristic,colour,corolla,emarginate,form,geminate,glabrousnes,growth,height,inflorescence,leaf,length,na,new,ovary,plant,seed,shape,size,staman,stem,texture,type,wide	.5,0.5-1,0.5-1.5,0.5-2.5,1,1-2,1-4,1-5,1.5,10-20,2-4,2-7,2-foliate,3-10,3-6,4-6,5-12,5-15,absent,abundant,acute,apex,base,berry,brown,center,chartaceous,ciliate,cm,cordate,decurrent,densely,diameter,dm,drying,edge,elliptic,elliptic-ovoid,entire,fine,flower,fruit,geniculate,glabrous,globose,hair,herb,immature,interpetalar,linear-lanceolate,long,margin,maturing,membranaceous,mm,moderately,nearly,oblong,obtuse,often,parallel,petiole,pubescent,radiating,raised,ridge,rotate,rounded,running,semitransparent,shallow,short,sparsely,tissue,triangular,two-celled,unbranched,usually,white,x,yellow	emarginate,geminate,na,wide
361	wfo-0001030083	success	146	107	73	83	63	24	67	6	.5,.75,0.5-2,0.8-1,0.8-3,1-1.5,1-2,10-30,2-3,2-5-flowered,3-4,4-15,4-6,9-11,accrescent,acute,anther,apex,bark,base,berry,calyx,cm,corolla,decurrent,deeply,dia,drying,elliptic,exserted,flower,fruit,fruiting,glabrous,globose,green,greenish-white,hyaline,lateral,leaf,lobe,long,long-acuminate,long-styled,main,minutely,mm,narrowly,onto,ovary,ovate,ovoid-reniform,pair,pale,papillose,pedicel,petiole,pitted,poricidal,red-papillose,short-styled,shrub,simple,single-stemmed,slender,small-capitate,somewhat,soon,stem,stigma,strongly,style,surface,tan,tapering,tip,tube,vein,white,winged,woody,x,young	0.1,0.25-0.5,0.5-1,1.5-3,2,3/4,anthesi,beginning,broadly,closely,cup-shaped,dar,deciduous,deflexed,deltoid,dry,eaf,edicel,eed,elongate,fleshy,greyish-re,inflorescenc,internodal,lobed,lon,lower,membranous,middle,near,nflorescence,older,opposite,overlapping,paler,papillae,pore,prominent,proximal,raised,reddish-gold,reflexed,ruit,scar,shallowly,shaped,slightly,spaced,specimen,straight,tall,tear-drop,terminal,thickened,thin,translucent,tub,ud,unifoliat,unit,way,widest,ympodial	arrangement,bud,characteristic,colour,dark,diameter,exertion,form,greyish-red,growth,height,history,inflorescence,length,life,perennial,plant,seed,shape,size,texture,type,unifoliate,winging	.5,.75,0.5-2,0.8-1,0.8-3,1-1.5,1-2,10-30,2-5-flowered,3-4,4-15,4-6,9-11,accrescent,acute,base,berry,calyx,cm,decurrent,deeply,dia,drying,elliptic,exserted,flower,glabrous,globose,green,greenish-white,hyaline,leaf,long,long-acuminate,long-styled,minutely,mm,narrowly,onto,ovate,ovoid-reniform,pair,pale,papillose,petiole,pitted,poricidal,red-papillose,short-styled,shrub,simple,single-stemmed,slender,small-capitate,somewhat,soon,stem,strongly,surface,tan,tapering,tip,tube,white,winged,woody,x	-3,dark,di,greyish-red,perennial,unifoliate
362	wfo-0001030093	success	181	124	85	97	84	27	80	5	0.1-0.3,0.2-0.5,0.5-1.1,0.6-1.5,1-1.5,1-12,1-5,3.5-12,4-6,7-30,7-9,8-9,acuminate,acute,anther,apex,attenuate,bark,base,becoming,beneath,berry,branched,brownish-tan,calyx,campanulate,case,clavate,cm,continues,corolla,cuneate,densely,dia,ellipsoid,elliptic,erect,exserted,filament,fruiting,glabrous,globose,golden,green,greenish-white,growth,hirsutulous,lateral,leaf,lobed,main,margin,minutely,mm,narrowly,nearly,new,obovate,occasionally,often,opposite,ovary,ovoid-reniform,pair,pale,pedicel,petiole,pitted,plant,puberulent,pubescent,shaped,shiny,shoot,shrub,simple,size,slender,slightly,small,soon,stem,stigma,style,surface,tapering,tear-drop,terminal,tiny,tree,trichome,tube,uniseriate,vein,white,x,yellowish	.2,.5,0,0.2,0.2-1,0.75-1,1.3-4.5,2-2.5,2.5-11,3-4,5-50-flowered,5-8,anthesi,apar,closely,collection,commonly,deflexed,deltoid,differing,difoliate,eaf,edicel,eed,especially,evenly,except,expanded,flower,forest,free,furcate,geminat,greyish-brow,guyanese,hyaline,impressed,inundated,like,lobe,lon,long,long-styled,lower,major,many,member,middle,minor,nflorescence,older,one,onto,open,orbicular,paler,papillo,persisting,population,pore,poricidal,portion,present,quite,reflexed,remaining,ruit,scar,short-styled,southern,spaced,straight,tall,thickened,time,tip,tub,ud,underside,unit,widest,woody,ympodial,young	1.5-4,alternate,arrangement,bud,characteristic,colour,diameter,drying,exertion,form,fruit,glabrousnes,greyish-brown,height,history,inflorescence,length,life,lobing,na,papillose,peduncle,primary,seed,shape,texture,type	0.1-0.3,0.2-0.5,0.5-1.1,0.6-1.5,1-1.5,1-12,1-5,3.5-12,4-6,7-30,7-9,8-9,acuminate,acute,attenuate,base,becoming,beneath,berry,branched,brownish-tan,calyx,campanulate,case,clavate,cm,continues,cuneate,densely,dia,ellipsoid,elliptic,erect,exserted,glabrous,globose,golden,green,greenish-white,growth,hirsutulous,lateral,leaf,lobed,main,minutely,mm,narrowly,nearly,obovate,occasionally,often,opposite,ovoid-reniform,pair,pale,pitted,puberulent,pubescent,shaped,shiny,shoot,shrub,simple,slender,slightly,small,soon,tapering,tear-drop,terminal,tiny,tree,trichome,tube,uniseriate,vein,white,x,yellowish	1.5-4,alternate,greyish-brown,na,papillose
363	wfo-0001030145	success	152	116	82	95	57	21	82	0	-3,0.2-2,0.3-1-2.5,0.5,0.5-1,0.5-4,1,1-2,1-3,1-5,1.5-2,1.5-4.5,1.5-7,10-12,2-4,2.5-6.5,3-10,3-4,3-5,6-40,abaxially,acute,adaxially,adpressed,apart,apex,basal,base,calyx,campanulate,cm,compound,connective,cuneate,cylindrical,deltate,densely,diameter,dunal,ellipsoidal,elliptic-ovate,entire,exceeding,fide,fleshy,flower,forked,fruit,glabrous,glandular,globose,hair,herb,lanceolate,leaf,less,lobe,long,margin,mm,moderately,narrowly,obtuse,ovate-elliptic,pedicel,peduncle,petiole,pilose,puberulent,rachi,radiu,reddish,remnant,shorter,shrub,simple,sinuate,slender,slightly,somewhat,sparsely,stigma,style,subcordate,ternately,thecae,toward,triangular,truncate,tube,unbranched,unknown,violet,x,yellow	-2,1-1.5,1.5,2-3,3,4-5,4-8,4-foliat,8-11,absent,aggregate,also,ape,articulated,axe,beyond,blade,cell,chartaceous,color,directed,distally,eaf,eed,elliptic,exserted,larger,lateral,leaflet,leaving,lon,lower,near,nflorescence,nther,orolla,pedicellar,pore,presen,puberulen,ripe,ruit,spaced,stamen,stone,subcoriaceous,tal,tem,terminal,time,tomento,truncat,ud,unit,vary,wide,ympodial	anther,arrangement,bud,characteristic,colour,corolla,form,growth,height,inflorescence,length,number,ovary,per,plant,seed,shape,size,spacing,stem,texture	-3,0.2-2,0.3-1-2.5,0.5,0.5-1,0.5-4,1,1-2,1-3,1-5,1.5-2,1.5-4.5,1.5-7,10-12,2-4,2.5-6.5,3-10,3-4,3-5,6-40,abaxially,acute,adaxially,adpressed,apart,apex,basal,base,campanulate,cm,compound,cuneate,cylindrical,deltate,densely,dunal,ellipsoidal,elliptic-ovate,entire,exceeding,fide,fleshy,flower,forked,fruit,glabrous,glandular,globose,hair,herb,lanceolate,less,lobe,long,mm,moderately,narrowly,obtuse,ovate-elliptic,pilose,puberulent,reddish,shorter,shrub,simple,sinuate,slender,slightly,somewhat,sparsely,style,subcordate,ternately,thecae,toward,triangular,truncate,unbranched,unknown,violet,x,yellow	
364	wfo-0001030146	success	210	105	67	86	124	19	67	0	0.5â1,0.6â0.7,0.6â2,0.9â1,1.2â1.5,1â1.1,1â1.5,2.5â9,3â6,5â8,9â9.5,acuminate,acute,anther,anthesi,apex,axe,base,berry,branched,brown,brownish,c.,calyx,capitate,cm,coriaceous,corolla,dark,densely,diameter,drying,ellipsoidal,elliptic,entire,filament,flattened-reniform,fresh,fruiting,globose,golden,green,growth,halfway,inflorescence,leaf,length,like,many,margin,minutely,mm,narrowly,new,nodding,olive,pale,pedicel,peduncle,peltate,persistent,petiole,pitted,plant,pubescent,reddish,revolute,ripe,short-stalked,simple,small,stem,stigma,stout,style,surface,tan,terminal,time,tree,treelet,trichome,tube,way,white,â18	.1,.2,.5,0.2â0.4,0.5,1.5â2,16â20,20,20â30,2â5,3â4,40â50,4â30,4â4.5,5-merou,6.5â16,60+,6â7,8â15,>,abaxial,abaxially,absent,adaxial,ag,almost,along,alyx,apar,appearing,ark,articulated,beig,beneath,branching,bright,cell,center,closely,connivent,covered,cup-shaped,deeply,deltate,dense,dichasia,discolorous,eaf,echinoid,edge,eed,elongate,erec,exserted,flower,free,fused,glabrous,gradually,ilament,impressed,lamina,layer,lengthening,less,lobe,lobed,long,loosely,lower,midpoint,multangulate,narrowing,nflorescence,older,orolla,pair,papillose,part,per,perfect,pericarp,plurifoliate,pore,poricidal,portion,primary,projection,pubescence,ray,reflexed,regularly,rhachi,ruit,scar,scurfy,sessile,shiny,slit,spaced,sparsely,stellate,strongly,subtended,tall,tangled,tem,testal,thin,tiny,tip,ud,undersurface,unevenly,unit,upper,vary,varying,vein,visible,wide,woody,yellow,ympodial	arrangement,bark,bud,characteristic,colour,exertion,form,fruit,glabrousnes,height,history,life,lobing,ovary,seed,shape,size,texture,type	0.5â1,0.6â0.7,0.6â2,0.9â1,1.2â1.5,1â1.1,1â1.5,2.5â9,3â6,5â8,9â9.5,acuminate,acute,anthesi,axe,base,berry,branched,brown,brownish,c.,calyx,capitate,cm,coriaceous,dark,densely,drying,ellipsoidal,elliptic,entire,flattened-reniform,fresh,globose,golden,green,halfway,inflorescence,like,many,minutely,mm,narrowly,nodding,olive,pale,peltate,persistent,pitted,pubescent,reddish,revolute,ripe,short-stalked,simple,small,stout,tan,terminal,time,tree,treelet,trichome,tube,way,white,â18	
365	wfo-0001030147	success	156	71	35	49	107	22	34	1	0.5-2,1-5,10-19,14-35,15-30,2-10,2-10.5,2-13,2-3,2-5,2.5-7.5,4-5.5,4.2-7.5,4.5-10,5-8,blue,branched,calyx,cm,conical,corolla,cyme,diameter,dichasial,dichasially,ebracteate,finely,forked,herbaceous,interjected,lateral,leaf,leaflet,mm,monochasial,mucilaginous,odd-pinnate,ovoid,pedicel,peduncle,perennial,petiole,plant,pubescent,purple,seed,size,style,terminal	0-5,1-4,1.0-2.0,1.0-2.2,2,3-5-7-8,3-6-foliat,4-3.,8-38,abaxiall,abaxially,acumen,acuminate,acute,adaxially,apex,apical,apically,articulate,attenuate,base,cell,connate,covering,cuneate,deep,dehiscent,digestion,diminishing,distal,dorsally,eaf,edge,eed,elliptical,emoval,enzyme,exceeding,filament,flat,flower,folded,generally,globo,gradually,green,green-white,hair-like,half,honeycomb,introrse,living,lobe,lon,long,long-attenuate,lower,lunat,make,maturing,medium,narrowly,nflorescence,nther,oblique,obtuse,often,orolla,ovate,pair,pattern,perfect,petiolule,plan,poricidally,proximal,reveal,rotate,rounded,ruit,sessile,seudostipule,short,slit,specimen,stamen,stigma,straight,subequal,subsessile,tal,tem,testal,thick,throughou,throughout,tip,toward,tuber-bearing,typically,unit,vary,wall,wide,yellow,ympodial,Â¼	4-31,abaxial,adaxial,anther,arrangement,colour,form,fruit,growth,height,history,inflorescence,length,life,ovary,pseudostipule,shape,stem,surface,texture,type,width	0.5-2,1-5,10-19,14-35,15-30,2-10,2-10.5,2-13,2-3,2-5,2.5-7.5,4-5.5,4.2-7.5,4.5-10,5-8,blue,branched,cm,conical,cyme,dichasial,dichasially,ebracteate,finely,forked,herbaceous,mm,monochasial,mucilaginous,odd-pinnate,ovoid,perennial,pubescent,purple	4-31
366	wfo-0001030151	success	174	154	96	104	70	50	94	2	0.2-0.5,0.5,1-17,1-3,1.5-2.5,10-25,15-35-50,2-25,2-6,2-7-compound,20-30,3-14,3-5,3.5-32,5-6,6-9,abaxially,abundantly,acuminate,acute,adaxial,adaxially,apex,apiculate,around,axe,basal,base,beyond,blade,blotch,calyx,chartaceous,cm,connate,cordate,cuneate,decurrent,deltate,diameter,eglandular,elliptic,entire,except,exserted,flower,fruit,glabrous,glandular,glandular-puberulent,globose,hair,lanceolate,leaf,leaflet,less,lilac-tinged,line,lobe,long,longitudinal,margin,membranaceous,mm,narrowly,oblique,oblong,obovate,often,pedicel,peduncle,perfect,petiole,pinnately,probably,puberulent,pyriform,ring,ripe,sand-punctate,scattered,shallowly,short,simple,slender,slightly,sometimes,sparsely,stamen,stigma,stripe,style,surface,tip,tree,triangular,truncate,tube,unbranched,vein,white,x,yellow,yellow-green	-3,0.3-0.5,0.5-1,1,1-1.5,1-2,1-5,1.5-2,10-20,2-11,2-3,4-5,4-foliat,?,absent,aggregate,apart,ape,articulated,cell,channe,ciliat,compound,connective,cylindrical,directed,distally,eaf,eed,exceeding,glabrate,leaving,lon,lower,near,nflorescence,nther,obtuse,orolla,pedicellar,pore,presence,purplish,rachi,radiu,remnant,ruit,sand-punctat,shorter,small,somewhat,spaced,stalked,stellate,stone,tal,tem,thecae,time,toward,truncat,ud,unit,unknow,vary,veiny,white-puberulent,whitish,wide,ympodial	anther,appearance,arrangement,bark,border,branch,bud,channel,characteristic,colour,corolla,corrugation,distal,drying,exertion,filament,form,fruiting,giving,glabrousnes,growth,height,history,inflorescence,interjected,lateral,length,life,lobing,midpoint,na,new,number,ovary,per,plant,prickle,primary,pseudostipule,ray,seed,shape,size,stem,terminal,texture,thicknes,type,variation,width	0.2-0.5,0.5,1-17,1-3,1.5-2.5,10-25,15-35-50,2-25,2-6,2-7-compound,20-30,3-14,3-5,3.5-32,5-6,6-9,abaxially,abundantly,acuminate,acute,adaxial,adaxially,apex,apiculate,around,axe,basal,beyond,blade,blotch,chartaceous,cm,connate,cordate,cuneate,decurrent,deltate,eglandular,elliptic,entire,except,exserted,flower,fruit,glabrous,glandular,glandular-puberulent,globose,hair,lanceolate,less,lilac-tinged,line,lobe,long,longitudinal,membranaceous,mm,narrowly,oblique,oblong,obovate,often,perfect,petiole,pinnately,probably,puberulent,pyriform,ring,ripe,sand-punctate,scattered,shallowly,short,simple,slender,slightly,sometimes,sparsely,stamen,stripe,style,surface,tip,tree,triangular,truncate,unbranched,vein,white,x,yellow,yellow-green	channel,na
367	wfo-0001030153	success	147	120	80	97	50	23	79	1	.1,.2,/3,0.2-1,0.8-0.9,1-2,1-2.5,1.3-1.5,1.3-1.9,2-8,2-lobed,3-4,3-5,3-50,3.5-10.5,5-6,6-8,absent,acuminate,acute,age,anther,anthesi,apex,apparently,attenuate,bark,base,berry,branched,calyx,clavate,cm,conical,corolla,dark,diameter,distinct,domatia,ellipsoid,elliptic,entire,erect,exerted,filament,flower,fruiting,glabrous,globose,green,growth,impressed,internodal,lanceolate,lengthening,less,margin,minutely,mm,narrowly,new,nodding,occasionally,older,ovary,pair,papillate,pedicel,peduncle,petiole,pit-like,pore,poricidal,primary,revolute,ripe,simple,slightly,slit,small,stem,stigma,strongly,style,surface,terminal,time,tip,tree,treelet,tube,vein,way,white,x,yellowish,young	0.8-1.3,1-1.2,1-1.5,1-10,1.5-2,2.5-4,abaxially,adaxially,apart,ape,apiculate,axil,brittle,broadly,caly,campanulate,deltate,densely,dot,dry,eaf,enlarged,free,glabrou,irregularly,known,lobe,lobed,lower,markedly,membranous,nflorescence,ot,paler,papillat,perfect,plane,plurifoliat,portion,rachi,resinous,ruit,scar,spaced,specimen,straight,thin,ud,unit,ympodial	abaxial,adaxial,arrangement,bud,characteristic,colour,exertion,form,fruit,glabrousnes,height,history,inflorescence,leaf,length,life,lobing,na,plant,shape,size,texture,type	.1,.2,/3,0.2-1,0.8-0.9,1-2,1-2.5,1.3-1.5,1.3-1.9,2-8,2-lobed,3-4,3-5,3-50,3.5-10.5,5-6,6-8,absent,acuminate,acute,age,anthesi,apex,apparently,attenuate,base,berry,branched,calyx,clavate,cm,conical,dark,diameter,distinct,domatia,ellipsoid,elliptic,entire,erect,exerted,flower,glabrous,globose,green,impressed,internodal,lanceolate,lengthening,less,minutely,mm,narrowly,nodding,occasionally,older,pair,papillate,pit-like,pore,poricidal,revolute,ripe,simple,slightly,slit,small,stem,strongly,terminal,time,tip,tree,treelet,way,white,x,yellowish,young	na
368	wfo-0001030167	success	141	77	47	47	94	30	36	11	.8,.9,0.6,acuminate,anther,apex,base,berry,branch,chartaceous,cm,densely,diameter,entire,extra-axillary,flattened,flower,fruit,glabrous,green,herbaceous,lanceolate,margin,membranaceous,mm,obtuse,ovate,ovoid,pedicel,peduncle,petiole,pointed,rachi,rounded,sand-punctate,simple,slender,somewhat,stellate,stigma,style,thinly,unbranched,vine,weakly,white,x	0.1â0.2,0.5â0.6,0.5â0.7,0.6â0.8,0.7â1.2,0.8â1,1.2â2.5,1.5â2,1.5â7,12,14â19,15â20,17â58,1â1.2,1â1.5,2â3,2â4.5,4.5â8,4â10,4â4.5,4â5,4â7,5-merous,8â10,abaxially,accrescent,acute,adaxially,along,alyx,apar,apically,axe,blade,c.,calyx,ciliat,ciliate,clavate,climbing,contiguously,eaf,eed,enlarged,fertile,filament,fruiting,gap,glabrou,immature,less,lobe,long,lower,m.,maturity,membranous,minutely,moderately,near,nearly,nflorescence,nternode,orolla,pair,penden,perfec,petal,pinnate,plurifoliat,reflexed,ruit,scar,secondary,seen,slightly,spaced,sparsely,subequal,symmetrical,tamen,tem,time,tip,truncat,tube,unit,unknown,vary,vegetation,vein,venation,wide,ympodial	0.1-0.2,0.7-1.2,0.8-1,1-1.5,1.5-2,15-20,2-4.5,4-4.5,8-10,arrangement,characteristic,colour,corolla,form,growth,history,inflorescence,leaf,length,life,ovary,pendent,shape,size,staman,stem,surface,texture,truncate,type	.8,.9,0.6,acuminate,apex,berry,chartaceous,cm,densely,entire,extra-axillary,flattened,flower,fruit,glabrous,green,herbaceous,lanceolate,membranaceous,mm,obtuse,ovate,ovoid,pointed,rounded,sand-punctate,simple,slender,somewhat,stellate,thinly,unbranched,vine,weakly,white,x	0.1-0.2,0.7-1.2,0.8-1,1-1.5,1.5-2,15-20,2-4.5,4-4.5,8-10,pendent,truncate
369	wfo-0001030176	success	171	103	65	76	95	27	63	2	-4.25,-6.25,.2,.7,0.4-1.5,0.5-2,0.7-1.4,1,1.2-2.5,2-3,2.25-3.25,3-5,3-lobed,3.75-5,6-8,6â8,acute,anther,apex,attenuate,base,berry,bilobed,broadly,chartaceous,ciliate,cm,connivent,decumbent,depressed-globose,diameter,especially,extra-axillary,few-branched,filament,flattened-reniform,flower,fruit,glabrous,hair,herb,light,long,margin,midrib,mm,nearly,node,often,ovate,pale,pedicel,peduncle,petiole,plant,prostrate,pubescent,rachi,rarely,ripe,rotate-stellate,simple,slightly,sometimes,somewhat,sparsely,stigma,style,tube,unbranched,violet,white,x,yellow,yellow-orange,young	-1.4,.75-1.5,0.5,0.6-0.9,0.7â0.8,1-2,1-5,1.2,1.5-2,1.5-2.5,1.6,1/3,1/6,2-foliate,2.5,2.5â7.5,2.5â9,2â3,4-9,5-merou,abaxially,accrescent,adaxiall,adaxially,alyx,angulate,apart,apparently,articulated,asymmetrically,axe,ba,basal,bi-lobed,blade,branch,broad,calyx,capitat,contact,covering,cylindrical,dehiscent,downward,eaf,eed,erec,forming,fruiting,geminat,hermaphroditic,hold,interlobal,juic,lance-ovate,lanceolate-oblong,lateral,line,lobe,lon,longitudinall,lower,major,mesocarp,minutely,near,nflorescence,numerous,oblong,orolla,partially,patch,perfect,pore,recurve,recurved,rooting,round,ruit,sinus,soil,spaced,tamen,tem,terminal,time,tip,triangular,unit,vary,vein,white-puberulent,wide,winged,ympodial	abaxial,adaxial,arrangement,capitate,characteristic,colour,corolla,form,glabrousnes,growth,height,history,inflorescence,leaf,length,life,lobing,new,olong,ovary,seed,shape,size,stem,surface,texture,type	-4.25,-6.25,.2,.7,0.4-1.5,0.5-2,0.7-1.4,1,1.2-2.5,2-3,2.25-3.25,3-5,3-lobed,3.75-5,6-8,6â8,acute,attenuate,berry,bilobed,broadly,chartaceous,ciliate,cm,connivent,decumbent,depressed-globose,diameter,especially,extra-axillary,few-branched,flattened-reniform,flower,fruit,glabrous,hair,herb,light,long,midrib,mm,nearly,node,often,ovate,pale,prostrate,pubescent,rarely,ripe,rotate-stellate,simple,slightly,sometimes,somewhat,sparsely,unbranched,violet,white,x,yellow,yellow-orange,young	capitate,olong
370	wfo-0001030180	success	135	84	55	65	70	19	53	2	.1,0.8-2,0.9-1.8,1-1.5,1.1-1.2,3-8,4.5-5,6,8.5-23,?,abruptly,anther,apex,appearing,attenuate,bark,base,berry,calyx,clavate,cm,corolla,dark,decurrent,dia,ellipsoid,erect,fruit,fruiting,furcate,glabrous,globose,green,immature,leaf,linear,lobed,long-acuminate,mm,narrowing,nearly,occasionally,opposite,ovary,papillate,pedicel,petiole,puberulent,shaped,shrub,slightly,sparsely,stem,stigma,style,surface,tear-drop,terminal,trichome,tube,uniseriate,unknown,white,winged,x	.5,.75,0.05-1,0.5-1,10-30-flowered,3-4,8-10,accrescent,anthesi,apart,apiculate,becoming,clu,deflexe,deltoid,eaf,edicel,eed,exserted,filament,free,glabrate,height,inflorescenc,interpetalar,known,lateral,lenticellat,lobe,lon,long,lower,main,middle,minute,minutely,nflorescence,older,overlapping,pair,papillose,peduncl,planar,plurifoliat,pore,poricidal,portion,prominent,proximal,raised,rounded,ruit,scar,sinus,slender,soon,spaced,straight,thin,tip,ud,unevenly,unit,vein,widely,widest,woody,yellowish,ympodial,young	characteristic,colour,deflexed,diameter,form,growth,history,inflorescence,length,life,lobing,na,number,per,seed,shape,size,texture,type	.1,0.8-2,0.9-1.8,1-1.5,1.1-1.2,3-8,4.5-5,6,8.5-23,?,abruptly,appearing,attenuate,base,berry,calyx,clavate,cm,dark,decurrent,dia,ellipsoid,erect,furcate,glabrous,globose,green,immature,leaf,linear,lobed,long-acuminate,mm,narrowing,nearly,occasionally,opposite,papillate,petiole,puberulent,shaped,shrub,slightly,sparsely,tear-drop,terminal,trichome,tube,uniseriate,unknown,white,winged,x	deflexed,na
371	wfo-0001030189	success	185	116	75	89	96	27	72	3	/3,0-1,0-30,0.5-1.6,0.9-1.1,1,1-1.5,1.3-4.2,1.5-4.5,1/3,2-3,2-5.5,2.5-4,3.2-4.5,4-5.5,abaxially,anther,apex,apparently,articulated,bark,base,berry,branched,calyx,chartaceous,cm,concolorous,cordate,densely,diameter,drying,dull,elliptic,entire,erect,evenly,filament,flattened-reniform,flower,fruit,fruiting,glabrescent,gray,green,lateral,leaf,length,long,lower,margin,maturity,mauve,mm,moderately,oblong,obtuse,orange,ovate,pedicel,peduncle,per,petiole,poricidal,purple,red,rounded,scandent,shrub,simple,sometimes,sparsely,spherical,stellate-pubescent,stem,style,surface,tapering,terete,terminal,tip,tube,unarmed,upper,way,wide,yellow,yellow-green,young	.2,0-15,0.1,0.1-0.2,0.2-0.3,0.2-0.5,1-2,1-3-cellular,1-4-cellula,1-4-cellular,1.1-2.7-4,1.5-2,1.5-5,1/,1/6-1/3-1/2,2,3-4,4-13,5-10,5-6,5-8,5-8-10,5-merous,6-10,6-12,8-18,acut,alyx,apar,apically,appressed,blade,connivent,curved,deltate,eaf,eed,elongating,equal,faint,foliaceous,free,frui,glabrescen,glabrous,gland-tipped,infructescence,lobe,lobed,longer,mature,midpoint,nflorescence,often,older,one,open,orolla,oung,pair,perfec,pericarp,plurifoliat,porrect,portion,primary,ray,recurved,red-brow,reflexed,ruit,scar,sessile,shorter,slender,smooth,somewhat,spaced,spreading,stalk,stalked,stellate,strongly,tamen,tertiary,time,trichome,unarme,unit,variously,vary,vein,venation,visible,woody,ympodial	1/4,arrangement,branch,characteristic,colour,corolla,exertion,form,glabrousnes,growth,height,history,inflorescence,life,lobing,na,new,number,ovary,plant,red-brown,seed,shape,size,stigma,texture,type	/3,0-1,0-30,0.5-1.6,0.9-1.1,1,1-1.5,1.3-4.2,1.5-4.5,1/3,2-3,2-5.5,2.5-4,3.2-4.5,4-5.5,abaxially,apparently,articulated,base,berry,branched,chartaceous,cm,concolorous,cordate,densely,diameter,drying,dull,elliptic,entire,erect,evenly,flattened-reniform,flower,glabrescent,gray,green,lateral,long,lower,maturity,mauve,mm,moderately,oblong,obtuse,orange,ovate,per,poricidal,purple,red,rounded,scandent,shrub,simple,sometimes,sparsely,spherical,stellate-pubescent,tapering,terete,terminal,tip,unarmed,upper,way,wide,yellow,yellow-green,young	1/4,na,red-brown
372	wfo-0001030219	success	191	135	83	90	101	45	79	4	0.1â0.3,0.2â2.3,0.5,0.5â,0.7â1.1,1.0â2.2,1.5,1.6â,2.0â2.5,2.0â3.2,2.4â6.0,2â,2â3,3,4.8â11.5,4â5,4â7,60,6â8,9â10,abaxially,adaxially,anther,anthesi,base,black,blue,branched,brown,calyx,cm,decurrent,deeply,densely,diameter,elliptic,filament,flattened,flower,fruit,glabrescent,glabrous,globose,green,hair,incised,indistinct,lanceolate,leaf,lilac,lobe,long,margin,marking,mm,moderately,multicellular,number,oblong,olive,ovate,pair,pale,paler,pedicel,peduncle,perennial,petiole,pitted,pubescent,purple,regularly,shallowly,shrub,simple,size,spaced,sparsely,stigma,style,surface,time,tube,unicellular,uniseriate,velutinous,winged,woody,x,â9.5	0.4â1.0,0.8â3.0,0â,1.0â1.2,1.0â1.5,1.0â2.0,1.3â2.9,1.4â2.8,10,15,1â2.5,2.0â5.5,2â2.5,2â4.5,4.5â5.5,5,5â,5â8,6â,6â10,7â11,8â18,9â12,abaxiall,acut,acute,adaxiall,adnate,ag,along,anisophyllous,apart,apex,apical,apparently,appearing,arising,arranged,articulated,axe,ba,basal,blade,bractâlike,cell,chartaceous,clavat,concave,connivent,convex,cylindrical,decreasing,diamete,difoliate,directed,distally,eaf,eed,equal,erect,geminat,internode,longitudinal,lower,nflorescence,opening,opposed,oppositely,orolla,pentagonal,perfect,pore,present,procumbent,rapidly,redâpurple,rounded,ruit,serrate,sessile,sid,side,smaller,split,stone,straight,stripe,strongly,tal,tamen,tem,two,unit,vary,white,wide,wing,yellow,ympodial,â3.0,â7.0	appearance,arrangement,border,branch,bud,characteristic,clavate,colour,corolla,distal,drying,exertion,form,fruiting,giving,glabrousnes,growth,height,history,inflorescence,interjected,lateral,leaflet,length,life,lobing,mentioned,na,new,opposite,ovary,per,plant,prickle,primary,pseudostipule,seed,shape,stem,terminal,texture,type,variation,vein,width	0.1â0.3,0.2â2.3,0.5,0.5â,0.7â1.1,1.0â2.2,1.5,1.6â,2.0â2.5,2.0â3.2,2.4â6.0,2â,2â3,3,4.8â11.5,4â5,4â7,60,6â8,9â10,abaxially,adaxially,anthesi,base,black,blue,branched,brown,cm,decurrent,deeply,densely,diameter,elliptic,flattened,flower,fruit,glabrescent,glabrous,globose,green,hair,incised,indistinct,lanceolate,leaf,lilac,lobe,long,marking,mm,moderately,multicellular,number,oblong,olive,ovate,pair,pale,paler,perennial,petiole,pitted,pubescent,purple,regularly,shallowly,shrub,simple,spaced,sparsely,time,unicellular,uniseriate,velutinous,winged,woody,x,â9.5	clavate,mentioned,na,opposite
373	wfo-0001030225	success	151	123	61	72	79	51	60	1	.5-2.5,1,1-4,1-6,10-15-30,10-30,2-18,2-3,2-6,3-11-compound,3-20,3-5,4-5,8-15,abaxially,acuminate,acute,adaxially,apex,apical,basal,base,bilobed,calyx,cm,conivent,cordate,cuneate,densely,diameter,elliptic-ovate,entire,expanded,flower,forked,fruit,glabrous,gland,globose,leaf,leaflet,less,lobe,long,margin,mm,moderately,narrowly,oblong,obtuse,pedicel,peduncle,petiole,pinnately,possibly,puberulent,purple,shallowly,shrub,simple,small,sparsely,stigma,style,succulent,tree,triangular,truncate,tube,two,unbranched,x	-1.5,-11,.5,0-20,0-45,0-5,1.5,1.5-2.5-7,2,2-2.5-4,3-4,3-foliat,absent,apart,ape,apically,articulated,ature,axe,beyond,blade,campanulate,color,compound,connective,coriaceous,cylindrical,deltate,dilated,directed,distally,eaf,eed,equal,especially,exceeding,exserted,fleshy,glabrate,immature,laterally,leaving,lower,minutely,nflorescence,nther,one,orolla,papillose,perfect,pore,prominent,puberulen,rachi,radiu,scar,see,seen,slightly,somewhat,spaced,stalked,stamen,stellate,strongly,tal,tem,thecae,time,tip,tomento,toward,ud,unit,unknow,unknown,vary,wide,ympodial	anther,appearance,arrangement,bark,border,branch,bud,characteristic,colour,corolla,corrugation,distal,drying,exertion,filament,form,fruiting,giving,glabrousnes,growth,height,history,inflorescence,interjected,lateral,length,life,lobing,midpoint,na,new,number,ovary,per,plant,prickle,primary,pseudostipule,ray,seed,shape,size,stem,surface,terminal,texture,thicknes,type,variation,vein,width	.5-2.5,1,1-4,1-6,10-15-30,10-30,2-18,2-3,2-6,3-11-compound,3-20,3-5,4-5,8-15,abaxially,acuminate,acute,adaxially,apex,apical,basal,bilobed,cm,conivent,cordate,cuneate,densely,diameter,elliptic-ovate,entire,expanded,flower,forked,glabrous,gland,globose,less,lobe,long,mm,moderately,narrowly,oblong,obtuse,pinnately,possibly,puberulent,purple,shallowly,shrub,simple,small,sparsely,succulent,tree,triangular,truncate,two,unbranched,x	na
374	wfo-0001030250	success	169	99	64	77	92	22	62	2	/4,0.5-1,1-1.5,1-3,1.1-1.2,1.4-1.5,1.7-7,1.9-2.6,2-2.5,3.5-4,4-7,5-6,anther,bark,base,berry,brown,bullate,calyx,capitate,cm,conical,corolla,curved,dark,decurrent,dia,dry,elliptic-ovate,exerted,fruiting,glabrous,globose,green,greenish-white,greenish-yellow,horizontally,inflorescence,leaf,lobe,lobed,minutely,mm,node,ovary,ovoid-reniform,pale,papillose,pedicel,petiole,pitted,sea-green,seed,shape,shaped,shrub,simple,size,slender,slightly,soon,specimen,spreading,stem,stigma,straight,style,surface,tan,tapering,tear-drop,translucent-green,tube,way,white-lenticellate,winged,x	.5,0-seeded,1.1-3.5,1.25-1.5,11.2-22,11.3,2.1-6,2.5-3.25,25,3-5,3.4-6.6,5-50-flowered,6-8,across,anthesi,apart,apex,appearing,arching,attenuate,beginning,beneath,broadly,carinate-hooded,consisting,cuneate,cup-shaped,deflexed,differing,difoliate,eaf,edicel,eed,elliptic,filament,five,free,fresh,geminat,glabrou,inflorescenc,irregularly,lateral,lon,long,long-acuminate,lower,main,major,maturity,middle,minor,n,nflorescence,occasionally,older,one,opposite,orbicular,orbiculate,pair,paler,papillo,pendulous,pit,pore,poricidal,portion,projection,prominent,proximal,raised,reflexed,rim,ruit,scar,shallow,smooth,spaced,tall,tip,translucent,two,ud,unit,usually,vein,white-lenticellat,wide,widest,woody,ympodial	abaxial,adaxial,alternate,arrangement,bud,characteristic,colour,diameter,exertion,form,fruit,growth,height,history,length,life,lobing,peduncle,perennial,plant,texture,type	/4,0.5-1,1-1.5,1-3,1.1-1.2,1.4-1.5,1.7-7,1.9-2.6,2-2.5,3.5-4,4-7,5-6,base,berry,brown,bullate,calyx,capitate,cm,conical,curved,dark,decurrent,dia,dry,elliptic-ovate,exerted,glabrous,globose,green,greenish-white,greenish-yellow,horizontally,leaf,lobe,lobed,minutely,mm,node,ovoid-reniform,pale,papillose,pitted,sea-green,shaped,shrub,simple,slender,slightly,soon,specimen,spreading,straight,tan,tapering,tear-drop,translucent-green,tube,way,white-lenticellate,winged,x	alternate,perennial
375	wfo-0001030271	success	195	121	74	97	98	24	72	2	0-2,0.15-0.75,0.7-9.5,0.9-2.5,1-2,1-2.5,1-3,1-7,1.4-2.1,1.9-6.6,15-61,2-2.7,2-3,2-4,2-6,2.4-5.6,3-10,3-5,3.4-7.5,4-7,5-8,5.6-12.3,6-15,acumen,anther,berry,blade,blue,brownish,clavate,cm,coloration,completely,condition,coriaceous,corolla,dark,deep,diameter,drying,elliptic,erect,filament,flower,forked,fresh,fruit,glabrous,green,green-white,greenish,herb,homostylous,interjected,lanceolate,lateral,leaf,leaflet,light,lilac,lobe,long,medium,mm,moniliform,mottled,mucilaginous,odd-pinnate,ovate,ovoid,pair,pedicel,peduncle,pentagonal,petiole,plant,purple,ripe,rotate,seed,size,slightly,spot,stigma,straight,style,terminal,throughout,tube,tuber,vein,wet,white,whitish,wide,x,yellow	0.5-1.2,0.9-3.6,1-4,1-6,4-22,5-merou,abaxially,acute,adaxiall,adaxially,ag,along,alyx,apart,apex,apparently,arranged,articulated,asymmetric,attenuate,axe,axillary,base,basiscopic,bead,bud,capitat,cell,connivent,considerably,covering,decreasing,digestion,distal,dorsally,eaf,edge,eed,enzyme,exceeding,flat,folded,geminat,generally,glabrou,habi,hair-like,half,honeycomb-shaped,larger,lengthening,like,linear,living,lower,make,middl,multiple,necklace,nflorescence,orbicular,orolla,perfect,petiolulate,plurifoliate,pore,poricidal,removed,rosette,rounded,ruit,sessile,seudostipule,side,slit,sometimes,spaced,specimen,stamen,stolon,subtending,symmetric,tall,tamen,tem,testal,thick,tip,tissue,toward,tri-,typically,unit,unwinged,usually,vary,wall,ympodial	abaxial,adaxial,arrangement,articulation,calyx,capitate,colour,form,glabrousnes,growth,height,history,inflorescence,length,life,middle,ovary,pseudostipule,shape,spacing,staman,stem,surface,texture	0-2,0.15-0.75,0.7-9.5,0.9-2.5,1-2,1-2.5,1-3,1-7,1.4-2.1,1.9-6.6,15-61,2-2.7,2-3,2-4,2-6,2.4-5.6,3-10,3-5,3.4-7.5,4-7,5-8,5.6-12.3,6-15,berry,blue,brownish,clavate,cm,coloration,completely,condition,coriaceous,dark,deep,drying,elliptic,erect,forked,fresh,glabrous,green,green-white,greenish,herb,homostylous,lanceolate,light,lilac,long,medium,mm,moniliform,mottled,mucilaginous,odd-pinnate,ovate,ovoid,pentagonal,purple,ripe,rotate,slightly,spot,straight,throughout,vein,wet,white,whitish,wide,x,yellow	capitate,middle
376	wfo-0001030272	success	179	128	87	103	76	25	85	2	.3,.5,/4,0-20,0.5-1,0.5-1.5,0.5-2,0.6-0.9,0.65-1,0.7-2.5,0.8-1.5,1,1-1.5,1-2.8,1.2-1.8,1.5-2.5,2-6.5,2.5-3,2.5-3.5,2.8-3.5,4-6,4-8,abaxially,acute,almost,anther,apex,apically,apparently,articulated,bark,base,berry,bright,calyx,cm,concolorous,deltate,densely,diameter,drying,elliptic,entire,erect,evenly,filament,flattened-reniform,flower,fruit,fruiting,glabrescent,glabrous,green,lateral,leaf,length,less,lobe,long,long-attenuate,margin,maturity,mauve,membranous,mm,near,obtuse,orange-brown,pair,pedicel,peduncle,per,petiole,poricidal,primary,red,red-brown,rounded,shallowly,shrub,simple,slender,sometimes,sparsely,spherical,stellate-pubescent,stem,straight,style,surface,tapering,terete,terminal,tip,trichome,tube,unarmed,unbranched,undulate,vein,way,wide,young	-6,0.05-0.1,0.05-1.5,1.5-3,1/3,1/3-2/3,10-20,2-2.5,3-8,3.5-5,4-10,4-15,5-7,5-merous,acut,alyx,ame,apar,ba,blade,c.,connivent,difoliate,eaf,eed,elongating,equal,free,geminat,glabrescen,gland,glandular,gra,hair,infructescence,lobed,longer,lower,mature,midpoint,minute,moderately,multangulate,narrow-deltate,nflorescence,older,one,open,orolla,oung,perfec,pericarp,porrect,portion,ray,reduced,reflexe,ruit,scar,sessile,shorte,smooth,spaced,spreading,stellate,tamen,tertiary,time,unarme,unit,upper,vary,venation,visible,woody,ympodial	arrangement,branch,bud,characteristic,colour,corolla,exertion,form,glabrousnes,gray,growth,height,inflorescence,lobing,na,new,number,ovary,plant,seed,shape,size,stigma,texture,type	.3,.5,/4,0-20,0.5-1,0.5-1.5,0.5-2,0.6-0.9,0.65-1,0.7-2.5,0.8-1.5,1,1-1.5,1-2.8,1.2-1.8,1.5-2.5,2-6.5,2.5-3,2.5-3.5,2.8-3.5,4-6,4-8,abaxially,acute,almost,apically,apparently,articulated,base,berry,bright,cm,concolorous,deltate,densely,diameter,drying,elliptic,entire,erect,evenly,flattened-reniform,flower,glabrescent,glabrous,green,lateral,less,lobe,long,long-attenuate,maturity,mauve,membranous,mm,near,obtuse,orange-brown,pair,per,poricidal,red,red-brown,rounded,shallowly,shrub,simple,slender,sometimes,sparsely,spherical,stellate-pubescent,straight,surface,tapering,terete,terminal,tip,trichome,unarmed,unbranched,undulate,way,wide,young	gray,na
377	wfo-0001030287	success	148	133	95	106	42	27	92	3	-40,0-15,0.5-1,1,1-10,1-15,1-2,1-2.5,1-3,1-4,1-5.5,1.5-10,1.5-2.5,1966,2,2-10,2-12,2-3-9-11,2-5,2.5-4,3,4-5,4.5-6,5-10,8-13,abaxially,acute,adaxially,apart,apex,base,bluish,branched,calyx,chartaceous,cm,compound,cylindrical,deltate,dendritic,dendritically,densely,diameter,directed,down,eglandular,ellipsoidal,elliptic-ovate,entire,fide,flattened,flower,forked,glabrous,gland,glandular,hair,herb,lanceolate,leaf,leaving,lilac,lobe,long,long-stalked,margin,membranaceous,mm,moderately,narrowly,oblong,often,ovoid,pedicel,pedicellar,peduncle,petiole,pinnately,pore,puberulent,pubescent,purple,rachi,radiu,rugulose,scar,scattered,shrub,simple,slightly,smith,sparsely,stalked,stellate,stigma,strongly,style,subcordate,tip,triangular,truncate,tube,unbranched,unknown,x,yellow	-foliat,-many,.5-2.5,4-6,?,adaxiall,aggregate,articulated,axe,basiscopically,blade,cell,color,connivent,decurrent,dendritic-pubescen,distall,eaf,eed,lateral,leaflet,lon,lower,nflorescence,nther,obtuse,orolla,presen,ruit,spaced,sparser,stone,subcapitat,subcoriaceous,tal,tem,time,unit,upper,vary,wide,ympodial	abaxial,adaxial,anther,arrangement,articulation,characteristic,colour,corolla,dendritic-pubescent,direction,distally,form,fruit,glabrousnes,growth,height,inflorescence,length,ovary,plant,seed,shape,size,spacing,stem,subcapitate,texture	-40,0-15,0.5-1,1,1-10,1-15,1-2,1-2.5,1-3,1-4,1-5.5,1.5-10,1.5-2.5,1966,2,2-10,2-12,2-3-9-11,2-5,2.5-4,3,4-5,4.5-6,5-10,8-13,abaxially,acute,adaxially,apart,apex,base,bluish,branched,chartaceous,cm,compound,cylindrical,deltate,dendritic,dendritically,densely,directed,down,eglandular,ellipsoidal,elliptic-ovate,entire,fide,flattened,flower,forked,glabrous,gland,glandular,hair,herb,lanceolate,leaving,lilac,long,long-stalked,membranaceous,mm,moderately,narrowly,oblong,often,ovoid,pedicellar,pinnately,puberulent,pubescent,purple,rugulose,scar,scattered,shrub,simple,slightly,smith,sparsely,stalked,stellate,strongly,subcordate,tip,triangular,truncate,unbranched,unknown,x,yellow	dendritic-pubescent,distally,subcapitate
378	wfo-0001030300	success	232	141	98	111	121	30	93	5	-7,0.4-0.5,0.5,0.5-0.6,0.5-4,0.7-1.2,0.9-1,1,1-1.3,1-2,1-4,1.4-2.4,2-2.1,2-2.5,2-foliate,2-locular,3/4,4-11,adaxially,almost,anther,anthesi,apex,appendage,articulated,basal,base,bifid,brittle,broadly,brown,calyx,capitate,cell,cm,cordate,corolla,crenate,curved,deltate,densely,diameter,distal,ellipsoidal,elliptical,elongate,entire,filament,finely,fruit,fruiting,glabrous,globose,golden,green,hair-like,halfway,herb,imparipinnate,inflorescence,interrupted,introrse,irregularly,large,lateral,less,like,long,margin,mm,obovate,occasionally,once-branched,orbicular,outgrowth,ovary,pale,pedicel,peduncle,pentagonal,perennial,petiole,plant,population,pore,primary,pubescent,rounded,simple,slightly,sparsely,spathulate,stem,stigma,strongly,style,surface,testa,thick,triangular,tube,unit,united,vein,wall,wide,woody,yellow,yellowish,yellowish-green,zygomorphic	.5,0.1,0.1-0.15,0.15-1,0.2,0.2-0.5,0.2-1.5,0.4-1.5,0.4-4.5,0.5-0.6-0.9,0.5-1,0.5-5,0.6-0.7-1,0.6-0.8-1,0.7-0.8,0.7-1.5,0.8-1,0.8-3,0.8-4,1-2-celled,1-6,1-celled,1.2-2.2-7.5,1.5-2.5,1.5-3.5-13,2-3,2-4,4-celled,6-15,6-8-celled,9-12,abaxially,absent,abundant,acute,adaxial,although,always,apical,appearance,articulation,ba,bent,beyond,bract,bracteate,coherent,column,crenat,developed,diamete,eaf,edicel,eed,eglandular,even,exserted,face,flower,frequently,give,glandular,glutinous-viscose,gree,head,interjected,internode,lamina,larger,leaflet,leave,lobe,lon,longer,markedly,midvein,minute,moderately,multicellular,narrowly,nflorescence,node,oblique,pair,papillae,partially,petal,petiolule,pith,present,pseudostipule,pubescence,reflexed,rest,ruit,secondary,silky,spreadin,spreading,staminal,sterile,straight,tall,tem,terminal,tertiary,tip,trichome,two,ud,underlying,unicellular,uniseriate,upper,usually,velvety,weak,well,wider,winged,ympodial	1.2-7.5,1.5-13,arrangement,bark,branch,bud,characteristic,colour,corrugation,drying,exertion,form,glabrousnes,growth,height,history,leaf,length,life,lobing,na,new,number,per,seed,shape,size,sympodial,texture,type	-7,0.4-0.5,0.5,0.5-0.6,0.5-4,0.7-1.2,0.9-1,1,1-1.3,1-2,1-4,1.4-2.4,2-2.1,2-2.5,2-foliate,2-locular,3/4,4-11,adaxially,almost,anthesi,appendage,articulated,basal,base,bifid,brittle,broadly,brown,calyx,capitate,cell,cm,cordate,crenate,curved,deltate,densely,diameter,distal,ellipsoidal,elliptical,elongate,entire,finely,glabrous,globose,golden,green,hair-like,halfway,herb,imparipinnate,interrupted,introrse,irregularly,large,lateral,less,like,long,mm,obovate,occasionally,once-branched,orbicular,outgrowth,pale,pentagonal,perennial,population,pore,pubescent,rounded,simple,slightly,sparsely,spathulate,stem,strongly,testa,thick,triangular,tube,unit,united,wall,wide,woody,yellow,yellowish,yellowish-green,zygomorphic	1.2-7.5,1.5-13,leaf,na,sympodial
379	wfo-0001030311	success	182	130	66	86	96	44	63	3	.2,0.6â1,0.8â1.2,1.2â7,1.5â5.5,1.5â8,1.8â2,15â22,1â1.5,1â2.5,1â3,2.2â2.5,2.2â3,2â2.5,2â6,3â5,5-pinnate,5â10,acuminate,acute,anther,apex,appearance,base,berry,brown,calyx,chartaceous,clavate,cm,cordate,deltoid,densely,diameter,distal,entire,extra-axillary,filament,flattened,flower,fruit,fruiting,giving,glabrous,granular,green,half,herbaceous,lanceolate,lateral,leaflet,lenticular,lobe,lower,margin,membranaceous,minutely,mm,oblique,obtuse,orangish,ovoid-rhomboid,papillose,pedicel,peduncle,petiole,pubescent,purplish,rounded,sand-punctate,slender,slightly,sparsely,stem,stigma,style,surface,tan,thickened,tip,tube,unbranched,vein,vine,white,x	.5,.5â1.8,0.1,0.1â0.2,0.3â1.5,0.4â2,0.5â0.8,0.5â1,0.5â2,0.5â2.5,0.6â2.4,0.8â4,0.8â4.5,1.5â2,1.5â3,1.5â6,1â1.2,1â2,2.5â9,2â10,3â7,<,abaxially,accrescent,adaxial,adaxially,along,alyx,apar,apical,axe,basal,blade,c.,capitat,ciliat,ciliate,color,cuneate,dense,eaf,eed,elliptical,especially,falcate,fallen,glabrou,groov,groove,ground,hair,like,log,lon,long,m.,membranous,midvein,nflorescence,nternode,obovate,occasionally,orolla,pair,petiolulate,petiolule,plurifoliat,present,proximal,pubescence,rachi,rhomboid,ruit,scattered,sessile,short,shortly,side,smaller,spaced,stellate,strongly,tamen,tem,terrestrial,thick,thinner,trailing,trichome,unit,upper,vary,wide,wide-diameter,widely,ympodial	0.5,arrangement,bark,border,branch,bud,capitate,characteristic,colour,corolla,corrugation,drying,exertion,form,glabrousnes,growth,height,history,inflorescence,interjected,leaf,length,life,lobing,midpoint,na,new,number,ovary,per,plant,prickle,primary,pseudostipule,ray,seed,shape,size,terminal,texture,thicknes,type,variation,width	.2,0.6â1,0.8â1.2,1.2â7,1.5â5.5,1.5â8,1.8â2,15â22,1â1.5,1â2.5,1â3,2.2â2.5,2.2â3,2â2.5,2â6,3â5,5-pinnate,5â10,acuminate,acute,berry,brown,chartaceous,clavate,cm,cordate,deltoid,densely,entire,extra-axillary,flattened,flower,fruit,glabrous,granular,green,half,herbaceous,lanceolate,lenticular,lower,membranaceous,minutely,mm,oblique,obtuse,orangish,ovoid-rhomboid,papillose,pubescent,purplish,rounded,sand-punctate,slender,slightly,sparsely,tan,thickened,tip,unbranched,vine,white,x	0.5,capitate,na
380	wfo-0001030311	success	201	105	67	78	123	27	64	3	.2,.5,0.6-1,1-1.5,1-2.5,1-3,1.5-2,1.5-5.5,1.8-2,15-22,2-6,2.2-2.5,2.2-3,3-5,5-10,5-pinnate,abaxially,acuminate,acute,adaxial,adaxially,anther,apex,basally,base,brown,chartaceous,cm,cordate,deltoid,densely,diameter,entire,especially,filament,flattened,flower,fruit,glabrous,granular,green,groove,half,herb,lenticular,long,lower,margin,membranaceous,minutely,mm,oblique,oblong,obtuse,orangish,ovoid-rhomboid,papillose,pedicel,peduncle,petiole,pubescent,purplish,rounded,slender,slightly,sparsely,stem,stigma,style,surface,tan,thickened,tip,tube,unbranched,vein,white,x	.5-1.8,0-2.5,0.1,0.4-2,0.5-0.8,0.5-1,0.5-2,0.6-2.4,0.8-1.2,0.8-4,0.8-4.5,1-1.2,1.2-7,1.5-3,1.5-6,1.5-8,2-10,2-2.5,2224,3-7,5-merou,8031,<,absen,absent,accrescent,ag,aggregate,along,alyx,apart,apical,apparently,appearance,articulated,axe,ba,basal,blade,capitat,cell,ciliat,ciliate,clavate,color,connivent,cuneate,dense,dig,directed,distal,distally,eaf,eed,elliptical,equal,falcate,fallen,formation,g,geminat,gh,giving,groov,ground,hair,interjected,large,lateral,leaflet,like,lobe,log,lon,longitudinal,m.,midvein,nflorescence,node,obovate,occasionally,opening,orolla,pair,perfect,petiolulate,petiolule,pittier,plurifoliate,pore,present,proximal,rachi,rhomboid,rooting,ruit,scattered,sessile,short,shortly,side,simple,sinple,slit,smaller,spaced,stellate,stone,strongly,tamayo,tamen,tem,thick,thinner,trailing,uniseriate,unit,upper,vary,wide,widely,yellow,ympodial	arrangement,calyx,capitate,characteristic,colour,corolla,exertion,form,glabrousnes,growth,history,inflorescence,leaf,length,life,lobing,na,new,number,ovary,per,perennial,seed,shape,size,texture,type	.2,.5,0.6-1,1-1.5,1-2.5,1-3,1.5-2,1.5-5.5,1.8-2,15-22,2-6,2.2-2.5,2.2-3,3-5,5-10,5-pinnate,abaxially,acuminate,acute,adaxial,adaxially,basally,brown,chartaceous,cm,cordate,deltoid,densely,entire,especially,flattened,flower,fruit,glabrous,granular,green,groove,half,herb,lenticular,long,lower,membranaceous,minutely,mm,oblique,oblong,obtuse,orangish,ovoid-rhomboid,papillose,pubescent,purplish,rounded,slender,slightly,sparsely,tan,thickened,tip,unbranched,vein,white,x	capitate,na,perennial
381	wfo-0001030335	success	153	115	89	94	59	21	84	5	.25,0-5,0.05-0.2,0.5-1,0.7-1,1-1.5,1-2,1-3-flowered,1.1-1.4,1.1.5,2-2.2,2-5,2.5-3,5-6,acuminate,acute,along,anther,apex,bark,base,beneath,berry,bi-lobed,branch,bud,calyx,cm,conical,corolla,dark,deciduous,decurrent,densely,dia,dry,elliptic,erect,exserted,filiform,flattened,fruiting,gently,giving,glabrous,globose,green,greyish-red,horizontally,leaf,lightly,like,long,material,minute,minutely,mm,narrowly,obovoid,often,older,onto,opposite,ovary,ovoid-reniform,pale,papillose,pedicel,petiole,pitted,puberulent,pubescent,ripe,shaped,shrub,simple,soon,spreading,stem,stigma,style,surface,tan,tapering,tear-drop,trichome,tube,uniseriate,vein,white,winged,x,yellowish-green,young	.1,.5,.75,0.1-0.5,0.25-0.5,2-2.5,2-4.5,3/4,5-7,7-13,anthesi,aspec,ba,deflexed,deltoid,eaf,edicel,eed,except,expanded,filament,free,geminate,lamina,lateral,lenticellate,lobe,lobed,lon,lower,main,middle,nflorescence,occasionally,pair,papillo,pore,poricidal,portion,prominent,puberulen,raised,reflexed,ruit,slightly,sparsely,straight,strongly,tall,tip,ud,underside,unifoliat,unit,way,widest,woody,yellow,ympodial	arrangement,aspect,characteristic,colour,diameter,form,fruit,growth,height,history,inflorescence,length,life,perennial,plant,seed,shape,size,texture,type,unifoliate	.25,0-5,0.05-0.2,0.5-1,0.7-1,1-1.5,1-2,1-3-flowered,1.1-1.4,1.1.5,2-5,2.5-3,5-6,acuminate,acute,along,apex,base,beneath,berry,bi-lobed,bud,calyx,cm,conical,corolla,dark,deciduous,decurrent,densely,dia,dry,elliptic,erect,exserted,filiform,flattened,gently,giving,glabrous,globose,green,greyish-red,horizontally,leaf,lightly,like,long,material,minute,minutely,mm,narrowly,obovoid,often,older,onto,opposite,ovoid-reniform,pale,papillose,petiole,pitted,puberulent,pubescent,ripe,shaped,shrub,simple,soon,spreading,stem,tan,tapering,tear-drop,trichome,tube,uniseriate,vein,white,winged,x,yellowish-green,young	-2.2,aspect,di,perennial,unifoliate
382	wfo-0001030336	success	262	200	147	162	100	38	142	5	-10,.5,0.1-0.5,0.1-0.7,0.15-0.9,0.2-0.25,0.2-1,0.5,0.5-0.7,0.8-1.3,1,1-1.4,1-1.5,1-3,1-celled,1.0-1.4,1.5-2,1.6-7,1.7-2.3,1.8-3.0,1/4-1/3,4-10-19,4-celled,8-celled,acute,adpressed,almost,amongst,anther,anthesi,apex,appearance,articulated,base,basiscopically,bent,berry,bluntly,branch,bright,brown,calyx,capitate,cell,cm,coat,conical,corolla,crenate,curved,dark,darker,decurrent,deeply,densely,diameter,distal,eglandular,elliptic,elongate,entire,exserted,extremely,filament,flushed,fruit,fruiting,giving,glandular,globose,grayish,green,greenish,hair-like,half,halfway,head,herb,imparipinnate,inflorescence,interjected,interrupted,investing,large,lateral,leaf,leaflet,less,like,lobe,lobed,long,longer,loosely,margin,markedly,midvein,minutely,mixed,mm,narrowing,oblique,obovate,occasionally,orbicular,outgrowth,ovary,pale,pedicel,peduncle,perennial,petiole,petiolule,present,primary,proximal,pseudostipule,puberulent,pubescent,purple,rachi,rotate,rounded,scattered,sessile,shaggy,shorter,silky,simple,sinus,slightly,sometimes,sparse,spreading,stellate,stem,stigma,strongly,style,surface,ten,terminal,testa,thick,tip,trichome,truncate,tube,two,unicellular,uniformly,uniseriate,upper,usually,velvety,wall,way,white,wide,woody,yellow,young	-1.5,0-2-9,0.1-0.3,0.1-1,0.15-0.2,0.2,0.2-0.8,0.2-1.5-2,0.3-0.4,0.3-1.1,0.5-1,0.5-1.5,0.6-0.8,0.6-1.5,0.8-0.9,0.8-1.2,0.8-3,1.5-3.5,1.5-4-10,1.5-5,10,2-4,2-foliate,2-locular,2/3,3-5,4,4-8-16,6,8-20,absent,apical,appearing,appendage,articulation,basal,bifurcate,bract,bracteate,clavat,column,completely,cordate,developed,diamete,divided,eaf,edicel,eed,entir,erect,essentially,first,flower,glandula,internode,lanceolate,larger,largest,leave,lon,lower,maturity,mere,middl,minute,mostly,narrowly,nflorescence,node,often,once-branched,pair,papillate,part,population,range,reflexed,rest,ruit,secondary,shrub,small,soft,southern,spreadin,staminal,sterile,straight,stripe,surrounding,tall,tem,tertiary,ud,unit,united,weak-walled,winged,ympodial	2-9,4-10,arrangement,bark,border,bud,characteristic,clavate,colour,corrugation,drying,exertion,form,glabrousnes,growth,height,history,length,life,lobing,middle,midpoint,na,new,number,per,plant,prickle,ray,seed,shape,size,texture,thicknes,type,variation,vein,width	-10,.5,0.1-0.5,0.1-0.7,0.15-0.9,0.2-0.25,0.2-1,0.5,0.5-0.7,0.8-1.3,1,1-1.4,1-1.5,1-3,1-celled,1.0-1.4,1.5-2,1.6-7,1.7-2.3,1.8-3.0,1/4-1/3,4-10-19,4-celled,8-celled,acute,adpressed,almost,amongst,anthesi,apex,appearance,articulated,base,basiscopically,bent,berry,bluntly,bright,brown,calyx,capitate,cell,cm,coat,conical,crenate,curved,dark,darker,decurrent,deeply,densely,diameter,distal,eglandular,elliptic,elongate,entire,exserted,extremely,flushed,giving,glandular,globose,grayish,green,greenish,hair-like,half,halfway,head,herb,imparipinnate,interrupted,investing,large,lateral,leaf,leaflet,less,like,lobed,long,longer,loosely,markedly,midvein,minutely,mixed,mm,narrowing,oblique,obovate,occasionally,orbicular,outgrowth,pale,perennial,petiolule,present,proximal,puberulent,pubescent,purple,rachi,rotate,rounded,scattered,sessile,shaggy,shorter,silky,simple,sinus,slightly,sometimes,sparse,spreading,stellate,stem,strongly,surface,ten,testa,thick,tip,trichome,truncate,two,unicellular,uniformly,uniseriate,upper,usually,velvety,wall,way,white,wide,woody,yellow,young	2-9,4-10,clavate,middle,na
383	wfo-0001030342	success	155	111	72	84	71	27	67	5	.2,0.1â0.2,0.3â1.2,0.8â1.5,1-6.5,1.2â3,1.5,1.5â13,1.5â5,1.5â7.5,10â25,1â1.5,1â2.5,1â3,1â7,2â2.5,2â4,3-pinnate,3â12,4â5,4â8,6â7,acute,anther,apex,berry,blade,brown,chartaceous,cm,cylindrical,dense,diameter,entire,extra-axillary,filament,flattened,flower,fruit,glabrous,greenish,herbaceous,lanceolate,leaf,lenticular,light,lobe,long,margin,membranous,minutely,mm,mottled,often,ovoid-rhomboid,pedicel,peduncle,petiole,pointed,pubescent,rachi,rarely,revolute,sand-punctate,scattered,slender,smooth,stellate,stem,stigma,style,surface,tip,trichome,tube,unbranched,undulate,vine,white,wide,wide-diameter,widely,x,yellowish	.5,0.5â1,0.5â3,0.5â5,0.8â4,1-5,1.5â2,1â1.2,1â5.5,1â6,2â,3,5-merous,abaxially,abundant,accrescent,acuminate,adaxially,along,alyx,apar,apical,apiculate,axe,base,broadly,c.,calyx,capitat,ciliat,cordate,cuneate,deltoid,eaf,eed,elliptical,fruiting,glabrou,lateral,leaflet,like,lon,lower,m.,nflorescence,nternode,oblique,obtuse,orolla,perfec,petiolule,plurifoliat,proximal,pubescen,rhomboid,rounded,ruit,side,slightly,spaced,sparsely,tamen,tem,terrestria,truncate,truncate-acuminat,unit,vary,vein,ympodial,â7	2â7,abaxial,adaxial,apart,arrangement,capitate,characteristic,colour,corolla,density,form,growth,history,inflorescence,internode,length,life,number,ovary,seed,shape,size,spacing,sparingly,terrestrial,texture,type	.2,0.1â0.2,0.3â1.2,0.8â1.5,1-6.5,1.2â3,1.5,1.5â13,1.5â5,1.5â7.5,10â25,1â1.5,1â2.5,1â3,1â7,2â2.5,2â4,3-pinnate,3â12,4â5,4â8,6â7,acute,apex,berry,brown,chartaceous,cm,cylindrical,dense,diameter,entire,extra-axillary,flattened,glabrous,greenish,herbaceous,lanceolate,leaf,lenticular,light,long,membranous,minutely,mm,mottled,often,ovoid-rhomboid,pointed,pubescent,rarely,revolute,sand-punctate,scattered,slender,smooth,stellate,tip,unbranched,undulate,vine,white,wide,wide-diameter,widely,x,yellowish	2â7,apart,capitate,sparingly,terrestrial
384	wfo-0001030342	success	151	136	76	90	61	46	73	3	-7,.2,.5,0.5-1,0.5-5,0.8-4,1-1.2,1-1.5,1-3,1-5.5,1-6,1-7,1.2-3,1.5-13,1.5-2,1.5-5,1.5-7.5,10-25,2-2.5,2-3,3-12,3-pinnate,4-5,6-7,absent,acuminate,acute,adaxially,anther,apex,basally,base,brown,calyx,chartaceous,cm,cordate,cuneate,deltoid,diameter,entire,extra-axillary,filament,flower,fruit,fruiting,glabrous,hair,herb,interjected,lanceolate,lateral,leaf,leaflet,lenticular,light,lobe,long,margin,membraceous,minutely,mm,oblique,oblong,obtuse,pedicel,peduncle,petiole,pubescent,rarely,revolute,sagittate,scattered,simple,slender,smooth,stigma,style,surface,terrestrial,tip,truncate,tube,unbranched,undulate,uniseriate,vein,white,widely,x	0.5-3,1-5,1-6.5,4-8,5-merou,abaxially,abundant,accrescent,ag,along,alyx,apart,apical,apiculate,apparently,articulated,axe,ba,blade,broadly,capitat,ciliat,connivent,cylindrical,directed,distally,eaf,eed,elliptical,equal,geminat,longitudinal,lower,nflorescence,node,opening,orolla,perfect,petiolule,plurifoliate,pore,proximal,pubescen,rachi,rhomboid,rooting,rounded,side,slightly,slit,spaced,stellate,tamen,tem,trailing,truncate-acuminat,unit,vary,wide,yellow,ympodial	appearance,arrangement,bark,border,branch,bud,capitate,characteristic,colour,corolla,corrugation,distal,drying,exertion,form,giving,glabrousnes,growth,height,history,inflorescence,length,life,lobing,midpoint,na,new,number,ovary,per,plant,prickle,primary,pseudostipule,ray,seed,shape,size,stem,terminal,texture,thicknes,truncate-acuminate,type,variation,width	-7,.2,.5,0.5-1,0.5-5,0.8-4,1-1.2,1-1.5,1-3,1-5.5,1-6,1-7,1.2-3,1.5-13,1.5-2,1.5-5,1.5-7.5,10-25,2-2.5,2-3,3-12,3-pinnate,4-5,6-7,absent,acuminate,acute,adaxially,basally,brown,chartaceous,cm,cordate,cuneate,deltoid,diameter,entire,extra-axillary,flower,fruit,glabrous,hair,herb,lanceolate,leaf,lenticular,light,lobe,long,membraceous,minutely,mm,oblique,oblong,obtuse,pubescent,rarely,revolute,sagittate,scattered,simple,slender,smooth,terrestrial,tip,truncate,tube,unbranched,undulate,uniseriate,white,widely,x	capitate,na,truncate-acuminate
385	wfo-0001030353	success	222	147	89	112	110	35	84	5	.2,.7,0-6,0.5-0.9,0.8-1.2,1-6,1.2-1.8,1.8-2.2,1.8-3,1/3,2.5-4,2.8-3.7,20-200,3-4,4-4.5,6-15,6-8,acute,almost,anther,apart,apex,apically,apparently,bark,base,berry,brown,calyx,chartaceous,cm,conical,cuneate,curved,deltate,densely,diameter,discolorous,distal,drying,ellipsoid,elliptic,evenly,filament,flattened,flattened-reniform,flower,fruit,fruiting,glabrous,green,lateral,leaf,length,lobe,lobed,long,long-styled,lower,margin,maturity,mauve,midpoint,mm,moderately,multangulate,narrow-deltate,orange-brown,pair,pedicel,peduncle,per,petiole,plant,poricidal,prickle,prickly,primary,ray,red-brown,reddish-green,reflexed,sessile,shape,short-styled,shrub,simple,small,somewhat,spaced,sparsely,spreading,stellate,stellate-pubescent,stem,straight,strongly,style,subentire,surface,tapering,terminal,tip,tree,trichome,tube,unarmed,vein,weakly,wide,yellow,young	-3,-5,-merous,.1-0.2,.5,0,0-15,0-2,0.1-0.2,0.1-0.3,0.15-0.3,0.5-1.5,0.8,1-2,1-3,1-5,1-7,1/,1/2-2/3,1/5,1/6,1/6-1/4-1/2,10-15,11-16,2-10,2-7,3-5.5,3.5-4,4-5,4-5-6,5,5-6,6,7-10,8-15,abaxial,abaxially,adaxial,alyx,andromonoecious,apar,apiculat,articulated,blade,broad-deltate,c.,connivent,development,distance,eaf,eed,elongating,equal,erect,extending,free,glabrescent,half,hermaphrodite,heterostylous,infructescence,less,longer,lowermost,mature,midvein,nflorescence,older,one,open,orolla,oung,patch,pendulous,pericarp,plurifoliat,pointed,porrect,portion,retaining,rounded,ruit,scar,shorter,side,smooth,sometimes,stalk,stalked,staminat,stout,tamen,terete,tertiary,throughout,time,unarme,unbranched,unit,upper,vary,venation,visible,warty,way,whit,white-gray,wo,woody,ympodial	30,4-6,apiculate,appearance,arrangement,border,branch,bud,characteristic,colour,corolla,exertion,form,giving,glabrousnes,growth,height,inflorescence,interjected,leaflet,lobing,na,new,number,ovary,pseudostipule,seed,size,stigma,texture,thicknes,type,variation,white,width	.2,.7,0-6,0.5-0.9,0.8-1.2,1-6,1.2-1.8,1.8-2.2,1.8-3,1/3,2.5-4,2.8-3.7,20-200,3-4,4-4.5,6-15,6-8,acute,almost,apart,apically,apparently,base,berry,brown,chartaceous,cm,conical,cuneate,curved,deltate,densely,discolorous,ellipsoid,elliptic,evenly,flattened,flattened-reniform,flower,glabrous,green,lateral,lobed,long,long-styled,lower,maturity,mauve,mm,moderately,multangulate,narrow-deltate,orange-brown,pair,per,poricidal,prickly,red-brown,reddish-green,reflexed,sessile,short-styled,shrub,simple,small,somewhat,spaced,sparsely,spreading,stellate,stellate-pubescent,straight,strongly,subentire,tapering,terminal,tip,tree,trichome,unarmed,weakly,wide,yellow,young	30,4-6,apiculate,na,white
386	wfo-0001030407	success	182	127	93	104	78	23	88	5	.2,.5,0.7-3.2,1-2,1.5-5,12-14,2-5,2-6.7,2-7,3-10.5,3-6.5,3-9,3.5-9.5,30-60,4-5,5,6-7,6.5-18.5,7-8,abaxially,adaxially,anther,axillary,berry,blade,brownish,bud,cell,chartaceous,ciliate,cm,condition,conical,connivent,corolla,covering,densely,diameter,distal,drying,end,filament,flower,forked,fresh,fruit,generally,glabrous,green,green-white,greenish,hair,hair-like,half,herb,homostylous,lanceolate,lateral,leaf,leaflet,light,like,lobe,long,make,margin,minute,mm,mottled,mucilaginous,odd-pinnate,one,ovoid,pedicel,peduncle,pentagonal,petiole,placed,plant,poricidal,pubescent,purple,ripe,seed,size,stigma,style,subtending,terminal,testal,thick,throughout,tip,tube,tuber,typically,unwinged,usually,wall,wet,whitish,wide,x,yellow	1-10,1-3,1-4,12-15,2-2.5,3-4,5-merou,absent,acumen,acuminate,ag,alyx,apart,apex,apparently,articulated,axe,base,capitat,decreasing,digestion,dorsally,eaf,edge,eed,elliptic-lanceolate,enzyme,especially,exceeding,flat,folded,geminat,glabrou,gradually,honeycomb-shaped,interjected,larger,lengthening,living,lower,middle,nflorescence,obtuse,orolla,ovate,pair,perfect,petiolule,plurifoliate,pore,proximal,pubescen,ray,removed,round,ruit,secondary,semierec,seudostipule,slit,spaced,specimen,stamen,ste,stolo,subequal,subsessile,symmetrical,tall,tamen,tem,thir,toward,tri-,unit,vary,white,ympodial	5-merous,arrangement,calyx,capitate,colour,form,growth,height,history,inflorescence,length,life,ovary,placement,pseudostipule,semierect,shape,stem,stolon,surface,texture,type,width	.2,.5,0.7-3.2,1-2,1.5-5,12-14,2-5,2-6.7,2-7,3-10.5,3-6.5,3-9,3.5-9.5,30-60,4-5,5,6-7,6.5-18.5,7-8,abaxially,adaxially,axillary,berry,brownish,bud,cell,chartaceous,ciliate,cm,condition,conical,connivent,covering,densely,distal,drying,end,flower,forked,fresh,fruit,generally,glabrous,green,green-white,greenish,hair,hair-like,half,herb,homostylous,lanceolate,lateral,light,like,long,make,margin,minute,mm,mottled,mucilaginous,odd-pinnate,one,ovoid,pentagonal,placed,plant,poricidal,pubescent,purple,ripe,seed,subtending,terminal,testal,thick,throughout,tip,typically,unwinged,usually,wall,wet,whitish,wide,x,yellow	5-merous,capitate,semierect,stem,stolon
387	wfo-0001030420	success	159	103	67	80	79	23	66	1	-pubescent,0.5-1,0.5-1-1.5,0.5-4,0.5-8,1-2,1-2-6-9,1-3,1-4,1-6,1-7.5,1.5-5,10-15-25-30,10-25-35,2-14.5,2-3-lobed,2-9,4-7,5-15-20,acuminate,acute,also,apart,apex,basal,base,calyx,chartaceous,cm,connivent,cordate,deltate,densely,diameter,eglandular,ellipsoidal,elongated,entire,flower,forked,fruit,glabrate,glabrous,glandular-,lanceolate,leaf,lobe,lobed,long,margin,mm,moderately,obtuse,often,pedicel,pedicellar,peduncle,petiole,pinnately,puberulent,pubescent-pilose,purple,rachi,rarely,remnant,shrub,simple,small,sparsely,stellate,stigma,style,tip,tree,truncate,unbranched,unknown,unlobed,x,yellow	-4,1.5-3,1/2,2-3,2-3-7,2-5,4-foliat,5-6,5-6-7,5-7-19,7-22,7/8,abaxially,absent,adaxially,aggregate,ape,articulated,axe,beyond,blade,cell,color,connective,cylindrical,dark,directed,distally,divided,eaf,eed,eglandular-pilo,eglandular-puberulent,elliptic-ovate,equal,exserted,glandular-puberulent,hair,leaving,lon,lower,midrib,narrowly,nearly,nflorescence,nther,orolla,ovate,perfect,pilose,pore,presen,puberulent-pubescent,pubescent,pubescent-pilo,radiu,ripe,ruit,shorter,sinus,spaced,stamen,stone,subcoriaceous,tal,tem,thecae,time,tomento,triangular,truncat,tube,ud,unit,vary,vein,wide,yello,ympodial	anther,arrangement,bud,characteristic,colour,corolla,eglandular-pilose,form,fruiting,growth,height,inflorescence,length,number,ovary,per,plant,seed,shape,size,spacing,stem,texture	-pubescent,0.5-1,0.5-1-1.5,0.5-4,0.5-8,1-2,1-2-6-9,1-3,1-4,1-6,1-7.5,1.5-5,10-15-25-30,10-25-35,2-14.5,2-3-lobed,2-9,4-7,5-15-20,acuminate,acute,also,apart,apex,basal,chartaceous,cm,connivent,cordate,deltate,densely,eglandular,ellipsoidal,elongated,entire,flower,forked,glabrate,glabrous,glandular-,lanceolate,lobe,lobed,long,mm,moderately,obtuse,often,pinnately,puberulent,pubescent-pilose,purple,rarely,shrub,simple,small,sparsely,stellate,tip,tree,truncate,unbranched,unknown,unlobed,x,yellow	eglandular-pilose
388	wfo-0001030426	success	157	107	75	84	73	23	72	3	0.3-7,0.3-8,0.4-0.7,1-4,1-4.2,1.5-3,1.7-3.2,10,15-25-30,2,2-3,2.5-4,2.5-6,3-4,3-6,4-10,4-6.5,6-11.5,6-8,9,apical,apically,apiculate,branched,calyx,caudate,cell,cm,connate,corolla,covering,cyme,dehiscent,diameter,dichasial,dichasially,ebracteate,exceeding,filament,forked,glandular,globose,hair-like,heart-shaped,herbaceous,interjected,introrse,lateral,leaf,leaflet,lobe,long,make,maturing,mm,monochasial,mucilaginous,oblong,odd-pinnate,often,ovoid,pedicel,peduncle,perennial,petiole,pilose,plant,poricidally,seed,short,size,slit,stamen,stellate,stigma,straight,style,terminal,testal,thick,wall,white,wide,yellow	1.5-6.5,3-12,3-6-foliat,abaxially,absen,acumen,acute,adaxially,apex,articulate,base,decurrent,digestion,diminishing,distal,dorsally,eaf,edge,eed,elliptic-lanceolate,emoval,enzyme,flat,flower,folded,generally,globo,gradually,green,green-white,half,honeycomb,lanceolate,larger,linear,linear-lanceolate,linear-oblong,living,lon,lower,nflorescence,nther,oblique,obtuse,orolla,pair,pattern,perfect,pinnatifi,plan,proximal,rachi,reveal,rounded,ruit,second,sessile,seudostipule,specimen,spot,stripe,tal,tem,throughout,toward,tuber-bearing,typically,unit,vary,whit,without,ympodial,Â¼	abaxial,absent,adaxial,anther,arrangement,colour,form,fruit,growth,height,history,inflorescence,length,life,ovary,pinnatifid,pseudostipule,shape,stem,surface,texture,wet,width	0.3-7,0.3-8,0.4-0.7,1-4,1-4.2,1.5-3,1.7-3.2,10,15-25-30,2,2-3,2.5-4,2.5-6,3-4,3-6,4-10,4-6.5,6-11.5,6-8,9,apical,apically,apiculate,branched,caudate,cell,cm,connate,covering,cyme,dehiscent,diameter,dichasial,dichasially,ebracteate,exceeding,forked,glandular,globose,hair-like,heart-shaped,herbaceous,introrse,lateral,lobe,long,make,maturing,mm,monochasial,mucilaginous,oblong,odd-pinnate,often,ovoid,perennial,pilose,poricidally,seed,short,slit,stamen,stellate,stigma,straight,style,testal,thick,wall,white,wide,yellow	absent,pinnatifid,wet
389	wfo-0001030430	success	171	101	69	64	107	37	52	17	.2,anther,anthesi,axillary,base,blue,borne,branched,brittle,brown,calyx,capitate,clavate,cm,connivent,decurrent,densely,diameter,equal,filament,flattened,fleshy,fruit,glabrous,globose,green,leaf,lobe,lobed,long,margin,mm,moderately,oblong,occasionally,pair,pale,pedicel,peduncle,pentagonal,perennial,petiole,pitted,poricidal,pubescent,purple,regularly,shallowly,shoot,shrub,simple,stigma,style,subglabrous,surface,terminal,time,tip,tube,violet,white,woody,x,yellow	.5,0.25,0.3,0.4,0.5,0.5â12,0.6,0.6â0.8,0.6â1.0,0.8â3.0,0.8â5.6,0.9â1.0,0â20,1.0â1.2,1.0â1.5,1.0â2.0,1.2â2.0,1.3â8.0,1.4â1.5,1.5â1.7,1.6â1.8,1.8â5.0,12â20,12â30,1â3,1â9,2.0â3.0,2.0â4.2,2â3,3.0â4.5,30â200,3â17,3â24,3â4,3â5,3â8,5,5.5â12,5â10,5â6,6â10,abaxially,abundant,acute,adaxiall,adaxially,ag,apart,apex,apical,appressed,articulated,axe,ba,basal,blade,bud,cell,chartaceous,convex,cylindrical,dentate,diamete,eaf,eed,elliptic,erect,especially,few-seeded,flower,geminat,hair,indumentum,lon,longitudinal,lower,m.,multicellular,nflorescence,opening,orolla,ovate,perfect,pore,present,rounded,ruit,serrate,shaped,side,slit,spaced,stone,straight,tal,tamen,tear-drop,tem,toward,unifoliate,uniseriate,unit,vary,wide,ympodial,â2.7,â40	0-20,0.5-12,0.8-3.0,0.8-5.6,1.0-2.0,1.3-8.0,1.4-1.5,1.6-1.8,12-20,2-3,3-17,3-4,3-5,3-8,30-200,5-10,5-6,arrangement,characteristic,colour,corolla,form,growth,height,history,inflorescence,length,life,lobing,ovary,plant,seed,shape,size,stem,texture,type	.2,anthesi,axillary,blue,borne,branched,brittle,brown,capitate,clavate,cm,connivent,decurrent,densely,diameter,equal,flattened,fleshy,fruit,glabrous,globose,green,lobe,lobed,long,mm,moderately,oblong,occasionally,pair,pale,pentagonal,perennial,pitted,poricidal,pubescent,purple,regularly,shallowly,shoot,shrub,simple,subglabrous,terminal,time,tip,tube,violet,white,woody,x,yellow	0-20,0.5-12,0.8-3.0,0.8-5.6,1.0-2.0,1.3-8.0,1.4-1.5,1.6-1.8,12-20,2-3,3-17,3-4,3-5,3-8,30-200,5-10,5-6
390	wfo-0001030441	success	178	130	92	103	75	27	89	3	.5,0.5,0.5-0.75,0.5-1,0.5-3,1,1-1.4,1-2-celled,1.2-1.4,2,2-10,2-5.5,5-7.5,6-11,<,acuminate,acute,along,anther,anthesi,apex,attenuate,base,berry,branched,bright,c.,calyx,capitate,cell,cm,corolla,decurrent,diameter,ellipsoid,elliptic,entire,exerted,eye,filament,flattened,flexuous,fruiting,glabrous,glandular,globose,green,growth,hair,lateral,lobe,lobed,long,making,many,margin,membranous,midvein,minutely,mm,narrowly,new,occasionally,onto,open,pale,pedicel,peduncle,petiole,plant,poricidal,pubescent,red,reniform,ridged,ripe,shrub,simple,slightly,spot,spreading,stellate,stem,stigma,strongly,style,surface,terminal,thin,time,tip,trichome,tube,undulate,uniseriate,usually,vine,violet,wall,way,white,woody,yellow	+,1-1.5,1.5-2,10-40,2-3,2.5,3-4,30,4-5,5-14,5-6,5-7,5-merou,>,ag,alyx,apart,ark,articulated,brow,closely,deltate,distall,eaf,eed,flower,free,glabrou,glandula,ilament,impressed,irregularly,juicy,leaving,lengthening,lon,lower,markedly,nflorescence,older,orolla,otherwise,pair,papillat,papillose,peg,per,perfect,pericarp,plurifoliat,pore,portion,primary,reflexed,ruit,scandent,scar,shiny,short,shrubby,slit,small,somewhat,spaced,spreadin,tem,trailing,triangular,ud,unit,upper,vary,vein,wide,ympodial	abaxial,adaxial,arrangement,bark,brown,bud,characteristic,colour,exertion,form,fruit,glabrousnes,height,history,inflorescence,leaf,length,life,lobing,na,ovary,papillate,seed,shape,size,texture,type	.5,0.5,0.5-0.75,0.5-1,0.5-3,1,1-1.4,1-2-celled,1.2-1.4,2,2-10,2-5.5,5-7.5,6-11,<,acuminate,acute,along,anthesi,attenuate,base,berry,branched,bright,c.,calyx,capitate,cell,cm,decurrent,diameter,ellipsoid,elliptic,entire,exerted,eye,flattened,flexuous,glabrous,glandular,globose,green,hair,lateral,lobe,lobed,long,making,many,membranous,midvein,minutely,mm,narrowly,occasionally,onto,open,pale,petiole,poricidal,pubescent,red,reniform,ridged,ripe,shrub,simple,slightly,spot,spreading,stellate,strongly,surface,terminal,thin,time,tip,trichome,tube,undulate,uniseriate,usually,vine,violet,wall,way,white,woody,yellow	brown,na,papillate
391	wfo-0001030444	success	196	132	91	110	86	22	89	2	0-24,0.15-0.8,0.8-2,1,1-10,1-2,1-4,1-5,1.2-1.8,11-45,2-8,2.3-3.6,2.4-3.8,3-10,3-5,4-17,4-7,5.3-9,6.1-12.8,7.1-17.5,9.4-20.1,anther,apart,axillary,berry,blade,blue,brownish,bud,cell,ciliate,clavate,cm,condition,connivent,coriaceous,corolla,covering,dark,deep,diameter,distal,dot,drying,elliptic,filament,flower,forked,fresh,fruit,generally,glabrous,green,green-white,greenish,hair-like,half,herb,homostylous,interjected,lanceolate,lateral,leaf,leaflet,light,lilac,lobe,long,make,margin,medium,mm,moniliform,mucilaginous,narrow,odd-pinnate,ovate,ovoid,pair,pedicel,peduncle,pentagonal,petiole,plant,purple,ripe,rotate,seed,size,sometimes,stigma,straight,style,subtending,terminal,testal,thick,throughout,tube,tuber,unwinged,usually,wall,wet,white,whitish,wide,wing,x,yellow	1.1-2.7,2-3,2-6,3.7-6.8,4-39,5-merou,abaxiall,abaxially,acumen,acuminate,acute,adaxially,ag,along,alyx,apex,apparently,arranged,articulated,asymmetric,attenuate,axe,base,basiscopic,bead,capitat,decreasing,digestion,dorsally,eaf,edge,eed,enzyme,erec,exceeding,flat,folded,geminat,general,glabrou,hal,high,honeycomb-shaped,larger,lengthening,like,linear,living,lower,multiple,necklace,nflorescence,orbicular,orolla,perfect,petiolulate,plurifoliate,pore,poricidal,removed,rough,rounded,ruit,sessile,seudostipule,shortly,side,slit,spaced,specimen,stamen,stolon,subequal,symmetric,tall,tamen,tem,tip,tissue,touch,toward,tri-,typically,unit,vary,ympodial	5-merous,abaxial,adaxial,arrangement,calyx,capitate,colour,form,growth,height,history,inflorescence,length,life,ovary,presence,pseudostipule,shape,spacing,stem,surface,texture	0-24,0.15-0.8,0.8-2,1,1-10,1-2,1-4,1-5,1.2-1.8,11-45,2-8,2.3-3.6,2.4-3.8,3-10,3-5,4-17,4-7,5.3-9,6.1-12.8,7.1-17.5,9.4-20.1,apart,axillary,berry,blue,brownish,bud,cell,ciliate,clavate,cm,condition,connivent,coriaceous,covering,dark,deep,distal,dot,drying,elliptic,forked,fresh,generally,glabrous,green,green-white,greenish,hair-like,half,herb,homostylous,lanceolate,lateral,light,lilac,long,make,medium,mm,moniliform,mucilaginous,narrow,odd-pinnate,ovate,ovoid,pentagonal,plant,purple,ripe,rotate,seed,sometimes,straight,subtending,terminal,testal,thick,throughout,unwinged,usually,wall,wet,white,whitish,wide,wing,x,yellow	5-merous,capitate
392	wfo-0001030445	success	226	166	108	127	99	39	106	2	0.2,0.2-0.4,0.2-0.5,0.2-0.7,0.3,0.4,0.6-2.2,0.8,1-1.3,1-7,1.3,1.3-1.8,1.3-2,1.6-2,1.7-2.4,10-14,14,15-35,2.2-2.9,3-5.4,4.1-8.7,4.2-10,5-125,5.9-15,6.1-9.1,7.5-16,8.1-10,abaxially,acuminate,adaxially,along,anther,apex,bark,base,berry,black,blade,blunt-tipped,branch,branched,brownish-yellow,bud,bulbous-based,calyx,capitate,cm,corolla,decurrent,deltoid-reniform,diameter,drying,elliptic,elliptical,elongated,entire,exserted,ferruginous,ferruginous-granular,ferruginous-tomentose,filament,flower,fruit,fruiting,glabrate,glabrous,globose,green,greyish-tan,hair,lateral,leaf,lobe,long,many,margin,midrib,mm,mostly,multangulate,oblong,oblong-lanceolate,obovate,obtuse,orangish-tan,orbicular,ovate,ovate-lanceolate,pedicel,peduncle,petiole,porrect-stellate,pseudoterminal,pubescence,ray,reniform,reticulate-punctate,semi-spherical,sessile,shrub,side,simple,slightly,small,soon,sparse,stalk,stem,stigma,stout,style,subcampanulate,sulcate,surface,thick,thicknes,thin,time,tomentose,tree,tube,vein,vestigial-rayed,white,x,yellowish,yellowish-tan	.1,.5,/5-2/3,0.1-0.7,0.5,0.6-3.5,0.7,1,1.1-4.3,1.5-2.1,1.8-3.5,10-16,2.1-5.2,2.2-3.5,2.4-4.7,3.1-5,3.4-5.6,3.5-4.2,5-merou,5.2-7.1,5.9-8.3,8.2-18,abaxial,accrescent,acute,ag,alyx,apart,appressed,around,articulated,axillary,blunt-tippe,brown,concentrated,cylindrical,directed,distally,eaf,earl,edge,eed,erect,free,geminate,glabrescen,high,homostylous,inserted,intermediate,lackin,lengthening,lobed,lon,longitudinal,lower,m.,main,midvein,multangulat,nflorescence,obscured,older,open,orange,orolla,plurifoliate,pore,poricidal,porrect-stellat,pubescent,rachi,relatively,resorption,rounded,ruit,runk,slit,somewhat,spaced,sparsely,splitting,stamen,stellate,suture,tamen,thick-textured,thin-,tip,tissue,tomentum,unarme,unit,vary,way,wide,yellow,ympodial,young	appearance,arrangement,border,characteristic,colour,corrugation,distal,exertion,form,giving,glabrousnes,growth,height,history,inflorescence,interjected,leaflet,length,life,lobing,midpoint,na,new,number,ovary,per,plant,prickle,primary,pseudostipule,seed,shape,size,terminal,texture,type,unarmed,variation,width	0.2,0.2-0.4,0.2-0.5,0.2-0.7,0.3,0.4,0.6-2.2,0.8,1-1.3,1-7,1.3,1.3-1.8,1.3-2,1.6-2,1.7-2.4,10-14,14,15-35,2.2-2.9,3-5.4,4.1-8.7,4.2-10,5-125,5.9-15,6.1-9.1,7.5-16,8.1-10,abaxially,acuminate,adaxially,along,apex,base,berry,black,blade,blunt-tipped,branched,brownish-yellow,bulbous-based,calyx,capitate,cm,decurrent,deltoid-reniform,diameter,drying,elliptic,elliptical,elongated,entire,exserted,ferruginous,ferruginous-granular,ferruginous-tomentose,flower,fruit,glabrate,glabrous,globose,green,greyish-tan,hair,long,many,midrib,mm,mostly,multangulate,oblong,oblong-lanceolate,obovate,obtuse,orangish-tan,orbicular,ovate,ovate-lanceolate,porrect-stellate,pseudoterminal,pubescence,reniform,reticulate-punctate,semi-spherical,sessile,shrub,side,simple,slightly,small,soon,sparse,stalk,stout,subcampanulate,sulcate,thick,thin,time,tomentose,tree,vein,vestigial-rayed,white,x,yellowish,yellowish-tan	na,unarmed
393	wfo-0001030447	success	276	170	129	151	125	19	127	2	.2,.3,.5,/5,0.4-0.7,0.4-0.9,0.5-0.65,0.5-10,0.5-3,0.7-1,0.8-1.7,0.8-3.5,1,1-3,1.5,1.5-7,1.8-2.5,1/3,1/3-1/2,2-4,2.2-2.8,2.5-10,2.5-6.5,3,3-4.5,3-5,30-45Â°,5-15,6-10,6-16,6.5-9,7-8,8,abaxially,acute,adaxially,always,anther,apart,apex,apparently,armed,bark,base,berry,calyx,cell,characteristically,chartaceous,clavate,cm,corolla,cuneate,cupular,curved,diameter,discolorous,divided,drying,equal,filament,finely,flat,flattened,flattened-reniform,flower,free,fruit,fruiting,gently,glabrescent,glabrous,globose,irregular,lateral,leaf,length,lobe,lobed,long,long-styled,lower,margin,maturity,midvein,mm,moderately,obconical,oblique,oblong,often,older,opening,orange,orange-brown,orange-red,outline,ovate,pair,pale,pedicel,peduncle,petiole,pit,porrect,prickle,primary,pubescent,purple,rachi,raised,red-brown,ridged,rounded,sessile,shallowly,shortly,shrub,side,simple,slender,small,smooth,sometimes,somewhat,sparsely,spreading,stalked,stellate,stellate-pubescent,stem,stigma,straight,straw-yellow,style,surface,tapering,tertiary,translucent,trichome,tube,unarmed,unbranched,vein,venation,visible,weakly,white,yellow,yellow-orange,Ã	0,0.1,0.1-0.3,0.15-0.3,0.2,0.2-0.4,0.5,1-1.5,1-10,1-2,1-2.5,1-5,1-6,1.5-2.5,1/3-2/3,1/4-1/3,4-8,5,5-merou,6,6-7,6-8,6-9,accrescent,age,alyx,apar,apical,apically,articulated,axe,beyond,blade,branche,broad-deltate,c.,covering,dark,deltate,densely,development,difoliate,distance,eaf,eed,elongating,erect,exserted,extending,filiform,fine,finger-hair,geminat,herbaceous,infructescence,irregula,lengthening,less,long-ovoi,longer,longitudinal,mature,midpoint,minute,mostly,narrow-deltate,nflorescence,obtuse,one,open,orange-translucent,orolla,oung,papillo,pendulous,per,perfect,pericarp,persisting,point,pore,poricidal,portion,pronounced,prostrate,ray,reduced,rest,ri,ridge,ruit,scar,shallow,shiny,short-styled,shorter,sinus,slit,spaced,sparse,spherical,stalk,stout,stump,subsessile,tamen,terete,terminal,thick,thin,throughout,time,tip,toward,ud,unequal,unit,usually,variously,vary,wide,widest,woody,x,ympodial	arrangement,branched,characteristic,colour,form,growth,height,inflorescence,ovary,papillose,plant,pubescence,seed,shape,size,spacing,texture,type,width	.2,.3,.5,/5,0.4-0.7,0.4-0.9,0.5-0.65,0.5-10,0.5-3,0.7-1,0.8-1.7,0.8-3.5,1,1-3,1.5,1.5-7,1.8-2.5,1/3,1/3-1/2,2-4,2.2-2.8,2.5-10,2.5-6.5,3,3-4.5,3-5,30-45Â°,5-15,6-10,6-16,6.5-9,7-8,8,abaxially,acute,adaxially,always,apart,apparently,armed,berry,cell,characteristically,chartaceous,clavate,cm,cuneate,cupular,curved,diameter,discolorous,divided,drying,equal,finely,flat,flattened,flattened-reniform,flower,free,gently,glabrescent,glabrous,globose,irregular,lateral,leaf,length,lobe,lobed,long,long-styled,lower,maturity,midvein,mm,moderately,obconical,oblique,oblong,often,opening,orange,orange-brown,orange-red,outline,ovate,pair,pale,pit,porrect,prickle,pubescent,purple,raised,red-brown,ridged,rounded,sessile,shallowly,shortly,shrub,side,simple,slender,small,smooth,sometimes,somewhat,sparsely,spreading,stalked,stellate,stellate-pubescent,straight,straw-yellow,tapering,translucent,trichome,unarmed,unbranched,visible,weakly,white,yellow,yellow-orange,Ã	branched,papillose
394	wfo-0001030453	success	127	91	54	63	64	28	51	3	.25,/4,0.8-1.5,1-1.3,1-1.5,1.5-1.6,1.5-2.5,3-3.5,acuminate,acute,anther,apex,arachnoid,arachnoid-pubescent,attenuate,base,broadly,calyx,clavate,cm,corolla,cup-shaped,deflexed,densely,divided,ellipsoid,elliptic,filament,flat,glabrous,later,leaf,less,long,middle,minutely,mm,narrowly,nearly,occasionally,ovary,pedicel,petiole,pubescent,rounded,shaped,shiny,shrub,simple,slender,sparsely,stem,stigma,style,surface,tall,tear-drop,trichome,tube,way,white,widest,young	.5,0.25-0.5,4-5,9-12,9-14,abaxially,adaxially,along,anthesi,axi,bark,closely,dark,delicate,deltate,dendritic,dia,eaf,edicel,eed,especially,exserted,fine,floccose,free,glabrate,know,known,lateral,lobe,lon,lower,main,margin,midrib,minute,near,nflorescence,older,opposite,overlappin,pair,papillat,papillose,planar,pore,poricidal,portion,reddish,reddish-brow,ruit,scar,soon,spaced,straight,strongly,tip,tub,ud,unifoliat,unit,vein,wide,ympodial	abaxial,adaxial,arrangement,bud,characteristic,colour,diameter,form,fruit,growth,history,inflorescence,length,life,lobing,na,number,papillate,peduncle,per,seed,shape,size,texture,type,unifoliate,variation,width	.25,/4,0.8-1.5,1-1.3,1-1.5,1.5-1.6,1.5-2.5,3-3.5,acuminate,acute,arachnoid,arachnoid-pubescent,attenuate,base,broadly,clavate,cm,cup-shaped,deflexed,densely,divided,ellipsoid,elliptic,flat,glabrous,later,leaf,less,long,middle,minutely,mm,narrowly,nearly,occasionally,pubescent,rounded,shaped,shiny,shrub,simple,slender,sparsely,stem,tall,tear-drop,trichome,way,white,widest,young	na,papillate,unifoliate
395	wfo-0001030486	success	141	105	74	81	60	24	70	4	1-1.5,1-5,1.1-1.4,1.7-2,10-14.5,2-3,3-3.5,3/4,4-4.5,4-6.5,5-8-flowered,6-7,abaxially,acute,adaxially,anther,apex,bark,basal,base,berry,brown,calyx,clavate,cm,completely,corolla,dark,dia,difoliate,dry,drying,ellipsoid,elliptic,erect,exserted,f,fleshy,fresh,fruiting,glabrous,globose,green,internodal,later,leaf,lobed,long,material,minutely,mm,older,opposite,ovary,ovoid-reniform,pale,papillose,pedicel,petiole,pitted,shaped,shrub,simple,size,slightly,stem,stigma,stout,style,surface,tan,tapering,tear-drop,tube,unit,usually,way,white,x,yellow-green,young	.5,0.8-2.2,1.5-2,1/2,1/4,10-12,2-5.5,3-5,4.5-5,anthesi,ba,beneath,closely,clustered,conical,deflexed,deltate,differing,distal,eaf,edicel,eed,filament,free,geminat,inflorescenc,lateral,lobe,lon,lower,m.,main,major,margin,middle,minor,nflorescence,overlapping,pair,papillo,planar,pore,poricidal,portion,reddish,ruit,scar,shin,small,spaced,tall,thickened,tip,treelet,tub,ud,vein,widest,woody,ympodial	arrangement,bud,characteristic,colour,diameter,exertion,form,fruit,geminate,growth,height,history,inflorescence,length,life,lobing,perennial,plant,seed,shape,shiny,sympodial,texture,type	1-1.5,1-5,1.1-1.4,1.7-2,10-14.5,2-3,3-3.5,3/4,4-4.5,4-6.5,5-8-flowered,6-7,abaxially,acute,adaxially,bark,basal,base,berry,brown,calyx,clavate,cm,completely,dark,dia,difoliate,dry,drying,ellipsoid,elliptic,erect,exserted,f,fleshy,fresh,glabrous,globose,green,internodal,later,leaf,lobed,long,material,minutely,mm,older,opposite,ovoid-reniform,pale,papillose,pitted,shaped,shrub,simple,slightly,stem,stout,tan,tapering,tear-drop,tube,unit,usually,way,white,x,yellow-green,young	geminate,perennial,shiny,sympodial
396	wfo-0001030489	invalid_json	196	112	NA	88	108	24	NA	NA	0.5-3,0.9-1.1,1-3,1.2-1.6,1.6-2.1,1.7-2,1.9-2.6,1/3-1/2,3-6,3-8,4-8,4.5-9,5,7-15,anther,apart,apex,appressed-pubescent,bark,base,becoming,berry,blunt-tipped,broadly,brown,bud,calyx,chartaceous,cinereous,cm,conical,continued,corolla,deltoid,densely,diameter,due,elliptic,elongate,entire,filament,fleshy,flower,fruit,glabrate,glabrous,globose,greenish,growth,high,honeycombed,lateral,leaf,length,long-acuminate,margin,minutely,mm,oblong,ovate-lanceolate,pedicel,peduncle,petiole,probably,pubescent,rachi,reniform,reticulate-punctate,ripe,shrub,simple,small,somewhat,stellate-pubescent,stem,stigma,style,subcampanulate,subglobose,suborbicular,tomentose,tree,unarmed,way,white,x,yellow,yellowish	-6.5,.5-2.8,.5-3,.75-5.25,0.25-0.4,0.6-0.9,0.75-0.9,1-1.3,1-3.75,1.1-1.3,1.2-1.5,1.75-2,1/5-1/2,100,12-24,2.1-2.9,5-6,6-8,abaxially,abruptly,absen,acuminate,acute,adaxiall,adaxially,ag,anthesi,apical-lateral,apparently,appressed,articulated,attenuate,axe,axillary,ba,blade,branch,branched,closely,cylindrical,dehiscing,dichotomously,eaf,echinoi,echinoid,eed,free,hair,inserted,introrse,large,lobe,lobed,long,long-exserted,longitudinal,lower,main,midvein,minute,mostly,multangulate,narrowly,nflorescence,obtuse,older,orolla,ovate,pale,perfect,plurifoliate,pore,porrect-stellate,pseudo-terminal,puberulent,pulverulen,pulverulent,ruit,runk,sessile,several,short,short-stalked,side,slender,slit,smooth,spaced,sparingly,sparse,stellate-rotate,subcapitat,tamen,terete,testa,thick,time,toward,tube,turn,unarme,unit,usually,vary,vein,wide,ympodial,young	2.5-2.8,5-6.5,abaxial,adaxial,arrangement,characteristic,colour,form,height,inflorescence,lobing,ovary,plant,pseud-terminal,seed,shape,size,spacing,subcapitate,surface,texture,thicknes,type,value	NA	NA
397	wfo-0001030509	success	218	141	101	117	101	24	99	2	0-10,0-100,0-5,0.1-0.2,0.2,0.3-2.5,0.6-1,0.8-1.2,0.8-4,1-1.5,1-2,1-4,1.3-2,1.7-2,1/4,2-2.5,2-4.2,2-4.5,2-6,2.8-3,2/3-3/4,3-4,7-9,8-16,anther,apex,apparently,articulated,bark,base,berry,calyx,cm,cordate,cream,cuneate,dark,densely,diameter,entire,erect,filament,flattened-reniform,flower,fruit,fruiting,gland,globular,gray,green,half,herb,inflated,lateral,leaf,length,lobed,long,long-styled,lower,margin,marking,maturity,mauve,midpoint,mm,moderately,obtuse,often,orange,orange-brown,ovate,pair,pale,pedicel,peduncle,per,petiole,plant,poricidal,porrect,prickle,prickly,primary,purple,ray,reduced,rounded,shorter,shrub,simple,sometimes,sparsely,spherical,stalk,stalked,stellate,stellate-pubescent,stem,style,surface,tapering,terminal,tip,trichome,tube,unarmed,unbranched,upper,variously,vein,way,weakly,wide,yellow,yellow-green,young	-6,/3,0-0.3,0-15,0-2,0-3,0.1,0.1-0.25,0.1-0.3,0.5-1.5,1-3,1-6,1.5-2,1/,1/3-2/3,2-3,3-10,4.5-10,4.5-12,4.5-8,5-10,5-merous,7-15,abaxially,alyx,andromonoecious,apar,apart,apical,apically,becoming,blade,broad-deltate,brow,chartaceous,connivent,curved,difoliate,discolorous,distal,distance,drying,eaf,eed,elongating,equal,extending,eye,free,geminat,glabrescent,glabrous,herbaceous,hermaphrodite,heterostylous,infructescence,lobe,long-acuminat,longer,lowermost,mature,midvein,naked,narrow-deltate,narrow-oblong,nflorescence,occasional,occasionally,older,one,open,orolla,oung,pendulous,pericarp,perpendicular,portion,ruit,scar,short-styled,shorte,side,slender,smooth,spaced,spreading,staminat,straight,subsessile,tamen,terete,tertiary,time,unarme,unit,usually,vary,venation,visible,woody,ympodial	arrangement,branch,brown,bud,characteristic,colour,corolla,exertion,form,glabrousnes,growth,height,inflorescence,lobing,na,new,number,ovary,seed,shape,size,stigma,texture,type	0-10,0-100,0-5,0.1-0.2,0.2,0.3-2.5,0.6-1,0.8-1.2,0.8-4,1-1.5,1-2,1-4,1.3-2,1.7-2,1/4,2-2.5,2-4.2,2-4.5,2-6,2.8-3,2/3-3/4,3-4,7-9,8-16,apparently,articulated,base,berry,cm,cordate,cream,cuneate,dark,densely,diameter,entire,erect,flattened-reniform,flower,gland,globular,gray,green,half,herb,inflated,lateral,length,lobed,long,long-styled,lower,marking,maturity,mauve,midpoint,mm,moderately,obtuse,often,orange,orange-brown,ovate,pair,pale,per,poricidal,porrect,prickle,prickly,purple,ray,reduced,rounded,shorter,shrub,simple,sometimes,sparsely,spherical,stalk,stalked,stellate,stellate-pubescent,surface,tapering,terminal,tip,trichome,unarmed,unbranched,upper,variously,way,weakly,wide,yellow,yellow-green,young	brown,na
398	wfo-0001030516	success	172	118	86	95	77	23	82	4	0.4-1.5,1-2.5,1-4,1-7,1.1-3.5,1.1-4.1,1.5-2,1.8-2.4,2-12,2-3,2-4,3-8,3-9.8,4-22,4-6,4-7,4.2-10.7,6-15,8-9,9-22,acumen,acute,apical,apically,branched,calyx,cell,cm,connate,corolla,covering,cyme,darker,dehiscent,diameter,dichasial,dichasially,ebracteate,exceeding,filament,forked,gland,globose,green,hair-like,herbaceous,interjected,introrse,lateral,leaf,leaflet,light,lobe,long,long-attenuate,make,maturing,mm,monochasial,mucilaginous,odd-pinnate,often,outline,ovoid,pedicel,peduncle,pentagonal,perennial,petiole,pilose,plant,poricidally,puberulent,pubescent,rotate,seed,short,short-stalked,size,slightly,slit,sometimes,stamen,stigma,straight,stripe,style,terminal,testal,thick,triangular,type,wall,wide,yellow	1.7,2-2.,3-6,3-6-foliat,4-4,9-32,abaxially,acuminate,adaxially,apex,articulate,base,cordate,covered,cuneate,decurrent,densely,digestion,diminished,distal,dorsally,eaf,edge,eed,elliptical,emoval,enzyme,first,flat,flower,folded,generally,globo,gradually,green-white,hair,half,honeycomb,less,living,lon,longer,lower,lunat,nflorescence,nther,oblique,orolla,ovate,pair,pattern,perfect,plan,proximal,rarely,reveal,ruit,second,sessile,seudostipule,short-petiolate,specimen,spreading,tal,tem,throughout,time,toward,triangulat,tuber-bearing,typically,unit,vary,whit,ympodial,Â¼,â	2-21,anther,arrangement,branching,colour,form,fruit,growth,height,history,inflorescence,length,life,lunate,ovary,pseudostipule,shape,stem,surface,texture,wet,white,width	0.4-1.5,1-2.5,1-4,1-7,1.1-3.5,1.1-4.1,1.5-2,1.8-2.4,2-12,2-3,2-4,3-8,3-9.8,4-22,4-6,4-7,4.2-10.7,6-15,8-9,9-22,acumen,acute,apical,apically,branched,cell,cm,connate,covering,cyme,darker,dehiscent,dichasial,dichasially,ebracteate,exceeding,forked,gland,globose,green,hair-like,herbaceous,introrse,lateral,light,lobe,long,long-attenuate,make,maturing,mm,monochasial,mucilaginous,odd-pinnate,often,outline,ovoid,pentagonal,perennial,pilose,poricidally,puberulent,pubescent,rotate,seed,short,short-stalked,slightly,slit,sometimes,stamen,stigma,straight,stripe,style,testal,thick,triangular,type,wall,wide,yellow	2-21,lunate,wet,white
399	wfo-0001030551	success	162	126	89	99	63	27	86	3	-5,0-2,0.5-1,0.6-1.5,1-10,1-2,1-2-6-12,1-2.5,1-3.5,1-4,1-5,1.5-2-3,1.5-2.5,1.5-2.5-5,10-20,2,2.5-4,20-25-30,3-12,3-4-7,3-5,3-8,4-10-40,4-5,5-17,5-6,abruptly,acuminate,acute,adpressed,also,apart,apex,basal,base,blue,broad,calyx,campanulate,clavate,cm,concave,connective,cordate,densely,dia,diameter,dilated,distally,ellipsoidal,entire,fading,flower,fruit,glandular-puberulent,globose,hair,lanceolate,lobe,long,margin,mm,moderately,narrow,narrowed,narrowly,oblong-fusiform,obtuse,often,ovate,ovate-elliptic,ovoid,pedicel,peduncle,perfect,petiole,pilose,puberulent,puberulent-pubescent,pubescent-pilose,rachi,radiu,remnant,shrub,simple,sparsely,stellate,stigma,style,tip,triangular,triangular-elliptic,truncate,tube,unbranched,unknown,violet,x,yellowish	1,13.,4-5-6,4-foliat,9-20,abaxially,absent,adaxially,aggregate,ape,articulated,axe,beyond,bilobe,blade,cell,chartaceous,color,directed,eaf,ed,equal,et,exceeding,exserted,fleshy,glabrous,laterally,leaving,lon,lower,martinelli,nflorescence,nther,orolla,papillose,pedicellar,pore,puberulen,pubescent-pilo,ripe,round,ruit,seen,shorter,slightly,small,spaced,stamen,stone,subcoriaceous,tal,tem,thecae,time,tomento,ud,unit,unknow,vary,wide,widening,ympodial	4-6,abaxial,adaxial,anther,arrangement,bilobed,bud,characteristic,colour,corolla,form,growth,height,history,inflorescence,leaf,length,life,ovary,perennial,plant,seed,shape,size,spacing,stem,texture	-5,0-2,0.5-1,0.6-1.5,1-10,1-2,1-2-6-12,1-2.5,1-3.5,1-4,1-5,1.5-2-3,1.5-2.5,1.5-2.5-5,10-20,2,2.5-4,20-25-30,3-12,3-4-7,3-5,3-8,4-10-40,4-5,5-17,5-6,abruptly,acuminate,acute,adpressed,also,apart,apex,basal,base,blue,broad,campanulate,clavate,cm,concave,cordate,densely,dia,dilated,distally,ellipsoidal,entire,fading,flower,glandular-puberulent,globose,hair,lanceolate,lobe,long,mm,moderately,narrow,narrowed,narrowly,oblong-fusiform,obtuse,often,ovate,ovate-elliptic,ovoid,perfect,pilose,puberulent,puberulent-pubescent,pubescent-pilose,shrub,simple,sparsely,stellate,style,tip,triangular,triangular-elliptic,truncate,unbranched,unknown,violet,x,yellowish	4-6,bilobed,perennial
400	wfo-0001030570	success	170	144	84	93	77	51	83	1	0-1-3,0.3-0.5,1-3,1-4,1-8,1.5,10-25,15-35,2-3,2-5,2-7-lobed,2-8,2.5-22,20-30,3-10,3-5,4-25,4-5,4-7,abaxially,acuminate,acute,adaxially,apex,apiculate,basal,base,beyond,calyx,cm,connivent,cordate,cylindrical,diameter,dilated,distally,eglandular,ellipsoidal,entire,exserted,flattened,flower,forked,fruit,glabrous,glandular-puberulent,globose,green,hair,lanceolate,leaf,lobe,lobed,long,margin,mm,narrowly,obtuse,occasionally,often,ovoid,pedicel,peduncle,petiole,pilose,pinnately,pubescent,purplish,rarely,rounded,rugose,simple,slightly,sometimes,sparsely,stamen,stigma,style,subcoriaceous,submarginally,tip,tree,triangular,truncate,tube,unbranched,unequal,unknown,unlobed,vein,white,x,yellow	.3-0.5-1,0.5-1,0.5-2-3,1,1-1.5,1-2,1-3-6,1-5,1.5-2.5,1/2,2-2.5,2-4,2-7,3-6,3.5-5,4-foliat,4/5,5-10-17,8-15-20,absent,aggregate,apart,ape,articulated,axe,blade,campanulate,cell,color,connective,directed,divided,eaf,eed,elliptic-oblong,exceeding,fleshy,glabrat,leaving,lon,lower,midrib,near,nflorescence,nther,orolla,ovate,pedicellar,perfect,pilo,pore,presen,punctate,purpl,rachi,radiu,remnant,ripe,ruit,shorter,sinus,small,somewhat,spaced,stellate,stone,tal,tem,thecae,time,tomento,truncat,ud,unit,vary,wide,ympodial	anther,appearance,arrangement,bark,border,branch,bud,characteristic,colour,corolla,corrugation,distal,drying,exertion,filament,form,fruiting,giving,glabrousnes,growth,height,history,inflorescence,interjected,lateral,leaflet,length,life,lobing,midpoint,na,new,number,ovary,per,plant,prickle,primary,pseudostipule,ray,seed,shape,size,stem,surface,terminal,texture,thicknes,type,variation,width	0-1-3,0.3-0.5,1-3,1-4,1-8,1.5,10-25,15-35,2-3,2-5,2-7-lobed,2-8,2.5-22,20-30,3-10,3-5,4-25,4-5,4-7,abaxially,acuminate,acute,adaxially,apex,apiculate,basal,base,beyond,cm,connivent,cordate,cylindrical,dilated,distally,eglandular,ellipsoidal,entire,exserted,flattened,flower,forked,fruit,glabrous,glandular-puberulent,globose,green,hair,lanceolate,lobe,lobed,long,mm,narrowly,obtuse,occasionally,often,ovoid,pilose,pinnately,pubescent,purplish,rarely,rounded,rugose,simple,slightly,sometimes,sparsely,stamen,subcoriaceous,submarginally,tip,tree,triangular,truncate,unbranched,unequal,unknown,unlobed,vein,white,x,yellow	na
401	wfo-0001030581	success	187	135	98	100	87	35	81	17	1-4-celled,9,abaxial,acute,adaxial,along,angle,angled,anther,anthesi,apex,appressed,articulated,basal,base,berry,black,calyx,capitate,central,clustered,cm,conical,corolla,decurrent,densely,denser,diameter,ellipsoid,elliptic,entire,exserted,filament,flattened-reniform,flower,fruit,fruiting,globose,green,growth,halfway,herb,inflorescence,intermodal,lateral,leaf,less,like,lobe,long,margin,maturity,minute,minutely,mm,near,new,occasionally,often,once-branched,ovary,ovate,pair,papillate,pedicel,peduncle,per,petiole,pitted,plant,portion,primary,pubescent,purplish,ridge,ripe,shallow,simple,slightly,somewhat,sparsely,spreading,stem,stigma,straight,style,surface,terete,third,translucent,trichome,tube,turning,uniseriate,upper,vein,white,wide,yellow,yellowish	.3,.5,0.2â0.8,0.4â0.6,0.4â1.6,0.5,0.5â0.7,0.5â2.5,0.6â0.7,0.7â0.8,0.9â1,1,1.2â1.5,1.8â8,1â2,1â2-celled,1â2.5,1â4-celled,2,20â50,2â3-celled,35â45,3â4,3â5,4.5â12,4â7,4â9,5-merous,5â6,5â8,abaxially,adaxially,aggregate,apar,becoming,beyond,branched,bright,cell,cone,difoliate,drop,eaf,eed,florescence,free,geminat,glabrous,individual,lacking,later,leave,live,lobed,lon,lower,markedly,narrowly,outline,pentagonal,perfect,rachi,reflexe,reflexed,remaining,rounded,ruit,scar,shiny,shorter,spaced,sprawlin,stellate,stone,strongly,tall,tangled,tem,testal,ud,unit,usually,winged,woody,ympodial,â15,â5	0.2-0.8,0.4-1.6,0.5-2.5,0.6-0.7,0.9-1,1-2-celled,1-2.5,1.2-1.5,20-50,3-4,3-5,35-45,4-7,4-9,5,5-6,5-8,arrangement,bud,characteristic,colour,exertion,form,glabrousnes,height,history,length,life,lobing,number,seed,shape,size,texture,type	1-4-celled,9,acute,along,angle,angled,anthesi,appressed,articulated,basal,base,berry,black,calyx,capitate,central,clustered,cm,conical,decurrent,densely,denser,diameter,ellipsoid,elliptic,entire,exserted,flattened-reniform,flower,globose,green,halfway,herb,intermodal,lateral,leaf,less,like,lobe,long,maturity,minute,minutely,mm,near,occasionally,often,once-branched,ovate,pair,papillate,per,petiole,pitted,portion,pubescent,purplish,ridge,ripe,shallow,simple,slightly,somewhat,sparsely,spreading,stem,straight,surface,terete,third,translucent,trichome,tube,turning,uniseriate,upper,vein,white,wide,yellow,yellowish	0.2-0.8,0.4-1.6,0.5-2.5,0.6-0.7,0.9-1,1-2-celled,1-2.5,1.2-1.5,20-50,3-4,3-5,35-45,4-7,4-9,5,5-6,5-8
402	wfo-0001030583	success	166	117	83	96	70	21	80	3	.2,.5,0.1-0.5,0.2-1,0.3-1,0.4-2.7,0.5-1,0.7-4.5,0.8-1,0.9-3.5,1,1-1.5,1-8,1/2,2.5,2.5-3,2.5-9,3-4,3/4,5-6,abaxial,acute,anther,apex,bark,base,berry,calyx,cm,corolla,crisped,cultivar,deep,dendritic,densely,dia,difoliate,dry,ellipsoid,elliptic,erect,flattened-reniform,flower,form,fruit,fruiting,glabrous,globose,golden,green,immature,included,incrassate,irregular,leaf,lobe,lobed,long,margin,minor,minutely,mm,narrowly,often,opposite,orange-red,ovary,pale,pedicel,petiole,pitted,prostrate,pubescent,ripe,rounded,shaped,shrub,simple,size,small,small-capitate,soon,stem,stigma,style,surface,tall,tan,tear-drop,trichome,unit,way,white,x,yellow,young	1-2,1.5-4,4-6,5-7,6-7,abaxially,adaxially,along,anthesi,ba,brow,cell,closely,conical,corky,cultivated,dark,deflexed,differing,eaf,edicel,eed,enlarged,especially,filament,free,frui,geminat,lateral,leave,like,live,lon,long-rectangular,long-triangular,lower,main,major,midvein,nflorescence,occasionally,older,outline,overlapping,pair,papery,papillo,papillose,pericarp,planar,plant,pore,poricidal,portion,rest,ruit,scar,spaced,spathulate,specimen,stout,testal,thin,tip,tube,ud,uniseriate,vein,woody,ympodial	adaxial,arrangement,brown,bud,characteristic,colour,diameter,exertion,geminate,growth,hair,history,inflorescence,length,life,lobing,seed,shape,sympodial,texture,type	.2,.5,0.1-0.5,0.2-1,0.3-1,0.4-2.7,0.5-1,0.7-4.5,0.8-1,0.9-3.5,1,1-1.5,1-8,1/2,2.5,2.5-3,2.5-9,3-4,3/4,5-6,acute,base,berry,calyx,cm,crisped,cultivar,deep,dendritic,densely,dia,difoliate,dry,ellipsoid,elliptic,erect,flattened-reniform,flower,glabrous,globose,golden,green,immature,included,incrassate,irregular,leaf,lobe,lobed,long,margin,minutely,mm,narrowly,often,opposite,orange-red,pale,pitted,prostrate,pubescent,ripe,rounded,shaped,shrub,simple,small,small-capitate,soon,stem,tall,tan,tear-drop,trichome,unit,way,white,x,yellow,young	brown,geminate,sympodial
403	wfo-0001030605	success	144	119	84	96	48	23	82	2	.4,.5,0.3-0.5,1,1-4,1.5-2,1.7,12-19-flowered,2,2.5,7,acute,almost,anther,anthesi,apex,apical,area,attenuate,base,berry,branch,branched,brown,calyx,cinereous,cm,commonly,coriaceous,corolla,covered,cylindrical,dark,dendritic-echinoid,densely,dia,difoliate,dry,ellipsoid,exerted,fruiting,glabrate,glabrous,globose,gold,green,growth,inflorescence,leaf,less,light,lobe,long,margin,material,minutely,mm,nearly,new,obovate,obtuse,olive,ovary,ovoid-reniform,pedicel,peduncle,petiole,pitted,pubescent,rarely,reflexed,revolute,rounded,shaped,shiny,shrub,simple,slender,slightly,smooth,soon,sparsely,stigma,style,surface,tear-drop,thickened,tinged,tip,trichome,tube,unifoliate,way,white,woody,x	0.1,1.5-5.5,1/3-1/2,2-3,5-12.5,abaxially,adaxially,along,apart,ape,beginning,beneath,conical,deflexed,drying,eaf,edicel,eed,entire,filament,free,geminat,inflorescenc,internodal,lobed,lower,midrib,nflorescence,occasionally,opposite,otherwise,ovate,overlapping,papillate,papillosefruit,pore,poricidal,portion,scar,scattered,somewhat,sparesly,tub,ud,unit,vein,yellow,ympodial	arrangement,bud,characteristic,colour,diameter,exertion,form,fruit,geminate,glabrousnes,height,history,length,life,lobing,papillose,plant,seed,shape,size,stem,texture,type	.4,.5,0.3-0.5,1,1-4,1.5-2,1.7,12-19-flowered,2,2.5,7,acute,almost,anthesi,apex,apical,area,attenuate,base,berry,branch,branched,brown,calyx,cinereous,cm,commonly,coriaceous,covered,cylindrical,dark,dendritic-echinoid,densely,dia,difoliate,dry,ellipsoid,exerted,glabrate,glabrous,globose,gold,green,less,light,lobe,long,material,minutely,mm,nearly,obovate,obtuse,olive,ovoid-reniform,pitted,pubescent,rarely,reflexed,revolute,rounded,shaped,shiny,shrub,simple,slender,slightly,smooth,soon,sparsely,style,tear-drop,thickened,tinged,tip,trichome,tube,unifoliate,way,white,woody,x	geminate,papillose
404	wfo-0001030624	success	170	113	83	92	78	21	80	3	.5,0.9-1,1-3,1.2-1.8,1.2-2,1.5-2,2-10,2-3,25-40-flowered,3-3.5,3.5-4,acute,anther,apex,attenuate,axil,bark,base,berry,calyx,clavate,cm,corolla,decurrent,dia,ellipsoid,elliptic,except,exserted,extreme,falcate,flattened-reniform,fruiting,furcate,glabrate,glabrous,glandular,globose,green,hyaline,large,later,lateral,leaf,lobe,long,longitudinally,main,middle,minutely,mm,narrowly,nearly,occasionally,one,opposite,ovary,papillose,pedicel,petiole,pitted,puberulent,shining,short,shrub,simple,size,slender,slightly,small,soon,stem,stigma,straight,style,surface,tapering,three,tip,tree,trichome,tube,tuft,two,uniseriate,vein,white,widest,x,yellowish,yellowish-green,yellowish-grey	.25,0.5,0.5-1,0.5-1.5,2,2.5-5.5,3,4.5-8,6-13,7-9,anthesi,apart,apiculate,appearing,ba,beginning,branch,caly,cell,deflexed,differing,difoliate,dimorphic,distal,dry,eaf,edicel,eed,end,erect,expanded,filament,free,geminat,greyish,incrassate,inflorescenc,like,lobed,lon,lower,major,margin,material,midrib,minor,near,nflorescence,older,outer,pair,pale,planar,pore,poricidal,portion,prominent,raised,remaining,round,rugo,ruit,scar,somewhat,spaced,square,tall,thickened,ti,trunk,ud,unevenly,unit,wall,woody,yellow,ympodial,young	arrangement,bud,characteristic,colour,diameter,exertion,form,fruit,growth,height,history,inflorescence,length,life,lobing,plant,rugose,seed,shape,texture,type	.5,0.9-1,1-3,1.2-1.8,1.2-2,1.5-2,2-10,2-3,25-40-flowered,3-3.5,3.5-4,acute,attenuate,axil,base,berry,calyx,clavate,cm,decurrent,dia,ellipsoid,elliptic,except,exserted,extreme,falcate,flattened-reniform,furcate,glabrate,glabrous,glandular,globose,green,hyaline,large,later,lateral,leaf,lobe,long,longitudinally,main,middle,minutely,mm,narrowly,nearly,occasionally,one,opposite,papillose,petiole,pitted,puberulent,shining,short,shrub,simple,slender,slightly,small,soon,straight,tapering,three,tip,tree,trichome,tube,tuft,two,uniseriate,vein,white,widest,x,yellowish,yellowish-green,yellowish-grey	.2-2,di,rugose
405	wfo-0001030638	success	177	109	75	86	91	23	69	6	0.1,0.5-1,0.5-1.5,0.7-1.5,1-1.2,1-1.5,1.4-1.7,1.5-2,1.6-2.2,2-3,2-7-flowered,2.5-4,3-10,8,8-9,anther,anthesi,apically,bark,base,berry,broadly,bud,calyx,cm,corolla,cup-shaped,deflexed,densely,dia,difoliate,elliptic,exfoliating,filament,flattened,fruit,fruiting,geminate,glabrate,glabrous,glandular,globose,green,inflorescence,later,leaf,less,lobed,long,minor,minutely,mm,nearly,obovate,occasionally,open,opposite,ovary,pale,papillose,pedicel,petiole,poricidal,red,red-glandular,rugose,seed,shape,shrub,simple,size,stem,stigma,style,surface,tapering,terminal,thickening,tip,transversely,tree,tube,unit,white,x,young	0.5,0.5-0.7,0.5-2,1-2,2-5,3-13,4-6,8-11,acute,along,apex,appear,appearing,axi,axil,ba,beginning,beneath,blade,branched,closely,conspicuously,corky,cucullate,deltoid,differing,dry,eaf,eed,entire,erect,extending,fleshy,free,geminat,gre,impressed,irregular,known,lamina,large,lateral,like,lobe,lon,lower,main,major,margin,material,middle,near,nflorescence,often,older,one,overlapping,ovoi,pair,paler,papillae,papillo,persistent,planar,pore,portion,present,prominent,rather,reddish,rest,roundish,ruit,scar,shaped,soon,spaced,speciman,straight,tall,tear-drop,thick,thickened,trichome,uniseriate,usually,vein,wall,widest,woody,ympodial	abaxial,adaxial,arrangement,characteristic,colour,diameter,form,grey,growth,hair,height,history,length,life,lobing,na,number,ovoid,per,plant,sympodial,texture,type	0.1,0.5-1,0.5-1.5,0.7-1.5,1-1.2,1-1.5,1.4-1.7,1.5-2,1.6-2.2,2-7-flowered,2.5-4,3-10,8,8-9,anthesi,apically,base,berry,broadly,calyx,cm,cup-shaped,deflexed,densely,dia,difoliate,elliptic,exfoliating,flattened,geminate,glabrate,glabrous,glandular,globose,green,later,leaf,less,lobed,long,minutely,mm,nearly,obovate,occasionally,open,opposite,pale,papillose,poricidal,red,red-glandular,rugose,shrub,simple,stem,style,surface,tapering,terminal,thickening,tip,transversely,tree,tube,unit,white,x,young	-3,di,grey,na,ovoid,sympodial
406	wfo-0001030661	success	180	135	100	112	68	23	97	3	.5,0.5-0.6,0.5-2,0.7-0.8,1-1.2,1-1.4,1-1.5,1.5-7,4-15,5-5.5,50-100+,acute,along,anther,anthesi,apex,articulated,attenuate,base,berry,branched,brown,calyx,capitate,cell,cm,connivent,corolla,densely,denser,diameter,ellipsoid,elliptic,entire,erect,exserted,extending,filament,flattened,flower,fruiting,glabrescent,glabrous,globose,growth,inflorescence,insertion,lamina,lateral,leaf,lobed,long,loosely,lower,many,margin,mature,membranous,midrib,minute,minutely,mm,narrowly,near,new,nodding,occasionally,onto,pedicel,peduncle,petiole,pitted,point,poricidal,pubescent,rectangular,red,reddish,reniform,scattered,shrub,simple,sleeve,slender,slightly,small,sparsely,stem,stigma,strongly,style,surface,tangled,terminal,testal,time,tinged,tip,tree,trichome,tube,uniseriate,upper,usually,vein,violet,way,white,winged,woody,Â½,Â¾	.2,0,0.5-0.75,1-.,1-1.2-7,1-1.3,1.5-2,12-16-24,2-2.5,2-3-20,3-3.5,3-4,4-6,5-10,5-merou,ag,alyx,ark,branch,brow,clustered,conical,dar,deltate,drying,eaf,eed,em,erec,free,glabrou,group,ilament,lengthening,lobe,lon,never,nflorescence,older,orolla,otherwise,pair,pale,papillo,per,perfect,pericarp,planar,platform,plurifoliat,pore,portion,primary,ruit,scar,shiny,slit,spreading,stellate,thin,twinin,ud,unit,vary,x,yellow,yellowish,ympodial	1-5,arrangement,bud,characteristic,colour,exertion,form,fruit,glabrousnes,height,history,length,life,lobing,ovary,papillose,plant,seed,shape,size,stelate,texture,type	.5,0.5-0.6,0.5-2,0.7-0.8,1-1.2,1-1.4,1-1.5,1.5-7,4-15,5-5.5,50-100+,acute,along,anthesi,articulated,attenuate,base,berry,branched,brown,calyx,capitate,cell,cm,connivent,densely,denser,diameter,ellipsoid,elliptic,entire,erect,exserted,extending,flattened,flower,glabrescent,glabrous,globose,insertion,lamina,lateral,lobed,long,loosely,lower,many,mature,membranous,midrib,minute,minutely,mm,narrowly,near,nodding,occasionally,onto,pitted,point,poricidal,pubescent,rectangular,red,reddish,reniform,scattered,shrub,simple,sleeve,slender,slightly,small,sparsely,stem,strongly,surface,tangled,terminal,testal,time,tinged,tip,tree,trichome,tube,uniseriate,upper,usually,vein,violet,way,white,winged,woody,Â½,Â¾	1-5,papillose,stelate
407	wfo-0001030676	success	219	125	89	101	118	24	86	3	0.4,1-1.2,1-3,1.1-1.4,1.2-1.3,14-17,16,19-35,3-6,4-6,7-8,7-9,8-10,8-12,abaxially,abruptly,acute,adaxially,angled,anther,anthesi,apart,apex,appressed-tomentose,articulated,bark,base,becoming,berry,blunt-tipped,branch,brown,bud,calyx,closely,cm,conical,continued,corolla,deltoid,diameter,due,elongate,entire,exserted,filament,finely,fleshy,fruit,globose,granular-tomentose,green,greenish,grooved,growth,honeycombed,lateral,leaf,length,longitudinally,margin,midvein,minutely,mm,oblique,oblong,oblong-elliptic,often,ovate-lanceolate,pedicel,peduncle,probably,pseudo-terminal,pulverulent,reniform,reticulate-punctate,ripe,scabrous,short-attenuate,shrub,side,simple,small,somewhat,spaced,stem,stigma,strongly,style,subcampanulate,subglobose,suborbicular,terete,tree,vein,velutinous,white,whitish,x,yellow,yellowish	-2.5,-3.9,-8.5,/10-1/5,0-100,0.6-1.2-1.6,1,1.1-1.9,1.3-1.5,1.7-2,1/4,11-14,2.1-2.3,2.1-2.6,2.2-5.7,2.4-3.1,2.5-5.5,2.75-3.25,3-3.5,3-5,4-6.5,7-10,along,apical-lateral,apparently,appearing,axillary,ba,blade,branched,chartaceous,crown,cylindrical,dehiscing,densely,dichotomously,eaf,echinoi,echinoid,eed,except,flat-topped,flower,forming,free,glabrescen,glabrescent,glabrous,hair,high,horizontal,initially,inserted,introrse,lackin,lamina,large,lengthen,lined,lobe,lobed,long,longitudinal,lower,main,midvei,minute,moderately,mostly,multangulate,nearly,nflorescence,obtuse,occasional,older,opening,openly,orolla,ovate,parallel,perfect,petiole,plurifoliate,pore,pubescent,rachi,rather,ray,ridged,ruit,runk,scattered,sessile,short-stalked,slit,sparsely,spreading,stellate,stellate-pubescent,subcapitat,tamen,tending,testa,thick,thin,time,tip,tomentose,tube,tuft,unarme,unit,usually,vary,way,wide,ympodial,young	arrangement,characteristic,colour,exertion,form,glabrousnes,height,history,inflorescence,life,lobing,new,ovary,perennial,plant,primary,seed,shape,size,subcapitate,surface,texture,type,unarmed	0.4,1-1.2,1-3,1.1-1.4,1.2-1.3,14-17,16,19-35,3-6,4-6,7-8,7-9,8-10,8-12,abaxially,abruptly,acute,adaxially,angled,anthesi,apart,apex,appressed-tomentose,articulated,base,becoming,berry,blunt-tipped,brown,calyx,closely,cm,conical,continued,deltoid,diameter,due,elongate,entire,exserted,finely,fleshy,globose,granular-tomentose,green,greenish,grooved,growth,honeycombed,lateral,longitudinally,midvein,minutely,mm,oblique,oblong,oblong-elliptic,often,ovate-lanceolate,probably,pseudo-terminal,pulverulent,reniform,reticulate-punctate,ripe,scabrous,short-attenuate,shrub,side,simple,small,somewhat,spaced,stem,strongly,subcampanulate,subglobose,suborbicular,terete,tree,velutinous,white,whitish,x,yellow,yellowish	perennial,subcapitate,unarmed
408	wfo-0001030686	success	182	122	80	103	79	19	79	1	.2,.5,1-1.1,1-1.2,1-2,1.2-1.5,1.5-2,1.5-4.5,1.6-3,15,2-2.5,2-3,2-6.5,2.5-8,3-3.5,5-12,5-25,5-30,5-6,8-9,abruptly,acuminate,acute,anther,apex,bark,basal,base,berry,bifid,black,branched,brown,c.,calyx,cm,conical,corolla,cup-shaped,dark,darker,deeply,densely,diameter,drying,elliptic,entire,erect,filament,flattened,flower,form,fruit,fruiting,glabrous,globose,half,height,internodal,leaf,leaf-opposed,lepidote,less,lilac,lobe,long,margin,maturity,mm,oblique,orange,ovary,pair,pale,pedicel,peduncle,petiole,pitted,plant,poricidal,primary,pubescent,purple,seed,shallowly,shiny,short,simple,spreading,stem,stigma,style,surface,time,tip,tree,tube,uniformly,usually,vein,way,x,yellow	.5-1,0.5-1,1-1.5,1972,2.5-4,?,abaxially,aborted,adam,adaxially,age,anthesi,apart,beneath,breast,brittle,bu,centre,closely,denser,different,difoliate,discolorous,dry,eaf,edicel,eed,empty,exerted,fide,fragrant,free,geminat,glabrescen,golden,heteromorphic,lamina,lengthening,lobed,lower,many,midrib,midvein,minutely,nflorescence,noddin,older,overlapping,paler,papillae,papillose,pericarp,planar,pore,portion,pubescen,rachi,ruit,scar,scarious,shallow,slightly,slit,somewhat,space,spaced,sparsely,stellate,strongly,styl,thin,tissue,trichome,ud,unit,visible,woody,ympodial,â	arrangement,branch,bud,characteristic,colour,exertion,glabrousnes,growth,history,inflorescence,length,life,lobing,mentioned,new,shape,size,texture,type	.2,.5,1-1.1,1-1.2,1-2,1.2-1.5,1.5-2,1.5-4.5,1.6-3,15,2-2.5,2-3,2-6.5,2.5-8,3-3.5,5-12,5-25,5-30,5-6,8-9,abruptly,acuminate,acute,apex,basal,base,berry,bifid,black,branched,brown,c.,cm,conical,cup-shaped,dark,darker,deeply,densely,diameter,elliptic,entire,erect,flattened,flower,glabrous,globose,half,internodal,leaf-opposed,lepidote,less,lilac,lobe,long,maturity,mm,oblique,orange,pair,pale,pitted,poricidal,pubescent,purple,shallowly,shiny,short,simple,spreading,style,time,tip,tree,uniformly,usually,way,x,yellow	mentioned
409	wfo-0001030709	success	214	103	65	85	129	18	63	2	-9,0.7-1,0.9-1.5,1-1.2,1-1.6,1-4.5,1.3-1.4,1.4-2,1.6-2.1,1.9-2.8,1/3-1/2,1/4,2-6,2.3-3,5-20,6-21,7-9,8-11,acuminate,acute,anther,apex,apically,articulated,bark,base,berry,calyx,chartaceous,cm,cordate,diameter,dull,elliptic,erect,filament,finely,flattened-reniform,fruit,fruiting,inflorescence,lateral,leaf,length,lobed,lobing,long,margin,maturity,mauve,mm,moderately,narrow-deltate,orange-brown,pair,pedicel,peduncle,petiole,pitted,poricidal,prickly,primary,purple,red-green,seed,shrub,simple,size,sparsely,spherical,spreading,stellate-pubescent,stem,style,surface,tapering,terminal,tip,truncate,upper,vein,way,wide,yellow,yellow-green	0-2,0-2-8,0-20,0-30,0-5,0.1-0.2,0.15-0.5,0.2-0.5,0.3-1.5,0.4,0.8-4,1-6,1/2-2/3,1/4-1/3,10-14,10-50,2-4,2-5,2/3-3/4,3-5-9,4-5-merous,5-10,5-6,5-7,6-10,6-7,6-8,7-8,8-15,abaxially,adaxially,almost,alyx,ame,apar,apart,ape,apparently,blade,branched,bright,broad-deltate,brow,c.,conical,connivent,cuspidate,deltate,discolorous,distance,drying,eaf,edge,eed,elongating,equal,extending,flower,free,glabrescent,glabrous,increasing,infructescence,lanceolate,lengt,lobe,lon,long-acuminat,longer,lower,mature,middle,midpoint,midvein,nflorescence,occasionally,often,older,one,open,orolla,oung,pendulous,per,perfect,pericarp,perpendicular,pit,plurifoliat,porrect,portion,prickl,prickle,ray,red-orange,reflexed,retrorse,rounded,ruit,scar,secondary,short-styled,shorter,side,slender,smooth,sometimes,spaced,stalk,stalked,stellate,straight,tamen,terete,tertiary,time,toward,trichome,tube,unarmed,unit,usually,variously,vary,venation,visible,weakly,woody,ympodial	arrangement,branch,brown,characteristic,colour,corolla,exertion,form,glabrousnes,growth,height,long-acuminate,new,ovary,plant,shape,texture,type	-9,0.7-1,0.9-1.5,1-1.2,1-1.6,1-4.5,1.3-1.4,1.4-2,1.6-2.1,1.9-2.8,1/3-1/2,1/4,2-6,2.3-3,5-20,6-21,7-9,8-11,acuminate,acute,apically,articulated,base,berry,chartaceous,cm,cordate,diameter,dull,elliptic,erect,finely,flattened-reniform,lateral,lobed,long,maturity,mauve,mm,moderately,narrow-deltate,orange-brown,pair,pitted,poricidal,prickly,purple,red-green,shrub,simple,sparsely,spherical,spreading,stellate-pubescent,tapering,terminal,tip,truncate,upper,way,wide,yellow,yellow-green	brown,long-acuminate
410	wfo-0001030714	success	177	135	104	116	61	19	102	2	.2,/3,0.1-0.3,0.5,0.5-0.8,0.5-1.9-3,0.7-0.8,1.2-1.5,1.2-4,1/3,2-2.6,5-100,7-17,acuminate,acute,adaxially,age,aid,along,anther,apex,articulating,bark,basal,base,becoming,beneath,berry,blue,blue-black,branching,calyx,clavate,cm,conical,cordate,corolla,dark,denser,diameter,ellipsoid,elliptic,entire,especially,except,exserted,flattened,flower,fruit,glabrous,globose,gradually,greyish,growth,herbaceous,leaf-opposed,leaving,lengthening,liana,like,lobed,long,many,margin,membranous,midrib,minute,minutely,mm,narrowly,new,node,ob-ellipsoid,ob-elliptic,oblique,occasionally,ovary,overall,pale,papillate,pedicel,peduncle,peg,petiole,pitted,pore,poricidal,pubescent,reniform,ripe,shape,simple,slightly,slit,sparsely,stellate,stem,stigma,strongly,style,surface,tapering,terminal,time,tip,trichome,truncate,tube,twining,uniseriate,vein,vine,violet,way,woody,yellow	.5,0.3-0.4,0.8-1,1-1.2,1-1.3,1-1.5,1-2.5,1.4-3.5,1.5-2,2-2.5,20,3-3.5,3-7,5-6,>,abaxial,abaxially,anthesi,apar,campanulate,climbin,cup,densely,eaf,eed,fide,filament,free,grading,gree,howard,joined,lobe,lower,narrow,nflorescence,nodding,older,pair,paler,papillat,pedice,per,perfect,planar,plurifoliat,portion,primary,prominent,quadrate,ruit,scar,spaced,submarginal,thickened,tub,ud,unit,widely,x,ympodial	arrangement,bud,characteristic,climbing,colour,exertion,form,glabrousnes,green,history,inflorescence,leaf,length,life,lobing,seed,size,texture,type	.2,/3,0.1-0.3,0.5,0.5-0.8,0.5-1.9-3,0.7-0.8,1.2-1.5,1.2-4,1/3,2-2.6,5-100,7-17,acuminate,acute,adaxially,age,aid,along,articulating,basal,base,becoming,beneath,berry,blue,blue-black,branching,calyx,clavate,cm,conical,cordate,dark,denser,diameter,ellipsoid,elliptic,entire,especially,except,exserted,flattened,flower,glabrous,globose,gradually,greyish,herbaceous,leaf-opposed,leaving,lengthening,liana,like,lobed,long,many,membranous,midrib,minute,minutely,mm,narrowly,node,ob-ellipsoid,ob-elliptic,oblique,occasionally,overall,pale,papillate,peg,pitted,pore,poricidal,pubescent,reniform,ripe,shape,simple,slightly,slit,sparsely,stellate,stem,strongly,surface,tapering,terminal,time,tip,trichome,truncate,tube,twining,uniseriate,vein,vine,violet,way,woody,yellow	climbing,green
411	wfo-0001030733	success	130	89	56	65	65	24	51	5	.5,/4,1-1.2,1-1.5,1-2,1.7-2.7,2-2.5,3-4,3-5,5-8-flowered,6-7,abaxially,acuminate,acute,adaxially,anther,apex,bark,base,berry,bi-lobed,broadly,brown,calyx,capitate,cm,conical,corolla,dark,decurrent,densely,dia,ellipsoid,elliptic,erect,fruiting,glabrous,globose,later,leaf,long,minutely,mm,moderately,narrowly,onto,ovary,ovoid-reniform,pedicel,petiole,pubescent,shaped,shrub,simple,smooth,somewhat,stem,stigma,style,surface,tear-drop,treelet,way,white,x	0.5-1,1.5-5,4-15,4.5-5,6-9,?,along,anthesi,ape,clearly,closely,coriaceous,deltate,denser,eaf,eed,elongate,embryo,exserted,filament,free,grayish-brow,green,lamina,lateral,like,lobe,lobed,lon,lower,main,margin,middle,nflorescence,older,opposite,overlappin,pair,papillo,planar,pore,poricidal,portion,rounded,ruit,scar,spaced,sparsely,strongly,tall,testa,thick,tip,trichome,tube,ud,unifoliat,uniseriate,unit,vein,visible,widest,woody,ympodial,young	arrangement,bud,characteristic,colour,diameter,form,fruit,grayish-brown,growth,height,history,inflorescence,length,life,lobing,peduncle,perennial,plant,seed,shape,size,texture,type,unifoliate	.5,/4,1-1.2,1-1.5,1-2,2-2.5,3-4,3-5,5-8-flowered,6-7,abaxially,acuminate,acute,adaxially,apex,base,berry,bi-lobed,broadly,brown,capitate,cm,conical,dark,decurrent,densely,ellipsoid,elliptic,erect,glabrous,globose,later,long,minutely,mm,moderately,narrowly,onto,ovoid-reniform,petiole,pubescent,shaped,shrub,simple,smooth,somewhat,tear-drop,treelet,way,white,x	.7-2.7,di,grayish-brown,perennial,unifoliate
412	wfo-0001030772	success	154	117	75	92	62	25	72	3	.2,.25,.5,0.2-0.8-2,0.25-0.5,0.9-1,1-2,1-2.5,1.4-1.6,3-3.5,3-5,4.2-6.5,5-10-flowered,5-6,8-10,9-15,acuminate,anther,anthesi,apex,attenuate,bark,base,becoming,beneath,berry,branch,bud,calyx,capitate,cm,corolla,dark,deflexed,dia,ellipsoid,elliptic,extreme,filament,fruit,fruiting,gently,glabrous,globose,green,grey,later,lateral,leaf,lobed,long,long-acuminate,main,margin,minutely,mm,nearly,occasionally,ovary,ovoid-reniform,pair,pale,paler,papillose,pedicel,per,petiole,pitted,pore,poricidal,reflexed,shape,shaped,shining,shrub,simple,size,slender,soon,stem,stigma,style,surface,tan,tapering,tear-drop,tip,tube,vein,white,x,young	.05,0.5-1,0.75-1,0.9-3.1,1.2-5,1.5-2,2-7,acute,archin,ba,beginning,closely,differing,difoliate,eaf,edicel,eed,erect,free,geminat,impressed,inflorescenc,large,lenticellate,lobe,lon,long-triangular,lower,major,methyl,middle,minor,nflorescence,node,older,one,opposite,overlapping,papillo,portion,prominent,ripe,rounded,ruit,salicylate,scar,slightly,smelling,spaced,straight,strongly,swollen,tall,trichome,ud,uniseriate,unit,usually,widest,wintergreen,woody,ympodial	alternate,arching,arrangement,characteristic,colour,corrugation,diameter,drying,exertion,form,growth,height,history,inflorescence,length,life,lobing,na,number,peduncle,plant,primary,seed,texture,type	.2,.25,.5,0.2-0.8-2,0.25-0.5,0.9-1,1-2,1-2.5,1.4-1.6,3-3.5,3-5,4.2-6.5,5-10-flowered,5-6,8-10,9-15,acuminate,anthesi,attenuate,base,becoming,beneath,berry,bud,calyx,capitate,cm,dark,deflexed,dia,ellipsoid,elliptic,extreme,gently,glabrous,globose,green,grey,later,lateral,lobed,long,long-acuminate,main,minutely,mm,nearly,occasionally,ovoid-reniform,pair,pale,paler,papillose,pitted,pore,poricidal,reflexed,shaped,shining,shrub,simple,slender,soon,tan,tapering,tear-drop,tip,tube,vein,white,x,young	alternate,arching,na
413	wfo-0001030781	success	213	166	127	139	74	27	122	5	0-5,1-10,1-12,1-2,1-8,1.5-12,1.5-2,1.5-9,1.6-2.2,10-40,15-35,2-20,2.5-14,2.5-3.5,3-4,4-15,5-7,5-8,6-7,7.5-9,abaxially,adaxially,along,anther,apart,axillary,base,borne,broadly,brown,brownish,bud,cell,chartaceous,ciliate,cm,condition,corolla,covering,dark,deep,densely,diameter,distal,dot,drying,elliptic,end,especially,filament,finely,flower,forked,fresh,fruit,generally,glabrous,glandular,globose,gray-green,green,green-white,greenish,hair,hair-like,half,herb,high,homostylous,interjected,lanceolate,lateral,leaf,leaflet,lengthening,light,like,lobe,long,make,margin,membranous,midrib,minutely,mm,mucilaginous,obovate,odd-pinnate,ovate,ovate-lanceolate,ovoid,pair,papillose,pedicel,peduncle,pentagonal,pilose,plant,pore,poricidal,puberulent,pubescent,purple,rarely,rotate-pentagonal,scattered,seed,simple,singly,size,slit,small,sometimes,somewhat,sparsely,stem,stigma,straight,style,subovoid,subtending,terminal,testal,thick,throughout,tip,tube,tuber,typically,unwinged,usually,violet,wall,wet,white,whitish,wide,x,yellow	0.2-4,0.5-6,0.5-8,1-1.5,1-4,2-3,3-6,5-6,5-merou,abruptly,acumen,ag,alyx,apex,apiculate,apparently,articulated,axe,berry,blade,caly,capitat,connivent,cuneate,decreasing,decurrent,digestion,dorsally,eaf,edge,eed,enzyme,erect,exceeding,flat,folded,geminat,glabrou,gradually,honeycomb-shaped,larger,living,low-growin,lower,narrowed,nflorescence,orbicular,orolla,perfect,petiole,petiolulate,plurifoliate,pointed,rachi,removed,rounded,ruit,sessile,seudostipule,short,slightly,spaced,specimen,stamen,ste,stolo,tall,tamen,tem,toward,tri-,unit,vary,ympodial	5-merous,abaxial,adaxial,age,arrangement,articulation,calyx,capitate,colour,form,growth,height,history,inflorescence,length,life,number,ovary,pilosity,porosity,presence,pseudostipule,shape,spacing,stolon,texture,type	0-5,1-10,1-12,1-2,1-8,1.5-12,1.5-2,1.5-9,1.6-2.2,10-40,15-35,2-20,2.5-14,2.5-3.5,3-4,4-15,5-7,5-8,6-7,7.5-9,abaxially,adaxially,along,apart,axillary,base,borne,broadly,brown,brownish,bud,cell,chartaceous,ciliate,cm,condition,corolla,covering,dark,deep,densely,distal,dot,drying,elliptic,end,especially,finely,forked,fresh,generally,glabrous,glandular,globose,gray-green,green,green-white,greenish,hair,hair-like,half,herb,high,homostylous,lanceolate,lateral,lengthening,light,like,long,make,margin,membranous,midrib,minutely,mm,mucilaginous,obovate,odd-pinnate,ovate,ovate-lanceolate,ovoid,papillose,pentagonal,pilose,plant,pore,poricidal,puberulent,pubescent,purple,rarely,rotate-pentagonal,scattered,seed,simple,singly,slit,small,sometimes,somewhat,sparsely,stem,straight,subovoid,subtending,terminal,testal,thick,throughout,tip,typically,unwinged,usually,violet,wall,wet,white,whitish,wide,x,yellow	5-merous,age,calyx,capitate,stolon
414	wfo-0001030782	success	198	148	106	128	70	20	104	2	0-1,0-7,0.4-1.5,1-2,1-3,1-6,1.3-1.6,1.5-2,1.5-7.5,1.6-4.6,11-47,13-22,15,2,2-3,2.2-4,3-10,4-11.6,4-6,4.6-26,5-20,7-15.6,abaxially,acumen,acuminate,acute,adaxially,anther,apex,attenuate,axillary,base,blade,broadly,brownish,bud,cell,clavate,cm,condition,connivent,coriaceous,corolla,covering,dark,deep,diameter,distal,dorsally,drying,edge,elliptic,filament,flat,flower,folded,forked,fresh,fruit,generally,glabrescent,glabrous,globose,green,green-white,greenish,hair,hair-like,half,herb,homostylous,interjected,lanceolate,lateral,leaf,leaflet,light,lilac,lobe,long,make,medium,mm,moniliform,mottled,mucilaginous,odd-pinnate,ovate,ovoid,pair,pedicel,peduncle,pentagonal,petiole,petiolulate,plant,poricidal,prominently,purple,rachi,ripe,rotate,rounded,scarce,seed,sessile,short,size,stigma,straight,style,subtending,terminal,testal,thick,throughout,tip,tube,tuber,usually,wall,wet,white,whitish,wide,winged,x,yellow	1-5,1.2-3.9,12-30,2.4-11.5,3-5,5-merou,6-8,abaxiall,ag,along,alyx,apart,apparently,arranged,articulated,asymmetric,axe,basiscopic,bead,berry,capitat,cuneate,decreasing,digestion,eaf,eed,enzyme,exceeding,geminat,glabrou,hal,high,honeycomb-shaped,inconspicuous,lengthening,like,living,lower,multiple,necklace,nflorescence,orbicular,orolla,perfect,plurifoliate,pore,removed,ruit,second,seudostipule,side,slit,smaller,sometimes,spaced,specimen,stamen,stolon,subequal,tal,tamen,tem,tissue,totally,toward,tri-,typically,unit,vary,ympodial	5-merous,abaxial,adaxial,arrangement,calyx,capitate,colour,form,growth,height,history,inflorescence,length,life,ovary,pseudostipule,shape,stem,surface,texture	0-1,0-7,0.4-1.5,1-2,1-3,1-6,1.3-1.6,1.5-2,1.5-7.5,1.6-4.6,11-47,13-22,15,2,2-3,2.2-4,3-10,4-11.6,4-6,4.6-26,5-20,7-15.6,abaxially,acumen,acuminate,acute,adaxially,attenuate,axillary,broadly,brownish,bud,cell,clavate,cm,condition,connivent,coriaceous,covering,dark,deep,distal,dorsally,drying,elliptic,flat,folded,forked,fresh,generally,glabrescent,glabrous,globose,green,green-white,greenish,hair,hair-like,half,herb,homostylous,lanceolate,lateral,light,lilac,long,make,medium,mm,moniliform,mottled,mucilaginous,odd-pinnate,ovate,ovoid,pentagonal,petiolulate,plant,poricidal,prominently,purple,ripe,rotate,rounded,scarce,seed,sessile,short,straight,subtending,terminal,testal,thick,throughout,tip,usually,wall,wet,white,whitish,wide,winged,x,yellow	5-merous,capitate
415	wfo-0001030802	success	171	113	70	85	86	28	67	3	.3,.5,0,0.5-0.75,0.5-1,0.9-1,1,1-1.1,1-1.2,2-3,2-5,2.5-3,3-4,3-6,4-6,5-10-flowered,acuminate,acute,anther,apex,bark,base,berry,brown,bud,calyx,cm,cordate,corolla,deeply,dia,difoliate,exerted,filament,filiform,flattened-reniform,fruit,fruiting,glabrous,glandular,globose,halfway,heart-shaped,lateral,leaf,length,lobe,lobed,long,long-triangular,main,margin,minutely,mm,ovary,ovoid,pair,pale,papillate,pedicel,per,petiole,pitted,plant,pubescent,red,reddish,shaped,shrub,simple,somewhat,soon,stem,stigma,style,surface,tapering,tear-drop,tube,unifoliate,vein,white,x,yellow,yellowish	.5mm,0.25-0.4,0.5-1.5,0.7-1cm,0.75-1,1-1.5,2-2.5,3-3.5x,4-5mm,abaxially,abrupt,adaxially,along,anthesi,appearing,basal,becoming,beginning,beneath,campanulate,cucullate,deflexed,densely,denser,dry,eaf,edicel,eed,ellipsoid,evenly,except,exudate,free,geminat,gland,glandurla,hanging,incrassate,inflorescenc,internodal,invest,irregularly,lamina,later,line,live,lower,m.,markedly,material,midvein,near,nflorescence,obconic,older,palmate,papillose,persistently,pore,poricidal,portion,prominent,pubescen,raised,ruit,scar,single-celled,slender,spaced,specimen,stigm,straight,strongly,subshrub,tip,tipped,trichoem,trichome,ud,uniseriate,unit,variable,widely,woody,ympodial,young	0.7-1,4-5,arrangement,branch,characteristic,colour,corrugation,diameter,drying,exertion,form,glabrousnes,growth,height,history,inflorescence,life,lobing,na,new,number,peduncle,primary,seed,shape,size,texture,type	.3,.5,0,0.5-0.75,0.5-1,0.9-1,1,1-1.1,1-1.2,2-3,2-5,2.5-3,3-4,3-6,4-6,5-10-flowered,acuminate,acute,base,berry,brown,calyx,cm,cordate,deeply,dia,difoliate,exerted,filiform,flattened-reniform,fruit,glabrous,glandular,globose,halfway,heart-shaped,lateral,lobe,lobed,long,long-triangular,main,minutely,mm,ovoid,pair,pale,papillate,per,pitted,pubescent,red,reddish,shaped,shrub,simple,somewhat,soon,surface,tapering,tear-drop,unifoliate,vein,white,x,yellow,yellowish	0.7-1,4-5,na
416	wfo-0001030809	success	154	87	40	54	100	33	37	3	1.2-1.4,1.4-1.5,1.5-3.5,2-2.5,4.5-5,6-8,8,9.9-12,acute,anther,apex,bark,base,berry,calyx,clavate,cm,corolla,dia,ellipsoid,elliptic,erect,exserted,falcate,filament,fruit,fruiting,glabrous,globose,green,leaf,lobed,mm,nearly,opposite,ovary,ovate,pedicel,petiole,pubescent,size,soon,stem,stigma,style,tapering,terminal,tomentose,tree,tube,vein,white,x,yellow-brown	.5,0.2,0.5-1,1-1.25,1-1.5,1.5-2.4,2.3-5.5,20-60-flowered,5-8,across,along,also,anthesi,apar,appearing,beneath,branched,broadly,caly,campanulate,curl-tipped,curved,dark-papillo,deciduous,deflexed,deltoid,dense,densely,difoliate,distally,eaf,edicel,eed,especially,evenly,free,geminat,golden,hair,hidden,interpetalar,known,large,lateral,leave,like,lobe,lon,long,long-papillose,lower,main,major,markedly,mature,membranous,middle,midrib,minor,minutely,nflorescence,older,one,overtopping,planar,pore,poricidal,portion,present,round,ruit,scar,scattered,several,shinin,shining,shoot,simple,sinus,slender,slightly,small,spaced,straight,tall,three,time,tip,triangular,trichome,two,ud,underside,unequal,uniseriate,unit,wide,widest,ympodial,young	0.5,arrangement,branch,bud,characteristic,colour,corrugation,dark-papillose,diameter,drying,exertion,form,glabrousnes,growth,height,history,inflorescence,length,life,lobing,margin,na,new,number,peduncle,per,plant,primary,seed,shape,surface,texture,type	1.2-1.4,1.4-1.5,1.5-3.5,2-2.5,4.5-5,6-8,8,9.9-12,acute,base,berry,clavate,cm,dia,ellipsoid,elliptic,erect,exserted,falcate,glabrous,globose,green,leaf,lobed,mm,nearly,opposite,ovate,pubescent,soon,tapering,terminal,tomentose,tree,white,x,yellow-brown	0.5,dark-papillose,na
417	wfo-0001030810	success	191	96	64	59	132	37	49	15	anther,apex,axillary,base,bipinnate,blue,borne,brown,clavate,cm,colour,dark,decreasing,densely,diameter,divided,elliptical,filament,flattened,fleshy,fruit,glabrous,globose,green,greyish,leaf,leafy,long,margin,mm,moderately,oblong,older,pair,pale,pedicel,peduncle,pentagonal,petiole,pinnae,pinnate,pitted,primary,pubescent,shallowly,shiny,shoot,shrub,size,stem,stigma,style,subglabrous,surface,tomentose,unknown,violet,woody,x	0.2,0.2â0.3,0.3,0.4,0.5â,0.5â0.8,0.6â1.0,0.7â1.4,0.8â5.5,0.95â2.0,0â,1,1.0â1.5,1.0â2.0,1.0â3.0,1.1â2.0,1.1â2.2,1.2â1.5,1.5â1.9,1â2,1â3,1â5,2.9â4.5,20â100,2â3,2â4,3.0â5.0,3.3â5.5,3.3â8.5,3.5â4.6,3â19,4â14,4â5,4â7,5,5â15,5â30,5â32,6â10,6â22,7â10,7â11,8â10,abaxially,absen,accrescent,acute,adaxiall,adaxially,ag,along,anthesi,apart,articulated,axe,ba,blade,branched,calyx,cell,chartaceous,connivent,cylindrical,denser,eaf,eed,elliptic,equal,erect,especially,flower,geminat,hair,half,hig,indumentum,irregular,lobe,lon,longitudinal,lower,m.,midrib,midvein,multicellular,narrow,nflorescence,obtu,occasionally,opening,opposed,orolla,oung,perfect,plurifoliate,pore,poricidal,rarely,reflexed,rounded,ruit,secondary,shaped,side,simple,slit,sometimes,spaced,sparsely,stone,straight,tamen,tardily,tear-drop,time,tip,tube,unicellular,uniseriate,unit,vary,white,wide,wing,yellow,ympodial,â2.5,â3,â3.4,â4.5,â5.0,â8	0.2-0.3,0.6-1.0,0.8-5.5,1.1-2.2,1.2-1.5,1.5-1.9,20-100,3.3-5.5,3.3-8.5,4-14,4-5,4-7,5-32,7-10,8-10,abaxial,adaxial,arrangement,characteristic,corolla,form,glabrousnes,growth,height,history,inflorescence,length,life,lobing,new,ovary,plant,seed,shape,texture,type,vein	apex,axillary,base,bipinnate,blue,borne,brown,clavate,cm,dark,decreasing,densely,diameter,divided,elliptical,flattened,fleshy,glabrous,globose,green,greyish,leaf,leafy,long,mm,moderately,oblong,older,pair,pale,pentagonal,pinnae,pinnate,pitted,primary,pubescent,shallowly,shiny,shoot,shrub,size,stem,subglabrous,surface,tomentose,unknown,violet,woody,x	0.2-0.3,0.6-1.0,0.8-5.5,1.1-2.2,1.2-1.5,1.5-1.9,20-100,3.3-5.5,3.3-8.5,4-14,4-5,4-7,5-32,7-10,8-10
418	wfo-0001030822	success	146	87	45	63	83	24	45	0	0.1-0.2,0.5-1.5,0.8-1,0.9-1,1-1.2,1-1.5,11-15.5,2-2.5,2-3.8,2-5,3-3.5,3.5-7,5-6,5-7,anther,base,berry,clavate,cm,completely,corolla,elliptic-obovate,erect,exserted,filament,filiform,flattened-reniform,fruiting,glabrous,globose,green,inflorescence,leaf,long-ellipsoid,margin,minor,minutely,mm,nearly,ovary,pale,pedicel,petiole,pitted,revolute,shaped,shiny,shrub,simple,size,stem,stigma,strongly,style,surface,tan,tear-drop,tube,white,winged,x,yellowish-brown,young	.2,0-0.5,0.4,0.4-1,1.5-2,3-5,8-9,abaxially,acute,adaxially,anthesi,apex,attenuate,ba,beneath,broadly,calyx,closely,clustered,cucullat,cucullate,cup,decurrent,deflexed,deltate,dia,differing,difoliate,eaf,edicel,eed,fleshy,flower,free,geminat,incrassate,inflorescenc,internodal,later,lateral,lobe,lobed,lon,long,lower,main,major,middle,minute,near,nflorescence,occasionally,older,onto,open,opposite,pair,papillo,papillose,perhaps,planar,pore,poricidal,portion,present,red-papillose,ruit,scar,slightly,somewhat,spaced,sparsely,tall,tapering,tip,ud,unit,usually,vein,widest,woody,yellowish,ympodial	abaxial,adaxial,bud,characteristic,colour,diameter,exertion,form,fruit,glabrousnes,growth,height,history,length,life,lobing,maturity,plant,seed,shape,texture,type,width,winging	0.1-0.2,0.5-1.5,0.8-1,0.9-1,1-1.2,1-1.5,11-15.5,2-2.5,2-3.8,2-5,3-3.5,3.5-7,5-6,5-7,base,berry,clavate,cm,completely,elliptic-obovate,erect,exserted,filiform,flattened-reniform,glabrous,globose,green,long-ellipsoid,minutely,mm,nearly,pale,pitted,revolute,shaped,shiny,shrub,simple,strongly,tan,tear-drop,white,winged,x,yellowish-brown	
419	wfo-0001030871	success	248	160	120	132	116	28	117	3	0-120,0.2-0.4,0.3-4,0.6-1.5,0.7-1.3,1-18,1.3-2,1.5-3,1.8-2.6,1/2-3/4,11,2-8,3-32,3-5,3-6,3.5-14,30,4.5-6.5,4.8-9.5,6-40,9-13,abaxially,abruptly,acuminate,acute,adaxial,adaxially,along,anther,anthesi,apex,attenuate,bark,base,becoming,berry,blade,blunt-tipped,branch,branched,brown,bud,calyx,campanulate,chartaceous,cm,conical,continued,corolla,dark,decurrent,deltoid,densely,diameter,due,early,elongate,entire,equal,erect,exserted,filament,fleshy,flower,fruit,fruiting,glabrescent,glabrous,granular-tomentose,green,greenish,growth,honeycombed,lateral,leaf,length,long,longer,margin,midvein,mm,mostly,narrowly,nearly,nodding,oblong,obtuse,often,orbicular,ovate,ovate-lanceolate,pale,pedicel,peduncle,petiole,probably,prominent,pubescent,purple,reflexed,reniform,reticulate-punctate,ripe,scabridulous,short,shrub,side,simple,sometimes,sparingly,stamen,stem,stigma,strongly,style,subglobose,suborbicular,sulcate,terete,terminal,time,tomentose,tube,unarmed,vein,velutinous,violet,way,white,x,yellow,yellowish	.2-3,.8-3.5,.9-1.2,/30-1/5,0.4-1.8,0.7-2.5,1-1.3,1.3-3,1.4-2.7,1.5-6,1.8-3.5,1/2,1/4,1/4-1/3,2-3,2.8-4.5,3-4.4,5-33,5-7,7-12,accrescent,ag,apart,apical-lateral,apparently,appressed,appressed-tomentose,articulated,axe,axillary,ba,capitat,closely,dehiscing,dendritic-echinoi,dendritic-echinoid,dendritic-multangulate,directed,distal,eaf,earl,echinoi,echinoid,eed,elliptic,evident,extend,free,glabrescen,grayish,hair,held,high,inserted,introrse,large,lobe,lobed,long-,long-stalked,longitudinal,lower,m.,main,minute,mixed,multangulat,multangulate,nflorescence,occasionally,older,open,orbicula,orolla,overlapping,partly,perfect,plait,plurifoliate,pore,porrect-stellate,present,rachi,rather,ray,relatively,rotate-stellate,ruit,runk,sessile,short-,short-stalked,slit,small,somewhat,soon,spaced,sparsely,splitting,stellate-tomentose,striate,suture,tamen,testa,thick,thick-stalked,thin-stalked,toward,tree,unarme,unit,usually,vary,wide,ympodial,young	arrangement,capitate,characteristic,colour,corrugation,drying,exertion,form,glabrousnes,height,history,inflorescence,life,lobing,na,new,number,ovary,per,perennial,plant,primary,seed,shape,size,surface,texture,type	0-120,0.2-0.4,0.3-4,0.6-1.5,0.7-1.3,1-18,1.3-2,1.5-3,1.8-2.6,1/2-3/4,11,2-8,3-32,3-5,3-6,3.5-14,30,4.5-6.5,4.8-9.5,6-40,9-13,abaxially,abruptly,acuminate,acute,adaxial,adaxially,along,anthesi,apex,attenuate,base,becoming,berry,blade,blunt-tipped,branched,brown,calyx,campanulate,chartaceous,cm,conical,continued,dark,decurrent,deltoid,densely,diameter,due,early,elongate,entire,equal,erect,exserted,fleshy,flower,fruit,glabrescent,glabrous,granular-tomentose,green,greenish,growth,honeycombed,lateral,length,long,longer,midvein,mm,mostly,narrowly,nearly,nodding,oblong,obtuse,often,orbicular,ovate,ovate-lanceolate,pale,petiole,probably,prominent,pubescent,purple,reflexed,reniform,reticulate-punctate,ripe,scabridulous,short,shrub,side,simple,sometimes,sparingly,stamen,stem,strongly,subglobose,suborbicular,sulcate,terete,terminal,time,tomentose,unarmed,velutinous,violet,way,white,x,yellow,yellowish	capitate,na,perennial
420	wfo-0001030872	success	166	110	76	85	81	25	73	3	0.8-1,1-1.2,1-1.5,1-2,1.2-1.5,1.5-2,1.5-5,12-18,2-5,4-6,4-6-flowered,5-6,5.5-7,6-12.5,acuminate,acute,anther,apex,area,bark,base,berry,black,brown,calyx,closed,cm,completely,corky,corolla,dark,deflexed,dia,ellipsoid-ovoid,elliptic,erect,exserted,fleshy,fruiting,glabrate,glabrous,globose,green,hooded,leaf,lenticel,lobe,lobed,long,minutely,mm,nearly,nerve,oblique,one,opposite,ovary,ovate,pair,papillose,pedicel,petiole,primary,puberulent,red-glandular-puberulent,reddish-glandular,rest,shaped,shining,simple,size,small,soon,stem,stigma,straight,strongly,style,tear-drop,tip,tree,treelet,white,x,young	.5,0.5,0.5-1,0.8-2,1.2-3,3-7,adaxial,age,along,anthesi,appearing,beginning,broadly,caly,center,closely,consisting,crateriform,cucullate,darker,deltoid,densely,difoliate,dry,eaf,edicel,eed,filament,free,full,geminat,incurved,inflorescenc,known,large,lenticellate,less,like,live,lon,lower,major,margin,material,middle,minor,nflorescence,older,overlapping,pale,paler,petal,planar,pore,poricidal,portion,prominent,proximal,raised,rather,reddish-glandular-puberulent,relative,ridge,rounded,ruit,scar,shorter,side,slightly,spaced,specimen,styl,tall,tapering,thickened,tube,ud,unit,widest,woody,ympodial	arrangement,bud,characteristic,colour,diameter,exertion,form,fruit,growth,height,history,inflorescence,length,life,lobing,na,number,per,plant,seed,shape,surface,texture,type,vein	0.8-1,1-1.2,1-1.5,1-2,1.2-1.5,1.5-5,12-18,2-5,4-6,4-6-flowered,5-6,5.5-7,6-12.5,acuminate,acute,area,base,berry,black,brown,calyx,closed,cm,completely,corky,dark,deflexed,dia,ellipsoid-ovoid,elliptic,erect,exserted,fleshy,glabrate,glabrous,globose,green,hooded,leaf,lenticel,lobe,lobed,long,minutely,mm,nearly,nerve,oblique,one,opposite,ovate,pair,papillose,primary,puberulent,red-glandular-puberulent,reddish-glandular,rest,shaped,shining,simple,small,soon,straight,strongly,style,tear-drop,tip,tree,treelet,white,x,young	.5-2,di,na
421	wfo-0001030882	success	144	124	62	81	63	43	60	2	.1,.5,0.5-0.75,0.5-1,0.5-1.1,0.8-1.1,0.9-1.1,1-1.3,1-1.5,1-4,1.6-2,2,2.2-4.6,3/4,6.5-15.6,8-12,acuminate,anther,apex,attenuate,bark,base,berry,calyx,capitate,cm,corolla,crenulate,deflexed,dia,elliptic,exserted,filament,fruit,fruiting,glabrous,globose,green,lateral,leaf,lightly,lobe,long,main,margin,minutely,mm,narrowly,nearly,occasionally,ovary,ovoid,ovoid-reniform,pair,pale,papillose,pedicel,petiole,pitted,shaped,shrub,simple,size,small,soon,stem,stigma,style,surface,tan,tapering,tear-drop,terminal,tree,truncate,tube,vein,way,white,x,yellowish	0.75-1,0.8-2.4,2-5.4,2-6,3-3.5,?,accrescent,anthesi,beginning,beneath,closely,conical,deltoid,differing,difoliate,eaf,edicel,eed,erect,extreme,free,geminat,inflorescenc,lobed,lon,lower,major,middle,minor,nflorescence,older,one,opposite,overlapping,paler,papillo,peelin,planar,pore,poricidal,portion,prominent,raised,ruguse,ruit,scar,short,slender,slightly,spaced,straight,tall,thick,thickened,tip,transversely,tub,ud,unit,widest,woody,ympodial,young	-3.5,appearance,arrangement,border,branch,bud,characteristic,colour,corrugation,diameter,distal,drying,exertion,form,giving,glabrousnes,growth,height,history,inflorescence,interjected,leaflet,length,life,lobing,midpoint,na,new,number,peduncle,per,plant,prickle,primary,pseudostipule,ray,seed,shape,texture,thicknes,type,variation,width	.1,.5,0.5-0.75,0.5-1,0.5-1.1,0.8-1.1,0.9-1.1,1-1.3,1-1.5,1-4,1.6-2,2,2.2-4.6,3/4,6.5-15.6,8-12,acuminate,attenuate,base,berry,capitate,cm,crenulate,deflexed,dia,elliptic,exserted,glabrous,globose,green,lateral,lightly,long,main,minutely,mm,narrowly,nearly,occasionally,ovoid,ovoid-reniform,pair,pale,papillose,pitted,shaped,shrub,simple,small,soon,tan,tapering,tear-drop,tree,truncate,vein,way,white,x,yellowish	-3.5,na
422	wfo-0001030883	success	179	152	114	131	48	21	111	3	-3,.05,.1,.5,0.5-3,0.5-5,1-1.1,1-1.2,1-1.3,1-4,1.5-2,10-18,18-44.5,2-5,20-50-flowered,3-4,3/4,5-6,9.5-27.5,accrescent,acuminate,acute,anther,apex,arching,bark,base,becoming,berry,brown,calyx,cell,clavate,cm,collapsed,corolla,dark,deflexed,dia,difoliate,dry,elliptic,epidermal,filament,finely,fleshy,fruit,fruiting,furcate,geminate,glabrous,glandular,globose,green,hard,hollow,imbedded,inflorescence,large,later,lateral,leaf,like,live,lobe,lobed,long,long-acuminate,main,massive,material,midrib,minute,minutely,mm,oblique,occasionally,older,opposite,ovary,ovate,ovoid-reniform,pair,pale,papillate,papillose,pedicel,perpendicular,petaloid,petiole,pitted,placenta,plant,pore,poricidal,puberulent,quite,reticulate,russet,seed,shaped,shrub,size,slender,slightly,sometimes,soon,stem,stigma,stout,strongly,style,surface,tan,tapering,tear-drop,thick,time,tip,trichome,tube,uniseriate,unit,upper,vein,wall,way,white,woody,x,young	1-1.5,1.5-3.5,3-3.5,across,anthesi,apart,appearing,approximatately,branched,bu,collection,differing,eaf,edicel,eed,erect,evenly,free,geminat,laminar,lenticellat,less,little,living,lon,lower,malodorous,markedly,middle,narrowly,nflorescence,papillo,portion,present,proximal,pulp,rather,reflexed,ruit,scar,spaced,straight,tall,triangular,two,ud,widest,ympodial	adaxial,approximately,arrangement,bud,characteristic,colour,diameter,exertion,form,growth,height,history,length,life,lobing,number,per,shape,sympodial,texture,type	-3,.05,.1,.5,0.5-3,0.5-5,1-1.1,1-1.2,1-1.3,1-4,1.5-2,10-18,18-44.5,2-5,20-50-flowered,3-4,3/4,5-6,9.5-27.5,accrescent,acuminate,acute,arching,base,becoming,berry,brown,calyx,cell,clavate,cm,collapsed,dark,deflexed,dia,difoliate,dry,elliptic,epidermal,finely,fleshy,furcate,geminate,glabrous,glandular,globose,green,hard,hollow,imbedded,large,later,leaf,like,live,lobed,long,long-acuminate,massive,material,midrib,minute,minutely,mm,oblique,occasionally,older,opposite,ovate,ovoid-reniform,pair,pale,papillate,papillose,perpendicular,petaloid,pitted,placenta,plant,pore,poricidal,puberulent,quite,reticulate,russet,shaped,shrub,slender,slightly,sometimes,soon,stem,stout,strongly,tan,tapering,tear-drop,thick,time,tip,trichome,tube,uniseriate,unit,upper,wall,way,white,woody,x,young	approximately,bud,sympodial
423	wfo-0001030884	success	218	136	96	112	106	24	92	4	0.4-3,0.5-1.2,0.8-1,1-1.2,1-1.5,1.5,1.5-2,1.5-2.5,100,2-5,4-13,5-30,5-6,6-25,9-11,>,abruptly,acute,along,anther,anthesi,apex,bark,basal,base,berry,brown,c.,calyx,capitate,cm,conical,dark,decurrent,densely,diameter,elliptic,filament,flower,fruiting,glabrous,glandular,gray-tinged,green,greenish,growth,half,inflorescence,lateral,leaf,length,like,lobed,long,long-styled,long-triangular,margin,mature,minute,minutely,mixture,mm,moderately,new,ovary,ovoid-reniform,pair,pale,pedicel,peduncle,per,petiole,plant,poricidal,prickly,primary,pubescent,red,reddish,reflexed,rest,sagittate,sessile,shallowly,short-stalked,short-styled,shrub,simple,size,slender,sparsely,spherical,spreading,stellate,stem,stigma,strongly,style,surface,tannish,tapering,tip,treelet,trichome,tube,uniseriate,vein,way,white,wide,wing,winged	.2,.5,.7,0.3,0.3-0.5,0.5,0.9-5,1,1-3,10,2,4-5,4.5-5,5,5-merous,5.5-7,6-10,6-8,7-8,abaxial,abaxially,adaxial,adaxiall,also,alyx,andromonoeciou,apar,arme,articulated,blade,broad-based,connivent,curved,di-,differing,directed,discolorous,distal,eaf,eed,equal,extend,extending,flowering,free,geminate,gree,herbaceous,heterostylous,infructescence,leafy,lobe,long-stalked,lower,magnification,midpoint,midrib,nflorescence,node,occasionally,older,one,onto,open,orolla,oung,outlin,papillat,pore,porrect,portion,present,prickle,principal,ray,reflexe,regularly,ruit,scar,scattered,shap,short,similar,spaced,stellate-pubescent,stiff,still,tall,tamen,time,trifoliate,unarmed,unicellular,uniformly,unit,upward,usually,vary,varying,visible,weakly,without,woody,yellow,ympodial,young	armed,arrangement,branch,bud,characteristic,colour,corolla,drying,exertion,form,fruit,glabrousnes,height,history,life,lobing,na,number,outline,papillate,seed,shape,texture,type	0.4-3,0.5-1.2,0.8-1,1-1.2,1-1.5,1.5,1.5-2,1.5-2.5,100,2-5,4-13,5-30,5-6,6-25,9-11,>,abruptly,acute,along,anthesi,apex,basal,base,berry,brown,c.,capitate,cm,conical,dark,decurrent,densely,diameter,elliptic,flower,glabrous,glandular,gray-tinged,green,greenish,half,inflorescence,lateral,leaf,like,lobed,long,long-styled,long-triangular,mature,minute,minutely,mixture,mm,moderately,ovoid-reniform,pair,pale,per,petiole,poricidal,prickly,pubescent,red,reddish,reflexed,rest,sagittate,sessile,shallowly,short-stalked,short-styled,shrub,simple,slender,sparsely,spherical,spreading,stellate,strongly,surface,tannish,tapering,tip,treelet,trichome,uniseriate,way,white,wide,wing,winged	armed,na,outline,papillate
424	wfo-0001030899	success	145	114	78	88	57	26	75	3	.5-2,0.3-0.5,0.5-1,1,1-3,1-6,10-13,10-20,2-3,2-3.5,20-25-45,3-12,3-4,3-5,3.5-4,4-5,5-10,5-6.5,6.5-31-45,7-27,?,abaxially,acuminate,adaxially,apart,apex,basal,base,calyx,cm,connective,cordate,coriaceous,deeply,densely,desc,diameter,dilated,directed,distally,ellipsoidal,end,entire,ex,extrorse,flattened,flower,fruit,glabrous,glandular-puberulent,globose,green,less,light,lobe,long,margin,mm,mucronate,obconical,oblong,obtuse,ovate,ovoid,pedicel,peduncle,petiole,pore,puberulent,pubescent,rachi,radiu,remnant,shrub,simple,slightly,splotch,stellate,stigma,stripe,strongly,style,triangular,unbranched,upward,white,x,yellow	0.5,1-1.5,1-2,1.5-2,2,2.5-3.5,3-foliate,8-11,absent,acute,aggregate,ape,articulated,axe,beyond,blade,bronze,cell,chartaceous,connivent,eaf,eed,exceeding,exserted,inside,leaving,lon,lower,narrowly,nflorescence,nther,orang,orolla,outside,pedicellar,peltifor,perfect,presen,puberulen,purple,ruit,shorter,spaced,stamen,stone,tal,tem,thecae,time,tomento,tube,ud,unit,vary,vein,wide,ympodial	abaxial,adaxial,anther,arrangement,bud,characteristic,colour,corolla,direction,form,growth,height,inflorescence,leaf,length,orange,ovary,peltiform,plant,seed,shape,size,spacing,stem,texture,tomentose	.5-2,0.3-0.5,0.5-1,1,1-3,1-6,10-13,10-20,2-3,2-3.5,20-25-45,3-12,3-4,3-5,3.5-4,4-5,5-10,5-6.5,6.5-31-45,7-27,?,abaxially,acuminate,adaxially,apart,apex,basal,base,cm,cordate,coriaceous,deeply,densely,desc,diameter,dilated,directed,distally,ellipsoidal,end,entire,ex,extrorse,flattened,flower,glabrous,glandular-puberulent,globose,green,less,light,lobe,long,mm,mucronate,obconical,oblong,obtuse,ovate,ovoid,puberulent,pubescent,shrub,simple,slightly,splotch,stellate,stripe,strongly,triangular,unbranched,upward,white,x,yellow	orange,peltiform,tomentose
425	wfo-0001030902	success	158	110	66	79	79	31	62	4	-2,-20,0.6-1.5,1-2,1-6,1.5-13,1.5-2.5,10-15,2-3,2-5,2.5-4,3-20,30-50,4,4-7,5-7,5-9,acuminate,acute,angled,apart,apex,apically,apiculate,base,branched,brown-pilose,calyx,cm,connective,cordate,cylindrical,dark,deltate,densely,diameter,dilated,eglandular,ellipsoidal,entire,flattened,forked,fruit,glabrescent,glabrous,globose,hair,lobe,long,margin,mm,oblong,obtuse,occasionally,orange,ovate,pedicel,pedicellar,peduncle,petiole,pinkish,purple,purplish,rachi,radiu,rarely,reddish,remnant,simple,somewhat,stellate,stigma,style,tip,tree,truncate,unbranched,x,yellow	0-15,1.5-2,1.5-2-3-5,15-50,2,2.5,3-13,3-4,3.5-4,4-22,4-6,4-foliat,6-24,8-14,abaxially,absent,adaxially,aggregate,along,ape,articulated,axe,basal,beyond,blade,brow,cell,connivent,directed,distally,eaf,eed,equalling,exceeding,except,exserted,fleshy,flower,glabrat,glandular,glandular-puberulen,laterally,leaving,lon,lower,mature,narrowly,nflorescence,nther,orolla,perfect,pore,presen,present,puberulence,ruit,shorter,slightly,small,spaced,sparse,sparsely,stamen,stone,subcapitat,subcoriaceous,tal,tem,thecae,time,tomento,triangular,tube,ud,unit,vary,vein,wide,ympodial	abaxial,adaxial,anther,arrangement,brown,bud,characteristic,colour,corolla,form,glabrate,glabrousnes,growth,height,history,inflorescence,leaf,length,life,ovary,perennial,plant,seed,shape,size,spacing,stem,subcapitate,surface,texture,theca	-2,-20,0.6-1.5,1-2,1-6,1.5-13,1.5-2.5,10-15,2-3,2-5,2.5-4,3-20,30-50,4,4-7,5-7,5-9,acuminate,acute,angled,apart,apically,apiculate,branched,brown-pilose,cm,cordate,cylindrical,dark,deltate,densely,dilated,eglandular,ellipsoidal,entire,flattened,forked,glabrescent,glabrous,globose,hair,long,mm,oblong,obtuse,occasionally,orange,ovate,pinkish,purple,purplish,rarely,reddish,simple,somewhat,stellate,tip,tree,truncate,unbranched,x,yellow	brown,glabrate,perennial,subcapitate
426	wfo-0001030914	success	186	107	78	88	98	19	75	3	.1,.5,/4,0.7-1,0.8-1.3,1-2,1.2-1.5,1.5-3,1.5-8,2-10,5-25-flowered,7-8,along,anther,bark,base,berry,calyx,campanulate,capitate,cm,constriction,corolla,dark,densely,dia,dry,elliptic,erect,fruiting,furcate,glabrate,glabrous,globose,golden,green,inflorescence,leaf,lemon-yellow,length,like,lobed,long,many,minutely,mm,obovate,occasionally,older,opposite,otherwise,ovary,ovoid-reniform,pale,papillose,pedicel,petiole,pitted,plant,puberulent,pubescent,reddish-brown,ripe,shape,shaped,shrub,simple,slender,small,sparsely,specimen,stem,stigma,style,surface,tan,tapering,tear-drop,time,tree,trichome,trunk,tube,uniseriate,vein,way,white,young	0-0.25,0.1-0.5,0.5-1,0.8-1,1-1.5,1.5-2,2-2.5,2.5-11,2.5-3,3-4,3.5-17,5-17,7-10,9-35,acute,anthesi,apex,attenuate,beneath,blade,bud,closely,decurrent,deflexed,deltoid,differing,difoliate,distal,eaf,edicel,eed,ellipsoid,equal,even,evenly,exserted,filament,flower,free,geminat,greyish-brow,individual,later,lateral,live,lobe,lon,long-styled,lower,main,major,margin,middle,minor,narowly,nflorescence,often,one,onto,overlappin,pair,papillo,planar,pore,poricidal,portion,prominent,quite,raised,rest,rounded,ruit,scar,short-styled,size,slightly,sometimes,soon,spaced,straight,tall,thick,third,ti,tip,tub,ud,unit,usually,variable,weight,widest,winged,within,woody,x,yellow,ympodial	abaxial,adaxial,alternate,arrangement,characteristic,colour,diameter,form,fruit,greyish-brown,growth,height,history,life,lobing,narrowly,seed,texture,type	.1,.5,/4,0.7-1,0.8-1.3,1-2,1.2-1.5,1.5-3,1.5-8,2-10,5-25-flowered,7-8,along,bark,base,berry,calyx,campanulate,capitate,cm,constriction,dark,densely,dia,dry,elliptic,erect,furcate,glabrate,glabrous,globose,golden,green,leaf,lemon-yellow,like,lobed,long,many,minutely,mm,obovate,occasionally,older,opposite,otherwise,ovoid-reniform,pale,papillose,pitted,puberulent,pubescent,reddish-brown,ripe,shaped,shrub,simple,slender,small,sparsely,specimen,stem,tan,tapering,tear-drop,time,tree,trichome,trunk,tube,uniseriate,vein,way,white,young	alternate,greyish-brown,narrowly
427	wfo-0001030918	success	223	145	86	106	117	39	81	5	-5,-9,.5,0-25,0-4,0.3-1.5,0.5-0.7,0.6-2.5,0.7-1.2,0.7-1.7,1,1-1.5,1-1.8-2.3,1.5-2.5-3.2,1.5-5.5-6,1/2-2/3,2-2.5,2-25-40,2-8,2.8-3,3-4,abaxially,acute,anther,apex,apically,articulated,bark,base,berry,calyx,cell,chartaceous,cm,cuneate,curved,dark,diameter,drying,dull,elliptic,erect,evenly,filament,flattened-reniform,fruit,fruiting,glabrous,green,green-brown,lateral,leaf,length,lobe,lobed,lobing,long,lower,margin,maturity,mauve,midpoint,mm,moderately,narrow-deltate,obtuse,orange,orange-brown,outline,pair,pedicel,peduncle,per,petiole,pit,poricidal,prickle,prickly,primary,purple,raised,ray,red,red-brown,seed,shrub,simple,slender,small,smooth,sometimes,spherical,stellate-pubescent,stem,style,surface,tapering,terminal,tip,tube,vein,way,weakly,wide,yellow,young	-4,.7,0-10,0-20,0-6,0.1,0.1-0.25,0.2-0.4,0.25-0.45,0.5-2,0.5-2.5-4.5,0.6,1-2,1-4,1.5-2,1/3,1/3-1/2,1/3-1/2-3/4,1/4-1/3,2-10,2-3,2-4,2-7,2/,3-15,3-6.5,3-7,3.5-6,4-7,5-7,5-8,5-merous,5.5-7,6-8,7-10-12,abaxial,acicular,adaxial,alyx,ame,apar,apart,apparently,blade,branched,brow,c.,caudat,connivent,deltate,densely,difoliate,discolorous,distance,eaf,elongated,elongating,equal,extending,faint,flattened,flower,free,geminat,glabrescent,infructescence,longer,mature,midvein,mixture,nflorescence,oblong,occasionally,older,one,open,orolla,oung,pale,pendulous,perfec,pericarp,perpendicular,porrect,portion,prickl,pubescent,reduced,reflexed,ruit,scandent,scar,secondary,sessile,side,somewhat,spaced,sparsely,spreading,stalk,stalked,stellate,straight,strongly,tamen,terete,tertiary,time,trichome,unit,upper,usually,vary,venation,visible,woody,ympodial	2/3,appearance,arrangement,border,branch,brown,bud,caudate,characteristic,colour,corolla,corrugation,distal,exertion,form,giving,glabrousnes,growth,height,history,inflorescence,interjected,leaflet,life,na,new,number,ovary,perennial,plant,pseudostipule,shape,size,stigma,texture,thicknes,type,variation,width	-5,-9,.5,0-25,0-4,0.3-1.5,0.5-0.7,0.6-2.5,0.7-1.2,0.7-1.7,1,1-1.5,1-1.8-2.3,1.5-2.5-3.2,1.5-5.5-6,1/2-2/3,2-2.5,2-25-40,2-8,2.8-3,3-4,abaxially,acute,apically,articulated,base,berry,cell,chartaceous,cm,cuneate,curved,dark,diameter,dull,elliptic,erect,evenly,flattened-reniform,glabrous,green,green-brown,lateral,lobed,long,lower,maturity,mauve,mm,moderately,narrow-deltate,obtuse,orange,orange-brown,outline,pair,per,pit,poricidal,prickle,prickly,purple,raised,red,red-brown,shrub,simple,slender,small,smooth,sometimes,spherical,stellate-pubescent,tapering,terminal,tip,way,weakly,wide,yellow,young	2/3,brown,caudate,na,perennial
428	wfo-0001030943	success	167	120	79	93	74	27	77	2	.5,0,0.5-1,1-1.2,1-1.5,1.1,1.5-2,1.8-2.2,1/2,12-15,2-6,3,3-4,3/4,4-4.5,7-13.5,7-8,absent,acuminate,acute,anther,apex,apical,bark,basal,base,becoming,berry,bi-lobed,black,branch,calyx,cm,conical,corolla,dendritic,densely,diameter,drying,echinoid,elliptic,exserted,filament,flattened,fruiting,glabrous,globose,golden,golden-yellow,growth,im,lateral,leaf,lenticular,minute,minutely,mm,narrowly,ovary,overtopping,pair,pale,pedicel,per,petiole,pitted,plurifoliate,poricidal,pubescent,purplish-black,reddish-brown,secondary,shoot,shrub,small,stem,stigma,strongly,style,surface,tapering,terminal,tip,tree,tree-like,trichome,tube,vein,violet,way,x,yellow,yellowish-white	0.5-3,10-25,4-5,4-6,8-10,abaxial,abaxially,adaxial,adaxially,age,along,anthesi,belo,branching,cupulate,dark,decurrent,deflexed,denser,eaf,edicel,eed,elongate,erect,ew,fide,flower,free,glabrat,horizontal,inserted,large,lobe,lobed,lon,long,lower,m.,main,monochasia,nflorescence,nodding,often,older,outline,papillo,pearce,pericarp,planar,pore,portion,raised,ruit,scar,scattered,showy,sleeve,slightly,slit-like,somewhat,sparsely,stamen,tall,thin,time,triangular,tub,ud,unit,upper,wide,woody,ympodial,young	arrangement,bud,characteristic,colour,exertion,form,fruit,glabrousnes,height,history,inflorescence,length,life,lobing,margin,monochasial,na,new,number,peduncle,plant,primary,seed,shape,size,texture,type	.5,0,0.5-1,1-1.2,1-1.5,1.1,1.5-2,1.8-2.2,1/2,12-15,2-6,3,3-4,3/4,4-4.5,7-13.5,7-8,absent,acuminate,acute,apex,apical,basal,base,becoming,berry,bi-lobed,black,calyx,cm,conical,dendritic,densely,diameter,echinoid,elliptic,exserted,flattened,glabrous,globose,golden,golden-yellow,im,lateral,lenticular,minute,minutely,mm,narrowly,overtopping,pair,pale,per,pitted,plurifoliate,poricidal,pubescent,purplish-black,reddish-brown,secondary,shoot,shrub,small,strongly,tapering,terminal,tip,tree,tree-like,trichome,tube,vein,violet,way,x,yellow,yellowish-white	monochasial,na
429	wfo-0001030959	success	164	91	59	71	93	20	56	3	.8,/5,0.5-1.5,0.7-1.2,1-10,1-7,1.2-1.8,10-15,2.5-4.5,2.5-5,4-6,5-6,5-9,9-12,almost,anther,apart,apex,apically,articulated,bark,base,branched,brown,cm,color,cuneate,deltate,diameter,elliptic,erect,filament,fresh,glabrous,glandular,hair,inflorescence,known,lateral,leaf,length,lobed,long,long-acuminate,margin,minute,mm,pedicel,peduncle,perpendicular,petiole,poricidal,prickle,scar,shrub,spaced,stellate,stem,straight,straw,style,subentire,surface,tapering,tip,toward,tube,unarmed,way,wide,yellow	.05,.2,0.5,1-2,1.5-2,1.5-3.5,1/5-1/10,2-4,2.5-4,4-8,5-merous,6-8,abaxially,alyx,ame,apar,apparently,armed,blade,brown-green,c.,concolorous,connivent,curved,densely,difoliate,distributed,drying,eaf,eed,equal,evenly,flower,free,geminat,gently,glabrescent,glabrou,green-brow,know,less,like,lobe,long-acuminat,longer,lower,membranous,midpoint,narrow-deltate,nflorescence,numerous,older,one,open,orolla,oung,pair,part,perfec,porrect,portion,present,prickl,prickly,primary,prominent,ray,ruit,scrambling,secondary,sessile,several,short,side,simple,slender,sparsely,spreading,stellate-pubescent,tamen,terete,tertiary,time,trichome,unit,usually,vary,vein,venation,visible,whole,ympodial,youngest	0.2,arrangement,calyx,characteristic,colour,corolla,form,fruit,green-brown,growth,height,na,ovary,plant,seed,shape,size,texture,type,width	.8,/5,0.5-1.5,0.7-1.2,1-10,1-7,1.2-1.8,10-15,2.5-4.5,2.5-5,4-6,5-6,5-9,9-12,almost,apart,apex,apically,articulated,base,branched,brown,cm,color,cuneate,deltate,elliptic,erect,fresh,glabrous,glandular,hair,known,lateral,lobed,long,long-acuminate,minute,mm,perpendicular,poricidal,shrub,spaced,stellate,stem,straight,straw,subentire,surface,tapering,tip,toward,unarmed,way,wide,yellow	0.2,green-brown,na
430	wfo-0001030982	success	215	143	106	127	88	16	106	0	-2-2.5,.1,.5,0.05,0.05-0.5,0.2-3,0.5,0.5-0.9,0.5-1,1-1.5,1.5,1.5-2,2/3,3-8,6-8,abaxially,acuminate,acute,adaxially,angular,anther,apex,base,berry,broadly,brown,brownish,bud,caducous,calyx,capitate,channelled,chartaceous,ciliate,cm,conic,conical,corolla,cuneate,dark,diameter,dry,drying,ellipsoid,elliptic,enlarged,entire,exerted,external,filament,flattened-reniform,flower,form,fresh,fruit,fruiting,glabrescent,glabrous,globose,golden-green,green,growth,inconspicuously,larger,later,leaf,less,long,margin,material,maturity,minutely,mm,mostly,near,new,oblique,obovate,occasionally,olive,opposite,ovary,ovate,pale,papillate,papillose,pedicel,peduncle,petiole,pitted,plant,poricidal,puberulent,pubescent,reddish,reflexed,revolute,rhizomatous,sagittate,seed,shoot,simple,sinuate,size,slightly,somewhat,sparsely,stem,stigma,stripe,strongly,style,subshrub,surface,tip,transverse,trichome,tube,uniseriate,vegetative,vein,way,weakly,white,x,yellowish,young	.2,0.1,0.1-0.15,0.3-2,0.5-3,1,1-8,1.5-3,3-21,4-12,4-5,age,anisophyllous,anthesi,ape,appressed,ba,beneath,central,closely,cream,cucullate,curved,deflexed,deltate,differing,difoliate,distall,distally,distichou,eaf,edicel,eed,extension,fleshy,foliage,free,geminate,glandular,glandular-papillose,greenish,hilum,impressed,internal,isostylous,lengthening,like,live,lobe,lobed,lower,major,materia,midvein,minor,nflorescence,often,one,overlappin,packed,pair,papillae,papillat,planar,pore,portion,primary,projection,prominent,prominently,rest,ruit,scar,separated,sigmoidally,situated,slit,stamen,straight,testa,tetramerous,tightly,time,tub,ud,unit,veined,ympodial	abaxial,adaxial,arrangement,characteristic,colour,exertion,glabrousnes,height,history,inflorescence,length,life,lobing,shape,texture,type	-2-2.5,.1,.5,0.05,0.05-0.5,0.2-3,0.5,0.5-0.9,0.5-1,1-1.5,1.5,1.5-2,2/3,3-8,6-8,abaxially,acuminate,acute,adaxially,angular,apex,base,berry,broadly,brown,brownish,caducous,calyx,capitate,channelled,chartaceous,ciliate,cm,conic,conical,cuneate,dark,dry,drying,ellipsoid,elliptic,enlarged,entire,exerted,external,flattened-reniform,flower,fresh,glabrescent,glabrous,globose,golden-green,green,inconspicuously,larger,later,leaf,less,long,material,maturity,minutely,mm,mostly,near,oblique,obovate,occasionally,olive,opposite,ovate,pale,papillate,papillose,pitted,poricidal,puberulent,pubescent,reddish,reflexed,revolute,rhizomatous,sagittate,shoot,simple,sinuate,slightly,somewhat,sparsely,stripe,strongly,subshrub,surface,tip,transverse,trichome,tube,uniseriate,vegetative,vein,way,weakly,white,x,yellowish,young	
431	wfo-0001030989	success	177	118	83	97	80	21	79	4	.5,0.5-1,1-1.5,1-10,12-15,15-27.5,2-3.5,3-4,3-5.5,3-7.5,4-5,4-8,5,5.5-7.9,6-13,6-6.5,9-10,abaxially,adaxially,anther,apart,berry,blade,brownish,cell,chartaceous,ciliate,cm,condition,conical,connivent,corolla,covering,densely,diameter,distal,drying,end,filament,flower,forked,fresh,fruit,generally,glabrous,green,green-white,greenish,hair,hair-like,half,herb,homostylous,interjected,lanceolate,lateral,leaf,leaflet,light,like,long,make,margin,minute,mm,mucilaginous,occurring,odd-pinnate,ovoid,pedicel,peduncle,petiole,plant,pubescent,ripe,seed,semierect,singly,size,sparsely,stem,stigma,style,terminal,testal,thick,throughout,tuber,typically,unwinged,violet,wall,wet,whitish,wide,x,yellow	1-2,3-20,4-7,5-merou,acuminate,ag,alyx,apex,apparently,articulated,axe,axillary,base,bud,capitat,decreasing,digestion,dorsally,eaf,edge,eed,enzyme,erec,especially,flat,folded,geminat,glabrou,gradually,honeycomb-shaped,larger,lengthening,living,lobe,lower,nflorescence,obtuse,orbicular,orolla,ovate,ovate-lanceolate,pair,pale,perfect,petiolule,plurifoliate,pore,poricidal,present,proximal,pubescen,ray,removed,rotate,ruit,secondary,seudostipule,slit,spaced,specimen,ste,stolo,subequal,subsessile,subtending,symmetrical,tall,tamen,tem,thir,tip,toward,tri-,triangular,tube,unit,usually,vary,wider,ympodial	5-merous,arrangement,calyx,capitate,colour,erect,form,growth,height,history,inflorescence,length,life,occurrence,ovary,pseudostipule,shape,spacing,stolon,surface,texture	.5,0.5-1,1-1.5,1-10,12-15,15-27.5,2-3.5,3-4,3-5.5,3-7.5,4-5,4-8,5,5.5-7.9,6-13,6-6.5,9-10,abaxially,adaxially,apart,berry,brownish,cell,chartaceous,ciliate,cm,condition,conical,connivent,covering,densely,distal,drying,end,forked,fresh,generally,glabrous,green,green-white,greenish,hair,hair-like,half,herb,homostylous,lanceolate,lateral,light,like,long,make,margin,minute,mm,mucilaginous,occurring,odd-pinnate,ovoid,plant,pubescent,ripe,seed,semierect,singly,sparsely,stem,testal,thick,throughout,typically,unwinged,violet,wall,wet,whitish,wide,x,yellow	5-merous,capitate,erect,stolon
432	wfo-0001030991	success	203	120	85	99	104	21	85	0	.5,0.5,0.5-0.7,0.5-1,0.5-1.5,0.7-1.2,1-1.5,1-1.6,1-2.2,1-2.5,3-5-lobed,9-11,absent,acuminate,acute,along,angled,anther,anthesi,apex,apparently,appressed,ascending,attenuate,base,berry,brown,calyx,capitate,cm,corolla,densely,diameter,ellipsoid,ellipsoidal,elliptic,elongate,entire,exerted,filament,filiform,flattened,fruiting,furcate,fusiform,glabrous,globose,grey,growth,herb,inflorescence,lanceolate,lateral,leaf,leaf-opposed,like,lobed,margin,minutely,mm,narrowly,nearly,new,occasionally,pedicel,peduncle,petiole,pinnatifid,pitted,pubescent,red,reniform,rest,ripe,scattered,short,shrub,simple,slightly,small,sparsely,stellate,stem,stigma,strongly,style,suffrutescent,surface,terminal,trichome,tube,uniseriate,variably,vein,violet,white,winged,yellowish,young	0,0.1,0.2,0.2-0.7,0.3-0.4,0.5-3.5,0.6-0.8,1-7,1.5,10-20,2-plurifoliat,2.5-10,2.5-3,2/3,3-5-5.5,4-10,5-merou,<,abaxially,adaxiall,adaxially,ag,alyx,arising,ark,articulated,basal,bulbous,cell,color,conical,connivent,different,distally,drying,eaf,eed,enlarged,eye,flower,free,frui,glabrescen,ilament,incised,leave,lengthening,less,lobe,long-triangular,loosely,lower,midrib,minute,nflorescence,nodding,often,older,orolla,outline,packed,pair,papillo,part,particularly,pendant,per,perfect,pericarp,platfor,pointing,pore,poricidal,portion,primary,pseudoumbel,rectangular,reflexed,rootstoc,ruit,scar,shallowly,shiny,sleeve,slit,somewhat,spreading,tangled,tem,testal,thin,tightly,tip,twinin,ud,uniformly,unit,upper,vary,weak,weight,woody,x,ympodial	arrangement,bark,bud,characteristic,colour,exertion,form,fruit,glabrousnes,height,history,length,life,lobing,ovary,plant,seed,shape,size,texture,type	.5,0.5,0.5-0.7,0.5-1,0.5-1.5,0.7-1.2,1-1.5,1-1.6,1-2.2,1-2.5,3-5-lobed,9-11,absent,acuminate,acute,along,angled,anthesi,apparently,appressed,ascending,attenuate,base,berry,brown,calyx,capitate,cm,densely,diameter,ellipsoid,ellipsoidal,elliptic,elongate,entire,exerted,filiform,flattened,furcate,fusiform,glabrous,globose,grey,herb,inflorescence,lanceolate,lateral,leaf-opposed,like,lobed,minutely,mm,narrowly,nearly,occasionally,pinnatifid,pitted,pubescent,red,reniform,rest,ripe,scattered,short,shrub,simple,slightly,small,sparsely,stellate,stem,strongly,suffrutescent,surface,terminal,trichome,tube,uniseriate,variably,vein,violet,white,winged,yellowish,young	
433	wfo-0001031005	success	231	152	120	135	96	17	119	1	.5,/3-1/2,0.1,0.8,0.9,1,1-1.5,1-2,1-2.5,1-3,10,2-3.2,2.3-3,2.5,2.5-4,3-10,3-4,3-6.5,5,5-7,5-8,5Â°,6-12,abaxially,accrescent,acuminate,acute,adaxially,almost,along,anther,anthesi,apex,apically,attenuate,bark,base,berry,black,blue,brachyblast,branch,branched,branching,brown,calyx,capitate,chartaceous,clustered,cm,conical,corolla,cupular,dendritic,denser,developing,diameter,dilated,drying,elliptic,elongated,evenly,extending,eye,fine,flat,flattened,flexuous,flower,form,forming,fruit,fruiting,glabrous,greenish,increasing,lateral,leaf,length,liana,like,lobe,long,longitudinally,loop,main,membranous,midvein,mm,naked,network,oblong,obovate,occasional,occasionally,older,orange-brown,ovoid,pair,pedicel,peduncle,petiole,primary,prominent,pubescent,purple,rachi,raised,ray,ridged,short,side,slender,sometimes,somewhat,spread,spreading,stem,stigma,strongly,style,terete,terminal,tertiary,thick-chartaceous,tip,toward,trichome,unarmed,usually,vein,venation,visible,white,x	.4,0-0.5,0.3-0.5,0.5-1.5,1.5-2.5,1.5-4,4-6,abaxial,age,alyx,apar,apparently,articulated,clearly,clum,common,concolorous,curved,dark,datum,deeply,delineated,deltoid,dendritic-pubescent,density,detaching,discolorous,divided,domatia,eaf,ellipsoi,entire,equal,fertilisation,filament,free,immature,inside,junction,known,leave,lengthening,linear,lobed,lower,m.,margin,minute,much,nflorescence,nther,obscure,often,onl,orolla,ou,outside,ovate,pendulous,perfec,pericarp,plurifoliat,pointed,pore,poricidal,portion,protruding,region,rest,ruit,scar,secondary,seed,simple,smaller,smoot,smooth,soon,sparsely,standing,stump,surface,surrounding,tangling,tearing,thin,tube,ud,uneven,unit,vary,weakly,well-developed,wide,ympodial,young	adaxial,arrangement,bud,characteristic,colour,ellipsoid,exertion,growth,history,inflorescence,life,lobing,ovary,shape,size,texture,type	.5,/3-1/2,0.1,0.8,0.9,1,1-1.5,1-2,1-2.5,1-3,10,2-3.2,2.3-3,2.5,2.5-4,3-10,3-4,3-6.5,5,5-7,5-8,5Â°,6-12,abaxially,accrescent,acuminate,acute,adaxially,almost,along,anthesi,apex,apically,attenuate,base,berry,black,blue,brachyblast,branch,branched,branching,brown,capitate,chartaceous,clustered,cm,conical,corolla,cupular,dendritic,denser,developing,dilated,drying,elliptic,elongated,evenly,extending,eye,fine,flat,flattened,flexuous,flower,forming,fruit,glabrous,greenish,increasing,lateral,length,liana,like,lobe,long,longitudinally,loop,membranous,midvein,mm,naked,network,oblong,obovate,occasional,occasionally,older,orange-brown,ovoid,pair,prominent,pubescent,purple,rachi,raised,ray,ridged,short,side,slender,sometimes,somewhat,spread,spreading,stem,strongly,terete,terminal,thick-chartaceous,tip,toward,trichome,unarmed,usually,vein,visible,white,x	ellipsoid
434	wfo-0001031007	success	205	120	82	98	107	22	82	0	0.2,0.75-1.5,1,1-1.5,1-3.5,1.2-1.5,1.6-2,1.9-3,15,3-4,4-6,5.5-6,6,7-10,<,acute,alfway,almost,along,anther,anthesi,apex,base,becoming,berry,bifid,black,branched,broad,brown,c.,calyx,capitate,chartaceous,cm,completely,connivent,corolla,cuneate,dendritic,diameter,dull,ellipsoid,elliptic,entire,exserted,extending,filament,flattened-reniform,fleshy,fruit,fruiting,glabrous,globose,growth,inflorescence,lamina,lilac,long,loose,loosely,many,margin,matte,minutely,mm,narrowly,new,occasionally,outline,pedicel,peduncle,per,petiole,pitted,pubescent,reddish,revolute,sagittate,shiny,shrub,simple,slender,sparsely,stem,stigma,strongly,style,surface,tangled,terminal,time,trichome,tube,usually,vein,vine,x	.5,0.5,0.5-1,0.5-10,1-1.2,1.3-2.5-5,1.5-2,1/3,11-14,2.5-5-12,4-7,4.5-5,5,5-merou,50-100,8-10,abaxiall,abruptly,ag,alyx,apar,apparently,ark,articulated,beginning,branching,broadly,campanulate,cell,clustered,cup-shaped,dark,deltate,densely,dilated,drying,eaf,eed,flower,free,geminat,glabrescen,glabrou,herbarium,ilament,impressed,intramarginal,irregularly,junction,lax,leaving,lengthening,lobe,lobed,looping,lower,m.,markedly,midvein,multi-celled,narrowing,near,nflorescence,nodding,often,older,orolla,pale,papillat,papillate,peg,perfect,pericarp,planar,plurifoliate,pore,poricidal,portion,primary,prominent,rat,round-rectangular,ruit,scar,sleeve,slightly,slit,spaced,specimen,splitting,spreading,stellate,stellate-pentagonal,stout,testal,thin,tiny,tip,twining,ud,unit,upper,vary,way,woody,yellow,ympodial	abaxial,adaxial,arrangement,bark,bud,characteristic,colour,exertion,form,glabrousnes,height,leaf,length,lobing,number,ovary,plant,seed,shape,size,texture,type	0.2,0.75-1.5,1,1-1.5,1-3.5,1.2-1.5,1.6-2,1.9-3,15,3-4,4-6,5.5-6,6,7-10,<,acute,alfway,almost,along,anthesi,apex,base,becoming,berry,bifid,black,branched,broad,brown,c.,calyx,capitate,chartaceous,cm,completely,connivent,cuneate,dendritic,diameter,dull,ellipsoid,elliptic,entire,exserted,extending,flattened-reniform,fleshy,glabrous,globose,lamina,lilac,long,loose,loosely,many,matte,minutely,mm,narrowly,occasionally,outline,per,pitted,pubescent,reddish,revolute,sagittate,shiny,shrub,simple,slender,sparsely,strongly,tangled,terminal,time,trichome,tube,usually,vein,vine,x	
435	wfo-0001031007	success	204	124	84	102	102	22	84	0	0.2,0.75-1.5,1,1-1.5,1-3.5,1.2-1.5,1.6-2,1.9-3,15,3-4,4-6,5.5-6,6,7-10,<,acute,adaxial,alfway,almost,along,anther,anthesi,apex,bark,base,becoming,berry,bifid,black,branched,broad,brown,c.,calyx,capitate,chartaceous,cm,completely,corolla,cuneate,dendritic,diameter,ellipsoid,elliptic,entire,exserted,extending,filament,flattened,fleshy,fruit,fruiting,glabrous,globose,growth,inflorescence,lamina,lax,lilac,lobed,long,loose,many,margin,minutely,mm,narrowly,new,occasionally,pedicel,peduncle,per,petiole,pitted,poricidal,pubescent,reddish,reniform,revolute,sagittate,shiny,shrub,simple,slender,sparsely,stem,stigma,strongly,style,surface,tall,tangled,terminal,time,tip,trichome,tube,usually,vein,vine,wide,woody	.5,0.5,0.5-1,0.5-10,1-1.2,1.3-2.5-5,1.5-2,1/3,11-14,2.5-5-12,4-7,4.5-5,5,5-merou,50-100,8-10,abaxially,abruptly,ag,alyx,apar,apparently,articulated,beginning,branching,broadly,campanulate,cell,clustered,cup-shaped,dark,deltate,densely,dilated,drying,dull,eaf,eed,flower,free,glabrescen,glabrou,herbarium,ilament,impressed,intramarginal,irregularly,junction,leaving,lengthening,lobe,looping,lower,m.,markedly,matte,midvein,multi-celled,narrowing,near,nflorescence,nodding,often,older,orolla,outline,pale,papillat,papillate,peg,perfect,pericarp,planar,plurifoliat,pore,portion,primary,prominent,rat,round-rectangular,ruit,scar,sleeve,slightly,slit,spaced,specimen,splitting,spreading,stellate,stellate-rotate,stout,testal,thin,tiny,twinin,ud,unit,upper,vary,way,ympodial	abaxial,arrangement,bud,characteristic,colour,exertion,form,glabrousnes,height,history,leaf,length,life,lobing,number,ovary,plant,seed,shape,size,texture,type	0.2,0.75-1.5,1,1-1.5,1-3.5,1.2-1.5,1.6-2,1.9-3,15,3-4,4-6,5.5-6,6,7-10,<,acute,alfway,almost,along,anthesi,apex,base,becoming,berry,bifid,black,branched,broad,brown,c.,calyx,capitate,chartaceous,cm,completely,cuneate,dendritic,diameter,ellipsoid,elliptic,entire,exserted,extending,flattened,fleshy,glabrous,globose,lamina,lax,lilac,lobed,long,loose,many,minutely,mm,narrowly,occasionally,per,pitted,poricidal,pubescent,reddish,reniform,revolute,sagittate,shiny,shrub,simple,slender,sparsely,strongly,tall,tangled,terminal,time,tip,trichome,tube,usually,vein,vine,wide,woody	
436	wfo-0001031036	success	150	110	77	84	66	26	73	4	.25,0.8-1,0.8-1.2,1-1.3,1-2.5,1.2-1.5,1.5-3,10-20-flowered,12-15,2-2.5,4.5-6.5,5-6,7-8,abaxially,acuminate,acute,adaxially,along,angle,anther,apex,base,becoming,berry,bi-lobed,brown,calyx,cm,corolla,crisped,dark,decurrent,dia,dry,ellipsoid,elliptic,exserted,filiform,flattened-reniform,fruiting,glabrous,globose,green,greenish-white,lateral,leaf,lobed,long,main,margin,material,minutely,mm,nearly,oblique,onto,ovary,pair,pedicel,petiole,pitted,poricidal,sagittate,shiny,shrub,simple,size,slightly,soon,stem,stigma,strongly,style,surface,tapering,thickened,tip,trichome,tube,uniseriate,vein,white,winged,x	.2,.5,0.5-1,2.2-3.7,3-4,3-5,3.5-5.5,anthesi,arising,axil,ba,broadly,closely,conical,deflexed,differing,difoliate,drying,eaf,edicel,eed,enlarged,erect,filament,fleshy,free,fresh,geminat,knob-like,lamina,lobe,lon,lower,major,middle,minor,nflorescence,older,opposite,overlappin,papillo,papillose,perhaps,planar,pointed,pore,portion,rounded,ruit,scar,shaped,short,sinus,spaced,spathulate,tall,tear-drop,tub,ud,unit,usually,widest,woody,yellowish,ympodial,young	abaxial,alternate,arrangement,bud,characteristic,colour,diameter,exertion,form,fruit,growth,hair,height,history,inflorescence,length,life,lobing,none,plant,prickle,primary,seed,shape,texture,type	.25,0.8-1,0.8-1.2,1-1.3,1-2.5,1.2-1.5,1.5-3,10-20-flowered,12-15,4.5-6.5,5-6,7-8,abaxially,acuminate,acute,adaxially,along,angle,base,becoming,berry,bi-lobed,brown,calyx,cm,crisped,dark,decurrent,dia,dry,ellipsoid,elliptic,exserted,filiform,flattened-reniform,glabrous,globose,green,greenish-white,lateral,leaf,lobed,long,main,margin,material,minutely,mm,nearly,oblique,onto,pair,petiole,pitted,poricidal,sagittate,shiny,shrub,simple,slightly,soon,stem,strongly,tapering,thickened,tip,trichome,tube,uniseriate,vein,white,winged,x	-2.5,alternate,di,none
437	wfo-0001031064	success	179	100	60	78	101	22	58	2	.0-2.5,.5,0,0.5-0.7,1-1.2,1-2,1-3,1.2,1.7-4.2,10-12,10-12.5,10-17,3-5.5,3-7,3.5-4,5-10.5,5-6,6-16,7-16,anther,basal,base,berry,bright,cm,completely,conical,corolla,dark,densely,diameter,elongate,fleshy,fruit,fruiting,glabrous,globose,green,half,inflorescence,lateral,leaf,leaflet,lobed,lower,minutely,mm,nearly,node,obovate,ovary,ovate,ovoid-reniform,pair,pedicel,per,petiole,pinnate,poricidal,pubescent,purple,rachi,scattered,short-pubescent,shrub,somewhat,sparsely,stem,stigma,style,terminal,tip,translucent,trichome,uniseriate,white,winged,x	.05,.5-1,0-15,0.5,0.5-0.8,1,1.5-2,2,2.5-3,3,4-5-celled,8-10-celled,abaxially,acroscopic,acuminate,adaxially,along,anthesi,anticlinal,apex,arising,attenuate,axil,bearing,blade,broader,calyx,cell,clavat,commentary,conspicuous,deltate,denser,distal,dr.,eaf,edicel,eed,epidermal,erec,exserted,filament,flower,free,highly,irregular,irregularly,lamina,leave,lenticel,lightly,like,lobe,lon,long,lost,margin,minute,narrower,near,nflorescence,nodding,occasionally,often,open,papillate,petiolule,planar,portion,projection,prominent,pubescen,rugose,ruit,scar,see,side,simple,single,sinuous,sinus,slender,smaller,splitting,strongly,surface,swollen,tal,tem,thickening,time,tub,tube,ud,unifoliat,unit,usually,vein,wand-like,without,ympodial	abaxial,adaxial,arrangement,bud,clavate,colour,form,glabrousnes,growth,height,history,length,life,lobing,number,perennial,plant,seed,shape,size,texture,type	.0-2.5,.5,0,0.5-0.7,1-1.2,1-2,1-3,1.2,1.7-4.2,10-12,10-12.5,10-17,3-5.5,3-7,3.5-4,5-10.5,5-6,6-16,7-16,base,berry,bright,cm,completely,conical,dark,densely,elongate,fleshy,glabrous,globose,green,half,lobed,lower,minutely,mm,nearly,obovate,ovate,ovoid-reniform,pair,pinnate,poricidal,pubescent,purple,scattered,short-pubescent,shrub,somewhat,sparsely,tip,translucent,trichome,uniseriate,white,winged,x	clavate,perennial
438	wfo-0001031071	success	186	98	61	79	107	19	60	1	0-10,0.2-0.8,1-1.5,1-2,1.5-2.2,2-8,2.1-3,2.4-3.4,3-10,3.8-5.4,4-6,5-9.4,5.7-8.8,6-8,7-16.5,7-8,8-28,anther,blade,blue,brownish,clavate,cm,color,condition,coriaceous,corolla,dark,deep,diameter,distal,drying,filament,forked,fresh,fruit,generally,glabrous,globose,green,green-white,greenish,half,herb,interjected,lanceolate,lateral,leaf,leaflet,lilac,long,medium,mm,moniliform,mottled,mucilaginous,odd-pinnate,ovate,ovoid,pedicel,peduncle,pentagonal,petiole,plant,purple,rotate,seed,size,spot,star,stigma,style,terminal,throughout,tuber,wet,white,whitish,x	0.4-2,1-3,1-7,2-3,2-5,3-5,3-6,4-25,5-merou,abaxiall,abaxially,acumen,acute,adaxially,ag,along,alyx,apart,apex,apparently,arranged,articulated,asymmetric,attenuate,axe,axillary,base,basiscopic,bead,berry,bud,capitat,cell,connivent,covering,decreasing,digestion,dorsally,eaf,edge,eed,elliptic,enzyme,erec,exceeding,flat,flower,folded,geminat,glabrou,hair-like,homostylous,honeycomb-shaped,lengthening,like,living,lobe,lower,make,middl,multiple,narrowly,necklace,nflorescence,orbicular,orolla,pair,perfect,petiolulate,plurifoliate,pore,poricidal,removed,ripe,round,ruit,sessile,seudostipule,short,side,slightly,slit,spaced,specimen,stamen,stolon,straight,subequal,subtending,tall,tamen,tem,testal,thick,tip,tissue,toward,tri-,tube,typically,unit,usually,vary,wall,winged,yellow,ympodial	abaxial,adaxial,arrangement,calyx,capitate,colour,form,growth,height,history,inflorescence,length,life,ovary,pseudostipule,shape,stem,surface,texture	0-10,0.2-0.8,1-1.5,1-2,1.5-2.2,2-8,2.1-3,2.4-3.4,3-10,3.8-5.4,4-6,5-9.4,5.7-8.8,6-8,7-16.5,7-8,8-28,blue,brownish,clavate,cm,color,condition,coriaceous,dark,deep,distal,drying,forked,fresh,generally,glabrous,globose,green,green-white,greenish,half,herb,lanceolate,lilac,long,medium,mm,moniliform,mottled,mucilaginous,odd-pinnate,ovate,ovoid,pentagonal,plant,purple,rotate,spot,star,throughout,wet,white,whitish,x	capitate
439	wfo-0001031097	success	174	90	55	69	105	21	54	1	0.45,1-4,1-4.5,1.6-5.5,1.8-2.5,1.8-2.6,13-30,2-3.3,2-4,3-5,3.5-6,3.7-8.4,4-6,5-11,5-12,5-9,8-11,9-21,abaxial,abaxially,adaxially,branched,calyx,cm,corolla,cyme,darker,deep,diameter,dichasial,dichasially,dotted,ebracteate,exceeding,filament,green,herbaceous,lateral,leaf,leaflet,light,lighter,long,margin,medium,mm,monochasial,mottled,mucilaginous,narrow,odd-pinnate,ovoid,pedicel,peduncle,perennial,petiole,plant,puberulent,pubescent,purple,seed,size,stamen,strigose,style,terminal,violet,violet-blue,wide	0.5,1,1-3,1.5,2-3,3-6-foliat,4-7,acumen,acuminate,acute,along,apex,apical,apically,articulate,base,cell,connate,covering,cuneate,decurrent,dehiscent,digestion,diminishing,distal,dorsally,eaf,edge,eed,elliptical,emoval,enzyme,flat,flower,folded,forked,frequently,generally,globo,gree,green-white,hair-like,half,highly,honeycomb,interjected,interpetalar,introrse,living,lobe,lon,lower,lunat,make,maturing,nflorescence,noticeably,nther,oblique,obovate,often,orolla,ovate,pair,pattern,pentagonal,perfect,petal,petiolulate,petiolule,plan,poricidally,proximal,rachi,rapidly,rarely,reveal,rotate,ruit,sessile,seudostipule,short,side,slit,sometimes,specimen,stigma,straight,tal,tem,testal,thick,throughout,tissu,toward,tuber-bearing,typically,unit,vary,vbase,wall,without,yellow,ympodial,Â¼	adaxial,anther,arrangement,characteristic,colour,form,fruit,growth,height,history,inflorescence,length,life,ovary,pseudostipule,shape,stem,surface,texture,wet,width	0.45,1-4,1-4.5,1.6-5.5,1.8-2.5,1.8-2.6,13-30,2-3.3,2-4,3-5,3.5-6,3.7-8.4,4-6,5-11,5-12,5-9,8-11,9-21,abaxially,adaxially,branched,cm,cyme,darker,deep,dichasial,dichasially,dotted,ebracteate,exceeding,green,herbaceous,light,lighter,long,margin,medium,mm,monochasial,mottled,mucilaginous,narrow,odd-pinnate,ovoid,perennial,puberulent,pubescent,purple,stamen,strigose,style,violet,violet-blue,wide	wet
440	wfo-0001031101	success	191	149	109	129	62	20	106	3	-5,-8,/2,/2-equal,0.05-0.2,0.1-0.2,0.1-0.3,0.3-0.5,0.5-0.8,0.5-3,0.6-0.8-1,0.7-0.8,0.8-1-2.3,1-2,1-2-5-8,1.3-2,1.3-2.5,1.4-1.7,1/4-1/2,10-30,2-2.8,2-6,2.5-3.8,2.5-4-10-16,3-15,3-8,4.5-9,5-6,6-10-20,8-15-30,abaxial,acuminate,adaxial,almost,ame,anther,apex,apical,apically,apparently,articulated,bark,base,berry,branched,bright,c.,calyx,cm,connivent,diameter,dull,elongating,entire,erect,evenly,filament,filiform,flattened-reniform,flower,fruiting,glabrescent,glabrous,glandular,green,hair,lateral,leaf,length,lobe,long,long-acute,margin,mature,maturity,mauve,midpoint,minute,mm,moderately,multangulate,narrow-deltate,near,obtuse,often,orange-brown,orange-red,ovate,pair,pale,pedicel,peduncle,petiole,poricidal,porrect,primary,ray,red,resembling,rounded,sessile,shrub,simple,sparsely,spherical,stalked,stellate-pubescent,stem,straight,style,surface,tapering,terete,terminal,tertiary,tip,trichome,tube,umbel,unarmed,variously,vein,venation,visible,way,white,wide,yellow,young	-20,1-3,1.5-3,1/3-1/2,2-4,2.5-3.5,3-10,3.5-4.5,4-5-merous,4-7,5-20-30,abaxially,alyx,apar,ba,blade,concolorous,deltate,difoliate,drying,eaf,eed,equal,free,frui,geminat,green-brown,herbaceous,infructescence,lobed,long-acuminat,longer,lower,membranous,nflorescence,older,one,open,orolla,oung,pendulous,per,perfec,pericarp,portion,red-brow,ruit,scandent,scar,smooth,spaced,spreading,stalk,stellate,stellate-pubescen,tamen,time,unarme,unit,vary,yellow-green,ympodial	arrangement,characteristic,colour,corolla,form,fruit,growth,height,inflorescence,lobing,long-acuminate,number,ovary,plant,red-brown,seed,shape,size,texture,type	-5,-8,/2,/2-equal,0.05-0.2,0.1-0.2,0.1-0.3,0.3-0.5,0.5-0.8,0.5-3,0.6-0.8-1,0.7-0.8,0.8-1-2.3,1-2,1-2-5-8,1.3-2,1.3-2.5,1.4-1.7,1/4-1/2,10-30,2-2.8,2-6,2.5-3.8,2.5-4-10-16,3-15,3-8,4.5-9,5-6,6-10-20,8-15-30,acuminate,almost,ame,apical,apically,apparently,articulated,base,berry,branched,bright,c.,cm,connivent,diameter,dull,elongating,entire,erect,evenly,filiform,flattened-reniform,glabrescent,glabrous,glandular,green,hair,lateral,length,long,long-acute,mature,maturity,mauve,minute,mm,moderately,multangulate,narrow-deltate,near,obtuse,often,orange-brown,orange-red,ovate,pair,pale,poricidal,porrect,ray,red,resembling,rounded,sessile,shrub,simple,sparsely,spherical,stalked,stellate-pubescent,straight,surface,tapering,terete,terminal,tip,trichome,umbel,unarmed,variously,visible,way,white,wide,yellow,young	fruit,long-acuminate,red-brown
441	wfo-0001031114	invalid_json	208	145	NA	114	94	31	NA	NA	.2,.5,0.5,0.5-1,0.7-1.5,0.8-1.2,1-10,1-2,1-7,10-15,2-17,2-3,2-4,2-7,2.5-3,2/3,25-50,3-10,3-4,3-5,4-10,4-5,4.5-6,6-7,abaxially,acuminate,acute,adaxially,anther,apex,base,becoming,berry,blade,branched,brown,calyx,chartaceous,cm,connivent,dark,deltate,densely,diameter,distal,elliptic-ovate,entire,erect,especially,filament,first,flattened,fleshy,flower,fruit,fruiting,glabrous,globose,green,hair,leaf,leaf-opposed,light,like,lobe,long,major,margin,minor,mm,multangulate,nodding,oblong,obtuse,outline,ovate,pedicel,peduncle,petiole,porrect,pubescent,purple,reniform,ripe,rounded,rugulose,shrub,side,simple,small,sparsely,stellate,stellate-pubescent,stem,stigma,strongly,style,subcoriaceous,subcuneate,surface,thickened,tip,toward,tree,triangular,truncate,tube,vein,white,white-pubescent,white-stellate,x,yellow,yellowish	.1,0-0.3,0.3-0.5,1-1.5,1-4.5,1-8,1.5-2.5,1.5-4,3-7,4-8,5-10,5-8,5-merou,7-15,absen,accrescent,adaxiall,ag,alyx,apart,apparently,articulated,axe,ba,capitat,covering,cylindrical,differentiated,directed,discolorous,distally,dried,eaf,echinoid,eed,equal,free,frui,geminate,highly,homostylous,impressed,interpetalar,introrsely,juic,lacking,large,long-stalked,longitudinal,lower,membanaceous,midpoint,nearly,nflorescence,often,one,opening,orolla,paired,part,perfect,pericarp,plurifoliate,pore,prominent,rachi,ray,ruit,sessile,short,short-,short-stalked,slightly,slit,somewhat,spaced,stalk,ste,straight,subcucullate,subtending,tall,tamen,tem,thin,time,tissue,unarme,unit,vary,whitish,wide,without,ympodial	arrangement,bark,branch,bud,capitate,characteristic,colour,corolla,corrugation,drying,exertion,form,glabrousnes,growth,height,inflorescence,length,lobing,na,new,number,ovary,per,plant,primary,seed,shape,size,texture,type,value	NA	NA
442	wfo-0001031116	success	191	138	99	116	75	22	97	2	.5,.8,/4,0-10,0.3-0.5,0.7-0.9,0.7-1,1-5,1/2,2-5,2.7-3.2,3.5-4,30-100,4-7,8-11,abaxial,abaxially,acuminate,adaxial,almost,anther,apex,apically,apparently,articulated,attenuate,bark,base,berry,branching,bristle,broad-deltate,calyx,caudate,cm,collapsed,connivent,densely,diameter,discolorous,drying,dull,elliptic,erect,evenly,filament,flattened-reniform,flower,fragile,fruit,fruiting,glabrescent,glabrous,glaucous-green,green,lateral,leaf,length,lobe,lobed,long,lower,margin,maturity,mauve,membranous,mm,moderately,multangulate,narrow-deltate,obovate,obtuse,often,orange-brown,orange-red,pedicel,peduncle,petiole,poricidal,primary,recurved,red-brown,reflexed,rounded,secondary,sessile,sharply,shortly,shrub,simple,slender,small,soft,sometimes,sparsely,spherical,stalked,stellate,stellate-pubescent,stem,straight,style,subentire,surface,tapering,tip,tree,trichome,tube,unarmed,upper,way,weakly,wide,yellow,young	.2,0,0.05-0.15,0.1,0.4-0.7,1,1/3-2/,1/6-1/4,10-14,15-25,30-50,4-10,5,5-15,5-merous,9-13,alyx,ame,apar,apart,arachnoid,blade,brow,c.,clearly,dirty-white,eaf,eed,elongated,elongating,epidermi,equal,flat,flexuous,free,hair,infructescence,less,longer,mature,midpoint,minute,nflorescence,obtu,older,one,open,orolla,oung,pair,per,perfec,pericarp,perpendicular,plurifoliat,portion,ray,ruit,scar,single,smooth,spaced,stalk,tamen,terete,tertiary,time,unarme,unit,vary,vein,venation,visible,woody,ympodial	1/3-2/3,arrangement,branch,brown,characteristic,colour,corolla,exertion,form,glabrousnes,growth,height,inflorescence,lobing,new,ovary,plant,seed,shape,size,texture,type	.5,.8,/4,0-10,0.3-0.5,0.7-0.9,0.7-1,1-5,1/2,2-5,2.7-3.2,3.5-4,30-100,4-7,8-11,abaxially,acuminate,almost,apically,apparently,articulated,attenuate,base,berry,branching,bristle,broad-deltate,caudate,cm,collapsed,connivent,densely,diameter,discolorous,drying,dull,elliptic,erect,evenly,flattened-reniform,flower,fragile,glabrescent,glabrous,glaucous-green,green,lateral,lobe,lobed,long,lower,maturity,mauve,membranous,mm,moderately,multangulate,narrow-deltate,obovate,obtuse,often,orange-brown,orange-red,poricidal,primary,recurved,red-brown,reflexed,rounded,secondary,sessile,sharply,shortly,shrub,simple,slender,small,soft,sometimes,sparsely,spherical,stalked,stellate,stellate-pubescent,straight,subentire,tapering,tip,tree,trichome,unarmed,upper,way,weakly,wide,yellow,young	1/3-2/3,brown
443	wfo-0001031128	success	208	110	75	89	119	21	73	2	/4,0.3-0.8,0.5-0.7,0.5-0.8,0.6-1,0.8-1.7,1-1.6,1.5-3,20-60-100,anther,apex,apparently,bark,base,berry,bristle,brown,calyx,cm,concolorous,connivent,cuneate,densely,diameter,drying,dull,elliptic,entire,erect,evenly,filament,flattened-reniform,fruit,fruiting,glabrescent,glabrous,glandular,green,hair,inflorescence,lateral,leaf,length,lobed,long-acuminate,margin,maturity,mauve,membranous,minute,mm,moderately,multangulate,near,orange-brown,pale,pedicel,peduncle,petiole,poricidal,purple-black,recurved,red,red-brown,sessile,shallowly,short-attenuate,shrub,simple,soft,spherical,stalked,stellate,stellate-pubescent,stem,style,surface,tapering,terminal,tip,trichome,unarmed,undulate,variously,way,white,yellow,yellow-green,young	0,0-10,0-30,0.05-0.2,0.05-0.25,0.2,0.2-0.4,0.5-1.5,0.5-5,1,1-2-5-6.5,1.2-2,1.5-3.5,1/,1/6-1/3,10-35,2-9.5,2.3-3-4-4.5,2.5-10,2.5-3.5,20-50,3-4,3.5-4.5,4-5-merous,4-7,5-10-20,5-15,5-19,5-30,8-12,8-23,abaxial,abaxially,acute,almost,alyx,apar,apart,ape,apically,articulated,blade,branched,branching,deltate,eaf,eed,elongated,elongating,equal,eye,filiform,flexuous,flower,free,gland,gra,infructescence,less,lobe,lon,long,long-acuminat,longer,lower,mature,midpoint,multangualte,naked,narrow-deltate,nflorescence,occasionally,often,older,one,open,orolla,oung,pair,per,perfect,pericarp,perpendicular,plurifoliat,portion,primary,ray,reduced,reflexed,ruit,scar,secondary,short-styled,side,single,smooth,spaced,spreading,stalk,staminate,straight,tamen,terete,tertiary,time,tube,unarme,unit,usually,vary,vein,venation,visible,weakly,whitish,wide,woody,yellow-brown,ympodial	1-6.5,arrangement,branch,characteristic,colour,corolla,exertion,form,glabrousnes,gray,growth,height,lobing,new,ovary,plant,seed,shape,size,texture,type	/4,0.3-0.8,0.5-0.7,0.5-0.8,0.6-1,0.8-1.7,1-1.6,1.5-3,20-60-100,apex,apparently,base,berry,bristle,brown,cm,concolorous,connivent,cuneate,densely,diameter,drying,dull,elliptic,entire,erect,evenly,flattened-reniform,glabrescent,glabrous,glandular,green,hair,lateral,lobed,long-acuminate,maturity,mauve,membranous,minute,mm,moderately,multangulate,near,orange-brown,pale,poricidal,purple-black,recurved,red,red-brown,sessile,shallowly,short-attenuate,shrub,simple,soft,spherical,stalked,stellate,stellate-pubescent,tapering,terminal,tip,trichome,unarmed,undulate,variously,way,white,yellow,yellow-green,young	1-6.5,gray
444	wfo-0001031135	success	187	157	101	106	81	51	99	2	0-2,0.7-2,1-1.5,1-10,1-2.5,1-3,1.5-2,1.5-3,10-20,2,2-2.5,2-23,2-3.5,2-4,2-5,2-5-9-pinnate,2.5-28,3-4,3.5-12,5-11,5-30,abaxially,acuminate,acute,adaxially,adpressed,also,apex,basal,base,basiscopically,beyond,calyx,cm,compound,cordate,cuneate,darker,decurrent,deflexed,deltate,densely,diameter,ellipsoidal,elliptic,entire,exserted,fading,flattened,flower,frequently,fruit,fusiform,green,hair,lateral,leaf,leaflet,light,lobe,lobed,long,longitudinal,margin,mm,moderately,oblique,oblong,obtuse,often,ovate,ovoid,pedicel,peduncle,peltiform,petiole,pilose,pink,pinnately,pinnatifid,puberulent,pubescent,purple,ripe,shrub,simple,sparsely,stamen,stigma,stripe,style,time,tip,tree,triangular,truncate,tube,unbranched,unlobed,upper,white,whitish,wide,x,yellow-green,yellowish	-7,0.5-2,1-3-10,1-4,1.5-9,2-3,3-5,4-5,4-foliat,7-15,absent,aggregate,along,apart,ape,articulated,axe,biglandula,blade,broad,campanulate,cell,chartaceous,color,connective,coriaceous,cylindrical,dilated,directed,distally,eaf,eed,eglandular-pubescent,ellipsoida,equal,especially,exceeding,glabrous,glandular-,interstitial,irregularly,laterally,leaving,lon,lower,midrib,narrowed,nflorescence,nther,obconical,occasionally,orolla,papillose,pedicellar,perfect,pilo,pore,present,rachi,radiu,remnant,ruit,shorter,slightly,small,smaller,spaced,stone,strongly,subcoriaceous,tal,tem,thecae,tomento,toward,ud,unit,unknow,vary,violet,ympodial	anther,appearance,arrangement,bark,biglandular,border,branch,bud,characteristic,colour,corolla,corrugation,distal,drying,exertion,filament,form,fruiting,giving,glabrousnes,growth,height,history,inflorescence,interjected,length,life,lobing,midpoint,na,new,number,ovary,per,plant,prickle,primary,pseudostipule,ray,seed,shape,size,stem,surface,terminal,texture,thicknes,type,variation,vein,width	0-2,0.7-2,1-1.5,1-10,1-2.5,1-3,1.5-2,1.5-3,10-20,2,2-2.5,2-23,2-3.5,2-4,2-5,2-5-9-pinnate,2.5-28,3-4,3.5-12,5-11,5-30,abaxially,acuminate,acute,adaxially,adpressed,also,apex,basal,base,basiscopically,beyond,cm,compound,cordate,cuneate,darker,decurrent,deflexed,deltate,densely,diameter,ellipsoidal,elliptic,entire,exserted,fading,flattened,flower,frequently,fruit,fusiform,green,hair,lateral,leaf,leaflet,light,lobe,lobed,long,longitudinal,mm,moderately,oblique,oblong,obtuse,often,ovate,ovoid,peltiform,pilose,pink,pinnately,pinnatifid,puberulent,pubescent,purple,ripe,shrub,simple,sparsely,stamen,stripe,style,time,tip,tree,triangular,truncate,unbranched,unlobed,upper,white,whitish,wide,x,yellow-green,yellowish	biglandular,na
445	wfo-0001031144	success	227	116	85	100	127	16	84	1	.5,0.8-1.4,1-4,1.1-2.5,2-3,2.5-3,2/3,25,3-7,4-4.5,6,7-10,acuminate,acute,adaxially,anther,anthesi,apex,articulated,asymmetric,base,berry,bright,broadly,brown,calyx,capitate,cm,commonly,connivent,cordate,corolla,diameter,ellipsoid,elliptic,entire,exserted,filament,flattened-reniform,form,fruiting,glabrous,globose,groove,growth,inflated,inflorescence,later,lateral,leaf,less,lobed,long,loosely,margin,minute,minutely,mm,new,oblique,occasionally,pale,pedicel,peduncle,petiole,pinnately,pinnatifid,pitted,pubescent,red,reddish,ripe,seed,shiny,simple,sleeve,slightly,small,sparsely,stem,stigma,strongly,style,surface,tan,terete,terminal,tiny,triangular,trichome,truncate,tube,uniseriate,usually,vine,violet,way,x,yellowish,Â½	.2,0.2,0.5,1-1.5,1-2-9-11,100,2,2-3.5-10-13,2-6,3-4.5,4,4-20,4-6,5,5-9,5-merou,<,ag,alyx,apart,apicula,apiculae,appearing,ark,around,away,axi,basal,basiscopically,blac,branch,branche,brow,cell,closer,corresponding,cupped,curved,densely,divaricate,drying,eaf,eed,elongate,elongating,extending,flattened,flower,four,free,geminat,ilament,irregularly,lamina,larger,leaflet,leaving,lengthening,like,lobe,longer,longest,lower,many,markedly,membranous,mere,near,nflorescence,number,often,older,one,open,orolla,outline,pair,papillo,peg,pendant,pentagonal,per,perfect,pericarp,plurifoliate,pore,poricidal,portion,primary,progress,quite,rim,ruit,scar,slit,smaller,sometimes,spaced,spreading,stellate-rotate,tangle,tem,testal,thin,third,tip,together,tuft,twinin,twining,two,ud,unequal,unit,upper,variable,vary,vein,wall,weight,white,widest,wing,wood,woody,yellow,ympodial	arrangement,bark,bud,characteristic,colour,exertion,fruit,glabrousnes,length,lobing,ovary,papillose,shape,size,texture,type	.5,0.8-1.4,1-4,1.1-2.5,2-3,2.5-3,2/3,25,3-7,4-4.5,6,7-10,acuminate,acute,adaxially,anthesi,apex,articulated,asymmetric,base,berry,bright,broadly,brown,calyx,capitate,cm,commonly,connivent,cordate,diameter,ellipsoid,elliptic,entire,exserted,flattened-reniform,form,glabrous,globose,groove,inflated,later,lateral,less,lobed,long,loosely,minute,minutely,mm,oblique,occasionally,pale,pinnately,pinnatifid,pitted,pubescent,red,reddish,ripe,shiny,simple,sleeve,slightly,small,sparsely,strongly,surface,tan,terete,terminal,tiny,triangular,trichome,truncate,tube,uniseriate,usually,vine,violet,way,x,yellowish,Â½	papillose
446	wfo-0001031152	success	232	154	114	127	105	27	111	3	-1.5,-10,.4,0.2-0.3,0.2-1.5,0.3-3,1-1.5,1-3,1-6,1.1-2.2,1.4-2.6,1/2-3/4,11,13-27,2.5-7.5,4-19,4-6,4-8,9-13,abaxially,acuminate,acute,adaxially,anther,anthesi,apart,apex,articulated,attenuate,basal,base,becoming,berry,blunt-tipped,branch,branched,brown,bud,bullate,calyx,closely,cm,conical,continued,corolla,decurrent,deltoid,densely,diameter,due,entire,exserted,filament,fleshy,flower,fruit,fruiting,glabrous,globose,granular-tomentose,greenish,growth,hair,honeycombed,lanceolate,lateral,lavender,leaf,length,lilac,long,long-,margin,midvein,mm,mostly,multangulate,narrowly,nearly,oblanceolate,oblong,obtuse,openly,orbicular,ovate,pale,pedicel,peduncle,persistently,petiole,porrect-stellate,probably,pubescent,rather,reddish,reniform,reticulate-punctate,ripe,scabrous,sessile,shrub,side,simple,slightly,soon,spaced,sparingly,stelliform,stem,stigma,strongly,style,suborbicular,surface,terete,terminal,thick-stalked,time,tree,tube,unarmed,variously,vein,violet,x,yellow,yellowish	-5.5,/100-1/16,0-100,0.3-1.3,1.1-3,1.2-1.8,1.3-4,1.5-3,1.5-3.5,1/2-2/3,2-5,2.7-3.7,2.7-4.5,2.7-6,2.8-4,3.7-7,4-7,5-6,6.5-10,8-20,accrescent,ag,along,apical-lateral,apparently,axe,axillary,ba,blade,blister,capitat,chartaceous,dehiscing,directed,eaf,earl,eed,evident,extend,few-rayed,free,glabrescen,green,high,inserted,introrse,lackin,large,less,lobe,lobed,longer,longitudinal,lower,m.,main,mixed,moderately,multangulat,nflorescence,occasionally,one,open,orolla,partly,perfect,pitted,plurifoliate,pore,rachi,ray,reddish-brown,relatively,rotate-stellate,ruit,runk,short-,short-stalked,slit,somewhat,sparsely,splitting,stamen,stellate-pubescent,stipitate-glandular,stout-stalked,suture,swelling,tamen,testa,thick,thin,thin-,thin-stalked,tomentose,touching,toward,unarme,unit,usually,vary,way,wide,ympodial,young	arrangement,bark,capitate,characteristic,colour,drying,exertion,form,glabrousnes,height,history,inflorescence,life,lobing,na,new,number,ovary,per,perennial,plant,primary,seed,shape,size,texture,type	-1.5,-10,.4,0.2-0.3,0.2-1.5,0.3-3,1-1.5,1-3,1-6,1.1-2.2,1.4-2.6,1/2-3/4,11,13-27,2.5-7.5,4-19,4-6,4-8,9-13,abaxially,acuminate,acute,adaxially,anthesi,apart,apex,articulated,attenuate,basal,base,becoming,berry,blunt-tipped,branched,brown,bullate,calyx,closely,cm,conical,continued,decurrent,deltoid,densely,diameter,due,entire,exserted,fleshy,flower,fruit,glabrous,globose,granular-tomentose,greenish,growth,hair,honeycombed,lanceolate,lateral,lavender,lilac,long,long-,midvein,mm,mostly,multangulate,narrowly,nearly,oblanceolate,oblong,obtuse,openly,orbicular,ovate,pale,persistently,petiole,porrect-stellate,probably,pubescent,rather,reddish,reniform,reticulate-punctate,ripe,scabrous,sessile,shrub,side,simple,slightly,soon,spaced,sparingly,stelliform,stem,strongly,suborbicular,terete,terminal,thick-stalked,time,tree,unarmed,variously,violet,x,yellow,yellowish	capitate,na,perennial
447	wfo-0001031202	success	198	122	86	101	97	21	84	2	.1,0-0.5,0-1,0.5-1,0.6-1.1,0.8-1,1-1.5,1-1.7,1.5-2,1.5-2.5,2-8,2/3,6-25,acute,along,anther,apex,bark,base,beneath,berry,broadly,bud,calyx,capitate,cm,completely,cordate,corolla,cup-shaped,decurrent,deflexed,densely,dia,enclosed,exserted,filament,fleshy,fruit,fruiting,glabrate,glabrous,globose,golden,green,inflorescence,later,lateral,leaf,lobed,long,long-ellipsoid,minute,minutely,mm,obovate,occasional,occasionally,opposite,ovary,overtopping,ovoid-reniform,pale,papillose,pedicel,petiole,pitted,plant,puberulent,pubescent,quite,reddish-brown,scattered,sessile,shape,shaped,shoot,shrub,size,slightly,small,stem,stigma,straight,style,surface,tan,tear-drop,terminal,thicker,tip,tree,trichome,tube,uniseriate,variable,vein,way,white,winged,young	.5,0.1-0.3,0.5,1-5,1.5-9,15-40,2-3,2.5-13,2.5-3.5,2.5-4,20-100-flowered,3.5-4,9-11,9-20,abrupt,accrescent,anthesi,apart,apiculate,axi,complex,condition,corky,deltoid,differing,difoliate,distal,dry,due,eaf,edicel,eed,erect,extremely,flower,free,frui,furcate,geminat,greenish-white,greyi,hard,irregularly,large,like,live,lobe,lon,long-styled,longer,lower,main,major,many,margin,material,middle,minor,narrowing,nflorescence,often,older,one,orbicular,pair,paler,papillo,planar,pore,poricidal,portion,prominent,raised,rounded,ruit,scar,short-styled,slender,spaced,sparsely,specimen,tall,tapering,thick,thickened,third,time,tub,ud,unit,usually,weight,whitish,widest,woody,x,ympodial	alternate,arrangement,branch,characteristic,colour,diameter,exertion,form,glabrousnes,greyish,growth,height,history,length,life,lobing,new,peduncle,seed,texture,type	.1,0-0.5,0-1,0.5-1,0.6-1.1,0.8-1,1-1.5,1-1.7,1.5-2,1.5-2.5,2-8,2/3,6-25,acute,along,apex,base,beneath,berry,broadly,bud,calyx,capitate,cm,completely,cordate,corolla,cup-shaped,decurrent,deflexed,densely,dia,enclosed,exserted,fleshy,glabrate,glabrous,globose,golden,green,later,lateral,leaf,lobed,long,long-ellipsoid,minute,minutely,mm,obovate,occasional,occasionally,opposite,overtopping,ovoid-reniform,pale,papillose,pitted,puberulent,pubescent,quite,reddish-brown,scattered,sessile,shaped,shoot,shrub,slightly,small,straight,tan,tear-drop,terminal,thicker,tip,tree,trichome,uniseriate,variable,vein,way,white,winged,young	alternate,greyish
448	wfo-0001031207	success	217	134	89	106	111	28	86	3	-4,-7,/5,0-20,0-8,0.25-0.5,0.3-0.5,0.5-1,0.6-0.9,0.6-1.2,0.7-2,0.85-1.4,0.9-1.6,1.4-2,1.5-5,1/4-1/3,2.1-2.3,2.8-3,3-5,anther,apex,apparently,articulated,bark,base,berry,bristly,calyx,cell,chartaceous,cm,concolorous,cordate,dark,densely,diameter,discolorous,drying,dull,erect,evenly,filament,flattened-reniform,fruit,fruiting,gray,green,herb,lateral,leaf,length,lobed,long,lower,margin,maturity,mauve,mm,moderately,narrow-deltate,oblong,obtuse,orange-brown,outline,ovate,pair,pale,pedicel,peduncle,per,petiole,pit,poricidal,prickly,primary,raised,red,reflexed,scandent,shrub,simple,small,smooth,sometimes,spherical,spreading,stellate,stellate-pubescent,stem,style,subentire,surface,tapering,terminal,tip,tube,upper,vein,visible,way,weakly,white,wide,yellow,yellow-green,young	-11,.1,0-0.5,0-10,0-5,0.1-0.2,0.1-0.3-0.4,0.1-0.5,0.2,0.2-0.3,0.8,1,1-3,1-4,1-5,1/,1/3,1/3-equal,1/4-1/3-1/2,2-3,2-4,2.5-3-5,3.5-7,5-8,5-merous,6-8,6.5-8,9-5,abaxially,acuminat,acute,alyx,ame,apar,apart,apically,blade,branched,bristle,broad-deltate,brow,c.,curved,difoliate,distance,eaf,eed,elongated,elongating,equal,extending,eye,filiform,flower,free,geminat,gently,glabrescent,glabrous,herbaceous,infructescence,lanceolate,less,like,lobe,longer,mature,midpoint,midvein,multangulate,naked,nflorescence,occasionally,older,one,open,orolla,oung,pendulous,perfec,pericarp,perpendicular,persistent,porrect,portion,prickl,prickle,ray,rounded,ruit,scar,sessile,shorter,side,spaced,stalk,stalked,straight,tamen,terete,tertiary,time,toward,trichome,unarmed,unit,usually,variously,vary,venation,ympodial	1/4,arrangement,branch,brown,bud,characteristic,colour,corolla,exertion,form,glabrousnes,growth,height,history,inflorescence,life,lobing,na,new,number,ovary,plant,seed,shape,size,stigma,texture,type	-4,-7,/5,0-20,0-8,0.25-0.5,0.3-0.5,0.5-1,0.6-0.9,0.6-1.2,0.7-2,0.85-1.4,0.9-1.6,1.4-2,1.5-5,1/4-1/3,2.1-2.3,2.8-3,3-5,apparently,articulated,base,berry,bristly,cell,chartaceous,cm,concolorous,cordate,dark,densely,diameter,discolorous,dull,erect,evenly,flattened-reniform,gray,green,herb,lateral,lobed,long,lower,maturity,mauve,mm,moderately,narrow-deltate,oblong,obtuse,orange-brown,outline,ovate,pair,pale,per,pit,poricidal,prickly,raised,red,reflexed,scandent,shrub,simple,small,smooth,sometimes,spherical,spreading,stellate,stellate-pubescent,subentire,tapering,terminal,tip,upper,visible,way,weakly,white,wide,yellow,yellow-green,young	1/4,brown,na
449	wfo-0001031218	success	154	140	78	85	69	55	75	3	0.5,0.5-1,1-4,15-25,2-22,2-3,2.5-3,3-5,4-28,4-7,4-8,40,40-100+,5-37,5.5-7,6-10,6-7,6-9,8-17,abaxially,acuminate,acute,adaxially,apex,apiculate,basal,base,branched,calyx,cm,connivent,cordate,dark,densely,diameter,eglandular,eglandular-pilose,ellipsoidal,entire,flattened,flower,fruit,glabrous,glandular,glandular-puberulent,globose,greenish-purple,hair,lanceolate,lavender,less,lobe,long,margin,minutely,mm,mottled,narrowly,oblique,obtuse,orange,ovate,ovate-elliptic,ovoid,pedicel,peduncle,perfect,petiole,puberulent,pubescent,purple,ripe,simple,sometimes,sparsely,stigma,style,succulent,tip,tree,triangular,tube,violet,x,yellow	-5,1-2,1-3,10-19,2-2.5,3,3-14,4-5,4-foliat,5-7,8-20,aggregate,apart,ape,articulated,axe,beyond,blade,cell,connective,coriaceous,cylindrical,directed,distally,eaf,eed,equal,especially,exceeding,exserted,glabrou,introrse,leaving,lon,lower,moderately,nflorescence,nther,orolla,papillo,pedicellar,pore,presen,present,purpl,rachi,radiu,remnant,ruit,shorter,slightly,small,spaced,stamen,stellate,stone,subcoriaceous,tal,tem,thecae,time,tomento,toward,truncat,ud,unit,vary,wide,ympodial	anther,appearance,arrangement,bark,border,branch,bud,characteristic,colour,corolla,corrugation,distal,drying,exertion,filament,form,fruiting,giving,glabrousnes,growth,height,history,inflorescence,interjected,lateral,leaf,leaflet,length,life,lobing,midpoint,na,new,number,ovary,papillose,per,plant,prickle,primary,pseudostipule,ray,seed,shape,size,stem,surface,terminal,texture,thicknes,truncate,type,variation,vein,width	0.5,0.5-1,1-4,15-25,2-22,2-3,2.5-3,3-5,4-28,4-7,4-8,40,40-100+,5-37,5.5-7,6-10,6-7,6-9,8-17,abaxially,acuminate,acute,adaxially,apex,apiculate,basal,branched,cm,connivent,cordate,dark,densely,eglandular,eglandular-pilose,ellipsoidal,entire,flattened,flower,fruit,glabrous,glandular,glandular-puberulent,globose,greenish-purple,hair,lanceolate,lavender,less,lobe,long,minutely,mm,mottled,narrowly,oblique,obtuse,orange,ovate,ovate-elliptic,ovoid,perfect,puberulent,pubescent,purple,ripe,simple,sometimes,sparsely,succulent,tip,tree,triangular,violet,x,yellow	na,papillose,truncate
450	wfo-0001031225	success	163	129	97	104	59	25	93	4	.25,.5,0.2,0.2-0.75,0.7-6,0.8-1,1-1.5,1-1.7,1-5,2,3-9,3/4,5-50-flowered,5-6,6-8,7-9,9-16,acute,along,anther,anthesi,apex,bark,base,berry,broadly,bud,calyx,characteristic,cm,corolla,cup-shaped,darker,decurrent,dia,dry,ellipsoid,elliptic,exserted,filament,fruiting,furcate,glabrate,glabrous,globose,green,growth,inflorescence,lateral,leaf,less,like,lobe,lobed,long,main,margin,minute,minutely,mm,narrowly,often,older,ovary,ovate,ovoid-reniform,pair,pale,papillose,pedicel,petiole,pitted,plant,pubescent,red-papillose,reflexed,rest,shape,shaped,shrub,size,slender,slightly,small,soon,specimen,stem,stigma,strongly,style,surface,tan,tapering,tear-drop,tip,tree,trichome,tube,uniseriate,vein,way,white,x,young	/3,0.1-0.75,0.5,0.5-1,0.75-1,1-3,1.5-5,2.5-3,apart,beginning,closely,conspicuous,deltoid,differentiated,differing,difoliate,eaf,edicel,eed,erect,flattene,fragrant,free,geminat,greyish-brow,inflorescenc,live,lon,lower,major,middle,minor,much,nflorescence,one,opposite,outline,papillo,pore,poricidal,portion,prominent,proximal,raised,rhomboidal,rounded,ruit,scar,spaced,straight,sweetly,swelling,tall,ud,unevenly,unit,widest,woody,ympodial	alternate,arrangement,branch,colour,corrugation,diameter,drying,exertion,flattened,form,fruit,glabrousnes,greyish-brown,height,history,length,life,lobing,na,new,peduncle,primary,seed,texture,type	.25,.5,0.2,0.2-0.75,0.7-6,0.8-1,1-1.5,1-1.7,1-5,2,3-9,3/4,5-50-flowered,5-6,6-8,7-9,9-16,acute,along,anthesi,apex,base,berry,broadly,bud,calyx,characteristic,cm,corolla,cup-shaped,darker,decurrent,dia,dry,ellipsoid,elliptic,exserted,furcate,glabrate,glabrous,globose,green,growth,inflorescence,lateral,leaf,less,like,lobe,lobed,long,main,margin,minute,minutely,mm,narrowly,often,older,ovate,ovoid-reniform,pair,pale,papillose,petiole,pitted,pubescent,red-papillose,reflexed,rest,shape,shaped,shrub,slender,slightly,small,soon,specimen,stem,strongly,tan,tapering,tear-drop,tip,tree,trichome,tube,uniseriate,vein,way,white,x,young	alternate,flattened,greyish-brown,na
451	wfo-0001031231	success	174	116	77	87	87	29	74	3	.5,0.5-1.5-2,1-1.5,1-2,1.5-2,2-3,37/2,37/3,4-8,5-7,8-10,acuminate,acute,almost,anther,apex,axillary,base,berry,branch,branched,brown,calyx,campanula,campanulate,cm,colour,corolla,dark,discoidal,ellipsoid,elliptic,entire,equal,erect,except,exerted,filament,fork,glabrous,globose,green,greyish,hair,juvenile,lanceolate,lasting,leaf,len,less,long,loosely,marbled,minute,mm,oblong,occasionally,ovary,pedicel,peduncle,pentagonal,petal,pinnatisect,plant,poricidal,purple,rh,ripening,rotate,rounded,rugose-ruminate,seed,several,shrub,simple,soft,sometimes,stout,style,surface,tinged,tip,vigorous,violet,wooded,x,year	1-3,1-4,13,2-4,2.5-3,25-35,3-4,80-110,absent,acumen,adherent,along,anthesi,aromatic,aspect,axi,basal,becoming,beyond,blunt,bluntly,cell,clonal,cluster,declinate,developed,dia,eaf,eed,exceeding,expanded,facetted,fleshy,flower,flowering,folded,general,glandular,gree,habit,herbarium,interacuminal,lengthening,lobe,lon,lower,margin,mature,mauve,midrib,nflorescence,often,pedice,pedicellate,plurifoliat,pore,projecting,rarely,readily,recurve,ripe,ruit,sessile,shallow,shed,short,sinus,slightly,slit,small,specimen,stigma,stone,stonrgly,succulent,tissue,toward,translucent,triangular,tub,ud,unit,usually,variable,well,without,ympodial	arrangement,bud,characteristic,corrugation,diameter,drying,exertion,form,fruit,glabrousnes,growth,height,history,inflorescence,length,life,lobing,na,new,petiole,primary,shape,size,stem,strongly,texture,tube,type,vein	.5,0.5-1.5-2,1-1.5,1-2,1.5-2,2-3,37/2,37/3,4-8,5-7,8-10,acuminate,acute,almost,axillary,berry,branch,branched,brown,calyx,campanula,campanulate,cm,dark,discoidal,ellipsoid,elliptic,entire,equal,erect,except,exerted,fork,glabrous,globose,green,greyish,hair,juvenile,lanceolate,lasting,len,less,long,loosely,marbled,minute,mm,oblong,occasionally,pentagonal,petal,pinnatisect,plant,poricidal,purple,rh,ripening,rotate,rounded,rugose-ruminate,several,shrub,simple,soft,sometimes,stout,tinged,tip,vigorous,violet,wooded,x,year	na,strongly,tube
452	wfo-0001031252	success	170	150	105	121	49	29	101	4	0.2-1.5,0.3-1.1,1-2,1-3,1.3-1.9,1.75-5.2,16-33,2-3,2.5-7,2.8-3.6,3-10,3-5,3-6,5-17,5-8,5-9,5.5-6.5,7-18,abaxially,absent,acumen,acute,adaxially,anther,apart,apex,articulated,attenuate,axillary,base,berry,brownish,bud,cell,ciliate,clavate,cm,condition,coriaceous,corolla,covering,cuneate,dark,deep,diameter,distal,dorsally,drying,edge,elliptic,entire,filament,flat,flower,folded,forked,fresh,fruit,generally,glabrous,globose,green,green-white,greenish,hair-like,half,herb,high,homostylous,interjected,lanceolate,lateral,leaflet,lengthening,light,lobe,long,make,margin,medium,mm,moniliform,mottled,mucilaginous,ovate,ovoid,pedicel,peduncle,petiole,plant,pore,poricidal,purple,ripe,rotate,rounded,seed,serrate,simple,slit,sometimes,stigma,straight,stripe,style,subtending,terminal,testal,thick,throughout,tip,tube,tuber,unwinged,usually,wall,wet,white,whitish,x,yellow	0.4-3,12-20,5-merou,adaxiall,ag,along,alyx,apparently,arranged,axe,bead,blade,capitat,connivent,digestion,eaf,eed,enzyme,erec,exceeding,geminat,glabrou,hal,honeycomb-shaped,like,linear,living,lower,multiple,necklace,nflorescence,orolla,perfect,plurifoliate,removed,ruit,seudostipule,spaced,specimen,stamen,stolon,tall,tamen,tem,tri-,typically,unit,vary,ympodial	5-merous,abaxial,adaxial,age,arrangement,articulation,axi,calyx,capitate,colour,erect,form,growth,height,history,inflorescence,leaf,length,life,ovary,porosity,pseudostipule,shape,size,spacing,staman,stem,surface,texture	0.2-1.5,0.3-1.1,1-2,1-3,1.3-1.9,1.75-5.2,16-33,2-3,2.5-7,2.8-3.6,3-10,3-5,3-6,5-17,5-8,5-9,5.5-6.5,7-18,abaxially,absent,acute,adaxially,apart,articulated,attenuate,axillary,berry,brownish,bud,cell,ciliate,clavate,cm,condition,coriaceous,covering,cuneate,dark,deep,diameter,distal,dorsally,drying,elliptic,entire,flat,folded,forked,fresh,generally,glabrous,globose,green,green-white,greenish,hair-like,half,herb,high,homostylous,lanceolate,lateral,lengthening,light,long,make,medium,mm,moniliform,mottled,mucilaginous,ovate,ovoid,plant,pore,poricidal,purple,ripe,rotate,rounded,seed,serrate,simple,slit,sometimes,straight,stripe,subtending,terminal,testal,thick,throughout,tip,unwinged,usually,wall,wet,white,whitish,x,yellow	5-merous,age,capitate,erect
453	wfo-0001031257	success	200	166	114	124	76	42	111	3	0,0.7-1,0.75-2.5,1-1.3,1.1-1.2,1.5,1.5-1.7,1.5-2,2-,2-4.5-6,3,3.5-5.7,4-10,5,5-8.5-12,6-celled,7.5-9,abaxially,abundant,acuminate,adaxially,anther,anthesi,antrorse,apex,ascending,attenuate,basal,base,berry,blue-violet,branch,bud,calyx,cm,coarsely,connectival,corolla,cuneate,dark,dentate,diameter,directed,dorsally,edentate,ellipsoidal,erect,filament,finely,flexuous,foliage,fruiting,glabrous,glandular,globose,half,herb,herbaceous,hollow,honey-combed,inconspicuous,inserted,lamina,lateral,leaf,length,light,like,little,lobe,long,long-stalked,longer,longitudinally,margin,midvein,mm,narrowly,non-glandular,odorles,outward,ovate,pair,papillate,patent,petiole,prolongation,pubescent,purple,reduced,ridged,ring,robust,secondary,seed,serrate,shrub,simple,smooth,somewhat,spur-like,stem,stigma,striate,style,subglobose,thickened,time,tip,tooth,trans-ovoidal,triangular,trichome,tube,unequal,upward,vein,ventrifixed,verrucate,viscid,white,within,x,yellow	0.4,0.5,0.5-0.8,1-1.2,1/10,11.5-15,3.5-4-,4.5-5,4.5-6-12,5-,7-10-16-22.5,8,8-celled,accrescen,ag,aggregate,bicellular,broad,campanulate,cell,coat,cotyledon,curved,cuticle,deep,densely,diamete,difoliate,eaf,eed,elliptical,embryo,endosperm,epidermal,free,geminat,hair-like,head,high,lon,longitudinal,lower,many-seeded,opening,orolla,pericarp,pore,poricidal,portion,rarely,ree,rest,ruit,saddle-shape,scarce,scarcely,separated,short-stalked,shorter,single-celled,sinus,slightly,slit,small,solitary,stalk,stone,strand,tem,thecae,thickening,unit,vary,viscid-pubescen,wall,ympodial	appearance,arrangement,border,characteristic,colour,distal,exertion,form,fruit,giving,glabrousnes,growth,height,history,inflorescence,interjected,leaflet,life,lobing,midpoint,na,new,number,ovary,pedicel,peduncle,per,plant,prickle,pseudostipule,ray,saddle-shaped,shape,size,surface,terminal,texture,thicknes,type,variation,viscid-pubescent,width	0,0.7-1,0.75-2.5,1-1.3,1.1-1.2,1.5,1.5-1.7,1.5-2,2-,2-4.5-6,3,3.5-5.7,4-10,5,5-8.5-12,6-celled,7.5-9,abaxially,abundant,acuminate,adaxially,anthesi,antrorse,ascending,attenuate,basal,base,berry,blue-violet,bud,cm,coarsely,connectival,corolla,cuneate,dark,dentate,diameter,directed,dorsally,edentate,ellipsoidal,erect,filament,finely,flexuous,foliage,glabrous,glandular,globose,half,herb,herbaceous,hollow,honey-combed,inconspicuous,inserted,lamina,light,like,little,lobe,long,long-stalked,longer,longitudinally,margin,midvein,mm,narrowly,non-glandular,odorles,outward,ovate,pair,papillate,patent,prolongation,pubescent,purple,reduced,ridged,ring,robust,secondary,serrate,shrub,simple,smooth,somewhat,spur-like,striate,subglobose,thickened,time,tip,tooth,trans-ovoidal,triangular,trichome,tube,unequal,upward,vein,ventrifixed,verrucate,viscid,white,within,x,yellow	na,saddle-shaped,viscid-pubescent
454	wfo-0001031270	success	234	180	144	158	76	22	142	2	+,0.4-1.5,0.5-1,1,1-1.2,1-4,1.2-1.6,1/3,10,10-12,100,2-2.5,2-20,2-3,2-4,2-7,2.5-3,3-10,3-20,4-5,5,5-10,5-15,5-6,6-17,6-50,7-12,>,acute,along,anther,anthesi,apex,articulated,associated,bark,base,berry,bipinnatifid,bright,brown,calyx,capitate,clavate,cm,conical,curved,deeply,densely,depressed-spherical,diameter,differentiated,directed,elliptic,entire,few-rayed,filament,flower,free,fruiting,glabrous,glandular,glandular-pubescent,green,growth,herb,inflorescence,infructescence,later,lateral,leaf,leaf-opposed,length,like,live,lobe,lobed,long,long-styled,margin,membranous,midpoint,midvein,minute,minutely,mixture,mm,multangulate,multiseriate,new,obovate,often,ovoid,pair,pale,pedicel,peduncle,per,petiole,pinnatifid,pitted,plant,pore,poricidal,prickle,prickly,primary,pubescent,ray,red,reddish,reflexed,reniform,rest,ripe,rounded,scattered,sessile,shallowly,short-stalked,short-styled,shrub,simple,size,slender,slightly,small,sparsely,spherical,spreading,stalk,stellate,stem,stigma,straight,straw-colored,style,surface,tan,tapering,terete,tip,tissue,trichome,truncate,tube,uniseriate,upward,varying,vein,way,well,white,wide,wing,yellow,yellowish,Â½	.5,1-3,1.5,1.5-2,3-5,5-merous,8,9-10,abaxial,abaxially,accrescent,adaxial,adaxiall,alyx,apart,arme,basal,beginning,blade,brow,c.,cell,celled,colored,connivent,consistently,difoliate,distal,eed,ellipti,equal,erect,frui,geminat,gland,heavily,heterostylous,investing,leafy,lon,longer,loosely,lower,narrowly,nflorescence,occasionally,older,orolla,oung,outline,papillo,pericarp,portion,rachi,ruit,scar,secondary,shallow,shining,single,sinuate,staminat,strongly,tall,tamen,testal,thin,thus,tightly,unit,usually,vary,wice,wid,woody,ympodial	arrangement,branch,bud,characteristic,colour,corolla,exertion,form,fruit,glabrousnes,height,history,life,lobing,na,number,ovary,papillose,seed,shape,texture,type	+,0.4-1.5,0.5-1,1,1-1.2,1-4,1.2-1.6,1/3,10,10-12,100,2-2.5,2-20,2-3,2-4,2-7,2.5-3,3-10,3-20,4-5,5,5-10,5-15,5-6,6-17,6-50,7-12,>,acute,along,anthesi,articulated,associated,base,berry,bipinnatifid,bright,brown,capitate,clavate,cm,conical,curved,deeply,densely,depressed-spherical,diameter,differentiated,directed,elliptic,entire,few-rayed,flower,free,glabrous,glandular,glandular-pubescent,green,herb,inflorescence,infructescence,later,lateral,leaf-opposed,length,like,live,lobe,lobed,long,long-styled,membranous,midpoint,midvein,minute,minutely,mixture,mm,multangulate,multiseriate,obovate,often,ovoid,pair,pale,per,pinnatifid,pitted,plant,pore,poricidal,prickle,prickly,pubescent,ray,red,reddish,reflexed,reniform,rest,ripe,rounded,scattered,sessile,shallowly,short-stalked,short-styled,shrub,simple,size,slender,slightly,small,sparsely,spherical,spreading,stalk,stellate,stem,straight,straw-colored,surface,tan,tapering,terete,tip,tissue,trichome,truncate,tube,uniseriate,upward,varying,vein,way,well,white,wide,wing,yellow,yellowish,Â½	na,papillose
455	wfo-0001031283	success	51	39	21	24	27	15	19	2	0.1-0.15-0.25,0.4-0.5,0.5-0.7,0.7,2.2-2.8,30-40,brown,calyx,cm,diameter,fruit,hair-like,lobe,long,mm,obovate,outgrowth,pale,pubescent,shrub,surface,thick,wide,woody	.7-2.3,acute,apex,appearance,base,cell,eed,elongating,erect,fide,give,lateral,lo,markedly,moore,narrowly,pleasant,silky,small,smelling,somewhat,sprawling,spreadin,tall,testa,wall,winged	1.7-2.3,colour,form,growth,height,history,length,life,plant,seed,shape,size,spreading,texture,width	0.1-0.15-0.25,0.4-0.5,0.5-0.7,0.7,2.2-2.8,30-40,brown,cm,hair-like,long,mm,obovate,outgrowth,pale,pubescent,shrub,thick,wide,woody	1.7-2.3,spreading
456	wfo-0001031287	success	147	116	74	86	61	30	71	3	.5,0.5-1.5,0.9-1,1,1-1.2,1-1.3,1-1.5,1-5,1.5-2,1.5-5.5,3-4,4-5,5-14,6-10-flowered,6-7,abaxially,acute,adaxially,anther,apex,attenuate,bark,base,berry,bi-lobed,branch,calyx,cm,conical,corolla,dark,dendritic,densely,dia,divergently,ellipsoid,elliptic,elongate,erect,exserted,filament,fleshy,fruiting,glabrous,globose,green,greenish-white,later,leaf,lobed,long,margin,minutely,mm,nearly,onto,ovary,ovoid-reniform,pale,pedicel,petiole,pitted,pointed,pubescent,red-papillose,rounded,shaped,shrub,simple,somewhat,stem,stigma,strongly,style,surface,tan,tear-drop,thick,trichome,tube,tuft,vein,white,winged,x,young	2-2.5,3-5,4-6,4.5-5,anthesi,apar,ape,axil,bearing,connective,coriaceous,deflexed,deltate,difoliate,eaf,edicel,eed,enlarged,free,frui,geminate,internodal,knob,lamina,lateral,lobe,lon,lower,main,many,membranous,middle,nflorescence,occasionally,older,pair,papillo,papillose,planar,plurifoliate,pore,poricidal,portion,reddish-brow,reflexed,ruit,scar,shoot,short,sinus,small,spaced,thin,tip,tub,ud,unevenly,unit,widest,woody,ympodial	0.5,arrangement,bud,characteristic,colour,corrugation,diameter,drying,exertion,form,fruit,growth,height,history,inflorescence,length,life,lobing,na,number,peduncle,per,plant,primary,reddish-brown,seed,shape,size,texture,type	.5,0.5-1.5,0.9-1,1,1-1.2,1-1.3,1-1.5,1-5,1.5-2,1.5-5.5,3-4,4-5,5-14,6-10-flowered,6-7,abaxially,acute,adaxially,apex,attenuate,base,berry,bi-lobed,calyx,cm,conical,dark,dendritic,densely,dia,divergently,ellipsoid,elliptic,elongate,erect,exserted,fleshy,glabrous,globose,green,greenish-white,later,lobed,long,minutely,mm,nearly,onto,ovoid-reniform,pale,petiole,pitted,pointed,pubescent,red-papillose,rounded,shaped,shrub,simple,somewhat,strongly,tan,tear-drop,thick,trichome,tube,tuft,white,winged,x,young	0.5,na,reddish-brown
457	wfo-0001031300	success	216	123	80	97	119	26	78	2	.5,/4,0.2-0.4,0.2-0.5,0.3,0.5-0.9,0.5-18,0.6-0.8,0.7-0.9,0.7-1.2-2.2,0.8-1.5,1-2,1.2-1.7,2-4,2-5.5,2.2-2.3,2.2-2.7,3-4,acute,anther,apex,articulated,attenuate,bark,base,berry,branched,brown-green,calyx,cell,chartaceous,cm,concolorous,creeping,curved,densely,diameter,drying,dull,erect,filament,filiform,flattened-reniform,fruit,fruiting,glabrous,gray-green,lateral,leaf,length,lobed,long,margin,maturity,membranous,mm,moderately,near,oblanceolate,orange,orange-brown,orange-green,outline,pair,pedicel,peduncle,petiole,pit,poricidal,prickly,primary,pubescent,raised,red,rounded,shrub,simple,small,smooth,sparsely,spherical,stellate,stellate-pubescent,stem,style,surface,tapering,terete,tip,trichome,tube,vein,way,white,wide,yellow,yellow-green	-4,-5,-6,0-15,0-20,0-3,0-8,0.1,0.1-0.5,0.1-0.6,0.15-0.7,0.2-0.7,0.2-1,0.3-0.6,0.3-1.3,0.5-1.5,0.5-2,0.6-1,0.6-1.2,1-4,1-5,1.3-2,1.5-3.5,1/2-3/4,1/3-1/2,1/6-1/4,10-30,2-3,2-3-4,2-6,2.5-3.2,4.5-6,5-15,5-merous,6-8,abaxially,absent,also,alyx,apar,apart,apically,apparently,ba,blade,brow,bulbous,caudat,connivent,deltate,difoliate,distance,eaf,eed,elongating,equal,extending,eye,flattened,flower,free,geminat,geniculate,glabrescent,hair,herbaceous,highly,infructescence,lobe,lon,longer,lower,mature,midpoint,midvein,minute,naked,nflorescence,oblong,obtuse,older,one,open,orolla,oung,pale,pendulous,per,perfec,pericarp,porrect,portion,prickl,prickle,rarely,ray,reduced,ruit,scar,sessile,side,spaced,spreading,stalk,stalked,tamen,tertiary,thin,time,uniradiate,unit,vary,venation,visible,weakly,wider,winged,yellow-orange,ympodial	arrangement,branch,brown,bud,characteristic,colour,corolla,exertion,form,glabrousnes,growth,height,history,inflorescence,life,lobing,na,new,ovary,plant,seed,shape,size,stigma,texture,type	.5,/4,0.2-0.4,0.2-0.5,0.3,0.5-0.9,0.5-18,0.6-0.8,0.7-0.9,0.7-1.2-2.2,0.8-1.5,1-2,1.2-1.7,2-4,2-5.5,2.2-2.3,2.2-2.7,3-4,acute,apex,articulated,attenuate,base,berry,branched,brown-green,cell,chartaceous,cm,concolorous,creeping,curved,densely,diameter,dull,erect,filiform,flattened-reniform,glabrous,gray-green,lateral,lobed,long,maturity,membranous,mm,moderately,near,oblanceolate,orange,orange-brown,orange-green,outline,pair,pit,poricidal,prickly,pubescent,raised,red,rounded,shrub,simple,small,smooth,sparsely,spherical,stellate,stellate-pubescent,tapering,terete,tip,trichome,way,white,wide,yellow,yellow-green	brown,na
458	wfo-0001031310	success	203	170	129	144	59	26	124	5	.5,0-3,0-4,1-10,1-2,1-3,1-6,1.5-4,15-40,2-3,2.5-5.5,2.5-8.5,3-10,4-10,4-12,4.5-4.8,5-7,5.5-21,6-7,abaxially,absent,acumen,acuminate,adaxially,along,anther,apart,apex,attenuate,axillary,base,berry,blue,blue-purple,borne,broadly,brown,brownish,bud,cell,chartaceous,ciliate,cm,condition,connivent,corolla,covering,cuneate,decurrent,diameter,distal,dorsally,drying,edge,elliptic,end,especially,filament,flat,flower,folded,forked,fresh,fruit,generally,glabrous,globose,green,green-white,greenish,hair,hair-like,half,herb,high,homostylous,interjected,lanceolate,lateral,leaf,leaflet,light,like,lobe,make,margin,membranous,midrib,minutely,mm,mottled,mucilaginous,multicellular,narrowly,obtuse,odd-pinnate,ovate-elliptic,ovate-lanceolate,ovoid,pair,pale,pedicel,peduncle,petiole,petiolule,pilose,plant,pointed,puberulent,pubescent,purple,rosette-forming,rotate,seed,shortly,simple,singly,size,slightly,sometimes,sparsely,stem,stigma,straight,streak,style,subrosette-forming,subtending,terminal,testal,thick,throughout,tip,tube,tuber,typically,unwinged,usually,wall,wet,white,whitish,x,yellow	0.5-3,1-5.5,5-6,5-merou,ag,alyx,apparently,articulated,axe,blade,caly,conspicuously,decreasing,digestion,eaf,eed,enzyme,erect-decumben,exceeding,extremely,geminat,glabrou,gradually,honeycomb-shaped,larger,lengthening,less,living,long,lower,nflorescence,orolla,ovate,perfect,plurifoliate,pore,poricidal,rachi,removed,ruit,seudostipule,slit,small,somewhat,spaced,specimen,stamen,ste,stolo,subellipsoi,tall,tamen,tem,tissue,toward,tri-,unit,vary,ympodial	5-merous,abaxial,adaxial,arrangement,articulation,calyx,colour,erect-decumbent,form,growth,height,history,inflorescence,length,life,number,ovary,presence,pseudostipule,shape,spacing,stolon,subellipsoid,surface,texture,type	.5,0-3,0-4,1-10,1-2,1-3,1-6,1.5-4,15-40,2-3,2.5-5.5,2.5-8.5,3-10,4-10,4-12,4.5-4.8,5-7,5.5-21,6-7,abaxially,absent,acuminate,adaxially,along,apart,attenuate,axillary,base,berry,blue,blue-purple,borne,broadly,brown,brownish,bud,cell,chartaceous,ciliate,cm,condition,connivent,corolla,covering,cuneate,decurrent,diameter,distal,dorsally,drying,elliptic,end,especially,flat,folded,forked,fresh,generally,glabrous,globose,green,green-white,greenish,hair,hair-like,half,herb,high,homostylous,lanceolate,lateral,light,like,make,margin,membranous,midrib,minutely,mm,mottled,mucilaginous,multicellular,narrowly,obtuse,odd-pinnate,ovate-elliptic,ovate-lanceolate,ovoid,pale,petiolule,pilose,plant,pointed,puberulent,pubescent,purple,rosette-forming,rotate,seed,shortly,simple,singly,slightly,sometimes,sparsely,stem,straight,streak,subrosette-forming,subtending,terminal,testal,thick,throughout,tip,typically,unwinged,usually,wall,wet,white,whitish,x,yellow	5-merous,calyx,erect-decumbent,stolon,subellipsoid
459	wfo-0001031316	success	207	127	93	109	98	18	92	1	-2,/3,0.05-0.1,0.05-0.15,0.1-0.2,0.3-1,0.4-0.8,0.5-2,0.8-1.2,0.8-1.8,0.9-1.3,1.2-2.1,1.3-3.5,1.5-2,1.5-3.5,2-3,2.5-8,3-8,3.5-3.8,3.8-5,4-7,5-10,5-15,8-25,abaxial,acuminate,acute,adaxial,almost,ame,anther,apex,apically,apparently,bark,base,berry,blue-mauve,branched,bright,c.,calyx,cm,connivent,cream,curved,dark,densely,diameter,dull,entire,flattened-reniform,fruit,fruiting,glabrescent,glabrous,gray,green,held,inward,lateral,leaf,length,lobe,long,lowermost,margin,marking,maturity,midpoint,mm,moderately,multangulate,narrow-deltate,obtuse,orange,orange-brown,ovate,pale,pedicel,peduncle,petiole,poricidal,porrect,purple,ray,red-brown,sessile,shrub,simple,sometimes,spherical,stalked,stellate-pubescent,stem,style,surface,tapering,terete,terminal,tip,trichome,unarmed,variously,way,white,wide,yellow,young	.1,0.4-0.6,0.6-1,1-5,1.5-2-3,1.5-5,1/3-1/2,1/3-2/3,2-20,2-4,3-10,4,4-9,5-6,5-8,5-merous,6-20,8-11,8-12,abaxially,alyx,apar,articulated,becoming,blade,broad,colored,concolorous,contrast,difoliate,discolorous,drying,eaf,eed,elongating,erect,eye,fifth,filament,flower,foliaceou,four,free,geminat,glabrou,hair,herbaceous,infructescence,lobed,long-acuminat,longer,lower,mature,membranous,minute,naked,nflorescence,older,one,open,orolla,oung,pair,pendulous,per,perfec,pericarp,portion,primary,red-brow,reflexed,ruit,scar,slender,smooth,spaced,sparsely,spreading,stalk,stellate,stellate-pubescen,strongly,tamen,tertiary,time,tube,unarme,unequal,unit,usually,vary,vein,venation,visible,white-green,whitish,yellow-green,ympodial	arrangement,characteristic,colour,corolla,form,growth,height,inflorescence,lobing,long-acuminate,ovary,plant,seed,shape,size,staman,texture,type	-2,/3,0.05-0.1,0.05-0.15,0.1-0.2,0.3-1,0.4-0.8,0.5-2,0.8-1.2,0.8-1.8,0.9-1.3,1.2-2.1,1.3-3.5,1.5-2,1.5-3.5,2-3,2.5-8,3-8,3.5-3.8,3.8-5,4-7,5-10,5-15,8-25,acuminate,acute,almost,ame,anther,apically,apparently,base,berry,blue-mauve,branched,bright,c.,cm,connivent,cream,curved,dark,densely,diameter,dull,entire,flattened-reniform,glabrescent,glabrous,gray,green,held,inward,lateral,length,lobe,long,lowermost,marking,maturity,mm,moderately,multangulate,narrow-deltate,obtuse,orange,orange-brown,ovate,pale,poricidal,porrect,purple,ray,red-brown,sessile,shrub,simple,sometimes,spherical,stalked,stellate-pubescent,tapering,terete,terminal,tip,unarmed,variously,way,white,wide,yellow,young	long-acuminate
460	wfo-0001031333	success	194	97	61	76	118	21	61	0	1-1.5,1-4,1.2-2,1.5,1.5-1.7,1.5-2,1/2,3-4,3/4,7-9,?,acuminate,acute,almost,anther,anthesi,apex,base,berry,bilobed,branched,broadly,brown,calyx,capitate,cm,conical,densely,diameter,ellipsoidal,elliptic,entire,exserted,filament,flattened,fruting,glabrous,globose,golden,green,greenish,growth,immature,inflorescence,many,margin,membranous,minute,minutely,mm,narrowly,new,nodding,ovate,pale,pedicel,peduncle,petiole,pitted,pubescent,reniform,simple,somewhat,sparsely,stem,stigma,strongly,style,surface,terminal,time,truncate,tube,vine,way,white	+,.5,0.1-0.5,0.5,1-5,2,2-3,2.5-3,2.7-7,30-40,5-7,5-8,5-merou,50,7-10,<,>,abaxially,adaxiall,adaxially,adjacent,ag,alyx,apart,appearing,ark,articulated,branche,cell,clustered,collection,composed,crea,cupped,denser,eaf,eed,flower,free,glabrescen,glabrescent,half,high,ilament,lamina,leaving,lengthening,less,like,lobe,lobed,long,lower,m.,matte,mere,near,nflorescence,occasionally,older,orolla,outline,pair,papillat,peg,penden,pentagonal,per,perfect,pericarp,planar,plurifoliat,pore,poricidal,portion,primary,pubescent-papillate,quadrate,rest,rhachi,ruit,scar,sinus,slightly,slit,small,soon,splitting,ste,stellate,striped,tangled,tem,testal,thickened,thin,tip,trailing,triangular,trichome,twining,ud,undersurface,undulation,unequal,unevenly,uniseriate,unit,upper,vary,vein,venation,whitish,woody,x,yellow,yellowish,ympodial	abaxial,adaxial,arrangement,bark,bud,characteristic,colour,corolla,exertion,form,fruit,glabrousnes,leaf,length,lobing,ovary,seed,shape,size,texture,type	1-1.5,1-4,1.2-2,1.5,1.5-1.7,1.5-2,1/2,3-4,3/4,7-9,?,acuminate,acute,almost,anthesi,base,berry,bilobed,branched,broadly,brown,calyx,capitate,cm,conical,densely,diameter,ellipsoidal,elliptic,entire,exserted,flattened,glabrous,globose,golden,green,greenish,immature,many,membranous,minute,minutely,mm,narrowly,nodding,ovate,pale,pitted,pubescent,reniform,simple,somewhat,sparsely,strongly,terminal,time,truncate,tube,vine,way,white	
461	wfo-0001031333	success	194	98	60	77	117	21	60	0	1-1.5,1-4,1.5,1.5-1.7,1.5-2,1/2,3-4,3/4,7-9,?,acuminate,acute,adaxially,almost,anther,anthesi,apex,base,berry,bilobed,branched,broadly,brown,capitate,cm,corolla,densely,diameter,ellipsoid,elliptic,entire,exserted,filament,flattened,fruiting,glabrous,globose,golden,green,growth,immature,inflorescence,many,margin,membranous,minute,minutely,mm,narrowly,near,new,nodding,ovate,pedicel,peduncle,petiole,pitted,pubescent,reniform,simple,somewhat,sparsely,stem,stigma,strongly,style,surface,terminal,time,trichome,truncate,tube,uniseriate,vine,way,white,woody	+,.5,0.1-0.5,0.5,1-5,1-5-2,2,2-3,2.5-3,2.7-7,3,30-40,5-7,5-8,5-merou,50,7-10,<,>,abaxially,adaxiall,adjacent,ag,alyx,apart,appearing,articulated,bark,branche,calyx,cell,clustered,composed,conical,cream,cupped,denser,eaf,eed,flower,free,glabrescen,glabrescent,greenish,half,high,ilament,lamina,leaving,lengthening,less,like,lobe,lobed,long,lower,m.,matte,mere,nflorescence,occasionally,older,orolla,outline,pair,pale,papillat,peg,penden,per,perfect,pericarp,planar,plurifoliat,pore,poricidal,portion,primary,pubescent-papillate,quadrate,rest,rhachi,rotate-stellate,ruit,scar,sinus,slightly,slit,small,soon,spaced,splitting,stellate,striped,tangled,testal,thickened,thin,tip,trailing,triangular,tub,twinin,ud,undersurface,undulation,unequal,unevenly,unit,upper,vary,vein,venation,whitish,wide,yellowish,ympodial	abaxial,adaxial,arrangement,bud,characteristic,colour,exertion,form,fruit,glabrousnes,history,leaf,length,life,lobing,ovary,seed,shape,size,texture,type	1-1.5,1-4,1.5,1.5-1.7,1.5-2,1/2,3-4,3/4,7-9,?,acuminate,acute,adaxially,almost,anthesi,base,berry,bilobed,branched,broadly,brown,capitate,cm,densely,diameter,ellipsoid,elliptic,entire,exserted,flattened,glabrous,globose,golden,green,immature,many,membranous,minute,minutely,mm,narrowly,near,nodding,ovate,pitted,pubescent,reniform,simple,somewhat,sparsely,strongly,terminal,time,trichome,truncate,uniseriate,vine,way,white,woody	
462	wfo-0001031359	success	166	125	86	98	68	27	84	2	.02,.25,.5,/4,0.5-1,0.5-6,1-4,1.1-1.6,1.2-1.6,1.2-2.5,1.3-1.6,1.9-2.3,12-21,2.5-3,3-3.5,3.6-8.8,5-30-flowered,5-angled,6-7,acuminate,angle,anther,apex,attenuate,axil,bark,base,beneath,berry,bi-lobed,brown,calyx,cm,corolla,dark,dia,dried,dull,elliptic,extending,filament,flattened-reniform,fruiting,glabrous,globose,green,internodal,lateral,leaf,live,long,main,margin,minutely,mm,narrowly,nearly,obovoid,occasionally,often,opposite,outline,ovary,papillae,papillose,pedicel,petiole,pit,pitted,plant,ripe,round,rusty,shaped,shiny,shrub,simple,size,slender,somewhat,specimen,stem,stigma,style,surface,tan,tapering,tear-drop,trichome,tube,tuft,uniseriate,vein,way,white,x,yellow,yellow-orange	0.75-1,1.5-2,1.6-2.8,5-7,5.3-7.5,anthesi,apart,apiculate,appearing,ba,beginning,broadly,curled,deflexed,differing,difoliate,distal,eaf,edicel,eed,evenly,free,geminat,incrassate,inflorescenc,interpetalar,lamina,lobe,lobed,lon,lower,major,membraneous,middle,minor,near,nflorescence,older,one,originating,pair,paler,papillo,planar,pore,poricidal,portion,reflexed,ridged,ruit,scar,sinus,slightly,spaced,straight,strongly,tall,tip,triangular,tub,ud,undulate,unit,white-lenticellat,widest,woody,ympodial,young	arrangement,bud,characteristic,colour,corrugation,diameter,drying,exertion,form,fruit,growth,height,history,inflorescence,length,life,lobing,na,number,peduncle,per,primary,seed,shape,texture,type,white-lenticellate	.02,.25,.5,/4,0.5-1,0.5-6,1-4,1.1-1.6,1.2-1.6,1.2-2.5,1.3-1.6,1.9-2.3,12-21,2.5-3,3-3.5,3.6-8.8,5-30-flowered,5-angled,6-7,acuminate,angle,attenuate,axil,base,beneath,berry,bi-lobed,brown,calyx,cm,dark,dia,dried,dull,elliptic,extending,flattened-reniform,glabrous,globose,green,internodal,lateral,leaf,live,long,main,minutely,mm,narrowly,nearly,obovoid,occasionally,often,opposite,outline,papillae,papillose,pedicel,pit,pitted,plant,ripe,round,rusty,shaped,shiny,shrub,simple,slender,somewhat,specimen,tan,tapering,tear-drop,trichome,tube,tuft,uniseriate,vein,way,white,x,yellow,yellow-orange	na,white-lenticellate
463	wfo-0001031362	success	138	84	52	64	74	20	50	2	.2,.5,0.5-1,0.7-1,1-1.1,1-4,1.5-2,2-2.5,?,acute,anther,apex,attenuate,bark,base,berry,brown,calyx,cm,conical,corolla,dendritic,densely,dia,ellipsoid,flattened-reniform,fruiting,glabrous,globose,golden,incrassate,lanceolate,leaf,long,margin,minutely,mm,nearly,orange-red,ovary,pale,pedicel,petiole,pitted,pubescent,pubesent,red,rounded,shaped,shrub,simple,small-capitate,somewhat,sparsely,stem,stigma,style,subshrub,surface,tan,tear-drop,trichome,white,x	.3,0.4-0.5,1-1.5,1-3,1-3-flowered,3-4,3-6,abaxially,adaxially,along,anthesi,appearance,branch,bushy,cell,closely,denser,eaf,edicel,eed,erect,exceeding,exserted,filament,flattened,free,giving,golden-brow,inflorescenc,internodal,lamina,lateral,like,lobe,lobed,lon,long-triangular,lower,main,middle,nflorescence,nodding,older,opposite,outline,overlappin,packed,pair,papillo,papillose,pericarp,planar,plurifoliat,pore,poricidal,portion,rectangular,rest,ruit,scar,shiny,slender,spaced,straight,thin,tip,tube,ud,unit,vein,widest,woody,ympodial,young	abaxial,adaxial,arrangement,bud,characteristic,colour,diameter,form,fruit,golden-brown,growth,inflorescence,length,lobing,plurifoliate,seed,shape,size,texture,type	.2,.5,0.5-1,0.7-1,1-1.1,1-4,1.5-2,2-2.5,?,acute,attenuate,base,berry,brown,cm,conical,dendritic,densely,dia,ellipsoid,flattened-reniform,glabrous,globose,golden,incrassate,lanceolate,long,margin,minutely,mm,nearly,orange-red,pale,pitted,pubescent,pubesent,red,rounded,shaped,shrub,simple,small-capitate,somewhat,sparsely,subshrub,tan,tear-drop,trichome,white,x	golden-brown,plurifoliate
464	wfo-0001031400	success	160	82	47	62	98	20	46	1	0.25-0.8,0.4-1.7,0.6-1.8,0.7-6,0.8-1.1,1.2-2,1.5-5,10-11,2-3,2-5,2-9,4-13,4-6.5,4-7,4-7-25,5-12.5,6-23,7-28,abaxial,branched,calyx,cm,corolla,cyme,deeply,diameter,dichasial,dichasially,ebracteate,forked,globose,green-white,herbaceous,interjected,lateral,leaf,leaflet,long,mm,monochasial,odd-pinnate,ovoid,pedicel,peduncle,perennial,petiole,plant,puberulent,seed,size,stellate,stigma,straight,style,subglabrous,terminal,throughout,tone,violet,white,wide,yellow	-3,1,1-2,1-4,2,3-6-foliat,4-17,abaxially,abruptly,absen,acumen,acute,adaxially,apex,apical,apically,apiculate,articulate,base,cell,connate,covering,cuneate,dark,decurrent,dehiscent,digestion,diminishing,distal,dorsally,eaf,edge,eed,emoval,enzyme,exceeding,filament,flat,flower,folded,forming,generally,globo,green,hair-like,half,honeycomb,introrse,linear,linear-lanceolate,living,lobe,lon,lower,lunat,make,maturing,mucilaginous,nflorescence,nther,oblique,oblong,occasionally,often,orolla,pair,pattern,perfect,plan,poricidally,proximal,rachi,reveal,ruit,sessile,seudostipule,short,side,slit,specimen,stamen,stripe,structure,tal,tem,testal,thick,tip,toward,trilobe,tuber-bearing,typically,unit,vary,wall,without,ympodial,Â¼	absent,adaxial,anther,arrangement,colour,form,fruit,growth,height,history,inflorescence,length,life,ovary,pseudostipule,shape,stem,texture,type,width	0.25-0.8,0.4-1.7,0.6-1.8,0.7-6,0.8-1.1,1.2-2,1.5-5,10-11,2-3,2-5,2-9,4-13,4-6.5,4-7,4-7-25,5-12.5,6-23,7-28,branched,cm,cyme,deeply,diameter,dichasial,dichasially,ebracteate,forked,globose,green-white,herbaceous,long,mm,monochasial,odd-pinnate,ovoid,perennial,puberulent,stellate,straight,subglabrous,throughout,tone,violet,white,wide,yellow	absent
465	wfo-0001031401	success	182	150	116	127	55	23	115	1	0.5,0.6-1.2,0.8-1.2,1,1-1.4,1-1.5,1-6,1.1-3,1.5-2,1/2,2-2.4,2-5,2.5-4,3,3.5-4,3/4,5,5-9,7-9,abaxial,acute,adaxial,age,along,anther,apex,apical,appearing,attenuate,bark,basal,base,becoming,berry,bi-lobed,black,branch,brown,calyx,cm,corolla,dark,deciduous,dendritic,densely,diameter,drying,ecuador,ecuadorian,elliptic,exserted,filament,finely,flattened,fork,free,fruit,fruiting,glabrous,globose,golden,golden-yellow,growth,lateral,leaf,lenticular,less,long,matted,minutely,mm,narrowly,near,new,node,occasionally,often,outline,ovary,overtopping,pair,pedicel,per,petiole,pore,poricidal,portion,prominently,puberulent,pubescent,purplish-black,raised,rounded,roundish,scar,secondary,shiny,shoot,short,shrub,slit-like,small,sometimes,somewhat,sparsely,specimen,stem,stigma,strongly,style,surface,tapering,terminal,tip,tree,tree-like,trichome,tube,vein,violet,way,white,wide,winged,x,yellow,young	5-7,8-10,abaxially,adaxially,anthesi,axi,blade,branching,clearly,conical,deflexed,deltoid,denser,dichasial,differentiated,eaf,edicel,eed,ew,flower,impressed,inserted,lobe,lobed,long-triangular,lower,m.,mesophyll,monochasia,nflorescence,noddin,nodding,older,papillo,pericarp,pitted,planar,plurifoliate,pubescen,pyramidal,reddish-brown,ruit,sleev,stamen,ste,tall,thin,time,tub,ud,unit,usually,visible,woody,ympodial	arrangement,bud,characteristic,colour,exertion,form,glabrousnes,height,history,inflorescence,length,life,lobing,number,papillose,peduncle,plant,seed,shape,size,staman,texture,type	0.5,0.6-1.2,0.8-1.2,1,1-1.4,1-1.5,1-6,1.1-3,1.5-2,1/2,2-2.4,2-5,2.5-4,3,3.5-4,3/4,5,5-9,7-9,acute,age,along,anther,apical,appearing,attenuate,basal,base,becoming,berry,bi-lobed,black,branch,brown,calyx,cm,dark,deciduous,dendritic,densely,diameter,drying,ecuador,ecuadorian,elliptic,exserted,filament,finely,flattened,fork,free,fruit,glabrous,globose,golden,golden-yellow,lateral,leaf,lenticular,less,long,matted,minutely,mm,narrowly,near,new,node,occasionally,often,outline,overtopping,pair,per,petiole,pore,poricidal,portion,prominently,puberulent,pubescent,purplish-black,raised,rounded,roundish,secondary,shiny,shoot,short,shrub,slit-like,small,sometimes,somewhat,sparsely,specimen,stem,strongly,surface,tapering,terminal,tip,tree,tree-like,trichome,tube,vein,violet,way,white,wide,winged,x,yellow,young	papillose
466	wfo-0001031480	success	233	141	96	114	119	27	94	2	/3,0-2,0-30,0.5-2,0.6-0.8,0.8-1,1-1.3,1-1.5,1-2,1-3,1.5-2.2,1.7-2.2,1.8-3,2-2.7,3-7,3.5-7,4-5,4-6,6-13,acute,anther,apex,apically,apparently,articulated,bark,base,berry,bright,calyx,cell,cm,cuneate,curved,deltate,densely,diameter,discolorous,drying,dull,ellipsoid,entire,erect,filament,flattened-reniform,fruit,fruiting,glabrous,lateral,leaf,length,lobed,long,margin,maturity,mauve,minutely,mm,moderately,near,obtuse,orange-brown,outline,ovate,pair,pale,pedicel,peduncle,per,petiole,pit,plant,poricidal,porrect,prickle,prickly,primary,purple,raised,red,red-brown,red-green,red-yellow-green,reticulate,scandent,shallowly,shrub,simple,slender,small,smooth,somewhat,spherical,spreading,stalked,stellate,stellate-pubescent,stem,straight,style,surface,tapering,terminal,thick-chartaceous,tip,trichome,truncate,tube,unarmed,variously,vein,way,wide,yellow	0-0.5,0-1,0-5,0.1-0.25,0.1-0.3,0.1-0.4,0.15-0.3,0.2-0.35,0.4,0.4-0.8,0.5-3-10,0.7,0.8,1-4,1/2,1/3,1/4,1/6-1/5,2-3,2-5,2-6,2-6-30,3,3-10,3-6,5-8,5-merous,6-8,7-8,8-12,abaxial,abaxially,acuminat,adaxial,alyx,andromonoecious,apar,apart,ba,blade,branched,branching,broad-deltate,cream,dark,difoliate,distal,distance,eaf,eed,elongate,elongating,equal,extending,eye,faint,flattened,flower,free,geminat,glabrescent,glandular,green,hair,hermaphrodite,heterostylous,inconspicuous,infructescence,lobe,long-styled,longer,lower,lowermost,marking,mature,midpoint,midvein,naked,nflorescence,often,older,one,open,orolla,oung,pendulous,pericarp,persistent,portion,pubescent,ray,red-brow,reduced,rounded,ruit,scar,sessile,short-styled,shorter,side,slightly,spaced,sparsely,stalk,staminat,tamen,terete,tertiary,time,unarme,unit,upper,vary,venation,visible,weakly,woody,ympodial,young	acuminate,arrangement,branch,bud,characteristic,colour,corolla,corrugation,exertion,form,glabrousnes,growth,height,history,inflorescence,life,lobing,na,new,number,ovary,seed,shape,size,stigma,texture,type	/3,0-2,0-30,0.5-2,0.6-0.8,0.8-1,1-1.3,1-1.5,1-2,1-3,1.5-2.2,1.7-2.2,1.8-3,2-2.7,3-7,3.5-7,4-5,4-6,6-13,acute,apex,apically,apparently,articulated,base,berry,bright,cell,cm,cuneate,curved,deltate,densely,diameter,discolorous,dull,ellipsoid,entire,erect,flattened-reniform,glabrous,lateral,lobed,long,maturity,mauve,minutely,mm,moderately,near,obtuse,orange-brown,outline,ovate,pair,pale,per,pit,poricidal,porrect,prickle,prickly,purple,raised,red,red-brown,red-green,red-yellow-green,reticulate,scandent,shallowly,shrub,simple,slender,small,smooth,somewhat,spherical,spreading,stalked,stellate,stellate-pubescent,straight,tapering,terminal,thick-chartaceous,tip,trichome,truncate,unarmed,variously,way,wide,yellow	acuminate,na
467	wfo-0001031483	success	154	107	72	89	65	18	72	0	.5,/2,0,0.5,0.5-2,1,1-2,1.1-2.5,1.2-1.4,1.7-5.5,11-20.5,2-2.5,2.5-3.2,3-4,3-8-flowered,6-10,7-10,across,acuminate,acute,almost,anther,apex,attenuate,base,berry,calyx,clavate,cm,corky,corolla,decurrent,dia,distal,end,exserted,filament,filiform,fruiting,fusiform,glabrous,green,indistinct,internode,larger,lateral,leaf,lenticellate,less,linear,lobed,long,main,markedly,minor,mm,oblanceolate,oblong,obovate,obovoid,often,orbiculate,ovary,ovoid-reniform,pair,pale,paler,pedicel,per,petiole,pointed,shape,shaped,shrub,simple,slightly,soon,stem,stigma,style,subshrub,tapering,tear-drop,tube,turbinate,vein,way,white,x	1/3,2-3,anew,anthesi,apart,ba,bearing,beginning,beneath,blade,ca,caly,continuous,cork,deflexed,deltoid,difoliate,dry,eaf,edicel,eed,evenly,flower,free,fresh,geminat,indistinc,lea,lobe,lower,major,minutely,nflorescence,opposite,papillo,papillose,planar,pore,poricidal,portion,prominent,quite,raised,rounded,ruit,scar,short,short-triangular,slender,somewhat,spaced,straight,strongly,tall,tan,third,tip,ud,unit,variable,widest,wing,winged,woody,ympodial	bud,characteristic,colour,diameter,exertion,form,fruit,growth,height,inflorescence,length,lobing,number,plant,seed,size,texture,type	.5,/2,0,0.5,0.5-2,1,1-2,1.1-2.5,1.2-1.4,1.7-5.5,11-20.5,2-2.5,2.5-3.2,3-4,3-8-flowered,6-10,7-10,across,acuminate,acute,almost,attenuate,base,berry,calyx,clavate,cm,corky,decurrent,dia,distal,end,exserted,filiform,fusiform,glabrous,green,indistinct,larger,lenticellate,less,linear,lobed,long,markedly,mm,oblanceolate,oblong,obovate,obovoid,often,orbiculate,ovoid-reniform,pair,pale,paler,per,pointed,shaped,shrub,simple,slightly,soon,stem,style,subshrub,tapering,tear-drop,turbinate,way,white,x	
468	wfo-0001031492	success	175	131	101	110	65	21	101	0	.5,/4,0.5,0.7-1.3,0.9-1.1,08,1-1.3,1-1.5,1.3-2,1.5-1.8,1.5-2.5,10-15,2-10,2-5,20,3-4,3-5,4-10,4-4.5,6-8,8-9,absent,acuminate,acute,age,anther,apex,apical,appearing,attenuate,basal,base,berry,bi-lobed,branching,calyx,cm,corolla,dark,dbh,deciduous,decurrent,densely,diameter,distinguishable,drying,dull,echinoid,elliptic,exserted,filament,flattened,flower,fruit,fruiting,glabrous,globose,golden,growth,lamina,lateral,leaf,lenticular,lightly,lobed,long,medium,minutely,mm,narrowly,ovary,overtopping,pedicel,per,petiole,pitted,poricidal,pubescent,purplish-black,pyramidal,reddish-brown,scarcely,scattered,shiny,shoot,shrub,size,sometimes,sparsely,stem,stigma,strongly,style,surface,tall,tapering,terminal,time,tip,tree,tree-like,trichome,tube,vein,violet,way,wide,winged,x,young	2-3,8-11,abaxially,adaxially,anthesi,axe,ba,bark,becoming,beneath,bitter,conical,deltoid,dendritic,denser,eaf,edicel,eed,erect,ew,free,grey,inserted,juice,lobe,lower,m.,monochasia,nflorescence,nodding,occasionally,older,pair,papillo,pericarp,planar,plurifoliate,pore,portion,predominantly,prominent,rather,remaining,ruit,scar,secondary,short,sleeve,slightly,slit-like,somewhat,stamen,ste,sticky,sunken,thin,tub,ud,undersurface,unit,upper,upturned,woody,ympodial,younger	arrangement,bud,characteristic,colour,exertion,form,glabrousnes,height,history,inflorescence,length,life,lobing,new,number,peduncle,plant,seed,shape,texture,type	.5,/4,0.5,0.7-1.3,0.9-1.1,08,1-1.3,1-1.5,1.3-2,1.5-1.8,1.5-2.5,10-15,2-10,2-5,20,3-4,3-5,4-10,4-4.5,6-8,8-9,absent,acuminate,acute,age,apical,appearing,attenuate,basal,base,berry,bi-lobed,branching,calyx,cm,dark,dbh,deciduous,decurrent,densely,diameter,distinguishable,drying,dull,echinoid,elliptic,exserted,flattened,flower,fruit,glabrous,globose,golden,growth,lamina,lateral,leaf,lenticular,lightly,lobed,long,medium,minutely,mm,narrowly,overtopping,per,petiole,pitted,poricidal,pubescent,purplish-black,pyramidal,reddish-brown,scarcely,scattered,shiny,shoot,shrub,size,sometimes,sparsely,stem,strongly,style,tall,tapering,terminal,time,tip,tree,tree-like,trichome,tube,vein,violet,way,wide,winged,x,young	
469	wfo-0001031503	success	139	116	81	90	49	26	80	1	-10,-15,-7,0.3-3,0.5-1,0.5-4,1-2.5,1-5,1-7,2-3,2.5-10,3-4,3-5,3-6,6-7,7-10,7-15,abaxially,abruptly,acuminate,acute,adaxially,angled,apart,apex,articulated,base,branched,calyx,chartaceous,cm,connivent,cuneate,curled,cylindrical,decurrent,deltate,densely,diameter,distally,eglandular,elliptic,entire,except,forked,glabrous,globose,hair,lanceolate,lobe,margin,mm,moderately,mostly,narrowed,narrowly,obtuse,often,orange,ovate,pedicel,peduncle,petiole,puberulent,pubescent,rarely,reddish,ripe,rounded,rugose-pubescent,shrub,simple,slightly,sparsely,stellate,stigma,style,subclavate,tip,toward,triangular,truncate,tube,unbranched,unequal,uniseriate,usually,white,x,yellow	-30,1-1.5-7,1-3,1.5-2,1.5-3,1.5-8,1.7-3.5-6,10-19,3-15-25,5613,6-many-foliat,absen,aggregate,axe,ba,blade,cell,directed,distall,eaf,eed,fide,flower,gland,long,lower,nflorescence,nther,occasionally,orolla,perfect,pore,present,rachi,radiu,ruit,spaced,stalked,stone,subcapitat,tal,tem,time,unit,vary,vein,venturi,wide,ympodial	abaxial,adaxial,anther,arrangement,articulation,characteristic,colour,corolla,form,fruit,growth,height,inflorescence,leaf,length,ovary,plant,seed,shape,size,spacing,stem,subcapitate,surface,texture,type	-10,-15,-7,0.3-3,0.5-1,0.5-4,1-2.5,1-5,1-7,2-3,2.5-10,3-4,3-5,3-6,6-7,7-10,7-15,abaxially,abruptly,acuminate,acute,adaxially,angled,apart,apex,articulated,base,branched,chartaceous,cm,connivent,cuneate,curled,cylindrical,decurrent,deltate,densely,distally,eglandular,elliptic,entire,except,forked,glabrous,globose,hair,lanceolate,mm,moderately,mostly,narrowed,narrowly,obtuse,often,orange,ovate,puberulent,pubescent,rarely,reddish,ripe,rounded,rugose-pubescent,shrub,simple,slightly,sparsely,stellate,subclavate,tip,toward,triangular,truncate,unbranched,unequal,uniseriate,usually,white,x,yellow	subcapitate
470	wfo-0001031586	success	166	65	39	51	115	14	38	1	0.1-1,0.5-1,1-1.2,1-2,1.4-2.5,2,7-10-flowered,anther,bark,base,bright,bud,calyx,capitate,cm,corolla,cream-colored,ellipsoid,elliptic,exerted,glabrous,globose,green,greenish,inflorescence,leaf,lobe,lobed,long,mm,nearly,ovary,pale,papillate,pedicel,petiole,poricidal,ridged,shiny,shrub,simple,soon,stem,stigma,style,surface,tapering,tip,white,yellow,yellowish	.25,0.5-0.8,1,1-1.5-2,1.3-5,1.5-2,2-2.5,3-11,5-10,5-6,abrupt,absent,acute,anthesi,apart,apex,apparently,appearing,attenuate,becoming,beneath,borne,branch,broadly,campanulate,closer,completely,conical,cucullate,deflexed,deltate,dia,differing,difoliate,distance,drying,eaf,edicel,eed,exfoliatin,filament,fleshy,flower,free,fresh,geminate,gree,inflorescenc,know,known,later,lateral,leave,lower,main,major,margin,material,may,minor,minutely,mucro,near,new,nflorescence,notched,occasionally,older,olive,one,onto,open,opposite,overtopping,pair,paler,papillose,planar,pore,portion,present,prominent,raised,remaining,rounded,ruit,scar,shap,shaped,shin,size,slender,small,sometimes,somewhat,spaced,sparsely,straight,swollen,tall,tear-drop,thick,thickened,trichome,truncate,trunk,tube,ud,uniseriate,unit,vein,widely,x,ympodial,young	alternate,arrangement,characteristic,colour,diameter,exertion,form,growth,height,length,lobing,plant,shape,texture	0.1-1,0.5-1,1-1.2,1-2,1.4-2.5,2,7-10-flowered,base,bright,calyx,capitate,cm,cream-colored,ellipsoid,elliptic,exerted,glabrous,globose,green,greenish,lobe,lobed,long,mm,nearly,pale,papillate,poricidal,ridged,shiny,shrub,simple,soon,tapering,tip,white,yellow,yellowish	alternate
471	wfo-0001031587	success	142	101	74	84	58	17	71	3	.5,0.8-1,1-1.5,1.7-2,12-16,17-30,2-2.5,2-9-celled,2/3,5,abaxially,acute,adaxially,along,anther,apart,apex,attenuate,bark,base,bi-lobed,broadly,calyx,clavate,cm,conical,corolla,decurrent,dendritic,densely,denser,dia,drying,elliptic-ovoid,evenly,filament,fleshy,furcate,glabrous,golden-red,inflorescence,lamina,leaf,like,lobed,long,minutely,mm,oblique,ovary,pale,pedicel,petiole,pore,poricidal,pubescent,rarely,reddish-grey,rest,shape,shaped,simple,size,soft,somewhat,spaced,stem,stigma,style,surface,tear-drop,thick,thickened,tip,tree,trichome,tube,uniseriate,vein,verrucose,way,white,winged,x	1.5-2,10-15,2,3-4,6-7,6-8,7-9,anthesi,axi,closely,cone,deflexed,deltate,differing,eaf,edicel,eed,elliptic,erect,exserted,fide,free,globose,included,irregular,know,known,later,lateral,lobe,loose,lower,lowered,main,major,middle,minor,mostly,ocasionally,occasional,older,overlappin,pair,papillate,papillo,parallel,perpendicular,persisten,portion,rect,ruit,scar,steinbach,tall,tub,ud,widest,young	abaxial,characteristic,colour,diameter,form,fruit,growth,height,length,lobing,na,occasionally,papillose,plant,seed,texture,type	.5,0.8-1,1-1.5,1.7-2,12-16,17-30,2-2.5,2-9-celled,2/3,5,abaxially,acute,adaxially,along,apart,apex,attenuate,base,bi-lobed,broadly,clavate,cm,conical,decurrent,dendritic,densely,denser,dia,drying,elliptic-ovoid,evenly,fleshy,furcate,glabrous,golden-red,inflorescence,lamina,leaf,like,lobed,long,minutely,mm,oblique,pale,pore,poricidal,pubescent,rarely,reddish-grey,rest,shaped,simple,soft,somewhat,spaced,stem,surface,tear-drop,thick,thickened,tip,tree,trichome,uniseriate,vein,verrucose,way,white,winged,x	na,occasionally,papillose
472	wfo-0001031589	success	221	134	89	107	114	27	87	2	-6.5,.5,0-30,0.1-0.5,0.2-0.5,0.4,0.5-1,0.55-0.7,0.6-1.2,0.8-2.3,0.9-1.3,0.9-1.6,1-1.8,1.2-1.5,1.7-2.5,1.8-2.9,1/3-1/4,2.5-6,3-5,4-6.5,acute,anther,apex,articulated,attenuate,bark,base,berry,bright,brown-green,calyx,cell,chartaceous,cm,concolorous,cream,dark,densely,diameter,discolorous,drying,dull,elliptic,erect,filament,flattened-reniform,fruit,fruiting,glabrous,gray-green,green,lateral,leaf,length,lobed,long,long-obovate,margin,marking,maturity,mauve,membranous,mm,moderately,narrow-cuneate,occasionally,often,orange-brown,orange-green,outline,pair,pale,pedicel,per,petiole,pit,plant,poricidal,prickly,primary,raised,rounded,scandent,shiny,shrub,simple,small,smooth,sparsely,spherical,stellate,stellate-pubescent,stem,style,subentire,surface,tapering,tip,tube,vein,way,weakly,white,wide,yellow,yellow-green,young	-15,-6,/6,0,0-1,0-10,0-3,0.1,0.15-0.3,0.2-0.4-0.5,0.2-3,0.7,1,1-5,1.5-5,1/3,1/3-1/2,10-30,2-10,2-3-4,2-3.5,2.5-4.5,2.8-4,3-4,3/4,4/5,5-8,5-merous,6-8,8-14,8-30,abaxially,alyx,ame,apart,apically,apparently,blade,broadly,brow,c.,caudat,connivent,deltate,density,difoliate,distance,eed,elongating,equal,extending,eye,flower,free,geminat,glabrescent,higher,infructescence,lengt,lobe,lon,longer,lower,mature,midpoint,midvein,multangulate,naked,narrow,nflorescence,oblong,obovate,older,orolla,oung,part,pendulous,perfec,pericarp,porrect,portion,prickl,prickle,ray,reflexed,ruit,sessile,shorter,side,solitary,sometimes,somewhat,spaced,spreading,stalk,stalked,stout,straight,subsessile,tamen,terete,tertiary,time,trichome,unit,upper,vary,venation,visible,whole,winged,woody,yellow-orange,ympodial	arrangement,branch,brown,bud,characteristic,colour,corolla,exertion,form,glabrousnes,growth,height,history,inflorescence,life,lobing,na,new,number,ovary,peduncle,seed,shape,size,stigma,texture,type	-6.5,.5,0-30,0.1-0.5,0.2-0.5,0.4,0.5-1,0.55-0.7,0.6-1.2,0.8-2.3,0.9-1.3,0.9-1.6,1-1.8,1.2-1.5,1.7-2.5,1.8-2.9,1/3-1/4,2.5-6,3-5,4-6.5,acute,articulated,attenuate,base,berry,bright,brown-green,cell,chartaceous,cm,concolorous,cream,dark,densely,diameter,discolorous,dull,elliptic,erect,flattened-reniform,glabrous,gray-green,green,lateral,lobed,long,long-obovate,marking,maturity,mauve,membranous,mm,moderately,narrow-cuneate,occasionally,often,orange-brown,orange-green,outline,pair,pale,per,pit,poricidal,prickly,raised,rounded,scandent,shiny,shrub,simple,small,smooth,sparsely,spherical,stellate,stellate-pubescent,subentire,tapering,tip,way,weakly,white,wide,yellow,yellow-green,young	brown,na
473	wfo-0001031609	success	153	97	67	77	76	20	66	1	0.4-3,0.5-3,1-10,1-6,1.3-3,10-25,2-3,2-3-9-lobed,20-25,3-24,4,4-5,4-6,4.5-60,acute,apex,apiculate,around,base,brownish,calyx,campanulate,cm,connivent,cuneate,deltate,dia,diameter,dilated,directed,distally,ellipsoidal,elliptic,entire,flattened,fleshy,forked,fruit,glabrous,globose,green,inflorescence,laterally,leaf,lobed,margin,mm,obconical,obovate,obtuse,orange,pedicel,peduncle,petiole,pinnately,pore,puberulent,rachi,reticulate,ripe,shallowly,shrub,simple,small,stellate,stigma,strongly,style,succulent,tip,tree,triangular,truncate,unbranched,unlobed,x,yellow	.5,/4,0-30,0.5-1,1.5-2,1.5-3,2,2.5-4,3-5,3-foliat,5-25,5/6,8-20,abaxially,absen,absent,adaxially,aggregate,ape,articulated,axe,barely,beyond,bilobe,blade,branch,brow,cell,connective,conspicuous,contiguous,dark,divided,eaf,eed,elliptic-ovate,emerging,equal,exceeding,exserted,flower,glabrou,leaving,lobe,long,lower,midrib,minutely,nearly,nflorescence,nther,occasionally,orolla,papillose,pedicellar,point,radiu,rounded,ruit,scar,sinus,stamen,stone,succulen,tal,tem,thecae,time,tomento,tube,two,ud,unit,vary,wide,ympodial	anther,arrangement,bilobed,bud,characteristic,colour,corolla,direction,form,growth,height,length,plant,seed,shape,size,stem,surface,texture,type	0.4-3,0.5-3,1-10,1-6,1.3-3,10-25,2-3,2-3-9-lobed,20-25,3-24,4,4-5,4-6,4.5-60,acute,apex,apiculate,around,base,brownish,campanulate,cm,connivent,cuneate,deltate,dia,diameter,dilated,directed,distally,ellipsoidal,elliptic,entire,flattened,fleshy,forked,glabrous,globose,green,laterally,lobed,margin,mm,obconical,obovate,obtuse,orange,pinnately,puberulent,reticulate,ripe,shallowly,shrub,simple,small,stellate,strongly,succulent,tip,tree,triangular,truncate,unbranched,unlobed,x,yellow	bilobed
474	wfo-0001031615	success	154	97	63	75	79	22	59	4	.5,0,0.8-1,0.9-1.1,1-1.6,1.3-1.8,1.5,1.5-5,5-20-flowered,5-6,acuminate,acute,anther,apex,attenuate,bark,base,berry,bilobed,calyx,capitate,cm,corolla,decurrent,deep,dia,elliptic,exserted,flattened-reniform,fruit,fruiting,furcate,glabrous,glandular,globose,green,inflorescence,leaf,lobed,long,margin,minutely,mm,nearly,occasionally,older,opposite,ovary,pedicel,per,petiole,pitted,scarcely,shaped,shrub,simple,size,slender,small,stem,stigma,style,subumbellate,surface,tapering,tear-drop,tree,trichome,tube,tuft,uniseriate,white,winged,x,young	0.5,0.5-1,11-15.5,2-3,2-4.2,3.8-6.1,4-6.5,6-8,8-10,anthesi,arising,axil,ba,becoming,brown,caly,closely,dark,dark-papillo,deflexed,deltoid,differing,difoliate,distal,eaf,edicel,eed,expanded,filament,free,geminat,impressed,incrassate,interpetalar,lamina,lateral,less,lobe,lon,lower,main,major,maroo,middle,minor,minute,nflorescence,one,overlappin,packed,pair,paler,papillae,papillose,pore,poricidal,portion,prominent,reflexed,ruit,scar,shiny,sinus,slightly,somewhat,straight,tall,terminal,thickened,thin,tip,ud,unicellular,unit,urceolate,vein,widest,woody,ympodial	bud,characteristic,colour,dark-papillose,decurred,diameter,exertion,form,growth,height,history,length,life,lobing,maroon,number,perennial,plant,seed,shape,texture,type	.5,0,0.8-1,0.9-1.1,1-1.6,1.3-1.8,1.5,1.5-5,5-20-flowered,5-6,acuminate,acute,attenuate,base,berry,bilobed,calyx,capitate,cm,decurrent,deep,dia,elliptic,exserted,flattened-reniform,furcate,glabrous,glandular,globose,green,leaf,lobed,long,minutely,mm,nearly,occasionally,older,opposite,petiole,pitted,scarcely,shaped,shrub,simple,slender,small,subumbellate,tapering,tear-drop,tree,trichome,tube,tuft,uniseriate,white,winged,x,young	dark-papillose,decurred,maroon,perennial
475	wfo-0001031618	success	184	92	57	70	114	22	57	0	0-3,0.5-1.5,1-1.5,1-1.5-2,1.5-2,10-18,2-3,3-4,3-8,4-5,5-12,90-110,acute,anther,apex,axil,base,berry,branch,calyx,capitate,cm,corolla,cuneate,cyme,discoidal,ellipsoid,equal,erect,except,filament,finely,glabrous,glandular,greyish,growing,hair,lavender-purple,leaf,less,long,minute,mm,narrowly,obovoid,ovary,ovoid,pale,pedicel,peduncle,petiole,pinatisect,point,reddish-brown,reticulate,rounded,rugose,scorpioid,shrub,simple,somewhat,stem,stigma,surface,tapering,terete,unequal,variable,x,young	1-7,1.5-3.5,10-lobed,13,2-2.5,3,40-60,5,acuman,almost,also,anthesi,appearance,appearing,aspect,becoming,beyond,blunt,bluntly,broadly,c.,cell,clonal,cluster,column,conical,covering,cut,darker,developed,dia,eaf,eed,elliptic,emarginate,enlarged,exerted,extending,facetted,fleshy,floral,flower,fork,forked,frui,general,giving,greatly,gree,green,habit,half,interacuminal,lanceolate,lasting,lengthening,lobe,lobed,lon,loosely,lower,marbled,maturity,mauve,may,mid-vein,midrib,nflorescence,oblong,occasional,occur,often,ovate-lanceolate,pal,pedicellate,petal,plurifoliat,pore,poricidal,purple,rarely,rhachi,ripe,rotate,ruit,sessile,several,shallowly,side,single,sinus,slit,soft-wooded,sometimes,specimen,stone,stout,stripe,strongly,styl,succulent,tinged,tip,tissue,triangular,tub,ud,unit,vigorous,way,well,year,ympodial,younger	bud,characteristic,colour,diameter,form,fruit,glabrousnes,growth,height,history,inflorescence,length,life,number,per,plant,seed,shape,size,style,texture,type	0-3,0.5-1.5,1-1.5,1-1.5-2,1.5-2,10-18,2-3,3-4,3-8,4-5,5-12,90-110,acute,axil,berry,branch,capitate,cm,cuneate,cyme,discoidal,ellipsoid,equal,erect,except,finely,glabrous,glandular,greyish,growing,hair,lavender-purple,leaf,less,long,minute,mm,narrowly,obovoid,ovoid,pale,pinatisect,point,reddish-brown,reticulate,rounded,rugose,scorpioid,shrub,simple,somewhat,tapering,terete,unequal,variable,x,young	
476	wfo-0001031646	success	169	107	76	91	78	16	75	1	-pinnate,.2,0.2-0.8,0.5-2,0.8-1.5,1-1.8,1-10,1-6,1.2-2.5,1.5-3.5,15-25,2-10,2-2.5,2-3,2.5-10,20,4-8,5-6,5-7,5-7.5,7-8,8-15,abaxially,adaxially,anther,apart,apical,base,berry,blue,brown,calyx,chartaceous,cm,covered,darker,decreasing,densely,diameter,ellipsoidal,entire,filament,flattened,flower,fruit,glabrous,globose,green,hair,immature,lateral,leaf,leaflet,light,long,margin,maroon,mature,mm,multicellular,oblong,ovate-lanceolate,pedicel,peduncle,petiole,pubescence,pubescent,rachi,red,rotate-pentagonal,rugulose,scandent,shrub,simple,size,slightly,smooth,spreading,stem,stigma,stout,style,surface,tawny,toward,tube,uniseriate,vine,violet,x,yellow	.5,1.5-4,18-38,1962,3.5-4,4-18,4-20,4-5,4-foliate,5-merou,absen,absent,accrescent,acuminate,acut,acute,aggregate,alyx,apex,apparently,articulated,axe,ba,basally,blade,branched,cell,ciliat,climbing,connivent,correll,cuneate,cylindrical,directed,distall,eaf,eed,elliptic,elliptic-lanceolate,equal,fide,fruiting,geminat,glandular,high,highly,homostylous,hyaline,interjected,lobe,lower,nflorescence,oblique,obliquely,obtuse,orolla,ovate-lanceolat,part,perfect,petiolule,pore,present,pubescen,rounded,ruit,seudostipule,shortly,small,spaced,stone,tamen,tem,tip,tree,truncat,unit,vary,ympodial	arrangement,characteristic,colour,corolla,form,growth,inflorescence,length,ovary,pseudostipule,seed,shape,spacing,texture,truncate,type	-pinnate,.2,0.2-0.8,0.5-2,0.8-1.5,1-1.8,1-10,1-6,1.2-2.5,1.5-3.5,15-25,2-10,2-2.5,2-3,2.5-10,20,4-8,5-6,5-7,5-7.5,7-8,8-15,abaxially,adaxially,apart,base,berry,blue,brown,chartaceous,cm,covered,darker,decreasing,densely,diameter,ellipsoidal,entire,flattened,flower,fruit,glabrous,globose,green,hair,immature,leaf,light,long,maroon,mature,mm,multicellular,oblong,ovate-lanceolate,pubescence,pubescent,red,rotate-pentagonal,rugulose,scandent,shrub,simple,size,slightly,smooth,spreading,stout,tawny,toward,uniseriate,vine,violet,x,yellow	truncate
477	wfo-0001031651	success	199	173	141	155	44	18	138	3	-3,-3.5,.1,.6,.7,/5,0-20,0.1,0.1-0.15,0.1-0.2,0.1-0.25,0.2-0.5,0.3-0.5,0.3-0.8,0.3-1.5,0.6-1,0.6-1.3,0.7-1,1-1.7,1-2,1-4,1.2-2,1.2-3,1.3-1.6,1.5-2,1/5,2-10,2-3,2-3.5,4-5,4-6,4.5-7,5-merous,abaxial,abaxially,absent,acute,adaxial,ame,anther,apart,apex,apically,apparently,bark,base,berry,blade,branched,brown,c.,calyx,cell,chartaceous,cm,concolorous,cordate,curved,dark,deltate,densely,diameter,discolorous,drying,dull,elliptic,entire,equal,filament,filiform,flattened-reniform,flower,free,fruit,fruiting,glabrescent,glabrous,gray,herb,lanceolate,lateral,leaf,length,lobe,lobed,long,longer,lower,margin,maturity,midpoint,mm,oblong,obtuse,one,open,orange-brown,outline,ovate,pedicel,peduncle,per,persistent,petiole,pit,poricidal,porrect,portion,prickle,prickly,purple,raised,ray,red,red-green,reflexed,rounded,scar,shorter,shrub,simple,small,smooth,sometimes,spaced,spherical,spreading,stalk,stalked,stellate,stellate-pubescent,stem,straight,style,subentire,surface,tapering,terete,terminal,thick,thick-stalked,time,tip,toward,trichome,tube,unarmed,upper,variously,way,weakly,white,wide,yellow,yellow-green	/3,0.15-0.2,1/6-1/4,2/3-3/,3-5,acuminat,alyx,apar,articulated,difoliate,eaf,eed,elongating,erect,eye,faint,geminat,gra,herbaceous,infructescence,mature,naked,nflorescence,older,orolla,oung,pair,pendulous,perfec,pericarp,prickl,primary,ruit,scandent,subsessile,tamen,tertiary,unarme,unit,vary,vein,venation,visible,ympodial	2/3-3/4,acuminate,characteristic,colour,corolla,form,growth,height,inflorescence,ovary,perfect,plant,seed,size,staman,texture,type,young	-3,-3.5,.1,.6,.7,/5,0-20,0.1,0.1-0.15,0.1-0.2,0.1-0.25,0.2-0.5,0.3-0.5,0.3-0.8,0.3-1.5,0.6-1,0.6-1.3,0.7-1,1-1.7,1-2,1-4,1.2-2,1.2-3,1.3-1.6,1.5-2,1/5,2-10,2-3,2-3.5,4-5,4-6,4.5-7,5-merous,abaxially,absent,acute,ame,apart,apically,apparently,base,berry,blade,branched,brown,c.,cell,chartaceous,cm,concolorous,cordate,curved,dark,deltate,densely,diameter,discolorous,drying,dull,elliptic,entire,equal,filament,filiform,flattened-reniform,flower,free,glabrescent,glabrous,gray,herb,lanceolate,lateral,length,lobe,lobed,long,longer,lower,maturity,midpoint,mm,oblong,obtuse,one,open,orange-brown,outline,ovate,per,persistent,pit,poricidal,porrect,portion,prickly,purple,raised,ray,red,red-green,reflexed,rounded,shorter,shrub,simple,small,smooth,sometimes,spaced,spherical,spreading,stalk,stalked,stellate,stellate-pubescent,straight,subentire,surface,tapering,terete,terminal,thick,thick-stalked,time,tip,toward,trichome,tube,unarmed,upper,variously,way,weakly,white,wide,yellow,yellow-green	2/3-3/4,acuminate,perfect
478	wfo-0001031656	success	154	84	46	60	94	24	44	2	/4,1-2.5,1.2-1.5,1.5-2,1.5-5,10-20,2.5-3.5,4-9,5-7,6-8,acuminate,acute,anther,anthesi,apex,bark,base,berry,calyx,capitate,cm,corolla,dia,ellipsoid,elliptic,fruit,fruiting,glabrous,globose,green,greyish,lateral,leaf,long-acuminate,main,minutely,mm,oblique,opposite,ovary,ovate,pair,pedicel,petiole,plant,red-papillose,rounded,sessile,shaped,shrub,size,stem,stigma,style,surface,tear-drop,vein,way,white,x	.5,0.5,0.5-1,1-1.5,1-2,3-3.5,3-5,5-ribbed,also,arising,ba,bright,closely,cork,densely,differing,difoliate,directly,drying,eaf,edicel,eed,enclosing,erect,extremely,filament,fleshy,flower,free,geminat,hooded,known,live,lobe,lobed,lon,long,lower,major,margin,matte,mature,middle,minor,minute,nflorescence,node,often,older,one,pale,paler,papillo,papillose,peelin,persistent,planar,pore,poricidal,portion,prominent,proximal,rather,reddish,reflexed,rib,ridged,ruit,scar,shiny,slightly,somewhat,spaced,specimen,straight,strongly,swollen,tall,terminal,thick,thickened,tip,top,transversely,tube,ud,unit,upper,visible,wide,widest,woody,ympodial,young	arrangement,bud,characteristic,colour,diameter,exertion,form,growth,height,history,inflorescence,length,life,lobing,na,number,peduncle,per,perennial,primary,seed,shape,texture,type	/4,1-2.5,1.2-1.5,1.5-2,1.5-5,10-20,2.5-3.5,4-9,5-7,6-8,acuminate,acute,anthesi,base,berry,capitate,cm,dia,ellipsoid,elliptic,glabrous,globose,green,greyish,lateral,leaf,long-acuminate,main,minutely,mm,oblique,opposite,ovate,pair,red-papillose,rounded,sessile,shaped,shrub,tear-drop,vein,way,white,x	na,perennial
479	wfo-0001031667	success	153	70	36	49	104	21	35	1	0.6-1,1-1.5,1.4-3,1.5-2,10-13,12-35,2-5,2.5-5,3-13,3-5,5-9,6-10,8-13,8-15,branched,calyx,cm,corolla,cyme,diameter,dichasial,dichasially,ebracteate,globose,green-white,herbaceous,interjected,lateral,leaf,leaflet,long,mm,monochasial,odd-pinnate,ovoid,pedicel,peduncle,perennial,petiole,pilose,plant,seed,size,stellate,style,terminal,throughout,white,yellow	0.6-1.5,1-4,2-3,2-6,3-6-foliat,3-8,4-1.,5-15,abaxially,abruptly,acumen,acuminate,acute,adaxially,apex,apical,apically,apiculate,articulate,base,caudate,cell,connate,cordate,covering,cuneate,dark,dehiscent,digestion,diminishing,distal,dorsally,eaf,edge,eed,elliptic-lanceolate,emoval,enzyme,exceeding,filament,flat,flower,folded,forked,generally,globo,green,hair-like,half,honeycomb,introrse,irregularly,lanceolate,living,lobe,lobed,lon,lower,lunat,make,maturing,mucilaginous,nflorescence,nther,oblique,oblong,often,orolla,pair,pattern,perfect,petiolate,petiolule,plan,poricidally,proximal,reveal,rounded,ruit,sessile,seudostipule,short,slit,specimen,spot,stamen,stigma,straight,stripe,tal,tem,testal,thick,toward,tuber-bearing,typically,unit,vary,wall,whit,wide,without,ympodial,Â¼	4-10,abaxial,adaxial,anther,arrangement,characteristic,colour,form,fruit,growth,height,history,inflorescence,length,life,ovary,pseudostipule,shape,stem,texture,width	0.6-1,1-1.5,1.4-3,1.5-2,10-13,12-35,2-5,2.5-5,3-13,3-5,5-9,6-10,8-13,8-15,branched,cm,cyme,dichasial,dichasially,ebracteate,globose,green-white,herbaceous,long,mm,monochasial,odd-pinnate,ovoid,perennial,pilose,stellate,style,throughout,white,yellow	4-10
480	wfo-0001031672	success	157	130	68	78	79	52	67	1	0-2,0.3-0.5,0.5-1.5,1-2,1-5,1.5-2,1.5-2.5,1.5-3.5,1.5-5,10-20,15-20,15-50,2-12,2-28,4,4-34,6,9-lobed,acuminate,acute,apex,apiculate,basal,base,beyond,calyx,chartaceous,cm,cordate,densely,diameter,entire,exserted,flattened,flower,fruit,glabrous,globose,green,greenish-brown,hair,lanceolate,leaf,lobe,lobed,long,margin,mature,mm,moderately,narrowly,obtuse,ovoid,pedicel,peduncle,petiole,pilose,pinnately,puberulent,rounded,simple,sparsely,stamen,stellate,stigma,style,subcoriaceous,tip,tree,triangular,truncate,tube,unbranched,unlobed,white,whitish,x,yellow	0,0.5,0.5-1,1,1-1.5,1-1.5-2.5,1-10,3-4-foliat,3/4,4.5-5,4/5,5-6,abaxially,absent,adaxially,aggregate,apart,ape,articulated,aublet,axe,blade,cell,ciliat,connective,cylindrical,directed,distally,divided,eaf,eed,exceeding,fide,fleshy,glandular-puberulent,leaving,lon,lower,membranaceous,midrib,near,nflorescence,nther,occasionally,often,one,orolla,ovate,pedicellar,perfect,pilo,pore,presen,present,pubescent,purple,rachi,radiu,remant,represented,ruit,shorter,sinus,slightly,small,spaced,stone,tal,tem,thecae,time,toward,truncat,ud,unit,vary,wide,yello,ympodial	anther,appearance,arrangement,bark,border,branch,bud,characteristic,colour,corolla,corrugation,distal,drying,exertion,filament,form,fruiting,giving,glabrousnes,growth,height,history,inflorescence,interjected,lateral,leaflet,length,life,lobing,midpoint,na,new,number,ovary,per,plant,prickle,primary,pseudostipule,ray,seed,shape,size,stem,surface,terminal,texture,thicknes,type,variation,vein,width	0-2,0.3-0.5,0.5-1.5,1-2,1-5,1.5-2,1.5-2.5,1.5-3.5,1.5-5,10-20,15-20,15-50,2-12,2-28,4,4-34,6,9-lobed,acuminate,acute,apex,apiculate,basal,beyond,chartaceous,cm,cordate,densely,entire,exserted,flattened,flower,fruit,glabrous,globose,green,greenish-brown,hair,lanceolate,lobe,lobed,long,mature,mm,moderately,narrowly,obtuse,ovoid,pilose,pinnately,puberulent,rounded,simple,sparsely,stamen,stellate,subcoriaceous,tip,tree,triangular,truncate,unbranched,unlobed,white,whitish,x,yellow	na
481	wfo-0001031684	success	161	126	99	107	54	19	96	3	.25,.5,.75,/4,0.4-1.5,0.5-0.8,0.5-1,0.7-1,1-1.2,1-5,10-100,2,2-9,3-3.5,3-30,4-17,acuminate,acute,along,anther,apex,bark,base,bearing,beneath,berry,black,borne,branched,calyx,clavate,cm,corolla,curly,decurrent,densely,dia,difoliate,drying,elliptic,expanded,exserted,filiform,flower,fruiting,geminate,glabrous,globose,green,inflorescence,internodal,irregularly,leaf,like,lobe,lobed,long,long-triangular,lower,minutely,mm,obconic,occasionally,older,opposite,ovary,ovoid-reniform,pale,papillose,pedicel,persistently,petiole,pitted,previously,pubescent,rest,scar,shaped,short,shrub,size,slender,slightly,small,soon,sparsely,stem,stigma,straight,style,surface,tan,tapering,tear-drop,time,tipped,tree,trichome,tube,unifoliate,uniseriate,vein,way,white,winged,x,young	0.1,0.5-0.7,0.75-1,5-7,anthesi,apar,causing,deflexed,denser,differing,eaf,edicel,eed,elongated,except,extremely,filament,free,gre,greatly,lateral,less,lon,main,major,middle,midrib,minor,nflorescence,one,pair,papillo,planar,pore,poricidal,portion,present,pulled,raised,reflexe,reflexed,ruit,single,siz,spaced,tall,tip,ud,unevenly,unit,varying,widely,widest,ympodial	arrangement,characteristic,colour,diameter,exertion,form,fruit,grey,growth,height,history,length,life,lobing,plant,seed,shape,texture,type	.25,.5,.75,/4,0.4-1.5,0.5-0.8,0.5-1,0.7-1,1-1.2,1-5,10-100,2,2-9,3-30,4-17,acuminate,acute,along,apex,base,bearing,beneath,berry,black,borne,branched,calyx,clavate,cm,curly,decurrent,densely,dia,difoliate,drying,elliptic,expanded,exserted,filiform,flower,geminate,glabrous,globose,green,inflorescence,internodal,irregularly,leaf,like,lobe,lobed,long,long-triangular,lower,minutely,mm,obconic,occasionally,older,opposite,ovoid-reniform,pale,papillose,persistently,petiole,pitted,previously,pubescent,rest,scar,shaped,short,shrub,slender,slightly,small,soon,sparsely,stem,straight,tan,tapering,tear-drop,time,tipped,tree,trichome,tube,unifoliate,uniseriate,vein,way,white,winged,x,young	-3.5,di,grey
482	wfo-0001031695	success	183	112	72	86	97	26	69	3	0.5-1,0.5-2,1-2,1-9,1.5-2,1.5-8,2-3,2-4,2-5,2.5-5,20-30,3-10,3-17,3-19,3-7,30-40,4-10,4-5,4-6,5-20,5-7,6-10,6-20,6-8,abruptly,acuminate,also,apex,base,branched,broadened,calyx,campanulate,cm,connective,cordate,dark,deep,densely,diameter,ellipsoidal,entire,flattened,fruit,glabrous,green,greenish,hard,immature,lanceolate,lavender,leaf,lobe,lobed,margin,mm,moderately,mottled,narrowly,oblique,oblong,occasionally,ovate,pedicel,peduncle,petiole,pilose-hirsute,puberulent,pubescent,purple,purplish,rachi,radiu,remnant,shrub,simple,sometimes,sparsely,stigma,stripe,style,tree,triangular,unbranched,x,yellow	1,1-3,1/2,1/3,10-15-20,10-35,3-4-6,4-foliat,5,7-10-15,?,abaxially,acute,adaxially,aggregate,apart,ape,apically,apiculate,articulated,axe,basal,beyond,blade,capitat,cell,chartaceous,color,connivent,cylindrical,d,dilated,directed,divided,eaf,eed,eglandular,eglandular-pilose,exceeding,exserted,fleshy,flower,glabrate,glabrescent,glandular-puberulent,hair,lateral,laterally,leaving,lilac,lon,long,lower,midrib,nflorescence,nther,obtuse,often,orolla,ovoid,pedicellar,perfect,pilo,pilose,pilose-hirsut,pore,presen,present,puberulent-pubescent,ripe,rounded,ruit,shorter,sinus,slight,slightly,small,somewhat,spaced,stamen,stone,subcoriaceous,swelling,tal,tem,thecae,time,tip,tomento,tube,unequal,unit,unknown,unlobed,vary,wide,ympodial	10-20,anther,arrangement,capitate,characteristic,colour,corolla,form,glabrousnes,growth,height,history,inflorescence,length,life,ovary,perennial,plant,seed,shape,size,spacing,stem,surface,texture,theca	0.5-1,0.5-2,1-2,1-9,1.5-2,1.5-8,2-3,2-4,2-5,2.5-5,20-30,3-10,3-17,3-19,3-7,30-40,4-10,4-5,4-6,5-20,5-7,6-10,6-20,6-8,abruptly,acuminate,also,branched,broadened,campanulate,cm,cordate,dark,deep,densely,ellipsoidal,entire,flattened,glabrous,green,greenish,hard,immature,lanceolate,lavender,lobed,mm,moderately,mottled,narrowly,oblique,oblong,occasionally,ovate,pilose-hirsute,puberulent,pubescent,purple,purplish,shrub,simple,sometimes,sparsely,stripe,tree,triangular,unbranched,x,yellow	10-20,capitate,perennial
483	wfo-0001031698	success	56	46	26	31	25	15	24	2	2-2.5,2.5,2.5-3,4-4.5,bark,base,branch,cm,dull,elliptic,flattened,fruiting,glabrous,green,leaf,minutely,mm,pale,pedicel,pitted,reddish-brown,reniform,repandly,rugose,shrub,stem,stout,strongly,surface,winged,x	ape,decurrent,deflexed,dia,difoliate,eaf,eed,fide,geminat,incrassate,long,maguire,margin,older,otherwise,paler,papillae,persistin,tall,unit,wing,woody,yellowish,ympodial,young	1,apex,arrangement,characteristic,colour,diameter,form,growth,height,length,plant,seed,shape,size,texture	2-2.5,2.5,2.5-3,4-4.5,base,cm,dull,elliptic,flattened,glabrous,green,minutely,mm,pale,pitted,reddish-brown,reniform,repandly,rugose,shrub,stout,strongly,winged,x	1,apex
484	wfo-0001031707	success	178	139	110	117	61	22	105	5	/4,0.5-1,1-1.2,1-1.3,1-1.5,1-3,1.2-1.8,1.2-2,1.5-1.7,1.5-6,1/3,16-20,2,2-3,2-4,2-6,24,3,6-7,8-12,9-15,acuminate,acute,almost,along,anther,anthesi,apex,apically,attenuate,axil,axillary,base,basiscopically,bearing,berry,brown,calyx,capitate,cm,conical,conspicuously,corolla,cucullate,densely,diameter,distal,drying,elliptic,enlarged,erect,exserted,flattened,flower,four-lobed,fruiting,glabrous,globose,green,greenish,lanceolate,leaf,leaflet,lobe,long,margin,minutely,mm,narrowly,oblique,obovate,occasionally,open,ovary,pair,papillate,pedicel,per,petiole,petiolule,pink,pinnate,planar,plant,pointed,poricidal,pubescent,raised,reddish,round,sagittate,scar,simple,slightly,smooth,somewhat,spaced,sparsely,stigma,stout,strongly,style,surface,ternate,time,tip,trichome,tube,type,uniseriate,vine,way,white,white-lenticellate,widely,woody,x	-3,.5,1.5-2,2-10,4-5,4-6,5-10-celled,80-140,abaxially,absent,adaxially,apical,basal,c.,cateniform,cell,clavat,climbing,dense,distinct,eaf,edicel,eed,endrophilum,epidermal,filament,flap-like,flat,fleshy,free,high,horizonta,inflorescenc,lateral,less,like,lobed,lon,lower,narrower,nflorescence,penden,portion,primary,quadrate,quite,regular,rest,ruit,scattered,smaller,tem,terminal,thickening,tub,ud,unifoliat,unit,usually,vein,ympodial	0.5,arrangement,bud,cateniforme,characteristic,clavate,colour,form,fruit,growth,height,history,horizontal,inflorescence,length,life,lobing,seed,shape,size,stem,texture	/4,0.5-1,1-1.2,1-1.3,1-1.5,1-3,1.2-1.8,1.2-2,1.5-1.7,1.5-6,1/3,16-20,2,2-3,2-4,2-6,24,3,6-7,8-12,9-15,acuminate,acute,almost,along,anthesi,apex,apically,attenuate,axil,axillary,base,basiscopically,bearing,berry,brown,calyx,capitate,cm,conical,conspicuously,cucullate,densely,diameter,distal,drying,elliptic,enlarged,erect,exserted,flattened,flower,four-lobed,glabrous,globose,green,greenish,lanceolate,leaflet,lobe,long,margin,minutely,mm,narrowly,oblique,obovate,occasionally,open,pair,papillate,pedicel,per,pink,pinnate,planar,pointed,poricidal,pubescent,raised,reddish,round,sagittate,scar,simple,slightly,smooth,somewhat,spaced,sparsely,stout,strongly,ternate,time,tip,trichome,tube,uniseriate,vine,way,white,white-lenticellate,widely,woody,x	0.5,cateniforme,clavate,horizontal,inflorescence
485	wfo-0001031723	success	218	160	123	140	78	20	123	0	-1.5,-15,0-2,0.1-0.2,0.2-1,0.4,0.4-0.9,0.4-1,0.4-1-2.5-5,0.55-0.9,0.6-1,0.7-1,0.8-1.5,1-15-45,1-2,1-3,1.2-2,2-3.5,2-4-11,2.5-4.5,2.5-5,2/3-3/4,4-6,5-9,8-20,abaxial,abaxially,acuminate,acute,adaxial,ame,anther,apex,apically,apparently,articulated,bark,base,berry,branched,branching,brown,c.,calyx,chartaceous,cm,connivent,cuneate,curved,dark,deltate,densely,diameter,discolorous,drying,dull,elongated,entire,erect,evenly,filament,filiform,finely,flattened-reniform,fruit,fruiting,gently,glabrous,glandular,green,hair,lateral,leaf,length,lobe,lobed,long,margin,marking,maturity,mauve,midpoint,minute,mm,moderately,multangulate,narrow-deltate,near,obtuse,orange,orange-brown,ovate,pale,pedicel,peduncle,per,petiole,poricidal,porrect,prickle,prickly,primary,ray,recurved,red,reflexed,rounded,secondary,sessile,shrub,simple,sometimes,sparsely,spherical,spreading,stalked,stellate,stellate-pubescent,stem,straight,strongly,style,subentire,surface,tapering,terminal,tip,trichome,tube,unarmed,usually,variously,way,weakly,white,whitish,wide,yellow,yellow-green,young	-6,-8,-merous,0.05-0.2,0.1-0.3,0.1-0.5,0.15,1-2-5.5-6.5,1-3-10,1-5,1-5-40,1.5-10,1.5-2.5,1.5-4-10-16,1/3-1/2,1/6-1/4-1/3-1/2,10-30,2-7,2/3,3-15,4-10-30,4-20,4-5,acut,alyx,apar,apart,ba,blade,brow,conical,eaf,eed,elongating,equal,eye,flower,free,glabrescent,gland,gland-tipped,gray,herbaceous,inflated,infructescence,longer,lower,mature,naked,nflorescence,older,one,open,orolla,oung,pair,perfec,pericarp,perpendicular,plurifoliat,portion,ruit,scar,smooth,spaced,stalk,tamen,terete,tertiary,time,unarme,unit,vary,vein,venation,visible,woody,ympodial	arrangement,branch,characteristic,colour,corolla,exertion,form,glabrousnes,growth,height,inflorescence,lobing,new,ovary,plant,seed,shape,size,texture,type	-1.5,-15,0-2,0.1-0.2,0.2-1,0.4,0.4-0.9,0.4-1,0.4-1-2.5-5,0.55-0.9,0.6-1,0.7-1,0.8-1.5,1-15-45,1-2,1-3,1.2-2,2-3.5,2-4-11,2.5-4.5,2.5-5,2/3-3/4,4-6,5-9,8-20,abaxially,acuminate,acute,ame,apex,apically,apparently,articulated,base,berry,branched,branching,brown,c.,chartaceous,cm,connivent,cuneate,curved,dark,deltate,densely,diameter,discolorous,drying,dull,elongated,entire,erect,evenly,filiform,finely,flattened-reniform,gently,glabrous,glandular,green,hair,lateral,length,lobe,lobed,long,marking,maturity,mauve,midpoint,minute,mm,moderately,multangulate,narrow-deltate,near,obtuse,orange,orange-brown,ovate,pale,per,poricidal,porrect,prickle,prickly,primary,ray,recurved,red,reflexed,rounded,secondary,sessile,shrub,simple,sometimes,sparsely,spherical,spreading,stalked,stellate,stellate-pubescent,straight,strongly,subentire,tapering,terminal,tip,trichome,unarmed,usually,variously,way,weakly,white,whitish,wide,yellow,yellow-green,young	
486	wfo-0001031729	success	159	128	91	96	63	32	84	7	-2,..,0.5,0.5-1,1-1.5,1-2,1.0-1.3,1.5,1.5-2,11-30-45,12-13,2-2.5,2-3,2.5-,2.5-5,3-4,3.5-4,4.1-16,5-10-20,5-6,5-7,abruptly,acuminate,along,anther,apex,attenuate,base,beneath,branch,branched,calyx,cm,conical,corolla,dark,darker,diameter,drying,elliptic,filament,flattened,fruit,fruiting,glabrous,globose,gradually,green,greenish,later,less,lobed,long,markedly,middle,mm,mottling,nearly,obovate,occasionally,ovary,ovate-reniform,pair,pale,papillae,papillate,pedicel,peduncle,per,pink,point,pointed,primary,purplish,reddish,scattered,short,shrub,single,small,smooth,somewhat,stem,stigma,stripe,surface,tan,time,toward,trichome,tube,vein,white,widening,x,young	-0.5,0.5-4,0.6-1-2.5,1-1.5-2,3-celled,50,8-9,anthesi,apicula,apiculate-deltate,branc,brittle,brow,c.,cell,cucullate,curve,deltate,dry,eaf,edicel,eed,elongate,erec,flattened-capitat,flower,glandular,lobe,lower,membranous,minute,minutely,narrowly,never,nflorescence,noddin,open,outer,outline,papillose,pericarp,petiole,planar,plurifoliat,quadrate,regularly,ruit,scar,single-stemmed,sinuate,striate,testa,thin,thing,tip,triangular,tuft,ud,unit,usually,wall,wand-like,ympodial	0-0.5,arrangement,brown,bud,characteristic,colour,curved,exertion,flattened-capitate,form,glabrousnes,growth,height,history,inflorescence,leaf,length,life,lobing,margin,na,new,nodding,number,plant,plurifoliate,seed,shape,size,style,texture,type	-2,..,0.5,0.5-1,1-1.5,1-2,1.0-1.3,1.5,1.5-2,11-30-45,12-13,2-2.5,2-3,2.5-,2.5-5,3-4,3.5-4,4.1-16,5-10-20,5-6,5-7,abruptly,acuminate,along,anther,attenuate,base,beneath,branched,cm,conical,dark,darker,diameter,drying,elliptic,flattened,fruit,glabrous,globose,gradually,green,greenish,later,less,lobed,long,markedly,middle,mm,mottling,nearly,obovate,occasionally,ovate-reniform,pair,pale,papillae,papillate,per,pink,point,pointed,purplish,reddish,scattered,short,shrub,single,small,smooth,somewhat,stigma,stripe,surface,tan,time,toward,trichome,vein,white,widening,x,young	0-0.5,brown,curved,flattened-capitate,na,nodding,plurifoliate
487	wfo-0001031738	success	230	133	94	114	116	19	93	1	0-15,0-2,0.7-1,0.7-1.1,0.9-2.1,1-1.5,1-1.8,1-4,1.4-1.7,1.5-4,1/2-2/3,1/3,10-15,15-40,2-3-4,2.3-3,4,4-8,abaxial,acute,adaxial,anther,apex,apparently,articulated,auriculate,bark,base,berry,branched,calyx,cell,chartaceous,cm,connivent,cordate,dark,deltate,densely,diameter,discolorous,drying,dull,erect,evenly,filament,flattened-reniform,frequently,fruit,fruiting,glabrescent,glabrous,gray,green,lateral,leaf,length,lobe,lobed,lobing,long,margin,maturity,mm,multangulate,orange,orange-brown,outline,ovate,pale,pedicel,peduncle,petiole,pit,plant,poricidal,porrect,prickle,prickly,prominent,raised,reflexed,shrub,side,simple,small,smooth,sometimes,spherical,spreading,stalked,stellate-pubescent,stem,strongly,style,surface,tapering,terminal,tip,tree,trichome,truncate,tube,unarmed,upper,variously,way,weakly,white,yellow,yellow-green,yellow-orange,yellowish,young	-5,-merous,.5,0-3,0.1-0.25,0.2-0.3,0.25-0.8,0.3-1,1-3,1.5-2-4-5,1/,1/3-2/3,1/4-1/3,1/6-1/4,20-200,3-4,3-6,3-7,3.5-3.8,3.5-4.5,4-10,4-5,4-6,5,5-6,5-8,6-15,7-12,7-12.5,8-10,8-10-15,8-18,abaxially,acuminat,adaxially,almost,always,alyx,andromonoecious,apar,apart,apically,blade,curved,distal,distance,eaf,eed,elongating,equal,extending,flattened,flower,free,held,hermaphrodite,heterostylous,infructescence,inside,long-styled,longer,lower,lowermost,mature,midpoint,midvein,narrow-deltate,nflorescence,oblong,obovate,often,older,one,open,orolla,oung,pair,per,pericarp,plurifoliat,poorly,portion,prickl,primary,pubescent,ray,resin,rounded,ruit,scar,secondary,sessile,short-styled,shorter,spaced,sparsely,stalk,staminat,stellate,sticky,stout,straight,tamen,terete,tertiary,time,unit,usually,vary,vein,venation,visible,white-brow,wide,woody,ympodial	arrangement,branch,characteristic,colour,corolla,exertion,form,glabrousnes,growth,height,inflorescence,new,ovary,seed,shape,size,texture,type,white-brown	0-15,0-2,0.7-1,0.7-1.1,0.9-2.1,1-1.5,1-1.8,1-4,1.4-1.7,1.5-4,1/2-2/3,1/3,10-15,15-40,2-3-4,2.3-3,4,4-8,acute,apparently,articulated,auriculate,base,berry,branched,cell,chartaceous,cm,connivent,cordate,dark,deltate,densely,diameter,discolorous,drying,dull,erect,evenly,flattened-reniform,frequently,glabrescent,glabrous,gray,green,lateral,lobe,lobed,long,maturity,mm,multangulate,orange,orange-brown,outline,ovate,pale,pit,poricidal,porrect,prickle,prickly,prominent,raised,reflexed,shrub,side,simple,small,smooth,sometimes,spherical,spreading,stalked,stellate-pubescent,strongly,tapering,terminal,tip,tree,trichome,truncate,unarmed,upper,variously,way,weakly,white,yellow,yellow-green,yellow-orange,yellowish,young	white-brown
488	wfo-0001031752	success	166	142	81	90	76	52	80	1	-10,0.5-1,1,1-2,1-4,1.5-3,1.5-3.5-6,15-25,15-40-100,2-2.5,2-5,20-35,3-11.5,3-4,3-7,3.5-5,5-23,5-8,acuminate,acute,apex,apiculate,basal,base,beyond,calyx,chartaceous,cm,connivent,cuneate,darker,deltate,diameter,ellipsoidal,elliptic,entire,exserted,flattened,flower,fruit,fusiform,glabrescent,glabrous,gland,glandular-puberulent,green,immature,lanceolate,less,light,lobe,margin,mm,moderately,narrowly,oblong,often,older,ovate,ovoid,pedicel,peduncle,petiole,pink,puberulent,purplish,ripe,rounded,rugose,shrub,simple,small,stalked,stamen,stigma,stripe,style,subcordate,subcoriaceous,tip,tree,triangular,truncate,tube,unbranched,white,wide,x,yellow,young	-pubescent,0.5-1.5,1-1.5,1-1.5-2.5-3,1-3,1.5-10.5-44,1.5-2,2-3,3-4-foliat,3.5-15-47,5-6,8-15,9-16,abaxially,adaxially,aggregate,apart,ape,articulated,axe,blade,cell,ciliat,ciliate,connective,cylindrical,densely,directed,distally,eaf,eed,equal,exceeding,fleshy,glabrate,glandular-puberulen,leaving,linear,lon,long,lower,membranaceous,near,nearly,nflorescence,nther,obtuse,olde,orolla,pedicellar,perfect,pore,presen,present,pubescent,purpl,rachi,radiu,remnant,ruit,slightly,spaced,sparsely,stellate,stone,swelling,tal,tem,thecae,time,tomentose,truncat,ud,unit,vary,ympodial	anther,appearance,arrangement,bark,border,branch,bud,characteristic,colour,corolla,distal,drying,exertion,filament,form,fruiting,giving,glabrousnes,growth,height,history,inflorescence,interjected,lateral,leaf,leaflet,length,life,lobing,midpoint,na,new,number,ovary,per,plant,prickle,primary,pseudostipule,ray,seed,shape,size,stem,surface,terminal,texture,thicknes,type,variation,vein,width	-10,0.5-1,1,1-2,1-4,1.5-3,1.5-3.5-6,15-25,15-40-100,2-2.5,2-5,20-35,3-11.5,3-4,3-7,3.5-5,5-23,5-8,acuminate,acute,apex,apiculate,basal,beyond,chartaceous,cm,connivent,cuneate,darker,deltate,ellipsoidal,elliptic,entire,exserted,flattened,flower,fruit,fusiform,glabrescent,glabrous,gland,glandular-puberulent,green,immature,lanceolate,less,light,lobe,mm,moderately,narrowly,oblong,often,older,ovate,ovoid,pink,puberulent,purplish,ripe,rounded,rugose,shrub,simple,small,stalked,stamen,stripe,subcordate,subcoriaceous,tip,tree,triangular,truncate,unbranched,white,wide,x,yellow,young	na
489	wfo-0001031756	success	186	114	73	88	98	26	71	2	.5,.8,/2,0-2,0.4-1.6,0.5-1,0.5-1.3,0.6-1.2,0.6-1.6,0.7-1.7,0.8-1,1-4,1.5-2,1.8-2.5,3-5,4-5,4.5,abaxially,anther,apex,articulated,bark,base,berry,broad-deltate,calyx,cm,color,cordate,curved,densely,diameter,entire,erect,evenly,eye,filament,finely,flattened-reniform,fruit,fruiting,glabrous,gray,green,known,leaf,lobed,long,margin,mature,mauve,mm,moderately,naked,orange-brown,ovate,pair,pale,pedicel,peduncle,petiole,pitted,poricidal,prickly,primary,rounded,shoot,short,shrub,simple,slender,spherical,stellate-pubescent,stem,style,surface,tapering,terminal,tip,truncate,tube,vein,visible,way,white,wide,yellow-green,young	-5,.1,0,0-1,0-5,0.02-0.2,0.1,0.15-0.25,0.2,00,1-1.8,1-2,1-3,1.5-3.5,1/2,1/3,10,2-6,3-15,3-7,5-merous,6-9,7-10,9-14,accrescent,acut,alyx,apar,apart,apically,apparently,blade,branched,chartaceous,concolorous,conical,connivent,deltate,drying,eaf,eed,elongating,enclosing,equal,flower,free,fully,glabrescent,glabrou,herbaceous,inflated,infructescence,invested,lobe,longer,lower,midpoint,nflorescence,older,one,open,orolla,oung,pendulous,per,perfec,pericarp,perpendicular,plurifoliat,porrect,portion,prickl,prickle,ray,red-brown,ruit,scandent,scar,sessile,shorter,small,smooth,spaced,sparsely,spreading,stalk,stalked,stellate,straight,tamen,terete,time,trichome,unarmed,unit,variously,vary,ympodial	arrangement,branch,characteristic,colour,corolla,exertion,form,glabrousnes,growth,height,history,inflorescence,length,life,lobing,na,new,ovary,perennial,plant,seed,shape,size,stigma,texture,type	.5,.8,/2,0-2,0.4-1.6,0.5-1,0.5-1.3,0.6-1.2,0.6-1.6,0.7-1.7,0.8-1,1-4,1.5-2,1.8-2.5,3-5,4-5,4.5,abaxially,apex,articulated,base,berry,broad-deltate,cm,color,cordate,curved,densely,diameter,entire,erect,evenly,eye,finely,flattened-reniform,glabrous,gray,green,known,lobed,long,mature,mauve,mm,moderately,naked,orange-brown,ovate,pair,pale,pitted,poricidal,prickly,rounded,shoot,short,shrub,simple,slender,spherical,stellate-pubescent,tapering,terminal,tip,truncate,visible,way,white,wide,yellow-green,young	na,perennial
490	wfo-0001031786	success	207	135	106	117	90	18	104	2	.5,/3,0-2,0-3,0-5,0.2-2.5,0.5-1.5,0.7-1,0.7-1.6,0.7-4,0.8-1.2,1-2,1-3,1-6,1.2-1.6,1.5-1.9,1.5-2.5,2-13,2-3,2-7,2-8,2.5-3.5,3-4,3-5.5,4-5,6-8,8-12,abaxially,acute,almost,anther,apart,apex,apically,apparently,articulated,bark,base,berry,branched,calyx,cell,chartaceous,cm,concolorous,connivent,curved,dark,deep,deltate,densely,diameter,drying,elliptic,erect,evenly,flattened-reniform,flower,fruit,fruiting,glabrescent,glabrous,green,herb,lateral,leaf,length,lobe,lobed,long,maturity,mauve,membranous,minute,mm,one,open,orange,outline,ovate,pale,pedicel,peduncle,petiole,pit,poricidal,prickle,raised,red,red-brown,reflexed,shiny,shrub,simple,small,smooth,sometimes,spaced,sparsely,spherical,spreading,stellate,stellate-pubescent,stigma,straight,style,surface,tapering,time,tip,trichome,way,weakly,white,wide,yellow-orange,young	.4,/2,0-20,0.1,0.1-0.4,0.2-0.3,0.25-0.5,0.8,1,1-4,1/3-1/2,5-7,5-merous,acut,alyx,ame,apar,becoming,blade,c.,clavat,cuneate,distance,eaf,eed,elongating,equal,extending,eye,filament,filiform,flattened,free,gray,gray-brow,herbaceous,inconspicuous,infructescence,lon,longer,lower,margin,mature,midpoint,midvein,naked,nflorescence,obtuse,older,orange-brown,orolla,oung,pair,pendulous,per,perfec,pericarp,plurifoliat,porrect,portion,prickl,prickly,primary,ray,rounded,ruit,scandent,scar,sessile,shorter,side,slightly,stalk,stalked,stem,tamen,terete,tertiary,thick,truncate,tube,unarmed,unit,variously,vary,vein,venation,visible,woody,ympodial	characteristic,clavate,colour,corolla,form,gray-brown,growth,height,inflorescence,ovary,plant,seed,shape,size,staman,texture,type,width	.5,/3,0-2,0-3,0-5,0.2-2.5,0.5-1.5,0.7-1,0.7-1.6,0.7-4,0.8-1.2,1-2,1-3,1-6,1.2-1.6,1.5-1.9,1.5-2.5,2-13,2-3,2-7,2-8,2.5-3.5,3-4,3-5.5,4-5,6-8,8-12,abaxially,acute,almost,apart,apically,apparently,articulated,base,berry,branched,cell,chartaceous,cm,concolorous,connivent,curved,dark,deep,deltate,densely,diameter,drying,elliptic,erect,evenly,flattened-reniform,flower,glabrescent,glabrous,green,herb,lateral,lobe,lobed,long,maturity,mauve,membranous,minute,mm,one,open,orange,outline,ovate,pale,pit,poricidal,prickle,raised,red,red-brown,reflexed,shiny,shrub,simple,small,smooth,sometimes,spaced,sparsely,spherical,spreading,stellate,stellate-pubescent,straight,surface,tapering,time,tip,trichome,way,weakly,white,wide,yellow-orange,young	clavate,gray-brown
491	wfo-0001031793	success	188	106	68	85	103	21	66	2	-4,.5,1-2,1.5-2,1.5-4,10-15,15-20,2-3,2-5,3-8,acumen,acuminate,aging,almost,anther,apex,base,berry,black,branched,broadly,brown,brownish,calyx,capitate,cm,cuneate,densely,diameter,elliptic,evident,extra-axillary,ferrugineous,filament,flattened,flower,forked,fruit,fruiting,globose,hair,inflorescence,leaf,linear,lobe,long,margin,minutely,mm,oblong-lanceolate,orange-yellow,orbicular-ovate,ovate,pedicel,peduncle,petiole,porocidal,prickle,pubescent,reddish,rounded,scarcely,scattered,shallow,shrub,simple,small,stellate,stellate-pubescent,stem,stigma,stout,style,surface,thickened,tip,tree,triangular,tube,unbranched,upward,well-developed,white,yellow,yellow-brown	0,1,1-1.5,1-3,1-8,1/3,1/4,1/5,13-20,20,26,3-4,3/4,4,40,5-merous,7,8-11,absent,abundant,accrescent,acute,adult,alyx,apparently,armed,articulated,aspect,axe,ba,bilobe,blade,branche,broad,central,chartaceous,cut,difoliate,distal,eaf,eed,elongatin,erec,erect,extreme,geminat,general,glandular,homostylou,interpetalar,larger,lobing,lon,lower,main,many,maturing,midpoint,midrib,mostly,mucilaginous,nflorescence,oblique,obtuse,often,older,orolla,per,perfect,pore,porrect,principal,rachi,reduced,reticulation,ruit,rusty,sessile,side,similar,single,sinus,size,smaller,sparsely,stellate-pubescen,stipitate,tall,tamen,tem,testa,tissue,triangular-acuminat,trichome,unarmed,unit,usually,uvenile,vary,way,woody,x,ympodial	adaxial,arrangement,bilobed,characteristic,colour,corolla,form,growth,height,history,juvenile,length,life,ovary,perennial,plant,seed,shape,staman,texture,type	-4,.5,1-2,1.5-2,1.5-4,10-15,15-20,2-3,2-5,3-8,acumen,acuminate,aging,almost,berry,black,branched,broadly,brown,brownish,capitate,cm,cuneate,densely,elliptic,evident,extra-axillary,ferrugineous,flattened,flower,forked,fruit,globose,hair,linear,lobe,long,minutely,mm,oblong-lanceolate,orange-yellow,orbicular-ovate,ovate,porocidal,pubescent,reddish,rounded,scarcely,scattered,shallow,shrub,simple,small,stellate,stellate-pubescent,stout,thickened,tip,tree,triangular,unbranched,upward,well-developed,white,yellow,yellow-brown	bilobed,perennial
492	wfo-0001031829	success	138	90	47	64	74	26	45	2	.25,.5,0.7-1,1-2,1.3-1.5,1.5-3.5,2-4,3/4,4-8.5,7-10,absent,anther,base,berry,broadly,calyx,capitate,cm,conical,corolla,densely,drying,elliptic,exserted,filament,fruiting,glabrous,globose,green,growth,inflorescence,lateral,leaf,leathery,main,margin,minute,mm,often,ovary,pair,pedicel,petiole,pubescent,revolute,shaped,shrub,simple,size,somewhat,sparsely,stem,stigma,style,surface,tapering,tear-drop,thick,tube,vein,way,white,x,yellowish	0.5-2.1,1,1.5-2,1.5-2.5,1.5-4.5,3-5-flowered,4-4.5,abaxially,acute,adaxial,adaxially,along,anthesi,ape,apex,apiculae,bae,bark,branched,crystalline,deflexed,denser,dia,differing,difoliate,eaf,edicel,eed,epidermi,erect,free,geminat,glabrat,greenish-brown,immature,known,large-celled,like,lobe,lobed,lon,long,lower,major,minor,minutely,nflorescence,occasionally,older,opposite,overlappin,packed,papillo,papillose,planar,pore,poricidal,portion,quadrate,ruit,scar,soft,tall,tip,trichome,tub,tuft,ud,uniseriate,unit,waxy,woody,ympodial,young	arrangement,bud,characteristic,colour,diameter,exertion,form,fruit,glabrousnes,height,history,length,life,lobing,na,new,number,peduncle,per,perennial,plant,primary,seed,shape,texture,type	.25,.5,0.7-1,1-2,1.3-1.5,1.5-3.5,2-4,3/4,4-8.5,7-10,absent,base,berry,broadly,capitate,cm,conical,densely,elliptic,exserted,glabrous,globose,green,lateral,leathery,main,minute,mm,often,pair,pubescent,revolute,shaped,shrub,simple,somewhat,sparsely,tapering,tear-drop,thick,vein,way,white,x,yellowish	na,perennial
493	wfo-0001031832	success	232	137	95	111	121	26	93	2	0.1-0.3,0.2-0.6,0.2-1.5,0.3-3,0.7-1.6,0.7-2,0.8-1.2,1-12,1.2-1.6,1.2-2,14,2-6,3-6.5,4-20,7-10,8-25,9,abaxially,acuminate,acute,adaxially,anther,anthesi,apart,apex,articulated,attenuate,bark,basal,base,becoming,berry,blunt-tipped,branch,brown,bud,bullate,calyx,closely,cm,conical,continued,corolla,dark,deltoid,diameter,due,entire,exserted,filament,fleshy,flower,fruit,fruiting,glabrous,globose,granular-tomentose,green,greenish,growth,half,honeycombed,lanceolate,lateral,leaf,length,margin,midvein,mm,mostly,oblanceolate,oblong,obovoid,orbicular,ovate,pale,pedicel,peduncle,petiole,pitted,probably,pubescent,reniform,reticulate-punctate,ripe,rough,scabrous,shrub,side,simple,soon,spaced,sparingly,stem,stigma,style,subcampanulate,suborbicular,surface,terete,terminal,tree,tube,unarmed,vein,violet,weakly,white,x,yellow,yellowish	-8,.5-1,/50-1/10,0-150,0.3-0.8,0.7-1.5,1.1-2.4,1.2-2.5,1.3-4.2,1.5-4,1.7-4,1.8-4,1/2-3/4,2-3.6,2-4,2.5-6.5,2.8-4.8,3-7,3.5-7,4-7,5-21,5.5-10,accrescent,ag,apical-lateral,apice,apparently,axe,axillary,ba,blade,blister,branched,brownish,capitat,chartaceous,connate,decurrent,dehiscing,directed,eaf,eed,evident,extend,ferrugineous,few-rayed,forming,free,glabrescen,glabrescent,hair,high,indument,inserted,introrse,lackin,large,line,lobe,lobed,long,long-,longer,longitudinal,lower,m.,main,minute,mixed,multangulate,nearly,nflorescence,obtuse,occasionally,older,orolla,partly,perfect,persistent,plurifoliate,pore,porrect-stellat,porrect-stellate,pubescence,rachi,rather,ray,relatively,rotate-stellate,ruit,runk,sessile,short-,short-stalked,slit,smooth,sometimes,somewhat,sparse,splitting,stamen,stellate-pubescent,stipitate-glandular,suture,swelling,tamen,testa,thick,thick-stalked,time,toward,translucent,unarme,unit,usually,vary,way,whitish,wide,ympodial,young	arrangement,capitate,characteristic,colour,corrugation,drying,exertion,form,glabrousnes,height,history,inflorescence,life,lobing,na,new,number,ovary,per,plant,primary,seed,shape,size,texture,type	0.1-0.3,0.2-0.6,0.2-1.5,0.3-3,0.7-1.6,0.7-2,0.8-1.2,1-12,1.2-1.6,1.2-2,14,2-6,3-6.5,4-20,7-10,8-25,9,abaxially,acuminate,acute,adaxially,anthesi,apart,apex,articulated,attenuate,basal,base,becoming,berry,blunt-tipped,brown,bullate,calyx,closely,cm,conical,continued,dark,deltoid,diameter,due,entire,exserted,fleshy,flower,fruit,glabrous,globose,granular-tomentose,green,greenish,growth,half,honeycombed,lanceolate,lateral,midvein,mm,mostly,oblanceolate,oblong,obovoid,orbicular,ovate,pale,pitted,probably,pubescent,reniform,reticulate-punctate,ripe,rough,scabrous,shrub,side,simple,soon,spaced,sparingly,stem,subcampanulate,suborbicular,terete,terminal,tree,unarmed,violet,weakly,white,x,yellow,yellowish	capitate,na
494	wfo-0001031834	success	150	95	47	62	88	33	44	3	0.5,0.5-3,0.5-3.5,0.6-1.4,0.8-1,0.8-1.3,1.5,1.6-2,1.9-6.5,2/3,6-7,6.5-14,acuminate,acute,anther,apex,base,berry,calyx,cm,corolla,decurrent,deltoid,filament,flattened-reniform,fruit,fruiting,globose,green,greenish-yellow,leaf,less,margin,minutely,mm,ovary,ovate,pale,papillose,pedicel,petiole,pitted,pubescent,scabrous,shaped,shrub,simple,slender,sparsely,stem,stigma,style,surface,tan,tapering,tear-drop,tube,vein,way,white,x,yellow	.5,0.5-1,0.9-1.4,1,1.5-4,2.9-7,accrescent,across,anthesi,apar,apically,apiculate,appear,attenuate,bi-cellular,borne,campanulate,covered,deciduou,deciduous,deflexed,depression,dia,difoliate,eaf,edicel,eed,expanded,eye,few-flowered,free,geminat,glabrou,glabrous,hook,hooked,incrassate,lamina,larger,leaving,like,lobe,lobed,lon,long,lower,major,markedly,middle,minor,minute,mound-like,multicellular,naked,nflorescence,often,opposite,papillo,persistent,planar,pore,poricidal,portion,proximal,ruit,scar,short,slightly,small,soon,spaced,speck,straight,tall,tip,trichome,tufted,ud,unevenly,uni-,uniseriate,unit,upper,usually,widest,woody,ympodial,young	2,arrangement,bark,branch,bud,characteristic,colour,corrugation,diameter,drying,exertion,form,glabrousnes,growth,height,history,inflorescence,length,life,lobing,na,new,number,peduncle,per,perennial,plant,primary,seed,shape,size,texture,type	0.5,0.5-3,0.5-3.5,0.6-1.4,0.8-1,0.8-1.3,1.5,1.6-2,1.9-6.5,2/3,6-7,6.5-14,acuminate,acute,base,berry,cm,decurrent,deltoid,flattened-reniform,globose,green,greenish-yellow,less,minutely,mm,ovate,pale,papillose,pitted,pubescent,scabrous,shaped,shrub,simple,slender,sparsely,tan,tapering,tear-drop,way,white,x,yellow	2,na,perennial
495	wfo-0001031842	success	161	131	101	107	54	24	97	4	.4,.5,.75,0.1-0.5,0.6-1,0.7-1,1-1.8,1-3.5,1.5-2,10-20,10-30-flowered,2-10,2-3,3-8,3/4,4.5-6,7-9,acute,anther,anthesi,apex,attenuate,axil,bark,base,bearing,beneath,berry,bi-lobed,brown,calyx,capitate,cm,corolla,dark,decurrent,deeply,dia,difoliate,dry,ellipsoid,elliptic,exsertion,filament,flattened-reniform,fruiting,glabrous,globose,green,later,lateral,leaf,leaf-opposed,lobe,lobed,long,main,minor,minutely,mm,near,new,often,onto,opposite,ovary,overtopping,pale,papillose,pedicel,petiole,pitted,pore,poricidal,reddish-resinous,reflexed,shaped,shiny,shoot,shrub,simple,size,slender,somewhat,soon,specimen,stem,stigma,strongly,style,surface,tapering,tear-drop,terminal,time,tip,tree,trichome,tube,tuft,uniseriate,unit,vein,way,white,x,young	.1,0.5-1,0.5-2,1,1-1.5,10-12,2.5-3,2.5-6,9-15,apart,ba,beginning,cup-shaped,cusp,deflexed,densely,differing,eaf,edicel,eed,exserte,free,geminat,incrassate,inflorescenc,irregularly,lon,lower,major,margin,middle,nflorescence,older,one,pair,paler,papillo,portion,prominent,pubescent,quadrate,reddish,ruit,scar,spaced,sparsely,straight,tall,ud,widest,woody,yellowish,yellowish-whit,ympodial	arrangement,bud,characteristic,colour,diameter,exertion,exserted,form,fruit,geminate,growth,height,history,inflorescence,length,life,lobing,plant,seed,shape,sympodial,texture,type,yellowish-white	.4,.5,.75,0.1-0.5,0.6-1,0.7-1,1-1.8,1-3.5,1.5-2,10-20,10-30-flowered,2-10,2-3,3-8,3/4,4.5-6,7-9,acute,anthesi,apex,attenuate,axil,base,bearing,beneath,berry,bi-lobed,brown,calyx,capitate,cm,corolla,dark,decurrent,deeply,dia,difoliate,dry,ellipsoid,elliptic,exsertion,flattened-reniform,glabrous,globose,green,later,lateral,leaf,leaf-opposed,lobe,lobed,long,main,minutely,mm,near,new,often,onto,opposite,overtopping,pale,papillose,petiole,pitted,pore,poricidal,reddish-resinous,reflexed,shaped,shiny,shoot,shrub,simple,slender,somewhat,soon,specimen,stem,strongly,surface,tapering,tear-drop,terminal,time,tip,tree,trichome,tube,tuft,uniseriate,unit,vein,way,white,x,young	exserted,geminate,sympodial,yellowish-white
496	wfo-0001031843	success	245	139	107	122	123	17	104	3	.5,0.6-1.2,0.7-2,0.8-2,1-7,1.2-2,1.2-2.2,1.5,1.8-2.5,2-3,2.5,3-4,3-7,4-12,45-60Â°,5-10,5-12,6-9,abaxially,adaxially,almost,along,anther,apex,apically,appressed,basal,base,berry,black,branch,branched,branching,brown,calyx,canaliculate,capitate,cm,completely,conical,corolla,cupular,curved,dark,deeply,density,diameter,dilated,discoid,distributed,drying,dull,erect,evenly,fine,finely,flat,flower,forming,fruiting,glabrous,green,honeycomb,leaf,length,liana,like,long,loop,main,margin,midvein,mm,network,oblong,obovate,orange-brown,orange-yellow,pair,part,partly,pattern,pedicel,peduncle,petiole,pitted,primary,prominent,pubescent,raised,rarely,reddish,scar,seed,shiny,shrub,side,slender,sometimes,sparsely,spheroidal,spreading,stem,stigma,straight,stump,style,surface,terminal,tertiary,thick-chartaceous,trichome,twice,unarmed,variable,vein,venation,violet,visible,white,x,young	.2,.3,.6,0-4,0.2-2,0.4-0.5,0.5-1,0.5-1.5,0.7-1.2,1-2,1.5-2,1/6-1/4,1mm,2-4,accrescent,acuminate,age,always,alyx,anthesi,apar,apice,apparently,around,articulated,attenuate,bark,becoming,broadly,caudate,clearly,collapsing,cuspidate,delineated,deltoid,dendritic,detaching,discolorous,domatia,eaf,eed,ellipsoi,entire,equal,even,eye,fertilisation,filament,flexuous,free,hand,inner,largely,leave,len,lengthening,lignified,lobe,lobed,longitudinally,looping,lower,m.,much,multiseriate,naked,never,nflorescence,nther,oblique,obscure,older,opening,orange,orolla,outline,ovate,papillo,pendulous,perfec,pericarp,pit,plurifoliat,pore,poricidal,portion,present,pronounced,protruding,rachi,recurve,red,reveal,ribbed,ridged,rounded,ruit,see,shallowly,shortly,simple,sinus,slightly,small,smaller,smooth,soon,strongly,surfac,tearing,thickened,thin,tip,tube,tuft,ud,unit,vary,weakly,wide,wider,without,ympodial	apart,arrangement,bud,characteristic,colour,ellipsoid,form,fruit,growth,inflorescence,lobing,ovary,papillose,shape,size,texture,type	.5,0.6-1.2,0.7-2,0.8-2,1-7,1.2-2,1.2-2.2,1.5,1.8-2.5,2-3,2.5,3-4,3-7,4-12,45-60Â°,5-10,5-12,6-9,abaxially,adaxially,almost,along,apex,apically,appressed,basal,base,berry,black,branch,branched,branching,brown,canaliculate,capitate,cm,completely,conical,cupular,curved,dark,deeply,diameter,dilated,discoid,distributed,drying,dull,erect,evenly,fine,finely,flat,flower,forming,glabrous,green,honeycomb,liana,like,long,loop,main,midvein,mm,network,oblong,obovate,orange-brown,orange-yellow,pair,part,partly,pattern,peduncle,pitted,prominent,pubescent,raised,rarely,reddish,shiny,shrub,side,slender,sometimes,sparsely,spheroidal,spreading,stem,straight,stump,terminal,thick-chartaceous,trichome,twice,unarmed,variable,vein,violet,visible,white,x,young	apart,ellipsoid,papillose
497	wfo-0001031852	success	152	117	53	69	83	48	49	4	0.1-1,0.5-1.3,0.5-3,1-4,1-4.2,1-9,1.3-2.5,1.4-3,2-5.5,2.6-9.5,3.5-10,4-10,4-6,5-15,7-12-35,9-11,acuminate,acute,apex,base,branched,calyx,cm,conical,corolla,cyme,decurrent,diameter,dichasial,dichasially,distal,ebracteate,elliptic,elliptic-lanceolate,filament,green,green-white,herbaceous,interjected,lanceolate,lateral,leaf,leaflet,light,lobe,long,mm,monochasial,mucilaginous,oblique,oblong,odd-pinnate,ovate-elliptic,ovoid,pedicel,peduncle,perennial,petiole,plant,pubescent,seed,sessile,size,stigma,style,terminal,throughout,white,wide	1-2-3,1.5-3,2-3,3-4,3-6-foliat,3-9,4-4-5-8,abaxially,abruptly,absen,acumen,adaxially,apical,apically,apiculate,articulate,attenuate,cell,connate,covering,dehiscent,digestion,diminishing,dorsally,eaf,edge,eed,emoval,enzyme,exceeding,flat,flower,folded,forked,generally,globo,hair-like,half,honeycomb,introrse,living,lon,lower,lunat,make,maturing,nflorescence,nther,often,orolla,pair,pattern,perfect,plan,poricidally,proximal,rachi,reveal,ruit,seudostipule,short,shortly,slit,specimen,stamen,stellate,straight,tal,tem,testal,thick,throughou,toward,tuber-bearing,typically,unit,vary,wall,white-crea,without,yellow,ympodial,Â¼	absent,anther,appearance,arrangement,bark,border,branch,bud,characteristic,colour,corrugation,drying,exertion,form,fruit,fruiting,giving,glabrousnes,globose,growth,height,history,inflorescence,length,life,lobing,margin,midpoint,na,new,number,ovary,per,prickle,primary,pseudostipule,ray,shape,stem,surface,texture,thicknes,tube,type,variation,vein,white-cream,width	0.1-1,0.5-1.3,0.5-3,1-4,1-4.2,1-9,1.3-2.5,1.4-3,2-5.5,2.6-9.5,3.5-10,4-10,4-6,5-15,7-12-35,9-11,acuminate,acute,branched,cm,conical,cyme,decurrent,diameter,dichasial,dichasially,ebracteate,elliptic,elliptic-lanceolate,green,green-white,herbaceous,lanceolate,light,long,mm,monochasial,mucilaginous,oblique,oblong,odd-pinnate,ovate-elliptic,ovoid,perennial,pubescent,sessile,throughout,white,wide	absent,globose,na,white-cream
498	wfo-0001031864	success	140	101	68	77	63	24	65	3	.2,.25,.5,0.2-0.5,0.5-13.5,0.5-4,0.7-0.8,0.8-1,1-1.2,1-2,1.5-10,15-60,2-3,2.5-6,3-3.5,3-pinnate,7.5-8,abaxially,acute,adaxially,anther,apex,berry,calyx,chartaceous,ciliate,clavate,cm,deltoid,dense,densely,diameter,entire,extra-axillary,filament,fine,flattened,fleshy,flower,fruit,glabrous,hair,herbaceous,lenticular,like,long,margin,middle,mm,ovoid-deltoid,papillose,pedicel,peduncle,petiole,pointed,pubescence,pubescent,rachi,rotate,scattered,short,slender,slightly,sparsely,stem,stigma,style,surface,tip,trichome,unbranched,unknown,vine,violet,wide-diameter,widely,x	0.4-3,0.6-3.5,0.6-4,1-1.8,1-3,1-5,1-6.5,1.2-1.5,1.5,1.5-2.5,2,5-15,5-9,5-merous,accrescent,acuminate,alyx,apar,apical,apiculate,axe,base,blade,c.,capitat,color,cuneate,eaf,eed,emarginate,fruiting,glabrou,lateral,leaflet,lobe,lon,lower,m.,minutely,moderately,near,nflorescence,nternode,oblique,orolla,perfec,petiolule,plurifoliat,pubescenc,rounded,ruit,sand-punctate,spaced,tamen,tem,terrestria,truncate,tube,typical,unit,vary,vein,ympodial	.8,abaxial,adaxial,arrangement,capitate,characteristic,colour,corolla,form,growth,history,inflorescence,internode,leaf,length,life,number,ovary,seed,shape,size,terrestrial,texture,type	.2,.25,.5,0.2-0.5,0.5-13.5,0.5-4,0.7-0.8,0.8-1,1-1.2,1-2,1.5-10,15-60,2-3,2.5-6,3-3.5,3-pinnate,7.5-8,abaxially,acute,adaxially,apex,berry,chartaceous,ciliate,clavate,cm,deltoid,dense,densely,diameter,entire,extra-axillary,fine,flattened,fleshy,flower,glabrous,hair,herbaceous,lenticular,like,long,middle,mm,ovoid-deltoid,papillose,pointed,pubescence,pubescent,rotate,scattered,short,slender,slightly,sparsely,stem,tip,trichome,unbranched,unknown,vine,violet,wide-diameter,widely,x	.8,capitate,terrestrial
499	wfo-0001031864	success	148	108	77	87	61	21	75	2	.25,.5,0.5-13.5,1-1.2,1-2,1-5,1-6.5,1.5,1.5-2.5,15-60,2-3,3-3.5,3-5-celled,3-pinnate,5-15,5-9,7.5-8,abaxially,absent,acuminate,adaxially,anther,apart,articulated,basally,base,blue-purple,calyx,center,ciliate,cm,connivent,cordate,dense,densely,diameter,directed,distally,entire,extra-axillary,filament,fine,fleshy,flower,glabrous,hair,herb,interjected,large,leaflet,lenticular,long,longitudinal,margin,mm,oblong,opening,papillose,pedicel,peduncle,pore,pubescence,pubescent,scattered,short,simple,slender,slit,somewhat,spaced,sparsely,stigma,style,surface,terrestrial,thick,tip,tube,unbranched,uniseriate,unknown,weakly,widely,wiry,woody,x,yellow	.2,0.4-3,0.5-4,0.6-3.5,0.6-4,1-1.8,1-3,1.2-1.5,2,2.5-6,5-merou,accrescent,acute,ag,alyx,apex,apical,apiculate,apparently,axe,ba,blade,capitat,clavate,color,cuneate,deltoid,eaf,eed,emarginate,equal,etiole,fruit,fruiting,geminat,lateral,lobe,lower,m.,minutely,near,nflorescence,node,oblique,orolla,perfect,petiolule,plurifoliate,pubescenc,rachi,rooting,rotate,rounded,slightly,tamen,tem,trailing,truncate,unit,vary,ympodial	age,arrangement,capitate,characteristic,colour,corolla,form,growth,history,inflorescence,leaf,length,life,lobing,ovary,petiole,seed,shape,size,stem,texture	.25,.5,0.5-13.5,1-1.2,1-2,1-5,1-6.5,1.5,1.5-2.5,15-60,2-3,3-3.5,3-5-celled,3-pinnate,5-15,5-9,7.5-8,abaxially,absent,acuminate,adaxially,apart,articulated,basally,base,blue-purple,center,ciliate,cm,connivent,cordate,dense,densely,diameter,directed,distally,entire,extra-axillary,fine,fleshy,flower,glabrous,hair,herb,large,lenticular,long,longitudinal,mm,oblong,opening,papillose,pore,pubescence,pubescent,scattered,short,simple,slender,slit,somewhat,spaced,sparsely,terrestrial,thick,tip,unbranched,uniseriate,unknown,weakly,widely,wiry,woody,x,yellow	age,capitate
500	wfo-0001031871	success	185	139	97	112	73	27	93	4	0.4-2,0.6-1.2,1-2,1.4-2.1,1.5-11,1.5-2,1.5-2.1,1.6-2.7,2-3,2-4,2.9-6,3-10,3.5-4,33-40,36-44,4-6,4-7,5.4-12.3,6-12,6-7,6.5-20.5,7-9,7.5-23,acumen,anther,axillary,berry,blade,brownish,bud,cell,chartaceous,clavate,cm,condition,connivent,corolla,covering,dark,deep,diameter,distal,dot,drying,end,filament,flower,forked,fresh,fruit,generally,glabrous,globose,green,green-white,greenish,hair,hair-like,half,herb,homostylous,interjected,lanceolate,lateral,leaflet,lobe,long,make,medium,mm,mottled,mucilaginous,narrowly,odd-pinnate,one,ovoid,pedicel,peduncle,petiole,placed,plant,poricidal,pubescent,purple,ripe,rotate,seed,short,size,stigma,straight,style,subglabrous,subtending,terminal,testal,thick,throughout,tiny,tip,tube,tuber,typically,usually,wall,wet,white,whitish,wide,winged,x,yellow	14-22,3-4,3-5,5-merou,abaxially,acute,adaxiall,adaxially,ag,alyx,apart,apex,apparently,articulated,asymmetric,attenuate,axe,base,basiscopic,capitat,digestion,dorsally,eaf,edge,eed,elliptic,enzyme,erec,exceeding,flat,folded,geminat,glabrou,hal,high,honeycomb-shaped,lengthening,linear,living,lower,nflorescence,orbicular,orolla,ovate,pair,perfect,petiolulate,plurifoliate,pore,removed,round,rounded,ruit,sessile,seudostipule,side,slit,sometimes,spaced,specimen,stamen,stolo,subequal,subglabrou,symmetric,tall,tamen,tem,tissue,tri-,unit,vary,ympodial	5-merous,abaxial,adaxial,arrangement,calyx,capitate,colour,erect,form,growth,height,history,inflorescence,leaf,length,life,number,ovary,placement,pseudostipule,shape,staman,stem,stolon,surface,texture,type	0.4-2,0.6-1.2,1-2,1.4-2.1,1.5-11,1.5-2,1.5-2.1,1.6-2.7,2-3,2-4,2.9-6,3-10,3.5-4,33-40,36-44,4-6,4-7,5.4-12.3,6-12,6-7,6.5-20.5,7-9,7.5-23,axillary,berry,brownish,bud,cell,chartaceous,clavate,cm,condition,connivent,covering,dark,deep,distal,dot,drying,end,forked,fresh,generally,glabrous,globose,green,green-white,greenish,hair,hair-like,half,herb,homostylous,lanceolate,lateral,long,make,medium,mm,mottled,mucilaginous,narrowly,odd-pinnate,one,ovoid,placed,plant,poricidal,pubescent,purple,ripe,rotate,seed,short,straight,subglabrous,subtending,terminal,testal,thick,throughout,tiny,tip,typically,usually,wall,wet,white,whitish,wide,winged,x,yellow	5-merous,capitate,erect,stolon
501	wfo-0001031876	success	140	75	37	47	93	28	34	3	.1,.5,0-flowered,0.8-1,1,1-1.6,1.5-2.2,acute,anther,apex,bark,base,berry,calyx,cm,corolla,cup-like,decurrent,dia,elliptic,fruiting,glabrous,globose,green,leaf,lightly,long,long-acuminate,mm,nearly,oblanceolate,ovary,papillose,pedicel,petiole,shaped,shrub,simple,slightly,stem,stigma,straight,style,tapering,tear-drop,white,winged	0.5,1-1.5,1-4,27-35,3,5,9-15,?,across,anthesi,apiculate,arc,arising,ba,bearing,beneath,bright,closely,convergence,corky,differing,eaf,edicel,eed,erect,family,filament,flower,free,glabrou,granular,greenish-yellow,immature,irregularity,known,lateral,lenticellat,less,lobe,lobed,lower,main,major,margin,melastomataceae,member,middle,minute,minutely,nflorescence,oblique,often,opposite,otherwise,overlappin,pair,parallel,perpendicular,persistent,point,pore,poricidal,portion,present,primary,prominent,raised,recurved,reflexed,resemble,ruit,running,scar,secondary,slender,spaced,styl,tall,time,tip,tube,ud,unifoliat,unit,vein,venation,wide,widest,woody,x,yellow,ympodial,young	arrangement,bud,characteristic,colour,diameter,form,fruit,growth,height,history,inflorescence,length,life,lobing,na,number,peduncle,per,perennial,plant,seed,shape,size,surface,texture,type,unifoliate,width	.1,.5,0-flowered,0.8-1,1,1-1.6,1.5-2.2,acute,base,berry,cm,cup-like,decurrent,dia,elliptic,glabrous,globose,green,lightly,long,long-acuminate,mm,nearly,oblanceolate,papillose,shaped,shrub,simple,slightly,straight,tapering,tear-drop,white,winged	na,perennial,unifoliate
502	wfo-0001031877	success	213	116	81	96	117	20	79	2	0.3-1,0.3-1.2,0.6-1.2,1-1.5,1-3,1.5,1.5-1.9,2,2-6-10,2.5,6-8,abruptly,acuminate,acute,adaxially,angled,anther,anthesi,apex,basal,basally,base,berry,bright,brown,calyx,capitate,clavate,cm,conical,corolla,deltate,densely,diameter,ellipsoid,ellipsoidal,entire,exserted,filament,flattened,fruit,fruiting,glabrous,globose,greenish,growth,hastate,later,lateral,line,lobe,lobed,margin,minute,minutely,mm,nearly,new,outline,pale,pedicel,peduncle,per,petiole,pitted,plump,pubescent,purple,red,reddish,reniform,ripe,scrambler,seed,simple,slender,slightly,somewhat,sparsely,stellate,stem,stigma,strongly,style,surface,terminal,tinged,triangular,trichome,truncate,tube,uniseriate,usually,vine,white,x	+,.3,.5,0.2,0.3-1-3.5,0.5,0.5-1,0.8-0.9,1,1-4,1.1-1.8-5,1.5-2,3-5,3-6,3.5-4,5-merou,abaxially,adaxiall,ag,along,alyx,apar,apparently,ark,articulated,ascending,cell,connivent,deep,deflexed,distal,dried,eaf,eed,enlarged,erect,especially,exposed,eye,fleshy,flower,free,furcate,green,ilament,impressed,internal,irregularly,lamina,lengthening,like,linear,long,long-acuminate,loosely,lower,material,mature,midvein,nflorescence,occasionally,often,older,orolla,pair,papillate,papillo,parallel,part,perfect,pericarp,plant,plurifoliat,pointing,pore,poricidal,portion,primary,prominently,pubescence,purplish,rectangular,reflexed,rest,rounded,ruit,scar,semi-woody,shiny,short,shorte,silky,sinuate,sleeve,slit,sometimes,spaced,spreadin,subshru,tem,testal,thin,tip,twinin,ud,uniformly,unit,upper,vary,vein,visible,wall,weak,woody,yello,ympodial,young	arrangement,bark,bud,characteristic,colour,exertion,form,glabrousnes,inflorescence,leaf,length,lobing,number,ovary,shape,size,sparingly,texture,type,yellow	0.3-1,0.3-1.2,0.6-1.2,1-1.5,1-3,1.5,1.5-1.9,2,2-6-10,2.5,6-8,abruptly,acuminate,acute,adaxially,angled,anthesi,basal,basally,base,berry,bright,brown,calyx,capitate,clavate,cm,conical,deltate,densely,diameter,ellipsoid,ellipsoidal,entire,exserted,flattened,glabrous,globose,greenish,hastate,later,lateral,line,lobe,lobed,minute,minutely,mm,nearly,outline,pale,per,pitted,plump,pubescent,purple,red,reddish,reniform,ripe,scrambler,simple,slender,slightly,somewhat,sparsely,stellate,strongly,terminal,tinged,triangular,trichome,truncate,tube,uniseriate,usually,vine,white,x	sparingly,yellow
503	wfo-0001031880	success	180	117	83	99	81	18	82	1	0.7-0.8,1,1-1.3,1-1.5,1.5,2-3,2-9,2.5-8,3-3.5,3-4-pluri-foliate,3-foliate,3-lobed,4,4-8,6-9,acuminate,acute,anther,anthesi,apex,base,berry,broadly,brown,calyx,capitate,cell,ciliate,cm,conical,cordate,corolla,cup-shaped,curved,dark,densely,diameter,ellipsoid,enlarged,entire,erect,filament,flattened,flower,fruit,fruiting,glabrous,glandular,globose,green,herb,heteromorphic,hollow,inflorescence,internodal,leaf,less,long,margin,mature,minutely,mm,orange,ovary,ovoid,pale,papillose,pedicel,petiole,pitted,poricidal,pubescent,purple,red,reddish,reflexed,shallowly,simple,slightly,spreading,stem,stigma,straight,strongly,style,subshrub,surface,testal,tip,toothed,triangular,truncate,tube,unlobed,upward,wall,x,yellow,â5	.5,0.5-1,0.5-2,1-2,2,2-4,5,5-6,7-9,abaxially,adaxially,age,apart,basal,bearing,becoming,c.,color,crenate,crowded,eaf,edicel,eed,elliptic,exerted,fleshy,flush,free,gland,gland-tipped,growing,horn,irregularly,lamina,lengthening,lobe,lon,longest,lower,markedly,maturit,mid-length,middle,narrowly,near,nflorescence,nodding,ovate,pair,papillo,peduncle,pericarp,plan,pore,portion,primary,pubescen,rachi,ruit,scar,shortest,single,slender,slit,sometimes,spaced,sparse,sparsely,terminal,thin,trichome,ud,unicellula,uniseriate,unit,upper,vein,widely,widest,woody,ympodial	arrangement,bud,characteristic,colour,form,growth,height,history,length,life,lobing,maturity,plant,seed,shape,size,texture,type	0.7-0.8,1,1-1.3,1-1.5,1.5,2-3,2-9,2.5-8,3-3.5,3-4-pluri-foliate,3-foliate,3-lobed,4,4-8,6-9,acuminate,acute,anthesi,berry,broadly,brown,capitate,cell,ciliate,cm,conical,cordate,cup-shaped,curved,dark,densely,diameter,ellipsoid,enlarged,entire,erect,flattened,flower,fruit,glabrous,glandular,globose,green,herb,heteromorphic,hollow,internodal,leaf,less,long,mature,minutely,mm,orange,ovoid,pale,papillose,pitted,poricidal,pubescent,purple,red,reddish,reflexed,shallowly,simple,slightly,spreading,straight,strongly,subshrub,testal,tip,toothed,triangular,truncate,unlobed,upward,wall,x,yellow,â5	maturity
504	wfo-0001031881	success	168	93	61	73	95	20	58	3	1-1.3,1-1.5,1-7,1.2-6,1.5-2.5,1/3,3/4,5-6,anther,base,beneath,branch,branched,broadly,brown,bud,calyx,campanulate,capitate,cm,corolla,dark,decurrent,deflexed,densely,dia,distal,ellipsoid,elliptic,erect,exserted,fruit,fruiting,glabrous,globose,golden,golden-pubescent,green,inflorescence,leaf,lightly,lobed,long,minutely,mm,obovate,opposite,ovary,ovoid-reniform,papillose,pedicel,petiole,pitted,puberulent,pubescent,shape,shaped,shrub,size,small,soon,sparsely,stem,stigma,style,surface,tear-drop,tree,usually,way,white,winged,young	.5,0.1-0.5,0.2,0.2-0.6,0.4-1,0.5-0.7,0.5-1,10-12,10-30,2,2-9,3-19,3.5-4,7-14,absent,acute,along,anthesi,apar,apex,apparent,attenuate,axil,ba,bark,constriction,deltoid,differing,difoliate,dry,drying,eaf,edicel,eed,either,evenly,filament,fleshy,free,geminat,golden-puberulent,greyish-brow,incrassate,inflorescenc,junction,lateral,like,lobe,lon,lower,main,major,margin,material,maturity,middle,midrib,minor,minute,nflorescence,occasionally,older,one,orbicular,pair,papillo,planar,pore,poricidal,portion,puberulen,rest,rounded,ruit,scar,simple,slender,slightly,somewhat,spaced,straight,strong,tall,tapering,tip,trichome,tube,ud,uniseriate,unit,vein,widest,woody,x,ympodial	abaxial,adaxial,alternate,arrangement,characteristic,colour,diameter,exertion,form,growth,hair,height,history,length,life,lobing,plant,seed,texture,type	1-1.3,1-1.5,1-7,1.2-6,1.5-2.5,1/3,3/4,5-6,base,beneath,branched,broadly,brown,bud,campanulate,capitate,cm,corolla,dark,decurrent,deflexed,densely,dia,distal,ellipsoid,elliptic,erect,exserted,glabrous,globose,golden,golden-pubescent,green,leaf,lightly,lobed,long,minutely,mm,obovate,opposite,ovoid-reniform,papillose,pitted,puberulent,pubescent,shaped,shrub,small,soon,sparsely,tear-drop,tree,usually,way,white,winged,young	-1.5,alternate,di
505	wfo-0001031886	success	168	108	70	86	82	22	65	5	-9,.5,1-1.5,1-4,1.2-2.5,1.5-2,2-4,2-5,2.0-2.5,3-6,3.0,4,4-15-25,5-6,5-ridged,6-20,6-8,9-10,acuminate,anther,anticlinal,apex,attenuate,basal,base,berry,bright,brown,calyx,capitate,cm,commonly,completely,conical,corolla,diameter,elliptic,equal,fleshy,fruit,fruiting,glabrous,green,greenish,irregular,lanceolate,lateral,leaflet,long,minutely,mm,nearly,occasionally,ovary,ovoid-reniform,pair,papillae,pedicel,per,petiole,pinnate,poricidal,primary,projection,reddish,rugose,seed,shape,shrub,simple,sinuous,smaller,somewhat,sparse,stigma,strongly,style,surface,terminal,thickening,tip,vein,white,without,woody,x	-1.2,-4,0,0.1,0.5-1,10-40,2,2-2.5,2-3,20-30,5-10,abaxially,abruptly,absent,adaxially,along,anthesi,arising,axil,axillary,beak,bearing,broadly,bud,cell,clavat,deltate,distinctly,dry,eaf,earl,edicel,eed,either,em,epidermal,erec,exserted,filament,flower,free,half,le,lobe,lobed,lower,margin,narrowed,near,nflorescence,noddin,node,oblique,open-conical,papillate,papillose,petiolule,portion,purple,rachi,raised,reflexed,ripe,ruit,scar,scattered,similar,single,smelling,specimen,time,triangular,trichome,tub,tube,ud,unifoliat,uniseriate,unit,usually,wintergreen,ympodial	1,1-1.2,40,arrangement,clavate,colour,form,growth,height,history,inflorescence,leaf,length,life,lobing,nodding,number,plant,size,stem,texture,type	-9,.5,1-1.5,1-4,1.2-2.5,1.5-2,2-4,2-5,2.0-2.5,3-6,3.0,4,4-15-25,5-6,5-ridged,6-20,6-8,9-10,acuminate,anticlinal,attenuate,base,berry,bright,brown,capitate,cm,commonly,completely,conical,diameter,elliptic,equal,fleshy,glabrous,green,greenish,irregular,lanceolate,lateral,long,minutely,mm,nearly,occasionally,ovoid-reniform,pair,pinnate,poricidal,projection,reddish,rugose,shrub,simple,sinuous,smaller,somewhat,sparse,strongly,thickening,tip,white,without,woody,x	1,1-1.2,40,clavate,nodding
506	wfo-0001031895	success	160	110	68	91	69	19	67	1	-1.5,0.5,1-1.5,1.5-2,1.5-3,2-2.5,2.5-3,3-4,3.5-6,4,4-5,5,5-6,6-9,acute,anther,apex,attenuate,bark,base,beneath,berry,bluish,broadly,calyx,capitate,cm,completely,conical,corolla,cup-shaped,dark,deltate,densely,diameter,drying,ellipsoid,elliptic,entire,erect,exerted,exfoliating,filament,fleshy,fruiting,glabrous,globose,green,growth,less,lobe,margin,matte,minutely,mm,new,occasionally,once-branched,ovary,overlapping,ovoid,pair,pale,papillate,pedicel,peduncle,peeling,petiole,pitted,poricidal,primary,reddish,reniform,revolute,shiny,shrub,simple,slightly,stem,stigma,stout,strongly,style,surface,tan,tip,tube,vein,violet,white,x	0.5-1,0.5-2,1.5-6,3-10,3-8,4.5-16.5,5-8,6-7,age,anthesi,apparently,articulating,blac,campanulate,cell,eaf,eed,emarginated,enlarging,erec,expand,flower,fragrant,free,glabrou,immature,inflorescenc,intensely,irregular,leaf-opposed,leafy,leaving,lengthening,lobed,lower,nflorescence,older,papillat,part,patch,peg,perfect,pericarp,planar,plurifoliat,pore,portion,ruit,scar,shoot,short,sinuate,slender,slit,small,somewhat,straight,terminal,testal,thick,thin,tree,tub,ud,unit,way,woody,ympodial,Â¼-1/2	arrangement,black,bud,characteristic,colour,exertion,form,fruit,glabrousnes,height,inflorescence,leaf,length,plant,seed,shape,size,texture,type	-1.5,0.5,1-1.5,1.5-2,1.5-3,2-2.5,2.5-3,3-4,3.5-6,4,4-5,5,5-6,6-9,acute,attenuate,beneath,berry,bluish,broadly,capitate,cm,completely,conical,cup-shaped,dark,deltate,densely,diameter,ellipsoid,elliptic,entire,erect,exerted,exfoliating,fleshy,glabrous,globose,green,less,matte,minutely,mm,occasionally,once-branched,overlapping,ovoid,pair,pale,papillate,peeling,pitted,poricidal,reddish,reniform,revolute,shiny,shrub,simple,slightly,stout,strongly,tan,tip,violet,white,x	black
507	wfo-0001031897	success	264	126	95	105	159	21	93	2	.1,.8,0.1-0.5,0.15,0.6,1.1,1.3-2,1.7-3,2-4,2/3,6-9,acute,along,anther,anthesi,apex,apically,bark,base,berry,black,brachyblast,branch,branched,brown,calyx,chartaceous,clavate,clustered,cm,conical,coriaceous,corolla,curved,dendritic,densely,developed,diameter,dilated,distributed,dry,drying,dull,elliptic,epiphyte,erect,evenly,eye,fruit,fruiting,glabrous,green,grey,hair,lanceolate,larger,lateral,leaf,light,long,mauve,mm,multicellular,naked,never,obconical,oblong,occasionally,orange-brown,ovoid,partly,pedicel,pericarp,petiole,plant,pointed,pubescent,reddish,ribbed,ridged,short,shrub,simple,slender,slightly,smooth,sometimes,sparse,sparsely,stem,stigma,style,surface,terete,terminal,thick,thin,trichome,unarmed,visible,weakly,white,winged,x,young	.5,0-1,0.2-0.4,0.4-1.1,0.5-1,0.5-3,0.8-1.5,0Â°,1,1-1.5,1-2,1-2.5,1.5,1.5-8,13,4-5,462.,5-6,8,abaxial,abaxially,absent,accrescent,adaxial,adaxially,age,almost,alyx,apar,apparently,appearing,appendage,arising,aristate,articulated,attenuate,axillary,bendy,boiteau,cell,clearly,concolorous,condensed,connate,covering,cuneate,dark,datum,dehiscing,delineated,dense,developing,development,divided,domatia,dorsal,dorsifixed,eaf,earliest,ed,enlarged,entire,equal,even,except,extending,faint,filament,filiform,fine,flower,foliaceous,free,immature,indistinc,inner,inside,known,lamina,least,lengthening,like,linear,lobe,lobed,longitudinal,longitudinally,looped,lower,m.,main,margi,margin,membranous,midvein,minute,minutely,multiseriate,nflorescence,nther,oblon,obtuse,occasional,one,orange,orolla,outside,ovate,overlapping,pair,papillose,part,peduncle,pendulous,perfec,persisting,plurifoliat,pore,poricidal,portion,primary,prominent,pronounced,protruding,raised,rarely,reach,revolute,ridge,ruit,scar,secondary,see,seen,shoot,side,sinus,smaller,smoot,stump,subulate,sunk,tearing,tertiary,tip,toward,tube,ud,unbranched,unicellular,unit,usually,vary,vein,venation,well-developed,wide,wrinkle,ympodial	arrangement,bud,characteristic,colour,exertion,form,growth,history,inflorescence,length,life,na,number,ovary,per,perennial,seed,shape,size,texture,type	.1,.8,0.1-0.5,0.15,0.6,1.1,1.3-2,1.7-3,2-4,2/3,6-9,acute,along,anthesi,apex,apically,base,berry,black,brachyblast,branch,branched,brown,chartaceous,clavate,clustered,cm,conical,coriaceous,corolla,curved,dendritic,densely,developed,dilated,distributed,dry,drying,dull,elliptic,epiphyte,erect,evenly,eye,fruit,glabrous,green,grey,hair,lanceolate,larger,lateral,light,long,mauve,mm,multicellular,naked,never,obconical,oblong,occasionally,orange-brown,ovoid,partly,pericarp,plant,pointed,pubescent,reddish,ribbed,ridged,short,shrub,simple,slender,slightly,smooth,sometimes,sparse,sparsely,stem,terete,terminal,thick,thin,unarmed,visible,weakly,white,winged,x,young	na,perennial
508	wfo-0001032157	success	136	107	73	83	53	24	69	4	.5,.75,0.25,0.6-1,1-3,1.9-2.2,2.2,3-6,5-15-flowered,5-9,7-9,9-17,acute,anther,apex,bark,base,becoming,beneath,berry,bi-lobed,calyx,cm,completely,corolla,crystalline,decurrent,deflexed,dia,dry,elliptic,exserted,filament,fruiting,glabrous,globose,golden,green,lateral,leaf,less,live,lobed,long,longitudinal,main,minutely,mm,nearly,ovary,ovoid-reniform,pair,paler,papillose,pedicel,peeling,petiole,pitted,plant,pore,poricidal,reddish,rounded,shaped,shiny,shrub,simple,size,slender,soon,stem,stigma,strip,style,surface,tapering,tear-drop,tip,tube,vein,white,x,yellowish	0.5-1,0.75-1,2-3,2-5,5-8,anthesi,apart,beginning,caly,deltoid,differing,difoliate,eaf,edicel,eed,evenly,free,frui,geminat,glabrou,incrassate,inflorescenc,living,lobe,lon,lower,major,margin,middle,minor,nflorescence,obscure,older,one,opposite,papillo,persistent,portion,raised,reflexed,ruit,scar,slightly,spaced,straight,tall,translucen,ud,unit,widest,woody,ympodial,young	arrangement,bud,characteristic,colour,diameter,exertion,form,fruit,growth,height,history,inflorescence,length,life,lobing,na,number,per,perennial,primary,seed,shape,texture,type	.5,.75,0.25,0.6-1,1-3,2.2,3-6,5-15-flowered,5-9,7-9,9-17,acute,base,becoming,beneath,berry,bi-lobed,calyx,cm,completely,crystalline,decurrent,deflexed,dia,dry,elliptic,exserted,glabrous,globose,golden,green,lateral,less,live,lobed,long,longitudinal,main,minutely,mm,nearly,ovoid-reniform,pair,paler,papillose,peeling,petiole,pitted,plant,pore,poricidal,reddish,rounded,shaped,shiny,shrub,simple,slender,soon,strip,surface,tapering,tear-drop,tip,tube,vein,white,x,yellowish	.9-2.2,di,na,perennial
509	wfo-0001032161	success	146	92	59	74	72	18	58	1	.5,0.4-1.2,0.7-4,0.8-1,1-1.5,1-11,1-3,1.2-1.3,1.4-2,2-7,2.5-3,3.5-4,?,acute,adaxially,anther,apex,area,bark,base,berry,calyx,cm,conical,corolla,dark,delicate,densely,dia,drying,ellipsoid,elliptic,filiform,fruiting,glabrous,globose,green,inflorescence,internodal,later,leaf,lobed,margin,merely,minutely,mm,mustard,nearly,obovate,opposite,ovary,ovoid-reniform,pale,papillose,pedicel,petiole,pitted,plant,pubescent,revolute,shaped,shrub,sparsely,stem,stigma,style,sulcate,surface,tan,tear-drop,thin,white,x,yellow	0.5-1,0.75-1,2-8-flowered,abaxially,adaxiall,anthesi,apical,ba,beneath,branched,brownish-blac,closely,color,coriaceous,deflexed,deltate,dendritic,difoliate,eaf,edicel,eed,exserted,filament,free,giving,golden,hanging,lamina,like,lobe,long,lower,many,middle,minute,nflorescence,occasionally,older,overlappin,pericarp,persistent,plurifoliate,pore,poricidal,portion,projection,quadrate,reflexed,rest,ruit,scar,shiny,shoot,short,simple,spaced,strongly,styl,tall,tip,trichome,tub,tube,ud,uniseriate,unit,usually,vein,widest,yellowish,ympodial,young	brownish-black,bud,characteristic,colour,diameter,form,fruit,growth,height,history,length,life,lobing,seed,shape,size,texture,type	.5,0.4-1.2,0.7-4,0.8-1,1-1.5,1-11,1-3,1.2-1.3,1.4-2,2-7,2.5-3,3.5-4,?,acute,adaxially,area,base,berry,cm,conical,dark,delicate,densely,dia,drying,ellipsoid,elliptic,filiform,glabrous,globose,green,internodal,later,leaf,lobed,merely,minutely,mm,mustard,nearly,obovate,opposite,ovoid-reniform,pale,papillose,pitted,pubescent,revolute,shaped,shrub,sparsely,sulcate,tan,tear-drop,thin,white,x,yellow	brownish-black
510	wfo-0001032165	success	197	84	51	65	132	19	48	3	1-1.2,1-1.5,1-2,1.5-4,10-25,2-2.5,3-6,5-15,5-6,5-7,8-9,anther,bark,base,berry,bud,capitate,center,cm,corolla,densely,dia,ellipsoid,elliptic,erect,exserted,fruiting,glabrous,globose,golden-puberulent,golden-pubescent,green,greyish-brown,inflorescence,later,leaf,minutely,mm,nearly,obovate,occasionally,once-furcate,ovary,ovoid-reniform,pale,pedicel,petiole,pitted,plant,purplish,ripe,shape,simple,size,stem,stigma,strongly,style,surface,tear-drop,tinged,tree,white,x,young	.25,.5,0.1,0.1-0.3,0.25-0.5,0.3-1,0.75-1,2.5-3.5,3-4,3.5-8.5,4-6,5-30-flowered,5-9.5,abaxial,acute,adaxial,along,anthesi,apex,apparent,appearing,ba,beginning,beneath,broadly,brown,calyx,closely,continued,cucullate,cup-shaped,dark,deciduous,decurrent,deltoid,denser,differing,difoliate,distal,dry,due,dull,eaf,edged,edicel,eed,end,entire,even,expansion,exsertion,filament,free,geminat,golden,immature,inflorescenc,lateral,less,like,live,lobe,lobed,lon,long,lower,main,major,margin,markedly,medial,middle,midrib,minor,minute,near,nflorescence,node,older,one,onto,opposite,orbicular,overlapping,pair,paler,papillo,papillose,planar,pore,poricidal,portion,presence,prominent,puberulent,rather,rest,ridge,rounded,ruit,scar,shaepd,single,slender,slightly,slow,small,smoot,spaced,specimen,stout,straight,stripe,swollen,tall,tapering,terminal,thickened,time,tip,trichome,tub,tube,ud,uniseriate,unit,vein,widest,winged,woody,yellowish,ympodial	alternate,arrangement,characteristic,colour,diameter,exertion,form,fruit,growth,height,history,length,life,lobing,perennial,seed,shaped,texture,type	1-1.2,1-1.5,1-2,1.5-4,10-25,2-2.5,3-6,5-15,5-6,5-7,8-9,base,berry,capitate,center,cm,densely,dia,ellipsoid,elliptic,erect,exserted,glabrous,globose,golden-puberulent,golden-pubescent,green,greyish-brown,later,minutely,mm,nearly,obovate,occasionally,once-furcate,ovoid-reniform,pale,pitted,purplish,ripe,simple,strongly,tear-drop,tinged,tree,white,x,young	alternate,perennial,shaped
511	wfo-0001032167	success	163	104	67	80	83	24	65	2	.5,0.5-1,0.5-2.5,0.75-3,1,1-2.5,1-5,1-7,1.5,10-20,10-35,12-20,2-7,2-foliate,3-6,5-15,7-10,absent,acute,anther,apex,base,berry,brown,calyx,cell,chartaceous,ciliate,cm,densely,diameter,dm,drying,elliptic,elliptic-ovoid,entire,few-,flower,forming,fruit,geniculate,globose,growth,hair,herb,immature,linear-lanceolate,many-branched,margin,maturing,membranaceous,mm,moderately,nearly,netlike,new,oblong,obtuse,pedicel,peduncle,per,petiole,projection,pubescent,purple,raised,rotate,rounded,seed,semitransparent,sparsely,staman,stigma,style,surface,two-celled,wall,white,x,yellow	0.5-1.5,1-2,1-2-celled,1-3,2-4,3-7,4-10,4-6,abaxially,abundant,adaxiall,adaxially,along,appressed,axe,blade,closely,common,connected,cordate,curved,decurrent,dehiscing,dense,denser,eaf,eed,emarginat,explosively,filament,flat,flattened,frui,geminat,glabrous,growt,held,interpetalar,larger,lobe,long,longer,lower,lowermost,lying,maturit,mesocarp,near,nfloresence,notch,often,older,one-celled,orolla,placenta,pressure,pubescen,rachi,ruit,shorter,slightly,small,smaller,sometimes,stamen,straight,tal,tamen,tem,tissue,triangular,tube,twisted,unbranched,unit,upper,usually,vary,vein,watery,wid,woody,ympodial	abaxial,adaxial,arrangement,branch,characteristic,colour,corolla,form,glabrousnes,height,history,inflorescence,leaf,length,life,ovary,perennial,plant,shape,size,stem,texture,type,wide	.5,0.5-1,0.5-2.5,0.75-3,1,1-2.5,1-5,1-7,1.5,10-20,10-35,12-20,2-7,2-foliate,3-6,5-15,7-10,absent,acute,berry,brown,cell,chartaceous,ciliate,cm,densely,diameter,dm,drying,elliptic,elliptic-ovoid,entire,few-,flower,forming,fruit,geniculate,globose,hair,herb,immature,linear-lanceolate,many-branched,maturing,membranaceous,mm,moderately,nearly,netlike,oblong,obtuse,per,projection,pubescent,purple,raised,rotate,rounded,semitransparent,sparsely,two-celled,wall,white,x,yellow	perennial,wide
512	wfo-0001032176	success	177	145	108	121	56	24	104	4	.5,0,0.42,0.5-0.7,0.5-1,0.8-1,0.8-6,1-1.2,1-10,1.5-1.6,1.5-2.5,1.5-6,1/2,3-3.5,3-4,3-7,5-6-celled,6,6-10,7,adaxially,along,anther,anthesi,apex,apical,basal,base,becoming,berry,branched,calyx,cell,cm,conical,copiously,corolla,creeping,cucullate,densely,denser,diameter,drying,ellipsoid,elliptic,epidermal,equal,especially,exserted,filament,filiform,fruiting,glabrous,globose,green,greenish,grey-brown,greyish,herb,lateral,leaf,leaflet,lengthening,like,lobe,lobed,long,long-papillose,lower,minute,mm,nearly,nodding,node,obovate,occasionally,onto,ovary,ovoid-reniform,pair,pale,pedicel,per,petiole,pinnate,pore,poricidal,projection,pubescent,quadrate,rachi,reflexed,rest,rooting,rounded,seed,simple,sinuous,size,slightly,slit,smaller,somewhat,soon,sparsely,stem,stigma,strongly,style,terminal,thickening,tip,trichome,tube,uniseriate,vein,wall,white,winged,without,x	0.5,0.5-0.75,100,2-3,2.5-10,3-15,adhering,apart,arising,attaining,attenuate,axil,axillary,beak,capitat,cateniform,containing,eaf,edicel,eed,fallen,flower,free,hangin,inflorescenc,lengt,log,margin,minutely,nflorescence,obtuse,often,open,papillose,petiolule,portion,ruit,scar,separate,single,spaced,strait,tem,tightly,time,tree,truncate,trunk,tub,ud,ultimate,unevenly,unifoliat,unit,whit,ympodial	arrangement,branching,bud,capitate,cateniforme,colour,exsertion,form,fruit,growth,history,inflorescence,length,life,lobing,number,plant,pubescence,shape,straith,surface,texture,type,winging	.5,0,0.42,0.5-0.7,0.5-1,0.8-1,0.8-6,1-1.2,1-10,1.5-1.6,1.5-2.5,1.5-6,1/2,3-3.5,3-4,3-7,5-6-celled,6,6-10,7,adaxially,along,anthesi,apical,base,becoming,berry,branched,calyx,cell,cm,conical,copiously,creeping,cucullate,densely,denser,drying,ellipsoid,elliptic,epidermal,equal,especially,exserted,filiform,glabrous,globose,green,greenish,grey-brown,greyish,herb,lateral,lengthening,like,lobe,lobed,long,long-papillose,lower,minute,mm,nearly,nodding,node,obovate,occasionally,onto,ovoid-reniform,pair,pale,pinnate,pore,poricidal,projection,pubescent,quadrate,rachi,reflexed,rest,rooting,rounded,simple,sinuous,size,slightly,slit,smaller,somewhat,soon,sparsely,stem,strongly,thickening,tip,trichome,tube,uniseriate,vein,wall,white,winged,without,x	capitate,cateniforme,inflorescence,straith
513	wfo-0001032187	success	132	119	86	98	34	21	83	3	0.1â1.4,0.5,0.5-1.1â3.2,0.5â1,0.6â1.3,1.8â2,1.8â2.8,100,1â1.7-2.1,22,24.6â26.3,2â9-11,3.1â3.5-4.2,3â3.2-4,3â4-5,5-merous,5â7-9,7â11,9,acuminate,acute,adherent,angular,anther,apex,appressed,aromatic,base,berry,blade,broadly,brown,brownish,changing,cm,consisting,corolla,cyme,dark,dull,eglandular,elliptic,entire,equal,erect,filament,flowered,forked,glabrescent,globose,green,hair,herb,leaf,light,lobe,long,margin,marked,mature,mm,numerous,obovate,occasionally,ovate,pedicel,peduncle,pentagonal,per,persistent,petiole,plant,pollen,purple,rarely,ridge,short,simple,small,soft,sparse,stage,stellate,stem,style,sub-glabrous,texture,tinged,tooth,triangular,truncate,well,widest,yellowish,Â±,Â±1,Âµm,Ã	1.3â1.8,1.6â2.1,alyx,ape,branch,di-foliate,dia,eaf,eed,fully,geminat,granule,hite,hooked,hydrated,lower,many,nflorescence,penden,perfec,petiolate,predominantly,presen,protruding,ruit,running,sclerotic,sometimes,spreading,straight,unit,wing,yellow,ympodial	arrangement,calyx,characteristic,colour,diameter,flower,form,fruit,growth,height,inflorescence,length,number,pendent,perfect,point,seed,shape,size,type,white	0.1â1.4,0.5,0.5-1.1â3.2,0.5â1,0.6â1.3,1.8â2,1.8â2.8,100,1â1.7-2.1,22,24.6â26.3,2â9-11,3.1â3.5-4.2,3â3.2-4,3â4-5,5-merous,5â7-9,7â11,9,acuminate,acute,adherent,angular,apex,appressed,aromatic,berry,broadly,brown,brownish,changing,cm,consisting,cyme,dark,dull,eglandular,elliptic,entire,equal,erect,flowered,forked,glabrescent,globose,green,hair,herb,light,long,margin,marked,mature,mm,numerous,obovate,occasionally,ovate,pentagonal,per,persistent,plant,purple,rarely,ridge,short,simple,small,soft,sparse,stage,stellate,sub-glabrous,tinged,tooth,triangular,truncate,well,yellowish,Â±,Â±1,Âµm,Ã	pendent,perfect,white
514	wfo-0001032206	success	213	156	119	133	80	23	116	3	.5,0,0-5,0.8â1.2,00â200,0â20,0â5,1.1â1.2,1.2â2.2,1.5â2.5,1/3,1/4â1/2,1â2,1â2.3,1â3,1â4,2.5â3.3,2.7â3.5,2â2.5,2â3,3.5â9,3â4,4â6,5â15,5â20,5â8,6â10,6â15-20,8â20,acute,anther,apart,apex,apically,apparently,approximately,armed,articulated,bark,base,berry,branched,calyx,chartaceous,cm,concolorous,connivent,cream,cuneate,dark,deltate,diameter,discolorous,distance,drying,elliptic,erect,extending,filament,flattened,flattened-reniform,flower,foliaceous,fruit,fruiting,glabrescent,glabrous,green,green-brown,lateral,leaf,length,lobe,lobed,lobing,long,long-styled,margin,marking,maturity,mauve,midvein,mm,moderately,obtuse,often,one,open,orange-brown,ovate,pair,pale,pedicel,peduncle,pendent,per,petiole,plant,poricidal,prickle,primary,purple,rarely,secondary,short-styled,shrub,side,slender,sometimes,spaced,spherical,stellate,stellate-pubescent,stem,straight,style,surface,tapering,time,tip,toward,trichome,truncate,tube,unarmed,usually,vein,weakly,white,wide,yellow,yellow-orange,young	..,.2,0.2,0.2â0.4,0.2â0.5-0.8,0.5â1,0â30,1-2,1.5â2,1/4â1/3,1/6,10â80,11â22,2â8,30â80,4.5â5.8,5-merous,5â6,5â9,6â8,7â10,abaxially,accrescent,adaxially,alyx,andromonoecious,apar,blade,bluntly,broad-deltate,brow,clearly,covering,curved,distal,eaf,eed,equal,free,functionally,gently,hermaphroditic,heterostylous,infructescence,lengt,longer,lowermost,mal,mature,midpoint,nflorescence,older,orolla,ower,pendulous,pericarp,plurifoliat,porrect,portion,ray,reflexed,scar,sessile,smooth,sparsely,spreading,stalk,stalked,stout,tamen,tertiary,uit,ung,unit,variously,vary,venation,visible,woody,ympodial	0.5â1.5,arrangement,branch,brown,characteristic,colour,corolla,exertion,form,glabrousnes,growth,height,inflorescence,na,new,number,ovary,seed,shape,size,stigma,texture,type	.5,0,0-5,0.8â1.2,00â200,0â20,0â5,1.1â1.2,1.2â2.2,1.5â2.5,1/3,1/4â1/2,1â2,1â2.3,1â3,1â4,2.5â3.3,2.7â3.5,2â2.5,2â3,3.5â9,3â4,4â6,5â15,5â20,5â8,6â10,6â15-20,8â20,acute,apart,apex,apically,apparently,approximately,armed,articulated,base,berry,branched,chartaceous,cm,concolorous,connivent,cream,cuneate,dark,deltate,diameter,discolorous,distance,drying,elliptic,erect,extending,flattened,flattened-reniform,flower,foliaceous,glabrescent,glabrous,green,green-brown,lateral,length,lobe,lobed,lobing,long,long-styled,marking,maturity,mauve,midvein,mm,moderately,obtuse,often,one,open,orange-brown,ovate,pair,pale,pendent,per,poricidal,prickle,purple,rarely,secondary,short-styled,shrub,side,slender,sometimes,spaced,spherical,stellate,stellate-pubescent,straight,surface,tapering,time,tip,toward,trichome,truncate,unarmed,usually,weakly,white,wide,yellow,yellow-orange,young	0.5â1.5,brown,na
515	wfo-0001032209	success	252	144	104	120	132	24	101	3	.5,0.5-1,1-6,1.5,1.5-6,10-13,2,2-3,2-3-lobed,2-5,2/3,20-30,3-7,4-20-30+,6-8,acute,along,anther,anthesi,apex,appearing,arching,basal,base,berry,bilobed,blue,branch,branched,broadly,brown,calyx,capitate,cell,climbing,cm,colour,conical,conspicuously,cordate,corolla,dark,dendritic,densely,diameter,early,ellipsoid,elliptic,entire,evenly,exerted,filament,flattened-reniform,fruiting,glabrous,globose,growth,hairy,hollow,inflorescence,lamina,lateral,leaf,length,like,lobed,margin,metallic,minute,minutely,mm,narrowly,nearly,new,occasionally,ovate,pair,papillae,pedicel,peduncle,per,petiole,pinnately,pinnatifid,primary,puberulent,pubescent,purple,red,reddish,rest,ripe,several,shiny,simple,sometimes,somewhat,spreading,stem,stigma,stout,style,surface,tapering,terminal,testa,time,tiny,trichome,truncate,tube,uniseriate,vein,vine,violet,wall,white,within,woody,x	0.3,0.5,1,1-1.5,1-2,1-2-celled,1.5-2,1.5-2.5,1.5-3-9-11,100,12-16,2.5-6-15-20,4,5-8,5-merou,absent,adaxial,ag,alyx,apart,apiculae,apparently,ark,articulated,axi,berr,bu,canopy,cast,chartaceous,connivent,coriaceous,cucullat,deeply,deltate,denser,distally,distinct,dried,eaf,ecuador,eed,enlarged,equal,erect,especially,finely,fleshy,flower,flowering,free,geminat,giving,glabrescen,groove,hanging,hastate,held,ilament,keeled,large,leathery,leaving,lengthening,less,lobe,long,longer,longest,lower,markedly,material,mean,mere,middle,midrib,midvein,mixture,near,nflorescence,nipple,often,older,one,orolla,papillat,papillate,part,particularly,peg,pentagonal,perfect,pericarp,planar,plurifoliate,pointed,pore,poricidal,portion,probably,pubescence,rhachi,rim,ruit,sagittate,scar,sleeve,slit,small,spaced,sparser,stellate,tem,testal,thin,third,tightly,tip,twinin,twining,ud,unequal,unit,upper,usually,variable,vary,w,weight,widest,yellow,ympodial	2.5-15-20,arrangement,bark,bud,characteristic,corrugation,drying,exertion,form,fruit,glabrousnes,height,history,life,lobing,na,number,ovary,plant,seed,shape,size,texture,type	.5,0.5-1,1-6,1.5,1.5-6,10-13,2,2-3,2-3-lobed,2-5,2/3,20-30,3-7,4-20-30+,6-8,acute,along,anthesi,appearing,arching,basal,base,berry,bilobed,blue,branched,broadly,brown,calyx,capitate,cell,climbing,cm,conical,conspicuously,cordate,dark,dendritic,densely,diameter,early,ellipsoid,elliptic,entire,evenly,exerted,flattened-reniform,glabrous,globose,hairy,hollow,inflorescence,lamina,lateral,like,lobed,metallic,minute,minutely,mm,narrowly,nearly,occasionally,ovate,pair,papillae,per,petiole,pinnately,pinnatifid,puberulent,pubescent,purple,red,reddish,rest,ripe,several,shiny,simple,sometimes,somewhat,spreading,stout,tapering,terminal,testa,time,tiny,trichome,truncate,tube,uniseriate,vein,vine,violet,wall,white,within,woody,x	2.5-15-20,bud,na
516	wfo-0001032232	success	137	93	56	70	67	23	52	4	.5,0.25,0.5,0.5-1,0.6-3,0.8-1,1-3,1.8-2,18.8-27.5,2,2-2.6,20-100-flowered,3/4,4.8-7.3,5-6,anther,apex,attenuate,bark,base,berry,calyx,clavate,cm,corolla,dark-papillose,dia,elliptic,erose,filiform,fruiting,glabrous,globose,green,greenish-brown,leaf,lenticellate,less,light,lightly,long,long-acuminate,margin,minutely,mm,narrowly,occasionally,ovary,ovoid-reniform,pale,papillose,pedicel,petiole,pitted,revolute,shrub,simple,slightly,stem,stigma,straight,style,subshrub,surface,tube,umbonate,undulate,way,wide,winged	0.1,?,abruptly,age,anthesi,ba,becoming,closely,cup-shaped,decurrent,deflexed,distally,eaf,edicel,eed,erect,evenly,exfoliatin,filament,flower,free,immature,irregular,lateral,lobe,lobed,lower,main,middle,midrib,minute,nflorescence,node,onto,opposite,overlappin,packed,pair,paler,papillo,pore,poricidal,portion,prominent,raised,reflexed,rounded,ruit,scar,shaped,short-styled,somewhat,sparsely,tall,tear-drop,ti,tip,translucent,tub,ud,unifoliat,unit,vein,widening,widest,woody,ympodial	arrangement,characteristic,colour,diameter,exfoliating,form,fruit,glabrousnes,growth,height,history,inflorescence,length,life,lobing,plant,seed,shape,size,texture,type,unifoliate,width	.5,0.25,0.5,0.5-1,0.6-3,0.8-1,1-3,18.8-27.5,2,2-2.6,20-100-flowered,3/4,4.8-7.3,5-6,attenuate,base,berry,clavate,cm,dark-papillose,dia,elliptic,erose,filiform,glabrous,globose,green,greenish-brown,lenticellate,less,light,lightly,long,long-acuminate,minutely,mm,narrowly,occasionally,ovoid-reniform,pale,pitted,revolute,shrub,simple,slightly,straight,subshrub,umbonate,undulate,way,wide,winged	.8-2,di,exfoliating,unifoliate
517	wfo-0001032233	success	160	125	64	72	88	53	62	2	0-2,0.3-2,1-1.5,1.5-2.5,10-15,2-15,2-3,2-5.5,2-6,3-4,3.5-4,4-18,4-5,5-6,6-25,acuminate,acute,almost,apex,basal,base,beyond,calyx,chartaceous,cm,convex,cordate,cylindrical,dark,densely,diameter,ellipsoidal,entire,exserted,flattened,fruit,glabrescent,glabrous,globose,green,lobe,longitudinal,margin,mm,moderately,narrowly,oblong,orange,ovate,ovoid,pedicel,peduncle,petiole,puberulent,pubescent,purple,shallowly,simple,stamen,stigma,stripe,style,subcoriaceous,subpeltiform,tree,triangular,truncate,tube,vein,x,yellow,yellow-green	1-2,1-3,157,2-4,2.5-4,20-100+,25-40,3-15,3-4.5,3-5,4-7,4-foliat,5-16,8-12,abaxially,absen,absent,adaxial,adaxially,aggregate,apart,ape,articulated,axe,bent,biglandula,blade,branched,brow,cell,connective,connivent,coriaceous,dilated,directed,distally,eaf,eed,equal,especially,exceeding,fleischmann,fleshy,flower,glabrate,glandular-puberulent,laterally,leaving,lon,long,lower,nflorescence,nther,obtuse,orolla,pedicellar,perfect,pore,present,projection,puberulen,rachise,radiu,remnant,ruit,shorter,slightly,small,somewhat,spaced,sparsely,stellate,stone,tal,tem,thecae,time,tip,tomento,toward,ud,unbranched,unit,vary,white,wide,yellow-orange,ympodial	anther,appearance,arrangement,bark,biglandular,border,branch,bud,characteristic,colour,corolla,corrugation,distal,drying,exertion,filament,form,fruiting,giving,glabrousnes,growth,height,history,inflorescence,interjected,lateral,leaf,leaflet,length,life,lobing,midpoint,na,new,number,ovary,per,plant,prickle,primary,pseudostipule,ray,seed,shape,size,stem,surface,terminal,texture,thicknes,type,variation,width	0-2,0.3-2,1-1.5,1.5-2.5,10-15,2-15,2-3,2-5.5,2-6,3-4,3.5-4,4-18,4-5,5-6,6-25,acuminate,acute,almost,apex,basal,base,beyond,chartaceous,cm,convex,cordate,cylindrical,dark,densely,diameter,ellipsoidal,entire,exserted,flattened,glabrescent,glabrous,globose,green,lobe,longitudinal,mm,moderately,narrowly,oblong,orange,ovate,ovoid,puberulent,pubescent,purple,shallowly,simple,stamen,stripe,subcoriaceous,subpeltiform,tree,triangular,truncate,x,yellow,yellow-green	biglandular,na
518	wfo-0001032259	success	201	113	77	95	106	18	76	1	-4,/3,0.45-0.6,0.5-0.8,0.5-1.5,0.7-1.1,0.8-1.3,0.9-1.2,1-2,1-2.5,1.5-4.5,10-30,2-2.5,2.2-3,3-4,4,4-5,5.5-8,7-16,9-22,abaxial,acute,adaxial,almost,anther,apex,apically,apparently,articulated,bark,base,berry,brown,calyx,cm,conical,connivent,cordate,cuneate,dark,deltate,densely,diameter,dull,evenly,flattened,flattened-reniform,fruit,fruiting,glabrescent,glabrous,green,lateral,leaf,length,lobe,lobed,long,margin,maturity,mauve,mm,orange,orange-brown,ovate,pair,pedicel,peduncle,petiole,poricidal,prickle,primary,pubescent,recurved,red,shrub,simple,sparsely,spherical,stellate,stellate-pubescent,straight,style,surface,tapering,terminal,tip,toward,trichome,vein,way,white,wide,yellow,young	.5,/4,0-10,0-2,0-20,0-4,0-5,0.1-0.2,0.1-0.3,0.15-0.3,1-1.8,1/2,1/3,1/4-1/3,1/6-1/5,15-40,2-4,2-5,20-60,3/,4-6,4-9,5,5-30,5-merous,7-8,abaxially,acut,alyx,apar,apart,becoming,blade,branched,broad-deltate,brownish,chartaceous,difoliate,discolorous,distance,drying,eaf,eed,elongating,equal,erect,extending,filament,flower,free,fully,geminate,gland,green-brow,hair,infructescence,longer,lower,mature,midpoint,midvein,minute,moderately,nflorescence,older,one,open,opening,orolla,oung,pendulous,per,perfec,pericarp,porrect,portion,prickl,prickly,ray,reduced,rounded,ruit,scar,sessile,shorter,side,slender,smooth,sometimes,spaced,spreading,stem,strongly,tamen,terete,tertiary,time,tube,unarmed,unit,vary,venation,visible,woody,yellow-green,ympodial	arrangement,characteristic,colour,corolla,form,green-brown,growth,height,inflorescence,ovary,plant,seed,shape,size,staman,texture,type,width	-4,/3,0.45-0.6,0.5-0.8,0.5-1.5,0.7-1.1,0.8-1.3,0.9-1.2,1-2,1-2.5,1.5-4.5,10-30,2-2.5,2.2-3,3-4,4,4-5,5.5-8,7-16,9-22,acute,almost,apex,apically,apparently,articulated,base,berry,brown,cm,conical,connivent,cordate,cuneate,dark,deltate,densely,diameter,dull,evenly,flattened,flattened-reniform,glabrescent,glabrous,green,lateral,lobed,long,maturity,mauve,mm,orange,orange-brown,ovate,pair,poricidal,pubescent,recurved,red,shrub,simple,sparsely,spherical,stellate,stellate-pubescent,straight,tapering,terminal,tip,toward,trichome,way,white,wide,yellow,young	green-brown
519	wfo-0001032260	success	210	149	90	111	99	38	88	2	-10,-8,/5,0-10-30,0-20,0-5,0-8,0.2-0.5,0.5-0.8,0.5-2,0.5-5,0.6-0.8-1.5,0.7-1.5,0.8-1.1,1-1.7,1.2-1.7,1.5-4,2,2.5,2.5-3,2.5-3.5,3-5,3-8,3-9,6-10,acuminate,acute,anther,apart,apex,apparently,articulated,bark,base,berry,calyx,cell,cm,cuneate,curved,deltate,densely,diameter,discolorous,drying,dull,elliptic,erect,filament,flattened,flattened-reniform,fruit,fruiting,glabrous,glaucous,green-brown,lateral,leaf,length,lobe,lobed,long,margin,maturity,mauve,midpoint,mm,orange-brown,outline,ovate,pair,pale,pedicel,peduncle,per,petiole,pit,poricidal,prickle,prickly,primary,pubescent,purple,raised,ray,red,rounded,scandent,shallowly,shrub,simple,small,spaced,sparsely,spherical,stellate,stellate-pubescent,stem,strongly,style,subentire,surface,tapering,terminal,tip,tube,vein,way,wide,yellow,yellow-green	-3,.1,0-0.5,0-10,0-5-20,0.1,0.1-0.3,0.1-0.4,0.15-0.3,0.4,0.7,1-3,1-5,1-6,1/2,1/3,1/3-1/2,1/3-1/5,2-20,2-4,2-5,3-10,4-5-merous,5-6-8,7-15,abaxial,abaxially,acuminat,adaxial,alyx,apar,apically,blade,branched,broad-deltate,chartaceous,connivent,difoliate,distance,eaf,eed,elongating,equal,extending,eye,flower,free,geminat,glabrescent,glabrou,gland,globular,gray-brow,infructescence,lon,long-styled,longer,lower,mature,midvein,moderately,naked,narrow-ovate,nflorescence,older,one,open,orolla,oung,pendulous,perfec,pericarp,porrect,portion,prickl,reduced,reflexed,ruit,scar,sessile,shorter,side,slender,smooth,spreading,stalk,stalked,tamen,terete,tertiary,time,trichome,unit,variously,vary,venation,visible,woody,ympodial	appearance,arrangement,border,branch,bud,characteristic,colour,corolla,corrugation,distal,exertion,form,giving,glabrousnes,gray-brown,growth,height,history,inflorescence,interjected,leaflet,life,lobing,na,new,number,ovary,plant,pseudostipule,seed,shape,size,stigma,texture,thicknes,type,variation,width	-10,-8,/5,0-10-30,0-20,0-5,0-8,0.2-0.5,0.5-0.8,0.5-2,0.5-5,0.6-0.8-1.5,0.7-1.5,0.8-1.1,1-1.7,1.2-1.7,1.5-4,2,2.5,2.5-3,2.5-3.5,3-5,3-8,3-9,6-10,acuminate,acute,apart,apparently,articulated,base,berry,cell,cm,cuneate,curved,deltate,densely,diameter,discolorous,dull,elliptic,erect,flattened,flattened-reniform,glabrous,glaucous,green-brown,lateral,lobed,long,maturity,mauve,mm,orange-brown,outline,ovate,pair,pale,per,pit,poricidal,prickle,prickly,pubescent,purple,raised,red,rounded,scandent,shallowly,shrub,simple,small,spaced,sparsely,spherical,stellate,stellate-pubescent,strongly,subentire,tapering,terminal,tip,way,wide,yellow,yellow-green	gray-brown,na
520	wfo-0001032264	success	183	97	62	75	108	22	58	4	0.6-2.2,0.8-10,1-1.5,1.2-2,1.5-1.8,1.8-3,2-6,3,3-15,6-17,acuminate,acute,anther,apex,apiculate,bark,base,berry,branched,bud,calyx,cm,corolla,densely,dia,elliptic,exserted,flattened-reniform,fruiting,glabrous,globose,gnarled,green,inflorescence,leaf,minutely,mm,multiseriate,narrowly,nearly,occasionally,ovary,ovoid,pale,pedicel,petiole,pitted,plant,pubescent,red-papillose,reddish-tan,several,shaped,shrub,simple,size,slender,small-capitate,soon,sparsely,stem,stigma,style,surface,tapering,tear-drop,time,tree,trichome,tube,uniseriate,weak,white,x,yellowish-brown	.2,.5,0.25-0.5,0.25-0.75,0.5-1,0.8-4,10-22,2-50-flowered,3-9,4.5-5,5-9,along,anthesi,apar,appearing,ba,broadly,bullate,cell,cell-layer,closely,cup-like,curling,deciduous,deflexed,differing,difoliate,dry,eaf,edicel,eed,epidermal,filament,fleshy,flower,free,geminat,greyi,habitat,hair,incrassate,lamina,large,larger,lateral,layer,like,live,lobe,lobed,lon,long,lower,main,major,margin,material,middle,minor,minute,nflorescence,often,older,one,opposite,overlapping,pair,papillo,papillose,parallel,peeling,planar,pointed,pore,poricidal,portion,primarily,prominent,quite,raised,reddish,revolute,rounded-deltoid,ruit,scar,scattered,sheet,sheltered,short,small-celled,somewhat,spaced,straight,tall,thick,tip,transversely,trunk,ud,unit,upper,vein,whitish,wide,widest,woody,ympodial,young	4-8,abaxial,alternate,arrangement,characteristic,colour,diameter,exertion,form,fruit,greyish,growth,height,history,length,life,lobing,perennial,seed,shape,texture,type	0.6-2.2,0.8-10,1-1.5,1.2-2,1.5-1.8,1.8-3,2-6,3,3-15,6-17,acuminate,acute,apiculate,base,berry,branched,calyx,cm,densely,dia,elliptic,exserted,flattened-reniform,glabrous,globose,gnarled,green,minutely,mm,multiseriate,narrowly,nearly,occasionally,ovoid,pale,pitted,pubescent,red-papillose,reddish-tan,several,shaped,shrub,simple,slender,small-capitate,soon,sparsely,tapering,tear-drop,time,tree,trichome,tube,uniseriate,weak,white,x,yellowish-brown	4-8,alternate,greyish,perennial
521	wfo-0001032274	success	192	111	71	89	103	22	70	1	0,0.15-0.2,0.5-0.7,0.5-1,0.7-1.8,0.9-1,1-1.2,1-1.5,1-3,1.5-2,2,3-6,3/4,5-7,acuminate,acute,anther,anthesi,apex,axillary,basal,base,berry,brown,calyx,capitate,cm,corolla,densely,diameter,ellipsoid,elliptic,entire,exserted,filament,filiform,flattened-reniform,fruiting,glabrous,globose,growth,inflorescence,lanceolate,leaf,lobe,lobed,margin,minute,minutely,mm,new,nodding,obtusely,often,once-branched,one,pedicel,peduncle,per,petiole,pitted,pubescent,purple,red,reddish,ripe,rounded,shape,shiny,shoot,short,shrub,simple,size,sometimes,sparsely,stem,stigma,style,surface,terminal,tinged,truncate,tube,two,violet,way,white,x	.5,0.5,0.5-1.5,2-3.5,2-7,3-10,3-4,3-5,5-merou,<,ag,alyx,apiculate,apparently,appearance,arching,ark,articulated,ba,borne,branch,cell,clustered,conical,connivent,deltate,dendritic,distal,eaf,eed,fleshy,flower,free,geminat,glabrou,green,grey,group,highly,ilament,irregular,lax,lengthening,less,like,long,loosely,lower,markedly,membranous,nflorescence,non-reproductive,occasionally,older,orolla,pair,pale,papillo,peg,pendan,perfect,pericarp,platfor,platform,plurifoliate,pore,poricidal,portion,primary,puberulent,quadrate,reflexed,reproductive,ridge,ridged,ruit,scar,sleeve,slit,small,somewhat,square,stellate,strongly,suckering,tem,testal,thin,tip,trichome,twinin,ud,uniseriate,unit,upper,usually,variable,vary,vein,visible,woody,yellow,ympodial	abaxial,adaxial,arrangement,bud,characteristic,colour,exertion,form,fruit,glabrousnes,height,history,length,life,lobing,number,ovary,perennial,plant,seed,texture,type	0,0.15-0.2,0.5-0.7,0.5-1,0.7-1.8,0.9-1,1-1.2,1-1.5,1-3,1.5-2,2,3-6,3/4,5-7,acuminate,acute,anthesi,axillary,basal,base,berry,brown,calyx,capitate,cm,densely,diameter,ellipsoid,elliptic,entire,exserted,filiform,flattened-reniform,glabrous,globose,lanceolate,lobe,lobed,minute,minutely,mm,nodding,obtusely,often,once-branched,one,per,pitted,pubescent,purple,red,reddish,ripe,rounded,shiny,shoot,short,shrub,simple,sometimes,sparsely,terminal,tinged,truncate,tube,two,violet,way,white,x	perennial
522	wfo-0001032276	success	152	101	73	83	69	18	71	2	-,.25,.5,0.3-1,0.5-0.75,0.5-1,0.8-1,1-1.5,1-2,1.8-2,3-6-flowered,5-7,acute,along,anther,anthesi,apex,attenuate,bark,base,beneath,broadly,brown,calyx,cm,corolla,cup-shaped,curly-tipped,dark,decurrent,densely,dia,dry,elliptic,filiform,fruiting,glabrous,globose,green,lamina,leaf,lobe,lobed,long,long-pubescent,material,minutely,mm,narrowly,nearly,occasionally,onto,ovary,ovoid-reniform,pale,pedicel,perhaps,petiole,pitted,plant,prominent,pubescent,reflexed,shaped,shrub,simple,slender,sparsely,stem,stigma,straw-colored,style,surface,tapering,tear-drop,trichome,tube,unifoliate,uniseriate,vein,white,winged,yellow	0.25-1.5,1,2-2.5,2.5-4,3-3.5,7-8,9-18,apart,ba,blade,capitat,converging,deflexed,deltoid,eaf,edicel,eed,ellipsoid,evenly,except,exserted,filament,free,geminate,greyish-gree,later,lateral,like,lower,main,margin,middle,minute,nflorescence,node,non-reproductive,obovoid,older,opposite,pair,papillose,pore,poricidal,portion,raise,raised,remaining,rest,ruit,scar,short,slightly,somewhat,soon,spaced,straight,strongly,tall,tip,triangular,tub,ud,unit,widely,widest,woody,x,ympodial,young	arrangement,capitate,characteristic,colour,diameter,form,fruit,greyish-green,growth,height,inflorescence,length,lobing,seed,shape,size,texture,type	-,.25,.5,0.3-1,0.5-0.75,0.5-1,0.8-1,1-1.5,1-2,1.8-2,3-6-flowered,5-7,acute,along,anthesi,attenuate,base,beneath,broadly,brown,calyx,cm,cup-shaped,curly-tipped,dark,decurrent,densely,dia,dry,elliptic,filiform,glabrous,globose,green,lamina,leaf,lobe,lobed,long,long-pubescent,material,minutely,mm,narrowly,nearly,occasionally,onto,ovoid-reniform,pale,perhaps,petiole,pitted,prominent,pubescent,reflexed,shaped,shrub,simple,slender,sparsely,straw-colored,tapering,tear-drop,trichome,tube,unifoliate,uniseriate,vein,white,winged,yellow	capitate,greyish-green
523	wfo-0001032277	success	163	121	87	97	66	24	82	5	.5,0.1-0.5,0.2-0.6,0.75-1,0.8-3,1-1.1,1-1.2,1-2,1.5-1.8,1/2,2-2.5,2-4,2-6-flowered,3-3.5,5-6,8-9,acute,along,anther,anthesi,apex,area,bark,base,beneath,berry,blunt,branched,bright,calyx,cm,corolla,cup-shaped,densely,dia,ellipsoid,elliptic,filament,flattened-reniform,fruit,fruiting,glabrous,globose,green,immature,inflorescence,internodal,lax,leaf,lobed,long,margin,minutely,mm,number,opposite,ovary,pale,papillae,papillose,pedicel,petiole,pitted,pore,poricidal,puberulent,pubescent,revolute,ripe,round,rounded,shrub,simple,slender,small,sparsely,stem,stigma,straight,strict,style,surface,tapering,tip,translucent,trichome,tube,uniseriate,unit,varying,vein,virgately,way,white,x,yellow,yellowish-tan	1-1.5,1-5,10-14,3-9,apiculate,appear,appearing,auriculate,ba,blade,closely,coriaceous,deltoid,drooping,dry,eaf,edicel,eed,erect,exserted,free,geminat,gre,impressed,incrassate,indentation,lateral,like,lobe,lower,main,mature,middle,nflorescence,obscured,occasionally,older,overlapping,pair,paler,partially,portion,prominent,pubescenc,raised,reddish,remaining,rest,ruit,scar,slende,spaced,specimen,spicy-fragrant,strongly,styl,tall,truncate,trunk,tub,two,ud,widest,woody,ympodial,young	arrangement,bud,characteristic,colour,diameter,exertion,form,grey,growth,height,history,length,life,lobing,na,peduncle,per,plant,seed,shape,size,sympodial,texture,type	.5,0.1-0.5,0.2-0.6,0.75-1,0.8-3,1-1.1,1-1.2,1-2,1.5-1.8,1/2,2-2.5,2-4,2-6-flowered,3-3.5,5-6,8-9,acute,along,anthesi,area,base,beneath,berry,blunt,branched,bright,calyx,cm,cup-shaped,densely,dia,ellipsoid,elliptic,flattened-reniform,glabrous,globose,green,immature,internodal,lax,leaf,lobed,long,minutely,mm,number,opposite,pale,papillae,papillose,pitted,pore,poricidal,puberulent,pubescent,revolute,ripe,round,rounded,shrub,simple,slender,small,sparsely,straight,strict,style,tapering,tip,translucent,trichome,tube,uniseriate,unit,varying,vein,virgately,way,white,x,yellow,yellowish-tan	.5-1.8,di,grey,na,sympodial
524	wfo-0001032304	success	249	162	107	123	126	39	103	4	0.2-0.3,0.5-4.5,1-3.5,1.1-2,1.2-2.3,1.3-2.1,1.6-1.9,10,18,2-5,2.5-19.5,2/3-3/4,3-10,3-15,3-4.5,3-6,4-7.5,5.5-9,7-27,9-13,abaxially,acuminate,acute,adaxially,anther,anthesi,apex,bark,base,becoming,berry,blackish,blunt-tipped,branch,branched,broadly,brown,brownish,bud,calyx,campanulate,cm,conical,continued,corolla,dark,deltoid,densely,diameter,distal,due,elliptic,entire,exserted,filament,fleshy,flower,fruit,fruiting,glabrescent,glabrous,granular-tomentose,green,greenish,growth,honeycombed,lateral,leaf,least,length,lobe,long-attenuate,margin,midvein,mm,mostly,oblong,obtuse,orbicular,ovate,ovate-lanceolate,pale,pedicel,peduncle,petiole,plant,probably,pubescent,rather,ray,reniform,reticulate-punctate,ripe,scabridulous,seed,short-,shrub,side,simple,small,sparingly,spreading,stamen,stem,stigma,style,subglobose,suborbicular,terete,time,tomentose,tree,tube,unarmed,vein,velutinous,violet,way,white,whitish,x,yellow,yellowish	-3,.6-1.2,.9-1.4,/20,0-120,0.3-1.5,0.5-3,0.9-1.3,1,1.2-3,1.5-3.2,1.8-4,1/2,1/3-1/2,1/5,1/8,2-4,2-4.2,21,3-20,3.2-3.8,3.2-5.5,44,5-6,7.5-12,accrescent,ag,along,apart,apical-lateral,apparently,appressed-tomentose,articulated,ascending,axe,axillary,ba,blade,capitat,chartaceous,closely,decurrent,dehiscing,dendritic,dendritic-echinoi,dendritic-echinoid,directed,eaf,echinoi,echinoid,especially,extend,few-,few-rayed,free,glabrescen,hair,high,inserted,introrse,juvenile,large,lobed,long,long-,long-stalked,longitudinal,lower,m.,main,many,many-rayed,mixed,multangulat,multangulate,nflorescence,obscured,occasionally,often,older,opaque,orolla,ovat,overlapping,partly,perfect,plurifoliate,pore,porrect-stellate,present,pseudo-terminal,rachi,rarely,relatively,rotate-stellate,ruit,runk,sessile,short,short-stalked,slit,somewhat,spaced,stellate-tomentose,strongly,sulcate,suture,tamen,testa,thick,thick-stalked,thin,thin-,thin-stalked,tomentu,touching,toward,triangular-ovate,unarme,unit,usually,vary,wide,within,ympodial,young	0.9-1.4,appearance,arrangement,border,capitate,characteristic,colour,corrugation,drying,exertion,form,giving,glabrousnes,height,history,inflorescence,interjected,leaflet,life,lobing,midpoint,na,new,number,ovary,per,prickle,primary,pseud-terminal,pseudostipule,shape,size,surface,terminal,texture,thicknes,type,variation,width	0.2-0.3,0.5-4.5,1-3.5,1.1-2,1.2-2.3,1.3-2.1,1.6-1.9,10,18,2-5,2.5-19.5,2/3-3/4,3-10,3-15,3-4.5,3-6,4-7.5,5.5-9,7-27,9-13,abaxially,acuminate,acute,adaxially,anthesi,apex,base,becoming,berry,blackish,blunt-tipped,branched,broadly,brown,brownish,calyx,campanulate,cm,conical,continued,dark,deltoid,densely,diameter,due,elliptic,entire,exserted,fleshy,flower,fruit,glabrescent,glabrous,granular-tomentose,green,greenish,growth,honeycombed,lateral,least,length,lobe,long-attenuate,midvein,mm,mostly,oblong,obtuse,orbicular,ovate,ovate-lanceolate,pale,probably,pubescent,rather,reniform,reticulate-punctate,ripe,scabridulous,short-,shrub,side,simple,small,sparingly,spreading,stamen,stem,subglobose,suborbicular,terete,time,tomentose,tree,unarmed,velutinous,violet,way,white,whitish,x,yellow,yellowish	0.9-1.4,capitate,na,pseud-terminal
525	wfo-0001032307	success	153	124	83	101	52	23	80	3	.5,/3,0.2-0.5,0.4-1.3,1-1.5,1-2,1.5-5,10-20,2-5,2.5-12,30,4-8,5-12,5-25-flowered,7-18,abaxial,acute,adaxial,along,anther,apex,bark,base,berry,branch,branched,calyx,campanulate,capitate,cm,congested,corolla,dark,dendritic,densely,dia,ellipsoid,elliptic,erect,exserted,filament,flat,flattened-reniform,fruiting,glabrate,glabrous,globose,green,growth,incrassate,inflorescence,later,lateral,leaf,like,lobed,long,loose,main,many,margin,minutely,mm,new,ovary,pair,pale,pedicel,petiole,pitted,plant,prominent,pubescent,reddish,reddish-brown,rest,shaped,shrub,small,sparsely,stem,stigma,stout,strongly,style,surface,tan,tear-drop,terminal,thick,time,tree,tree-like,trichome,truncate,tube,type,vein,way,white,wide	1.5-2,2.5-3,2.5-3.5,3.5-4,?,anthesi,apar,blade,body,brow,christmas-tree-like,deltate,eaf,edicel,eed,either,elongate,fleshy,free,immature,inflorescenc,lobe,lon,lower,middle,minute,nflorescence,older,papillae,papillo,petal,planar,plurifoliat,pore,poricidal,portion,ruit,scar,spaced,tall,thickened,tip,tub,ud,unevenly,upper,variable,widest,within,woody,ympodia,young	arrangement,brown,bud,characteristic,colour,diameter,exertion,form,fruit,glabrousnes,height,history,length,life,lobing,peduncle,perennial,plurifoliate,primary,seed,shape,size,texture	.5,/3,0.2-0.5,0.4-1.3,1-1.5,1-2,1.5-5,10-20,2-5,2.5-12,30,4-8,5-12,5-25-flowered,7-18,acute,along,base,berry,branched,calyx,campanulate,capitate,cm,congested,dark,dendritic,densely,dia,ellipsoid,elliptic,erect,exserted,flat,flattened-reniform,glabrate,glabrous,globose,green,incrassate,inflorescence,later,lateral,like,lobed,long,loose,main,many,margin,minutely,mm,pair,pale,pitted,prominent,pubescent,reddish,reddish-brown,rest,shaped,shrub,small,sparsely,stout,strongly,tan,tear-drop,terminal,thick,time,tree,tree-like,trichome,truncate,tube,vein,way,white,wide	brown,perennial,plurifoliate
526	wfo-0001032308	success	190	156	109	131	59	25	106	3	0-3,0.7-1,0.7-1.2,1-10,1-2,1.5-2.5,1.8-2.5,1.9-3,12-16,2,2-4,3-10,3-6,3.8-5,4-7,4-8,4.8-7.7,5-7,6,6-11,8-9,abaxially,absent,acumen,adaxially,anther,apart,axillary,base,berry,blade,broadly,brownish,bud,cell,chartaceous,ciliate,clavate,cm,condition,connivent,corolla,covering,cuneate,deep,diameter,distal,dorsally,dot,drying,edge,elliptic,filament,flat,flower,folded,forked,fresh,fruit,generally,glabrous,globose,green,green-white,greenish,hair,hair-like,half,interjected,lanceolate,lateral,leaflet,lengthening,like,lobe,lobed,long,make,margin,medium,membranous,minute,minutely,mm,mucilaginous,odd-pinnate,often,ovoid,pair,pedicel,peduncle,pentagonal,perfect,petiole,plant,plurifoliate,pore,poricidal,puberulent,pubescent,pure,ripe,scattered,seed,shape,slightly,slit,stem,stigma,straight,style,substellate,subtending,sympodial,terminal,testal,thick,throughout,tip,tri-,truncate,tube,unit,usually,wall,wet,white,whitish,wide,x,yellow	0.2-2.1,0.3-5,2-3,2-6,5-merou,acute,ag,along,alyx,apex,apparently,articulated,axe,capitat,cordate,digestion,eaf,eed,enzyme,especially,exceeding,geminat,glabrou,greatly,hal,homostylous,honeycomb-shaped,invested,irregular,larger,leave,living,lower,midrib,much,narrowly,nflorescence,non-glandular,obtuse,orbicular,orolla,ovate,petiolulate,petiolule,removed,rounded,ruit,sessile,seudostipule,short,spaced,specimen,stamen,ste,tamen,trichome,typically,vary,varying	abaxial,adaxial,age,arrangement,articulation,calyx,capitate,colour,form,growth,history,inflorescence,leaf,length,life,na,number,ovary,pseudostipule,size,spacing,state,surface,texture,type	0-3,0.7-1,0.7-1.2,1-10,1-2,1.5-2.5,1.8-2.5,1.9-3,12-16,2,2-4,3-10,3-6,3.8-5,4-7,4-8,4.8-7.7,5-7,6,6-11,8-9,absent,apart,axillary,berry,broadly,brownish,bud,cell,chartaceous,ciliate,clavate,cm,condition,connivent,corolla,covering,cuneate,deep,distal,dorsally,dot,drying,elliptic,flat,folded,forked,fresh,generally,glabrous,globose,green,green-white,greenish,hair,hair-like,half,lanceolate,lateral,lengthening,like,lobed,long,make,medium,membranous,minute,minutely,mm,mucilaginous,odd-pinnate,often,ovoid,pentagonal,perfect,plant,plurifoliate,pore,poricidal,puberulent,pubescent,pure,ripe,scattered,seed,slightly,slit,stem,straight,substellate,subtending,terminal,testal,thick,throughout,tip,tri-,truncate,usually,wall,wet,white,whitish,wide,x,yellow	age,capitate,na
527	wfo-0001032335	success	214	137	100	99	115	38	85	15	.2,0.4,100,100+,15,16,>,abaxial,acuminate,acute,adaxial,along,anther,anthesi,apex,attenuate,axe,base,berry,branched,bright,c.,calyx,capitate,chartaceous,cm,connivent,corolla,cup-shaped,densely,diameter,ellipsoidal,elliptic,entire,evenly,exserted,filament,flattened-reniform,flower,fruiting,glabrous,globose,gold,golden-yellow,gradually,growth,inflorescence,length,like,long,loosely,many,margin,membranous,minute,minutely,mm,moderately,multangulate,narrowing,narrowly,new,nodding,onto,orange,pale,pedicel,peduncle,peltate,per,persistent,petiole,pitted,plane,porrect-stellate,pubescent,ray,reddish,ripe,sessile,short-stalked,shrub,simple,small,somewhat,stem,stigma,stout,strongly,style,surface,terminal,time,tree,trichome,tube,way,white,wide	.5,0,0.05,0.2,0.2â0.3,0.5,0.5â1,0.9â1,1.5â2,10â12,12â15,1â1.2,1â1.5,1â3,2.5â3,2â10,2â2.5,2â5,3361,4â14,4â5,4â6-rayed,5-merou,5â6,6â19,6â6.5,7â10,abaxially,ag,alyx,apar,appearing,ark,articulated,beneath,boh,branching,cell,center,closely,covered,deltate,dichasia,discolorous,drying,eaf,eed,elongate,equal,erec,fide,free,fused,golden-brow,half,ilament,impressed,lamina,lengthening,less,lobe,lobed,lower,markedly,midpoint,near,nflorescence,older,orolla,pair,papillo,part,perfect,pericarp,plurifoliate,pore,poricidal,porrect,portion,primary,pubescence,reflexed,regularly,ruit,scar,scurfy,shiny,short,silvery,slightly,slit,sometimes,spaced,sparsely,square,stellate,stub,tal,tem,testal,thin,tip,ud,unevenly,unit,upper,vary,varying,vein,visible,woody,yellow,ympodial,â4,âstellate	0.2-0.3,0.5-1,0.9-1,1-1.2,1-1.5,1-3,1.5-2,2-5,4,4-14,4-6-rayed,5-6,6-6.5,arrangement,bark,branch,bud,characteristic,colour,dichasial,exertion,form,fruit,glabrousnes,height,history,leaf,life,lobing,number,ovary,perennial,plant,seed,shape,size,texture,type	.2,0.4,100,100+,15,16,>,acuminate,acute,along,anthesi,attenuate,axe,base,berry,branched,bright,c.,calyx,capitate,chartaceous,cm,connivent,cup-shaped,densely,diameter,ellipsoidal,elliptic,entire,evenly,exserted,flattened-reniform,flower,glabrous,globose,gold,golden-yellow,gradually,inflorescence,length,like,long,loosely,many,membranous,minute,minutely,mm,moderately,multangulate,narrowing,narrowly,nodding,onto,orange,pale,pedicel,peltate,per,persistent,petiole,pitted,plane,porrect-stellate,pubescent,ray,reddish,ripe,sessile,short-stalked,shrub,simple,small,somewhat,stem,stout,strongly,terminal,time,tree,trichome,tube,way,white,wide	0.2-0.3,0.5-1,0.9-1,1-1.2,1-1.5,1-3,1.5-2,2-5,4,4-14,4-6-rayed,5-6,6-6.5,dichasial,perennial
528	wfo-0001032337	success	225	113	75	92	133	21	71	4	0.4-1.5,0.5-3.5,1-2,1.2-2.8,1.4-2,1.5,1.6-4,2-3.5,2-7,2.3-11.5,2.3-4.8,3-8,3.6-5,4-17,4-6,4-9,4.5-14.5,5-11,8-10,8-17,9-29,abaxially,adaxially,anther,berry,blade,borne,brownish,canescent,chartaceous,clavate,cm,condition,corolla,darker,deep,densely,diameter,drying,end,filament,flower,fresh,fruit,glabrous,globose,green,greenish,hair,herb,homostylous,lateral,leaf,leaflet,light,like,lobe,long,membranous,mm,mottled,odd-pinnate,often,ovoid,pedicel,peduncle,petiole,plant,pubescent,purple,ray,seed,short,singly,size,sometimes,sparsely,stem,stigma,style,subglabrous,terminal,tube,tuber,typically,unwinged,violet,violet-purple,whitish,wide,wing,x	0,1,1-10,1-4,10,2,2-14,2-4,2-4.5,3-4,5-merou,9-21,acumen,acuminate,acute,ag,along,alyx,apart,apex,apiculate,apparently,articulated,attenuate,axe,axillary,base,basiscopic,broadly,bud,capitat,cell,ciliate,connivent,cordate,covering,cuneate,decurrent,digestion,distal,dorsally,dot,eaf,edge,eed,elliptic,enzyme,erec,especially,exceeding,except,flat,folded,forked,frequently,geminat,generally,glabrou,greatly,green-white,hair-like,half,honeycomb-shaped,interjected,lanceolate,lengthening,living,lower,make,margin,middl,midrib,minutely,mucilaginous,nflorescence,oblique,obtuse,orbicular,orolla,ovate,pair,paired,pentagonal,perfect,petiolulate,petiolule,plurifoliate,pore,poricidal,proximal,puberulent,rarely,reduced,removed,ripe,rotate,rounded,ruit,scattered,sessile,seudostipule,side,slightly,slit,small,spaced,specimen,stamen,ste,stolo,straight,subequal,subsessile,subtending,tall,tamen,tem,tertiary,testal,thick,throughout,tip,tissue,tri-,unit,unpaired,usually,vary,wall,wet,white,yellow,ympodial	5-merous,arrangement,calyx,capitate,colour,erect,form,growth,height,history,inflorescence,length,life,ovary,presence,pseudostipule,shape,staman,stolon,texture,type	0.4-1.5,0.5-3.5,1-2,1.2-2.8,1.4-2,1.5,1.6-4,2-3.5,2-7,2.3-11.5,2.3-4.8,3-8,3.6-5,4-17,4-6,4-9,4.5-14.5,5-11,8-10,8-17,9-29,abaxially,adaxially,berry,borne,brownish,canescent,chartaceous,clavate,cm,condition,darker,deep,densely,diameter,drying,end,fresh,glabrous,globose,green,greenish,hair,herb,homostylous,light,like,long,membranous,mm,mottled,odd-pinnate,often,ovoid,pubescent,purple,ray,short,singly,sometimes,sparsely,stem,subglabrous,typically,unwinged,violet,violet-purple,whitish,wide,wing,x	5-merous,capitate,erect,stolon
529	wfo-0001032344	success	157	125	92	101	56	24	89	3	0.2-0.5,1-1.3,1-3,1-4,1.5-4.5,1.5-6,1.6-2.4,10-29,2-2.8,2-3,2.2-4,3-5,3-7,3-8.5,3-9,3.5-6.5,4-8,5-10,6-15,9.5-21,absent,acumen,acute,apical,apically,bluish,branched,calyx,cell,cm,connate,corolla,covering,cyme,dark,dehiscent,diameter,dichasial,dichasially,distal,dot,ebracteate,exceeding,filament,forked,generally,globose,green,green-white,hair-like,half,herbaceous,interjected,introrse,lateral,leaf,leaflet,lobe,long,long-attenuate,make,maturing,medium,mm,monochasial,mucilaginous,odd-pinnate,often,ovoid,pedicel,peduncle,perennial,petiole,plant,poricidally,puberulent,pubescent,purple,rotate,rotate-pentagonal,scarce,seed,short,size,slit,smooth,stamen,stigma,straight,style,terminal,testal,thick,throughout,tuber-bearing,typically,violet,wall,white,wide,yellow	2.8,3-6-foliat,4-11,abaxially,abruptly,acuminate,adaxially,apex,articulate,base,belo,broadly,cuneate,decurrent,digestion,diminishing,dorsally,eaf,edge,eed,elliptical,emoval,enzyme,flower,globo,honeycomb,inrolled,layeral,living,lon,lower,lunat,nflorescence,nther,oblique,orolla,ovate,pair,pattern,perfect,petiolule,plan,proximal,reveal,ruit,sessile,seudostipule,sometimes,specimen,tal,tem,toward,unit,vary,ympodial,Â¼	7,abaxial,adaxial,anther,arrangement,colour,form,fruit,growth,height,history,inflorescence,length,life,lunate,ovary,pseudostipule,shape,stem,surface,texture,type,wet,width	0.2-0.5,1-1.3,1-3,1-4,1.5-4.5,1.5-6,1.6-2.4,10-29,2-2.8,2-3,2.2-4,3-5,3-7,3-8.5,3-9,3.5-6.5,4-8,5-10,6-15,9.5-21,absent,acumen,acute,apical,apically,bluish,branched,cell,cm,connate,covering,cyme,dark,dehiscent,dichasial,dichasially,distal,dot,ebracteate,exceeding,forked,generally,globose,green,green-white,hair-like,half,herbaceous,introrse,lateral,lobe,long,long-attenuate,make,maturing,medium,mm,monochasial,mucilaginous,odd-pinnate,often,ovoid,perennial,plant,poricidally,puberulent,pubescent,purple,rotate,rotate-pentagonal,scarce,seed,short,slit,smooth,stamen,stigma,straight,style,testal,thick,throughout,tuber-bearing,typically,violet,wall,white,wide,yellow	7,lunate,wet
530	wfo-0001032354	success	171	146	110	121	50	25	104	6	0,0-5,0.5-1,0.8-1,1-10,1-2,1-3,1-5,10-lobed,2-2.5,2.5-3,25,29,38/2,4-6,5-15,acuminate,acute,anther,apex,aster,axi,axillary,base,becoming,berry,bilobed,branch,branched,broadly,brown,calyx,campanulate,capitate,cell,cm,coarsely,colour,corolla,creating,cuneate,cut,dia,discoidal,effect,ellipsoid,exerted,filament,fleshy,fork,glabrous,glandular,globose,green,greenish-ivory,greyish,hair,halfway,lasting,leaf,lengthening,linear,lobe,lobed,maturity,midrib,minute,minutely,mm,narrow,obovate,obovoid,occasionally,oval,ovary,ovoid,pale,pebble-shaped,pedicel,peduncle,pinnatisect,pore,poricidal,puberulent,pubescent,rh,rotate,rounded,rugose-reticulate,secondary,several,shape,shrub,simple,sinus,size,slightly,slit,small,soft,somewhat,stellate,stem,stigma,stone,straight,strongly,style,surface,tip,trichome,uniseriate,variable,vein,violet,wing,within,wooded,woody,x,year	0.3,0.8-1.2,2,250-400,3-4,40-75,5-10,almost,angular,anthesi,aspect,c.,decurrent,deep,deeply,distal,eaf,eed,except,facetted,flower,general,gre,gree,lanceolat,large,lower,nflorescence,ovate,pair,pedicellate,plurifoliat,rather,ruit,seedling,shoot,single,smaller,smel,sparse,spreading,tall,tub,ud,unit,unpleasant,usually,wide,ympodial,young	arrangement,branching,bud,characteristic,decurred,diameter,form,fruit,glabrousnes,grey,growth,height,history,inflorescence,lanceolate,length,life,na,new,perennial,plant,seed,texture,tube,type	0,0-5,0.5-1,0.8-1,1-10,1-2,1-3,1-5,10-lobed,2-2.5,2.5-3,25,29,38/2,4-6,5-15,acuminate,acute,apex,aster,axillary,base,becoming,berry,bilobed,branch,branched,broadly,brown,calyx,campanulate,capitate,cm,coarsely,creating,cuneate,cut,dia,discoidal,effect,ellipsoid,exerted,fleshy,fork,glabrous,glandular,globose,green,greenish-ivory,greyish,halfway,lasting,lengthening,linear,lobe,lobed,maturity,midrib,minute,minutely,mm,narrow,obovate,obovoid,occasionally,oval,ovoid,pale,pebble-shaped,pinnatisect,pore,poricidal,puberulent,pubescent,rh,rotate,rounded,rugose-reticulate,secondary,several,shrub,simple,sinus,slightly,slit,small,soft,somewhat,stellate,stem,straight,strongly,tip,trichome,uniseriate,variable,vein,violet,wing,within,wooded,woody,x,year	decurred,grey,lanceolate,na,perennial,tube
531	wfo-0001032358	success	216	116	74	95	121	21	73	1	.5,/2,0.2-4,0.5-3,0.7-1,1-2,1.3-1.7,1.5-2,13-20,2-10,2-3,2-4,2.2-7.5,3-4,3.5-13,4-4.5,4.5-5,acute,anther,apart,apex,appearing,armed,bark,base,based,berry,branched,broad,brown,calyx,capitate,cm,cordate,corolla,curved,densely,diameter,entire,exserted,filament,flattened,fruit,fruiting,furcate,glabrescent,glabrous,globose,green,growth,inflorescence,internodal,leaf,margin,membranous,minutely,mm,new,orangish,ovate,ovoid,pale,pedicel,peduncle,petiole,pitted,prickle,pubescent,purple,red,reniform,ripening,scar,shrub,simple,sinuate,slightly,somewhat,spaced,sparsely,stellate,stem,stigma,strongly,style,surface,tan,time,tube,tuberculate,type,unevenly,way,x,yellowish	.1,.2,.3,.4,0,0.6-0.8,0.6-1,1-1.6,1.5-2.5,1/4-1/2,12-20,15-40,2,2-5,3-10,4-7,4-8,4-merous,abaxially,abscissio,adaxially,along,another,anthesi,away,basal,bulbous,cell,center,cupuliform,difoliate,dorsal,drying,eaf,eed,equal,erect,expanding,flower,free,frui,geminate,glabrescen,heteromorphic,interpetalar,irregular,irregularly,lamina,left,lengthening,like,linear,lobe,lobed,long,longer,lower,lowermost,margined,markedly,maturity,midpoint,midrib,midvein,nflorescence,nodding,occasionally,often,older,one,pair,paler,papillat,papillate,part,peg,per,perfect,pericarp,persistent,planar,pore,poricidal,porrect,portion,present,prickly,primary,ray,rhachi,rotate-stellate,ruffly,ruit,sessile,shiny,short,short-stalked,sinus,slit,small,sometimes,space,spreading,staman,thick,thin,three,tip,trichome,tub,two,ud,unisexual,unit,upper,usually,vein,whitish,widely,ympodial,zygomorphic	abaxial,adaxial,arrangement,bud,characteristic,colour,exertion,form,glabrousnes,height,history,length,life,lobing,ovary,perennial,plant,seed,shape,size,texture	.5,/2,0.2-4,0.5-3,0.7-1,1-2,1.3-1.7,1.5-2,13-20,2-10,2-3,2-4,2.2-7.5,3-4,3.5-13,4-4.5,4.5-5,acute,apart,appearing,armed,base,based,berry,branched,broad,brown,calyx,capitate,cm,cordate,curved,densely,diameter,entire,exserted,flattened,furcate,glabrescent,glabrous,globose,green,internodal,membranous,minutely,mm,orangish,ovate,ovoid,pale,pitted,pubescent,purple,red,reniform,ripening,shrub,simple,sinuate,slightly,somewhat,spaced,sparsely,stellate,strongly,tan,time,tube,tuberculate,unevenly,way,x,yellowish	perennial
532	wfo-0001032367	success	231	142	84	100	131	42	78	6	0-0.3,0.7-1.1,1-2.1,100-300,1â1.8,2-4,2.2â2.5,2.2â2.8,2â2.5,3-5,3â6,5.5â6.9,6-8,6.8â8.2,acute,anther,apex,base,berry,branch,calyx,capitate,cm,conical,cordate,cream,dark,densely,diameter,filament,flattened-reniform,free,fruiting,glabrous,gland-tipped,glandular-puberulent,globose,green,greenish,hair,immature,inflorescence,lateral,leaf,length,light,lobe,lobed,long,margin,maturity,membranous,midpoint,minute,minutely,mm,mottled,nearly,obtuse,ovary,ovate,pair,pale,pedicel,peduncle,per,petiole,poricidal,prickle,prickly,pubescence,pubescent,ray,red-brown,sessile,shallow,shrub,similar,simple,size,sparsely,stellate,stem,stigma,style,suborbicular,surface,tapering,terete,tip,truncate,tube,unbranched,uniformly,usually,vein,white,wide,yellow,â15	-3,.2,.4,0.2â0.35,0.4-0.5,0.4â0.5,0.4â0.6,0.4â1,0.5â0.8,0.5â2,0.6,0.6â0.8,0.8,0.8â2,1-2,1.2,1â1.5,2,2-3-celled,2.5â3,3-celled,3.2â4,3â10,3â5,4,4â6.5,5-merous,5â18,7â10,8,abaxial,abaxially,accrescent,acicular,adaxial,adaxiall,adaxially,also,alyx,anthesi,arme,around,axi,ba,blade,broad-based,congested,connivent,copious,curved,deciduous,difoliate,directed,distall,eaf,eed,enlarged,entire,equal,erect,expand,fertile,flower,geminat,geminate,grading,herbarium,heterostylous,hyaline,infructescence,lanceolate,largest,layer,least,long-styled,longer,lower,lowermost,major,many,mesocarp,mixed,mixture,moderately,narrowly,nflorescence,often,one,orolla,oung,papillat,pore,portion,puberulent,rarely,recurved,rest,ruit,scarcely,scattered,secondary,short-styled,shorter,slender,small,smaller,somewhat,specimen,spongy,spreadin,spreading,staminat,ste,straight,tall,tamen,thick,tightly,time,tooth,triangular,trichome,twice,unarmed,uniseriate,unit,variable,vary,whitish,ympodial,â5	0.5-2,7-10,appearance,armed,arrangement,bark,border,bud,characteristic,colour,corolla,corrugation,distal,drying,exertion,form,fruit,giving,glabrousnes,growth,height,history,interjected,leaflet,life,lobing,na,new,number,papillate,perennial,plant,primary,pseudostipule,seed,shape,terminal,texture,thicknes,type,variation,width	0-0.3,0.7-1.1,1-2.1,100-300,1â1.8,2-4,2.2â2.5,2.2â2.8,2â2.5,3-5,3â6,5.5â6.9,6-8,6.8â8.2,acute,base,berry,capitate,cm,conical,cordate,cream,dark,densely,diameter,flattened-reniform,free,glabrous,gland-tipped,glandular-puberulent,globose,green,greenish,hair,immature,lateral,light,lobe,lobed,long,maturity,membranous,minute,minutely,mm,mottled,nearly,obtuse,ovate,pair,pale,pedicel,per,poricidal,prickly,pubescence,pubescent,red-brown,sessile,shallow,shrub,similar,simple,sparsely,stellate,stem,suborbicular,tapering,terete,tip,truncate,unbranched,uniformly,usually,white,wide,yellow,â15	0.5-2,7-10,armed,na,papillate,perennial
533	wfo-0001032407	success	216	126	88	106	110	20	85	3	0-4,0.4-4,0.5-3,1-2,1-2.4,1.2-7,1.4-2.7,1.5-2.2,10-19.5,10-27,2-10.5,2.5-10.5,2.5-9,3-15,3.1-13.5,4-11,4-7,5,5-23,5-30,7-9,8-10,abaxially,adaxially,anther,berry,blade,brownish,cell,chartaceous,ciliate,clavate,cm,coarsely,condition,conical,connivent,corolla,covering,dark,densely,diameter,drying,filament,finely,flower,fresh,fruit,glabrous,green,green-white,greenish,hair,hair-like,herb,homostylous,interjected,lanceolate,lateral,leaf,leaflet,light,like,lobe,long,make,margin,medium,membranous,minute,minutely,mm,moniliform,mottled,mucilaginous,odd-pinnate,ovoid,pedicel,peduncle,petiole,plant,puberulent,pubescent,purple,rarely,ripe,seed,semierect,simple,size,sparsely,stem,stigma,style,terminal,testal,thick,throughout,tube,tuber,wall,wet,white,whitish,wide,x	0.3-0.6,0.3-8,0.8,0.8-0.3,1-10,1-5,12,2-4,30,38,4-48,5-merou,6,absent,acumen,acuminate,ag,along,alyx,apart,apex,apparently,arranged,articulated,asymmetrical,attenuate,axe,axillary,base,basiscopic,bead,bud,capitat,commonly,decreasing,digestion,distal,eaf,edge,eed,elliptic,elongated,enzyme,erec,especially,exceeding,folded,forked,geminat,generally,glabrou,gradually,half,honeycomb-shaped,larger,lengthening,less,living,lower,middle,multiple,narrow,necklace,nflorescence,obtuse,orbicular,orolla,ovate,pair,pentagonal,perfect,petiolule,plurifoliate,pore,poricidal,proximal,pubescen,ray,removed,rotate,round,ruit,secondary,sessile,seudostipule,side,slit,spaced,specimen,stamen,ste,stolon,straight,subequal,subtending,symmetrical,tall,tamen,tem,tip,tissue,tri-,typically,unit,unwinged,usually,vary,wing,yellow,ympodial	5-merous,abaxial,adaxial,arrangement,calyx,capitate,colour,erect,form,growth,height,history,inflorescence,length,life,ovary,pseudostipule,shape,surface,texture	0-4,0.4-4,0.5-3,1-2,1-2.4,1.2-7,1.4-2.7,1.5-2.2,10-19.5,10-27,2-10.5,2.5-10.5,2.5-9,3-15,3.1-13.5,4-11,4-7,5,5-23,5-30,7-9,8-10,abaxially,adaxially,berry,brownish,cell,chartaceous,ciliate,clavate,cm,coarsely,condition,conical,connivent,covering,dark,densely,drying,finely,fresh,glabrous,green,green-white,greenish,hair,hair-like,herb,homostylous,lanceolate,lateral,light,like,long,make,margin,medium,membranous,minute,minutely,mm,moniliform,mottled,mucilaginous,odd-pinnate,ovoid,puberulent,pubescent,purple,rarely,ripe,seed,semierect,simple,sparsely,stem,testal,thick,throughout,wall,wet,white,whitish,wide,x	5-merous,capitate,erect
534	wfo-0001032465	success	229	169	140	150	79	19	136	4	+,-11,.5,0.2,0.5-1.5-5,0.5-2,1-1.5,1-1.7,1-3-8-14,1.2-1.5,1.5-1.8,1.5-2,1/3,2,2-2.5,25,3-3.5,4,5,5-8,9,acuminate,acute,angled,anther,anthesi,apex,articulated,axi,basal,base,berry,black,branched,brown,calyx,capitate,ciliate,clasping,cm,commonly,conical,connivent,cordate,corolla,de,deep,deeper,deeply,deltate,densely,diameter,distal,edge,ellipsoid,elliptic,entire,filament,filiform,flattened,flower,fringe,fruiting,glabrous,gland,glandular,glandular-tipped,globose,greenish,growth,included,inflorescence,janeiro,larger,later,lateral,leaf,leaving,length,lengthening,like,lobe,lobed,long,loosely,lower,margin,minute,minutely,mm,narrowly,new,nodding,often,outline,ovate,pair,pedicel,peduncle,peg,petiole,pinnate,pinnatifid,pore,poricidal,pubescent,purplish,reddish,reniform,reticulate,revolute,rio,ripe,seed,shallow,shape,similar,simple,size,sleeve,slit,sparsely,stellate-rotate,stem,stigma,strongly,style,surface,terminal,time,tiny,tip,transparent,trichome,truncate,tube,unicellular,uniseriate,upper,usually,variously,varying,vine,violet,way,white,woody,x,young,Â½	.2,0,0.5-2.5-5.5-9,1-5-8-10,1-celled,1.5,3-4,3-5,3-9,5-7,5-merou,abaxial,ag,alyx,apar,apically,appearing,ark,cell,coriaceous,decreasing,drying,eaf,eed,elongate,erect,exserte,free,glabrescen,green,growing,half,ilament,irregular,irregularly,mature,membranous,nflorescence,occasionally,older,orolla,paired,papillate,papillo,pendan,pentagonal,per,perfect,pericarp,planar,plurifoliat,portion,primary,puberulent,ruit,scar,scattered,shiny,sinus,somewhat,spaced,splitting,subshrub,tem,testal,thicker,thin,toward,tuft,twinin,twining,ud,unit,vary,vein,wall,widest,yellowish,ympodial	age,arrangement,bark,bud,characteristic,colour,exertion,exserted,form,fruit,glabrescent,glabrousnes,history,life,lobing,ovary,papillose,texture,type	+,-11,.5,0.2,0.5-1.5-5,0.5-2,1-1.5,1-1.7,1-3-8-14,1.2-1.5,1.5-1.8,1.5-2,1/3,2,2-2.5,25,3-3.5,4,5,5-8,9,acuminate,acute,angled,anthesi,articulated,axi,basal,base,berry,black,branched,brown,calyx,capitate,ciliate,clasping,cm,commonly,conical,connivent,cordate,corolla,de,deep,deeper,deeply,deltate,densely,diameter,distal,edge,ellipsoid,elliptic,entire,filiform,flattened,flower,fringe,glabrous,gland,glandular,glandular-tipped,globose,greenish,included,inflorescence,janeiro,larger,later,lateral,leaf,leaving,length,lengthening,like,lobe,lobed,long,loosely,lower,margin,minute,minutely,mm,narrowly,nodding,often,outline,ovate,pair,peg,pinnate,pinnatifid,pore,poricidal,pubescent,purplish,reddish,reniform,reticulate,revolute,rio,ripe,shallow,similar,simple,sleeve,slit,sparsely,stellate-rotate,stem,strongly,surface,terminal,time,tiny,tip,transparent,trichome,truncate,tube,unicellular,uniseriate,upper,usually,variously,varying,vine,violet,way,white,woody,x,young,Â½	age,exserted,glabrescent,papillose
535	wfo-0001032494	success	163	100	68	77	86	23	65	3	.5,0.8-1,0.9-1.2,1-1.5,1.45-1.5,1.5-8,1.6-2,16.5-20.5,2.3-2.5,2.5,2.5-8,3/4,5-40,5-6.4,acuminate,anther,anthesi,apex,attenuate,base,berry,brown,calyx,clavate,cm,corolla,decurrent,dia,exserted,flattened-reniform,flowered,fruit,fruiting,furcate,glabrous,globose,leaf,light,lobed,long,margin,minutely,mm,narrowly,occasionally,opposite,ovary,ovate,ovoid,papillose,pedicel,petiole,pitted,revolute,shaped,shrub,simple,size,slender,small,stem,stigma,style,surface,tapering,tear-drop,tree,trichome,tube,two-winged,uniseriate,way,white,whitish-green,winged,x,zig-zag	.1,.4,0.6-1,0.75-1,1.1-1.2,1.5,1.8-4.5,3-4,3.4-14.5,4-8,8-11,accrescent,apart,appearing,axil,ba,bark,beginning,beneath,bullate,deflexed,differing,difoliate,dry,eaf,edicel,eed,equal,evenly,except,expanded,filament,free,geminat,geminate,greenish-yellow,incrassate,inflorescenc,lateral,lax,lenticellat,lobe,lon,lower,main,major,material,middle,minor,nearly,nflorescence,node,orange,pair,pale,papillae,papillo,planar,pore,poricidal,portion,prominent,proximal,pubescent,quite,raised,ridge,ruit,scar,slightly,somewhat,spaced,straight,tall,tan,tip,triangular,ud,unit,upper,vein,venation,widest,woody,yellow,ympodial	2.4,4,bud,characteristic,colour,diameter,exertion,form,growth,height,history,inflorescence,length,life,lobing,na,number,per,plant,seed,shape,texture,type	.5,0.8-1,0.9-1.2,1-1.5,1.45-1.5,1.5-8,1.6-2,16.5-20.5,2.3-2.5,2.5,2.5-8,3/4,5-40,5-6.4,acuminate,anthesi,attenuate,base,berry,brown,calyx,clavate,cm,decurrent,dia,exserted,flattened-reniform,flowered,furcate,glabrous,globose,leaf,light,lobed,long,minutely,mm,narrowly,occasionally,opposite,ovate,ovoid,papillose,petiole,pitted,revolute,shaped,shrub,simple,slender,small,stem,tapering,tear-drop,tree,trichome,tube,two-winged,uniseriate,way,white,whitish-green,winged,x,zig-zag	2.4,4,na
536	wfo-0001032507	success	206	98	65	75	131	23	61	4	.5,0.25,0.8,1,1.5â7,10â20,15â20,1â10,3â7,5â10,5â20,6,8â15,abaxial,absent,acuminate,anthesi,apex,berry,branched,brown,chartaceous,cm,collection,compound,diameter,entire,flattened-reniform,flowering,glabrous,globose,green,hair,herbaceous,herbarium,internode,leaflet,light,long,margin,material,minutely,mm,often,pedicel,peduncle,perennial,pericarp,petiole,pinnate,pinnately,pinnatifid,pitted,present,prickle,pulp,rachi,rarely,reddish,rounded,rugose,shape,simple,slender,stem,stout,strongly,surface,terminal,unbranched,variously,vine,white,woody,Ã	.2,/4,0.3,0.5,0.7-1.2,1.2-1.7,1.3,1.5â2,1â1.5,2,2.5â4,2.5â6,20â30,2â9,3â5,4â10,5â8,abaxially,abundant,acute,adaxiall,adaxially,adjacent,ag,alyx,anther,apiculate,armed,articulated,base,becoming,blade,blue,broadly,bud,calyx,campanulate,cell,confluent,connivent,corolla,cream,curved,deep,deltate,distally,distinct,dr.,eaf,eed,either,ellipsoid,elliptic,elongating,equal,exserted,fertile,fifth,filament,flower,four,fruiting,highly,individual,interpetalar,larger,lateral,lengthening,lobe,lobed,longer,lower,major,midrib,narrowly,nearly,nflorescence,oblong,observe,occasionally,one,orolla,ovate,pale,papery,pentagonal,pistillate,plant,plurifoliat,pore,poricidal,puberulent,purple,purplish,quadrate,ranging,recurve,regularly,rotate-pentagonal,ruit,side,single,sinus,slightly,slit,sometimes,spreading,staminate,stigma,straight,style,tamen,tear,testal,time,tip,tissue,tube,unequal,unit,unlobed,usually,variable,vary,vein,way,wide,widest,wood,yellowish,ympodial	adaxial,arrangement,characteristic,colour,dry,form,fruit,glabrousnes,greyish,growth,history,inflorescence,leaf,length,life,new,plurifoliate,presence,recurved,seed,size,texture,type	.5,0.25,0.8,1,1.5â7,10â20,15â20,1â10,3â7,5â10,5â20,6,8â15,absent,acuminate,anthesi,berry,branched,brown,chartaceous,cm,collection,compound,diameter,entire,flattened-reniform,flowering,glabrous,globose,green,herbaceous,herbarium,leaflet,light,long,material,minutely,mm,often,perennial,pinnate,pinnately,pinnatifid,pitted,present,pulp,rarely,reddish,rounded,rugose,simple,slender,stout,strongly,terminal,unbranched,variously,vine,white,woody,Ã	dry,greyish,plurifoliate,recurved
537	wfo-0001032523	success	200	108	70	85	115	23	68	2	-5,.2,.5,/4,0.3-0.5,0.6-0.7,0.6-0.8,1-1.5,1-3,1.3-1.6,1.5-3,10-50,2-2.4,2.7-3,abaxially,acuminate,acute,anther,apex,apically,apparently,bark,base,berry,calyx,cm,cuneate,curved,deltate,diameter,dull,elliptic,entire,erect,evenly,filament,filiform,flattened-reniform,fruit,fruiting,gently,glabrescent,glabrous,green,lateral,leaf,length,long,margin,maturity,mauve,membranous,mm,moderately,orange-brown,ovate,pedicel,peduncle,petiole,poricidal,prickly,recurved,red,red-brown,shrub,simple,sometimes,sparsely,spherical,stellate-pubescent,stem,straight,style,subentire,surface,tapering,terminal,tip,tube,unarmed,way,weakly,wide,yellow,young	-2,0-0.15,0-10,0-12,0-15,0-3,0.1-0.2,0.2,0.2-0.4,0.4-1,0.4-1.5,0.5-1,1-2,1-8,1/3-1/2,1/4-1/3,15-30,2,2-2.5,2-4,2-5.5,2.5-6,3-15,3-4,3.5-4,4-5-merous,4-7,5-12,5-20,6-10,6-20,6-8,abaxial,acuminat,adaxial,alyx,ame,apar,apart,articulated,blade,branching,brow,c.,conical,connivent,discolorous,drying,eaf,eed,elongating,equal,flower,free,glabrou,hair,herbaceous,inflated,infructescence,lobe,lobed,lon,longer,lower,mature,midpoint,minute,multangulate,narrow-deltate,nflorescence,older,one,open,orange,orolla,oung,pair,pale,per,perfec,pericarp,perpendicular,plurifoliat,porrect,portion,prickle,primary,ray,reflexed,ruit,scandent,scar,secondary,sessile,smooth,spaced,spreading,stalk,stalked,stellate,strongly,tamen,terete,tertiary,time,trichome,unarme,unit,variously,vary,vein,venation,visible,woody,ympodial	arrangement,branch,brown,characteristic,colour,corolla,exertion,form,glabrousnes,growth,height,inflorescence,lobing,na,new,ovary,plant,seed,shape,size,stigma,texture,type	-5,.2,.5,/4,0.3-0.5,0.6-0.7,0.6-0.8,1-1.5,1-3,1.3-1.6,1.5-3,10-50,2-2.4,2.7-3,abaxially,acuminate,acute,apically,apparently,base,berry,cm,cuneate,curved,deltate,diameter,dull,elliptic,entire,erect,evenly,filiform,flattened-reniform,gently,glabrescent,glabrous,green,lateral,long,maturity,mauve,membranous,mm,moderately,orange-brown,ovate,poricidal,prickly,recurved,red,red-brown,shrub,simple,sometimes,sparsely,spherical,stellate-pubescent,straight,subentire,tapering,terminal,tip,unarmed,way,weakly,wide,yellow,young	brown,na
538	wfo-0001032524	success	205	91	49	71	134	20	48	1	1-2,1-2.5,1.5-2,1.5-4,10-35,12-13,14-50,2-3,2-5,2.5-8,25-90,3-5,3-8.5,3.5-4.5,4.5-8,5-6,6-13,6-16.5,7-35,7-8,abaxially,adaxially,anther,berry,blade,chartaceous,clavate,cm,corolla,densely,diameter,filament,flower,fruit,glabrous,globose,grayish-green,green,greenish,herb,interjected,lateral,leaflet,length,light,lilac,lobe,membranous,minutely,mm,moniliform,odd-pinnate,ovoid,pedicel,peduncle,plant,puberulent,pubescent,purple,seed,size,stem,stigma,style,terminal,tube,tuber,unwinged,violet,whitish,x	1-10,120-210,3-4,4,4-5,4.5-5,5-9,5-merou,50-70,?,acumen,acute,ag,along,alyx,apart,apex,apparently,arranged,articulated,ascending,attenuate,axe,axillary,base,bead,brownish,bud,capitat,cell,ciliate,condition,connivent,covering,cuneate,different,digestion,distal,dorsally,drying,eaf,edge,eed,elliptic,enzyme,erec,especially,exceeding,except,flat,folded,forked,fresh,geminat,generally,glabrou,greatly,green-white,hair,hair-like,hal,half,head,homostylous,honeycomb-shaped,lanceolate,lengthening,like,living,long,lower,make,margin,middle,midrib,mucilaginous,multicellular,multiple,narrowly,necklace,nflorescence,non-glandular,obtuse,often,orolla,ovate,pair,pentagonal,perfect,petiole,petiolulate,petiolule,plurifoliate,pore,poricidal,proximal,reduced,removed,ripe,rotate,rounded,ruit,sessile,seudostipule,short,silky,silvery-white,slit,spaced,specimen,stamen,ste,stolon,straight,subequal,subtending,tall,tamen,tem,testal,tetralobulate,thick,throughout,tip,tri-,trichome,typically,unit,usually,vary,wall,wet,yellow,ympodial	abaxial,adaxial,arrangement,calyx,capitate,colour,form,growth,height,history,inflorescence,leaf,life,number,ovary,pseudostipule,shape,staman,texture,type	1-2,1-2.5,1.5-2,1.5-4,10-35,12-13,14-50,2-3,2-5,2.5-8,25-90,3-5,3-8.5,3.5-4.5,4.5-8,5-6,6-13,6-16.5,7-35,7-8,abaxially,adaxially,berry,chartaceous,clavate,cm,densely,glabrous,globose,grayish-green,green,greenish,herb,light,lilac,membranous,minutely,mm,moniliform,odd-pinnate,ovoid,puberulent,pubescent,purple,unwinged,violet,whitish,x	capitate
539	wfo-0001032532	success	160	81	44	56	104	25	40	4	0.3-2.5,1-4,1.5-2.6,1.5-3.2,1.5-4.3,13-52,15-30,2-10,2-13,2-3,2.8-3.6,2.8-9.5,3-10,3.4-12.2,3.7-10,4-5.5,4.5,6,6-22,branched,calyx,cm,conical,corolla,cyme,diameter,dichasial,dichasially,ebracteate,filament,finely,forked,herbaceous,interjected,lateral,leaf,leaflet,light,long,mm,monochasial,mucilaginous,odd-pinnate,ovoid,pedicel,peduncle,perennial,petiole,plant,pubescent,purple,seed,size,style,terminal,wide	0-.,1-1.5,2,2-3-5,3-6-foliat,8-38,abaxiall,abaxially,absent,acumen,acuminate,acute,adaxially,apex,apical,apically,articulate,attenuate,base,cell,coarsel,connate,covering,cuneate,deep,dehiscent,digestion,diminishing,distal,dorsally,eaf,edge,eed,elliptical,emoval,enzyme,exceeding,flat,flower,folded,generally,globo,gradually,green,green-white,hair-like,half,honeycomb,introrse,living,lobe,lon,long-attenuate,lower,lunat,make,maturing,medium,minute,narrowly,nflorescence,nther,oblique,obtuse,often,orolla,ovate,pair,pattern,perfect,petiolule,plan,poricidally,proximal,reveal,rotate,rounded,ruit,sessile,seudostipule,short,slit,specimen,stamen,stigma,straight,subequal,subsessile,tal,tem,testal,thick,throughou,throughout,tip,toward,tuber-bearing,typically,unit,vary,wall,yellow,ympodial,Â¼	0-2,abaxial,adaxial,anther,arrangement,coarsely,colour,form,fruit,globose,growth,height,history,inflorescence,length,life,ovary,pseudostipule,shape,stem,surface,texture,type,wet,width	0.3-2.5,1-4,1.5-2.6,1.5-3.2,1.5-4.3,13-52,15-30,2-10,2-13,2-3,2.8-3.6,2.8-9.5,3-10,3.4-12.2,3.7-10,4-5.5,4.5,6,6-22,branched,cm,conical,cyme,dichasial,dichasially,ebracteate,finely,forked,herbaceous,light,long,mm,monochasial,mucilaginous,odd-pinnate,ovoid,perennial,pubescent,purple,wide	0-2,coarsely,globose,wet
540	wfo-0001032536	success	254	155	97	124	130	31	96	1	/3,0.5,1-2.5,1.3-2.2,10,10-30,100,2-3,2.5-3,20-22,20-50,3-3.5,4-6,4-9,5-8,5.5-8,7-10,<,>,abruptly,acute,age,almost,anther,apex,armed,bark,basal-most,base,berry,bright,bristle,bristly,brown,calyx,capitate,chartaceous,clavate,cm,conical,curved,dark,deeply,densely,depressed,diameter,elliptic,entire,fading,filament,flattened,fruit,fruiting,glabrous,glandular,globose,grayish,growth,inflorescence,lateral,leaf,leaf-opposed,length,lobe,lobed,long,margin,maturity,membranous,midpoint,minute,minutely,mixture,mm,multiseriate,narrowing,near,new,number,oblique,older,olive-green,once-branched,ovary,papillae,papillate,part,pedicel,peduncle,per,petiole,plant,poricidal,porrect,prickle,primary,pubescent,purple,ray,reddish,reniform,simple,slightly,somewhat,sparsely,stellate,stem,stigma,style,surface,tapering,terete,terminal,tip,tree,trichome,truncate,tube,unarmed,vein,way,white,wide,yellow-green	-3,1,1-2,1.5,10-20,10-50,13-24,14-16,20-25,3,3-6,4-8,5,5-6,5-merous,abaxial,abaxially,adaxial,adaxiall,adaxially,along,alyx,angle,anthesi,apar,appressed,around,articulated,axi,berr,blade,broad-based,broadly,caudat,caudate,cell,clearly,coriaceous,cu,dbh,deltate,denser,difoliate,directed,diverging,eaf,eed,enlarged,equal,evenly,flower,free,geminate,glabrescent,glandular-puberulent,halfway,hanging,heterostylous,inflorescenc,infructesecnce,interpetalar,irregularly,juvenile,lamina,leaving,like,long-stalked,long-styled,lower,mature,midrib,midvein,mixed,multangulate,narrowly,nflorescence,occasionally,occurring,odor,open,orolla,oung,papillat,pentagonal,pericarp,pore,portion,potato,prickl,prickly,prominent,protuberance,rarely,reproductive,rough,ruit,scar,scattered,shallowly,short-,short-styled,slender,small,smooth,soft,spaced,spreading,stalk,staminate,stellate-pubescent,strongly,tall,tamen,thick,time,tissue,triangular,trunk,unequal,unit,upward,urceolate,usually,vary,visible,wood,woody,yellowish,ympodial,younger	appearance,arrangement,border,branch,bud,characteristic,colour,corolla,corrugation,distal,drying,exertion,form,giving,glabrousnes,height,history,interjected,leaflet,life,lobing,na,pseudostipule,seed,shape,size,texture,thicknes,type,variation,width	/3,0.5,1-2.5,1.3-2.2,10,10-30,100,2-3,2.5-3,20-22,20-50,3-3.5,4-6,4-9,5-8,5.5-8,7-10,<,>,abruptly,acute,age,almost,armed,basal-most,base,berry,bright,bristle,bristly,brown,calyx,capitate,chartaceous,clavate,cm,conical,curved,dark,deeply,densely,depressed,diameter,elliptic,entire,fading,flattened,glabrous,glandular,globose,grayish,lateral,leaf-opposed,lobed,long,maturity,membranous,minute,minutely,mixture,mm,multiseriate,narrowing,near,oblique,older,olive-green,once-branched,ovary,papillae,papillate,part,per,petiole,poricidal,porrect,pubescent,purple,reddish,reniform,simple,slightly,somewhat,sparsely,stellate,tapering,terete,tip,tree,trichome,truncate,unarmed,way,white,wide,yellow-green	na
541	wfo-0001032542	success	161	118	78	93	68	25	76	2	.25,/4,0.5-1,0.7-1,1-1.3,1-1.5,1-5,10-15-flowered,10-28,2-3,2-3.5,3-4,4-7,4-9.5,4.5-5,5-8,acuminate,acute,adaxially,anther,apex,attenuate,bark,base,berry,bluish-green,bright,brown,calyx,capitate,cm,conical,corolla,dark,deflexed,dendritic,densely,dia,elliptic,elliptic-obovate,exserted,filament,flattened-reniform,fruiting,glabrous,globose,golden,green,growth,incrassate,inflorescence,later,lateral,leaf,less,long,main,margin,minutely,mm,new,opposite,ovary,pair,pedicel,petiole,pitted,pubescent,reddish-brown,shape,shaped,shining,shrub,simple,size,slender,small,stem,stigma,strongly,style,surface,tear-drop,treelet,trichome,tube,vein,way,wide,x,yellow-green,yellowish,young	.25-0.5,.5,.5-1,1-2,1.5-3.5,2.5-5,3-5,abaxial,abaxially,along,anthesi,apical,axi,ba,basal,beginning,closely,compact,deltate,di,differing,difoliate,distal,dry,eaf,edicel,eed,either,erect,free,geminat,inflorescenc,lamina,like,lobe,lobed,lon,loose,lower,major,minor,minute,narrowly,near,nflorescence,older,overlapping,papillo,persisten,planar,pore,poricidal,portion,rounded,ruit,scar,slightly,somewhat,spaced,sparsely,swollen,tip,triangular,tub,ud,unit,woody,ympodial	alternate,arrangement,branch,bud,characteristic,colour,corrugation,diameter,drying,exertion,form,fruit,glabrousnes,height,history,length,life,lobing,na,peduncle,plant,primary,seed,texture,type	.25,/4,0.5-1,0.7-1,1-1.3,1-1.5,1-5,10-15-flowered,10-28,2-3,2-3.5,3-4,4-7,4-9.5,4.5-5,5-8,acuminate,acute,adaxially,apex,attenuate,base,berry,bluish-green,bright,brown,calyx,capitate,cm,conical,dark,deflexed,dendritic,densely,dia,elliptic,elliptic-obovate,exserted,flattened-reniform,glabrous,globose,golden,green,incrassate,later,lateral,leaf,less,long,main,margin,minutely,mm,opposite,pair,pitted,pubescent,reddish-brown,shaped,shining,shrub,simple,slender,small,strongly,tear-drop,treelet,trichome,tube,vein,way,wide,x,yellow-green,yellowish,young	alternate,na
542	wfo-0001032564	success	160	122	89	102	58	20	88	1	.05-0.1,.1,.5,0.25-0.5,0.3-1,1-1.3,1-1.5,1-2,1.3-2.5,1.5,2-2.5,4-5,4-6-flowered,5.5-9,6-7,8-9,along,anther,anthesi,apex,arched,bark,base,becoming,beneath,berry,branch,broadly,brown,calyx,clavate,cm,conical,corolla,dark,deflexed,deltoid,densely,dia,dry,elliptic,filiform,flattened,fresh,fruiting,glabrous,globose,green,greenish-white,greyish-red,lateral,leaf,lobe,lobed,long,long-acuminate,main,material,minute,minutely,mm,narrowly,nearly,often,ovary,ovate,ovoid-reniform,pair,papillose,pedicel,petiole,pitted,pore,poricidal,projection,puberulent,reflexed,ripe,shaped,shiny,shrub,simple,stem,stigma,strongly,style,surface,tan,tapering,tear-drop,thread-like,tiny,tip,trichome,truncate,tube,unifoliate,uniseriate,vein,winged,x,yellowish-green	.05,0.75-1,1-1.2,apar,apart,aspec,ba,bud,converging,eaf,edicel,eed,except,expanded,exserted,extreme,flower,geminate,giving,glabrate,golden,halfway,lamina,later,like,lower,margin,member,middle,nflorescence,node,non-reproductive,obovoi,older,one,open,opposite,papillo,planar,point,prominent,proximal,raised,rounded,ruit,scar,slightly,small,soon,straight,tall,time,ud,unit,widest,woody,ympodial,young	arrangement,characteristic,colour,diameter,form,fruit,growth,height,history,inflorescence,length,life,lobing,perennial,plant,seed,shape,size,texture,type	.05-0.1,.1,.5,0.25-0.5,0.3-1,1-1.3,1-1.5,1-2,1.3-2.5,1.5,2-2.5,4-5,4-6-flowered,5.5-9,6-7,8-9,along,anthesi,arched,base,becoming,beneath,berry,broadly,brown,calyx,clavate,cm,conical,dark,deflexed,deltoid,densely,dia,dry,elliptic,filiform,flattened,fresh,glabrous,globose,green,greenish-white,greyish-red,leaf,lobe,lobed,long,long-acuminate,material,minute,minutely,mm,narrowly,nearly,often,ovate,ovoid-reniform,pair,papillose,pitted,pore,poricidal,projection,puberulent,reflexed,ripe,shaped,shiny,shrub,simple,strongly,surface,tan,tapering,tear-drop,thread-like,tiny,tip,trichome,truncate,tube,unifoliate,uniseriate,vein,winged,x,yellowish-green	perennial
543	wfo-0001032569	success	164	93	60	72	92	21	59	1	.5,/3,0.5-10,0.8-1,1-1.2,1.2-5,1.5-2,1.7-2,4-18,7-27,7-9,acute,anther,apex,bark,base,berry,bilobed,branched,broadly,brown,calyx,cm,conical,corolla,dark,decurrent,dendritic,densely,dia,ellipsoid,elliptic,erect,exserted,flattened,fleshy,fruiting,glabrous,globose,green,inflorescence,later,leaf,lobed,long,minutely,mm,occasionally,onto,ovary,ovate,pedicel,petiole,pitted,pubescent,reniform,shaped,shrub,simple,size,stem,stigma,strongly,style,surface,tear-drop,thick,trichome,tube,way,white,x	1-1.5,1-2,1-4,1.5,2-3,2-4,4-8,5-6,5-60-flowered,abaxially,adaxially,along,anthesi,apparently,appearing,axi,bearing,bullate,cell,closely,corrugated,deflexed,dense,denser,differing,difoliate,dry,drying,eaf,edicel,eed,filament,free,geminate,golden,gra,incrassate,irregularly,lateral,lea,like,lobe,lon,los,lower,main,major,margin,matted,mature,middle,minor,moderately,nflorescence,obscured,open,opposite,otherwise,pair,paler,papillo,papillose,pericar,planar,pore,poricidal,portion,present,pubecsence,rich,ruit,scar,somewhat,spaced,sparsely,splitting,stone,tall,time,tip,triangular,tub,tuft,ud,unifoliate,unit,vein,waxy,widest,woody,ympodial,young	abaxial,adaxial,bud,characteristic,colour,diameter,exertion,form,fruit,gray,growth,height,history,length,life,lobing,plant,seed,shape,texture,type	.5,/3,0.5-10,0.8-1,1-1.2,1.2-5,1.5-2,1.7-2,4-18,7-27,7-9,acute,apex,base,berry,bilobed,branched,broadly,brown,calyx,cm,conical,dark,decurrent,dendritic,densely,dia,ellipsoid,elliptic,erect,exserted,flattened,fleshy,glabrous,globose,green,later,lobed,long,minutely,mm,occasionally,onto,ovate,petiole,pitted,pubescent,reniform,shaped,shrub,simple,strongly,tear-drop,thick,trichome,tube,way,white,x	gray
544	wfo-0001032576	success	227	129	90	108	119	21	89	1	/5,0-5,0.3-0.5,0.3-0.7,0.5-1,0.5-2,0.5-4,0.8-1.2,0.8-1.4,1.2-1.8,1.5-2,1.5-2.3,1.5-7.5,1.8-2.5,1/3,2-4,3-14,4,4-6,acute,anther,apex,apically,apparently,articulated,bark,base,berry,bright,brown,brown-green,calyx,cell,chartaceous,cm,cuneate,deltate,densely,diameter,dull,ellipsoid,entire,erect,evenly,filament,flattened-reniform,fruit,fruiting,glabrescent,glandular,gray,green,hair,herb,lanceolate,lateral,leaf,length,lobed,long,margin,maturity,membranous,minutely,mm,moderately,obtuse,often,orange-brown,outline,ovate,pair,pedicel,peduncle,petiole,pit,poricidal,prickly,primary,purple,raised,red,red-green,reflexed,reticulate,shiny,shrub,simple,small,sparsely,spherical,spreading,stellate-pubescent,stem,style,surface,tapering,terminal,tip,tube,upper,vein,way,white,wide,yellow,yellow-green,young	-10,-12,/4,0-1.5,0-2,0-3,0-30,0.1,0.1-0.15,0.1-0.2,0.1-0.25,0.5-1.5,0.8-2,1-3,1-4,1/2-2/3,1/3-1/6,2-10,2-3,2-5,2.5-3,2.5-4,4-5-merous,4-6-8,4-6.5,5-30,6-8,7-8,abaxially,acuminat,alyx,apar,apart,ascendant,ba,blade,branched,branching,brow,concolorous,conical,curved,difoliate,distance,drying,eaf,eed,elongating,equal,extending,eye,faint,flattened,flower,free,geminat,glabrous,gland,globular,herbaceous,infructescence,lobe,longer,lower,mature,midpoint,midvein,naked,narrow-deltate,narrow-ovate,near,nflorescence,obovate,older,one,open,orolla,oung,pale,per,perfec,pericarp,porrect,portion,prickl,prickle,ray,reduced,rounded,ruit,scandent,scar,sessile,short,shorter,side,slender,slightly,smooth,sometimes,spaced,stalk,stalked,stellate,straight,tamen,tertiary,time,trichome,unarmed,unit,usually,variously,vary,venation,visible,woody,yellow-orange,ympodial	acuminate,arrangement,branch,characteristic,colour,corolla,exertion,form,glabrousnes,growth,height,inflorescence,lobing,new,ovary,plant,seed,shape,size,texture,type	/5,0-5,0.3-0.5,0.3-0.7,0.5-1,0.5-2,0.5-4,0.8-1.2,0.8-1.4,1.2-1.8,1.5-2,1.5-2.3,1.5-7.5,1.8-2.5,1/3,2-4,3-14,4,4-6,acute,apically,apparently,articulated,base,berry,bright,brown,brown-green,cell,chartaceous,cm,cuneate,deltate,densely,diameter,dull,ellipsoid,entire,erect,evenly,flattened-reniform,glabrescent,glandular,gray,green,hair,herb,lanceolate,lateral,lobed,long,maturity,membranous,minutely,mm,moderately,obtuse,often,orange-brown,outline,ovate,pair,pit,poricidal,prickly,purple,raised,red,red-green,reflexed,reticulate,shiny,shrub,simple,small,sparsely,spherical,spreading,stellate-pubescent,tapering,terminal,tip,upper,way,white,wide,yellow,yellow-green,young	acuminate
545	wfo-0001032595	success	197	134	101	109	88	25	100	1	0-0.5-3.5,0.5-1,1-2,1-3,1.5-2,1.5-2.5,1.5-5,15-25,15-40,2-4,25-40,3-10,3-12-25,3-4,4-7,5-6,abaxially,acuminate,acute,adaxially,along,also,anther,apex,apical,apiculate,articulated,basal,base,branch,branched,brownish-purple,calyx,cm,connivent,cordate,cucullate,deeply,deltate,densely,diameter,dull,eglandular,ellipsoidal,entire,filament,finely,flattened,flower,fork,forked,fruit,fusiform,glabrous,gland,glandular,greenish,hair,lanceolate,leaf-opposed,leaving,lobe,long,loosely,margin,mature,mm,moderately,narrowly,near,oblique,often,ovate,ovoid,pale,pedicel,pedicellar,peduncle,petiole,pilose,prominent,pseudohair,puberulent,pubescent,rarely,remnant,reniform,rugulose,shallow,shrub,simple,slightly,small,sparsely,stellate,stigma,style,subcoriaceous,tip,tree,triangular,truncate,tube,two,unbranched,violet,white,x,yellow	-pilose,1,1-2.5,1-6,1-6.5-20,1.5-4.5,12-16,2-3,2.3-24,3-4-foliate,3-5,4-25,4-5,5-merou,6-7,9-14,accrescen,aggregate,alyx,apart,ape,axe,blade,brownish,cell,ciliat,connective,coriaceous,cream,crow,dense,denser,dilated,directed,distally,eaf,eed,equal,exceeding,free,fruiting,geminate,homostylous,larg,lon,longitudinal,lower,m.,major,midrib,nflorescence,opening,orolla,part,per,perfect,pilo,pore,produced,purple,purplish,rachi,ruit,shorter,side,single,slit,spaced,spreading,stamen,stone,strongly,swelling,tall,tamen,tem,thecae,time,tomentose,toward,trunk,ud,umbrella-shaped,unit,vary,vein,wide,ympodial	arrangement,bud,characteristic,colour,corolla,exertion,form,growth,height,history,inflorescence,leaf,length,life,lobing,ovary,perennial,plant,seed,shape,size,stem,surface,texture,type	0-0.5-3.5,0.5-1,1-2,1-3,1.5-2,1.5-2.5,1.5-5,15-25,15-40,2-4,25-40,3-10,3-12-25,3-4,4-7,5-6,abaxially,acuminate,acute,adaxially,along,also,apex,apical,apiculate,articulated,basal,base,branch,branched,brownish-purple,cm,connivent,cordate,cucullate,deeply,deltate,densely,diameter,dull,eglandular,ellipsoidal,entire,finely,flattened,flower,fork,forked,fruit,fusiform,glabrous,gland,glandular,greenish,hair,lanceolate,leaf-opposed,leaving,lobe,long,loosely,margin,mature,mm,moderately,narrowly,near,oblique,often,ovate,ovoid,pale,pedicellar,pilose,prominent,pseudohair,puberulent,pubescent,rarely,remnant,reniform,rugulose,shallow,shrub,simple,slightly,small,sparsely,stellate,subcoriaceous,tip,tree,triangular,truncate,two,unbranched,violet,white,x,yellow	perennial
