	coreid	status	nwords_original	nwords_result	nwords_recovered	nwords_omitted	nwords_created	prop_recovered	common_words	original_only	result_only
0	wfo-0001025652	success	156	76	24	132	52	0.154	anther,apex,base,calyx,corolla,filament,fruit,growth,leaf,lower,margin,pale,pedicel,petiole,pore,shape,shrub,small,stem,surface,tan,tree,unit,white	.3,.5,0.5-1,1,1-1.5,1.5-2,10-20,15-17,15-19,2-3,2-5,2-6,20-50,3-3.5,3-5,3-5-flowered,4,4-6,4-7,9-11,abruptly,acuminate,acute,anthesi,appearing,bark,bilobed,blade,broad,campanulate,closed,closely,cm,completely,connate,decurrent,densely,dia,differing,difoliate,dry,eaf,edicel,eed,elliptic,emerge,envelope,fleshy,flower,free,furcate,geminat,glabrate,glabrous,green,greyi,greyish,growing,irregular,lateral,like,live,lobe,lobed,lon,long,main,major,matte,middle,minor,minute,minutely,mm,narrowing,nearly,new,nflorescence,occasionally,older,one,onto,opposite,ovary,overlappin,ovoid,ovoid-reniform,pair,paler,papillae,papillo,papillose,parallel,pinkish-grey,pitted,planar,plant,poricidal,portion,rather,red-papillose,ry,scar,shaped,shiny,simple,size,soon,spaced,specimen,stigma,straight,strongly,style,tall,tapering,tear,tear-drop,thick,thicker,tightly,tip,tube,ud,vein,wider,widest,wing,winged,x,ympodial,young	appressed,articulation,bract,branching,breeding,broad-based,cell,colour,connective,form,fruiting,hair,heteromorphism,inflated,inflorescence,insertion,interjected,interpetalar,leaflet,length,marking,mature,modification,needle-like,none,odour,orientation,paired,pattern,placement,position,prickle,pseudostipule,rhizome,scale,smell,spot,staman,stellate,stone,structure,symmetry,sympodial,system,texture,tissue,trichome,tuber,type,vegetative,xylopodia,zygomorphy
1	wfo-0001025657	exception_thrown	239	0	0	239	0	0.0		-2,/3,0.1-0.4,0.2-0.4,0.5-2.5,1-1.1,1-1.3,1-1.6,1-3,1.2-1.5,1.3-2,1.5-1.8,1.7-1.9,12x,2-10,2-3.5,2.2-5.5,2.5-9.3,2.7-4.3,2/3,25-60,3-4,3-4.8,3-6,3.2-6,4-4.4,4-4.5,4-7,5-14,5-16,6-12,6-8,6.5-10,7-27,7-9,7-9.5,8-10.5,8.3-12,abaxially,accrescent,acute,adaxially,ag,also,anther,anthesi,apart,apex,apparently,appearing,ark,around,articulated,ascending,axe,axillary,ba,base,berry,blade,bluish,blunt-tipped,branch,branched,broadly,brown,bud,calyx,capitat,central,chartaceous,closely,cm,conical,cordate,corolla,cylindrical,dark,deltoid,dendritic-multangulat,dendritic-multangulate,dense,densely,diameter,directed,distally,dried,due,eaf,earl,edge,eed,elliptic,entire,especially,evident,exerted,expanded,exserted,farinose,few-rayed,filament,fleshy,flower,free,fruit,fruiting,glabrous,glandula,glandular,granular,green,hair,half,inserted,lanate-pubescent,lanceolate,lateral,leaf,length,lengthening,light,lobe,lobed,long,long-stalked,longitudinal,lower,m.,magnification,main,margin,midrib,minutely,mixed,mm,multangulate,narrowly,nearly,nflorescence,oblong,obtuse,occasional,often,older,open,orbicular,orolla,ovat,ovate,ovate-lanceolate,overlapping,pale,part,parted,partly,pedicel,peduncle,perfect,persistent,persistently,petiole,plurifoliate,pore,poricidal,porrect-stellate,present,pseudo-terminal,pubescence,pubescent,rachi,ray,reportedly,reticulate-punctate,ripe,ruit,scented,semi-ovate,sessile,short,short-,short-stalked,shrub,side,simple,slightly,slit,soft,somewhat,spaced,splitting,stamen,stellate,stellate-pubescent,stem,stigma,stipitate-glandular,stipitate-multangulate,strongly,style,subcampanulate,subcoriaceous,suborbicular,surface,suture,tall,tamen,tan,terete,thick-stalked,thickened,thin-stalked,time,tip,tomentose,tomentose-pubescent,tomentum,transparent,tree,tube,two-third,ud,unarme,unarmed,unit,upper,usually,vary,vein,velutinous-pubescent,way,weakly,white,wide,x,yellow,yellowish,ympodial,young	
2	wfo-0001025669	success	216	131	77	139	54	0.356	0-7,0.1-0.3,1,1-2,2-3,2.2-6.5,absent,anther,apex,articulation,base,berry,blue,cell,chartaceous,cm,corolla,cuneate,distal,end,filament,forming,fruit,glabrous,globose,green,hair,half,herb,homostylous,interjected,lanceolate,leaflet,lengthening,long,lower,margin,membranous,minute,mm,moderately,monochasium,multicellular,near,oblique,odd-pinnate,one,ovoid,pedicel,petiole,placed,plant,plurifoliate,pore,poricidal,pubescent,purple,rarely,rosette,rotate,scale-like,short,slightly,slit,sometimes,stem,streaked,subglabrous,tall,tinged,tip,tri-,tuber,typically,unbranched,unit,white	'',.5,0-1,0-5,0.8-2.4,1-10,1-2.2,1-3,1-4,1.3-4.2,1.4-2.5,1.6-4.4,13-35,2,2-4,2.2-6,2.4-7,3-5,3-7,4-6,5-merou,9-24.5,``,abaxially,absen,acumen,acuminate,acute,adaxially,ag,along,alyx,apart,apparently,axe,blade,broadly,brownish,capitat,ciliate,clavate,clearly,condition,connivent,contracted,covering,decurrent,diameter,digestion,discussion,distinct,dorsally,drying,eaf,edge,eed,elliptic,enzyme,erec,especially,exceeding,except,extra,flat,flower,flowered,folded,fresh,geminat,glabrou,greatly,green-white,greenish,hair-like,highly,honeycomb-shaped,larger,lateral,like,living,lobe,make,midrib,minutely,mottled,mucilaginous,nflorescence,obovate,obtuse,often,orbicular,orolla,ovate,pair,peduncle,perfect,petiolulate,petiolule,proximal,puberulent,reduced,removed,ripe,rounded,ruit,see,seed,sessile,seudostipule,single,size,spaced,species,specimen,stamen,ste,stigma,stolo,straight,style,subequal,tamen,tem,terminal,testal,thick,throughout,truncate,tube,unequal,unwinged,vary,wall,wet,whitish,wide,x,yellow,ympodial	age,appressed,bract,branching,breeding,broad-based,calyx,colour,connective,erect,form,fruiting,geminate,growth,heteromorphism,inflated,inflorescence,insertion,interpetalar,leaf,length,marking,mature,modification,needle-like,null,odour,orientation,paired,pattern,placement,position,prickle,pseudostipule,rhizome,scale,shape,smell,spot,staman,stolon,stone,structure,surface,symmetry,sympodial,system,texture,tissue,trichome,type,vegetative,xylopodia,zygomorphy
3	wfo-0001025697	success	181	114	60	121	54	0.331	0-14,1-1.7,1-2,3-6,anther,apex,asymmetric,attenuate,axillary,base,basiscopic,berry,blue,bud,cell,cm,coriaceous,corolla,deep,distal,filament,forked,fruit,glabrous,globose,green,hair,half,herb,high,homostylous,interjected,lanceolate,leaf,leaflet,lilac,long,lower,medium,mm,odd-pinnate,pedicel,pentagonal,petiole,plurifoliate,pore,poricidal,purple,ripe,rotate,rounded,sessile,side,stripe,subtending,terminal,tip,tissue,tri-,unit	-9,0.15-0.75,0.6-3.5,0.8-2,1-3,1.5-1.8,1.7-8.6,10-26,2-10.5,2-2.6,2-4,2-6,25-35,3-10,3-4,3-5,3.3-11,4-7.5,5-merou,5.5-11.5,6.5-13.5,abaxially,acumen,acuminate,acute,adaxiall,adaxially,ag,alyx,apart,apparently,articulated,axe,blade,brownish,capitat,clavate,condition,connivent,covering,dark,decreasing,decurrent,diameter,digestion,dorsally,drying,eaf,edge,eed,elliptic,enzyme,erec,exceeding,flat,flower,folded,fresh,geminat,generally,glabrescent,glabrou,green-white,greenish,hair-like,hal,honeycomb-shaped,lateral,lengthening,light,linear,living,lobe,make,mucilaginous,nflorescence,orbicular,orolla,ovate,ovoid,pair,peduncle,perfect,petiolulate,plant,rachi,removed,ruit,seed,seudostipule,short,size,slightly,slit,spaced,specimen,stamen,stigma,straight,style,subequal,subglabrou,tall,tamen,tem,testal,thick,throughout,toward,tube,typically,unwinged,usually,vary,wall,wet,whitish,wood,x,yellow,ympodial	appressed,articulation,bract,branching,breeding,broad-based,calyx,colour,connective,form,fruiting,geminate,growth,heteromorphism,inflated,inflorescence,insertion,interpetalar,length,margin,marking,mature,modification,needle-like,null,odour,orientation,paired,pattern,placement,position,prickle,pseudostipule,rhizome,scale,shape,smell,spot,staman,stem,stone,structure,subglabrous,surface,symmetry,sympodial,system,texture,trichome,tuber,type,vegetative,xylopodia,zygomorphy
4	wfo-0001025699	exception_thrown	181	0	0	181	0	0.0		.2,.5,0.5,1,1-1.5,1-2,1-2.5,1-3,1.5,1.5-2,1/3,10,15-20,2,2-2.5,2-6,2cm,3-15,3-3.5,3-5.5,3-8,4-5,499,5-8,5-winged,5.5-14,8-9,abaxially,absent,acute,adaxially,age,almost,anther,anthesi,apart,apex,apparently,appearing,articulating,attenuate,bark,base,becoming,berry,branching,brown,c.,calyx,campanulate,capitate,cm,completely,conical,conspicuously,continuing,corolla,corrugate,crystal,cup-shaped,dark,darker,deltate,densely,diameter,difoliate,dorsal,dry,drying,eaf,eed,ellipsoid,elliptic,entire,erect,exerted,face,fide,filament,flower,free,fruiting,glabrou,glabrous,globose,green,grey-brown,growth,immature,included,inclusion,inflorescenc,inflorescence,irregularly,lanceolate,leaf,leaf-opposed,leafy,leaving,lengthening,less,lobe,lobed,lower,margin,markedly,midrib,minutely,mm,narrowly,new,nflorescence,nodding,older,one,onto,ovary,oxalate,pair,pale,papillat,papillose,pedicel,peduncle,peg,penden,per,perfect,petiole,plurifoliate,pore,poricidal,portion,primary,red,reddish,reniform,reticulate-pitted,rounded,rounded-sagittate,ruit,sand,scar,shoot,short,simple,slightly,slit,small,somewhat,spaced,stearn,stem,stigma,straight,strongly,style,surface,tangled,thickened,time,tip,tree,triangular,trichome,tube,ud,unit,vein,way,white,white-spotted,wide,wing,winged,woody,x,yellow,ympodial,young,Â½	
5	wfo-0001025700	success	189	123	68	121	55	0.36	0-16,0.30-2.0,0.5-2,0.8-2.6,5-15,5.5-18,9-31,abaxially,adaxially,anther,apex,asymmetric,attenuate,base,basiscopic,berry,blade,cell,chartaceous,cm,corolla,distal,dot,filament,forked,fruit,glabrescent,glabrous,globose,green,hair,half,herb,high,homostylous,interjected,lanceolate,lateral,leaf,leaflet,lilac,long,lower,medium,mm,odd-pinnate,pedicel,pentagonal,petiole,petiolulate,plurifoliate,pore,poricidal,purple,ripe,rotate-pentagonal,rounded,short,side,sometimes,tall,terminal,tip,tissue,tri-,unit,white,x	0.7-2.7,0.8-4,1-2,1-3,1.1-2.3,1.5-2,10-40,10.5-12,15-40,2-12,2-7,2.5-4,3-4,3-8,3.5-10.5,3.7-8.6,4-5,5-20,5-merou,5.3-17.5,5.5-8,acuman,acumen,acuminate,acute,ag,alyx,apiculate,apparently,articulated,axe,axillary,basal,brownish,bud,capitat,clavate,condition,connivent,considerably,covering,decrease,decreasing,diameter,digestion,dorsally,drying,eaf,edge,eed,elliptic,enzyme,erec,exceeding,except,flat,flower,folded,fresh,geminat,generally,glabrou,green-white,greenish,hair-like,hal,honeycomb-shaped,larger,lengthening,light,linear,living,lobe,make,mucilaginous,narrowly,nflorescence,orbicular,orolla,ovate,ovoid,pair,par,peduncle,perfect,plant,proximal,removed,ruit,seed,sessile,seudostipule,size,slightly,slit,specimen,stamen,stigma,straight,style,subequal,subglabrou,subtending,tamen,tem,testal,thick,throughout,toward,tube,typically,unwinged,usually,vary,wall,wet,whitish,whose,winged,yellow,ympodial	appressed,articulation,bract,branching,breeding,broad-based,calyx,colour,connective,erect,form,fruiting,geminate,growth,heteromorphism,inflated,inflorescence,insertion,interpetalar,length,margin,marking,mature,modification,needle-like,null,odour,orientation,paired,pattern,placement,position,prickle,pseudostipule,rhizome,scale,shape,smell,spot,staman,stem,stone,structure,subglabrous,surface,symmetry,sympodial,system,texture,trichome,tuber,type,vegetative,xylopodia,zygomorphy
6	wfo-0001025704	success	248	185	135	113	50	0.544	-10,/6,0,0-2,0.1,0.15-0.8,0.5-1.5,1,1.2-3,1.5-2,1.5-4.5,1/4-3/4,2-3,3-10,3-6,5-20,6-12,8-12,8-15,8-17,abaxial,adaxial,andromonoecious,anther,apart,apex,apically,apparently,auriculate,base,berry,blade,branched,broad-deltate,calyx,cell,chartaceous,cm,cordate,covering,curved,densely,discolorous,distance,drying,ellipsoid,elliptic,elongating,erect,extending,filament,flattened,free,fruit,fruiting,glabrescent,glabrous,green-yellow,half,heterostylous,lateral,leaf,length,less,lobe,lobed,lobing,long,longer,lower,margin,mature,maturity,mauve,midpoint,midvein,mm,moderately,multangulate,obtuse,occasionally,often,orange,orange-brown,ovate,pair,pedicel,petiole,poricidal,porrect,portion,prickle,primary,prominent,rarely,ray,red-green,reflexed,rounded,secondary,sessile,shape,shrub,side,small,sometimes,spaced,sparsely,spherical,stalk,stalked,stellate,stellate-pubescent,stem,straight,strongly,surface,terminal,tertiary,time,tip,tree,trichome,truncate,tube,unbranched,unit,vein,venation,visible,white,white-gray,wide,yellow,yellow-green	-2,-3,-5,0-100,0-3.5,0-5,0.1-0.3,0.1-0.5,0.3-0.8,0.7-1,1-3.5,1-4,1-6,1.5-3.2,1.8-3.5,1/2-4/5,1/5,2,2-10,2-4.5,2-5,2-7,2.5-4.5,2.7-4,3-15,3-5,4-12,4-5,4.5-6.5,5-merous,6-15,abaxially,acute,age,almost,alyx,apar,apiculate,articulated,axe,ba,bark,brow,connivent,deltate,development,diameter,distal,eaf,eed,end,equal,evenly,flattened-reniform,flower,gray,green,hermaphrodite,infructescence,irregular,long-styled,lowermost,near,nflorescence,older,one,open,orolla,oung,outline,pale,peduncle,pendulous,per,pericarp,pit,plant,plurifoliat,prickl,prickly,raised,recurved,red-brown,retaining,round,ruit,scar,short-styled,shorter,slender,smooth,somewhat,spreading,staminat,stellate-pubescen,stout,style,tamen,tapering,terete,throughout,unarmed,upper,variously,vary,warty,way,widening,woody,yellowish,ympodial,young,Ã	appressed,articulation,bract,branching,breeding,broad-based,colour,connective,corolla,form,growth,hair,heteromorphism,inflated,inflorescence,insertion,interjected,interpetalar,leaflet,marking,mentioned,modification,needle-like,odour,orientation,paired,pattern,placement,plurifoliate,pore,position,present,pseudostipule,rhizome,scale,smell,spot,staman,stone,structure,symmetry,sympodial,system,texture,tissue,tuber,type,vegetative,xylopodia,zygomorphy
7	wfo-0001025729	exception_thrown	177	0	0	177	0	0.0		-20,.5,/4,0.25-0.5,0.7-1.2,1-1.5,1-5,1.1-1.5,1.2-1.8,1.5-2,1.75,2,2-3.5,20,3-6,4-5,4-8,5-50-flowered,6-8,7-8,9-17,abaxial,abaxially,abrupt,acute,adaxially,along,anther,anthesi,apar,apex,apical,apiculate,appearing,axil,bark,basal,base,berry,black,blackish,branched,bright,bristly,bud,calyx,cm,corolla,covered,covering,cyathiform,dark,deflexed,deltoid,densely,denser,dia,diam,differing,difoliate,dirty,drying,eaf,edicel,eed,elliptic,enclosed,expanded,f,filament,flattened-reniform,fleshy,free,fruiting,furcate,geminat,gently,glabrou,glabrous,globose,green,greenish-yellow,greyish-brown,growing,incrassate,lamina,lat,lateral,leaf,like,live,lobe,lobed,lon,long,lower,m.,main,mainly,major,margin,member,middle,minor,minute,minutely,mm,nflorescence,oblique,occasionally,often,older,one,opposite,ovary,overlapping,overtopping,pair,pale,papillo,papillose,partially,pedicel,petiole,pit,pitted,plant,pore,poricidal,portion,prominent,pubescent,quite,raised,reflexed,ripening,rounded,ruit,scar,shaped,shiny,short,simple,size,sparsely,stem,stigma,stout,straight,style,surface,tall,tapering,tear-drop,terminal,tip,touching,tree,treelet,trichome,tub,tube,tuft,ud,uniseriate,unit,usually,vein,way,white,widening,widest,woody,x,yellow,ympodial,young	
8	wfo-0001025749	success	217	131	78	139	53	0.359	-12,/5,0-10,0.2-1.5,0.5-0.8,0.5-3,1-3,1/4-1/3,2.5-6,3-20,5-10,adnate,anther,apart,apex,apparently,base,berry,blade,calyx,chartaceous,cm,cuneate,difoliate,elongating,erect,filament,flattened,fruit,fruiting,glabrous,lateral,leaf,length,lobe,lobed,long,lower,margin,markedly,mature,maturity,mauve,midvein,mm,moderately,narrow-deltate,orange-red,pedicel,petiole,poricidal,prickle,prickly,procumbent,purple,rounded,shrub,side,sometimes,spaced,sparsely,spherical,spreading,stellate,stellate-pubescent,stem,straight,straw-yellow,surface,tapering,tip,trichome,unit,usually,way,white,wide,yellow-orange	-1,.5,0-3,0-5,0-6,0-8,0.1,0.1-0.2,0.1-0.3,0.1-0.4,0.2,0.3-1.5,0.4-0.7,0.5,0.5-0.9,0.5-1.3,0.6-4.5,0.8-0.9,1,1-10,1-13,1-2,1-6,1-8.5,1-9,1.5,1.5-2,1.5-2.5,1/5-1/2,2-10,2-2.5,2/3,3-5,4-8,5-,5-20,5-merous,6-8,abaxial,abaxially,acuminat,acute,adaxial,adaxially,almost,alyx,apar,apically,articulated,bark,branched,broad-deltate,concolorous,curved,dark,densely,diameter,discolorous,distance,drying,dull,eaf,eed,equal,extending,filiform,flattened-reniform,flower,free,geminat,gently,glabrescent,gray,green-brown,herbaceous,indistinct,infructescence,light,lon,long-ovate,longer,magnification,midpoint,narrow-ovate,nflorescence,oblong,obtuse,occasionally,older,one,open,orange-brow,orange-brown,orbicular,orolla,oung,ovate,pair,pale,peduncle,pendulous,per,perfec,pericarp,porrect,portion,prickl,primary,rarely,ray,recurved,red-brown,reduced,ruit,scar,sessile,shorter,smooth,stalk,stalked,strongly,style,tamen,terete,tertiary,time,toward,tube,variously,vary,vein,venation,visible,without,yellow,yellow-green,yellowish,ympodial,Â½-2/	appressed,articulation,bract,branching,breeding,broad-based,cell,colour,connective,corolla,form,geminate,growth,hair,heteromorphism,inflated,inflorescence,insertion,interjected,interpetalar,leaflet,marking,mentioned,modification,needle-like,odour,orientation,paired,pattern,perfect,placement,pore,position,present,pseudostipule,rhizome,scale,shape,smell,spot,staman,stone,structure,symmetry,sympodial,system,texture,tissue,tuber,type,vegetative,xylopodia,zygomorphy
9	wfo-0001025754	exception_thrown	164	0	0	164	0	0.0		-celled,.5,0.1-0.2,0.5-1,0.5-1.5,1,1-2,1-3,1-3.5,1.5,1.5-3,1.5-4,10-20,10-35,2-4,2-5-celled,2-7,2-foliate,3-10,3-5,3-6,4,4-6,5-12,5-15,abaxially,absent,abundant,acuminate,acute,adaxiall,adaxially,along,anther,apex,asymmetrical,axe,barely,base,berry,beyond,blade,branch,brown,calyx,center,chartaceous,ciliate,cm,connected,cordate,cordiform,decumbent,decurrent,dehiscing,densely,denser,diameter,dm,dried,drying,eaf,edge,eed,eglandular,emarginat,entire,equal,erect,explosively,exserted,filament,fine,flat,flower,fruit,geminat,glabrous,glandular,globose,hair,held,herb,immature,interpetalar,leaf,leaving,like,linear-lanceolate,lobe,long,lower,lying,main,margin,material,maturing,maturit,membranaceous,mesocarp,mixed,mm,moderately,much-branched,nearly,nfloresence,notch,oblong,often,orolla,palmately,parallel,pedicel,peduncle,penden,per,petiole,placenta,pressure,probably,pubescen,pubescent,rachi,radiating,raised,ridge,rotate,ruit,running,semitransparent,shallow,short,slightly,small,solitary,sometimes,sparsely,stamen,stem,stigma,straight,style,surface,swollen,tal,tamen,tem,tissue,triangular,truncate,tube,unbranched,unit,upright,vary,vein,visible,watery,white,wid,woody,x,yellow,ympodial	
10	wfo-0001025760	success	210	91	43	167	48	0.205	1-4,annual,anther,apex,base,berry,calyx,cm,cuneate,difoliate,erect,filament,fruit,fruiting,geminate,hair,herb,lateral,leaf,length,lobed,long,lower,margin,marking,mature,orange,pedicel,perennial,petiole,rounded,shape,shrub,spherical,stellate,stem,subentire,surface,trichome,unbranched,unit,weakly,white	-10,-12,-3,-5,-6,.5,/3,0-0.5,0-100,0.1,0.1-0.2,0.15-0.3,0.2-0.35,0.3-1,0.4-0.8,0.45-0.9,0.5-1.5,0.5-2,0.7-2.5,0.8-1.8,1,1-,1-1.8,1-2,1.5,1.5-2.5,1.5-4.5,1.5-5,1/4,1/4-1/2,1/4-1/3,1/5,2-2.5,2-3,2.1-3.5,2.3-4,2.5-10,2.5-8,2/3,3,3-6,3.5-17,3.5-9,5-10-merous,5-18,8-10,abaxial,abaxially,acut,acute,adaxial,almost,alyx,apar,apically,apparently,articulated,bark,black,blade,broad-deltate,brow,chartaceous,concolorous,connivent,cream,cultivar,curved,dark,deltate,diameter,discolorous,distance,drying,dull,eaf,eed,elliptic,elongating,equal,extending,flattened-reniform,flower,free,geminat,gently,glabrescent,glabrous,green,infructescence,lengt,lobe,longer,maturity,membranous,midpoint,midvein,minute,mm,moderately,nflorescence,often,older,one,open,orange-brown,orolla,oung,ovate,pair,pale,peduncle,pendulous,per,perfec,pericarp,poricidal,porrect,portion,primary,ray,recurved,red-brown,reflexe,ruit,scar,sessile,shorter,side,simple,slender,smooth,sometimes,spaced,spreading,stalk,stalked,stellate-pubescen,stellate-pubescent,stout,straight,style,tamen,tapering,terete,tertiary,thick-stalked,time,tip,tube,unarme,unarmed,upper,usually,various,variously,vary,vein,venation,visible,way,wide,woody,yellow,yellow-green,ympodial,young	appressed,articulation,bract,branching,breeding,broad-based,cell,colour,connective,corolla,form,growth,heteromorphism,inflated,inflorescence,insertion,interjected,interpetalar,leaflet,modification,needle-like,null,odour,orientation,paired,pattern,placement,pore,position,prickle,pseudostipule,rhizome,scale,smell,spot,staman,stone,structure,symmetry,sympodial,system,texture,tissue,tuber,type,vegetative,xylopodia,zygomorphy
11	wfo-0001025782	exception_thrown	200	0	0	200	0	0.0		-2,.5,0-10,0-5,0.1-0.15,0.1-0.2,0.1-0.25,0.3-1,0.4-0.6,0.5-1,0.55-0.75,0.9-1.3,1,1-1.7,1-2,1-2.5,1-4,1.2-6,1.3-1.6,1.5-3,1/4-1/2,1/4-1/3,1/6,10-13,2-10,2-2.5,2-3,2-5,2-7,2.5-3.5,2/3-3/4,20,3-4,3-5,4,4-4.5,4.5-9,5-20,5-6.5,5-8,5-merous,5.5-6,6-14,6-8,abaxial,abaxially,acuminat,acuminate,adaxial,also,alyx,andromonoecious,anther,apar,apart,apex,apically,apparently,articulated,bark,base,berry,blade,brown,calyx,chartaceous,climbing,cm,concolorous,conical,connivent,cuneate,curved,deltate,densely,diameter,difoliate,discolorous,distal,distance,drying,dull,eaf,eed,elliptic,elongated,elongating,equal,evenly,extending,filament,flattened,flattened-reniform,flower,free,fruit,fruiting,geminat,geminate,gently,glabrescent,glabrous,green,green-brown,hair,hermaphrodite,heterostylous,infructescence,lateral,leaf,lengt,length,less,lobe,lobed,long,long-styled,longer,lower,lowermost,margin,mature,maturity,membranous,midpoint,midvein,minute,mm,moderately,nflorescence,occasionally,older,one,open,orange-brown,orolla,oung,pair,pedicel,peduncle,pendulous,per,pericarp,petiole,plant,poricidal,porrect,portion,prickl,prickle,prickly,primary,ray,red-brow,reduced,ruit,scar,sessile,short-styled,shorter,shrub,side,simple,smooth,spaced,sparsely,spherical,spreading,staminat,stellate,stellate-pubescent,stem,stout,straight,style,surface,tamen,tapering,terete,tertiary,time,tip,toward,trichome,tube,unbranched,unit,vary,vein,venation,visible,way,weakly,white,wide,woody,yellow,yellow-green,ympodial,young	
12	wfo-0001025783	exception_thrown	179	0	0	179	0	0.0		.5,0.5,0.5-1,0.5-1.5,0.8-3.5,1-1.2,1-1.5,1-3,1.8-2,2,2-3+,2-5,2-6.5,3-4,5,5-merou,7-10,<,abaxiall,abaxially,acute,adaxiall,adaxially,along,alyx,anther,anthesi,apart,ape,apex,ark,articulated,axil,base,berry,branched,branching,brown,bud,c.,calyx,cell,cluster,cm,completely,confined,conical,coriaceous,corolla,dendritic,densely,diameter,eaf,eed,ellipsoid,elliptic,entire,erect,expanded,exposed,exserted,filiform,flattened,fleshy,flexuous,flower,free,fruiting,glabrou,glabrous,globose,green,greyish,groove,growth,hromosome,ilament,inserted,keeled,known,lateral,lax,less,lobe,lobed,long,long/tall,lower,margin,mature,midrib,midvein,minute,minutely,mm,mmm,narrowly,near,new,nflorescence,nodding,number,obscured,obtuse,occasionally,older,orolla,outlin,pair,pale,pedicel,peduncle,penden,pentagonal,perfect,pericarp,petiole,pitted,plurifoliat,point,portion,possibly,primary,pubescent,purple,reniform,revolute,ripe,ruit,sagittate,scar,scarious,see,shiny,shoot,short,shrub,simple,sleeve,slightly,sometimes,somewhat,spaced,sparse,sparsely,stellate,stem,stigma,strongly,style,surface,suture,terminal,testal,thin,time,transparent,triangular,trichome,truncate,tube,tuft,twinin,type,ud,uniseriate,unit,upper,vary,vein,vine,violet,way,weak,wide,within,woody,yellowish,ympodial	
13	wfo-0001025788	success	158	135	76	82	59	0.481	1-4,1-5,1.8-2.7,2-10,2-3,2m,4-5.5,4.5-10.1,abaxially,adaxially,apex,apical,base,blue,branched,calyx,cell,cm,conical,connate,corolla,cuneate,cyme,deep,dehiscent,dichasial,dichasially,distal,ebracteate,filament,finely,flower,forked,generally,green,hair-like,half,herbaceous,honeycomb,interjected,introrse,lateral,leaf,leaflet,long,lower,maturing,medium,mm,monochasial,oblique,odd-pinnate,pattern,pedicel,perennial,perfect,petiole,petiolule,plant,poricidally,proximal,pubescent,purple,rotate,rounded,sessile,short,slit,subsessile,testal,tuber-bearing,typically,unit,wall,wide,Â¼	-8,0-6,0.5-2,1.8-3.9,10-24,14-48,15-30,2-13,2-5,2.8-9.5,3-,3-6-foliat,4-3.,4.5-12.5,5-8,6-7,6.2-12.5,8-38,abaxiall,acumen,acuminate,acute,apically,articulate,attenuate,covering,diameter,digestion,diminishing,dorsally,eaf,edge,eed,elliptical,emoval,enzyme,exceeding,flat,folded,globo,gradually,green-white,living,lobe,lon,long-attenuate,lunat,make,mucilaginous,narrowly,nflorescence,nther,obtuse,often,orolla,ovate,ovoid,pair,peduncle,plan,reveal,ruit,seed,seudostipule,size,specimen,stamen,stigma,straight,style,subequal,tal,tem,terminal,thick,throughou,throughout,tip,toward,vary,yellow,ympodial	3-6-foliate,4-31,anther,appressed,articulation,bract,branching,breeding,broad-based,colour,connective,form,fruit,fruiting,growth,hair,heteromorphism,inflated,inflorescence,insertion,interpetalar,length,lunate,margin,marking,mature,modification,needle-like,null,odour,orientation,paired,placement,pore,poricidal,position,prickle,pseudostipule,rhizome,scale,shape,smell,spot,staman,stem,stone,structure,surface,symmetry,sympodial,system,texture,tissue,trichome,tuber,type,vegetative,xylopodia,zygomorphy
14	wfo-0001025792	success	203	170	116	87	54	0.571	0.4-0.7,1-2,1-3,2-3.5,2.5-4,3-5,3.5-6,4-6,4.5-7,5,5-6,5-9,7-10,abaxially,acute,adaxially,anther,apex,articulated,articulation,auriculate,axillary,base,basiscopic,berry,blade,blue-mauve,blue-purple,broadly,bud,cell,chartaceous,cm,connivent,corolla,dark,decurrent,densely,developing,distal,distinct,distinctly,elliptic,except,filament,forked,fruit,generally,glabrous,globose,greatly,green,hair,half,herb,high,homostylous,indistinct,interjected,lanceolate,lateral,leaflet,lengthening,like,long,lower,margin,mauve,membranous,minute,mm,narrow,oblique,odd-pinnate,often,onto,ovoid,pair,pedicel,petiole,petiolulate,plant,plurifoliate,pore,poricidal,proximal,pubescent,purple,rachi,reduced,ripe,rotate-pentagonal,rounded,semi-rosette,sessile,short,side,size,slightly,slit,stem,streak,sub-rosette,subequal,subtending,tall,terminal,tinged,tip,tri-,unit,usually,white,wing,x,young	1-10,1-4,10-15,2-11,2-3,2.5-3.5,21-28,3-4,4-12,5-10,5-merou,7.5-8,8-10,9-12,acumen,acuminate,ag,along,alyx,apart,apparently,axe,brownish,capitat,ciliate,condition,covering,diameter,digestion,dorsally,drying,eaf,edge,eed,enzyme,especially,exceeding,flat,flower,folded,fresh,geminat,glabrou,green-white,greenish,hair-like,hal,honeycomb-shaped,living,lobe,make,midrib,minutely,mottle,mucilaginous,narrowly,nflorescence,orolla,papillose,peduncle,perfect,puberulent,removed,ruit,seed,semi-erec,seudostipule,shortly,spaced,specimen,stamen,ste,stigma,straight,style,tamen,tem,testal,thick,throughout,tube,vary,wall,wet,whitish,yellow,ympodial	age,appressed,bract,branching,breeding,broad-based,calyx,colour,connective,form,fruiting,geminate,growth,heteromorphism,inflated,inflorescence,insertion,interpetalar,leaf,length,marking,mature,modification,needle-like,null,odour,orientation,paired,pattern,placement,position,prickle,pseudostipule,rhizome,scale,semi-erect,shape,smell,spot,staman,stone,structure,surface,symmetry,sympodial,system,texture,tissue,trichome,tuber,type,vegetative,xylopodia,zygomorphy
15	wfo-0001025804	exception_thrown	155	0	0	155	0	0.0		.25,.5,0.5-1,1-1.5,1-3,1.2-1.5,1.4-1.7,1.5-2,10-20,11-20,16-35,2-2.5,2.5-4,3-4.5,3.5-12,4-10,5,6-8,7-10,?,abaxially,acute,adaxially,age,anther,anthesi,apar,ape,apex,apiculate,attenuate,ba,bark,base,berry,bilobed,branched,c.,calyx,clavate,cm,conical,corolla,covered,cream,cucullate,dark,decurrent,deflexed,densely,dia,differing,difoliate,drying,eaf,edicel,eed,ellipsoid,elliptic,erect,exserted,filament,flattened,fleshy,flower,free,fruiting,geminat,glabrous,glandular,globose,green,incrassate,internodal,later,lateral,leaf,lengthening,light,lobe,lobed,long,lower,main,major,many,margin,mere,middle,minor,minute,minutely,mm,near,nearly,nflorescence,obovate,occasionally,often,older,onto,opposite,ovary,pair,paler,papillae,papillat,papillate,papillose,pedicel,pitted,planar,plurifoliate,pore,poricidal,portion,projection,red,red-papillose,reddish-brow,reddish-brown,regularly,reniform,rim,ruit,scar,sessile,shrub,size,slit,somewhat,spaced,stem,stigma,strongly,style,surface,tall,thick,time,tip,tub,tube,ud,unit,vein,white,whitish-green,widest,wing,winged,woody,x,ympodial,young	
16	wfo-0001025813	exception_thrown	197	0	0	197	0	0.0		'',0-2,0.7-1.7,1-1.5,1-10,1-2,1-4,1.2-4.5,1.3-7,1.5-1.8,1.5-2,1.5-6.5,15-30,2-3,2-4,2-5,3-3.5,3-4,3-5,3-6,3-7,5-18.5,5-6,5-merou,6-7,``,abaxially,absent,acumen,acuminate,acute,adaxially,ag,along,alyx,anther,apart,apex,apparently,articulated,axe,base,berry,blade,blue,borne,broadly,brownish,cell,chartaceous,ciliate,cm,condition,connivent,contracted,corolla,covering,cuneate,dark,decreasing,decurrent,densely,diameter,digestion,discussion,distal,distinct,dorsally,drying,eaf,edge,eed,elliptic,end,enzyme,especially,exceeding,extra,filament,flat,flower,folded,fresh,fruit,geminat,glabrou,glabrous,globose,green,green-white,greenish,hair,hair-like,half,herb,highly,homostylous,honeycomb-shaped,interjected,lanceolate,larger,lateral,leaflet,lengthening,light,like,living,lobe,long,longer,lower,make,margin,membranous,midrib,minute,minutely,mm,monochasium,mucilaginous,near,nflorescence,obtuse,odd-pinnate,often,orbicular,orolla,ovate,ovoi,ovoid,pair,pedicel,peduncle,perfect,petiole,petiolulate,pilose,plant,plurifoliate,pore,poricidal,puberulent,pubescent,rachi,rarely,removed,rosette-formin,rotate,ruit,see,seed,sessile,seudostipule,short,single-flowered,singly,size,slit,sometimes,spaced,species,specimen,stamen,ste,stem,stigma,stolo,straight,strongly,style,suborbicular,tamen,tem,terminal,testal,thick,thir,throughout,tip,toward,tri-,tube,tuber,typically,unforked,unit,unwinged,vary,vein,violet,wall,wet,white,whitish,x,yellow,ympodial	
17	wfo-0001025825	success	187	118	64	123	54	0.342	1-2,1-5.5,14-85,3-5,anther,apex,asymmetric,attenuate,axillary,back,base,basiscopic,berry,bud,cell,cm,coriaceous,corolla,decurrent,distal,filament,forked,fruit,glabrous,green,hair,half,herb,high,homostylous,interjected,lanceolate,leaf,leaflet,lilac,lobe,long,lower,medium,mm,odd-pinnate,ovoid,pedicel,pentagonal,petiole,petiolulate,plurifoliate,pore,poricidal,rachi,rotate-pentagonal,rounded,sessile,shiny,side,slightly,streak,subtending,terminal,tip,tissue,tri-,unit,white	0-0.21,0.4-1,0.4-3,0.5-0.8,0.5-10.4,0.7-2.2,0.9-2,0.9-4,1-3,1.1-1.4,10-24,10.5-26,2-3.7,2-5,22-86,3-10,3-8.5,3.7-6.5,4-8,4-9,5-10,5-7,5-merou,6-10,6.6-14,abaxially,acumen,acuminate,acute,adaxiall,adaxially,ag,alyx,apart,apparently,articulated,axe,blade,brownish,capitat,clavate,condition,connivent,covering,cuneate,dark,decreasing,diameter,digestion,dorsally,drying,eaf,edge,eed,elliptic,enzyme,erec,exceeding,flat,flower,folded,fresh,geminat,generally,glabrescent,glabrou,green-white,greenish,hair-like,hal,honeycomb-shaped,increasing,lateral,lengthening,light,living,make,middle,mucilaginous,nflorescence,orbicular,orolla,ovate,pair,peduncle,perfect,plant,removed,ruit,seed,seudostipule,short,size,slit,smaller,spaced,specimen,stamen,stigma,straight,style,subequal,subglabrou,tall,tamen,tem,testal,thick,throughout,toward,tube,unwinged,usually,vary,wall,wet,whitish,wide,wing,winged,x,yellow,ympodial	appressed,articulation,bract,branching,breeding,broad-based,calyx,colour,connective,form,fruiting,geminate,growth,heteromorphism,inflated,inflorescence,insertion,interpetalar,length,margin,marking,mature,modification,needle-like,null,odour,orientation,paired,pattern,placement,position,prickle,pseudostipule,rhizome,scale,shape,smell,spot,staman,stem,stone,structure,subglabrous,surface,symmetry,sympodial,system,texture,trichome,tuber,type,vegetative,xylopodia,zygomorphy
18	wfo-0001025838	exception_thrown	217	0	0	217	0	0.0		-20,.5,0.5,0.5-1,0.7-2,1-1.2,1-1.5,1.2-5,1.5-1.7,1.5-2,1.5-2.5,1.5-3.5,1.5-5,1.8-2,10-15,10-60,2-2.5,2-5,2.5-3,2/3,20-40,3.5-,4-15,4.5-5.5,5,5-merou,6-15,6.5-7,abruptly,acuminate,adaxial,adaxially,ag,along,alyx,anther,anthesi,apart,apex,apiculate,appearing,archin,ark,articulated,attenuate,axil,basall,base,berry,black,branch,branched,broad,brown,calyx,capitate,cell,clavate,clustered,cm,connivent,corolla,cucullate,cup-shaped,dark,decurrent,dendritic,dense,densely,denser,diameter,disintegrating,drying,eaf,eed,ellipsoidal,elliptic,entire,erect,exserted,extending,filament,flattened,fleshy,flower,free,fruit,fruiting,glabrescent,glabrous,globose,greenish,growth,hairy,ilament,inflorescence,inserted,insertion,irregularly,keeled,lamina,lanceolate,lateral,leaf,lengthening,less,like,lobe,lobed,long,loosely,lower,m.,many,margin,membranous,midrib,minute,minutely,mm,mostly,narrowing,narrowly,never,new,nflorescence,nodding,occasionally,often,older,onto,orolla,ovoid,pair,pale,papillat,papillo,pedicel,peduncle,per,perfect,pericarp,petiole,pitted,platform,plurifoliat,point,pointed,pore,poricidal,portion,primary,pubescent,purple,quadrate,reddish,reniform,revolute,ripe,ruit,scar,seed,shin,shiny,short,shrub,simple,sinus,sleeve,slender,slightly,slit,small,sometimes,spaced,sparsely,spreading,square,stellate,stem,stigma,strongly,style,surface,tall,tem,terminal,testal,thi,thin,time,tinged,tip,tree,trichome,tube,tuft,turbinate,twinin,ud,uniseriate,unit,upper,vary,vein,wall,way,weight,white,wing,winged,woody,x,yellow,yellowish,ympodial,Â¾	
19	wfo-0001025845	exception_thrown	180	0	0	180	0	0.0		.5,0.3-0.5,0.4-1.5,0.5-11,0.5-2.5,1,1-1.8,1-2,1-4.5,1.5,1.5-13,1.5-2,1.5-2.5,1.5-7,2,2-15,2-3,2-5-lobed,2.5-4,3,3-13,3-4,3-6,3-foliat,4-5,4-6,5-6,6-6.5,6-9,7-10,abaxially,abundantly,acuminate,acute,adaxial,adaxially,aggregate,along,anther,apart,apex,apiculate,around,articulated,ascending,axe,ba,base,blade,branch,brown,calyx,cell,channe,chartaceous,cm,compressed,connivent,corolla,cuneate,cylindrical,dark,decurrent,deltate,diamete,diameter,directed,distall,distally,divided,eaf,eed,eglandular,ellipsoidal,elliptic,entire,especially,extra-axillary,filament,flattened,flower,fork,free,fruit,glabrou,glabrous,green,greenish,herb,inserted,lateral,laterally,leaf,light,lobe,lobed,located,long,longitudinal,lower,major,margin,membranaceous,mesocarp,midrib,minutely,mm,narrowly,near,nearly,nflorescence,obovate,obtuse,often,orange,orolla,ovate,ovoid,part,patch,pedicel,peduncle,perfect,petiole,pinnately,pore,puberulent,pubescent,purple,rachi,radiu,rarely,rotate-stellate,rounded,rugose-verrucate,ruit,sagittate,sand-punctate,shorter,shrub,side,simple,sinus,small,spaced,sparsely,stigma,stone,stripe,strongly,style,subcordate,tal,tamen,tapered,tem,terminal,thecae,thick,tightly,time,tip,tomento,triangular,truncat,truncate,tube,unbranched,unit,unlobed,vary,vein,veiny,white,wide,x,yellow,yellowish,ympodial,youn	
20	wfo-0001025850	exception_thrown	197	0	0	197	0	0.0		-5,-7,.5,.8,0.5,0.5-,0.5-1,0.5-3,0.6-1,1,1-1.5,1-3,1-celled,1.5,1.5-5,15-20,2,2-12,2-6.5,3-4,30,4-5,5-7,5-merou,6-7,abaxial,acute,ag,along,alyx,anther,anthesi,apar,apex,apparently,ark,articulated,axi,basal,base,berry,branched,broadly,brown,calyx,capitate,cell,cm,connivent,corolla,cupped,cyathiform,deciduous,deflexed,deltate,densely,denser,diameter,divaricate,divided,drying,eaf,eed,ellipsoid,elliptic,elongate,em,entire,erect,exserted,extending,filament,flattened,fleshy,flower,free,fruiting,geminat,glabrou,glabrous,gland,glandular,globose,green,growth,half,halfway,ilament,inflorescence,irregularly,lamina,later,lateral,lax,leaving,lengthening,less,lobe,lobed,long,loosely,lower,many,margin,membranous,midrib,minute,minutely,mm,narrowly,nearly,new,nflorescence,nodding,node,occasionally,often,older,openly,orange,orolla,outline,pair,pale,papillate-puberulent,papillo,pedicel,peduncle,peg,per,perfect,petiole,pinnatifid,pitted,planar,plurifoliate,pore,poricidal,portion,primary,puberulen,pubescent,reddish,reniform,rhomboid,ripe,rounded,ruit,scar,scattered,shallowly,shiny,shrub,simple,sinuate,sinus,sleeve,slender,slightly,slit,small,sometimes,soon,spaced,splitting,spreadin,spreading,stellate,stem,stigma,strongly,style,surfac,surface,tan,terminal,testal,thin,time,tiny,tip,trichome,truncate,tube,twinin,ud,uniseriate,unit,vary,vein,vine,white,woody,x,yellow,ympodial,young	
21	wfo-0001025872	exception_thrown	160	0	0	160	0	0.0		.1,.5,0.25-0.5,0.5,0.5-1,0.6-1,1,1-1.3,1-1.5,1-2,1.2-1.5,1.2-1.6,1.7-3,10-25-flowered,2-2.5,2-5,2/3,3.5-4,4-4.5,4.5-13,6-10,6-8,acute,along,anther,anthesi,apart,apex,apically,auriculate,ba,bark,base,becoming,beginning,beneath,berry,blade,branched,bright,broadly,brownish,calyx,capitate,cm,coriaceous,corolla,crinkled,crowded,cup-shaped,dark,decurrent,deeply,deflexed,dense,densely,dia,dry,eaf,edicel,eed,elliptic,exserted,filament,flattened,flattened-reniform,fleshy,flower,free,fruiting,glabrous,glandular-resinous,globose,grayish-brow,green,greenish-tan,incrassate,inflorescenc,irregularly,junction,later,lateral,leaf,live,lobe,lobed,lon,long,lower,main,margin,material,midrib,minutely,mm,narrowly,nflorescence,occasionally,often,older,onto,opposite,ovary,pair,paler,papillae,papillo,papillose,pedicel,petiole,pitted,planar,plant,plurifoliat,pore,poricidal,portion,prominent,pubescent,red-papillose,revolute,rounded,rounded-triangular,ruit,scar,several,shaped,shrub,simple,somewhat,soon,spaced,specimen,stem,stigma,straight,style,surface,tall,tapering,tear-drop,terminal,thick,thickened,time,tip,trichome,tub,tube,ud,uniseriate,unit,vein,visible,way,white,woody,x,ympodial,young	
22	wfo-0001025893	exception_thrown	157	0	0	157	0	0.0		.25,.4,.5,0.5-1.5,0.8-1,1-1.2,1-1.5,1-2.5,1-4,1.5-1.7,1.5-2,11-20,2-2.5,2-3,3-5,5-6,6-10,accrescent,along,anther,anthesi,apex,attenuate,bank,barely,bark,base,bearing,beginning,beneath,berry,bi-lobed,blade,branched,broadly,brownish-green,calyx,capitate,closely,cm,corolla,cup-shaped,decurrent,deflexed,deltoid,densely,dia,difoliate,dry,eaf,early,eed,ellipsoid,elliptic,erect,even,exserted,faintly,filament,flower,free,fruit,fruiting,geminate,glabrate,glabrous,globose,golden-puberulent,gravelly,green,greyish,growing,impressed,inflorescenc,internodal,lateral,leaf,lobe,lobed,lon,long,long-acuminate,longitudinally,lower,main,many,margin,material,middle,minutely,mm,narrowly,nearly,nflorescence,obovate,occasionally,older,opposite,ovary,overlapping,ovoid-reniform,pair,pale,papillo,papillose,pedicel,petiole,pitted,planar,plurifoliat,pore,poricidal,portion,puberulent,red-papillose,reflexed,river,rocky,ruit,sandy,scar,shaped,shrub,slender,slightly,sometimes,spaced,specimen,stem,stigma,straight,stream,striat,style,surface,tall,tapering,tear-drop,thickened,time,tip,trichome,tube,ud,unicellular,unit,usually,vein,visible,white,widest,winged,woody,x,yellowish,ympodial,young	
23	wfo-0001025896	success	146	131	74	72	57	0.507	.5-2.5,0.5-2,1-8,2-14,2-2.5,4-23,4-6,5-7,7-,abaxial,acuminate,adaxially,also,apex,articulated,base,blade,branched,brownish,calyx,cell,chartaceous,cm,connivent,constricted,cuneate,dendritically,densely,directed,eglandular,elliptic-ovate,entire,forked,fruit,glabrous,gland,globose,hair,inflated,like,long,lower,margin,mm,moderately,nearly,occasionally,often,orange,ovate,pale,pedicel,petiole,pore,present,pubescent,purple,red,rotate-stellate,short-stalked,shrub,simple,stem,stone,subcordate,surface,time,tube,unbranched,unit,vein,white,wide,x	-3,-30,0.5,1-1.5,1-25,1-3,1-6.5,1.5-2,1.5-9,10-15,10-25,2.5-14,2.5-5,4,4-12,4-5,5-15,6-10,6-13,7743,abaxially,absen,acosta,acute,adaxiall,aggregate,angled,apart,axe,ba,cylindrical,deltate,diameter,distall,eaf,eed,especially,flower,greenish,lobe,many-foliat,membranaceous,near,nflorescence,nther,obtuse,orolla,peduncle,perfect,puberulent,pubescen,rachi,radiu,ripe,rugose,ruit,smooth,solÃ­,spaced,sparsely,stalked,stigma,style,tal,tem,tip,triangular-ovate,triangular-subulate,truncat,vary,yellow,ympodial	absent,anther,appressed,articulation,bract,branching,breeding,broad-based,colour,connective,corolla,distally,filament,form,fruiting,growth,heteromorphism,inflorescence,insertion,interjected,interpetalar,leaf,leaflet,length,many-foliate,marking,mature,modification,needle-like,null,odour,orientation,paired,pattern,placement,position,prickle,pseudostipule,rhizome,scale,shape,smell,spot,staman,structure,symmetry,sympodial,system,tall,texture,tissue,trichome,tuber,type,vegetative,xylopodia,zygomorphy
24	wfo-0001025902	exception_thrown	211	0	0	211	0	0.0		.2,.5,/2,0.1-0.5,0.5-2,0.5-2.5,1-1.2,1-1.5,1.2-1.5,1.5,1.5-2,1.5-3,1/3,11-15,1983,2-6,2.5-4,3-10,4,4-13,4-5,4-6,40,5-6,5-merou,8-10,8-15,8-9,>,abaxially,absent,accompanied,acute,adaxially,ag,aid,along,always,alyx,anther,anthesi,apar,apex,ark,articulated,attenuate,axi,bark,base,becoming,beginning,berr,berry,black,branch,branched,branching,broadly,c.,cabrera,calyx,cell,chartaceous,circular,clavate,climbin,cm,completely,conical,connivent,corolla,deciduou,deltate,densely,diameter,dull,eaf,eed,either,ellipsoid,entire,except,exfoliatin,exserted,fide,filament,flattened-reniform,fleshy,flower,free,fruiting,geminat,glabrous,globose,green,growth,ilament,inflorescence,lanceolate,lateral,leaf,leaf-opposed,leaving,length,lengthening,less,linear,lobe,lobed,long,loosely,low,lower,margin,markedly,mature,midvei,minute,minutely,mm,new,nflorescence,obscured,occasionally,often,older,one,orolla,ovary,pair,pale,papillat,papillose,pedicel,peduncle,peg,pendant,per,perfect,pericarp,petiole,pitted,planar,plurifoliate,pore,poricidal,portion,primary,prominent,pubescent,revolute,ridged,rotate-stellate,rounded,ruit,scar,scattered,scrambling,semi-aquati,semi-circular,shallow,simple,sleeve,slender,slit,small,sometimes,somewhat,soon,spaced,sparsely,spreading,stem,stigma,strongly,style,surface,tangled,tapering,tem,terminal,testal,thin,time,tip,trichome,tube,twining,ud,ultimate,uniseriate,unit,usually,vary,vegetation,vein,vine,violet,water,way,weak,weight,whitish,widely,wing,woody,x,yellow,yellowish,ympodial,Â½	
25	wfo-0001025906	success	188	112	58	130	54	0.309	0-14,0.1-2,1-2,4-7,5-7,anther,apex,axillary,base,berry,blue,bud,cell,cm,connivent,coriaceous,corolla,cuneate,distal,filament,forked,fruit,glabrous,globose,green,hair,half,herb,high,homostylous,interjected,lanceolate,leaf,leaflet,light,lilac,long,lower,mm,odd-pinnate,ovoid,pedicel,pentagonal,petiole,plurifoliate,pore,poricidal,purple,ripe,rotate,shiny,stripe,subglabrous,subtending,terminal,tip,tri-,unit	0.15-0.6,0.2-0.6,0.20-0.60,1-3,1-6,1.1-2,1.6-12.4,1.8-4.8,16-51,2-4.4,2-6,2.6-5.2,3-10,3-5,4-10,4-12,4-5,5-6,5-merou,5.2-9,8-16,8.5-12.5,abaxially,acumen,acute,adaxiall,adaxially,ag,alyx,apart,apparently,articulated,axe,blade,brownish,capitat,clavate,condition,covering,dark,decreasing,decurrency,decurrent,delimited,diameter,digestion,diminishing,dorsally,drying,eaf,edge,eed,enzyme,erec,exceeding,falcate,first,flat,flower,folded,fresh,geminat,generally,glabrou,green-white,greenish,hair-like,hal,honeycomb-shaped,lateral,lengthening,linear,living,lobe,make,mucilaginous,next,nflorescence,obtuse,orolla,pair,peduncle,perfect,plant,pubescent,rachi,removed,ruit,second,seed,sessile,seudostipule,short,size,slightly,slit,smaller,spaced,sparsely,specimen,stamen,stigma,straight,style,sub-glabrous,subequal,subglabrou,tall,tamen,tem,testal,thick,third,throughout,toward,tube,typically,unwinged,usually,vary,wall,well,wet,white,whitish,width,wood,x,yellow,ympodial	appressed,articulation,bract,branching,breeding,broad-based,calyx,colour,connective,form,fruiting,geminate,growth,heteromorphism,inflated,inflorescence,insertion,interpetalar,length,margin,marking,mature,modification,needle-like,odour,orientation,paired,pattern,placement,position,prickle,pseudostipule,rhizome,scale,shape,smell,spot,staman,stem,stone,structure,surface,symmetry,sympodial,system,texture,tissue,trichome,tuber,type,unstated,vegetative,xylopodia,zygomorphy
26	wfo-0001025907	exception_thrown	148	0	0	148	0	0.0		-4,.05,.5,.5-1,0,0-60,0.8-1.8,1,1-1.2,1-2.3,1-3,1-5,1.5-2,1.5-2.2,10-15,12-45,2,2-3.5,2-8,2/3,3-,3-4,3/2,4-5,5-15,absent,acuminate,acute,along,anther,anthesi,anthesis5-7,anticlinal,apex,appearing,attenuate,axil,axillary,base,beak,bearing,berry,breaking,brown,c,calyx,cell,clavat,cm,conical,conspicuously,deciduous,densely,diameter,eaf,edicel,eed,elliptic,epidermal,erec,filament,flattened,flower,free,fruit,fruiting,glabrous,globose,green,greenish,growth,highly,included,iquito,irregular,isolated,lamina,lobe,lobed,lon,long,lower,margin,minutely,mm,near,nearly,new,nflorescence,obovate,occasionally,open,ovary,ovoid-reniform,pair,papillate,papillose,pedicel,per,petiole,plant,population,poricidal,portion,primary,projection,pubescent,raised,red-papillate,reflexed,remaining,round,rugose,ruit,scar,scattered,seed,shrub,simple,single-stemmed,sinuous,size,slender,soon,sparsely,stigma,style,surface,tal,tem,thickening,time,tip,trichome,truncate,tub,tube,ud,unifoliat,uniseriate,unit,variable,vein,white,white-lenticellate,without,x,ympodial	
27	wfo-0001026203	success	197	70	18	179	52	0.091	anther,apex,base,cell,corolla,filament,fruit,hair,interjected,leaf,leaflet,lower,pedicel,petiole,pore,tissue,tuber,unit	0-39,0-7,0.06-0.86,0.3-11,0.3-6,0.38-11.3,0.4-3,0.5-2.3,0.5-3.2,0.7-2.6,1-13,1-2,1-4,1-5,1-9,1.1-7.9,1.2-5.5,2-10,2-4.9,2-43,2-5,2-8.5,2.2-13.3,3-10,3-11,3-5,3.2-22,3.2-23,5-merou,7-47,abaxially,acumen,acuminate,acute,adaxially,ag,along,alyx,apart,apparently,arranged,articulated,asymmetric,attenuate,axe,axillary,basiscopic,bead,berry,blade,blue,brownish,bud,capitat,clavate,cm,condition,connivent,coriaceous,covering,dark,decreasing,decurrent,deep,diameter,digestion,distal,dorsally,drying,eaf,edge,eed,elliptic,enzyme,erect,exceeding,flat,flower,folded,forked,fresh,geminat,generally,glabrescen,glabrescent,glabrou,glabrous,globose,green,green-white,greenish,hair-like,hal,half,herb,high,homostylous,honeycomb-shaped,lanceolate,lateral,lengthening,light,like,lilac,linear,living,lobe,long,make,medium,middle,mm,moniliform,mucilaginous,multiple,necklace,nflorescence,odd-pinnate,orbicular,orolla,ovate,ovoid,pair,peduncle,pentagonal,perfect,plant,plurifoliate,poricidal,rachi,removed,ripe,rosett,rotate,rounded,ruit,seed,sessile,seudostipule,short,side,size,slightly,slit,sometimes,spaced,specimen,stamen,stigma,stolon,straight,stripe,style,subequal,subglabrous,subtending,tall,tamen,tem,terminal,testal,thick,throughout,tip,toward,tri-,tube,typically,unwinged,usually,vary,wall,wet,white,whitish,wide,x,yellow,ympodial	appressed,articulation,bract,branching,breeding,broad-based,calyx,colour,connective,form,fruiting,growth,heteromorphism,inflated,inflorescence,insertion,interpetalar,length,margin,marking,mature,modification,needle-like,none,odour,orientation,paired,pattern,placement,position,prickle,pseudostipule,rhizome,scale,shape,smell,spot,staman,stellate,stem,stone,structure,surface,symmetry,sympodial,system,texture,trichome,type,vegetative,xylopodia,zygomorphy
28	wfo-0001026208	exception_thrown	214	0	0	214	0	0.0		-1/2,-10,-3,-5,.5,/3,0,0-20,0-4,0-5,0-8,0.1,0.1-0.2,0.1-0.25,0.1-0.3,0.5-0.8,0.5-1.2,0.6-0.8,0.6-0.9,0.7-2,0.8-1.3,0.8-1.5,1-2,1-4,1-5,1.5,1.5-2.5,1.8-2.3,1.8-2.5,1/3,1/4-1/3,1/4-1/6,11-25,2,2-20,2-3,2-4,2.5-5,2.5-6,3-30,3-5,3-6,3.5-5,3/,4-7,4-9,5,5-,5-17,5-22,5-merous,6-22,6-8,abaxial,abaxially,acuminate,acut,acute,adaxial,alyx,anther,apar,apart,apex,apically,apparently,articulated,bark,base,becoming,berry,blade,branched,bright,broad-deltate,brown,calyx,chartaceous,cm,conical,connivent,cuneate,curved,dark,deltate,densely,diameter,difoliate,discolorous,distance,drying,dull,eaf,eed,elliptic,elongated,elongating,equal,erect,evenly,extending,filament,flattened,flattened-reniform,flower,free,fruit,fruiting,geminat,geminate,glabrescent,glabrous,gray-greenish,green,green-brown,infructescence,lateral,leaf,length,lobe,lobed,long,longer,lower,margin,mature,maturity,mauve,membranous,midpoint,midvein,mm,moderately,nflorescence,older,one,open,orange,orange-brown,orolla,oung,ovate,pair,pale,pedicel,peduncle,pendulous,per,perfec,pericarp,petiole,poricidal,porrect,portion,prickle,prickly,primary,pubescent,ray,recurved,red,red-brow,rounded,ruit,scar,sessile,shorter,shrub,side,slender,smooth,sometimes,somewhat,spaced,sparsely,spherical,spreading,stalk,stalked,stellate,stellate-pubescent,stem,stout,straight,straw-yellow,style,subentire,surface,tamen,tapering,terete,terminal,tertiary,time,tip,toward,trichome,tube,unarme,unarmed,unit,usually,variously,vary,vein,venation,visible,way,white,wide,woody,yellow,ympodial,young	
29	wfo-0001026215	success	150	158	102	48	56	0.68	-3,.5,0,0.05,1-3,1.5,1.5-2,13-35,18-20,2,2-4,3/4,4-15,7-8,abruptly,absent,acuminate,anther,anthesi,anticlinal,apex,axil,axillary,base,beak,berry,calyx,cell,cm,completely,conical,conspicuously,continually,corolla,diameter,elliptic,epidermal,filament,flower,free,fruit,fruiting,glabrous,green,herb,highly,horizontal,internode,irregular,kink,length,less,lobe,lobed,long,lower,marked,minutely,mm,narrowing,nearly,nodding,occasionally,often,onto,pair,papillate,pedicel,per,petiole,poricidal,portion,primary,projection,purple,raised,reflexed,rugose,scar,shrub,simple,single-stemmed,sinuous,small,stem,strongly,surface,thickening,time,tip,tube,unit,usually,vein,way,white,white-lenticellate,wide,wing,winged,without,x	.05,0.5-1,1,1.5-2.2,15-2,2-3,2-3.5,4-5,abaxially,along,ape,bifi,broadly,brown,clavate,deltate,densely,eaf,edicel,eed,enlarged,entire,erect,exserted,flattened-round,globose,greenish,markedly,nflorescence,noddin,ovary,ovoid-reniform,papillae,papillat,red-papillose,rounded,ruit,seed,shortsympodial,ste,stigma,style,tal,tem,tub,ud,unifoliat,white-pubescent	appressed,articulation,bract,branching,breeding,broad-based,colour,connective,form,growth,hair,heteromorphism,inflated,inflorescence,insertion,interjected,interpetalar,leaf,leaflet,margin,marking,mature,modification,needle-like,null,odour,orientation,paired,pattern,placement,pore,position,prickle,pseudostipule,rhizome,scale,shape,short,smell,spot,staman,stone,structure,symmetry,sympodial,system,tall,texture,tissue,trichome,tuber,type,unifoliate,vegetative,xylopodia,zygomorphy
30	wfo-0001026229	success	299	173	122	177	51	0.408	0.2â0.8,0.3â1.2,1,1-celled,1/3,2â3-celled,4â6,5,abaxial,accrescent,anther,apex,asymmetric,base,berry,black,branch,branching,broken,brown,calyx,central,changing,completely,connivent,corolla,covered,creating,cuneate,cyme,dark,densely,differing,directed,diÂ­,drying,elliptic,elongated,entire,few-rayed,fruit,geminate,glabrescent,glabrous,globose,green,growth,hair,hirsute,hispid,immature,inflorescence,insertion,internodal,introrsely,larger,lateral,leaf,long,longer,longitudinal,lower,mainly,margin,mature,membranaceous,mm,moderately,multangulate,multiseriate,oblong,often,old,one,open,opening,orientation,paired,pale,pedicel,perfect,petiole,plurifoliate,point,pore,poricidal,porrect-stellate,pubescent,purple,rarely,ray,remnant,revolute,rounded,shiny,shrub,simple,size,slightly,slit,small,smaller,solitary,sometimes,spread,stalk,stellate,stem,subopposite,surface,terminal,tree,trichome,trifoliate,type,unbranched,unequal,unit,usually,vestiture,white,yellowish-white	0.1â1.47,0.35,0.3â0.9,0.4,0.8â1.2,0.8â2,0.9,0.9â4.3,1.2â4.8,1.3â1.5,1.3â1.7,1.4,1.7â11.8,1.7â2.3,1.8,1.8â5.5,1.9â2.5,13,1â1.4,1â2,1â4,2,2.3â3.4,2.8â4,2â3,2â4-celled,3,35,3â4,3â5,4.5â6.5,5-merou,5â9,6â15,6â7,6â8,8.6â12,8â10,9â31,abaxially,acuminate,acute,adaxial,adaxiall,adaxially,ag,almost,also,always,alyx,anthesi,ark,articulated,associated,attenuate-caudate,axe,ba,barely,beneath,blade,broadly,camptodromous,capitate,celled,clavate,cm,commentary,commonly,concentrated,cordate,cylindrical,deltoid,develope,developed,diameter,discolorous,dried,eaf,eed,eglandular,ellipsoidal,even,faces,flattened,flower,found,free,frequently,fresh,fully,gland,glandular,glandular-capitate,golden,head,hyaline,ilament,impressed,included,involute,irregular,lamina,lanceolate,less,like,lobe,lobed,long-stalked,material,maturit,midpoint,midri,midvein,minute,mixed,much,multangulate-stellate,narrow-ovate,narrowly,near,nearly,new,nflorescence,older,orolla,other,oung,ovate,ovate-elliptic,pair,papillose,peduncle,pedunculate,per,pink,pit,poorly,portion,primary,purplish,ra,rachi,raised,reniform,ruit,secondary,see,sessile,shin,short-,short-stalked,shorter,somewhat,sparsely,spreadin,spreading,stigma,strongly,style,subsessile,supported,surfac,three,tube,tuft,ud,upper,vary,vein,venation,visible,weakly,whitish-green,wide,yellow,ympodial,Â¾	1.8-5.5,2.8-4,5-merous,actinomorphic,age,appressed,articulation,bract,breeding,broad-based,cell,colour,connective,filament,form,fruiting,heteromorphism,inflated,interjected,interpetalar,leaflet,length,marking,maturity,midrib,modification,needle-like,none,odour,pattern,placement,position,prickle,pseudostipule,rhizome,scale,shape,smell,spot,staman,stone,structure,symmetry,sympodial,system,texture,tissue,tuber,vegetative,xylopodia,zygomorphy
31	wfo-0001026230	exception_thrown	144	0	0	144	0	0.0		.25,.5,.8,0.3-1.5,0.5-3,0.75-1,0.9-2,1-1.4,1-1.5,1-4,1.1-1.8,1.8-2.3,1.9-4.1,12.6-20.8,2-4,2-5,3-4,4.6-9.3,5-10,5-20-flowered,acuminate,acute,anisomorphic,anisophyllou,anther,anthesi,apart,apex,apiculate,appears,area,back,bark,base,beginning,beneath,berry,broadly,bud,calyx,clavate,clu,cm,completely,cordate,coroll,corolla,deflexed,deltoid,dia,difoliate,distal,eaf,edicel,eed,elliptic,enclosing,erect,evenly,except,filament,free,fruit,fruiting,geminate,glabrous,globose,green,grey,immature,inflorescenc,large,lateral,leaf,lobe,lobed,lon,long,long-acuminate,long-triangular,lower,main,major,margin,middle,minor,minutely,mm,nearly,nflorescence,obtuse,older,opposite,orbicular,ovary,ovoid,pair,papillose,pedicel,petiole,pointed,pore,poricidal,portion,raised,reflexed,rounded,ruit,rusty-papillose,scar,shaped,shrub,simple,sinus,slender,slightly,small,spaced,stem,stigma,straight,strongly,style,surface,tall,tapering,tear-drop,thickened,tip,tree,tube,ud,umbonate,unit,unknown,vein,white,white-lenticellat,widest,winged,woody,x,ympodial,young	
32	wfo-0001026233	success	165	168	109	56	59	0.661	-1.9,-5.5,-50,.25,0.3,0.5,0.8-1.55,0.8-4,1-,1.2-2.7,1/2,2,2-,2.3-7,2/3,3.2-3.7,3.2-4.7,3.5-4.5,5-30,6,accrescent,annual,anther,antrorse,apex,articulated,basal,base,bearing,berry,calyx,campanulate,capitate,cm,conspicuous,cuneate-attenuate,curved,cylindrical,densely,diameter,dimorphic,ellipsoidal,elliptic,entire,evident,few-,filament,fruiting,glabrous,globose,hair,herb,interlobular,investing,lamina,larger,leaf,less,lilac,lobe,lobed,longitudinal,lower,margin,membrane,minutely,mm,moderately,near,non-glandular,occasionally,opening,other,ovate,ovule,pale,papery-scarious,partially,petiole,pinnatipartite,pinnatisect,pore,poricidal,present,protuberance,pubescent,reticulate,rounded,scarcely,serrate,simple,slit,small,smaller,sparsely,stigma,striate,strongly,style,subglobose,surface,tip,trichome,unifoliate,uniseriate,unit,wider,x,yellow	-1,-3.8,-8.1,.75,0.7-,0.7-0.8,0.8-1.3,1,1.1,1.5,2.1,2.4-3.5,2.6,4-,5-6.2,abundant,acute,ag,annular,ascending,broadly,coat,difoliat,eaf,eed,embryo,herbaceous,hig,long,longitudinally,multicellular,narrowly,obtuse,orolla,outer,portion,pubescen,ree,ridged,ruit,seed,seede,shorter,slender,slightly,styl,tem,trans-ovoidal,tube,tuberculate,unequal,vary,venatio,verrucose,winged,ympodial	age,appressed,articulation,bract,branching,breeding,broad-based,cell,colour,connective,corolla,difoliate,form,fruit,growth,heteromorphism,high,inflated,inflorescence,insertion,interjected,interpetalar,leaflet,length,marking,mature,mentioned,modification,needle-like,odour,orientation,ovary,paired,pattern,pedicel,placement,position,prickle,pseudostipule,rhizome,scale,seeded,shape,smell,spot,staman,stem,stone,symmetry,sympodial,system,texture,tissue,tuber,type,vegetative,venation,xylopodia,zygomorphy
33	wfo-0001026241	exception_thrown	220	0	0	220	0	0.0		.2,.3,.5,0.1â0.15,0.2â,0.3â,0.3â0.4,0.3â0.6,0.3â1,0.5,0.5â0.7,0.5â0.8,0.5â1,0.7â1.1,1-,1-celled,1.2â1.5,1.2â2,1.5â1.7,1.5â2.5,1.5â3.5,1.9â2.1,1/3â1/2,10-20,109,1â,1â1.1,1â1.4,1â1.5,1â2,2-flowered,2.5â3,2â2.1,2â3,3,3-,30â50,3â3.1,4-,4.5â5,5,5-celled,5-merous,6,abaxially,adaxially,always,anther,anthesi,apex,apical,appearing,appears,articulated,attenuate,ba,basal,base,basiscopically,beak,berry,black,branching,brittle,broader,brown,calyx,campanulate,capitate,cell,center,cm,conical,connecting,cordate,corolla,covered,cup,curved,curving,darker,decurrent,deflexe,dehiscing,deltate,densely,denser,depressed-globose,dia,difoliate,discrete,dry,drying,dwarf,eaf,eglandular,elliptic,enclosed,entire,equal,erect,erose,et,extended,filament,flower,foliat,foliose,free,fruit,fruiting,galiano,geminate,glabrous,gland,glandular,glandular-pubescent,globose,herb,inflorescence,internodal,intially,irregularly,larger,lateral,leaf,leaflet,like,lobe,lobed,lon,long,longitudinal,main,margin,midvein,mixture,mm,much,near,nflorescence,oblique,one,onto,open,orangish,outline,ovary,ovate,ovoid,papillat,papillate,pedicel,peduncle,per,perennial,perfect,pericarp,petiole,pinnatifid,pitted,pore,portion,prolonged,pubescen,pubescent,pulp,rachi,remain,reniform,robust,ruit,seed,shallowly,shiny,simple,sinuate,slightly,slit,small,smaller,sometimes,somewhat,spatulate,stamen,stellate,stem,stigma,stout,strongly,style,subshrub,succulent,sulcate,surface,taproot,terminal,ternate,testa,thick,thickened,tip,tissue,triangular,trichome,truncate,tube,tuberculate,ud,uniseriate,unit,usually,vein,way,white,wide,wing,woody,x,ympodial	
34	wfo-0001026242	exception_thrown	210	0	0	210	0	0.0		-0.9,-1.5,-2,-5,-6,/4,0,0-2,0.05-0.2,0.1,0.3-0.5,0.35-,0.4-0.5,0.4-0.55,0.4-2,0.5,0.5-0.7,0.5-1,0.55-0.9,0.7,0.7-1.3,1-1.5,1-2.5,1-3,1.2-2,1.5-3,1.5-4,1/2,1/5-1/3,1/6-1/4,10-,10-20,2-2.5,2-5,2.5-2.8,2.5-4.5,3-6.5,30-80,4-10,4-13,4-5-merous,4.5-5.5,5-,5-18,5-7,6.5-8,7-17,8-20,abaxial,abaxially,acut,acute,almost,alyx,ame,anther,apar,apart,apex,apically,apparently,articulated,bark,base,berry,blade,branched,bright,broad-deltate,c.,calyx,cm,concolorous,connivent,cuneate,curved,deltate,densely,diameter,difoliate,distance,drying,dull,eaf,eed,elliptic,elongating,equal,erect,evenly,extending,eye,filament,filiform,flattened,flattened-reniform,flower,free,fruit,fruiting,geminat,glabrescent,glabrou,glabrous,glandular,green,green-gra,hair,infructescence,irregularly,largely,lateral,leaf,length,lobe,lobed,long,longer,lower,margin,mature,maturity,membranous,midpoint,midvein,minute,mm,moderately,multangulate,naked,narrow-deltate,nflorescence,obtuse,occasionally,older,one,open,orange-brown,orolla,oung,pair,pale,pale-brown,pedicel,peduncle,per,perfec,pericarp,petiole,poricidal,porrect,portion,prickl,prickle,prickly,primary,ray,recurved,red,red-brown,reflexed,rounded,ruit,scar,sessile,shorte,shorter,shrub,side,simple,smooth,sometimes,spaced,sparsely,spherical,spreading,stalk,stalked,stellate,stellate-pubescent,stem,straight,style,subentire,surface,tamen,tapering,terete,tertiary,time,tip,trichome,tube,unarme,unarmed,unit,upper,variously,vary,vein,venation,visible,way,weakly,white,wide,woody,yellow,ympodial,young	
35	wfo-0001026259	exception_thrown	233	0	0	233	0	0.0		.1,.7,.8,0.1â0.2,0.2â0.4,0.3â1.2,0.4â0.6,0.5,0.5â0.6,0.7â0.9,0404,0â2,1,1-celled,1.0â1.2,1.0â3.3,1.2â8.4,1.4â4.0,1.5,1.5â2.0,11â22,12â24,1m,1â2,1â2-celled,1â3-celled,2-ridged,2/3,2â17,2â3-celled,3.0â3.4,35â45,4â5,5-merous,5â14,5â7-celled,6,7â10,8â11,?,abaxial,abaxially,acuminate,acute,adaxial,adaxially,affected,age,anther,anthesi,apar,apex,appressed,arising,base,becoming,berry,beyond,branch,branched,branching,broadly,brown,calyx,cell,central,close,cm,coloured,concave-reniform,cone,congested,conical-ellipsoid,corolla,cream-coloured,cylindrical,decurrent,dehiscing,deltate,densely,diameter,difoliate,drop,eaf,eed,ellipsoid,elongating,end,entire,especially,et,exerted,filament,fleshy,flower,free,fruit,fruiting,geminat,glabrous,globose,gradually,green,green-orange,growt,halfway,herb,hilum,individual,inflorescence,internodal,knapp,larger,lateral,leaf,leave,length,lengthening,less,like,lilac,live,lobe,lobed,lon,long,longer,lower,lowermost,margin,membranous,minutely,mm,much,narrower,narrowly,near,nearly,nflorescence,node,occasionally,often,once-branched,one,outline,ovary,ovate-lanceolate,pair,pale,papillate,pathogen,pedicel,peduncle,pentagonal,per,perfect,pericarp,petiole,plant,pore,poricidal,portion,positioned,primary,pubescent,purple,purple-black,purple-coloured,rachi,rarely,recurving,reduced,reflexed,relatively,remaining,ripe,rounded,ruit,scar,shiny,short,shorter,shrub,similar,simple,slightly,slit,smooth,sometimes,somewhat,spaced,sparsely,splitting,spreading,star,stellate,stem,stigma,stone,stout,straight,strongly,style,sub-laterally,surface,tall,tapering,tem,testal,thick,tightly,tinged,tip,together,toward,translucent,trichome,tube,turning,two,ud,uniseriate,unit,vein,white,wide,winged,woody,yellow,yellow-green,ympodial,young,â15	
36	wfo-0001026267	exception_thrown	162	0	0	162	0	0.0		.25,.5,0.1-1,0.5-1,0.6-1.7,0.7-1.1,1-1.2,1-1.5,1-2.6,1-4,1.5-2,1.5-2.3,2.5-3,20-30-flowered,3-15,3-6.1,3.2-8.6,4-8,5-7,8-10,8.5-15,acuminate,acute,anther,anthesi,apex,attenuate,axil,ba,bark,base,beginning,beneath,berry,blackish,body,bright,broadly,calyx,closely,cm,corolla,crateriform,cuneate,decurrent,deflexed,densely,depressed,dia,differing,difoliate,distally,distinct,drying,eaf,edicel,eed,except,exerted,filament,flattened-reniform,free,fruiting,geminat,glabrous,globose,green,greenish-white,greyish-green,hard,incrassate,inflorescenc,larger,lateral,lavender,leaf,lobe,lobed,lon,long,longinflorescence,lower,main,major,margin,maturity,middle,minor,minutely,mm,narrowly,nearly,occasionally,often,older,one,opposite,ovary,ovate,overlapping,pair,pale,papillo,papillose,pedicel,petiole,pitted,pitting,pore,poricidal,portion,pubescent,quickly,raised,reflexed,remaining,ripening,rough,ruit,scar,scarious,scattered,shaped,shrub,simple,size,slender,slightly,small,softening,soon,spaced,sparsely,stem,stigma,straight,style,surface,tall,tan,tapering,tear-drop,tinge,tip,tree,triangular,trichome,tube,tuft,ud,uniseriate,unit,vein,white,widest,wing,winged,woody,x,yellow-green,ympodial,young	
37	wfo-0001026279	exception_thrown	248	0	0	248	0	0.0		-11.4,-2.9,-34.3,-4,-5.9,/14-1/8,0.2-0.4,0.25-0.4,0.8-2.3,0.9-1,0.9-1.8,1-1.4,1-10,1-3.5,1.1-1.6,1.1-1.9,1.5-1.8,1.5-3,1.7-2.3,1.9-3,1.9-3.2,1/2,11.5-19.7,14-27,2.4-3.2,2.5-3.2,2.6-4.8,2/3,3-4,3.1-3.6,3.1-4.2,3.4-5.2,3.5-7.8,3.8-5.1,4-7.5,5-200,5-8,8,8-11,8.5-10.5,9-22,abaxially,accrescent,acuminate,acute,adaxiall,adaxially,ag,anther,anthesi,apart,apex,apparently,appearing,appressed,ark,around,articulated,attenuate,axe,axillary,ba,base,berry,black,blade,blunt-tipped,branch,branched,brown,bud,calyx,capitate,chartaceous,closely,cm,completely,conical,corolla,covering,cuneate,cylindrical,dark,deltoid,dendritic-echinoi,dendritic-echinoid,dense,diameter,directed,distally,drying,due,eaf,earl,echinoi,echinoid,edge,eed,elliptic,elongated,entire,enveloping,equal,evident,exerted,expanded,farinose,few-rayed,filament,fleshy,flower,free,fruit,fruiting,glabrescen,glabrescent,glabrous,globose,granular,grayish,grayish-green,green,hair,half,immature,inserted,lanceolate,lateral,lavender,leaf,length,lengthening,lilac,lobe,lobed,long,long-stalked,longer,longitudinal,longitudinall,lower,m.,main,many,margin,mature,midrib,minute,mixed,mm,multangulate,multangulate-pubescent,multiseriate,narrowly,nflorescence,oblong,obovate,occasional,occasionally,often,older,open,orbicular,orolla,ovate-lanceolate,overlapping,pale,partly,pedicel,peduncle,perfect,petiole,plant,plurifoliate,pore,poricidal,porrect-stellate,present,prominent,pseudo-terminal,pubescence,rachi,reticulate-punctate,rounded,ruit,scabridulous,scabrous,scattered,secondary,semi-ovate,sessile,short,short-,short-decurrent,short-stalked,shrub,side,simple,slightly,slit,slowly,somewhat,spaced,splitting,stalk,stamen,stellate,stem,stigma,style,subcampanulate,subcoriaceous,suborbicular,subsessile,sulcate,surface,suture,tall,tamen,tertiary,thickened,thin,thin-stalked,time,tip,tomentose,tomentose-pubescent,tree,tube,ud,unarme,unarmed,unit,unwinged,upper,usually,vary,vein,way,white,whitish,wide,x,yellow,yellowish,yellowish-tan,ympodial,young	
38	wfo-0001026299	success	239	144	94	145	50	0.393	--,-10,-3.5,0.25-0.5,0.4-0.5,0.5-1,0.5-2.5,1,1-celled,2-foliate,2.5-7,25,3-,5-15,acute,almost,anther,apex,base,basiscopically,bract,bracteate,calyx,cell,chota,cm,corolla,crenate-serrate,dark,decurrent,densely,developed,distal,ebracteate,entire,erect,filament,fruit,fruiting,glabrous,glandular,globose,green,half,head,herb,imparipinnate,inflorescence,interjected,interrupted,investing,irregularly,jequetepeque,leaf,leaflet,lobed,long,loosely,lower,margin,middle,mm,multicellular,nearly,node,oblique,often,pedicel,pentagonal,perennial,petiole,population,present,prostrate,pseudostipule,pubescent,regularly,short,simple,sparse,spreading,stem,stripe,surface,trichome,truncate,unicellular,uniseriate,unit,valley,weak-walled,wide,woody,yellow	-0.8,-1,-2.5,-5,.5,0-8,0.1-0.2,0.1-0.25,0.1-0.4,0.1-0.5,0.15-0.2,0.2-0.25,0.2-1,0.3-0.4,0.4-2,0.5,0.5-0.6,0.5-0.7,0.6-2,0.7-3.5,0.8-0.9,0.8-1,0.9-1,1-1.4,1.1-1.7,1.2-1.6,1.2-5,1.5-,1.5-2.3,1.8-2,2-4,2-6,2-locular,2.2-3.2,2.5,3.5-10,5,5-20,6-20,7-12,abaxially,absent,abundant,acroscopically,adaxially,along,angled,anthesi,apical,appearance,appendage,approximately,articulated,axi,basal,beneath,berr,broadly,brown,capitate,change,column,conical,could,crenat,diamete,diameter,eaf,edicel,eed,eglandular,elliptic,exserted,flower,give,gree,hair-like,hal,intermixed,internode,lacking,lanceolate,larger,lateral,less,like,lobe,lon,long-acuminate,longer,maraÃ±Ã³n,maturity,minute,minutely,mixture,narrowly,nflorescence,obovate,occasionally,outgrowth,ovary,pair,pale,patent,peduncle,petiolule,primary,pubescence,purple,rachi,reflexed,rest,ruit,scarcely,scattered,secondary,sessile,silky,size,sparsely,staminal,sterile,stigma,stout,straight,style,tall,tem,terminal,tertiary,testa,thick,tip,toward,tube,ud,usually,variously,vein,velvety,wall,way,white,winged,ympodial	actinomorphic,appressed,articulation,berry,branching,breeding,broad-based,colour,connective,crenate,form,growth,hair,heteromorphism,inflated,insertion,interpetalar,length,marking,mature,mentioned,modification,needle-like,odour,orientation,paired,pattern,placement,pore,position,prickle,rhizome,scale,shape,smell,spot,staman,stellate,stone,structure,symmetry,sympodial,system,texture,tissue,tuber,type,vegetative,xylopodia,zygomorphy
39	wfo-0001026305	exception_thrown	135	0	0	135	0	0.0		.25,/4,0.2-1,0.25-0.5,0.5-2,0.6-1,0.7-1,1-1.5,1.3-1.5,2-2.5,2-6-flowered,2.5-3,3-8.5,4-4.5,5-7,6-9,7-16,7-9,abaxial,abaxially,acute,adaxially,along,anther,anthesi,apex,apical,area,attenuate,ba,bark,base,beige-tan,berry,calyx,closely,cm,congested,conical,corolla,dark,deflexed,deltate,dendritic,densely,dia,difoliate,drying,eaf,edicel,eed,elliptic,exserted,filament,free,fruiting,geminat,glabrate,glabrous,globose,green,greenish-white,interlocking,knob-like,lamina,lateral,leaf,leaf-opposed,like,lobe,lobed,lon,long,lower,main,margin,middle,midrib,minute,minutely,mm,nflorescence,occasionally,older,ovary,overlappin,ovoid-reniform,pair,pale,papillose,pedicel,petiole,pitted,planar,pore,poricidal,portion,projection,pubescent,reddish-brow,rounded,ruit,scar,scattered,shaped,shining,shrub,simple,slender,spaced,sparsely,stem,stigma,strongly,styl,style,surface,tall,tan,tear-drop,tip,trichome,tub,tube,ud,unifoliate,unit,vein,visible,way,widest,woody,x,ympodial,young	
40	wfo-0001026307	exception_thrown	193	0	0	193	0	0.0		.0â1.2,.3,.5,.5â4.0,.6,.8,0.2â0.5,0.2â1.5,0.4,0.5â0.6,0.5â0.7,0.5â5.0,0.6,0.8â0.9,0.8â2,0.8â5,1.0â1.2,1.0â1.5,1.0â2.0,1.0â2.4,1.0â2.5,1â3-celled,1â6-celled,2.0,2.0â3.0,2.0â3.5,2.6â13,2/3,3.0â4.0,3.5â7.0,35â45,3â8,3â8-celled,4â5.7,5-merous,5â7,8â12,9,abaxial,abaxially,acute,acute-acuminate,adaxial,adaxially,age,angled,anther,anthesi,apar,apex,appressed,articulated,base,becoming,berry,beyond,black,broadly,calyx,cell,central,clavate,cm,cone,corolla,cuneate,cylindrical,decurrent,densely,diameter,difoliate,eaf,eed,ellipsoid,end,entire,exerted,eye,facing,filament,flattened-reniform,flower,free,fruit,fruiting,geminat,glabrous,glandular,globose,gradually,green,growth,herb,hilum,internodal,later,lateral,length,lengthening,like,lobe,lobed,long,longer,lower,margin,membranous,middle,minutely,mm,narrower,narrowing,new,nflorescence,one,outline,ovary,ovate,pair,paler,papillat,pedicel,peduncle,pentagonal,per,perfect,petiole,pore,poricidal,portion,positioned,primary,pubescent,purple,purple-yellow,recurved,reflexe,reflexed,restricted,ripe,ruit,scar,shallow,shallowly,shape,shorter,shrub,side,simple,slightly,slit,spaced,sparsely,spreading,ste,stellate,stem,stigma,stone,straight,strongly,style,sub-laterally,surface,tal,tem,testal,three,tinged,tip,toward,translucent,triangular,trichome,tube,turning,two,ud,undulate,unequal,unevenly,uniseriate,unit,upper,variable,vein,vigorous,weak-stemmed,white,wide,yellow,yellow-green,ympodial	
41	wfo-0001026317	success	169	78	26	143	52	0.154	?,anther,apex,base,bright,calyx,clonal,corolla,filament,fruiting,globose,growth,inflorescence,lower,margin,orange,pedicel,petiole,pore,shrub,stem,surface,trichome,unit,white,yellowish	.5,/4,0.25-1,0.3-1.2,0.5,0.5-0.6,0.5-0.8,0.5-1,0.6-,0.7-0.9,0.8-1,1-1.2,1-1.5,1-5.7,10-12,2-,2-2.5,2-4,2.5-10,3,3-3.5,3-foliate,3.5-15,4-5,50-200,6-8,6x,abaxially,absent,acuminate,acute,adaxially,age,anthesi,apart,apically,approximately,attenuate,bark,berry,branched,brown,capitate,closely,cm,conical,correlated,dark,deltate,dendritic,dense,densely,diameter,distally,drying,eaf,eed,elliptic,em,entire,erec,erect,essentially,exerted,extremely,flattened,flower,found,free,geminat,glabrous,halfwa,internodal,lamina,lengthening,less,like,lobe,lobed,longer,many,maturity,minutely,mm,narrowly,new,nflorescence,nodding,occasionally,often,ovary,packed,pair,pale,papillat,papillate,peduncle,per,perfect,pericarp,pitted,planar,plane,plant,population,poricidal,portion,primary,pubescen,pubescence,pubescent,pulp,rachi,red,reflexed,reniform,ruit,scar,shiny,simple,slightly,slit,sparsely,sticky,stigma,straight,style,swollen,terminal,thin,time,tip,toward,triangular,tube,ud,uniseriate,variable,vein,way,woody,x,ympodial	appressed,articulation,bract,branching,breeding,broad-based,cell,colour,connective,form,fruit,hair,heteromorphism,inflated,insertion,interjected,interpetalar,leaf,leaflet,length,marking,mature,modification,needle-like,none,odour,orientation,paired,pattern,placement,position,prickle,pseudostipule,rhizome,scale,shape,smell,spot,staman,stellate,stone,structure,symmetry,sympodial,system,texture,tissue,tuber,type,vegetative,xylopodia,zygomorphy
42	wfo-0001026335	success	157	145	93	64	52	0.592	.5,.5-3.5,0.1-0.3,0.5-1,0.8-1.3,1-1.5,1-2,1-3,1.5-4,2,2-3,2-7.5,3-18,5-,5-7,7-8,abaxially,accrescent,acuminate,anther,apex,articulated,base,blade,branched,calyx,chartaceous,cm,covering,cuneate,densely,directed,distally,eaf,elliptic,elliptic-ovate,entire,filament,forked,fruit,fruiting,geminate,glandula,glandular,globose,green,hair,large,leaf,leaf-opposed,lobe,long,longitudinal,lower,many-foliate,margin,midpoint,mm,moderately,much,multangulate,oblong,often,opening,paired,pedicel,petiole,pore,probably,pubescent,ray,ripe,rounded,sessile,shrub,simple,slightly,slit,smaller,sometimes,stellate,stem,subtending,surface,time,unit,unripe,usually,white,whitish,wide,x,yellowish	0.25-0.5,0.6-1,1,1-4,1.5-2,10-20,10-30,2-4,3-5,4-5,5-15,acute,adaxiall,adaxially,ag,apart,apparently,axe,ba,capitat,connivent,curved,cylindrical,deltate,dense,diameter,eed,equal,erect,especially,flattened,flower,frui,glabrescent,glabrous,held,lanceolate,like,nflorescence,orolla,peduncle,perfect,pubescence,rachi,reticulate,ruit,scattered,spaced,ste,stellate-pubescent,stigma,straight,style,tal,tamen,tem,tip,toward,tube,uprigh,vary,vein,yellow,ympodial	age,appressed,articulation,bract,branching,breeding,broad-based,cell,colour,connective,corolla,form,growth,heteromorphism,inflated,inflorescence,insertion,interjected,interpetalar,leaflet,length,marking,mature,modification,needle-like,null,odour,orientation,pattern,placement,position,prickle,pseudostipule,rhizome,scale,shape,smell,spot,staman,stone,symmetry,sympodial,system,tall,texture,tissue,trichome,tuber,type,vegetative,xylopodia,zygomorphy
43	wfo-0001026343	exception_thrown	221	0	0	221	0	0.0		-1,-1.5,-15,-3.5,-4,-7,.5,/2,/5,0,0-10,0-2,0-4,0-40,0-5,0.05-0.2,0.05-0.5,0.1-0.2,0.15,0.2,0.2-0.3,0.2-0.7,0.3,0.45-1,0.5,0.5-1.5,0.8-1.5,1-2,1-3,1-4,1.3-1.7,1.5-2,1.5-2.5,1.8-2.2,1.8-3,1/,1/3,1/4-2/3,1/5,10-30,2-3,2-3.2,2-4,2-5,2-6,2-8,2.2-3.2,2.5-8,3-4,3-5,3.5-4.5,5-10,5-merous,5.5-9,6-9,7-12,7-14,7-8,7-9,abaxial,abaxially,acuminat,acute,adaxial,alyx,andromonoecious,anther,apar,apart,apex,apically,apparently,articulated,bark,base,berry,blade,branched,broadly,brow,calyx,chartaceous,cm,concolorous,connivent,cream,cuneate,curved,dark,deltate,densely,diameter,distal,distance,drying,dull,eed,elliptic,elongating,equal,erect,extending,faint,filament,flattened,flattened-reniform,flower,free,fruit,fruiting,glabrescent,glabrous,green,green-brown,hermaphrodite,heterostylous,infructescence,lateral,leaf,length,less,lobe,lobed,lobing,lon,long,long-styled,longer,lower,lowermost,margin,marking,mature,maturity,mauve,midpoint,midvein,mm,moderately,multangulate,narrow-deltate,nflorescence,obtuse,older,one,open,orange,orange-brown,orolla,oung,ovate,pair,pale,pedicel,peduncle,pendulous,per,pericarp,petiole,plant,plurifoliat,poricidal,porrect,portion,prickl,prickle,prickly,primary,purple,ray,reddish,reduced,reflexed,rounded,ruit,scar,secondary,sessile,short-styled,shrub,side,small,smooth,sometimes,spaced,sparsely,spherical,spreading,stalk,stalked,staminat,stellate,stellate-pubescent,stem,stout,style,surface,tamen,tapering,terete,tertiary,time,tip,tree,trichome,tube,unarmed,unit,upper,variously,vary,vein,venation,visible,way,weakly,wide,woody,yellow,ympodial,young	
44	wfo-0001026352	exception_thrown	209	0	0	209	0	0.0		.3,.5,0.5,0.5-0.8,0.5-1,0.5-1.5,0.5-3,0.6-,0.7-2,0.9-1,1-,1-1.5,1-10,1-2-celled,1.2-1.7,1.5,1.5-2,1.5-4.6,10+,12-60,2,2-3-celled,3-15,3.5-9,4-4.5,5-6,5-merou,6-7,7-9,<,?,abaxially,acuminate,acute,adaxiall,ag,almost,alyx,angle,anther,anthesi,antrorsely,apart,apex,apparently,appearance,arising,articulated,articulation,axi,bark,basal,base,bending,berry,blue,branch,branching,broadly,brown,calyx,capitate-truncate,cell,chartaceous,cm,conical,cordate,corolla,curved,deciduous,deltate,densely,denser,diameter,discolorous,eaf,eed,ellipsoid,entire,evenly,eventually,expanded,exserted,few-celled,filament,flattened,flower,free,fruiting,giving,glabrous,globose,green,greenish,growth,half,heigh,herbarium,ilament,immature,impressed,inflorescenc,inflorescence,irregularly,junction,lamina,large,largest,leafy,leave,leaving,length,lengthening,like,lobe,lobed,long,lower,many,margin,mature,membranous,minutely,mm,narrowly,near,nearly,new,nflorescence,older,orolla,outline,ovate,pair,pale,papillate,papillo,pedicel,peduncle,peg,per,perfect,pericarp,petiole,pink,plurifoliat,point,pore,poricidal,portion,primary,principal,pubescent,rachi,reflexed,reniform,rest,revolute,right,ruit,scar,seen,shallowly,shiny,shoot,short,simple,sleeve,slit,small,spaced,sparser,specimen,spreadin,spreading,stellate,stem,stigma,straw-colored,strongly,style,surface,tem,terminal,thin,third,time,tip,trichome,truncate,tub,tube,tuberculate,ud,uniseriate,unit,unspecified,upper,vary,vein,vine,violet,weak,white,wide,widest,woody,yellowish,ympodial	
45	wfo-0001026352	success	214	119	72	142	47	0.336	0.5,0.7-2,2,<,?,anther,apex,articulation,basal,base,berry,blue,branch,branching,calyx,cell,chartaceous,cm,cordate,corolla,densely,ellipsoid,entire,evenly,filament,form,fruiting,globose,green,growth,inflorescence,leaf,leafy,length,lower,many,margin,mature,membranous,mm,narrowly,near,pale,pedicel,petiole,pink,plurifoliate,pore,poricidal,principal,pubescent,revolute,shallowly,shiny,shoot,short,simple,stellate,stem,surface,terminal,time,tip,trichome,truncate,uniseriate,unit,vine,violet,white,woody,yellowish	.3,.5,0.5-0.8,0.5-1,0.5-1.5,0.5-3,0.6-,0.9-1,1-,1-1.5,1-10,1-2-celled,1.2-1.7,1.5,1.5-2,1.5-4.6,10+,12-60,2-3-celled,3-15,3.5-9,4-4.5,5-6,5-merou,6-7,7-9,abaxially,acuminate,acute,adaxially,ag,almost,alyx,angle,anthesi,antrorsely,apart,apparently,appearance,arising,ark,articulated,axi,bending,broadly,brown,capitate-truncate,conical,connivent,curved,deciduous,deltate,denser,diameter,discolorous,eaf,eed,eventually,expanded,exserted,few-celled,flattened-reniform,flower,free,geminat,giving,glabrous,greenish,half,heigh,herbarium,ilament,immature,impressed,inflorescenc,irregularly,junction,lamina,large,largest,leaving,lengthening,like,lobe,lobed,long,minutely,nearly,new,nflorescence,older,orolla,outline,ovate,pair,papillate,papillo,peduncle,peg,per,perfect,pericarp,point,portion,primary,rachi,reflexed,rest,right,ruit,scar,seen,sleeve,slit,small,spaced,sparser,speciman,specimen,spreadin,spreading,stigma,straw-colored,strongly,style,tem,thin,third,tub,tube,tuberculate,twining,ud,unspecified,upper,vary,vein,weak,widest,x,yellow,ympodial	appressed,bract,breeding,broad-based,colour,connective,fruit,geminate,hair,heteromorphism,inflated,insertion,interjected,interpetalar,leaflet,marking,modification,needle-like,null,odour,orientation,paired,pattern,placement,position,prickle,pseudostipule,rhizome,scale,shape,smell,spot,staman,stone,structure,symmetry,sympodial,system,texture,tissue,tuber,type,vegetative,xylopodia,zygomorphy,â,â
46	wfo-0001026379	exception_thrown	219	0	0	219	0	0.0		-4.5,0.2-0.38,0.2-0.4,0.7-1,0.7-2.5,0.8-1.2,0.9-1.2,1-1.7,1-10,1-2,1-3.7,1.3-2.1,1.5-2.3,1.7-4.9,1.8-2.6,1.8-3.2,1.8-5,1.9-3.4,1/2,13,2-2.8,2-7,2.4-5.1,2.6-3.7,2.9-4,2/3,3-11,3/4,4-5,4.1-7,5.3-10.2,50-450,6-10.6,8-13,8-15,8-29,8.3-10,9-14,abaxially,accrescent,acute,adaxiall,adaxially,ag,along,anther,anthesi,apart,apex,apparently,around,articulated,attenuate,axillary,ba,bark,basal,base,berry,blade,blunt-tipped,branch,branched,brown,calyx,capitat,chartaceous,closely,cm,completely,conical,corolla,covering,cylindrical,dark,dendritic-echinoid,densely,diameter,directed,distal,distally,dried,eaf,echinoi,echinoid,echinoid-pubescent,edge,eed,ellipsoid,entire,enveloping,evident,farinose,few-rayed,filament,finely,fleshy,flower,free,fruit,fruiting,glabrous,globose,granular,gray-brown,grayish,growth,hair,hig,included,inserted,lacking,large,lateral,leaf,length,lengthening,line,lobe,lobed,long,long-attenuate,lower,m.,main,many,margin,mature,midrib,minute,minutely,mm,mostly,multangulat,multangulate,multangulate-pubescent,nearly,nflorescence,oblong,obovate,obtuse,often,older,orolla,ovate,ovate-lanceolate,pale,partly,pedicel,peduncle,perfect,persistently,petiole,pitted,plant,plurifoliate,pore,poricidal,porrect-stellate,present,pubescen,rachi,rather,recent,reniform,rich,ruit,runk,scabrous,scattered,semi-ovate,sessile,short-stalked,shrub,side,simple,size,slit,small,sometimes,somewhat,spaced,sparse,stellate,stellate-,stellate-pubescent,stellate-tomentose,stelliform,stem,stigma,style,suture,tamen,terete,testa,thin,time,tip,tomentose-pubescent,translucent,tree,tube,ud,uneven,unit,upper,usually,vary,vein,velutinous-pubescent,vestigial,violet,way,whitish,whitish-brown,x,yellow,ympodial,young	
47	wfo-0001026400	success	187	132	77	110	55	0.412	0.2-0.8,0.4-1,0.5-1.2,1-2,10-28,5-7,abaxially,adaxially,anther,apex,asymmetric,attenuate,axillary,base,basiscopic,berry,blue,bud,cell,cm,coriaceous,corolla,deep,distal,filament,finely,forked,fruit,glabrescent,glabrous,globose,green,hair,half,herb,high,homostylous,interjected,lanceolate,leaf,leaflet,lengthening,light,lilac,long,lower,mm,moderately,odd-pinnate,pedicel,pentagonal,petiole,plurifoliate,pore,poricidal,puberulent,pubescent,purple,ripe,rounded,semi-stellate,sessile,short,side,simple,slit,stripe,subtending,tall,terminal,tip,tissue,tri-,unit,unwinged,white,whitish	0.5-1,0.7-1.1,1-10,1.3-2.6,1.7-2.2,10-18,12-27,13-30,2-6,2-8,2.4-5.9,3-6,3.4-4.8,3.5-5.9,30-55,4-7,5-merou,6-13,6-15,6.5-20,8-12,9-13,acumen,acuminate,acute,adaxiall,ag,alyx,apart,apparently,articulated,axe,blade,brownish,capitat,clavate,condition,connivent,covering,dark,decreasing,decurrent,diameter,digestion,dorsally,drying,eaf,edge,eed,elliptic,enzyme,erec,exceeding,flat,flower,folded,fresh,geminat,generally,glabrou,gree,green-white,greenish,hair-like,hal,honeycomb-shaped,lateral,linear,living,lobe,make,mucilaginous,nflorescence,orbicular,orolla,ovate,ovoid,pair,peduncle,perfect,petiolulate,plant,removed,ruit,seed,seudostipule,size,slightly,spaced,specimen,stamen,stigma,straight,style,subequal,tamen,tem,testal,thick,throughout,toward,tube,typically,usually,vary,wall,wet,x,yellow,ympodial	age,appressed,articulation,bract,branching,breeding,broad-based,calyx,colour,connective,erect,form,fruiting,geminate,growth,heteromorphism,inflated,inflorescence,insertion,interpetalar,length,margin,marking,mature,modification,needle-like,null,odour,orientation,paired,pattern,placement,position,prickle,pseudostipule,rhizome,scale,shape,smell,spot,staman,stem,stone,structure,surface,symmetry,sympodial,system,texture,trichome,tuber,type,vegetative,xylopodia,zygomorphy
48	wfo-0001026406	success	219	156	105	114	51	0.479	.2,0-3,0-5,0.5-2.5,1.3-1.5,1.5-5,1/3,1/4-1/2,1/4-1/3,2-3,2-6,2.5-8,3-4,5-50,6.5-7,abaxial,adaxial,andromonoecious,anther,apart,apex,apically,apparently,base,berry,blade,branched,calyx,cm,conical,connivent,cordate,cream,curved,dark,deltate,densely,dirty-whitish,distal,distance,elongating,erect,extending,filament,flattened,flower,fruit,fruiting,gently,glabrous,green,herb,hermaphrodite,heterostylous,lateral,leaf,least,length,lobe,lobed,long,long-styled,lower,lowermost,margin,marking,mature,maturity,mauve,midvein,mm,obtuse,orange-brown,pale,pedicel,petiole,poricidal,porrect,prickle,purple,red-brown,reflexed,rounded,short-styled,shrub,side,spaced,spherical,stalked,stellate,stellate-pubescent,stem,straight,surface,tapering,terminal,tip,trichome,unit,velvety,way,white,wide,yellow,young	-1,.5,0,0-30,0.3,0.3-0.5,0.3-0.7,0.4-0.8,0.4-0.9,0.5,0.5-1.5,0.8,00-200,1,1-2,1.5-2,1.8-2.4,1/,1/4,10-30,12-19,2-2.7,2.9-3.2,20-60,3-10.5,3.2-3.8,30-60,5,5-25,5-6,5-7,5-8,5-merous,6-12,6-15,7-10,7-8,7-9,9-15,abaxially,acute,adaxially,alyx,ame,apar,articulated,bark,broad-deltate,c.,chartaceous,diameter,discolorous,drying,eaf,eed,elongated,equal,flattened-reniform,foliaceous,free,fully,infructescence,lon,longer,midpoint,moderately,nflorescence,oblong,older,one,open,opening,orolla,oung,ovate,pair,peduncle,pendent,pendulous,per,pericarp,plant,plurifoliat,portion,prickl,prickly,primary,ray,ruit,scar,sessile,smooth,sometimes,sparsely,spreading,stalk,staminat,stout,style,tamen,terete,tertiary,time,tube,upper,variously,vary,vein,venation,visible,weakly,woody,yellow-brow,ympodial	appressed,articulation,bract,branching,breeding,broad-based,cell,colour,connective,corolla,form,growth,hair,heteromorphism,inflated,inflorescence,insertion,interjected,interpetalar,leaflet,modification,needle-like,null,odour,orientation,paired,pattern,placement,plurifoliate,pore,position,pseudostipule,rhizome,scale,shape,smell,spot,staman,staminate,stone,structure,symmetry,sympodial,system,texture,tissue,tuber,type,vegetative,xylopodia,zygomorphy
49	wfo-0001026407	exception_thrown	221	0	0	221	0	0.0		+,-11,-6,.5,/3,0.5,0.5-0.6,0.5-1,0.5-2,0.9-3,1,1-1.2,1-10,1.2-1.5,1.3,1.5-1.7,1.5-2,1.5-7,2-2.5,2.5-3,20-30,20-40,3.5,3.5-5.5,4-5,5,5-10,5-7,5-merou,7-10,7-8,abaxially,acute,adaxially,ag,aid,along,always,alyx,anther,anthesi,apart,apex,appearing,area,ark,around,articulated,axi,basal,base,becoming,beneath,berr,berry,black,blunt,branch,branched,broadly,brown,brownish,calyx,capitate,cell,chartaceous,clear,climbin,cm,congested,conical,connivent,corolla,deep,deltate,dendritic,dense,densely,denser,diameter,discolorous,eaf,eed,ellipsoid,elliptic,entire,erect,evenly,exserted,filament,flattened-reniform,fleshy,flower,free,fruiting,geminat,glabrescen,glabrou,glabrous,globose,golden,golden-pubescent,growth,ilament,inflorescence,internodal,interpetalar,irregularly,lamina,lateral,lax,leafy,leaving,lengthening,like,lobe,lobed,long,loosely,lower,many,margin,markedly,membranous,midvein,minutely,mixture,mm,narrowly,near,new,nflorescence,numerous,oblique,obscured,occasionally,often,older,open,orolla,outline,pair,pale,paler,papillat,papillate,pedice,pedicel,peduncle,peg,pentagonal,per,perfect,pericarp,persistent,petiole,pitted,planar,plurifoliate,pore,poricidal,portion,primary,pubescenc,pubescence,pubescent,purple,purplish,reddish,revolute,ripe,ruit,scar,shiny,short,shrub,simple,sinus,sleeve,slightly,slit,small,spaced,sparsely,sparser,spreading,stellate,stem,stiff,stigma,stout,strongly,style,surface,tangled,tem,terminal,testal,thin,time,tip,transition,trichome,truncate,tube,twining,ud,undulate,unit,upper,usually,vary,vein,vine,violet,way,weak,woody,x,yellow,ympodial	
50	wfo-0001026424	success	138	156	99	39	57	0.717	-25,-3.5,-4,1,1-,1-1.5,1-10,1-2,10,10-15,15-30,2,3-11,637/1,8-,acuman,acuminate,acute,age,apex,axil,base,becoming,blush-violet,broadly,calyx,campanulate,cell,clonal,close,cm,corolla,cuneate,cut,cyme,distinct,downard,elliptic,erect,exceeding,except,facing,flower,fork,forked,glabrous,glandular,growing,hair,lanceolate,lanceolate-elliptic,lasting,lavender,leaf,lobe,lobed,long,lower,midvein,minute,oblique,obovate,often,part,pedicel,pedicellate,petiole,pinnatisect,point,rarely,rh,rotate-stellate,rounded,scorpioid,second,several,shallowly,shrub,simple,sinus,slightly,soft-wooded,stem,stone,straggly,time,tip,tissue,toward,triangular,unit,unwinged,usually,violet,within,woody,x,year,young	0.75-1.5,1.5-2,12-60,15,3-4,acumen,angular,anthesi,aspect,ba,blunt,bluntly,broad,common,conspicuous,dia,eaf,ellipsoid,exerted,facetted,floral,general,gree,interacuminal,lacking,larger,line,lon,mm,nflorescence,peduncle,plurifoliat,rachi,raised,short,soon,tub,ud,ympodial	anther,appressed,articulation,bract,branching,breeding,broad-based,colour,connective,filament,form,fruit,fruiting,growth,heteromorphism,inflated,inflorescence,insertion,interjected,interpetalar,leaflet,length,margin,marking,mature,mentioned,minutely,modification,needle-like,odour,orientation,paired,pattern,placement,plurifoliate,pore,position,present,prickle,pseudostipule,rhizome,scale,shape,smell,spot,staman,surface,symmetry,sympodial,system,texture,trichome,tuber,type,vegetative,xylopodia,zygomorphy
51	wfo-0001026440	exception_thrown	181	0	0	181	0	0.0		0-15,1-5,1.1-1.4,1.1-1.5,1.3-1.7,1.5-2.1,1.8-4.5,1.9-3.7,1/2,1/2-2/3,14-30,2-2.8,2-4,2.9-4.4,3-5,3-7,3-8,3.9-6.5,3/4,4-12,5-7,7-14,9,abaxially,accrescent,acute,adaxiall,adaxially,ag,along,always,anther,anthesi,apex,apparently,appressed,articulated,axillary,ba,bark,basal,base,berry,blade,blunt-tipped,bract-like,branch,branche,branched,broadly,brown,calyx,capitat,chartaceous,closely,cm,conical,corolla,dendritic-echinoid,dense,developed,diameter,dichotomy,directed,distal,distally,eaf,echinoi,echinoid,eed,elliptic,entire,filament,first,fleshy,flower,free,fruiting,globose,granular,green,greenish-yellow,hair,high,included,inserted,large,leaf,length,lengthening,lobe,lobed,long,long-attenuate,lower,m.,many,margin,minute,minutely,mm,mostly,multangulat,multangulate,multangulate-pubescent,nearly,nflorescence,oblong,obovate,obovoid-oblong,obscure,obtuse,often,older,openly,orolla,ovate,pair,pale,pedicel,peduncle,perfect,persistently,petiole,pitted,plurifoliate,pore,poricidal,porrect-stellate,pubescen,rather,reniform,ripe,ruit,runk,scabrous,semi-ovate,sessile,short-acuminate,short-stalked,shrub,simple,size,slit,small,sometimes,somewhat,spaced,sparse,stellate,stellate-pubescent,stem,stigma,style,suture,tamen,terete,testa,thick,thin,time,tip,tomentose,tomentose-pubescent,tomentum,translucent,tree,truncate,tube,turning,ud,uneven,unit,usually,vary,way,white,x,yellow,ympodial,young	
52	wfo-0001026441	success	197	171	117	80	54	0.594	0-2,0.3-0.7,0.5-1.5,0.8,1-2,1.5-2.5,2-5.5,2-8,3-5,4-6,4-8.5,5,6-15,7-20,abaxially,absent,acuminate,adaxially,anther,apex,axillary,base,berry,blade,bud,cell,chartaceous,cm,conical,corolla,covering,decreasing,digestion,distal,elliptic-lanceolate,end,enzyme,equal,filament,forked,fruit,generally,glabrous,gradually,green,green-white,hair,hair-like,half,herb,homostylous,honeycomb-shaped,interjected,internal,larger,lateral,leaf,leaflet,light,like,long,lower,make,margin,middle,minute,mm,mucilaginous,narrow,obtuse,odd-pinnate,one,orbicular,ovate,pair,pale,pedicel,petiole,petiolule,placed,plant,plurifoliate,pore,pubescent,removed,rotate,rounded,secondary,seed,semierect,short,size,slightly,sparsely,star,stem,straight,subequal,subsessile,subtending,symmetrical,tall,terminal,testal,thick,throughout,toward,tri-,tuber,typically,unit,violet,wall,wet,white,wing,x	.5,0.4-3,1-1.5,1-10,1.5-2,10,10-14,15-20,2-2.5,4-8,4.5-6.5,5-10.5,5-merou,7-8,9-14,acumen,ag,alyx,apart,apparently,articulated,attenuate,axe,brownish,capitat,ciliate,condition,connivent,diameter,dorsally,drying,eaf,edge,eed,erec,especially,exceeding,flat,flower,folded,fourt,fresh,geminat,glabrou,greenish,lanceolate,lengthening,living,lobe,minutely,mottled,nflorescence,orolla,ovoid,peduncle,perfect,poricidal,puberulent,purple,ripe,ruit,seudostipule,slit,spaced,specimen,stamen,ste,stigma,stolo,style,tamen,tem,tip,tube,usually,vary,whitish,wide,yellow,ympodial	appressed,articulation,bract,branching,breeding,broad-based,calyx,colour,connective,erect,form,fourth,fruiting,geminate,growth,heteromorphism,inflated,inflorescence,insertion,interpetalar,length,marking,mature,modification,needle-like,null,odour,orientation,paired,pattern,placement,position,prickle,pseudostipule,rhizome,scale,shape,smell,spot,staman,stolon,stone,structure,surface,symmetry,sympodial,system,texture,tissue,trichome,type,vegetative,xylopodia,zygomorphy
53	wfo-0001026460	exception_thrown	131	0	0	131	0	0.0		.1,.5,0.5-1.5,1-1.5,1.5-2,1/2,10-15,13.5-21,2-2.5,2.5-3,4.5-5,5,513,6-7,6-9,7-9,8-10,abaxially,acut,acute-acuminate,adaxially,anther,anthesi,apex,axi,base,becoming,berry,branched,brown,calyx,capitate,closely,cm,completely,conical,corolla,dark,deflexed,deltate,dia,distal,do,drying,eaf,edicel,eed,elliptic,erect,fide,filament,filiform,floccose,flower,free,frui,fruiting,glabrous,globose,green,greenish,inflorescenc,inflorescence,internodal,leaf,less,like,lobe,lobed,long,long-exserted,lower,major,membraneous,middle,minutely,mm,nearly,nflorescence,often,older,opposite,ovary,ovoid-reniform,pair,pale,papillo,papillose,pedicel,pitted,pore,poricidal,portion,puberulent,reddish,reddish-brow,reflexed,ruit,santo,scar,shaped,shrub,simple,slightly,somewhat,soon,spaced,stem,stigma,style,subshrub,surface,tall,tapering,tear-drop,tiny,tip,trichome,tub,tube,ud,unifoliat,unit,vein,white,widest,woody,x,yellow,ympodial,young	
54	wfo-0001026489	success	153	75	22	131	53	0.144	1.5-5,anther,apex,base,calyx,corolla,filament,fruiting,green,leaf,lower,margin,pedicel,petiole,pore,shrub,stem,surface,tall,trichome,unit,white	.3,0.05-0.1,0.25-0.5,0.5,0.5-0.75,0.5-1,0.5-2,0.6-1.4,0.8-1.2,0.8-1.3,0.8-3.7,1-1.5,1.3-3,2-3,2-4,2-5,2-8-flowered,2.5-13,2.5-4,2/3,5-6,8-13,acute,along,anthesi,appearing,area,axil,ba,bark,beneath,berry,branched,broadly,brown,closely,cm,cup-shaped,dark,deflexed,deltoid,densely,dia,differing,difoliate,dry,eaf,edicel,eed,elliptic,erect,exserted,extending,flattened,flattened-reniform,fleshy,free,geminat,glabrous,globose,gra,incrassate,lamina,later,lateral,lobe,lobed,lon,long,main,major,middle,minor,minutely,mm,nflorescence,occasionally,often,older,one,opposite,ovary,overlappin,pair,paler,papillo,papillose,parallel,perpendicular,pitted,planar,poricidal,portion,prominent,pubescent,red-papillose,rhachi,ruit,scar,shaped,shiny,simple,size,slender,somewhat,soon,spaced,specimen,stigma,straight,strongly,style,tapering,tear-drop,terminal,thickened,tip,tub,tube,ud,uniseriate,usually,vein,way,whitish,widened,widest,woody,x,ympodial,young	appressed,articulation,bract,branching,breeding,broad-based,cell,colour,connective,form,fruit,growth,hair,heteromorphism,inflated,inflorescence,insertion,interjected,interpetalar,leaflet,length,marking,mature,modification,needle-like,none,odour,orientation,paired,pattern,placement,position,prickle,pseudostipule,rhizome,scale,shape,smell,spot,staman,stellate,stone,structure,symmetry,sympodial,system,texture,tissue,tuber,type,vegetative,xylopodia,zygomorphy
55	wfo-0001026490	exception_thrown	272	0	0	272	0	0.0		.5,0.1â0.2,0.1â2.5,0.2â1,0.2â1.5,0.3â3.5,0.4â0.8,0.5â1,0.5â1.5,0.5â3.5,0.5â8,0.7â3,0.8â1.5,0.8â12,1.2â8,1.5,1.5â2,1.5â3.5,1.5â5,1.8â2.2,1.9,10â20,1â1.2,1â15,1â2.5,1â3,1â8,2,2.5â3.5,2â2.5,2â4,2â6,2â8,3,3â4.2,3â4.5,3â5,3â5-pinnate,3â8,4.6,4â4.5,4â5,5-merous,5â7,6,7,7-pinnate,7â15,=,[,],abaxially,absent,accrescent,acuminate,acute,adaxially,ag,along,alyx,anther,anthesi,apart,apex,apical,apicall,apparently,around,articulated,axe,axillary,ba,base,becoming,blade,bract,bracteate,branched,broadly,brown,calyx,capitat,cauline,chartaceous,ciliate,climbing,cm,commonly,completely,connivent,contiguously,cordate,corolla,covered,crisped,cylindrical,darker,decreasing,densely,diameter,directed,distal,distally,eaf,eed,eglandular,ellipsoidal,elliptic,entire,equal,exceeding,expanded,extra-axillary,filament,flat,flattened,flower,free,fruit,fruiting,fused,geminat,glabrous,green,ground,immature,incurved,inflorescence,interjected,irregularly,lacking,large,lateral,latrorse-introrse,leaf,leaflet,length,lenticular,light,lobe,lobed,long,longitudinal,lower,lowermost,lunate,main,margin,markedly,match,mature,mean,mean=,medium,middle,midvein,minute,mm,moderately,mottled,multicellular,near,nearly,nflorescence,node,obliqu,oblique,obliquely,oblon,oblong,obtuse,obtusely,occasionally,one,opening,orange,orolla,ovate,ovate-lanceolate,pair,papillose,part,pedicel,peduncle,pentagonal,per,perfec,perfect,petiole,petiolule,plurifoliate,pointed,pore,present,pseudostipule,pubescen,pubescence,pubescent,punctate,pur,rachi,radial,reflexed,reniform,resulting,revolute,rooting,rounded,ruit,sand,seed,seudostipule,shape,shoot,short,shorter,similar,simple,size,slender,slightly,slit,smaller,smooth,sometimes,somewhat,spaced,sparsely,spur,stamen,stem,stigma,striation,striping,strongly,style,surface,tamen,tawny,teardrop-shaped,tem,terminal,thickened,tip,toward,trailing,transparent,trichome,trichomessympodial,truncate,tube,typically,unbranched,undulate,unit,vary,vegetation,vine,violet,white,wide,wing,woody,yellow,yellowish-tan,youn,Â½,Ã,â4,â4.5,â8,â9.5	
56	wfo-0001026491	exception_thrown	165	0	0	165	0	0.0		.5,1,1-2,1.5-2,1.5-2.5,1.5-3.5,1.7,10-50,1977,2-3,2-4,2-celled,2.5-3.5,3,3-pinnate,5-6,5-8,5-merou,6-8,7-8,abaxiall,abaxially,absent,acuminate,acute,adaxially,alyx,anderson,anther,apex,apparently,appressed,articulated,averaging,axe,ba,base,bayonet,bent,berry,blade,bract,branched,branching,broadly,capitat,cellular-papillose,cellular-pilose,central,cm,connivent,conspicuously,crinkly,cuneate,deciduous,deep,deltoid,densely,diameter,directed,distall,eaf,eed,elliptic-lanceolate,entire,equal,filament,first,flower,geminat,glistening,globose,greatly,green,growing,hair,highly,homostylous,inflorescence,interjected,lanceolate,lateral,leaf,leaflet,less,light,lobe,long,lower,lunulat,margin,mean,middle,minutely,mm,near,nflorescence,oblong-elliptic,obtuse,often,orolla,ovate,ovate-elliptic,ovoid,pale,pedicel,peduncle,perfect,petiole,pilose,plurifoliate,point,pore,poricidal,porrect-incurved,present,pubescent,purple,rachi,rarely,readily,reduced,rotate-pentagonal,rotate-substellate,rounded,row,ruit,scandent,seudostipule,sharp,shortly,shrub,similar,simple,slender,small,spotted,stigma,straight,strigo,strigose,strong,strongly,subacute,suborbicular-ovate,surface,tal,tamen,tawny,tem,terminal,tightly,tip,tube,tyle,uniseriate,unit,upright,usually,ventral,white,whitish,x,yellow,ympodial	
57	wfo-0001026501	exception_thrown	195	0	0	195	0	0.0		-1.7,-3,.1,.35,.5,.6,.7,/3,0,0-1,0-2,0.05-0.3,0.1,0.2-1.8,0.27-0.7,0.5,0.5-0.6,0.5-0.9,0.5-1,0.6-1,0.6-1.1,0.6-2,0.9-2.2,1,1-2,1-2.5,1.8-2.2,1/2-2/3,1/4,1/6-1/2,2-10,2.5-4,2.8-3,3-4,3-5,3-9,3.5-4,4-5,4-7,5-merous,6-9,7-9,?,abaxially,acicular,acute,almost,alyx,anther,apar,apart,apex,apically,apparently,articulated,bark,base,becoming,berry,blade,borne,branched,brown,brown-green,calyx,chartaceous,cm,color,concolorous,cuneate,curved,deltate,densely,diameter,discolorous,drying,dull,eaf,eed,elliptic,elongated,elongating,entire,equal,erect,eye,filament,filiform,filiform-acuminat,flattened,flattened-reniform,flower,free,fruit,fruiting,glabrou,glabrous,gray,green,infructescence,known,leaf,length,light,lobe,lobed,long,longer,lower,margin,mature,mauve,midpoint,mm,moderately,naked,nflorescence,often,older,one,open,orange-brown,orbicular,orolla,oung,ovate,pair,pale,pedicel,peduncle,pendulous,per,perfec,pericarp,petiole,plurifoliat,poricidal,porrect,portion,prickl,prickle,prickly,primary,ray,reddish,rounded,ruit,scandent,scar,sessile,shoot,short,shorter,shrub,simple,slender,small,smooth,sometimes,somewhat,spaced,sparsely,spherical,spreading,stalk,stalked,stellate,stellate-pubescent,stem,straight,style,subsessile,surface,tamen,tapering,terete,terminal,time,tip,trichome,tube,unarme,unarmed,unit,upper,variously,vary,vein,visible,way,white,wide,yellow,yellow-green,ympodial	
58	wfo-0001026513	exception_thrown	138	0	0	138	0	0.0		.1,.25,.3,.75,/3,0.8-2,1-1.5,1-3,2-2.2,2-5,3-5,3-6-flowered,4-5,6-8,7-9,8-16,acute,anther,anthesi,apex,apiculate,area,ba,bark,base,berry,broadly,caly,calyx,closely,cm,completely,corolla,darkish,decurrent,deflexed,delicate,deltoid,dia,differentiated,dry,eaf,edicel,eed,elliptic,erect,except,exserted,filament,flower,free,fruit,fruiting,glabrous,globose,gre,green,hirsute,immature,known,lanceolate,lateral,leaf,leave,less,live,lobe,lobed,long,long-styled,longer,lower,main,mature,middle,minute,minutely,mm,much,nflorescence,obscure,older,opposite,ovary,overlappin,pair,pale,papillose,pedicel,petiole,plant,pore,poricidal,portion,prominent,raised,reflexed,rest,ruit,scar,shaped,shiny,short-styled,shrub,simple,slender,small,somewhat,soon,spaced,specimen,stem,stigma,straight,styl,style,surface,tall,tear-drop,tip,treelet,trichome,tube,ud,undersurface,unifoliat,uniseriate,unit,vein,venation,way,white,wide,widest,woody,x,ympodial,young	
59	wfo-0001026529	exception_thrown	219	0	0	219	0	0.0		0-25,0.3-1,0.5-4.5,1,1-10,1-2,1-3,1-4.5,1.1-2.5,1.5-2.5,1.5-4,10,10-28,11-14,12-22,120-210,2,2-5,2-7.5,20-60,3-12,3-5,3-6,3-9.5,4-8,5-15,5-17,5-9,5-merou,50-70,6-20,600-950,?,abaxially,acumen,acuminate,acute,adaxially,ag,along,alyx,anther,apart,apex,apparently,articulated,attenuate,axe,axillary,base,berry,blade,blue,broadly,brownish,bud,capitat,cell,chartaceous,ciliate,clavate,cm,condition,connivent,cordate,corolla,covering,creamy,dark,deep,densely,diameter,digestion,distal,dorsally,dot,drying,eaf,edge,eed,elliptic,enzyme,erec,especially,exceeding,except,faintly,filament,flat,flower,folded,forked,fresh,fruit,geminat,generally,glabrou,glabrous,gland,glandular,globose,greatly,gree,green,green-white,greenish,hair,hair-like,hal,half,head,herb,homostylous,honeycomb-shaped,interjected,lanceolate,lateral,leaflet,length,lengthening,light,like,lilac,living,lobe,long,longer,lower,lunate,make,margin,medium,membranous,midrib,minutely,mm,moderately,mucilaginous,narrowly,nflorescence,non-glandular,oblique,odd-pinnate,often,orbicular,orolla,ovate,ovoid,pair,pedicel,peduncle,pentagonal,perfect,petiole,petiolulate,petiolule,plant,plurifoliate,pore,poricidal,proximal,puberulent,pubescent,pure,rarely,reduced,removed,ripe,rounded,ruit,scattered,seed,sessile,seudostipule,shape,short,size,slightly,slit,spaced,specimen,stamen,ste,stem,stigma,straight,style,subequal,subsessile,substellate,subtending,tall,tamen,tem,terminal,testal,tetralobulate,thick,throughout,tip,tri-,trichome,tube,typically,unit,unwinged,usually,vary,varying,wall,wet,white,whitish,wide,wing,x,yellow,yellowish,ympodial	
60	wfo-0001026534	exception_thrown	150	0	0	150	0	0.0		-1.5,0.5-1,1-2,1-2.5,1-3,1.5-6,1.5-9,10-15,10-20,10-50,15-50,2-2.5,2-3,2-7,2-8,2.5-15,2.5-4,3-,3-10,3-25,3-4,3-5,3.5-4,4-10,4-foliat,4.5-5,5-6,6-35,7-12,7-40,abaxially,absent,acuminate,acute,adaxially,aggregate,apart,ape,apex,apiculate,articulated,auriculate,axe,basal,base,beyond,blade,branched,bright,calyx,cell,chartaceous,cm,connective,connivent,cordate,cylindrical,darker,deltate,densely,diameter,directed,distally,eaf,eed,eglandular,ellipsoidal,entire,equal,exserted,flattened,fleshy,flower,fruit,glabrous,glandular,hair,lanceolate,leaving,lemon-yello,lobe,lon,long,longitudinal,lower,m.,margin,mm,moderately,narrowly,nflorescence,nther,obtuse,often,orange,orolla,ovate,ovoid,pale,pedicel,pedicellar,peduncle,perfect,petiole,pinkish,pore,presen,puberulen,puberulent,pubescent,purple,rachi,radiu,red,remnant,ruit,shorter,simple,slightly,small,spaced,sparsely,stamen,stellate,stigma,stone,stripe,style,subcoriaceous,tal,tem,thecae,time,tip,tomento,tree,triangular,truncat,truncate,tube,ud,unbranched,unit,vary,vein,white,wide,x,yellow,ympodial	
61	wfo-0001026535	exception_thrown	248	0	0	248	0	0.0		.1,.2,.4,.5,.8,0-0.5,0.1-0.2,0.15,0.2,0.2-0.3,0.2-1.5,0.5-1,0.7-1.5,1,1-2,1-3,1-5,1.2-2,1.3,1.5-2,1.5-3,1/2-2/3,1/3,2-3,2-5,2.5,3,3-4.5,3-5,3.5-4,4-15,5-10,5-7,5Â°,7-8,abaxial,abaxially,absent,accrescent,acute,adaxially,age,almost,along,alternate,alyx,anther,anthesi,apar,apex,apically,apparently,area,around,articulated,bark,base,becoming,berry,black,brachyblast,branch,branched,branching,broadly,brown,calyx,chartaceous,clavate,clearly,clustered,cm,concolorous,condensed,conical,corolla,cuneate,cup,cupular,curved,dark,deeply,delineate,delineated,deltoid,dendritic,dendritic-pubescent,dense,detaching,developed,developing,diameter,dilated,discolorous,distributed,divided,domatia,dorsal,dry,drying,eaf,eed,ellipsoi,elliptic,elongated,entire,equal,evenly,except,eye,fertilisation,filament,fine,flat,flexuous,flower,forming,free,frui,fruit,fruiting,glabrous,green-brown,increasing,inside,known,leaf,leave,length,lengthening,liana,like,linear,lobe,lobed,lon,long,loop,loose,lower,m.,main,margin,marginal,membranous,midvein,minute,minutely,mm,mostly,much,naked,network,nflorescence,nther,number,oblong,obovate,obscure,older,orange-brown,orolla,outside,ovate,ovoid,pair,papillo,partly,pedicel,peduncle,pendulous,perfec,pericarp,petiole,plant,plurifoliat,pointed,pore,poricidal,portion,primary,prominent,protruding,pubescent,rachi,raised,rarely,ray,reaching,ridged,rounded,ruit,scar,secondary,see,short,shrub,side,simple,sinus,slender,slightly,smaller,smooth,soon,spaced,sparsely,spreading,stem,stigma,stump,style,surface,tearing,terete,terminal,tertiary,thin,tip,tissue,toward,translucent,trichome,truncate,tube,tufted,two,ud,unarmed,uneven,unevenly,unit,unlignified,vary,vein,venation,violet,visible,weakly,white,wide,widely,wider,x,yellowish,ympodial,young,youngest	
62	wfo-0001026604	exception_thrown	192	0	0	192	0	0.0		.4,.5,.75,0,0.1,0.4-0.6,0.8-0.9,0.8-1,1-1.2,1.1-1.3,1.2-1.7,1.5-2,1.5-9,10-30,2-2.3,2-2.5,2.3-3.5,3-3.5,3-5,3.5-4,4-4.5,4.5-7,5,5-7,50-100,<,?,absent,acuminate,age,aid,along,always,anther,anthesi,apart,apex,appearing,articulated,articulation,atop,bark,basal,base,berry,branching,brow,brown,c.,calyx,capitate,cell,clearly,climbing,cm,comical,conical,cordate,corolla,cucullate,cupped,dark,deflexed,densely,diameter,differentiated,distal,distinct,drying,due,eaf,eed,ellipsoid,elongate,entire,expanding,exserted,filament,flattened,flexuous,flower,free,fruit,fruiting,glabrous,globose,growth,inflated,later,leaf-opposed,leaving,lengthening,liana,lobe,lobed,lower,margin,mere,midrib,minute,minutely,mm,narrowly,new,nflorescence,nodding,oblique,occasionally,older,outline,ovary,ovate,overall,ovoid,pair,pale,papillo,papillose,part,particularly,pedicel,peduncle,peg,per,perfect,pericarp,petiole,pitted,planar,plurifoliat,poin,point,pore,poricidal,portion,primary,pubescent,purple,quarter,receptacle-like,red,reddish,reniform,rim,ripe,ruit,scar,series,shape,shiny,shrub,simple,sinuate,slender,slightly,slit,somewhat,spaced,stellate,stem,stigma,stout,strongly,structure,style,support,surface,swolle,terminal,testal,thin,time,tip,trichome,truncate,tub,tube,twisting,ud,undulation,uniseriate,unit,upper,vein,vining,violet,way,widely,woody,x,ympodial,Â½	
63	wfo-0001026607	success	204	139	85	119	54	0.417	0-3,0.1-0.3,0.8-3.4,1-2,4-6,5,absent,anther,apex,attenuate,axillary,base,basiscopic,berry,bud,cell,chartaceous,cm,coarse,corolla,decurrent,deep,distal,dot,filament,finely,forked,forming,fruit,generally,glabrous,globose,green,hair,half,herb,high,homostylous,interjected,lanceolate,leaf,leaflet,like,long,lower,margin,medium,membranous,minute,mm,moderately,odd-pinnate,often,orbicular,ovate,pedicel,pentagonal,petiole,petiolulate,plant,plurifoliate,pore,poricidal,puberulent,pubescent,rarely,ripe,rosette,scattered,sessile,short,side,simple,slit,stem,subtending,tall,terminal,tip,tri-,typically,unit,violet,white,whitish	0-4,0.3-1.8,0.5-5.8,0.8-4.5,0.8-5,1-10,1-3.8,1-5,1-8,1.5-4,10-30,2-10,2-2.5,2-3,2.4-5.8,2.5-3.8,2.7-19,3-8,4-10,5-merou,5.8-19.8,6-10,abaxially,acumen,acute,adaxially,ag,along,alyx,apart,apparently,articulated,axe,blade,brownish,capitat,ciliate,clavate,clearly,condition,connivent,covering,decreasing,diameter,digestion,dorsally,drying,eaf,edge,eed,elliptic,enzyme,especially,exceeding,flat,flower,folded,fresh,geminat,glabrou,greatly,gree,green-white,greenish,hair-like,hal,honeycomb,larger,lateral,lengthening,living,lobe,make,marked,midrib,minutely,much,mucilaginous,nflorescence,obtuse,orolla,ovoid,pair,peduncle,perfect,present,rachi,removed,rounded,ruit,seed,semierec,seudostipule,shaped,size,sometimes,spaced,specimen,stamen,ste,stigma,straight,style,tamen,tem,testal,thick,throughout,toward,tube,unwinged,usually,vary,wall,wet,without,x,yellow,ympodial	age,appressed,articulation,bract,branching,breeding,broad-based,calyx,colour,connective,form,fruiting,geminate,growth,heteromorphism,inflated,inflorescence,insertion,interpetalar,length,marking,mature,modification,needle-like,odour,orientation,paired,pattern,placement,position,prickle,pseudostipule,rhizome,scale,semierect,shape,smell,spot,staman,stone,structure,surface,symmetry,sympodial,system,texture,tissue,trichome,tuber,type,unspecified,vegetative,xylopodia,zygomorphy
64	wfo-0001026613	exception_thrown	159	0	0	159	0	0.0		0.5-1,0.6,1-10,1-2,1.5-4,11-19.5,2-7.5,2.3-8,2.5-2.8,3-10,3-5,4-5,4.5-8.5,5,5-6,5-7,5-merou,5.5-7,6-12,6-8,6.2-9.5,8-18,8.5-10,8.5-9,9.5-13.5,abaxially,absent,acumen,acuminate,adaxially,ag,along,alyx,anther,apart,apex,apparently,articulated,attenuate,axe,axillary,base,berry,blade,borne,bud,capitat,chartaceous,ciliate,cm,conical,connivent,cordate,corolla,decreasing,densely,diameter,distal,dorsally,eaf,edge,eed,end,erec,especially,filament,flat,flower,folded,forked,fruit,geminat,generally,glabrous,greatly,green,hair,hal,half,herb,homostylous,immature,interjected,lanceolate,larger,lateral,leaf,leaflet,lengthening,like,lobe,long,lower,m-1.2,margin,mature,membranous,middle,midrib,minute,minutely,mm,mottled,nflorescence,odd-pinnate,orolla,ovate,pair,pedicel,peduncle,perfect,petiole,petiolule,plant,plurifoliate,pore,poricidal,proximal,puberulent,pubescen,pubescent,purple,rotate-pentagonal,ruit,secondary,semierect,seudostipule,singly,size,slit,spaced,sparsely,ste,stem,stigma,stolo,style,subequal,subtending,symmetrical,tall,tamen,tem,terminal,tip,toward,tri-,tube,tuber,typically,unit,unknow,unknown,unwinged,usually,vary,x,yellow,ympodial	
65	wfo-0001026614	exception_thrown	200	0	0	200	0	0.0		.8,0.2,0.2â0.3,0.4-0.7,0.5,0.5â2,1-,1.3-1.8,1.5â2,11-15,15â30,1â2,1â3,1â5,2.2,2.2-5.5,2.5,2.5â3,20â25,2â4,2â4-branched,2â6.5,3-foliate,3.2-5.2,3â10,4-7,4.5â11,4.5â5.5,5,5-merou,5.3-8.2,50,6.4-8.4,6â8,7.2-9.8,8â10,9â16,>,abaxially,absent,across,acuminate,acute,adaxiall,adaxially,alyx,anther,apart,apex,apparently,armed,articulated,axe,ba,base,berry,black,blade,blunt-tipped,broad-based,brown,calyx,campanulate,capitat,chartaceous,clavate,closely,cm,commonly,concentrated,cylindrical,dark,densely,denser,developed,diameter,directed,distally,dried,eaf,eed,entire,erect,especially,evenly,expanded,extra-axillary,filament,flattened-reniform,fleshy,flower,foveolate,fruit,fruiting,geminate,glabrescent,glabrous,gland-tipped,globo,globose,golden,hair,homostylous,internode,interpetalar,irregularly,lanceolate-attenuate,lateral,leaf,less,linear,lobe,lobed,lon,long,lower,margin,midpoint,midvein,minute,minutely,mm,mottled,nearly,nflorescence,oblique,obtuse,often,orange,orange-red,orolla,ovate,ovate-lanceolate,ovoid,pair,pedicel,peduncle,per,perfect,petiole,pore,prickle,pubescence,pubescent,rachi,rarely,ray,reflexed,repand,ripe,rotate-pentagonal,rounded,ruit,scattered,sessile,shallowly,shin,shrub,side,similar,simple,slightly,smaller,sometimes,somewhat,soon,spaced,sparsely,spreading,stellae,stellate,stellate-pubescent,stem,stigma,style,surface,tall,tamen,tapering,tem,time,tissu,tissue,tube,ud,unarme,unarmed,usually,vary,vein,weakly,well,white,wide,x,yellow,yellowish,ympodia,young,â5	
66	wfo-0001026642	exception_thrown	193	0	0	193	0	0.0		.05,.1,.8,0.1,0.1â0.3,0.2,0.25,0.4,0.4â2.2,0.5,0.5â,0.5â0.7,0.5â1.7,0.5â2.0,0.5â3.5,0.6,0.6â1.0,0.75â1.0,0.75â2.0,0.7â1.6,0.8â1.2,1.0,1.0â2.0,1.2â1.7,1.2â2.0,1.2â3.5,1.2â6.2,1.6â8.0,1.9â3.0,12â30,1â10,1â3,2.0â4.0,2.5â3.5,2.5â4.0,2.8â3.0,3.0â5.1,3â5,4.0â6.0,4â7,5,5.0â7.0,50â100,6,<,abaxial,abaxially,acute,adaxiall,adaxially,ag,along,annual,anther,anthesi,apart,apex,appressed,articulated,axe,axillary,ba,base,bipinnate,black,blade,blue,borne,branched,brown,calyx,cell,chartaceous,circular,clavate,cm,connivent,cylindrical,dark,decreasing,decumbent,densely,denser,diameter,divided,eaf,eed,either,elliptic,equal,erect,filament,flattened,fleshy,flower,fruit,geminat,glabrescen,glabrous,gland,glandular,globose,green-purple,hair,half,herb,indumentum,lavender,leaf,length,lilac,lobe,lon,long,longitudinal,lower,m.,mm,moderately,multicellular,narrow,nflorescence,number,oblong,obtuse,occasionally,often,opening,orolla,ovate,pair,pale,pedicel,peduncle,pentagonal,perennial,perfect,petiole,pinnae,pinnate,pitted,pore,poricidal,present,primary,probably,pubescent,rapidly,rounded,ruit,secondary,sessile,shallowly,shoot,side,simple,slit,sometimes,spaced,sparsely,stigma,stone,straight,style,subglabrous,surface,tal,tamen,tem,time,tip,tube,unicellular,unifoliate,uniseriate,unit,usually,vary,vein,violet,white,wide,wing,woody,x,yellow,ympodial,â1.2,â11.0,â2.0,â4.5,â6,â7	
67	wfo-0001026651	exception_thrown	222	0	0	222	0	0.0		-celled,0.2â1.3,0.35â2.6,0.9â3,1,1.8,1â2,2.2â10,2.8,2â11.5,2â13,2â3,2â3.3,2â4,2â4.5,2â8,3,3-plurifoliate,3â5,3â7,4,4â6,4â7.8,5-merou,6â10,6â14,8,abaxially,absent,accrescent,acuminate,acute,adaxiall,adaxially,along,alyx,anisophyllous,anther,antror,antrorse,antrorsely,apar,apex,appressed,arcuate,ark,articulated,asymmetric,attenuate,axi,base,beneath,berry,beyond,branch,broadly,brochidodromous,brown,brownish-green,calyx,capitat,capitate,cell,chartaceous,ciliate,circular,cm,connivent,cordate,cylindrical,cyme,dark,decumbent,decurrent,densely,diameter,differing,directed,discolorous,drying,dull,eaf,eed,elliptic,emarginate,entire,equal,erect,exfoliating,exserted,eye,filament,flattened,flexuous,flower,frui,fruit,geminate,geniculate,glabrescent,glabrou,glabrous,glandular,globose,green,growt,hair,head,herb,highly,hilum,hollow,impressed,introrsely,lanceolate,lateral,leaf,length,less,light,like,lobe,long,longitudinal,lower,lying,major,margin,markedly,matte,membranaceous,midrib,minor,mm,moderate,moderately,mostly,much-branched,multicellular,naked,narrowly-elliptic,new,nflorescence,normally,oblong-ellipsoid,obtuse,older,one,onto,opening,orolla,ovate-deltate,ovate-lanceolate,ovate-reniform,parallel,pedicel,peduncle,pedunculate,per,perfect,petiole,plant,pore,poricidal,prominent,pubescence,pubescent,reduce,region,revolute,ripe,rounded,ruit,secondary,seed,shape,shiny,shrub,similar,simple,single-celled,size,slightly,slit,small,smaller,sometimes,spaced,stalk,stamen,stellate,stem,stigma,straight,style,sub-opposite,subapical,surface,tall,tamen,tem,terminal,translucent,trichome,turning,unbranched,undulate,uniseriate,unit,upper,usually,vary,vein,venation,visible,white,wide,woody,yellow,ympodial,young,Ã	
68	wfo-0001026656	success	211	177	122	89	55	0.578	0-4,0.3-3,0.3-4.2,0.4-6.5,0.7-10.5,0.9-13,1-10,1-2,10,2-6,2.5-17,20-60,5,5.5-27,abaxially,absent,acuminate,acute,anther,apex,articulated,attenuate,base,bearing,blade,blue,borne,broadly,bud,cell,chartaceous,cm,corolla,cuneate,dark,decurrent,densely,distal,dot,elliptic,end,especially,filament,forked,fruit,generally,glabrous,glaucous,globose,greatly,green,greenish-yellow,hair,half,herb,homostylous,interjected,lanceolate,larger,lateral,leaflet,light,like,long,lower,lunate,margin,membranous,mm,moderately,narrowly,non-glandular,oblique,occasionally,odd-pinnate,often,ovate,pair,pedicel,pentagonal,petiole,petiolulate,petiolule,plant,plurifoliate,pore,poricidal,pubescent,purple,rachi,ranging,rotate-pentagonal,scale-like,scattered,seudostipule,short,singly,slightly,sometimes,somewhat,star,ste,stem,subequal,subglabrous,subtending,symmetrical,tall,terminal,tertiary,therefore,tinged,tip,tri-,truncate,tuber,typically,unit,violet,white,wide,without	1,1-1.8,1-3.8,1-4,1-5,1.1-8.1,1.5-7,2-8,4-10,4-13,4-8,5-18,5-35,5-merou,9-11,acumen,adaxially,ag,along,alyx,apart,brownish,capitate,ciliate,clavat,condition,connate,connivent,covering,curved,diameter,digestion,dorsally,drying,eaf,edge,eed,enzyme,erec,exceeding,flat,flower,folded,fresh,geminat,green-white,greenish,hair-like,honeycomb-shaped,lengthening,living,lobe,make,middl,midvein,minutely,mottled,mucilaginous,nflorescence,orolla,ovoid,peduncle,puberulent,pubescen,removed,ruit,seed,slit,spaced,specimen,stamen,stigma,stolo,straight,style,tamen,tem,testal,thick,throughout,tube,unwinged,vary,wall,wet,whitish,wing,yellow,ympodial	appressed,articulation,bract,branching,breeding,broad-based,calyx,colour,connective,erect,form,fruiting,geminate,growth,heteromorphism,inflated,inflorescence,insertion,interpetalar,leaf,length,marking,mature,middle,modification,needle-like,null,odour,orientation,paired,pattern,placement,position,prickle,pseudostipule,rhizome,scale,shape,smell,spot,staman,stolon,stone,structure,surface,symmetry,sympodial,system,texture,tissue,trichome,type,vegetative,xylopodia,zygomorphy
69	wfo-0001026663	exception_thrown	251	0	0	251	0	0.0		-15,-2.9,-8,-9.7,.5-2.5,/25-1/15,/3,0-160,0.2-0.6,0.3-0.8,0.4-2.2,0.9-1.5,1,1-2.5,1-3.2,1-5,1.1,1.1-2.1,1.2-2,1.4-2.6,1.4-3.1,1.6-2.3,1.9-2.6,1/2,1/3,1/4-1/2,10-26,10.3-13.2,12-14,2-12,2.1-2.6,2.5-3.7,2.8-5.3,2.9-5,2/3,24-45,3-5,3.5-5,3.8-5.7,31,4.5-5.7,4.7-25.9,5-8,5.5-,5.5-8.8,7.5-9,8-17,abaxially,accrescent,acuminate,acute,adaxiall,adaxially,ag,along,angled,anther,anthesi,apart,apex,apparently,appressed,around,articulated,ascending,attenuate,axe,axillary,bark,base,becoming,berry,blade,blunt-tipped,branch,branched,broadly,brown,bud,calyx,capitat,chartaceous,closely,cm,completely,conical,constricted,corolla,covering,cylindrical,dark,densely,diameter,directed,distally,distributed,drying,eaf,echinoi,echinoid,echinoid-pubescent,edge,eed,elongated,entire,enveloping,especially,evident,exserted,farinose,filament,flared,fleshy,flower,free,fruit,fruiting,glabrescen,glabrescent,glabrous,globose,granular,granular-tomentose,green,greenish-brown,grooved,hair,immature,inserted,lanceolate,lateral,leaf,length,lengthening,less,light,line,lined,lobe,lobed,long,long-stalke,long-stalked,longer,longitudinal,longitudinally,lower,m.,main,many,margin,matur,midrib,midvein,minute,mm,multangulate,multangulate-pubescent,nearly,nflorescence,obtuse,occasional,occuring,older,opening,openly,orolla,ovate,ovate-lanceolat,ovate-lanceolate,pale,pedicel,peduncle,perfect,persistent,petiole,plurifoliate,pore,poricidal,porrect-stellate,present,pseudo-terminal,pubescence,pubescent,rachi,rather,ray,rich,ridged,robust,ruit,runk,scabrous,sessile,short,short-stalked,shrub,side,simple,slightly,slit,small,sometimes,somewhat,soon,spaced,sparsely,stalk,stalked,stamen,stellate,stem,stigma,strongly,style,subcampanulate,subcoriaceous,subglabrous,subglobose,suture,tall,tamen,tangled,terete,thick,thin,time,tip,tomentose,tomentose-pubescent,tomentum,touching,tree,tube,ud,unarme,unarmed,unit,upper,usually,vary,vein,violet,way,white,whitish,wide,x,yellow,ympodial,young	
70	wfo-0001026686	exception_thrown	196	0	0	196	0	0.0		.4,0.2-0.5,0.6-0.9,1,1-10,1-2,1-2.5,1.2-3.4,1.2-3.6,1.5-7,1.7-2.5,10-28,2-10,2-9,2.4-3.6,2.5-8,3-4,3-5,3.7-8,4-6,5,5-16.5,5-8,5-merou,6.5-12.7,7-9,8-10,8-14,8-27,abaxially,absent,acumen,acuminate,adaxially,ag,along,alyx,anther,apart,apex,apparently,articulated,axe,axillary,base,berry,blade,borne,brownish,bud,capitat,cell,chartaceous,ciliate,cm,condition,conical,connivent,corolla,covering,decreasing,densely,diameter,digestion,distal,dorsally,drying,eaf,edge,eed,elliptic-lanceolate,end,enzyme,equal,erec,especially,exceeding,filament,flat,flower,folded,forked,fresh,fruit,geminat,generally,glabrou,glabrous,gradually,green,green-white,greenish,hair,hair-like,half,herb,homostylous,honeycomb-shaped,interjected,lanceolate,larger,lateral,leaf,leaflet,lengthening,light,like,living,lobe,long,lower,make,margin,middle,midrib,minute,minutely,mm,mottled,mucilaginous,nflorescence,obtuse,odd-pinnate,often,orbicular,orolla,ovate,ovoid,pair,pedicel,peduncle,perfect,petiole,petiolule,plant,plurifoliate,pore,poricidal,puberulent,pubescen,pubescent,purple,purple-violet,removed,ripe,rotate-stellate,round,ruit,secondary,seed,semierect,seudostipule,singly,size,slightly,slit,spaced,sparsely,specimen,stamen,star,ste,stigma,stolo,straight,stripe,style,subequal,subsessile,subtending,symmetrical,tall,tamen,tem,terminal,testal,thick,throughout,tip,toward,tri-,tube,tuber,typically,unit,usually,vary,wall,wet,white,whitish,wide,wing,x,yellow,ympodial	
71	wfo-0001026696	success	139	135	73	66	62	0.525	0.8-7,1,1-4,2-3,3-3.5,4-16,abaxially,adaxially,apex,apical,apically,base,branched,calyx,cell,cm,connate,corolla,covering,cuneate,cyme,decurrent,dehiscent,densely,dichasial,dichasially,distal,ebracteate,entire,filament,flower,forked,generally,globose,green,hair-like,half,herbaceous,honeycomb,introrse,lateral,light,long,lower,margin,maturing,mm,monochasial,odd-pinnate,often,pattern,pedicel,perennial,perfect,petiole,plant,poricidally,proximal,pubescent,rounded,short,simple,sinuate,slit,stellate,testal,thick,tuber-bearing,typically,unit,wall,white-cream,Â¼	0.3-4.5,0.9-7.2,1-1.3,1.3-2.1,1.5-3,2-17,3-17,3-6,3-6-foliat,3-8.5,5-35,9,acumen,acute,apiculate,articulate,broadly,diameter,digestion,dorsally,eaf,edge,eed,emoval,enzyme,exceeding,flat,folded,globo,green-white,lanceolate,light-yello,linear,living,lobe,lon,lunat,make,mucilaginous,nflorescence,nther,oblong,obtuse,orolla,ovate,ovoid,peduncle,plan,reveal,ruit,seed,seudostipule,specimen,stamen,stigma,straight,style,tal,tem,throughou,throughout,vary,wide,without,yellow,ympodial	3-6-foliate,anther,appressed,articulation,bract,branching,breeding,broad-based,colour,connective,form,fruit,fruiting,growth,hair,heteromorphism,inflated,inflorescence,insertion,interjected,interpetalar,leaf,leaflet,length,light-yellow,lunate,marking,mature,modification,needle-like,null,odour,orientation,paired,placement,pore,poricidal,position,prickle,pseudostipule,rhizome,scale,shape,smell,spot,staman,stem,stone,structure,surface,symmetry,sympodial,system,tall,texture,tissue,trichome,tuber,type,vegetative,xylopodia,zygomorphy
72	wfo-0001026706	exception_thrown	232	0	0	232	0	0.0		-3.1,-4.4,-5.5,-6.1,.5,/14-1/6,0-240,0.2-0.3,0.2-0.5,0.6-2.2,0.8-1.2,0.8-1.5,0.8-2.8,0.9-1.9,0.9-2,1-2.2,1-5,1.1-4,1.5-3,1/2-2/3,10-15,12,14-32,2.2-3.3,2.3-3.8,2.5-3,2.7-4,2.9-6,2/3-3/4,3-4.6,3.1-3.8,3.6-5.7,4,4.2-12,4.5-5.5,5-6.5,5.3-6.4,6-10,6-8,6.1-,7-16,8-14,9.8-15.4,abaxially,accrescent,acute,adaxiall,adaxially,ag,anther,anthesi,apart,apex,apparently,appearing,around,articulated,attenuate,axe,axillary,ba,bark,base,becoming,berry,blade,blunt-tipped,branch,branched,brown,bud,calyx,capitat,chartaceous,closely,cm,completely,coriaceous,corolla,covering,crisped,cuneate,cylindrical,dark,dendritic-echinoid,dendritic-multangulate,densely,diameter,directed,distally,eaf,edge,eed,entire,enveloping,exserted,farinose,filament,fleshy,flower,fourth,free,fruit,fruiting,furfuraceou,glabrate,glabrous,globose,golden,grayish,green,hair,herbarium,indument,inserted,lackin,lacking,lanceolate,lateral,leaf,length,lengthening,lobe,lobed,long,long-stalked,longitudinal,lower,m.,main,many,margin,matted,midrib,minute,mixed,mm,multangulat,multangulate,nearly,nflorescence,oblong,obscured,obtuse,occasionally,often,older,orolla,ovate,ovate-elliptic,ovate-lanceolate,pale,pedicel,peduncle,perfect,persistent,petiole,plurifoliate,pore,poricidal,porrect-stellate,pseudo-terminal,pubescence,pubescent,rachi,rather,reddish,reticulate-punctate,ruit,runk,semi-ovate,sessile,short-,short-stalked,shrub,side,simple,slightly,slit,small,softly,somewhat,soon,spaced,sparsely,specimen,splitting,stalked,stamen,stellate,stem,stigma,strongly,style,subcampanulate,subconical,subglobose,suborbicular,sulcate,surface,suture,tall,tamen,thin-walled,time,tip,tomentose-pubescent,tomentu,touching,translucent,transparent,tree,tube,ud,unarme,unarmed,unevenly,unit,upper,vary,vein,velutinous,wavy,way,white,whitish,wide,x,yellow,yellowish-tan,ympodial,young	
73	wfo-0001026707	success	196	178	129	67	49	0.658	-1/3,-3,-5,.5,.8,/3,0,0-20,0.05,0.05-0.15,0.3-0.8,0.5-1,0.5-3,1/3-1/2,1/3-3/4,1/4-1/3,1/8-1/4,11-16,2-10,2.5-6,3-4,3-7,4,5-10,?,acute,anther,apart,apex,apparently,attenuate,bark,base,berry,blade,branche,branched,broadly,calyx,chartaceous,clustered,cm,concolorous,decurrent,discolorous,drying,eaf,elongating,entire,equal,erect,eye,filament,foliaceous,free,fruit,fruiting,fused,glabrescent,glabrous,gray,green,inflated,known,lateral,leaf,length,less,lobe,lobed,long,longer,lower,margin,mature,mauve,midpoint,mm,moderately,naked,narrow-deltate,narrow-oblong,older,pedicel,petiole,plurifoliat,poricidal,porrect-lepidote,portion,prickle,pubescent,ray,red-brown,rounded,sessile,shorter,shrub,simple,small,sometimes,spaced,sparsely,spherical,stalk,stalked,stellate,stellate-pubescent,stem,straight,surface,terete,terminal,time,tip,tree,trichome,tube,unarmed,unit,variously,venation,visible,way,weakly,white,wide,yellow-green,ympodial,Â¼	0.1-0.2,0.6-0.7,0.6-0.8,0.7-1,0.7-1.4,0.7-1.5,1-1.7,1-3,1-5,1.5-1.8,1.6-2,1/3,2-2.3,2-6,2.5-3,2.5-4,3-4.5,3-8,5-25,5-7,5-8,5-merous,8-15,abaxially,alyx,apar,apically,articulated,broad-deltate,color,connivent,curved,cuspidat,densely,diameter,eed,flattened-reniform,flower,gently,glabrou,infructescence,juvenil,nflorescence,obtuse,one,open,orange-brown,orolla,oung,peduncle,per,perfec,pericarp,porrect,prickly,reflexed,ruit,scar,slender,smooth,spreading,stout,style,tamen,tapering,upper,vary	+,appressed,articulation,bract,branching,breeding,broad-based,cell,colour,connective,corolla,form,growth,hair,heteromorphism,inflorescence,insertion,interjected,interpetalar,leaflet,marking,mentioned,modification,needle-like,odour,orientation,paired,pattern,perfect,placement,pore,position,pseudostipule,rhizome,scale,shape,smell,spot,staman,stone,symmetry,system,texture,tissue,tuber,type,vegetative,xylopodia,zygomorphy
74	wfo-0001026711	success	210	124	73	137	51	0.348	.5,0.5-1.5,0.8,1-30,1/4-1/3,3-5,3.5-5.2,acicular,anther,apart,apex,apparently,articulated,base,berry,blade,branched,calyx,cell,cm,cuneate,densely,difoliate,elongating,equal,erect,filament,fruit,fruiting,lateral,leaf,length,less,lobe,lobed,long,lower,margin,mature,maturity,mauve,mm,occasionally,orange,pedicel,perpendicular,petiole,poricidal,prickle,prickly,purple,red,reflexed,rounded,shallowly,shrub,sometimes,somewhat,spaced,spherical,stellate,stellate-pubescent,stem,straight,surface,terminal,thick-chartaceous,tip,trichome,unarmed,unit,weakly,wide	-15,-2,-5,-6,-7,.2,.8,0,0-0.2,0-25,0-4,0-6,0.1,0.15,0.2-0.3,0.3-1,0.7-,0.7-0.9,0.7-1.4,0.75-1,0.8-2.2,0.9-1.1,0.9-1.5,1-,1-2,1.5-,1.5-2.2,1.7-4,1/,1/2-2/3,1/3,1/4,2-2.2,2-2.5,2-3.5,2-4,2-6,2.1-2.5,3-4,3-4.5,3-7,4-8,4.5-7,5-merous,7-8,abaxially,acuminat,acute,alyx,ame,apar,apically,bark,brow,c.,concolorous,connivent,curved,deltate,diameter,discolorous,distance,drying,dull,eaf,eed,elliptic,evenly,extending,faint,flattened-reniform,flower,free,geminat,glabrous,green,infructescence,longer,midpoint,midvein,moderately,narrow-deltate,nflorescence,obtuse,older,one,open,orange-brown,orolla,oung,outline,pair,pale,peduncle,pendulous,per,perfec,pericarp,pit,porrect,portion,prickl,primary,raised,ray,reduced,ruit,scar,sessile,shorter,side,slender,small,smooth,spreading,stalk,stalked,style,tamen,tapering,terete,tertiary,time,tube,uniform,upper,variously,vary,vein,venation,visible,way,woody,yellow,yellow-green,ympodial,young	appressed,articulation,bract,branching,breeding,broad-based,colour,connective,corolla,form,geminate,growth,hair,heteromorphism,inflated,inflorescence,insertion,interjected,interpetalar,leaflet,marking,mentioned,modification,needle-like,odour,orientation,paired,pattern,perfect,placement,pore,position,pseudostipule,rhizome,scale,shape,smell,spot,staman,stone,structure,symmetry,sympodial,system,texture,tissue,tuber,type,vegetative,xylopodia,zygomorphy
75	wfo-0001026717	exception_thrown	207	0	0	207	0	0.0		0.3-0.6,0.3-2.5,0.3-5,0.6-1.5,0.8,1-10,1-2,1-2.5,1-3,1.3-2.5,1.4-2.2,1.8-3,13-28,14-22,15-34,2.2-5,2.5-4.5,2.5-5.5,3-4,3-5,3-6,3.3-11,4-6,4-8,4-9,5,5-11,5-13.5,5-6,5-merou,5.3-9,7-11,abaxially,acumen,acuminate,adaxially,ag,along,alyx,anther,apart,apex,apparently,articulated,attenuate,axe,axillary,base,berry,blade,borne,brownish,bud,capitat,cell,chartaceous,ciliate,cm,condition,conical,connivent,corolla,covering,dark,darker,decreasing,decurrent,diameter,digestion,distal,dorsally,drying,eaf,edge,eed,elliptic,end,enzyme,equal,erec,especially,exceeding,filament,flat,flower,folded,forked,fresh,fruit,geminat,generally,glabrou,glabrous,gradually,green,green-white,greenish,hair,hair-like,half,herb,homostylous,honeycomb-shaped,interjected,lanceolate,larger,lateral,leaf,leaflet,lengthening,light,like,living,lobe,long,lower,make,margin,medium,membranous,middle,midrib,minute,minutely,mm,mottled,mucilaginous,narrow,nflorescence,obtuse,odd-pinnate,often,one-quarte,orbicular,orolla,ovate,ovoid,pair,pedicel,peduncle,pentagonal,perfect,petiole,petiolule,plant,plurifoliate,pore,poricidal,present,puberulent,pubescen,pubescent,purple,removed,ripe,rotate,round,ruit,secondary,seed,semierect,sessile,seudostipule,singly,size,slightly,slit,spaced,sparsely,specimen,stamen,ste,stigma,stolo,straight,stripe,style,subequal,subglabrous,subsessile,subtending,symmetrical,tall,tamen,tem,terminal,testal,thick,throughout,tip,toward,tri-,tube,tuber,typically,unit,usually,vary,violet,wall,wet,whitish,wide,wing,x,yellow,ympodial	
76	wfo-0001026725	exception_thrown	166	0	0	166	0	0.0		.3,.5,/4,0.2,0.7-1.2,1-1.2,1-1.5,1-4.5,1-5,1.2-1.7,1.5,1.5-2,1.6-2,1/2,2,2.2-4,3.5-4,3.6-7.7,5-20-flowered,5-5.5,5-6,8-18.6,8-9,accrescent,acute,anther,anthesi,apart,apex,attenuate,axil,bark,base,becoming,beneath,berry,black,bluish,broadly,brownish-papillose,calyx,capitate,character,cm,corolla,crackin,cup-shaped,dark,deflexed,dia,differing,difoliate,dry,drying,eaf,edicel,eed,ellipsoid,elliptic,evenly,extremely,filament,flattened-reniform,free,fruit,fruiting,geminat,geographically,glabrous,glandular-papillose,globose,green,greenish-white,incrassate,inflorescenc,interpetalar,large,lateral,leaf,less,lobe,lobed,lon,long,lower,main,major,margin,margine,material,middle,minor,minutely,mm,nflorescence,occasionally,often,older,one,onto,open,opposite,ovary,ovate,ovoid,pair,pale,paler,papillo,papillose,pedicel,petiole,pitted,planar,pore,poricidal,portion,prominent,proximal,pubescent,reddish-brown,reflexed,rounded,ruit,scar,scarious,shaped,short,shrub,simple,sinus,size,slender,slightly,spaced,split,stem,stigma,straight,stretching,style,subshrub,surface,tall,tan,tapering,tear-drop,tip,triangular,trichome,tube,tuft,ud,uniseriate,unit,upper,varying,vein,way,white,widest,winged,woody,x,ympodial,young	
77	wfo-0001026733	exception_thrown	188	0	0	188	0	0.0		-1,-11,-13,-14,-15,-2,-4,-7,-8,.5-3,0.3-0.5,0.3-2,0.5,0.5-1,0.5-2,0.5-4,1,1-1.5,1-2,1-3,1-7,1.5-14,1.5-2,1.5-2.5,10-20,15-,2-2.5,2-3,2-4,2-6,2.5-7.5,20-50,25-40,3-15,3-3.5,3-4-foliat,3-7,4,4-23,4-5,4.5-5,5-8,7-10,8-12,abaxially,acuminate,acute,acute-acuminate,adaxially,aggregate,apart,ape,apex,articulated,axe,basal,base,beyond,blade,calyx,capitat,cell,chartaceous,ciliat,cm,color,connective,connivent,cordate,curled,cylindrical,deltate,dense,densely,dia,diameter,directed,distally,eaf,eed,eglandular-pilose,eglandular-pubescent,eglandular-villous,ellipsoidal,elliptic-ovate,entire,equal,especially,exceeding,exserted,flattened,flower,forked,fruit,fusiform,glabrate,glabrous,gland-tipped,glandula,glandular-,glandular-puberulent,glandular-tomentose,green,greyish,hair,hirsute,immature,lanceolate,leaving,linear-triangular,lobe,lon,long,longitudinal,lower,margin,membranaceous,midrib,mm,moderately,narrowly,near,nflorescence,nther,oblique,orolla,ovate,ovoid,ovum,pedicel,pedicellar,peduncle,perfect,petiole,pilose,pore,present,pubescent,pubescent-pilo,pubescent-pilose,rachi,radiu,remnant,ripe,round,ruit,shining,shorter,simple,slightly,small,smooth,sometimes,spaced,sparsely,stamen,stellate,stigma,stone,stripe,style,submarginally,swelling,tal,tem,thecae,time,toward,tree,triangular,truncate,tube,ud,unbranched,unit,unknow,unknown,usually,vary,vein,villous,white,white-puberulent,wide,x,yellow,yellowish,ympodial	
78	wfo-0001026734	success	266	226	161	105	65	0.605	0.1,0.3,0.5,0.6,1,1/4,3,8,abaxial,absent,accrescent,acuminate,adaxial,adaxially,always,anther,apex,apical,articulated,asymmetric,axi,barely,base,becoming,beneath,berry,blade,branch,branched,broadly,calyx,camptodromous,celled,central,chartaceous,closely,cm,commonly,congested,corolla,covered,cuneate,cyme,dark,densely,diameter,differing,directed,discolorous,distally,downward,drying,elliptic,entire,fewer,flower,foliate,free,frequently,fruit,geminate,glabrescent,glabrous,glandular,globose,green,growth,hair,held,immature,initially,internodal,introrsely,lamina,lateral,leaf,length,less,lobed,long,long-attenuate,longer,longitudinal,lower,margin,mature,maturity,membranaceous,midpoint,midri,minute,mm,moderately,much,multiseriate,near,nflorescence,normally,obovate,obtuse,old,one,opening,other,ovate,pair,paired,pale,pedicel,peduncle,perfect,petiole,plane,pore,poricidal,porrect,porrect-stellate,portion,pubescent,purple,purplish,rachi,raised,rarely,ray,reaching,rounded,scandent,secondary,sessile,shape,short-stalked,shorter,shrub,simple,size,slightly,slit,smaller,sometimes,spaced,sparsely,spread,stalk,stellate,stem,still,subopposite,subsessile,surface,terminal,trichome,unbranched,unequal,uniseriate,unit,vein,venation,visible,white,wide	0.2,0.7â0.9,0.7â1,0.8â1,1.6â2,1.6â2.5,1.8â2.2,1.8â3,1â1.2,1â3,2.2â7,2.3â5,2.5â3,2â2.4,2â3,3.2â3.8,3â4,3â4-celled,3â8,4â6,4â7,4â8,4â9,5-merou,5â9,abaxially,acute,adaxiall,ag,also,alyx,anthesi,apice,archin,ark,associated,beneat,bright,brown,caly,capitate,clavate,connivent,covering,cylindrical,dense,denser,dried,due,eaf,eed,eglandular,emergent,erect,f.,flat,flattened,forked,found,glabrescen,gray,ilament,irregular,j,lanceolate,large,lobe,lying,material,maturit,mostly,narrow,new,oblong,observed,often,older,one-celled,orolla,oung,ovary,papillose,pit,pointing,pubescence,rayed,reniform,ruit,shiny,sparse,spreading,stigma,style,surfac,tube,tuft,ud,upward,vary,vestiture,whole,yellow,yellowish,ympodial,Â¾	1-3,1.6-2,2-3,2.2-7,2.3-5,3-4,3-8,3/4,4-6,4-8,4-9,5-9,5-merous,age,appressed,arching,articulation,bract,branching,breeding,broad-based,cell,colour,connective,filament,form,fruiting,heteromorphism,inflated,inflorescence,insertion,interjected,interpetalar,larger,leaflet,marking,mentioned,midrib,modification,needle-like,none,odour,orientation,pattern,placement,position,prickle,pseudostipule,rhizome,scale,smell,spot,staman,stone,structure,symmetry,sympodial,system,texture,tissue,tuber,type,vegetative,xylopodia,zygomorphy
79	wfo-0001026740	success	171	83	28	143	55	0.164	1-5,absent,apex,base,branched,calyx,cell,connective,ellipsoidal,fruit,greenish,hair,lower,margin,mature,pedicel,petiole,pore,present,purple,small,stellate,stone,tree,unbranched,unit,whitish,yellow	-17,-2,0-10,0.5-1,1-10,1-12,1-2,1-3,1-4,10-20,10-30,2-3,2-4,2.5-27,2.5-3,2.5-4.5,2.5-6,20-50,3-15,3-3.5,3-5,3-foliat,3.5-40,4-5,4.5-10,5-40,5-8,6-10,8-19,abaxially,absen,acuminate,acute,acute-acuminate,adaxially,aggregate,also,apart,ape,apiculate,articulated,axe,basal,beyond,blade,browni,ciliate,cm,connivent,cordate,corky,curled,cylindrical,darker,deltate,densely,diameter,directed,distally,eaf,eed,eglandular,elliptic,entire,equal,especially,exceeding,exserted,flattened,fleshy,flower,glabrate,glabrous,glandular-puberulent,immature,lanceolate,leaving,lobe,lon,long,mm,moderately,narrowly,near,nearly,nflorescence,nther,oblong,obtuse,often,orange,orolla,ovate,ovoid,pedicellar,peduncle,perfect,pilo,pilose,puberulent,pubescent,rachi,radiu,rarely,remnant,reticulate,ruit,scar,sessile,shorter,simple,slightly,sometimes,spaced,sparsely,stamen,stigma,stripe,style,subcoriaceous,swelling,tal,tems,thecae,time,tomentose,toward,triangular,truncat,truncate,tube,ud,unlobed,vary,vein,villous,violet,white-puberulent,wide,woody,x,ympodial,young	anther,appressed,articulation,bract,branching,breeding,broad-based,colour,corolla,filament,form,fruiting,growth,heteromorphism,inflated,inflorescence,insertion,interjected,interpetalar,leaf,leaflet,length,marking,modification,needle-like,none,odour,orientation,paired,pattern,placement,position,prickle,pseudostipule,rhizome,scale,shape,smell,spot,staman,stem,structure,surface,symmetry,sympodial,system,tall,texture,tissue,trichome,tuber,type,vegetative,xylopodia,zygomorphy
80	wfo-0001026752	success	169	142	84	85	58	0.497	-3,-4,0-,1-12,1-2,1-3,1-5,2.5-20,4-45,abaxially,abruptly,adaxially,aggregate,also,apex,basal,base,black,blade,branched,calyx,campanulate,cell,chartaceous,cm,connective,cordate,cuneate,darker,densely,directed,distally,ellipsoidal,elliptic-oblong,elliptic-ovate,entire,fleshy,forked,fruit,globose,green,greenish-brown,hair,immature,lanceolate,laterally,lobe,long,lower,margin,mm,moderately,near,pedicel,petiole,pilose,pore,possibly,presence,pubescent,pubescent-pilose,purplish,rarely,rather,ripe,short-acuminate,simple,small,somewhat,stellate,stone,stripe,time,tree,truncate,unbranched,unit,vein,violet,white,whitish,wide,x,yellow	-25,-50,1,1-1.5,1-6,1.5-12,1.5-2,1.5-2.5,10-20,15-35,2,2-2.5,2-3,2-4,2.5-5,20-30,3,3-18,3-4,3-5,3-foliat,3.5-4,4-5,7-15,8-16,absent,acute,apart,ape,apiculate,articulated,axe,beyond,capitat,connivent,coriaceous,cylindrical,deltate,diameter,dilated,eaf,eed,equal,exceeding,exserted,finely,flattened,flower,glabrous,leaving,less,lon,narrowly,nearly,nflorescence,nther,obtuse,orolla,ovoid,papillose,pedicellar,peduncle,perfect,pilo,present,rachi,radiu,remnant,ruit,slightly,spaced,stamen,stigma,style,tal,tem,thecae,tomento,triangular,tube,ud,unknow,vary,yello,ympodial	3-foliate,anther,appressed,articulation,bract,branching,breeding,broad-based,colour,corolla,filament,form,fruiting,growth,heteromorphism,inflated,inflorescence,insertion,interjected,interpetalar,leaf,leaflet,length,marking,mature,mentioned,modification,needle-like,odour,orientation,paired,pattern,placement,position,prickle,pseudostipule,rhizome,scale,shape,smell,spot,staman,stem,structure,surface,symmetry,sympodial,system,tall,texture,tissue,trichome,tuber,type,unknown,vegetative,xylopodia,zygomorphy
81	wfo-0001026754	exception_thrown	176	0	0	176	0	0.0		-6+,.5,0.5,0.5-1,0.9-1.1,1,1-,1.5-3,1/2,10,198.,2,2-2.5,2-3,2-4,2.5-3.5,2/3,3-4-celled,30+,4-5,5,5-lobed,5-merou,5.5-9,7-9,9,9-11,abaxially,acute,adaxially,ag,along,alyx,anther,anthesi,apar,apex,apparently,ark,articulated,asymmetric,axi,basal,base,berry,branched,broadly,brow,cabrera,calyx,clavate,cm,complete,conical,connivent,corolla,cucullat,deeply,dendritic,densely,denser,diameter,distal,divided,eaf,ed,ellipsoid,elliptic,entire,especially,exerted,extending,fide,filament,flower,free,glabrous,globose,growth,half,halfway,ilament,inflorescence,irregularly,lamina,later,lateral,leaf,leaving,lengthening,like,lobe,lobed,long,loosely,lower,many,margin,mature,membranous,midvein,minute,minutely,mixture,mm,mostly,narrowly,new,nflorescence,oblique,older,orolla,outline,pair,papillo,pedicel,peduncle,peg,perfect,petiole,pinnate,planar,plurifoliat,pore,poricidal,portion,primary,puberulent,pubescent,ruit,scandent,scar,seen,simple,sleeve,slender,slit,small,sometimes,spaced,sparsely,splitting,spreading,stellate-rotate,stem,stigma,style,surface,tangled,tem,terminal,time,tip,transparent,trichome,truncate,tub,tube,twinin,twining,ud,uniseriate,unit,upper,vary,vein,vine,way,weak,white,within,woody,x,yellow,yellowish,ympodial	
82	wfo-0001026756	exception_thrown	147	0	0	147	0	0.0		.25,.5,0-7-1.2,0.25-0.5,0.5-1,0.5-3,1-1.5,1-2,1.5-1.7,1.5-10,1.5-2,1.5-3,1.8-3,3-4,3.5-8.5,5-10,5-10-flowered,5-5.5,6-10,6-16,abaxial,abaxially,acute,adaxially,along,anther,anthesi,apex,apiculate,attenuate,ba,bark,base,berry,bilobed,broadly,brown,calyx,closely,cm,conical,corolla,corresponding,dark,deflexed,deltate,dendritic,densely,denser,dia,differing,difoliate,distal,eaf,edicel,eed,elliptic,erect,exserted,filament,fleshy,free,fruiting,geminat,glabrescent,glabrous,globose,grayish-brow,green,hard,inflorescenc,irregular,lamina,lateral,lax,leaf,like,lobe,lobed,long,lower,main,major,middle,minor,minutely,mm,nearly,nflorescence,occasionally,older,opposite,ovary,ovate,overlappin,ovoid-reniform,pair,pale,papillo,pedicel,perhaps,pericarp,petiole,pinkish-white,pitted,planar,pore,poricidal,portion,present,pubescence,pubescent,rest,ruit,scar,shape,shaped,shrub,simple,somewhat,soon,spaced,sparsely,stem,stigma,strongly,style,surface,tall,tear-drop,thick,tip,tree,trichome,tub,tube,ud,unifoliate,uniseriate,unit,vein,white,wide,widest,woody,ympodial,young	
83	wfo-0001026777	exception_thrown	168	0	0	168	0	0.0		.25,.5,/3,0.25-0.5,0.5-1,0.5-1.5,0.5-5,0.9-3,1-1.3,1-1.5,1-10,1-2,1-4,1.2-1.8,1.5-3,1.5-5,2-4,2-4.5,2-5,3-3.5,4-8,5-14,5-50-flowered,5-7,acuminate,acute,anther,anthesi,apart,apex,apiculate,axil,ba,base,beginning,beneath,berry,blue,body,branching,brown,calyx,campanulate,capitate,cell,cm,corolla,cup,decurrent,deflexed,dense,dia,differing,difoliate,distal,eaf,edicel,eed,elliptic,end,exserted,fide,filament,filiform,flattened,flattened-reniform,flexuous,free,fruiting,geminat,glabrate,glabrous,globose,green,greyi,growth,hyaline,incrassate,inflorescenc,irregularly,lateral,leaf,like,lobe,lobed,lon,long,lower,main,major,margin,matted,middle,minor,minutely,mm,narrowly,near,nearly,new,nflorescence,occasionally,often,older,one,onto,opposite,outline,ovary,overtopping,pair,papillo,papillose,pedicel,petiole,pitted,planar,pore,poricidal,portion,prominent,pubescent,quadrate-deltoid,quite,rest,ruit,russet,scar,seed,shaped,shiny,shrub,sinuate,size,slightly,smooth,somewhat,soon,spaced,sparsely,stem,stigma,straight,style,surface,tall,tapering,tear-drop,testa,thread-like,tip,trichome,tube,tuft,ud,uniseriate,unit,vein,vellozo,wall,way,white,widest,woody,x,yellowish,ympodial,young	
84	wfo-0001026819	exception_thrown	218	0	0	218	0	0.0		0-27,0.3-4.7,0.5-1.5,1-10,1-2,1-2.3,1-5,1.2-36,1.5-10,1.5-12,1.5-3.0,1.5-3.3,1.5-3.5,1.6-3.5,10,10-26,2-5,2-6,2.5-5,3-120,3-18,3-20,3-35,3-38,4,4-10,4-7,5-30,5-merou,6-11,7,abaxially,absent,acumen,acuminate,acute,adaxially,ag,along,alyx,anther,apart,apex,articulated,ascending,attenuate,base,bearing,blade,blue,borne,broadly,brownish,bud,capitate,cell,chartaceous,ciliate,clavat,cm,condition,connate,connivent,corolla,covering,cuneate,curved,dark,decurrent,densely,diameter,digestion,distal,dorsally,dot,drying,eaf,edge,eed,elliptic,end,enzyme,erec,especially,exceeding,filament,flat,flower,folded,forked,fresh,fruit,geminat,generally,glabrou,glabrous,glaucous,globose,greatly,green,green-white,greenish,greenish-yellow,hair,hair-like,half,herb,homostylous,honeycomb-shaped,interjected,lanceolate,larger,lateral,leaflet,lengthening,light,like,living,lobe,long,lower,lunate,make,margin,membranous,middle,midvein,minutely,mm,moderately,mottled,mucilaginous,narrowly,nflorescence,non-glandular,oblique,odd-pinnate,often,orolla,ovate,ovoid,pair,pedice,pedicel,peduncle,pentagonal,petiole,petiolule,plant,plurifoliate,pore,poricidal,puberulent,pubescent,purple,rachi,ranging,removed,rotate-pentagonal,ruit,scale-like,scattered,seed,seudostipule,short,singly,slightly,slit,sometimes,somewhat,spaced,specimen,stamen,star,ste,stem,stigma,stolo,straight,stripe,style,subequal,subglabrous,suborbicular,subrosette,subtending,symmetrical,tall,tamen,tem,terminal,tertiary,testal,therefore,thick,throughout,tinged,tip,tri-,truncate,tube,tuber,typically,unit,unwinged,usually,vary,violet,wall,wet,white,whitish,wide,wing,within,without,yellow,ympodial	
85	wfo-0001026821	success	204	173	121	83	52	0.593	0.2-1.5,0.3-1.2,0.3-2.5,0.5-3.5,1-1.5,1-3,1-5,1.5-2.5,2-15,2-3.5,2-6,2-celled,3-11,3-18,3-7,3-branched,3-celled,5-34,acuminate,adaxial,anther,apex,apical,appressed,articulated,auriculate,basal,base,berry,blade,bract,broadly,cell,cm,cordate,cuneate,dark,directed,distal,distally,ellipsoidal,elliptic,especially,filament,forked,frequent,fruit,gglobose,glabrous,gland-tipped,greatly,green,hair,herb,homostylous,incurved,interjected,lanceolate,large,lateral,leaf-opposed,leaflet,length,light,long,long-attenuate,longitudinal,lower,lowermost,margin,mature,membranous,minute,mm,moderately,much,oblique,obliquely,oblong,obtuse,occasional,occasionally,odd-pinnate,one-celled,opening,pair,paired,pale,pedicel,petiole,petiolule,pilose,plurifoliate,pore,present,pseudostipular,pubescent,rachi,rarely,reduced,reniform,rounded,scandent,slender,slit,smaller,somewhat,sparsely,stellate,stripe,subglabrous,substellate,surface,terminal,time,tri-,unbranched,unit,white,wide,x	.2,/3,0-20,0.4-1.5,0.5-1.2,0.7-1.8,0.8-1,1-2,1-20,1.2-1.5,10-15,17,1977,2.5-18,3-6,4-4.5,5-10,5-12,5-20,5-merou,abaxially,acut,adaxially,ag,alyx,anderson,angular,apart,apically,apiculate,axe,ba,bayonet,brown,chartaceous,ciliat,deltate,diameter,due,eaf,eed,equal,exceeding,flattened,flower,fused,geminat,glabrou,interstaminal,lobe,many,mean,membrane,minutely,narrowly,nflorescence,orolla,peduncle,per,perfect,puberulent,pubescen,remnant,ruit,seudostipule,short,slightly,small,spaced,stamen,stigma,style,subtended,tamen,tem,thickening,truncat,tube,vary,wall,winged,yellow,ympodial	'bayonet,acute,age,articulation,branching,breeding,broad-based,calyx,colour,connective,corolla,form,fruiting,geminate,growth,heteromorphism,inflated,inflorescence,insertion,interpetalar,leaf,marking,modification,needle-like,null,odour,orientation,pattern,placement,position,prickle,pseudostipule,rhizome,scale,shape,smell,spot,staman,stem,stone,structure,symmetry,sympodial,system,texture,tissue,trichome,tuber,type,vegetative,xylopodia,zygomorphy
86	wfo-0001026827	exception_thrown	143	0	0	143	0	0.0		.5,/3,0.2-0.5,0.4-0.6,0.5-2,0.6-1,1-,1-1.1,1-1.5,1-2,1-2.1,1.3-1.6,1.5-2,2-2.2,2-2.5,2-4,3-9,5-6,7-9,?,abaxially,acute,adaxiall,age,and/or,anther,anthesi,apart,apex,appearing,arachnoid,attenuate,bark,base,branch,branched,broadly,calyx,clavate,cm,conical,corolla,crowded,deciduou,deltate,dendritic,dense,densely,diameter,distally,dry,drying,eaf,ellipsoid,erect,especially,exerted,filament,fleshy,flower,free,glabrescent,glabrous,growth,inflorescence,internodal,irregularly,know,known,lamina,lanceolate,leaf,lengthening,less,like,lobe,lobed,lower,margin,minutely,mm,narrowly,near,new,nflorescence,nodding,oblanceolate,ot,ovary,pair,paler,papillat,papillate,pedicel,peduncle,perfect,petiole,planar,plane,plurifoliat,pore,poricidal,portion,primary,pubescent,rachi,reddish,revolute,scar,shrub,simple,sinus,slender,slit,small,soon,sparsely,stem,stigma,stout,straight,strongly,style,surfac,surface,terminal,thick,thickened,third,tip,trichome,tub,tube,ud,uniseriate,unit,upper,vein,way,white,widest,x,ympodial	
87	wfo-0001026830	success	198	152	99	99	53	0.5	0-10,0.3-1.3,0.4-1,0.5-1.0,1-2,4-14.5,4-7,4.4-14.5,abaxially,adaxially,along,anther,apex,arranged,asymmetric,attenuate,axillary,base,basiscopic,bead,berry,blade,brownish,bud,cell,ciliate,cm,coriaceous,corolla,deep,distal,filament,finely,forked,fruit,generally,glabrescent,glabrous,globose,green,hair,half,herb,high,homostylous,interjected,lanceolate,leaf,leaflet,lengthening,light,like,long,lower,margin,medium,mm,moderately,moniliform,multiple,necklace,odd-pinnate,orbicular,ovate,pedicel,pentagonal,petiole,petiolulate,plant,plurifoliate,pore,poricidal,puberulent,pubescent,purple,ripe,rotate,rounded,sessile,short,side,simple,slit,stolon,stripe,subglabrous,subtending,tall,terminal,tip,tissue,tri-,tuber,typically,unit,white,whitish,x,yellowish	0.5-1.2,0.9-1.9,1-10,1-11,1.1-2.7,1.4-4,1.5-4,10-57,2-4,2-6,2.5-4.4,2.5-5,2.7-8,3.5-8.5,4-10,4.5-17.5,5-11,5-merou,6-13,7-18,acumen,acuminate,acute,adaxiall,ag,alyx,apart,apparently,articulated,axe,brown,capitat,clavate,condition,connivent,covering,decreasing,diameter,digestion,dorsally,drying,eaf,edge,eed,elliptic,enzyme,erec,exceeding,flat,flower,folded,fresh,geminat,glabrou,green-white,greenish,hair-like,hal,honeycomb,lateral,linear,living,lobe,make,mucilaginous,nflorescence,orolla,ovoid,pair,peduncle,perfect,removed,ruit,seed,seudostipule,shaped,size,spaced,specimen,stamen,stigma,straight,style,subequal,subglabrou,tamen,tem,testal,thick,throughout,toward,tube,unwinged,usually,vary,wall,wet,yellow,ympodial	age,appressed,articulation,bract,branching,breeding,broad-based,calyx,colour,connective,erect,form,fruiting,geminate,growth,heteromorphism,inflated,inflorescence,insertion,interpetalar,length,marking,mature,modification,needle-like,null,odour,orientation,paired,pattern,placement,position,prickle,pseudostipule,rhizome,scale,shape,smell,spot,staman,stem,stone,structure,surface,symmetry,sympodial,system,texture,trichome,type,vegetative,xylopodia,zygomorphy
88	wfo-0001026831	exception_thrown	207	0	0	207	0	0.0		-0.25,-5,-6.5,-9,.5,/4,0-10,0-20,0-3,0-6,0.1,0.1-0.2,0.1-0.25,0.15-0.25,0.2-0.4,0.2-1,0.3-0.6,0.3-0.65,0.5-1.2,0.6,0.6-2,0.65-1,0.7-1.1,0.7-2,1-10,1-2,1-2.2,1-2.5,1-3,1-4,1-6,1.2-2,1.5-2.5,1/3,1/3-1/,1/3-2/3,1/5-1/4,2-2.5,2-3,2-4,2.3-2.9,2.5-4.5,3-5,3-6,3.5-10,5-merous,7-10,7-8,abaxially,acute,alyx,anther,apar,apart,apex,apically,apparently,articulated,attenuate,bark,base,berry,blade,branched,bright,broad-deltate,brow,calyx,caudat,cell,chartaceous,cm,concolorous,connivent,cream,curved,dark,deltate,densely,diameter,difoliate,distance,drying,dull,eaf,eed,elliptic,elongating,equal,erect,extending,eye,filament,flattened-reniform,flower,free,fruit,fruiting,fully,geminat,glabrescent,glabrous,gray-brown,green,herbaceous,infructescence,lateral,leaf,length,less,lobe,lobed,long,longer,lower,margin,marking,mature,maturity,mauve,membranous,midpoint,midvein,mm,moderately,multangulate,naked,narrow-cuneate,nflorescence,oblong,occasionally,older,one,open,opening,orange,orange-brown,orolla,oung,outline,ovate,pair,pale,pedicel,peduncle,pendulous,per,perfec,pericarp,petiole,poricidal,porrect,portion,prickl,prickle,prickly,primary,raised,ray,red-brown,reduced,rounded,ruit,scandent,scar,sessile,shiny,shorter,shrub,side,slender,smooth,sometimes,spaced,sparsely,spherical,spreading,stalk,stellate,stellate-pubescent,stem,style,subsessile,surface,tamen,tapering,terete,tertiary,time,tip,trichome,tube,unit,upper,usually,vary,vein,venation,visible,way,white,white-gray,wide,yellow,yellow-green,ympodial,young	
89	wfo-0001026841	exception_thrown	139	0	0	139	0	0.0		.25,.5,/4,0.05,0.25-0.3,0.25-0.5,0.5-0.75,0.5-1,0.5-2,0.6-1,0.75-1,0.8-1,0.8-3,1.5,1.5-2,2-2.5,3-6.5,3.5-5,4-8,5-8-flowered,6-8,7-9,9.2-18,acute,along,anther,anthesi,apart,apex,arch,axi,ba,bark,base,beneath,berry,bi-lobed,broadly,calyx,clavate,cm,conical,coroll,corolla,curly-tipped,decurrent,deflexed,deltoid,dia,eaf,edicel,eed,ellipsoid,elliptic,exsertion,filament,filiform,free,fruiting,glabrate,glabrous,globose,green,greyish-gree,hyaline,immature,inflorescence,joined,known,later,lateral,leaf,like,lobe,lobed,lon,long,lower,main,margin,middle,minutely,mm,nflorescence,older,opposite,ovary,pair,paler,papillo,papillose,pedicel,petiole,pore,poricidal,portion,prominent,pubescent,raised,reddish,reflexed,rest,ruit,scar,series,shaped,shining,shrub,simple,slender,slightly,spaced,sparsely,stem,stigma,straight,style,tall,tapering,tear-drop,terminal,thickened,tip,trichome,tube,ud,unevenly,unifoliat,uniseriate,unit,vein,way,white,widest,winged,woody,x,ympodial,young	
90	wfo-0001026849	success	180	156	109	71	47	0.606	-50,0.5-1,1,1-1.5,1-2,1-6,11,2,2-3,30-,38/2,40,5-10,637/2,adherent,adult,anther,apex,appearing,aster,axil,base,berry,calyx,cell,cm,colour,conical,conspicuous,corolla,cut,cyme,developed,emarginate,entire,erect,exceeding,facetted,filament,flowered,fork,free,fruiting,glabrous,globular,greater,green,growth,hair,half,inflorescence,large,lavender,leaf,leave,lengthening,linear-lanceolate,lobe,long,long-cuneate,lower,margin,mature,maturity,mid-vein,mm,oblong,oblong-lanceolate,often,pedicel,petal,petiole,pore,poricidal,preparation,pruinose,rarely,relatively,reproducing,rh,rotate,rounded,sea,seed,shallow,short-lived,shrub,simple,sinus,slightly,slit,soft-wooded,sometimes,somewhat,stem,stone,stout,surface,thus,tip,tissue,unarmed,undulate,vegetatively,violet,way,well,x,young	0-10,1.5-2.5,1.75-2,100-130,5,7-8,80-,acute,amongst,aspect,australian,brown,capitate,composed,curved,deflexed,dia,discoidal,distinct,distinctly,eed,ellipsoid,enlarge,except,exerted,expanded,filled,flesh,floral,flower,general,glandular,globose,granule,gree,grey-brown,interacuminal,less,little,lon,loosely,minute,minutely,native,nflorescence,occasionally,ovary,pal,pale,pedicellate,peduncle,plurifoliat,purple,reticulate,rhachi,ruit,ruiting,shed,slende,solanum,solitary,soon,stigma,stony,style,tub,tube,ud,unit,uvenile,ympodial	appressed,articulation,bract,branching,breeding,broad-based,connective,enlarged,form,fruit,heteromorphism,inflated,insertion,interjected,interpetalar,juvenile,leaflet,length,marking,minuteglandular,modification,needle-like,odour,orientation,paired,pattern,placement,plurifoliate,position,prickle,pseudostipule,rhizome,scale,shape,smell,specified,spot,staman,symmetry,system,texture,trichome,tuber,type,vegetative,xylopodia,zygomorphy
91	wfo-0001026858	success	153	131	70	83	61	0.458	0.8,1-4,1.5-4,2-3,3-4,6-18,abaxially,adaxially,apex,apical,apically,base,branched,calyx,cell,cm,connate,cordate,corolla,cuneate,cyme,dehiscent,dichasial,dichasially,distal,ebracteate,filament,forked,generally,glabrescent,glabrous,globose,green,hair-like,half,herbaceous,honeycomb,interjected,introrse,lateral,leaf,leaflet,light,long,lower,maturing,mm,monochasial,oblique,odd-pinnate,often,pattern,pedicel,perennial,perfect,petiole,plant,poricidally,proximal,shiny,short,slightly,slit,stellate,testal,tuber-bearing,typically,unit,wall,Â¼	-30,-4,0-.,0.5,0.8-1,1-,1-10,1-11.5,1-5,1.3-1.5,2-2.5,2-4,2.5-3,3-,3-6-foliat,4-24,4.5-10.5,5-15,6-10,6-7,abruptly,acumen,acute,articulate,covering,diameter,digestion,diminishing,dorsally,eaf,edge,eed,emoval,enzyme,exceeding,flat,flower,folded,globo,green-white,living,lobe,lon,lunat,make,minute,mucilaginous,mucronate,nflorescence,nther,oblong,obtuse,orolla,ovate,ovate-lanceolate,ovoid,pair,peduncle,plan,reveal,rounded,ruit,seed,seudostipule,size,specimen,stamen,stigma,straight,style,tal,tem,thick,throughou,throughout,toward,triangular,vary,white-crea,wide,without,yellow,ympodial	0-2,3-6-foliate,anther,appressed,articulation,bract,branching,breeding,broad-based,colour,connective,form,fruit,fruiting,growth,hair,heteromorphism,inflated,inflorescence,insertion,interpetalar,length,lunate,margin,marking,mature,modification,needle-like,null,odour,orientation,paired,placement,pore,poricidal,position,prickle,pseudostipule,rhizome,scale,shape,smell,spot,staman,stem,stone,structure,surface,symmetry,sympodial,system,tall,texture,tissue,trichome,tuber,type,vegetative,white-cream,xylopodia,zygomorphy
92	wfo-0001026895	exception_thrown	166	0	0	166	0	0.0		.5,0-0.5,0.5-1,0.5-1.2,0.5-1.5,0.5-2,0.8-1,1-1.5,1-5,1.4-2.1,1.5-2,2-2.3,2-2.5,2-3,2.5-3.2,2/3,3-12,4.5-5,5-6,5-8-flowered,abaxial,acute,adaxial,along,anther,anthesi,apex,apical,apically,appearing,attenuate,ba,bark,base,berry,borne,broad,broadly,brown,calyx,campanulate,capitate,closely,cm,conical,contracted,corolla,dark,deflexed,deltoid,dendritic,denser,dia,differing,difoliate,drying,eaf,edicel,eed,ellipsoid,elliptic,elongate,erect,filament,filiform,flattened,free,fruiting,geminat,glabrate,glabrous,globose,green,hard,incrassate,internodal,lamina,lateral,leaf,like,lobe,lobed,lon,long,long-exserted,lower,main,major,margin,middle,minor,minute,minutely,mm,mustard,narrowly,nflorescence,obovate,often,older,ovary,overlappin,pair,pale,papillo,pedicel,pericarp,petiole,pitted,pointed,pore,poricidal,portion,present,projection,pubescent,reddish,reddish-brow,reniform,ruit,scar,scattered,shape,shaped,shoot,short,shrub,shrublet,side,simple,size,small,somewhat,soon,spaced,sparsely,stem,stigma,style,surface,swollen,swollen-based,tall,tan,tear-drop,thin,tip,toothed,trichome,tub,tube,tuft,type,ud,uniseriate,unit,usually,vein,way,white,widest,woody,x,yellow,ympodial,young	
93	wfo-0001026905	success	204	150	101	103	49	0.495	-2,-2/3,-4,.5,0,0.15,0.5-1.5,1-20,1-6,1/2-3/4,1/3,1/4,1/5-1/3,2-3,anther,apart,apex,apically,apparently,attenuate,base,berry,blade,branched,calyx,cell,chartaceous,cm,connivent,cream,curved,dark,densely,difoliate,discolorous,distance,drying,dull,elongating,equal,erect,extending,filament,fruit,fruiting,glabrous,gray-green,green,inflorescence,lateral,leaf,length,lobe,lobed,long,lower,margin,marking,mature,maturity,mauve,midvein,mm,orange,orange-brown,pale,pedicel,petiole,poricidal,porrect,prickle,prickly,red,rounded,sessile,shallowly,shrub,side,sometimes,spaced,spherical,stalk,stalked,stellate,stellate-pubescent,stem,straight,subentire,surface,tapering,trichome,unarmed,unit,variously,way,weakly,white,wide,yellow,yellow-green,young	-1.5,-10,-3,.2,0-2,0-20,0-25,0.1,0.2-0.3,0.2-0.5,0.3-0.4,0.4,0.4-0.9,0.4-1,0.5-0.7,0.6-0.7,0.7-1.4,0.75-1.1,0.9-1.3,1,1-2,1-2.5,1-3.7,1-4,1.9-2.5,2.5-2.9,2.5-3.5,2/3-3/,3-5,3-8,5-6,5-merous,6-8,7-8,abaxially,acuminat,acute,alyx,ame,apar,articulated,bark,brow,c.,deltate,diameter,eaf,eed,eye,flattened-reniform,flower,free,geminat,infructescence,longer,midpoint,moderately,naked,oblong,older,one,open,orolla,oung,outline,ovate,pair,peduncle,pendulous,per,perfec,pericarp,pit,portion,prickl,primary,raised,ray,reduced,ruit,scar,shorter,slender,small,smooth,somewhat,sparsely,spreading,style,tamen,terete,tertiary,time,tip,tube,upper,usually,vary,vein,venation,visible,woody,ympodial	appressed,articulation,bract,branching,breeding,broad-based,colour,connective,corolla,form,geminate,growth,hair,heteromorphism,inflated,insertion,interjected,interpetalar,leaflet,modification,needle-like,null,odour,orientation,paired,pattern,perfect,placement,pore,position,pseudostipule,rhizome,scale,shape,smell,spot,staman,stone,structure,symmetry,sympodial,system,texture,tissue,tuber,type,vegetative,xylopodia,zygomorphy
94	wfo-0001026923	success	177	158	107	70	51	0.605	-5,.1-0.3,.5,0.5-1,1-3,1-4,1-7,2,2-2.5,2-3,2-6,20-50,4-18,4-5-,5-9,abaxially,accrescent,adaxially,anther,apex,apparently,articulated,base,black,blade,branched,calyx,chartaceous,cm,covering,cuneate,densely,denser,diameter,directed,distally,elliptic,elliptic-ovate,entire,equal,filament,flower,forked,fruit,fruiting,geminate,glabrescent,glabrous,globose,green,hair,intermediate,large,leaf,leaf-opposed,like,lobe,long,longitudinal,lower,many-foliate,margin,midvein,mm,moderately,much,multangulate,nearly,oblong,opening,paired,pedicel,peltate,perfect,petiole,pore,possibly,pubescence,pubescent,purple,red,ripening,rounded,scale,sessile,shrub,simple,slightly,slit,small,smaller,sometimes,sparsely,stellate,stem,subtending,surface,time,tree,trichome,unit,usually,white,whitish,wide,x,yellowish	0-5,0.25-0.5,0.5,0.6-0.8,0.8-1,1,1-1.5,1.5-2,1.5-4,10,3-4,3-5,5-10,5-15,5-6,absent,acuminate,acute,adaxiall,ag,apart,axe,ba,brown,capitat,center,connivent,curved,cylindrical,deltate,eaf,eed,eglandular,erect,flattened,frui,fused,gland-tippe,glandular,held,lanceolate,lateral,light,midpoint,nflorescence,orange,orolla,peduncle,rachi,ray,relatively,rugulose,ruit,short,somewhat,spaced,ste,stigma,straight,strongly,style,tal,tamen,tem,tip,tube,uprigh,vary,yellow,ympodial	age,appressed,articulation,bract,branching,breeding,broad-based,cell,colour,connective,corolla,form,growth,heteromorphism,inflated,inflorescence,insertion,interjected,interpetalar,leaflet,length,marking,mature,modification,needle-like,null,odour,orientation,pattern,placement,position,prickle,pseudostipule,rhizome,shape,smell,spot,staman,stone,structure,symmetry,sympodial,system,tall,texture,tissue,tuber,type,vegetative,xylopodia,zygomorphy
95	wfo-0001026925	success	215	146	97	118	49	0.451	-2,0,0-20,0-7,0.5-4,1-3.5,1.5-4.5,1/3-1/2,1/4-2/3,1/6-1/3,2-4,3-20,3-7,5-6,6-8,acute,andromonoecious,anther,apart,apex,apically,apparently,articulated,attenuate,base,berry,blade,calyx,chartaceous,cm,connivent,cream,curved,dark,deltate,distance,elongating,erect,extending,filament,flattened,flower,fruit,fruiting,gently,glabrescent,glabrous,green,hair,heterostylous,lateral,leaf,length,lobe,lobed,long,long-styled,lower,margin,marking,mature,maturity,mauve,membranous,midvein,mm,moderately,oblong,pale,pedicel,petiole,poricidal,prickle,reflexed,rounded,short-styled,shrub,side,spaced,spherical,stellate,stellate-pubescent,stem,straight,surface,tapering,terete,terminal,tip,trichome,unit,way,white,wide,yellow,yellow-orange,young	.5,/6,0-10,0-5,0.1,0.1-0.2,0.1-0.3,0.2,0.5-1.5,0.7-1.8,0.9-1.8,00-200,1-1.3,1-1.4,1-25,1-3,1-4,1.5-2,1.5-2.5,1.8-2,1.8-2.5,1/3,2-5,2.4-2.6,2.4-3,2.5-6,2/,4-10,4-14,4-5,4-7,5-8,5-merous,5.5-10,6-10,6-17,7-12,abaxially,acuminat,alyx,ame,apar,bark,branched,broad-deltate,brow,c.,concolorous,diameter,distal,drying,eaf,eed,elliptic,equal,flattened-reniform,free,green-brown,hermaphrodite,infructescence,lobing,longer,lowermost,midpoint,minute,narrow-deltate,nflorescence,older,one,open,orange-brown,orolla,oung,ovate,pair,peduncle,pendent,pendulous,per,pericarp,plant,plurifoliat,porrect,portion,prickl,prickly,primary,rarely,ray,red-brown,reduced,ruit,scar,secondary,sessile,simple,smooth,sometimes,sparsely,spreading,stalk,stalked,staminat,stout,style,tamen,tertiary,time,translucent,tube,unarmed,upper,vary,vein,venation,visible,woody,ympodial	appressed,articulation,bract,branching,breeding,broad-based,cell,colour,connective,corolla,form,growth,heteromorphism,inflated,inflorescence,insertion,interjected,interpetalar,leaflet,mentioned,modification,needle-like,odour,orientation,paired,pattern,placement,plurifoliate,pore,position,pseudostipule,rhizome,scale,shape,smell,spot,staman,stone,structure,symmetry,sympodial,system,texture,tissue,tuber,type,vegetative,xylopodia,zygomorphy
96	wfo-0001026946	success	205	139	84	121	55	0.41	0-20,0.5-2,1-2,1-4,3-20,5-7,anther,apex,articulation,axillary,base,berry,borne,bud,cell,chartaceous,cm,corolla,creamy,deeply,densely,distal,end,extremely,filament,forked,fruit,generally,glabrous,globose,green,hair,half,herb,homostylous,interjected,lanceolate,leaflet,lengthening,like,long,lower,margin,membranous,mm,oblique,odd-pinnate,orbicular,ovate,ovoid,pedicel,pentagonal,petiole,petiolulate,plant,plurifoliate,pore,poricidal,proximal,pubescent,pure,purple,ripe,rounded,sessile,short,singly,slightly,slit,stellate,stem,streak,subtending,tall,terminal,tip,tri-,truncate,tuber,typically,unit,variable,white,yellow-white	0-5,0.9-3.5,0.9-4.3,1,1-10,1.5-2,1.6-3.7,10-39,12-23,2,2-15,2-5,2.5-10.5,2.7-9,3-5,3-6,3.5-10,4-7,4.1-9.4,5-merou,6-24,8-15,8-25,abaxially,acumen,acuminate,acute,adaxially,ag,along,alyx,apart,apparently,attenuate,axe,blade,broadly,brownish,capitat,ciliate,clavate,condition,connivent,covering,diameter,digestion,dorsally,dot,drying,eaf,edge,eed,elliptic,enzyme,erec,especially,exceeding,except,flat,flower,folded,fresh,geminat,glabrou,greatly,green-white,greenish,hair-like,honeycomb-shaped,lateral,living,lobe,make,midrib,minutely,mottled,mucilaginous,narrowly,nflorescence,often,orolla,pair,peduncle,perfect,petiolule,puberulent,pubescen,reduced,removed,ruit,scattered,seed,seudostipule,short-pubescent,size,spaced,specimen,stamen,ste,stigma,stolo,straight,style,subequal,tamen,tem,testal,thick,thir,throughout,tube,unwinged,usually,vary,wall,wet,whitish,wing,x,yellow,ympodial	age,appressed,bract,branching,breeding,broad-based,calyx,colour,connective,erect,form,fruiting,geminate,growth,heteromorphism,inflated,inflorescence,insertion,interpetalar,leaf,length,marking,mature,modification,needle-like,null,odour,orientation,paired,pattern,placement,position,prickle,pseudostipule,rhizome,scale,shape,smell,spot,staman,stolon,stone,structure,surface,symmetry,sympodial,system,texture,third,tissue,trichome,type,vegetative,xylopodia,zygomorphy
97	wfo-0001026962	exception_thrown	205	0	0	205	0	0.0		.05,.5,0,0.3-0.7,0.5,0.5-0.8,0.5-1,0.5-1.5,0.8-1,1,1-1.2,1-1.5,1-2,1-3,1-4.5,1-6,1.5-17,1.5-2,1.5-3,1.5-5,10-12,10-20,15-22,2-2.5,2-5,2-6,2/3-3/4,3-3.5,3-6,4-5,6-7,9-12,9-17,abaxially,abrupt,abruptly,accrescent,acute,adaxially,ag,alyx,anther,anthesi,apex,apparently,appearing,arising,articulated,axe,bark,base,basebud,becoming,beneath,blade,brittle,broadly,bud,calyx,capitat,cell,chartaceous,closely,cm,composed,connivent,constricted,corolla,cucullat,cylindrical,darker,deflexed,deltate,densely,denser,diameter,differing,difoliate,dimorphic,dry,eaf,eed,elliptic,elongate,entire,evenly,except,exerted,filament,flattened-reniform,flower,free,fruit,fruiting,geminat,glabrate,glabrou,glabrous,globose,green,ilament,incrassate,inflorescence,internodal,later,lateral,leaf,like,lobe,lobed,long,longitudinal,main,major,margin,material,minor,minutely,mm,narrowly,nflorescence,obconic,oblong,obovoid,occasionally,often,older,one,opening,opposite,orolla,oung,outline,ovate-lanceolate,overlapping,packed,pair,pale,papillose,paten,pedicel,peduncle,pendent,perfect,petiole,pitted,pore,portion,prominent,pubescen,pubescent,purplish,rachi,raised,reflexed,remaining,rest,rounded,rounder,ruit,sagittate,shaped,shrub,simple,size,slender,slightly,slit,small,sometimes,somewhat,soon,stellate,stem,stigma,straight,style,surface,tal,tapering,tear-drop,tinged,tip,tooth,tree,triangular,trichome,trunk,tube,unarmed,unbranched,unifoliate,uniseriate,unit,vary,vein,way,whit,white,woody,x,yellow,yellowish,ympodial,young	
98	wfo-0001026964	success	128	127	73	55	54	0.57	.5,0.5,0.5-1,1-2.5,2-4,3.5-7,4.5-8.5,acuminate,acute,along,anther,apex,attenuate,axillary,basal,base,bearing,berry,calyx,cm,conical,corolla,differentiated,equal,filament,filiform,fleshy,flower,fruiting,glabrous,green,greenish,herb,lateral,leaflet,lightly,lobed,long,long-attenuate,lower,margin,minutely,mm,nearly,obovate,often,onto,pair,papillate,pedicel,petiole,petiolule,pinnate,poricidal,primary,pubescent,purple,rachi,shape,simple,size,small,sparsely,surface,terminal,tip,trichome,uniseriate,unit,vein,winged,x,yellow	.2,0,1-1.2,10,10-30,2-2.5,3-5,7-8,?,anthesi,beak,capitat,conspicuously,diameter,distinct,eaf,edicel,elliptic,erec,exserted,free,glabrou,globose,horizontal,immature,known,lenticellate,line,lobe,nflorescence,noddin,one,open,ot,ovary,portion,purpli,reflexed,rugose,ruit,scar,side,slender,smooth,somewhat,stigma,style,tal,tem,time,tub,tube,ud,unifoliat,ympodial	appressed,articulation,bract,branching,breeding,broad-based,cell,colour,connective,form,fruit,growth,hair,heteromorphism,inflated,inflorescence,insertion,interjected,interpetalar,leaf,length,marking,mature,modification,needle-like,null,odour,orientation,paired,pattern,placement,pore,position,prickle,pseudostipule,rhizome,scale,smell,spot,staman,stem,stone,structure,symmetry,sympodial,system,texture,tissue,tuber,type,unifoliate,vegetative,xylopodia,zygomorphy
99	wfo-0001026981	exception_thrown	252	0	0	252	0	0.0		-0.4,-0.8,-14,-2,-2.5,-35,-4,-8,.2,.2-0.2,0-5,0.05-0.1,0.1-0.2,0.1-0.3,0.15-0.2,0.2,0.2-0.4,0.2-2,0.25-0.4,0.3-0.5,0.3.6,0.4-0.5,0.4-0.7,0.4-2,0.45-1.3,0.5,0.5-0.3,0.5-30,0.6-1.4,0.6-2,0.7-0.8,0.8-1.2,0.8-6,0.9-1.4,0.9-1.5,1,1-2,1-2-cellular,1-3,1-3-celled,1-3.3,1-4,1.5-2.0,1.5-5,1.5-8.5,1.8-2.8,1/3,11,196.,2-3,2-3-branched,2-locular,3-foliate,3.5-14,4,4-8,4-celled,6-10,7.5,<,abaxially,absen,absent,abundant,academy,accrescent,acute,adaxially,adpressed,along,amongst,angled,anther,anthesi,apex,apical,appearance,appendage,appressed,articulated,articulation,asymmetric,axi,base,basiscopically,bay,beak,becoming,bract,bracteole-like,brown,calyx,capitate,cell,citrus-like,cm,coastal,column,composed,cone,conical,cordate,corolla,d,dark,deltate,densely,diameter,distal,eaf,ebracteate,edicel,eed,entire,erect,exserted,filament,flower,fruit,fruiting,giving,glabrescent,glandular,globose,gree,green,hair-like,half,halfway,head,herb,imparipinnate,included,initially,interjected,internode,interrupted,irregularly,jointles,larger,later,lateral,leaf,leaflet,less,like,lime,linear,lobe,lobed,lon,long,lower,mainly,margin,maturity,minutely,mixed,mm,much,multicellular,narrowly,nflorescence,obovate,occasionally,orange,orbicular,outgrowth,ovary,ovate,pair,pale,patent,pedicel,peduncle,pentagonal,per,perennial,petiole,petiolule,plant,population,present,primary,procumbent,pronounced,proximal,pseudostipule,pubescence,pubescent,rachi,reflexed,rick,robust,rounded,ruit,scen,secondary,see,sessile,several,shaggy,shaped,short,shorter,silky,simple,slender,smaller,sometimes,sparsely,sparser,specimen,spreadin,staminal,stem,sterile,stigma,straight,strong,style,surface,tangled,tem,terminal,tertiary,testa,thick,tightly,transparent,trichome,tub,tube,type,uni-,unicellular,uniseriate,unit,upto,usually,variously,velvety,villous,viny,wall,wide,winged,without,yellow,ympodial,â,â	
100	wfo-0001026992	exception_thrown	243	0	0	243	0	0.0		-2.5,/7,0.2-0.5,0.25-0.45,0.5-1.2,0.6-1.5,0.8-3.4,00-170,1-4,1.2-1.4,1.2-1.7,1.3-2.6,1.3-4.3,1.4-1.6,1.4-1.9,1.5-3.4,1.7-1.9,1.7-2.4,1.7-4.3,1/2,10-12,12-33,2-10,2-5.6,2.3-3.3,2.6-4.6,2.8-4.6,2.8-4.7,3-4,3.3-5.5,3.3-5.6,4-8,5-15,5-merou,5.3-12.1,6-10,8,8-11,8-14,abaxial,abaxially,abruptly,accrescent,acuminate,acute,adaxiall,adaxially,ag,along,alyx,angled,anther,anthesi,apart,apex,apparently,appressed,approximately,around,articulated,attenuate,axe,axillary,ba,bark,base,berry,blade,blunt-tipped,branch,branched,broadly,brown,calyx,capitat,chartaceous,cm,completely,coriaceous,corolla,covering,crown,cylindrical,dark,deltoid,densely,diameter,directed,distally,drying,eaf,echinoi,echinoid,edge,eed,elliptic,entire,enveloping,equal,evident,exserted,farinose,filament,flat-topped,fleshy,flower,forming,free,fruit,fruiting,geminate,glabrescen,glabrous,globose,granular-tomentose,greenish,grooved,hair,high,homostylous,immature,inserted,lacking,lance-ovate,lanceolate,lateral,leaf,length,lengthening,less,line,lobe,lobed,long,long-stalked,longitudinal,longitudinally,lower,m.,main,many,margin,mature,maturity,midrib,minute,mm,moderately,mostly,multangulate,nearly,nflorescence,oblong,obtuse,occasional,occasionally,often,older,orange-tan,orolla,ovate,ovate-lanceolate,overlapping,pedicel,peduncle,perfect,petiole,plant,plurifoliate,pore,poricidal,porrect-stellate,pubescence,pubescent,rachi,rare,rather,reniform,reticulate-punctate,ripe,ruit,runk,scabridulous-,semi-ovate,sessile,short,short-,short-stalked,shorter,shrub,side,simple,size,slit,small,sometimes,somewhat,spaced,sparingly,split,spreading,stalked,stamen,stellate,stem,stigma,stout-stalked,style,subcampanulate,subglobose,surface,suture,tamen,tan,terete,terminal,thin-textured,time,tip,tomentose,tree,tube,ud,unarme,unarmed,unequal,unit,usually,vary,vein,velutinous,violet,way,weakly,white,whitish,wide,x,yellow,yellowish,ympodial,young,Â½	
101	wfo-0001026994	exception_thrown	266	0	0	266	0	0.0		-0.7,-10,-20,-30,-foliate,.2,.5,0.05-0.1,0.05-0.2,0.1,0.1-0.2,0.1-0.3,0.15-0.2,0.2-0.4,0.2-0.5,0.25,0.3-0.4,0.4-0.5,0.4-1.2,0.5,0.5-0.6,0.5-0.7,0.5-0.8,0.5-0.9,0.5-1.2,0.5-1.3,0.5-2,0.7-2.5,0.9-1.2,0.9-1.3,1,1-1.2,1-1.4,1-1.5,1-1.6,1-2,1.2-1.6,1.2-3.5,1.4-2.1,10-20,12-,2,2-,2-2.6,2-4,2-5-locular,2.2-3.2,2.5-6.5,20-50,3,3-branched,4,4-15,4-celled,5,5-,5-7,6-20,7-13,8,8-12,abaxially,absent,abundant,acroscopically,acuminate,acute,additional,adpressed,along,also,amongst,andscattered,anther,anthesi,apex,apical,apically,appearance,appendage,articulate,articulation,basal,basally,base,basiscopically,becoming,beneath,bent,berry,bifurcate,bifurcation,bract,bracteate,branched,bright,broader,broadly,brown,calyx,capitate,cell,celled,cm,column,conical,corolla,crenat,crenate,crowded,dark,darker,decreasing,decumbent,decurrent,deeply,densely,developed,diameter,distal,eaf,ebracteate,edicel,eed,eglandular,elliptic,erect,especially,essentially,exserted,fewer,filament,flower,fruit,fruiting,giving,glabrous,glandular,globose,grayish,gree,green,greenish,habitat,hair-like,hal,half,halfway,head,herb,imparipinnate,inflorescence,interjected,internode,interrupted,investing,irregularly,lamina,lanceolate,large,larger,largest,lateral,leaf,leaflet,leave,less,like,lobe,lobed,locule,lon,long,loosely,lower,margin,markedly,medial,midvein,minutely,mm,moderately,much,narrower,narrowing,narrowly,nearly,nflorescence,node,oblique,obovate,occasionally,often,outgrowth,ovary,pair,paler,papillate,pedicel,peduncle,perennial,petiole,petiolule,present,primary,pseudostipule,puberulent,pubescent,purple,rachi,rarely,reflexed,regularly,ripe,robust,rocky,rotate-stellate,secondary,sessile,set,shaggy,short,silky,simple,sinus,size,slightly,sometimes,sparsely,specimen,spreadin,spreading,staminal,stem,sterile,stigma,straight,stripe,style,surface,tall,tem,terminal,tertiary,testa,thick,tip,toward,trichome,tube,ud,unicellular,uniseriate,unit,usually,velvety,wall,weak-walled,well,white,wide,winged,woody,yellow,ympodial,young	
102	wfo-0001026996	success	188	126	71	117	55	0.378	0-6,1-2,6-8,acumen,along,anther,apex,arranged,asymmetric,attenuate,axillary,base,basiscopic,bead,berry,blue,bud,cell,cm,coriaceous,corolla,dark,deep,filament,forked,fruit,glabrous,globose,green,herb,homostylous,interjected,lanceolate,leaf,leaflet,like,lilac,long,lower,medium,mm,moniliform,multiple,necklace,odd-pinnate,pedicel,pentagonal,petiole,petiolulate,plurifoliate,pore,poricidal,ripe,rotate,rounded,side,slightly,sometimes,stolon,stripe,subtending,symmetric,terminal,tip,tissue,tri-,tuber,typically,unit,usually,white	0.6-1,0.9-2.7,1-3,1-4,1-5,1.2-1.8,1.3-7.7,1.8-4.4,14-33,15-28,2-3,3-10,3-5,3-7,3.3-6,3.8-14.1,4-4.4,4-8,4.5-10.5,5-8,5-merou,6.9-10.9,8.7-18.6,abaxiall,abaxially,acuminate,acute,adaxially,ag,alyx,apart,apparently,articulated,axe,blade,brownish,capitat,clavate,condition,connivent,considerably,covering,decreasing,diameter,digestion,distal,dorsally,drying,eaf,edge,eed,elliptic,enzyme,erec,exceeding,flat,flower,folded,fresh,geminat,generally,glabrou,green-white,greenish,hair-like,half,honeycomb-shaped,larger,lateral,lengthening,linear,living,lobe,make,middl,mottled,mucilaginous,nflorescence,orbicular,orolla,ovate,ovoid,pair,peduncle,perfect,plant,purple,removed,ruit,seed,sessile,seudostipule,size,slit,spaced,specimen,stamen,stigma,straight,style,subglabrou,tall,tamen,tem,testal,thick,throughout,toward,tube,unwinged,vary,wall,wet,whitish,x,yellow,ympodial	appressed,articulation,bract,branching,breeding,broad-based,calyx,colour,connective,form,fruiting,geminate,growth,hair,heteromorphism,inflated,inflorescence,insertion,interpetalar,length,margin,marking,mature,middle,modification,needle-like,null,odour,orientation,paired,pattern,placement,position,prickle,pseudostipule,rhizome,scale,shape,smell,spot,staman,stem,stone,structure,subglabrous,surface,symmetry,sympodial,system,texture,trichome,type,vegetative,xylopodia,zygomorphy
103	wfo-0001027010	success	198	138	85	113	53	0.429	0-2,0.4-5.1,0.5-1.5,1-10,1-2,4-8,abaxially,acute,adaxially,along,anther,apex,arranged,asymmetric,attenuate,axillary,base,basiscopic,bead,bud,cell,cm,connivent,coriaceous,corolla,deep,distal,filament,forked,fruit,generally,glabrescent,glabrous,green,hair,half,herb,high,homostylous,interjected,lanceolate,leaf,leaflet,lengthening,light,like,long,lower,mm,moniliform,multiple,necklace,odd-pinnate,ovoid,pedicel,pentagonal,petiole,petiolulate,plant,plurifoliate,pore,poricidal,purple,ripe,rotate,rounded,scabrous,sessile,short,side,slit,spot,stolon,stripe,subtending,tall,terminal,tip,tissue,tri-,tuber,typically,unit,usually,white	0-2.5,0-3,1-4,1-7,1.2-1.7,1.2-1.9,1.4-6.9,10-60,14-46,2-6,2-9.4,2.1-15.3,2.1-4.3,2.2-12.9,3-10,3-5,3-6,3-8,3.5-13.6,4-12,4.4-29,4.9-31,5-13,5-14,5-merou,acumen,acuminate,adaxiall,ag,alyx,apart,apparently,articulated,axe,blade,brownish,capitat,clavate,coloration,condition,covering,decreasing,diameter,digestion,dorsally,drying,eaf,edge,eed,elliptic,enzyme,erec,exceeding,flat,flower,folded,fresh,geminat,glabrescen,glabrou,green-white,greenish,hair-like,hal,honeycomb-shaped,larger,lateral,living,lobe,make,mucilaginous,narrow,nflorescence,occasionally,orbicular,orolla,ovate,pair,peduncle,perfect,present,removed,ruit,scabrou,seed,seudostipule,size,slightly,sometimes,spaced,specimen,stamen,stigma,straight,style,subequal,tamen,tem,testal,thick,throughout,toward,tube,vary,wall,wet,whitish,wide,wing,winged,x,yellow,ympodial	age,appressed,articulation,bract,branching,breeding,broad-based,calyx,colour,connective,erect,form,fruiting,geminate,growth,heteromorphism,inflated,inflorescence,insertion,interpetalar,length,margin,marking,mature,mentioned,modification,needle-like,odour,orientation,paired,pattern,placement,position,prickle,pseudostipule,rhizome,scale,shape,smell,staman,stem,stone,structure,surface,symmetry,sympodial,system,texture,trichome,type,vegetative,xylopodia,zygomorphy
104	wfo-0001027019	exception_thrown	142	0	0	142	0	0.0		.5,/4,0-0.5,0.5-1,1-1.5,1-2,1.5-2,1.5-3,1/2,10,10-40-flowered,12-30,2-3,2-5,2-8,4-5,4-8.5,7-14,abaxial,abaxially,abruptly,acute,adaxially,along,anther,anthesi,apex,apparent,attenuate,ba,bark,base,berry,branched,bright,calyx,capitate,cm,constriction,corolla,cyathiform,deflexed,deltoid,densely,dia,difoliate,distal,eaf,edicel,eed,ellipsoid,elliptic,erect,even,exserted,filament,flattened,fleshy,free,fruiting,geminat,glabrate,glabrous,globose,golden,green,inflorescenc,inflorescence,largely,later,leaf,like,live,lobe,lobed,lon,long,lower,major,midrib,minor,minutely,mm,narrowed,nflorescence,obovate,older,onto,opposite,ovary,overlapping,ovoid-reniform,pale,papillo,papillose,pedicel,petiole,pitted,planar,plant,pore,poricidal,portion,pubescent,reddish-brow,rest,ruit,scar,shaped,shrub,small,somewhat,spaced,sparsely,stem,stigma,straight,strongly,style,surface,tall,tan,tapering,tear-drop,third,tip,tree,trichome,tub,tube,ud,unit,waxy,way,white,widest,wing,winged,woody,x,ympodial,young	
105	wfo-0001027030	exception_thrown	234	0	0	234	0	0.0		-11,-15,.2,.5,0-4,0.05-0.1,0.1-0.7,0.1-0.9,0.15-0.2,0.2,0.2-0.3,0.2-1,0.3-,0.3-0.5,0.3-0.7,0.4-0.5,0.4-0.8,0.4-1.5,0.5,0.5-,0.5-0.7,0.5-0.8,0.5-1,0.6-0.7,0.6-0.8,0.6-1.8,0.7-1,0.8-0.9,0.8-1,0.9-1.1,1,1-,1-1.2,1-1.3,1-3,1-3.4,1.2-1.6,1.5-,1.6-2,2-,2-3,2-4,2-4.8,2-6,2-7,2-foliate,2-locular,2.2-3.2,3-4-celled,3-8,3-9,4-celled,5-12,8-celled,abaxial,abaxially,absent,abundant,acuminate,acute,adaxially,adpressed,angled,anther,anthesi,apex,apical,appearance,appendage,articulated,articulation,axi,basal,base,basiscopically,beneath,berry,beyond,bract,branched,bright,brown,calyx,capitate,cell,cm,column,conical,corolla,crenat,crenate,crenation,dark,darker,decurrent,deeper,deeply,densely,denser,diamete,diameter,distal,due,eaf,edicel,eed,eglandular,elliptic,entire,evenly,exserted,extremely,filament,flower,fruit,fruiting,giving,gland,glandular,globose,grayish,gree,green,growt,hair-like,hal,half,halfway,herb,imparipinnate,inflorescence,interjected,internode,interrupted,interspersed,investing,irregularly,lamina,lanceolate,larger,lateral,leaflet,less,like,lobe,lon,long,longer,loosely,lower,margin,minutely,mm,multicellular,narrowly,near,nflorescence,node,oblique,obovate,occasionally,often,outgrowth,ovary,pair,pale,paler,papillate,pedicel,peduncle,perennial,petiole,petiolule,present,primary,pseudostipule,pubescence,pubescent,reflexed,robust,rotate-stellate,ruit,secondary,sessile,silky,similar,simple,size,slender,slightly,small,smaller,soft,sometimes,somewhat,sparsely,spread,spreadin,spreading,staminal,stem,sterile,stigma,straight,stripe,style,surface,tall,tem,terminal,tertiary,testa,thick,tiny,trailing,trichome,truncate,tube,ud,unicellular,uniseriate,unit,usually,vein,velvety,wall,weak,white,wide,winged,woody,yellow,ympodial,young	
106	wfo-0001027035	success	199	149	97	102	52	0.487	0-36,0.1-0.9,0.3-2.3,0.9-3.1,1-2,1-3.4,1-8,2.8-10.3,4.9-23.5,abaxially,adaxially,along,anther,apex,arranged,asymmetric,attenuate,axillary,base,basiscopic,bead,blade,blue,bud,cell,cm,coloration,completely,corolla,deep,distal,elliptic,filament,forked,fruit,generally,glabrescent,glabrous,globose,green,hair,half,herb,high,homostylous,interjected,lanceolate,leaf,leaflet,light,like,lilac,long,lower,medium,mm,moniliform,multiple,necklace,odd-pinnate,orbicular,ovate,ovoid,pedicel,pentagonal,petiole,petiolulate,plant,plurifoliate,pore,poricidal,purple,ripe,rotate,rounded,sessile,shape,short,side,sometimes,stolon,stripe,subtending,tall,terminal,throughout,tip,tissue,tri-,tuber,typically,unit,usually,variable,white,wide,x	0-7,0.4-12.8,0.5-3.4,0.5-5,0.5-7,0.8-3,0.8-4.2,1-3,1.5-5.9,1.7-8,1.8-5.2,10-80,2-38,2-7,3-10,3-5,4-18,4-18.5,5-merou,acumen,acuminate,acute,adaxiall,ag,alyx,apart,apparently,articulated,axe,brownish,capitat,clavate,condition,connivent,covering,decreasing,diameter,digestion,dorsally,drying,eaf,edge,eed,enzyme,erec,exceeding,flat,flower,folded,fresh,geminat,glabrescen,glabrou,green-white,greenish,hair-like,hal,honeycomb,larger,lateral,lengthening,living,lobe,make,mucilaginous,nflorescence,orolla,pair,peduncle,perfect,present,removed,ruit,second,seed,seudostipule,shaped,size,slightly,slit,smaller,spaced,specimen,stamen,stigma,straight,style,subequal,subglabrous,tamen,tem,testal,thick,toward,tube,unwinged,vary,wall,wet,whitish,yellow,ympodial	appressed,articulation,bract,branching,breeding,broad-based,calyx,colour,connective,erect,form,fruiting,geminate,growth,heteromorphism,inflated,inflorescence,insertion,interpetalar,length,margin,marking,mature,modification,needle-like,null,odour,orientation,paired,pattern,placement,position,prickle,pseudostipule,rhizome,scale,smell,spot,staman,stem,stone,structure,surface,symmetry,sympodial,system,texture,trichome,type,vegetative,xylopodia,zygomorphy
107	wfo-0001027050	exception_thrown	244	0	0	244	0	0.0		-12,-9,.2,.5,/3,0-0.2,0-3,0.1-0.3,0.1-3,0.2-0.5,0.2-1,0.3-1.5,0.5-3,0.8,0.9-2.1,1,1-1.5,1-2,1.5-2,1.5-6,10-13.5,12-15,15-50+,2-2.5,2-3,2-4,2-5,2-8,2.5-3,3-5,4-20,4-8,5,5-10,5-6,5-7,5-9,5-merous,50,6-8,7-30+,8-26,abaxial,abaxially,absen,absent,abundant,acuminate,acute,adaxial,adaxiall,adult,alyx,andromonoeciou,anther,apar,apex,arme,articulated,axe,bark,basal,base,berry,blade,branch,branched,broad,broad-based,broadly,brow,brown,calyx,capitate,chartaceous,closely,cm,coarsely,conical,connivent,cordate,cuneate,curved,deeply,densely,diameter,difoliate,directed,distal,distall,distally,drying,eaf,eed,eglandular,elliptic,entire,equal,erec,erect,except,ferruginous,filament,flattened,flattened-reniform,flower,free,fruit,fruiting,geminat,glabrous,glandular-puberulent,green,growth,hair,half,heterostylous,inflorescence,infructescence,inside,interpetalar,juicy,juvenile,lanceolate,larger,lateral,leaf,leaf-opposed,least,length,less,like,lobe,lobed,long,long-styled,longer,lower,margin,markedly,mature,mid-way,midpoint,midrib,midvein,minute,minutely,mm,moderately,moist,mucilaginous,multiseriate,narrowly,near,nflorescence,numerous,oblique,obtuse,occasionally,often,older,orolla,oung,ovate,ovate-lanceolate,pale,papillat,pedicel,peduncle,per,pericarp,petiole,plant,pore,poricidal,porrect,portion,present,prickle,pricklier,prickly,pubescent,ray,rest,ripe,rounded,ruit,scar,scattered,secondary,sessile,several,shallowly,shiny,short-stalked,short-styled,shorter,shrub,side,slightly,small,somewhat,spaced,sparsely,spherical,stalk,stalked,stellate,stellate-pubescent,stem,stigma,straight,style,surface,tall,tamen,terete,thicker,time,tip,tissue,toothed,touching,tree,triangular,trichome,truncate,tube,unarmed,unbranched,unit,usually,vary,way,weakly,white,whitish,wide,woody,yellow,yellowish-green,ympodial,young,younger	
108	wfo-0001027050	exception_thrown	234	0	0	234	0	0.0		.2,0-0.2,0-0.5,0-1,0-3,0.1-3,0.2-0.6,0.2-1,0.3-0.6,0.4-1,0.5-0.8,0.5-1,0.5-3,0.8,1-1.5,1-2,1-5,1.5-2,1.5-6,10-13.5,10-30,11-21,12-15,14-20,15-50+,16-40,2-10,2-2.5,2-3,2-3-locular,2-4,2-5,2-6,2-8,2-foliate,2.5-3,23-40+,3-15,3-5,4-19,4-40,4-8,5,5-10,5-6,5-7,5-9,5-merous,6-8,7-30+,8-26,8-40+,abaxially,absen,absent,abundant,accrescent,across,acuminate,acute,adaxiall,adaxially,adult,andromonoecious,anther,anvil-shape,apart,apex,armed,articulated,axe,ba,base,blade,branche,branched,broad-based,broadly,brown,calyx,capitat,chartaceous,cm,coarsely,connivent,contiguous,cordate,cross-section,cuneate,curved,cylindrical,deeply,densely,diameter,directed,distall,distally,distributed,drying,eaf,eed,eglandular,elliptic,entire,erect,except,exocarp,extra-axillary,ferruginous,filament,flattened,flower,forked,fruit,fruiting,functional,geminat,glabrous,glandular-puberulent,globose,green,growth,hair,half,held,inflorescence,interpetalar,juicy,juvenile,lanceolate,lateral,leaf,leaf-opposed,length,less,like,lobe,lobed,long,longer,lower,margin,markedly,mature,mesocarp,midpoint,midvein,minute,minutely,mm,moderately,moist,mucilaginous,multiseriate,narrowly,nearly,nflorescence,oblique,obtuse,often,orolla,ovate,ovate-lanceolate,pair,pale,pedicel,peduncle,per,petiole,pinnatifid,pitted,placenta,plant,pore,porrect,present,prickle,rachi,ray,rounded,ruit,scattered,sessile,shallowly,shorter,shrub,side,simple,slightly,small,somewhat,spaced,sparsely,stalk,stalked,stellae,stellate,stellate-pubescent,stem,stigma,straight,style,surface,tal,tamen,tem,thick,thicker,throughout,time,tip,tissue,toothed,tree,triangular,truncate,tube,unarme,unarmed,unbranched,unit,upper,upright,usually,vary,weakly,white,whitish,wide,x,yellow,yellowish-green,ympodial,younger	
109	wfo-0001027091	exception_thrown	142	0	0	142	0	0.0		.3,0.7,0.8,1-1.6,1.1-1.6,1.8-2.6,1/2-2/3,2.3-2.9,2.5-3.5,3-8,3-9,30-60,4-10,5-11,6-10,6-10-flowere,8.5-11.5,9-13,accrescent,across,acute-tipped,along,alyx,annual,anther,anthesi,arcuate,armed,base,beneath,berry,blade,blue,branched,bristly,broadly,brown,calyx,campanulate,capitate-glandular,cauline,cm,dark,deltoid,densely,developing,dia,difoliate,divided,dm,dry,eaf,eed,enveloped,extended,few-rayed,fully,geminat,glabrous,gland,glandular,green,hair,herb,high,internodal,invested,lenticular,linear-lanceolate,lobe,lon,long,longer,low,main,maturity,mm,mostly,narrowly,near,nflorescence,obtuse,occasionally,oriented,orolla,ovate,pedicel,per,petiole,pinnatifid,pinnatisect,prickly,radially,reticulately,ridge,rounded,ruit,scattered,sessile,short,short-stipitate,simple,slende,sometimes,somewhat,sparsely,spherical,splitting,spreadingly,ste,stellae,stellate-pentagonal,stem,strait,suffused,surface,tamen,tapering,taprooted,terete,terminally,tightly,tigma,tub,tube,twice,tyle,undulate,unexpande,uniseriate,unit,usually,variously,vary,vein,vestiture,violet,wholly,wrinkled,yello,ympodial,younger	
110	wfo-0001027102	success	167	137	81	86	56	0.485	.5,.5-6,0.5-1,0.5-2,0.5-3,1-2,1-2.5,1.5-2,3-12,3-4,abaxially,absent,accrescent,adaxial,adaxially,anther,apex,appearance,articulated,base,blade,broad,calyx,cell,cm,connivent,corky,cuneate,densely,difoliate,directed,distally,entire,filament,forked,fruit,fruiting,giving,glabrous,globose,hair,leaf,leaf-opposed,lobe,long,long-tapered,longitudinal,major,margin,minor,mm,moderately,multiseriate,oblong,often,opening,orange,pedicel,perfect,petiole,pore,pubescent,rarely,roughened,shrub,simple,slender,slit,stellate,stem,stone,subcoriaceous,surface,time,unbranched,unit,white,wide,x,yellow,young	0.2-2,0.5,1-1.5,1-3,1-4,1-6,10-20,15,15-35,2-2.5,2-3,3,3-5,4-5,4-7,5-12,<,absen,acuman,acuminate,acute,adaxiall,ag,aggregate,almost,alyx,apart,axe,ba,broadly,channe,chartaceous,ciliate,congested,curved,cylindrical,deltate,diameter,differing,dimorphic,eaf,eed,elliptic,few-,flattened,flower,free,geminat,ilament,lanceolate,m.,narrowly,nflorescence,obtuse,one,orolla,ovate,peduncle,per,portion,rachi,ripe,rugulose,ruit,short,size,small,somewhat,spaced,sparsely,stigma,straight,style,tal,tem,tip,tomentose,triangular,truncat,truncate,tube,unarme,usually,vary,yellow-brown,ympodial	age,appressed,articulation,bract,branching,breeding,broad-based,channel,colour,connective,corolla,form,geminate,growth,heteromorphism,inflated,inflorescence,insertion,interjected,interpetalar,leaflet,length,lower,marking,mature,modification,needle-like,null,odour,orientation,paired,pattern,placement,position,prickle,pseudostipule,rhizome,scale,shape,smell,spot,staman,structure,symmetry,sympodial,system,tall,texture,tissue,trichome,tuber,type,unarmed,vegetative,xylopodia,zygomorphy
111	wfo-0001027104	exception_thrown	141	0	0	141	0	0.0		0.15-0.35,0.5-0.8,1-1.5,1-3,1-4,1.2-6,1.5-2.3,1.5-4.2,10-15,2-3,2-6,2.2-5,3-5.5,3-6-foliat,4-15,5-15,6-7.5,abaxially,acumen,acuminate,acute,adaxially,apex,apical,apically,articulate,attenuate,base,branched,calyx,cell,cm,condition,connate,cordate,corolla,covering,cyme,dehiscent,diameter,dichasial,dichasially,digestion,distal,dorsally,eaf,ebracteate,edge,eed,emoval,enzyme,epiphyti,epiphytic-like,exceeding,filament,finely,flat,flower,folded,forked,generally,globo,globose,green,green-white,growing,hair-like,half,herbaceous,honeycomb,introrse,lateral,linear,living,lobe,lon,long,lower,make,maturing,mm,monochasial,mos,mucilaginous,mucronate,narrowly,nflorescence,nther,odd-pinnate,often,orolla,ovat,ovate,ovoid,pattern,pedicel,peduncle,perennial,perfect,petiole,plan,plant,poricidally,proximal,pubescent,rarely,reveal,ruit,seed,seudostipule,short,simple,slit,specimen,stamen,stellate,stigma,straight,style,tall,tem,terrestrial,testal,thick,throughou,throughout,tone,truncate,tuber-bearing,typically,unit,vary,viole,wall,white,wide,without,yellow,yellow-green,ympodial,Â¼	
112	wfo-0001027114	exception_thrown	154	0	0	154	0	0.0		-17,-2,-30,.5,0.5-1,1-1.1,1-1.2,1-1.5,1-2,1.5-1.7,1.5-2,1/2,13-21,2-2.5,2-3,20-40,3-4,3-7,5,6-8,6-9,7-10,7-9,abaxial,abaxially,acute,adaxially,along,alternating,anther,anthesi,apar,apex,appearing,axillary,ba,bark,base,berry,branched,bushy,calyx,capitate,closely,cm,commonly,conical,corolla,dark,deltate,dendritic,densely,dia,differing,difoliate,drying,due,eaf,edicel,eed,elliptic,erect,exserted,filament,flattened-reniform,flowered,free,fruiting,geminate,glabrou,glabrous,globose,green,growt,halfway,inflorescenc,inflorescence,investing,lamina,lateral,leaf,like,lobe,lobed,lon,long,lower,main,major,many,margin,minor,minute,minutely,mm,nflorescence,occasionally,older,opening,opposite,ovary,pair,papillo,pedicel,petiole,pitted,planar,plurifoliate,pore,poricidal,portion,projection,pubescent,rapid,reddish,reddish-brown,rest,ruit,scar,scattered,several,shoot,shoot-terminal,shrub,simple,size,slit,soft,spaced,stem,stigma,style,surface,tall,tapering,thickened,time,tip,triangular,trichome,tub,tube,ud,unevenly,uniseriate,unit,vein,way,white,wide,woody,yellowish,ympodial,young	
113	wfo-0001027117	exception_thrown	235	0	0	235	0	0.0		-1.5,-11,-12,-2.8,-3/4,.5,/3,0-10,0-15,0-20,0-25,0-40,0-5,0.1,0.1-,0.1-0.7,0.15-0.25,0.15-0.35,0.2,0.2-0.45,0.5,0.5-1.5,0.6-0.9,0.7-0.9,0.7-1.3,0.7-1.5,0.8-,1-2,1-4,1-6,1.2,1.5-,1.5-2.3,1.5-6.5,1.7-2.5,1.8-2.5,1/,1/3,1/4,1/8-1/2,10-20,2-3,2-6,2-8,2.3-2.8,25-100,3-10,3-15,3-6,4-6.5,4-7,4-8,4.5-6.5,4.5-8,5-11,5-14,5-merous,6-10,6-9,7-,8,abaxially,accrescent,acicular,acute,almost,alyx,ame,anther,apar,apart,apex,apically,apparently,articulated,attenuate,bark,base,berry,beyond,black,blade,branched,brittle,brown,c.,calyx,cell,chartaceous,cm,concolorous,connivent,cordate,curved,dark,deltate,densely,diameter,discolorous,distance,drying,eaf,eed,elongating,enclosing,erect,evenly,extending,fifth,filament,fine,flattened-reniform,flower,four,free,fruit,fruiting,gently,glabrescent,glabrous,gra,green,herb,herbarium,infructescence,irregularly,lateral,leaf,length,less,lobe,lobed,lon,long,long-acuminat,longer,lower,margin,mature,maturity,mauve,membranous,midpoint,midvein,mm,moderately,narrow-deltate,narrow-elliptic,narrow-lanceolate,nflorescence,oblong,obovate,older,one,open,orolla,oung,outline,ovate,pair,pale,pedicel,peduncle,pendulous,per,perfec,pericarp,perpendicular,petiole,pit,plurifoliat,poricidal,porrect,portion,prickl,prickle,prickly,primary,raised,ray,red-brown,reduced,reflexed,rounded,ruit,scar,sessile,shallowly,shiny,shorter,side,small,smooth,sometimes,spaced,sparsely,specimen,spherical,spreading,stalk,stalked,staman,stellate,stellate-pubescent,stem,straight,style,surface,tamen,tapering,tearing,terete,tertiary,time,tip,tissue,translucent,trichome,tube,unequal,unit,upper,variously,vary,vein,venation,visible,way,weakly,wide,woody,yellow,yellow-green,ympodial,young	
114	wfo-0001027123	exception_thrown	181	0	0	181	0	0.0		-10,-20,.3,.5,0.3-1.6cm,0.5,0.5-0.8,0.7-3.5,0.8-1.3,0.9-1.3,1,1-1.2,1-1.5,1.5-2,2-2.2,2-2.5,2-2.6,2-3,2-5.5,2-lobed,2.5-10.4,2.5-4,2.5-6,3-15,3-4,4-5,4-6,5-10,5-6,abaxial,acute,adaxial,adaxially,along,anther,anthesi,apex,appearing,attenuate,axe,axi,bark,base,branched,bright,broadly,brown,calyx,campanulate,cell,clavate,cm,commonly,completely,conical,constricted,coriaceous,corolla,cup-shaped,dark,darker,deltate,dendritic,densely,denser,diameter,drying,eaf,edge,eed,elliptic,enlarged,erect,exerted,fide,filament,flattened,flower,free,fruiting,glabrous,glandular,globose,green,inflorescence,inserted,lamina,lax,leaf,less,lewi,like,lobe,lobed,lon,long,loose,loosely,lower,margin,mauve-purple,midvein,minute,minutely,mm,monopodia,narrowly,nflorescence,nodding,older,outline,ovary,pair,papillae,papillate,pedicel,peduncle,perfect,perhaps,petal,petiole,pitted,planar,plurifoliate,portion,primary,prominent,pubescent,reddish,reniform,revolute,scar,scatted,scattered,shin,shinin,shining,shiny,short,simple,sinuate,sleeve,slightly,sometimes,soon,spaced,sparsely,stellate,stem,stigma,stoutish,straight,strongly,style,subshrub,surface,terminal,testal,thick,time,tip,trailing,trichome,tub,tube,turned,ud,unit,upper,usually,vein,violet,warty,way,white,widely,wood,x,ympodial,young,Â¾	
115	wfo-0001027146	exception_thrown	213	0	0	213	0	0.0		0-11,0.3-2.2,0.5-3.2,0.6-3.3,0.7-2.4,0.8,0.8-3.1,0.8-5.8,1-10,1-2,1-2.5,1-9.5,1.9-10,10,13-36,2-12.2,2-13,2-4.2,2-5,3.3-6.1,3.5-22,4-11,4-12.5,4-38,4-8,5-merou,6,6-10,6-17.5,6.5-52,abaxially,acumen,acuminate,adaxially,ag,along,alyx,anther,apart,apex,apparently,arranged,articulated,asymmetrical,attenuate,axe,axillary,base,basiscopic,bead,berry,blade,brownish,bud,capitat,cell,chartaceous,ciliate,clavate,cm,coarsely,commonly,condition,conical,connivent,corolla,covering,dark,darker,decreasing,deep,diameter,digestion,distal,dorsally,drying,eaf,edge,eed,elliptic,enzyme,erec,especially,exceeding,filament,finely,flat,flower,folded,forked,fourt,fourth,fresh,fruit,geminat,generally,glabrou,glabrous,gradually,green,green-white,greenish,hair,hair-like,half,herb,homostylous,honeycomb-shaped,interjected,lanceolate,lateral,leaf,leaflet,lengthening,like,living,lobe,long,lower,make,margin,medium,membranous,midrib,minute,minutely,mm,moniliform,mottled,mucilaginous,multiple,necklace,nflorescence,odd-pinnate,orbicular,orolla,ovate,ovoid,pair,pedicel,peduncle,pentagonal,perfect,petiole,petiolule,plant,plurifoliate,pore,poricidal,proximal,puberulent,pubescent,purple,rarely,ray,removed,ripe,rotate,ruit,secondary,seed,semierect,sessile,seudostipule,side,simple,size,slit,sometimes,spaced,specimen,stamen,ste,stem,stigma,stolon,straight,style,subequal,subglabrou,subglabrous,subsessile,subtending,symmetrical,tall,tamen,tem,terminal,testal,thick,throughout,tinged,tip,tissue,toward,tri-,tube,tuber,typically,unit,unwinged,usually,vary,violet,wall,wet,white,whitish,wide,wing,x,yellow,ympodial	
116	wfo-0001027157	exception_thrown	207	0	0	207	0	0.0		0-3,0.15-0.3,0.7-2,0.9-2.8,1,1-10,1-2,1-3,1-3.8,1-6,1.5-6.5,10-30,2,2-15,2-2.5,2-3,2-5,2.3-4,2.5-3,3-12,3-7,3.3-7.8,3.8-8.3,4-5,5-merou,6.5-14.5,9-12,abaxially,absent,acumen,acuminate,acute,adaxially,ag,along,alyx,among,anther,apart,apex,apparently,articulated,attenuate,axe,axillary,base,berry,blade,broadly,brownish,bud,capitat,cell,chartaceous,ciliate,clavate,cm,condition,conical,connivent,cordate,corolla,covering,cuneate,decreasing,decurrent,deeply,densely,diameter,digestion,distal,dorsally,drying,eaf,edge,eed,elliptic,end,enzyme,erec,especially,exceeding,filament,flat,flower,folded,forked,fresh,fruit,geminat,generally,glabrou,glabrous,grassland,greatly,green,green-white,greenish,hair,hair-like,half,herb,homostylous,honeycomb-shaped,interjected,lanceolate,lateral,leaf,leaflet,lengthening,like,living,lobe,long,low-growing,lower,make,margin,markedly,membranous,middl,midrib,minutely,mm,mucilaginous,narrowly,nflorescence,oblique,obtuse,odd-pinnate,one,orbicular,orolla,ovate,ovoid,pair,pedicel,peduncle,perfect,petiole,petiolulate,petiolule,placed,plant,plurifoliate,pore,poricidal,puberulent,pubescent,rarely,removed,ripe,rounded,ruit,seed,semi-rosette,sessile,seudostipule,shady,short,situation,size,slightly,slit,sometimes,spaced,specimen,stamen,ste,stellate,stem,stigma,stolo,straight,style,subsessile,subtending,sunny,tall,tamen,tem,terminal,testal,thick,throughout,tinged,tip,toward,tri-,tube,tuber,typically,unequal,unit,unwinged,usually,vary,violet,wall,wet,white,whitish,wide,woodland,x,yellow,ympodial	
117	wfo-0001027184	success	219	181	130	89	51	0.594	.3,.5,.7,.8,0.2-0.4,0.4â0.9,0.8,1-2,1.5,1â2.5,1â4,2,2â4-celled,3â4-celled,4,5,5-7,abaxially,absent,accrescent,acute,adaxially,adventitious,anther,apex,appressed,basal,base,blue,broad,brown,calyx,cell,chartaceous,cluster,cm,connivent,covered,cylindrical,densely,diameter,directed,entire,epidermal,especially,extension,fasciculate,filament,flattened,fleshy,foliaceous,free,fruit,fruiting,glabrous,hair,hairlike,half,herbaceous,introrsely,lanceolate,largest,leaf,leaflet,least,light,like,lobe,long,longitudinal,lower,margin,membranous,meter,midrib,minutely,mm,much,node,oblong,often,opening,opposite,orange,pedicel,per,petiole,petiolule,pilose,pore,portion,prominent,prominently,pseudostipule,puberulent,pubescent,raised,red,reticulate,revolute,root,scarcely,secondary,several,shape,short,simple,slightly,slit,soft-woody,sparsely,stellate,stem,straight,style,subopposite,sulcate,surface,tertiary,tip,tube,unit,vein,vine,visible,wall,weak,white,x,yellow	0-,0-0.2,0.4-2,0.5-2,0.8â1.6,0â3,1.5-5,1.8â3.5,13â18,19,1â2,2.8â4.1,3-4-,3-foliolate,3.5â8,3â,4â12,7,9,adaxiall,ag,along,always,alyx,apart,articulated,axe,axi,axillary,ba,blade,borne,bract-like,branch,broadly,clavat,cordat,eaf,eed,elliptic,flower,geminat,generally,glabrescent,glabrou,globose,grading,ilament,imparipinnate,larger,lateral,leafy,less,m.,mostly,narrowly,nearly,nflorescence,obtuse,older,orolla,ovate,ower,peduncle,plurifoliate,rachi,rarely,ripe,ruit,shoot,size,small,somewhat,spaced,stigma,terminal,tightly,tree,truncate,trunk,unarme,unbranched,unequal,uniform,usually,vary,ympodial,young,â9	age,articulation,bract,branching,breeding,broad-based,colour,connective,cordate,corolla,form,growth,heteromorphism,inflated,inflorescence,insertion,interjected,interpetalar,length,marking,mature,modification,needle-like,none,odour,orientation,ovary,paired,pattern,placement,position,prickle,rhizome,scale,seed,smell,spot,staman,stone,structure,symmetry,sympodial,system,texture,tissue,trichome,tuber,type,vegetative,xylopodia,zygomorphy
118	wfo-0001027186	exception_thrown	168	0	0	168	0	0.0		-6,.4,.5,0.5-1,1-1.5,1-2.5,1.4-1.6,1.5,1.5-2,1.5-2.5,1.6-5,15,2-6,2-lobed,2.5-3,3-4,3.5-4,30-40,4-15,4-9,5-10,6-7,9-10,?,abaxial,abaxially,acute,adaxially,age,always,anther,anthesi,apart,apex,apparently,attenuate,axil,bark,base,berry,branch,branched,broadly,brown,calyx,clavate,cm,conical,corolla,dark,dbh,deflexed,deltate,denditic,dendritic,densely,denser,diameter,dry,eaf,ellipsoid,elliptic,enlarging,entire,exerted,filament,filiform,flower,free,fruit,fruiting,glabrescent,glabrous,globose,golden,green,growth,immature,incrassat,irregularly,keeled,lamina,lengthening,less,like,lobe,lobed,longer,loose,lower,m.,margin,maturity,midrib,minutely,mm,much,narrowly,new,nflorescence,occasionally,ovary,ovoid,pair,pale,papillat,papillate,pedicel,peduncle,pendent,perfect,pericarp,petiole,pitted,planar,plane,plurifoliat,pointed,pore,poridical,portion,primary,pubescen,pubescent,rachi,reddish,reniform,rough,ruit,scar,scattered,seed,shiny,short,simple,slightly,slit,small,soon,spaced,sparsely,spreading,stalk,stem,stigma,straight,strongly,style,surface,terminal,time,tip,tree,treelet,trichome,tub,tube,ud,uniseriate,unit,variably,vein,way,white,woody,x,yellow,ympodial	
119	wfo-0001027198	exception_thrown	191	0	0	191	0	0.0		.4,.5,0.05-1.0,0.5-0.75,0.5-1,0.7-1,0.8-1,1-1.5,1-10,1-5,1.5-10,1.5-2,10-11,11-20,2-5.5,3/4,4-9,5-120-flowered,5-6,7.5-9,abruptly,acuminate,acute,always,anther,anthesi,apart,apex,attenuate,axil,ba,base,beginning,beneath,berry,broadening,bushy,caly,calyx,channeled,clavate,closely,cm,complex,constriction,corky,corolla,corresponding,cyathiform,decurrent,deltoid,dendritic,densely,dia,differing,difoliate,dry,eaf,edge,edicel,eed,elliptic,entire,erect,evenly,exserted,extremely,eye,female,filament,flower,found,free,fruiting,furcate,geminat,glabrate,glabrous,globose,golden,green,impressed,inflorescenc,inflorescence,invisible,large,lateral,leaf,like,live,lobe,lobed,lon,long,lower,main,major,male,many,margin,medium,meet,middle,minor,minute,minutely,mm,naked,nearly,nflorescence,obovate,often,older,opposite,ovary,overlapping,ovoid,ovoid-reniform,pale,paler,papillo,papillose,pedicel,pendan,petiole,pitted,planar,plant,pore,poricidal,portion,puberulent,pubescence,pubescent,rather,reddi,reflexed,rest,rounded,ruit,scar,sessile,set,shaped,shining,short,shrub,simple,size,slender,slightly,small,soon,spaced,speciman,specimen,stem,stigma,straight,strong,style,styled,surface,tall,tannish-yellow,tear-drop,testae,thickened,thin,time,tip,top,tree,trichome,tube,two,type,ud,undersurface,uniseriate,unit,usually,vein,way,white,widest,woody,x,yellowish,ympodial,young	
120	wfo-0001027200	exception_thrown	139	0	0	139	0	0.0		0.05-0.25,0.25-0.5,0.5-0.75,0.5-1,0.6-1,0.7-2.5,1-1.4,1-1.5,1.2-1.5,1.5-2,1.5-5,1.6-6,2-3,2.5-3,3-3.5,3.5-6,6-8,8-15,9-11,across,acute,anther,anthesi,apex,aspec,ba,bark,base,beneath,berry,branch,branche,broadly,brown,calyx,capitate,cm,conical,converging,corolla,dark,decurrent,deeply,deflexed,deltoid,densely,dia,differing,eaf,eed,elliptic,except,filament,flattened,free,fruiting,geminate,giving,glabrous,globose,golden,green,grey-brown,horizontally,impressed,inflorescence,lateral,leaf,lightly,like,lobe,lobed,lon,long,lower,main,major,margin,middle,minor,minute,minutely,mm,near,nearly,node,non-reproductive,occasionally,older,onto,ovary,ovoid-reniform,papillo,papillose,pedicel,petiole,pitted,planar,pore,poricidal,portion,prominent,puberulent,reflexed,rest,ruit,shaped,shrub,size,slightly,small,sparse,sparsely,spreading,stem,stigma,straight,style,surface,tall,tear-drop,tip,tree,trichome,tube,unicellular,unifoliate,uniseriate,unit,vein,white,widened,widest,winged,woody,x,yellowish,ympodial,young	
121	wfo-0001027213	success	231	121	71	160	50	0.307	-3.3,/10,0-2.5,1-2,1-5,anther,apex,articulated,attenuate,axillary,base,blade,branched,calyx,cell,cm,completely,corolla,covering,cuneate,entire,enveloping,eventually,filament,fruit,fruiting,glabrescent,globose,granular,green,hair,high,homostylous,lanceolate,leaf,length,lower,many,margin,mm,mostly,multangulate,pedicel,petiole,plurifoliate,pore,poricidal,porrect-stellate,pseudo-terminal,scabrous,short,short-stalked,shrub,simple,stellate,stem,surface,thick-stalked,time,tip,tomentose,tomentose-pubescent,tree,unarmed,unit,unwinged,violet,white,whitish,yellow-green,yellowish	-19,-230,-4.5,0-160,0.2-0.4,0.2-0.5,0.7-2.3,0.8-1.8,1.1-1.7,1.2-1.6,1.2-1.7,1.2-2.5,1.3-2.2,1.7-3.6,1.7-3.9,1.8-2.8,1.8-3.2,1/2-2/3,10-24,12.3-16.3,2-5,2.4-4.7,2.5-5.1,2.9-3.8,2.9-4.8,2/3,3.5-5,3.5-8,4-9.5,4.2-5.9,5-7.5,5-8,5-merou,5.7-6.2,8-24,8.2-10.5,9-13,abaxially,accrescent,acuminate,acute,adaxially,ag,along,alyx,anthesi,apart,apparently,ark,around,axe,ba,basal,blunt-tipped,branch,broadly,brown,capitat,conical,cylindrical,dark,decurrent,deltoid,diameter,directed,distally,drying,eaf,early,edge,eed,elliptic,epidermal,exserted,farinose,few-rayed,flower,free,glabrescen,glabrous,grayish-brown,group,immature,inserted,lackin,lateral,lengthening,lobe,lobed,long,long-,long-stalked,longitudinal,m.,main,midrib,mixed,moderately,multangulat,nearly,nflorescence,oblanceolate,obovate,obscured,obtuse,often,older,orbicular,orolla,ovate,ovate-lanceolate,pale,partly,peduncle,perfect,porrect-stellat,prominent,pubescence,pubescent,rachi,rather,relatively,reniform,reticulate-punctate,ruit,sessile,short-,short-attenuate,side,slit,sometimes,somewhat,spaced,sparsely,stamen,stigma,style,subcampanulate,suture,tamen,terete,thick,thin-stalked,ti,tomentu,touching,tube,ud,unarme,vary,vein,vestigial-rayed,way,whitish-green,wide,x,yellow,yellow-tan,ympodial,young	appressed,articulation,bract,branching,breeding,broad-based,colour,connective,form,growth,heteromorphism,inflated,inflorescence,insertion,interjected,interpetalar,lacking,leaflet,marking,mature,modification,needle-like,null,odour,orientation,paired,pattern,placement,position,prickle,pseudostipule,rhizome,scale,shape,smell,spot,staman,stone,structure,symmetry,sympodial,system,texture,tissue,trichome,tuber,type,vegetative,xylopodia,zygomorphy
122	wfo-0001027214	exception_thrown	181	0	0	181	0	0.0		-20,-38,-9,..,.25,.5,0,0-16,0.25,0.3-1.5,0.3-1.7,0.5-0.8,0.5-1,0.7-2,0.7-2.5,0.8-1,1-1.5,1-2.8,1.2-3,1.5,1.5-1.8,1.5-6,10-,10-13,12-17,15-25,2,2-9,3-,3-6,4-5,5-6,6-,6-12,7-12,8-9,abaxially,absent,acuminate,acute,adaxially,along,anther,anthesi,anticlinal,apex,apical,basal,base,berry,broadly,calyx,capitat,cell,climbing,cm,composed,conical,conspicuously,corolla,decurrent,deltate,densely,diameter,dr.,drying,eaf,edicel,eed,elliptic,epidermal,erect,exserted,extending,filament,finely,flattened-round,flower,free,fruit,fruiting,glabrous,globose,green,greenish,groove,grown,height,herb,horizontal,inflorescenc,inflorescence,irregular,lamina,lanceolate,lateral,leaflet,length,less,like,lobe,lobed,lon,long,long-acuminate,long-conical,lower,margin,markedly,midrib,minutely,mm,narrowly,nearly,nflorescence,noddin,nodding,oblique,obovate,occasionally,often,once-branched,onto,open,opposite,ovary,pair,paired,papilla,papillate,pedicel,per,perfectly,petiole,petiolule,pinnate,pointed,poricidal,portion,projection,pubescent,rachi,reflexed,rest,rugose,rugosity,ruit,scar,scattered,scrambling,seed,sharply,simple,sinuous,smaller,somewhat,stigma,style,surface,tem,terminal,thickening,time,tip,triangular,trichome,truncate,tub,tube,ud,unevenly,unifoliat,uniseriate,unit,vein,white,white-lenticellate,whitish,without,x,ympodial	
123	wfo-0001027219	exception_thrown	143	0	0	143	0	0.0		.5,/4,0.3,0.4-0.6,0.5,0.5-0.8,1,1-15,1-2,1-3,1.5-2,1.5-2.5,2,2-2.5,2-3,2-3.5,2-4,3-5,3-6,6-8,7-8,absent,acuminate,acute,age,anther,anthesi,apex,axillary,bark,base,berr,berry,bright,broadly,brown,c.,calyx,capitate,closely,cm,completely,conical,corolla,cup-shaped,deltate,densely,diameter,drying,eaf,edge,eed,elliptic,entire,erect,exerte,exfoliatin,filament,flower,free,fruiting,glabrescent,glabrou,glabrous,globose,green,greyish,growth,hard,heterostylous,known,leaf-opposed,lengthening,less,lobe,lobed,long-conical,long-styled,lower,margin,maturity,minutely,mm,new,nflorescence,ovary,overlappin,pair,pale,papillo,papillose-pubescent,pedicel,peduncle,pendent,pericarp,petiole,planar,plurifoliat,pointed,pore,poricidal,portion,primary,pubescent,purple,ruit,scar,sharply,shoot,short,short-styled,shrub,simple,slightly,slit,sometimes,somewhat,soon,spaced,stem,stigma,stout,style,surface,terminal,thickened,tip,trichome,tube,tuft,ud,uniseriate,unit,vein,violet,way,weight,white,woody,x,yellowish,ympodial,â1/3	
124	wfo-0001027223	success	189	170	112	77	58	0.593	0.19-0.75,1-2,1.3-2,1.5-3.5,1.8-3.5,3-5,3.5-6,3.5-7,4-6,5-21,5-8,5.9-12.2,9-22,abaxially,acuminate,adaxially,anther,apex,asymmetric,attenuate,axillary,base,basiscopic,berry,blade,bud,cell,cm,conical,connivent,corolla,covering,decreasing,deep,densely,distal,dot,elliptic,end,filament,forked,fruit,generally,glabrous,green,hair,half,herb,homostylous,hyaline,interjected,lanceolate,larger,lateral,leaf,leaflet,light,like,long,lower,make,middle,mm,mucilaginous,odd-pinnate,one,orbicular,ovate,ovoid,pair,pedicel,pentagonal,petiole,petiolulate,placed,plant,plurifoliate,pore,poricidal,present,pubescent,purple,ripe,rotate,rounded,seed,sessile,shortly,side,size,slightly,slit,sometimes,stripe,subequal,subtending,tall,terminal,testal,thick,tip,tissue,toward,tri-,tuber,typically,unit,usually,wall,wet,white,x	.5,0.3-1.2,1-3,16-41,2-4,2-7,3-10,3-11,3-5.2,3.5-4,3.7-9.3,5-10,5-merou,9-15,9-35,acumen,adaxiall,ag,alyx,apart,apparently,articulated,axe,brownish,capitat,clavate,condition,diameter,digestion,dorsally,drying,eaf,edge,eed,enzyme,erec,exceeding,flat,flower,folded,fresh,geminat,glabrou,green-white,greenish,hair-like,hal,honeycomb-shaped,lengthening,living,lobe,nflorescence,orolla,peduncle,perfect,removed,ruit,seudostipule,short,spaced,specimen,stamen,ste,stigma,stolo,straight,style,tamen,tem,throughout,tube,unwinged,vary,whitish,wide,yellow,ympodial	'hair-like,actinomorphic,age,appressed,articulation,bract,branching,breeding,broad-based,calyx,colour,connective,erect,form,fruiting,geminate,growth,heteromorphism,inflated,inflorescence,insertion,interpetalar,length,margin,marking,mature,modification,needle-like,none,odour,orientation,paired,pattern,placement,position,prickle,pseudostipule,rhizome,scale,shape,smell,spot,staman,stellate,stem,stolon,stone,structure,surface,symmetry,sympodial,system,texture,trichome,type,vegetative,xylopodia,zygomorphy
125	wfo-0001027237	success	122	117	61	61	56	0.5	.5,/4,8,anther,anthesi,appearing,bark,base,berry,black,branched,calyx,corolla,cucullate,difoliate,drying,erect,filament,free,fruiting,geminate,glabrous,globose,green,greenish-white,inflorescence,internodal,leaf,lobe,lobed,long,lower,many,margin,minutely,mm,occasionally,older,papillose,pedicel,pore,portion,reflexed,shaped,shining,shrub,slender,small,stem,surface,tall,tear-drop,time,tip,tree,tube,unit,usually,way,white,young	0.5-1,1-1.2,1.5-2,1.5-2.5,2-3,3-3.5,3-4,30-100-flowered,5,6-11,6-8,apart,apiculae,apiculate,ba,blac,branc,broadly,brown,clavate,cm,completely,cup-shaped,dark,deflexed,deltoid,dia,edicel,eed,ellipsoid,exsertion,flattened,greyi,later,nflorescence,ovary,paler,papillate,papillo,part,pitted,plurifoliat,poricidal,regularly,regulary,reniform,ruit,scar,spaced,stigma,straight,style,tapering,terminal,ud,upper,widely,woody,x,x.,ympodial	apex,appressed,articulation,bract,branching,breeding,broad-based,cell,colour,connective,form,fruit,greyish,growth,hair,heteromorphism,inflated,insertion,interjected,interpetalar,leaflet,length,marking,mature,modification,needle-like,null,odour,orientation,paired,pattern,petiole,placement,plurifoliate,position,prickle,pseudostipule,rhizome,scale,shape,smell,spot,staman,stone,structure,symmetry,sympodial,system,texture,tissue,trichome,tuber,type,vegetative,xylopodia,zygomorphy
126	wfo-0001027238	success	204	169	118	86	51	0.578	-5,0-1,0.3-0.8,0.3-1,0.3-5,0.5-1,0.5-16,0.5-2,1-1.5,1-2,1.5-3,1.5-4,1.5-7,10,2-3,2-4,4-,4-10,4-16,4-8,accrescent,anther,apex,articulated,base,berry,black,blade,calyx,chartaceous,cm,connivent,covering,cuneate,densely,diameter,directed,distally,elliptic,elliptic-ovate,entire,equal,extra-axillary,filament,fleshy,fruit,fruiting,geminate,glabrescent,glabrous,gland,gland-tipped,globose,hair,homostylous,interpetalar,introrsely,large,lavender,leaf,like,lobe,long,longitudinal,lower,major,margin,membranaceous,midpoint,minor,mixed,mm,multangulate,nearly,new,oblique,oblong,opening,paired,pale,pedicel,petiole,plurifoliate,pore,porrect-stellate,pubescent,purple,ray,ripe,rounded,scandent,sessile,shiny,short-stalked,shrub,simple,slit,small,sometimes,somewhat,sparse,sprawling,stellate,stellate-pubescent,stem,subtending,surface,time,tissue,tree,unbranched,unit,white,whitish,wide,without,x,yellowish	-25,.3,.5,0-0.7,0-1.5,0.3-0.5,15-30,3-4,3-5,3-6,4-5,5-15,5-7,5-merou,6-15,6-8,abaxially,acuminate,acute,adaxiall,adaxially,ag,alyx,apparently,axe,ba,branch,brown,capitat,contiguous,cylindrical,dark,deltate,differentiated,discolorous,eaf,eed,flattened,flower,foliaceous,fork,free,frui,green,greenish,growt,juic,light,lighter,minutely,narrowly,near,nflorescence,obtuse,often,one,orolla,outline,part,peduncle,perfect,pericarp,pitted,rachi,reniform,ruit,side,similar,sparsely,ste,stigma,straight,strongly,style,tamen,tem,tip,toward,triangular,tube,unarme,unequal,vary,vein,yellow,ympodial	age,appressed,articulation,bract,branching,breeding,broad-based,cell,colour,connective,corolla,form,growth,heteromorphism,inflated,inflorescence,insertion,interjected,leaflet,length,marking,mature,modification,needle-like,null,odour,orientation,pattern,placement,position,prickle,pseudostipule,rhizome,scale,shape,smell,spot,staman,stone,structure,symmetry,sympodial,system,texture,trichome,tuber,type,unarmed,vegetative,xylopodia,zygomorphy
127	wfo-0001027244	success	294	169	123	171	46	0.418	-2,0-,0.1-0.5,0.1-0.6,0.2-1,0.3-0.5,0.4-1,0.5,0.5-1,1,1-celled,1.5-6.5,2-,2-4,2-4-celled,2-foliate,2-locular,3.5-13,4-12,4-celled,5-,5-10,8-16,alfway,amongst,anther,apex,articulation,base,berry,bifurcate,bract,branched,c.,cage,calyx,cell,cm,common,cordate,corolla,crenate,dark,decumbent,decurrent,dense,densely,dentate,diameter,distal,eglandular,erect,filament,flower,flushed,fruit,fruiting,glandular,globose,green,greenish,half,head,herb,imparipinnate,inflorescence,interjected,interrupted,investing,irregularly,larger,leaflet,length,like,lobe,lobed,long,longer,lower,margin,middle,mixed,mixture,mm,oblique,often,onto,patent,pedicel,perennial,petiole,primary,pseudostipule,pubescent,purple,rachi,ripe,rotate-stellate,rounded,scattered,sessile,simple,sometimes,somewhat,sparse,sparsely,spreading,stem,stout,stripe,surface,tall,tiny,trichome,truncate,uniseriate,unit,usually,vivid,white,wide,woody,yellow	-1.2,-12,-3.2,.5,0.02-,0.04-,0.05,0.05-1,0.07-0.15,0.1-,0.1-0.3,0.15-0.2,0.2,0.2-,0.25-0.4,0.3,0.3-0.4,0.3-0.6,0.3-0.8,0.4-,0.4-0.6,0.45-0.6,0.5-0.8,0.6-0.9,0.6-09,0.7-1,0.7-1.5,0.7-2,0.7-3,0.8-1.2,0.9-1.3,0.9-1.7,1-2-celled,1-2.5,1-3.5,1.1-1.3,1.2-1.6,1.5-2,1.5-2.1,1.5-2.4,1.7-3.0,1/2,2-9,2.1-8,3-5,3/4,5-9-celled,7-12,8-celled,abaxially,absent,abundance,abundant,acroscopically,acuminate,acute,adaxially,adpressed,along,also,always,angled,anthesi,apical,apparently,appearance,appendage,arequipa,around,articulated,articulatio,axi,basal,berr,bracteate,broadly,brown,capitate,column,conical,curved,deciduous,deeper,deltate,density,developed,diamete,eaf,edicel,eed,either,elliptic,elliptical,exserted,extremely,forming,general,giving,glabrescent,glabrous,gland,gree,hair-like,halfway,hyaline,internode,lamina,lanceolate,largest,lateral,leave,lobing,lon,midvein,minute,multicellular,narrowly,near,node,obovate,occasionally,orbicular,outgrowth,ovary,pair,papillate-pubescent,peduncle,petiolule,population,present,reflexed,rest,ruit,secondary,shaggy,short,shorter,silky,sinus,size,slender,small,sparser,staminal,sterile,stigma,straight,strongly,style,tem,terminal,tertiary,testa,thick,tip,tipped,toward,tube,two,ud,undulate,unicellular,united,upper,variable,variety,vein,velvety,wall,winged,ympodial	appressed,branching,breeding,broad-based,colour,connective,form,growth,hair,heteromorphism,inflated,insertion,interpetalar,leaf,marking,mature,modification,needle-like,null,odour,orientation,paired,pattern,placement,pore,position,prickle,rhizome,scale,shape,smell,spot,staman,stellate,stone,structure,symmetry,sympodial,system,texture,tissue,tuber,type,vegetative,xylopodia,zygomorphy
128	wfo-0001027248	exception_thrown	158	0	0	158	0	0.0		.5,0,0.5-1,0.5-2.5,0.7-1.2,1-1.5,1-2,1-3,1-5,2-2.5,2-4.5,3-4,3-7,3-7-flowered,3.5-4,4-8,5-5.5,6-13,6.5-8,7-9,abaxial,abaxially,acute,adaxially,along,anther,anthesi,ape,apex,appearing,arachnoid,arachnoid-pubescen,arachnoid-pubescent,area,bark,base,beige,beneath,berry,broadened,broadly,brown,brownish,brownish-gra,calyx,closely,cm,conical,corolla,dark,deflexed,deltate,densely,denser,dia,differing,difoliate,dirty,eaf,edicel,eed,ellipsoid,elliptic,erect,exserted,felty,filament,fleshy,free,fruit,fruiting,geminate,glabrescent,glabrous,globose,grayish-green,green,impressed,lamina,later,lateral,leaf,lightly,lobe,lobed,long,lower,main,major,margin,merely,minor,minutely,mm,nearly,nflorescence,node,occasionally,older,opposite,ovary,overlappin,ovoid-reniform,pair,pale,papillo,papillose,patch,pedicel,per,petiole,pitted,planar,pore,poricidal,portion,present,pubescence,pubescent,ruit,scar,scattered,shaped,shoot,shrub,simple,size,small,somewhat,soon,spaced,sparsely,specimen,stem,stigma,strongly,style,surface,tall,tear-drop,thick,tip,top,tree,trichome,tub,tube,ud,unifoliate,unit,vein,white,wid,wide,winged,woody,ympodial,young	
129	wfo-0001027258	exception_thrown	178	0	0	178	0	0.0		.25,.5,/4,0.25-0.5,0.5-1,0.6-2,0.9-1.3,1-1.5,1-2.3,1-4,1.2-2,1.5-1.6,2-2.5,2.5-8,3-4,3-6,3.5-4,4-5,4.5-5,5-10-flowered,6-8,7-13,7-9,abaxially,abruptly,acuminate,acute,adaxially,age,along,anther,anthesi,apar,apex,apical,apiculae,attenuate,axil,ba,bark,base,beneath,berry,broadly,calyx,capitate,cm,corolla,crystal,darker,decurrent,deflexed,deltate,dense,densely,deposit,dia,differing,difoliate,dissecting,drying,eaf,edicel,eed,ellipsoid,elliptic,enlarge,entire,evenly,exserted,extending,fide,filament,flattened-reniform,fragrant,free,fruit,fruiting,geminat,glabrou,glabrous,globose,green,greenish-yellow,incrassate,internodal,lamina,large,lateral,leaf,length,lengthening,lenticel,lobe,lobed,long,lower,main,major,margin,microscope,middle,minor,minute,minutely,mm,nee,nflorescence,occasionally,often,older,onto,opposite,ovary,ovate,pair,pale,papillo,papillose,pedicel,petiole,pitted,planar,pore,poricidal,portion,projection,prominent,pubescent,red-papillose,reddish,ruit,sand,scar,scattered,shrub,simple,size,slender,slightly,slit,small,spaced,sparsely,speck,stem,stigma,straight,strongly,style,surface,sweetly,swollen,tall,tiny,tip,treelet,trichome,tub,tube,tuft,ud,uniseriate,unit,urceolate,vein,visible,way,white,widening,widest,winged,woody,x,yellowish,yellowish-tan,ympodial,young	
130	wfo-0001027260	exception_thrown	176	0	0	176	0	0.0		-17,-2,-60,-7,0.25-1,0.5-1,0.5-3,0.5-6.5,0.75-1,0.8-2,1-,1-2,1-3,1-4,1-6,1-7,1.5-13,1.5-2,10-25,15-30,2-,2-10,2-18,2-2.5,2.5-14,2.5-3.5,3-,3-10,3-11,3-4.5,3-6,3.5-25,4-25,4-32,4-5-foliat,4-6,4.5-14,5-,5-25,5-40,5-merous,6-20,abaxially,absent,acuminate,acute,acute-,adaxially,age,aggregate,also,alyx,apart,ape,apex,articulated,axe,basal,base,berry,beyond,blade,branched,cell,chartaceous,clavate,cm,connective,connivent,cordate,cylindrical,darker,densely,diamete,diameter,directed,distally,eaf,eed,eglandular,ellipsoidal,elliptic,elliptic-ovate,entire,equal,exceeding,exserted,fading,flattened,flower,fruit,glabrate,glabrous,globose,greenish,hair,lanceolate,lavender,leaving,lobe,lon,long,longitudinal,lower,margin,membranaceous,mm,moderately,narrowly,nearly,nflorescence,nther,obtuse,often,orolla,ovate,pedicel,pedicellar,peduncle,perfec,perfect,petiole,pilo,pilose,pink,pore,presen,puberulent,puberulent-pubescen,puberulent-pubescent,pubescent,pubescent-pilose,purple,rachi,radiu,remnant,ruit,shorter,shrub,simple,slightly,small,spaced,sparsely,stamen,stellate,stigma,stone,stripe,strongly,style,subcoriaceous,tal,tapered,tem,thecae,time,tomento,tree,triangular,truncate,tube,ud,unbranched,unit,usually,vary,vein,white,wide,x,yellow,yellow-green,yellow-orang,yellowish,ympodial	
131	wfo-0001027265	exception_thrown	159	0	0	159	0	0.0		-2.5,.2,.3,.5,0.1â2,0.2-0.4,0.5,0.5-1,0.5â0.6,1-1.3,1-2.5,1-3,1.2-1.3,1.2-2,1.2â1.4,1.5-2.5,1.5â1.8,1.5â2,1.5â4,2,2-,2-3,2-4,2/3,20-30,2â2.5,2â3,3-,3-lobed,30â50,4-5,4.5â8,4â6,4â7-branched,5-merou,58409,abaxially,accrescent,acute,adaxiall,adaxially,alyx,anther,apart,apex,apparently,articulated,axe,ba,base,berry,blade,broad,calyx,capitat,chartaceous,ciliate,cm,connivent,covering,croat,cylindrical,dehiscent,diameter,eaf,eed,entire,erect,extra-axillary,filament,flattened-reniform,flower,foliate,frui,fruit,fruiting,geminat,glabrous,globose,granule,hair,herb,hermaphroditic,juic,larger,leaf-opposed,light,lobe,lon,long,long-attenuate,longitudinall,low,lower,margin,mesocarp,minutely,mm,near,nearly,nflorescence,node,numerous,oblong,obtuse,orange,orolla,ovate-lanceolate,paired,partially,pedicel,peduncle,petiole,pitted,pore,present,prominent,puberulent,pubescent,purple,rachi,rarely,recurved,red,ripe,rooting,rotate-stellate,ruit,scarcely,sclerotic,seed,simple,slightly,sometimes,somewhat,spaced,sparsely,stigma,style,subcoriaceous,surface,tall,tamen,tem,time,tip,triangular,tube,unit,usually,vary,weak,white,white-puberulent,wide,winged,x,yellow,ympodial	
132	wfo-0001027265	exception_thrown	156	0	0	156	0	0.0		-2.5,.2,.3,.5,0.1â2,0.2-0.4,0.5,0.5-1,0.5â0.6,1-1.3,1-2.5,1-3,1.2-1.3,1.2-2,1.2â1.4,1.5-2.5,1.5â1.8,1.5â2,1.5â4,2,2-,2-3,2-4,2/3,20-30,2â2.5,2â3,3-,3-lobed,30â50,4-5,4.5â8,4â6,4â7-branched,5-merou,58409,abaxially,accrescent,acute,adaxiall,adaxially,alyx,anther,apart,apex,apparently,articulated,axe,ba,base,blade,broad,calyx,capitat,chartaceous,ciliate,cm,connivent,covering,croat,cylindrical,dehiscent,diameter,eaf,eed,entire,erect,extra-axillary,filament,flattened-reniform,flower,foliate,frui,fruit,fruiting,geminat,glabrous,globose,granule,hair,herb,hermaphroditic,juic,larger,leaf-opposed,light,lobe,lon,long,long-attenuate,longitudinall,low,lower,margin,mesocarp,minutely,mm,near,nearly,nflorescence,node,numerous,oblong,obtuse,orange,orolla,ovate-lanceolate,paired,partially,pedicel,peduncle,petiole,pitted,pore,prominent,puberulent,pubescent,purple,rachi,rarely,recurved,red,ripe,rooting,rotate-stellate,ruit,scarcely,sclerotic,seed,simple,slightly,sometimes,somewhat,spaced,sparsely,stigma,style,subcoriaceous,surface,tall,tamen,tem,time,tip,triangular,tube,unit,vary,weak,white,white-puberulent,wide,winged,x,yellow,ympodial	
133	wfo-0001027284	success	172	114	53	119	61	0.308	accrescent,anther,apex,axillary,base,berry,blade,branched,brownish,calyx,cm,cordate,entire,extra-axillary,filament,flattened,fleshy,fruit,fruiting,globose,green,inflorescence,lobe,lower,margin,mm,nearly,oblique,orangish,ovoid,pale,pedicel,petiole,plurifoliate,pointed,rarely,rounded,sand-punctate,scandent,shrub,simple,slightly,sometimes,somewhat,stellate,stem-terminal,surface,truncate,unbranched,unit,vine,white,x	.3,0.1â0.5,0.1â2,0.2â,0.7â0.9,0.7â1,1.2â1.5,1.5â2,1.5â2.5,1.5â5.5,1.5â8,1.8â2,1â1.5,1â2,1â3,2.5â3,2.5â3.5,2â16,2â2.2,3.5â14,3â4,4,4â12,4â6,5-merous,5â7,5â8,9â18,abaxially,acuminate,acute,adaxially,alyx,anthesi,axe,branch,c.,capitat,ciliat,climbing,conspicuous,contiguousl,cylindrical,deflected,deltoid,densely,diameter,distally,eaf,eed,elliptic,enlarged,fine,flattened-reniform,flower,glabrescen,glabrou,glabrous,gradually,herbaceous,immature,leafy,long,m.,maturity,midvein,minutely,near,nflorescence,nternode,one,orolla,ovate,pair,peduncle,pendulou,perfec,pink,pinnate,planar,prominent,pubescence,pubescent,rachi,reduced,reticulate-rugulose,ruit,sand-punctat,scar,secondary,seen,shortly,side,size,soon,spaced,sparsely,spreading,stigma,style,tamen,tan,tem,thickened,thickly,time,tip,toward,tree,tube,understory,unifoliat,vary,vein,venation,weakly,wide,woody,ympodial	0.2-,1-1.5,1.5-2.5,1.5-8,3.5-14,appressed,articulation,bract,branching,breeding,broad-based,cell,colour,connective,corolla,form,growth,hair,heteromorphism,inflated,insertion,interjected,interpetalar,leaf,leaflet,length,marking,mature,modification,needle-like,null,odour,orientation,paired,pattern,placement,pore,position,prickle,pseudostipule,rhizome,scale,shape,smell,spot,staman,stem,stone,structure,symmetry,sympodial,system,texture,tissue,trichome,tuber,type,unifoliate,vegetative,xylopodia,zygomorphy
134	wfo-0001027302	exception_thrown	188	0	0	188	0	0.0		.5,0.4-5,0.5,0.5-1,0.6-1,0.8-1,1,1-1.3,1-1.5,1-2,1-3,1.2-1.6,1.2-2.5,1.5-2,10,10-20,2,2-3,2-6,2.2,2.7-7.5,3.5-5,3/4,5-7,6-12,7,7/8,abaxial,abaxially,acuminate,acute,adaxial,adaxially,age,along,anther,anthesi,apex,apical,appearing,ba,bark,basal,base,becoming,berry,blade,branching,bright,broader,brownish-yellow,calyx,capitate,clavate,cm,conical,cordate,corolla,crispate,cultivation,decurrent,deflexed,deltoid,dendritic,densely,denser,diameter,dichasia,discussion,eaf,edicel,eed,elliptic,entire,especially,ew,exserted,filament,fine,flat-topped,flattened,flower,free,fruiting,glabrous,globose,growing,growth,inserted,juvenile,larger,later,lateral,lax,leaf,length,lenticular,less,like,lobe,lobed,lon,long,long-triangular,lower,m.,main,margin,minutely,mm,monochasial,narrowly,nflorescence,nodding,occasionally,older,otherwise,ovary,ovate,overtopping,pair,pale,papillo,pedicle,per,pericarp,petiole,pitted,planar,plant,plurifoliate,pore,poridical,portion,prominent,puberulent,pubescent,pyramidal,red,reddish-brown,reflexed,ruit,scar,scattered,scrambling,secondary,see,shade,shin,shoot,shrub,simple,sleeve,slit-like,small,somewhat,sparsely,stamen,stem,stigma,strongly,style,surface,tall,tapering,terminal,thin,time,tiny,tip,tree,trichome,truncate,tub,tube,ud,undulate,unit,usually,vein,violet,way,wide,winged,woody,x,ympodial,young	
135	wfo-0001027310	exception_thrown	215	0	0	215	0	0.0		-2.2,-20,.8,/3,0,0-20,0-5,0.05,0.05-0.15,0.1,0.1-0.2,0.15-0.3,0.6-1,0.7-2,0.9-0.17,1-1.2,1-1.7,1-6,1.1-1.5,1.5-2.2,1.5-5,1/10-1/6,1/3-1/2,1/3-3/4,11-16,2-10,2-3.1,2-4,2-5,2.2-2.5,2.8-3,2/3,20-60,22-30,3-15,4-10,4-9,4.5-5.5,4.5-7,5-10,5-20,5-7,5-merous,6-8,7-10,8-10,9-13,abaxial,abaxially,acut,acute,adaxial,alyx,andromonoecious,anther,apar,apart,apex,apically,apparently,articulated,bark,base,berry,blade,branched,branching,broadly,calyx,chartaceous,cm,connivent,cuneate,curved,dark,deltate,densely,diameter,discolorous,distal,drying,eaf,eed,elongating,entire,equal,erect,evenly,faint,filament,flattened,flattened-reniform,flower,foliaceous,free,fruit,fruiting,fused,gently,glabrescent,glabrou,glabrous,glaucous,gray,green,green-brown,hair,hermaphrodite,heterostylous,inflated,infructescence,lanceolate,lateral,leaf,length,less,lobe,lobed,long,long-styled,longer,lower,lowermost,margin,mature,maturity,mauve,midpoint,minutely,mm,moderately,nflorescence,older,one,open,orange-brown,orolla,oung,pair,pale,pedicel,peduncle,pendulous,per,pericarp,petiole,pitted,plant,plurifoliat,poricidal,porrect,porrect-lepidote,portion,prickle,prickly,primary,pubescent,purple,ray,red,reddi,reflexed,rounded,ruit,scar,secondary,sessile,shallowly,short-styled,shorter,shrub,simple,smooth,sometimes,spaced,sparse,sparsely,spherical,spreading,stalk,stalked,staminat,stellate,stellate-pubescent,stem,stout,straight,strongly,style,surface,tamen,tapering,terete,terminal,tertiary,time,tip,toward,tree,trichome,truncate,tube,unarme,unarmed,unit,vary,vein,venation,visible,way,wide,woody,yellow,ympodial,young	
136	wfo-0001027317	exception_thrown	144	0	0	144	0	0.0		.25,.5,0.1-0.2,0.3-1,0.4-1.5,0.5-1,0.5-3,0.8-3.5,1,1-1.5,1-2,1-5,1.4-1.6,1.5-2,2-3-flowered,2-9,3-3.5,4.5-5,7-9,?,abaxial,acuminate,acute,adaxially,along,anther,anthesi,apex,apical,apically,arch,ba,bark,base,beneath,berry,bilobed,broadly,calyx,closely,cm,conical,corolla,cucullate,deciduous,deflexed,deltoid,densely,dia,differing,difoliate,drying,eaf,edicel,eed,ellipsoid,elliptic,elongated,erect,expanded,filament,filiform,free,fruit,fruiting,geminat,glabrous,globose,golden,green,greyish-whit,immature,inflorescenc,joined,known,lateral,leaf,like,lobe,lobed,lon,long,long-exserted,lower,main,major,margin,mature,minor,minute,minutely,mm,nearly,nflorescence,offset,older,opposite,ovary,overlappin,pair,pale,papillo,papillose,pedicel,petiole,pointed,pore,poricidal,portion,projection,prominent,pubescent,reflexed,rest,ruit,scar,series,shaped,shrub,simple,size,slightly,soon,spaced,sparsely,stem,stigma,strongly,style,surface,tall,tear-drop,tip,trichome,tub,tube,ud,uniseriate,vein,white,woody,x,ympodia,young	
137	wfo-0001027323	exception_thrown	175	0	0	175	0	0.0		.75,/3,0.5-1,1-1.5,1-2,1.2-1.5,10-15,14-21,2-3,2-6,2.5-3,20-45,3-5,5-20-flowered,5-7,6-11,7-9,acute,adaxial,along,anther,anthesi,apex,apparent,appearing,area,arising,asymmetric,attenuate,ba,bark,base,berry,broadened,bud,calyx,campanulate,character,closed,closely,cm,cork,corolla,decurrent,deflexed,densely,dia,differing,difoliate,dried,dry,eaf,edicel,eed,elliptic,elongate,entire,erect,erose,exserted,filament,five-pointed,fleshy,flopping,flower,free,fruit,fruiting,furcate,geminat,glabrate,glabrous,globose,grey,growing,held,higher,hood,hooded,immature,interpetalar,lateral,leaf,like,live,lobe,lobed,lon,long,long-triangular-deltoid,lower,main,major,margin,matte,mature,measured,middle,minor,minutely,mm,nflorescence,occasionally,older,one,onto,opposite,ovary,overlapping,ovoid,ovoid-reniform,pair,papillae,papillo,papillose,partially,pedicel,persistent,petiole,pinkish-grey,pitted,planar,plant,pore,poricidal,portion,prominent,proximal,rather,red-papillose,reddish-grey,rest,ridge,ruit,scar,secondary,seen,shaped,sinus,size,slightly,small,smoot,soon,spaced,specimen,stem,stigma,straight,style,surface,tall,tan,tear-drop,thickened,thin,tiny,tip,treelet,trunk,tube,two,ud,unit,upper,vein,visible,way,white,widest,winged,woody,x,ympodial,young	
138	wfo-0001027340	success	189	142	87	102	55	0.46	0.5-0.9,1-2,2-4,3.5-9,4-6,5-6,7-18,absent,anther,apex,apparently,articulated,articulation,auriculate,axillary,base,berry,blade,bud,cell,chartaceous,cm,connivent,cordate,corolla,developing,distal,distinct,elliptic,filament,flower,forked,fruit,generally,glabrous,globose,green,hair,half,herb,high,homostylous,indistinct,interjected,lanceolate,leaflet,lengthening,like,lilac-purple,lower,margin,membranous,minute,mm,odd-pinnate,ovate,ovoid,pedicel,perfect,petiole,petiolulate,plant,plurifoliate,pore,poricidal,pubescent,purple,ripe,rotate,rounded,semi-rosette,sessile,short,slightly,slit,sparsely,stem,subtending,tall,terminal,tinged,tip,tri-,truncate,unit,x,young	1-10,1-3,1.5-2.7,10-16,16-22,2-3,2-3.5,2.5-4.5,2.7-4.5,3-4,3.5-5,4-7.5,5-11,5-merou,6-8.5,7-8,8-14,8-9.5,abaxially,abruptly,acumen,acuminate,adaxially,ag,along,alyx,apart,axe,brownish,capitat,ciliate,condition,covering,dark,decreasing,diameter,digestion,dorsally,drying,eaf,edge,eed,enzyme,especially,exceeding,flat,folded,fresh,geminat,glabrou,green-white,greenish,hair-like,hal,honeycomb-shaped,lateral,living,lobe,long,make,midrib,minutely,mucilaginous,narrow,narrowed,nflorescence,orolla,pair,papillose,peduncle,pointed,puberulent,purpl,removed,ruit,seed,semi-erec,seudostipule,shortly,size,spaced,specimen,splotched,stamen,ste,stigma,straight,style,tamen,tem,testal,thick,throughout,tube,usually,vary,wall,wet,whitish,wing,yellow,ympodial	age,appressed,bract,branching,breeding,broad-based,calyx,colour,connective,entire,form,fruiting,geminate,growth,heteromorphism,inflated,inflorescence,insertion,interpetalar,leaf,length,marking,mature,modification,needle-like,null,odour,orientation,paired,pattern,placement,position,prickle,pseudostipule,rhizome,scale,semi-erect,shape,smell,spot,staman,stone,structure,surface,symmetry,sympodial,system,texture,tissue,trichome,tuber,type,vegetative,xylopodia,zygomorphy
139	wfo-0001027354	exception_thrown	166	0	0	166	0	0.0		.5,0,0.5,0.5-2,0.7-1.3,1,1-1.2,1-1.5,1-7,1.5-1.8,1.5-2,1.7-5,10,10-20,2.5-3.5,3-4,3.4-4,3/4,4-10,5-7,6.5-13,8-12,abaxial,abaxially,absent,acute,adaxial,age,along,anther,anthesi,apex,apical,appearing,ba,bark,basal,base,becoming,belo,berry,bi-lobed,blade,branch,branching,calyx,cm,conical,corolla,covered,dark,deltoid,dendritic,densely,denser,diameter,dichasia,drying,eaf,edicel,eed,elliptic,entire,erect,ew,exserted,filament,flattened,flower,fork,free,fruit,fruiting,glabrate,glabrous,globose,golden,growth,inserted,later,lateral,leaf,length,lenticular,less,like,lobe,lobed,long,loose,loosely,lower,m.,minutely,mm,monochasial,mostly,narrowly,near,nflorescence,nodding,occasionally,older,ovary,pair,papillo,pedicel,per,pericarp,petiole,pitted,planar,plurifoliate,pore,poricidal,portion,pubescen,pubescent,purplish-black,pyramidal,raised,reddish-brown,ruit,scar,secondary,shrub,side,simple,sleeve,slightly,slit-like,small,somewhat,sparsely,stamen,stem,stigma,strongly,style,surface,tall,tapering,terminal,thecalyx,thin,time,tiny,tip,tree,tree-like,trichome,tub,tube,type,ud,unit,vein,violet,way,white,wide,winged,woody,x,ympodial,young	
140	wfo-0001027359	success	224	136	81	143	55	0.362	-3,.5,/3,0-3,0.3-1.2,0.5,0.5-1,1.5-2,1/5-1/4,2-10,anther,apart,apex,base,berry,branched,bright,calyx,cell,chartaceous,cm,cuneate,deltate,densely,difoliate,elongate,elongating,entire,equal,erect,filament,flattened,fruit,fruiting,glabrous,lateral,leaf,length,less,lobed,long,lower,margin,marking,mature,membranous,mm,often,pale,pedicel,petiole,poricidal,prickle,prickly,purple,red,reflexed,scandent,shrub,sometimes,spaced,sparsely,spherical,spreading,stellate,stellate-pubescent,stem,surface,tapering,terminal,tip,trichome,unarmed,unit,way,weakly,white,wide,yellow,yellow-brown,young	-0.25,-2,-20,-4,-7,-9,.1,.2,/4,0,0-2,0-5,0-9,0.1,0.1-0.2,0.1-1.5,0.3-0.5,0.5-2,0.6-0.8,0.6-1,1-1.2,1-2,1-3,1-4,1-5,1.2-1.5,1.2-2,1.5-2.5,1.8-3.2,2-3,2-4,2.5-3.5,2.5-5.5,3-10,4-,4-5,5-,5-6.5,5-merous,6-8,7-8,abaxially,acut,acute,alyx,apar,apically,apparently,articulated,ba,bark,blade,brow,concolorous,coroll,cream,curved,dark,diameter,distinctive,drying,dull,eaf,eed,eye,filiform,flattened-reniform,flower,free,geminat,glabrescent,gray,green,herbaceous,infructescence,like,lobe,longer,maturity,midpoint,minutely,moderately,naked,narrow-deltate,narrow-ovate,near,nflorescence,obtuse,occasional,older,one,open,orange-brown,orolla,oung,outline,ovate,ovoid,pair,peduncle,per,perfec,pericarp,pit,porrect,portion,primary,rachi,raised,rarely,ray,reticulate,ruit,scar,sessile,shallowly,shorter,simple,slender,slightly,small,smooth,stalk,stalked,stump,style,tamen,terete,tertiary,time,tinge,tube,ud,unarme,undulate,usually,variously,vary,vein,venation,visible,woody,ympodial	4-6.5,absent,actinomorphic,appressed,articulation,bract,branching,breeding,broad-based,colour,connective,corolla,form,geminate,growth,hair,heteromorphism,inflated,inflorescence,insertion,interjected,interpetalar,leaflet,mentioned,modification,needle-like,odour,orientation,paired,pattern,perfect,placement,pore,position,present,pseudostipule,rhizome,scale,shape,smell,spot,staman,stone,structure,symmetry,sympodial,system,texture,tissue,tuber,type,unmodified,vegetative,xylopodia,zygomorphy
141	wfo-0001027366	success	136	120	66	70	54	0.485	/4,0.5-1,1-2,1-3,3-10-flowered,abaxially,acute,adaxially,anther,anthesi,apex,axe,bark,base,berry,bright,broadly,calyx,cm,corolla,drying,elliptic,except,filament,fruiting,glabrous,globose,golden,green,greenish-white,internodal,leaf,less,lobed,long,lower,margin,middle,mm,older,opposite,orbicular,pale,papillose,pedicel,petiole,planar,pore,reddish,rounded,shaped,shining,shrub,simple,sometimes,somewhat,stem,surface,tall,tear-drop,tip,trichome,unit,way,widest,young	.5,/2,0.25-0.5,0.7-1,1-1.5,1.5-2,11-21,2-2.5,3-9,4-4.5,4-5,5-7,6-19,603,ape,ba,brown,capitate,closely,conical,conspicuously,dark,deflexed,deltate,dia,eaf,edicel,eed,erect,et,exserted,fide,free,lamina,lateral,lobe,lon,long-triangular,main,minutely,nflorescence,ovary,overlappin,ovoid,ovoid-reniform,packed,pair,papillo,parallel,pitted,pointed,poridical,portion,ramo,ruit,scar,secondary,stigma,straight,style,tub,tube,ud,unifoliat,vein,venation,wide,woody,yellowish-gre,ympodial	appressed,articulation,bract,branching,breeding,broad-based,cell,colour,connective,form,fruit,growth,hair,heteromorphism,inflated,inflorescence,insertion,interjected,interpetalar,leaflet,length,marking,mature,modification,needle-like,null,odour,orientation,paired,pattern,placement,position,prickle,pseudostipule,rhizome,scale,shape,smell,spot,staman,stone,structure,symmetry,sympodial,system,texture,tissue,tuber,type,unifoliate,vegetative,xylopodia,yellowish-grey,zygomorphy
142	wfo-0001027368	success	145	132	75	70	57	0.517	-10,-2,-5,0.3-2.5,0.5-3.5,1-2,1.5-2,2-3,3-12.5,4-6,abaxially,adaxially,apex,articulated,base,blade,branched,calyx,cell,chartaceous,cm,connivent,cuneate,darker,decurrent,dendritically,densely,denser,directed,distally,ellipsiodal,elliptic,elliptic-ovate,entire,forked,glabrous,globose,hair,lanceolate,lighter,lobe,long,long-stalked,lower,margin,mm,narrowly,oblong,occasionally,often,ovoid-fusiform,pedicel,petiole,pore,pubescent,purple,ray,shrub,simple,small,sparsely,star,stellate,stone,subcoriaceous,subhastate,terminal,three,time,unbranched,unknown,vein,white,wide,x	-15,-20,.5,0.5-5,0.8-2,1-15-flower,1-6,1.5-2.5,2,2-2.5,2-4,2-9,3,4-many-foliat,5-10,5-15,5-6,8-13,abruptly,absen,acuminate,acute,adaxiall,aggregate,also,apart,axe,ba,color,contiguous,cylindrical,deltate,diameter,eaf,eed,except,gland,lenticular,midvein,moderately,narrowed,nearly,nflorescence,nther,obtuse,orolla,otherwise,peduncle,puberulent,pubescen,rachi,radiu,ruit,sometimes,spaced,stalked,stigma,style,subcapitat,tal,tem,tip,triangular,truncate,tube,unit,usually,vary,yellow,ympodial	absent,anther,appressed,articulation,bract,branching,breeding,broad-based,colour,connective,corolla,filament,form,fruit,fruiting,growth,heteromorphism,inflated,inflorescence,insertion,interjected,interpetalar,leaf,leaflet,length,marking,mature,modification,needle-like,null,odour,orientation,paired,pattern,placement,position,prickle,pseudostipule,rhizome,scale,shape,smell,spot,staman,stem,surface,symmetry,system,tall,texture,tissue,trichome,tuber,type,vegetative,xylopodia,zygomorphy
143	wfo-0001027369	success	191	183	131	60	52	0.686	-1,-10,-11,-2,.1,.5,.7,/4,0,0-3,0-5,0.1,0.1-0.3,0.2-0.5,0.25-0.4,0.3-1.5,0.5,0.5-0.8,0.5-1.5,1-2,1-2.5,1.2-2.5,1.2-3,1/3,3,4-8,5,7-15,almost,ame,anther,apart,apex,apically,apparently,bark,base,berry,blade,branched,broad-deltate,c.,calyx,cm,color,concolorous,cordate,densely,difoliate,distance,drying,elongating,erect,extending,eye,filament,filiform,free,fruit,fruiting,glabrous,glaucous,gra,green,hair,known,lateral,leaf,length,less,lobe,lobed,long,lower,margin,mature,mauve,membranous,midpoint,midvein,mm,multangulate,naked,narrowly,older,one,orbicular,pale,pedicel,perpendicular,petiole,poricidal,porrect,portion,prickle,prickly,ray,reflexed,reniform,rounded,scandent,sessile,shrub,side,simple,slightly,spaced,sparsely,spherical,spreading,stalk,stalked,stellate,stellate-pubescent,stem,straight,surface,tapering,terete,terminal,time,trichome,tube,unit,venation,visible,way,wide,wider,winged,yellow	.4,0-1,0-15,0-6,0.05-0.15,0.1-0.2,0.6-0.8,1-,1-3,1-4,1.5-2,2-3,2-4,2-5,3-10,3-4,4-5,5-merous,abaxially,acut,alyx,apar,articulated,curved,deltate,diameter,eaf,eed,equal,flower,geminat,glabrou,herbaceous,infructescence,know,lanceolate,lon,moderately,nflorescence,open,orolla,oung,peduncle,pendulous,per,perfec,pericarp,prickl,ruit,scar,slender,smooth,strongly,style,tamen,tip,unarmed,unequal,vary,ympodial	appressed,articulation,bract,branching,breeding,broad-based,cell,colour,connective,corolla,form,geminate,growth,heteromorphism,inflated,inflorescence,insertion,interjected,interpetalar,leaflet,marking,modification,needle-like,null,odour,orientation,paired,parsely,pattern,perfect,placement,pore,position,pseudostipule,rhizome,scale,shape,smell,spot,staman,stone,structure,symmetry,sympodial,system,texture,tissue,tuber,type,vegetative,xylopodia,zygomorphy
144	wfo-0001027378	exception_thrown	149	0	0	149	0	0.0		.2,0.5â1,0.7â1,0.8â2.5,1.2â1.5,1.2â1.8,1.5â1.8,1.5â8,15â35,1â1.5,1â3,2.3â5,2.5â7,2â11,2â2.2,2â2.5,3â4.5,3â5,3â6,4â6,4â9,5-8,5-merous,5â10,5â13,5â7,6â10,6â7,abaxially,acuminate,acute,adaxial,adaxially,alyx,anther,apar,apex,apicall,axe,base,berry,blade,blue,broadly,c.,calyx,capitat,chartaceous,ciliate,clavate,climbin,cm,color,cordate,cylindrical,deeply,deltoid,densely,diameter,eaf,eed,extra-axillary,filament,flattened,fleshy,flower,fruit,fruiting,glabrou,glabrous,hair,hair-tipped,half,herbaceous,lanceolate,leaf,light,like,lobe,lon,long,longer,lower,m.,margin,markedly,membranous,minutely,mm,moderately,narrowly,nflorescence,nternode,obscure,often,orolla,ovate,ovoid,palmate,papillose,pedicel,peduncle,pentagonal,perfec,petiole,plurifoliat,pointed,primary,pubescent,rachi,revolute,rotate-stellate,rounded,ruit,sand-punctat,sand-punctate,scattered,short,side,simple,slender,slightly,small,somewhat,spaced,sparsely,stem,stigma,style,tamen,tem,terrestrial,tip,tooth,trichome,tube,unbranched,unit,unknow,unknown,vary,vein,venation,vine,white,wide,widely,x,ympodial	
145	wfo-0001027378	exception_thrown	141	0	0	141	0	0.0		.2,0.7-1,0.8-2.5,1-1.5,1-3,1.2-1.5,1.5-1.8,1.5-8,15-35,2-11,2-2.2,2-4,2.3-5,2.5-7,3-4.5,3-5,3-6,4-6,4-9,5-13,5-8,5-merou,6-10,6-7,abaxially,acuminate,acute,adaxially,ag,alyx,anther,apart,apex,apicall,apparently,articulated,axe,ba,basally,base,blade,blue,broadly,calyx,capitat,chartaceous,ciliate,clavate,climbing,cm,connivent,cordate,cylindrical,deeply,deltoid,densely,diameter,directed,distally,eaf,eed,equal,extra-axillary,filament,fleshy,flower,fruit,fruiting,geminat,glabrous,hair,hair-tipped,herb,lanceolate,large,leaf,light,lobe,long,longer,longitudinal,lower,margin,minutely,mm,moderately,multicellular,narrowly,nflorescence,node,oblong,obscure,often,opening,orolla,ovate,pedicel,peduncle,perfect,petiole,plurifoliate,pore,pubescen,pubescent,rachi,revolute,rooting,rotate-pentagonal,rounded,scattered,short,simple,slender,slightly,slit,small,somewhat,spaced,sparsely,stigma,style,tamen,tem,terrestrial,tip,tooth,trailing,tube,unbranched,unit,unknow,unknown,vary,vein,weakly,white,wide,widely,x,yellow,ympodial	
146	wfo-0001027384	exception_thrown	155	0	0	155	0	0.0		.25,.5,.75,/3,0.4-1.1,0.5-1,0.9-1,1-1.3,1-1.5,1-3,1-4,1.5-2,2.5-6.5,3-3.5,3-4,3/4,4-7,5-15-flowered,5-5.5,7-14,7.5-8,abov,acute,anothe,anther,anthesi,apart,apex,ba,bark,base,beginning,beneath,berry,breaking,broadly,brown,bud,calyx,capitate,clavate,closely,cm,corolla,cuneate,deep,dia,difoliate,distal,drying,eaf,edicel,eed,ellipsoid,equal,erect,filament,flattened-reniform,free,fruiting,geminate,glabrous,globose,green,hard,herbarium,incrassate,inflorescenc,later,lateral,leaf,lobe,lobed,long,long-exserted,lower,main,margin,member,middle,minutely,mm,mustard,narrowly,nflorescence,obovate,occasionally,older,opposite,ovary,overlapping,pair,pale,paler,papillo,papillose,pedicel,peeling,petiole,pitted,planar,pore,poricidal,portion,prominent,pseudo-terminal,rarely,reddish-purple,rounded,ruit,scar,section,shaped,shining,shrub,simple,siz,slender,small,spaced,specimen,stem,stigma,straight,style,subcoriaceous-fleshy,sulcate,surface,tall,tapering,tear-drop,thick,tip,transverse,tree,triangular,trichome,tub,tube,tuft,ud,uniseriate,unit,vein,way,white,widely,widest,without,woody,x,yellow,yellowish,ympodial,young	
147	wfo-0001027389	exception_thrown	154	0	0	154	0	0.0		.1,.25,.5,0.25-0.3,0.25-0.5,0.5-0.75,0.5-1.5,0.6-1,1,1-1.5,1-2,1.8-1.9,11-14,2-2.5,3-3.5,3-4.5,4-5-flowered,5-7,7-8,acuminate,acute,along,anther,anthesi,apart,apex,ba,bark,base,beneath,berry,broadening,broadly,brown,bud,calyx,cm,conical,corolla,dark,decurrent,deflexed,deltoid,dia,dry,eaf,edicel,eed,ellipsoid,elliptic,erect,evenly,except,expanded,exserted,filament,filiform,foetid,foliage,free,fruiting,geminate,glabrous,globose,green,hispidulous,inflorescence,lateral,leaf,like,lobe,lobed,lon,long,lower,main,making,margin,material,middle,minutely,mm,nearly,nflorescence,node,non-reproductive,obovoi,occasionally,often,older,one,opposite,ovary,ovate,ovoid-reniform,pair,paler,papillo,papillose,pedicel,petiole,pitted,pore,poricidal,portion,prominent,prominently,proximal,puberulent,raise,raised,reddish-golden,reflexed,rest,ruit,scar,shaped,shin,shrub,side,simple,slender,slight,slightly,soon,spaced,sparsely,stem,stigma,straight,style,surface,tall,tapering,tear-drop,thread-like,tip,top,trichome,truncate,tube,ud,unifoliat,uniseriate,unit,vein,white,widest,winged,woody,x,yellowish,ympodial,young	
148	wfo-0001027395	success	153	75	22	131	53	0.144	anther,apex,base,calyx,corolla,filament,fruit,fruiting,globose,green,immature,leaf,lower,margin,pedicel,petiole,pore,shrub,stem,trichome,unit,white	.25,.5,0.25-0.5,0.6-1.1,0.75-1,1-1.5,1-2,1-5,1.1-1.5,1.5-1.9,1.5-2.5,1.6-2.9,10-20-flowered,11-15,12.5-17.3,2-3,2.2-7,3.5-4,4-6,5-6.5,8,acute,anthesi,apically,apiculate,attenuate,bark,becoming,beginning,beneath,berry,black,caly,capitate,closely,cm,conical,constricted,cucullate,decurrent,deflexed,deltoid,densely,depressed,dia,differing,difoliate,drying,eaf,edicel,eed,enlarging,erect,exfoliating,exserted,fleshy,free,geminat,glabrous,imperceptibly,inflorescenc,known,large,lateral,lobe,lobed,lon,long,main,major,midrib,minor,minutely,mm,narrowly,nearly,nflorescence,obovate,occasionally,older,once-furcate,opposite,ovary,overlapping,ovoid,pair,papillo,papillose,partially,piece,planar,pointed,poricidal,portion,primary,pubescent,raised,restricted,robust,ruit,rusty-papillate,scar,secondary,shaped,shining,shiny,simple,size,small,somewhat,spaced,stigma,straight,style,tall,tapering,tear-drop,thick,thickened,tip,transverse,tube,ud,uniseriate,vein,within,without,woody,x,ympodial,young	appressed,articulation,bract,branching,breeding,broad-based,cell,colour,connective,form,growth,hair,heteromorphism,inflated,inflorescence,insertion,interjected,interpetalar,leaflet,length,marking,mature,modification,needle-like,none,odour,orientation,paired,pattern,placement,position,prickle,pseudostipule,rhizome,scale,shape,smell,spot,staman,stellate,stone,structure,surface,symmetry,sympodial,system,texture,tissue,tuber,type,vegetative,xylopodia,zygomorphy
149	wfo-0001027396	exception_thrown	244	0	0	244	0	0.0		-2,-5,-6,/3,0-100,0-3,0-30,0-4,0-5,0.1-0.5,0.1-1,0.4-0.7,0.5-1,0.5-1.5,0.5-2,0.5-2.5,0.7-2.5,0.8,0.8-1.3,1,1-4,1.2-2,1.5-3,1.5-3.5,1.8-3,1/2-2/3,1/3,1/4-1/3,1/6,10-15,10-25,10-30,10-35,12-25,15-40,2-3,2-3.5,2-7,2.5-4,2.8-4.5,20-100,3-,3-9,3.5-6,4,4-5,4-6,4-7,5-10,5-20,5-30,5-50,5-8,5-merous,5.5-7.5,6-20,6.5-7.5,7-10,7-15,8-20,abaxial,abaxially,acute,adaxial,almost,alyx,ame,andromonoecious,anther,apar,apart,apex,apically,apparently,articulated,attenuate,ba,bark,base,berry,black,blade,broad,broad-deltate,brown,bulbous,c.,calyx,chartaceous,cm,concolorous,connivent,cream,cuneate,curved,dark,decurrent,deltate,densely,diameter,difoliate,discolorous,distal,distance,drying,eaf,eed,elliptic,elongate,elongating,equal,erect,extending,extensive,fewer,filament,flattened,flattened-reniform,flower,free,fruit,fruiting,fully,geminat,glabrescent,glabrous,glandular,gray-brow,green,hair,herb,hermaphrodite,heterostylous,infructescence,lateral,leaf,length,less,lignified,lobe,lobed,lobing,lon,long,long-acuminat,long-styled,longer,lower,lowermost,margin,marking,mature,maturity,mauve,midpoint,midvein,mm,moderately,near,nflorescence,obtuse,often,older,one,open,opening,orange,orolla,oung,pair,pale,pedicel,peduncle,pendulous,per,pericarp,perpendicular,petiole,plant,poricidal,porrect,portion,prickl,prickle,prickly,primary,pubescent,purple,ray,red-brown,reflexed,rotate,ruit,scar,secondary,sessile,short-styled,shrub,side,simple,smooth,sometimes,somewhat,spaced,sparsely,spherical,spreading,stalk,stalked,staminat,stellate-pubescent,stem,stout,straight,style,surface,tamen,tapering,tearing,terete,tertiary,time,tip,trichome,tube,unarmed,unbranched,unit,upper,usually,variously,vary,vein,venation,visible,way,white,wide,woody,yellow,yellow-green,yellowish,ympodial,young	
150	wfo-0001027449	exception_thrown	160	0	0	160	0	0.0		.4,.5,.75,/3,0.5-1,0.5-1.5,0.8-1.5,0.9-1.1,1.2-1.5,1.4-1.5,1.5-2.5,10-15-flowered,2-3,2-4,3,3-3.5,3-7,4-6,5-6,8-15,acuminate,acute,anther,anthesi,apex,appearing,area,arising,around,axil,bark,base,becoming,beginning,beneath,berry,brown,bud,calyx,closely,cm,corolla,cup,dark,deciduous,deflexed,dense,densely,density,dia,differing,difoliate,dry,eaf,edicel,eed,ellipsoid,elliptic,erect,exserted,extreme,filament,forming,free,frui,fruit,fruiting,geminat,glabrate,glabrous,globose,green,inflorescenc,inflorescence,lamina,later,lateral,leaf,like,lobe,lobed,lon,long,long-acuminate,long-triangular,lower,main,major,material,minor,minutely,mm,narrowly,nflorescence,obconic,oblique,often,older,one,opposite,orangish,ovary,overlapping,ovoid-reniform,packed,pair,pale,papillose,pedicel,persistent,petiole,pitted,pointed,pore,poricidal,portion,prominent,pubescent,raised,red-papillose,reddish-brow,reflexed,rest,ruit,scar,shaped,shrub,simple,size,slender,small,soon,sparse,sparsely,stem,stigma,straight,styl,style,surface,tall,tapering,tear-drop,tip,tree,trichome,trunk,tube,tuft,ud,uniseriate,unit,varying,vein,way,white,woody,x,ympodial,young	
151	wfo-0001027452	success	152	147	89	63	58	0.586	0.5-1.5,0.5-2,0.5-2.5,1,1-2,1-3,1-4.5,1-5,1.5-3,10-20,2-4,2-foliate,4,5-12,abaxially,absent,abundant,adaxially,along,anther,apex,axe,base,berry,blade,branched,brown,calyx,cell,celled,chartaceous,ciliate,cm,cordate,decurrent,densely,denser,dm,drying,elliptic,elliptic-ovoid,entire,filament,flat,flower,fruit,glabrous,globose,hair,herb,immature,interpetalar,long,lower,lying,margin,maturing,membranaceous,mm,moderately,nearly,oblong,obtuse,often,one-,pedicel,peduncle,petiole,pubescent,rachi,rotate,rounded,semitransparent,single,slightly,sometimes,sparsely,stamen,straight,tissue,two-celled,unbranched,unit,usually,vein,white,woody,x,yellow	.5,0.5-1,1.5,2-6,3-6,3-9,4-6,5-20,acute,adaxiall,beyond,center,connected,dehiscing,diameter,eaf,eed,emarginat,equal,explosively,exserted,frui,geminat,growt,held,large,linear-lanceolate,lobe,maturit,mesocarp,new,nfloresence,notched,orolla,outer,parallel,per,perpendicular,placenta,pressure,pubescen,raised,ridge,ruit,running,seed,short,significantly,smaller,smoother,stigma,style,swollen,tal,tamen,tem,triangular,tube,vary,wall,watery,wid,ympodial	appressed,articulation,bract,branching,breeding,broad-based,colour,connective,corolla,emarginate,form,fruiting,geminate,growth,heteromorphism,inflated,inflorescence,infloresence,insertion,interjected,leaf,leaflet,length,marking,mature,modification,needle-like,null,odour,orientation,paired,pattern,placement,pore,position,prickle,pseudostipule,rhizome,scale,shape,smell,spot,staman,stem,stone,structure,surface,symmetry,sympodial,system,tall,texture,trichome,tuber,type,vegetative,xylopodia,zygomorphy
152	wfo-0001027471	exception_thrown	165	0	0	165	0	0.0		.5,/4,0.1-0.2,0.2-0.4,0.2-0.5,0.4-1,0.5,0.5-0.6,0.5-0.7,0.5-1.5,0.7-0.9,0.9-1,1-1.2,1-1.5,1-1.6,1.4-3,1.5-2,2-2.5,2-3,2-lobed,3-4,3-7,4-5,6-7,abaxially,acute,adaxially,age,along,anther,anthesi,apex,appressed,ascending,bark,base,berry,bifid,branched,brittle,c.,calyx,closely,cm,conical,corolla,deltate,dendritic,densely,desnsely,diameter,differing,difoliate,distant,drying,eaf,eed,elliptic,entire,erec,erect,especially,filament,flattened,flower,free,fruiting,furcate-dendritic,geminate,glabrous,globose,growth,herb,included,inflorescence,internodal,lamina,leaf,leaf-opposed,lengthening,less,like,lobe,lobed,long-triangular,lower,major,margin,maturity,midvein,minor,minutely,mixture,mm,new,nflorescence,nodding,node,occasionally,open-conical,orbicular,ovary,ovate,overlapping,pair,pale,papillat,pedicel,peduncle,perfect,pericarp,petal,petiole,pitted,planar,plane,pore,poridical,portion,primary,pubescent,pubscent,rachi,red-orange,reflexed,reniform,ruit,scar,scattered,shape,shrub,similar,simple,size,slender,slightly,slit,small,somewhat,spaced,sparsely,stem,stigma,straight,style,subshrub,surface,tan,thickened,thin,tip,trichome,trifoliat,tube,ud,uniseriate,unit,usually,vein,way,white,woody,x,yellowish,ympodial	
153	wfo-0001027473	exception_thrown	138	0	0	138	0	0.0		.25,/2,0.25-0.5,0.5-1,0.8-1,1-1.5,1-2,1.3-2,1.5-2,1.8-2,1/3,2-2.5,2.5-3,3.5-5,4.5-13,5,6-9,8.5-37,?,abaxially,absen,acute,adaxially,along,anther,anthesi,ape,apex,apparently,bark,base,berry,brown,calyx,clavate,cm,conical,corolla,deccurent,decurrent,deep,deflexed,dendritic,densely,denser,di-,dia,differing,drying,eaf,eed,empty,erect,filament,flattened-reniform,free,fruiting,geminat,giving,glabrous,globose,green,incrassate,later,lateral,leaf,less,like,lobe,lobed,long,long-triangular,lower,main,major,margin,middle,minor,minute,minutely,mm,near,obovate,occasionally,older,ovary,overall,pair,pale,papillo,pedicel,petiole,pitted,planar,pointed,pore,poricidal,portion,pubescent,pubesent,rootstock,ruit,rusty,sac,sessile,shape,shaped,shrub,somewhat,sparsely,stem,sterile,stigma,strongly,style,subshrub,surface,tall,tear-drop,thick,tip,trichome,trifoliate,tube,unit,usually,vein,way,white,wide,widest,wing,winged,woody,yellowish,yellowish-brow,ympodial,young	
154	wfo-0001027483	success	164	169	110	54	59	0.671	0.6,1-4,1-5,1.2-2.5,1.5-10,1.5-3,2,2-3,2-4,2-4.5,3-6,3.5-20,abaxially,acute,adaxially,apex,apical,apically,basal,base,branched,calyx,cell,cm,coarsely,connate,corolla,covering,cuneate,cyme,decurrent,dehiscent,dichasial,dichasially,diminishing,distal,dot,ebracteate,elliptical,filament,finely,flower,forked,generally,globose,gradually,green,hair-like,half,herbaceous,honeycomb,interjected,interpetiolar,introrse,lateral,leaf,leaflet,light,lighter,long,lower,maturing,medium,mm,monochasial,obtuse,odd-pinnate,often,ovate,ovoid,pair,pattern,pedicel,perennial,perfect,petiole,petiolule,plant,poricidally,proximal,pubescent,purple,rachi,ray,rosette,rotate,rounded,sessile,short,size,slit,smooth,sometimes,subsessile,tall,terminal,testal,thick,toward,tuber-bearing,typically,uniform,unit,varying,violet,violet-purple,wall,white,wide,Â¼	0-1.,0.2-1.9,1,1-2,1-2.5,1.5-2.6,3-15,3-6-foliat,4.5-8,5-10,5-6,acumen,articulate,diameter,digestion,dorsally,eaf,edge,eed,emoval,enzyme,erec,exceeding,flat,folded,globo,green-white,living,lobe,lon,lunat,make,minute,mucilaginous,nflorescence,nther,orolla,peduncle,plan,reveal,ruit,seed,seudostipule,specimen,stamen,stigma,straight,style,tem,throughout,tissu,vary,yellow,ympodial	0-10,3-6-foliate,anther,appressed,articulation,bract,branching,breeding,broad-based,colour,connective,erect,form,fruit,fruiting,growth,hair,heteromorphism,inflated,inflorescence,insertion,interpetalar,length,lunate,margin,marking,mature,modification,needle-like,null,odour,orientation,paired,placement,pore,position,prickle,pseudostipule,rhizome,scale,shape,smell,spot,staman,stem,stone,structure,surface,symmetry,sympodial,system,texture,tissue,trichome,tuber,type,vegetative,xylopodia,zygomorphy
155	wfo-0001027506	success	215	150	101	114	49	0.47	-7,-7.5,.5,/2,/6,0-10,0-2,0.5-1.5,1/3,1/6-1/4,10-40,2.5-5,2.5-8,3-6,5-10,6-13,andromonoecious,anther,apart,apex,apparently,base,becoming,berry,blade,branched,brown,calyx,cell,chartaceous,cm,concolorous,cordate,cream,cuneate,curved,dark,densely,dry,drying,elongating,entire,erect,filament,flattened,fruit,fruiting,glabrous,green,hard,heterostylous,lateral,leaf,length,lobe,lobed,long,longer,lower,margin,marking,mature,maturity,mauve,mm,multangulate,occasionally,orange,ovate,pale,pedicel,petiole,poricidal,porrect,prickle,purple,reflexed,shrub,simple,small,sometimes,spaced,spherical,stellate,stellate-pubescent,stem,subentire,surface,terminal,time,tip,tree,trichome,truncate,twice,unit,way,wide,woody,yellow,young	-0.35,-1,-20,-3,.2,0,0-6,0-60,0.1-,0.1-0.3,0.2,0.2-0.3,0.25,0.5-6,0.7-1.3,0.8-1.5,1-2,1-3,1-4,1.2-1.5,1.5-2.2,1.8,2-3.2,2.2-3.5,3-10,3-5,3.5-5,5-7,5-merous,6.5-10,7-8,7-9,8-10,9-13,abaxially,acuminat,acuminate,acute,alyx,ame,apar,apically,articulated,bark,brow,c.,connivent,diameter,distal,eaf,eed,equal,fine,flattened-reniform,flower,free,glabrescent,hermaphrodite,infructescence,lengt,long-styled,lowermost,midpoint,moderately,narrow-deltate,nflorescence,older,one,open,orange-brown,orolla,oung,outline,pair,peduncle,pendulous,per,pericarp,pit,plant,plurifoliat,portion,prickl,prickly,primary,raised,ray,reddish,reduced,ruit,scar,sessile,short-styled,smooth,spreading,stalk,stalked,staminat,stout,style,tamen,tapering,terete,tertiary,tube,unarmed,upper,variously,vary,vein,venation,visible,yellow-green,ympodial	appressed,articulation,bract,branching,breeding,broad-based,colour,connective,corolla,form,growth,hair,heteromorphism,inflated,inflorescence,insertion,interjected,interpetalar,leaflet,mentioned,modification,needle-like,odour,orientation,paired,pattern,placement,plurifoliate,pore,position,pseudostipule,rhizome,scale,shape,smell,spot,staman,stone,structure,symmetry,sympodial,system,texture,tissue,tuber,type,vegetative,xylopodia,zygomorphy
156	wfo-0001027548	exception_thrown	216	0	0	216	0	0.0		-11.5,.3,0.2,0.3-1.2,0.5,0.5-2,1,1-1.5,1-10,1-2.5,1-3.5,1.2,1.5,1.5-2,1.5-2.5,10-12,10-50,3-7,4-6,4-8,4.5,5-merou,6-9,7-10,8-9,abaxiall,acuminate,acute,adaxially,ag,almost,along,also,although,alyx,anther,anthesi,apart,apex,apical,apparently,appearing,area,ark,articulated,articulation,attenuate,axi,basal,base,beneath,bent,berry,black,branch,branched,branching,brown,bu,c.,calyx,capitate,cell,cm,conical,connivent,corolla,dark,darker,deflexe,deltate,dendritic,densely,denser,depressed-elliptic,diameter,drying,dull,eaf,early,eed,ellipsoid,elliptic,elongate,em,entire,exserted,extending,filament,flattened-reniform,flexuous,flower,free,fruiting,geminat,glabrescen,glabrous,glandular,globose,green,growth,half,herbarium,ilament,immature,inflorescence,irregularly,lamina,leaf,leaving,lengthening,less,like,lilac,lobe,lobed,lon,long,long-styled,loose,loosely,lower,many,margin,matte,membranous,minute,minutely,mixed,mm,narrowly,near,new,nflorescence,occasionally,older,orolla,outline,pair,pale,papillae,papillate,papillo,pedicel,peduncle,per,perfect,pericarp,petiole,pitted,planar,plurifoliate,point,pore,poricidal,portion,primary,prominent,puberulent,pubescent,rachi,rectangular,reddish,revolute,ripe,ruit,scar,scattered,simple,size,slender,slit,small,sometimes,somewhat,spaced,sparse,sparsely,specimen,spreading,stellate,stem,stigma,strongly,style,surface,swollen,tapering,terminal,testal,thickened,thin,time,tinged,tiny,tip,transparent,trichome,tube,twinin,type,ud,uniseriate,unit,upper,usually,vary,vein,vine,warty,way,white,woody,x,yellow,ympodial	
157	wfo-0001027581	exception_thrown	200	0	0	200	0	0.0		0.2â0.3,0.3,0.3â1,0.5â1,0.5â1.5,1,1.2â1.5,1.3â1.5,1.5,1.5â2,1.5â3,10,100+,10â16,12,12â30,15â20,1â1.5,1â3-rayed,2.5â3,200,3.5â4.5,3â3.5,4.5â16,4â8,5-merou,6â7,7â10,7â9,8,8â10,9â11,9â9.5,>,abaxial,abaxially,acute,adaxial,ag,along,alyx,anther,anthesi,apar,apex,ark,articulated,axe,base,beneath,berry,branched,branching,broadly,brow,brown,bulbous,c.,calyx,clavate,clearly,closely,cm,connivent,corolla,cup-shaped,dark,deltate,densely,diameter,dichasia,discolorous,distally,drying,eaf,echinoid,eed,ellipsoidal,elliptic,entire,erec,evenly,exserted,filament,flattened-reniform,flower,free,fruiting,glabrescent,glabrous,globose,golden,gradually,green,greyish,growth,ilament,inflorescence,lamina,largest,leaf,length,lengthening,less,like,lobe,lobed,long,longest,loosely,lower,many,margin,midvei,minute,minutely,mixed,mm,moderately,multangulate,multiseriate,narrowing,near,new,nflorescence,nodding,older,orolla,pair,papillo,part,pedicel,peduncle,per,perfect,pericarp,petiole,pitted,plane,plurifoliate,pore,poricidal,porrect-stellate,portion,primary,pubescent,purple,ray,reddish,reflexed,rhachi,ripe,ruit,scar,scarcely,sessile,shiny,short-stalked,shrub,simple,size,slit,small,smaller,spaced,sparsely,spreading,stalk,stellate,stem,stigma,stout,style,surface,tall,tem,terminal,thin,time,tip,tree,trichome,tube,ud,undersurface,unevenly,unit,upper,vary,varying,vein,visible,way,weak,whit,wide,woody,yellow,yellowish,ympodial	
158	wfo-0001027584	success	144	127	73	71	54	0.507	-16,-2,..,.5,0.5-1.5,0.9-2.5,1-1.2,1.5-2,1.6-1.9,2,2.5-3,3,3-.,7-10,8-9,abruptly,anther,apex,attenuate,base,beneath,branched,calyx,cell,cm,corolla,cucullate,darker,densely,diameter,ellipsoid,elliptic,filament,four,fruit,fruiting,glabrous,green,herb,lamina,lobed,long,lower,margin,markedly,minutely,mm,narrowly,nearly,ovate,pair,papillate,pedicel,petiole,primary,scattered,shrub,single-stemmed,small,sparsely,stem,stripe,suffruticose,surface,time,tip,triangular,trichome,uniseriate,unit,vein,white,x	0.5-1,0.9-1,1.2-1.4,1.5-8,10-15,100,11.5-45,2-10,4-6,4-7,4.5-20,absent,acuminate,anthesi,apical,bark,becoming,beginning,branch,brittle,broadly,brow,c.,capitat,conical,deflexe,deltate,dry,eaf,edicel,eed,erec,flattened,flower,irregular,lobe,nflorescence,open,outer,outline,ovary,pale,peduncle,per,pericarp,planar,plurifoliat,pointed,present,reddish,regularly,reniform,ruit,scar,single,sinuate,smooth,sparse,stigma,striate,style,tan,testal,thickening,thin,tube,tuft,ud,wall,without,ympdoial	appressed,articulation,bract,branching,breeding,broad-based,colour,connective,deflexed,form,growth,hair,heteromorphism,inflated,inflorescence,insertion,interjected,interpetalar,leaf,leaflet,length,marking,mature,modification,needle-like,null,odour,orientation,paired,pattern,placement,plurifoliate,pore,position,prickle,pseudostipule,rhizome,scale,shape,smell,spot,staman,stone,structure,symmetry,sympodial,system,texture,tissue,tuber,type,vegetative,xylopodia,zygomorphy
159	wfo-0001027600	success	185	175	116	69	59	0.627	-3,0.5-1,1,1-14,1-2,1-4,1.5-2,1.5-2.5,1/2-3/4,2-18,2-3,2.5-21,2.5-6,3-5,3-5-lobed,4-6,abaxially,abruptly,absent,acuminate,acute,adaxial,adaxially,adpressed,aggregate,along,apex,articulated,basal,base,blade,calyx,campanulate,cell,cm,collection,connective,cordate,cream,cuneate,densely,directed,distally,divided,ellipsoidal,elliptic,entire,especially,exceeding,except,fading,forked,fruit,glabrescent,glabrous,greenish-white,laterally,leaf,leaving,lobe,lobed,long,lower,main,margin,mature,midrib,minutely,mm,moderately,narrowed,oblong,occasionally,older,orange,ovate,pedicel,pedicellar,perfect,petiole,pilose,pinnately,pore,puberulence,puberulent,pubescent,purple,purplish,rarely,remnant,rounded,shorter,simple,sinus,slightly,small,sparsely,stone,style,subcoriaceous,surface,thecae,time,tree,truncate,unbranched,unit,unlobed,vein,white,wide,x,yellow,yellow-green,yellowish,young	-10,0.5-1.5,1-5,10-,10-20,15-25,2-11,2-3.5,2-4,2-4.5,2-5,2-6,20-30,3-15,3-6,4-foliat,5-13,8-17,absen,apart,ape,apical,apiculate,axe,beyond,brow,channe,concave,coriaceous,deltate,diameter,dilated,eaf,eed,exserted,flattened,fleshy,flower,gland,glandular-puberulent,lon,nflorescence,nther,obconical,obtuse,orolla,ovoid,papillose,peduncle,pilo,puberulen,rachi,radiu,ruit,somewhat,spaced,stamen,stigma,strongly,tal,tem,tip,tomento,triangular,tube,two,ud,vary,ympodial	4-foliate,actinomorphic,anther,appressed,articulation,bract,branching,breeding,broad-based,brown,channel,colour,corolla,filament,form,fruiting,growth,hair,heteromorphism,inflated,inflorescence,insertion,interjected,interpetalar,leaflet,length,marking,modification,needle-like,odour,orientation,paired,pattern,placement,position,prickle,pseudostipule,rhizome,scale,shape,smell,specified,spot,staman,stem,structure,symmetry,sympodial,system,tall,texture,tissue,tomentose,trichome,tuber,type,vegetative,xylopodia,zygomorphy
160	wfo-0001027607	exception_thrown	167	0	0	167	0	0.0		.1,.25,.5,0.25-0.5,0.5,0.5-1,0.8-1,1,1-4,1.2-1.5,1.5-3,2-2.5,2-3,2-4,2.5-3,3-3.5,3/4,4-10-flowered,5-10,5-7,8-9,acuminate,acute,age,anther,anthesi,apar,apex,arching,area,aspect,ba,bark,basal,base,becoming,berry,branch,branche,brown,calyx,cm,corky,corolla,curling,dark,decurrent,deflexed,deltoid,densely,dia,dry,eaf,edicel,eed,ellipsoid,elliptic,elongate,erect,evenly,except,exserted,f,filament,filiform,flattened,free,fruiting,geminate,gently,giving,glabrate,glabrous,globose,golden,green,lamina,lateral,leaf,lenticellat,less,like,lobe,lobed,lon,long,lower,m.,main,material,middle,midrib,minute,minutely,mm,narrow,narrowly,nflorescence,non-reproductive,obovoid,occasionally,older,opposite,ovary,ovoid-reniform,pagoda-like,pair,papillose,pedicel,petiole,pitted,plant,pore,poricidal,portion,present,prominent,pubescent,raised,rarely,reddish-brown,reflexed,ruit,scar,shaped,short,shrub,simple,slender,slight,slightly,small,soon,spaced,stem,stigma,straight,strongly,styl,style,surface,tall,tan,tapering,tear-drop,tip,treelet,trichome,tub,tube,ud,unifoliate,uniseriate,unit,vein,way,white,widened,widening,widest,winged,woody,x,yellowish,ympodial,young,zig-zag	
161	wfo-0001027618	exception_thrown	202	0	0	202	0	0.0		-10,-pubescent,0-10,0.5,0.5-1,0.5-6,1,1-,1-1.5,1-13,1-14,1-23,1-3,1-5,1-9,1.4-4,1.5-13,1.5-3,1.5-7,1.5-8.5,11-16,11-22,11-pinnate,12-27,15-30,15-35,2-11,2-11.5,2-12,2-27,2-5,2-8.5,2-9,2.5-6,3-18,3-30,3-5,3-7,3-7-pinnate,3.5-6,4,4-8,5-18,5-20,5-30,5-7.5,5-merous,5.5-12,6-25,6-40,7-25,8-16,8-35,abaxially,acuminat,acut,acute,adaxially,aggregate,also,alyx,apart,ape,apex,articulated,ascending,axe,basal,base,beyond,blade,branched,bud,campanulate,capitate,cell,chartaceous,cm,compound,connective,cordate,cuneate,cylindrical,darker,deltate,densely,dia,diamete,diameter,dilated,directed,distally,eaf,eed,ellipsoidal,elliptic,elliptic-ovate,entire,exceeding,exserted,fleshy,flower,fruit,fusiform,glabrous,globose,greenish,lateral,laterally,leaf,leaflet,leaving,length,less,lobe,lon,long,longitudinal,lower,margin,membranaceous,mesocarp,minutely,mm,moderately,near,nflorescence,nther,oblong,obovate,obtu,obtuse,often,orange,orolla,ovate,papillose,pedicel,pedicellar,peduncle,per,perfec,perfect,petiole,petiolule,pilo,pilose,pinnately,pore,presen,puberulent,puberulent-pilo,puberulent-pubescent,pubescent,pubescent-pilose,purple,rachi,radiu,ranch,ratio,remnant,reticulate,ripe,rown,ruit,runk,shallowly,shorter,shrub,simple,slightly,small,sometimes,somewhat,spaced,sparsely,spreading,stamen,stigma,stone,stripe,style,sympodial,tal,terminal,thecae,tomentose,tree,triangular,truncate,tube,unbranched,uni,unit,urceolate,vary,white,wide,width,without,x,yellow	
162	wfo-0001027622	exception_thrown	203	0	0	203	0	0.0		.5,0-14,0-16,0.3-10,1,1-10,1-2,1.5-3.5,1.5-4.2,1.6-4.5,1/,12-23,2-25,2-3,2-6,2.5-3.5,3-16,3-4,3-4.5,3.5-11,4-5,4-9.5,5-11,5-merou,6-17,6-7,8-16,8-20,abaxially,acumen,acuminate,acute,adaxially,ag,along,alyx,anther,apart,apex,apparently,articulated,axe,axillary,base,berry,blade,blue,blue-purple,borne,broadly,brownish,bud,capitat,cell,chartaceous,ciliate,clavate,cm,condition,connivent,corolla,covering,decumben,diameter,different,digestion,distal,dorsally,drying,eaf,edge,eed,elliptic,elliptical,end,enzyme,erect,especially,exceeding,except,filament,flat,flower,folded,forked,fresh,fruit,geminat,generally,glabrescent,glabrou,glabrous,globose,greatly,green,green-white,greenish,hair,hair-like,half,herb,homostylous,honeycomb-shaped,interjected,lanceolate,lateral,leaflet,lengthening,light,like,living,lobe,long,lower,make,margin,membranous,middle,midrib,minutely,mm,mottled,mucilaginous,narrowly,nflorescence,oblique,odd-pinnate,often,orolla,ovate,ovate-lanceolate,ovoid,pair,pale,pedicel,peduncle,pentagonal,perfect,petal,petiole,petiolule,plant,plurifoliate,population,pore,poricidal,proximal,puberulent,pubescent,purple,reduced,removed,rounded,ruit,seed,seudostipule,shortly,singly,size,slightly,slit,sometimes,spaced,specimen,stamen,star,ste,stellate,stem,stigma,stolo,straight,striped,style,subequal,subglabrous,subtending,tall,tamen,tem,terminal,testal,thick,throughout,tip,tri-,truncate,tube,tuber,typically,unit,unwinged,usually,vary,varying,wall,wet,whitish,wide,wing,x,yellow,ympodial	
163	wfo-0001027624	exception_thrown	189	0	0	189	0	0.0		0-3,0-7,0.1-0.9,0.3-1,0.4-3,0.5-1.5,0.8-5.6,1-2,1-3,1-5,1.1-8.4,1.2-2.6,1.3-2.9,1.5-6.6,2-20,2-5,2-7,2.4-4.8,2.9-12,3-10,3-11,3-4,3-5,4-15.2,4-7,4-8,5-9,5-merou,6-18.5,9-41,abaxially,acuman,acumen,acuminate,acute,adaxially,ag,along,alyx,anther,apart,apex,apparently,arranged,articulated,axe,axillary,base,bead,berry,blade,brownish,bud,capitat,cell,clavate,cm,condition,connivent,considerably,corolla,covering,cuneate,decreasing,decumben,decurrent,deep,densely,diameter,digestion,distal,dorsally,drying,eaf,edge,eed,elliptic,entirely,enzyme,erect,exceeding,filament,flat,flower,folded,forked,fresh,fruit,geminat,glabrou,glabrous,globose,green,green-white,greenish,hair,hair-like,half,herb,homostylous,honeycomb-shaped,interjected,lanceolate,larger,lateral,leaf,leaflet,leave,lengthening,light,like,living,lobe,long,lower,make,middl,mm,moniliform,mottled,mucilaginous,multiple,necklace,nflorescence,odd-pinnate,onto,orbicular,orolla,ovate,ovoid,pair,pedicel,peduncle,pentagonal,perfect,petiole,plant,plurifoliate,pore,poricidal,present,pubescent,purple,rachi,removed,rotate,ruit,seed,sessile,seudostipule,short,size,slightly,slit,sometimes,spaced,specimen,stamen,stigma,stolon,straight,style,subtending,tall,tamen,tem,terminal,testal,thick,throughout,tip,toward,tri-,tube,tuber,typically,unit,unwinged,usually,vary,wall,wet,white,whitish,wide,widely,x,yellow,ympodial	
164	wfo-0001027626	exception_thrown	152	0	0	152	0	0.0		.3,.5,0.1â0.2,0.2â0.6,0.5-1,0.5â1,0.7â1,0.7â2.8,1,1.3â4.5,1.5â2,1.5â8,13â14,14â116,2â3,2â49,2â5,3â4,3â4.5,3â5,3â55,4.4â11,4â6,5-merous,5â6,8,9â18,abaxially,accrescen,acuminate,acute,adaxially,along,alyx,anther,apar,apex,arrangement,axe,base,berry,blade,broadly,c.,calyx,capitat,center,chartaceous,ciliat,clavate,climbing,cm,color,cordate,coriaceous,densely,diameter,distant,distichous,distinct,eaf,eed,elliptical,entire,extra-axillary,filament,fleshy,flower,frequently,fruit,fruiting,glabrou,glabrous,greenish-white,immature,lamina,lanceolate,leaf-opposed,liana,line,lobe,long,lower,m.,margin,maturity,membranous,midvein,minutely,mm,moderately,mor,nearly,nflorescence,nternode,oblique,orolla,ovate,pair,pedicel,peduncle,perfec,petal,petiole,pinnate,plurifoliat,pointed,possibly,pubescent,rachi,reflexed,rounded,ruit,sand-punctat,sand-punctate,scandent,scar,secondary,seen,shortly,shrub,side,simple,slender,somewhat,spaced,sparsely,spindle-shaped,ste,stellate,stigma,style,tamen,tem,terminal,time,tip,trichome,truncate,tube,two,unbranched,unit,unknown,vary,vein,venation,white,wide,wiry-woody,x,ympodial	
165	wfo-0001027630	exception_thrown	149	0	0	149	0	0.0		.1,.2,.5,0.05-0.1,0.5-1,0.5-1.2,0.5-2,1-1.5,1-5,1.4-1.7,1.5-2,2-3,2-6-flowered,3/4,4-6,5.5-11.2,6-10,8-9,acute,also,anther,anthesi,apart,apex,arising,bark,base,beginning,berry,blunt,branchlet,broadly,calyx,ciliate,climbing,cm,corolla,de,decurrent,deflexed,deltoid,densely,dia,distinguishable,eaf,edicel,eed,elongat,erose,except,extreme,filament,free,fruit,fruiting,glabrate,glabrous,globo,globose,golden,green,hirsute,immature,indistinct,inflorescenc,internodal,irregularly,knob-like,known,lanceolate,lateral,leaf,linear,lobe,lobed,lon,long,long-acuminate,lower,main,margin,middle,midrib,minutely,mm,near,nflorescence,novo,occasionally,older,opposite,ovary,pair,paler,papillose,partially,pedicel,petiole,pore,poricidal,portion,prominent,proximal,puberulent,pubescent,raised,reflexed,rest,rounded,ruit,scar,seen,shaped,shrub,simple,slender,spaced,sparsely,stem,stigma,straight,strongly,style,swollen,tall,tapering,tear-drop,terminal,thickened,ti,tip,trichome,tube,ud,ultimate,unifoliat,uniseriate,unit,vein,way,white,wide,widest,wing,winged,x,yellowish,ympodial,young	
166	wfo-0001027661	exception_thrown	222	0	0	222	0	0.0		+,-10,0.5,0.5-,0.5-2,0.6-1.1,0.6-1.5,1-,1-1.5,1-5,1-7,1.2-6,1.3,1.5,1.5-2,2,2.5-3,2.5-7,30,4-15,4-8-celled,4.5-6,40,5-9,5-merou,6-12,6-8,6-9,8-10,<,>,abaxially,acuminate,acute,adaxiall,ag,along,alyx,anther,anthesi,apart,apex,ark,articulate,axi,basal,base,berry,branch,branched,bright,broadly,calyx,capitate,cell,cm,column,commonly,conical,connivent,cordate,corolla,creeping,deeply,dendritic,densely,denser,density,diameter,eaf,eed,ellipsoid,elliptic,entire,even,extremely,filament,flattened,flower,free,fruiting,fused,glabrous,globose,gre,green,grey,ground,growth,herbaceous,hue,ilament,irregularly,lamina,lateral,leaf,leaf-opposed,leaving,lengthening,like,lobe,lobed,long,long-exserted,lower,many,margin,markedly,membraneous,minute,minutely,mixture,mm,moderately,narrowing,near,new,nflorescence,occasionally,often,older,open,orolla,outline,ovate,pair,pale,papillat,papillate,papillo,pedicel,peduncle,peg,pentagonal,per,perfect,pericarp,petiole,pinnatifid,pitted,plurifoliat,pointed,pore,poricidal,portion,primary,prominent,pubescen,pubescence,pubescent,purple,purplish,rachi,rarely,red,reflexed,reniform,ripe,ruit,scar,shape,shiny,short,simple,single,sinus,size,sleeve,slender,slit,small,spaced,sparsely,spot,spreadin,spreading,stellate,stem,stigma,strongly,style,surface,swollen,tan,tangled,tem,terminal,ternately,testa,thin,tightly,time,tip,trailing,triangular,trichome,truncate,tube,turbinate,two,type,ud,underground,unieriate,uniseriate,unit,upper,usually,variable,vary,vein,vine,violet,way,white,wide,woody,yellow,yellowish,ympodial,zig-za,Â¾	
167	wfo-0001027714	exception_thrown	251	0	0	251	0	0.0		+,.5,/3,0,0.4,0.5,0.5-0.7,0.6-0.7,0.9-1.5,1,1-,1-1.5,1-1.6,1-2,1.5-2,1.5-2.5,1.5-3,1.5-5,14-16,2-,2-2.5,2-8,2.5-,2.5-4,2373.,3-3.5,4-10,4-5,4.5-5,5,5-10,5-6,5-merou,6-7,7-20,80,<,abaxial,abaxially,acuminate,acute,adaxial,adaxially,age,aid,almost,along,alyx,angle,anther,anthesi,apar,apex,apice,appearance,ark,around,articulated,axi,basal,base,berry,branched,bright,brown,calyx,canop,capitate,cell,channelled,climbin,cm,confined,conical,connected,connivent,cordate,corky,corolla,creating,cucullate,cupped,deep,deflexed,dendritic,densely,denser,diameter,drying,eaf,eed,ellipsoid,elliptic,elongate,enlarged,entire,especially,exserted,fide,filament,flattened,fleshy,flower,free,fruit,fruiting,furcate,giving,glabrate,glabrou,glabrous,globose,groove,growth,hairy,hanging,ilament,immature,individual,inflated,inflorescence,irregularly,juicy,lamina,large,lateral,leaf,leaving,lengthening,like,lobe,lobed,lon,long,longer,loosely,lower,many,margin,marginal,mature,mere,minute,minutely,mm,mpodial,nee,new,nflorescence,nodding,obovate,occasionally,often,older,orolla,otherwise,outline,ovary,pair,pale,papillate,papillo,pedicel,peduncle,peg,per,perfect,pericarp,petal,petiole,petiolule,pinnatifid,pitted,plat,plurifoliat,pore,poricidal,portion,primary,prominent,pubescence,pubescent,purple,reaching,rectangular,red,reddish,reniform,rim,ripe,ruit,scar,seed,shiny,showy,similar,simple,sleeve,slender,slightly,slit,small,somewhat,spaced,sparsely,spreading,stellate-rotate,stem,stigma,strongly,style,surface,tangled,tem,terminal,testa,testal,thecae,thick,thickened,thin,third,time,tiny,tip,tooth,trichome,truncate,tube,twining,ud,uniformly,uniseriate,unit,upper,usually,vein,vine,violet,visible,wall,way,weak,weight,widest,wing,woody,x,yellow,yellowish,younger	
168	wfo-0001027720	exception_thrown	184	0	0	184	0	0.0		%,.25-0.3,0,0-15,0.15-0.25,0.25-0.35,0.3-5,0.4-0.7,0.4-0.8,0.5-0.8,0.5-1,0.6-1.2,0.8-1,1-1.5,1-2,1-3.5,1-locular,1.5-2,13-23,13-35,15-25,2-3,2-4,2-7,2-branched,2-foliate,2.8-3.1,23-35,3-13,4-,4-5.5,4-7,4.3-15,4.3-7.5,5-merous,6,7-10,7-8,7-9,8-11,8-16,9-15,abaxially,absen,absent,acute,adaxiall,adaxially,adult,alyx,anther,apex,apparently,articulated,axe,ba,base,berry,blade,brown,calyx,capitat,chartaceous,cm,confined,connivent,cuneate,cylindrical,deltate,densely,diameter,directed,distall,distally,eaf,eed,eglandular,elliptic,entire,erect,extra-axillary,filament,finger,flattened,flower,fruit,fruiting,geminat,glabrous,gland-tipped,globose,green,hair,half,hig,homostylous,incomplete,inflorescence,intepetalar,juicy,juvenile,lamina,lanceolate,lateral,leaf,length,less,lilac,lobe,long,loosely,lower,margin,markedly,mature,mesocarp,mid-point,midpoint,midrib,minute,mm,narrowly,nflorescence,notched,oblique,orolla,ovate,pale,part,pedicel,peduncle,per,perennial,perfec,perfect,petiole,pore,porrect,present,prickle,pubescent,rachi,ray,red,rhizomatous,ruit,scarce,septum,sessile,short,shrub,simple,slightly,sparsely,stellae,stellate,stellate-pubescent,stigma,straight,style,subreniform,succulen,surface,tamen,tem,thick,thicker,time,tissue,toward,triangular,tube,unarme,unarmed,unit,upper,vary,white,wide,without,x,yellow,yellowi,ympodial	
169	wfo-0001027720	success	272	149	87	185	62	0.32	1/3,aequilateral,anther,apex,apical,appearing,armed,articulated,attenuate,base,berry,broad-based,calyx,channel,channeled,cm,concave,connivent,corolla,deciduous,dehiscence,developed,diameter,difoliate,dorsally,entire,especially,extra-axillary,filament,fruit,glabrous,globose,growth,hair,homostylous,inclined,internode,interpetalar,juvenile,lateral,lavender,leaf,line,long,lower,margin,mature,minute,mm,narrowly,oblique,occasionally,orange,pedicel,petiole,poorly,pore,prickle,red,reflexed,scattered,short,shrub,side,simple,slightly,small,stellae,stellate,stem,straight,subcoriaceous,surface,suture,tall,tissue,translucent,tree,triangular,twice-branched,unarmed,upper,violet,wavy,wide,yellow-ferruginous,young	.0,.04,.2,.3,.5,.9,0,0.1â0.6,0.2â0.4,0.3â0.4,0.7â0.9,0.7â1.1,0.7â1.2,0.8â1.3,0.8â1.9,0.8â2.0,0.9,1.4â1.9,1.5â1.7,1.5â2.0,1.5â2.5,1.5â3.3,1.5â9.0,1.7â1.8,1.7â2.0,1.7â2.5,1.8â2.0,1.9â2.2,1/2,1/3â1/2,10.0,10.8â18.2,12â16,13.0,19.7â30.0,2.0,2.5,2.5â2.8,2.5â2.9,2â3,3.2,3.6,3.7â5.7,3.9,4.0â12.6,4.0â18.0,4â5-merou,5.1â18.6,6.5â9.5,6â8,8.0,8.0â11.9,8.2â10.5,8.5â9.4,9.5â16.0,abaxially,acuminate,acute,adaxially,adnate,alyx,anthesi,apiculate,apparently,attachment,axe,ba,becoming,bilobed,blade,branch,broad,brochidodromous,bud,cancellate,capitate,colore,congested,conical,cream,crisped,curved,densely,dentate,distally,dry,eaf,eed,either,elliptic,emerging,endocarp,erect,exocarp,fertile,filiform,flattened-irregular,flattened-orbicular,flattened-reniform,flower,free,geminat,glandular,glossy,gradually,heavily,hooked,increasing,intersepalar,juic,lamina,large,least,like,lobe,lon,longer,m.,major,midpoint,midrib,midvein,minor,moderately,nearly,nflorescence,notched,oblong,often,orolla,ovate,part,peduncle,per,perforate,point,porrect,porrect-stellate,portion,potentially,presumably,proximal,pubescent,raised,ray,rigid,rip,row,ruit,sessile,shorter,sinus,soon,sparsely,splitting,spread,stamen,stellate-pubescen,stellate-pubescent,stigma,style,subacute,tamen,tem,thin,time,tip,toward,truncate,tube,two,ud,vary,vein,way,weakly,white,yellow,yellow-ferruginou,yellow-tan,ympodia,youngest,Â±equal,Ã,â4	--,0.8-1.9,1.5-2.5,1.5-9.0,2-3,3.7-5.7,4,absent,actinomorphic,appressed,articulation,bract,branching,breeding,cell,colour,connective,form,fruiting,geminate,heteromorphism,inflated,inflorescence,insertion,interjected,leaflet,length,marking,modification,needle-like,none,odour,orientation,paired,pattern,perforated,placement,position,present,pseudostipule,radial,rhizome,ripe,scale,shape,smell,spot,staman,stone,structure,symmetry,sympodial,system,texture,trichome,tuber,type,unit,unmodified,vegetative,xylopodia,zygomorphy
170	wfo-0001027757	success	186	146	79	107	67	0.425	0.6,12,2,5,accrescent,acute,anther,apex,apical,arising,articulated,basal,base,blue,branching,calyx,campanulate,cell,cm,colour,concave,convex,decurrent,directed,distally,entire,erect,erose,filament,fleshy,fruit,globose,hair,irregularly,leaf,lilac,lobe,lobed,long,longitudinal,lower,margin,mm,multicellular,oblong,obtuse,occasionally,opening,opposed,pair,pale,pedicel,perennial,perfect,petiole,plurifoliate,pore,poricidal,primary,regularly,rotate,secondary,serrate,shrub,side,simple,slit,smaller,sometimes,stone,straight,surface,tip,unbranched,uniseriate,unit,unknown,violet,x	0.2,0.2â0.3,0.3â2.0,0.5,0.6â1.0,0.7,0â1.4,1.0â1.1,1.0â2.5,1.2â4.0,1.5â1.6,1.5â2.5,1.6â2.4,1.9â2.7,1â1.5,1â11,1â2,1â3,2.5,2.5â4,2.5â5.5,2.5â7,2â,2â10,3â12,3â5,4â9,5â,60â100,6â9,7â8,8â16,abaxially,absen,adaxiall,adaxially,ag,along,anthesi,apart,axe,axillary,ba,blade,borne,brown,chartaceous,clavate,connivent,cylindrical,dark,deeply,densely,diameter,eaf,eed,elliptic,equal,flattened,flower,geminat,glabrescen,glabrou,glabrous,lanceolate,leafy,lon,m.,moderately,narrowly,nflorescence,often,orolla,ovate,peduncle,pitted,probably,pubescent,rootstock,ruit,shoot,spaced,sparsely,stigma,style,tall,tamen,tem,thic,thickened,time,toward,tube,unicellular,vary,white,wide,woody,yellow,ympodial,â19,â2.7,â3.2,â4.0,â5.5,â6,â9	--,0,1,1.4,2.5-5.5,3,4,5.5,9,absent,actinomorphic,age,appressed,articulation,berry,bract,breeding,broad-based,connective,corolla,form,fruiting,geminate,growth,heteromorphism,inflated,inflorescence,insertion,interjected,interpetalar,leaflet,length,marking,mature,modification,needle-like,none,odour,orientation,paired,pattern,placement,position,present,prickle,pseudostipule,rhizome,scale,shape,smell,spot,staman,stellate,stem,structure,symmetry,sympodial,system,texture,thick,tissue,trichome,tuber,type,vegetative,xylopodia,zygomorphy
171	wfo-0001027765	exception_thrown	167	0	0	167	0	0.0		-30,-4,-44,0-.,0.8,1,1-,1-10,1-11.5,1-2,1-4,1-5,1.5-6,10-13,2-2.5,2-3,2-4,2.5-4,2.5-4.2,20-30,3-,3-12,3-20,3-6-foliat,5,5-15,5-6,5-8,7-20,abaxial,abaxially,abruptly,acumen,acuminate,acute,apex,apical,apically,apiculate,articulate,base,branched,calyx,cell,cm,connate,cordate,corolla,covering,cuneate,cyme,dehiscent,diameter,dichasial,dichasially,digestion,diminishing,distal,dorsally,eaf,ebracteate,edge,eed,elliptic,elliptic-lanceolate,emoval,enzyme,exceeding,filament,flat,flower,folded,forked,generally,glandular,globo,globose,green,green-white,hair,hair-like,half,herbaceous,honeycomb,interjected,introrse,lateral,leaf,leaflet,light,living,lobe,lon,long,lower,lunat,make,maturing,mm,monochasial,mucilaginous,nflorescence,nther,oblique,obtuse,odd-pinnate,often,orolla,ovate,ovate-elliptic,ovate-lanceolate,ovoid,pair,pattern,pedicel,peduncle,perennial,perfect,petiolate,petiole,petiolule,pilose,plan,plant,poricidally,proximal,reveal,rounded,ruit,seed,sessile,seudostipule,short,side,simple,size,slightly,slit,specimen,stamen,stellate,stigma,straight,style,tal,tem,terminal,testal,thick,throughou,throughout,tip,tone,toward,truncate,tuber-bearing,typically,unit,vary,violet,wall,white,wide,without,yellow,ympodial,Â¼	
172	wfo-0001027807	success	116	87	31	85	56	0.267	0.2-0.9,2-5,apex,attenuate,base,berry,cm,decurrent,dry,fruiting,glabrous,globose,green,growth,internodal,leaf,leaf-opposed,margin,material,occasionally,pedicel,petiole,revolute,shrub,simple,slightly,small,stem,surface,tree,winged	.5,0-0.2,0.1-1,0.2-0.3,0.3-0.4,0.9-1,0.9-2.5,1-1.5,15-30,2-6,3.5-9,abaxially,acuminate,acute,adaxially,almost,barely,bark,brittle,brown,bud,closely,deflexe,deflexed,diameter,difoliate,drying,eaf,eed,ellipti,elliptic,flattened,flower,geminat,gray,grayish,know,known,lanceolate,maturity,midrib,minutely,mm,narrowly,new,nflorescence,older,ot,overlapping,pair,pale,paler,papillae,papillate,parallel,peduncle,pitted,plane,primary,prominent,rachi,reddi,reddish,reniform,reproductive,ruit,scar,seemingly,shoot,slender,somewhat,spaced,sparsely,thickened,ud,unifoliate,unit,usually,vein,visible,white,x,yellowish,ympodial,young	anther,appressed,articulation,bract,branching,breeding,broad-based,calyx,cell,colour,connective,corolla,filament,form,fruit,hair,heteromorphism,inflated,inflorescence,insertion,interjected,interpetalar,leaflet,length,lower,marking,mature,modification,needle-like,null,odour,orientation,paired,pattern,placement,pore,position,prickle,pseudostipule,rhizome,scale,shape,smell,spot,staman,stone,symmetry,system,texture,tissue,trichome,tuber,type,vegetative,xylopodia,zygomorphy
173	wfo-0001027816	exception_thrown	187	0	0	187	0	0.0		..,.5,0.2,0.5,0.5-1,0.5-2,0.6-0.8,0.7-1,1,1-1,1-1.5,1-3,1-4,1.2-2,1.5-2,1.8-6,12-14,2-2.5,2-4,2/3,3-3.5,3.5-4,4-5,5-30,5-merou,6-9,<,acuminate,acute,ag,almost,along,alyx,anther,anthesi,apar,apex,ark,articulated,attenuate,axi,base,becoming,berry,bluish,branched,brown,calyx,capitate,cell,cm,confined,conical,connivent,corolla,cupped,dark,dense,densely,diameter,drying,eaf,eed,ellipsoid,em,entire,erect,exserted,filament,filiform,flattened,fleshy,flower,free,fruiting,glabrous,gland-tipped,glandular,globose,growth,half,ilament,inflorescence,irregularly,lanceolate,lateral,leaf,leaving,lengthening,less,like,linear,lobe,lobed,loosely,lower,m.,margin,markedly,minute,minutely,mm,new,nflorescence,nodding,occasionally,often,older,orange,orolla,pair,papillo,patent,pedicel,peduncle,peg,per,perfect,perhaps,pericarp,petiole,pitted,plant,plurifoliat,pore,poricidal,portion,primary,prominen,pubescen,pubescent,purple,rectangular,red,reddish,reniform,ripe,rounded,ruit,scar,several,shiny,shrub,simple,sleeve,slightly,slit,small,sometimes,somewhat,spaced,sparse,sparsely,spreadin,spreading,square,stellate,stem,stigma,style,surface,terminal,testal,thin,time,tip,triangular,trichome,tube,twinin,ud,ultimate,uniformly,uniseriate,unit,upper,usually,variable,vary,vein,viscous,way,woody,x,yellowish,ympodial,Â½	
174	wfo-0001027819	exception_thrown	199	0	0	199	0	0.0		-100,0.5-1,1,1-,1-2,1-5,1.5-2,10-20,10-50,12-21,15-22,16-25,2,2-,2-15,2-3,20-25,20-35,20-40,22-35,25-35,3-40,3-5,3-5-lobed,4,4-10,4-15,4-25,4-5,5,5-6,5-merous,8-10,9-12,abaxially,acute,adaxially,aggregate,also,alyx,apart,ape,apex,apical,apiculat,articulated,axe,ba,basal,base,beyond,blade,branched,cell,ciliate,cm,color,concave,connective,cordate,cuneate,cylindrical,deeply,densely,denser,dia,diamete,diameter,dilated,directed,distally,divided,eaf,eed,eglandular,eglandular-pilose,ellipsoidal,elliptic,elliptic-ovate,entire,equal,especially,exceeding,except,exserted,fading,finely,fleshy,flower,forked,fruit,glabrous,globose,green,hair,halfway,leaf,leaving,length,lobe,lobed,lon,long,lower,main,margin,mesocarp,midrib,mm,moderately,narrow,narrowly,near,nflorescence,nther,oblique,oblong,obtu,obtuse,occasionally,often,orolla,ovate,pedicel,pedicellar,peduncle,per,perfec,perfect,petiole,pilose,pinnately,pore,present,probably,prominent,protuberance,puberulen,puberulence,puberulent,purple,purplish,rachi,radiu,ranch,rarely,ratio,remnant,ripe,rounded,rown,rugose,ruit,runk,shallowly,short-acuminat,shorter,simple,sinus,slightly,small,sometimes,spaced,sparsely,stamen,stellate,stigma,stone,strongly,style,subcoriaceous,swelling,sympodial,tal,thecae,toward,tree,triangular,truncate,tube,two,ud,umbrella-shaped,unbranched,uni,unit,unknown,unlobed,usually,vary,vein,villous,whitish,wide,width,without,x,yellow,young	
175	wfo-0001027834	exception_thrown	236	0	0	236	0	0.0		-6.1,.5-3,0-110,0.2-0.3,0.2-0.4,0.2-0.6,0.4-1.1,0.5-2,0.9-1.8,1-1.6,1-1.9,1-10,1-2.5,1.1-1.6,1.1-1.8,1.4-2,1.6-2.7,1.8-4.9,1/2,10-25,2-3.8,2-8,2.2-4.3,2.3-3.4,2.4-6.2,2.7-7.3,2.9-4.2,25,3-15,3-4.3,4-5.2,4-6,4.8-6.9,5-20,5-merous,5.1-8,6.9-18.1,9-11.9,9-13,abaxial,abaxially,absent,accrescent,acuminate,acute,adaxial,adaxially,ag,alyx,angled,anther,anthesi,apar,apex,apical,around,articulated,attenuate,axillary,ba,bark,base,becoming,berry,blade,blunt-tipped,branch,branched,branching,brown,bud,calyx,capitat,closely,cm,completely,concentrated,connivent,coriaceous,corolla,covering,crown,cylindrical,deltoid,dendritic-echinoi,dendritic-echinoid,densely,diameter,dichasia,directed,discolorous,distally,drying,eaf,echinoi,echinoid,edge,eed,ellipsoid,enclosing,entire,enveloping,equal,erec,exserted,farinose,filament,finely,flat-topped,fleshy,flower,forming,fruit,fruiting,glabrescent,glabrous,globose,granular-tomentose,gray,grooved,hair,high,included,inserted,leaf,lengthening,lenticular,less,light,lobe,lobed,long,long-stalked,longitudinal,longitudinally,lower,many,margin,mm,mostly,multangulat,multangulate,near,nflorescence,numerous,obovate,obscured,obtuse,older,orbicular,orolla,ovate,ovate-elliptic,ovate-lanceolate,pair,pedicel,peduncle,perfec,persistent,petiole,plurifoliate,pore,poricidal,porrect-stellate,primary,pseudo-terminal,pubescence,pubescent,rachi,rarely,ray,reticulate-punctate,ripe,rounded,ruit,runk,scabridulous,scar,semi-ovate,semi-spherical,sessile,short,short-stalked,shrub,simple,slit,small,soft,sometimes,somewhat,spaced,sparsely,spreading,stalked,stamen,stellate,stellate-pubescent,stem,stigma,style,subcampanulate,subcoriaceous,surface,suture,tamen,though,time,tip,tomentose,tomentu,tomentum,toward,tree,trichome,tube,turbinoid,ud,unarme,unit,usually,vary,vein,velutinous-tomentose,villous,way,white,whitish,whitish-tomentose,wide,x,yellow,yellowish,yellowish-tan,yellowish-tomentose,ympodial,young	
176	wfo-0001027843	exception_thrown	154	0	0	154	0	0.0		.5,.75,/3,0.5-0.75,0.5-1,0.8-3.5,1-1.2,1-1.3,1-1.5,1.2-1.5,1.2-2.5,2-2.5,2-4,3-15-flowered,3-6,5-6,6-13,6-9,acute,along,anther,anthesi,apart,apex,apiculate,ba,bark,base,bearing,becoming,beginning,beneath,berry,broadly,calyx,clavate,cm,conical,coroll,corolla,curly,deflexed,deltoid,densely,denser,dia,differing,difoliate,distally,eaf,edicel,eed,ellipsoid,erose,exsertion,filament,flower,free,fruiting,geminat,glabrate,glabrous,globose,green,hairy,impressed,irregularly,known,lamina,larger,later,lateral,leaf,like,lobe,lobed,lon,long,long-acuminate,lower,main,major,margin,middle,minor,minutely,mm,near,nearly,nflorescence,occasionally,older,one,opposite,orbicular,ovary,ovate,pair,papillo,papillose,pedicel,petiole,pleated,pore,poricidal,portion,prominent,proximal,pubescent,reddish-gre,reflexed,rounded,ruit,scar,shape,shaped,shrub,simple,sinus,size,slender,slightly,somewhat,spaced,sparsely,sparser,stem,stiff,stigma,straight,strongly,style,surface,tall,tapering,tear-drop,time,tip,tipped,trichome,tube,two,ud,uniseriate,unit,vein,way,white,widest,winged,woody,x,ympodial,young	
177	wfo-0001027847	success	219	194	141	78	53	0.644	-0.8,-3,-4,-6,.7,/2,/3,0-2,0-7,0.1-0.4,0.15-0.2,0.2,0.4-1,0.5,0.5-1,1-2.5,1.5-2,1.5-5,1/2,1/6-1/3,2-3,2-4,2-5,3-15,3-5,5-6,5.5-8,6-11,6-8,ame,anther,apart,apex,apically,apparently,bark,base,berry,blade,branched,broadly,c.,calyx,chartaceous,cm,cordate,curved,deltate,densely,dimorphic,discolorous,distance,drying,elliptic,elongating,equal,erect,extending,faint,filament,flattened,free,fruit,fruiting,geminate,glabrescent,glabrous,gray,green,lateral,leaf,length,lobe,lobed,long,longer,lower,margin,mature,maturity,mauve,midpoint,midvein,minor,mm,older,orange,orbicular,ovate,pair,pedicel,perpendicular,petiole,poricidal,porrect,portion,prickle,prickly,primary,purple,ray,red,red-brown,reddish,retrorse,rounded,scandent,sessile,shrub,side,simple,spaced,sparsely,spherical,stalk,stalked,stellate,stellate-pubescent,stem,straight,strongly,surface,tapering,terete,terminal,tertiary,time,tip,trichome,tube,unit,usually,variously,vein,venation,visible,way,weakly,white,wide,young	-2,-2.5,-5,.35,0,0.8,0.8-0.9,0.8-1.2,1,1-2,1.5-2.5,1.9-2.3,1/4,2-2.8,2.2-3,2.5-3.5,2/,3-6,3.5-6,4-5-merous,5-25,7-10,abaxially,acute,almost,alyx,apar,articulated,brow,connivent,diameter,dull,eaf,edge,eed,evenly,filiform,filiform-acuminat,finely,flattened-reniform,flower,increasing,infructescence,lon,middle,moderately,narrow-deltate,nflorescence,one,open,orange-brown,orolla,oung,peduncle,pendulous,per,perfec,pericarp,pit,pitted,plurifoliat,prickl,ruit,scar,seed,size,slender,smooth,sometimes,spreading,style,tamen,toward,unarmed,upper,vary,yellow,ympodial	appressed,articulation,bract,branching,breeding,broad-based,brown,cell,colour,connective,corolla,form,growth,hair,heteromorphism,inflated,inflorescence,insertion,interjected,interpetalar,leaflet,marking,mentioned,modification,needle-like,odour,orientation,paired,pattern,perfect,placement,plurifoliate,pore,position,pseudostipule,rhizome,scale,shape,smell,spot,staman,stone,structure,symmetry,sympodial,system,texture,tissue,tuber,type,vegetative,xylopodia,zygomorphy
178	wfo-0001027872	exception_thrown	190	0	0	190	0	0.0		0.5,1,1-1.2,1-4,1-8,1.0-1.3,1.5-4,10,12-35,15,2,2-3,2.2-3.5,2.8,20,3-6-foliat,35,4-6,5-10,5-7,5-8,5-lobed,6-20,8-11,abaxially,acumen,acuminate,acute,adaxially,angular,apex,apical,apically,apiculate,articulate,b,ba,basal,base,becoming,branched,ca,calyx,caudate,cell,celled,clasping,cm,commonly,connate,cordate,covering,cuneate,cyme,decreasing,deep,dehiscent,densely,diameter,dichasial,dichasially,digestion,distal,eaf,ebracteate,eed,elliptic,emoval,enzyme,erect,exceeding,externally,filament,flower,forked,four-celled,generally,glabrescent,gland,glandular,glandular-pubescent,globo,globose,gray-green,green,green-white,hair-like,half,herbaceous,homogeneously,honeycomb,interjected,introrse,lanceolate,lateral,leaflet,light,living,lobe,lon,long,longer,lower,make,maturing,middle,mm,moderately,monochasial,mottled,mucilaginous,narrowly,nearly,nflorescence,nther,obliquely,oblong,odd-pinnate,often,orolla,ovate,ovoid,pair,pattern,pedicel,peduncle,pentagonal,perennial,perfect,petiolate,petiolulate,petiolule,plant,poricidally,puberulent,pubescent,purpl,purple,rarely,reduced,reveal,rhizomatous,rhizome,rotate,rotate-,rounded,ruit,seed,semi-lunate,sessile,seudostipule,shape,short,single,size,slightly,slit,sometimes,somewhat,specimen,stamen,ste,stigma,straight,style,subequal,symmetrically,tem,terete,terminal,testal,thick,tinged,tip,trailing,type,typically,unbranched,uniformly,unit,usually,vary,viole,wall,wid,wide,wider,yellow,yellowish-green,ympodial	
179	wfo-0001027880	exception_thrown	185	0	0	185	0	0.0		-3,-3.5,.25,0.3-3,0.5-1.5,0.5-5,0.6-1,0.6-1.5,0.8-1.5,1-14,1-15,1-2,1-2.5,1-3,1.5-2,1.5-3,10-15,2-3,2-80,2/,3-4,4-10,4-6,5-11,5-8,5-merou,8,abaxially,absen,accrescen,acuminate,acute,adaxially,ag,aggregate,along,alyx,anther,apart,apex,apiculate,apparently,articulated,axe,ba,base,blade,branch,branching,calyx,cell,chartaceous,ciliat,clavate,cm,conical,connivent,contiguously,cordate,coriaceous,curled,cylindrical,deltate,dense,densely,diameter,diminishing,directed,discolorous,distally,distichous,distinct,distinctly,eaf,eed,entire,epiphytic,equal,extra-axillary,filament,flattened,flower,fruit,fruiting,geminat,glabrous,globose,green,greenish,growing,hair,increasing,inflorescence,internode,leaf,leaf-opposed,line,lobe,long,longer,longitudinal,lower,margin,midvein,minutely,mm,multicellular,nearly,nflorescence,node,oblique,oblong,oblong-ovate,occasionally,often,opening,orolla,ovate,ovoid,pair,pale,papillose,pedicel,peduncle,perfect,petiole,pink,plurifoliate,point,pore,pubescen,pubescent,purple,rachi,red-brown,reddish,revolute,ripe,rooting,rounded,rugulose,ruit,scar,secondary,shrub,simple,size,slender,slightly,slit,sometimes,somewhat,spaced,sparsely,ste,stellate,stigma,stone,style,surface,tamen,tan,tem,thickened,time,tip,trailing,tree,truncate,trunk,tube,typically,unbranched,undulate,uniseriate,unit,usually,vary,vein,vine,white,wide,x,yellow,ympodial	
180	wfo-0001027880	exception_thrown	170	0	0	170	0	0.0		.25,0.2-0.5,0.3â3,0.5,0.5â1.5,0.5â5,0.6â1,0.6â1.5,0.8â1.5,1.5â2,1.5â3,10â15,1â14,1â15,1â2,1â2.5,1â3,2-80,2/3,2â3,3â4,4â10,4â6,5-merous,5â11,5â8,8,abaxially,absent,accrescen,acuminate,acute,adaxially,along,alyx,anther,apar,apex,apiculate,arrangement,axe,base,berry,blade,bluish-purple,c.,calyx,capitat,chartaceous,ciliat,clavate,climbing,cm,conical,contiguously,cordate,coriaceous,curled,cylindrical,deltate,dense,densely,diameter,discolored,distichous,distinct,distinctly,eaf,eed,entire,extra-axillary,filament,flattened,flower,fruit,fruiting,glabrous,globose,green,greenish,hair,lanceolate,leaf,leaf-opposed,line,lobe,long,longer,lower,m.,margin,membranous,midvein,minutely,mm,mottled,nearly,nflorescence,nternode,oblique,oblong-ovate,occasionally,often,orolla,ovate,ovoid,pair,pale,papillose,pedicel,peduncle,perfec,petiole,pink,pinnate,plurifoliat,pubescent,rachi,red,reddish,reddish-brown,revolute,rip,rounded,rugulose,ruit,sand-punctat,sand-punctate,scar,secondary,shrubby,simple,slender,slightly,sometimes,somewhat,spaced,sparsely,ste,stellate,stigma,style,surface,tamen,tan,tem,thickened,time,tip,tree,trichome,truncate,trunk,tube,typically,unbranched,undulate,uniseriate,unit,vary,vegetatio,vein,venation,vine,white,wide,woody,x,ympodial,â3.5	
181	wfo-0001027881	exception_thrown	215	0	0	215	0	0.0		-3,.3â0.5,0.5â2.2,0.8â1.5,1-celled,1.3â2,1.8â2.9,10â25,1â2,1â2-celled,1â2.5,1â2.6,1â3,1â3-celled,1â4,2.5â3.6,20â40,2â4,2â6,2â7,4â6,4â9.5,5,5-merous,6â10,7â14,7â9,8,abaxially,absent,abundant,accrescent,acuminate,acute,adaxiall,adaxially,almost,alyx,anther,apex,appressed,articulated,asymmetric,attenuate,axe,ba,barely,base,berry,blackish,blade,bulge,calyx,camptodromous,capitat,case,central,chartaceous,ciliate,closely,cm,commonly,connected,connivent,contiguous,cordate,cordiform,curved,cylindrical,decurrent,dehiscing,densely,denser,diameter,difoliate,directed,dorsally,drying,eaf,ed,eglandular,emarginate,emerging,entire,equal,erect,exceeding,exclusively,explosively,extra-axillary,eye,few-,fewer,filament,flattened,flower,forming,frequent,fruit,geminate,giving,glabrous,glandular,globose,greenish,groove,hair,half,held,herb,hollow,immature,impression,interpetalar,introrsely,larger,lateral,leaf,less,light-brown,like,lobe,long,longer,longitudinal,lower,mainly,many-branched,margin,maturit,maturity,membranaceous,mesocarp,mixed,mm,moderately,much,multicelled,multicellular,naked,near,netlike,nflorescence,normally,one,opening,orolla,other,ovate-elliptic,pair,parallel,part,pedicel,peduncle,per,perfec,petiole,placenta,pore,pressure,primary,projection,prominent,pubescence,pubescent,rachi,raised,reniform,rotate,ruit,secondary,seed,sessile,short,side,similar,simple,size,slightly,slit,small,smaller,solitary,sometimes,sparsely,stalk,staman,stamen,stem,stigma,style,subapically,subopposite,surface,tal,tamen,tem,tissue,translucent,triangular,tube,two,unbranched,unit,vary,vein,venation,visible,watery,white,winged,woody,yellow,ympodial,Ã	
182	wfo-0001027882	exception_thrown	184	0	0	184	0	0.0		.25,.5,0.1,0.5-1,06a,1,1-1.5,1-5,1.5-,1.5-2,1.5-2.2,1.5-6,1.6-2.2,10-25,10-40,2-3,2-6,2-lobed,2.1-2.6,2.5-3,3-4,3.2-6,3.5-4,3.5-5,4-5,6-9,7-,9-13,abaxially,absent,acuminate,adaxially,age,along,anther,anthesi,apart,apex,apparently,appearing,attenuate,axil,bark,base,berry,branch,branched,branching,broadly,brown,c.,caly,calyx,clavate,cm,completely,conical,corolla,cucullate,dark,deltate,dense,densely,diameter,difoliate,dry,drying,eaf,eed,elliptic,entire,erect,et,exerted,fide,filament,flattened,flower,fork,free,fruiting,fusiform,geminat,glabrou,glabrous,globose,green,growth,hairy,hollow,hooked,inflorescence,irregularly,junction,kallunki,lamina,leaf-opposed,lengthening,less,lobe,lobed,lower,margin,markedly,maturity,midrib,minutely,mm,new,nflorescence,nodding,occasionally,ovary,ovoid,pair,pale,papillat,papillate,paulo,pedicel,peduncle,penden,perfect,petiole,pitted,planar,plane,pointed,population,pore,poricidal,portion,primary,pulp,rachi,rarely,red-papillat,reddish,reniform,ruit,scar,shattering,shiny,shrub,simple,slender,slit,small,sometimes,spaced,sparse,sparsely,specimen,stem,sticky,stigma,stout,straight,strongly,structurally,style,surface,sweet-scented,swollen,sÃ£o,thickened,time,tip,tree,trichome,tube,tuft,ud,uniseriate,unit,usually,vein,way,white,woody,x,yellow,yellowish,ympodial	
183	wfo-0001027889	exception_thrown	151	0	0	151	0	0.0		-2.5,-pubescent,.5,.5-2,0,0.5-1,0.5-11,0.7-2,1,1-10,1-3,1-3.5,1.5,1.5-2,10-12,10-20,10-30,2-20,2-3,3-4,3-8,3-9,4-foliat,5-10,abaxially,acuminate,acute,acute-acuminate,adaxially,aggregate,apart,ape,apex,apiculate,articulated,axe,basal,base,beyond,blade,calyx,capitat,cell,chartaceous,cm,color,connective,connivent,cylindrical,darker,deltate,densely,diameter,dilated,directed,distally,eaf,eed,eglandular-puberulent,eglandular-pubescent,elliptic,entire,equal,exceeding,exserted,extending,finely,flower,fruit,glabrous,glandular-,green,greenish,immature,introrse,laterally,leaving,length,light,lobe,lon,long,longitudinal,lower,margin,mm,moderately,narrow,nflorescence,nther,oblong,orolla,ovate,ovoid,pedicel,pedicellar,peduncle,perfect,petiole,pore,presen,present,probably,puberulen,puberulent,puberulent-pubescen,puberulent-pubescent,rachi,radiu,remnant,ripe,ruit,shrub,simple,slightly,small,somewhat,spaced,sparsely,stamen,stellate,stigma,stone,stripe,style,subcordate,subcoriaceous,swelling,tal,tem,thecae,time,tip,tomento,tomentose,tree,triangular,truncate,tube,ud,unbranched,unit,unknown,vary,violet,white,wide,x,yello,yellowish,ympodial	
184	wfo-0001027901	exception_thrown	156	0	0	156	0	0.0		.25,.5,0.3-1.2,0.5-1,0.8-1,0.8-2,0.9-2.3,1-1.5,1-2,1-2.5,1.5-1.8,1.8-4.5,2.5-3,3-5,4-10-flowered,4-5,4.7-12,6-7,?,abaxial,abaxially,acuminate,acute,adaxially,anther,anthesi,apex,area,attenuate,ba,bark,base,beneath,berry,bright,broadened,brow,brown,calyx,closely,cm,conical,corolla,curled,dark,deflexed,densely,dia,differing,difoliate,direction,dry,drying,eaf,edicel,eed,ellipsoid,elliptic,exserted,filament,firm,fleshy,free,fresh,fruiting,geminat,glabrous,globose,green,imbedded,immature,inflorescence,keeled,later,lateral,leaf,like,lobe,lobed,lon,long,lower,main,major,material,matrix,middle,midrib,minor,minutely,mm,nearly,nflorescence,older,opposite,orbicular,oriented,ovary,overlappin,ovoid-reniform,pair,papillo,papillose,pedicel,petiole,pitted,planar,pore,poricidal,portion,prominently,pubescent,reddish,reflexed,rest,ripe,rounded,ruit,scar,shape,shaped,shiny,shrub,simple,single,size,slender,spaced,sparsely,stem,stigma,straight,strongly,style,surface,swollen,tall,tear-drop,tip,translucent,triangular,trichome,tub,tube,ud,uniseriate,unit,usually,vein,white,widest,woody,x,yellow,ympodial,young	
185	wfo-0001027902	exception_thrown	128	0	0	128	0	0.0		-2.5,0.5-1,1-1.5,1-2,1-6,1.5-3,10-15,10-20,15-30,2,2-12,2-15,2-3,2-8,2-9,20-50,3-4,3-5,3-foliat,4-25,4-5,5-20,6-37,7-9,8-13,abaxially,absen,acuminate,acute,adaxiall,adaxially,aggregate,angled,apart,apex,articulated,axe,base,blade,branched,calyx,cell,chartaceous,cm,color,connivent,cordate,cylindrical,deeply,densely,diameter,directed,distall,distally,eaf,eed,eglandular,entire,flower,forked,fruit,glabrous,glandular,globose,hair,inflated,leaving,like,lobe,lon,long,lower,margin,mm,moderately,narrowly,nearly,nflorescence,nther,obtuse,orolla,ovate,pedicel,pedicellar,peduncle,petiole,pore,puberulent,pubescen,pubescent,purple,purplish,rachi,radiu,remnant,reticulate,ripe,ruit,shrub,simple,small,spaced,sparsely,ste,stellate,stigma,stone,style,subcoriaceous,tal,tem,time,tip,tree,triangular,truncat,truncate,tube,unbranched,unit,unknown,usually,vary,whitish,wide,x,yellow,ympodial	
186	wfo-0001027929	success	193	159	102	91	57	0.528	1,1-4,1-8,10,15,2,20,4-5,4-6,abaxially,adaxially,along,apex,apical,articulate,basal,base,beyond,branched,calyx,cell,center,clasping,cm,connate,cordate,corolla,covering,cuneate,cyme,darker-violet-blue,decreasing,deep,dehiscent,diameter,dichasial,dichasially,distal,ebracteate,filament,generally,glabrous,globose,green,hair,hair-like,half,herbaceous,honeycomb,interjected,introrse,lanceolate,lateral,leaflet,light,long,lower,maturing,middle,mm,monochasial,obliquely,odd-pinnate,pair,pattern,pedicel,perennial,perfect,petiolate,plant,poricidally,puberulent,purple,rarely,reduced,rhizomatous,rhizome,rotate,rounded,semi-lunate,shape,short,size,slit,sometimes,somewhat,spot,star,subequal,testal,thick,typically,unbranched,unit,usually,vein,violet,violet-blue,wall,white,wide,without	0.2-0.9,1-10,1.0-1.3,1.5-4,2-3,2.0-3.0,3-6-foliat,3.5-5,35,4-30,5-10,5-6,5-lobed,6-15,acumen,acuminate,acute,angular,apically,apiculate,ba,becoming,caudate,cente,coat,color,dark,digestion,eaf,eed,elliptic,embryo,emoval,enzyme,erect,exceeding,except,flower,forked,formed,globo,green-white,included,living,lobe,lon,make,mostly,mucilaginous,narrowly,nearly,nflorescence,nther,oblong,occasional,often,orolla,ovate,ovoid,peduncle,pentagonal,petiolulate,petiolule,purpl,radiating,reveal,rotate-,ruit,seed,sessile,seudostipule,slightly,specimen,stamen,ste,stigma,straight,style,symmetrically,tem,terete,terminal,tinged,tip,trailing,vary,visible,wid,wider,yellow,ympodial	3-6-foliate,anther,appressed,articulation,berry,bract,branching,breeding,broad-based,colour,connective,form,fruit,fruiting,growth,heteromorphism,inflated,inflorescence,insertion,interpetalar,leaf,length,margin,marking,mature,modification,needle-like,null,occasionally,odour,orientation,paired,petiole,placement,pore,position,prickle,pseudostipule,rotate-pentagonal,scale,smell,staman,stem,stone,structure,surface,symmetry,sympodial,system,texture,tissue,trichome,tuber,type,vegetative,xylopodia,zygomorphy
187	wfo-0001027948	exception_thrown	186	0	0	186	0	0.0		-15,-16,-6,.5,0-,0.4,0.5-0.7,0.5-2,0.6,0.8-,1-1.2,1-2,1.2-2.2,1.3-1.8,1.5-4.5,1.6,1/10,10-14,13,14,2-,2.2-,2.5-,3-8.2,3.2-5.2,3.5,3.7-4,5,5-,6-celled,7,7-15,7.5-10,8-celled,abaxially,abundant,accrescen,acuminate,adaxially,ag,aggregate,anther,antrorse,ape,apex,articulate,attenuate,ature,basal,base,berry,bicellular,branch,c.,calyx,campanulate,cell,cm,connectival,corolla,crushed,cuticle,dark,delicate,diamete,diameter,difoliate,directed,dorsally,eaf,edentate,ellipsoidal,elliptical,erect,filament,finely,flexuous,fragrance,free,fruiting,generally,glabrous,glandular,globose,head,herb,herbaceous,hig,hollow,ill-smelling,inconspicuous,inserted,lamina,leaf,length,light,lobe,long,long-stalked,longer,longitudinal,longitudinally,lower,many-,margin,midvein,mm,narrow,narrowly,near,non-glandular,occasionally,odorles,opening,orolla,ovate,ovoid,pair,papillate,patent,pericarp,petiole,pore,poricidal,portion,prolongation,pubescence,pubescent,purple,reduced,ree,ridged,ruit,saddle-shape,scarce,scarcely,secondary,seed,seeded,seen,separated,serrulate,short-stalked,shorter,simple,single-celled,sinus,slightly,slit,small,smooth,solitary,spur-like,stalk,stem,stigma,stone,straight,striat,striate,style,sub-opposite,sub-shrub,tem,thecae,thickened,time,tip,tooth,triangular,trichome,tube,twice,unequal,unit,upward,vary,vein,ventrifixed,verrucate,violet,viscid-pubescent,x,ympodial,Â¼,Â½	
188	wfo-0001027961	exception_thrown	177	0	0	177	0	0.0		.5,0.25,0.25-0.5,0.5-1,0.9-1,1,1-1.5,1-3,1-4,1-5,1-9,10-50,2-2.5,2.3-2.5,2.5-9,3-3.5,4.5-5,5-8,5-merou,6-9,7-9,8-10,<,?,abaxially,acute,adaxiall,adaxially,age,always,alyx,anther,anthesi,apar,apex,ark,articulated,asymmetric,axil,base,berry,branched,broadly,brow,c.,calyx,clavate,clear,cm,conical,connivent,cordate,corolla,curling,deltate,densely,diameter,distributed,eaf,early,eed,ellipsoid,elliptic,entire,equalling,exserted,fading,filament,flower,free,fruiting,fusiform,geminat,glabrous,globose,green,growth,ilament,immature,inflorescence,irregularly,lamina,lateral,lengthening,lobe,lobed,lon,long,loosely,lower,many,margin,mature,maturity,membranous,midrib,minute,minutely,mm,new,nflorescence,obovate,observed,occasionally,often,older,one,orolla,other,pair,papillo,pedicel,peduncle,pendan,perfect,pericarp,petiole,pinched,pinnatifid,planar,plurifoliate,pore,poricidal,portion,present,primary,probably,pubescen,pubescent,purple,reddish,rotate-stellate,ruit,scar,shiny,simple,sleeve,slender,slightly,slit,small,spaced,sparsely,spreading,stem,stigma,style,surface,tem,terminal,thin,time,tip,transition,triangular,trichome,truncate,tube,tuft,twinin,twining,ud,unequal,uniseriate,unit,upper,vary,vein,vine,violet,way,white,white-pubescent,woody,x,yellow,ympodial	
189	wfo-0001027966	exception_thrown	207	0	0	207	0	0.0		0.4-0.5,0.7-3,0.8,0.8-2.5,1-1.8,1-10,1-2,1-3,1-4.2,1-5,1.2-4.5,1.3-2.2,1.5-3,1.5-5.2,10,10-30,2.2-2.9,2.5-10.5,2.8-9,3-4,3-5,3-7,4,40-80,5-10,5-6,5-9.5,5-merou,5.5-14,6-11,abaxially,absent,acumen,acuminate,adaxially,ag,along,alyx,anther,apart,apex,apparently,arranged,articulated,asymmetrical,attenuate,axe,axillary,base,basiscopic,bead,berry,blade,blue-violet,brownish,bud,capitat,cell,chartaceous,ciliate,cm,commonly,condition,conical,connivent,corolla,covering,decreasing,densely,diameter,digestion,distal,dorsally,drying,eaf,edge,eed,elliptic,enzyme,erec,especially,exceeding,filament,flat,flower,folded,forked,fresh,fruit,geminat,generally,glabrou,glabrous,gradually,green,green-white,greenish,hair,hair-like,half,herb,homostylous,honeycomb-shaped,interjected,lanceolate,larger,lateral,leaf,leaflet,lengthening,less,light,like,living,lobe,long,lower,make,margin,medium,membranous,middle,minute,mm,moniliform,mottled,mucilaginous,multiple,narrow,necklace,nflorescence,odd-pinnate,orbicular,orolla,ovate,ovoid,pair,pale,pedicel,peduncle,pentagonal,perfect,petiole,petiolule,plant,plurifoliate,pore,poricidal,proximal,pubescent,purple,rarely,ray,removed,ripe,rotate,ruit,secondary,seed,semierect,sessile,seudostipule,shorter,side,size,slightly,slit,somewhat,spaced,sparsely,specimen,stamen,ste,stem,stigma,stolon,straight,subequal,subsessile,subtending,symmetrical,tall,tamen,tem,terminal,testal,thick,throughout,tip,tissue,tri-,tube,tuber,tyle,typically,unit,usually,violet,wall,wet,white,whitish,wide,wing,x,yellow,ympodial	
190	wfo-0001028014	exception_thrown	222	0	0	222	0	0.0		-0.5,-1,-1/2,-10,-15,-2.5,-3,-4,-5,-6,.5,/5,0,0.1-0.2,0.15,0.15-0.3,0.2,0.2-0.4,0.2-1,0.2-1.6,0.25,0.3-0.4,0.5,0.5-1,0.5-1.5,0.5-2,0.5-3,0.6-0.9,0.7-1,0.7-1.6,0.9-1.2,1-,1-10,1-2,1-3,1-4,1.3-2.4,1.5,1.5-2,1.8-3,1/4,1/4-2/3,2,2-20,2-3,2-4.5,2-6.5,2.5-4,3-10,4-10,4.5-7,5-merous,6-10,6-11,abaxially,acuminat,almost,alyx,ame,anther,apar,apart,apex,apically,apparently,around,articulated,bark,base,berry,black,blade,branched,broad-deltate,brown,brown-green,c.,calyx,cell,chartaceous,cm,concolorous,connivent,cordate,curved,decurrent,deltate,densely,diameter,difoliate,discolorous,distance,drying,eaf,edge,eed,elongating,equal,erect,extending,eye,filament,flattened,flattened-reniform,flower,free,fruit,fruiting,geminat,glabrescent,glabrou,glabrous,gland,globular,gray,gray-green,herbaceous,infructescence,lateral,leaf,length,lobe,lobed,lon,long,longer,lower,margin,mature,maturity,mauve,membranous,midpoint,midvein,mm,moderately,naked,nflorescence,obtuse,occasionally,older,one,open,orange,orange-gra,orolla,oung,outer,outline,ovate,pair,pale,pedicel,peduncle,pendulous,per,perfec,pericarp,petiole,pit,poricidal,porrect,portion,prickl,prickle,prickly,primary,purple,raised,ray,red,reduced,reflexed,rough,rounded,ruit,scandent,scar,seed,sessile,shiny,shorter,shrub,side,simple,slender,smooth,sometimes,spaced,spherical,spreading,stalk,stalked,stellate,stellate-pubescent,stem,straight,strongly,style,surface,tamen,tapering,terete,terminal,tertiary,time,tip,trichome,tube,unit,vary,vein,venation,visible,visibly,way,weakly,wide,winged,yellow,yellow-green,ympodial	
191	wfo-0001028017	success	158	117	59	99	58	0.373	1.5-2,2-4,2.5-5,3-12,5-7,absent,aggregate,apex,base,calyx,cell,cm,connective,connivent,cuneate,densely,directed,distally,eglandular,ellipsoidal,entire,forked,fruit,fusiform,glabrous,glandular,green,greenish,hair,immature,introrse,lanceolate,lower,margin,mm,near,oblique,pedicel,perfect,petiole,pointed,pore,pubescent,rarely,ripe,simple,small,sometimes,stellate,stellate-campanulate,stone,subcoriaceous,tree,truncate,unbranched,unit,white,x,yellow	-2.5,0.3-1,1,1-10,1-2,1-3,10-22,13-40,15-35,15-50-flower,2,2-3,3,3-14,3-4,3-foliat,40-50,5,5-9,6-7,6-8,9-11,abaxially,absen,acuminate,acute,adaxially,apart,ape,apiculate,articulated,axe,basal,beyond,blade,brown,chartaceous,ciliat,clavate,cream,cylindrical,diameter,eaf,eed,eglandular-puberulent,eglandular-pubescent,elliptic,exceeding,exserted,flattened,fleshy,flower,glandular-,glandular-puberulent,leaving,lobe,lon,long,moderately,narrowly,nflorescence,nther,obtuse,orolla,ovate,ovoid,pedicellar,peduncle,puberulen,purple,purplish,rachi,radiu,remnant,ruit,short-acuminate,shorter,slightly,spaced,sparsely,stamen,stigma,style,tal,tan,tem,thecae,time,tip,tomentose,triangular,truncat,tube,ud,vary,vein,wide,without,ympodial	3-foliate,anther,appressed,articulation,bract,branching,breeding,broad-based,colour,corolla,filament,form,fruiting,growth,heteromorphism,inflated,inflorescence,insertion,interjected,interpetalar,leaf,leaflet,length,marking,mature,modification,needle-like,null,odour,orientation,paired,pattern,placement,position,prickle,pseudostipule,puberulent,rhizome,scale,shape,smell,spot,staman,stem,structure,surface,symmetry,sympodial,system,tall,texture,tissue,trichome,tuber,type,vegetative,xylopodia,zygomorphy
192	wfo-0001028033	success	157	107	51	106	56	0.325	anther,apex,attenuate,base,calyx,cell,chartaceous,ciliate,cyme,decurrent,densely,entire,few-branched,filament,fruit,growth,herb,hispid-pubescent,known,lateral,length,like,long,lower,margin,mm,nearly,oblong,onto,pedicel,perfect,petiole,pore,poricidal,pubescence,rhizomatous,shrub,simple,slightly,solitary,spreading,stellate,stem,surface,trichome,unbranched,uniseriate,unit,upright,white,woody	.6,1.4â1.8,1.5,1â4,1â5,2â3,2â4,2âfoliate,3,3â11,3â4,3â5,4â12,4â5,5-merou,50,5â7,6â12,abaxially,acuminate,acute,adaxiall,adaxially,along,alyx,anthesi,ark,ascending,becoming,blade,branch,brochidodromous,brown,capitat,cm,connivent,contiguou,cordate,cylindrical,darker,deeply,denser,diameter,directed,discolorous,drying,eaf,eed,elliptic,emarginate,equal,eye,florescence,flower,geminat,glabrescent,glabrous,green,greenish,high,introrsely,know,light,linear-lanceolate,lobe,lobed,longitudinal,mainly,membranaceous,midrib,naked,new,older,opening,order,orolla,ovate-lanceolate,prominent,prostrat,pubescent,recurved,ruit,secondary,sessile,shin,shiny,shorter,slit,sparsely,stigma,straight,strongly,style,subapical,tamen,tem,tube,unknown,vary,vein,venation,visible,wide,yellow,ympodial,Ã	2-4,2-foliate,6-12,appressed,articulation,bract,branching,breeding,broad-based,colour,connective,contiguous,corolla,form,fruiting,geminate,hair,heteromorphism,inflated,inflorescence,insertion,interjected,interpetalar,leaf,leaflet,marking,mature,modification,needle-like,null,odour,orientation,paired,pattern,placement,position,prickle,pseudostipule,rhizome,scale,shape,smell,spot,staman,stone,structure,symmetry,sympodial,system,texture,tissue,tuber,type,vegetative,xylopodia,zygomorphy
193	wfo-0001028067	exception_thrown	139	0	0	139	0	0.0		-30,0.5-1,0.5-1.5,0.5-2,1,1-10,1-11,1-2,1-3,1-7,1.5-2.5,10-25,2,2-2.5,2-3,2.5-3,3-17,3-4,3-5,3-7,4-foliat,5-7,6-12,6-18,7-11-compound,7-20,7-9,8-13,abaxially,acuminate,acute,adaxiall,adaxially,aggregate,along,apart,apex,articulated,axe,base,basiscopically,blade,calyx,cell,chartaceous,cm,color,compound,connivent,cuneate,cylindrical,dark,decurrent,diameter,directed,distall,eaf,eed,elliptic-fusiform,elliptic-ovate,entire,especially,flattened,flower,fruit,glabrou,glabrous,hair,lateral,leaf,leaflet,leaving,lobe,lon,long,lower,margin,midrib,mm,moderately,narrowly,nearly,nflorescence,nther,obtuse,often,orolla,pedicel,pedicellar,peduncle,per,petiole,pink,pinnately,pore,puberulen,puberulent,purple,rachi,radiu,rarely,remnant,ripe,ruit,several,shrub,simple,slightly,smal,spaced,sparsely,stellate,stigma,stone,strongly,style,subcoriaceous,tal,tem,time,tip,tomentulose,triangular,triangular-deltate,truncat,truncate,tube,unbranched,unequal,unit,unknown,upper,usually,vary,wide,x,yellow,ympodial,zigzag	
194	wfo-0001028069	success	253	209	162	91	47	0.64	-30,-6,.1,.1-0.2,.5,0.1-0.2,0.1-0.3,0.1-0.5,0.1-0.6,0.2-0.3,0.2-0.5,0.3,0.3-1,0.4,0.4-1,0.5-2,0.6-4,1-2-celled,1-2.7,1-4.5,1.4,1.5-3.5,10-30,2-17,2-3-branched,2-4,2-7,2-locular,3,3-,3-foliate,4-celled,5-22,5-25,6-,abaxially,abundant,accrescent,acute,adjacent,alternate,always,among,anther,apex,appressed,articulated,basal,base,basioscopically,berry,bilaterally,bract,bracteole-like,bright,calyx,cell,citru,cm,cordate,corolla,cuneate,decurrent,deep,deeply,dense,densely,due,ebracteate,eglandular,erect,filament,forming,fruit,fruiting,fusion,gland,gland-tipped,glandular,globose,green,half,head,herb,imparipinnate,initially,interjected,internode,interrupted,larger,later,lateral,leaf,leaflet,length,lime,lobe,lobed,long,longer,longest,lower,margin,minute,mm,multicellular,oblique,obovate,occasionally,often,one,orange,ovate,pair,pale,patent,pedicel,pentagonal,per,perennial,petiole,petiolule,population,present,primary,procumbent,pseudostipule,pubescent,quaternary,robust,rounded,scarcely,scent,secondary,sessile,several,short,shorter,simple,single-celled,size,slender,smaller,somewhat,stem,strong,subopposite,surface,symmetric,terminal,tertiary,tightly,trichome,unicellular,uniseriate,unit,usually,varying,viny,weak,wide,yellow	-0.4,.2,0.05-0.1,0.1-0.15,0.3-0.4,0.3-0.45,0.3-0.6,0.3-0.7,0.4-0.5,0.4-0.8,0.5,0.5-0.7,0.5-1.8,0.6-1.1,0.7-1,0.7-1.3,0.7-1.5,0.8-1.2,1-3.5,1.5-2.0,1.6-3.2,10,10-12,12,<,absen,adpressed,along,anthesi,apical,appearance,appendage,axi,ba,becoming,brown,column,composed,cone-shaped,conical,curving,diameter,eaf,edicel,eed,exserted,flower,giving,glabrescent,gland-tippe,glandular-villous,gree,hair-like,halfway,included,less,like,linear,lon,maturity,middl,midvein,minutely,narrowly,nflorescence,outgrowth,ovary,peduncle,plant,pubescence,rarely,reflexed,ruit,shaggy,silky,staminal,sterile,stigma,straight,style,tangled,tem,testa,thick,toward,transparent,tube,ud,wall,winged,ympodial	absent,articulation,branching,breeding,broad-based,colour,connective,form,growth,hair,heteromorphism,inflated,inflorescence,insertion,interpetalar,marking,mature,middle,modification,needle-like,null,odour,orientation,paired,pattern,placement,pore,position,prickle,rhizome,scale,shape,smell,spot,staman,stone,structure,symmetry,sympodial,system,texture,tissue,tuber,type,vegetative,xylopodia,zygomorphy
195	wfo-0001028075	success	196	108	53	143	55	0.27	2-4.5,7-13,absent,anther,apex,base,berry,blade,borne,cell,chartaceous,ciliate,cm,corolla,dark,end,filament,forked,fruit,glabrescent,glabrous,globose,green,hair-like,herb,interjected,leaf,leaflet,light,long,lower,margin,membranous,mm,oblique,odd-pinnate,ovoid,pedicel,pentagonal,petiole,plurifoliate,pore,rotate,rounded,singly,slightly,subcordate,terminal,tri-,tuber,typically,unit,white	.5,1-10,1-2,1-2.7,1-3,1.5-2.5,1.5-7,1.6-2.7,10-35,2-3,2-6,2.5-10,3-11,3-23.5,4-12,4-7,5-12,5-14,5-17,5-7,5-8,5-9,5-merou,7-30,8-12,abaxially,acuman,acumen,acuminate,acute,adaxially,ag,along,alyx,apart,apparently,articulated,axe,axillary,broadly,brownish,bud,capitat,condition,connivent,covering,cuneate,decreasing,diameter,differentiated,digestion,distal,distally,distinctively,dorsally,dot,drying,eaf,edge,eed,elliptic-lanceolate,enzyme,erec,especially,exceeding,flat,flower,folded,fresh,geminat,generally,glabrescen,green-white,greenish,half,homostylous,honeycomb-shaped,lanceolate,larger,lateral,lengthening,ligulate,living,lobe,make,middl,midrib,minutely,much,mucilaginous,narrow,nflorescence,obtuse,often,orolla,ovate,ovate-elliptic,pair,pale,peduncle,perfect,petiolule,plant,poricidal,puberulent,purple,reflexed,removed,ruit,scattered,seed,seudostipule,size,slit,sometimes,spaced,specimen,stamen,star,stigma,stolo,straight,style,subtending,tall,tamen,tem,testal,thick,throughout,tip,toward,tube,usually,vary,wall,wet,whitish,wide,wing,x,yellow,ympodial	appressed,articulation,bract,branching,breeding,broad-based,calyx,colour,connective,form,fruiting,geminate,growth,hair,heteromorphism,inflated,inflorescence,insertion,interpetalar,length,marking,mature,middle,modification,needle-like,null,odour,orientation,paired,pattern,placement,position,prickle,pseudostipule,rhizome,scale,shape,smell,spot,staman,stem,stolon,stone,structure,surface,symmetry,sympodial,system,texture,tissue,trichome,type,vegetative,xylopodia,zygomorphy
196	wfo-0001028076	success	195	140	85	110	55	0.436	1-2,110,13-14,2.5-4,4-5,5,5-20,5-6.5,absent,anther,apex,axillary,base,berry,blade,borne,bud,cell,chartaceous,cm,conical,connivent,corolla,densely,distal,end,filament,forked,fruit,generally,glabrous,green,hair,half,herb,homostylous,interjected,lanceolate,larger,lateral,leaf,leaflet,lengthening,light,like,long,lower,margin,medium,membranous,minute,mm,odd-pinnate,pedicel,pentagonal,petiole,plant,plurifoliate,pore,poricidal,proximal,pubescent,purple,rarely,ray,ripe,rotate,semierect,sessile,singly,slit,stem,subsessile,subtending,symmetrical,tall,terminal,tip,tri-,tuber,typically,unit,usually,white,x	.5,0.4-0.5,0.5,1-1.3,1-10,1-3,1.2-2.2,1.8-2.2,12-22,2-12,2-3,2-5.4,2.2-2.6,2.2-3.7,2.5-3,2.6-3.8,4.5-7,5-6,5-merou,7-8,?,abaxially,acumen,acuminate,adaxially,ag,alyx,apart,apparently,articulated,attenuate,axe,brownish,capitat,ciliate,condition,covering,decreasing,diameter,digestion,dorsally,drying,eaf,edge,eed,elliptic,enzyme,erec,especially,exceeding,flat,flower,folded,fresh,geminat,glabrou,gradually,green-white,greenish,hair-like,honeycomb-shaped,less,living,lobe,make,mucilaginous,nflorescence,obtuse,orolla,ovate,ovoid,pair,peduncle,perfect,petiolule,pubescen,removed,round,ruit,secondary,seed,seudostipule,size,slightly,spaced,specimen,stamen,ste,stigma,stolo,straight,style,subequal,tamen,tem,testal,thick,thir,throughout,toward,tube,unwinged,vary,wall,wet,whitish,wide,wing,yellow,ympodial	age,appressed,articulation,bract,branching,breeding,broad-based,calyx,colour,connective,erect,form,fruiting,geminate,growth,heteromorphism,inflated,inflorescence,insertion,interpetalar,length,marking,mature,mentioned,modification,needle-like,odour,orientation,paired,pattern,placement,position,prickle,pseudostipule,rhizome,scale,shape,smell,spot,staman,stolon,stone,structure,surface,symmetry,sympodial,system,texture,third,tissue,trichome,type,vegetative,xylopodia,zygomorphy
197	wfo-0001028105	success	150	75	22	128	53	0.147	anther,apex,base,calyx,corolla,filament,fruiting,green,leaf,lower,margin,pedicel,petiole,pore,shrub,small,stem,surface,tree,trichome,unit,white	.1,.4,.5,0.3-1.5,0.5,0.5-1,0.5-2,0.6-1,1-1.2,1-1.5,1-2.5,1.5,1.5-1.8,1.5-2,1.5-4.5,2,2-2.2,2-5,3-5-celled,3-6,3.5-4,5-7-flowered,6-7,9.5-15,abaxially,acuminate,acute,adaxially,anthesi,apar,apical,attenuate,axi,axil,ba,bark,berry,bilobed,clavate,cm,conical,dark,deflexed,dense,dia,differing,difoliate,distinct,drying,eaf,edicel,eed,ellipsoid,elliptic,erect,evenly,exserted,filiform,flattened-reniform,free,geminat,glabrous,glandular,globose,greenish-yello,incrassate,lamina,lateral,like,lobe,lobed,lon,long,main,major,middle,minor,minutely,mm,nearly,nflorescence,occasionally,older,olive-green,opposite,ovary,pair,pale,papillo,papillose,pitted,planar,poricidal,portion,projection,pubescent,quadrate,reddish-brown,reflexed,ruit,scar,scattered,shaped,simple,size,slightly,spaced,sparsely,spreading,stigma,straight,strongly,style,tall,tear-drop,tip,tub,tube,tuft,ud,uniseriate,vein,widest,woody,x,yellowish,ympodial,young	appressed,articulation,bract,branching,breeding,broad-based,cell,colour,connective,form,fruit,growth,hair,heteromorphism,inflated,inflorescence,insertion,interjected,interpetalar,leaflet,length,marking,mature,modification,needle-like,none,odour,orientation,paired,pattern,placement,position,prickle,pseudostipule,rhizome,scale,shape,smell,spot,staman,stellate,stone,structure,symmetry,sympodial,system,texture,tissue,tuber,type,vegetative,xylopodia,zygomorphy
198	wfo-0001028109	success	205	135	81	124	54	0.395	0.4-0.8,1.5-5.5,1/8-1/4,2-15,2.5-3,2.5-5,3-7,3/4,almost,anther,apart,apex,apparently,bark,base,berry,blade,branching,bright,calyx,chartaceous,cm,cuneate,curved,deltate,elongating,entire,equal,erect,filament,free,fruit,fruiting,glabrescent,glabrous,lateral,leaf,length,long,lower,margin,mature,maturity,mauve,mm,occasionally,older,orange-brown,pedicel,perpendicular,petiole,poricidal,portion,prickle,primary,red,reflexed,secondary,shrub,simple,small,spaced,spherical,stellate,stellate-pubescent,stem,straight,surface,tapering,terete,terminal,tip,tree,trichome,tube,unarmed,unit,white,wide,woody,young	-20,-4,-7,.5,/3,0.05-0.15,0.05-0.2,0.1,0.1-0.2,0.3,0.4-1.5,0.45-0.65,0.5-1.2,0.5-2.5,0.6-0.8,0.7,0.8-1.5,0.8-1.6,1.5-10,1.5-2.5,10-25,10-30,12-40,15-100,2-4,2.3-2.9,2/3-3/4,20-60,3-,3.5-6,30-150,4-13,4-5-merous,5-13,5-30,8-12,8-15,8-25,abaxial,abaxially,acuminate,acut,acute,adaxial,alyx,ame,apar,apically,articulated,brow,c.,connivent,densely,diameter,dimorphic,discolorous,drying,dull,eaf,eed,elliptic,evenly,flattened-reniform,flower,fully,geminate,gently,glabrou,gray-green,green,green-brown,infructescence,light,lobe,lobed,long-styled,longer,midpoint,minor,moderately,multangulate,nflorescence,obtuse,one,open,opening,orolla,oung,pair,peduncle,per,perfec,pericarp,plurifoliat,porrect,prickl,prickly,ray,recurved,red-brown,ruit,scar,sessile,slender,smooth,sometimes,spreading,stalk,stalked,strongly,style,tamen,tertiary,time,unarme,usually,vary,vein,venation,visible,way,weakly,yellow,ympodial	+,appressed,articulation,bract,breeding,broad-based,cell,colour,connective,corolla,form,growth,hair,heteromorphism,inflated,inflorescence,insertion,interjected,interpetalar,leaflet,marking,mentioned,modification,needle-like,odour,orientation,paired,pattern,perfect,placement,plurifoliate,pore,position,present,pseudostipule,rhizome,scale,shape,smell,spot,staman,stamen,stone,structure,symmetry,sympodial,system,texture,tissue,tuber,type,vegetative,xylopodia,zygomorphy
199	wfo-0001028115	exception_thrown	165	0	0	165	0	0.0		-1.1,-2.5,-5.2,.2,.6,0.2-0.3,0.42,0.5,0.6-0.7,0.7-0.8,0.8-,1-2.4,1-3,1.1-1.8,1.3-1.8,1.4-1.7,1.7-2.2,1.8-3.5,12-13.5,2-,2-3.2,2.5-,3-4.5,3-5,3-6.5,4.7-,5-15,5-8.5,6-10,7-7.5,9-17,abaxially,abundant,accrescent,acuminat,acute,adaxially,ag,alternate,amply,annular,anther,antrorse,apex,articulate,attenuate,basal,base,berry,blade,blue,calyx,campanulate,capitate,cm,coat,connectival,curved,diameter,difoliat,dorsal,eaf,eed,ellipsoidal,elliptical,embryo,entire,especially,evident,exceeding,filament,fruiting,glabrescent,glabrous,glandular,globose,growing,half,herb,herbaceous,hig,inflated,length,light,linear,lobe,long,longer,longitudinal,longitudinally,lower,margin,mixed,mm,moderately,much,multi-seeded,narrowly,near,nerve,non-glandular,oblong,one,opening,opposite,orolla,ovate,pair,pale,papery-scarious,papillo,petiole,pinnatifid,pinnatipartite,pinnatisect,pore,poricidal,portion,prolongation,prostrate,pubescent,rarely,ree,reticulate,ridged,ruit,scarce,seed,segment,similar,simple,slender,slightly,slit,small,smooth,sometimes,stem,stigma,strongly,styl,style,subsessil,tem,time,tip,trans-ovoidal,triangular,trichome,tube,tuberculate,unequal,unifoliate,uniseriate,unit,vary,venation,violet,wide,wider,width,winged,x,yellow,ympodial	
200	wfo-0001028131	exception_thrown	208	0	0	208	0	0.0		-1.2,.1,.5,/5,0-0.6,0-2,0-3,0-30,0-4,0.05-0.2,0.1-0.15,0.1-0.3,0.2-1.5,0.3-0.7,0.4-0.8,0.5-1.1,0.7-1.1,0.8-1,0.8-1.1,1-10,1-3,1-4,1-5,1.5-3,1.5-5,1.8-2,1.8-2.2,1/4-2/3,1/5,2-2.8,2-4,2-5,2-6.5,2/3,3-6,4-6,5-6.5,5-8,5-merous,6-7,7-8,abaxial,abaxially,absent,acuminat,adaxial,alyx,anther,apar,apart,apex,apically,apparently,articulated,attenuate,bark,base,berry,blade,branched,broad-deltate,calyx,cell,chartaceous,cm,concolorous,connivent,cream,curved,dark,deltate,densely,diameter,difoliate,distance,drying,dull,eaf,eed,elongating,epidermi,equal,erect,extending,eye,filament,filiform,flattened,flattened-reniform,flower,free,fruit,fruiting,geminat,glabrescent,glabrous,gland,green,herb,infructescence,lanceolate,lateral,leaf,lengt,length,like,lobe,lobed,long,longer,lower,margin,marking,mature,maturity,mauve,membranous,midpoint,midvein,mm,moderately,naked,narrow-obovate,narrow-ovate,nflorescence,oblong,obtuse,often,older,one,open,orange,orange-brown,orolla,oung,outline,pair,pale,pale-brown,pale-gra,pedicel,peduncle,pendulous,per,perfec,pericarp,petiole,pit,poricidal,porrect,portion,prickl,prickle,prickly,primary,purple,raised,ray,red,reduced,reflexed,rounded,ruit,scar,sessil,sessile,shiny,shorter,side,simple,small,smooth,sometimes,spaced,sparsely,spherical,spreading,stellate,stellate-pubescent,stem,straight,strongly,style,sunk,surface,tamen,tapering,terete,tertiary,time,tip,trichome,tube,unarme,unarmed,unit,upper,vary,vein,venation,visible,way,wide,woody,yellow,yellow-green,ympodial,young	
201	wfo-0001028148	success	157	132	74	83	58	0.471	0.6-3.5,1.5,15,4.5-10,5,5-7,5-8,6-18,apex,base,blade,blue-black,branched,calyx,cell,central,cm,connivent,dark,decurrent,densely,directed,elliptic,entire,fleshy,fruit,glabrous,glaucous,globose,hair,highly,less,long,lower,margin,mature,midrib,mm,moderately,narrowly,often,ovate,pedicel,perfect,petiole,pink,plicate,pore,puberulent-pubescent,purple,rarely,rhizomatous,ripe,rotate-stellate,shrub,simple,slender,slightly,sometimes,star,stone,succulent,surface,tapered,thickened,time,treelet,unbranched,unit,violet,white,whitish,wide,x	-6,.5-4,0.25-0.5,0.5-1.5,0.75-2,1-15,1-3.5,1.5-2.5,10-30,12-15,2,2-3,2-7,2.5-4,20-50,3.5-4,3.5-9,4-10,5-10,5-20,abaxially,absen,acute,adaxially,aggregate,angled,apart,apiculate,articulated,axe,ba,broadly,chartaceous,cylindrical,deltate,diameter,distal,distall,eaf,eed,especially,except,flower,fresh,light-colored,lobe,many-foliat,margi,material,minute,nflorescence,nther,obtuse,orange,orolla,part,peduncle,plicae,puberulence,puberulent,rachi,radiu,ridge,ruit,scalloped,smoot,smooth,spaced,sparse,stigma,style,tal,tem,tip,triangular,truncat,tube,usually,vary,winge,yellow,ympodial,young	absent,anther,appressed,articulation,bract,branching,breeding,broad-based,colour,connective,corolla,distally,filament,form,fruiting,growth,heteromorphism,inflated,inflorescence,insertion,interjected,interpetalar,leaf,leaflet,length,many-foliate,marking,modification,needle-like,null,odour,orientation,paired,pattern,placement,position,prickle,pseudostipule,rhizome,scale,shape,smell,spot,staman,stem,structure,symmetry,sympodial,system,texture,tissue,trichome,tuber,type,vegetative,winged,xylopodia,zygomorphy
202	wfo-0001028161	exception_thrown	124	0	0	124	0	0.0		.5,0.1-0.25,0.25-0.5,0.7-1.7,1-1.3,1-1.5,1-2,1-2.3,1.5-4.5,1/3,2-5-flowered,2-9,2.5-3,3-4,3-7,4-5,6-9,7.5-12,9-11,abaxially,acuminate,acute,adaxially,along,anthesi,apex,arising,attenuate,ba,bark,base,berry,branch,branched,brown,calyx,cell,closely,cm,congested,consisting,corolla,deflexed,dendritic,densely,denser,dia,differing,difoliate,distal,eaf,edicel,eed,elliptic,exserted,fruiting,geminat,glabrescen,globose,green,incrassate,inflorescenc,lanceolate,later,lateral,leaf,like,lon,long,main,major,margin,middle,minor,minutely,mm,narrowly,nflorescence,obovoid,often,older,opposite,orbicular,outline,overlappin,ovoid-reniform,pair,pale,pedicel,petiole,pitted,probably,pubescence,pubescent,reddish-brown,rest,rounded,ruit,scar,shape,short,shrub,simple,sinuate,size,somewhat,spaced,sparsely,stem,strongly,surface,tall,tan,tapering,thin,trichome,tub,ud,unit,vein,widest,x,ympodial,young	
203	wfo-0001028164	success	197	151	97	100	54	0.492	/4,0.05-1.5,0.1,0.8-1.5,1-1.5,1-4.5,1/6-1/4,12-20,2-2.5,2.5-4,3-7,8-17,ame,anther,apex,apparently,attenuate,bark,base,berry,blade,branched,bright,c.,calyx,cm,concolorous,dark,densely,difoliate,drying,elliptic,elongating,entire,erect,filament,free,fruit,fruiting,glabrescent,glabrous,gray,hair,lateral,leaf,length,lobed,long,longer,lower,margin,mature,maturity,mauve,membranous,midpoint,midvein,minute,mm,moderately,multangulate,older,pale,pedicel,petiole,poricidal,portion,ray,red,red-brown,sessile,shallowly,shorter,shrub,simple,sometimes,sparsely,spherical,stalk,stalked,stellate,stellate-pubescent,stem,surface,terminal,time,tip,trichome,tube,unarmed,undulate,unit,variously,way,white,wide,yellow-green	-1,-14,-6,-8,0-20,0.05-0.2,0.3-0.8,0.4-0.8,0.5-0.8,0.5-1,0.7-1.1,0.9-1.6,1,1.5-2.5,1.8-2.5,1/3,2.5-4.5,2.8-4,3-17,3.6-4.8,4-13,4-5-merous,4-7,4-8,6-8,8-15,abaxial,abaxially,acuminate,acute,almost,alyx,apar,apically,articulated,connivent,curved,deltate,diameter,dull,eaf,eed,equal,evenly,eye,filiform,flattened-reniform,flower,geminat,glabrescen,glabrou,glandular,green,infructescence,less,lobe,long-acuminat,naked,narrow-deltate,nflorescence,obtuse,often,one,open,orange-brown,orolla,oung,pair,peduncle,per,perfec,pericarp,porrect,primary,recurved,reflexe,ruit,scar,shorte,side,smooth,spaced,spreading,straight,style,tamen,tapering,terete,tertiary,unarme,upper,vary,vein,venation,visible,woody,yellow,yellow-gra,ympodial,young	appressed,articulation,bract,branching,breeding,broad-based,cell,colour,connective,corolla,form,geminate,growth,heteromorphism,inflated,inflorescence,insertion,interjected,interpetalar,leaflet,marking,mentioned,modification,needle-like,odour,orientation,paired,pattern,perfect,placement,pore,position,prickle,pseudostipule,reflexed,rhizome,scale,shape,smell,spot,staman,stone,structure,symmetry,sympodial,system,texture,tissue,tuber,type,vegetative,xylopodia,yellow-gray,zygomorphy
204	wfo-0001028180	exception_thrown	147	0	0	147	0	0.0		.05,.5,/2,0.7-1,1-1.2,1-1.5,1-1.8,1-3,1.5-5,15-28,2-2.2,2-3,2.5-3,20-30-flowered,3-10,3-4,4.5-5,5-6,5-8,7,8-10,abaxially,acute,adaxially,along,anther,anthesi,apex,attenuate,ba,bark,base,beginning,berry,c.,calyx,capitate,closely,cm,conical,corolla,cucullate,dark,darker,deflexed,deltate,densely,dia,differing,difoliate,distinctly,drying,eaf,eed,elliptic,elongate,erect,falcate,filament,fleshy,four-angled,free,fruiting,geminat,glabrat,glabrous,globose,gold,golden,green,irregularly,know,larger,lateral,leaf,leathery,lobe,lobed,lon,long,lower,main,major,margin,midrib,minor,minutely,mm,nearly,nflorescence,obscure,older,onto,opposite,ovary,overlappin,ovoid-reniform,pair,pale,papillose,pedicel,petiole,pinkish-white,pitted,planar,pore,poricidal,portion,puberulent,pubescent,ruit,scar,shaped,shiny,simple,size,small,somewhat,spaced,sparsely,stem,stigma,straight,styl,style,surface,tall,tan,tear-drop,thick,tip,tree,trichome,tube,ud,underside,uniseriate,unit,vein,way,white,winged,woody,x,yellow-gray,ympodial,young	
205	wfo-0001028182	success	150	74	21	129	53	0.14	anther,apex,base,calyx,corolla,filament,hemiepiphyte,inflorescence,leaf,lower,margin,pedicel,petiole,pore,shrub,spindly,stem,surface,trichome,unit,white	.5,0-90,0.1-0.2,0.5,0.5-0.6,0.5-1,0.8-1,0.9-1,1-1.5,2,2-2.5,2-6.5,3,3-5,4-6,5-15-flowered,5-ribbed,6-9,along,anthesi,apart,apiculae,apiculate,arching,axi,bark,bending,beneath,black,blade,branch,brown,capitate,ciliate,cm,conical,cordate,deflexed,deltoid,densely,dia,dry,eaf,edicel,eed,ellipsoid,evenly,except,extreme,filiform,flower,free,glabrous,globose,gre,internodal,keeled,know,known,later,lateral,lax,less,like,lobe,lobed,long,long-acuminate,main,material,midrib,minute,minutely,mm,narrowly,nearly,nflorescence,obovoid,older,opposite,ovary,ovate,pair,papillo,papillose,planar,poricidal,portion,present,prominent,proximal,pubescent,purplish,reflexed,rib,rounded,ruit,sca,scar,shaped,shiny,simple,slender,slightly,somewhat,spaced,sparsely,sparser,specimen,stigma,still,strongly,style,tapering,tear-drop,third,time,tip,truncate,tube,ud,unifoliat,uniseriate,vein,widest,x,ympodial,young,zig-zag	appressed,articulation,bract,branching,breeding,broad-based,cell,colour,connective,form,fruit,fruiting,growth,hair,heteromorphism,inflated,insertion,interjected,interpetalar,leaflet,length,marking,mature,modification,needle-like,none,odour,orientation,paired,pattern,placement,position,prickle,pseudostipule,rhizome,scale,shape,smell,spot,staman,stellate,stone,structure,symmetry,sympodial,system,texture,tissue,tuber,type,vegetative,xylopodia,zygomorphy
206	wfo-0001028183	exception_thrown	237	0	0	237	0	0.0		-10,-5.3,.5-3,0.1,0.1-0.2,0.1-0.4,0.1-0.9,0.2-0.3,0.2-0.4,0.2-0.5,0.5,0.5-2.5,0.6,0.7-1.2,0.7-2,0.8-1.4,0.8-3.1,1.1-1.8,1.2-1.4,1.3-1.4,1.3-1.7,1.4-2.8,1.5-3.4,1.6-2.3,1.7-2.7,1.9-3.7,1/3-1/2,10-15,11-30,2-4.2,2-5,2.2-5.7,2.5-4.1,2.6-4.4,2.8-4.2,3.2-,3.5-6.6,4.5-9,4.6-6.4,5-8,5-8.5,5.2-6.2,50-400,6.6-20,7.5-23,8-9.1,9-13,abaxial,abaxially,accrescent,acute,adaxially,ag,along,alyx,anther,anthesi,apart,apex,apparently,around,articulated,attenuate,axi,axillary,bark,base,berry,blade,blunt-tipped,branch,branched,brown,bud,calyx,capitate,cell,central,chartaceous,closely,cm,corolla,cuneate,cylindrical,dark,deltoid,dendritic-multangulate,diameter,directed,distally,distantly,drying,dull,eaf,earl,edge,eed,elliptic,elongated,entire,epidermal,especially,evident,except,exserted,farinose,few-rayed,filament,flower,free,fruit,fruiting,glabrescen,glabrescent,glabrous,globose,granular-punctate,group,hair,half,high,inserted,lackin,lanceolate,lateral,leaf,lengthening,lobe,lobed,lon,long,long-decurrent,longitudinal,lower,m.,main,many,margin,midrib,mm,multangulate,narrowly,nearly,nflorescence,oblong,obovoid,older,open,orangish-tan,orolla,ovate-lanceolate,overlapping,pedicel,peduncle,perfec,petiole,plurifoliate,pore,poricidal,porrect-stellat,porrect-stellate,present,prominent,pseudoterminal,pubescence,pubescent,purple,rachi,rarely,relatively,reportedly,reticulate-punctate,ripe,ruit,runk,scabrous,sessile,short,short-,shrub,side,simple,slit,small,somewhat,soon,spaced,sparingly,sparse,spherical,splitting,stage,stalk,stamen,stellate,stem,stigma,stipitate-glandular,stout,streak,strongly,style,sub-lenticular,subcampanulate,surface,suture,tamen,tan,terete,thick,thin,thin-textured,time,tip,tomentose,touching,translucent,tree,tube,ud,unarme,unit,upper,usually,vary,vein,violet,way,white,whitish,wide,x,yellow,yellowish,yellowish-tomentose,ympodial,young	
207	wfo-0001028227	success	236	171	117	119	54	0.496	-6.2,.5-4,0.1,0.3,0.4,0.5,0.8-1.4,1,1-4.2,1/2,10,10-24,2-12,2.5-7.8,3-4.9,abaxial,abaxially,acute,adaxially,anther,apex,apparently,appressed,attenuate,axillary,bark,base,berry,blade,branch,branched,brown,brownish,calyx,cm,corolla,cuneate,dark,decurrent,dendritic-echinoid,diameter,directed,distally,echinoid,elliptic,entire,farinose,filament,fleshy,flower,fruit,fruiting,glabrescent,globose,granular-tomentose,gray,grayish,green,hair,high,lacking,lanceolate,leaf,less,long,lower,many,margin,mm,mostly,multangulate,oblong,oblong-lanceolate,obtuse,older,overlapping,pale,pedicel,petiole,plurifoliate,pore,poricidal,porrect-stellate,present,pseudoterminal,pubescence,purple,relatively,ripe,scabridulous,sessile,shrub,simple,slightly,somewhat,stalk,stellate,stem,stout,sulcate,surface,thick,thicker,thin,time,tip,tomentose,touching,tree,unit,velutinous,violet,wide,x,yellow,yellowish,young	-2/3,0-250,0.2,0.2-0.3,0.2-0.4,0.2-0.5,0.7-2.1,0.8,0.9,0.9-1.2,0.9-1.4,1-1.7,1-2.5,1.1-3.1,1.2-2,1.3-4,1.4,1.4-2.6,1.5-2.3,1.7-2.8,1.9,1.9-4.2,1.9-5.8,1/2-3/4,11-15,2-3.8,2.6-5.9,2.9-4.7,3.7-6.3,3.7-7,4-13,4.8-7.6,5-7.5,6-16,6.7-15,8.1-18,8.5-22,accrescent,acuminate,ag,age,along,alyx,anthesi,apart,around,articulated,becoming,blunt-tippe,blunt-tipped,bud,c.,closely,cylindrical,deltoid,drying,eaf,early,echinoi,edge,eed,elongate,ength,exserted,free,glabrous,inserted,lateral,lengthening,lobe,lobed,lon,longitudinal,m.,main,midrib,midvein,nflorescence,obscured,occasionally,often,orangish-tan,orbicular,orolla,ovate-lanceolate,ovate-orbicula,peduncle,perfec,prominent,pubescent,quarter,rachi,reticulate-punctate,rounded,ruit,runk,side,slit,spaced,sparsely,stamen,stigma,style,subcampanulate,sublenticular,subspherical,suture,tamen,tomentu,tube,ud,unarme,upper,usually,vary,vein,way,well,ympodial	accescent,articulation,bract,branching,breeding,broad-based,cell,colour,connective,form,growth,heteromorphism,inflated,inflorescence,insertion,interjected,interpetalar,leaflet,length,marking,mature,modification,needle-like,null,odour,orientation,ovate-orbicular,paired,pattern,perfect,placement,position,prickle,pseudostipule,rhizome,scale,shape,smell,spot,staman,stone,structure,symmetry,sympodial,system,texture,tissue,trichome,trunk,tuber,type,vegetative,xylopodia,zygomorphy
208	wfo-0001028228	exception_thrown	143	0	0	143	0	0.0		.5,0.1-1.7,0.75,1-1.5,1.1-1.2,1.1-2.5,1.2-1.8,1.5-2,1.8-3.4,10-30-flowered,2,2-5,2-8,2.1-4.2,2.8-6.5,3/4,6-7,6-8,7.5-12.5,abruptly,acute,age,anther,anthesi,apex,area,ba,bark,base,becoming,beginning,beneath,berry,brown,caly,calyx,campanulate,clavate,closely,cm,coriaceous,corolla,dark,deflexed,deltoid,dia,difoliate,distal,dry,eaf,edicel,eed,elliptic,erect,exserted,filament,fragrant,free,fruiting,geminat,glabrous,globose,green,greenish-yellow,impressed,inflorescenc,lateral,leaf,lobe,lobed,lon,long,lower,main,major,margin,material,middle,minor,minute,minutely,mm,narrowing,nflorescence,obovate,occasionally,older,opposite,ovary,overlapping,ovoid,ovoid-reniform,pair,pale,papillose,pedicel,petiole,planar,pore,poricidal,portion,prominent,reticulate,rounded,ruit,scar,shaped,shinin,shining,shrub,simple,slender,slightly,small,spaced,stem,stigma,straight,styl,style,surface,sweetly,tall,tapering,tear-drop,terminal,thick-margined,thickened,tip,tree,tube,ud,unit,usually,vein,way,weight,white,widest,woody,x,ympodial,young	
209	wfo-0001028263	success	156	137	77	79	60	0.494	1-3,1-4,2-3,6,6-8,abaxially,adaxially,apex,apical,base,branched,calyx,cell,cm,conical,connate,cordate,corolla,covering,cuneate,cyme,darker,deep,dehiscent,dichasial,dichasially,distal,ebracteate,filament,flower,forked,generally,green,half,herbaceous,honeycomb,interjected,introrse,lateral,leaf,leaflet,light,long,lower,make,maturing,medium,mm,monochasial,mucilaginous,oblique,odd-pinnate,often,pattern,pedicel,perennial,perfect,petiole,plant,poricidally,proximal,puberulent,pubescent,rotate,seed,short,slit,strigose,testal,thick,throughout,tuber-bearing,typically,unit,violet,wall,Â¼	0.25,1-2,11-13,11-23,14-44,2,2-4,2.6,3,3-6-foliat,3.4,3.5-4.2,4,4-5,5-7,5-7.5,8-1.,8-14,9,abaxiall,acumen,acuminate,acute,apically,articulate,atenuate,broadly,diameter,digestion,diminishing,dorsally,eaf,edge,eed,elliptical,emoval,enzyme,equal,exceeding,first,flat,folded,globo,gradually,green-white,hair-like,living,lobe,lon,lunat,nflorescence,nther,orolla,ovate,ovoid,pair,peduncle,plan,reveal,ruit,sessile,seudostipule,size,specimen,stamen,stigma,straight,style,tal,tem,terminal,throughou,toward,truncate,two,vary,wide,yellow,ympodial	'hair-like,3-6-foliate,8-19,anther,appressed,articulation,bract,branching,breeding,broad-based,colour,connective,form,fruit,fruiting,growth,hair,heteromorphism,inflated,inflorescence,insertion,interpetalar,length,lunate,margin,marking,mature,modification,needle-like,null,odour,orientation,paired,placement,pore,position,prickle,pseudostipule,rhizome,scale,shape,smell,spot,staman,stem,stone,structure,surface,symmetry,sympodial,system,texture,tissue,trichome,tuber,type,vegetative,wet,xylopodia,zygomorphy
210	wfo-0001028280	success	87	114	54	33	60	0.621	2-3,7-8,acuminate,apex,arching,attenuate,axil,bark,base,berry,branch,ciliate,completely,dark,decurrent,elliptic,flattened,fruiting,glabrous,globose,green,lanceolate,lateral,leaf,long,lower,main,margin,middle,minutely,mm,narrowly,new,older,onto,opposite,pair,papillae,pedicel,petiole,present,rounded,shrub,simple,small,stem,surface,tip,ultimate,unit,vein,widest,winged,young	.5,0.7-1,1-2,1-2-flowered,1.5-2.7,2-2.5,6-9,almost,anthesi,ape,brow,closely,cm,dia,eaf,eed,immature,know,known,lon,nflorescence,pendant,ruit,scar,sessil,somewhat,spaced,tall,ud,unifoliat,woody,x,ympodial	anther,appressed,articulation,bract,branching,breeding,broad-based,brown,calyx,cell,colour,connective,corolla,filament,form,fruit,growth,hair,heteromorphism,inflated,inflorescence,insertion,interjected,interpetalar,leaflet,length,marking,mature,modification,needle-like,null,odour,orientation,paired,pattern,placement,pore,position,prickle,pseudostipule,rhizome,scale,shape,smell,spot,staman,stone,structure,symmetry,sympodial,system,texture,tissue,trichome,tuber,type,unifoliate,vegetative,xylopodia,zygomorphy
211	wfo-0001028281	exception_thrown	267	0	0	267	0	0.0		+,-0.9,-1,-10,-20,-3,-36,-45,-5,-7,-8,.2,.4,.5,0.05-0.4,0.1-0.15,0.15-0.2,0.2-0.3,0.2-0.5,0.2-0.7,0.3-0.5,0.3-1,0.5-,0.5-0.6,0.5-0.7,0.5-1,0.5-1.1,0.5-1.2,0.7-,0.7-1.2,0.7-2.5,0.75-1,0.8-1,1,1-,1-1.5,1-3,1-5,1.0-1.6,1.1-1.4,1.1-2.4,1.2-1.5,1.2-1.6,1.4-4,1.5-2,1.5-6,1.7-2.5,10-18,10-30,2-13,2-4,2-4-celled,2-6.5,2-locular,2.1-3.0,2.5-,20-30,3-16,3-5,3-8.5,3-foliate,5-8-celled,6,6-15,7-30,abaxial,abaxially,absent,acuminate,acute,adaxial,almost,alternate,anther,anthesi,apex,apical,appearance,appendage,appressed,arising,articulation,autogamous,axi,base,basiscopically,bent,berr,blade,bract,bracteate,branching,broadly,brown,calyx,capitate,cell,cm,column,composed,conical,corolla,covering,dark,darker,decreasing,decurrent,deep,densely,developed,diameter,distal,doubly,dry,eaf,edicel,eed,eglandular,either,elliptic,elongate,elongate-triangular,enclosing,entire,exerted,exserted,extended,filament,flower,form,fragile,free,fruit,fruiting,generally,giving,glabrous,gland,glandular,globose,golden,gree,green,hair-like,hal,half,halfway,head,imparipinnate,included,inflorescence,interjected,internode,interrupted,large,largest,lateral,leaf,leaflet,less,like,lobe,lon,long,longest,lower,margin,material,medial,midvein,minute,mixture,mm,multi-celled,multi-cellular,multicellular,narrowly,nflorescence,node,oblique,obovate,occasionally,once-branched,opposite,orbicular,other,outgrowth,ovary,ovate,pair,pale,paler,patent,pedicel,peduncle,petiole,petiolule,point,population,portion,present,primarily,primary,probably,proximal,pseudostipule,pubescent,rachi,regularly,rest,rotate,ruit,secondary,serrat,serrate,sessile,set,shorter,shrub,silky,size,small,smaller,smooth,sometimes,sparsely,sparser,sprawling,staminal,stem,sterile,stiff,stigma,straight,stripe,strongly,style,subopposite,surface,tem,terminal,tertiary,testa,thick,thin,three,tip,toward,transparent,trichome,tube,type,ud,unicellular,uniseriate,unit,usually,vein,vine,wall,weak,weak-walled,well,wide,winged,yellow,ympodial	
212	wfo-0001028317	success	204	130	79	125	51	0.387	0.5-3.5,0.6-1.2,0.8-1.1,1-4,1/3-1/4,3-10,almost,anther,apart,apex,apparently,base,berry,blade,branched,bright,brown,calyx,chartaceous,cm,cream,cuneate,curved,dark,difoliate,elongating,equal,erect,filament,fruit,fruiting,glabrous,gray,green,hair,herb,lateral,leaf,length,lobed,long,lower,margin,marking,mature,maturity,mauve,mm,obtuse,pale,pedicel,petiole,poricidal,prickle,purple,red,reflexed,scandent,shrub,simple,sometimes,spaced,spherical,spreading,stellate,stellate-pubescent,stem,straight,surface,tapering,terminal,trichome,truncate,unarmed,unit,white,wide,yellow,young	-1.5,-5,/5,0,0-1,0-5,0.1,0.1-0.25,0.1-0.3,0.1-0.4,0.3-0.4,0.3-1,0.6-0.8,0.6-1.5,0.8-2.5,1-1.3,1-3,1.1-1.9,1.4-2,1.8-2.5,1/,1/4-2/3,1/5,2-2.8,2-4,2-4.5,2.5-6.5,2.8-3.3,2/3,3-4,3-5,4-5-merous,4-6,4-8,5-8,6-10,abaxially,absent,acuminat,acute,alyx,apar,apically,articulated,bark,broad-deltate,brow,concolorous,deltate,densely,diameter,distance,drying,dull,eaf,eed,extending,eye,filiform,flattened-reniform,flower,free,geminat,herbaceous,infructescence,lanceolate,lobe,longer,midpoint,midvein,minute,moderately,naked,nflorescence,oblong,older,one,open,orange-brown,orolla,oung,ovate,pair,peduncle,pendulous,per,perfec,pericarp,porrect,portion,prickl,prickly,primary,ray,reduced,rounded,ruit,scar,sessile,shorter,side,smooth,sparsely,stalk,stalked,style,subsessile,tamen,terete,tertiary,time,tip,toward,translucent,tube,unarme,upper,variously,vary,vein,venation,visible,way,yellow-green,ympodial	appressed,articulation,bract,branching,breeding,broad-based,cell,colour,connective,corolla,form,geminate,growth,heteromorphism,inflated,inflorescence,insertion,interjected,interpetalar,leaflet,modification,needle-like,null,odour,orientation,paired,pattern,perfect,placement,pore,position,present,pseudostipule,rhizome,scale,shape,smell,spot,staman,stone,structure,symmetry,sympodial,system,texture,tissue,tuber,type,vegetative,xylopodia,zygomorphy
213	wfo-0001028323	exception_thrown	164	0	0	164	0	0.0		-2,0.2-0.5,0.2-1,0.4-1.3,0.5,0.5-1,0.6-1,0.8,0.9-1.2,1,1-1.2,1-1.5,1-2,1.1-4.5,1.5,1.5-2.5,2-3,2-9,3,3-5,3-6,3.5-4,5-6,7.5-9,abaxially,abscissio,absent,acute,along,anther,anthesi,apart,apex,apparently,appressed,articulated,attenuate,ba,bark,base,berry,blue-green,brown,c.,calyx,capiatate,cell,cm,conical,coriaceous,corolla,cup-shaped,dark,deltate,dendritic,densely,diameter,drying,eaf,eed,ellipsoid,elliptic,entire,erect,fading,filament,fleshy,flower,free,fruiting,glabrescen,glabrescent,glabrous,globose,grey,growth,included,inflorescence,internodal,lanceolate,leaf-opposed,lengthening,less,like,lobe,lobed,longer,lower,main,margin,maturity,minute,minutely,mm,new,nflorescence,occasionally,ovary,ovate,ovoid,pair,pale,papillat,papillose,pedicel,peduncle,peg,perfect,pericarp,petiole,pitted,planar,plurifoliat,pore,poricidal,portion,primary,proceed,pubescent,reddish,remaining,revolute,rounded,ruit,scar,scattered,shiny,shoot,short,shrub,simple,sinus,small,soft,sometimes,somewhat,soon,sparely,sparsely,splitting,stem,stigma,straight,style,surface,tearing,testal,thick,thin,tip,trichome,tube,tuft,ud,uniseriate,unit,vein,violet,wall,way,white,woody,x,ympodial	
214	wfo-0001028329	exception_thrown	215	0	0	215	0	0.0		.5-3,.75-2,.75-5.75,/10-3/10,0-100,0.2-0.3,0.8-1.1,0.8-1.4,0.9-1.3,1-6,1.0-1.4,1.1-2.5,1.3-1.8,1.3-2,1.5-2.3,1.5-2.75,1.5-3.5,1.5-8,10-34,12,2-3,2-4,2.2-3.9,2.6-5,2.75-4.5,3-14,3-8,3.75-7,3/4,4-15,4-5,5-10,6-11,6-8,6-9,7-19,abaxially,absen,acuminate,acute,adaxially,ag,angled,anther,anthesi,apart,apex,apical-lateral,apparently,articulated,asperous,axe,axillary,ba,bark,base,becoming,berry,blade,blunt-tipped,branch,branched,brown,bud,calyx,chartaceous,closely,cm,conical,continued,corolla,cylindrical,dehiscing,deltoid,dendritic-echinoi,dendritic-echinoid,diameter,dichotomously,distantly,distinct,due,eaf,echinoid,eed,entire,filament,finely,fleshy,flower,free,fruit,glabrescen,glabrous,granular,granular-tomentose,gray,green,grooved,growth,hair,high,honeycombed,inserted,introrse,large,lateral,leaf,length,lengthening,lobe,lobed,long,long-attenuate,longitudinally,lower,main,margin,midvein,minutely,mm,moderately,mostly,multangulat,multangulate,nflorescence,obelliptic,oblong,obovate,obscured,obtuse,occasional,older,orbicular,orolla,ovate,ovate-elliptic,pale,pedicel,peduncle,perfect,petiole,plurifoliate,pore,porrect-stellate,present,pseudo-terminal,pubescent,rachi,rather,receptacle,relatively,reniform,reticulate-punctate,ripe,ruit,runk,sessil,sessile,several,short-,short-stalked,shrub,side,simple,slightly,slit,small,sometimes,spaced,sparse,sparsely,stalked,stellat,stellate,stellate-pubescent,stellate-rotate,stelliform,stem,stigma,style,subcapitat,subglobose,suborbicular,suture,swollen,tamen,testa,thick,thickened,thin,time,tomentose,tomentu,touching,toward,tree,tube,turning,unarme,unarmed,unit,usually,vary,vein,velutinous,vestigial,way,white,whitish,wide,x,yellow,yellowish,ympodial,young	
215	wfo-0001028337	exception_thrown	195	0	0	195	0	0.0		-2,-2.5,-4,-6,.5,.8,/3,0,0.05-0.15,0.05-1,0.1-0.3,0.3-0.5,0.4-0.7,0.4-0.8,0.7-0.9,0.7-1,1,1-1.8,1-2,1-3,1.5-3,1.5-4,1.8-2,1/2,1/3-2/3,1/4-1/3,1/8-1/4,11-16,15-50,2-2.2,2-4,3-4,4-5,5-25,5-6,5-8,5-merous,6-7,8-10,8-14,abaxial,abaxially,acut,adaxial,alyx,anther,apar,apart,ape,apex,apically,apparently,articulated,bark,base,berry,blade,branched,calyx,chartaceous,cm,color,conical,connivent,cuneate,curved,dark,deltate,densely,diameter,discolorous,drying,eaf,eed,elongating,entire,equal,erect,evenly,eye,filament,flattened-reniform,flower,free,fruit,fruiting,fused,gently,glabrescent,glabrou,glabrous,glaucous,gray,gray-brown,green,green-brown,hair,inflorescence,infructescence,juvenil,juvenile,known,lateral,leaf,length,lobe,lobed,long,long-styled,longer,lower,margin,marking,mature,mauve,midpoint,minutely,mm,moderately,naked,narrow-oblong,nflorescence,occasionally,older,one,open,orange-brown,orolla,oung,pale,pedicel,peduncle,per,perfect,pericarp,petiole,pitted,plurifoliat,poricidal,porrect,porrect-lepidote,portion,prickle,prickly,primary,ray,reddish,reflexed,rounded,ruit,scar,sessile,shallowly,shoot,short,short-styled,shorter,shrub,simple,slender,small,smooth,spaced,sparse,spherical,staminate,stellate,stellate-pubescent,stem,stout,straight,strongly,style,surface,tamen,tapering,terete,terminal,time,tip,toward,trichome,tube,unarme,unarmed,unit,usually,vary,vein,visible,way,white,wide,ympodial,young	
216	wfo-0001028339	exception_thrown	195	0	0	195	0	0.0		.5,0.05-0.1,0.8-1.2,1-1.2,1-1.5,1-2,1-5,1.1-1.4,1.2-1.5,1.5,1.5-2,1.7-3.2,10-30-flowered,10.2-18.5,2.5-5,3.4-5.5,3.5-4,43191,5-7,5-angled,5.8-7.9,7-11,8-10,8182,across,acuminate,acute,almost,anther,anthesi,apex,appearance,appearing,appressed,attenuate,bark,base,becoming,beneath,berry,blue,broadly,brown,bud,calyx,capitate,carinate,carpel,closely,cm,connate,corolla,covered,crystalline,cuneate,cup-shaped,dark,decurrent,deflexed,densely,dia,differing,difoliate,distinctly,dried,dry,eaf,edicel,eed,enclosed,epidermi,erect,evenly,exserted,fide,filament,filiform,first,flattened,floccose,flower,free,frui,fruiting,geminat,glabrate,glabrous,globose,grainy,greyish-brown,growth,irregular,large-celled,later,lateral,leaf,leave,like,little,lobe,lobed,lon,long,long-triangular,lower,main,major,margin,middle,minor,minutely,mm,mustard,nearly,nee,nflorescence,oblique,obscure,occasionally,older,one,opposite,ovary,ovate,overlappin,ovoid,ovoid-reniform,papery,papillate,papillose,pedicel,petiole,pitted,planar,pore,poricidal,portion,proximal,pulp,red-brown,reflexed,ruit,scar,schwarz,secondary,septum,shaped,shining,shrub,simple,size,slender,slightly,small,somewhat,spaced,sparsely,specimen,speckled,stem,stigma,straight,strong,strongly,style,surface,tall,tapering,tear-drop,texture,tightly,tip,tree,trichome,tub,tube,ud,uniseriate,unit,urceolate,vein,venation,white,white-lenticellat,white-papillo,white-speckled,wide,widest,winged,woody,x,yellow,yellowish,ympodial,young	
217	wfo-0001028351	exception_thrown	175	0	0	175	0	0.0		.2,.8,.8â1.0,0,0.1,0.2,0.5,0.6,0â,1.0â,1.0â1.6,1.0â2.0,1.0â2.5,1.4â1.5,1.5â4.0,1.6â,10,2,2.0â2.5,2.0â5.0,2.1â3.5,2/3,2â2.5,2â4,3,3.4â5.0,3â4,4,40,5,5.0,5.0â5.5,5.5â10.5,5â7,6.5â8.5,6â12,8â15,abaxially,absent,acute,adaxiall,adaxially,ag,along,annual,anther,anthesi,apart,apex,apical,articulated,axe,ba,basal,base,becoming,blade,blue,branching,brown,calyx,capitate,cell,chartaceous,clavate,cm,colour,connivent,convex,cylindrical,densely,diameter,directed,distally,eaf,eed,equal,erect,filament,flattened,fleshy,flower,fruit,geminat,glabrous,glandular,globose,green,hair,herb,indumentum,lamin,lanceolate,leaf,like,lobe,lobed,lon,long,longitudinal,lower,m.,margin,midvein,mm,moderately,multicellular,narrowly,nfloresence,number,oblong,obtuse,occasionally,opening,opposed,orolla,ovate,pair,pale,pedicel,peduncle,pentagonal,perennial,perfect,petiole,pitted,plurifoliate,pore,present,probably,pubescent,regularly,ruit,serrate,shallowly,shaped,shiny,side,simple,slender,slit,smaller,spaced,sparsely,stem,stigma,stone,straight,style,surface,tal,tamen,tardily,teardrop,tem,time,truncate,tube,unbranched,unicellular,uniseriate,unit,unknown,vary,velutinous,white,wide,wing,winged,woody,x,ympodial,young,â,â3.0	
218	wfo-0001028353	exception_thrown	177	0	0	177	0	0.0		.5,/3,0.2-0.4,0.5,0.5-,0.9-1.2,1,1-2,1-4,1.4-2,1.5-2,1.5-5,2,2-3,2-4,3,3-5,4-7,6-8,7,8-10,abaxially,accrescent,acute,age,along,anther,anthesi,apart,apex,area,base,becoming,beneath,berry,bluntly,bright,calyx,campanulate,capitate,cell,centre,ciliate,clasping,cm,coarsely,conical,cordate,corolla,cup-shaped,curved,dark,decreasing,decumben,deep,deeply,densely,diameter,difoliate,distally,dry,drying,eaf,edicel,eed,ellipsoid,elliptic,emarginated,erect,exerted,filament,fleshy,flower,fracturing,free,frui,fruiting,geminat,glabrous,globose,gree,green,greenish,growing,herb,heteromorphic,hollow,honey-comb,horn,horned,inserted,internodal,leaf,lengthening,less,like,lobe,lon,long,lower,m.,margin,material,midrib,minute,minutely,mm,nflorescence,nodding,often,open,outline,ovary,ovoid,pair,pale,papery,papillate,papillose,pedicel,peduncle,pericarp,petiole,pitted,plant,plump,point,pore,poricidal,portion,primary,principal,pubescent,purple,reddish,rhomboid,ripe,ruit,scar,scattered,sessil,sessile,shallow,short,simple,size,sleeve,slender,slightly,slit,somewhat,sparsely,stem,stigma,straight,strongly,style,surface,tan,testal,thin,tip,toothed,toward,trichome,truncate,tube,ud,uniseriate,unit,vein,wall,way,wrinkled,x,yellow,ympodial	
219	wfo-0001028390	success	147	137	75	72	62	0.51	.5-3.3,0.5-1.5,1,1-2.5,1.5-2,1.5-5.5,2,4-11,5-7,abaxially,acute,apex,articulated,base,blade,branched,calyx,cell,chartaceous,cm,connivent,cuneate,dendritically,dendritically-branched,densely,directed,eglandular,elliptic,entire,forked,glabrous,gland,globose,hair,lanceolate,leaving,less,like,long,lower,margin,mixed,mm,moderately,mostly,near,occasionally,orange,ovate,pedicel,peg,petiole,pore,pubescent,rarely,ripe,scar,short,shrub,simple,small,sparsely,stalked,stellate,stone,subcordate,subcoriaceous,time,unbranched,unit,violet,white-pubescent,wide,x,yellow	-10,0,0.5,0.5-1,0.5-2.5,1-3,1-5,1.5-3.5,10-15,2.5,3-4,3-5,4-5,6-many-foliat,7,7-8,9,absen,adaxiall,adaxially,aggregate,angled,apart,apiculate,axe,curled,cylindrical,deltate,dense,diameter,distall,divided,eaf,eed,felty-pubescent,flower,lobe,lon,midvein,narrowly,nflorescence,nther,obtuse,often,orolla,peduncle,perfect,presen,pseudohair,puberulent,pubescen,rachi,radiu,ruit,slightly,spaced,ste,stigma,style,subcapitat,subclavate,tal,tem,tip,triangular,truncate,tube,unequally,usually,vary,white,ympodial	6-many-foliate,absent,anther,appressed,articulation,bract,branching,breeding,broad-based,colour,connective,corolla,distally,filament,form,fruit,fruiting,growth,heteromorphism,inflated,inflorescence,insertion,interjected,interpetalar,leaf,leaflet,length,marking,mature,modification,needle-like,null,odour,orientation,paired,pattern,placement,position,present,prickle,pseudostipule,rhizome,scale,shape,smell,spot,staman,stem,structure,surface,symmetry,sympodial,system,tall,texture,tissue,trichome,tuber,type,vegetative,xylopodia,zygomorphy
220	wfo-0001028405	exception_thrown	149	0	0	149	0	0.0		0.4-0.5,0.5-3,1-4,1-9,1.3-8,1.5-6.5,10-11,2,2-2.5,2-3,2-4,3-20,3-4,3-6-foliat,3.5-10,3.5-6.5,4-11.5,4-6,6-7,7-14.5,8-15,9-15,abaxially,absen,acumen,acute,adaxially,apex,apical,apically,apiculate,articulate,attenuate,base,branched,calyx,cell,cm,conical,connate,corolla,covering,cyme,decurrent,dehiscent,diameter,dichasial,dichasially,digestion,diminishing,distal,dorsally,eaf,ebracteate,edge,eed,elliptic,elliptic-lanceolate,emoval,enzyme,exceeding,filament,flat,flower,folded,forked,generally,globo,gradually,green,green-white,hair-like,half,herbaceous,honeycomb,interjected,introrse,lanceolate,lateral,leaf,leaflet,living,lobe,lon,long,lower,lunat,make,maturing,mm,monochasial,mucilaginous,nflorescence,nther,oblique,oblong,odd-pinnate,often,orolla,ovate-elliptic,ovoid,pair,pattern,pedicel,peduncle,perennial,perfect,petiole,plan,plant,poricidally,proximal,puberulent,rachi,reveal,ruit,seed,seudostipule,short,short-acuminate,short-petiolate,size,slit,specimen,stamen,stellate,stigma,straight,style,subsessile,tal,tem,terminal,testal,thick,throughou,throughout,toward,tuber-bearing,typically,unit,vary,wall,whit,wide,without,yellow,ympodial,Â¼	
221	wfo-0001028429	success	162	138	81	81	57	0.5	1-4,1.5-3,2-3,2.5-7.5,4-14,abaxially,adaxially,apex,apical,apically,base,branched,calyx,cell,cm,connate,cordate,corolla,cuneate,cyme,darker,dehiscent,dichasial,dichasially,distal,ebracteate,especially,filament,flower,forked,generally,glabrescent,glabrous,globose,green,greenish,hair,hair-like,half,herbaceous,honeycomb,interjected,introrse,lateral,leaf,leaflet,light,lower,maturing,medium,mm,monochasial,oblique,odd-pinnate,often,ovoid,pattern,pedicel,pentagonal,perennial,perfect,petiole,plant,poricidally,proximal,rotate,scattered,short,slightly,slit,spot,testal,throughout,tuber-bearing,typically,unit,vein,violet,wall,white,Â¼	0.2-0.4,0.8-1.2,0.9-2.3,1-2.5,1.5-4,10-11,10-27,10.5-21,2-1.,2-4,2-8,2.5-12,2.5-4,2.7-3.6,3-6,3-6-foliat,5-12,6-18,6-28,7-7,abaxiall,acumen,acuminate,acute,articulate,broadly,covering,diameter,digestion,diminishing,dorsally,eaf,edge,eed,elliptical,emoval,enzyme,exceeding,flat,folded,globo,gradually,green-white,living,lobe,lon,long,long-attenuate,lunat,make,mucilaginous,narrowly,nflorescence,nther,obovate,orolla,ovate,pair,peduncle,petiolule,plan,reveal,ruit,seed,seudostipule,size,specimen,stamen,stigma,straight,style,tal,tem,terminal,thick,throughou,toward,vary,wide,yellow,ympodial	2-19,3-6-foliate,anther,appressed,articulation,bract,branching,breeding,broad-based,colour,connective,form,fruit,fruiting,growth,heteromorphism,inflated,inflorescence,insertion,interpetalar,length,lunate,margin,marking,mature,modification,needle-like,null,odour,orientation,paired,placement,pore,poricidal,position,prickle,pseudostipule,rhizome,scale,shape,smell,staman,stem,stone,structure,surface,symmetry,sympodial,system,texture,tissue,trichome,tuber,type,vegetative,xylopodia,zygomorphy
222	wfo-0001028436	success	150	129	79	71	50	0.527	.5,0.5-1,1-2-celled,1-3,1.5-2,1st,2nd,4,5-8,abaxially,absent,abundant,acute,adaxially,along,anther,apex,apically,appearing,axe,base,berry,blade,brown,calyx,cell,chartaceous,ciliate,decurrent,difficult,dried,elliptic,entire,filament,flat,flower,fruit,fruiting,geniculate,glabrous,globose,hair,interpetalar,leaf,linear,lower,lying,margin,membranaceous,mm,moderately,much-branched,nearly,oblong,often,pedicel,peduncle,petiole,pointing,pubescent,rachi,rhizomatous,rotate,shrub,small,sparsely,stem,structure,surface,taproot,thick,tissue,two-celled,unbranched,unifoliate,unit,white,woody,x	0.2-0.4,0.5,0.8-1.5,1-2,1.5,1.5-2.5,10-20,2-3,2-4,2.5-3,5-10,5-12,5-15,7,8-12,adaxiall,appearance,beyond,center,cm,connected,cordat,deflated,dehiscent,diameter,dm,due,eaf,edge,eed,evaluat,explosively,exserted,fine,frui,glabrescen,lengt,like,linear-lancolate,lobe,long,nflorescence,notch,older,orolla,oung,parallel,per,placenta,presence,pubescen,radiating,raised,reaching,ridge,ruit,running,shallow,stamen,stigma,style,swollen,tal,tamen,tear,triangular,tube,vary,wid,wrinkled,ympodial	appressed,articulation,bract,branching,breeding,broad-based,colour,connective,corolla,evaluate,form,growth,heteromorphism,inflated,inflorescence,insertion,interjected,leaflet,length,marking,mature,modification,needle-like,null,odour,orientation,paired,pattern,placement,pore,position,prickle,pseudostipule,rhizome,scale,shape,smell,spot,staman,stone,symmetry,sympodial,system,texture,trichome,tuber,type,vegetative,xylopodia,zygomorphy
223	wfo-0001028465	exception_thrown	159	0	0	159	0	0.0		0.75,1-2,1-4,1.2-2,1.5-2.9,10,10-24,11-23,2,2-3,2-4,2-6,2-9.3,2.4-2.8,2.5-4,3-4,3-5,3-6-foliat,3-8,3.8-7,4-1.,4-8,4.5-5.5,5-7,7-15,8-10,9-19,abaxially,acumen,acuminate,acute,adaxially,apex,apical,apically,articulate,attenuate,base,branched,broadly,calyx,cell,cm,connate,corolla,covering,cuneate,cyme,decurrent,dehiscent,diameter,dichasial,dichasially,digestion,diminishing,distal,dorsally,eaf,ebracteate,edge,eed,elliptical,emoval,enzyme,equal,exceeding,filament,first,flat,flower,folded,forked,generally,globo,globose,gradually,green,green-white,hair-like,half,herbaceous,honeycomb,interjected,interpetalar,introrse,lateral,leaf,leaflet,living,lobe,lon,long,lower,lunat,make,maturing,medium,mm,monochasial,mucilaginous,nflorescence,nther,oblique,odd-pinnate,often,orolla,ovoid,pair,pattern,pedicel,peduncle,perennial,perfect,petiole,petiolule,plan,plant,poricidally,proximal,puberulent,pubescent,purple,rachi,rarely,reveal,rotate,ruit,seed,sessile,seudostipule,short,size,slit,specimen,spot,stamen,stigma,straight,strigose,style,tal,tem,terminal,testal,thick,throughout,tissu,toward,tuber-bearing,two,typically,unit,vary,wall,white,wide,yellow,ympodial,Â¼	
224	wfo-0001028468	success	255	143	91	164	52	0.357	-10,-7,.3-0.4,.5-1.5,/10-1/5,0.5-8,0.6-2,0.7-2.5,0.8-3.5,20,accrescent,along,anther,apart,apex,appressed,armed,attenuate,base,becoming,berry,blade,blue,broad-based,brown,calyx,central,chartaceous,clavate,cm,commonly,compressed,corolla,densely,distally,extra-axillary,filament,flattened,fruit,fruiting,gradually,hair,increasing,interpetalar,lateral,laterally,length,light,lobed,lower,margin,mm,moderately,oblique,occasionally,orange,pedicel,per,petiole,pore,porrect-stellate,prickle,pubescence,purple,recurved,rotate-stellate,shallowly,short,short-stalked,shrub,similar,simple,slightly,somewhat,spaced,stellate-pubescent,stem,straight,subcuneate,subglobose,subshrub,surface,thicknes,tissue,unarmed,unbranched,unifoliate,unit,usually,vein,x	-1.3,-3,-4,-5.5,.1-0.2,.1-0.3,.1-0.4,.2,.2-0.4,.3,.5,.5-1.6,.6-1,/4-1/3,0.05,0.1,0.2-0.3,0.2-0.6,0.2-1.5,0.4-1,0.4-4,0.5-2,0.5-3,0.5-3.3,0.5-3.5,0.6-1.2,1,1.2-1.5,1.3-2,1.5-2.2,1.5-3.1,1.6,1/3-1/2,1/5-1/2,16,2,2-9,2.2-3,2.5-4,2.8-4.1,2/3-3/4,3-4,4-6,4-9,5-21,5-9,6-10,6-9,abaxially,acuminate,acute,adaxially,ark,articulated,axe,beyond,broadly,bu,bud,c.,campanulate,cauline,compresse,connivent,d.,dark,decreasing,density,diameter,directed,distal,distantly,dry,eaf,eed,ellipsoid,equal,exserted,flower,foveate,geminat,glabrescent,glabrous,gray,green,greenish,half,inserted,introrsel,lamin,lobe,long,longer,m.,main,midpoint,midvein,minutely,mixed,mostly,multangulat,multangulate,narrowly,nflorescence,oblong-conical,oblong-lanceolate,obtuse,older,orangish,orolla,ovate,overlapping,ovoid,pair,pale,papillo,peduncle,perfect,proximal,pubescent,rachi,ray,reduced,relatively,reticulate,rhombic,ruit,sessile,short-,side,similarly,sparsely,specimen,stalk,stamen,stelliform,stigma,style,subacuminate,subcapitate,subchartaceous,subelliptic,sublenticular,subreniform,subsessile,tal,tamen,terete,testa,thick,thick-stalked,time,touching,toward,triangular,tube,upper,vary,way,wide,yellow,yellowish,ympodial,young	articulation,bract,branching,breeding,cell,colour,connective,dm,form,geminate,growth,heteromorphism,inflated,inflorescence,insertion,interjected,lamina,leaf,leaflet,marking,mature,modification,needle-like,null,odour,orientation,paired,pattern,placement,position,present,pseudostipule,rhizome,scale,shape,smell,spot,staman,stellate,stone,structure,symmetry,sympodial,system,tall,texture,trichome,tuber,type,vegetative,xylopodia,zygomorphy
225	wfo-0001028470	exception_thrown	185	0	0	185	0	0.0		0-18,0.25-0.75,0.9-2.2,0.9-2.3,1-12.3,1-2,1-3,1.5-2.8,1.6-3.2,11.8-21,12-44,2-10,2-5,2-7,2-8,2.1-3.9,3-10,3-5,3.2-5.5,3.5-16,3.5-7,4-6,4-7,5-merou,5.5-11.6,6-33,abaxially,acumen,acute,adaxiall,adaxially,ag,alyx,anther,apart,apex,apparently,articulated,asymmetric,attenuate,axe,axillary,base,basiscopic,berry,blade,brownish,bud,capitat,cell,chartaceous,clavate,cm,condition,connivent,corolla,covering,dark,decreasing,deep,diameter,digestion,distal,dorsally,dot,drying,eaf,edge,eed,elliptic,end,enzyme,erec,exceeding,filament,flat,flower,folded,forked,fresh,fruit,geminat,generally,glabrescent,glabrou,glabrous,green,green-white,greenish,hair,hair-like,hal,half,herb,high,homostylous,honeycomb-shaped,interjected,lanceolate,lateral,leaf,leaflet,lengthening,light,living,lobe,long,lower,make,medium,mm,mottled,mucilaginous,nflorescence,odd-pinnate,one,orbicular,orolla,ovate,ovoid,pair,pedicel,peduncle,pentagonal,perfect,petiole,petiolulate,placed,plant,plurifoliate,pore,poricidal,pubescent,purple,removed,ripe,rounded,ruit,scarce,seed,sessile,seudostipule,short,side,size,slit,sometimes,spaced,specimen,stamen,stigma,stolo,straight,style,subequal,subglabrou,substellate,subtending,tall,tamen,tem,terminal,testal,thick,throughout,tip,tissue,toward,tri-,tube,tuber,typically,unit,unwinged,usually,vary,wall,wet,white,whitish,wide,wing,x,yellow,ympodial	
226	wfo-0001028476	exception_thrown	246	0	0	246	0	0.0		-1,-16,-20,-6,-8,.05-0.1,.5,0-,0-0.5,0.1-0.15,0.1-0.4,0.15-0.2,0.15-0.4,0.2-0.3,0.2-0.5,0.2-0.6,0.25-0.4,0.25-0.5,0.3-0.4,0.3-0.5,0.3-0.7,0.3-1.2,0.4-0.5,0.4-0.6,0.4-1.5,0.5,0.5-0.6,0.5-1.7,0.7-2.5,0.8-1.2,0.8-1.6,1,1-1.2,1-1.4,1-1.5,1-2,1-2-celled,1-4,1-6,1-celled,1.1-1.5,1.1-1.6,1.2-2.5,1.8-2.5,12-30,2,2-6,2-foliate,2-locular,2.4-3,3-12,3-7,3-foliate,3.5-13,4-celled,5-15,6-,7-10,8-30,abaxially,absent,abundant,acroscopically,acuminate,acute,age,almost,along,also,alternate,anther,anthesi,ape,apex,apical,appearance,appendage,articulated,axi,basal,base,basiscopically,becoming,bifurcate,bifurcation,bract,bracteate,branched,bright,brown,calyx,capitate,cell,cm,column,conical,corolla,curved,dark,decurrent,deeply,diamete,diameter,distal,eaf,ebracteate,edicel,eed,elliptic,elongate,entire,especially,exserted,filament,first,flower,fortaleza,fruit,fruiting,give,glabrescent,glandular,globose,gradually,gree,green,hair-like,hal,half,head,herb,hyaline,imparipinnate,incurved,inflorescence,interjected,internode,interrupted,irregularly,lanceolate,largest,lateral,leaf,leaflet,less,like,lobe,lobed,lon,long,lower,main,margin,maturity,midvein,minute,minutely,mixed,mm,narrowly,nflorescence,node,numerous,oblique,obovate,occasionally,often,outgrowth,ovary,pair,pale,pedicel,peduncle,perennial,petiole,petiolule,population,present,primary,prominent,pseudostipule,puberulent,pubescence,pubescent,purple,rachi,rarely,recurve,reflexed,regularly,rest,rounded,ruit,rÃ­o,scattered,secondary,sessile,set,short,silky,simple,sinus,slightly,smaller,sparsely,sprawling,spreading,staminal,stellate,stem,sterile,stiff,stigma,straight,stripe,style,subopposite,surface,tall,tem,terminal,tertiary,testa,thick,tip,toward,trichome,truncate,tube,ud,unicellular,uniformly,uniseriate,unit,unpaired,usually,vein,wall,weak-walled,white,wid,wide,winged,woody,yellow,ympodial	
227	wfo-0001028481	success	194	122	68	126	54	0.351	.1,0-2,0.6-1,1-4,almost,anther,apex,apically,attenuate,base,branched,canaliculate,chartaceous,cm,colour,corolla,cuneate,cupular,deeply,dendritic,dendritic-pubescent,dilated,discolorous,divided,dry,drying,entire,equal,eye,filament,glabrous,known,leaf,length,less,liana,like,lobed,long,lower,margin,mm,naked,oblique,oblong,occasional,pedicel,petiole,pore,poricidal,ray,ridged,shortly,shrub,simple,slender,sparsely,stem,surface,terminal,thickly,tip,trichome,unarmed,unit,unknown,visible,young	.3,.5,0.1-0.2,0.15,0.5-1,0Â°,1-1.4,1-2,1-3,1.5,1.5-2,1.8-2.5,1/2-2/3,2-3,2.5-3,3,3-3.5,3-4,3-4.5,3-6,5.5-7.5,8,abaxially,absent,acuminate,acute,adaxially,age,along,alyx,anthesi,apar,apparently,articulated,bark,branch,brown,clavate,clearly,close,conical,delineated,deltoid,density,diameter,different,distributed,domatia,dorsifixed,eaf,eed,ellipsoi,elliptic,erect,evenly,except,extending,extent,faint,flaking,flat,flexuous,flower,free,green,increasing,know,lamina,lengthening,linear,lobe,lon,long-acuminate,longer,longitudinally,m.,main,midvein,mostly,narrowly,nflorescence,nther,often,orange-brown,orolla,ovate,pair,peduncle,perfec,plurifoliat,portion,primary,protruding,pubescent,rachi,raised,reddish,ribbed,ruit,scar,see,side,sinus,size,small,smoot,smoothly,spreading,stigma,stump,style,tearing,tertiary,together,toward,tube,ud,uneven,vary,vein,venation,white,wide,x,yellowish,ympodial	appressed,articulation,bract,branching,breeding,broad-based,calyx,cell,connective,form,fruit,fruiting,growth,hair,heteromorphism,inflated,inflorescence,insertion,interjected,interpetalar,leaflet,marking,mature,modification,needle-like,null,odour,orientation,paired,pattern,placement,plurifoliate,position,prickle,pseudostipule,rhizome,scale,shape,smell,spot,staman,stellate,stone,structure,symmetry,sympodial,system,texture,tissue,tuber,type,vegetative,xylopodia,zygomorphy
228	wfo-0001028482	exception_thrown	224	0	0	224	0	0.0		.1,.5,/3,0,0.2,0.5,0.5-1,0.5-5,0.7-1.1,00,1-1.5,1-11,1-2,1-4,1.1-5,1.2-1.6,1.5-2,1.5-3,10,2-3,2-celled,3-12,3-4,4-5,5-25,6-50,7-14,abaxially,acuminate,acute,adaxially,age,alternate,angled,anther,anthesi,apex,apiculae,ascending,asymmetric,bark,basal,base,becoming,berr,berry,bifid,bifurcate,bilobed,branched,bright,broadly,brochiodromous,brownish,bud,calyx,campanulate,capitate,channeled,chartaceous,circinate,closely,cm,constriction,coriaceous,corky,corolla,corrugated,creamy,cucullate,curved,cymose,deciduous,deflexed,deltate,densely,diameter,diffusely,difoliate,discolorous,distally,distinct,dry,drying,eaf,eed,ellipsoid,elliptic,emarginate,embryo,enlarged,entire,exerted,exfoliating,expanding,filament,flattened-reniform,fleshy,flower,free,fresh,fruit,fruiting,geminat,glabrou,glabrous,glandular,globose,golden,grayish,green,growth,halfway,hard,heterostylous,impressed,incrassate,individual,internodal,investing,irregular,keeled,leaf-opposed,lengthening,less,lobe,lobed,long,lower,margin,markedly,materia,material,maturity,midrib,midvein,minute,minutely,mm,new,nflorescence,nodding,obovate,occasionally,olive,ovary,overlappin,pair,pale,papillat,pedicel,peduncle,pentamerous,per,pericarp,petal,petiole,pitted,pore,poricidal,portion,primary,pubescent,reddish,revolute,row,ruit,scandent,scar,shaped,shiny,short,simple,size,slightly,slit,small,sometimes,somewhat,soon,spaced,sparsely,stem,stigma,stout,straight,style,subcoriaceous,subglobose,subpyramidal,surface,tan,tear-drop,tightly,tiny,tip,transparent,transversely,tree,trichome,truncate,tub,tube,tuberculate,tuft,twice,two,ud,unifoliate,uniseriate,unit,usually,vegetative,vein,venation,way,white,woody,x,yellow,yellowish,ympodial,young,Âµm	
229	wfo-0001028487	exception_thrown	195	0	0	195	0	0.0		0-9,0.3-0.7,0.4-1.5,0.9-3,1-2,1-3,1-3.2,1.1-1.5,1.4-1.7,1.7-7,10-4.3,10-41,15-28,2-4,2-4.8,2-6,2.5-3.5,3-10,3-19,3-4,3-5,3.4-7.8,4-7,4.6-13.6,5-6,5-merou,7.8-16.4,abaxially,acumen,acuminate,acute,adaxiall,adaxially,ag,along,alyx,anther,apart,apex,apparently,arranged,articulated,asymmetric,attenuate,axe,axillary,base,basiscopic,bead,berry,blade,brownish,bud,capitat,cell,central,clavate,cm,condition,connivent,considerably,coriaceous,corolla,covering,dark,decreasing,deep,diameter,digestion,distal,dorsally,drying,eaf,edge,eed,elliptic,enzyme,erec,exceeding,filament,flat,flower,folded,forked,fresh,fruit,geminat,generally,glabrescent,glabrou,glabrous,green,green-white,greenish,hair,hair-like,hal,half,herb,high,homostylous,honeycomb-shaped,interjected,lanceolate,lateral,leaf,leaflet,lengthening,light,like,living,lobe,long,lower,make,medium,mm,moniliform,mucilaginous,multiple,narrow,necklace,nflorescence,odd-pinnate,orbicular,orolla,ovate,ovoid,pair,pedicel,peduncle,pentagonal,perfect,petiole,petiolulate,plant,plurifoliate,pore,poricidal,purple,removed,ripe,rounded,ruit,scabrous,scarce,second,seed,sessile,seudostipule,short,side,size,slit,smaller,sometimes,spaced,specimen,stamen,star,stigma,stolon,straight,style,subequal,subglabrou,substellate,subtending,tall,tamen,tem,terminal,testal,thick,throughout,tip,tissue,toward,tri-,tube,tuber,typically,unit,unwinged,usually,vary,wall,wet,white,whitish,wide,wing,x,yellow,ympodial	
230	wfo-0001028489	success	224	149	100	124	49	0.446	-2.5,-4,/4,0-50,0.3-0.5,0.3-1.2,0.5-0.8,0.5-1,1-7,1/3-1/2,1/4-1/2,2-3,4-13,acicular,acute,anther,apart,apex,apically,apparently,base,berry,beyond,blade,branched,broad-deltate,calyx,cell,chartaceous,cm,cordate,cream,cuneate,dark,deltate,difoliate,elongating,equal,erect,filament,free,fruit,fruiting,glabrous,gray,green,hair,lateral,leaf,length,lobe,lobed,long,lower,margin,marking,mature,maturity,mauve,membranous,mm,often,orange,orange-brown,pale,pedicel,perpendicular,petiole,poricidal,porrect,portion,prickle,protruding,purple,rounded,sessile,shrub,side,simple,sometimes,spaced,spherical,stellate,stellate-pubescent,stem,straight,subsessile,surface,tapering,tip,trichome,truncate,tube,unit,way,white,wide,yellow,yellow-orange,young	-0.6,-10,-5,-6,0-10,0-15,0-20,0-3,0.1,0.1-0.6,0.2,0.2-,0.2-0.4,0.2-0.5,0.2-0.6,0.2-0.7,0.3-0.7,0.3-1,0.4-0.8,0.5-1.1,0.5-1.5,0.6-1.2,0.7-3,1-3,1-4,1-6,1.5-3,1.5-4,1.8-2.2,1.8-4,1.8-5.5,1/3,2-4,2-6,2.1-3,3-7,3.5-6,4-10,4-8,5-25,5-8,5-merous,7.5,abaxially,alyx,apar,articulated,ba,bark,caudat,concolorous,connivent,curved,densely,diameter,distance,drying,dull,eaf,eed,elliptic,extending,eye,flattened-reniform,flower,geminat,herbaceous,infructescence,less,lon,longer,midpoint,midvein,minute,moderately,naked,nflorescence,obtuse,occasionally,older,one,open,orange-green,orolla,oung,outline,ovate,pair,peduncle,pendulous,per,perfec,pericarp,prickly,primary,raised,ray,red-brown,ruit,scar,shiny,slender,smooth,sparsely,spreading,stalk,style,tamen,terete,tertiary,time,toward,unarme,unarmed,upper,vary,vein,venation,visible,weakly,white-gra,woody,yellow-green,ympodial	appressed,articulation,bract,branching,breeding,broad-based,colour,connective,corolla,form,geminate,growth,heteromorphism,inflated,inflorescence,insertion,interjected,interpetalar,leaflet,modification,needle-like,null,odour,orientation,paired,pattern,perfect,placement,pore,position,pseudostipule,rhizome,scale,shape,smell,spot,staman,stone,structure,symmetry,sympodial,system,texture,tissue,tuber,type,vegetative,xylopodia,zygomorphy
231	wfo-0001028492	success	130	99	39	91	60	0.3	1-2.5,3,5-8,apex,base,calyx,cell,cm,colored,dark,directed,entire,forked,fruit,glabrous,globose,hair,herb,lower,margin,mm,narrowly,pedicel,petiole,pore,punctate,purple,rarely,ripe,rounded,shrub,simple,stellate,stone,subcordate,triangular,unbranched,unit,white	-5-foliat,0.2-2,0.5-1,1-4,1-5,1.5-2.5,1.5-3,1.5-6,1.75-3.5,15-20,2-2.5,2-3,2-4,2-5,2.5-9,3-6,4,5-15,5-25-flower,6-11,6-12,8-15,abaxially,absen,acute,adaxially,aggregate,angled,apart,apiculate,articulated,axe,axi,blade,chartaceous,ciliolate,color,connivent,containing,crystal,cylindrical,deltate,diameter,distall,eaf,eed,elliptic-ovate,except,glabrou,irregularly,leaving,lobe,long,nflorescence,nther,obtuse,orolla,peduncle,pubescent,rachi,radiu,reticulate,ruit,san,sand-punctate,scar,somewhat,spaced,sparse,splitting,stigma,style,subcoriaceous,succulent,tal,tem,time,tip,triangular-ovate,truncat,tube,unevenly,unknown,vary,veiny,white-punctate,whitish,wide,x,x1-3,ympodial	-5-foliate,absent,anther,appressed,articulation,bract,branching,breeding,broad-based,colour,connective,corolla,distally,filament,form,fruiting,growth,heteromorphism,inflated,inflorescence,insertion,interjected,interpetalar,leaf,leaflet,length,marking,mature,modification,needle-like,null,odour,orientation,paired,pattern,placement,position,prickle,pseudostipule,rhizome,scale,shape,smell,spot,staman,stem,structure,surface,symmetry,sympodial,system,tall,texture,tissue,trichome,tuber,type,vegetative,xylopodia,zygomorphy
232	wfo-0001028501	exception_thrown	195	0	0	195	0	0.0		0-3,0-3.2,0-4,0.3-0.7,0.3-3.3,0.6-5.8,0.8-1.6,0.8-1.7,1,1-2,1-3,1-8,1.8-10.7,13-41,2-4,2-5,2.8-18,2.8-4.9,3-10,3-5,3-7,3.1-10.4,3.1-12,4-8,4.8-18,5-merou,6.6-21.1,8-10,8-34,abaxially,acumen,acuminate,acute,adaxiall,adaxially,ag,along,alyx,anther,apart,apex,apparently,arranged,articulated,attenuate,axe,axillary,base,bead,berry,blade,broadly,brownish,bud,capitat,cell,clavate,cm,condition,connivent,considerably,coriaceous,corolla,covering,dark,decreasing,decurrent,diameter,digestion,distal,dorsally,drying,eaf,edge,eed,elliptic,enzyme,erec,exceeding,filament,flat,flower,folded,forked,fresh,fruit,geminat,generally,glabrescent,glabrou,glabrous,green,green-white,greenish,hair,hair-like,hal,half,herb,high,homostylous,honeycomb-shaped,interjected,lanceolate,larger,lateral,leaf,leaflet,lengthening,light,like,linear,living,lobe,long,lower,make,medium,mm,moniliform,mottled,mucilaginous,multiple,narrow,narrowly,necklace,nflorescence,odd-pinnate,onto,orbicular,orolla,ovate,ovoid,pair,pedicel,peduncle,perfect,petiole,plant,plurifoliate,pore,poricidal,present,purple,pyriform,rachi,removed,ripe,rotate,ruit,scarce,seed,sessile,seudostipule,short,simple,size,slit,sometimes,spaced,specimen,spot,stamen,stigma,stolon,straight,style,subglabrou,subtending,tall,tamen,tem,terminal,testal,thick,throughout,tip,toward,tri-,tube,tuber,typically,unit,unwinged,usually,vary,wall,wet,white,whitish,wide,wing,x,yellow,ympodial	
233	wfo-0001028502	exception_thrown	158	0	0	158	0	0.0		.5,/2,0.5-1,1-2,1.5-2,1.5-2.5,1.5-3,1.5-6,1.6-2.4,2-2.5,2-4,2-5,2-7,2-8,3.5-15,3.5-4,5-15,5-6,6-8,?,abaxial,abaxially,acute,adaxially,age,along,anther,anthesi,apar,apex,ba,bark,base,beige,blade,body,branch,branched,brown,calyx,campanulate,cazalet,christmas-tree-like,clavate,closely,cm,cone,congested,constricted,corolla,dark,deltate,dendritic,densely,denser,dia,eaf,edicel,eed,elliptic,erect,exserted,fawn,fide,filament,flat,flattened-reniform,fleshy,flower,free,fruiting,glabrat,glabrous,globose,heteromorphic,impressed,included,incrassate,inflorescenc,inflorescence,later,lateral,leaf,lengthening,light,like,lobe,lobed,lon,long,long-styled,lower,main,margin,matted,middle,minutely,mm,narrower,nflorescence,obovate,often,older,ovary,packed,pair,papillo,papillose,pedicel,petiole,pitted,planar,plurifoliat,pore,poricidal,portion,prominent,pubescent,reddish-brown,rest,ruit,scar,scattered,seed,shining,short-styled,shrub,slit,small,spaced,stem,stigma,structure,style,surface,tall,terminal,thick,time,tip,tree,tree-like,trichome,tub,tube,ud,unclear,unevenly,vein,warty,way,white,wide,widest,within,woody,ympodia,young	
234	wfo-0001028505	exception_thrown	168	0	0	168	0	0.0		.01,.1,.3,.5,/3,0.25-0.5,0.8-1,0.8-1.5,1,1-3,1.2-2.5,1/3,10-14-flowered,10-15,2,2.5-4.5,3-5,3.5-5,7-8,acuminate,acute,anther,anthesi,apex,aspect,ba,barely,bark,basal,base,beneath,berry,black,blade,body,branch,bright,broadly,bud,calyx,characteristic,cm,conical,corolla,darker,deciduous,decurrent,deflexed,delicate,deltoid,dia,differentiated,differing,difoliate,distance,distinct,dried,dry,drying,eaf,edicel,eed,elliptic,erect,expanded,exserted,exsertion,f,filament,flattened,free,fruiting,geminat,gently,glabrous,globose,greatly,green,grey,incrassate,lateral,leaf,live,lobe,lobed,lon,long,lower,m.,main,major,margin,materia,material,member,minor,minute,minutely,mm,narrowly,nflorescence,obovoid,obvious,older,opposite,ovary,ovate,overlapping,ovoid-reniform,pair,pale,papillose,pedicel,petiole,pitted,plant,pore,poricidal,portion,prominent,proximal,pubescent,purple,reflexed,rounded,ruit,scar,seed,shape,shaped,short,shrub,simple,size,slightly,somewhat,soon,specimen,stem,stigma,straight,strongly,style,surface,tall,tan,tapering,tear-drop,tip,touching,trichome,truncate,tube,ud,unicellular,uniseriate,unit,usually,vein,way,whit,white,widest,woody,x,yellowish,ympodial,young	
235	wfo-0001028524	success	236	183	134	102	49	0.568	-2.7,/10-3/10,0.6-1.4,1.1-1.2,10-20,2-6,2.5-3.4,3-10,3-15,3-4.3,3.3-4,4-6,abaxially,accrescent,acute,adaxially,along,anther,apex,apical-lateral,apparently,articulated,ascending,axillary,base,becoming,berry,blade,blunt-tipped,branched,calyx,chartaceous,cm,continued,corolla,cream,dark,dehiscing,diameter,distal,due,echinoid,elliptic,entire,extend,ferrugineous,few-,few-rayed,filament,fleshy,free,fruit,fruiting,glabrescent,glabrous,granular-tomentose,green,greenish,growth,hair,half,high,indument,interpetalar,introrse,lacking,lanceolate,large,lateral,leaf,length,lobe,long,longitudinal,lower,many-rayed,margin,midvein,mixed,mm,multangulate,oblong,obtuse,ovate,overlapping,pale,partly,pedicel,perfect,persistent,petiole,plurifoliate,pore,porrect-stellate,present,probably,prominent,pseudo-terminal,pubescent,ray,relatively,ripe,rounded,scabridulous,sessile,short,simple,slightly,slit,small,somewhat,sparsely,stellate,stem,stout-stalked,subcoriaceous,subglobose,thick-stalked,thin-stalked,time,tissue,tomentose,touching,tree,unarmed,unit,usually,velutinous,warty,wide,x,yellow,yellowish,yellowish-green	-3,.5-1,0-150,0.3,0.3-0.8,0.5-3.5,1-5,1.2-1.3,1.5-1.6,1.5-3,1.8-2.5,1/3-2/3,11,2-3.8,2.5-3.8,2.5-4,2.8-3.5,3.4-3.6,4-8,4.3-6,6-7,6-9,7-10,7-11,8-13,9-14,acuminate,ag,anthesi,apart,axe,ba,bark,branch,brown,bud,capitat,closely,conical,deltoid,densely,dm,eaf,echinoi,eed,exserted,first,flower,glabrescen,gray,honeycombed,inserted,lanceolat,late,later,lobed,m.,main,matted,midvei,nearly,nflorescence,obscured,often,older,orbicular,orolla,ovate-lanceolate,peduncle,rachi,rather,reniform,reticulate-punctate,ruit,runk,short-stalked,side,spaced,sparingly,stalked,stamen,stelliform,stigma,strongly,style,suborbicular,sulcate,suture,tamen,terete,testa,thick,thin,tomentu,translucent,tube,unarme,vary,vein,way,ympodial,young	age,appressed,articulation,bract,branching,breeding,broad-based,cell,colour,connective,form,heteromorphism,inflated,inflorescence,insertion,interjected,leaflet,marking,mature,modification,needle-like,null,odour,orientation,paired,pattern,placement,position,prickle,pseudostipule,rhizome,scale,shape,smell,spot,staman,stone,structure,surface,symmetry,sympodial,system,texture,trichome,tuber,type,vegetative,xylopodia,zygomorphy
236	wfo-0001028525	success	257	176	126	131	50	0.49	.25,.4,0.2-0.3,0.2-0.6,0.5,0.5-1.5,1-1.5,1-2,1.5-3,1mm,2,2.5-5,4,4-15,4-5,6,7,accrescent,acuminate,acute,age,almost,anther,apart,apex,apically,apparently,around,attenuate,base,becoming,berry,black,branch,branched,branching,broadly,brown,calyx,chartaceous,clearly,cm,cordate,corolla,cup,dark,delineated,deltoid,dendritic,density,developed,developing,diameter,dilated,discolorous,drying,elongated,entire,erect,filament,form,forming,frequently,fruit,fruiting,green-brown,increasing,lamina,lateral,leaf,lengthening,less,liana,light,like,linear,lobe,lobed,long,loose,lower,lumpy,margin,mature,mauve,membranous,midvein,mm,multicellular-dendritic,narrowly,oblong,orange-brown,ovate,partly,pedicel,petiole,pore,poricidal,pyriform,ray,red-brown,shrub,simple,size,slender,slightly,smaller,sometimes,spheroidal,stem,structure,surface,terminal,tip,toward,trichome,truncate,unarmed,unit,vein,weakly,well-developed,whitish,wide,wider,x	0.5-2.5,0Â°,1-2.5,1-4,1.1-1.7,1.2-1.6,1.5,1/3-3/4,10,10-13,2-2.5,2-3,3,3-5,3-7,4-7,7-13,7.5,along,alternate,alyx,anthesi,apar,apice,articulated,axil,bark,brachyblast,capitate,centre,clavate,clum,clustered,conical,curved,deeply,dendritic-pubescent,densely,detaching,divided,domatia-like,dorsal,dorsifixed,eaf,eed,ellipsoi,equal,eye,fertilisation,fewer,fine,flat,flattened,flexible,flexuous,flower,formed,free,frui,glabrescent,glabrous,grey,inside,known,laterally,leave,longer,longitudinally,loop,m.,main,minute,much,naked,nflorescence,nther,obconical,obscuring,often,one,orolla,outside,overlapping,ovoid,pair,peduncle,pendulous,perfec,pericarp,plurifoliat,portion,primary,prominent,protruding,puberulous,pubescent,rachi,ridged,rounded,ruit,scar,scattered,sessile,side,sinus,small,smoot,smooth,somewhat,soon,sparsely,spreading,stigma,stripe,stump,style,tangling,tearing,terete,tertiary,thick,thin,tube,ud,uneven,vary,venation,visible,white,ympodial,young	appressed,articulation,bract,breeding,broad-based,cell,colour,connective,growth,hair,heteromorphism,inflated,inflorescence,insertion,interjected,interpetalar,leaflet,length,marking,mentioned,modification,needle-like,none,odour,orientation,paired,pattern,perfect,placement,plurifoliate,position,prickle,pseudostipule,rhizome,scale,shape,smell,spot,staman,stone,symmetry,sympodial,system,texture,tissue,tuber,type,vegetative,xylopodia,zygomorphy
237	wfo-0001028528	exception_thrown	155	0	0	155	0	0.0		.5,0.9-1.2,1-2,1.1-1.2,1.5,1.8-2,2-3,2-4,2.5-3,3.5-4,3.5-6,3/4,4-5,4-6,6-10,6-7,8-9,?,abaxial,absent,acuminate,acute,adaxial,adaxially,age,along,anther,anthesi,apex,apical,attenuate,ba,bark,basal,base,becoming,berry,bi-lobed,blackish,branch,branching,calyx,cm,conical,coriaceous,corolla,decurrent,dendritic,densely,denser,diameter,dichasia,eaf,edicel,eed,elliptic,erect,ew,except,exserted,filament,flattened,flower,fork,free,fruiting,glabrat,glabrous,glandular,globose,growth,immature,impressed,inserted,later,leaf,leave,like,lobe,lobed,long,lower,m.,margin,midvein,minute,minutely,mm,mucronate,narrowly,nflorescence,nodding,obovate,occasionally,older,outline,ovary,pair,papillo,pedicel,per,pericarp,petal,petiole,pitted,planar,plurifoliate,pore,poricidal,portion,prominent,pubescent,pyramidal,reddish-brown,revolute,round,ruit,scar,secondary,shiny,short,shrub,sleeve,slit-like,somewhat,sparsely,stamen,ste,stem,stigma,strongly,style,surface,tall,tapering,terminal,thin,time,tip,triangular,trichome,tub,tube,ud,unit,vein,violet,way,white,wide,winged,woody,x,ympodial,young	
238	wfo-0001028529	exception_thrown	164	0	0	164	0	0.0		.2,0.1,0.5,0.5-2,0.8-1.3,0.8-3,0.8-3.2,1,1-1.2,1-1.5,1.5,2.5-3,2/3,3-40-flowered,3-5,5-6,6-9,7-8,8-14,across,acuminate,acute,age,anther,anthesi,apart,apex,apiculate,attenuate,bark,base,becoming,beginning,beneath,berry,bluish,brown,bud,calyx,capitate,cast,close,cm,cork,corolla,course,dark,decurrent,deflexe,deltoid,dia,distal,eaf,edicel,eed,ellipsoi,elliptic,erect,evenly,exfoliating,exserted,filament,flower,free,fruiting,furcate,glabrous,globose,green,growing,heterostylous,hrub,hyaline,immature,indistinct,inflorescenc,internodal,lanceolate,lateral,leaf,lenticellat,less,linear,lobe,lobed,lon,long,lower,main,major,metallic,middle,minor,minute,minutely,mm,much,narrowly,nearly,nflorescence,oblanceolate,occasionally,older,one,opposite,ovary,ovoid-reniform,pair,paler,papillae,papillo,papillose,pedicel,petiole,pitted,planar,pore,poricidal,portion,present,prominent,range,reflexed,river,ruit,scar,scattered,shape,shaped,short,shrub,simple,size,slender,slightly,small,smooth,somewhat,soon,spaced,species,stem,stigma,straight,style,subshrub,surface,tall,tapering,tear-drop,tip,tube,ud,umbonate,variable,vein,way,white,widest,winged,woody,x,yellowish,young	
239	wfo-0001028532	success	186	142	87	99	55	0.468	0-19,0.2-1,1-2,1-3,4-7,5-9,6.5-9.2,7.5-15.2,abaxially,adaxially,along,anther,apex,arranged,asymmetric,attenuate,axillary,base,basiscopic,bead,berry,blade,bud,cell,chartaceous,cm,connivent,corolla,dark,deep,distal,filament,forked,fruit,generally,glabrous,globose,green,half,herb,homostylous,interjected,lanceolate,leaf,leaflet,like,long,lower,medium,mm,moniliform,multiple,necklace,odd-pinnate,orbicular,ovate,pedicel,pentagonal,petiole,petiolulate,plant,plurifoliate,pore,poricidal,purple,ripe,rotate,rounded,sessile,side,slightly,slit,sometimes,spot,stolon,subtending,symmetric,tall,terminal,tip,tissue,tuber,typically,unit,usually,white,x	1-1.6,1-1.7,1-5,1.3-8.7,1.4-1.6,15-36,17-42,2-3,2-6,2-8,2.2-4.2,3-10,3-5,3-7,3.3-4.4,3.9-5,5-merou,5.5-15,abaxiall,acumen,acuminate,acute,ag,alyx,apart,apparently,articulated,axe,brownish,capitat,clavate,condition,covering,decreasing,diameter,digestion,dorsally,drying,eaf,edge,eed,enzyme,erec,exceeding,flat,flower,folded,fresh,geminat,glabrou,green-white,greenish,hair-like,honeycomb-shaped,larger,lateral,lengthening,linear,living,lobe,make,middl,mottled,mucilaginous,nflorescence,orolla,ovate-lanceolate,ovoid,pair,peduncle,perfect,removed,ruit,second,seed,seudostipule,size,spaced,specimen,stamen,stigma,straight,style,subequal,tamen,tem,testal,thick,throughout,toward,tri-,tube,unwinged,vary,wall,wet,whitish,yellow,ympodial	age,appressed,articulation,bract,branching,breeding,broad-based,calyx,colour,connective,erect,form,fruiting,geminate,growth,hair,heteromorphism,inflated,inflorescence,insertion,interpetalar,length,margin,marking,mature,middle,modification,needle-like,null,odour,orientation,paired,pattern,placement,position,prickle,pseudostipule,rhizome,scale,shape,smell,staman,stem,stone,structure,surface,symmetry,sympodial,system,texture,trichome,type,vegetative,xylopodia,zygomorphy
240	wfo-0001028547	success	224	152	106	118	46	0.473	-3,.7,/2,/5,0-2,0-30,0-5,0.8-1,1-2.5,1-5,1/5-1/4,10-12,2-4,anther,apart,apex,articulated,base,berry,blade,branched,branching,bright,calyx,cell,chartaceous,cm,conical,connivent,cream,cuneate,curved,dark,deltate,densely,discolorous,drying,elongate,elongating,entire,equal,erect,filament,flattened,flower,free,fruit,fruiting,glabrescent,glabrous,green,inflorescence,lateral,leaf,length,lobe,lobed,long,lower,margin,marking,mature,maturity,mauve,mm,moderately,occasionally,often,orange,pale,pedicel,petiole,poricidal,porrect,portion,prickle,purple,red,reflexed,scandent,shallowly,short-styled,shrub,simple,sometimes,somewhat,spaced,spherical,staminate,stellate,stellate-pubescent,stem,straight,subsessile,surface,tapering,terminal,tip,trichome,truncate,tube,way,wide,yellow-green,yellow-orange,young	-1/2,-13,-6,.2,.5,.8,0,0-1,0-10,0-15,0.05-0.15,0.1-0.2,0.15,0.2-0.35,0.3-0.4,0.5-,0.7-1,1-2,1-4,1.2-1.4,1.5-2.5,1.7-2,1/3,2-1.5,2-2.5,2-6,2.5-2.8,2.8-3.2,3-5,3.5-4.5,4-5,4-6,5-merous,6-8,7-10,7-9,abaxial,abaxially,absent,acute,adaxial,alyx,apar,ape,apically,apparently,appearing,bark,bulbous,diameter,distance,dull,eaf,eed,extending,faint,flattened-reniform,gently,glabrou,gray-brow,infructescence,lon,long-acuminate,long-styled,longer,midpoint,midvein,narrow-deltate,nflorescence,oblong,older,one,open,orange-brown,orolla,oung,outline,ovate,pair,peduncle,pendulous,per,perfect,pericarp,pit,plurifoliat,prickl,prickly,primary,raised,ray,reddish,rounded,ruit,scar,sessile,side,slender,small,smooth,spreading,stalk,stalked,style,tamen,terete,tertiary,thin-acuminat,time,unit,usually,vary,vein,venation,villous,woody,yellow,ympodial	appressed,articulation,bract,breeding,broad-based,colour,connective,corolla,form,growth,hair,heteromorphism,inflated,insertion,interjected,interpetalar,leaflet,modification,needle-like,null,odour,orientation,paired,pattern,placement,plurifoliate,pore,position,present,pseudostipule,rhizome,scale,shape,smell,spot,staman,stone,symmetry,system,texture,tissue,tuber,type,vegetative,xylopodia,zygomorphy
241	wfo-0001028587	exception_thrown	178	0	0	178	0	0.0		.4,.5,.75,0,0.3,0.3-1,0.5,0.5-1,0.7-1.2,0.8-1.6,0.8-1.8,0.8-2.9,1-1.3,1-1.5,1-2,1-4,1.3-5.1,1/4,2-5,2.1-6.9,2.5,3-8,6-8,6.5-17.7,8-10,8-10-flowered,abruptly,accrescent,across,acuminate,acute,anther,anthesi,apex,bark,base,baseflower,becoming,berry,brown,ca,calyx,chartaceou,closely,cm,coat,corolla,cracking,cup,deflexed,degree,densely,dia,different,difoliate,distal,drying,eaf,edicel,eed,ellipsoid,erect,filament,flower,forming,free,fruit,fruiting,geminat,geminate,glabrous,globose,green,greenish-white,impressed,keeled,lamina,lateral,layer,leaf,length,like,lobe,lobed,lon,long,long-styled,lower,main,major,middle,midrib,minor,minute,minutely,mm,narrowing,nearly,nflorescence,obe,obovate,obovoid,occasionally,often,older,open,opposite,outer,ovary,ovate,overlappin,ovoid-reniform,pair,paler,papillo,papillose,pedicel,peeling,per,persistent,petiole,pitted,pore,poricidal,portion,puberulent,pubescence,pubescent,pubesent,reflexed,ruit,scar,scattered,seed,short,shrub,simple,slender,slightly,slit-like,spaced,sparsely,stem,stiff,stigma,straight,straw-colored,style,subumbellate,surface,tall,terminal,thickened,thin,tip,transversel,triangular,trichome,tube,two,type,ud,umbonate,unicellular,uniseriate,unit,upon,upper,usually,variable,vein,white,wide,widest,woody,x,ympodial,young	
242	wfo-0001028594	exception_thrown	142	0	0	142	0	0.0		.5,0-100,0.3-1.0,0.8-1.8,1-1.2,1-1.3,1-1.5,1-2,1-3,1.5-9,12,12-14,2,3-4,3-6,3-9,5-6,6-20,6-7,abaxially,acuminate,acute,adaxially,along,anther,anthesi,apex,axil,axillary,base,bearing,becoming,berry,black,bottle-shaped,calyx,capitat,cell,climbing,cm,conical,corolla,densely,denser,diameter,drying,eaf,edicel,eed,ellipsoid,elliptic,epidermal,especially,exserted,filament,flattened-reniform,floo,flower,forest,free,fruit,fruiting,glabrat,glabrous,globose,green,hair-like,herb,immature,inflorescenc,inflorescence,lax,leaf,length,like,lobe,lon,long,lower,margin,maturity,minute,minutely,mm,nflorescence,noddin,obtuse,often,open,orange-brown,ovary,ovate,pair,papillate,pedicel,pendent,per,petiole,planar,portion,primary,projection,pubescent,purple,quit,rectangular,reddish,reflexed,regular,rest,rounded,ruit,scar,scattered,side,simple,slightly,smooth,soft,somewhat,sparsely,spreading,stigma,strait,strongly,style,surface,tem,time,tip,trailing,trichome,tub,tube,ud,unifoliat,uniseriate,unit,vein,violet,x,ympodial	
243	wfo-0001028660	success	204	157	100	104	57	0.49	0-5,0.5-2.8,1-2,1.5-7.6,2-11,20,3-30,3.8-13,4-6,6,abaxially,absent,adaxially,anther,apex,axillary,base,berry,blade,blue,borne,broadly,bud,cell,chartaceous,ciliate,cm,condition,corolla,decumbent,decurrent,densely,distal,dot,end,entirely,filament,forked,fruit,generally,glabrous,globose,green,hair,half,herb,homostylous,interjected,lanceolate,leaflet,less,like,long,lower,margin,membranous,mm,oblique,odd-pinnate,often,orbicular,ovate,pedicel,pentagonal,petiole,petiolulate,petiolule,plant,plurifoliate,pore,poricidal,pubescent,purple,rarely,ripe,rotate,scabrous,scattered,sessile,short,singly,slit,sparsely,specimen,stem,substellate,subtending,sunny,tall,terminal,tinged,tip,tri-,tuber,typically,unit,usually,white,whitish,x	0.1-0.3,0.2-1.1,0.3-1.1,0.5-5.5,0.7-4.2,0.8-1,0.9-2.5,1-10,1.5-2.8,1.5-4,2-5,2-6,2-9,3-5,3-7,3-9,5-8,5-merou,7-10,acumen,acute,ag,along,alyx,apart,apparently,articulated,attenuate,axe,brownish,capitat,clavate,connivent,covering,diameter,digestion,dorsally,drying,eaf,edge,eed,elliptic,enzyme,erec,especially,exceeding,except,flat,flower,folded,fresh,geminat,glabrou,greatly,green-white,greenish,hair-like,honeycomb-shaped,lateral,lengthening,linear,living,lobe,make,middl,midrib,minutely,mucilaginous,narrowly,nflorescence,obtuse,orolla,ovoid,pair,peduncle,perfect,proximal,puberulent,reduced,removed,ruit,seed,seudostipule,size,spaced,stamen,ste,stigma,stolo,straight,style,subequal,tamen,tem,testal,thick,throughout,tube,unwinged,vary,wall,wet,yellow,ympodial	age,appressed,articulation,bract,branching,breeding,broad-based,calyx,colour,connective,erect,form,fruiting,geminate,growth,heteromorphism,inflated,inflorescence,insertion,interpetalar,leaf,length,marking,mature,middle,modification,needle-like,odour,orientation,paired,pattern,placement,position,prickle,pseudostipule,rhizome,scale,shape,smell,sometimes,spot,staman,stolon,stone,structure,surface,symmetry,sympodial,system,texture,tissue,trichome,type,unspecified,vegetative,xylopodia,zygomorphy
244	wfo-0001028667	success	129	108	52	77	56	0.403	-2.6,0.4-0.7,acute,aid,apex,around,axillary,base,berry,branched,calyx,cell,climbing,cm,coriaceous,corolla,curling,dry,entire,exfoliating,flattened,fruiting,glabrous,growth,inflorescence,leaf,like,lower,margin,outer,pedicel,petiole,reniform,revolute,shiny,shoot,short,simple,sleeve,small,stem,strongly,support,surface,terminal,twice,twining,unit,vine,white,woody,wrinkling	.5,0.7-4,1-1.5,1-2-1.5,1-4.5,1-6,1.3-2,3,3-11,5,5-20,5-merou,8-10,alyx,anthesi,apar,appearing,ark,articulated,branch,climbin,clustered,completely,conical,creamy,deciduous,diameter,discolorous,eaf,eed,ellipsoid,elliptic,exfoliatin,exserted,fide,flower,fragrant,irregularly,lobe,long,mentz,midrib,minutely,mm,narrowly,new,nflorescence,occasionally,older,orolla,other,pale,papilla,papillat,peduncle,pendan,per,perfect,pitted,plurifoliat,primary,scar,slender,slightly,soon,spaced,straw-colored,tem,tip,triangular,tube,ud,vein,visible,x,yellow,ympodial	anther,appressed,articulation,bract,branching,breeding,broad-based,colour,connective,filament,form,formed,fruit,hair,heteromorphism,inflated,insertion,interjected,interpetalar,leaflet,length,marking,mature,modification,needle-like,null,odour,orientation,paired,pattern,placement,plurifoliate,pore,position,prickle,pseudostipule,rhizome,scale,shape,smell,spot,staman,stone,structure,symmetry,sympodial,system,texture,tissue,trichome,tuber,type,vegetative,xylopodia,yet,zygomorphy
245	wfo-0001028688	exception_thrown	137	0	0	137	0	0.0		.5,0.4-1,0.5,0.5-0.75,0.5-1,0.5-1.5,0.9-1,1-1.5,1-1.8,1-3,1-5,1.1-1.2,1.4-2.8,2-3,2.2-4.8,5-11,5-6,across,acuminate,acute,along,anther,anthesi,apar,apex,area,bark,base,beneath,bi-cellular,branch,calyx,clavate,cm,corolla,curl-tipped,deciduous,decreasing,deflexed,deltoid,densely,densest,dia,differing,difoliate,eaf,edicel,eed,elliptic,exfoliatin,exserted,filament,free,furcate,geminat,glabrous,globose,golden,interpetalar,irregularly,know,known,lanceolate,leaf,like,lobe,lobed,lon,long,lower,major,markedly,membraneous,middle,minor,minutely,mm,near,nearly,nflorescence,occasionally,often,older,opposite,ovary,overtopping,paler,papillose,pedicel,petiole,pilose,planar,pore,poricidal,portion,proximal,pubescent,reddish-brown,ruit,scar,shaped,shiny,shoot,shrub,sinus,size,slender,slightly,soon,spaced,sparsely,stem,stigma,straight,styl,style,tall,tapering,tear-drop,terminal,thickened,thin,tip,trichome,tub,tube,ud,uniseriate,unit,usually,vein,white,wide,widest,x,ympodial,young	
246	wfo-0001028698	exception_thrown	166	0	0	166	0	0.0		0-1.,0.3-0.75,1-2,1-4,1-9.8,1.8-5,1.9-4,13-25,2-10,2-3,2-4,3-17,3-5,3-6-foliat,3.5,4-14,5-15,5-6,5-8,6,6-13,6-27,8-10,9-35,abaxiall,abaxially,acumen,acuminate,acute,adaxially,apex,apical,apically,articulate,base,branched,broadly,calyx,cell,cm,commonly,conical,connate,corolla,covering,cuneate,cyme,dark,darker,decurrent,dehiscent,diameter,dichasial,dichasially,digestion,diminishing,distal,dorsally,dot,eaf,ebracteate,edge,eed,ellipsoid,elliptical,emoval,enzyme,equal,exceeding,filament,first,flat,flower,folded,forked,generally,globo,gradually,green,green-white,hair-like,half,herbaceous,honeycomb,interjected,introrse,lateral,leaf,leaflet,light,living,lobe,lon,long,long-attenuate,lower,lunat,make,maturing,medium,minute,mm,monochasial,mucilaginous,nflorescence,nther,oblique,odd-pinnate,often,orolla,ovate,ovoid,pair,pattern,pedicel,peduncle,pentagonal,perennial,perfect,petiole,petiolule,plan,plant,poricidally,proximal,puberulent,pubescent,rachi,raised,rarely,reveal,rotate,ruit,seed,sessile,seudostipule,short,size,slit,smooth,specimen,stamen,stigma,straight,strigose,style,tal,tem,terminal,testal,thick,throughout,toward,tuber-bearing,two,typically,unit,usually,vary,violet,wall,white,wide,yellow,ympodial,Â¼	
247	wfo-0001028716	exception_thrown	145	0	0	145	0	0.0		.2,.5,0.5,0.6-1.9,0.75,1-2,1.9-5.5,10-40-flowered,11-16.4,2-4,2.2-7.9,2.5-8,3.6-8.8,5-6,7-8,8-9,9-10,across,acuminate,anisophyllou,anther,anthesi,apart,apex,appearing,asymmetric,ba,bark,base,becoming,beginning,beneath,bi-cellular,branched,brown,calyx,cm,corolla,cuneate,dark,decurrent,deflexed,dia,differing,difoliate,eaf,edicel,eed,ellipsoid,elliptic,evenly,except,fertilization,fifth,filament,filiform,free,fruit,geminate,glabrous,glandular,hirsute,inflorescenc,intermediate,know,known,lateral,leaf,lengthening,lenticellat,less,like,lobe,lobed,lon,long,long-triangular,lower,main,major,markedly,middle,minor,minutely,mm,much,nearly,nflorescence,node,often,older,one,opposite,orbicular,ovary,ovate,pair,papillose,pedicel,petiole,pointed,pore,poricidal,portion,prominent,proximal,puberulent,pubescent,raised,reflexed,remaining,rounded,ruit,scar,shape,shaped,shrub,simple,size,slightly,spaced,sparsely,stem,stigm,straight,strongly,style,tall,tear-drop,tip,triangular,trichome,truncate,tube,two,ud,uniseriate,unit,vein,white,widening,widest,x,ympodial,young	
248	wfo-0001028723	exception_thrown	211	0	0	211	0	0.0		-1.5,.3,.5,0-0.5,0.2,0.8-1,0.8-2,0Â°,1,1-1.5,1-1.8,1-2.2,1-2.5,1/3-1/2,1/5-1/3,10-15,10-16,2-2.5,2-2.7,2-4,2.5,3-4,3.5-4,4,4-5,5,5-6,5-7,abaxial,abaxially,acute,adaxially,age,almost,alternate,alyx,another,anther,anthesi,apar,apex,apically,apice,apparently,articulated,bark,base,becoming,brachyblast,branch,branched,branching,broadly,brown,calyx,capitate,clearly,clustered,cm,common,concolorous,conical,corolla,curved,dark,decurrent,delineated,deltoid,dendritic,densely,density,developed,diameter,dilated,divided,domatia,dorsifixed,drying,eaf,eed,ellipsoi,elliptic,entire,equal,except,ey,faint,filament,fine,flat,flexuous,flower,formed,free,frequent,glabrous,gradual,green,increasing,inner,junction,know,known,leaf,length,lengthening,less,liana,like,lobe,lobed,long,long-attenuate,longitudinally,lower,m.,main,margin,membranous,middle,midvein,minutely,mm,mostly,much,multiply,naked,narrowly,nflorescence,nther,obconical,oblong,obovate,obtuse,occasional,one,orange-brown,orolla,outer,ovate,overlapping,pair,pale,papillo,pedicel,peduncle,perfec,petiole,plurifoliat,poorly,pore,poricidal,portion,primary,prominent,protruding,pubescent,rachi,raised,ray,region,regular,ridged,ruit,scar,separated,short,shrub,side,simple,sinus,slender,small,smaller,smooth,sparsely,spreading,stem,stigma,stump,style,surface,surrounding,tearing,terminal,tertiary,tip,tissu,toward,transition,trichome,tube,tuft,ud,unarmed,uneven,unevenly,unit,vary,vein,venation,visible,white,wide,widely,wrinkled,x,yellow,ympodial,young,youngest	
249	wfo-0001028736	exception_thrown	180	0	0	180	0	0.0		0.2-0.4,0.5,0.5-1,0.5-1.5,0.5-1mm,0.5-2,1,1-1.5,1-2,1-3,1.5,1.5-3,1/6,10-15,2-4,2-5,2-7,3-5,3-6,3-8,3.5-5,4-12,4-6,4-9,40-70,5-10,5-15,5-merou,6-13x3-8,6-8,abaxially,absent,accrescent,acute,adaxiall,adaxially,alyx,anther,apar,apex,apical,apparently,armed,attenuate,axe,base,berry,beyond,blade,brown,calyx,chartaceous,cm,connivent,contiguous,cordate,created,cut,cylindrical,dark,decurrent,densely,diameter,difoliate,directed,discolorous,eaf,eed,either,exserted,extra-axillary,filament,filiform,flattened,flower,frui,fruit,fruiting,geminate,glabrou,glabrous,glandular,globose,gree,green,hair,immature,introsel,leaf,length,less,light,like,lobe,lobed,long,lower,m.,major,many,mature,midpoint,midrib,midvein,mm,moderately,mottled,multicellular,multiseriate,narrowly,nearly,netlike,nflorescence,obtuse,occasional,occasionally,onto,orange,orolla,pair,pedicel,peduncle,per,perfect,petiole,pit,pore,porrect-stellate,prickle,pubescent,purple,rachi,raised,ray,recurved,red,reniform,rhombic,ridge,roselike,ruit,scanden,shrub,side,simple,sinus,slightly,small,spaced,sparsely,stalk,stamen,ste,stellate,stem,stigma,style,surface,tamen,tapering,tem,thin-skinned,triangular,tube,unarmed,unbranched,unequa,unicellular,uniseriate,unit,unlobed,vary,vein,way,white,wide,x,yellow,yellow-white,ympodial	
250	wfo-0001028737	exception_thrown	151	0	0	151	0	0.0		0.2-0.5,0.7-2,1,1-2.5,1-4,1-6,1.5-3.5,10,12-14,16-30,2-3,2-5,2.8-3.5,3-4,3-5,3-6-foliat,4-10,4-6.5,4-9,5-6,6,7-15,abaxially,absen,acumen,acuminate,acute,adaxially,apex,apical,apically,apiculate,articulate,attenuate,base,branched,calyx,caudate,cell,cm,connate,corolla,covering,cyme,decurrent,dehiscent,diameter,dichasial,dichasially,digestion,diminishing,distal,dorsally,eaf,ebracteate,edge,eed,elliptic-lanceolate,emoval,enzyme,exceeding,filament,flat,flower,folded,forked,generally,glabrescent,glandular,globo,globose,gradually,green,green-white,hair-like,half,herbaceous,honeycomb,interjected,introrse,lanceolate,larger,lateral,leaf,leaflet,living,lobe,lon,long,lower,make,maturing,mm,monochasial,mucilaginous,nflorescence,nther,oblique,oblong,odd-pinnate,often,orolla,ovoid,pair,pattern,pedicel,peduncle,perennial,perfect,petiole,pinnatifi,plan,plant,poricidally,proximal,rachi,reveal,ruit,second,seed,sessile,seudostipule,short,size,slit,specimen,stamen,stellate,stigma,straight,strongly,style,tal,tem,terminal,testal,thick,throughou,throughout,toward,tuber-bearing,typically,unit,vary,wall,whit,wide,without,yellow,ympodial,Â¼	
251	wfo-0001028777	success	205	131	81	124	50	0.395	.5,.8,0.4-0.8,1/4,1/4-1/2,3.5-5,3/4-4/5,4.5-8,anther,apex,articulated,attenuate,base,berry,blade,branched,calyx,chartaceous,cm,connivent,dark,elongating,entire,erect,filament,flower,free,fruit,fruiting,glabrescent,glabrous,green,inflorescence,leaf,length,less,lobe,lobed,long,lower,margin,marking,mature,maturity,mauve,mm,moderately,occasionally,orange,pale,pedicel,perfect,petiole,poricidal,portion,reflexed,shoot,short,short-styled,shrub,simple,small,spherical,staminate,stellate,stellate-pubescent,stem,surface,tapering,terminal,tip,tree,trichome,truncate,tube,unarmed,unit,usually,way,white,young	-10,-12,-2.5,-3,-4,.9,0-2,0-30,0.1-0.2,0.1-0.3,0.2,0.5-1.3,0.6-1,0.7-1.2,0.7-1.3,0.8-1,0.8-2.2,1,1-2,1-2.5,1-3,1.5,1.5-3,1.5-4,1.8-2.5,2-,2.5,2.5-3,2.5-5,3,4-5-merous,6-10,7-11,8,8-15,abaxially,acuminat,acute,alyx,ame,apar,ape,apically,bark,briefly,c.,concolorous,curved,deciduou,deltate,diameter,discolorous,drying,eaf,eed,equal,faint,flattened-reniform,glabrescen,green-brown,infructescence,lengt,long-styled,longer,midpoint,minute,multangulate,narrow-deltate,nflorescence,obovate,older,one,open,orange-brown,orolla,oung,ovate,pair,peduncle,per,pericarp,plurifoliat,porrect,present,primary,ray,recurved,red-brown,reflexe,retuse,rounded,ruit,scar,sessile,shorte,shorter,smooth,sometimes,somewhat,soon,spaced,sparsely,spreading,stalk,stalked,stout,strongly,style,tamen,terete,tertiary,time,unarme,variously,vary,vein,venation,visible,whole,wide,wider,woody,yellow-green,ympodial	appressed,articulation,bract,branching,breeding,broad-based,cell,colour,connective,corolla,form,growth,hair,heteromorphism,inflated,insertion,interjected,interpetalar,leaflet,mentioned,modification,needle-like,odour,orientation,paired,pattern,placement,plurifoliate,pore,position,prickle,pseudostipule,rhizome,scale,shape,smell,spot,staman,stone,structure,symmetry,sympodial,system,texture,tissue,tuber,type,vegetative,xylopodia,zygomorphy
252	wfo-0001028791	success	257	147	98	159	49	0.381	+,-0.6,-9,0-6,0.05,0.05-0.2,0.2-0.4,0.3-0.5,10,2-7,4-15,5-plurifoliate,absent,anther,apex,articulation,base,basiscopically,branched,breaking,calyx,cell,clambering,cm,corolla,deciduous,developed,dichotomously,ebracteate,eglandular,elongating,entire,extended,filament,fruit,fruiting,glandular,globose,green,grow,hair-like,imparipinnate,interjected,internode,interrupted,lamina,large,lateral,leaf,leaflet,leaving,less,liana,long,lower,margin,middle,mm,multicellular,near,oblique,outgrowth,pedicel,per,petiole,petiolule,plant,poorly,protuberance,pseudostipule,rough,sandpapery,scandent,sessile,short,simple,sometimes,somewhat,spreading,stellate,stem,stiff,surface,testa,touch,transparent,trichome,truncate,unicellular,uniseriate,unit,usually,vegetation,vine,wall,wide,woody,yellow	-1.5,.5,0.2-0.3,0.2-0.8,0.25-0.3,0.3-0.4,0.3-0.6,0.3-0.8,0.4-0.5,0.4-0.6,0.4-0.65,0.4-1.1,0.45-0.55,0.5,0.6-0.8,0.6-0.9,0.7-1.5,0.8-1,0.8-1.3,1-1.5,1-2,1-2-celled,1-3,1-3-celled,1-celled,1.5-,1.5-2,1.6-4.5,1.7-2.1,1.8-3.3,100,2-3,2-3.5,2-7-celled,2-locular,2.5-4.5,2.8-3.0,20-to,3-,3-4,4-11.5,4-5+,4-celled,5-,5-10,5-15,5-22,50-80,8-10-celled,9-30,9-35,abaxially,absen,abundant,acuminate,acute,adaxially,addition,ag,along,anthesi,apical,appearance,appendage,articulated,basal,beneath,berr,border,broadly,brown,bullate,capitate,colo.,column,conical,consistently,dark,darker,deltate,densely,densest,diameter,eaf,edicel,eed,elliptic,enlarged,even,exserted,flower,free,give,glabrescent,glabrous,gree,growing,half,halfway,head,like,lobe,lon,many,midvein,minutely,mixture,much,nflorescence,obovate,occasionally,often,ovary,pair,pale,paler,papillate,peduncle,present,primary,pubescence,pubescent,rachi,reflexed,rest,round,ruit,secondary,seed,shorter,silky,single,slightly,small,smaller,sparse,sparsely,stamen,staminal,sterile,stigma,straight,style,tal,tem,terminal,tertiary,thick,thickened,time,tip,tube,ud,upper,vein,white,winged,ympodial,â1-2-celled	appressed,berry,bract,branching,breeding,broad-based,colour,connective,form,growth,hair,heteromorphism,inflated,inflorescence,insertion,interpetalar,length,marking,mature,modification,needle-like,null,odour,orientation,paired,pattern,placement,pore,position,prickle,rhizome,scale,shape,smell,spot,staman,stone,structure,symmetry,sympodial,system,tall,texture,tissue,tuber,type,vegetative,xylopodia,zygomorphy
253	wfo-0001028798	success	214	169	118	96	51	0.551	.5-5,0-1,0.9-1.2,1/20,2-3,2-6,3.3-5.6,3.8-4.2,4-5.4,5-8,8-18,abaxially,accrescent,acuminate,acute,adaxially,anther,apex,apical-lateral,articulated,attenuate,axillary,base,becoming,berry,blade,blunt-tipped,boat-shaped,branched,calyx,chartaceous,cm,continued,corolla,curved,decurrent,dehiscing,densely,dm,downward,due,echinoid,entire,extend,filament,fleshy,free,fruit,fruiting,glabrous,granular,green,greenish,growth,hair,high,introrse,lacking,lanceolate,large,lateral,leaf,length,less,lobe,long,longitudinal,lower,many,margin,mixed,mm,multangulate,nearly,oblanceolate,oblong,obovate,overlapping,pale,pedicel,perfect,persistent,persistently,petiole,plurifoliate,pore,porrect-stellate,present,probably,pseudo-terminal,ray,ripe,rotate-stellate,rough,rough-granular,sessile,short-stalked,shrub,simple,slightly,slit,small,somewhat,stalked,stem,subcoriaceous,subglobose,time,tip,tomentose,toward,unarmed,unit,velutinous,wide,x,yellow,yellowish	0-60,0.2-0.4,0.5-2,1-3,1-4.5,1-6,1.1-2,1.5-1.8,1/2-2/3,10,15-19,2-3.75,2-7,2.4-4.4,2.5-3.5,2.6-4,2/3,3-4,3-5,5.25-7.5,6-10,6-8,7-8,8.5-13,ag,anthesi,apart,apparently,axe,ba,branch,bud,capitat,conical,cylindrical,diameter,distal,eaf,echinoi,eed,exserted,flower,granular-tomentose,hal,included,inserted,irregularly,lined,lobed,m.,main,midvein,minutely,multangulat,nflorescence,oblanceolat,obscured,obtuse,often,orbicular,orolla,oung,ovate-lanceolate,peduncle,prominent,pubescent,quite,rachi,rather,ruit,semi-ovate,short,side,spaced,sparingly,splitting,stamen,stellate-pubescent,stigma,strongly,style,subcampanulate,sulcate,suture,tamen,thick,tomentu,tomentum,translucent,tube,unarme,unknow,vary,vein,way,ympodial	age,appressed,articulation,bract,branching,breeding,broad-based,cell,colour,connective,form,heteromorphism,inflated,inflorescence,insertion,interjected,interpetalar,leaflet,marking,mature,modification,needle-like,null,odour,orientation,paired,pattern,placement,position,prickle,pseudostipule,rhizome,scale,shape,smell,spot,staman,stone,structure,surface,symmetry,sympodial,system,texture,tissue,trichome,tuber,type,vegetative,xylopodia,zygomorphy
254	wfo-0001028815	success	196	175	121	75	54	0.617	0.4-0.8,1-2,1-3.5,1-4,1-5,14-28,2-4,2.5-6.5,3-5,3-7,5-7,6-10,abaxially,acute,adaxially,anther,apex,articulated,articulation,auriculate,axillary,base,basiscopic,berry,blade,broadly,bud,cell,chartaceous,cm,corolla,covering,cuneate,dark,decreasing,decurrent,developing,digestion,distal,distinct,elliptic,enzyme,filament,forked,fruit,generally,glabrous,globose,green,green-white,hair,hair-like,half,herb,high,homostylous,honeycomb-shaped,indistinct,interjected,lanceolate,lateral,leaflet,lengthening,like,lilac-purple,lower,make,margin,medium,membranous,mm,mucilaginous,narrowly,obtuse,odd-pinnate,onto,ovate,ovoid,pair,pedicel,petiole,petiolulate,plant,plurifoliate,pore,poricidal,pubescent,purple,rachi,red-purple,removed,ripe,rotate,rounded,rugose,seed,semi-rosette,sessile,short,side,size,slightly,slit,sparsely,stem,subtending,tall,terminal,testal,thick,throughout,tinged,tip,tri-,unit,unwinged,wall,wet,winged,x,young	0.5-1,1-10,10-15,2-4.5,2-9,22-35,3-4,4-10,5-6,5-merou,6-8,7-16,acumen,ag,along,alyx,apart,apparently,axe,brownish,capitat,ciliate,condition,connivent,diameter,dorsally,drying,eaf,edge,eed,elliptic-lanceolate,especially,exceeding,flat,flower,folded,fresh,geminat,glabrou,greenish,hal,living,lobe,long,midrib,minutely,nflorescence,orolla,papillose,peduncle,perfect,pointed,puberulent,purpl,ruit,semi-erec,seudostipule,spaced,specimen,splotched,stamen,ste,stigma,straight,style,tamen,tem,terminated,triangular-lanceolate,tube,usually,vary,whitish,yellow,ympodial	age,appressed,bract,branching,breeding,broad-based,calyx,colour,connective,form,fruiting,geminate,growth,heteromorphism,inflated,inflorescence,insertion,interpetalar,leaf,length,marking,mature,modification,needle-like,null,odour,orientation,paired,pattern,placement,position,prickle,pseudostipule,rhizome,scale,semi-erect,shape,smell,spot,staman,stone,structure,surface,symmetry,sympodial,system,texture,tissue,trichome,tuber,type,vegetative,xylopodia,zygomorphy
255	wfo-0001028876	exception_thrown	127	0	0	127	0	0.0		.5,/4,0.4-1,0.5-2,1-2,1.5-2,1.5-3,2-2.3,3-5,3-8,4-5,4-8,5-6,abaxial,abaxially,acute,adaxially,along,anther,anthesi,apex,attenuate,bark,base,branched,brown,calyx,capitate,closely,cm,conical,corolla,dark,dendritic,densely,dia,difoliate,drying,eaf,edicel,eed,ellipsoid,elliptic,filament,flower,free,geminat,glabrat,glabrous,golden,hroughout,included,inflorescenc,internodal,know,known,lamina,lateral,leaf,leave,like,lobe,lobed,long,long-triangular,lower,main,middle,midrib,minutely,mm,nflorescence,nodding,occasionally,older,opposite,ovary,overlappin,pair,papillae,papillo,papillose,pedicel,petiole,planar,pore,poricidal,portion,pubescent,reddish,rest,rounded,ruti,sagittate,scar,shaped,shining,shrub,simple,slender,small,spaced,sparsely,speciman,stem,stigma,straight,style,subshrub,surface,tall,tear-drop,tip,trichome,tub,tube,type,ud,uniseriate,unit,vein,way,white,widest,x,ympodial,young	
256	wfo-0001028883	exception_thrown	207	0	0	207	0	0.0		0.3â0.6,0.4â1.2,0.5â2,0.6,1,1.5â7,1â2,1â6,2,2â3,2â5,3â5,4,4â6,5,5-merou,50,6,6â10,6â12,abaxially,absent,accrescent,acuminate,acute,adaxiall,adaxially,almost,along,alyx,anther,antrorse,antrorsely,apar,apex,arched,ark,articulated,ascending,attenuate,axi,base,becoming,berry,blade,branch,brochidodromous,brow,calyx,capitat,capitate,cell,chartaceous,ciliate,circular,cm,common,completely,concolorous,connivent,coriaceous,curved,cylindrical,cyme,dark,decurrent,deltate,densely,diameter,differing,directed,drying,dull,eaf,eed,elliptic,elliptic-ovate,emarginate,entire,equal,erect,exfoliating,eye,filament,flattened,flower,frui,fruit,geminate,geniculat,glabrescent,glabrou,glabrous,glandular,globose,green,greenish,growth,head,herb,hilum,hollow,impressed,introrsely,lateral,leaf,length,less,light,like,lobe,long,longitudinal,lower,lying,margin,membranaceous,midrib,minor,mm,moderately,multicellular,naked,narrowly,new,nflorescence,normally,notably,oblong,obtuse,often,older,onto,opening,orolla,ovate-lanceolate,parallel,pedicel,peduncle,pendan,per,perfect,petiole,plurifoliate,pore,poricidal,present,primarily,prominent,pubescence,pubescent,rachi,rarely,region,reniform,ripe,rounded,ruit,secondary,seed,sessile,shap,shiny,shrub,similar,simple,single,single-celled,size,slightly,slit,small,sometimes,spaced,sparse,sparsely,spreading,stalk,stellate,stem,stigma,straight,style,subapical,subopposite,subsessile,surface,swollen,tall,tamen,tem,trichome,unbranched,undulate,uniseriate,unit,vary,vein,venation,visible,white,whitish,wide,woody,yellow,ympodial,Ã	
257	wfo-0001028885	exception_thrown	214	0	0	214	0	0.0		-1,.5,0.3-0.5,0.5-1,0.5-5,0.7-2,1-1.2,1-1.5,1-2,1-3,1.5-1.7,1.5-3.5,10-20,2,2-,2-2.5,2.3-2.5,2.5-3.5,2/3,3-5,3.5-4.5,3.5-8.5,4-5,5-merou,7-8,7-9,9-11,9-12,?,abaxial,acute,adaxial,adaxially,ag,along,alyx,anther,anthesi,apart,apex,apiculate,apparently,archin,ark,articulated,attenuate,basal,base,berry,black,blackish,branch,branched,broadly,brown,calyx,capitate,cell,cm,collapsing,connivent,corolla,cup-shaped,dark,dark-pigmented,decurrent,deltate,dendriti,densely,diameter,distal,dried,drying,eaf,eed,ellipsoid,elliptic,entire,erect,exserted,extending,filament,fleshy,flower,free,fruiting,furcate,glabrescent,glabrou,glabrous,glandular,globose,golden,gradually,groove,groupe,growth,height,ilament,immature,inflorescence,inserted,irregularly,known,lamina,lanceolate,lateral,leaf,leaving,lengthening,less,like,live,lobe,lobed,long,loosely,lower,margin,material,midvein,minute,minutely,mm,mostly,multicellular,narrowing,narrowly,new,nflorescence,noddin,nodding,occasionally,often,older,orolla,pair,papillo,part,pedicel,peduncle,peg,perfect,pericarp,petiole,pigmentation,plant,plurifoliat,pore,poricidal,portion,primary,pubescent,purple,quarter,recorded,reddish,retaining,revolute,rhachi,ripe,ruit,scandent,scar,scattered,shin,shiny,short,shrub,simple,sleeve,slender,slightly,slit,small,smaller,sometimes,spaced,sparsely,spheroidal,spreading,stellate,stem,stigma,strongly,style,surface,tangled,tem,terminal,thin,third,time,tip,trichome,tube,twinin,ud,uniseriate,unit,upper,usually,vary,vein,vine,wall,way,weak,weak-walled,wide,winged,woody,ympodial,Â¾	
258	wfo-0001028888	success	207	138	83	124	55	0.401	0-3.5,0-7,0.15-0.5,1-2,5-7,6-11,abaxially,adaxially,anther,apex,axillary,base,berry,bud,cell,center,chartaceous,cm,corolla,covered,distal,dot,end,filament,forked,fruit,generally,glabrous,globose,green,hair,half,herb,homostylous,interjected,lanceolate,leaflet,like,lobe,long,lower,margin,membranous,middle,mm,oblique,odd-pinnate,often,one,orbicular,ovate,pedicel,pentagonal,petiole,petiolulate,placed,plant,plurifoliate,pore,poricidal,pubescent,ripe,rounded,scattered,sessile,short,slit,sparsely,stem,streak,subglabrous,substellate,subtending,tall,terminal,tip,tri-,tuber,typically,unit,violet,white,whitish	0-5,1,1-1.5,1-10,1-3,1.5-4,10-25,12.5-25,2-5,2-6,2.3-5,2.3-7,2.5-3.3,3-4,3-5,3.6-12.5,3.8-8.3,4-25,4-7,5-10,5-merou,8-11,8-13.5,acumen,acuminate,acute,ag,along,alyx,apart,apiculate,apparently,articulated,axe,blade,broadly,brownish,capitat,central,ciliate,clavate,condition,connivent,covering,cuneate,diameter,digestion,dorsally,drying,eaf,edge,eed,elliptic,enzyme,erec,especially,exceeding,except,flat,flower,folded,fresh,geminat,glabrou,glaucous,greatly,green-white,greenish,hair-like,hal,honeycomb-shaped,lateral,lengthening,less,living,low,make,midrib,minutely,mottled,mucilaginous,nflorescence,orolla,ovoid,pair,peduncle,perfect,petiolule,proximal,puberulent,purple,reduced,removed,ruit,seed,seudostipule,size,slightly,sometimes,spaced,specimen,stamen,ste,stigma,stolo,straight,style,subequal,tamen,tem,testal,thick,throughout,truncate,tube,unwinged,usually,vary,wall,wet,wing,x,yellow,ympodial	age,appressed,articulation,bract,branching,breeding,broad-based,calyx,colour,connective,erect,form,fruiting,geminate,growth,heteromorphism,inflated,inflorescence,insertion,interpetalar,leaf,length,marking,mature,modification,needle-like,odour,orientation,paired,pattern,placement,position,prickle,pseudostipule,rhizome,scale,shape,smell,spot,staman,stolon,stone,structure,surface,symmetry,sympodial,system,texture,tissue,trichome,type,unspecified,vegetative,xylopodia,zygomorphy
259	wfo-0001028920	exception_thrown	152	0	0	152	0	0.0		.25,.5,0.2-1,0.5-1,0.8-1.1,1-1.2,1-1.5,1-2.4,1-3,1.5-2,2-2.5,2-7,3-15-flowered,3-3.5,3-4,5-9,6-15,6-6.5,abaxially,acuminate,acute,adaxially,anther,anthesi,apex,arachnoid,arachnoid-pubescent,area,attenuate,axil,ba,bark,base,berry,broadly,brown,brownish,calyx,closely,cm,congested,conical,corolla,cucullate,dark,decurrent,deflexed,deltate,dendritic,dense,densely,dia,differing,difoliate,eaf,edicel,eed,ellipsoid,elliptic,erect,exserted,felty,filament,fleshy,flower,free,fruiting,geminat,glabrate,glabrous,globose,gray-brow,green,later,lateral,leaf,lightly,lobe,lobed,lon,long,long-styled,lower,main,major,middle,minor,minutely,mm,nearly,nflorescence,obovate,obovoid,occasionally,older,opposite,ovary,overlappin,ovoid-reniform,pair,papillose,pedicel,petiole,pitted,planar,pore,poricidal,portion,present,pubescence,pubescent,ruit,scar,shape,shaped,short-styled,shrub,simple,size,small,somewhat,soon,spaced,sparsely,stem,stigma,strongly,styl,style,surface,tall,tapering,tear-drop,thick,tip,tree,trichome,tub,tube,tuft,ud,unifoliate,uniseriate,unit,vein,white,widest,winged,woody,x,ympodial,young	
260	wfo-0001028929	success	210	107	58	152	49	0.276	0.2-0.8,0.8-1,3-20,5-6,acicular,anther,apart,apex,base,berry,calyx,cell,chartaceous,cuneate,difoliate,erect,filament,flower,fruit,fruiting,glabrous,hair,inflorescence,lateral,leaf,length,lobed,lower,margin,mature,maturity,mm,occasionally,pale,pedicel,perfect,perpendicular,petiole,poricidal,prickle,red,short-styled,shrub,simple,spaced,spherical,staminate,stellate,stellate-pubescent,stem,straight,surface,tip,trichome,unit,white,wide,yellow	-2,-2/3,.5,.7,.9,/5,0,0-1,0-10,0-20,0-3,0.1,0.15-0.3,0.2-0.3,0.2-0.4,0.3-0.6,0.4-0.8,0.5-1.5,0.5-2,0.7-1,0.7-2,1,1-1.1,1-3,1.5-2.4,1/2,1/4-1/3,2-3,2-4,2-6,2-9,2.2-2.3,2.5-4,2.7-3,2/3-3/4,3-4,4-6,5-25,5-7.5,5-merous,6-8,7-9,8-10,abaxial,abaxially,acute,adaxial,alyx,apar,ape,apically,apparently,articulated,bark,blade,branched,cm,concolorous,connivent,curved,densely,diameter,discolorous,distance,drying,dull,eaf,eed,elliptic,elongating,equal,extending,flattened-reniform,foliaceous,free,geminat,gently,glabrescent,glabrou,gra,infructescence,lobe,lon,long,long-styled,longer,midpoint,midvein,minute,minutely,narrow-deltate,narrow-ovate,nflorescence,oblong,obovate,obtu,obtuse,older,one,open,orange-brown,orolla,oung,outline,pair,patch,peduncle,pendulous,per,pericarp,pit,porrect,portion,prickl,prickly,primary,raised,ray,red-brown,red-green,reticulate,rounded,ruit,scar,sessile,side,slender,small,smooth,sometimes,spreading,stalk,stalked,style,subsessile,tamen,tapering,terete,tertiary,time,tube,unarmed,usually,variously,vary,vein,venation,visible,way,woody,yellow-green,ympodial	appressed,articulation,bract,branching,breeding,broad-based,colour,connective,corolla,form,geminate,growth,heteromorphism,inflated,insertion,interjected,interpetalar,leaflet,marking,mentioned,modification,needle-like,odour,orientation,paired,pattern,placement,pore,position,present,pseudostipule,rhizome,scale,shape,smell,spot,staman,stone,structure,symmetry,sympodial,system,texture,tissue,tuber,type,vegetative,xylopodia,zygomorphy
261	wfo-0001028963	exception_thrown	197	0	0	197	0	0.0		.5,/2,0-0.4,0-2,0.1,0.1-0.2,0.1-0.25,0.15-0.3,0.3-0.6,0.3-0.7,0.3-1,0.3-1.5,0.45-0.6,0.6-0.9,0.6-1,0.8-1.8,0.9-1.5,1-4,1.5-2,1/,1/4-1/3,1/5,1/6,2-2.3,2-3,2-4,2-5,2-9,2.4-2.8,3-4.5,3.5-4.2,4-10,4-8,5-25,5-merous,6-10,7-8,abaxially,acute,alyx,anther,apar,ape,apex,apically,apparently,articulated,attenuate,bark,base,becoming,berry,blade,bright,broad-deltate,brown,calyx,cell,chartaceous,cm,concolorous,connivent,curved,cuspidat,deltate,densely,diameter,difoliate,discolorous,drying,dull,eaf,eed,elongating,entire,equal,erect,evenly,eye,filament,flattened-reniform,flower,free,frui,fruiting,geminat,glabrescent,glabrous,gra,gray-green,green,herb,herbaceous,inflorescence,infructescence,lanceolate,lateral,leaf,length,less,light,lobe,lobed,long,long-styled,longer,lower,margin,mature,maturity,mauve,midpoint,mm,moderately,naked,narrow-cuneate,narrow-elliptic,narrowly,nflorescence,obtuse,occasionally,older,one,open,orange,orolla,oung,outline,pair,pale,pedicel,peduncle,pendulous,per,perfect,pericarp,petiole,pit,poricidal,porrect,portion,primary,purple,raised,ray,red,ruit,scar,sessile,short-styled,shorter,shrub,simple,slender,slightly,small,smooth,spaced,spherical,spreading,stalk,stalked,staminate,stellate,stellate-pubescent,stem,straight,style,subsessile,surface,tamen,tapering,terete,terminal,tertiary,time,tip,trichome,tube,unarme,unarmed,unbranched,unit,upper,usually,variously,vary,vein,venation,visible,way,wide,winged,woody,yellow-orange,ympodial,young	
262	wfo-0001028971	success	225	111	63	162	48	0.28	.1-0.2,2-foliate,along,anther,apex,articulated,base,branched,broad-based,calyx,cauline,coarsely,compressed,dentate,elongate-deltoid,erect,essentially,extra-axillary,filament,form,fruit,globose,hair,inflorescence,lateral,laterally,leaf,length,lignescent,like,lower,margin,midrib,mixture,mm,obtuse,often,orange,outline,pedicel,perennial,petiole,pore,prickle,principal,pubescent,scattered,sessile,short,simple,spreading-hirsute,spreadingly,stellate,stem,stipitate,surface,thin-textured,trichome,truncate,unbranched,unit,vein,white	-0.8,-1.4,0.1-0.4,0.1-0.5,0.2-0.5,0.25-0.6,0.25-1.25,0.3-0.6,0.4-0.9,0.4-1.5,0.8-2.5,05-2.5,1-2,1-5,1.5-2.2,1.5-4,1.75-2.5,1/5-1/2,10-15,15-30,2-5,2.2-3.5,2.5-3.5,2.5-4.5,2.5-5,20-35,3-14,3-5,3-6,4-5,4-9,5-10,5-15,5-8,6-16,6-8.5,6-9,7-16,abaxially,acute,acute-,adaxiall,adaxially,also,apart,appearance,appearing,armed,ascending,attenuate,axe,ba,bearing,becoming,blade,broadly,campanulate,capitat,close,cm,connivent,cylindrical,delicate,deltoid,densely,diameter,directed,distal,distall,eaf,eed,elongate,entire,farinaceous,felty,felty-pubescent,female-sterile,flower,frequently,geminat,glabrous,grading,growt,inserted,interlobal,invested,lanceolate,largest,later,least,lenticular,linear-lanceolate,lobe,lon,long,longer,longest,major,manifestly,maturit,midpoint,minute,minutely,much,multiseriate,narrowly,nflorescence,numerous,occasionally,one,orolla,other,ovate,ovate-apiculate,ovate-lanceolate,pair,peduncle,per,persistent,pitted,prickly,rachi,ray,reduced,reniform-ovate,ripe,round-tipped,ruit,sericeous,short-stalked,shorter,side,similar,sinus,smaller,sometimes,spaced,sparse,stalk,ste,stellae,stellate-pubescent,stigma,style,tal,tamen,tan,tem,termination,time,tooth-like,tube,underdeveloped,usually,variable,variously,vary,well-developed,wide,x,yellow,ympodial	appressed,articulation,bract,branching,breeding,cell,colour,connective,corolla,fruiting,geminate,growth,heteromorphism,inflated,insertion,interjected,interpetalar,leaflet,marking,mature,modification,needle-like,null,odour,orientation,paired,pattern,placement,position,pseudostipule,rhizome,scale,shape,smell,spot,staman,stone,structure,symmetry,sympodial,system,texture,tissue,tuber,type,vegetative,xylopodia,zygomorphy
263	wfo-0001028975	exception_thrown	163	0	0	163	0	0.0		.2,.5,0.1-1,0.5-1,1,1-3,1-5,1.2-1.5,1.5-1.8,1.5-2,2.2-6,3-10-flowered,3-3.5,3-6.5,5-ribbed,5.5-10,6-6.5,7.5-15,8-9,?,acuminate,acute,along,anther,anthesi,apart,apex,appearing,area,bark,base,beneath,berry,broad,brown,calyx,closely,cm,conical,conically,corky,corolla,cup-shaped,dark,decurrent,deflexed,densely,denser,dia,differing,difoliate,eaf,edicel,eed,elliptic,entire,epidermi,equal,erect,exserted,extension,filament,free,fruit,fruiting,geminat,glabrous,globose,golden,green,hyaline,immature,large-celled,late,lateral,leaf,length,like,lobe,lobed,lon,long,lower,main,mainly,major,margin,member,mere,middle,minor,minutely,mm,narrowly,nearly,nflorescence,obscured,occasionally,older,once-furcate,one,opposite,ovary,ovoid-reniform,pair,papillo,pedicel,petiole,pitted,pore,poricidal,portion,prominent,pubescenc,pubescent,raised,reddi,reflexed,remaining,rib,ruit,scar,shaped,shiny,short,shrub,simple,sinus,size,slender,slightly,small,somewhat,spaced,sparsely,stem,stigma,straight,strongly,style,surface,tall,tapering,tear-drop,tip,tree,triangular,trichome,tub,tube,ud,uniseriate,unit,upper,varying,vein,white,wide,widest,woody,x,ympodial,young	
264	wfo-0001028980	exception_thrown	168	0	0	168	0	0.0		.1,.5,.75,/3,0.5-1.5,1-1.2,1.2-1.8,1.2-3,1.5-1.8,1.5-2,1.5-6,2.5,2.5-5,20-25-flowered,3-4,3/4,4-5,5-6,5-8,6,6-8,7-12,acuminate,acute,along,anther,anthesi,apart,apex,axil,bark,basal,base,beginning,beneath,berry,black,broadly,calyx,capitate,clearly,cm,coarsely,conical,corky,corolla,cucullate,deflexed,deltoid,densely,dia,differentiated,differing,difoliate,dry,drying,eaf,edicel,eed,elliptic,expanded,exserted,extending,f,filament,flattened-reniform,fleshy,free,frui,fruiting,furcate,geminat,glabrate,glabrous,glandular,globose,green,impressed,incrassate,inflorescenc,lamina,lateral,leaf,lenticellat,like,lobe,lobed,lon,long,lower,m.,main,major,margin,material,member,middle,minor,minutely,mm,nflorescence,occasionally,older,one,opposite,ovary,ovate,ovoid,pair,pale,paler,papillose,pedicel,peduncle,petiole,pit,pitted,planar,pore,poricidal,portion,prominent,pubescent,reddish,reflexed,ruit,scar,scarious,seed,shaped,sharply,shining,shrub,simple,size,slightly,small,soon,sparsely,speciman,stem,stigma,strongly,style,surface,tall,tapering,tear-drop,thick,ti,tip,tree,trichome,tube,type,ud,uniseriate,unit,usually,vein,way,white,widest,woody,x,yellowish,ympodial,young	
265	wfo-0001028984	success	180	147	90	90	57	0.5	-2.5,-3,-6,1-,1-2,1-2.5,1-9,1.2-4,2,2-,2-16,2-2.5,2-4,3-28,4-5,5,abaxially,abruptly,adpressed,age,aggregate,also,apex,articulated,basal,base,blade,broad,calyx,campanulate,cell,chartaceous,cm,color,connective,cordate,densely,directed,distally,eglandular,ellipsoid-fusiform,entire,forked,fruit,greenish,hair,lanceolate,laterally,leaving,lobe,long,lower,margin,mm,moderately,narrowed,often,pale,pedicel,pedicellar,petiole,pilose,pore,possibly,presence,puberulent,puberulent-pubescent,pubescent-pilose,purple,rarely,remnant,ripe,shrub,simple,small,sparsely,stone,style,subcoriaceous,time,tree,truncate,turning,unbranched,unit,unknown,violet,wide,x,yellow	-14,-2,-65,-9,0.5-,1,1-1.7,1-6,1.5,10-20,12-20,15-35,2-3,20-40,3-10,3-26,3-6,4-30,4-6,4-6.3,4-7,4-foliat,5-10,7-14,8-15,absen,acuminate,acute,adaxially,almost,apart,ape,apical,axe,broadly,concave,diameter,dilated,eaf,eed,equalling,especially,exceeding,fleshy,flower,glabrous,gland,glandular-puberulent,globose,lon,longer,minutely,near,nflorescence,nther,obconical,obtuse,orolla,ovate,ovoid,papillose,peduncle,perfect,pilo,present,pubescent-pilo,rachi,radiu,ruit,shorter,slightly,spaced,stamen,stigma,strongly,swelling,tal,tem,thecae,tip,tomento,tomentose,toward,triangular,tube,two,ud,unknow,vary,ympodial	4-foliate,absent,anther,appressed,articulation,bract,branching,breeding,broad-based,colour,corolla,filament,form,fruiting,growth,heteromorphism,inflated,inflorescence,insertion,interjected,interpetalar,leaf,leaflet,length,marking,mature,modification,needle-like,odour,orientation,paired,pattern,placement,position,prickle,pseudostipule,rhizome,scale,shape,smell,spot,staman,stem,structure,surface,symmetry,sympodial,system,tall,texture,tissue,trichome,tuber,type,vegetative,xylopodia,zygomorphy
266	wfo-0001028997	success	136	137	80	56	57	0.588	.5,0.5-0.7,0.5-1,1-1.5,3-4,4-angled,6-7,abaxially,acute,adaxially,anther,apex,appearing,attenuate,bark,base,berry,branched,calyx,cm,conical,coriaceous,corolla,difoliate,dry,drying,elliptic,elliptic-obovate,erect,filament,free,fruiting,glabrous,globose,golden,green,height,later,lateral,leaf,lobe,long,lower,main,many,margin,matte,middle,mm,mustard,older,opposite,pair,pedicel,pericarp,petiole,pore,poricidal,portion,quadrate,revolute,shaped,shiny,shrub,stem,surface,tear-drop,terminal,thick,time,tip,trifoliate,tube,unknown,vein,white,widest,x,yellow,young	0.5-1.5,0.8-1.1,1-1.2,2-2.5,2-3.5,20-50-flowered,3.3.5,4-10,4-4.5,5-6,6-10,anthesi,apar,area,ba,broadened,cucullate,deflexed,dia,eaf,edicel,eed,exserted,filiform,flattened-reniform,fragrant,geminat,glabrou,greenish-brow,incrassate,lobed,lon,merely,minutely,nearly,nflorescence,ovary,pale,papillose,partially,pitted,ruit,scar,spaced,specimen,stigma,strongly,styl,style,tan,thickened,tub,ud,unevenly,woody,ympodia	appressed,articulation,bract,branching,breeding,broad-based,cell,colour,connective,form,fruit,geminate,greenish-brown,growth,hair,heteromorphism,inflated,inflorescence,insertion,interjected,interpetalar,leaflet,length,marking,mature,modification,needle-like,null,odour,orientation,paired,pattern,placement,position,prickle,pseudostipule,rhizome,scale,shape,smell,spot,staman,stone,structure,symmetry,sympodia,sympodial,system,texture,tissue,trichome,tuber,type,unit,vegetative,xylopodia,zygomorphy
267	wfo-0001029003	exception_thrown	207	0	0	207	0	0.0		0-6,0.3-0.5,0.4-3,0.5,1,1-10,1-2,1-2.5,1-3,1-5,1.2-1.9,1.2-2.5,1.5-2.3,11-32,12.2-30,13-36,2-6,2.5-10,2.5-7.5,3,3-20,3-5,3.5-7.5,4-8,5,5-10.5,5-12.5,5-merou,7-15.5,7-9,9-14,abaxially,absent,acumen,acuminate,adaxially,ag,alyx,anther,apart,apex,apparently,articulated,attenuate,axe,axillary,base,berry,blade,blue-violet,brownish,bud,capitat,cell,chartaceous,ciliate,cm,condition,conical,connivent,corolla,covering,decreasing,diameter,digestion,distal,dorsally,drying,eaf,edge,eed,elliptic,elongated,end,enzyme,equal,erec,especially,exceeding,filament,flat,flower,folded,forked,fourth,fresh,fruit,geminat,generally,glabrou,glabrous,gradually,green,green-white,greenish,hair,hair-like,hal,half,herb,highly,homostylous,honeycomb-shaped,interjected,lanceolate,larger,lateral,leaf,leaflet,lengthening,light,like,living,lobe,long,lower,make,margin,medium,membranous,middle,minute,mm,mottled,mucilaginous,nflorescence,obtuse,odd-pinnate,one,orbicular,orolla,ovate,ovoid,pair,pale,pedicel,peduncle,pentagonal,perfect,petiole,petiolule,pigmentation,placed,plant,plurifoliate,pore,poricidal,prostrate,proximal,pubescent,purple,rarely,ray,removed,ripe,rotate,rounded,ruit,secondary,seed,sessile,seudostipule,size,slightly,slit,sometimes,spaced,sparsely,specimen,stamen,ste,stem,stigma,stolo,straight,style,subcapitate,subequal,subglabrous,subtending,symmetrical,tall,tamen,tem,terminal,testal,thick,throughout,tip,toward,tri-,tube,tuber,typically,unit,usually,vary,violet,wall,wet,white,whitish,wide,wing,x,yellow,ympodial	
268	wfo-0001029006	exception_thrown	217	0	0	217	0	0.0		-+,.5,0.2,0.4-2.5,0.5,0.5-2,0.5-4,1,1-1.5,1-4,1-5,1.2-1.5,1.8-2.2,1/3,10,10-20,2-3,2-6,2.5,3.5-4,4-6,5,5-6,5-merou,50,7-8,7-9,<,>,abaxially,acuminate,acute,adaxial,adaxiall,ag,age,along,alyx,anther,anthesi,apar,apex,area,ark,articulated,asymmetrical,axi,axil,basal,base,berry,beyond,bilobed,black,blackish,branched,bright,broadest,c.,calyx,cell,chartaceous,clavat,cm,conical,connivent,corolla,deeply,deltate,dense,depending,diameter,drying,eaf,eed,ellipsoid,elliptic,elongate,entire,exserted,extending,filament,filiform,flattened,flower,free,fruiting,glabrous,globose,green,groove,growing,growth,ilament,inflated,inflorescence,intramarginal,irregular,irregularly,keeled,lamina,later,lateral,leaving,lengthening,lobe,lobed,long,loosely,lower,many,margin,markedly,membranous,midrib,minute,minutely,mm,narrowly,nearly,new,nflorescence,nodding,oblique,obvious,occasionally,often,older,one,orolla,pair,pale,papillate,part,pedicel,peduncle,peg,pendan,pentagonal,per,perfect,pericarp,petiole,pinnatifid,pitted,planar,plurifoliat,pore,poricidal,portion,primary,puberulen,puberulent,pubescent,purple,purplish,reaching,reddish,reniform,ripe,rotate-stellate,ruit,sagittate,scar,shiny,simple,size,sleeve,slit,small,smaller,sometimes,somewhat,spaced,sparsely,spreading,stem,stigma,strong,strongly,style,sunligh,surface,tan,tem,terminal,testal,thin,time,tiny,tip,trichome,truncate,tube,tuft,twinin,twining,ud,uniseriate,unit,upper,usually,variable,variously,vary,vein,vine,violet,way,white,widest,within,woody,x,ympodial,young,zig-zag	
269	wfo-0001029031	exception_thrown	213	0	0	213	0	0.0		-11.4,-12.3,-3.6,-8,.1-0.3,.5-1.2,0-5,0.1-0.5,0.5,0.5-1.5,0.5-4,0.6-1.2,0.7-1.1,1-1.5,1-2,1-2.5,1-2.6,1-3,1-5,1-9.4,1.3-3.3,1.5-2.8,1.5-3.5,1.8-2.7,1.8-4,1/3,10,13.5,2-10.7,2-3,2-3.3,2-5,2.5-5.5,2.5-5.6,20-150,3-10,4-5-,4-7.5,5-17,6-12,6-21,abaxially,absent,accrescent,acuminate,acute,adaxiall,adaxially,ag,angle,anther,apart,apex,apexacute,apparently,around,articulated,axe,ba,base,becoming,berry,bilobe,black,blade,bluish,branched,brown,calyx,capitate,center,chartaceous,cm,connivent,corolla,covering,cuneate,curved,cylindrical,deltate,densely,denser,diameter,directed,distally,eaf,edge,eed,eglandula,eglandular,elliptic,elliptic-ovate,entire,equal,erect,farinose,filament,flattened,fleshy,flower,forked,frui,fruit,fruiting,fused,geminate,glabrescent,glabrous,globose,green,hair,held,immature,impressed,inserted,lanceolate,large,lateral,leaf,leaf-opposed,least,length,light,like,lobe,long,longitudinal,lower,major,many-foliate,margin,midpoint,midvein,mm,nearly,nflorescence,oblong,obtuse,occasionally,opening,orange,orolla,outline,paired,pedicel,peduncle,peltate,peltate-stellate,perfect,petiole,pore,porrect-stellate,possibly,prominent,pseudoterminal,pubescen,pubescence,pubescent,rachi,rarely,ray,reniform,ripening,rounded,rugulose,ruit,sessile,short,short-stalked,shrub,side,silvery,simple,slightly,slit,small,smaller,sometimes,somewhat,spaced,sparsely,ste,stellate,stellate-pubescent,stem,stigma,straight,strongly,style,suborbicular,subtending,surface,tall,tamen,tem,time,tip,tree,trichome,tube,unarme,unbranched,unit,usually,vary,vein,white,whitish,wide,x,yellow,yellowish,ympodial	
270	wfo-0001029048	exception_thrown	162	0	0	162	0	0.0		.01,.2,.5,/3,0.5,0.5-1,0.5-1.7,0.8-1,1,1-2,1-8,1.5-2,11,14,2,25,26,3-4,3-7,3.5-4,4-6,5-8,8-10,9-15,acuminate,angle,another,anther,anthesi,apar,apex,apparent,arching,attenuate,basal,base,bearing,becoming,beneath,berry,bicellular,blade,branch,bright,broadly,calyx,cm,conical,corolla,decurrent,dia,eaf,edicel,eed,elliptic,elongated,except,expanded,f,filament,filiform,flower,free,fruiting,geminate,glabrate,glabrous,globose,golden,greatly,green,greenish-white,greenish-yello,greenish-yellow,hanging,hispidulous,incrassate,lateral,leaf,less,like,live,lobe,lobed,long,lower,main,margin,matte,middle,midrib,minute,minutely,mm,much,nflorescence,node,non-reproductive,obovoid,obtuse,older,one,opposite,ovary,ovoid-reniform,pair,pale,papillo,papillose,parallel,pedicel,petiole,pitted,planar,pore,poricidal,portion,puberulent,reflexed,right,ripe,rounded,ruit,scar,shaped,sharply,shrub,slender,slightly,small-capitate,somewhat,spaced,specimen,stem,stigma,straight,style,surface,tall,tan,tapering,tear-drop,thread-like,time,tip,translucent,trichome,tube,ud,unevenly,uni-,unifoliate,unit,vein,way,widely,widest,winged,x,ympodial,young,zig-zag	
271	wfo-0001029055	success	169	70	16	153	54	0.095	apex,base,calyx,cell,corolla,filament,hair,interjected,leaf,leaflet,lower,pattern,pedicel,petiole,type,unit	0.4-1.5,1-2.6,1-4,1-5,1.6-3.5,1.7-2.2,1.8-3.5,14-50,2-1.,2-3,2-4,2.2-3,2.5-8,3,3-10,3-6,3-6-foliat,4-10,4-6,4-7,5-24,5.5-9,6-14,8-9,9-22,abaxially,acumen,acuminate,acute,adaxially,apical,apically,articulate,attenuate,branched,cm,connate,cordate,covered,covering,cuneate,cyme,dark,decurrent,dehiscent,densely,diameter,dichasial,dichasially,digestion,diminishing,distal,dorsally,eaf,ebracteate,edge,eed,elliptcal,elliptical,emoval,enzyme,exceeding,first,flat,flower,folded,forked,generally,gland,globo,green,green-white,hair-like,half,herbaceous,honeycomb,introrse,lateral,living,lobe,lon,long,long-attenuate,longer,longitudional,lunat,make,maturing,mm,monochasial,mucilaginous,near,nflorescence,nther,oblique,odd-pinnate,often,orolla,outline,ovate,ovoid,pair,peduncle,pentagonal,perennial,perfect,pilose,plan,plant,poricidally,proximal,pubescent,purple,rarely,reveal,rotate,ruit,second,seed,sessile,seudostipule,short,short-petiolate,short-stalked,size,slit,sometimes,specimen,spreading,stamen,stigma,straight,stripe,style,tal,tem,terminal,testal,thick,throughout,time,toward,triangular,tuber-bearing,typically,vary,wall,whit,wide,widest,yellow,ympodial,Â¼	anther,appressed,articulation,bract,branching,breeding,broad-based,colour,connective,form,fruit,fruiting,growth,heteromorphism,inflated,inflorescence,insertion,interpetalar,length,margin,marking,mature,modification,needle-like,none,odour,orientation,paired,placement,pore,position,prickle,pseudostipule,rhizome,scale,shape,smell,spot,staman,stellate,stem,stone,structure,surface,symmetry,sympodial,system,texture,tissue,trichome,tuber,vegetative,xylopodia,zygomorphy
272	wfo-0001029059	exception_thrown	199	0	0	199	0	0.0		.5,0.1-0.5,0.1-1,0.2,0.2-0.5,0.5,0.5-1,1-1.2,1-1.5,1-3,1-4,1-6,1.2-3,1.3-1.7,1.5-2,1.5-2.8,10-19,2.5,3-3.5,3-6.5,3.5-6,3.5-8,4-10.5,5,5-15-flowered,6-10,7-9,acute,along,anisophyllou,anther,anthesi,apar,ape,apex,apiculae,apiculate,arising,bark,base,beneath,berry,bout,branched,bud,calyx,clavate,closely,cm,coiba,connivent,cordate,corolla,covered,cuneate,de,deep,deflexed,deltoid,dense,densely,dia,differing,difoliate,dirty,eaf,edicel,eed,ellipsoid,elliptic,expanded,exserted,extending,extremely,filament,flattened-reniform,foetid,free,fruiting,geminate,glabrate,glabrous,globose,greatly,hispidulous,impressed,incrassate,inflorescence,interpetalar,isla,lamina,lateral,leaf,lobe,lobed,lon,long,longest,lower,main,major,margin,member,membranous,middle,minor,minute,minutely,mm,narrowly,nearly,nflorescence,oblique,occasionally,often,older,one,opposite,orange,orangish-yellow,orbiculate,ovary,pair,pale,paler,panama,papillo,papillose,partially,pedicel,petiole,pitted,planar,pointed,population,pore,poricidal,portion,prominent,pubescence,pubescent,purplish,reddish-gre,rest,ripe,rounded,ruit,scar,shallowly,shape,shaped,shrub,simple,sinus,size,slender,small,somewhat,soon,spaced,sparse,specimen,stem,stigma,straight,style,surface,tall,tapering,tear-drop,terminal,thickened,ti,tightly,tinge,tip,tree,triangular,trichome,tube,ud,underside,unicellular,uniseriate,unit,usually,variable,vein,waxy,white,wide,widest,woody,x,yellowish,yellowish-green,yellowish-tan,ympodial,young	
273	wfo-0001029072	success	235	158	107	128	51	0.455	-1/2,.5,/6,0-8,0.5-3,1-1.5,1/3,1/4-1/2,1/4-1/3,12-19,2-5,2-7,3-5,3-50,4.2-6.5,5-50,5-7,andromonoecious,anther,apart,apex,apically,apparently,articulated,base,berry,blade,branched,bright,broadly,calyx,chartaceous,cm,conical,connivent,cordate,cream,cuneate,curved,dark,deltate,densely,distance,elongating,equal,erect,extending,filament,flattened,flower,free,fruit,fruiting,glabrous,green,herb,heterostylous,lateral,leaf,least,length,lobe,lobed,long,long-styled,lower,margin,marking,mature,maturity,mauve,midvein,mm,multangulate,orange-brown,pale,pedicel,pendent,petiole,poricidal,porrect,portion,prickle,prickly,reflexed,rounded,short-styled,shrub,side,simple,sometimes,spaced,spherical,stellate,stellate-pubescent,stem,surface,tapering,terminal,tip,trichome,unit,way,white,wide,yellow,young	-15,-2.5,0,0-2,0-20,0-4,0.1-0.4,0.2-0.3,0.2-0.4,0.3,0.4-0.9,0.5-2,0.7,0.8,0.8-1.5,00-200,1,1-1.2,1-25,1-3,1.5-2.5,1.5-2.6,1.5-3.2,2-10,2-8,2.2-2.5,2.2-3.2,2.5-3.5,2.5-3.8,2.5-4.5,20-50,3-10,3-20,3-8,3.5-6,3/,4-,4-10,4.5-9,5-10,5-9,5-merous,7-10,7-15,8-20,8-27,abaxial,abaxially,acute,adaxial,adaxially,alyx,ame,angled,apar,bark,broad-deltate,c.,clearly,diameter,dirty,discolorous,distal,drying,dull,eaf,eed,elongated,flattened-reniform,gently,gra,green-brown,hermaphrodite,infructescence,longer,longitudinal,lowermost,midpoint,moderately,narrow-deltate,nflorescence,obtu,older,one,open,orolla,oung,ovate,pair,peduncle,pendulous,per,pericarp,plant,plurifoliat,prickl,primary,raised,ray,ridge,ruit,scar,sessile,smooth,sparsely,spreading,stalk,stalked,staminat,stout,straight,strongly,style,tamen,tertiary,time,tube,unarmed,upper,variously,vary,vein,venation,visible,weakly,whitish,woody,ympodial	appressed,articulation,bract,branching,breeding,broad-based,cell,colour,connective,corolla,form,growth,hair,heteromorphism,inflated,inflorescence,insertion,interjected,interpetalar,leaflet,modification,needle-like,null,odour,orientation,paired,pattern,placement,plurifoliate,pore,position,present,pseudostipule,rhizome,scale,shape,smell,spot,staman,stone,structure,symmetry,sympodial,system,texture,tissue,tuber,type,vegetative,xylopodia,zygomorphy
274	wfo-0001029073	exception_thrown	211	0	0	211	0	0.0		.5,.7,0.3-1,0.5,0.5-1,0.6-0.7,0.6-2,1-1.2,1-1.5,1-2.5,1-3,1.1-1.5,1.2-1.6,1.5-2,10-15,10-16,2,2-3,2-4,2/3,3.5-9,4-5,4-6,5-6,5-8,5-merous,6-9,7-10,8-14,abaxially,acuminate,acute,adaxially,along,another,anther,anthesi,apart,apex,armed,articulated,away,awn-like,ba,bark,basal,base,beneath,berry,broad-based,brown,calyx,cell,chartaceous,cm,conical,corolla,cream,curved,dark,darker,dense,densely,diameter,difoliate,dimorphic,discolorous,drying,eaf,eed,elliptic,enlarged,entire,equal,erect,except,exserted,filament,flattened,flower,four,free,frui,fruiting,geminat,glabrous,globose,golden,gre,growth,hooked,inflorescence,internodal,interpetalar,lamina,lanceolate,leaf,length,lengthening,like,linear,lobe,lobed,long,long-styled,lower,margin,maturity,midpoint,midvein,minutely,mixture,mm,multangulate,narrowly,new,nflorescence,nodding,oblique,occasionally,older,one,opposite,orange,pair,pale,paler,papillose,pedicel,peduncle,per,perfect,pericarp,petiole,planar,plurifoliate,pore,poricidal,porrect,portion,prickle,prickly,primary,pubescence,pubescent,purple,ray,rectangular,reniform,reticulate,ruit,scar,sessile,shallowly,shiny,short,short-stalked,shorter,shrub,simple,sinuate,slightly,slit,sometimes,somewhat,spaced,sparsely,splitting,stellate,stem,stigma,straight,strongly,style,styled,surface,tan,tapering,testal,thin,three,ti,tip,tissue,triangular,trichome,truncate,tube,two,ud,unarmed,underside,unequal,unequally,unisexual,unit,upper,upward,vein,visible,wall,way,whitish,wide,woody,x,yellow,yellowish,ympodial,zygomorphic,Â½	
275	wfo-0001029074	exception_thrown	174	0	0	174	0	0.0		.1,.5,0,0.2-1,0.3-0.4,0.3-0.8,0.5-1,0.5-1.2,0.7-0.8,0.7-0.95,1,1-,1-1.2,1-1.5,1-2,1.4-1.8,1.5-2,1.5-4,11,2-2.3,2-4,2-5,2-7,3-,3-6,3.5-5,5-6,5-7,abaxially,absent,acute,adaxially,age,almost,along,anther,anthesi,apart,apex,apparently,appearing,articulation,bark,basa,base,berry,black,broadly,calyx,capitate,cm,conical,corolla,cuneate,deflexed,densely,denser,diameter,eaf,eed,ellipsoid,entire,exerted,expanding,filament,flattened,flower,free,frui,fruiting,glabrescen,glabrous,globose,green,grey,growth,herb,immature,internodal,lacking,leaf,lengthening,less,lignescent,like,lobe,lobed,longest,lower,margin,markedly,midpoint,midvein,minutely,mixture,mm,new,nflorescence,obscuring,often,older,opposite,ovary,ovate,pair,pale,papillat,pedicel,peduncle,per,perfect,pericarp,petal,petiole,pitted,planar,plurifoliat,pore,poricidal,portion,primary,prominent,pubescent,pulp,purplish,ray,reflexed,reniform,ripening,rounded,ruit,sagittate,scar,scattered,sessile,simple,slit,small,somewhat,sparsely,stalk,stalked,stellate,stellate-pubescent,stem,stigma,strongly,style,subshrub,surface,swollen,thin,tip,triangular,trichome,truncate,tub,tube,ud,underside,uniformly,uniseriate,unit,usually,vein,watery,way,white,woody,x,yellow,yellowish,ympodial,Â¾	
276	wfo-0001029075	success	217	152	97	120	55	0.447	0-8,0.8-1.5,1-2,30-60,4-14,4.5-6.5,6-12,7-17,abaxially,acumen,adaxially,anther,apex,axillary,base,berry,blade,bud,canescent,cell,cm,corolla,cuneate,dark,densely,distal,dot,end,erect,filament,flecked,forked,fruit,generally,glabrescent,glabrous,glandular-pilose,glandular-puberulent,gray-green,green,hair,half,herb,homostylous,interjected,lanceolate,leaf,leaflet,lengthening,light,like,lobe,long,lower,margin,mm,odd-pinnate,orbicular,orne,ovate,ovoid,pedicel,pentagonal,petal,petiole,petiolulate,plant,plurifoliate,pore,poricidal,pubescent,purple,rounded,sessile,short,singly,slightly,slit,small,sometimes,stem,substellate,subtending,tall,terminal,tip,tri-,tuber,typically,unit,upper,usually,white,whitish-gray,x,yellow-green,yellowish-white	.3,.5,0-3,0.5-0.8,0.8-1.2,1-10,1-2.5,1-3,10-20,2-4,2-5,2.5-3,2.7-4.2,4-10,4-5,4-7,5-10,5-8,5-8.5,5-merou,7-9,8-9,abruptly,ag,along,alyx,apart,apparently,articulated,attenuate-acuminate,atypically,axe,broadly,brown,brownish,ciliate,clavifor,condition,connivent,covering,decreasing,decurrent,diameter,digestion,dorsally,drying,eaf,edge,eed,elliptic-lanceolate,enzyme,erect-ascendin,especially,etota,exceeding,flat,flower,folded,fresh,geminat,glabrou,gradually,greatly,green-white,greenish,hair-like,honeycomb-shaped,larger,lateral,living,long-spatulate,make,middl,midrib,minutely,mucilaginous,narrowed,narrowly,nflorescence,orolla,pair,peduncle,perfect,petiolule,pointed,puberulent,rachi,removed,ruit,sec,seed,seudostipule,size,spaced,specimen,stamen,ste,stigma,stolo,straight,style,subequal,subobtuse,subquadrate,tamen,tem,testal,thick,throughout,toward,tube,unwinged,vary,wall,wet,whitish,wide,woody,yellow,ympodial	age,appressed,articulation,bract,branching,breeding,broad-based,calyx,colour,connective,erect-ascending,form,fruiting,geminate,growth,heteromorphism,inflated,inflorescence,insertion,interpetalar,length,marking,mature,middle,modification,needle-like,odour,orientation,paired,pattern,placement,position,prickle,pseudostipule,rhizome,scale,shape,smell,spot,staman,stolon,stone,structure,surface,symmetry,sympodial,system,texture,tissue,trichome,type,unspecified,vegetative,xylopodia,zygomorphy
277	wfo-0001029084	success	192	123	70	122	53	0.365	1-2,10-50,2-3.5,5,abaxially,absent,adaxially,along,anther,apex,arranged,axillary,base,bead,berry,bud,cell,cm,conical,corolla,distal,filament,forked,fruit,generally,glabrous,green,half,herb,homostylous,interjected,interpetalar,leaf,leaflet,light,like,lilac,long,lower,margin,middle,minute,mm,moniliform,multiple,necklace,odd-pinnate,pedicel,petiole,petiolule,pilose,plant,plurifoliate,pore,proximal,pubescent,purple,rotate,sparsely,stolon,subglabrous,subsessile,subtending,tall,terminal,tissue,tri-,tuber,typically,unit	.5,0.8-2,0.8-2.1,1-10,1-3,1-4,1.1-2.2,1.5-2.5,2-4,2-5,3-6,3.5-7.5,3.5-8,4-17,4-7,4.5-10,4.5-6.5,5-7,5-merou,6-13,7-9,8-23,acumen,acuminate,ag,alyx,apart,apparently,articulated,axe,blade,brownish,capitat,chartaceous,ciliate,condition,connivent,covering,darker,decreasing,diameter,digestion,dorsally,drying,eaf,edge,eed,enzyme,especially,exceeding,flat,flower,folded,fresh,geminat,glabrou,gradually,green-white,greenish,hair-like,honeycomb-shaped,lanceolate,larger,lateral,lengthening,living,lobe,lon,make,midrib,minutely,mottled,mucilaginous,narrow,nflorescence,obtuse,orolla,ovate-lanceolate,ovoid,pair,peduncle,perfect,poricidal,puberulent,ray,removed,ripe,ruit,secondary,seed,semierec,seudostipule,size,slit,spaced,specimen,stamen,stigma,style,subequal,subglabrou,symmetrical,tamen,tem,testal,thick,thir,throughout,tip,toward,tube,unwinged,usually,vary,wall,wet,whitish,wide,wing,x,yellow,ympodial	appressed,articulation,bract,branching,breeding,broad-based,calyx,colour,connective,form,fruiting,geminate,growth,hair,heteromorphism,inflated,inflorescence,insertion,length,marking,mature,modification,needle-like,null,odour,orientation,paired,pattern,placement,position,prickle,pseudostipule,rhizome,scale,semierect,shape,smell,spot,staman,stem,stone,structure,surface,symmetry,sympodial,system,texture,third,trichome,type,vegetative,xylopodia,zygomorphy
278	wfo-0001029088	exception_thrown	149	0	0	149	0	0.0		.2,.3,0.1,0.6â3.2,0.9â1.5,1.3â4.5,1.5â2,1.5â3,15â25,1â1.2,1â1.5,1â1.6,1â3,2-lobe,2.5â20,2.5â4.2,25â30,2â2.5,2â3,3.5â7,3.5â8,3â16,4â8,5,5-merous,5â8,6-10,<,abaxially,accrescent,acuminate,acute,adaxially,alyx,anther,apar,apex,apicall,axe,base,berry,blade,bronze-brown,c.,calyx,capitate,ciliate,climbing,cm,cordate,cylindrical,densely,diameter,eaf,eed,emarginate,entire,extra-axillary,filament,flattened,flavor,fleshy,flower,fragrant,fruit,fruiting,glabrou,glabrous,greenish-brown,groun,hair,half,heavy,herbaceous,immature,juicy,lanceolate,leaf,lenticular,light,lobe,long,lower,m.,margin,mature,membranous,minutely,mm,moderately,narrowly,near,nflorescence,nternode,obtuse,orolla,ovoid-rhomboid,palmate,papillose,pedicel,peduncle,perfec,petiole,plurifoliat,primary,pubescent,purplish,rachi,reddish-brown,revolute,rounded,rugose,ruit,sand-punctate,scent,shortly,simple,slender,slightly,somewhat,spaced,sparsely,stellate,stigma,stout,straight,strongly,style,surface,swee,sweet,tamen,tem,terrestrial,tip,truncate,truncate-acuminat,tube,unbranched,unit,vary,vein,venation,vine,white,wider,x,ympodial,â7	
279	wfo-0001029089	exception_thrown	177	0	0	177	0	0.0		.5,.75,/4,0.1-0.25,0.5-0.6,0.5-1,0.8-1,0.8-1.2,1,1-1.5,1.5-2,1.5-6,1/2,10-25,2.5-3.5,4.5-5,5-10,5-20-flowered,5-6,5-9,6-7,8-9,abrupt,acute,along,anther,anthesi,apart,apex,apiculate,axil,ba,bark,base,beginning,beneath,berry,bilobed,branched,bud,calyx,campanulate,caniculate,closely,cm,completely,corolla,covered,covering,cracking,dark,decurrent,deflexed,densely,dia,differing,difoliate,drying,eaf,edicel,eed,either,elliptic,enclosed,entire,erect,expand,exserted,filament,flattened-reniform,free,fruiting,furcate,geminat,glabrou,glabrous,globose,golden,green,impressed,incrassate,inflorescenc,lamina,later,lateral,leaf,like,lobe,lobed,lon,long,lower,main,major,margin,material,member,middle,minor,minutely,mm,nflorescence,obovoid,occasionally,older,one,opposite,otherwise,ovary,overlapping,pair,papillo,papillose,part,pedicel,peeling,persistent,petiole,pinkish,pitted,planar,pore,poricidal,portion,primary,prominent,pubescent,purplish,reddish-grey,resinou,resinous,rounded,rounded-deltoid,ruit,scar,secretion,shaped,shiny,shrub,simple,size,slightly,small,smooth,somewhat,spaced,stem,stigma,still,straight,style,surface,tall,tan,tapering,tear-drop,tip,tree,trichome,tub,tube,ud,underside,uniseriate,unit,usually,varnish,varnished,vein,way,white,widening,widest,woody,x,ympodial,young	
280	wfo-0001029091	exception_thrown	212	0	0	212	0	0.0		-1,-15,-4,-4.5,0.3-,0.5-0.8,0.5-1,1,1-10,1-2,1.5-,1.5-2,10,10-20,10-toothed,15-40,170-210,2-12,2-2.5,2-3,2.5-,20-30,3,3-,3-11-lobed,3-4,4,46/1,5,5-7,635/1,7-8,acuminate,acute,age,anther,apex,appearing,aromatic,articulated,articulation,aspect,axil,ba,base,becoming,berry,blunt,bluntly,broadly,brownish,buff,calyx,campanulate,capitate,cell,clonal,close,cm,colour,common,conspicuous,corolla,cuneate,cut,cyme,dark,deeply,develop,developed,dia,discoidal,downward,eed,effect,ellipsoid,elliptic,emarginated,erect,exceeding,exerted,filament,flattened,floral,flower,flushed,fork,forked,fresh,fruiting,general,giving,glandular,globose,globular,gree,grey,growing,hair,half,intense,interacuminal,irregular,irregularly,juvenile,lacking,larger,lasting,later,lateral,lavende,lavender,leaf,lengthening,light,line,linear,linear-lanceolate,lobe,long,long-triangular,lower,may,mid-vein,mineral,minutely,mm,narrowly,nflorescence,oblong,obovate,obscure,occasionally,ochre-yellow,ovate,overlain,ovoid,ower,pale,pattern,pedicel,pedicellate,peduncle,pentagonal,petiol,petiolate,petiole,plurifoliat,point,pore,poricidal,pubescent,rachi,raised,readily,reddish-purple,relatively,reticulate-concentric,rh,ridge,ridged,ripe,rounded,ruit,scarcely,separate,several,shallowly,shed,shortly,shrub,sigmoid,simple,sinus,slender,slightly,slit,soft,soft-wooded,soon,sparsely,speckled,stellate-rotate,stem,stigma,stone,straggly,style,subulate,succulent,surface,swollen,tall,tip,tissue,toward,transverse,triangular,tub,ud,unit,upper,usually,violet,violet-purple,well,winged,without,woody,x,year,ympodial	
281	wfo-0001029101	exception_thrown	233	0	0	233	0	0.0		-15,-3,.5,/3,/4,0-100,0-2,0-20,0-5,0-8,0.1,0.1-0.4,0.1-0.5,0.1-0.7,0.1-1,0.2,0.4-1.5,0.5-1,0.7-,0.8-3.5,00-200,1,1-1.5,1-3,1-4,1-8,1.3-2,1.3-2.6,1.4-2.2,1.5-2,1.5-2.5,1.7,1.8-3,1/5-1/4,10-14,10-20,2-,2-20,2-6,2.5-3.5,2.5-6,2.8-3.3,2/3-3/4,3-,3-10,3-4,3-7,30-100,4-12,4-7,5-,5-20,5-6,5-7,5-8,5-9,5-merous,5.5-8,6-8,7-13,8-15,abaxial,abaxially,acute,adaxial,almost,always,alyx,andromonoecious,anther,apar,apart,apex,apically,apparently,articulated,bark,base,berry,blade,branched,broad-deltate,brown-green,calyx,cell,chartaceous,cm,concolorous,connivent,cream,cuneate,dark,darker,deltate,diameter,discolorous,distal,distance,drying,dull,eaf,eed,elliptic,elongating,equal,erect,extending,filament,flattened,flattened-reniform,flower,free,fruit,fruiting,glabrescent,glabrous,green,green-brow,hermaphrodite,heterostylous,infructescence,lateral,leaf,lengt,length,like,lobe,lobed,lon,long,long-styled,longer,lower,lowermost,margin,marking,mature,maturity,mauve,midpoint,midvein,mm,moderately,multangulate,narrow-deltate,nflorescence,oblong,obovate,obtuse,often,older,one,open,orange-brown,orolla,oung,outline,ovate,pair,pale,pedicel,peduncle,pendulous,per,pericarp,petiole,pit,plant,plurifoliat,poricidal,porrect,portion,present,prickl,prickle,prickly,primary,raised,rarely,ray,reduced,reflexed,rounde,rounded,ruit,scar,secondary,sessile,short-styled,shrub,side,simple,small,smooth,sometimes,spaced,sparsely,spherical,spreading,stalk,stalked,staminat,stellate,stellate-pubescent,stem,straight,style,suborbicular,surface,tamen,tapering,terete,tertiary,thick,time,tip,trichome,tube,unit,variously,vary,vein,venation,visible,way,well-developed,wide,woody,yellow,yellow-green,yellow-orange,ympodial,young	
282	wfo-0001029106	exception_thrown	200	0	0	200	0	0.0		-6,.1,.5,/3,0,0-0.3,0-10,0-2,0-20,0-5,0-6,0.1,0.2-0.4,0.2-1,0.25-0.7,0.5,0.5-0.8,0.5-0.9,0.5-1,0.5-2.5,0.9-1.2,1-1.6,1-2,1-5,1.5-1.8,1.5-2,1.5-3.5,1/4,1/5-1/4,2-3.5,2-4,2-5.5,2-6,2-8,2.2-3,2/,3-25,3-3.5,3-4,4-6,4-8,5-14,5-8,5-merous,6-8,abaxially,acuminat,acute,alyx,ame,anther,apar,apart,apex,apically,apparently,appearing,articulated,bark,base,berry,blade,branched,c.,calyx,cell,cm,concolorous,cuneate,curved,deltate,densely,diameter,discolorous,distance,drying,eaf,eed,elliptic,elongating,equal,erect,extending,eye,filament,flattened,flattened-reniform,flower,free,fruit,fruiting,gently,glabrescent,glabrous,infructescence,lateral,leaf,length,light,lobe,lobed,lon,long,longer,lower,margin,mature,maturity,mauve,membranous,midpoint,midvein,mm,naked,nflorescence,obtuse,older,one,open,orange,orange-brow,orange-brown,orbicular,orolla,oung,outline,ovate,pair,pale,pedicel,peduncle,pendulous,per,perfec,pericarp,petiole,pit,plurifoliat,poricidal,porrect,portion,prickl,prickle,prickly,primary,raised,ray,red,reflexed,rounded,scandent,scar,sessile,shallow,shiny,shorter,shrub,side,simple,size,slender,small,smooth,sometimes,spaced,sparsely,spherical,spreading,stalk,stalked,stellate,stellate-pubescent,stem,straight,style,subentire,surface,tamen,tapering,terete,tertiary,time,tip,trichome,tube,uit,unit,variously,vary,vein,venation,visible,way,weakly,white,wide,woody,yellow-orange,yellowish-green,ympodial	
283	wfo-0001029112	exception_thrown	190	0	0	190	0	0.0		0-2,0.5,0.9-1.7,1-10,1-2,1-3,1-4,1.4-2.5,1.5-1.8,1.5-2,10-17,10-21,2-3.5,2.5-4.5,2.6-3,2.7-3.5,2.7-4.2,2.7-5.7,20,3-4,3-5,3-6,3-7,3.5-4.5,3.5-7,5,5-8,5-merou,6.5-5.5,9.5-13,abaxially,acumen,acuminate,adaxially,ag,along,alyx,anther,apart,apex,apparently,arranged,articulated,axe,axillary,base,bead,berry,blade,brownish,bud,capitat,cell,chartaceous,ciliate,cm,condition,conical,connivent,corolla,covering,decreasing,densely,diameter,digestion,distal,dorsally,drying,eaf,edge,eed,elliptic-lanceolate,enzyme,equal,especially,exceeding,filament,flat,flower,folded,forked,fresh,fruit,geminat,generally,glabrou,glabrous,gradually,green,green-white,greenish,hair,hair-like,half,herb,homostylous,honeycomb-shaped,interjected,lanceolate,larger,lateral,leaf,leaflet,lengthening,light,like,living,lobe,long,lower,make,margin,middle,minute,mm,moniliform,mottled,mucilaginous,multiple,narrow,necklace,nflorescence,obtuse,odd-pinnate,orolla,ovate,ovoid,pair,pale,pedicel,peduncle,perfect,petiole,petiolule,plant,plurifoliate,pore,poricidal,present,pubescen,pubescent,purple,ray,removed,ripe,rotate,ruit,secondary,seed,semierec,seudostipule,size,slightly,slit,spaced,specimen,stamen,ste,stigma,stolon,style,subequal,subtending,symmetrical,tall,tamen,tem,terminal,testal,thick,thir,throughout,tip,toward,tri-,tube,tuber,typically,unit,usually,vary,violet,wall,wet,whitish,wide,wing,x,yellow,ympodial	
284	wfo-0001029120	exception_thrown	168	0	0	168	0	0.0		.05,.5,.75,/2,0.1-0.5,0.5-1.5,0.7-1,1-1.5,1.1-1.5,1.1-2,2.5-3.5,2.6-7,3-3.5,5-10-flowered,5-8,6-8,6.5-16.5,8511,abrupt,acuminate,acute,anther,anthesi,apart,apex,bark,basal,base,beginning,beneath,black,bud,bullate,calyx,cell,cm,corolla,dark,decurrent,deflexed,densely,dia,difoliate,dry,drying,eaf,edicel,eed,epidermi,erose,especially,evenly,f,fide,filament,fleshy,free,geminat,glabrous,globose,golden,greenish-brown,hirsute,inflorescenc,infloresence,internodal,know,known,lanceolate,large,larger,later,lateral,leaf,lehmann,like,lobe,lobed,lon,long,long-triangular,lower,main,margin,middle,midrib,minor,minutely,mm,narrow,narrower,narrowly,nearly,nflorescence,occasionally,often,older,opposite,outer,ovary,ovate,pair,pale,paler,papillose,pedicel,peduncl,peduncle,petaloid,petiole,point,pore,poricidal,portion,present,prominently,proximal,pubescent,raised,reproductive,rest,ruit,scar,scattered,shaped,shrub,simple,slender,slightly,spaced,sparsely,specimen,speckle,stem,stigma,straight,style,surface,sympodial,tall,tapering,tear-drop,terminal,thickened,tip,trichome,tub,tube,ud,unbranched,unifoliate,uniseriate,unit,upper,urceolate,vein,venation,way,white,white-papillo,wide,widening,widest,x,yellow,yellow-green,ympodial,young	
285	wfo-0001029121	success	161	138	80	81	58	0.497	0,1-4,1-5,2-10,2-3,2-3-celled,4-5.5,abaxially,adaxially,apex,apical,base,blue,branched,calyx,cell,cm,commonly,conical,connate,corolla,cuneate,cyme,deep,dehiscent,dichasial,dichasially,diminishing,distal,ebracteate,filament,flower,forked,generally,glabrous,gradually,green,hair,hair-like,half,herbaceous,honeycomb,interjected,introrse,lateral,leaf,leaflet,long,lower,maturing,medium,mm,monochasial,oblique,odd-pinnate,often,pattern,pedicel,perennial,perfect,petiole,plant,poricidally,proximal,purple,rarely,rotate,rounded,scattered,short,size,slit,subequal,testal,toward,tuber-bearing,typically,unit,wall,Â¼	-6,0-2,0.2-2,1.1-3.9,1.2-2.5,1.2-3.3,10,15-30,2-,2-13,3-5,3-6-foliat,3.6-9,3.8-11,4-10,4.5-10.0,5-20,5-8,8-16,9-33,abaxiall,acumen,acuminate,acute,apically,articulate,attenuate,covering,diameter,digestion,dorsally,eaf,edge,eed,elliptical,emoval,enzyme,exceeding,flat,folded,globo,green-white,living,lobe,lon,lunat,make,mucilaginous,narrowly,nflorescence,nther,obtuse,orolla,ovate,ovoid,pair,peduncle,petiolule,plan,reveal,ruit,seed,sessile,seudostipule,short-attenuate,specimen,stamen,stigma,straight,style,tal,tem,terminal,thick,throughou,throughout,tip,vary,wide,yellow,ympodial	3-6-foliate,6,anther,appressed,articulation,bract,branching,breeding,broad-based,colour,connective,form,fruit,fruiting,growth,heteromorphism,inflated,inflorescence,insertion,interpetalar,length,lunate,margin,marking,mature,modification,needle-like,null,odour,orientation,paired,placement,pore,poricidal,position,prickle,pseudostipule,rhizome,scale,shape,smell,spot,staman,stem,stone,structure,surface,symmetry,sympodial,system,texture,tissue,trichome,tuber,type,vegetative,xylopodia,zygomorphy
286	wfo-0001029125	exception_thrown	197	0	0	197	0	0.0		.0â3.5,.1,.1â1.4,.2,.4,.5â2.0,.6,0.5,0.5â0.6,0.5â1.0,0.8â0.9,0.9,1,1.0â1.2,1.0â1.5,1.0â4.0,1.5â2.0,1.5â3.0,1.7-,1.8â3.5,1â2-celled,2.5â12.0,2/3,20â100,2â3-celled,2â4,3.0â3.4,3.5â4,35â45,3â5,3â5-celled,4â8,5-merous,5â6,6,6â7,abaxial,abaxially,acuminate,acute,adaxial,adaxially,age,along,anther,anthesi,apar,apex,apparently,appressed,arising,articulated,attenuate,ba,base,berry,beyond,black,branching,brownish,calyx,cell,central,closely,cm,concave-reniform,cone,conical,corolla,cuneate,delicate,deltate,densely,diameter,difoliate,eaf,eed,ellipsoid,end,entire,especially,exerted,filament,flower,free,fruit,fruiting,geminat,glabrous,globose,green,growt,herb,hilum,internodal,later,lateral,leaf,lengthening,like,live,lobe,lobed,lon,long,lower,margin,maturity,maximum,minutely,mm,narrower,nearly,nflorescence,oblique,occasionally,often,one,orange,outline,ovary,ovate-lanceolate,pair,pale,papillate,pedicel,peduncle,pentagonal,per,perfect,petiole,place,plant,pore,poricidal,portion,positioned,primary,pubescent,purple,purple-tinged,purplish,reflexe,reflexed,ridged,ripe,ruit,scar,scattered,seed,shiny,shorter,simple,single,slightly,slit,small,spaced,sparsely,spreading,star,stellate,stem,stemmed,stigma,stone,straight,strongly,style,sub-lateral,subshrub,surface,tall,tem,terete,testal,tinged,tip,toward,traingular,trichome,tube,turning,ud,unequal,uniseriate,unit,usually,vein,white,whitewith,wide,woody,yellow,ympodial,young,Â¼	
287	wfo-0001029150	exception_thrown	177	0	0	177	0	0.0		.5,0.3,0.3-0.5,0.3â0.5,0.5â1.1,0.8-1,0.8â1,0.8â1.5,0.8â3.5,1.2â1.5,1.5,1.5â2,1.5â2.2,15,1â1.5,1â11,1â2,1â5,1â6,2.5â3,2.5â5,2.5â8,2â10,2â2.5,2â3,3-5,3â10,3â4,3â50,5-merous,6,7â8,8-shaped,9â12,abaxially,accrescent,across,acute,adaxiall,adaxially,alyx,anther,apar,apex,apicall,apically,apiculate,attenuate,axe,base,berry,blade,branched,c.,calyx,canopy,capitat,ciliate,climbing,cm,color,conical,cros,cylindrical,delicate,diameter,distant,dried,eaf,eed,ellipsoidal,elliptical,enlarged,entire,except,extra-axillary,filament,flattened,fleshy,flower,flush,fruit,fruiting,glabrou,glabrous,inconspicuous,lamina,lanceolate,larger,leaf,light,living,lobe,lon,long,lower,m.,margin,material,membranaceous,midvein,minutely,mm,moderately,mor,nearly,nflorescence,nternode,oblique,older,opposed,orolla,ovate,pair,pale,pedicel,peduncle,perfec,petiole,pinkish-white,pinnate,plurifoliat,pointed,pubescent,rachi,rarely,reaching,rounded,rounded-deltoid,rugose,ruit,sand-punctate,scar,secondary,section,shortly,side,simple,slender,slightly,small,somewhat,spaced,sparsely,specimen,stellate,stem,stigma,strong,style,surface,tamen,tan,teardrop-shaped,tem,thick,thickened,time,tip,translucent,tree,trichome,truncate,tube,understory,unit,vary,vegetation,vein,venation,vine,white,wide,wiry,woody,x,ympodial	
288	wfo-0001029152	exception_thrown	197	0	0	197	0	0.0		.1,.5,0.25-0.5,0.5-1,0.75-1,0.8-1,0.9-1.3,1,1-1.5,1-2,1-3,1-4,1.1-1.3,1.5-1.7,1.5-2,2-2.5,2-3,2-4,2-5,2.5-3,3-5,3-8-flowered,4-6,6-8,61-25,8.5-16,acuminate,acute,anther,anthesi,apex,appearanc,appearing,appressed,area,attenuate,ba,bark,base,beginning,beneath,berry,blade,branch,broadened,broadly,brown,bud,calyx,citronella,closely,cm,completely,conical,corky,corolla,cuneate,dark,deciduous,decurrent,deep,deflexed,deltoid,densely,dia,differing,difoliate,distal,dry,eaf,edicel,eed,ellipsoi,elliptic,enclosing,erect,et,exsertion,fide,filament,flattened,floccose,flower,fragrance,free,fruit,fruiting,geminat,giving,glabrous,globose,green,greyish-red,held,hyaline,inflorescenc,inflorescence,keeled,large-lenticellate,late,lateral,leaf,lightly,live,lobe,lobed,lon,long,long-styled,longer,lower,main,major,margin,material,middle,midrib,minor,minutely,mm,nearly,nflorescence,obovate,often,older,one,opposite,ovary,overlapping,ovoid-reniform,pair,pale,papillose,pedicel,per,petiole,pitted,planar,plane,plant,pore,poricidal,portion,prominent,prominently,quite,red,red-floccose,reddish,reddish-floccose,reflexed,reminiscent,rounded,ruit,scar,shape,shaped,shiny,short-styled,shrub,simple,single,size,slender,slightly,small,somewhat,soon,spaced,stem,stigma,straight,styl,style,surface,tall,tapering,tear-drop,terminal,third,tillett,tip,tree,trichome,tube,ud,unit,usually,vein,weak,white,widest,winged,woody,x,ympodial,young	
289	wfo-0001029156	success	65	103	42	23	61	0.646	0.5,1,2,<,almost,apex,berry,cell,center,completely,deeply,flattened,fruiting,glabrous,golden,growth,lateral,liana,long,margin,minute,minutely,mm,multiseriate,new,pale,pedicel,pitted,rectangular,reniform,rib-like,seed,shiny,sinuate,stem,surface,tan,thickening,trichome,vine,wall,woody	-3,1.5-2,10-12,4-6,6,6-8,apparently,bark,cm,diameter,eed,epiphytic,exfoliating,fide,markedly,nee,noddin,occasionally,older,per,shreddy,testal,wide	anther,appressed,articulation,base,bract,branching,breeding,broad-based,calyx,colour,connective,corolla,filament,form,fruit,hair,heteromorphism,inflated,inflorescence,insertion,interjected,interpetalar,leaf,leaflet,length,lower,marking,mature,modification,needle-like,nodding,null,odour,orientation,paired,pattern,petiole,placement,pore,position,prickle,pseudostipule,rhizome,scale,shape,smell,spot,staman,stone,structure,symmetry,sympodial,system,texture,tissue,tuber,type,unit,vegetative,xylopodia,zygomorphy
290	wfo-0001029156	success	65	103	41	24	62	0.631	0.5,1,2,<,almost,apex,berry,cell,center,completely,deeply,flattened,fruiting,glabrous,golden,growth,lateral,liana,margin,minute,minutely,mm,multiseriate,new,pale,pedicel,pitted,rectangular,reniform,rib-like,seed,shiny,sinuate,stem,surface,tan,thickening,trichome,vine,wall,woody	-3,1.5-2,10-12,4-6,6-8,apparently,ark,cm,diameter,eed,em,epiphytic,exfoliating,fide,lon,markedly,nee,noddin,occasionally,older,per,shreddy,testal,x	anther,appressed,articulation,base,bract,branching,breeding,broad-based,calyx,colour,connective,corolla,filament,form,fruit,hair,heteromorphism,inflated,inflorescence,insertion,interjected,interpetalar,leaf,leaflet,length,long,lower,marking,mature,modification,needle-like,nodding,null,odour,orientation,paired,pattern,petiole,placement,pore,position,prickle,pseudostipule,rhizome,scale,shape,smell,spot,staman,stone,structure,symmetry,sympodial,system,texture,tissue,tuber,type,unit,vegetative,xylopodia,zygomorphy
291	wfo-0001029163	exception_thrown	149	0	0	149	0	0.0		-25,-4,-9,0.3-2.5,0.5-1,1,1-2,1.5-2,1.5-2.5,1.5-3,10-,13-18,2,2-18,2-3,2-6,2-7,2.5-3,20-30,3-14,3-4,3-5,4-20,4-5-foliat,4-6,4.5-23,5-12,5-8,7-9,9-15,abaxial,abaxially,absen,acuminate,acute,adaxiall,adaxially,aggregate,apart,apex,articulated,axe,band,base,blade,calyx,cell,chartaceous,cm,color,connivent,cuneate,cylindrical,decurrent,deltate,densely,denser,diameter,directed,distall,distally,eaf,eed,eglandular,elliptic,elliptic-ovate,entire,flower,free,fruit,glabrous,glandular,globose,hair,herb,lanceolate,leaving,lenticular,like,lobe,lon,long,lower,margin,mm,moderately,narrowed,narrowly,nearly,nflorescence,nther,obtuse,orolla,papillose,pedicel,pedicellar,peduncle,perennial,petiole,pore,projection,pseudohair,puberulent,puberulent-pubescen,puberulent-pubescent,pubescence,purple,rachi,radiu,remnant,ripe,roughened,ruit,scale-like,shrub,simple,slightly,small,sometimes,spaced,sparsely,stalked,stellate,stem,stigma,stone,style,subapical,subcoriaceous,surface,tal,tem,thickened,time,tip,triangular,truncat,tube,unbranched,unit,unknown,vary,vein,white,whitish,wide,x,yellow,ympodial	
292	wfo-0001029171	success	137	120	60	77	60	0.438	1-3,1-4.5,1.5-2,1.5-7.5,3.5-18,5-8,6-,abaxially,adaxially,aggregate,also,apex,articulated,base,blade,branched,calyx,cell,chartaceous,cm,connivent,cuneate,decurrent,dendritically,densely,directed,eglandular,entire,forked,fruit,gland,globose,hair,lanceolate,like,lower,margin,mm,moderately,often,orange,pedicel,petiole,pore,pubescent,purple,rarely,red,ripe,short-stalked,shrub,simple,slightly,sometimes,stellate,stone,unbranched,unit,white,x	-,-10,-15,0.5,1-5,10-25,10-35,11-20,2-3,3-4,3.5-6.5,4-10,4-5,5-6,7-9,8-17,abruptly,absen,acuminate,acute,and/or,angled,apart,axe,ba,cylindrical,deltate,dense,diameter,distall,eaf,eed,elliptic,except,flower,glabrous,glandula,glandular,lobe,long,many-foliat,midrib,narrowed,narrowly,near,nearly,nflorescence,nther,obtuse,orolla,ovate-elliptic,peduncle,perfect,puberulent,rachi,radiu,rugose,ruit,shoot,smooth,spaced,sparsely,ste,stigma,style,tal,tem,time,tip,triangular,truncat,tube,usually,vary,wide,yellow,ympodial	absent,anther,appressed,articulation,bract,branching,breeding,broad-based,colour,connective,corolla,distally,filament,form,fruiting,growth,heteromorphism,inflated,inflorescence,insertion,interjected,interpetalar,leaf,leaflet,length,many-foliate,marking,mature,mentioned,modification,needle-like,odour,orientation,paired,pattern,placement,position,prickle,pseudostipule,rhizome,scale,shape,smell,spot,staman,stem,structure,surface,symmetry,sympodial,system,tall,texture,tissue,trichome,tuber,type,vegetative,xylopodia,zygomorphy
293	wfo-0001029215	success	49	97	29	20	68	0.592	0.5-2.5,1,brown,calyx,cell,coarse,diameter,elongating,fide,fruit,hair-like,herb,lateral,lobe,markedly,obovate,outgrowth,pubescent,shrub,small,smelling,strong,surface,tall,testa,wall,weigend,woody,xyledecor	-1.8-2.3,.2,0.3-0.5,0.5-0.7,2.3-2.9,appearance,border,cm,eed,entire,give,long,mm,narrowly,round,silky,spreadin,thick,wide,winged	anther,apex,appressed,articulation,base,bract,branching,breeding,broad-based,colour,connective,corolla,filament,form,fruiting,growth,hair,heteromorphism,inflated,inflorescence,insertion,interjected,interpetalar,leaf,leaflet,length,lower,margin,marking,mature,modification,needle-like,null,odour,orientation,paired,pattern,pedicel,petiole,placement,pore,position,present,prickle,pseudostipule,rhizome,scale,seed,shape,smell,spot,spreading,staman,stem,stone,structure,symmetry,sympodial,system,texture,tissue,trichome,tuber,type,unit,vegetative,xylopodia,zygomorphy
294	wfo-0001029216	exception_thrown	243	0	0	243	0	0.0		+,-0.5,-10,-5,.5,.8-1,0.1-0.3,0.1-0.5,0.1-0.6,0.1-0.8,0.2-0.25,0.2-0.3,0.2-0.4,0.2-0.8,0.3-0.4,0.3-0.5,0.3-2,0.4,0.4-0.5,0.5,0.5-0.8,0.5-1.5,0.5-2,0.6-0.8,0.6-1,0.8-2.5,1-1.2,1-2,1-3,1-4,1-6,1.2-6,1.5-2.3,1.5-2.5,1.5-3,1/,10,10-,10-14,2,2-4.5,2-locular,2.5-3.3,20-35,3,3-,3-4,3-5,3-7,3-foliate,4,5,5-15-flower,6-10,7-10,<,absen,absent,accrescent,acroscopically,acute,adpressed,allogamous,always,and/or,angeld,annual,anther,anthesi,apex,apical,appearance,appendage,articulated,articulation,attenuate,axi,basal,base,basiscopically,becoming,biennial,branch,bright,brown,calyx,capitate,cell,cente,cm,column,composed,cone,conical,cordate,corolla,crenate,cultivar,decurrent,deep,deeply,dentate,diameter,distal,eaf,edicel,eed,elliptic,entire,erect,exserted,extending,facultatively,fasciated,filament,fruit,fruited,fruiting,giving,glabrescent,gland-tipped,glandular,globose,gree,green,hair-like,half,halfway,herb,imparipinnate,included,inflorescence,initially,interjected,internode,interrupted,lanceolate,large,larger,later,lateral,leaflet,length,less,like,linear,lobe,lobulate,lon,long,longer,lower,mainly,margin,maturity,minute,minutely,mixture,mm,multicellular,multilocular,narrowly,near,nflorescence,numerous,oblique,obovate,often,one,orange,outgrowth,ovary,ovate,pair,pale,particularly,pedicel,peduncle,pentagonal,perennial,petiole,petiolule,plant,population,present,primary,procumbent,pseudostipule,pubescent,rarely,red,reflexe,ruit,scen,secondary,sessile,shaggy,shape,shaped,short,silky,simple,sometimes,somewhat,sparse,sparsely,spreading,staminal,stem,sterile,stigma,straight,strong,strongly,style,surface,tangled,tem,terminal,tertiary,testa,thick,thickening,tip,total,toward,trichome,truncate,tube,ud,unicellular,uniseriate,unit,usually,variety,varying,villous,viny,wall,wide,winged,yellow,ympodial	
295	wfo-0001029226	exception_thrown	206	0	0	206	0	0.0		-7,-9,.5,.75,0-1,0.5,0.5-5,1-1.5,1-2,1-3,1-celled,10-40+,2,2-3,2-6,2-9,2.5-10,3-3.5,3-6,30,4,4-6,5-7,5-merou,7-11,8-13,>,acuminate,acute,ag,alyx,anther,anthesi,apart,apex,apparently,ark,articulated,ba,basal,base,berry,black,blue,branched,breaking,bright,calyx,capitate,cell,cm,completely,congested,conical,connivent,cordate,corolla,dark,decurrent,deltate,densely,diameter,distall,divided,dry,eaf,eed,ellipsoid,elongate,enation,entire,exserted,filament,flattened,flexuous,flower,free,fruiting,glabrescent,glabrous,gland,glandular,globose,green,growth,hairy,herbaceous,ilament,irregularly,juice,lateral,lavender,leaf,lengthening,like,lobe,lobed,long,longer,loosely,lower,lyrate,many,margin,material,mature,membranous,mere,minute,minutely,mm,new,nflorescence,occasionally,often,older,one,open,orolla,overtopping,pair,pale,papillat,papillate,papillo,pedicel,peduncle,per,perfect,petiole,pinnate,pinnatifid,pitted,plurifoliat,pore,poricidal,portion,primary,pubescent,red,reflexed,remainin,reniform,rim,ripe,ruit,sagittate,scar,scarlet,seed,shiny,short-glandular,shorter,shrub,simple,sleeve,slender,slit,small,sometimes,spaced,sparsely,spot,sprawling,spreadin,spreading,staining,stellate,stem,stigma,strongly,style,surface,tan,tangled,tem,terminal,testal,thin,third,time,tip,translucent,trichome,truncate,tube,twinin,ud,uniformly,uniseriate,unit,usually,vary,vein,vine,wall,way,weak,white,wide,widest,winged,woody,yellowish,ympodial,Â¾	
296	wfo-0001029236	exception_thrown	159	0	0	159	0	0.0		.5,0.2-0.7,0.2-1,0.45-0.5,0.5,0.5-1.5,0.9-2.3,1-1.5,1-2,1.4-1.7,1/2,2-4,2-5,3,6-9,abaxially,absent,adaxial,age,anther,anthesi,apex,apical,apically,apparently,appearing,axi,ba,bark,basal,base,becoming,berry,bi-lobe,branch,branching,branchlet,broadly,calyx,cm,compact,completely,conical,coriaceous,corolla,cupulate,decurrent,deflexed,deltate,dendritic,densely,diameter,dichasial,eaf,edicel,eed,elliptic,erect,ew,except,exserted,filament,flattened,fleshy,flower,free,fruit,fruiting,glabrous,globose,grey-brown,growth,inserted,later,lateral,leaf,lenticular,less,lobe,lobed,long,lower,m.,many,margin,middle,midvein,minutely,mm,narrowly,near,nflorescence,nodding,obscure,obscurely,occasionally,older,ovary,overtopping,packe,pale,pedicel,per,pericarp,persistent,petiole,pitted,plurifoliate,pointed,pore,poricidal,portion,prominent,pubescent,purplish,purplish-black,reddish-brown,revolute,ruit,scar,scattered,secondary,shiny,shoot,short,shrub,simple,sleeve,slightly,slit-like,sparsely,stamen,stem,stigma,strongly,style,surface,tall,tapering,terminal,thin,time,tip,trichome,trongly,tub,tube,ud,unit,usually,venation,violet,way,wide,winged,woody,x,ympodial,young	
297	wfo-0001029246	exception_thrown	209	0	0	209	0	0.0		-1,-1.5,-4,/5,0,0-15,0-5,0.1-0.3,0.1-0.4,0.15-0.3,0.2-1.5,0.3-0.5,0.3-0.8,0.5,0.5-1.5,0.7-1.3,0.7-1.5,0.7-2,0.8-1.1,0.8-3,0.9-1.3,1-1.5,1-1.8,1-10,1-3,1-4,1-5,1-8,1.2-2,1.5-2.3,1.5-2.5,1.5-6,1.7-6,1.8-3,1/10-1/5,1/3,2,2-3,2-3.5,2-5,2.5-3.2,2.8-4,2/3,2/3-3/,3-20,3-5,3.5-5,4-6,5-,5-20,5-merous,6-10,6-8,7-12,8-16,abaxial,abaxially,acuminat,acuminate,acute,adaxial,almost,alyx,anther,apar,apart,apex,apically,apparently,articulated,bark,base,berry,blade,broad-deltate,c.,calyx,chartaceous,cm,concolorous,connivent,cuneate,curved,deltate,densely,diameter,discolorous,distance,drying,dull,eaf,eed,elliptic,elongating,entire,equal,erect,extending,eye,filament,flattened,flattened-reniform,flower,free,fruit,fruiting,glabrescent,glabrous,infructescence,lateral,leaf,length,less,lobe,lobed,lon,long,longer,lower,margin,mature,maturity,mauve,midpoint,midvein,mm,moderately,naked,narrow-deltate,narrow-ovate,nflorescence,oblong,obtuse,older,one,open,orange-brow,orange-brown,orange-red,orolla,oung,pair,pale,pedicel,peduncle,pendulous,per,perfec,pericarp,petiole,plurifoliat,poricidal,porrect,portion,prickl,prickle,prickly,primary,procumbent,pubescent,purple,ray,recurved,rounded,ruit,scar,sessile,shrub,side,simple,smooth,sometimes,spaced,sparsely,spherical,spreading,stellate,stellate-pubescent,stem,stout,straight,strongly,style,surface,tamen,tapering,terete,tertiary,time,tip,trichome,tube,unarmed,unbranched,unit,upper,usually,vary,vein,venation,visible,way,white,wide,woody,yellow,yellow-orange,ympodial,Â¼	
298	wfo-0001029286	exception_thrown	224	0	0	224	0	0.0		.4,.5,0-0.5,0.1,0.15-0.4,0.4-1.2,0.6-1.2,0.8,0Â°,1-1.5,1-2,1.5-2,1.5-4,1.5-8,1/8,15-50,2-3,2.5-3,3-4,4-5,4-6,4.5,4.5-7,5,5-6,6-8,6-9,7-10,abaxial,abaxially,abscising,acute,adaxially,age,almost,along,altered,alyx,another,anther,anthesi,apar,apart,apex,apically,apice,apiculate,apparently,arising,around,articulated,articulation,attenuate,axil,bark,base,becoming,branch,branched,branching,broadly,brown,canaliculate,capitate,chartaceous,clearly,closer,clustered,cm,concave,concolorous,conical,corolla,crenulate,curved,cuspidate,delineated,deltoid,dendritic,density,diameter,dilated,distributed,domatia,drying,eaf,eed,entire,equal,except,extending,faint,fertilization,filament,flat,flexuous,flower,formed,forming,free,fresh,glabrescent,glabrous,globo,green,grey,hair,increasing,inflorescenc,inside,isolated,junction,know,known,lamina,leaf,length,lengthening,less,liana,light,lilac,lobe,lobed,long,lower,m.,main,margi,margin,mas,mauve,meeting,membranous,middle,midvein,minutely,mm,much,multicellular,narrowly,nflorescence,nther,obconical,oblong,obovate,occasional,often,one,orolla,outside,ovate,pair,papillo,pedicel,peduncle,perfec,petiole,plurifoliat,pore,poricidal,portion,primary,prominent,protruding,rachi,raised,rarely,regular,rounded,ruit,scar,separated,shallowly,side,simple,slender,smaller,smooth,sometimes,somewhat,soon,sparsely,specimen,spreading,stem,stigma,stretchy,stump,style,surface,tangled,tearing,terete,terminal,tertiary,textur,thick,thickened,thinner,time,tip,tissue,together,toward,translucent,translucent-violet,trichome,tube,tuft,ud,unarmed,uneven,unit,vary,vein,venation,visible,wide,widely,x,yellowish,ympodial,young	
299	wfo-0001029310	exception_thrown	216	0	0	216	0	0.0		-16,-25,.1,.5,.6,/4,/6,0-20,0-5,0.1-0.2,0.2-0.3,0.2-0.8,0.5,0.5-3,0.6-1.1,00,1,1-1.5,1-2,1-4,1.2-1.5,1.8-3,1/,10,10-13,10-15,10-20,15-20,2-3.5,2-4,2.5-6,2/3-3/4,20-40,20-60,200-500,3-4,3-5,3.5,4-10,4-8,45-60,5,5-10,5-12,5-20,5-30,5-6,5-7,5-8,5-merous,6-8,7-12,7-13,8,abaxially,accrescent,acute,alyx,ame,andromonoecious,anther,apar,apart,apex,apically,apparently,articulated,bark,base,berry,beyond,blade,branched,brown,c.,calyx,cm,concolorous,conical,connivent,cordate,dark,deltate,diameter,difoliate,distal,distance,drying,dull,eaf,eed,elliptic,elongating,enclosing,equal,erect,extending,filament,filifor,flattened-reniform,flower,free,fruit,fruiting,geminat,gently,glabrescent,glabrous,gray,hair,herb,hermaphrodite,heterostylous,inflated,infructescence,lateral,leaf,length,lobe,lobed,lobing,lon,long,long-styled,longer,lower,lowermost,margin,mature,maturity,mauve,membranous,midpoint,midvein,minute,mm,moderately,narrow-deltate,nflorescence,older,one,open,orange-green,ornately,orolla,oung,pair,pedicel,peduncle,pendent,pendulous,per,pericarp,perpendicular,petiole,pinnatifid,plant,poricidal,porrect,portion,prickl,prickle,prickly,primary,ray,recurved,red-brow,retrorse,ruit,scar,secondary,sessile,short-styled,shorter,shrub,side,simple,smooth,sometimes,spaced,sparsely,spherical,spreading,stalk,stalked,staminat,stellate,stellate-pubescent,stem,stout,straight,strongly,style,surface,tamen,tapering,terete,tertiary,time,tip,tissue,toward,trichome,truncate,tube,unit,variously,vary,vein,venation,visible,way,wide,woody,yellow,ympodial	
300	wfo-0001029317	exception_thrown	151	0	0	151	0	0.0		.5,0.25,0.5,0.5-0.75,0.5-1,0.8-1,1,1-1.5,1.5-3.5,10-16,10-30-flowered,11-14,2-3,2.5-5,6-8,6.5-11,7-8,8-9,acuminate,along,anther,anthesi,apar,apex,area,attenuate,barely,base,beneath,broadly,brow,bud,ca,calyx,channeled,closely,cm,corolla,cup-like,deciduou,deflexed,deltoid,densely,denser,dia,differing,difoliate,dry,eaf,edicel,eed,ellipsoi,epidermi,erect,exserted,extreme,filament,free,frui,fruiting,geminate,glabrate,glabrous,globose,grayish,immature,inflorescence,known,lateral,leaf,like,lobe,lobed,lon,long,lower,main,major,margin,middle,minor,minutely,mm,narrowly,nearly,nflorescence,occasionally,often,older,one,opposite,otherwise,ovary,ovate,overlapping,ovoid,pair,paler,papillose,pedicel,petiole,pore,poricidal,portion,probably,prominent,proximal,pubescent,rachi,raised,reflexed,remaining,rest,rounded,ruit,scar,shaped,shrub,simple,size,slender,slightly,soft,soon,spaced,sparsely,specimen,stem,stigma,straight,styl,style,tall,tapering,tear-drop,thickened,tip,trichome,tube,tuft,ud,uniseriate,unit,vein,visible,white,widest,x,yellowish,ympodial,young	
301	wfo-0001029332	success	197	172	121	76	51	0.614	-5,.5,/3,0,0-0.5,0-4,0-5,0.1,0.15-0.2,1-1.5,1.5-2,1/3,1/4,1/4-1/3,10-30,2,2-2.5,2-4,2/3-3/4,3-6,4-15,5-6,6-8,8.5-9.5,abaxial,adaxial,andromonoecious,anther,apart,apex,apically,apparently,base,berry,blade,broad-deltate,calyx,chartaceous,cm,concolorous,conical,connivent,cordate,curved,densely,difoliate,distance,drying,elongating,equal,erect,extending,filament,flattened,free,fruit,fruiting,glabrescent,glabrous,lateral,leaf,length,less,lobe,lobed,long,longer,lower,margin,mature,mauve,midpoint,midvein,mm,moderately,orange-brown,ovate,pair,pale,pedicel,petiole,poricidal,porrect,portion,prickle,primary,pubescent,ray,rounded,scandent,shorter,shrub,side,simple,spaced,spherical,spreading,stalk,stellate,stellate-pubescent,stem,subsessile,surface,tapering,terminal,tertiary,time,tip,trichome,tube,unbranched,unit,vein,venation,visible,way,weakly,wide,yellow,yellow-green,yellow-orange	0-100,0-2,0-20,0.1-0.2,0.15-0.25,0.5-1,0.8-1,1-2,1-3,1-4,1.3-1.5,1/2,2.5-3.5,2.8-3.7,2/,3-4,3.5-5,4-10,5-8,5-merous,abaxially,alyx,apar,articulated,bark,becoming,diameter,distal,eaf,eed,flattened-reniform,flower,geminat,gland,globular,grayi,herbaceous,hermaphrodite,heterostylous,infructescence,long-acuminat,long-styled,lowermost,maturity,narrow-deltate,nflorescence,often,older,one,open,orolla,oung,peduncle,pendulous,per,pericarp,plant,prickl,prickly,reduced,ruit,scar,sessile,short-styled,slender,smooth,stalked,staminat,style,tamen,terete,upper,variously,vary,woody,ympodial	appressed,articulation,bract,branching,breeding,broad-based,cell,colour,connective,corolla,form,geminate,growth,hair,heteromorphism,inflated,inflorescence,insertion,interjected,interpetalar,leaflet,marking,modification,needle-like,null,odour,orientation,paired,pattern,placement,pore,position,pseudostipule,rhizome,scale,shape,smell,spot,staman,stone,structure,symmetry,sympodial,system,texture,tissue,tuber,type,vegetative,xylopodia,zygomorphy
302	wfo-0001029333	exception_thrown	155	0	0	155	0	0.0		.25,.5,/4,0.5,0.5-1,0.7-1,1-1.2,1-1.5,1-15,1-2,1-3,1-7,1.5-2,1.5-2.5,1.5-3,10-15-flowered,100,17-26,2-2.5,3-7,3-7.5,5-6,8-15,9-13,abaxial,abaxially,acuminate,acute,adaxially,along,anisophyllou,anther,anthesi,apex,auriculate,ba,bark,base,beige,beneath,berry,broadly,calyx,clavate,cm,conical,contracted,corolla,deflexed,dendritic,dendritic-pubescent,densely,denser,dia,differing,difoliate,dry,eaf,edicel,eed,elliptic-obovate,erect,exserted,filament,flattened-reniform,flower,free,fresh,fruiting,geminate,glabrous,globose,golden,green,heteromorphic,incrassate,inflorescenc,lateral,leaf,like,lobe,lobed,lon,long,long-styled,lower,main,major,margin,minor,minutely,mm,nflorescence,obovate,occasionally,older,opposite,orbicular,ovary,overlappin,pair,pale,paler,papillo,pedicel,petiole,pitted,planar,pore,poricidal,portion,present,pubescence,pubescent,reddish-brown,rest,rounded,ruit,scar,sessile,shape,shaped,shining,short-styled,shrub,simple,size,slender,small,somewhat,spaced,sparsely,stem,stigma,strongly,style,surface,tall,tear-drop,time,tip,tree,triangular,trichome,truncate,tube,type,ud,unit,vein,way,wide,woody,ympodial,young	
303	wfo-0001029334	exception_thrown	211	0	0	211	0	0.0		.2,0-4,0.15-0.3,1,1-10,1-2,1-3,1-6,1.3-4.5,1.5-3.9,1.5-6,1.8-2.9,2,2-2.5,2-4,2-5,2-8,2.5-3,3-5,3-7,3.2-5.8,3.3-6.5,4-5.5,4-8.5,5-10,5-merou,7.5-15.5,8-30,9-12,abaxially,absent,acumen,acute,adaxially,ag,almost,along,alyx,among,anther,apart,apex,apparently,articulated,attenuate,axe,axillary,base,berry,blade,borne,broadly,brownish,bud,capitat,cell,chartaceous,ciliate,clavate,cm,condition,connivent,cordate,corolla,covering,cuneate,decreasing,decurrent,densely,diameter,digestion,distal,dorsally,drying,eaf,edge,eed,elliptic,end,enzyme,erect,especially,exceeding,except,filament,flat,flower,folded,forked,fresh,fruit,geminat,generally,glabrou,glabrous,globose,gradually,grassland,greatly,green,green-white,greenish,hair,hair-like,half,herb,homostylous,honeycomb-shaped,interjected,lanceolate,lateral,leaflet,lengthening,like,living,lobe,long,low-growin,lower,make,margin,membranous,middl,midrib,minutely,mm,mucilaginous,narrowly,nflorescence,oblique,obtuse,odd-pinnate,often,orbicular,orolla,ovate,ovoid,pair,pedicel,peduncle,perfect,petiole,petiolulate,petiolule,plant,plurifoliate,pore,poricidal,proximal,puberulent,pubescent,pure,rarely,reduced,removed,ripe,rounded,ruit,seed,semi-rosette,sessile,seudostipule,shady,short,singly,situation,size,slightly,slit,spaced,specimen,stamen,ste,stellate,stem,stigma,stolo,straight,style,subequal,subsessile,subtending,sunny,tall,tamen,tem,terminal,testal,thick,throughout,tinged,tip,toward,tri-,tube,tuber,typically,unit,unwinged,usually,vary,violet,wall,wet,white,whitish,wide,woodland,x,yellow,ympodial	
304	wfo-0001029344	success	147	121	64	83	57	0.435	0.5-1,0.5-1.5,1,1.5-3,1.5-4,abaxially,abundant,adaxially,anther,apex,base,berry,brown,calyx,chartaceous,ciliate,cm,cordate,decurrent,densely,difoliate,dm,drying,elliptic,elliptic-ovoid,entire,filament,fruit,glabrous,globose,hair,herb,immature,interpetalar,lower,margin,maturing,membranaceous,mm,moderately,nearly,oblong,obtuse,often,pedicel,petiole,pubescent,rhizomatous,rotate,rounded,semitransparent,slightly,sometimes,sparsely,straight,surface,tissue,two-celled,unbranched,unit,white,woody,x,yellow	.5,0.4-1,0.5-3,1-2,1-3,1-5,1-6,1.5,10-20,10-35,2-3,2-3-celled,2-4,2-7,3-10,4-6,5-12,5-15,absent,acute,adaxiall,along,axe,beyond,blade,center,connected,dehiscing,denser,diameter,eaf,edge,eed,emarginat,equal,explosively,exserted,fine,flat,flower,frui,geminat,held,lacking,linear-lanceolate,lobe,long,lying,maturit,mesocarp,nflorescence,notch,obvious,one-,orolla,parallel,peduncle,per,placenta,pressure,pubescen,rachi,radiating,raised,ridge,ruit,running,shallow,short,stamen,stigma,style,swollen,tal,tamen,tem,triangular,tube,vary,vein,watery,wid,ympodial	appressed,articulation,bract,branching,breeding,broad-based,cell,colour,connective,corolla,emarginate,form,fruiting,geminate,growth,heteromorphism,inflated,inflorescence,insertion,interjected,leaf,leaflet,length,marking,mature,modification,needle-like,null,odour,orientation,paired,pattern,placement,pore,position,prickle,pseudostipule,rhizome,scale,shape,smell,spot,staman,stem,stone,structure,symmetry,sympodial,system,tall,texture,trichome,tuber,type,vegetative,xylopodia,zygomorphy
305	wfo-0001029363	exception_thrown	152	0	0	152	0	0.0		.25,.75,/4,0-0.1,0.1-0.5,0.2-1.1,0.5,0.5-1,1,1-1.2,1.5-1.7,1.5-3.5,2-6,3-7,4-11,5-7-flowered,6-7,6-8,7-10,acuminate,acute,anther,anthesi,apex,axil,ba,bark,base,becoming,beginning,beneath,berry,bi-lobed,bud,calyx,capitate,closely,cm,coroll,corolla,cup-shaped,deep,deflexed,deltoid,densely,dia,drying,eaf,edge,edicel,eed,elliptic,erect,except,exsertion,filament,free,fruit,fruiting,glabrous,globose,green,greyish,immature,inflorescenc,internodal,known,lamina,larger,later,lateral,leaf,lobe,lobed,lon,long,lower,main,margin,maroon,mature,meeting,middle,minute,minutely,mm,much,narrowly,near,nflorescence,obtuse,occasionally,often,older,opposite,ovary,overlapping,pair,pale,paler,papillo,papillose,pedicel,petiole,pore,poricidal,portion,prominent,pubescent,reflexed,ruit,scar,shiny,shrub,simple,slender,slit-like,small,somewhat,spaced,sparse,sparsely,stem,stigma,straight,style,surface,tall,tapering,terminal,thickened,tip,tree,trichome,tube,tuft,ud,unifoliat,uniseriate,unit,upon,usually,vein,way,white,white-papillose,wide,widest,woody,yellowish,ympodial,young	
306	wfo-0001029364	exception_thrown	153	0	0	153	0	0.0		-2,-3,-6,.5,0.2-0.5,1,1-,1-3,1-4,1-5,1.5-2,10-27,191.,2,2-,2-6,2-foliat,3-4,4-12,4-9,5-,5-11,5-9,6-8,7-9,8-10,8-15,?,abaxially,according,acuminate,acute,adaxially,aggregate,anther,apart,apex,around,articulated,axe,ba,base,bitter,blade,blue,calyx,cell,center,chartaceous,cm,color,connivent,corolla,cream,cuneate,curled,cylindrical,darker,deep,diameter,directed,distall,distally,eaf,ed,elliptic,entire,extra-axillary,fide,filament,finger,flower,free,fruit,glabrous,gland-tipped,glandular-puberulen,globose,green,greenish,hair,herb,immature,inserted,lobe,long,lower,major,margin,membranaceous,mesocarp,minutely,mm,moderately,narrowly,nearly,nflorescence,obtuse,orolla,ovate,part,pedicel,peduncle,perfect,petiole,pore,presence,present,puberulen,puberulent,pubescent,rachi,radiu,ripe,ruit,rusby,sagittate,shallow,short-tomentose,shorter,shrub,side,simple,small,spaced,sparsely,spot,stellate,stigma,stone,strongly,style,tal,tamen,tapered,tem,thecae,tightly,time,tomento,triangular,truncat,tube,unbranched,unit,unknown,vary,vein,white,wide,x,yellow,ympodial	
307	wfo-0001029368	exception_thrown	139	0	0	139	0	0.0		.2,.25,.5,0,0.5-2,0.9-1,1.5-1.6,1.5-2,1.5-3,1.5-4,11-13,16-25,2-5,2.5-4,5-6,?,abaxially,acuminate,acute,adaxially,along,anther,anthesi,apex,apparently,bark,base,bearing,berry,bitter,borne,breaking,broadly,brow,calyx,capitate,closely,cm,coarse,conical,corolla,crumpled,cup,deflexed,densely,dia,distal,eaf,edicel,eed,elliptic,erect,exserted,few-branched,fide,filament,flattened,flower,free,fruit,fruiting,glabrous,globose,golden,green,half,herb,indistinct,inflorescenc,inflorescence,internodal,known,lamina,lanceolate,lateral,leaf,leaving,like,lobe,long,lower,main,margi,margin,middle,midrib,minute,minutely,mm,nflorescence,non-flower,obtuse,older,one,opposite,ovary,overlappin,pair,papillo,papillose,parallel,pedicel,petiole,pore,poricidal,portion,puberulent,reflexed,rest,ruit,scar,shaped,shrub,simple,somewhat,spaced,stem,stigma,straight,strongly,style,tall,tear-drop,tip,trichome,tube,ud,unifoliat,uniseriate,unit,upper,vein,white,widest,winged,woody,x,ympodial,young	
308	wfo-0001029370	exception_thrown	224	0	0	224	0	0.0		-20,-32,.1,.3,.5,/4,0-10,0-100,0-3,0-35,0.1,0.1-0.15,0.2,0.3,0.5-1,0.5-2.2,1,1-2,1-3,1-4,1.5-6,1.8-2.5,1.8-2.8,1/3-1/2,1/4-1/3,10-17,10-40,10-50,12-17,15-30,2-10,2-20,2-3,2-6,2.5-3.5,3-4,3.5-4,3.5-8,3/,4-6,4-7,4-9,5-10,5-12,5-merous,5.5-7,6-15,7-11,7-13,8-14,8-20,8-23,abaxial,abaxially,acut,adaxial,almost,alyx,ame,andromonoecious,anther,apar,apart,apex,apically,apparently,articulated,bark,basal,base,berry,blade,branched,broad-deltate,c.,calyx,chartaceous,clearly,cm,conical,connivent,cordate,cream,curved,dark,densely,diameter,discolorous,distal,distance,drying,eaf,eed,elongate,elongating,equal,erect,extending,fewer,filament,fine,flattened,flattened-reniform,flower,free,fruit,fruiting,fully,gently,glabrescent,glabrous,green,greenish,herb,hermaphrodite,heterostylous,infructescence,lateral,leaf,length,lobe,lobed,long,long-styled,longer,lower,lowermost,margin,marking,mature,maturity,mauve,midpoint,midvein,mixture,mm,moderately,multangulate,nflorescence,obtuse,often,older,one,open,opening,orange,orange-brown,ornate,orolla,oung,ovate,overlapping,pair,pale,pattern,pedicel,peduncle,pendulous,per,pericarp,perpendicular,petiole,plant,plurifoliat,poricidal,porrect,portion,prickl,prickle,prickly,primary,ray,red-brown,reticulate,rotate,rounded,ruit,scar,sessile,shiny,short-styled,shrub,side,simple,slightly,smooth,sometimes,spaced,spherical,spreading,stalk,stalked,staminat,stellate-pubescent,stem,stout,straight,strongly,style,surface,tamen,tapering,terete,tertiary,time,tip,trichome,tube,unarmed,unit,variously,vary,vein,venation,visible,way,white,white-gra,whitish,wide,woody,yellow,ympodial,young	
309	wfo-0001029373	exception_thrown	199	0	0	199	0	0.0		.0â1.2,.2,.3,.5,.5â2.0,0.3â0.5,0.4â1.6,0.5â1.2,0.5â1.8,0.6â0.7,1.0â1.2,1.0â1.6,1.2â1.5,1.3â2.2,1.4â3.5,1.5â2.0,1.5â2.5,1.5â2.7,1.8â2.0,1.8â2.3,180Â°,2-celled,2.0â2.5,2.7â3.0,20â30,2â4-celled,3,3.5â4.0,30â40,3â5,4â5,4â6,5,5-merous,5â6,6.8,8â9,abaxial,abaxially,accrescent,acuminate,acute,adaxial,adaxially,age,anther,anthesi,apar,apex,appearanc,appressed,arising,articulated,bark,basal,base,bayonet,berry,beyond,broadly,bud,calyx,capped,cell,clavate,cm,cone,conical,corolla,curved,deltate,densely,developing,diameter,distal,eaf,eed,ellipsoid,elongate,enclosed,enclosing,entire,exerted,filament,finger,flattened-reniform,flower,free,fruit,fruiting,fully,geminat,glabrous,glandular-tipped,globose,green,grey-brown,growth,hair,half,halfway,herb,hilum,immature,individual,internodal,lateral,laterally,leaf,lengthening,less,like,live,lobe,lobed,lon,long,lower,margin,mature,mesocarp,middle,minute,minutely,mm,moderately,mouth,new,nflorescence,node,obtuse,older,outline,ovary,ovate-lanceolate,pair,papillate,pedicel,peduncle,pentagonal,per,perfect,petiole,pitted,plant,plurifoliate,pore,poricidal,portion,positioned,primary,pubescent,reflexed,resembling,root,rounded,ruit,scar,seen,seudostipule,shallowly,shape,short,simple,slightly,slit,smoot,spaced,spreading,stellate,stem,stigma,still,straight,style,surface,tall,tem,terete,testal,thicker-walled,tip,trailing,trichome,tub,tube,ud,uniseriate,unit,upper,vein,white,wide,woody,yellow,yellow-green,yellowish,ympodial,â5	
310	wfo-0001029402	success	113	98	38	75	60	0.336	0.5-2,1-2.5,2,4-8,6-16,acute,apex,base,blade,branched,calyx,ciliolate,cm,elliptic,fleshy,glabrous,hair,inrolled,long,lower,margin,narrowly,often,pedicel,petiole,pore,shrub,simple,somewhat,stellate,surface,tapered,thickened,time,unit,violet,wide,x	0.5-1,11-17,15-30,2-10,2-3,3-4,3-5,3-6,4-6,4-7,5-25,7-11,7-8,7-9,8-15,abaxial,abaxially,acuminate,adaxially,apart,articulated,axe,band,chartaceous,color,connivent,cylindrical,deltate,denser,diameter,directed,distall,eaf,eed,flower,forked,free,glabrate,glabrou,lanceolate,leaving,lobe,many-foliat,mm,moderately,narrowed,nearly,nflorescence,nther,orolla,papillose,peduncle,pubescence,pubescent,rachi,rachise,radiu,roughened,ruit,scale-like,scar,spaced,sparsely,stigma,style,tal,tem,tip,triangular,truncat,tube,unknow,unknown,vary,ympodial	anther,appressed,articulation,bract,branching,breeding,broad-based,cell,colour,connective,corolla,filament,form,fruit,fruiting,growth,heteromorphism,inflated,inflorescence,insertion,interjected,interpetalar,leaf,leaflet,length,many-foliate,marking,mature,modification,needle-like,null,odour,orientation,paired,pattern,placement,position,prickle,pseudostipule,rhizome,scale,shape,smell,spot,staman,stem,stone,structure,symmetry,sympodial,system,tall,texture,tissue,trichome,tuber,type,vegetative,xylopodia,zygomorphy
311	wfo-0001029404	exception_thrown	154	0	0	154	0	0.0		-1.5,-10,-3,-5,0-60-flower,0.5-1,1,1-4,1.5-2,15-25,2,2-3,2-4,2-5,2-8,2.5-22,2.5-3,20-35,3-4,3-5,3-8.5,4-foliat,5-10,5-20,5-24,5-6,6-8,6-9,6.5-34,8-12,abaxially,absent,acuminate,acute,adaxially,aggregate,anther,apart,ape,apex,apiculate,articulated,auriculate,axe,basal,base,beyond,blade,branched,calyx,cell,center,chartaceous,cm,connective,connivent,cordate,cream,cylindrical,dark,darker,deltate,densely,diameter,directed,distally,eaf,eed,eglandular,ellipsoidal,entire,exserted,flattened,fleshy,flower,fruit,glabrous,glandular,glandular-puberulen,green,hair,lanceolate,leaving,lemon,less,light,lobe,lon,long,longitudinal,lower,margin,mm,moderately,mottling,narrowly,nflorescence,nther,obtuse,orang,orange,orolla,ovate,ovoid,pedicel,pedicellar,peduncle,perfect,petiole,pink,pore,presen,puberulent,pubescent,purple,rachi,radiu,remnant,ripe,ruit,shorter,shrub,simple,slightly,small,somewhat,spaced,sparsely,star,stellate,stigma,stone,style,subcoriaceous,tal,tem,thecae,time,tomento,toward,tree,triangular,truncat,tube,ud,unbranched,unit,vary,vein,white,wide,x,yellow,ympodial	
312	wfo-0001029406	exception_thrown	136	0	0	136	0	0.0		.5,0.3-1,0.5-1,0.6-1,0.7-1.5,1-1.5,1-10,1-2,1.5-2.2,1.5-2.5,1.5-5,2,2-11,2-3,2.5-3.5,28,3-9,30,4-18,4-6,7-12,abaxially,acute,adaxially,along,anther,anthesi,apex,arachnoid,arachnoid-pubescent,ba,bark,base,berry,broadly,brown,brownish,bullate,calyx,clavate,cm,conical,conspicuously,corolla,dark,deciduous,deflexed,deltate,densely,dia,differing,difoliate,dry,eaf,eed,elliptic,felt-like,filament,free,fruiting,geminat,glabrous,globose,grayish-brown,grayish-green,green,greenish-white,impressed,large,lateral,leaf,lenticel,lilac,lobe,lobed,lon,long,lower,main,major,margin,matted,maturity,middle,minor,minutely,mm,nearly,occasionally,often,older,ovary,ovoid,ovoid-reniform,pair,pale,papillo,papillose,pedicel,petiole,pitted,planar,pointed,population,pore,poricidal,portion,pubescent,ruit,shaped,shiny,shrub,size,slightly,small,soon,stem,stigma,style,surface,tall,tear-drop,tinge,tip,tree,trichome,tube,unit,vein,waxy,white,wide,widest,woody,ympodial,young	
313	wfo-0001029407	success	208	165	114	94	51	0.548	-10,-2,-25,-7,.5,/3,0-2,0-4,0-5,0.15-0.4,0.2-0.3,0.5-2,1,1-3,1-4.5,1/3,1/3-1/2,1/8-1/5,2-4,2-5,2.5-3,4-15,4.5-6,7-8,acute,anther,apart,apex,apparently,base,berry,blade,bright-red,calyx,chartaceous,cm,cuneate,curved,dark,densely,difoliate,discolorous,drying,elliptic,elongating,entire,equal,erect,evenly,filament,flattened,free,fruit,fruiting,geminate,glabrous,green,green-brown,lateral,leaf,length,lobed,long,longer,lower,margin,mature,maturity,mauve,midpoint,mm,obtuse,orange,ovate,pale,pedicel,peduncle,petiole,poricidal,porrect,portion,prickle,pubescent,rarely,ray,rounded,shorter,shrub,simple,smooth,sometimes,spaced,sparsely,spherical,stalk,stalked,stellate,stellate-pubescent,stem,straw-yellow,strongly,surface,tapering,time,tip,trichome,tube,unbranched,unit,way,white,wide,yellow-green,young	-4,-6,0,0-15,0.1-0.2,0.1-0.25,0.4-0.7,0.4-1,0.5-0.7,0.5-1.5,0.6,0.6-0.9,0.7-1.2,1-1.4,1-2,1-4,1.5,1.8-2.5,1/5,2-3,3-4,3-6,3.5-4.5,4-9,5-7,5-merous,6-13,6-20,abaxial,abaxially,acut,adaxial,almost,alyx,apar,apically,articulated,bark,brow,connivent,deltate,diameter,dull,eaf,eed,flattened-reniform,flower,geminat,glabrescent,gray-greenish,infructescence,lengt,lobe,moderately,nflorescence,occasionally,older,one,open,orange-brown,orolla,oung,pair,pendulous,per,perfec,pericarp,prickl,prickly,primary,recurved,reflexed,ruit,scar,sessile,side,slender,spreading,stout,straight,style,tamen,terete,tertiary,thick,upper,vary,vein,venation,visible,weakly,woody,yellow,ympodial	appressed,articulation,bract,branching,breeding,broad-based,cell,colour,connective,corolla,form,growth,hair,heteromorphism,inflated,inflorescence,insertion,interjected,interpetalar,leaflet,marking,modification,needle-like,null,odour,orientation,paired,pattern,perfect,placement,pore,position,pseudostipule,rhizome,scale,shape,smell,spot,staman,stone,structure,symmetry,sympodial,system,texture,tissue,tuber,type,vegetative,xylopodia,zygomorphy
314	wfo-0001029408	success	244	181	127	117	54	0.52	-4.5,.2-3.5,/10,0.9-1.6,1-8,1.8-3.5,1/4,11-31,2-12,2.2-3.7,3-5,3.5-5,4-14,abaxially,accrescent,acute,adaxially,anther,apex,apical-lateral,articulated,axillary,base,becoming,berry,blade,blunt-tipped,branched,broadly,calyx,cm,continued,corolla,cuneate,dark,dehiscing,dendritic-multangulate,densely,due,echinoid,elliptic,entire,extend,few-rayed,filament,fleshy,free,fruit,fruiting,glabrous,globose,green,growth,hair,high,homostylous,indument,interpetalar,introrse,lacking,lanate,large,lateral,leaf,length,lilac,lobe,long,long-stalked,longitudinal,lower,margin,mixed,mm,mostly,multangulate,oblong,obtuse,often,ovate,overlapping,pale,part,partly,pedicel,persistent,petiole,plurifoliate,pore,porrect-stellate,present,pseudo-terminal,purplish,rarely,rather,ripe,rotate-stellate,sessile,short-,short-attenuate,short-stalked,shrub,simple,slightly,slit,small,stem,subovate,thick-stalked,thick-textured,thin-stalked,time,tissue,tomentose,touching,tree,unarmed,unit,usually,velutinous,well,white,whitish,wide,x,yellow,yellowish	-1.5,-10.5,0,0-100,0.2-0.3,0.3-5,0.5-2.5,0.7-1.2,0.9-1.3,1.1-1.5,1.4-1.9,1.5-3,1.6-2.8,1.7-2.4,1/2,1/2-3/4,2-3.5,2-4,2-5,2.5-7,2/3,4-20,4-7.5,5-24,5-6,5-6.5,5-8,5-merou,7-12,acuminate,adaxiall,ag,alyx,anthesi,apart,axe,ba,barely,bark,branch,brown,bud,capitat,chartaceous,clavate,conical,decurrent,deltoid,dendritic-echinoi,develope,diameter,directed,distal,distall,eaf,echinoi,eed,exserted,faintly,flower,gray,honeycombed,inserted,lanceolate,lobed,long-,long-attenuate,m.,main,many,midvein,moderately,near,nearly,nflorescence,obscured,older,orbicular,orolla,ovate-lanceolate,peduncle,perfect,pubescent,rachi,ray,relatively,reniform,reticulate-punctate,ribbed,ruit,runk,side,sometimes,spaced,stamen,stelliform,stigma,style,subcampanulate,suborbicular,suture,tamen,terete,testa,thick,tomentu,tomentum,top,toward,tube,turbinate,unarme,vary,vein,way,ympodial,young	5-merous,age,appressed,articulation,bract,branching,breeding,broad-based,cell,colour,connective,dendritic-echinoid,developed,form,heteromorphism,inflated,inflorescence,insertion,interjected,leaflet,long-and,marking,mature,modification,needle-like,null,odour,orientation,paired,pattern,placement,position,prickle,pseudostipule,rhizome,scale,shape,short-to,smell,spot,staman,stone,structure,surface,symmetry,sympodial,system,texture,trichome,tuber,type,vegetative,xylopodia,zygomorphy
315	wfo-0001029417	exception_thrown	213	0	0	213	0	0.0		.5,0-7,0.2-0.6,0.4-8,0.7-3,1,1-1.5,1-10,1-2,1-4,1-8,1.3-8,1.5-1.8,1.5-10,1.5-8,12,2-4,2.5-10,2.8-3.5,3-14,3-5,4-7,5-15,5-merou,6-11,8-15,8-9,abaxially,acumen,acuminate,acute,adaxially,ag,along,alyx,anther,apart,apex,apiculate,apparently,articulated,attenuate,axe,axillary,base,basiscopic,berry,blade,blue,borne,broadly,brownish,bud,capitat,cell,central,chartaceous,ciliate,clavate,cm,coarsely,condition,connivent,corolla,covering,dark,decreasing,decurrent,deep,diameter,digestion,distal,dorsally,dot,drying,eaf,edge,eed,end,enzyme,erec,erect,especially,exceeding,filament,flat,flower,folded,forked,fresh,fruit,geminat,generally,glabrou,glabrous,globose,greatly,green,green-white,greenish,hair,hair-like,hal,half,herb,homostylous,honeycomb-shaped,interjected,lanceolate,lateral,leaflet,lengthening,like,linear,living,lobe,long,lower,lunate,make,margin,medium,membranous,midrib,minute,minutely,mm,moderately,mucilaginous,narrowly,nflorescence,non-glandular,odd-pinnate,often,orbicular,orolla,ovate,ovoid,pair,pedicel,peduncle,pentagonal,perfect,petiole,petiolulate,pilose,plant,plurifoliate,pore,poricidal,puberulent,pubescent,purple,rapidly,rarely,removed,ripe,rotate,rounded,ruit,scattered,seed,sessile,seudostipule,short,short-petiolulate,side,singly,size,slightly,slit,sometimes,spaced,specimen,stamen,star,ste,stem,stigma,stolo,straight,style,subequal,subtending,tall,tamen,tem,terminal,testal,thick,throughout,tinged,tip,tri-,trichome,tube,tuber,typically,unit,unwinged,usually,vary,violet,wall,wet,white,whitish,wide,widely,wing,x,yellow,ympodial	
316	wfo-0001029461	success	217	191	141	76	50	0.65	-1.5,-2,-3,-3.2,-3/4,-5,.5,0,0.1,0.1-0.25,0.15-0.25,0.6-1,0.7-1,0.8,1-,1-2,1-6,1.3-2.2,1.5-,1.5-2,1/3-2/3,1/4,1/4-1/2,2-4,3-20,4.7-7.2,5-10,7-10,8-9,abaxially,ame,andromonoecious,anther,apart,apex,apically,attenuate,bark,base,becoming,berry,blade,breaking,brittle,brown,c.,calyx,cell,chartaceous,cm,concolorous,cuneate,curved,dark,densely,discolorous,distance,drying,dull,elliptic,elongating,erect,evenly,extending,fifth,filament,flattened,four,free,fruit,fruiting,glabrescent,glabrous,green,heterostylous,leaf,length,lobe,lobed,long,longer,lower,margin,mature,maturity,mauve,midpoint,midvein,mm,moderately,oblong,obovate,older,orange,ovate,pedicel,petiole,poricidal,porrect,portion,prickle,prickly,ray,reddish,reduced,reflexed,rounded,sessile,shallow,shrub,side,simple,slightly,sometimes,spaced,sparsely,spherical,stalk,stalked,staman,stellate,stellate-pubescent,stem,straight,subentire,surface,terete,time,tip,trichome,tube,unarmed,unequal,unit,variously,way,weakly,wide,yellow,young,zygomorphic	-14,-4,-4.5,0.8-1.5,1-1.6,1-3,1-4,1.2-1.7,1.2-1.8,1/3,2-2.4,2-2.8,2-3,2.5-3,3-6,4-10,4-6.5,4-7,4.5-7,5-25,5-merous,7-12,acuminat,almost,alyx,black,broad-deltate,diameter,distal,eaf,eed,faint,fine,flattened-reniform,flower,gra,hermaphrodite,infructescence,lengt,long-styled,lowermost,obtuse,orolla,oung,outline,pair,pendulous,per,pericarp,pit,plant,plurifoliat,prickl,primary,raised,ruit,shiny,short-styled,shorter,slender,small,smooth,spreading,staminat,strongly,style,tamen,tertiary,unarme,upper,vary,vein,venation,visible,woody,ympodial	appressed,articulation,bract,branching,breeding,broad-based,colour,connective,corolla,form,gray,growth,hair,heteromorphism,inflated,inflorescence,insertion,interjected,interpetalar,leaflet,marking,modification,needle-like,null,odour,orientation,paired,pattern,placement,plurifoliate,pore,position,pseudostipule,rhizome,scale,shape,smell,spot,stone,structure,symmetry,sympodial,system,texture,tissue,tuber,type,vegetative,xylopodia,zygomorphy
317	wfo-0001029462	success	166	128	71	95	57	0.428	-2,-5,0.5-2,1-6,1.5-2,1.5-7,3,3-18,3-4,7-8,abaxially,acuminate,adaxially,apex,base,blade,calyx,campanulate,cell,chartaceous,cm,connective,connivent,cuneate,curled,dark,densely,directed,eglandular,ellipsoidal,entire,flattened,fruit,glabrous,green,hair,lanceolate,laterally,light,long,longitudinal,lower,margin,membranaceous,minutely,mm,near,occasionally,oval,pedicel,petiole,pore,puberulent,pubescent-pilose,purplish,rounded,simple,small,smooth,somewhat,sparsely,stellate-,stone,stripe,tree,truncate,unbranched,unit,white,x,yellow	-30,-4,0.5-1,1,1-,1-2,1-3,1.5,1.5-3,10-,10-22,15-25,2-3,2-6.5,2.5-3.5,2.5-5.5,20-35,3-27,3-5,3-6,3-7,4-15,4-20,4-foliat,5-30,6-9,7-19,8-9,abruptly,absent,acute,aggregate,apart,ape,articulated,axe,basal,beyond,broad,ciliate,constricted,cylindrical,dentate,diameter,eaf,eed,elliptic,equal,exceeding,exserted,flower,leaving,lobe,lon,m.,moderately,narrowly,nflorescence,nther,obtuse,often,orolla,ovate,ovoid,pedicellar,peduncle,perfect,pubescent,pubescent-pilo,purpl,rachi,radiu,remnant,reticulate,ruit,shorter,slightly,spaced,stamen,stigma,style,tal,tem,thecae,time,tip,tomentose,triangular,truncat,tube,ud,vary,wide,without,ympodial	4-foliate,anther,appressed,articulation,bract,branching,breeding,broad-based,colour,corolla,filament,form,fruiting,growth,heteromorphism,inflated,inflorescence,insertion,interjected,interpetalar,leaf,leaflet,length,marking,mature,modification,needle-like,null,odour,orientation,paired,pattern,placement,position,prickle,pseudostipule,rhizome,scale,shape,smell,spot,staman,stem,structure,surface,symmetry,sympodial,system,tall,texture,tissue,trichome,tuber,type,vegetative,xylopodia,zygomorphy
318	wfo-0001029464	success	235	123	72	163	51	0.306	-2/3,0.5,1-10,1-3,1/4-1/3,10-50,2-3,acicular,andromonoecious,annual,anther,apart,apex,base,berry,black,blade,brown,calyx,chartaceous,cm,cordate,curved,dark,difoliate,ellipsoid,erect,filament,fruit,fruiting,glabrous,globular,green,hair,herb,heterostylous,lateral,leaf,length,less,lobed,long,lower,margin,maroon,mature,maturity,mauve,mm,oblong,obtuse,ovoid,pedicel,petiole,pink,prickle,purple,simple,spaced,stellate,stellate-pubescent,stem,straight,surface,terminal,trichome,unit,variously,white,wide,yellow-orange,young	-3,-30,-5,.9,0,0-2,0-80,0.2,0.2-0.5,0.2-0.7,0.3-0.7,0.3-1,0.5-2,0.8-2,00-200,1,1-8,1.2-3,1.5-2,1/,1/4,1/4-1/2,10-15,10-23,10-40,12-50,2,2-3.5,2-4,2.2-2.5,2.4-4,2.5-5,2.5-8,2.9-3.2,3-20,3-5,3-7,3.5-5,4-7,4-8,4-8-merous,5-17,5-8,5.5-6,5.5-7.5,6-15,7-10,8-13,8-15,9-15,abaxial,abaxially,acute,adaxial,alyx,ame,apar,apically,apparently,around,articulated,bark,branched,broad,broad-deltate,brow,c.,connivent,cultivar,cup-shaped,deltate,diameter,discolorous,distal,distance,drying,eaf,eed,elongated,elongating,equal,extending,flattened-reniform,flower,free,fully,geminat,glabrescent,glaucous,green-brown,hermaphrodite,infructescence,lobe,long-acuminat,long-styled,longer,lowermost,midpoint,midvein,minute,moderately,mottled,narrow-deltate,nflorescence,occasionally,often,older,one,open,opening,orange-brown,orolla,oung,ovate,pair,peduncle,pendent,pendulous,per,pericarp,plant,poricidal,porrect,portion,prickl,prickly,primary,ray,red-brown,rounded,ruit,scar,sessile,short-styled,side,smooth,sometimes,sparsely,spreading,stalk,stalked,staminat,striped,style,tamen,tapering,terete,tertiary,time,tip,translucent,tube,unarmed,upper,usually,vary,vein,venation,visible,way,woody,yellow-green,ympodial	appressed,articulation,bract,branching,breeding,broad-based,cell,colour,connective,corolla,form,geminate,growth,heteromorphism,inflated,inflorescence,insertion,interjected,interpetalar,leaflet,marking,modification,needle-like,null,odour,orientation,paired,pattern,placement,pore,position,present,pseudostipule,rhizome,scale,shape,smell,spot,staman,stone,structure,symmetry,sympodial,system,texture,tissue,tuber,type,vegetative,xylopodia,zygomorphy
319	wfo-0001029546	exception_thrown	203	0	0	203	0	0.0		0-2,0.3-1,1-10,1-2,1-3.2,1-4.5,1-5,1.5-2,1.5-6.2,1.6-6.5,2-4,2-9,2.2-2.8,3-8,3.5-5,4-10,4.5-12.5,4.5-7,5,5-10,5-18,5-8,5-merou,6.3-19.5,7-10,8,8-17,8-19.5,abaxially,absent,acumen,acuminate,acute,adaxiall,adaxially,ag,alyx,anther,apart,apex,apiculate,apparently,articulated,attenuate,axe,axillary,base,berry,blade,blue,broadly,brownish,bud,capitat,cell,chartaceous,clavate,cm,condition,connivent,cordate,corolla,covered,covering,curved,decreasing,decumben,decurrent,densely,diameter,digestion,distal,dorsally,dot,drying,eaf,edge,eed,elliptic,elliptical,enzyme,erect,exceeding,filament,flat,flower,folded,forked,frequently,fresh,fruit,geminat,generally,glabrou,glabrous,glandular,globose,greatly,green,green-white,greenish,hair,hair-like,half,herb,homostylous,honeycomb-shaped,interjected,lanceolate,lateral,leaf,leaflet,lengthening,like,living,lobe,long,longer,lower,lunate,make,membranous,middl,minutely,mm,mottle,mucilaginous,nearly,nflorescence,non-glandular,oblique,odd-pinnate,often,orbicular,ovate,ovoid,pair,pedicel,peduncle,pentagonal,perfect,petiole,petiolule,plant,plurifoliate,pore,poricidal,pubescent,purple,rachi,rarely,regular,removed,ripe,rotate-pentagonal,ruit,seed,sessile,seudostipule,short,simple,size,slightly,slit,soft,sometimes,spaced,specimen,stamen,ste,stem,stigma,straight,style,subequal,subtending,tall,tamen,tem,terminal,testal,thick,throughout,tinged,tip,tri-,trichome,truncate,tube,typically,unit,unwinged,usually,vary,wall,wet,white,whitish,wide,wing,x,yellow,ympodial	
320	wfo-0001029552	exception_thrown	161	0	0	161	0	0.0		.25,.5,0.1-0.5,0.5,0.6-1,1-1.3,1-1.5,1-2,1-3,1-5,1.5-2,1.5-6.5,10-20,12,2-2.5,2-9,2.5-3,5-10-flowered,5.5-8,6-9,abaxial,abaxially,abruptly,acuminate,acute,adaxially,along,anther,anthesi,apex,area,bark,base,berry,branched,broadened,broadly,calyx,clavate,closely,cm,conical,contracted,corolla,decurrent,deflexed,deltate,dendritic,densely,denser,dia,differing,difoliate,drying,eaf,edicel,eed,elliptic,erect,exserted,filament,flattened-reniform,flower,free,fruiting,geminat,glabrous,globose,green,greyish-brow,heteromorphic,incrassate,inflorescenc,inflorescence,lamina,later,lateral,leaf,like,lobe,lobed,lon,long,long-styled,lower,main,major,margin,middle,minor,minute,minutely,mm,nearly,nflorescence,occasionally,older,onto,opposite,orbicular,ovary,overlappin,pair,pale,paler,papillo,pedicel,persistent,petiole,pitted,planar,pore,poricidal,portion,present,pubescent,reflexed,rest,rounded,ruit,scar,scattered,shape,shaped,shining,short-styled,shrub,simple,size,slender,slightly,small,somewhat,spaced,sparsely,stem,stigma,strongly,style,surface,swollen,tall,tan,tear-drop,tip,tree,tree-like,trichome,tub,tube,ud,unit,vein,white,wide,widest,woody,x,yellowish,ympodial,young	
321	wfo-0001029584	exception_thrown	180	0	0	180	0	0.0		0-30,1,1-2,1-3,1-6,1.5-6.5,16.2-33,2-3,2-4,2.4-6.3,3-10,3-5,3-7,4-14,4-15,4-5,4.5-11.5,5-merou,5.3-13.3,6-7,6.1-9.4,7-14,8-15,9.7-23.4,9.8-17,abaxially,acumen,acuminate,acute,adaxially,ag,alyx,anther,apart,apex,apparently,articulated,asymmetric,attenuate,axe,axillary,base,basiscopic,blade,borne,brownish,bud,capitat,cell,clavate,cm,condition,connivent,considerably,coriaceous,corolla,covering,dark,decreasing,dense,densely,diameter,digestion,distal,dorsally,drying,eaf,edge,eed,elliptic,end,enzyme,erry,filament,finer,flat,flower,folded,forked,fresh,fruit,geminat,generally,glabrescent,glabrous,green,green-white,greenish,hair,hair-like,hal,half,herb,homostylous,honeycomb-shaped,interjected,larger,lateral,leaf,leaflet,lengthening,light,linear,living,lobe,long,lower,make,margin,middle,mm,mucilaginous,nflorescence,oblong-lanceolate,odd-pinnate,orbicular,orolla,ovate,ovoid,pair,pedicel,peduncle,pentagonal,perfect,petiole,petiolulate,plant,plurifoliate,pore,poricidal,present,proximal,pubescent,purple,removed,second,seed,semi-erec,sessile,seudostipule,short,side,simple,singly,size,slit,spaced,specimen,stigma,stolo,straight,style,substellate,subtending,tall,tamen,tem,terminal,testal,thick,throughout,tip,tissue,toward,tri-,tube,tuber,typically,unit,unknow,unwinged,usually,vary,wall,wet,white,whitish,x,yellow,ympodial	
322	wfo-0001029593	success	181	139	84	97	55	0.464	0.05,0.5-1,1,1-1.5,1-2,1-8,2-5,5-15,abaxially,adaxially,age,always,anther,apex,apically,arising,attenuate,axil,axillary,base,basiscopically,berry,broadly,calyx,cell,cm,conical,densely,drying,enlarged,entire,extremely,filament,filiform,free,fruit,fruiting,glabrescent,glabrous,globose,green,lamina,leaf,leaflet,long,lower,markedly,mm,oblique,occasionally,once-branched,opposite,pair,papillose,pedicel,perfectly,petiole,pinnate,plant,pointed,poricidal,portion,pubescence,pubescent,purple,rarely,reflecting,rest,shape,shrub,simple,single-stemmed,small,somewhat,surface,tall,tip,trichome,tube,uniseriate,unit,variable,vein,white	-10,0.5-5,0.8-1,0.8-1.2,1-1.2,1.6-2.3,10-50,100,2,2-14,2-3,2.3,2.3-3.0,3-4,3.5-8,35-60,4-6,5-10,7-25,7.5-15,9-15,abruptly,acuminate,acute,anthesi,anticlinal,basal,bearing,brown,capitate,cateniform,clavat,colony,cone,decurrent,deltate,diameter,dry,eaf,edicel,eed,elliptic,epidermal,exserted,flower,growing,half,hollow,included,irregular,large,lateral,lobe,minutely,much,narrowing,nflorescence,noddin,obovate,often,onto,open,ovary,ovoid-reniform,per,petiolule,place,primary,projection,pubescen,rachi,ruit,scar,seed,short-styled,similar,sinuous,slightly,smaller,smooth,sparsely,stigma,style,tem,terminal,thickening,tub,ud,unifoliat,usually,white-lenticellate,wider,winged,without,woody,x,ympodial	appressed,articulation,bract,branching,breeding,broad-based,cateniforme,colour,connective,corolla,form,growth,hair,heteromorphism,inflated,inflorescence,insertion,interjected,interpetalar,length,margin,marking,mature,modification,needle-like,nodding,null,odour,orientation,paired,pattern,placement,pore,position,prickle,pseudostipule,rhizome,scale,smell,spot,staman,stem,stone,structure,symmetry,sympodial,system,texture,tissue,tuber,type,unifoliate,vegetative,xylopodia,zygomorphy
323	wfo-0001029601	success	187	139	83	104	56	0.444	0-37,0.2-0.8,1-2,1-3,2-12,4-13.5,6.6-22,abaxially,adaxially,anther,apex,asymmetric,attenuate,axillary,base,basiscopic,berry,blade,borne,bud,cell,cm,connivent,coriaceous,corolla,dark,distal,dot,end,filament,forked,fruit,generally,glabrous,globose,green,hair,half,herb,homostylous,interjected,lanceolate,leaf,leaflet,lengthening,light,long,lower,middle,mm,odd-pinnate,orbicular,ovate,pedicel,pentagonal,petiole,petiolulate,plant,plurifoliate,pore,poricidal,puberulent,ripe,rotate,rounded,sessile,side,singly,slightly,slit,small,subtending,tall,terminal,tip,tissue,tri-,tuber,typically,unit,usually,white,x	0.5-5.8,0.5-8,1-4,1-53,1.1-2.7,1.2-2.3,1.7-6.5,2,2-3,2-7,2-9,2.2-4.5,2.3-5.9,2.8-10.5,3-10,3-5,3-7,5-41,5-merou,6-10,6.8-14.5,abaxiall,acumen,acuminate,acute,ag,alyx,apart,apparently,articulated,axe,brownish,capitat,clavate,condition,covering,decreasing,diameter,digestion,dorsally,drying,eaf,edge,eed,elliptic,enzyme,erec,exceeding,flat,flower,folded,fresh,geminat,glabrescent,glabrou,green-white,greenish,hair-like,honeycomb-shaped,larger,lateral,linear,living,lobe,make,middl,mucilaginous,narrow,nflorescence,orolla,ovoid,pair,peduncle,perfect,removed,ruit,seed,seudostipule,short,size,spaced,specimen,stamen,stigma,stolo,straight,style,subequal,subglabrou,tamen,tem,testal,thick,throughout,toward,tube,unwinged,vary,wall,wet,whitish,wing,yellow,ympodial	age,appressed,articulation,bract,branching,breeding,broad-based,calyx,colour,connective,erect,form,fruiting,geminate,growth,heteromorphism,inflated,inflorescence,insertion,interpetalar,length,margin,marking,mature,modification,needle-like,null,odour,orientation,paired,pattern,placement,position,prickle,pseudostipule,rhizome,scale,shape,smell,spot,staman,stem,stolon,stone,structure,subglabrous,surface,symmetry,sympodial,system,texture,trichome,type,vegetative,xylopodia,zygomorphy
324	wfo-0001029621	exception_thrown	165	0	0	165	0	0.0		.1,0.5-0.75,0.5-1,0.5-1.2,0.5-1.5,0.7-1.1,0.8-1,0.8-4.5,1-1.5,1-2,1.5-2,1.5-2.5,1.5-5,1/3,2.5-3,2/3,3-3.5,3.5-4.5,5-20-flowered,6-20,6-8,7-9,accrescent,acute,along,anther,anthesi,apar,apex,appearing,appressed,area,attenuate,bark,base,becoming,beneath,berry,borne,branched,brown,calyx,caudate,cluster,cm,completely,constricted,corolla,course,cup-shaped,dark,decurrent,deltoid,densely,dia,distal,dry,eaf,edicel,eed,ellipsoid,elongate,enclosed,erect,exsertio,filament,fleshy,free,fruit,fruiting,geminate,glabrate,glabrous,globose,green,irregularly,lanceolate,late,later,lateral,leaf,like,live,lobe,lobed,lon,long,lower,main,many,margin,material,merely,middle,minutely,mm,nflorescence,oblanceolate,occasionally,often,older,onto,ovary,ovoid-reniform,pair,pale,papillate,papillo,papillose,pedicel,pitted,planar,plant,plurifoliat,pore,poricidal,portion,prominent,puberulent,quite,rarely,reddish,reddish-gre,ripe,river,ruit,scar,sessile,shaped,shiny,shrub,small,somewhat,spaced,ste,stem,stigma,straight,style,surface,tall,tan,tapering,tear-drop,terminal,thick,time,tip,trichome,tube,ud,uniseriate,unit,vein,way,white,whorl-like,widened,widest,woody,x,yellow,yellowish,ympodial,young	
325	wfo-0001029622	success	182	117	63	119	54	0.346	.2,.5,0.5-0.7,0.5-1,1.5,abaxially,accrescent,acute,adaxially,anther,apex,appearing,attenuate,axil,base,calyx,chartaceous,cm,corolla,deciduous,diameter,difoliate,entire,filament,fruit,fruiting,geminate,glabrous,globose,green,inflorescence,internodal,leaf,major,margin,mature,minor,mm,oblong,occasionally,often,onto,opposite,pedicel,petiole,pore,shaped,shiny,shrub,simple,slender,slightly,somewhat,stellate,stem,tear-drop,thus,trichome,tuft,uniseriate,unit,vein,white	.1,/3,0.3,0.5,0.6-0.9,0.8-1,1-1.2,1-1.5,1-2.7,1-4,2-11,2-4,2-5,2.5-3,3-4,3-5,30-35,4-6.5,40,45-50,5-6,7-11,absent,ag,alyx,anthesi,apparently,arising,axe,bark,beneath,blade,brown,bud,capitat,connivent,consisting,cylindrical,deflexed,differing,dimorphic,eaf,eed,elliptic,elongate,except,flower,free,glabrou,ilament,immature,included,interlaced,jointed,known,lamina,lateral,less,lobe,lobed,long,long-acuminate,long-triangular,longitudinal,m.,main,measured,midrib,minute,minutely,narrowly,nflorescence,obconic,older,one,opening,orolla,oung,ovate,ovate-lanceolate,pair,papillose,peduncle,pendent,portion,present,probably,rachi,raised,reddish,reflexed,remaining,rounded,ruit,sagittate,scar,second,single,size,slende,slit,stigma,straight,style,tal,tapering,thin,tip,tube,ud,unarme,unifoliat,vary,way,within,x,yellow,ympodial,young	appressed,articulation,bract,branching,breeding,broad-based,cell,colour,connective,form,growth,hair,heteromorphism,inflated,insertion,interjected,interpetalar,leaflet,length,lower,marking,modification,needle-like,null,odour,orientation,paired,pattern,placement,position,prickle,pseudostipule,rhizome,scale,shape,smell,spot,staman,stone,structure,surface,symmetry,sympodial,system,tall,texture,tissue,tuber,type,unarmed,unifoliate,vegetative,xylopodia,zygomorphy
326	wfo-0001029625	success	168	138	82	86	56	0.488	.5,0.5-1.3,0.5-2mm,1-1.5,1-2,2,3,3-3.5,4-5-celled,4-7-celled,8-13,along,anther,anthesi,bark,base,beneath,branched,calyx,cell,corolla,cucullate,darker,densely,denser,elliptic,filament,four,fruit,fruiting,glabrescent,gland,glandular,globose,green,greenish,growth,herb,inflorescence,lamina,later,lobe,lobed,long,lower,margin,middle,mixed,mm,narrowly,nearly,new,occasionally,pair,papillate,pedicel,planar,point,pointed,primary,pubescent,purplish,scattered,shrub,single,single-stemmed,small,sparsely,stem,stripe,strongly,surface,time,tinged,tip,triangular,trichome,uniseriate,unit,vein,white,young	-15,..,.1-0.2,0.5-1,0.5-2,0.8-1.4,0.8-1.8,1-3,1.2-1.6,100,2.5-.,3-,3-3,4-10,4-4,4-9,5,5-10,5-6,5-8,6-9,9-25,abaxial,apical,branc,branch,brittle,brow,capitat,cel,cm,conical,deflexe,deflexed,deltate,diameter,distinct,dry,eaf,edicel,eed,erect,flattened,flower,frui,glabrous,gland-tipped,hyaline,lighter,like,markedly,midline,minute,nflorescence,open,outer,outline,ovary,ovate-reniform,pale,peduncle,per,pericarp,plurifoliat,rarely,reddish,regularly,ruit,scar,sinuate,slightly,smooth,stigma,striate,style,tan,testa,thin,tube,tuft,ud,wall,weight,without,x,ympodial	2.5-3,4-4.5,apex,appressed,articulation,bract,branching,breeding,broad-based,brown,colour,connective,form,hair,heteromorphism,inflated,insertion,interjected,interpetalar,leaf,leaflet,length,marking,mature,modification,needle-like,null,odour,orientation,paired,pattern,petiole,placement,plurifoliate,pore,position,prickle,pseudostipule,rhizome,scale,shape,smell,spot,staman,stone,structure,symmetry,sympodial,system,texture,tissue,tuber,type,vegetative,xylopodia,zygomorphy
327	wfo-0001029645	exception_thrown	160	0	0	160	0	0.0		-1,.5-1,0.2-0.5,0.3-0.5,0.5-2.5,0.5-7,1,1-1.5,1-2,1-4,1.3-7,1.5,1.5-2,2-3-foliat,2-4,2.5-17,2.5-4,3-10,3-15,3-7,3.5-4,337,4-5,4-8,5,5-8,6-12,7-12,750,?,abaxially,abundantly,acuminate,acute,adaxially,aggregate,along,anther,apart,apex,around,articulated,axe,ba,base,blade,blue,brown,calyx,cell,chartaceous,cm,connivent,corolla,cuneate,cylindrical,decurrent,deltate,diameter,directed,distall,distally,eaf,eed,entire,et,except,extra-axillary,fide,filament,finger,flattened,flower,free,fruit,glabrou,glabrous,gland-tipped,globose,green,greenish,hair,herb,immature,inserted,kayap,knapp,line,lobe,long,lower,major,margin,membranaceous,mesocarp,minutely,mm,moderately,nearly,nflorescence,obtuse,orolla,ovate,ovate-elliptic,part,pedicel,peduncle,perfect,petiole,pore,puberulen,puberulent,purple,rachi,radiu,rarely,red,rotate-stellate,rugose-verrucate,ruit,sagittate,sand-punctate,short,short-tomentose,shorter,shru,side,simple,small,smith,spaced,sparsely,stigma,stone,strongly,style,subcordate,tal,tamen,tapered,tem,thecae,tightly,time,tomento,triangular,truncat,truncate,tube,unbranched,unit,vary,vein,veiny,white,wide,x,yellow,ympodial,Â±	
328	wfo-0001029646	exception_thrown	141	0	0	141	0	0.0		0.1-0.6,0.5,0.5-0.8,0.7-2.2,1-4,1.5-2,1.5-4.9,10-15,2-3,3-14,3-6-foliat,4-5.5,5-15,6-8,7-15,abaxially,acumen,acuminate,acute,adaxially,apex,apical,apically,articulate,attenuate,base,branched,calyx,cell,cm,commonly,corolla,covering,cyme,dehiscent,diameter,dichasial,dichasially,digestion,distal,dorsally,eaf,ebracteate,edge,eed,elliptic,emoval,enzyme,epiphytic,equaling,filament,finely,flat,flower,folded,forked,free,generally,globo,globose,green,green-white,ground,growing,hair-like,half,herbaceous,honeycomb,introrse,lateral,leaf,linear,living,lobe,lon,long,lower,make,maturing,mm,monochasial,mos,mould,mucilaginous,mucronate,narrowly,nflorescence,nther,oak,often,orolla,ovat,ovate,ovoid,pattern,pedicel,peduncle,perennial,perfect,petiole,pine,plan,plant,poricidally,proximal,pubescent,rarely,reveal,ruit,seed,seudostipule,short,simple,slit,specimen,stamen,stellate,stigma,straight,style,tall,tem,testal,thick,throughou,throughout,tone,tree,tuber-bearing,typically,unit,vary,viole,wall,white,wide,without,yellow,yellow-green,ympodial,Â¼	
329	wfo-0001029652	exception_thrown	160	0	0	160	0	0.0		.25,.3,.5,0.5-1,0.5-4,0.75-1,0.8-1,1,1-2,1-3,1.5-2,2,2-2.5,2-4,2.5-3,25,3.5-4,3/4,4-4.5,6-15,7-9,abaxially,adaxially,along,anther,anthesi,apar,ape,apex,apical,arch,arching,attenuate,ba,bark,base,bearing,berry,broadly,calyx,cm,cone,conical,corolla,curling,deciduous,deflexed,deltate,denser,dia,differing,difoliate,drying,eaf,edicel,eed,elliptic-ovate,evenly,exserted,filament,filiform,flower,free,fruiting,geminat,glabrous,globose,golden,golden-red,green,greenish-white,hard,heteromorphic,hispid,included,joining,lamina,lateral,leaf,like,lobe,lobed,lon,long,long-acuminate,long-styled,lower,main,major,margin,maturity,middle,midrib,minor,minute,minutely,mm,narrowly,near,nflorescence,occasionally,older,opposite,ovary,ovoid-reniform,pair,pale,papillo,papillose,pedicel,pericarp,petiole,pitted,pore,poricidal,portion,projection,pubescent,reddish-brown,reflexed,ruit,scar,series,shaped,short-styled,shrub,simple,size,slende,slender,slightly,soon,spaced,sparsely,stem,stigma,style,surface,swollen,tall,tan,tear-drop,thickened,time,tip,trichome,tub,tube,ud,undulate,uniseriate,unit,vein,way,white,widest,within,x,ympodial,young	
330	wfo-0001029673	exception_thrown	159	0	0	159	0	0.0		.5,0.5-1,0.7-1.1,0.75-1,0.8-1,1-10,1-2,1-5,1.2-3.5,1.5-1.8,1.5-2,10-20,2-2.5,2-3,2-4,2.5,3-5,3/4,4-6,5-25,5.5-15,abaxial,abaxially,absent,accrescent,acuminate,acute,adaxial,adaxially,age,along,anther,anthesi,apex,apical,appearing,bark,basal,base,becoming,berry,black,blade,branch,branching,broadly,calyx,clavate,cm,conical,corolla,decurrent,deep,deflexed,deltoid,dendritic,densely,denser,diameter,dichasia,eaf,edicel,eed,elliptic,ew,exserted,filament,flower,fork,free,fruit,fruiting,glabrous,globose,greyish,greyish-yello,greyish-yellow,growth,individual,inserted,lamina,later,lateral,leaf,length,lenticular,like,lobe,lon,long,longer,lower,m.,minutely,mm,monochasial,narrowly,nflorescence,nodding,occasionally,older,ovary,overtopping,pair,papillo,pedicel,pericarp,petal,petiole,pitted,planar,plurifoliate,pore,poricidal,portion,prominent,pubescent,purple,pyramidal,reddish-brown,reflexed,ruit,scar,secondary,shoot,shrub,sleeve,slightly,slit-like,small,somewhat,sparsely,stamen,stem,stigma,strongly,style,surface,tall,tapering,terminal,thin,time,tip,tree,triangular,trichome,tub,tube,ud,unit,vein,violet,wide,winged,woody,x,ympodial,young	
331	wfo-0001029680	exception_thrown	212	0	0	212	0	0.0		.0,0.1,0.4,0.5â1.5,0.6,0.6â1.2,0.6â2.0,0.9â1.0,1,1.0,1.0â1.1,1.0â1.5,1.0â1.8,1.1â1.2,1.4â2.5,1.4â7.5,1.5,1.6â2.7,1.7â7,1.8â3.8,10,11â16,11â25,12,1â2,1â3,1â6,1â8,2.2â4.2,2â20,3.0â4.2,3.3â5.5,3â22,3â6,4.0â16,4.0â6.5,4.5â20,4.5â7.0,4â10,4â30,5,5.5â8.5,50,5â11,7â10,8â32,abaxially,absen,acute,adaxiall,adaxially,ag,along,annual,anther,anthesi,apart,apex,appressed,arequipa,arranged,articulated,asymmetrically,axe,axillary,ba,base,becoming,beyond,bipinnate,blade,blue,borne,branched,brown,calyx,cell,clavate,cm,connivent,cylindrical,decreasing,decurrent,densely,diameter,difoliate,divided,eaf,eed,entire,equal,erect,extending,filament,flange,flattened,fleshy,flower,forming,fruit,geminat,glabrous,globose,green,hair,herb,indistinct,irregularly,leaf,length,light,lobe,lon,long,longitudinal,lower,m.,margin,midrib,mm,moderately,multicellular,narrow,nflorescence,node,oblong,obovate,obtuse,occasionally,often,opening,orolla,ovate,pair,pale,parallel,pedicel,peduncle,pendant,pentagonal,perfect,petiole,pinnae,pinnate,pitted,plurifoliate,pore,poricidal,primary,prostrate,pubescent,purple,rapidly,rarely,red,ripe,rotate,ruit,running,secondary,shallowly,shaped,shoot,side,simple,size,sometimes,spaced,sparsely,specimen,split,stem,stigma,stone,straight,style,subglabrous,surface,tacna,tal,tamen,tear-drop,tem,terminal,tertiary,time,tip,tripinnate,tube,turning,unicellular,uniseriate,unit,usually,vary,violet,white,wide,wing,winge,winged,woody,x,yellow,ympodial,â10,â12.5,â19,â3,â3.2,â46,â48	
332	wfo-0001029704	success	146	131	80	66	51	0.548	.5,0.5,1-4,1.5,1.5-2.5,140-185,2-3,3-4-celled,3-5,5,along,also,anther,apex,base,berry,blue,branch,broadly,calyx,cell,cm,composed,corolla,cuneate,deeply,diam,ellipsoid,enlarged,erect,extra-axillary,few-flowered,filament,flower,fork,fruiting,globose,gradually,green,halfway,leaf,lengthening,less,lobed,long,lower,minute,mm,moderately,mottled,occasionally,one,pedicel,petiole,pinnatisect,pore,poricidal,pubescent,purple,record,shoot,shrub,simple,single,slit,sprawling,stellate,stone,stout,striped,surface,swollen,tip,trichome,twig,variable,variously,vein,white,young	-17,-3,0-1.5,1,1-2,1.5-3,10-14,1000-1200,15-25,2-2.5,2-5,4,4-7,7-,7-10,9-20,acuman,acuminate,acute,anthesi,apparently,aspect,axi,brown,c.,conical,cunate,cut,dark,deflexed,dia,eaf,eed,especially,exerted,flowering,glabrous,lanceolate,lobe,midrib,minutely,nflorescence,obovate,obovoid,ovary,peduncle,plurifoliat,reddish,reticulate,rounded,ruit,short,sinus,sombre,stigma,straight,style,subdiscoidal,subglobo,tub,tube,ud,unit,within,x,ympodial	appressed,articulation,bract,branching,breeding,broad-based,colour,connective,form,fruit,growth,hair,heteromorphism,inflated,inflorescence,insertion,interjected,interpetalar,leaflet,length,margin,marking,mature,mentioned,modification,needle-like,odour,orientation,paired,pattern,placement,plurifoliate,position,prickle,pseudostipule,rhizome,scale,shape,smell,spot,staman,stem,symmetry,system,texture,tissue,tuber,type,vegetative,xylopodia,zygomorphy
333	wfo-0001029727	exception_thrown	260	0	0	260	0	0.0		-1/3,-10,-3,.5,/3,0-15,0-2,0-20,0-30,0-4,0-40,0-5,0-8,0.1-5,0.15-0.2,0.15-0.3,0.2,0.2-0.5,0.2-2.5,0.3,0.4,0.4-1,0.5,0.5-1.2,0.5-3,0.7-0.9,0.7-1,1,1-,1-1.2,1-2,1-4,1.2-2,1.5-2.3,1.5-2.5,1.5-3,1.5-5.5,1.6-3,1/2-2/3,1/3-1/2,1/4,1/8-1/5,2-5,2.5,2.5-3.2,2.5-5.5,2.8-4,3-11,3-6,3-7,3/,4-7,4-merou,4-merous,4.5,4.5-,5-12,5-8,5-9,5.5-7,6-11,7-10,abaxial,abaxially,acicular,acuminate,acute,adaxial,age,almost,along,alternate,alyx,ame,anther,anthesi,apar,apart,apex,apically,apparently,articulated,bark,base,berry,blade,branched,bristle,brown,c.,calyx,chartaceous,clavate,climber,cm,colourles,connivent,cordate,corolla,covered,cupular,curved,darker,deltate,deltoid,densely,developing,diameter,different,dimorphic,discolorous,divided,drying,eaf,edge,eed,elongating,equal,erect,except,extending,ferrugineous,filament,filiform,filiform-acuminat,finely,fissure,flattened-reniform,flower,free,geminate,glabrous,increasing,inside,lateral,leaf,length,lengthening,less,like,lobe,lobed,lon,long,longer,lower,m.,margin,mature,mauve,middle,midpoint,midvein,minor,minutely,mixture,mm,moderately,narrow-deltate,nflorescence,nther,obconical,oblong,occasional,older,one,open,orange-brown,orolla,oung,outside,ovate,pair,papillo,papillose,pedicel,peduncle,per,perfec,perfect,petiole,pit,pitted,plurifoliat,pore,poricidal,porrect,portion,prickl,prickle,prickly,primary,protruding,pubescent,raised,rarely,ray,red-brow,red-brown,reddish,reduced,regular,rounded,scandent,scar,seed,series,sessile,shallowly,shape,short,shrub,simple,sinus,size,smooth,sometimes,spaced,spreading,stalk,stalked,stellate,stellate-pubescent,stem,stigma,straight,strongly,style,subentire,surface,tamen,tapering,tearing,terete,terminal,tertiary,time,tip,toward,translucent,transverse,trichome,tube,unarmed,uneven,unit,upper,variable,variously,vary,vein,venation,violet,visible,way,wide,x,yellowish,ympodial,young	
334	wfo-0001029731	success	246	164	116	130	48	0.472	.5,0.05,1,1-2,1.5,1.5-3,2,2-3,3,3-4,4,6-7,accrescent,acquiring,almost,along,anther,anthesi,apar,apex,apically,apparently,bark,basally,base,beak,becoming,berry,black,branch,branched,branching,broadly,brown,bumpy,calyx,cm,corolla,deltoid,diameter,distributed,dry,drying,dull,enlarge,epiphyte,erect,even,evenly,filament,finely,flaring,fruit,fruiting,glabrous,ground,hair,iscoid,leaf,less,liana,like,lobe,lobed,long,long-ellipsoid,longitudinally,lower,main,margin,mature,maturity,mauve,mm,obconical,obtuse,occasionally,orange-brown,papillae,pedicel,pericarp,pore,pyriform,reflexed,ribbed,ridged,rounded,scar,shallowly,shorter,sinus,small,sparsely,stem,stretched,stump,surface,tearing,thick,time,toward,trichome,tuft,unit,venation,visibl,well-developed,white,wide,widely,wing,winged,woody,x,yellow,young	.6,0.1-0.8,0.25-0.3,1-1.5,1-2.5,1.5-2.5,1/3,10-20,1994,2-6,2.5,2.5-4.5,3-10,31,4-5,4-9,6,7-11,8-9,abaxially,acuminate,acute,adaxially,age,alyx,arcy,articulated,basal,boundary,clavate,clearly,concolorous,conical,connate,coriaceous,crinkled,cuneate,darker,delimited,delineated,dense,development,different,dilated,domatia,dorsal,dorsifixed,eaf,early,elliptic,elongating,entire,equal,exserted,faint,filiform,fine,flattened,fleshy,flower,free,lamina,large,later,lateral,lengthening,linear,lon,longitudinal,midvein,much,narrowly,nflorescence,nther,oblong,obovate,often,orolla,pair,papillose,part,peduncle,pendulous,perfec,persisting,petiole,plurifoliat,poricidal,portion,primary,prominent,protruding,rachi,raised,rakotozafy,rarely,reported,revolute,ridge,ruit,see,several,simple,slender,slightly,smaller,smoot,sometimes,stigma,straight,style,succulent,sunk,terminal,thickened,thinner,though,tip,tub,tube,ud,usually,vary,vein,ventral,visible,wrinkling,yellow-green,ympodial,â	appressed,articulation,breeding,broad-based,cell,colour,connective,form,growth,heteromorphism,inflated,insertion,interjected,interpetalar,leaflet,length,marking,modification,needle-like,null,odour,orientation,paired,pattern,perfect,placement,position,prickle,pseudostipule,rhizome,scale,shape,smell,spot,stellate,stone,structure,symmetry,sympodial,system,taman,texture,tissue,tuber,type,vegetative,xylopodia,zygomorphy
335	wfo-0001029741	success	137	70	17	120	53	0.124	anther,apex,base,calyx,corolla,filament,fruit,fruiting,growth,inflorescence,leaf,lower,pedicel,petiole,pore,stem,unit	.4,.5,0.5-1.5,0.8-3.5,0.9-1.2,1-1.5,1-3.5,1.1-1.3,1.5,1.5-4,1.5-6,10-50-flowered,2-2.5,2.2-9,2.5-7.8,3,9.5-22.5,?,accrescent,acute,age,anthesi,apiculate,attenuate,becoming,berry,black,branched,ca,caly,capitate,closely,cm,completely,dark,deflexed,deltoid,dia,differing,difoliate,divisio,dry,drying,eaf,early,edicel,eed,elliptic,erect,exserted,flower,free,furcate,geminat,glabrou,glabrous,globose,green,immature,known,lateral,lenticellate,lighter,lobe,lobed,lon,long,main,major,middle,minor,minutely,mm,nearly,new,nflorescence,opposite,ovary,ovate,overlapping,pair,papillo,papillose,planar,poricidal,portion,produced,prominent,proximal,quite,raised,reddish-brown,ruit,scar,shaped,shrub,size,slender,slightly,spaced,stigma,straight,style,tall,tapering,tear-drop,tip,tree,tube,ud,usually,variable,vein,weak,white,widest,wood,woody,x,ympodial	appressed,articulation,bract,branching,breeding,broad-based,cell,colour,connective,form,hair,heteromorphism,inflated,insertion,interjected,interpetalar,leaflet,length,margin,marking,mature,modification,needle-like,none,odour,orientation,paired,pattern,placement,position,prickle,pseudostipule,rhizome,scale,shape,smell,spot,staman,stellate,stone,structure,surface,symmetry,sympodial,system,texture,tissue,trichome,tuber,type,vegetative,xylopodia,zygomorphy
336	wfo-0001029744	exception_thrown	113	0	0	113	0	0.0		0.3-0.6,0.5-1,1,1.5,1.5-3.2,2,2-4,5-8,50,7-15,8-10-flowered,8-11,abaxially,acute,adaxially,along,apart,apex,bark,base,beginning,blunt,branch,brow,calyx,cm,deltate,dendritic,densely,denser,difoliate,distinct,eaf,eed,elliptic,entire,examined,extreme,fide,flattened,flexuous,form,fruit,geminate,glabrescent,glabrous,golden,incrassate,inflorescenc,lamina,lanceolate,leaf,leave,lobe,long-acuminate,looping,lower,major,margin,marginal,mature,minor,minutely,mm,narrowly,nflorescence,node,non-reproductive,oblanceolate,oblique,occasionally,older,opposite,ovoid-reniform,pair,pale,pedicel,petiole,pitted,primary,pubescence,pubescent,revolute,scar,see,shape,shrub,similar,simple,single-celled,slightly,small,smaller,smith,sometimes,somewhat,spaced,stem,surface,thee,thin,tip,trichome,ud,unicellular,unifoliate,uniseriate,unit,vein,white,x,ympodial,young	
337	wfo-0001029746	exception_thrown	179	0	0	179	0	0.0		.5,0.3-2,0.5-1,0.7-1,1,1-1.3,1-1.5,1.2-1.5,1.5,2,2-2.5,2-4,2-7,2-8,3,3-4,3-4-pluri-foliate,3-4.5,3-6,4-9,6,6-7,8-10,8-11,abaxially,acuminate,acute,adaxially,age,anther,anthesi,apart,apex,base,bearing,becoming,berry,blackish,broadly,brown,c.,calyx,capitate,cell,centre,ciliate,cm,color,conical,cordate,corolla,crenate,crowded,cup-shaped,curved,dark,darker,densely,diameter,eaf,edicel,eed,ellipsoid,elliptic,enlarged,entire,erect,exerted,filament,flattened,fleshy,flower,flush,free,fruit,fruiting,glabrous,gland-tipped,glandular,globose,greenish,growing,herb,heteromorphic,hollow,horn,inflorescence,internodal,irregularly,lamina,leaf,lengthening,less,lobe,lon,long,longer,longest,lower,margin,markedly,mature,maturit,mid-length,minutely,mixed,mm,narrowly,near,nflorescence,nodding,occasionally,orange,ovary,ovate,ovoid,pair,pale,papillo,papillose,pedicel,peduncle,pericarp,petiole,pitted,plan,pore,poricidal,portion,primary,principal,pubescen,pubescent,purple,rachi,red,reddish,reflexed,ruit,scar,shallowly,shortest,simple,single,slender,slightly,slit,somewhat,spaced,sparse,sparsely,spreading,stem,stigma,straight,strongly,style,subshrub,surface,testal,thin,third,tip,triangular,trichome,tube,ud,uniseriate,unit,upper,upward,vein,wall,widely,widest,woody,x,ympodial,â3	
338	wfo-0001029769	exception_thrown	142	0	0	142	0	0.0		.25,.5,0.5-1.5,1-1.2,1-3,1.5-2,1.5-2.5,2.5-3,2.5-8,3.5-4,30-60-flowered,4,4-5,5-8,6-17,7-8,8-9,8.5-17,abaxially,acuminate,acute,adaxially,along,anther,anthesi,apar,ape,apex,archin,ba,bark,base,bearing,berry,branch,brochidodromu,brown,calyx,capitate,cerro,cm,conical,corolla,curl-tipped,cyathiform,dark,deflexed,deltoid,densely,dia,eaf,edicel,eed,elliptic,exserted,filament,filiform,flower,free,fresh,fruiting,glabrous,globose,golden,green,hen,horizontally,inglÃ©,internodal,lateral,leaf,less,like,lobe,lobed,lon,long,lower,main,margin,midrib,minutely,mm,nearly,nflorescence,older,onto,opposite,ovary,ovoid-reniform,pair,papillo,papillose,pedicel,petiole,pitted,pore,poricidal,portion,puberulent,pubescent,reflexed,ried,ruit,scar,scattered,shaped,shrub,simple,smooth,somewhat,spaced,sparsely,stem,stigma,straight,style,surface,swollen,tall,tear-drop,three,time,tip,trichome,tub,tube,two,ud,unevenly,unifoliat,uniseriate,unit,vein,white,wide,widely,winged,woody,x,ympodial,young	
339	wfo-0001029780	exception_thrown	204	0	0	204	0	0.0		1-1.2,1-10,1-2,1.4-1.9,1.5-2,11-24,120-210,15-22,15-45,2-12,2-2.5,2-2.8,2-3.5,2-5.5,2.4-4.2,20-60,3,3-6,3.5-7.3,4-6,4.5-6,5-7,5-merou,5.5,5.5-13,50-70,600-950,8-12,?,abaxially,absent,acumen,acute,adaxially,ag,along,alyx,anther,apart,apex,apparently,articulated,attenuate,axe,axillary,base,berry,blade,borne,brownish,bud,capitat,cell,chartaceous,ciliate,cm,condition,connivent,cordate,corolla,covering,cuneate,dark,decumbent,densely,diameter,digestion,distal,dorsally,drying,eaf,edge,eed,end,enzyme,erec,especially,exceeding,except,filament,flat,flower,folded,forked,fresh,fruit,geminat,generally,glabrou,glabrous,gland,glandular,globose,greatly,green,green-white,greenish,hair,hair-like,hal,half,head,herb,high,homostylous,honeycomb-shaped,interjected,invested,lanceolate,lateral,leaflet,length,lengthening,like,living,lobe,long,longer,lower,make,margin,membranous,midrib,minute,minutely,mm,mucilaginous,nflorescence,non-glandular,obtuse,odd-pinnate,often,orbicular,orolla,ovate,ovoid,pair,pale,pedicel,peduncle,perfect,petiole,petiolulate,petiolule,pinkish,plant,plurifoliate,pore,poricidal,proximal,puberulent,pubescent,rarely,reduced,removed,ripe,rotate,ruit,seed,sessile,seudostipule,short,singly,size,slit,spaced,specimen,stamen,ste,stem,stigma,stolo,straight,streak,stripe,style,subequal,subtending,tall,tamen,tem,terminal,testal,tetralobulate,thick,throughout,tip,tri-,trichome,truncate,tube,tuber,typically,unit,unwinged,usually,vary,wall,wet,white,whitish,x,yellow,ympodial	
340	wfo-0001029784	exception_thrown	237	0	0	237	0	0.0		-12,-5,.1,.2,.5,0-4,0.1-,0.1-0.15,0.1-0.5,0.2,0.2-,0.2-0.3,0.2-0.5,0.25-0.3,0.3-0.35,0.3-0.4,0.3-0.5,0.3-1,0.4-,0.4-0.45,0.4-0.5,0.4-0.6,0.5,0.5-,0.5-1.5,0.6-1,0.7-1.2,0.9-1.2,1,1-,1-1.1,1-1.2,1-1.5,1-2,1-2-celled,1-4,1.0-1.3,1.2-2.5,1.5-,1.7-2.6,1/3,2,2-,2-2.5,2-3-celled,2-4,2-4.5,2-foliate,2-locular,2.5-3.5,2/3,3-,3-5,5-10,5-14,5-8,abaxial,abaxially,absent,abundant,acuminate,acute,adaxially,adpressed,along,angled,anther,anthesi,apex,apical,appearance,appendage,arising,articulated,articulation,axi,basal,base,basicopically,beneath,berry,bract,broadly,brown,calyx,capitate,cell,cm,column,conical,corolla,crenate-serrate,crenation,dark,decurrent,deeper,densely,developed,diameter,distal,distributed,due,eaf,edicel,eed,eglandular,elliptic,enclosing,entire,evenly,exserted,filament,flower,fruit,fruiting,giving,glabrescent,glabrous,glandular,globose,golden,gree,green,hair-like,hal,half,halfway,head,herb,imparipinnate,included,inflorescence,interjected,internode,interrupted,interspersed,irregularly,lamina,lanceolate,larger,lateral,leaflet,like,live,lobe,lon,long,long-acuminate,loosely,lower,margin,markedly,maturing,mm,mostly,multicellular,narrowly,nflorescence,node,northern,obovate,occasionally,often,orbicular,outgrowth,ovary,pair,pale,paler,patent,pedicel,peduncle,pentagonal,perennial,petiole,petiolule,plant,population,present,primary,proximal,pseudostipule,pubescence,pubescent,rarely,reflexed,ripe,robust,ruit,scattered,secondary,sessile,silky,simple,smaller,soft,sometimes,somewhat,sparse,sparsely,spreadin,staminal,stem,sterile,stigma,stout,straight,stripe,strongly,style,surface,tem,terminal,tertiary,testa,thick,trailing,trichome,truncate,tube,ud,undulate,unicellular,uniseriate,unit,unseriate,usually,vein,velvety,wall,white,wide,winged,woody,x,yellow,ympodial	
341	wfo-0001029785	success	223	161	107	116	54	0.48	0-2,0.1-0.5,1-2,1.2-3.2,3-8,3.5-5,3.8-7.2,5-16,6,abaxially,absent,adaxially,along,anther,apex,articulation,axillary,base,berry,blade,borne,bud,cell,chartaceous,cm,corolla,cuneate,dark,decumbent,denser,distal,end,filament,flower,forked,fruit,generally,glabrous,globose,green,hair,half,herb,homostylous,interjected,invested,lanceolate,leaf,leaflet,lengthening,like,long,lower,margin,membranous,middle,minute,mm,multiple-celled,non-glandular,oblique,odd-pinnate,orbicular,ovate,ovoid,pale,pedicel,pentagonal,petiole,petiolulate,plant,plurifoliate,pore,poricidal,pubescent,purple,quite,rarely,ripe,rotate,rounded,scale-like,sessile,short,singly,slightly,slit,sparsely,stem,stripe,subglabrous,subtending,tall,terminal,tip,tri-,tuber,typically,unbranched,unit,unwinged,usually,variable,vein,violet,white,x	0-3,0.3-2.2,0.4-4.9,0.8-1,1-1.2,1-10,1-5,1.5-3.6,1.8-3.5,1.8-7,10-26,2-4,3-4,3-6,4-10.5,5-9,5-merou,8-11,acumen,acute,ag,alyx,apart,apparently,attenuate,axe,broadly,brownish,capitat,clavate,commonly,condition,connivent,cordate,covering,darker,decreasing,diameter,digestion,dorsally,drying,eaf,edge,eed,elliptic,enzyme,erec,especially,exceeding,flat,folded,fresh,geminat,glabrou,greatly,green-white,greenish,hair-like,honeycomb-shaped,larger,lateral,living,lobe,make,markedly,medium,midrib,minutely,mottled,much,mucilaginous,nflorescence,obovate,obtuse,one-quarte,orolla,outer,pair,peduncle,perfect,petiolule,point,present,puberulent,purple-tinged,removed,ruit,seed,seudostipule,shallowly,size,sometimes,spaced,specimen,stamen,ste,stigma,stolo,straight,style,tamen,tem,testal,thick,throughout,toward,truncate,tube,unequal,vary,wall,wet,whitish,wide,yellow,ympodial	age,appressed,bract,branching,breeding,broad-based,calyx,colour,connective,erect,form,fruiting,geminate,growth,heteromorphism,inflated,inflorescence,insertion,interpetalar,length,marking,mature,modification,needle-like,null,odour,one-quarter,orientation,paired,pattern,placement,position,prickle,pseudostipule,rhizome,scale,shape,smell,spot,staman,stolon,stone,structure,surface,symmetry,sympodial,system,texture,tissue,trichome,type,vegetative,xylopodia,zygomorphy
342	wfo-0001029789	success	167	109	54	113	55	0.323	0-2,1-3,12,anther,apex,axillary,base,basiscopic,blue,bud,cm,corolla,decurrent,distal,filament,forked,fruit,hair,half,herb,interjected,leaf,leaflet,lilac,long,lower,lunate,minute,mm,mottled,odd-pinnate,pedicel,pentagonal,petiole,petiolulate,plurifoliate,pore,pubescent,rarely,rotate,sessile,short,side,simple,sparsely,star,sterile,subglabrous,subtending,terminal,tri-,typically,unit,white	0.2-0.5,0.5-2.8,0.8-3.5,1-10,1-2,1.5-2,1.7-8.5,1.8-6.5,2-25,2-3,2-6,2-6.5,2.7-4.7,3-5,3-8.5,4-10,4-13,5-7,5-merou,6,6-7,7-16.6,7-21,8-9,abaxially,acumen,acuminate,acute,adaxiall,adaxially,ag,alyx,apart,apparently,articulated,attenuate,axe,blade,broadly,capitat,chartaceous,clavate,connivent,dark,decreasing,diameter,dorsally,eaf,edge,eed,erec,exceeding,flat,flower,folded,formed,geminat,generally,glabrous,greatly,green,hal,homostylous,lanceolate,lant,lateral,lengthening,light,like,linear,lobe,long-attenuate,maturing,membranous,minutely,narrowly,never,nflorescence,orbicular,orolla,ovary,ovate,pair,peduncle,perfect,plant,poricidal,pubescen,purpl,rachi,seudostipule,size,slightly,slit,spaced,stamen,ste,stigma,straight,style,subequal,tall,tamen,tem,tinged,tip,toward,tube,usually,vary,x,yellow,ympodial	appressed,articulation,bract,branching,breeding,broad-based,calyx,cell,colour,connective,form,fruiting,geminate,growth,heteromorphism,inflated,inflorescence,insertion,interpetalar,length,margin,marking,mature,modification,needle-like,null,odour,orientation,paired,pattern,placement,position,prickle,pseudostipule,rhizome,scale,shape,smell,spot,staman,stem,stone,structure,surface,symmetry,sympodial,system,texture,tissue,trichome,tuber,type,vegetative,xylopodia,zygomorphy
343	wfo-0001029810	exception_thrown	149	0	0	149	0	0.0		.25,.5,0.5-1,0.5-3,1-1.3,1-1.5,1-10,1-2,1-3,1.1-2.3,1.5-3,2-3,2-5,2.5-3,3-3.5,3-4,3-6,4-10,5-15-flowered,5-16,5-6,8-12,abaxially,acuminate,acute,adaxially,along,anther,anthesi,ape,apex,apically,arachnoid,attenuate,bark,base,berry,brown,calyx,capitate,closely,cm,compact,compressed,congested,conical,corolla,dark,deflexed,deltate,dendritic,densely,dia,differing,difoliate,drying,eaf,edicel,eed,ellipsoid,elliptic,exserted,filament,fleshy,free,fruiting,geminat,glabrou,glabrous,globose,green,inflorescence,internodal,large,later,lateral,leaf,lenticel,less,like,lobe,lobed,lon,long,lower,main,major,margin,middle,minor,minutely,mm,narrowly,nearly,nflorescence,occasionally,older,opposite,ovary,overlappin,ovoid-reniform,pale,papillo,papillose,pedicel,petiole,pitted,planar,pointed,pore,poricidal,portion,pubescent,reddish-brown,rest,ruit,scar,shaped,shining,shrub,simple,size,slender,small,spaced,sparsely,stem,stigma,style,surface,tall,tan,tapering,tear-drop,tip,tree,trichome,tub,tube,ud,unit,vein,white,wide,widest,woody,yellowish,ympodial,young	
344	wfo-0001029811	exception_thrown	225	0	0	225	0	0.0		-3,-6,-merous,.5,/3,0,0-30,0-35,0.1-0.3,0.1-0.4,0.2,0.2-0.6,0.3-1,0.3-1.5,0.5-2,0.8-1.5,1,1-1.5,1-2.5,1-3,1.3-1.7,1.5-2.5,1.5-6,1/,1/2-2/3,1/3,1/3-2/3,10-22,13-20,15-23,15-50,2-2.5,2-5,2-5.5,2.5-3,2.8-3.2,20-100,3-5,3-5.5,3-7,3.5-4.5,4-8,4.5-5,5,5-11,5-17,5-40,5-9,6-12,7-18,7-9,8-12,8-18,abaxial,abaxially,acicular,adaxial,alyx,andromonoecious,anther,apar,apart,apex,apically,apparently,articulated,bark,base,berry,blade,broad-deltate,brown,calyx,cell,chartaceous,cm,connivent,cordate,cream,cuneate,dark,densely,diameter,discolorous,distal,distance,drying,eaf,eed,elongate,elongating,equal,erect,extending,eye,faint,fewer,filament,flattened,flattened-reniform,flower,free,fruit,fruiting,glabrous,glandular,green,green-brow,hair,herb,hermaphrodite,heterostylous,inflated,infructescence,lateral,leaf,length,less,lobe,lobed,lobing,long,long-acuminat,long-styled,longer,lower,lowermost,margin,marking,mature,maturity,mauve,midpoint,midvein,minute,mm,moderately,multangulate,naked,narrow-deltate,nflorescence,obtuse,often,older,one,open,orange-brown,orolla,oung,outline,ovate,pair,pale,pedicel,peduncle,pendulous,per,pericarp,perpendicular,petiole,pit,plant,plurifoliat,poricidal,porrect,portion,prickl,prickle,prickly,primary,raised,ray,ruit,scandent,scar,secondary,sessile,short,short-styled,shorter,shrub,side,simple,slightly,small,smooth,sometimes,spaced,sparsely,spherical,spreading,stalk,stalked,staminat,stellate,stellate-pubescent,stem,stout,straight,style,surface,tamen,tapering,terete,tertiary,time,tip,trichome,tube,unarmed,unbranched,unit,upper,usually,vary,vein,venation,visible,way,wide,woody,yellow,yellow-green,ympodial,young	
345	wfo-0001029978	exception_thrown	208	0	0	208	0	0.0		0.3-0.4,0.3-0.7,0.5-0.6,0.7-1.9,0.8,0.9-2.3,1-10,1-2,1.3-1.5,1.4-1.5,1.5-3.1,1.8-5,11-19,15-27,2-4,3-5,3-7,3.1-6.3,3.2-2.5,3.5-9.5,3.7-8.1,4-11,4-7,4.2-5.2,5,5-16.5,5-merou,8-10,abaxially,acumen,acuminate,adaxially,ag,along,alyx,anther,apart,apex,apparently,arranged,articulated,asymmetrical,attenuate,axe,axillary,base,basiscopic,bead,berry,blade,brownish,bud,capitat,cell,chartaceous,ciliate,clavate,cm,coarsely,commonly,condition,conical,connivent,corolla,covering,dark,darker,decreasing,diameter,digestion,distal,dorsally,drying,eaf,edge,eed,elliptic,enzyme,erec,especially,exceeding,filament,finely,flat,flower,folded,forked,fourt,fresh,fruit,geminat,generally,glabrou,glabrous,gradually,green,green-white,greenish,hair,hair-like,half,herb,homostylous,honeycomb-shaped,interjected,lanceolate,larger,lateral,leaf,leaflet,lengthening,less,light,like,living,lobe,long,lower,make,margin,medium,membranous,middle,midrib,minute,minutely,mm,moniliform,mottled,mucilaginous,multiple,narrow,necklace,nflorescence,odd-pinnate,orbicular,orolla,ovate,ovoid,pair,pedicel,peduncle,pentagonal,perfect,petiole,petiolule,plant,plurifoliate,pore,poricidal,puberulent,pubescen,pubescent,purple,ray,removed,ripe,rotate,ruit,secondary,seed,semierect,sessile,seudostipule,side,simple,size,slightly,slit,spaced,sparsely,specimen,stamen,ste,stem,stigma,stolon,straight,style,subequal,subsessile,subtending,symmetrical,tall,tamen,tem,terminal,testal,thick,throughout,tip,tissue,toward,tri-,tube,tuber,typically,unit,usually,vary,wall,wet,whitish,wide,wing,x,yellow,ympodial	
346	wfo-0001029980	success	173	77	26	147	51	0.15	anther,apex,appressed,base,berry,bright,calyx,corolla,filament,fruiting,globose,green,leaf,lower,margin,pale,pedicel,petiole,pore,shape,shrub,stem,surface,trichome,unit,white	.1,.5,0.1-0.25,0.25-0.5,0.25-1,0.5-1,0.5-1.2,0.5-2.5,0.5-5,0.7-1.3,0.8-1.2,0.9-4.5,1-1.5,1-1.7,1.2-2.5,1.5-2,1.5-6,2-5,2-6,2/3,3-4,3-9,5-10,5-50-flowered,6.4-17,abaxially,acute,adaxially,anthesi,apar,appearing,axil,ba,bark,black,brown,bud,closely,cm,conical,curved,dark,decurrent,deflexed,deltoid,density,dia,differing,difoliate,dried,drying,eaf,edicel,eed,elevation,elliptic,especially,exserted,five,flattened-reniform,free,geminat,glabrous,gray,greatly,greenish-white,high,impressed,incrassate,knob,lateral,live,lobe,lobed,lon,long,main,major,material,middle,minor,minutely,mm,near,nflorescence,node,often,older,one,onto,opposite,orbicular,ovary,ovate,overlapping,pair,paler,papillose,pitted,plant,poricidal,portion,prominent,proximal,puberulent,race,reflexed,rounded,ruit,scar,shaped,shiny,side,simple,size,slender,slightly,small-capitate,somewhat,soon,spaced,specimen,stigma,straight,style,tall,tan,tapering,tear-drop,tip,tube,tuft,ud,unicellular,uniseriate,varying,vein,venezuelan,way,whit,widest,winged,woody,x,yellowish,ympodial,young	articulation,bract,branching,breeding,broad-based,cell,colour,connective,form,fruit,growth,hair,heteromorphism,inflated,inflorescence,insertion,interjected,interpetalar,leaflet,length,marking,mature,modification,needle-like,none,odour,orientation,paired,pattern,placement,position,prickle,pseudostipule,rhizome,scale,smell,spot,staman,stellate,stone,structure,symmetry,sympodial,system,texture,tissue,tuber,type,vegetative,xylopodia,zygomorphy
347	wfo-0001029989	exception_thrown	161	0	0	161	0	0.0		.2,.5,/2,0.25-0.5,0.5-1,0.5-1.5,1-1.5,1-2,1-2.5,1-4,1.3-2.3,1.5-2.5,10-14,2.5-3,3-5,3-8,3.5-8,4-4.5,5-10-flowered,5-6,7-20,abaxial,abaxially,acute,adaxially,anther,anthesi,apex,bark,base,berry,branch,branched,broadly,brownish-re,calyx,capitate,central,closely,cm,collection,congested,conical,corolla,deflexed,deltoid,dendritic,dense,densely,described,dia,difoliate,dimaeter,discussion,drying,due,eaf,edicel,eed,elliptic,erect,exserted,filament,flattened,fleshy,free,fruiting,geminat,glabrous,globose,golden,gray,green,greenish-black,heteromorphic,incrassate,inflorescenc,inflorescence,internodal,lamina,lateral,leaf,lenticular,like,lobe,lobed,lon,long,lower,main,margin,middle,minutely,mm,nearly,nflorescence,nodding,northern,occasionally,older,opposite,ovary,overlappin,pair,papillo,pedicel,peru,peruvian,perÃº,petal,petaloid,petiole,pitted,planar,population,pore,poricidal,portion,probably,pubescence,pubescent,reddish,reddish-brown,rest,ruit,scar,scattered,see,shaped,shining,short-style,shrub,simple,small,somewhat,spaced,sparsely,stem,stigma,style,surface,tall,tear-drop,tip,tree,tree-like,trichome,tube,ud,unifoliate,unit,vein,way,white,wide,widest,woody,x,yellow,ympodial,young	
348	wfo-0001030000	success	155	116	59	96	57	0.381	1-10,1-2,1.5-2,2-3,3-,4-5,abaxially,adaxially,also,apex,base,calyx,cell,connective,connivent,densely,directed,distally,eglandular,ellipsoidal,fruit,glabrous,globose,green,hair,immature,laterally,long,lower,margin,mature,mm,moderately,oblong,occasionally,orange,pedicel,perfect,pilose,pore,puberulent,pubescent,purplish,shrub,small,sparsely,spotted,stellate,stone,subcoriaceous,tinge,tree,unbranched,unit,white,x,yellow,yellow-brown,yellowish	-4,-5,-50,-7,-pilose,0.5-,0.5-1,0.5-14,0.5-3,1,1-,1.5-,10-,10-20,15-25,2-2.5,2-4,2-5,2.5-,2.5-3,2.5-3.5,25-30,3-16,3-4,3.5-5,30-50,4,4-4.5,4-foliat,7-15,absent,acute,aggregate,apart,ape,apiculate,articulated,axe,biglandula,chartaceous,ciliat,cm,conspicuous,coriaceous,creamy-whit,cucullate,deltate,dia,diameter,dilated,eed,equal,exceeding,flattened,flower,leaving,lobe,lon,narrowly,nflorescence,nther,obtuse,orolla,ovoid,pedicellar,peduncle,produced,pubescen,rachi,radiu,rarely,remnant,ruit,scar,shorter,slightly,smal,spaced,stamen,stigma,strongly,style,swelling,tal,tem,thecae,tip,tomentose,triangular,truncate,tube,ud,umbrella-shaped,vary,wide,ympodial	4-foliate,anther,appressed,articulation,bract,branching,breeding,broad-based,colour,corolla,filament,form,fruiting,growth,heteromorphism,inflated,inflorescence,insertion,interjected,interpetalar,leaf,leaflet,length,marking,modification,needle-like,null,odour,orientation,paired,pattern,petiole,placement,position,prickle,pseudostipule,rhizome,scale,shape,smell,spot,staman,stem,structure,surface,symmetry,sympodial,system,tall,texture,tissue,trichome,tuber,type,vegetative,xylopodia,zygomorphy
349	wfo-0001030000	success	178	124	68	110	56	0.382	0.5-13,1-10,1-2,1.5-2,2-,2-3,3-,4-25,4-5,5-25,abaxially,also,apex,articulated,base,blade,calyx,cell,cm,connective,connivent,cordate,densely,directed,distally,eglandular,ellipsoidal,entire,fruit,glabrous,globose,green,hair,laterally,long,lower,margin,mature,mm,moderately,oblique,oblong,occasionally,often,orange,pedicel,perfect,petiole,pilose,pore,puberulent,purplish,shrub,simple,small,sparsely,stellate,stone,subcoriaceous,tinge,tree,unbranched,unit,white,x,yellow,yellow-brown,yellowish	-2,-4,-5,-50,-7,-pilose,0.5-,0.5-1,0.5-14,0.5-3,1,1-,1-1.5,1-5,1.5-,10-,10-20,15-25,2-2.5,2-4,2-5,2.5-,2.5-3,2.5-3.5,25-30,3-16,3-4,3.5-5,30-50,4,4-4.5,4-foliat,7-15,absent,acuminate,acute,adaxially,aggregate,apart,ape,apiculate,axe,basal,biglandula,chartaceous,ciliat,conspicuous,coriaceous,creamy-whit,cucullate,deltate,dia,diameter,dilated,eaf,eed,elliptic,equal,exceeding,flattened,flower,glabrescent,immature,leaving,lobe,lon,narrowly,nflorescence,nther,obtuse,orolla,ovate,ovoid,pedicellar,peduncle,pilo,produced,pubescen,pubescent,rachi,radiu,rarely,remnant,ruit,scar,shorter,slightly,smal,spaced,spotted,stamen,stigma,strongly,style,swelling,tal,tem,thecae,time,tip,tomentose,triangular,truncate,tube,ud,umbrella-shaped,vary,vein,wide,ympodial	4-foliate,anther,appressed,articulation,bract,branching,breeding,broad-based,colour,corolla,filament,form,fruiting,growth,heteromorphism,inflated,inflorescence,insertion,interjected,interpetalar,leaf,leaflet,length,marking,modification,needle-like,null,odour,orientation,paired,pattern,placement,position,prickle,pseudostipule,rhizome,scale,shape,smell,spot,staman,stem,structure,surface,symmetry,sympodial,system,tall,texture,tissue,trichome,tuber,type,vegetative,xylopodia,zygomorphy
350	wfo-0001030004	exception_thrown	177	0	0	177	0	0.0		.3,0-0.5,0-1.5,0.2-1,0.3-1,0.8-1.1,1-1.5,1-2,1.2-2,1.5-2.5,15,15-20,2-20,20-200-flowered,3-3.5,3-4,3.5-5,4-15,5-25,9-30,abaxial,abaxially,across,acuminate,acute,adaxially,along,always,anther,anthesi,apar,apex,appearanc,axillary,barely,bark,basal,base,berry,blade,body,branched,branching,broadly,bushy,calyx,capitate,cm,collection,cone,conical,corolla,crotaloid,decurrent,deltate,dendritic,dense,densely,denser,dia,diamete,distal,drying,eaf,edicel,eed,elliptic,erect,especially,exserted,filament,flat,flattened-reniform,fleshy,free,fruiting,giving,glabrous,globose,green,greenish-yello,hard,incrassate,inflorescence,juvenile,knob,lamina,large,later,lateral,leaf,like,lobe,lobed,long,loose,lower,main,many,margin,middle,minutely,mm,much,nearly,nflorescence,obovate,obovoid,occasionally,often,older,onto,ovary,pair,pale,papillate,papillo,pedicel,pericarp,petiole,pitted,planar,plant,plurifoliate,pore,poricidal,portion,possessing,prominent,pubescence,pubescent,rest,ruit,scar,seed,sessile,shaped,shrub,simple,small,spaced,sparsely,stem,stigma,stout,strongly,style,surface,surpassing,tall,tan,tear-drop,terminal,thick,thin,time,tip,translucent,tree,trichome,tub,tube,tuft,ud,unevenly,variously,vein,white,wide,widest,winged,woody,x,yellowish,yellowish-green,ympodia,young	
351	wfo-0001030007	exception_thrown	168	0	0	168	0	0.0		.05,.4,.5,0.1-0.5,0.2-1,0.5-1,0.8-1,1-1.5,1-15,1-2,1.5-5,1.6-2.2,15-20,2-4,2-7,3-5,3/4,4.5-5,6-10-flowered,7-10,7-9,abrupt,acuminate,acute,along,anther,anthesi,apart,apex,ba,bark,base,becoming,beneath,berry,branched,broadly,brown,bud,calyx,campanulate,clavate,closely,cm,cork,corolla,dark,decurrent,deltoid,densely,dia,difoliate,dry,edicel,eed,elliptic,erect,exserted,filament,flattened,fleshy,free,fruiting,geminateleaf,glabrate,glabrous,globose,golden,golden-pubescent,gre,green,hooded,impressed,incrassate,inflorescenc,lateral,leaf,like,live,lobe,lobed,lon,long,longer,lower,main,major,margin,material,middle,midrib,minor,minutely,mm,nflorescence,oblique,obovoid,occasionally,older,one,onto,opposite,outline,ovary,pair,pale,papillo,papillose,pedicel,petiole,pitted,planar,plant,pore,poricidal,portion,prominent,pubescent,raised,reniform,rest,rounded,ruit,scar,shaped,short,shorter,shrub,simple,slender,slightly,small,soft,soon,spaced,sparsely,specimen,stem,stigma,straight,style,surface,tall,tapering,tear-drop,thick,thickened,tip,tree,trichome,trunk,tub,tube,two,type,ud,uniseriate,unit,vein,way,white,widening,widest,winged,woody,x,ympodial,young	
352	wfo-0001030010	exception_thrown	156	0	0	156	0	0.0		.5,.75,/4,0.5-5,0.7-1,0.9-1.1,1-1.3,1-1.5,1-2,1.2-1.5,1.5-2,10-15,10-50-flowered,11-12,2-2.2,2-7,2.5,20-40,3-5,4-4.5,5-7,7-10,acuminate,acute,anther,anthesi,apex,appearing,area,attenuate,bark,basal,base,beneath,berry,brown,bud,calyx,closely,cm,corolla,cyathiform,dark,deciduous,decurrent,deflexed,deltate,dia,differing,difoliate,distal,dry,eaf,edicel,eed,ellipsoid,exserted,f,filament,fleshy,free,fruit,fruiting,furcate,geminat,glabrate,glabrous,globose,green,grey,hooded,lateral,leaf,lobe,lobed,lon,long,lower,m.,main,major,margin,materia,material,middle,midrib,minor,minute,minutely,mm,near,nearly,nflorescence,obovate,occasionally,often,older,one,opposite,orange,ovary,overlappin,ovoid-reniform,pair,papillose,pedicel,persistent,petiole,pitted,planar,pore,poricidal,portion,prominent,puberulent,rather,reddish,ruit,scar,shaped,shin,shrub,simple,size,slightly,small,smooth,soon,spaced,stem,stigma,straight,styl,style,surface,tall,tapering,tear-drop,tiny,tip,tree,trichome,trunk,tube,ud,uniseriate,unit,vein,way,white,widest,winged,woody,x,ympodial,young	
353	wfo-0001030023	success	171	122	64	107	58	0.374	1,1-2,1-8,1.5-7,6-7,abaxially,adaxially,apex,base,branched,calyx,cell,cm,color,connective,connivent,cordate,cuneate,deeply,directed,distally,ellipsoidal,entire,especially,finely,fruit,glabrous,glandular-puberulent,globose,greenish-white,hair,highly,loosely,lower,margin,mm,moderately,narrow,narrowly,near,oblique,oblong,often,pedicel,perfect,petiole,pore,present,probably,prominent,purplish-,simple,small,stellate,stone,subcoriaceous,swelling,tree,triangular,truncate,unit,unknown,x,yellowish	-,0-100+,0.5-1,1-,1.5-2,10-,10-25,11-40+,12-18,13-20,2,2-3,2.5-3.5,20-30,3-4.5,3-5,30-50+,4,4-10,4-12,4-foliat,5,5-,5-16,5-6,6-26,7-9,acute,aggregate,apart,ape,apiculate,articulated,axe,basal,beyond,blade,capitat,ciliate,cylindrical,densely,denser,diameter,dilated,eaf,eed,elliptic,exceeding,except,exserted,flattened,fleshy,flower,forked,glandular-puberulen,lanceolate,leaving,lobe,lon,long,main,membranaceous,nflorescence,nther,obtuse,occasionally,orolla,ovate,pedicellar,peduncle,peltiform,presen,puberulent,pubescen,pubescence,pubescent,pubescent-pilo,rachi,radiu,remnant,ripe,ruit,short-acuminate,shorter,slightly,somewhat,spaced,sparsely,stamen,stigma,style,tal,tem,thecae,time,tip,tube,ud,unbranched,unknow,usually,vary,vein,villous,wide,ympodial,young	4-foliate,anther,appressed,articulation,bract,branching,breeding,broad-based,colour,corolla,filament,form,fruiting,growth,heteromorphism,inflated,inflorescence,insertion,interjected,interpetalar,leaf,leaflet,length,marking,mature,modification,needle-like,null,odour,orientation,paired,pattern,placement,position,prickle,pseudostipule,pubescent-pilose,rhizome,scale,shape,smell,spot,staman,stem,structure,surface,symmetry,sympodial,system,tall,texture,tissue,trichome,tuber,type,vegetative,xylopodia,zygomorphy
354	wfo-0001030032	success	250	167	119	131	48	0.476	.05,.5,0.1-0.4,0.1-0.5,0.4-1.5,0.5-1.5,0.5-2,1-celled,1.5-2,1.5-2.5,2,2-10,2-4,2-5,3,4-5,4-6-celled,4-celled,5-plurifoliate,7-16,8-10-celled,abaxially,adaxially,along,also,anther,apex,articulated,articulation,base,basiscopically,branched,breaking,bright,calyx,cell,cm,completely,corolla,decurrent,densely,densest,diameter,ebracteate,entire,filament,fruit,fruiting,glandular,golden,green,head,herbarium,imparipinnate,interjected,internode,interrupted,large,larger,leaf,leaflet,length,like,long,longest,lower,many,margin,middle,mixed,mm,moderately,multicellular,node,oblique,older,onto,opposite,patent,pedicel,petiole,present,primary,pseudostipule,pubescence,pubescent,rachi,rotate,rotate-stellate,rough,set,shorter,simple,slightly,soft,sparsely,specimen,stem,subopposite,surface,tangled,time,tiny,touch,transparent,trichome,truncate,unicellular,uniseriate,unit,usually,vein,vine,weaker-walled,well-developed,white,wide,woody,yellow	+,0.2,0.2-0.3,0.2-0.5,0.25-0.4,0.5,0.5-0.6,0.5-0.7,0.5-1,0.6-1.1,0.7-0.8,0.8-1.0,0.8-1.1,1-1.3,1-1.5,1-2-celled,1-3,11-20,13-35,2-3-locular,2-3.5,2-60,2-lobed,2.4-3.5,3-5,3.0-3.5,3.5-12,30,4.3-5.0,6-11,60-80,7.5-10,8-10,8-20,absent,abundant,acuminate,acute,adaxial,anthesi,apical,appearance,appendage,basal,basally,bent,border,branche,brown,capitate,clambering,column,conical,conspicuou,dark,deltate,desne,dry,eaf,edicel,eed,elliptic,exserted,flower,free,give,glabrous,gree,greenish-brown,hair-like,halfway,hea,irregularly,lamina,lateral,leave,lobe,markedly,midvein,much,nflorescence,oblanceolate,obovate,occasionally,often,orbicular,outgrowth,ovary,pair,pale,paler,peduncle,petiolule,pithy,reflexed,rest,round,ruit,secondary,seed,silky,smaller,sometimes,somewhat,sparser,splitting,spreading,stamen,staminal,sterile,stigma,straight,style,swollen,tall,tem,terminal,tertiary,testa,thick,thickened,tip,tube,ud,vegetatio,venation,wall,winged,ympodial,younger,Â½-3/4	appressed,bract,branching,breeding,broad-based,colour,connective,dense,form,growth,hair,heteromorphism,inflated,inflorescence,insertion,interpetalar,marking,mature,modification,needle-like,null,odour,orientation,paired,pattern,placement,pore,position,prickle,rhizome,scale,shape,smell,spot,staman,stellate,stone,structure,symmetry,sympodial,system,texture,tissue,tuber,type,vegetative,xylopodia,zygomorphy
355	wfo-0001030048	success	156	129	74	82	55	0.474	.5,0.5-1.5,2-5,3-5,abaxially,acute,adaxially,anther,apex,apically,arachnoid,bark,base,berry,blue,brown,calyx,cm,corolla,decurrent,densely,difoliate,drying,elliptic,felt-like,filament,fleshy,free,fruiting,glabrate,glabrous,globose,golden,green,greyish,internodal,leaf,lobed,long,lower,margin,matted,middle,mm,nearly,older,onto,opposite,pale,pedicel,petiole,pointed,pore,poricidal,portion,pubescent,shaped,shrub,simple,small,somewhat,stem,surface,tall,tear-drop,tip,tree,trichome,trifoliate,tube,unit,white,widest,young	1-1.5,1-2,1.2-2,1.3-1.6,1.5-3.5,1.5-7,10-16,2-3,3-3.5,4-15,4-4.5,5-10-flowered,5-8,5973,abaxial,along,anthesi,ape,apparently,becoming,bi-colored,bi-lobed,broadly,clavate,closely,completely,conical,covered,deflexed,deltate,dia,eaf,edicel,eed,ellipsoid,exserted,fide,four-angle,geminat,impressed,inflorescenc,lamina,lateral,lightly,like,lobe,lon,main,minutely,nflorescence,occasionally,ovary,overlappin,ovoid-reniform,pair,papillo,papillose,pitted,planar,prominent,rather,reddish-brown,rest,ruit,scar,shiny,solomon,spaced,sparsely,stigma,strongly,style,tan,thick,thickened,tub,ud,vein,wide,woody,yellowish,ympodial	appressed,articulation,bract,branching,breeding,broad-based,cell,colour,connective,entire,form,fruit,geminate,growth,hair,heteromorphism,inflated,inflorescence,insertion,interjected,interpetalar,leaflet,length,marking,mature,modification,needle-like,null,odour,orientation,paired,pattern,placement,position,prickle,pseudostipule,rhizome,scale,shape,smell,spot,staman,stellate,stone,structure,symmetry,sympodial,system,texture,tissue,tuber,type,vegetative,xylopodia,zygomorphy
356	wfo-0001030053	success	141	102	46	95	56	0.326	1.3-3.5,aiding,apex,around,base,berry,branched,brown,calyx,cell,cm,coriaceous,corolla,entire,fide,fragrant,fruiting,glabrous,growth,inflorescence,lower,many,margin,mentz,pale,pedicel,petiole,reniform,revolute,shining,simple,sleeve,small,stem,support,surface,terminal,time,truncate,turbinate,twining,unit,vine,white,woody,yellowish	0.5,0.5-1,1-1.3,1-13,1.5-5.5,1.8-2,10-20,100,2-2.5,2.5-3,3.5-4,4-,5,5-merou,7-11,7-9,<,abruptly,abscission,acuminate,acute,alyx,anthesi,apart,apical,apiculae,ark,articulated,bfeore,branch,climbin,completely,cyathiform,decurrent,diameter,eaf,eed,elliptic,exserted,far,filiform,fine,flattened,flower,frui,greenish,hyaline,irregularly,leaving,lobe,lobed,long,minutely,mm,near,new,nflorescence,nipple,older,orolla,pair,papilla,papillo,parallel,peduncle,peg,pendant,per,perfect,pitted,plurifoliat,primary,rectangular,rim,scar,secondary,shallowly,shin,shiny,slightly,spaced,spreadin,spreading,strongly,tem,testal,tiny,tip,tube,ud,usually,vein,venation,x,ympodial	anther,appressed,articulation,bract,branching,breeding,broad-based,climbing,colour,connective,filament,form,fruit,hair,heteromorphism,inflated,insertion,interjected,interpetalar,leaf,leaflet,length,marking,mature,modification,needle-like,null,odour,orientation,paired,pattern,placement,plurifoliate,pore,position,prickle,pseudostipule,rhizome,scale,shape,smell,spot,staman,stone,structure,symmetry,sympodial,system,texture,tissue,trichome,tuber,type,vegetative,xylopodia,zygomorphy
357	wfo-0001030057	success	141	126	65	76	61	0.461	2-3-celled,2-4,2-6,20-80,8,abaxially,absent,adaxially,apex,apparently,axillary,base,berry,borne,bud,cell,chartaceous,cm,cordate,cuneate,distal,end,extremely,flower,fruit,generally,globose,green,hair,half,herb,high,interjected,leaf,leaflet,like,long,lunate,membranous,mm,narrow,odd-pinnate,pedicel,perfect,petiole,plant,plurifoliate,pubescent,scale-like,short,singly,small,stem,subglabrous,subtending,tall,terminal,tri-,truncate,tuber,typically,unit,unwinged,whitish,wing	-2,1-10,1-2,2-4.5,2.1-4.1,20-30,3-5,3.5-8,4-10,4.3-8.2,5.5-12,7-14,8-19,acuminate,acute,apart,articulated,axe,blade,broadly,brownish,condition,covering,decreasing,diameter,digestion,drying,eaf,eed,elliptic,enzyme,erec,forked,fresh,geminat,glabrou,greatly,green-white,greenish,hair-like,honeycomb-shaped,larger,lateral,living,make,mottled,mucilaginous,nflorescence,ovate,ovoid,pair,peduncle,petiolule,purple,removed,ruit,seed,seudostipule,size,sometimes,spaced,specimen,ste,stolo,suborbicular,tem,testal,thick,thir,throughout,toward,usually,wall,wet,x,ympodial	anther,appressed,articulation,bract,branching,breeding,broad-based,calyx,colour,connective,corolla,erect,filament,form,fruiting,geminate,glabrous,growth,heteromorphism,inflated,inflorescence,insertion,interpetalar,length,lower,margin,marking,mature,modification,needle-like,null,odour,orientation,paired,pattern,placement,pore,position,prickle,pseudostipule,rhizome,scale,shape,smell,spot,staman,stolon,stone,structure,surface,symmetry,sympodial,system,texture,third,tissue,trichome,type,vegetative,xylopodia,zygomorphy
358	wfo-0001030057	success	197	133	78	119	55	0.396	2-3-celled,2-4,20-80,5-6,8,abaxially,absent,adaxially,anther,apex,axillary,base,berry,borne,bud,cell,cm,cordate,corolla,cuneate,distal,end,extremely,filament,forked,fruit,generally,globose,green,greenish-yellow,hair,half,herb,high,homostylous,interjected,lanceolate,leaf,leaflet,lengthening,like,long,lower,lunate,margin,middle,mm,odd-pinnate,pedicel,pentagonal,petal,petiole,plant,plurifoliate,pore,poricidal,pubescent,rotate,scale-like,short,singly,slit,small,star,stem,striped,subglabrous,subtending,tall,terminal,tip,tri-,truncate,tuber,typically,unit,white,whitish	-10,-2,.5-3.5,1-10,1-2,2-3,2-4.5,2-5,2-6,2.1-4.1,20-30,3-5,3.5-8,4-10,4.3-8.2,5-10,5-merou,5.5-12,7-14,8-19,acumen,acuminate,acute,ag,along,alyx,apart,apparently,articulated,axe,blade,broadly,brownish,chartaceous,ciliate,condition,connivent,covering,decreasing,diameter,digestion,dorsally,drying,eaf,edge,eed,elliptic,enzyme,erec,especially,exceeding,flat,flower,folded,fresh,geminat,glabrou,glabrous,globo,greatly,green-white,greenish,hair-like,honeycomb-shaped,larger,lateral,linear,living,lobe,make,membranous,midrib,minutely,mottled,mucilaginous,narrow,nflorescence,orolla,ovate,ovate-lanceolate,ovoid,pair,peduncle,perfect,petiolule,puberulent,purple,removed,ruit,seed,seudostipule,size,sometimes,spaced,specimen,stamen,ste,stigma,stolo,straight,style,suborbicular,tamen,tem,testal,thick,thir,throughout,toward,tube,unwinged,usually,vary,wall,wet,wing,x,yellow,ympodial	age,appressed,articulation,bract,branching,breeding,broad-based,calyx,colour,connective,erect,form,fruiting,geminate,growth,heteromorphism,inflated,inflorescence,insertion,interpetalar,length,marking,mature,modification,needle-like,null,odour,orientation,paired,pattern,placement,position,prickle,pseudostipule,rhizome,scale,shape,smell,spot,staman,stolon,stone,structure,surface,symmetry,sympodial,system,texture,third,tissue,trichome,type,vegetative,xylopodia,zygomorphy
359	wfo-0001030080	success	186	121	67	119	54	0.36	0.4-1.5,0.5-4,1-2,4-12,absent,along,anther,apex,arranged,axillary,base,bead,berry,bud,cell,cm,coriaceous,corolla,cuneate,distal,dot,filament,forked,fruit,generally,glabrous,green,hair,half,herb,high,homostylous,interjected,lanceolate,leaf,leaflet,like,long,lower,mm,moniliform,multiple,necklace,odd-pinnate,ovate,pedicel,petiole,plant,plurifoliate,pore,poricidal,pyriform,sometimes,stellate,stolon,subtending,tall,terminal,throughout,tiny,tip,tri-,tuber,typically,unit,usually,white	0.3-7,1-3,1.5-2,1.5-2.5,1.8-4.5,1999,2-3,2-4,2.1-7.1,3-10,3-5,3.3-7.7,4-7,5-13.5,5-7,5-merou,5.5-9.9,6.5-18.6,8-16,8-23,9.9-33,abaxiall,abaxially,acumen,acuminate,adaxially,ag,alyx,apart,apparently,articulated,axe,blade,brownish,capitat,ccording,clavate,condition,connivent,covering,dark,decreasing,decurrent,diameter,digestion,dorsally,drying,eaf,edge,eed,elliptic,enzyme,erec,exceeding,flat,flower,folded,fresh,geminat,glabrescent,glabrou,green-white,greenish,hair-like,hal,honeycomb-shaped,inconspicuous,larger,lateral,lengthening,light,linear,living,lobe,make,medium,mottled,mucilaginous,nflorescence,ochoa,onto,orolla,ovoid,pair,peduncle,perfect,purple,rachi,removed,second,seed,seudostipule,size,slightly,slit,spaced,specimen,stamen,stigma,straight,strongly,style,subequal,tamen,tem,testal,thick,toward,tube,unknown,vary,wall,wet,whitish,width,winged,x,yellow,ympodial	appressed,articulation,bract,branching,breeding,broad-based,calyx,colour,connective,erect,form,fruiting,geminate,growth,heteromorphism,inflated,inflorescence,insertion,interpetalar,length,margin,marking,mature,modification,needle-like,null,odour,orientation,paired,pattern,placement,position,prickle,pseudostipule,rhizome,scale,shape,smell,spot,staman,stem,stone,structure,surface,symmetry,sympodial,system,texture,tissue,trichome,type,vegetative,xylopodia,zygomorphy
360	wfo-0001030081	success	157	137	82	75	55	0.522	0.25-0.5,0.5-2.5,1,1-2-celled,1-3,1.5-3,1.5-7,1st,2-foliate,2nd,abaxially,abundant,adaxially,along,anther,apex,apically,base,berry,blade,brown,calyx,cell,chartaceous,ciliate,cm,cordate,decurrent,densely,denser,drying,elliptic,elliptic-ovoid,entire,few-branched,filament,flat,fruit,geniculate,glabrous,globose,hair,herb,immature,interpetalar,longer,lower,lying,margin,maturing,membranaceous,mm,moderately,oblong,obtuse,often,one,other,pedicel,petiole,pointing,pubescent,rarely,rotate,rounded,semitransparent,single-,slightly,sometimes,sparsely,straight,surface,tissue,two-celled,unbranched,unit,usually,vein,white,woody,x,yellow	.5,0.5-1,0.5-1.5,1-2,1-4,1-5,1.5,10-20,10-35,2-4,2-7,3-10,3-6,4-6,5-12,5-15,absent,acute,adaxiall,axe,beyond,center,connected,dehiscing,diameter,dm,eaf,edge,eed,emarginat,equal,explosively,exserted,fine,flower,frui,geminat,held,linear-lanceolate,lobe,long,maturit,mesocarp,nearly,nfloresence,notch,orolla,parallel,peduncle,per,placenta,pressure,pubescen,rachi,radiating,raised,ridge,ruit,running,shallow,short,small,stamen,stigma,style,swollen,tal,tamen,tem,triangular,tube,vary,watery,wid,ympodial	appressed,articulation,bract,branching,breeding,broad-based,colour,connective,corolla,emarginate,form,fruiting,geminate,growth,heteromorphism,inflated,inflorescence,insertion,interjected,leaf,leaflet,length,marking,mature,mentioned,modification,needle-like,odour,orientation,paired,pattern,placement,pore,position,prickle,pseudostipule,rhizome,scale,shape,smell,spot,staman,stem,stone,structure,symmetry,sympodial,system,texture,trichome,tuber,type,vegetative,xylopodia,zygomorphy
361	wfo-0001030083	exception_thrown	146	0	0	146	0	0.0		.5,.75,0.1,0.25-0.5,0.5-1,0.5-2,0.8-1,0.8-3,1-1.5,1-2,1.5-3,10-30,2,2-3,2-5-flowered,3-4,3/4,4-15,4-6,9-11,accrescent,acute,anther,anthesi,apex,bark,base,beginning,berry,broadly,calyx,closely,cm,corolla,cup-shaped,dar,deciduous,decurrent,deeply,deflexed,deltoid,dia,dry,drying,eaf,edicel,eed,elliptic,elongate,exserted,fleshy,flower,fruit,fruiting,glabrous,globose,green,greenish-white,greyish-re,hyaline,inflorescenc,internodal,lateral,leaf,lobe,lobed,lon,long,long-acuminate,long-styled,lower,main,membranous,middle,minutely,mm,narrowly,near,nflorescence,older,onto,opposite,ovary,ovate,overlapping,ovoid-reniform,pair,pale,paler,papillae,papillose,pedicel,petiole,pitted,pore,poricidal,prominent,proximal,raised,red-papillose,reddish-gold,reflexed,ruit,scar,shallowly,shaped,short-styled,shrub,simple,single-stemmed,slender,slightly,small-capitate,somewhat,soon,spaced,specimen,stem,stigma,straight,strongly,style,surface,tall,tan,tapering,tear-drop,terminal,thickened,thin,tip,translucent,tub,tube,ud,unifoliat,unit,vein,way,white,widest,winged,woody,x,ympodial,young	
362	wfo-0001030093	exception_thrown	181	0	0	181	0	0.0		.2,.5,0,0.1-0.3,0.2,0.2-0.5,0.2-1,0.5-1.1,0.6-1.5,0.75-1,1-1.5,1-12,1-5,1.3-4.5,2-2.5,2.5-11,3-4,3.5-12,4-6,5-50-flowered,5-8,7-30,7-9,8-9,acuminate,acute,anther,anthesi,apar,apex,attenuate,bark,base,becoming,beneath,berry,branched,brownish-tan,calyx,campanulate,case,clavate,closely,cm,collection,commonly,continues,corolla,cuneate,deflexed,deltoid,densely,dia,differing,difoliate,eaf,edicel,eed,ellipsoid,elliptic,erect,especially,evenly,except,expanded,exserted,filament,flower,forest,free,fruiting,furcate,geminat,glabrous,globose,golden,green,greenish-white,greyish-brow,growth,guyanese,hirsutulous,hyaline,impressed,inundated,lateral,leaf,like,lobe,lobed,lon,long,long-styled,lower,main,major,many,margin,member,middle,minor,minutely,mm,narrowly,nearly,new,nflorescence,obovate,occasionally,often,older,one,onto,open,opposite,orbicular,ovary,ovoid-reniform,pair,pale,paler,papillo,pedicel,persisting,petiole,pitted,plant,population,pore,poricidal,portion,present,puberulent,pubescent,quite,reflexed,remaining,ruit,scar,shaped,shiny,shoot,short-styled,shrub,simple,size,slender,slightly,small,soon,southern,spaced,stem,stigma,straight,style,surface,tall,tapering,tear-drop,terminal,thickened,time,tiny,tip,tree,trichome,tub,tube,ud,underside,uniseriate,unit,vein,white,widest,woody,x,yellowish,ympodial,young	
363	wfo-0001030145	success	153	148	92	61	56	0.601	-2,-3,0.2-2,0.5,0.5-4,1,1-2,1-3,1.5,1.5-7,2-4,3,3-4,abaxially,acute,adaxially,adpressed,aggregate,also,apex,articulated,basal,base,blade,calyx,campanulate,cell,chartaceous,cm,compound,connective,cuneate,deltate,densely,directed,distally,dunal,ellipsoidal,elliptic,elliptic-ovate,entire,fide,forked,fruit,glabrous,glandular,globose,hair,herb,larger,lateral,leaf,leaflet,leaving,less,lobe,long,lower,margin,mm,moderately,narrowly,near,ovate-elliptic,pedicel,pedicellar,petiole,pilose,pore,puberulent,remnant,shrub,simple,sinuate,slightly,sparsely,stone,style,subcordate,subcoriaceous,terminal,ternately,time,triangular,truncate,unbranched,unit,unknown,violet,wide,x,yellow	0.3-,0.5-1,1-1.5,1-2.5,1-5,1.5-2,1.5-4.5,10-12,2-3,2.5-6.5,3-10,3-5,4-5,4-8,4-foliat,6-40,8-11,absent,apart,ape,axe,beyond,color,cylindrical,diameter,eaf,eed,exceeding,exserted,fleshy,flower,lanceolate,lon,nflorescence,nther,obtuse,orolla,peduncle,presen,puberulen,rachi,radiu,reddish,ripe,ruit,shorter,slender,somewhat,spaced,stamen,stigma,tal,tem,thecae,tomento,toward,truncat,tube,ud,vary,ympodial	4-foliate,anther,appressed,articulation,bract,branching,breeding,broad-based,colour,corolla,filament,form,fruiting,growth,heteromorphism,inflated,inflorescence,insertion,interjected,interpetalar,length,marking,mature,modification,needle-like,odour,orientation,paired,pattern,placement,position,present,prickle,pseudostipule,rhizome,scale,shape,smell,spot,staman,stem,structure,surface,symmetry,sympodial,system,tall,texture,tissue,tomentose,trichome,tuber,type,vegetative,xylopodia,zygomorphy
364	wfo-0001030146	success	210	97	47	163	50	0.224	acute,anther,apex,base,berry,branched,branching,calyx,cell,cm,coriaceous,corolla,echinoid,ellipsoidal,entire,filament,fruiting,globose,green,growth,inflorescence,leaf,length,lower,many,margin,mm,multangulate,pedicel,peltate,petiole,plurifoliate,pore,poricidal,revolute,simple,small,stellate,stem,surface,terminal,time,tree,treelet,trichome,unit,white	.1,.2,.5,0.2â0.4,0.5,0.5â1,0.6â0.7,0.6â2,0.9â1,1.2â1.5,1.5â2,16â20,1â1.1,1â1.5,2.5â9,20,20â30,2â5,3â4,3â6,40â50,4â30,4â4.5,5-merou,5â8,6.5â16,60+,6â7,8â15,9â9.5,>,abaxial,abaxially,absent,acuminate,adaxial,ag,almost,along,alyx,anthesi,apar,appearing,ark,articulated,axe,beig,beneath,bright,brown,brownish,c.,capitate,center,closely,connivent,covered,cup-shaped,dark,deeply,deltate,dense,densely,diameter,dichasia,discolorous,drying,eaf,edge,eed,elliptic,elongate,erec,exserted,flattened-reniform,flower,free,fresh,fused,glabrous,golden,gradually,halfway,ilament,impressed,lamina,layer,lengthening,less,like,lobe,lobed,long,loosely,midpoint,minutely,narrowing,narrowly,new,nflorescence,nodding,older,olive,orolla,pair,pale,papillose,part,peduncle,per,perfect,pericarp,persistent,pitted,plant,portion,primary,projection,pubescence,pubescent,ray,reddish,reflexed,regularly,rhachi,ripe,ruit,scar,scurfy,sessile,shiny,short-stalked,slit,spaced,sparsely,stigma,stout,strongly,style,subtended,tall,tan,tangled,tem,testal,thin,tiny,tip,tube,ud,undersurface,unevenly,upper,vary,varying,vein,visible,way,wide,woody,yellow,ympodial,â18	0.6-2,1-1.5,appressed,articulation,bract,breeding,broad-based,colour,connective,dichasial,form,fruit,hair,heteromorphism,inflated,insertion,interjected,interpetalar,leaflet,marking,mature,modification,needle-like,null,odour,orientation,paired,pattern,placement,position,prickle,pseudostipule,rhizome,scale,shape,smell,spot,staman,stone,structure,symmetry,sympodial,system,texture,tissue,tuber,type,vegetative,xylopodia,zygomorphy
365	wfo-0001030147	success	158	124	65	93	59	0.411	1-4,1-5,1.0-2.0,2-10,2.5-7.5,4-5.5,abaxially,adaxially,apex,base,blue,branched,calyx,cell,cm,conical,connate,corolla,cuneate,cyme,deep,dehiscent,dichasial,dichasially,distal,ebracteate,elliptical,filament,finely,green,hair-like,half,herbaceous,honeycomb,interjected,lateral,leaf,leaflet,long,lower,medium,mm,monochasial,narrowly,oblique,odd-pinnate,ovate,pattern,pedicel,perennial,perfect,petiole,plant,poricidally,proximal,pubescent,purple,rotate,rounded,testal,tuber-bearing,unit,wall,wide,Â¼	-8,0-5,0.5-2,1.0-2.2,10-19,14-35,15-30,2,2-10.5,2-13,2-3,2-5,3-,3-6-foliat,4-3.,4.2-7.5,4.5-10,5-7,5-8,8-38,abaxiall,acumen,acuminate,acute,apical,apically,articulate,attenuate,covering,diameter,digestion,diminishing,dorsally,eaf,edge,eed,emoval,enzyme,exceeding,flat,flower,folded,forked,generally,globo,gradually,green-white,introrse,living,lobe,lon,long-attenuate,lunat,make,maturing,mucilaginous,nflorescence,nther,obtuse,often,orolla,ovoid,pair,peduncle,petiolule,plan,reveal,ruit,seed,sessile,seudostipule,short,size,slit,specimen,stamen,stigma,straight,style,subequal,subsessile,tal,tem,terminal,thick,throughou,throughout,tip,toward,typically,vary,yellow,ympodial	3-6-foliate,4-31,anther,appressed,articulation,bract,branching,breeding,broad-based,colour,connective,form,fruit,fruiting,growth,hair,heteromorphism,inflated,inflorescence,insertion,interpetalar,length,lunate,margin,marking,mature,modification,needle-like,null,odour,orientation,paired,placement,pore,poricidal,position,prickle,pseudostipule,rhizome,scale,shape,smell,spot,staman,stem,stone,structure,surface,symmetry,sympodial,system,texture,tissue,trichome,tuber,type,vegetative,xylopodia,zygomorphy
366	wfo-0001030151	exception_thrown	175	0	0	175	0	0.0		-3,-50,0.2-0.5,0.3-0.5,0.5,0.5-1,1,1-1.5,1-17,1-2,1-3,1-5,1.5-2,1.5-2.5,10-20,10-25,15-35,2-11,2-25,2-3,2-6,2-7-compound,20-30,3-14,3-5,3.5-32,4-5,4-foliat,5-6,6-9,?,abaxially,absent,abundantly,acuminate,acute,adaxial,adaxially,aggregate,apart,ape,apex,apiculate,around,articulated,axe,basal,base,beyond,blade,blotch,calyx,cell,channe,chartaceous,ciliat,cm,compound,connate,connective,cordate,cuneate,cylindrical,decurrent,deltate,diameter,directed,distally,eaf,eed,eglandular,elliptic,entire,exceeding,except,exserted,flower,fruit,glabrate,glabrous,glandular,glandular-puberulent,globose,hair,lanceolate,leaf,leaflet,leaving,less,lilac-tinged,line,lobe,lon,long,longitudinal,lower,margin,membranaceous,mm,narrowly,near,nflorescence,nther,oblique,oblong,obovate,obtuse,often,orolla,pedicel,pedicellar,peduncle,perfect,petiole,pinnately,pore,presence,probably,puberulent,purplish,pyriform,rachi,radiu,remnant,ring,ripe,ruit,sand-punctat,sand-punctate,scattered,shallowly,short,shorter,simple,slender,slightly,small,sometimes,somewhat,spaced,sparsely,stalked,stamen,stellate,stigma,stone,stripe,style,surface,tal,tem,thecae,time,tip,toward,tree,triangular,truncat,truncate,tube,ud,unbranched,unit,unknow,vary,vein,veiny,white,white-puberulent,whitish,wide,x,yellow,yellow-green,ympodial	
367	wfo-0001030153	exception_thrown	147	0	0	147	0	0.0		.1,.2,/3,0.2-1,0.8-0.9,0.8-1.3,1-1.2,1-1.5,1-10,1-2,1-2.5,1.3-1.5,1.3-1.9,1.5-2,2-8,2-lobed,2.5-4,3-4,3-5,3-50,3.5-10.5,5-6,6-8,abaxially,absent,acuminate,acute,adaxially,age,anther,anthesi,apart,ape,apex,apiculate,apparently,attenuate,axil,bark,base,berry,branched,brittle,broadly,caly,calyx,campanulate,clavate,cm,conical,corolla,dark,deltate,densely,diameter,distinct,domatia,dot,dry,eaf,ellipsoid,elliptic,enlarged,entire,erect,exerted,filament,flower,free,fruiting,glabrou,glabrous,globose,green,growth,impressed,internodal,irregularly,known,lanceolate,lengthening,less,lobe,lobed,lower,margin,markedly,membranous,minutely,mm,narrowly,new,nflorescence,nodding,occasionally,older,ot,ovary,pair,paler,papillat,papillate,pedicel,peduncle,perfect,petiole,pit-like,plane,plurifoliat,pore,poricidal,portion,primary,rachi,resinous,revolute,ripe,ruit,scar,simple,slightly,slit,small,spaced,specimen,stem,stigma,straight,strongly,style,surface,terminal,thin,time,tip,tree,treelet,tube,ud,unit,vein,way,white,x,yellowish,ympodial,young	
368	wfo-0001030167	success	141	114	57	84	57	0.404	.8,0.6â0.8,14â19,1â1.5,4.5â8,accrescent,along,anther,apex,base,berry,blade,calyx,chartaceous,ciliate,climbing,cm,densely,entire,extra-axillary,filament,flattened,fruit,fruiting,gap,glabrous,green,herbaceous,less,lobe,long,lower,margin,membranaceous,minutely,mm,moderately,obtuse,ovoid,pedicel,petiole,pointed,rounded,sand-punctate,secondary,simple,somewhat,sparsely,stellate,subequal,symmetrical,thinly,unbranched,vegetation,vine,white,x	.9,0.1â0.2,0.5â0.6,0.5â0.7,0.6,0.7â1.2,0.8â1,1.2â2.5,1.5â2,1.5â7,12,15â20,17â58,1â1.2,2â3,2â4.5,4â10,4â4.5,4â5,4â7,5-merous,8â10,abaxially,acuminate,acute,adaxially,alyx,apar,apically,axe,branch,c.,ciliat,clavate,contiguously,diameter,eaf,eed,enlarged,fertile,flower,glabrou,immature,lanceolate,m.,maturity,membranous,near,nearly,nflorescence,nternode,orolla,ovate,pair,peduncle,penden,perfec,petal,pinnate,plurifoliat,rachi,reflexed,ruit,scar,seen,slender,slightly,spaced,stigma,style,tamen,tem,time,tip,truncat,tube,unit,unknown,vary,vein,venation,weakly,wide,ympodial	1-1.2,appressed,articulation,bract,branching,breeding,broad-based,cell,colour,connective,corolla,form,growth,hair,heteromorphism,inflated,inflorescence,insertion,interjected,interpetalar,leaf,leaflet,length,marking,mature,modification,needle-like,null,odour,orientation,paired,pattern,placement,plurifoliate,pore,position,prickle,pseudostipule,rhizome,scale,shape,smell,spot,staman,stem,stone,surface,symmetry,system,texture,tissue,trichome,tuber,type,vegetative,xylopodia,zygomorphy
369	wfo-0001030176	exception_thrown	171	0	0	171	0	0.0		-1.4,-4.25,-6.25,.2,.7,.75-1.5,0.4-1.5,0.5,0.5-2,0.6-0.9,0.7-1.4,0.7â0.8,1,1-2,1-5,1.2,1.2-2.5,1.5-2,1.5-2.5,1.6,1/3,1/6,2-3,2-foliate,2.25-3.25,2.5,2.5â7.5,2.5â9,2â3,3-5,3-lobed,3.75-5,4-9,5-merou,6-8,6â8,abaxially,accrescent,acute,adaxiall,adaxially,alyx,angulate,anther,apart,apex,apparently,articulated,asymmetrically,attenuate,axe,ba,basal,base,berry,bi-lobed,bilobed,blade,branch,broad,broadly,calyx,capitat,chartaceous,ciliate,cm,connivent,contact,covering,cylindrical,decumbent,dehiscent,depressed-globose,diameter,downward,eaf,eed,erec,especially,extra-axillary,few-branched,filament,flattened-reniform,flower,forming,fruit,fruiting,geminat,glabrous,hair,herb,hermaphroditic,hold,interlobal,juic,lance-ovate,lanceolate-oblong,lateral,light,line,lobe,lon,long,longitudinall,lower,major,margin,mesocarp,midrib,minutely,mm,near,nearly,nflorescence,node,numerous,oblong,often,orolla,ovate,pale,partially,patch,pedicel,peduncle,perfect,petiole,plant,pore,prostrate,pubescent,rachi,rarely,recurve,recurved,ripe,rooting,rotate-stellate,round,ruit,simple,sinus,slightly,soil,sometimes,somewhat,spaced,sparsely,stigma,style,tamen,tem,terminal,time,tip,triangular,tube,unbranched,unit,vary,vein,violet,white,white-puberulent,wide,winged,x,yellow,yellow-orange,ympodial,young	
370	wfo-0001030180	success	135	128	72	63	56	0.533	.1,.5,0.5-1,0.8-2,0.9-1.8,1-1.5,1.1-1.2,3-8,4.5-5,6,8-10,?,anther,anthesi,apex,apiculate,attenuate,bark,base,becoming,calyx,cm,corolla,dark,decurrent,deltoid,filament,free,fruit,fruiting,glabrate,glabrous,green,height,immature,interpetalar,lateral,leaf,lobe,long,long-acuminate,lower,main,mm,older,ovary,pair,papillate,pedicel,petiole,pore,portion,prominent,puberulent,rounded,shrub,soon,sparsely,stem,style,surface,tip,trichome,tube,uniseriate,unknown,vein,white,widely,x,yellowish,young	.75,0.05-1,10-30-flowered,3-4,8.5-23,abruptly,accrescent,apart,appearing,berry,clavate,clu,deflexe,dia,eaf,edicel,eed,ellipsoid,erect,exserted,furcate,globose,inflorescenc,known,lenticellat,linear,lobed,lon,middle,minute,minutely,narrowing,nearly,nflorescence,occasionally,opposite,overlapping,papillose,peduncl,planar,plurifoliat,poricidal,proximal,raised,ruit,scar,shaped,sinus,slender,slightly,spaced,stigma,straight,tear-drop,terminal,thin,ud,unevenly,unit,widest,winged,woody,ympodial	10-30,appressed,articulation,bract,branching,breeding,broad-based,cell,colour,connective,count,diameter,flower,form,growth,hair,heteromorphism,inflated,inflorescence,insertion,interjected,leaflet,length,lenticellate,margin,marking,mature,modification,needle-like,none,odour,orientation,paired,pattern,placement,position,prickle,pseudostipule,rhizome,scale,shape,smell,spot,staman,stellate,stone,symmetry,system,texture,tissue,tuber,type,vegetative,width,xylopodia,zygomorphy
371	wfo-0001030189	success	188	138	86	102	52	0.457	-1/2,-4,.2,/3,0.1-0.2,0.5-1.6,1,1-4-cellular,1.1-2.7,1.5-2,1.5-5,1/6-1/3,2,5-,8-10,anther,apex,apparently,appressed,base,berry,blade,branched,calyx,chartaceous,cm,concolorous,cordate,drying,entire,equal,erect,filament,fruit,fruiting,glabrous,gland-tipped,green,lateral,leaf,length,lobed,long,longer,lower,margin,mature,maturity,mauve,midpoint,mm,oblong,often,orange,ovate,pedicel,petiole,poricidal,porrect,purple,ray,red,rounded,scandent,sessile,shorter,shrub,simple,spherical,stalk,stalked,stellate,stem,surface,tapering,terminal,time,tip,trichome,unarmed,unit,variously,way,wide,yellow-green,young	0-1,0-15,0-30,0.1,0.2-0.3,0.2-0.5,0.9-1.1,1-1.5,1-2,1-3-cellular,1-4-cellula,1.3-4.2,1.5-4.5,1/,1/3,2-3,2-5.5,2.5-4,3-4,3.2-4.5,4-13,4-5.5,5-10,5-6,5-merous,6-10,6-12,8,8-18,abaxially,acut,alyx,apar,apically,articulated,bark,connivent,curved,deltate,densely,diameter,dull,eaf,eed,elliptic,elongating,evenly,faint,flattened-reniform,flower,foliaceous,free,frui,glabrescen,glabrescent,gray,infructescence,lobe,moderately,nflorescence,obtuse,older,one,open,orolla,oung,pair,peduncle,per,perfec,pericarp,plurifoliat,portion,primary,recurved,red-brow,reflexed,ruit,scar,slender,smooth,sometimes,somewhat,spaced,sparsely,spreading,stellate-pubescent,strongly,style,tamen,terete,tertiary,tube,unarme,upper,vary,vein,venation,visible,woody,yellow,ympodial	articulation,bract,branching,breeding,broad-based,cell,colour,connective,corolla,form,growth,hair,heteromorphism,inflated,inflorescence,insertion,interjected,interpetalar,leaflet,marking,modification,needle-like,null,odour,orientation,paired,pattern,perfect,placement,plurifoliate,pore,position,prickle,pseudostipule,rhizome,scale,shape,smell,spot,staman,stone,structure,symmetry,sympodial,system,texture,tissue,tuber,type,vegetative,xylopodia,zygomorphy
372	wfo-0001030219	exception_thrown	191	0	0	191	0	0.0		0.1â0.3,0.2â2.3,0.4â1.0,0.5,0.5â,0.7â1.1,0.8â3.0,0â,1.0â1.2,1.0â1.5,1.0â2.0,1.0â2.2,1.3â2.9,1.4â2.8,1.5,1.6â,10,15,1â2.5,2.0â2.5,2.0â3.2,2.0â5.5,2.4â6.0,2â,2â2.5,2â3,2â4.5,3,4.5â5.5,4.8â11.5,4â5,4â7,5,5â,5â8,60,6â,6â10,6â8,7â11,8â18,9â10,9â12,abaxiall,abaxially,acut,acute,adaxiall,adaxially,adnate,ag,along,anisophyllous,anther,anthesi,apart,apex,apical,apparently,appearing,arising,arranged,articulated,axe,ba,basal,base,black,blade,blue,bractâlike,branched,brown,calyx,cell,chartaceous,clavat,cm,concave,connivent,convex,cylindrical,decreasing,decurrent,deeply,densely,diamete,diameter,difoliate,directed,distally,eaf,eed,elliptic,equal,erect,filament,flattened,flower,fruit,geminat,glabrescent,glabrous,globose,green,hair,incised,indistinct,internode,lanceolate,leaf,lilac,lobe,long,longitudinal,lower,margin,marking,mm,moderately,multicellular,nflorescence,number,oblong,olive,opening,opposed,oppositely,orolla,ovate,pair,pale,paler,pedicel,peduncle,pentagonal,perennial,perfect,petiole,pitted,pore,present,procumbent,pubescent,purple,rapidly,redâpurple,regularly,rounded,ruit,serrate,sessile,shallowly,shrub,sid,side,simple,size,smaller,spaced,sparsely,split,stigma,stone,straight,stripe,strongly,style,surface,tal,tamen,tem,time,tube,two,unicellular,uniseriate,unit,vary,velutinous,white,wide,wing,winged,woody,x,yellow,ympodial,â3.0,â7.0,â9.5	
373	wfo-0001030225	success	155	122	66	89	56	0.426	-1.5,1,1-6,2,2-18,3-11-compound,3-20,3-4,abaxially,acuminate,acute,adaxially,apex,basal,base,blade,calyx,campanulate,cm,compound,connective,cordate,coriaceous,cuneate,densely,directed,distally,elliptic-ovate,entire,fleshy,forked,fruit,globose,laterally,leaf,leaflet,less,lobe,long,lower,margin,mm,moderately,oblong,pedicel,petiole,pinnately,pore,possibly,puberulent,purple,shallowly,shrub,simple,small,somewhat,stalked,stellate,succulent,time,tree,unbranched,unit,unknown,wide,x	-11,-30,-4,-45,-7,.5,.5-2.5,0,0-20,0-5,1-4,1.5,1.5-2.5,10-15,10-30,2-2.5,2-3,2-6,3-5,3-foliat,4-5,8-15,absent,apart,ape,apical,apically,articulated,ature,axe,beyond,bilobed,color,conivent,cylindrical,deltate,diameter,dilated,eaf,eed,equal,especially,exceeding,expanded,exserted,flower,glabrate,glabrous,gland,immature,leaving,minutely,narrowly,nflorescence,nther,obtuse,one,orolla,papillose,peduncle,perfect,prominent,puberulen,rachi,radiu,scar,see,seen,slightly,spaced,sparsely,stamen,stigma,strongly,style,tal,tem,thecae,tip,tomento,toward,triangular,truncate,tube,two,ud,unknow,vary,ympodial	3-foliate,anther,appressed,articulation,bract,branching,breeding,broad-based,cell,colour,corolla,filament,form,fruiting,growth,hair,heteromorphism,inflated,inflorescence,insertion,interjected,interpetalar,length,marking,mature,modification,needle-like,odour,orientation,paired,pattern,placement,position,prickle,pseudostipule,rhizome,scale,shape,smell,spot,staman,stem,stone,structure,surface,symmetry,sympodial,system,texture,tissue,trichome,tuber,type,vegetative,xylopodia,zygomorphy
374	wfo-0001030250	success	169	169	116	53	53	0.686	.5,/4,0-seeded,0.5-1,1-1.5,1-3,1.1-3.5,1.7-7,11.2-22,11.3,2.1-6,2.5-3.25,25,3-5,3.4-6.6,5-50-flowered,6-8,anther,anthesi,apex,arching,attenuate,bark,base,beneath,berry,broadly,bullate,calyx,carinate-hooded,cm,consisting,corolla,cuneate,cup-shaped,dark,decurrent,dia,differing,difoliate,dry,elliptic,elliptic-ovate,filament,five,fresh,fruiting,glabrous,globose,green,greenish-white,greenish-yellow,horizontally,inflorescence,irregularly,lateral,leaf,lobe,long,long-acuminate,lower,main,major,middle,minor,minutely,mm,n,node,occasionally,older,one,opposite,orbicular,orbiculate,pair,pale,paler,papillose,pedicel,pendulous,petiole,pore,poricidal,projection,prominent,proximal,raised,reflexed,rim,sea-green,shape,shaped,shrub,simple,size,slender,slightly,specimen,spreading,stem,surface,tall,tapering,tear-drop,tip,translucent-green,tube,unit,vein,way,white-lenticellate,wide,widest,winged,x	1.1-1.2,1.25-1.5,1.4-1.5,1.9-2.6,2-2.5,3.5-4,4-7,5-6,across,apart,appearing,beginning,brown,capitate,conical,curved,deflexed,eaf,edicel,eed,exerted,free,geminat,glabrou,inflorescenc,lobed,lon,maturity,nflorescence,ovary,ovoid-reniform,papillo,pit,pitted,portion,ruit,scar,seed,shallow,smooth,soon,spaced,stigma,straight,style,tan,translucent,two,ud,usually,white-lenticellat,woody,ympodial	appressed,articulation,bract,branching,breeding,broad-based,cell,colour,connective,form,fruit,geminate,growth,hair,heteromorphism,inflated,insertion,interjected,interpetalar,leaflet,length,margin,marking,mature,modification,needle-like,null,odour,orientation,paired,pattern,placement,position,prickle,pseudostipule,rhizome,scale,smell,spot,staman,stone,structure,symmetry,sympodial,system,texture,tissue,trichome,tuber,type,vegetative,xylopodia,zygomorphy
375	wfo-0001030271	success	195	102	49	146	53	0.251	0-2,1-2,1.4-2.1,2-6,anther,apex,attenuate,base,berry,blue,cell,cm,coriaceous,corolla,deep,filament,forked,fruit,glabrous,green,herb,homostylous,interjected,leaf,leaflet,light,lilac,lower,medium,mm,moniliform,odd-pinnate,ovoid,pedicel,pentagonal,petiole,petiolulate,plurifoliate,pore,rotate,rounded,slightly,spot,terminal,tissue,tuber,typically,unit,white	0.15-0.75,0.5-1.2,0.7-9.5,0.9-2.5,0.9-3.6,1-2.5,1-3,1-4,1-6,1-7,1.9-6.6,15-61,2-2.7,2-3,2-4,2.4-5.6,3-10,3-5,3.4-7.5,4-22,4-7,5-8,5-merou,5.6-12.3,6-15,abaxially,acumen,acute,adaxiall,adaxially,ag,along,alyx,apart,apparently,arranged,articulated,asymmetric,axe,axillary,basiscopic,bead,blade,brownish,bud,capitat,clavate,coloration,completely,condition,connivent,considerably,covering,dark,decreasing,diameter,digestion,distal,dorsally,drying,eaf,edge,eed,elliptic,enzyme,erect,exceeding,flat,flower,folded,fresh,geminat,generally,glabrou,green-white,greenish,habi,hair-like,half,honeycomb-shaped,lanceolate,larger,lateral,lengthening,like,linear,living,lobe,long,make,middl,mottled,mucilaginous,multiple,necklace,nflorescence,orbicular,orolla,ovate,pair,peduncle,perfect,plant,poricidal,purple,removed,ripe,rosette,ruit,seed,sessile,seudostipule,side,size,slit,sometimes,spaced,specimen,stamen,stigma,stolon,straight,style,subtending,symmetric,tall,tamen,tem,testal,thick,throughout,tip,toward,tri-,tube,unwinged,usually,vary,vein,wall,wet,whitish,wide,x,yellow,ympodial	appressed,articulation,bract,branching,breeding,broad-based,calyx,colour,connective,form,fruiting,geminate,growth,hair,heteromorphism,inflated,inflorescence,insertion,interpetalar,length,margin,marking,mature,middle,modification,needle-like,null,odour,orientation,paired,pattern,placement,position,prickle,pseudostipule,rhizome,scale,shape,smell,staman,stem,stone,structure,surface,symmetry,sympodial,system,texture,trichome,type,vegetative,xylopodia,zygomorphy
376	wfo-0001030272	exception_thrown	179	0	0	179	0	0.0		-6,.3,.5,/4,0-20,0.05-0.1,0.05-1.5,0.5-1,0.5-1.5,0.5-2,0.6-0.9,0.65-1,0.7-2.5,0.8-1.5,1,1-1.5,1-2.8,1.2-1.8,1.5-2.5,1.5-3,1/3,1/3-2/3,10-20,2-2.5,2-6.5,2.5-3,2.5-3.5,2.8-3.5,3-8,3.5-5,4-10,4-15,4-6,4-8,5-7,5-merous,abaxially,acut,acute,almost,alyx,ame,anther,apar,apex,apically,apparently,articulated,ba,bark,base,berry,blade,bright,c.,calyx,cm,concolorous,connivent,deltate,densely,diameter,difoliate,drying,eaf,eed,elliptic,elongating,entire,equal,erect,evenly,filament,flattened-reniform,flower,free,fruit,fruiting,geminat,glabrescen,glabrescent,glabrous,gland,glandular,gra,green,hair,infructescence,lateral,leaf,length,less,lobe,lobed,long,long-attenuate,longer,lower,margin,mature,maturity,mauve,membranous,midpoint,minute,mm,moderately,multangulate,narrow-deltate,near,nflorescence,obtuse,older,one,open,orange-brown,orolla,oung,pair,pedicel,peduncle,per,perfec,pericarp,petiole,poricidal,porrect,portion,primary,ray,red,red-brown,reduced,reflexe,rounded,ruit,scar,sessile,shallowly,shorte,shrub,simple,slender,smooth,sometimes,spaced,sparsely,spherical,spreading,stellate,stellate-pubescent,stem,straight,style,surface,tamen,tapering,terete,terminal,tertiary,time,tip,trichome,tube,unarme,unarmed,unbranched,undulate,unit,upper,vary,vein,venation,visible,way,wide,woody,ympodial,young	
377	wfo-0001030287	success	150	142	82	68	60	0.547	-11,-many,.5-2.5,0.5-1,1-2,1-4,1.5-10,2-,2-10,3,3-9,4-6,4.5-6,?,abaxially,acute,adaxially,aggregate,apex,base,basiscopically,blade,bluish,branched,calyx,cell,chartaceous,cm,compound,connivent,decurrent,dendritic,dendritically,densely,directed,eglandular,ellipsoidal,elliptic-ovate,entire,forked,glabrous,gland,hair,herb,lanceolate,lateral,leaf,leaflet,lilac,long,long-stalked,lower,margin,mm,moderately,narrowly,oblong,often,ovoid,pedicel,petiole,pinnately,pore,pubescent,purple,scattered,shrub,simple,slightly,stalked,stellate,stone,subcordate,subcoriaceous,time,truncate,unbranched,unit,unknown,upper,wide,x	-40,-foliat,0-15,1,1-10,1-15,1-2.5,1-3,1-5.5,1.5-2.5,1966,2,2-12,2-5,2.5-4,4-5,5-10,8-13,adaxiall,apart,articulated,axe,color,cylindrical,deltate,dendritic-pubescen,diameter,distall,down,eaf,eed,fide,flattened,flower,glandular,leaving,lobe,lon,membranaceous,nflorescence,nther,obtuse,orolla,pedicellar,peduncle,presen,puberulent,rachi,radiu,rugulose,ruit,scar,smith,spaced,sparsely,sparser,stigma,strongly,style,subcapitat,tal,tem,tip,triangular,tube,vary,yellow,ympodial	-foliate,anther,appressed,articulation,bract,branching,breeding,broad-based,colour,connective,corolla,dendritic-pubescent,distally,filament,form,fruit,fruiting,growth,heteromorphism,inflated,inflorescence,insertion,interjected,interpetalar,length,marking,mature,modification,needle-like,null,odour,orientation,paired,pattern,placement,position,present,prickle,pseudostipule,rhizome,scale,shape,smell,spot,staman,stem,structure,surface,symmetry,sympodial,system,tall,texture,tissue,trichome,tuber,type,vegetative,xylopodia,zygomorphy
378	wfo-0001030300	exception_thrown	235	0	0	235	0	0.0		-0.9,-1,-7,.5,0.1,0.1-0.15,0.15-1,0.2,0.2-0.5,0.2-1.5,0.4-0.5,0.4-1.5,0.4-4.5,0.5,0.5-0.6,0.5-1,0.5-4,0.5-5,0.6-0.7,0.6-0.8,0.7-0.8,0.7-1.2,0.7-1.5,0.8-1,0.8-3,0.8-4,0.9-1,1,1-1.3,1-2,1-2-celled,1-4,1-6,1-celled,1.2-,1.4-2.4,1.5-,1.5-2.5,2-2.1,2-2.5,2-3,2-4,2-foliate,2-locular,2.2-7.5,3.5-13,3/4,4-11,4-celled,6-15,6-8-celled,9-12,abaxially,absent,abundant,acute,adaxial,adaxially,almost,although,always,anther,anthesi,apex,apical,appearance,appendage,articulated,articulation,ba,basal,base,bent,beyond,bifid,bract,bracteate,brittle,broadly,brown,calyx,capitate,cell,cm,coherent,column,cordate,corolla,crenat,crenate,curved,deltate,densely,developed,diamete,diameter,distal,eaf,edicel,eed,eglandular,ellipsoidal,elliptical,elongate,entire,even,exserted,face,filament,finely,flower,frequently,fruit,fruiting,give,glabrous,glandular,globose,glutinous-viscose,golden,gree,green,hair-like,halfway,head,herb,imparipinnate,inflorescence,interjected,internode,interrupted,introrse,irregularly,lamina,large,larger,lateral,leaflet,leave,less,like,lobe,lon,long,longer,margin,markedly,midvein,minute,mm,moderately,multicellular,narrowly,nflorescence,node,oblique,obovate,occasionally,once-branched,orbicular,outgrowth,ovary,pair,pale,papillae,partially,pedicel,peduncle,pentagonal,perennial,petal,petiole,petiolule,pith,plant,population,pore,present,primary,pseudostipule,pubescence,pubescent,reflexed,rest,rounded,ruit,secondary,silky,simple,slightly,sparsely,spathulate,spreadin,spreading,staminal,stem,sterile,stigma,straight,strongly,style,surface,tall,tem,terminal,tertiary,testa,thick,tip,triangular,trichome,tube,two,ud,underlying,unicellular,uniseriate,unit,united,upper,usually,vein,velvety,wall,weak,well,wide,wider,winged,woody,yellow,yellowish,yellowish-green,ympodial,zygomorphic	
379	wfo-0001030311	exception_thrown	182	0	0	182	0	0.0		.2,.5,.5â1.8,0.1,0.1â0.2,0.3â1.5,0.4â2,0.5â0.8,0.5â1,0.5â2,0.5â2.5,0.6â1,0.6â2.4,0.8â1.2,0.8â4,0.8â4.5,1.2â7,1.5â2,1.5â3,1.5â5.5,1.5â6,1.5â8,1.8â2,15â22,1â1.2,1â1.5,1â2,1â2.5,1â3,2.2â2.5,2.2â3,2.5â9,2â10,2â2.5,2â6,3â5,3â7,5-pinnate,5â10,<,abaxially,accrescent,acuminate,acute,adaxial,adaxially,along,alyx,anther,apar,apex,apical,appearance,axe,basal,base,berry,blade,brown,c.,calyx,capitat,chartaceous,ciliat,ciliate,clavate,cm,color,cordate,cuneate,deltoid,dense,densely,diameter,distal,eaf,eed,elliptical,entire,especially,extra-axillary,falcate,fallen,filament,flattened,flower,fruit,fruiting,giving,glabrou,glabrous,granular,green,groov,groove,ground,hair,half,herbaceous,lanceolate,lateral,leaflet,lenticular,like,lobe,log,lon,long,lower,m.,margin,membranaceous,membranous,midvein,minutely,mm,nflorescence,nternode,oblique,obovate,obtuse,occasionally,orangish,orolla,ovoid-rhomboid,pair,papillose,pedicel,peduncle,petiole,petiolulate,petiolule,plurifoliat,present,proximal,pubescence,pubescent,purplish,rachi,rhomboid,rounded,ruit,sand-punctate,scattered,sessile,short,shortly,side,slender,slightly,smaller,spaced,sparsely,stellate,stem,stigma,strongly,style,surface,tamen,tan,tem,terrestrial,thick,thickened,thinner,tip,trailing,trichome,tube,unbranched,unit,upper,vary,vein,vine,white,wide,wide-diameter,widely,x,ympodial	
380	wfo-0001030311	exception_thrown	203	0	0	203	0	0.0		.2,.5,.5-1.8,0-2.5,0.1,0.4-2,0.5-0.8,0.5-1,0.5-2,0.6-1,0.6-2.4,0.8-1.2,0.8-4,0.8-4.5,1-1.2,1-1.5,1-2.5,1-3,1.2-7,1.5-2,1.5-3,1.5-5.5,1.5-6,1.5-8,1.8-2,15-22,2-10,2-2.5,2-6,2.2-2.5,2.2-3,2224,3-5,3-7,5-10,5-merou,5-pinnate,8031,<,[,],abaxially,absen,absent,accrescent,acuminate,acute,adaxial,adaxially,ag,aggregate,along,alyx,anther,apart,apex,apical,apparently,appearance,articulated,axe,ba,basal,basally,base,blade,brown,capitat,cell,chartaceous,ciliat,ciliate,clavate,cm,color,connivent,cordate,cuneate,deltoid,dense,densely,diameter,dig,directed,distal,distally,eaf,eed,elliptical,entire,equal,especially,falcate,fallen,filament,flattened,flower,formation,fruit,g,geminat,gh,giving,glabrous,granular,green,groov,groove,ground,hair,half,herb,interjected,large,lateral,leaflet,lenticular,like,lobe,log,lon,long,longitudinal,lower,m.,margin,membranaceous,midvein,minutely,mm,nflorescence,node,oblique,oblong,obovate,obtuse,occasionally,opening,orangish,orolla,ovoid-rhomboid,pair,papillose,pedicel,peduncle,perfect,petiole,petiolulate,petiolule,pittier,plurifoliate,pore,present,proximal,pubescent,purplish,rachi,rhomboid,rooting,rounded,ruit,scattered,sessile,short,shortly,side,simple,sinple,slender,slightly,slit,smaller,spaced,sparsely,stellate,stem,stigma,stone,strongly,style,surface,tamayo,tamen,tan,tem,thick,thickened,thinner,tip,trailing,tube,unbranched,uniseriate,unit,upper,vary,vein,white,wide,widely,x,yellow,ympodial	
381	wfo-0001030335	success	153	77	22	131	55	0.144	anther,apex,base,berry,calyx,corolla,filament,fruiting,globose,green,leaf,lower,pedicel,petiole,pore,shrub,stem,surface,trichome,unit,white,yellowish-green	.1,.25,.5,.75,0-5,0.05-0.2,0.1-0.5,0.25-0.5,0.5-1,0.7-1,1-1.5,1-2,1-3-flowered,1.1-1.4,1.1.5,2-2.2,2-2.5,2-4.5,2-5,2.5-3,3/4,5-6,5-7,7-13,acuminate,acute,along,anthesi,aspec,ba,bark,beneath,bi-lobed,branch,bud,cm,conical,dark,deciduous,decurrent,deflexed,deltoid,densely,dia,dry,eaf,edicel,eed,elliptic,erect,except,expanded,exserted,filiform,flattened,free,geminate,gently,giving,glabrous,greyish-red,horizontally,lamina,lateral,lenticellate,lightly,like,lobe,lobed,lon,long,main,material,middle,minute,minutely,mm,narrowly,nflorescence,obovoid,occasionally,often,older,onto,opposite,ovary,ovoid-reniform,pair,pale,papillo,papillose,pitted,poricidal,portion,prominent,puberulen,puberulent,pubescent,raised,reflexed,ripe,ruit,shaped,simple,slightly,soon,sparsely,spreading,stigma,straight,strongly,style,tall,tan,tapering,tear-drop,tip,tube,ud,underside,unifoliat,uniseriate,vein,way,widest,winged,woody,x,yellow,ympodial,young	appressed,articulation,bract,branching,breeding,broad-based,cell,colour,connective,form,fruit,growth,hair,heteromorphism,inflated,inflorescence,insertion,interjected,interpetalar,leaflet,length,margin,marking,mature,mentioned,modification,needle-like,none,odour,orientation,paired,pattern,placement,position,prickle,pseudostipule,rhizome,scale,shape,smell,spot,staman,stellate,stone,structure,symmetry,sympodial,system,texture,tissue,tuber,type,vegetative,xylopodia,zygomorphy
382	wfo-0001030336	exception_thrown	266	0	0	266	0	0.0		-1.5,-10,-19,-2,.5,0-,0.1-0.3,0.1-0.5,0.1-0.7,0.1-1,0.15-0.2,0.15-0.9,0.2,0.2-0.25,0.2-0.8,0.2-1,0.2-1.5,0.3-0.4,0.3-1.1,0.5,0.5-0.7,0.5-1,0.5-1.5,0.6-0.8,0.6-1.5,0.8-0.9,0.8-1.2,0.8-1.3,0.8-3,1,1-1.4,1-1.5,1-3,1-celled,1.0-1.4,1.5-,1.5-2,1.5-3.5,1.5-5,1.6-7,1.7-2.3,1.8-3.0,1/4-1/3,10,2-4,2-9,2-foliate,2-locular,2/3,3-5,4,4-,4-10,4-celled,6,8-16,8-20,8-celled,absent,acute,adpressed,almost,amongst,anther,anthesi,apex,apical,appearance,appearing,appendage,articulated,articulation,basal,base,basiscopically,bent,berry,bifurcate,bluntly,bract,bracteate,branch,bright,brown,calyx,capitate,cell,clavat,cm,coat,column,completely,conical,cordate,corolla,crenate,curved,dark,darker,decurrent,deeply,densely,developed,diamete,diameter,distal,divided,eaf,edicel,eed,eglandular,elliptic,elongate,entir,entire,erect,essentially,exserted,extremely,filament,first,flower,flushed,fruit,fruiting,giving,glandula,glandular,globose,grayish,green,greenish,hair-like,half,halfway,head,herb,imparipinnate,inflorescence,interjected,internode,interrupted,investing,lanceolate,large,larger,largest,lateral,leaf,leaflet,leave,less,like,lobe,lobed,lon,long,longer,loosely,lower,margin,markedly,maturity,mere,middl,midvein,minute,minutely,mixed,mm,mostly,narrowing,narrowly,nflorescence,node,oblique,obovate,occasionally,often,once-branched,orbicular,outgrowth,ovary,pair,pale,papillate,part,pedicel,peduncle,perennial,petiole,petiolule,population,present,primary,proximal,pseudostipule,puberulent,pubescent,purple,rachi,range,reflexed,rest,rotate,rounded,ruit,scattered,secondary,sessile,shaggy,shorter,shrub,silky,simple,sinus,slightly,small,soft,sometimes,southern,sparse,spreadin,spreading,staminal,stellate,stem,sterile,stigma,straight,stripe,strongly,style,surface,surrounding,tall,tem,ten,terminal,tertiary,testa,thick,tip,trichome,truncate,tube,two,ud,unicellular,uniformly,uniseriate,unit,united,upper,usually,velvety,wall,way,weak-walled,white,wide,winged,woody,yellow,ympodial,young	
383	wfo-0001030342	exception_thrown	155	0	0	155	0	0.0		.2,.5,0.1â0.2,0.3â1.2,0.5â1,0.5â3,0.5â5,0.8â1.5,0.8â4,1-5,1-6.5,1.2â3,1.5,1.5â13,1.5â2,1.5â5,1.5â7.5,10â25,1â1.2,1â1.5,1â2.5,1â3,1â5.5,1â6,1â7,2â,2â2.5,2â4,3,3-pinnate,3â12,4â5,4â8,5-merous,6â7,abaxially,abundant,accrescent,acuminate,acute,adaxially,along,alyx,anther,apar,apex,apical,apiculate,axe,base,berry,blade,broadly,brown,c.,calyx,capitat,chartaceous,ciliat,cm,cordate,cuneate,cylindrical,deltoid,dense,diameter,eaf,eed,elliptical,entire,extra-axillary,filament,flattened,flower,fruit,fruiting,glabrou,glabrous,greenish,herbaceous,lanceolate,lateral,leaf,leaflet,lenticular,light,like,lobe,lon,long,lower,m.,margin,membranous,minutely,mm,mottled,nflorescence,nternode,oblique,obtuse,often,orolla,ovoid-rhomboid,pedicel,peduncle,perfec,petiole,petiolule,plurifoliat,pointed,proximal,pubescen,pubescent,rachi,rarely,revolute,rhomboid,rounded,ruit,sand-punctate,scattered,side,slender,slightly,smooth,spaced,sparsely,stellate,stem,stigma,style,surface,tamen,tem,terrestria,tip,trichome,truncate,truncate-acuminat,tube,unbranched,undulate,unit,vary,vein,vine,white,wide,wide-diameter,widely,x,yellowish,ympodial,â7	
384	wfo-0001030342	exception_thrown	153	0	0	153	0	0.0		-7,.2,.5,0.5-1,0.5-3,0.5-5,0.8-4,1-1.2,1-1.5,1-3,1-5,1-5.5,1-6,1-6.5,1-7,1.2-3,1.5-13,1.5-2,1.5-5,1.5-7.5,10-25,2-,2-2.5,2-3,3,3-12,3-pinnate,4-5,4-8,5-merou,6-7,abaxially,absent,abundant,accrescent,acuminate,acute,adaxially,ag,along,alyx,anther,apart,apex,apical,apiculate,apparently,articulated,axe,ba,basally,base,blade,broadly,brown,calyx,capitat,chartaceous,ciliat,cm,connivent,cordate,cuneate,cylindrical,deltoid,diameter,directed,distally,eaf,eed,elliptical,entire,equal,extra-axillary,filament,flower,fruit,fruiting,geminat,glabrous,hair,herb,interjected,lanceolate,lateral,leaf,leaflet,lenticular,light,lobe,long,longitudinal,lower,margin,membraceous,minutely,mm,nflorescence,node,oblique,oblong,obtuse,opening,orolla,pedicel,peduncle,perfect,petiole,petiolule,plurifoliate,pore,proximal,pubescen,pubescent,rachi,rarely,revolute,rhomboid,rooting,rounded,sagittate,scattered,side,simple,slender,slightly,slit,smooth,spaced,stellate,stigma,style,surface,tamen,tem,terrestrial,tip,trailing,truncate,truncate-acuminat,tube,unbranched,undulate,uniseriate,unit,vary,vein,white,wide,widely,x,yellow,ympodial	
385	wfo-0001030353	success	227	176	125	102	51	0.551	-0.2,-1.5,-1/2,-2,-3,.1,.2,.5,0,0-15,0.15-0.3,0.5,0.5-0.9,0.8,1-2,1-3,1/2-2/3,1/3,1/6,1/6-1/4,11-16,2-7,2.5-4,20-200,3.5-4,5,6-15,6-8,andromonoecious,anther,apart,apex,apically,apparently,base,berry,blade,broad-deltate,calyx,chartaceous,cm,conical,cuneate,curved,densely,discolorous,distal,distance,drying,ellipsoid,elliptic,elongating,erect,extending,filament,flattened,flower,fruit,fruiting,glabrous,half,hermaphrodite,heterostylous,lateral,leaf,length,less,lobe,lobed,long,long-styled,longer,lower,lowermost,margin,mature,maturity,mauve,midpoint,midvein,mm,moderately,multangulate,orange-brown,pedicel,petiole,pointed,poricidal,porrect,prickle,ray,reflexed,rounded,sessile,shape,short-styled,shrub,side,simple,small,sometimes,spaced,sparsely,stalk,stalked,stellate,stellate-pubescent,stem,straight,strongly,subentire,surface,tapering,terminal,time,tip,tree,trichome,unarmed,unbranched,unit,way,weakly,wide,yellow	-5,-6,-merous,.7,0-2,0-6,0.1-0.2,0.1-0.3,0.8-1.2,1,1-6,1-7,1.2-1.8,1.8-2.2,1.8-3,1/,1/5,10-15,2-10,2.8-3.7,3-4,3-5.5,4-,4-4.5,4-5,5-6,6,7-10,8-15,abaxial,abaxially,acute,adaxial,almost,alyx,apar,apiculat,articulated,bark,brown,c.,connivent,deltate,development,diameter,eaf,eed,equal,evenly,flattened-reniform,free,glabrescent,green,infructescence,narrow-deltate,nflorescence,older,one,open,orolla,oung,pair,patch,peduncle,pendulous,per,pericarp,plant,plurifoliat,portion,prickly,primary,red-brown,reddish-green,retaining,ruit,scar,shorter,smooth,somewhat,spreading,staminat,stout,style,tamen,terete,tertiary,throughout,tube,unarme,upper,vary,vein,venation,visible,warty,whit,white-gray,wo,woody,ympodial,young	appressed,articulation,bract,branching,breeding,broad-based,cell,colour,connective,corolla,form,growth,hair,heteromorphism,inflated,inflorescence,insertion,interjected,interpetalar,leaflet,marking,modification,needle-like,null,odour,orientation,paired,pattern,placement,plurifoliate,pore,position,pseudostipule,rhizome,scale,smell,spot,staman,staminate,stone,structure,symmetry,sympodial,system,texture,tissue,tuber,type,vegetative,xylopodia,zygomorphy
386	wfo-0001030407	success	182	132	76	106	56	0.418	0.7-3.2,1-2,1-4,2-6.7,2-7,30-60,5,abaxially,absent,acuminate,adaxially,anther,apex,axillary,base,berry,bud,cell,chartaceous,cm,conical,corolla,densely,distal,elliptic-lanceolate,end,filament,forked,fruit,generally,glabrous,green,hair,half,herb,homostylous,interjected,lateral,leaf,leaflet,light,like,long,lower,margin,middle,minute,mm,odd-pinnate,one,ovate,pedicel,pentagonal,petiole,petiolule,placed,plant,plurifoliate,pore,proximal,pubescent,purple,ray,ripe,subsessile,subtending,symmetrical,tall,terminal,tri-,tuber,typically,unit,usually,white,x	.2,.5,1-10,1-3,1.5-5,12-14,12-15,2-2.5,2-5,3-10.5,3-4,3-6.5,3-9,3.5-9.5,4-5,5-merou,6-7,6.5-18.5,7-8,acumen,ag,alyx,apart,apparently,articulated,axe,blade,brownish,capitat,ciliate,condition,connivent,covering,decreasing,diameter,digestion,dorsally,drying,eaf,edge,eed,enzyme,especially,exceeding,flat,flower,folded,fresh,geminat,glabrou,gradually,green-white,greenish,hair-like,honeycomb-shaped,lanceolate,larger,lengthening,living,lobe,make,mottled,mucilaginous,nflorescence,obtuse,orolla,ovoid,pair,peduncle,perfect,poricidal,pubescen,removed,round,ruit,secondary,seed,semierec,seudostipule,size,slit,spaced,specimen,stamen,ste,stigma,stolo,style,subequal,tamen,tem,testal,thick,thir,throughout,tip,toward,tube,unwinged,vary,wall,wet,whitish,wide,yellow,ympodial	5-merous,appressed,articulation,bract,branching,breeding,broad-based,calyx,colour,connective,form,fruiting,geminate,growth,heteromorphism,inflated,inflorescence,insertion,interpetalar,length,marking,mature,modification,needle-like,null,odour,orientation,paired,pattern,placement,position,prickle,pseudostipule,rhizome,scale,semierect,shape,smell,spot,staman,stem,stolon,stone,structure,surface,symmetry,sympodial,system,texture,third,tissue,trichome,type,vegetative,xylopodia,zygomorphy
387	wfo-0001030420	exception_thrown	170	0	0	170	0	0.0		-2,-20,-30,-35,-4,-9,-pubescent,0.5-,0.5-1,0.5-4,0.5-8,1,1-,1-1.5,1-2,1-3,1-4,1-6,1-7.5,1.5-3,1.5-5,1/2,10-,10-25,15-25,2-,2-14.5,2-3,2-5,2-6,2-9,3-7,3-lobed,4-7,4-foliat,5-,5-15,5-6,6-7,7-19,7-22,7/8,abaxially,absent,acuminate,acute,adaxially,aggregate,also,apart,ape,apex,articulated,axe,basal,base,beyond,blade,calyx,cell,chartaceous,cm,color,connective,connivent,cordate,cylindrical,dark,deltate,densely,diameter,directed,distally,divided,eaf,eed,eglandular,eglandular-pilo,eglandular-puberulent,ellipsoidal,elliptic-ovate,elongated,entire,equal,exserted,flower,forked,fruit,glabrate,glabrous,glandular-,glandular-puberulent,hair,lanceolate,leaf,leaving,lobe,lobed,lon,long,lower,margin,midrib,mm,moderately,narrowly,nearly,nflorescence,nther,obtuse,often,orolla,ovate,pedicel,pedicellar,peduncle,perfect,petiole,pilose,pinnately,pore,presen,puberulent,puberulent-pubescent,pubescent,pubescent-pilo,pubescent-pilose,purple,rachi,radiu,rarely,remnant,ripe,ruit,shorter,shrub,simple,sinus,small,spaced,sparsely,stamen,stellate,stigma,stone,style,subcoriaceous,tal,tem,thecae,time,tip,tomento,tree,triangular,truncat,truncate,tube,ud,unbranched,unit,unknown,unlobed,vary,vein,wide,x,yello,yellow,ympodial	
388	wfo-0001030426	success	158	129	72	86	57	0.456	1-4,1-4.2,10,2-3,6-8,abaxially,adaxially,apex,apical,apically,base,branched,calyx,cell,cm,connate,corolla,covering,cyme,dehiscent,dichasial,dichasially,distal,ebracteate,filament,flower,forked,generally,glandular,globose,green,hair-like,half,heart-shaped,herbaceous,honeycomb,interjected,introrse,lateral,leaf,leaflet,long,lower,maturing,mm,monochasial,oblique,odd-pinnate,often,pattern,pedicel,perennial,perfect,petiole,pilose,plant,poricidally,proximal,rounded,short,slit,spot,stellate,stripe,testal,thick,tuber-bearing,typically,unit,wall,white,Â¼	-30,0.3-7,0.3-8,0.4-0.7,1.5-3,1.5-6.5,1.7-3.2,15-25,2,2.5-4,2.5-6,3-12,3-4,3-6,3-6-foliat,4-10,4-6.5,6-11.5,9,absen,acumen,acute,apiculate,articulate,caudate,decurrent,diameter,digestion,diminishing,dorsally,eaf,edge,eed,elliptic-lanceolate,emoval,enzyme,exceeding,flat,folded,globo,gradually,green-white,lanceolate,larger,linear,linear-lanceolate,linear-oblong,living,lobe,lon,make,mucilaginous,nflorescence,nther,oblong,obtuse,orolla,ovoid,pair,peduncle,pinnatifi,plan,rachi,reveal,ruit,second,seed,sessile,seudostipule,size,specimen,stamen,stigma,straight,style,tal,tem,terminal,throughout,toward,vary,whit,wide,without,yellow,ympodial	3-6-foliate,absent,anther,appressed,articulation,bract,branching,breeding,broad-based,colour,connective,form,fruit,fruiting,growth,hair,heteromorphism,inflated,inflorescence,insertion,interpetalar,length,margin,marking,mature,modification,needle-like,null,odour,orientation,paired,pinnatifid,placement,pore,position,prickle,pseudostipule,rhizome,scale,shape,smell,staman,stem,stone,structure,surface,symmetry,sympodial,system,texture,tissue,trichome,tuber,type,vegetative,xylopodia,zygomorphy
389	wfo-0001030430	exception_thrown	171	0	0	171	0	0.0		.2,.5,0.25,0.3,0.4,0.5,0.5â12,0.6,0.6â0.8,0.6â1.0,0.8â3.0,0.8â5.6,0.9â1.0,0â20,1.0â1.2,1.0â1.5,1.0â2.0,1.2â2.0,1.3â8.0,1.4â1.5,1.5â1.7,1.6â1.8,1.8â5.0,12â20,12â30,1â3,1â9,2.0â3.0,2.0â4.2,2â3,3.0â4.5,30â200,3â17,3â24,3â4,3â5,3â8,5,5.5â12,5â10,5â6,6â10,abaxially,abundant,acute,adaxiall,adaxially,ag,anther,anthesi,apart,apex,apical,appressed,articulated,axe,axillary,ba,basal,base,blade,blue,borne,branched,brittle,brown,bud,calyx,capitate,cell,chartaceous,clavate,cm,connivent,convex,cylindrical,decurrent,densely,dentate,diamete,diameter,eaf,eed,elliptic,equal,erect,especially,few-seeded,filament,flattened,fleshy,flower,fruit,geminat,glabrous,globose,green,hair,indumentum,leaf,lobe,lobed,lon,long,longitudinal,lower,m.,margin,mm,moderately,multicellular,nflorescence,oblong,occasionally,opening,orolla,ovate,pair,pale,pedicel,peduncle,pentagonal,perennial,perfect,petiole,pitted,pore,poricidal,present,pubescent,purple,regularly,rounded,ruit,serrate,shallowly,shaped,shoot,shrub,side,simple,slit,spaced,stigma,stone,straight,style,subglabrous,surface,tal,tamen,tear-drop,tem,terminal,time,tip,toward,tube,unifoliate,uniseriate,unit,vary,violet,white,wide,woody,x,yellow,ympodial,â2.7,â40	
390	wfo-0001030441	exception_thrown	178	0	0	178	0	0.0		+,.5,0.5,0.5-0.75,0.5-1,0.5-3,1,1-1.4,1-1.5,1-2-celled,1.2-1.4,1.5-2,10-40,2,2-10,2-3,2-5.5,2.5,3-4,30,4-5,5-14,5-6,5-7,5-7.5,5-merou,6-11,<,>,acuminate,acute,ag,along,alyx,anther,anthesi,apart,apex,ark,articulated,attenuate,base,berry,branched,bright,brow,c.,calyx,capitate,cell,closely,cm,corolla,decurrent,deltate,diameter,distall,eaf,eed,ellipsoid,elliptic,entire,exerted,eye,filament,flattened,flexuous,flower,free,fruiting,glabrou,glabrous,glandula,glandular,globose,green,growth,hair,ilament,impressed,irregularly,juicy,lateral,leaving,lengthening,lobe,lobed,lon,long,lower,making,many,margin,markedly,membranous,midvein,minutely,mm,narrowly,new,nflorescence,occasionally,older,onto,open,orolla,otherwise,pair,pale,papillat,papillose,pedicel,peduncle,peg,per,perfect,pericarp,petiole,plant,plurifoliat,pore,poricidal,portion,primary,pubescent,red,reflexed,reniform,ridged,ripe,ruit,scandent,scar,shiny,short,shrub,shrubby,simple,slightly,slit,small,somewhat,spaced,spot,spreadin,spreading,stellate,stem,stigma,strongly,style,surface,tem,terminal,thin,time,tip,trailing,triangular,trichome,tube,ud,undulate,uniseriate,unit,upper,usually,vary,vein,vine,violet,wall,way,white,wide,woody,yellow,ympodial	
391	wfo-0001030444	success	196	118	66	130	52	0.337	0-24,0.8-2,1-2,4-17,along,anther,apex,arranged,attenuate,base,bead,berry,blue,cell,ciliate,cm,coriaceous,corolla,deep,distal,dot,filament,forked,fruit,glabrous,green,half,herb,high,homostylous,interjected,lanceolate,leaf,leaflet,like,lilac,long,lower,margin,medium,mm,moniliform,multiple,necklace,odd-pinnate,ovoid,pedicel,pentagonal,petiole,petiolulate,plurifoliate,pore,poricidal,ripe,rotate,rounded,sometimes,stolon,terminal,tip,tissue,tri-,tuber,typically,unit,white	0.15-0.8,1,1-10,1-4,1-5,1.1-2.7,1.2-1.8,11-45,2-3,2-6,2-8,2.3-3.6,2.4-3.8,3-10,3-5,3.7-6.8,4-39,4-7,5-merou,5.3-9,6.1-12.8,7.1-17.5,9.4-20.1,abaxiall,abaxially,acumen,acuminate,acute,adaxially,ag,alyx,apart,apparently,articulated,asymmetric,axe,axillary,basiscopic,blade,brownish,bud,capitat,clavate,condition,connivent,covering,dark,decreasing,diameter,digestion,dorsally,drying,eaf,edge,eed,elliptic,enzyme,erec,exceeding,flat,flower,folded,fresh,geminat,general,generally,glabrou,green-white,greenish,hair-like,hal,honeycomb-shaped,larger,lateral,lengthening,light,linear,living,lobe,make,mucilaginous,narrow,nflorescence,orbicular,orolla,ovate,pair,peduncle,perfect,plant,purple,removed,rough,ruit,seed,sessile,seudostipule,shortly,side,size,slit,spaced,specimen,stamen,stigma,straight,style,subequal,subtending,symmetric,tall,tamen,tem,testal,thick,throughout,touch,toward,tube,unwinged,usually,vary,wall,wet,whitish,wide,wing,x,yellow,ympodial	appressed,articulation,bract,branching,breeding,broad-based,calyx,colour,connective,form,fruiting,geminate,growth,hair,heteromorphism,inflated,inflorescence,insertion,interpetalar,length,marking,mature,modification,needle-like,null,odour,orientation,paired,pattern,placement,position,prickle,pseudostipule,rhizome,scale,shape,smell,spot,staman,stem,stone,structure,surface,symmetry,sympodial,system,texture,trichome,type,vegetative,xylopodia,zygomorphy
392	wfo-0001030445	exception_thrown	226	0	0	226	0	0.0		.1,.5,/5-2/3,0.1-0.7,0.2,0.2-0.4,0.2-0.5,0.2-0.7,0.3,0.4,0.5,0.6-2.2,0.6-3.5,0.7,0.8,1,1-1.3,1-7,1.1-4.3,1.3,1.3-1.8,1.3-2,1.5-2.1,1.6-2,1.7-2.4,1.8-3.5,10-14,10-16,14,15-35,2.1-5.2,2.2-2.9,2.2-3.5,2.4-4.7,3-5.4,3.1-5,3.4-5.6,3.5-4.2,4.1-8.7,4.2-10,5-125,5-merou,5.2-7.1,5.9-15,5.9-8.3,6.1-9.1,7.5-16,8.1-10,8.2-18,abaxial,abaxially,accrescent,acuminate,acute,adaxially,ag,along,alyx,anther,apart,apex,appressed,around,articulated,axillary,bark,base,berry,black,blade,blunt-tippe,blunt-tipped,branch,branched,brown,brownish-yellow,bud,bulbous-based,calyx,capitate,cm,concentrated,corolla,cylindrical,decurrent,deltoid-reniform,diameter,directed,distally,drying,eaf,earl,edge,eed,elliptic,elliptical,elongated,entire,erect,exserted,ferruginous,ferruginous-granular,ferruginous-tomentose,filament,flower,free,fruit,fruiting,geminate,glabrate,glabrescen,glabrous,globose,green,greyish-tan,hair,high,homostylous,inserted,intermediate,lackin,lateral,leaf,lengthening,lobe,lobed,lon,long,longitudinal,lower,m.,main,many,margin,midrib,midvein,mm,mostly,multangulat,multangulate,nflorescence,oblong,oblong-lanceolate,obovate,obscured,obtuse,older,open,orange,orangish-tan,orbicular,orolla,ovate,ovate-lanceolate,pedicel,peduncle,petiole,plurifoliate,pore,poricidal,porrect-stellat,porrect-stellate,pseudoterminal,pubescence,pubescent,rachi,ray,relatively,reniform,resorption,reticulate-punctate,rounded,ruit,runk,semi-spherical,sessile,shrub,side,simple,slightly,slit,small,somewhat,soon,spaced,sparse,sparsely,splitting,stalk,stamen,stellate,stem,stigma,stout,style,subcampanulate,sulcate,surface,suture,tamen,thick,thick-textured,thicknes,thin,thin-,time,tip,tissue,tomentose,tomentum,tree,tube,unarme,unit,vary,vein,vestigial-rayed,way,white,wide,x,yellow,yellowish,yellowish-tan,ympodial,young	
393	wfo-0001030447	exception_thrown	276	0	0	276	0	0.0		.2,.3,.5,/5,0,0.1,0.1-0.3,0.15-0.3,0.2,0.2-0.4,0.4-0.7,0.4-0.9,0.5,0.5-0.65,0.5-10,0.5-3,0.7-1,0.8-1.7,0.8-3.5,1,1-1.5,1-10,1-2,1-2.5,1-3,1-5,1-6,1.5,1.5-2.5,1.5-7,1.8-2.5,1/3,1/3-1/2,1/3-2/3,1/4-1/3,2-4,2.2-2.8,2.5-10,2.5-6.5,3,3-4.5,3-5,30-45Â°,4-8,5,5-15,5-merou,6,6-10,6-16,6-7,6-8,6-9,6.5-9,7-8,8,abaxially,accrescent,acute,adaxially,age,always,alyx,anther,apar,apart,apex,apical,apically,apparently,armed,articulated,axe,bark,base,berry,beyond,blade,branche,broad-deltate,c.,calyx,cell,characteristically,chartaceous,clavate,cm,corolla,covering,cuneate,cupular,curved,dark,deltate,densely,development,diameter,difoliate,discolorous,distance,divided,drying,eaf,eed,elongating,equal,erect,exserted,extending,filament,filiform,fine,finely,finger-hair,flat,flattened,flattened-reniform,flower,free,fruit,fruiting,geminat,gently,glabrescent,glabrous,globose,herbaceous,infructescence,irregula,irregular,lateral,leaf,length,lengthening,less,lobe,lobed,long,long-ovoi,long-styled,longer,longitudinal,lower,margin,mature,maturity,midpoint,midvein,minute,mm,moderately,mostly,narrow-deltate,nflorescence,obconical,oblique,oblong,obtuse,often,older,one,open,opening,orange,orange-brown,orange-red,orange-translucent,orolla,oung,outline,ovate,pair,pale,papillo,pedicel,peduncle,pendulous,per,perfect,pericarp,persisting,petiole,pit,point,pore,poricidal,porrect,portion,prickle,primary,pronounced,prostrate,pubescent,purple,rachi,raised,ray,red-brown,reduced,rest,ri,ridge,ridged,rounded,ruit,scar,sessile,shallow,shallowly,shiny,short-styled,shorter,shortly,shrub,side,simple,sinus,slender,slit,small,smooth,sometimes,somewhat,spaced,sparse,sparsely,spherical,spreading,stalk,stalked,stellate,stellate-pubescent,stem,stigma,stout,straight,straw-yellow,stump,style,subsessile,surface,tamen,tapering,terete,terminal,tertiary,thick,thin,throughout,time,tip,toward,translucent,trichome,tube,ud,unarmed,unbranched,unequal,unit,usually,variously,vary,vein,venation,visible,weakly,white,wide,widest,woody,x,yellow,yellow-orange,ympodial,Ã	
394	wfo-0001030453	exception_thrown	127	0	0	127	0	0.0		.25,.5,/4,0.25-0.5,0.8-1.5,1-1.3,1-1.5,1.5-1.6,1.5-2.5,3-3.5,4-5,9-12,9-14,abaxially,acuminate,acute,adaxially,along,anther,anthesi,apex,arachnoid,arachnoid-pubescent,attenuate,axi,bark,base,broadly,calyx,clavate,closely,cm,corolla,cup-shaped,dark,deflexed,delicate,deltate,dendritic,densely,dia,divided,eaf,edicel,eed,ellipsoid,elliptic,especially,exserted,filament,fine,flat,floccose,free,glabrate,glabrous,know,known,later,lateral,leaf,less,lobe,lon,long,lower,main,margin,middle,midrib,minute,minutely,mm,narrowly,near,nearly,nflorescence,occasionally,older,opposite,ovary,overlappin,pair,papillat,papillose,pedicel,petiole,planar,pore,poricidal,portion,pubescent,reddish,reddish-brow,rounded,ruit,scar,shaped,shiny,shrub,simple,slender,soon,spaced,sparsely,stem,stigma,straight,strongly,style,surface,tall,tear-drop,tip,trichome,tub,tube,ud,unifoliat,unit,vein,way,white,wide,widest,ympodial,young	
395	wfo-0001030486	success	141	145	89	52	56	0.631	.5,0.8-2.2,1-1.5,1-5,10-12,10-14.5,2-3,2-5.5,3-5,3/4,4-6.5,4.5-5,5-8-flowered,abaxially,acute,adaxially,anther,anthesi,apex,bark,base,beneath,berry,calyx,cm,completely,corolla,dark,dia,differing,difoliate,drying,elliptic,erect,filament,fleshy,free,fruiting,glabrous,globose,green,internodal,lateral,leaf,lobe,lobed,long,lower,main,major,margin,middle,minor,mm,older,opposite,pair,pale,pedicel,petiole,planar,pore,poricidal,portion,reddish,shaped,shrub,simple,size,slightly,small,stem,stout,surface,tall,tear-drop,tip,treelet,tube,unit,usually,vein,way,white,widest,woody,x,yellow-green,young	1.1-1.4,1.5-2,1.7-2,1/2,1/4,3-3.5,4-4.5,6-7,ba,basal,brown,clavate,closely,clustered,conical,deflexed,deltate,distal,dry,eaf,edicel,eed,ellipsoid,exserted,f,fresh,geminat,inflorescenc,later,lon,m.,material,minutely,nflorescence,ovary,overlapping,ovoid-reniform,papillo,papillose,pitted,ruit,scar,shin,spaced,stigma,style,tan,tapering,thickened,tub,ud,ympodial	appressed,articulation,bract,branching,breeding,broad-based,cell,colour,connective,form,fruit,geminate,growth,hair,heteromorphism,inflated,inflorescence,insertion,interjected,interpetalar,leaflet,length,marking,mature,modification,needle-like,null,odour,orientation,paired,pattern,placement,position,prickle,pseudostipule,rhizome,scale,shape,shiny,smell,specified,spot,staman,stone,structure,symmetry,sympodial,system,texture,tissue,trichome,tuber,type,vegetative,xylopodia,zygomorphy
396	wfo-0001030489	exception_thrown	196	0	0	196	0	0.0		-6.5,.5-2.8,.5-3,.75-5.25,0.25-0.4,0.5-3,0.6-0.9,0.75-0.9,0.9-1.1,1-1.3,1-3,1-3.75,1.1-1.3,1.2-1.5,1.2-1.6,1.6-2.1,1.7-2,1.75-2,1.9-2.6,1/3-1/2,1/5-1/2,100,12-24,2.1-2.9,3-6,3-8,4-8,4.5-9,5,5-6,6-8,7-15,abaxially,abruptly,absen,acuminate,acute,adaxiall,adaxially,ag,anther,anthesi,apart,apex,apical-lateral,apparently,appressed,appressed-pubescent,articulated,attenuate,axe,axillary,ba,bark,base,becoming,berry,blade,blunt-tipped,branch,branched,broadly,brown,bud,calyx,chartaceous,cinereous,closely,cm,conical,continued,corolla,cylindrical,dehiscing,deltoid,densely,diameter,dichotomously,due,eaf,echinoi,echinoid,eed,elliptic,elongate,entire,filament,fleshy,flower,free,fruit,glabrate,glabrous,globose,greenish,growth,hair,high,honeycombed,inserted,introrse,large,lateral,leaf,length,lobe,lobed,long,long-acuminate,long-exserted,longitudinal,lower,main,margin,midvein,minute,minutely,mm,mostly,multangulate,narrowly,nflorescence,oblong,obtuse,older,orolla,ovate,ovate-lanceolate,pale,pedicel,peduncle,perfect,petiole,plurifoliate,pore,porrect-stellate,probably,pseudo-terminal,puberulent,pubescent,pulverulen,pulverulent,rachi,reniform,reticulate-punctate,ripe,ruit,runk,sessile,several,short,short-stalked,shrub,side,simple,slender,slit,small,smooth,somewhat,spaced,sparingly,sparse,stellate-pubescent,stellate-rotate,stem,stigma,style,subcampanulate,subcapitat,subglobose,suborbicular,tamen,terete,testa,thick,time,tomentose,toward,tree,tube,turn,unarme,unarmed,unit,usually,vary,vein,way,white,wide,x,yellow,yellowish,ympodial,young	
397	wfo-0001030509	exception_thrown	220	0	0	220	0	0.0		-10,-2,-6,/3,0,0-0.3,0-100,0-15,0-3,0-5,0.1,0.1-0.2,0.1-0.25,0.1-0.3,0.2,0.3-2.5,0.5-1.5,0.6-1,0.8-1.2,0.8-4,1,1-1.5,1-2,1-3,1-4,1-6,1.3-2,1.5-2,1.7-2,1/,1/3-2/3,1/4,2-2.5,2-3,2-4.2,2-4.5,2-6,2.8-3,2/3-3/4,3-10,3-4,4.5-10,4.5-12,4.5-8,5-10,5-merous,7-15,7-9,8-16,abaxially,alyx,andromonoecious,anther,apar,apart,apex,apical,apically,apparently,articulated,bark,base,becoming,berry,blade,broad-deltate,brow,calyx,chartaceous,cm,connivent,cordate,cream,cuneate,curved,dark,densely,diameter,difoliate,discolorous,distal,distance,drying,eaf,eed,elongating,entire,equal,erect,extending,eye,filament,flattened-reniform,flower,free,fruit,fruiting,geminat,glabrescent,glabrous,gland,globular,gray,green,half,herb,herbaceous,hermaphrodite,heterostylous,inflated,infructescence,lateral,leaf,length,lobe,lobed,long,long-acuminat,long-styled,longer,lower,lowermost,margin,marking,mature,maturity,mauve,midpoint,midvein,mm,moderately,naked,narrow-deltate,narrow-oblong,nflorescence,obtuse,occasional,occasionally,often,older,one,open,orange,orange-brown,orolla,oung,ovate,pair,pale,pedicel,peduncle,pendulous,per,pericarp,perpendicular,petiole,plant,poricidal,porrect,portion,prickle,prickly,primary,purple,ray,reduced,rounded,ruit,scar,short-styled,shorte,shorter,shrub,side,simple,slender,smooth,sometimes,spaced,sparsely,spherical,spreading,stalk,stalked,staminat,stellate,stellate-pubescent,stem,straight,style,subsessile,surface,tamen,tapering,terete,terminal,tertiary,time,tip,trichome,tube,unarme,unarmed,unbranched,unit,upper,usually,variously,vary,vein,venation,visible,way,weakly,wide,woody,yellow,yellow-green,ympodial,young	
398	wfo-0001030516	exception_thrown	172	0	0	172	0	0.0		0.4-1.5,1-2.5,1-4,1-7,1.1-3.5,1.1-4.1,1.5-2,1.7,1.8-2.4,2-12,2-2.,2-3,2-4,3-6,3-6-foliat,3-8,3-9.8,4-22,4-4,4-6,4-7,4.2-10.7,6-15,8-9,9-22,9-32,abaxially,acumen,acuminate,acute,adaxially,apex,apical,apically,articulate,base,branched,calyx,cell,cm,connate,cordate,corolla,covered,covering,cuneate,cyme,darker,decurrent,dehiscent,densely,diameter,dichasial,dichasially,digestion,diminished,distal,dorsally,eaf,ebracteate,edge,eed,elliptical,emoval,enzyme,exceeding,filament,first,flat,flower,folded,forked,generally,gland,globo,globose,gradually,green,green-white,hair,hair-like,half,herbaceous,honeycomb,interjected,introrse,lateral,leaf,leaflet,less,light,living,lobe,lon,long,long-attenuate,longer,lower,lunat,make,maturing,mm,monochasial,mucilaginous,nflorescence,nther,oblique,odd-pinnate,often,orolla,outline,ovate,ovoid,pair,pattern,pedicel,peduncle,pentagonal,perennial,perfect,petiole,pilose,plan,plant,poricidally,proximal,puberulent,pubescent,rarely,reveal,rotate,ruit,second,seed,sessile,seudostipule,short,short-petiolate,short-stalked,size,slightly,slit,sometimes,specimen,spreading,stamen,stigma,straight,stripe,style,tal,tem,terminal,testal,thick,throughout,time,toward,triangular,triangulat,tuber-bearing,type,typically,unit,vary,wall,whit,wide,yellow,ympodial,Â¼,â	
399	wfo-0001030551	success	167	133	76	91	57	0.455	0-2,1-2,1-4,1-5,2,3-12,3-8,4-5,abaxially,adaxially,adpressed,also,apex,articulated,basal,base,blade,blue,calyx,campanulate,cell,chartaceous,cm,connective,cordate,densely,directed,entire,et,fading,fruit,glandular-puberulent,globose,hair,lanceolate,laterally,leaving,lobe,long,lower,margin,martinelli,mm,moderately,oblong-fusiform,often,ovate,ovate-elliptic,pedicel,pedicellar,petiole,pilose,pore,puberulent,puberulent-pubescent,pubescent-pilose,remnant,round,seen,shrub,simple,small,sparsely,stellate,stone,style,subcoriaceous,time,truncate,unbranched,unit,unknown,violet,wide,x,yellowish	-12,-30,-5,0.5-1,0.6-1.5,1,1-,1-10,1-2.5,1-3.5,1.5-,1.5-2.5,10-20,10-40,13.,2-3,2-6,2.5-4,2.5-5,20-25,3-,3-5,4-,4-7,4-foliat,5-17,5-6,9-20,abruptly,absent,acuminate,acute,aggregate,apart,ape,axe,beyond,bilobe,broad,clavate,color,concave,dia,diameter,dilated,distally,eaf,ed,ellipsoidal,equal,exceeding,exserted,fleshy,flower,glabrous,lon,narrow,narrowed,narrowly,nflorescence,nther,obtuse,orolla,ovoid,papillose,peduncle,perfect,puberulen,pubescent-pilo,rachi,radiu,ripe,ruit,shorter,slightly,spaced,stamen,stigma,tal,tem,thecae,tip,tomento,triangular,triangular-elliptic,tube,ud,unknow,vary,widening,ympodial	138,4-foliate,anther,appressed,articulation,bract,branching,breeding,broad-based,colour,corolla,filament,form,fruiting,growth,heteromorphism,inflated,inflorescence,insertion,interjected,interpetalar,leaf,leaflet,length,marking,mature,modification,needle-like,odour,orientation,paired,pattern,placement,position,prickle,pseudostipule,rhizome,scale,shape,smell,spot,staman,stem,structure,surface,symmetry,sympodial,system,tall,texture,tissue,trichome,tuber,type,vegetative,xylopodia,zygomorphy
400	wfo-0001030570	success	173	147	88	85	59	0.509	1-1.5,1-2,1-3,1-8,1.5,1.5-2.5,1/2,15-20,2-7-lobed,2-8,2.5-22,3.5-5,4-25,4/5,abaxially,absent,acute,adaxially,apex,articulated,basal,base,blade,calyx,campanulate,cell,cm,connective,connivent,cordate,directed,distally,divided,eglandular,ellipsoidal,elliptic-oblong,entire,forked,fruit,glabrous,glandular-puberulent,globose,green,hair,lanceolate,leaf,leaving,lobe,lobed,long,lower,margin,midrib,mm,near,occasionally,ovate,pedicel,pedicellar,petiole,pilose,pinnately,pore,purplish,rarely,remnant,ripe,rounded,simple,sinus,small,sometimes,sparsely,stellate,stone,subcoriaceous,time,tree,truncate,unbranched,unit,unknown,unlobed,vein,white,wide,x,yellow	-1,.3-0.5,0-,0.3-0.5,0.5-,0.5-1,1,1-,1-4,1-5,10-17,10-25,15-35,2-2.5,2-3,2-4,2-5,2-7,20-30,3-10,3-5,3-6,4-5,4-7,4-foliat,5-,8-,acuminate,aggregate,apart,ape,apiculate,axe,beyond,color,cylindrical,diameter,dilated,eaf,eed,exceeding,exserted,flattened,fleshy,flower,glabrat,lon,narrowly,nflorescence,nther,obtuse,often,orolla,ovoid,peduncle,perfect,pilo,presen,pubescent,punctate,purpl,rachi,radiu,rugose,ruit,shorter,slightly,somewhat,spaced,stamen,stigma,style,submarginally,tal,tem,thecae,tip,tomento,triangular,truncat,tube,ud,unequal,vary,ympodial	3-,4-foliate,anther,appressed,articulation,bract,branching,breeding,broad-based,colour,corolla,filament,form,fruiting,growth,heteromorphism,inflated,inflorescence,insertion,interjected,interpetalar,leaflet,length,marking,mature,modification,needle-like,odour,orientation,paired,pattern,placement,position,present,prickle,pseudostipule,purple,rhizome,scale,shape,smell,specified,spot,staman,stem,structure,surface,symmetry,sympodial,system,tall,texture,tissue,trichome,tuber,type,vegetative,xylopodia,zygomorphy
401	wfo-0001030581	exception_thrown	187	0	0	187	0	0.0		.3,.5,0.2â0.8,0.4â0.6,0.4â1.6,0.5,0.5â0.7,0.5â2.5,0.6â0.7,0.7â0.8,0.9â1,1,1-4-celled,1.2â1.5,1.8â8,1â2,1â2-celled,1â2.5,1â4-celled,2,20â50,2â3-celled,35â45,3â4,3â5,4.5â12,4â7,4â9,5-merous,5â6,5â8,9,abaxial,abaxially,acute,adaxial,adaxially,aggregate,along,angle,angled,anther,anthesi,apar,apex,appressed,articulated,basal,base,becoming,berry,beyond,black,branched,bright,calyx,capitate,cell,central,clustered,cm,cone,conical,corolla,decurrent,densely,denser,diameter,difoliate,drop,eaf,eed,ellipsoid,elliptic,entire,exserted,filament,flattened-reniform,florescence,flower,free,fruit,fruiting,geminat,glabrous,globose,green,growth,halfway,herb,individual,inflorescence,intermodal,lacking,later,lateral,leaf,leave,less,like,live,lobe,lobed,lon,long,lower,margin,markedly,maturity,minute,minutely,mm,narrowly,near,new,occasionally,often,once-branched,outline,ovary,ovate,pair,papillate,pedicel,peduncle,pentagonal,per,perfect,petiole,pitted,plant,portion,primary,pubescent,purplish,rachi,reflexe,reflexed,remaining,ridge,ripe,rounded,ruit,scar,shallow,shiny,shorter,simple,slightly,somewhat,spaced,sparsely,sprawlin,spreading,stellate,stem,stigma,stone,straight,strongly,style,surface,tall,tangled,tem,terete,testal,third,translucent,trichome,tube,turning,ud,uniseriate,unit,upper,usually,vein,white,wide,winged,woody,yellow,yellowish,ympodial,â15,â5	
402	wfo-0001030583	exception_thrown	166	0	0	166	0	0.0		.2,.5,0.1-0.5,0.2-1,0.3-1,0.4-2.7,0.5-1,0.7-4.5,0.8-1,0.9-3.5,1,1-1.5,1-2,1-8,1.5-4,1/2,2.5,2.5-3,2.5-9,3-4,3/4,4-6,5-6,5-7,6-7,abaxial,abaxially,acute,adaxially,along,anther,anthesi,apex,ba,bark,base,berry,brow,calyx,cell,closely,cm,conical,corky,corolla,crisped,cultivar,cultivated,dark,deep,deflexed,dendritic,densely,dia,differing,difoliate,dry,eaf,edicel,eed,ellipsoid,elliptic,enlarged,erect,especially,filament,flattened-reniform,flower,form,free,frui,fruit,fruiting,geminat,glabrous,globose,golden,green,immature,included,incrassate,irregular,lateral,leaf,leave,like,live,lobe,lobed,lon,long,long-rectangular,long-triangular,lower,main,major,margin,midvein,minor,minutely,mm,narrowly,nflorescence,occasionally,often,older,opposite,orange-red,outline,ovary,overlapping,pair,pale,papery,papillo,papillose,pedicel,pericarp,petiole,pitted,planar,plant,pore,poricidal,portion,prostrate,pubescent,rest,ripe,rounded,ruit,scar,shaped,shrub,simple,size,small,small-capitate,soon,spaced,spathulate,specimen,stem,stigma,stout,style,surface,tall,tan,tear-drop,testal,thin,tip,trichome,tube,ud,uniseriate,unit,vein,way,white,woody,x,yellow,ympodial,young	
403	wfo-0001030605	exception_thrown	144	0	0	144	0	0.0		.4,.5,0.1,0.3-0.5,1,1-4,1.5-2,1.5-5.5,1.7,1/3-1/2,12-19-flowered,2,2-3,2.5,5-12.5,7,abaxially,acute,adaxially,almost,along,anther,anthesi,apart,ape,apex,apical,area,attenuate,base,beginning,beneath,berry,branch,branched,brown,calyx,cinereous,cm,commonly,conical,coriaceous,corolla,covered,cylindrical,dark,deflexed,dendritic-echinoid,densely,dia,difoliate,dry,drying,eaf,edicel,eed,ellipsoid,entire,exerted,filament,free,fruiting,geminat,glabrate,glabrous,globose,gold,green,growth,inflorescenc,inflorescence,internodal,leaf,less,light,lobe,lobed,long,lower,margin,material,midrib,minutely,mm,nearly,new,nflorescence,obovate,obtuse,occasionally,olive,opposite,otherwise,ovary,ovate,overlapping,ovoid-reniform,papillate,papillosefruit,pedicel,peduncle,petiole,pitted,pore,poricidal,portion,pubescent,rarely,reflexed,revolute,rounded,scar,scattered,shaped,shiny,shrub,simple,slender,slightly,smooth,somewhat,soon,sparesly,sparsely,stigma,style,surface,tear-drop,thickened,tinged,tip,trichome,tub,tube,ud,unifoliate,unit,vein,way,white,woody,x,yellow,ympodial	
404	wfo-0001030624	exception_thrown	170	0	0	170	0	0.0		.25,.5,0.5,0.5-1,0.5-1.5,0.9-1,1-3,1.2-1.8,1.2-2,1.5-2,2,2-10,2-3,2.5-5.5,25-40-flowered,3,3-3.5,3.5-4,4.5-8,6-13,7-9,acute,anther,anthesi,apart,apex,apiculate,appearing,attenuate,axil,ba,bark,base,beginning,berry,branch,caly,calyx,cell,clavate,cm,corolla,decurrent,deflexed,dia,differing,difoliate,dimorphic,distal,dry,eaf,edicel,eed,ellipsoid,elliptic,end,erect,except,expanded,exserted,extreme,falcate,filament,flattened-reniform,free,fruiting,furcate,geminat,glabrate,glabrous,glandular,globose,green,greyish,hyaline,incrassate,inflorescenc,large,later,lateral,leaf,like,lobe,lobed,lon,long,longitudinally,lower,main,major,margin,material,middle,midrib,minor,minutely,mm,narrowly,near,nearly,nflorescence,occasionally,older,one,opposite,outer,ovary,pair,pale,papillose,pedicel,petiole,pitted,planar,pore,poricidal,portion,prominent,puberulent,raised,remaining,round,rugo,ruit,scar,shining,short,shrub,simple,size,slender,slightly,small,somewhat,soon,spaced,square,stem,stigma,straight,style,surface,tall,tapering,thickened,three,ti,tip,tree,trichome,trunk,tube,tuft,two,ud,unevenly,uniseriate,unit,vein,wall,white,widest,woody,x,yellow,yellowish,yellowish-green,yellowish-grey,ympodial,young	
405	wfo-0001030638	exception_thrown	177	0	0	177	0	0.0		0.1,0.5,0.5-0.7,0.5-1,0.5-1.5,0.5-2,0.7-1.5,1-1.2,1-1.5,1-2,1.4-1.7,1.5-2,1.6-2.2,2-3,2-5,2-7-flowered,2.5-4,3-10,3-13,4-6,8,8-11,8-9,acute,along,anther,anthesi,apex,apically,appear,appearing,axi,axil,ba,bark,base,beginning,beneath,berry,blade,branched,broadly,bud,calyx,closely,cm,conspicuously,corky,corolla,cucullate,cup-shaped,deflexed,deltoid,densely,dia,differing,difoliate,dry,eaf,eed,elliptic,entire,erect,exfoliating,extending,filament,flattened,fleshy,free,fruit,fruiting,geminat,geminate,glabrate,glabrous,glandular,globose,gre,green,impressed,inflorescence,irregular,known,lamina,large,later,lateral,leaf,less,like,lobe,lobed,lon,long,lower,main,major,margin,material,middle,minor,minutely,mm,near,nearly,nflorescence,obovate,occasionally,often,older,one,open,opposite,ovary,overlapping,ovoi,pair,pale,paler,papillae,papillo,papillose,pedicel,persistent,petiole,planar,pore,poricidal,portion,present,prominent,rather,red,red-glandular,reddish,rest,roundish,rugose,ruit,scar,seed,shape,shaped,shrub,simple,size,soon,spaced,speciman,stem,stigma,straight,style,surface,tall,tapering,tear-drop,terminal,thick,thickened,thickening,tip,transversely,tree,trichome,tube,uniseriate,unit,usually,vein,wall,white,widest,woody,x,ympodial,young	
406	wfo-0001030661	exception_thrown	183	0	0	183	0	0.0		-24,.2,.5,0,0.5-0.6,0.5-0.75,0.5-2,0.7-0.8,1-,1-.,1-1.2,1-1.3,1-1.4,1-1.5,1.2-7,1.5-2,1.5-7,12-16,2-,2-2.5,3-20,3-3.5,3-4,4-15,4-6,5-10,5-5.5,5-merou,50-100+,acute,ag,along,alyx,anther,anthesi,apex,ark,articulated,attenuate,base,berry,branch,branched,brow,brown,calyx,capitate,cell,clustered,cm,conical,connivent,corolla,dar,deltate,densely,denser,diameter,drying,eaf,eed,ellipsoid,elliptic,em,entire,erec,erect,exserted,extending,filament,flattened,flower,free,fruiting,glabrescent,glabrou,glabrous,globose,group,growth,ilament,inflorescence,insertion,lamina,lateral,leaf,lengthening,lobe,lobed,lon,long,loosely,lower,many,margin,mature,membranous,midrib,minute,minutely,mm,narrowly,near,never,new,nflorescence,nodding,occasionally,older,onto,orolla,otherwise,pair,pale,papillo,pedicel,peduncle,per,perfect,pericarp,petiole,pitted,planar,platform,plurifoliat,point,pore,poricidal,portion,primary,pubescent,rectangular,red,reddish,reniform,ruit,scar,scattered,shiny,shrub,simple,sleeve,slender,slightly,slit,small,sparsely,spreading,stellate,stem,stigma,strongly,style,surface,tangled,terminal,testal,thin,time,tinged,tip,tree,trichome,tube,twinin,ud,uniseriate,unit,upper,usually,vary,vein,violet,way,white,winged,woody,x,yellow,yellowish,ympodial,Â½,Â¾	
407	wfo-0001030676	exception_thrown	220	0	0	220	0	0.0		-1.6,-2.5,-3.9,-8.5,/10-1/5,0-100,0.4,0.6-1.2,1,1-1.2,1-3,1.1-1.4,1.1-1.9,1.2-1.3,1.3-1.5,1.7-2,1/4,11-14,14-17,16,19-35,2.1-2.3,2.1-2.6,2.2-5.7,2.4-3.1,2.5-5.5,2.75-3.25,3-3.5,3-5,3-6,4-6,4-6.5,7-10,7-8,7-9,8-10,8-12,abaxially,abruptly,acute,adaxially,along,angled,anther,anthesi,apart,apex,apical-lateral,apparently,appearing,appressed-tomentose,articulated,axillary,ba,bark,base,becoming,berry,blade,blunt-tipped,branch,branched,brown,bud,calyx,chartaceous,closely,cm,conical,continued,corolla,crown,cylindrical,dehiscing,deltoid,densely,diameter,dichotomously,due,eaf,echinoi,echinoid,eed,elongate,entire,except,exserted,filament,finely,flat-topped,fleshy,flower,forming,free,fruit,glabrescen,glabrescent,glabrous,globose,granular-tomentose,green,greenish,grooved,growth,hair,high,honeycombed,horizontal,initially,inserted,introrse,lackin,lamina,large,lateral,leaf,length,lengthen,lined,lobe,lobed,long,longitudinal,longitudinally,lower,main,margin,midvei,midvein,minute,minutely,mm,moderately,mostly,multangulate,nearly,nflorescence,oblique,oblong,oblong-elliptic,obtuse,occasional,often,older,opening,openly,orolla,ovate,ovate-lanceolate,parallel,pedicel,peduncle,perfect,petiole,plurifoliate,pore,probably,pseudo-terminal,pubescent,pulverulent,rachi,rather,ray,reniform,reticulate-punctate,ridged,ripe,ruit,runk,scabrous,scattered,sessile,short-attenuate,short-stalked,shrub,side,simple,slit,small,somewhat,spaced,sparsely,spreading,stellate,stellate-pubescent,stem,stigma,strongly,style,subcampanulate,subcapitat,subglobose,suborbicular,tamen,tending,terete,testa,thick,thin,time,tip,tomentose,tree,tube,tuft,unarme,unit,usually,vary,vein,velutinous,way,white,whitish,wide,x,yellow,yellowish,ympodial,young	
408	wfo-0001030686	exception_thrown	182	0	0	182	0	0.0		.2,.5,.5-1,0.5-1,1-1.1,1-1.2,1-1.5,1-2,1.2-1.5,1.5-2,1.5-4.5,1.6-3,15,1972,2-2.5,2-3,2-6.5,2.5-4,2.5-8,3-3.5,5-12,5-25,5-30,5-6,8-9,?,abaxially,aborted,abruptly,acuminate,acute,adam,adaxially,age,anther,anthesi,apart,apex,bark,basal,base,beneath,berry,bifid,black,branched,breast,brittle,brown,bu,c.,calyx,centre,closely,cm,conical,corolla,cup-shaped,dark,darker,deeply,densely,denser,diameter,different,difoliate,discolorous,dry,drying,eaf,edicel,eed,elliptic,empty,entire,erect,exerted,fide,filament,flattened,flower,form,fragrant,free,fruit,fruiting,geminat,glabrescen,glabrous,globose,golden,half,height,heteromorphic,internodal,lamina,leaf,leaf-opposed,lengthening,lepidote,less,lilac,lobe,lobed,long,lower,many,margin,maturity,midrib,midvein,minutely,mm,nflorescence,noddin,oblique,older,orange,ovary,overlapping,pair,pale,paler,papillae,papillose,pedicel,peduncle,pericarp,petiole,pitted,planar,plant,pore,poricidal,portion,primary,pubescen,pubescent,purple,rachi,ruit,scar,scarious,seed,shallow,shallowly,shiny,short,simple,slightly,slit,somewhat,space,spaced,sparsely,spreading,stellate,stem,stigma,strongly,styl,style,surface,thin,time,tip,tissue,tree,trichome,tube,ud,uniformly,unit,usually,vein,visible,way,woody,x,yellow,ympodial,â	
409	wfo-0001030709	exception_thrown	217	0	0	217	0	0.0		-2,-5,-9,0,0-,0-20,0-30,0.1-0.2,0.15-0.5,0.2-0.5,0.3-1.5,0.4,0.7-1,0.8-4,0.9-1.5,1-1.2,1-1.6,1-4.5,1-6,1.3-1.4,1.4-2,1.6-2.1,1.9-2.8,1/2-2/3,1/3-1/2,1/4,1/4-1/3,10-14,10-50,2-4,2-5,2-6,2-8,2.3-3,2/3-3/4,3-,4-5-merous,5-10,5-20,5-6,5-7,5-9,6-10,6-21,6-7,6-8,7-8,7-9,8-11,8-15,abaxially,acuminate,acute,adaxially,almost,alyx,ame,anther,apar,apart,ape,apex,apically,apparently,articulated,bark,base,berry,blade,branched,bright,broad-deltate,brow,c.,calyx,chartaceous,cm,conical,connivent,cordate,cuspidate,deltate,diameter,discolorous,distance,drying,dull,eaf,edge,eed,elliptic,elongating,equal,erect,extending,filament,finely,flattened-reniform,flower,free,fruit,fruiting,glabrescent,glabrous,increasing,inflorescence,infructescence,lanceolate,lateral,leaf,lengt,length,lobe,lobed,lobing,lon,long,long-acuminat,longer,lower,margin,mature,maturity,mauve,middle,midpoint,midvein,mm,moderately,narrow-deltate,nflorescence,occasionally,often,older,one,open,orange-brown,orolla,oung,pair,pedicel,peduncle,pendulous,per,perfect,pericarp,perpendicular,petiole,pit,pitted,plurifoliat,poricidal,porrect,portion,prickl,prickle,prickly,primary,purple,ray,red-green,red-orange,reflexed,retrorse,rounded,ruit,scar,secondary,seed,short-styled,shorter,shrub,side,simple,size,slender,smooth,sometimes,spaced,sparsely,spherical,spreading,stalk,stalked,stellate,stellate-pubescent,stem,straight,style,surface,tamen,tapering,terete,terminal,tertiary,time,tip,toward,trichome,truncate,tube,unarmed,unit,upper,usually,variously,vary,vein,venation,visible,way,weakly,wide,woody,yellow,yellow-green,ympodial	
410	wfo-0001030714	exception_thrown	178	0	0	178	0	0.0		-3,.2,.5,/3,0.1-0.3,0.3-0.4,0.5,0.5-0.8,0.5-1.9,0.7-0.8,0.8-1,1-1.2,1-1.3,1-1.5,1-2.5,1.2-1.5,1.2-4,1.4-3.5,1.5-2,1/3,2-2.5,2-2.6,20,3-3.5,3-7,5-100,5-6,7-17,>,abaxial,abaxially,acuminate,acute,adaxially,age,aid,along,anther,anthesi,apar,apex,articulating,bark,basal,base,becoming,beneath,berry,blue,blue-black,branching,calyx,campanulate,clavate,climbin,cm,conical,cordate,corolla,cup,dark,densely,denser,diameter,eaf,eed,ellipsoid,elliptic,entire,especially,except,exserted,fide,filament,flattened,flower,free,fruit,glabrous,globose,grading,gradually,gree,greyish,growth,herbaceous,howard,joined,leaf-opposed,leaving,lengthening,liana,like,lobe,lobed,long,lower,many,margin,membranous,midrib,minute,minutely,mm,narrow,narrowly,new,nflorescence,nodding,node,ob-ellipsoid,ob-elliptic,oblique,occasionally,older,ovary,overall,pair,pale,paler,papillat,papillate,pedice,pedicel,peduncle,peg,per,perfect,petiole,pitted,planar,plurifoliat,pore,poricidal,portion,primary,prominent,pubescent,quadrate,reniform,ripe,ruit,scar,shape,simple,slightly,slit,spaced,sparsely,stellate,stem,stigma,strongly,style,submarginal,surface,tapering,terminal,thickened,time,tip,trichome,truncate,tub,tube,twining,ud,uniseriate,unit,vein,vine,violet,way,widely,woody,x,yellow,ympodial	
411	wfo-0001030733	exception_thrown	130	0	0	130	0	0.0		.5,/4,0.5-1,1-1.2,1-1.5,1-2,1.5-5,1.7-2.7,2-2.5,3-4,3-5,4-15,4.5-5,5-8-flowered,6-7,6-9,?,abaxially,acuminate,acute,adaxially,along,anther,anthesi,ape,apex,bark,base,berry,bi-lobed,broadly,brown,calyx,capitate,clearly,closely,cm,conical,coriaceous,corolla,dark,decurrent,deltate,densely,denser,dia,eaf,eed,ellipsoid,elliptic,elongate,embryo,erect,exserted,filament,free,fruiting,glabrous,globose,grayish-brow,green,lamina,later,lateral,leaf,like,lobe,lobed,lon,long,lower,main,margin,middle,minutely,mm,moderately,narrowly,nflorescence,older,onto,opposite,ovary,overlappin,ovoid-reniform,pair,papillo,pedicel,petiole,planar,pore,poricidal,portion,pubescent,rounded,ruit,scar,shaped,shrub,simple,smooth,somewhat,spaced,sparsely,stem,stigma,strongly,style,surface,tall,tear-drop,testa,thick,tip,treelet,trichome,tube,ud,unifoliat,uniseriate,unit,vein,visible,way,white,widest,woody,x,ympodial,young	
412	wfo-0001030772	success	155	112	60	95	52	0.387	0.25-0.5,0.9-1,1-2,2-7,acuminate,anther,apex,attenuate,base,becoming,beginning,beneath,berry,calyx,cm,corolla,dark,difoliate,ellipsoid,elliptic,erect,filament,fruit,fruiting,gently,glabrous,globose,green,later,leaf,long,lower,major,margin,minor,minutely,mm,occasionally,opposite,paler,papillose,pedicel,petiole,pore,shape,shining,shrub,simple,slender,soon,stem,surface,tall,tapering,trichome,tube,unit,white,woody,young	-2,.05,.2,.25,.5,0.2-0.8,0.5-1,0.75-1,0.9-3.1,1-2.5,1.2-5,1.4-1.6,1.5-2,3-3.5,3-5,4.2-6.5,5-10-flowered,5-6,8-10,9-15,acute,anthesi,archin,ba,bark,branch,bud,capitate,closely,deflexed,dia,differing,eaf,edicel,eed,extreme,free,geminat,grey,impressed,inflorescenc,large,lateral,lenticellate,lobe,lobed,lon,long-acuminate,long-triangular,main,methyl,middle,nearly,nflorescence,node,older,one,ovary,overlapping,ovoid-reniform,pair,pale,papillo,per,pitted,poricidal,portion,prominent,reflexed,ripe,rounded,ruit,salicylate,scar,shaped,size,slightly,smelling,spaced,stigma,straight,strongly,style,swollen,tan,tear-drop,tip,ud,uniseriate,usually,vein,widest,wintergreen,x,ympodial	appressed,arching,articulation,bract,branching,breeding,broad-based,cell,colour,connective,form,geminate,growth,hair,heteromorphism,inflated,inflorescence,insertion,interjected,interpetalar,leaflet,length,marking,mature,modification,needle-like,null,odour,orientation,paired,pattern,placement,position,prickle,pseudostipule,rhizome,scale,smell,spot,staman,stone,structure,symmetry,sympodial,system,texture,tissue,tuber,type,vegetative,xylopodia,zygomorphy
413	wfo-0001030781	success	213	135	82	131	53	0.385	0.5-6,1-2,10-40,5-6,5-7,5-8,abaxially,adaxially,anther,apex,axillary,base,berry,borne,bud,cell,chartaceous,cm,corolla,decurrent,deep,densely,dot,end,filament,finely,forked,fruit,glabrous,globose,green,hair,herb,homostylous,interjected,lanceolate,leaf,leaflet,light,like,long,lower,margin,membranous,mm,odd-pinnate,orbicular,ovate,pedicel,pentagonal,petiole,petiolulate,pilose,plurifoliate,pore,poricidal,pubescent,purple,rachi,rarely,rotate-pentagonal,scattered,sessile,short,simple,singly,slit,small,sometimes,sparsely,stem,subovoid,subtending,tall,terminal,tip,tri-,tuber,typically,unit,violet,white	0-5,0.2-4,0.5-8,1-1.5,1-10,1-12,1-4,1-8,1.5-12,1.5-2,1.5-9,1.6-2.2,15-35,2-20,2-3,2.5-14,2.5-3.5,3-4,3-6,4-15,5-merou,6-7,7.5-9,abruptly,acumen,ag,along,alyx,apart,apiculate,apparently,articulated,axe,blade,broadly,brown,brownish,caly,capitat,ciliate,condition,connivent,covering,cuneate,dark,decreasing,diameter,digestion,distal,dorsally,drying,eaf,edge,eed,elliptic,enzyme,erect,especially,exceeding,flat,flower,folded,fresh,geminat,generally,glabrou,glandular,gradually,gray-green,green-white,greenish,hair-like,half,high,honeycomb-shaped,larger,lateral,lengthening,living,lobe,low-growin,make,midrib,minutely,mucilaginous,narrowed,nflorescence,obovate,orolla,ovate-lanceolate,ovoid,pair,papillose,peduncle,perfect,plant,pointed,puberulent,removed,rounded,ruit,seed,seudostipule,size,slightly,somewhat,spaced,specimen,stamen,ste,stigma,stolo,straight,style,tamen,tem,testal,thick,throughout,toward,tube,unwinged,usually,vary,wall,wet,whitish,wide,x,yellow,ympodial	age,appressed,articulation,bract,branching,breeding,broad-based,calyx,colour,connective,form,fruiting,geminate,growth,heteromorphism,inflated,inflorescence,insertion,interpetalar,length,marking,mature,modification,needle-like,odour,orientation,paired,pattern,placement,position,prickle,pseudostipule,rhizome,scale,shape,smell,spot,staman,stolon,stone,structure,surface,symmetry,sympodial,system,texture,tissue,trichome,type,unspecified,vegetative,xylopodia,zygomorphy
414	wfo-0001030782	success	198	150	96	102	54	0.485	0-7,0.4-1.5,1-2,11-47,2,4.6-26,5-20,6-8,abaxially,adaxially,along,anther,apex,arranged,asymmetric,attenuate,axillary,base,basiscopic,bead,berry,blade,bud,cell,cm,connivent,coriaceous,corolla,dark,deep,distal,filament,forked,fruit,generally,glabrescent,glabrous,globose,green,hair,half,herb,high,homostylous,inconspicuous,interjected,lanceolate,leaf,leaflet,lengthening,light,like,lilac,long,lower,medium,mm,moniliform,multiple,necklace,odd-pinnate,orbicular,ovate,ovoid,pedicel,pentagonal,petiole,plant,plurifoliate,pore,poricidal,prominently,rachi,ripe,rotate,rounded,scarce,sessile,short,side,slit,sometimes,stolon,subtending,terminal,tip,tissue,totally,tri-,tuber,typically,unit,usually,white,winged,x	0-1,1-3,1-5,1-6,1.2-3.9,1.3-1.6,1.5-2,1.5-7.5,1.6-4.6,12-30,13-22,15,2-3,2.2-4,2.4-11.5,3-10,3-5,4-11.6,4-6,5-merou,7-15.6,abaxiall,acumen,acuminate,acute,ag,alyx,apart,apparently,articulated,axe,broadly,brownish,capitat,clavate,condition,covering,cuneate,decreasing,diameter,digestion,dorsally,drying,eaf,edge,eed,elliptic,enzyme,exceeding,flat,flower,folded,fresh,geminat,glabrou,green-white,greenish,hair-like,hal,honeycomb-shaped,lateral,living,lobe,make,mottled,mucilaginous,nflorescence,orolla,pair,peduncle,perfect,petiolulate,purple,removed,ruit,second,seed,seudostipule,size,smaller,spaced,specimen,stamen,stigma,straight,style,subequal,tal,tamen,tem,testal,thick,throughout,toward,tube,vary,wall,wet,whitish,wide,yellow,ympodial	age,appressed,articulation,bract,branching,breeding,broad-based,calyx,colour,connective,form,fruiting,geminate,growth,heteromorphism,inflated,inflorescence,insertion,interpetalar,length,margin,marking,mature,mentioned,modification,needle-like,odour,orientation,paired,pattern,placement,position,prickle,pseudostipule,rhizome,scale,shape,smell,spot,staman,stem,stone,structure,surface,symmetry,sympodial,system,tall,texture,trichome,type,vegetative,xylopodia,zygomorphy
415	wfo-0001030802	exception_thrown	171	0	0	171	0	0.0		.3,.5,.5mm,0,0.25-0.4,0.5-0.75,0.5-1,0.5-1.5,0.7-1cm,0.75-1,0.9-1,1,1-1.1,1-1.2,1-1.5,2-2.5,2-3,2-5,2.5-3,3-3.5x,3-4,3-6,4-5mm,4-6,5-10-flowered,abaxially,abrupt,acuminate,acute,adaxially,along,anther,anthesi,apex,appearing,bark,basal,base,becoming,beginning,beneath,berry,brown,bud,calyx,campanulate,cm,cordate,corolla,cucullate,deeply,deflexed,densely,denser,dia,difoliate,dry,eaf,edicel,eed,ellipsoid,evenly,except,exerted,exudate,filament,filiform,flattened-reniform,free,fruit,fruiting,geminat,glabrous,gland,glandular,glandurla,globose,halfway,hanging,heart-shaped,incrassate,inflorescenc,internodal,invest,irregularly,lamina,later,lateral,leaf,length,line,live,lobe,lobed,long,long-triangular,lower,m.,main,margin,markedly,material,midvein,minutely,mm,near,nflorescence,obconic,older,ovary,ovoid,pair,pale,palmate,papillate,papillose,pedicel,per,persistently,petiole,pitted,plant,pore,poricidal,portion,prominent,pubescen,pubescent,raised,red,reddish,ruit,scar,shaped,shrub,simple,single-celled,slender,somewhat,soon,spaced,specimen,stem,stigm,stigma,straight,strongly,style,subshrub,surface,tapering,tear-drop,tip,tipped,trichoem,trichome,tube,ud,unifoliate,uniseriate,unit,variable,vein,white,widely,woody,x,yellow,yellowish,ympodial,young	
416	wfo-0001030809	exception_thrown	154	0	0	154	0	0.0		.5,0.2,0.5-1,1-1.25,1-1.5,1.2-1.4,1.4-1.5,1.5-2.4,1.5-3.5,2-2.5,2.3-5.5,20-60-flowered,4.5-5,5-8,6-8,8,9.9-12,across,acute,along,also,anther,anthesi,apar,apex,appearing,bark,base,beneath,berry,branched,broadly,caly,calyx,campanulate,clavate,cm,corolla,curl-tipped,curved,dark-papillo,deciduous,deflexed,deltoid,dense,densely,dia,difoliate,distally,eaf,edicel,eed,ellipsoid,elliptic,erect,especially,evenly,exserted,falcate,filament,free,fruit,fruiting,geminat,glabrous,globose,golden,green,hair,hidden,interpetalar,known,large,lateral,leaf,leave,like,lobe,lobed,lon,long,long-papillose,lower,main,major,markedly,mature,membranous,middle,midrib,minor,minutely,mm,nearly,nflorescence,older,one,opposite,ovary,ovate,overtopping,pedicel,petiole,planar,pore,poricidal,portion,present,pubescent,round,ruit,scar,scattered,several,shinin,shining,shoot,simple,sinus,size,slender,slightly,small,soon,spaced,stem,stigma,straight,style,tall,tapering,terminal,three,time,tip,tomentose,tree,triangular,trichome,tube,two,ud,underside,unequal,uniseriate,unit,vein,white,wide,widest,x,yellow-brown,ympodial,young	
417	wfo-0001030810	success	191	139	75	116	64	0.393	0.2,1,abaxially,adaxially,along,anther,apex,articulated,axillary,base,bipinnate,blue,borne,branched,calyx,cell,cm,colour,densely,divided,elliptical,erect,filament,fleshy,flower,fruit,globose,hair,irregular,leaf,leafy,long,lower,margin,mm,moderately,multicellular,narrow,oblong,occasionally,opposed,pair,pedicel,pentagonal,perfect,petiole,pinnae,pinnate,plurifoliate,pore,poricidal,primary,pubescent,secondary,shaped,shoot,shrub,side,simple,stem,stone,subglabrous,surface,tear-drop,time,tip,tomentose,unicellular,uniseriate,unit,unknown,violet,wide,wing,woody	0.2â0.3,0.3,0.4,0.5â,0.5â0.8,0.6â1.0,0.7â1.4,0.8â5.5,0.95â2.0,0â,1.0â1.5,1.0â2.0,1.0â3.0,1.1â2.0,1.1â2.2,1.2â1.5,1.5â1.9,1â2,1â3,1â5,2.9â4.5,20â100,2â3,2â4,3.0â5.0,3.3â5.5,3.3â8.5,3.5â4.6,3â19,4â14,4â5,4â7,5,5â15,5â30,5â32,6â10,6â22,7â10,7â11,8â10,absen,accrescent,acute,adaxiall,ag,anthesi,apart,axe,ba,blade,brown,chartaceous,clavate,connivent,cylindrical,dark,decreasing,denser,diameter,eaf,eed,elliptic,equal,especially,flattened,geminat,glabrous,green,greyish,half,hig,indumentum,lobe,lon,longitudinal,m.,midrib,midvein,nflorescence,obtu,older,opening,orolla,oung,pale,peduncle,pitted,rarely,reflexed,rounded,ruit,shallowly,shiny,size,slit,sometimes,spaced,sparsely,stigma,straight,style,tamen,tardily,tube,vary,white,x,yellow,ympodial,â2.5,â3,â3.4,â4.5,â5.0,â8	--,0,0.6-1.0,1-2,2,20-100,3,3.5-4.6,4,4-5,5-32,absent,appressed,articulation,bract,branching,breeding,broad-based,connective,corolla,form,fruiting,geminate,growth,heteromorphism,high,inflated,inflorescence,insertion,interjected,interpetalar,leaflet,length,marking,mature,mentioned,modification,needle-like,odour,orientation,paired,pattern,placement,position,prickle,pseudostipule,rhizome,scale,shape,smell,spot,staman,structure,symmetry,sympodial,system,texture,tissue,trichome,tuber,type,vegetative,xylopodia,zygomorphy
418	wfo-0001030822	success	146	111	58	88	53	0.397	.2,0.4,0.4-1,0.5-1.5,abaxially,adaxially,anther,anthesi,apex,attenuate,base,berry,calyx,cm,corolla,cup,dia,difoliate,elliptic-obovate,filament,filiform,fruiting,glabrous,globose,green,inflorescence,internodal,leaf,lobe,lobed,long,lower,major,margin,middle,minor,mm,nearly,occasionally,open,opposite,pedicel,petiole,planar,pore,revolute,shiny,shrub,simple,stem,surface,tapering,tube,unit,usually,white,widest,woody	0-0.5,0.1-0.2,0.8-1,0.9-1,1-1.2,1-1.5,1.5-2,11-15.5,2-2.5,2-3.8,2-5,3-3.5,3-5,3.5-7,5-6,5-7,8-9,acute,ba,beneath,broadly,clavate,closely,clustered,completely,cucullat,cucullate,decurrent,deflexed,deltate,differing,eaf,edicel,eed,erect,exserted,flattened-reniform,fleshy,flower,free,geminat,incrassate,inflorescenc,later,lateral,lon,long-ellipsoid,main,minute,minutely,near,nflorescence,older,onto,ovary,pair,pale,papillo,papillose,perhaps,pitted,poricidal,portion,present,red-papillose,ruit,scar,shaped,size,slightly,somewhat,spaced,sparsely,stigma,strongly,style,tall,tan,tear-drop,tip,ud,vein,winged,x,yellowish,yellowish-brown,ympodial,young	appressed,articulation,bract,branching,breeding,broad-based,cell,colour,connective,form,fruit,geminate,growth,hair,heteromorphism,inflated,insertion,interjected,interpetalar,leaflet,length,marking,mature,modification,needle-like,null,odour,orientation,paired,pattern,placement,position,prickle,pseudostipule,rhizome,scale,shape,smell,spot,staman,stone,structure,symmetry,sympodial,system,texture,tissue,trichome,tuber,type,vegetative,xylopodia,zygomorphy
419	wfo-0001030871	exception_thrown	248	0	0	248	0	0.0		.2-3,.8-3.5,.9-1.2,/30-1/5,0-120,0.2-0.4,0.3-4,0.4-1.8,0.6-1.5,0.7-1.3,0.7-2.5,1-1.3,1-18,1.3-2,1.3-3,1.4-2.7,1.5-3,1.5-6,1.8-2.6,1.8-3.5,1/2,1/2-3/4,1/4,1/4-1/3,11,2-3,2-8,2.8-4.5,3-32,3-4.4,3-5,3-6,3.5-14,30,4.5-6.5,4.8-9.5,5-33,5-7,6-40,7-12,9-13,abaxially,abruptly,accrescent,acuminate,acute,adaxial,adaxially,ag,along,anther,anthesi,apart,apex,apical-lateral,apparently,appressed,appressed-tomentose,articulated,attenuate,axe,axillary,ba,bark,base,becoming,berry,blade,blunt-tipped,branch,branched,brown,bud,calyx,campanulate,capitat,chartaceous,closely,cm,conical,continued,corolla,dark,decurrent,dehiscing,deltoid,dendritic-echinoi,dendritic-echinoid,dendritic-multangulate,densely,diameter,directed,distal,due,eaf,earl,early,echinoi,echinoid,eed,elliptic,elongate,entire,equal,erect,evident,exserted,extend,filament,fleshy,flower,free,fruit,fruiting,glabrescen,glabrescent,glabrous,granular-tomentose,grayish,green,greenish,growth,hair,held,high,honeycombed,inserted,introrse,large,lateral,leaf,length,lobe,lobed,long,long-,long-stalked,longer,longitudinal,lower,m.,main,margin,midvein,minute,mixed,mm,mostly,multangulat,multangulate,narrowly,nearly,nflorescence,nodding,oblong,obtuse,occasionally,often,older,open,orbicula,orbicular,orolla,ovate,ovate-lanceolate,overlapping,pale,partly,pedicel,peduncle,perfect,petiole,plait,plurifoliate,pore,porrect-stellate,present,probably,prominent,pubescent,purple,rachi,rather,ray,reflexed,relatively,reniform,reticulate-punctate,ripe,rotate-stellate,ruit,runk,scabridulous,sessile,short,short-,short-stalked,shrub,side,simple,slit,small,sometimes,somewhat,soon,spaced,sparingly,sparsely,splitting,stamen,stellate-tomentose,stem,stigma,striate,strongly,style,subglobose,suborbicular,sulcate,suture,tamen,terete,terminal,testa,thick,thick-stalked,thin-stalked,time,tomentose,toward,tree,tube,unarme,unarmed,unit,usually,vary,vein,velutinous,violet,way,white,wide,x,yellow,yellowish,ympodial,young	
420	wfo-0001030872	exception_thrown	166	0	0	166	0	0.0		.5,0.5,0.5-1,0.8-1,0.8-2,1-1.2,1-1.5,1-2,1.2-1.5,1.2-3,1.5-2,1.5-5,12-18,2-5,3-7,4-6,4-6-flowered,5-6,5.5-7,6-12.5,acuminate,acute,adaxial,age,along,anther,anthesi,apex,appearing,area,bark,base,beginning,berry,black,broadly,brown,caly,calyx,center,closed,closely,cm,completely,consisting,corky,corolla,crateriform,cucullate,dark,darker,deflexed,deltoid,densely,dia,difoliate,dry,eaf,edicel,eed,ellipsoid-ovoid,elliptic,erect,exserted,filament,fleshy,free,fruiting,full,geminat,glabrate,glabrous,globose,green,hooded,incurved,inflorescenc,known,large,leaf,lenticel,lenticellate,less,like,live,lobe,lobed,lon,long,lower,major,margin,material,middle,minor,minutely,mm,nearly,nerve,nflorescence,oblique,older,one,opposite,ovary,ovate,overlapping,pair,pale,paler,papillose,pedicel,petal,petiole,planar,pore,poricidal,portion,primary,prominent,proximal,puberulent,raised,rather,red-glandular-puberulent,reddish-glandular,reddish-glandular-puberulent,relative,rest,ridge,rounded,ruit,scar,shaped,shining,shorter,side,simple,size,slightly,small,soon,spaced,specimen,stem,stigma,straight,strongly,styl,style,tall,tapering,tear-drop,thickened,tip,tree,treelet,tube,ud,unit,white,widest,woody,x,ympodial,young	
421	wfo-0001030882	exception_thrown	144	0	0	144	0	0.0		.1,.5,0.5-0.75,0.5-1,0.5-1.1,0.75-1,0.8-1.1,0.8-2.4,0.9-1.1,1-1.3,1-1.5,1-4,1.6-2,2,2-5.4,2-6,2.2-4.6,3-3.5,3/4,6.5-15.6,8-12,?,accrescent,acuminate,anther,anthesi,apex,attenuate,bark,base,beginning,beneath,berry,calyx,capitate,closely,cm,conical,corolla,crenulate,deflexed,deltoid,dia,differing,difoliate,eaf,edicel,eed,elliptic,erect,exserted,extreme,filament,free,fruit,fruiting,geminat,glabrous,globose,green,inflorescenc,lateral,leaf,lightly,lobe,lobed,lon,long,lower,main,major,margin,middle,minor,minutely,mm,narrowly,nearly,nflorescence,occasionally,older,one,opposite,ovary,overlapping,ovoid,ovoid-reniform,pair,pale,paler,papillo,papillose,pedicel,peelin,petiole,pitted,planar,pore,poricidal,portion,prominent,raised,ruguse,ruit,scar,shaped,short,shrub,simple,size,slender,slightly,small,soon,spaced,stem,stigma,straight,style,surface,tall,tan,tapering,tear-drop,terminal,thick,thickened,tip,transversely,tree,truncate,tub,tube,ud,unit,vein,way,white,widest,woody,x,yellowish,ympodial,young	
422	wfo-0001030883	exception_thrown	179	0	0	179	0	0.0		-3,.05,.1,.5,0.5-3,0.5-5,1-1.1,1-1.2,1-1.3,1-1.5,1-4,1.5-2,1.5-3.5,10-18,18-44.5,2-5,20-50-flowered,3-3.5,3-4,3/4,5-6,9.5-27.5,accrescent,across,acuminate,acute,anther,anthesi,apart,apex,appearing,approximatately,arching,bark,base,becoming,berry,branched,brown,bu,calyx,cell,clavate,cm,collapsed,collection,corolla,dark,deflexed,dia,differing,difoliate,dry,eaf,edicel,eed,elliptic,epidermal,erect,evenly,filament,finely,fleshy,free,fruit,fruiting,furcate,geminat,geminate,glabrous,glandular,globose,green,hard,hollow,imbedded,inflorescence,laminar,large,later,lateral,leaf,lenticellat,less,like,little,live,living,lobe,lobed,lon,long,long-acuminate,lower,main,malodorous,markedly,massive,material,middle,midrib,minute,minutely,mm,narrowly,nflorescence,oblique,occasionally,older,opposite,ovary,ovate,ovoid-reniform,pair,pale,papillate,papillo,papillose,pedicel,perpendicular,petaloid,petiole,pitted,placenta,plant,pore,poricidal,portion,present,proximal,puberulent,pulp,quite,rather,reflexed,reticulate,ruit,russet,scar,seed,shaped,shrub,size,slender,slightly,sometimes,soon,spaced,stem,stigma,stout,straight,strongly,style,surface,tall,tan,tapering,tear-drop,thick,time,tip,triangular,trichome,tube,two,ud,uniseriate,unit,upper,vein,wall,way,white,widest,woody,x,ympodial,young	
423	wfo-0001030884	success	218	168	119	99	49	0.546	.2,0.3,0.4-3,0.5,1-1.5,1-3,10,2-5,4.5-5,5,6-8,abaxial,abaxially,abruptly,acute,along,also,anther,apex,base,berry,broad-based,c.,calyx,cm,curved,decurrent,densely,di-,differing,directed,equal,extend,extending,filament,fruiting,geminate,glandular,gray-tinged,green,greenish,growth,half,heterostylous,inflorescence,lateral,leaf,leafy,length,like,lobe,lobed,long,long-stalked,lower,magnification,margin,mature,midpoint,midrib,mixture,mm,moderately,node,occasionally,one,onto,pair,pedicel,petiole,pore,poricidal,porrect,present,prickle,prickly,pubescent,ray,reddish,reflexed,sagittate,sessile,shallowly,short,short-stalked,shrub,similar,simple,size,slender,sparsely,spherical,spreading,stellate,stellate-pubescent,stem,stiff,surface,tall,tapering,tip,treelet,trichome,trifoliate,unicellular,uniformly,uniseriate,unit,upward,usually,visible,way,weakly,white,wide,wing,winged,without,yellow	.5,.7,0.3-0.5,0.5-1.2,0.8-1,0.9-5,1,1-1.2,1.5,1.5-2,1.5-2.5,100,2,4-13,4-5,5-30,5-6,5-merous,5.5-7,6-10,6-25,7-8,9-11,>,adaxial,adaxiall,alyx,andromonoeciou,anthesi,apar,arme,articulated,bark,basal,blade,brown,capitate,conical,connivent,dark,diameter,discolorous,distal,eaf,eed,elliptic,flower,flowering,free,glabrous,gree,herbaceous,infructescence,long-styled,long-triangular,minute,minutely,new,nflorescence,older,open,orolla,oung,outlin,ovary,ovoid-reniform,pale,papillat,peduncle,per,plant,portion,primary,principal,red,reflexe,regularly,rest,ruit,scar,scattered,shap,short-styled,spaced,stigma,still,strongly,style,tamen,tannish,time,tube,unarmed,vary,varying,vein,woody,ympodial,young	andromonoecious,apart,appressed,articulation,bract,branching,breeding,cell,colour,connective,corolla,form,fruit,hair,heteromorphism,inflated,insertion,interjected,interpetalar,leaflet,marking,modification,needle-like,null,odour,orientation,paired,pattern,placement,position,pseudostipule,rhizome,scale,shape,smell,spot,staman,stone,structure,symmetry,sympodial,system,texture,tissue,tuber,type,vegetative,xylopodia,zygomorphy
424	wfo-0001030899	exception_thrown	146	0	0	146	0	0.0		-45,.5-2,0.3-0.5,0.5,0.5-1,1,1-1.5,1-2,1-3,1-6,1.5-2,10-13,10-20,2,2-3,2-3.5,2.5-3.5,20-25,3-12,3-4,3-5,3-foliate,3.5-4,4-5,5-10,5-6.5,6.5-31,7-27,8-11,?,abaxially,absent,acuminate,acute,adaxially,aggregate,apart,ape,apex,articulated,axe,basal,base,beyond,blade,bronze,calyx,cell,chartaceous,cm,connective,connivent,cordate,coriaceous,deeply,densely,desc,diameter,dilated,directed,distally,eaf,eed,ellipsoidal,end,entire,ex,exceeding,exserted,extrorse,flattened,flower,fruit,glabrous,glandular-puberulent,globose,green,inside,leaving,less,light,lobe,lon,long,lower,margin,mm,mucronate,narrowly,nflorescence,nther,obconical,oblong,obtuse,orang,orolla,outside,ovate,ovoid,pedicel,pedicellar,peduncle,peltifor,perfect,petiole,pore,presen,puberulen,puberulent,pubescent,purple,rachi,radiu,remnant,ruit,shorter,shrub,simple,slightly,spaced,splotch,stamen,stellate,stigma,stone,stripe,strongly,style,tal,tem,thecae,time,tomento,triangular,tube,ud,unbranched,unit,upward,vary,vein,white,wide,x,yellow,ympodial	
425	wfo-0001030902	success	159	141	85	74	56	0.535	-2,-5,1-2,1.5-,1.5-13,2,2-3,2-5,2.5,3-13,3-4,3.5-4,6-24,abaxially,absent,acuminate,adaxially,aggregate,along,apex,articulated,basal,base,blade,branched,brown-pilose,calyx,cell,cm,connective,connivent,cordate,dark,densely,directed,distally,eglandular,ellipsoidal,entire,except,forked,fruit,glabrescent,glabrous,glandular,globose,hair,laterally,leaving,lobe,long,lower,margin,mature,mm,oblong,occasionally,orange,ovate,pedicel,pedicellar,perfect,petiole,pore,present,puberulence,purple,rarely,reddish,remnant,simple,small,sparse,stellate,stone,subcoriaceous,time,tree,truncate,unbranched,unit,vein,wide,x,yellow	-20,0-15,0.6-1.5,1-6,1.5-2,1.5-2.5,10-15,15-50,2.5-4,3-20,30-50,4,4-22,4-6,4-7,4-foliat,5-7,5-9,8-14,acute,angled,apart,ape,apically,apiculate,axe,beyond,brow,cylindrical,deltate,diameter,dilated,eaf,eed,equalling,exceeding,exserted,flattened,fleshy,flower,glabrat,glandular-puberulen,lon,narrowly,nflorescence,nther,obtuse,orolla,peduncle,pinkish,presen,purplish,rachi,radiu,ruit,shorter,slightly,somewhat,spaced,sparsely,stamen,stigma,style,subcapitat,tal,tem,thecae,tip,tomento,triangular,tube,ud,vary,ympodial	4-foliate,anther,appressed,articulation,bract,branching,breeding,broad-based,colour,corolla,filament,form,fruiting,growth,heteromorphism,inflated,inflorescence,insertion,interjected,interpetalar,leaf,leaflet,length,marking,modification,needle-like,null,odour,orientation,paired,pattern,placement,position,prickle,pseudostipule,rhizome,scale,shape,smell,spot,staman,stem,structure,surface,symmetry,sympodial,system,tall,texture,tissue,trichome,tuber,type,vegetative,xylopodia,zygomorphy
426	wfo-0001030914	exception_thrown	186	0	0	186	0	0.0		.1,.5,/4,0-0.25,0.1-0.5,0.5-1,0.7-1,0.8-1,0.8-1.3,1-1.5,1-2,1.2-1.5,1.5-2,1.5-3,1.5-8,2-10,2-2.5,2.5-11,2.5-3,3-4,3.5-17,5-17,5-25-flowered,7-10,7-8,9-35,acute,along,anther,anthesi,apex,attenuate,bark,base,beneath,berry,blade,bud,calyx,campanulate,capitate,closely,cm,constriction,corolla,dark,decurrent,deflexed,deltoid,densely,dia,differing,difoliate,distal,dry,eaf,edicel,eed,ellipsoid,elliptic,equal,erect,even,evenly,exserted,filament,flower,free,fruiting,furcate,geminat,glabrate,glabrous,globose,golden,green,greyish-brow,individual,inflorescence,later,lateral,leaf,lemon-yellow,length,like,live,lobe,lobed,lon,long,long-styled,lower,main,major,many,margin,middle,minor,minutely,mm,narowly,nflorescence,obovate,occasionally,often,older,one,onto,opposite,otherwise,ovary,overlappin,ovoid-reniform,pair,pale,papillo,papillose,pedicel,petiole,pitted,planar,plant,pore,poricidal,portion,prominent,puberulent,pubescent,quite,raised,reddish-brown,rest,ripe,rounded,ruit,scar,shape,shaped,short-styled,shrub,simple,size,slender,slightly,small,sometimes,soon,spaced,sparsely,specimen,stem,stigma,straight,style,surface,tall,tan,tapering,tear-drop,thick,third,ti,time,tip,tree,trichome,trunk,tub,tube,ud,uniseriate,unit,usually,variable,vein,way,weight,white,widest,winged,within,woody,x,yellow,ympodial,young	
427	wfo-0001030918	exception_thrown	230	0	0	230	0	0.0		-12,-2.3,-3.2,-4,-4.5,-40,-5,-6,-9,.5,.7,0-10,0-20,0-25,0-4,0-6,0.1,0.1-0.25,0.2-0.4,0.25-0.45,0.3-1.5,0.5-0.7,0.5-2,0.5-2.5,0.6,0.6-2.5,0.7-1.2,0.7-1.7,1,1-1.5,1-1.8,1-2,1-4,1.5-2,1.5-2.5,1.5-5.5,1/2-2/3,1/2-3/4,1/3,1/3-,1/3-1/2,1/4-1/3,2-10,2-2.5,2-25,2-3,2-4,2-7,2-8,2.8-3,2/,3-15,3-4,3-6.5,3-7,3.5-6,4-7,5-7,5-8,5-merous,5.5-7,6-8,7-10,abaxial,abaxially,acicular,acute,adaxial,alyx,ame,anther,apar,apart,apex,apically,apparently,articulated,bark,base,berry,blade,branched,brow,c.,calyx,caudat,cell,chartaceous,cm,connivent,cuneate,curved,dark,deltate,densely,diameter,difoliate,discolorous,distance,drying,dull,eaf,elliptic,elongated,elongating,equal,erect,evenly,extending,faint,filament,flattened,flattened-reniform,flower,free,fruit,fruiting,geminat,glabrescent,glabrous,green,green-brown,infructescence,lateral,leaf,length,lobe,lobed,lobing,long,longer,lower,margin,mature,maturity,mauve,midpoint,midvein,mixture,mm,moderately,narrow-deltate,nflorescence,oblong,obtuse,occasionally,older,one,open,orange,orange-brown,orolla,oung,outline,pair,pale,pedicel,peduncle,pendulous,per,perfec,pericarp,perpendicular,petiole,pit,poricidal,porrect,portion,prickl,prickle,prickly,primary,pubescent,purple,raised,ray,red,red-brown,reduced,reflexed,ruit,scandent,scar,secondary,seed,sessile,shrub,side,simple,slender,small,smooth,sometimes,somewhat,spaced,sparsely,spherical,spreading,stalk,stalked,stellate,stellate-pubescent,stem,straight,strongly,style,surface,tamen,tapering,terete,terminal,tertiary,time,tip,trichome,tube,unit,upper,usually,vary,vein,venation,visible,way,weakly,wide,woody,yellow,ympodial,young	
428	wfo-0001030943	exception_thrown	167	0	0	167	0	0.0		.5,0,0.5-1,0.5-3,1-1.2,1-1.5,1.1,1.5-2,1.8-2.2,1/2,10-25,12-15,2-6,3,3-4,3/4,4-4.5,4-5,4-6,7-13.5,7-8,8-10,abaxial,abaxially,absent,acuminate,acute,adaxial,adaxially,age,along,anther,anthesi,apex,apical,bark,basal,base,becoming,belo,berry,bi-lobed,black,branch,branching,calyx,cm,conical,corolla,cupulate,dark,decurrent,deflexed,dendritic,densely,denser,diameter,drying,eaf,echinoid,edicel,eed,elliptic,elongate,erect,ew,exserted,fide,filament,flattened,flower,free,fruiting,glabrat,glabrous,globose,golden,golden-yellow,growth,horizontal,im,inserted,large,lateral,leaf,lenticular,lobe,lobed,lon,long,lower,m.,main,minute,minutely,mm,monochasia,narrowly,nflorescence,nodding,often,older,outline,ovary,overtopping,pair,pale,papillo,pearce,pedicel,per,pericarp,petiole,pitted,planar,plurifoliate,pore,poricidal,portion,pubescent,purplish-black,raised,reddish-brown,ruit,scar,scattered,secondary,shoot,showy,shrub,sleeve,slightly,slit-like,small,somewhat,sparsely,stamen,stem,stigma,strongly,style,surface,tall,tapering,terminal,thin,time,tip,tree,tree-like,triangular,trichome,tub,tube,ud,unit,upper,vein,violet,way,wide,woody,x,yellow,yellowish-white,ympodial,young	
429	wfo-0001030959	exception_thrown	164	0	0	164	0	0.0		.05,.2,.8,/5,0.5,0.5-1.5,0.7-1.2,1-10,1-2,1-7,1.2-1.8,1.5-2,1.5-3.5,1/5-1/10,10-15,2-4,2.5-4,2.5-4.5,2.5-5,4-6,4-8,5-6,5-9,5-merous,6-8,9-12,abaxially,almost,alyx,ame,anther,apar,apart,apex,apically,apparently,armed,articulated,bark,base,blade,branched,brown,brown-green,c.,cm,color,concolorous,connivent,cuneate,curved,deltate,densely,diameter,difoliate,distributed,drying,eaf,eed,elliptic,equal,erect,evenly,filament,flower,free,fresh,geminat,gently,glabrescent,glabrou,glabrous,glandular,green-brow,hair,inflorescence,know,known,lateral,leaf,length,less,like,lobe,lobed,long,long-acuminat,long-acuminate,longer,lower,margin,membranous,midpoint,minute,mm,narrow-deltate,nflorescence,numerous,older,one,open,orolla,oung,pair,part,pedicel,peduncle,perfec,perpendicular,petiole,poricidal,porrect,portion,present,prickl,prickle,prickly,primary,prominent,ray,ruit,scar,scrambling,secondary,sessile,several,short,shrub,side,simple,slender,spaced,sparsely,spreading,stellate,stellate-pubescent,stem,straight,straw,style,subentire,surface,tamen,tapering,terete,tertiary,time,tip,toward,trichome,tube,unarmed,unit,usually,vary,vein,venation,visible,way,whole,wide,yellow,ympodial,youngest	
430	wfo-0001030982	exception_thrown	215	0	0	215	0	0.0		-2-2.5,.1,.2,.5,0.05,0.05-0.5,0.1,0.1-0.15,0.2-3,0.3-2,0.5,0.5-0.9,0.5-1,0.5-3,1,1-1.5,1-8,1.5,1.5-2,1.5-3,2/3,3-21,3-8,4-12,4-5,6-8,abaxially,acuminate,acute,adaxially,age,angular,anisophyllous,anther,anthesi,ape,apex,appressed,ba,base,beneath,berry,broadly,brown,brownish,bud,caducous,calyx,capitate,central,channelled,chartaceous,ciliate,closely,cm,conic,conical,corolla,cream,cucullate,cuneate,curved,dark,deflexed,deltate,diameter,differing,difoliate,distall,distally,distichou,dry,drying,eaf,edicel,eed,ellipsoid,elliptic,enlarged,entire,exerted,extension,external,filament,flattened-reniform,fleshy,flower,foliage,form,free,fresh,fruit,fruiting,geminate,glabrescent,glabrous,glandular,glandular-papillose,globose,golden-green,green,greenish,growth,hilum,impressed,inconspicuously,internal,isostylous,larger,later,leaf,lengthening,less,like,live,lobe,lobed,long,lower,major,margin,materia,material,maturity,midvein,minor,minutely,mm,mostly,near,new,nflorescence,oblique,obovate,occasionally,often,olive,one,opposite,ovary,ovate,overlappin,packed,pair,pale,papillae,papillat,papillate,papillose,pedicel,peduncle,petiole,pitted,planar,plant,pore,poricidal,portion,primary,projection,prominent,prominently,puberulent,pubescent,reddish,reflexed,rest,revolute,rhizomatous,ruit,sagittate,scar,seed,separated,shoot,sigmoidally,simple,sinuate,situated,size,slightly,slit,somewhat,sparsely,stamen,stem,stigma,straight,stripe,strongly,style,subshrub,surface,testa,tetramerous,tightly,time,tip,transverse,trichome,tub,tube,ud,uniseriate,unit,vegetative,vein,veined,way,weakly,white,x,yellowish,ympodial,young	
431	wfo-0001030989	exception_thrown	177	0	0	177	0	0.0		.5,0.5-1,1-1.5,1-10,1-2,12-15,15-27.5,2-3.5,3-20,3-4,3-5.5,3-7.5,4-5,4-7,4-8,5,5-merou,5.5-7.9,6-13,6-6.5,9-10,abaxially,acuminate,adaxially,ag,alyx,anther,apart,apex,apparently,articulated,axe,axillary,base,berry,blade,brownish,bud,capitat,cell,chartaceous,ciliate,cm,condition,conical,connivent,corolla,covering,decreasing,densely,diameter,digestion,distal,dorsally,drying,eaf,edge,eed,end,enzyme,erec,especially,filament,flat,flower,folded,forked,fresh,fruit,geminat,generally,glabrou,glabrous,gradually,green,green-white,greenish,hair,hair-like,half,herb,homostylous,honeycomb-shaped,interjected,lanceolate,larger,lateral,leaf,leaflet,lengthening,light,like,living,lobe,long,lower,make,margin,minute,mm,mucilaginous,nflorescence,obtuse,occurring,odd-pinnate,orbicular,orolla,ovate,ovate-lanceolate,ovoid,pair,pale,pedicel,peduncle,perfect,petiole,petiolule,plant,plurifoliate,pore,poricidal,present,proximal,pubescen,pubescent,ray,removed,ripe,rotate,ruit,secondary,seed,semierect,seudostipule,singly,size,slit,spaced,sparsely,specimen,ste,stem,stigma,stolo,style,subequal,subsessile,subtending,symmetrical,tall,tamen,tem,terminal,testal,thick,thir,throughout,tip,toward,tri-,triangular,tube,tuber,typically,unit,unwinged,usually,vary,violet,wall,wet,whitish,wide,wider,x,yellow,ympodial	
432	wfo-0001030991	exception_thrown	204	0	0	204	0	0.0		.5,0,0.1,0.2,0.2-0.7,0.3-0.4,0.5,0.5-0.7,0.5-1,0.5-1.5,0.5-3.5,0.6-0.8,0.7-1.2,1-1.5,1-1.6,1-2.2,1-2.5,1-7,1.5,10-20,2-plurifoliat,2.5-10,2.5-3,2/3,3-,3-5-lobed,4-10,5-5.5,5-merou,9-11,<,abaxially,absent,acuminate,acute,adaxiall,adaxially,ag,along,alyx,angled,anther,anthesi,apex,apparently,appressed,arising,ark,articulated,ascending,attenuate,basal,base,berry,brown,bulbous,calyx,capitate,cell,cm,color,conical,connivent,corolla,densely,diameter,different,distally,drying,eaf,eed,ellipsoid,ellipsoidal,elliptic,elongate,enlarged,entire,exerted,eye,filament,filiform,flattened,flower,free,frui,fruiting,furcate,fusiform,glabrescen,glabrous,globose,grey,growth,herb,ilament,incised,inflorescence,lanceolate,lateral,leaf,leaf-opposed,leave,lengthening,less,like,lobe,lobed,long-triangular,loosely,lower,margin,midrib,minute,minutely,mm,narrowly,nearly,new,nflorescence,nodding,occasionally,often,older,orolla,outline,packed,pair,papillo,part,particularly,pedicel,peduncle,pendant,per,perfect,pericarp,petiole,pinnatifid,pitted,platfor,pointing,pore,poricidal,portion,primary,pseudoumbel,pubescent,rectangular,red,reflexed,reniform,rest,ripe,rootstoc,ruit,scar,scattered,shallowly,shiny,short,shrub,simple,sleeve,slightly,slit,small,somewhat,sparsely,spreading,stellate,stem,stigma,strongly,style,suffrutescent,surface,tangled,tem,terminal,testal,thin,tightly,tip,trichome,tube,twinin,ud,uniformly,uniseriate,unit,upper,variably,vary,vein,violet,weak,weight,white,winged,woody,x,yellowish,ympodial,young	
433	wfo-0001031005	exception_thrown	231	0	0	231	0	0.0		.4,.5,/3-1/2,0-0.5,0.1,0.3-0.5,0.5-1.5,0.8,0.9,1,1-1.5,1-2,1-2.5,1-3,1.5-2.5,1.5-4,10,2-3.2,2.3-3,2.5,2.5-4,3-10,3-4,3-6.5,4-6,5,5-7,5-8,5Â°,6-12,abaxial,abaxially,accrescent,acuminate,acute,adaxially,age,almost,along,alyx,anther,anthesi,apar,apex,apically,apparently,articulated,attenuate,bark,base,berry,black,blue,brachyblast,branch,branched,branching,brown,calyx,capitate,chartaceous,clearly,clum,clustered,cm,common,concolorous,conical,corolla,cupular,curved,dark,datum,deeply,delineated,deltoid,dendritic,dendritic-pubescent,denser,density,detaching,developing,diameter,dilated,discolorous,divided,domatia,drying,eaf,ellipsoi,elliptic,elongated,entire,equal,evenly,extending,eye,fertilisation,filament,fine,flat,flattened,flexuous,flower,form,forming,free,fruit,fruiting,glabrous,greenish,immature,increasing,inside,junction,known,lateral,leaf,leave,length,lengthening,liana,like,linear,lobe,lobed,long,longitudinally,loop,lower,m.,main,margin,membranous,midvein,minute,mm,much,naked,network,nflorescence,nther,oblong,obovate,obscure,occasional,occasionally,often,older,onl,orange-brown,orolla,ou,outside,ovate,ovoid,pair,pedicel,peduncle,pendulous,perfec,pericarp,petiole,plurifoliat,pointed,pore,poricidal,portion,primary,prominent,protruding,pubescent,purple,rachi,raised,ray,region,rest,ridged,ruit,scar,secondary,seed,short,side,simple,slender,smaller,smoot,smooth,sometimes,somewhat,soon,sparsely,spread,spreading,standing,stem,stigma,strongly,stump,style,surface,surrounding,tangling,tearing,terete,terminal,tertiary,thick-chartaceous,thin,tip,toward,trichome,tube,ud,unarmed,uneven,unit,usually,vary,vein,venation,visible,weakly,well-developed,white,wide,x,ympodial,young	
434	wfo-0001031007	exception_thrown	207	0	0	207	0	0.0		.5,0.2,0.5,0.5-1,0.5-10,0.75-1.5,1,1-1.2,1-1.5,1-3.5,1.2-1.5,1.3-,1.5-2,1.6-2,1.9-3,1/3,11-14,15,2.5-,2.5-5,3-4,4-6,4-7,4.5-5,5,5-12,5-merou,5.5-6,50-100,6,7-10,8-10,<,abaxiall,abruptly,acute,ag,alfway,almost,along,alyx,anther,anthesi,apar,apex,apparently,ark,articulated,base,becoming,beginning,berry,bifid,black,branched,branching,broad,broadly,brown,c.,calyx,campanulate,capitate,cell,chartaceous,clustered,cm,completely,connivent,corolla,cuneate,cup-shaped,dark,deltate,dendritic,densely,diameter,dilated,drying,dull,eaf,eed,ellipsoid,elliptic,entire,exserted,extending,filament,flattened-reniform,fleshy,flower,free,fruit,fruiting,geminat,glabrescen,glabrou,glabrous,globose,growth,herbarium,ilament,impressed,inflorescence,intramarginal,irregularly,junction,lamina,lax,leaving,lengthening,lilac,lobe,lobed,long,looping,loose,loosely,lower,m.,many,margin,markedly,matte,midvein,minutely,mm,multi-celled,narrowing,narrowly,near,new,nflorescence,nodding,occasionally,often,older,orolla,outline,pale,papillat,papillate,pedicel,peduncle,peg,per,perfect,pericarp,petiole,pitted,planar,plurifoliate,pore,poricidal,portion,primary,prominent,pubescent,rat,reddish,revolute,round-rectangular,ruit,sagittate,scar,shiny,shrub,simple,sleeve,slender,slightly,slit,spaced,sparsely,specimen,splitting,spreading,stellate,stellate-pentagonal,stem,stigma,stout,strongly,style,surface,tangled,terminal,testal,thin,time,tiny,tip,trichome,tube,twining,ud,unit,upper,usually,vary,vein,vine,way,woody,x,yellow,ympodial	
435	wfo-0001031007	exception_thrown	206	0	0	206	0	0.0		.5,0.2,0.5,0.5-1,0.5-10,0.75-1.5,1,1-1.2,1-1.5,1-3.5,1.2-1.5,1.3-,1.5-2,1.6-2,1.9-3,1/3,11-14,15,2.5-,2.5-5,3-4,4-6,4-7,4.5-5,5,5-12,5-merou,5.5-6,50-100,6,7-10,8-10,<,abaxially,abruptly,acute,adaxial,ag,alfway,almost,along,alyx,anther,anthesi,apar,apex,apparently,articulated,bark,base,becoming,beginning,berry,bifid,black,branched,branching,broad,broadly,brown,c.,calyx,campanulate,capitate,cell,chartaceous,clustered,cm,completely,corolla,cuneate,cup-shaped,dark,deltate,dendritic,densely,diameter,dilated,drying,dull,eaf,eed,ellipsoid,elliptic,entire,exserted,extending,filament,flattened,fleshy,flower,free,fruit,fruiting,glabrescen,glabrou,glabrous,globose,growth,herbarium,ilament,impressed,inflorescence,intramarginal,irregularly,junction,lamina,lax,leaving,lengthening,lilac,lobe,lobed,long,looping,loose,lower,m.,many,margin,markedly,matte,midvein,minutely,mm,multi-celled,narrowing,narrowly,near,new,nflorescence,nodding,occasionally,often,older,orolla,outline,pale,papillat,papillate,pedicel,peduncle,peg,per,perfect,pericarp,petiole,pitted,planar,plurifoliat,pore,poricidal,portion,primary,prominent,pubescent,rat,reddish,reniform,revolute,round-rectangular,ruit,sagittate,scar,shiny,shrub,simple,sleeve,slender,slightly,slit,spaced,sparsely,specimen,splitting,spreading,stellate,stellate-rotate,stem,stigma,stout,strongly,style,surface,tall,tangled,terminal,testal,thin,time,tiny,tip,trichome,tube,twinin,ud,unit,upper,usually,vary,vein,vine,way,wide,woody,ympodial	
436	wfo-0001031036	success	150	70	17	133	53	0.113	anther,apex,base,calyx,corolla,filament,fruiting,leaf,lower,margin,pedicel,petiole,pore,stem,surface,trichome,unit	.2,.25,.5,0.5-1,0.8-1,0.8-1.2,1-1.3,1-2.5,1.2-1.5,1.5-3,10-20-flowered,12-15,2-2.5,2.2-3.7,3-4,3-5,3.5-5.5,4.5-6.5,5-6,7-8,abaxially,acuminate,acute,adaxially,along,angle,anthesi,arising,axil,ba,becoming,berry,bi-lobed,broadly,brown,closely,cm,conical,crisped,dark,decurrent,deflexed,dia,differing,difoliate,dry,drying,eaf,edicel,eed,ellipsoid,elliptic,enlarged,erect,exserted,filiform,flattened-reniform,fleshy,free,fresh,geminat,glabrous,globose,green,greenish-white,knob-like,lamina,lateral,lobe,lobed,lon,long,main,major,material,middle,minor,minutely,mm,nearly,nflorescence,oblique,older,onto,opposite,ovary,overlappin,pair,papillo,papillose,perhaps,pitted,planar,pointed,poricidal,portion,rounded,ruit,sagittate,scar,shaped,shiny,short,shrub,simple,sinus,size,slightly,soon,spaced,spathulate,stigma,strongly,style,tall,tapering,tear-drop,thickened,tip,tub,tube,ud,uniseriate,usually,vein,white,widest,winged,woody,x,yellowish,ympodial,young	appressed,articulation,bract,branching,breeding,broad-based,cell,colour,connective,form,fruit,growth,hair,heteromorphism,inflated,inflorescence,insertion,interjected,interpetalar,leaflet,length,marking,mature,modification,needle-like,none,odour,orientation,paired,pattern,placement,position,prickle,pseudostipule,rhizome,scale,shape,smell,spot,staman,stellate,stone,structure,symmetry,sympodial,system,texture,tissue,tuber,type,vegetative,xylopodia,zygomorphy
437	wfo-0001031064	exception_thrown	179	0	0	179	0	0.0		.0-2.5,.05,.5,.5-1,0,0-15,0.5,0.5-0.7,0.5-0.8,1,1-1.2,1-2,1-3,1.2,1.5-2,1.7-4.2,10-12,10-12.5,10-17,2,2.5-3,3,3-5.5,3-7,3.5-4,4-5-celled,5-10.5,5-6,6-16,7-16,8-10-celled,abaxially,acroscopic,acuminate,adaxially,along,anther,anthesi,anticlinal,apex,arising,attenuate,axil,basal,base,bearing,berry,blade,bright,broader,calyx,cell,clavat,cm,commentary,completely,conical,conspicuous,corolla,dark,deltate,densely,denser,diameter,distal,dr.,eaf,edicel,eed,elongate,epidermal,erec,exserted,filament,fleshy,flower,free,fruit,fruiting,glabrous,globose,green,half,highly,inflorescence,irregular,irregularly,lamina,lateral,leaf,leaflet,leave,lenticel,lightly,like,lobe,lobed,lon,long,lost,lower,margin,minute,minutely,mm,narrower,near,nearly,nflorescence,nodding,node,obovate,occasionally,often,open,ovary,ovate,ovoid-reniform,pair,papillate,pedicel,per,petiole,petiolule,pinnate,planar,poricidal,portion,projection,prominent,pubescen,pubescent,purple,rachi,rugose,ruit,scar,scattered,see,short-pubescent,shrub,side,simple,single,sinuous,sinus,slender,smaller,somewhat,sparsely,splitting,stem,stigma,strongly,style,surface,swollen,tal,tem,terminal,thickening,time,tip,translucent,trichome,tub,tube,ud,unifoliat,uniseriate,unit,usually,vein,wand-like,white,winged,without,x,ympodial	
438	wfo-0001031071	success	186	145	91	95	54	0.489	0-10,1-2,1.5-2.2,2-5,3.8-5.4,5-9.4,5.7-8.8,6-8,7-16.5,abaxially,acute,adaxially,along,anther,apex,arranged,asymmetric,attenuate,axillary,base,basiscopic,bead,berry,blade,blue,bud,cell,cm,color,coriaceous,corolla,dark,decreasing,deep,distal,elliptic,filament,forked,fruit,glabrous,globose,green,herb,homostylous,interjected,lateral,leaf,leaflet,like,lilac,long,lower,medium,mm,moniliform,multiple,necklace,odd-pinnate,orbicular,ovate,pair,pedicel,pentagonal,petiole,petiolulate,plurifoliate,pore,purple,ripe,rotate,round,sessile,short,side,size,slightly,spot,star,stolon,subequal,subtending,terminal,tissue,toward,tri-,tuber,typically,unit,usually,white,x	0.2-0.8,0.4-2,1-1.5,1-3,1-7,2-3,2-8,2.1-3,2.4-3.4,3-10,3-5,3-6,4-25,4-6,5-merou,7-8,8-28,abaxiall,acumen,ag,alyx,apart,apparently,articulated,axe,brownish,capitat,clavate,condition,connivent,covering,diameter,digestion,dorsally,drying,eaf,edge,eed,enzyme,erec,exceeding,flat,flower,folded,fresh,geminat,generally,glabrou,green-white,greenish,hair-like,half,honeycomb-shaped,lanceolate,lengthening,living,lobe,make,middl,mottled,mucilaginous,narrowly,nflorescence,orolla,ovoid,peduncle,perfect,plant,poricidal,removed,ruit,seed,seudostipule,slit,spaced,specimen,stamen,stigma,straight,style,tall,tamen,tem,testal,thick,throughout,tip,tube,vary,wall,wet,whitish,winged,yellow,ympodial	appressed,articulation,bract,branching,breeding,broad-based,calyx,colour,connective,erect,form,fruiting,geminate,growth,hair,heteromorphism,inflated,inflorescence,insertion,interpetalar,length,margin,marking,mature,middle,modification,needle-like,null,odour,orientation,paired,pattern,placement,position,prickle,pseudostipule,rhizome,scale,shape,smell,staman,stem,stone,structure,surface,symmetry,sympodial,system,texture,trichome,type,vegetative,xylopodia,zygomorphy
439	wfo-0001031097	exception_thrown	174	0	0	174	0	0.0		0.45,0.5,1,1-3,1-4,1-4.5,1.5,1.6-5.5,1.8-2.5,1.8-2.6,13-30,2-3,2-3.3,2-4,3-5,3-6-foliat,3.5-6,3.7-8.4,4-6,4-7,5-11,5-12,5-9,8-11,9-21,abaxial,abaxially,acumen,acuminate,acute,adaxially,along,apex,apical,apically,articulate,base,branched,calyx,cell,cm,connate,corolla,covering,cuneate,cyme,darker,decurrent,deep,dehiscent,diameter,dichasial,dichasially,digestion,diminishing,distal,dorsally,dotted,eaf,ebracteate,edge,eed,elliptical,emoval,enzyme,exceeding,filament,flat,flower,folded,forked,frequently,generally,globo,gree,green,green-white,hair-like,half,herbaceous,highly,honeycomb,interjected,interpetalar,introrse,lateral,leaf,leaflet,light,lighter,living,lobe,lon,long,lower,lunat,make,margin,maturing,medium,mm,monochasial,mottled,mucilaginous,narrow,nflorescence,noticeably,nther,oblique,obovate,odd-pinnate,often,orolla,ovate,ovoid,pair,pattern,pedicel,peduncle,pentagonal,perennial,perfect,petal,petiole,petiolulate,petiolule,plan,plant,poricidally,proximal,puberulent,pubescent,purple,rachi,rapidly,rarely,reveal,rotate,ruit,seed,sessile,seudostipule,short,side,size,slit,sometimes,specimen,stamen,stigma,straight,strigose,style,tal,tem,terminal,testal,thick,throughout,tissu,toward,tuber-bearing,typically,unit,vary,vbase,violet,violet-blue,wall,wide,without,yellow,ympodial,Â¼	
440	wfo-0001031101	exception_thrown	197	0	0	197	0	0.0		-1,-16,-20,-30,-5,-8,/2,/2-equal,0.05-0.2,0.1-0.2,0.1-0.3,0.3-0.5,0.5-0.8,0.5-3,0.6-0.8,0.7-0.8,0.8-,1-,1-2,1-2.3,1-3,1.3-2,1.3-2.5,1.4-1.7,1.5-3,1/3-1/2,1/4-1/2,10-30,2-2.8,2-4,2-5,2-6,2.5-,2.5-3.5,2.5-3.8,3-10,3-15,3-8,3.5-4.5,4-10,4-5-merous,4-7,4.5-9,5-20,5-6,6-10,8-15,abaxial,abaxially,acuminate,adaxial,almost,alyx,ame,anther,apar,apex,apical,apically,apparently,articulated,ba,bark,base,berry,blade,branched,bright,c.,calyx,cm,concolorous,connivent,deltate,diameter,difoliate,drying,dull,eaf,eed,elongating,entire,equal,erect,evenly,filament,filiform,flattened-reniform,flower,free,frui,fruiting,geminat,glabrescent,glabrous,glandular,green,green-brown,hair,herbaceous,infructescence,lateral,leaf,length,lobe,lobed,long,long-acuminat,long-acute,longer,lower,margin,mature,maturity,mauve,membranous,midpoint,minute,mm,moderately,multangulate,narrow-deltate,near,nflorescence,obtuse,often,older,one,open,orange-brown,orange-red,orolla,oung,ovate,pair,pale,pedicel,peduncle,pendulous,per,perfec,pericarp,petiole,poricidal,porrect,portion,primary,ray,red,red-brow,resembling,rounded,ruit,scandent,scar,sessile,shrub,simple,smooth,spaced,sparsely,spherical,spreading,stalk,stalked,stellate,stellate-pubescen,stellate-pubescent,stem,straight,style,surface,tamen,tapering,terete,terminal,tertiary,time,tip,trichome,tube,umbel,unarme,unarmed,unit,variously,vary,vein,venation,visible,way,white,wide,yellow,yellow-green,ympodial,young	
441	wfo-0001031114	success	208	152	100	108	52	0.481	0.5,0.5-1,1-1.5,1-10,1-4.5,1.5-2.5,2-17,2-3,2-7,2.5-3,3-4,3-7,7-15,accrescent,anther,apex,articulated,base,becoming,berry,blade,branched,calyx,chartaceous,cm,connivent,covering,densely,directed,discolorous,distally,echinoid,elliptic-ovate,entire,equal,filament,first,fleshy,fruit,fruiting,geminate,globose,green,hair,highly,homostylous,interpetalar,introrsely,large,leaf,leaf-opposed,like,lobe,long,longitudinal,lower,major,margin,minor,mm,multangulate,oblong,opening,ovate,paired,pedicel,petiole,plurifoliate,pore,porrect,pubescent,purple,ripe,rounded,shrub,simple,slightly,slit,small,somewhat,sparsely,stellate,stellate-pubescent,stem,subcoriaceous,subcuneate,subtending,surface,tall,time,tissue,tree,truncate,unit,white,white-pubescent,wide,without,x,yellowish	.1,.2,.5,0-0.3,0.3-0.5,0.7-1.5,0.8-1.2,1-2,1-7,1-8,1.5-4,10-15,2-4,2/3,25-50,3-10,3-5,4-10,4-5,4-8,4.5-6,5-10,5-8,5-merou,6-7,abaxially,absen,acuminate,acute,adaxiall,adaxially,ag,alyx,apart,apparently,axe,ba,brown,capitat,cylindrical,dark,deltate,diameter,differentiated,distal,dried,eaf,eed,erect,especially,flattened,flower,free,frui,glabrous,impressed,juic,lacking,light,long-stalked,membanaceous,midpoint,nearly,nflorescence,nodding,obtuse,often,one,orolla,outline,part,peduncle,perfect,pericarp,prominent,rachi,ray,reniform,rugulose,ruit,sessile,short,short-,short-stalked,side,spaced,stalk,ste,stigma,straight,strongly,style,subcucullate,tamen,tem,thickened,thin,tip,toward,triangular,tube,unarme,vary,vein,white-stellate,whitish,yellow,ympodial	5-merous,age,appressed,articulation,bract,branching,breeding,broad-based,cell,colour,connective,corolla,form,growth,heteromorphism,inflated,inflorescence,insertion,interjected,leaflet,length,marking,mature,modification,needle-like,odour,orientation,pattern,placement,position,prickle,pseudostipule,rhizome,scale,shape,smell,spot,staman,stone,structure,symmetry,sympodial,system,texture,trichome,tuber,type,unarmed,unmentioned,vegetative,xylopodia,zygomorphy
442	wfo-0001031116	exception_thrown	191	0	0	191	0	0.0		-10,.2,.5,.8,/4,0,0.05-0.15,0.1,0.3-0.5,0.4-0.7,0.7-0.9,0.7-1,1,1-5,1/2,1/3-2/,1/6-1/4,10-14,15-25,2-5,2.7-3.2,3.5-4,30-100,30-50,4-10,4-7,5,5-15,5-merous,8-11,9-13,abaxial,abaxially,acuminate,adaxial,almost,alyx,ame,anther,apar,apart,apex,apically,apparently,arachnoid,articulated,attenuate,bark,base,berry,blade,branching,bristle,broad-deltate,brow,c.,calyx,caudate,clearly,cm,collapsed,connivent,densely,diameter,dirty-white,discolorous,drying,dull,eaf,eed,elliptic,elongated,elongating,epidermi,equal,erect,evenly,filament,flat,flattened-reniform,flexuous,flower,fragile,free,fruit,fruiting,glabrescent,glabrous,glaucous-green,green,hair,infructescence,lateral,leaf,length,less,lobe,lobed,long,longer,lower,margin,mature,maturity,mauve,membranous,midpoint,minute,mm,moderately,multangulate,narrow-deltate,nflorescence,obovate,obtu,obtuse,often,older,one,open,orange-brown,orange-red,orolla,oung,pair,pedicel,peduncle,per,perfec,pericarp,perpendicular,petiole,plurifoliat,poricidal,portion,primary,ray,recurved,red-brown,reflexed,rounded,ruit,scar,secondary,sessile,sharply,shortly,shrub,simple,single,slender,small,smooth,soft,sometimes,spaced,sparsely,spherical,stalk,stalked,stellate,stellate-pubescent,stem,straight,style,subentire,surface,tamen,tapering,terete,tertiary,time,tip,tree,trichome,tube,unarme,unarmed,unit,upper,vary,vein,venation,visible,way,weakly,wide,woody,yellow,ympodial,young	
443	wfo-0001031128	success	213	159	110	103	49	0.516	-10,-6.5,/4,0,0.05-0.25,0.2,0.2-0.4,1,1-,1/6-1/3,10-20,2-5,2-9.5,2.5-10,2.5-3.5,5-,8-23,anther,apart,apex,apparently,base,berry,blade,branched,branching,bristle,calyx,cm,concolorous,cuneate,drying,elliptic,elongated,elongating,entire,equal,erect,evenly,filament,filiform,flexuous,fruit,fruiting,glabrescent,glabrous,gland,green,hair,inflorescence,lateral,leaf,length,less,lobed,long,long-acuminate,longer,lower,margin,mature,maturity,mauve,membranous,midpoint,minute,mm,multangulate,often,pale,pedicel,perpendicular,petiole,primary,purple-black,ray,red,red-brown,reduced,reflexed,secondary,sessile,shallowly,short-attenuate,shrub,simple,single,soft,spaced,spherical,stalk,stalked,stellate,stem,straight,surface,terminal,time,trichome,unarmed,undulate,unit,usually,way,white,whitish,wide,yellow-brown,yellow-green,young	-100,-4.5,0-30,0.05-0.2,0.3-0.8,0.5-0.7,0.5-0.8,0.5-1.5,0.5-5,0.6-1,0.8-1.7,1-1.6,1.2-2,1.5-3,1.5-3.5,1/,10-35,2.3-,20-50,20-60,3-4,3.5-4.5,4-5-merous,4-7,5-15,5-19,5-30,8-12,abaxial,abaxially,acute,almost,alyx,apar,ape,apically,articulated,bark,brown,connivent,deltate,densely,diameter,dull,eaf,eed,eye,flattened-reniform,flower,free,glandular,gra,infructescence,lobe,lon,long-acuminat,moderately,multangualte,naked,narrow-deltate,near,nflorescence,occasionally,older,one,open,orange-brown,orolla,oung,pair,peduncle,per,perfect,pericarp,plurifoliat,poricidal,portion,recurved,ruit,scar,short-styled,side,smooth,spreading,staminate,stellate-pubescent,style,tamen,tapering,terete,tertiary,tip,tube,unarme,variously,vary,vein,venation,visible,weakly,woody,yellow,ympodial	appressed,articulation,bract,breeding,broad-based,cell,colour,connective,corolla,form,growth,heteromorphism,inflated,insertion,interjected,interpetalar,leaflet,marking,modification,needle-like,null,odour,orientation,paired,pattern,placement,plurifoliate,pore,position,prickle,pseudostipule,rhizome,scale,shape,smell,spot,staman,stone,structure,symmetry,sympodial,system,texture,tissue,tuber,type,vegetative,xylopodia,zygomorphy
444	wfo-0001031135	exception_thrown	189	0	0	189	0	0.0		-7,0-2,0.5-2,0.7-2,1-,1-1.5,1-10,1-2.5,1-3,1-4,1.5-2,1.5-3,1.5-9,10-20,2,2-,2-2.5,2-23,2-3,2-3.5,2-4,2-5,2.5-28,3-10,3-4,3-5,3.5-12,4-5,4-foliat,5-11,5-30,5-9-pinnate,7-15,abaxially,absent,acuminate,acute,adaxially,adpressed,aggregate,along,also,apart,ape,apex,articulated,axe,basal,base,basiscopically,beyond,biglandula,blade,broad,calyx,campanulate,cell,chartaceous,cm,color,compound,connective,cordate,coriaceous,cuneate,cylindrical,darker,decurrent,deflexed,deltate,densely,diameter,dilated,directed,distally,eaf,eed,eglandular-pubescent,ellipsoida,ellipsoidal,elliptic,entire,equal,especially,exceeding,exserted,fading,flattened,flower,frequently,fruit,fusiform,glabrous,glandular-,green,hair,interstitial,irregularly,lateral,laterally,leaf,leaflet,leaving,light,lobe,lobed,lon,long,longitudinal,lower,margin,midrib,mm,moderately,narrowed,nflorescence,nther,obconical,oblique,oblong,obtuse,occasionally,often,orolla,ovate,ovoid,papillose,pedicel,pedicellar,peduncle,peltiform,perfect,petiole,pilo,pilose,pink,pinnately,pinnatifid,pore,present,puberulent,pubescent,purple,rachi,radiu,remnant,ripe,ruit,shorter,shrub,simple,slightly,small,smaller,spaced,sparsely,stamen,stigma,stone,stripe,strongly,style,subcoriaceous,tal,tem,thecae,time,tip,tomento,toward,tree,triangular,truncate,tube,ud,unbranched,unit,unknow,unlobed,upper,vary,violet,white,whitish,wide,x,yellow-green,yellowish,ympodial	
445	wfo-0001031144	success	231	177	126	105	51	0.545	-11,-13,.2,1-,1-1.5,1-4,100,2,2-,2-3,2-9,25,3-7,3.5-10,4,4-6,5,acuminate,acute,adaxially,anther,apex,ark,asymmetric,basal,base,basiscopically,berry,blac,branch,bright,broadly,brow,brown,calyx,cell,cm,commonly,cordate,corolla,corresponding,divaricate,drying,elliptic,entire,extending,filament,flower,form,fruiting,glabrous,globose,groove,growth,inflated,inflorescence,lamina,later,lateral,leaf,leaflet,less,like,lobe,lobed,long,lower,many,margin,markedly,membranous,mm,near,new,number,oblique,occasionally,often,older,open,outline,pair,pale,pedicel,petiole,pinnately,pinnatifid,plurifoliate,pore,primary,pubescent,red,reddish,shiny,simple,sleeve,slightly,small,smaller,sometimes,sparsely,stellate-rotate,stem,surface,terete,terminal,third,tiny,triangular,trichome,truncate,twining,unequal,uniseriate,unit,upper,usually,variable,vein,vine,violet,white,widest,woody,x,yellowish	.5,0.2,0.5,0.8-1.4,1.1-2.5,2-6,2.5-3,2/3,3-4.5,4-20,4-4.5,5-9,5-merou,6,7-10,<,ag,alyx,anthesi,apart,apicula,apiculae,appearing,around,articulated,away,axi,branche,capitate,closer,connivent,cupped,curved,densely,diameter,eaf,eed,ellipsoid,elongate,elongating,exserted,flattened,flattened-reniform,four,free,geminat,ilament,irregularly,larger,leaving,lengthening,longer,longest,loosely,mere,minute,minutely,nflorescence,one,orolla,papillo,peduncle,peg,pendant,pentagonal,per,perfect,pericarp,pitted,poricidal,portion,progress,quite,rim,ripe,ruit,scar,seed,slit,spaced,spreading,stigma,strongly,style,tan,tangle,tem,testal,thin,tip,together,tube,tuft,twinin,two,ud,vary,wall,way,weight,wing,wood,yellow,ympodial,Â½	appressed,articulation,ba,bract,branching,breeding,broad-based,colour,connective,daxially,fruit,geminate,hair,heteromorphism,insertion,interjected,interpetalar,labrous,length,marking,mature,modification,needle-like,null,odour,orientation,paired,pattern,placement,position,prickle,pseudostipule,rhizome,scale,shape,smell,spot,staman,stellate,stone,structure,symmetry,sympodial,system,texture,tissue,tuber,type,vegetative,xylopodia,zygomorphy
446	wfo-0001031152	exception_thrown	232	0	0	232	0	0.0		-1.5,-10,-5.5,.4,/100-1/16,0-100,0.2-0.3,0.2-1.5,0.3-1.3,0.3-3,1-1.5,1-3,1-6,1.1-2.2,1.1-3,1.2-1.8,1.3-4,1.4-2.6,1.5-3,1.5-3.5,1/2-2/3,1/2-3/4,11,13-27,2-5,2.5-7.5,2.7-3.7,2.7-4.5,2.7-6,2.8-4,3.7-7,4-19,4-6,4-7,4-8,5-6,6.5-10,8-20,9-13,abaxially,accrescent,acuminate,acute,adaxially,ag,along,anther,anthesi,apart,apex,apical-lateral,apparently,articulated,attenuate,axe,axillary,ba,basal,base,becoming,berry,blade,blister,blunt-tipped,branch,branched,brown,bud,bullate,calyx,capitat,chartaceous,closely,cm,conical,continued,corolla,decurrent,dehiscing,deltoid,densely,diameter,directed,due,eaf,earl,eed,entire,evident,exserted,extend,few-rayed,filament,fleshy,flower,free,fruit,fruiting,glabrescen,glabrous,globose,granular-tomentose,green,greenish,growth,hair,high,honeycombed,inserted,introrse,lackin,lanceolate,large,lateral,lavender,leaf,length,less,lilac,lobe,lobed,long,long-,longer,longitudinal,lower,m.,main,margin,midvein,mixed,mm,moderately,mostly,multangulat,multangulate,narrowly,nearly,nflorescence,oblanceolate,oblong,obtuse,occasionally,one,open,openly,orbicular,orolla,ovate,pale,partly,pedicel,peduncle,perfect,persistently,petiole,pitted,plurifoliate,pore,porrect-stellate,probably,pubescent,rachi,rather,ray,reddish,reddish-brown,relatively,reniform,reticulate-punctate,ripe,rotate-stellate,ruit,runk,scabrous,sessile,short-,short-stalked,shrub,side,simple,slightly,slit,somewhat,soon,spaced,sparingly,sparsely,splitting,stamen,stellate-pubescent,stelliform,stem,stigma,stipitate-glandular,stout-stalked,strongly,style,suborbicular,surface,suture,swelling,tamen,terete,terminal,testa,thick,thick-stalked,thin,thin-,thin-stalked,time,tomentose,touching,toward,tree,tube,unarme,unarmed,unit,usually,variously,vary,vein,violet,way,wide,x,yellow,yellowish,ympodial,young	
447	wfo-0001031202	exception_thrown	198	0	0	198	0	0.0		.1,.5,0-0.5,0-1,0.1-0.3,0.5,0.5-1,0.6-1.1,0.8-1,1-1.5,1-1.7,1-5,1.5-2,1.5-2.5,1.5-9,15-40,2-3,2-8,2.5-13,2.5-3.5,2.5-4,2/3,20-100-flowered,3.5-4,6-25,9-11,9-20,abrupt,accrescent,acute,along,anther,anthesi,apart,apex,apiculate,axi,bark,base,beneath,berry,broadly,bud,calyx,capitate,cm,completely,complex,condition,cordate,corky,corolla,cup-shaped,decurrent,deflexed,deltoid,densely,dia,differing,difoliate,distal,dry,due,eaf,edicel,eed,enclosed,erect,exserted,extremely,filament,fleshy,flower,free,frui,fruit,fruiting,furcate,geminat,glabrate,glabrous,globose,golden,green,greenish-white,greyi,hard,inflorescence,irregularly,large,later,lateral,leaf,like,live,lobe,lobed,lon,long,long-ellipsoid,long-styled,longer,lower,main,major,many,margin,material,middle,minor,minute,minutely,mm,narrowing,nflorescence,obovate,occasional,occasionally,often,older,one,opposite,orbicular,ovary,overtopping,ovoid-reniform,pair,pale,paler,papillo,papillose,pedicel,petiole,pitted,planar,plant,pore,poricidal,portion,prominent,puberulent,pubescent,quite,raised,reddish-brown,rounded,ruit,scar,scattered,sessile,shape,shaped,shoot,short-styled,shrub,size,slender,slightly,small,spaced,sparsely,specimen,stem,stigma,straight,style,surface,tall,tan,tapering,tear-drop,terminal,thick,thickened,thicker,third,time,tip,tree,trichome,tub,tube,ud,uniseriate,unit,usually,variable,vein,way,weight,white,whitish,widest,winged,woody,x,ympodial,young	
448	wfo-0001031207	success	219	156	102	117	54	0.466	-1/2,-11,-5,0.1-0.2,0.1-0.5,0.2,0.2-0.3,0.25-0.5,0.5-1,0.8,1,1/3-equal,1/4-1/3,2.5-,3-5,5-8,6-8,9,anther,apart,apex,apparently,base,berry,blade,bristle,calyx,cell,chartaceous,cm,concolorous,cordate,curved,difoliate,discolorous,drying,elongated,elongating,filament,free,fruit,fruiting,gently,glabrous,gray,green,herb,lateral,leaf,length,less,like,lobed,long,lower,margin,mature,maturity,mauve,midpoint,mm,multangulate,obtuse,occasionally,orange-brown,pale,pedicel,perpendicular,petiole,poricidal,porrect,portion,prickle,ray,red,reflexed,scandent,shorter,shrub,simple,sometimes,spaced,spherical,stalk,stalked,stellate,stellate-pubescent,stem,straight,subentire,surface,terminal,tip,trichome,tube,unit,variously,weakly,white,wide,yellow-green,young	-0.4,-4,-7,-8,.1,/5,0,0-0.5,0-10,0-20,0.1-0.3,0.3-0.5,0.6-0.9,0.6-1.2,0.7-2,0.85-1.4,0.9-1.6,1-3,1-4,1-5,1.4-2,1.5-5,1/,1/3,2-3,2-4,2.1-2.3,2.8-3,3.5-7,5-merous,6.5-8,abaxially,acuminat,acute,alyx,ame,apar,apically,articulated,bark,branched,bristly,broad-deltate,brow,c.,dark,densely,diameter,distance,dull,eaf,eed,equal,erect,evenly,extending,eye,filiform,flattened-reniform,flower,geminat,glabrescent,herbaceous,infructescence,lanceolate,lobe,longer,midvein,moderately,naked,narrow-deltate,nflorescence,oblong,older,one,open,orolla,oung,outline,ovate,pair,peduncle,pendulous,per,perfec,pericarp,persistent,pit,prickl,prickly,primary,raised,rounded,ruit,scar,sessile,side,small,smooth,spreading,style,tamen,tapering,terete,tertiary,time,toward,unarmed,upper,usually,vary,vein,venation,visible,way,yellow,ympodial	+,0-5,appressed,articulation,bract,branching,breeding,broad-based,colour,connective,corolla,form,geminate,growth,hair,heteromorphism,inflated,inflorescence,insertion,interjected,interpetalar,leaflet,marking,modification,needle-like,odour,orientation,paired,pattern,placement,pore,position,present,pseudostipule,rhizome,scale,shape,smell,spot,staman,stone,structure,symmetry,sympodial,system,texture,tissue,tuber,type,unbranched,unspecified,vegetative,xylopodia,zygomorphy
449	wfo-0001031218	success	154	135	78	76	57	0.506	0.5,0.5-1,1-2,2-2.5,2-22,4-28,4-8,5-37,6-7,abaxially,adaxially,aggregate,apex,articulated,base,blade,branched,calyx,cell,cm,connective,connivent,cordate,dark,directed,distally,eglandular,ellipsoidal,entire,equal,exceeding,fruit,glabrous,glandular,glandular-puberulent,globose,greenish-purple,hair,introrse,lanceolate,lavender,leaving,less,long,lower,margin,mm,mottled,oblique,orange,ovoid,pedicel,pedicellar,perfect,petiole,pore,present,puberulent,purple,remnant,ripe,shorter,simple,slightly,small,sometimes,sparsely,stellate,stone,subcoriaceous,thecae,time,tree,unit,violet,wide,x,yellow	-5,1-3,1-4,10-19,15-25,2-3,2.5-3,3,3-14,3-5,4-5,4-7,4-foliat,40,40-100+,5-7,5.5-7,6-10,6-9,8-17,8-20,acuminate,acute,apart,ape,apiculate,axe,basal,beyond,coriaceous,cylindrical,densely,diameter,eaf,eed,eglandular-pilose,especially,exserted,flattened,flower,glabrou,lobe,lon,minutely,moderately,narrowly,nflorescence,nther,obtuse,orolla,ovate,ovate-elliptic,papillo,peduncle,presen,pubescent,purpl,rachi,radiu,ruit,spaced,stamen,stigma,style,succulent,tal,tem,tip,tomento,toward,triangular,truncat,tube,ud,vary,ympodial	4-foliate,anther,appressed,articulation,bract,branching,breeding,broad-based,colour,corolla,filament,form,fruiting,growth,heteromorphism,inflated,inflorescence,insertion,interjected,interpetalar,leaf,leaflet,length,marking,mature,modification,needle-like,null,odour,orientation,paired,pattern,placement,position,prickle,pseudostipule,rhizome,scale,shape,smell,spot,staman,stem,structure,surface,symmetry,sympodial,system,tall,texture,tissue,trichome,tuber,type,vegetative,xylopodia,zygomorphy
450	wfo-0001031225	success	163	125	74	89	51	0.454	.5,0.2-0.75,0.5-1,0.8-1,1-1.5,1-5,3/4,acute,along,anther,apex,base,berry,calyx,cm,corolla,decurrent,dia,differing,difoliate,elliptic,filament,fragrant,fruiting,furcate,glabrate,glabrous,globose,green,growth,inflorescence,leaf,like,lobed,long,lower,major,margin,middle,minor,minutely,mm,older,one,opposite,outline,ovate,pedicel,petiole,pore,proximal,pubescent,red-papillose,rounded,shape,shaped,shrub,size,slightly,small,stem,surface,sweetly,tall,tear-drop,tree,trichome,uniseriate,unit,vein,way,white,widest,young	.25,/3,0.1-0.75,0.2,0.5,0.7-6,0.75-1,1-1.7,1-3,1.5-5,2,2.5-3,3-9,5-50-flowered,5-6,6-8,7-9,9-16,anthesi,apart,bark,beginning,broadly,bud,characteristic,closely,conspicuous,cup-shaped,darker,deltoid,differentiated,dry,eaf,edicel,eed,ellipsoid,erect,exserted,flattene,free,geminat,greyish-brow,inflorescenc,lateral,less,live,lobe,lon,main,minute,much,narrowly,nflorescence,often,ovary,ovoid-reniform,pair,pale,papillo,papillose,pitted,plant,poricidal,portion,prominent,raised,reflexed,rest,rhomboidal,ruit,scar,slender,soon,spaced,specimen,stigma,straight,strongly,style,swelling,tan,tapering,tip,tube,ud,unevenly,woody,x,ympodial	appressed,articulation,bract,branching,breeding,broad-based,cell,colour,connective,form,fruit,geminate,hair,heteromorphism,inflated,insertion,interjected,interpetalar,leaflet,length,marking,mature,modification,needle-like,null,odour,orientation,paired,pattern,placement,position,prickle,pseudostipule,rhizome,scale,smell,spot,staman,stellate,stone,structure,symmetry,sympodial,system,texture,tissue,tuber,type,vegetative,xylopodia,zygomorphy
451	wfo-0001031231	exception_thrown	175	0	0	175	0	0.0		-2,.5,0.5-1.5,1-1.5,1-2,1-3,1-4,1.5-2,13,2-3,2-4,2.5-3,25-35,3-4,37/2,37/3,4-8,5-7,8-10,80-110,absent,acumen,acuminate,acute,adherent,almost,along,anther,anthesi,apex,aromatic,aspect,axi,axillary,basal,base,becoming,berry,beyond,blunt,bluntly,branch,branched,brown,calyx,campanula,campanulate,cell,clonal,cluster,cm,colour,corolla,dark,declinate,developed,dia,discoidal,eaf,eed,ellipsoid,elliptic,entire,equal,erect,exceeding,except,exerted,expanded,facetted,filament,fleshy,flower,flowering,folded,fork,general,glabrous,glandular,globose,gree,green,greyish,habit,hair,herbarium,interacuminal,juvenile,lanceolate,lasting,leaf,len,lengthening,less,lobe,lon,long,loosely,lower,marbled,margin,mature,mauve,midrib,minute,mm,nflorescence,oblong,occasionally,often,ovary,pedice,pedicel,pedicellate,peduncle,pentagonal,petal,pinnatisect,plant,plurifoliat,pore,poricidal,projecting,purple,rarely,readily,recurve,rh,ripe,ripening,rotate,rounded,rugose-ruminate,ruit,seed,sessile,several,shallow,shed,short,shrub,simple,sinus,slightly,slit,small,soft,sometimes,specimen,stigma,stone,stonrgly,stout,style,succulent,surface,tinged,tip,tissue,toward,translucent,triangular,tub,ud,unit,usually,variable,vigorous,violet,well,without,wooded,x,year,ympodial	
452	wfo-0001031252	success	170	120	66	104	54	0.388	0.2-1.5,1-2,7-18,absent,along,anther,apex,arranged,attenuate,axillary,base,bead,berry,bud,cell,ciliate,cm,coriaceous,corolla,cuneate,dark,deep,distal,entire,filament,forked,fruit,glabrous,globose,green,half,herb,high,homostylous,interjected,lanceolate,leaflet,like,long,lower,margin,medium,mm,moniliform,multiple,necklace,pedicel,petiole,plurifoliate,pore,poricidal,purple,ripe,rotate,serrate,simple,sometimes,stolon,stripe,subtending,terminal,tri-,tuber,typically,unit,white	0.3-1.1,0.4-3,1-3,1.3-1.9,1.75-5.2,12-20,16-33,2-3,2.5-7,2.8-3.6,3-10,3-5,3-6,5-17,5-8,5-9,5-merou,5.5-6.5,abaxially,acumen,acute,adaxiall,adaxially,ag,alyx,apart,apparently,articulated,axe,blade,brownish,capitat,clavate,condition,connivent,covering,diameter,digestion,dorsally,drying,eaf,edge,eed,elliptic,enzyme,erec,exceeding,flat,flower,folded,fresh,geminat,generally,glabrou,green-white,greenish,hair-like,hal,honeycomb-shaped,lateral,lengthening,light,linear,living,lobe,make,mottled,mucilaginous,nflorescence,orolla,ovate,ovoid,peduncle,perfect,plant,removed,rounded,ruit,seed,seudostipule,slit,spaced,specimen,stamen,stigma,straight,style,tall,tamen,tem,testal,thick,throughout,tip,tube,unwinged,usually,vary,wall,wet,whitish,x,yellow,ympodial	appressed,articulation,bract,branching,breeding,broad-based,calyx,colour,connective,form,fruiting,geminate,growth,hair,heteromorphism,inflated,inflorescence,insertion,interpetalar,leaf,length,marking,mature,modification,needle-like,null,odour,orientation,paired,pattern,placement,position,prickle,pseudostipule,rhizome,scale,shape,smell,spot,staman,stem,stone,structure,surface,symmetry,sympodial,system,texture,tissue,trichome,type,vegetative,xylopodia,zygomorphy
453	wfo-0001031257	exception_thrown	206	0	0	206	0	0.0		-12,-22.5,-5,-6,0,0.4,0.5,0.5-0.8,0.7-1,0.75-2.5,1-1.2,1-1.3,1.1-1.2,1.5,1.5-1.7,1.5-2,1/10,10-16,11.5-15,2-,2-4.5,3,3.5-,3.5-5.7,4-10,4-4.5,4.5-,5,5-,5-8.5,6-12,6-celled,7-,7.5-9,8,8-celled,abaxially,abundant,accrescen,acuminate,adaxially,ag,aggregate,anther,anthesi,antrorse,apex,ascending,attenuate,basal,base,berry,bicellular,blue-violet,branch,broad,bud,calyx,campanulate,cell,cm,coarsely,coat,connectival,corolla,cotyledon,cuneate,curved,cuticle,dark,deep,densely,dentate,diamete,diameter,difoliate,directed,dorsally,eaf,edentate,eed,ellipsoidal,elliptical,embryo,endosperm,epidermal,erect,filament,finely,flexuous,foliage,free,fruiting,geminat,glabrous,glandular,globose,hair-like,half,head,herb,herbaceous,high,hollow,honey-combed,inconspicuous,inserted,lamina,lateral,leaf,length,light,like,little,lobe,lon,long,long-stalked,longer,longitudinal,longitudinally,lower,many-seeded,margin,midvein,mm,narrowly,non-glandular,odorles,opening,orolla,outward,ovate,pair,papillate,patent,pericarp,petiole,pore,poricidal,portion,prolongation,pubescent,purple,rarely,reduced,ree,rest,ridged,ring,robust,ruit,saddle-shape,scarce,scarcely,secondary,seed,separated,serrate,short-stalked,shorter,shrub,simple,single-celled,sinus,slightly,slit,small,smooth,solitary,somewhat,spur-like,stalk,stem,stigma,stone,strand,striate,style,subglobose,tem,thecae,thickened,thickening,time,tip,tooth,trans-ovoidal,triangular,trichome,tube,unequal,unit,upward,vary,vein,ventrifixed,verrucate,viscid,viscid-pubescen,wall,white,within,x,yellow,ympodial	
454	wfo-0001031270	exception_thrown	234	0	0	234	0	0.0		+,.5,0.4-1.5,0.5-1,1,1-1.2,1-3,1-4,1.2-1.6,1.5,1.5-2,1/3,10,10-12,100,2-2.5,2-20,2-3,2-4,2-7,2.5-3,3-10,3-20,3-5,4-5,5,5-10,5-15,5-6,5-merous,6-17,6-50,7-12,8,9-10,>,abaxial,abaxially,accrescent,acute,adaxial,adaxiall,along,alyx,anther,anthesi,apart,apex,arme,articulated,associated,bark,basal,base,beginning,berry,bipinnatifid,blade,bright,brow,brown,c.,calyx,capitate,cell,celled,clavate,cm,colored,conical,connivent,consistently,curved,deeply,densely,depressed-spherical,diameter,differentiated,difoliate,directed,distal,eed,ellipti,elliptic,entire,equal,erect,few-rayed,filament,flower,free,frui,fruiting,geminat,glabrous,gland,glandular,glandular-pubescent,green,growth,heavily,herb,heterostylous,inflorescence,infructescence,investing,later,lateral,leaf,leaf-opposed,leafy,length,like,live,lobe,lobed,lon,long,long-styled,longer,loosely,lower,margin,membranous,midpoint,midvein,minute,minutely,mixture,mm,multangulate,multiseriate,narrowly,new,nflorescence,obovate,occasionally,often,older,orolla,oung,outline,ovoid,pair,pale,papillo,pedicel,peduncle,per,pericarp,petiole,pinnatifid,pitted,plant,pore,poricidal,portion,prickle,prickly,primary,pubescent,rachi,ray,red,reddish,reflexed,reniform,rest,ripe,rounded,ruit,scar,scattered,secondary,sessile,shallow,shallowly,shining,short-stalked,short-styled,shrub,simple,single,sinuate,size,slender,slightly,small,sparsely,spherical,spreading,stalk,staminat,stellate,stem,stigma,straight,straw-colored,strongly,style,surface,tall,tamen,tan,tapering,terete,testal,thin,thus,tightly,tip,tissue,trichome,truncate,tube,uniseriate,unit,upward,usually,vary,varying,vein,way,well,white,wice,wid,wide,wing,woody,yellow,yellowish,ympodial,Â½	
455	wfo-0001031283	success	52	70	6	46	64	0.115	apex,base,calyx,cell,fruit,surface	-0.25,.7-2.3,0.1-0.15,0.4-0.5,0.5-0.7,0.7,2.2-2.8,30-40,acute,appearance,brown,cm,diameter,eed,elongating,erect,fide,give,hair-like,lateral,lo,lobe,long,markedly,mm,moore,narrowly,obovate,outgrowth,pale,pleasant,pubescent,shrub,silky,small,smelling,somewhat,sprawling,spreadin,tall,testa,thick,wall,wide,winged,woody	anther,appressed,articulation,bract,branching,breeding,broad-based,colour,connective,corolla,filament,form,fruiting,growth,hair,heteromorphism,inflated,inflorescence,insertion,interjected,interpetalar,leaf,leaflet,length,lower,margin,marking,mature,modification,needle-like,none,odour,orientation,paired,pattern,pedicel,petiole,placement,pore,position,prickle,pseudostipule,rhizome,scale,shape,smell,spot,staman,stellate,stem,stone,structure,symmetry,sympodial,system,texture,tissue,trichome,tuber,type,unit,vegetative,xylopodia,zygomorphy
456	wfo-0001031287	exception_thrown	147	0	0	147	0	0.0		.5,0.5-1.5,0.9-1,1,1-1.2,1-1.3,1-1.5,1-5,1.5-2,1.5-5.5,2-2.5,3-4,3-5,4-5,4-6,4.5-5,5-14,6-10-flowered,6-7,abaxially,acute,adaxially,anther,anthesi,apar,ape,apex,attenuate,axil,bark,base,bearing,berry,bi-lobed,branch,calyx,cm,conical,connective,coriaceous,corolla,dark,deflexed,deltate,dendritic,densely,dia,difoliate,divergently,eaf,edicel,eed,ellipsoid,elliptic,elongate,enlarged,erect,exserted,filament,fleshy,free,frui,fruiting,geminate,glabrous,globose,green,greenish-white,internodal,knob,lamina,later,lateral,leaf,lobe,lobed,lon,long,lower,main,many,margin,membranous,middle,minutely,mm,nearly,nflorescence,occasionally,older,onto,ovary,ovoid-reniform,pair,pale,papillo,papillose,pedicel,petiole,pitted,planar,plurifoliate,pointed,pore,poricidal,portion,pubescent,red-papillose,reddish-brow,reflexed,rounded,ruit,scar,shaped,shoot,short,shrub,simple,sinus,small,somewhat,spaced,stem,stigma,strongly,style,surface,tan,tear-drop,thick,thin,tip,trichome,tub,tube,tuft,ud,unevenly,unit,vein,white,widest,winged,woody,x,ympodial,young	
457	wfo-0001031300	exception_thrown	219	0	0	219	0	0.0		-2.2,-4,-5,-6,.5,/4,0-15,0-20,0-3,0-8,0.1,0.1-0.5,0.1-0.6,0.15-0.7,0.2-0.4,0.2-0.5,0.2-0.7,0.2-1,0.3,0.3-0.6,0.3-1.3,0.5-0.9,0.5-1.5,0.5-18,0.5-2,0.6-0.8,0.6-1,0.6-1.2,0.7-0.9,0.7-1.2,0.8-1.5,1-2,1-4,1-5,1.2-1.7,1.3-2,1.5-3.5,1/2-3/4,1/3-1/2,1/6-1/4,10-30,2-,2-3,2-4,2-5.5,2-6,2.2-2.3,2.2-2.7,2.5-3.2,3-,3-4,4,4.5-6,5-15,5-merous,6-8,abaxially,absent,acute,also,alyx,anther,apar,apart,apex,apically,apparently,articulated,attenuate,ba,bark,base,berry,blade,branched,brow,brown-green,bulbous,calyx,caudat,cell,chartaceous,cm,concolorous,connivent,creeping,curved,deltate,densely,diameter,difoliate,distance,drying,dull,eaf,eed,elongating,equal,erect,extending,eye,filament,filiform,flattened,flattened-reniform,flower,free,fruit,fruiting,geminat,geniculate,glabrescent,glabrous,gray-green,hair,herbaceous,highly,infructescence,lateral,leaf,length,lobe,lobed,lon,long,longer,lower,margin,mature,maturity,membranous,midpoint,midvein,minute,mm,moderately,naked,near,nflorescence,oblanceolate,oblong,obtuse,older,one,open,orange,orange-brown,orange-green,orolla,oung,outline,pair,pale,pedicel,peduncle,pendulous,per,perfec,pericarp,petiole,pit,poricidal,porrect,portion,prickl,prickle,prickly,primary,pubescent,raised,rarely,ray,red,reduced,rounded,ruit,scar,sessile,shrub,side,simple,small,smooth,spaced,sparsely,spherical,spreading,stalk,stalked,stellate,stellate-pubescent,stem,style,surface,tamen,tapering,terete,tertiary,thin,time,tip,trichome,tube,uniradiate,unit,vary,vein,venation,visible,way,weakly,white,wide,wider,winged,yellow,yellow-green,yellow-orange,ympodial	
458	wfo-0001031310	exception_thrown	203	0	0	203	0	0.0		.5,0-3,0-4,0.5-3,1-10,1-2,1-3,1-5.5,1-6,1.5-4,15-40,2-3,2.5-5.5,2.5-8.5,3-10,4-10,4-12,4.5-4.8,5-6,5-7,5-merou,5.5-21,6-7,abaxially,absent,acumen,acuminate,adaxially,ag,along,alyx,anther,apart,apex,apparently,articulated,attenuate,axe,axillary,base,berry,blade,blue,blue-purple,borne,broadly,brown,brownish,bud,caly,cell,chartaceous,ciliate,cm,condition,connivent,conspicuously,corolla,covering,cuneate,decreasing,decurrent,diameter,digestion,distal,dorsally,drying,eaf,edge,eed,elliptic,end,enzyme,erect-decumben,especially,exceeding,extremely,filament,flat,flower,folded,forked,fresh,fruit,geminat,generally,glabrou,glabrous,globose,gradually,green,green-white,greenish,hair,hair-like,half,herb,high,homostylous,honeycomb-shaped,interjected,lanceolate,larger,lateral,leaf,leaflet,lengthening,less,light,like,living,lobe,long,lower,make,margin,membranous,midrib,minutely,mm,mottled,mucilaginous,multicellular,narrowly,nflorescence,obtuse,odd-pinnate,orolla,ovate,ovate-elliptic,ovate-lanceolate,ovoid,pair,pale,pedicel,peduncle,perfect,petiole,petiolule,pilose,plant,plurifoliate,pointed,pore,poricidal,puberulent,pubescent,purple,rachi,removed,rosette-forming,rotate,ruit,seed,seudostipule,shortly,simple,singly,size,slightly,slit,small,sometimes,somewhat,spaced,sparsely,specimen,stamen,ste,stem,stigma,stolo,straight,streak,style,subellipsoi,subrosette-forming,subtending,tall,tamen,tem,terminal,testal,thick,throughout,tip,tissue,toward,tri-,tube,tuber,typically,unit,unwinged,usually,vary,wall,wet,white,whitish,x,yellow,ympodial	
459	wfo-0001031316	success	207	108	56	151	52	0.271	0.5-2,1.5-2,1/3-1/2,5-8,acuminate,acute,anther,apex,base,becoming,berry,blade,blue-mauve,branched,bright,broad,calyx,cm,difoliate,entire,erect,filament,fruit,fruiting,glabrous,hair,lateral,leaf,length,long,lower,margin,marking,mature,membranous,mm,obtuse,orange,pedicel,petiole,poricidal,purple,reflexed,shrub,simple,spherical,stellate,stellate-pubescent,stem,surface,terminal,tip,trichome,unarmed,unequal,unit	-2,.1,/3,0.05-0.1,0.05-0.15,0.1-0.2,0.3-1,0.4-0.6,0.4-0.8,0.6-1,0.8-1.2,0.8-1.8,0.9-1.3,1-5,1.2-2.1,1.3-3.5,1.5-,1.5-3.5,1.5-5,1/3-2/3,2-20,2-3,2-4,2.5-8,3-10,3-8,3.5-3.8,3.8-5,4,4-7,4-9,5-10,5-15,5-6,5-merous,6-20,8-11,8-12,8-25,abaxial,abaxially,adaxial,almost,alyx,ame,apar,apically,apparently,articulated,bark,c.,colored,concolorous,connivent,contrast,cream,curved,dark,densely,diameter,discolorous,drying,dull,eaf,eed,elongating,eye,fifth,flattened-reniform,flower,foliaceou,four,free,geminat,glabrescent,glabrou,gray,green,held,herbaceous,infructescence,inward,lobe,lobed,long-acuminat,longer,lowermost,maturity,midpoint,minute,moderately,multangulate,naked,narrow-deltate,nflorescence,older,one,open,orange-brown,orolla,oung,ovate,pair,pale,peduncle,pendulous,per,perfec,pericarp,porrect,portion,primary,ray,red-brow,red-brown,ruit,scar,sessile,slender,smooth,sometimes,spaced,sparsely,spreading,stalk,stalked,stellate-pubescen,strongly,style,tamen,tapering,terete,tertiary,time,tube,unarme,usually,variously,vary,vein,venation,visible,way,white,white-green,whitish,wide,yellow,yellow-green,ympodial,young	appressed,articulation,bract,branching,breeding,broad-based,cell,colour,connective,corolla,foliaceous,form,geminate,growth,heteromorphism,inflated,inflorescence,insertion,interjected,interpetalar,leaflet,mentioned,modification,needle-like,odour,orientation,paired,pattern,perfect,placement,pore,position,prickle,pseudostipule,rhizome,scale,shape,smell,spot,staman,stone,structure,symmetry,sympodial,system,texture,tissue,tuber,type,vegetative,xylopodia,zygomorphy
460	wfo-0001031333	exception_thrown	194	0	0	194	0	0.0		+,.5,0.1-0.5,0.5,1-1.5,1-4,1-5,1.2-2,1.5,1.5-1.7,1.5-2,1/2,2,2-3,2.5-3,2.7-7,3-4,3/4,30-40,5-7,5-8,5-merou,50,7-10,7-9,<,>,?,abaxially,acuminate,acute,adaxiall,adaxially,adjacent,ag,almost,alyx,anther,anthesi,apart,apex,appearing,ark,articulated,base,berry,bilobed,branche,branched,broadly,brown,calyx,capitate,cell,clustered,cm,collection,composed,conical,crea,cupped,densely,denser,diameter,eaf,eed,ellipsoidal,elliptic,entire,exserted,filament,flattened,flower,free,fruting,glabrescen,glabrescent,glabrous,globose,golden,green,greenish,growth,half,high,ilament,immature,inflorescence,lamina,leaving,lengthening,less,like,lobe,lobed,long,lower,m.,many,margin,matte,membranous,mere,minute,minutely,mm,narrowly,near,new,nflorescence,nodding,occasionally,older,orolla,outline,ovate,pair,pale,papillat,pedicel,peduncle,peg,penden,pentagonal,per,perfect,pericarp,petiole,pitted,planar,plurifoliat,pore,poricidal,portion,primary,pubescent,pubescent-papillate,quadrate,reniform,rest,rhachi,ruit,scar,simple,sinus,slightly,slit,small,somewhat,soon,sparsely,splitting,ste,stellate,stem,stigma,striped,strongly,style,surface,tangled,tem,terminal,testal,thickened,thin,time,tip,trailing,triangular,trichome,truncate,tube,twining,ud,undersurface,undulation,unequal,unevenly,uniseriate,unit,upper,vary,vein,venation,vine,way,white,whitish,woody,x,yellow,yellowish,ympodial	
461	wfo-0001031333	exception_thrown	194	0	0	194	0	0.0		+,.5,0.1-0.5,0.5,1-1.5,1-4,1-5,1-5-2,1.5,1.5-1.7,1.5-2,1/2,2,2-3,2.5-3,2.7-7,3,3-4,3/4,30-40,5-7,5-8,5-merou,50,7-10,7-9,<,>,?,abaxially,acuminate,acute,adaxiall,adaxially,adjacent,ag,almost,alyx,anther,anthesi,apart,apex,appearing,articulated,bark,base,berry,bilobed,branche,branched,broadly,brown,calyx,capitate,cell,clustered,cm,composed,conical,corolla,cream,cupped,densely,denser,diameter,eaf,eed,ellipsoid,elliptic,entire,exserted,filament,flattened,flower,free,fruiting,glabrescen,glabrescent,glabrous,globose,golden,green,greenish,growth,half,high,ilament,immature,inflorescence,lamina,leaving,lengthening,less,like,lobe,lobed,long,lower,m.,many,margin,matte,membranous,mere,minute,minutely,mm,narrowly,near,new,nflorescence,nodding,occasionally,older,orolla,outline,ovate,pair,pale,papillat,pedicel,peduncle,peg,penden,per,perfect,pericarp,petiole,pitted,planar,plurifoliat,pore,poricidal,portion,primary,pubescent,pubescent-papillate,quadrate,reniform,rest,rhachi,rotate-stellate,ruit,scar,simple,sinus,slightly,slit,small,somewhat,soon,spaced,sparsely,splitting,stellate,stem,stigma,striped,strongly,style,surface,tangled,terminal,testal,thickened,thin,time,tip,trailing,triangular,trichome,truncate,tub,tube,twinin,ud,undersurface,undulation,unequal,unevenly,uniseriate,unit,upper,vary,vein,venation,vine,way,white,whitish,wide,woody,yellowish,ympodial	
462	wfo-0001031359	exception_thrown	166	0	0	166	0	0.0		.02,.25,.5,/4,0.5-1,0.5-6,0.75-1,1-4,1.1-1.6,1.2-1.6,1.2-2.5,1.3-1.6,1.5-2,1.6-2.8,1.9-2.3,12-21,2.5-3,3-3.5,3.6-8.8,5-30-flowered,5-7,5-angled,5.3-7.5,6-7,acuminate,angle,anther,anthesi,apart,apex,apiculate,appearing,attenuate,axil,ba,bark,base,beginning,beneath,berry,bi-lobed,broadly,brown,calyx,cm,corolla,curled,dark,deflexed,dia,differing,difoliate,distal,dried,dull,eaf,edicel,eed,elliptic,evenly,extending,filament,flattened-reniform,free,fruiting,geminat,glabrous,globose,green,incrassate,inflorescenc,internodal,interpetalar,lamina,lateral,leaf,live,lobe,lobed,lon,long,lower,main,major,margin,membraneous,middle,minor,minutely,mm,narrowly,near,nearly,nflorescence,obovoid,occasionally,often,older,one,opposite,originating,outline,ovary,pair,paler,papillae,papillo,papillose,pedicel,petiole,pit,pitted,planar,plant,pore,poricidal,portion,reflexed,ridged,ripe,round,ruit,rusty,scar,shaped,shiny,shrub,simple,sinus,size,slender,slightly,somewhat,spaced,specimen,stem,stigma,straight,strongly,style,surface,tall,tan,tapering,tear-drop,tip,triangular,trichome,tub,tube,tuft,ud,undulate,uniseriate,unit,vein,way,white,white-lenticellat,widest,woody,x,yellow,yellow-orange,ympodial,young	
463	wfo-0001031362	exception_thrown	138	0	0	138	0	0.0		.2,.3,.5,0.4-0.5,0.5-1,0.7-1,1-1.1,1-1.5,1-3,1-3-flowered,1-4,1.5-2,2-2.5,3-4,3-6,?,abaxially,acute,adaxially,along,anther,anthesi,apex,appearance,attenuate,bark,base,berry,branch,brown,bushy,calyx,cell,closely,cm,conical,corolla,dendritic,densely,denser,dia,eaf,edicel,eed,ellipsoid,erect,exceeding,exserted,filament,flattened,flattened-reniform,free,fruiting,giving,glabrous,globose,golden,golden-brow,incrassate,inflorescenc,internodal,lamina,lanceolate,lateral,leaf,like,lobe,lobed,lon,long,long-triangular,lower,main,margin,middle,minutely,mm,nearly,nflorescence,nodding,older,opposite,orange-red,outline,ovary,overlappin,packed,pair,pale,papillo,papillose,pedicel,pericarp,petiole,pitted,planar,plurifoliat,pore,poricidal,portion,pubescent,pubesent,rectangular,red,rest,rounded,ruit,scar,shaped,shiny,shrub,simple,slender,small-capitate,somewhat,spaced,sparsely,stem,stigma,straight,style,subshrub,surface,tan,tear-drop,thin,tip,trichome,tube,ud,unit,vein,white,widest,woody,x,ympodial,young	
464	wfo-0001031400	exception_thrown	161	0	0	161	0	0.0		-3,0.25-0.8,0.4-1.7,0.6-1.8,0.7-6,0.8-1.1,1,1-,1-4,1.2-2,1.5-5,10-11,2,2-3,2-5,2-9,3-6-foliat,4-,4-13,4-17,4-6.5,4-7,5-12.5,6-23,7-25,7-28,abaxial,abaxially,abruptly,absen,acumen,acute,adaxially,apex,apical,apically,apiculate,articulate,base,branched,calyx,cell,cm,connate,corolla,covering,cuneate,cyme,dark,decurrent,deeply,dehiscent,diameter,dichasial,dichasially,digestion,diminishing,distal,dorsally,eaf,ebracteate,edge,eed,emoval,enzyme,exceeding,filament,flat,flower,folded,forked,forming,generally,globo,globose,green,green-white,hair-like,half,herbaceous,honeycomb,interjected,introrse,lateral,leaf,leaflet,linear,linear-lanceolate,living,lobe,lon,long,lower,lunat,make,maturing,mm,monochasial,mucilaginous,nflorescence,nther,oblique,oblong,occasionally,odd-pinnate,often,orolla,ovoid,pair,pattern,pedicel,peduncle,perennial,perfect,petiole,plan,plant,poricidally,proximal,puberulent,rachi,reveal,ruit,seed,sessile,seudostipule,short,side,size,slit,specimen,stamen,stellate,stigma,straight,stripe,structure,style,subglabrous,tal,tem,terminal,testal,thick,throughout,tip,tone,toward,trilobe,tuber-bearing,typically,unit,vary,violet,wall,white,wide,without,yellow,ympodial,Â¼	
465	wfo-0001031401	exception_thrown	182	0	0	182	0	0.0		0.5,0.6-1.2,0.8-1.2,1,1-1.4,1-1.5,1-6,1.1-3,1.5-2,1/2,2-2.4,2-5,2.5-4,3,3.5-4,3/4,5,5-7,5-9,7-9,8-10,abaxial,abaxially,acute,adaxial,adaxially,age,along,anther,anthesi,apex,apical,appearing,attenuate,axi,bark,basal,base,becoming,berry,bi-lobed,black,blade,branch,branching,brown,calyx,clearly,cm,conical,corolla,dark,deciduous,deflexed,deltoid,dendritic,densely,denser,diameter,dichasial,differentiated,drying,eaf,ecuador,ecuadorian,edicel,eed,elliptic,ew,exserted,filament,finely,flattened,flower,fork,free,fruit,fruiting,glabrous,globose,golden,golden-yellow,growth,impressed,inserted,lateral,leaf,lenticular,less,lobe,lobed,long,long-triangular,lower,m.,matted,mesophyll,minutely,mm,monochasia,narrowly,near,new,nflorescence,noddin,nodding,node,occasionally,often,older,outline,ovary,overtopping,pair,papillo,pedicel,per,pericarp,petiole,pitted,planar,plurifoliate,pore,poricidal,portion,prominently,puberulent,pubescen,pubescent,purplish-black,pyramidal,raised,reddish-brown,rounded,roundish,ruit,scar,secondary,shiny,shoot,short,shrub,sleev,slit-like,small,sometimes,somewhat,sparsely,specimen,stamen,ste,stem,stigma,strongly,style,surface,tall,tapering,terminal,thin,time,tip,tree,tree-like,trichome,tub,tube,ud,unit,usually,vein,violet,visible,way,white,wide,winged,woody,x,yellow,ympodial,young	
466	wfo-0001031480	success	237	153	102	135	51	0.43	/3,0-1,0-2,0.1-0.3,0.1-0.4,0.4-0.8,0.5-,0.5-2,0.7,1-2,1/2,1/6-1/5,3-10,5-8,6-8,7-8,andromonoecious,anther,apart,apex,base,berry,blade,branched,branching,bright,calyx,cell,cm,cuneate,curved,densely,difoliate,ellipsoid,elongate,elongating,entire,erect,filament,flattened,fruit,fruiting,glabrous,glandular,hair,heterostylous,inconspicuous,lateral,leaf,length,lobe,lobed,long,lower,margin,marking,mature,mauve,midpoint,mm,often,pale,pedicel,petiole,poricidal,porrect,prickle,pubescent,purple,ray,red,red-brown,scandent,shallowly,shorter,shrub,simple,slightly,spaced,sparsely,spherical,spreading,stalk,stalked,stellate,stellate-pubescent,stem,straight,surface,tapering,terminal,thick-chartaceous,tip,trichome,truncate,unarmed,unit,variously,way,weakly,wide,young	-0.25,-2,0,0-0.5,0-30,0-5,0.1,0.15-0.3,0.2-0.35,0.4,0.6-0.8,0.8,0.8-1,1-1.3,1-1.5,1-3,1-4,1.5-2.2,1.7-2.2,1.8-3,1/3,1/4,2-,2-2.7,2-3,2-5,2-6,3,3-6,3-7,3.5-7,4-5,4-6,5-merous,6-13,6-30,8-12,abaxial,abaxially,acuminat,acute,adaxial,alyx,apar,apically,apparently,articulated,ba,bark,broad-deltate,cream,dark,deltate,diameter,discolorous,distal,distance,drying,dull,eaf,eed,equal,extending,eye,faint,flattened-reniform,flower,free,geminat,glabrescent,green,hermaphrodite,infructescence,long-styled,longer,lowermost,maturity,midvein,minutely,moderately,naked,near,nflorescence,obtuse,older,one,open,orange-brown,orolla,oung,outline,ovate,pair,peduncle,pendulous,per,pericarp,persistent,pit,plant,portion,prickly,primary,raised,red-brow,red-green,red-yellow-green,reduced,reticulate,rounded,ruit,scar,sessile,short-styled,side,slender,small,smooth,somewhat,staminat,style,tamen,terete,tertiary,time,tube,unarme,upper,vary,vein,venation,visible,woody,yellow,ympodial	actinomorphic,appressed,articulation,bract,breeding,broad-based,colour,connective,corolla,form,geminate,growth,heteromorphism,inflated,inflorescence,insertion,interjected,interpetalar,leaflet,modification,needle-like,none,odour,orientation,paired,pattern,placement,pore,position,present,pseudostipule,rhizome,scale,shape,smell,spot,staman,stone,structure,symmetric,symmetry,sympodial,system,texture,tissue,tuber,type,unmodified,vegetative,xylopodia,zygomorphy
467	wfo-0001031483	success	154	124	69	85	55	0.448	1.1-2.5,1/3,2-3,2.5-3.2,7-10,acuminate,acute,almost,anther,apart,apex,attenuate,base,beneath,berry,blade,calyx,cm,corky,corolla,decurrent,difoliate,distal,evenly,filament,filiform,fruiting,fusiform,glabrous,green,indistinct,lateral,leaf,linear,lower,main,minor,mm,oblanceolate,oblong,obovate,obovoid,opposite,orbiculate,pair,pale,pedicel,petiole,pore,prominent,raised,rounded,shape,shrub,simple,slender,slightly,spaced,stem,subshrub,tan,tapering,tear-drop,turbinate,unit,vein,white,widest,x	.5,/2,0,0.5,0.5-2,1,1-2,1.2-1.4,1.7-5.5,11-20.5,2-2.5,3-4,3-8-flowered,6-10,across,anew,anthesi,ba,bearing,beginning,ca,caly,clavate,continuous,cork,deflexed,deltoid,dia,dry,eaf,edicel,eed,end,exserted,flower,free,fresh,geminat,indistinc,internode,larger,lea,lenticellate,less,lobe,lobed,long,major,markedly,minutely,nflorescence,often,ovary,ovoid-reniform,paler,papillo,papillose,per,planar,pointed,poricidal,portion,quite,ruit,scar,shaped,short,short-triangular,somewhat,soon,stigma,straight,strongly,style,tall,third,tip,tube,ud,variable,way,wing,winged,woody,ympodial	appressed,articulation,bract,branching,breeding,broad-based,cell,colour,connective,form,fruit,geminate,growth,hair,heteromorphism,inflated,inflorescence,insertion,interjected,interpetalar,leaflet,length,margin,marking,mature,modification,needle-like,null,odour,orientation,paired,pattern,placement,position,prickle,pseudostipule,rhizome,scale,smell,spot,staman,stone,structure,surface,symmetry,sympodial,system,texture,tissue,trichome,tuber,type,vegetative,xylopodia,zygomorphy
468	wfo-0001031492	exception_thrown	175	0	0	175	0	0.0		.5,/4,0.5,0.7-1.3,0.9-1.1,08,1-1.3,1-1.5,1.3-2,1.5-1.8,1.5-2.5,10-15,2-10,2-3,2-5,20,3-4,3-5,4-10,4-4.5,6-8,8-11,8-9,abaxially,absent,acuminate,acute,adaxially,age,anther,anthesi,apex,apical,appearing,attenuate,axe,ba,bark,basal,base,becoming,beneath,berry,bi-lobed,bitter,branching,calyx,cm,conical,corolla,dark,dbh,deciduous,decurrent,deltoid,dendritic,densely,denser,diameter,distinguishable,drying,dull,eaf,echinoid,edicel,eed,elliptic,erect,ew,exserted,filament,flattened,flower,free,fruit,fruiting,glabrous,globose,golden,grey,growth,inserted,juice,lamina,lateral,leaf,lenticular,lightly,lobe,lobed,long,lower,m.,medium,minutely,mm,monochasia,narrowly,nflorescence,nodding,occasionally,older,ovary,overtopping,pair,papillo,pedicel,per,pericarp,petiole,pitted,planar,plurifoliate,pore,poricidal,portion,predominantly,prominent,pubescent,purplish-black,pyramidal,rather,reddish-brown,remaining,ruit,scar,scarcely,scattered,secondary,shiny,shoot,short,shrub,size,sleeve,slightly,slit-like,sometimes,somewhat,sparsely,stamen,ste,stem,sticky,stigma,strongly,style,sunken,surface,tall,tapering,terminal,thin,time,tip,tree,tree-like,trichome,tub,tube,ud,undersurface,unit,upper,upturned,vein,violet,way,wide,winged,woody,x,ympodial,young,younger	
469	wfo-0001031503	success	142	132	72	70	60	0.507	-10,-25,-6,-7,0.3-3,0.5-4,1-,1-2.5,1.5-7,1.7-3.5,3-15,5613,6-7,abaxially,adaxially,apex,articulated,base,blade,branched,calyx,cell,chartaceous,cm,connivent,cuneate,curled,decurrent,densely,directed,distally,eglandular,elliptic,entire,fide,flower,forked,globose,hair,lanceolate,long,lower,margin,mm,moderately,orange,ovate,pedicel,perfect,petiole,pore,present,pubescent,rarely,reddish,ripe,rounded,shrub,simple,slightly,stellate,stone,time,truncate,unbranched,uniseriate,unit,vein,venturi,white,wide,x	-15,-30,0.5-1,1-3,1-5,1-7,1.5-2,1.5-3,1.5-8,10-19,2-3,2.5-10,3-4,3-5,3-6,6-many-foliat,7-10,7-15,abruptly,absen,acuminate,acute,aggregate,angled,apart,axe,ba,cylindrical,deltate,diameter,distall,eaf,eed,except,glabrous,gland,lobe,mostly,narrowed,narrowly,nflorescence,nther,obtuse,occasionally,often,orolla,peduncle,puberulent,rachi,radiu,rugose-pubescent,ruit,spaced,sparsely,stalked,stigma,style,subcapitat,subclavate,tal,tem,tip,toward,triangular,tube,unequal,usually,vary,yellow,ympodial	6-many-foliate,absent,anther,appressed,articulation,bract,branching,breeding,broad-based,colour,connective,corolla,filament,form,fruit,fruiting,growth,heteromorphism,inflated,inflorescence,insertion,interjected,interpetalar,leaf,leaflet,length,marking,mature,mentioned,modification,needle-like,odour,orientation,paired,pattern,placement,position,prickle,pseudostipule,rhizome,scale,shape,smell,spot,staman,stem,structure,surface,symmetry,sympodial,system,tall,texture,tissue,trichome,tuber,type,vegetative,xylopodia,zygomorphy
470	wfo-0001031586	exception_thrown	167	0	0	167	0	0.0		-2,.25,0.1-1,0.5-0.8,0.5-1,1,1-1.2,1-1.5,1-2,1.3-5,1.4-2.5,1.5-2,2,2-2.5,3-11,5-10,5-6,7-10-flowered,abrupt,absent,acute,anther,anthesi,apart,apex,apparently,appearing,attenuate,bark,base,becoming,beneath,borne,branch,bright,broadly,bud,calyx,campanulate,capitate,closer,cm,completely,conical,corolla,cream-colored,cucullate,deflexed,deltate,dia,differing,difoliate,distance,drying,eaf,edicel,eed,ellipsoid,elliptic,exerted,exfoliatin,filament,fleshy,flower,free,fresh,geminate,glabrous,globose,gree,green,greenish,inflorescenc,inflorescence,know,known,later,lateral,leaf,leave,lobe,lobed,long,lower,main,major,margin,material,may,minor,minutely,mm,mucro,near,nearly,new,nflorescence,notched,occasionally,older,olive,one,onto,open,opposite,ovary,overtopping,pair,pale,paler,papillate,papillose,pedicel,petiole,planar,pore,poricidal,portion,present,prominent,raised,remaining,ridged,rounded,ruit,scar,shap,shaped,shin,shiny,shrub,simple,size,slender,small,sometimes,somewhat,soon,spaced,sparsely,stem,stigma,straight,style,surface,swollen,tall,tapering,tear-drop,thick,thickened,tip,trichome,truncate,trunk,tube,ud,uniseriate,unit,vein,white,widely,x,yellow,yellowish,ympodial,young	
471	wfo-0001031587	exception_thrown	142	0	0	142	0	0.0		.5,0.8-1,1-1.5,1.5-2,1.7-2,10-15,12-16,17-30,2,2-2.5,2-9-celled,2/3,3-4,5,6-7,6-8,7-9,abaxially,acute,adaxially,along,anther,anthesi,apart,apex,attenuate,axi,bark,base,bi-lobed,broadly,calyx,clavate,closely,cm,cone,conical,corolla,decurrent,deflexed,deltate,dendritic,densely,denser,dia,differing,drying,eaf,edicel,eed,elliptic,elliptic-ovoid,erect,evenly,exserted,fide,filament,fleshy,free,furcate,glabrous,globose,golden-red,included,inflorescence,irregular,know,known,lamina,later,lateral,leaf,like,lobe,lobed,long,loose,lower,lowered,main,major,middle,minor,minutely,mm,mostly,oblique,ocasionally,occasional,older,ovary,overlappin,pair,pale,papillate,papillo,parallel,pedicel,perpendicular,persisten,petiole,pore,poricidal,portion,pubescent,rarely,rect,reddish-grey,rest,ruit,scar,shape,shaped,simple,size,soft,somewhat,spaced,steinbach,stem,stigma,style,surface,tall,tear-drop,thick,thickened,tip,tree,trichome,tub,tube,ud,uniseriate,vein,verrucose,way,white,widest,winged,x,young	
472	wfo-0001031589	exception_thrown	222	0	0	222	0	0.0		-0.5,-15,-6,-6.5,.5,/6,0,0-1,0-10,0-3,0-30,0.1,0.1-0.5,0.15-0.3,0.2-0.4,0.2-0.5,0.2-3,0.4,0.5-1,0.55-0.7,0.6-1.2,0.7,0.8-2.3,0.9-1.3,0.9-1.6,1,1-1.8,1-5,1.2-1.5,1.5-5,1.7-2.5,1.8-2.9,1/3,1/3-1/2,1/3-1/4,10-30,2-,2-10,2-3.5,2.5-4.5,2.5-6,2.8-4,3-4,3-5,3/4,4-6.5,4/5,5-8,5-merous,6-8,8-14,8-30,abaxially,acute,alyx,ame,anther,apart,apex,apically,apparently,articulated,attenuate,bark,base,berry,blade,bright,broadly,brow,brown-green,c.,calyx,caudat,cell,chartaceous,cm,concolorous,connivent,cream,dark,deltate,densely,density,diameter,difoliate,discolorous,distance,drying,dull,eed,elliptic,elongating,equal,erect,extending,eye,filament,flattened-reniform,flower,free,fruit,fruiting,geminat,glabrescent,glabrous,gray-green,green,higher,infructescence,lateral,leaf,lengt,length,lobe,lobed,lon,long,long-obovate,longer,lower,margin,marking,mature,maturity,mauve,membranous,midpoint,midvein,mm,moderately,multangulate,naked,narrow,narrow-cuneate,nflorescence,oblong,obovate,occasionally,often,older,orange-brown,orange-green,orolla,oung,outline,pair,pale,part,pedicel,pendulous,per,perfec,pericarp,petiole,pit,plant,poricidal,porrect,portion,prickl,prickle,prickly,primary,raised,ray,reflexed,rounded,ruit,scandent,sessile,shiny,shorter,shrub,side,simple,small,smooth,solitary,sometimes,somewhat,spaced,sparsely,spherical,spreading,stalk,stalked,stellate,stellate-pubescent,stem,stout,straight,style,subentire,subsessile,surface,tamen,tapering,terete,tertiary,time,tip,trichome,tube,unit,upper,vary,vein,venation,visible,way,weakly,white,whole,wide,winged,woody,yellow,yellow-green,yellow-orange,ympodial,young	
473	wfo-0001031609	success	154	131	74	80	57	0.481	.5,/4,0.5-1,1-10,1-6,1.5-2,2-,3-24,3-5,3-9-lobed,4.5-60,5/6,abaxially,absent,adaxially,apex,base,blade,branch,brownish,calyx,campanulate,cell,cm,connective,connivent,cuneate,directed,distally,divided,elliptic,emerging,equal,exceeding,forked,fruit,glabrous,globose,green,inflorescence,laterally,leaf,lobed,lower,margin,midrib,minutely,mm,obovate,obtuse,occasionally,orange,pedicel,petiole,pinnately,point,pore,ripe,rounded,shrub,simple,sinus,small,stellate,stone,succulent,thecae,tree,two,unbranched,unit,unlobed,x,yellow	0-30,0.4-3,0.5-3,1.3-3,1.5-3,10-25,2,2-3,2.5-4,20-25,3-foliat,4,4-5,4-6,5-25,8-20,absen,acute,aggregate,ape,apiculate,around,articulated,axe,barely,beyond,bilobe,brow,conspicuous,contiguous,dark,deltate,dia,diameter,dilated,eaf,eed,ellipsoidal,elliptic-ovate,entire,exserted,flattened,fleshy,flower,glabrou,leaving,lobe,long,nearly,nflorescence,nther,obconical,orolla,papillose,pedicellar,peduncle,puberulent,rachi,radiu,reticulate,ruit,scar,shallowly,stamen,stigma,strongly,style,succulen,tal,tem,time,tip,tomento,triangular,truncate,tube,ud,vary,wide,ympodial	3-foliate,anther,appressed,articulation,bract,branching,breeding,broad-based,colour,corolla,filament,form,fruiting,growth,hair,heteromorphism,inflated,insertion,interjected,interpetalar,leaflet,length,marking,mature,mentioned,modification,needle-like,odour,orientation,paired,pattern,placement,position,prickle,pseudostipule,rhizome,scale,shape,smell,spot,staman,stem,structure,surface,symmetry,sympodial,system,tall,texture,tissue,tomentose,trichome,tuber,type,vegetative,xylopodia,zygomorphy
474	wfo-0001031615	exception_thrown	154	0	0	154	0	0.0		.5,0,0.5,0.5-1,0.8-1,0.9-1.1,1-1.6,1.3-1.8,1.5,1.5-5,11-15.5,2-3,2-4.2,3.8-6.1,4-6.5,5-20-flowered,5-6,6-8,8-10,acuminate,acute,anther,anthesi,apex,arising,attenuate,axil,ba,bark,base,becoming,berry,bilobed,brown,caly,calyx,capitate,closely,cm,corolla,dark,dark-papillo,decurrent,deep,deflexed,deltoid,dia,differing,difoliate,distal,eaf,edicel,eed,elliptic,expanded,exserted,filament,flattened-reniform,free,fruit,fruiting,furcate,geminat,glabrous,glandular,globose,green,impressed,incrassate,inflorescence,interpetalar,lamina,lateral,leaf,less,lobe,lobed,lon,long,lower,main,major,margin,maroo,middle,minor,minute,minutely,mm,nearly,nflorescence,occasionally,older,one,opposite,ovary,overlappin,packed,pair,paler,papillae,papillose,pedicel,per,petiole,pitted,pore,poricidal,portion,prominent,reflexed,ruit,scar,scarcely,shaped,shiny,shrub,simple,sinus,size,slender,slightly,small,somewhat,stem,stigma,straight,style,subumbellate,surface,tall,tapering,tear-drop,terminal,thickened,thin,tip,tree,trichome,tube,tuft,ud,unicellular,uniseriate,unit,urceolate,vein,white,widest,winged,woody,x,ympodial,young	
475	wfo-0001031618	success	184	164	111	73	53	0.603	-2,0.5-1.5,1-1.5,1-7,1.5-3.5,10-18,10-lobed,2-3,3,3-4,3-8,40-60,5-12,acute,anther,apex,appearance,appearing,axil,base,berry,beyond,bluntly,branch,calyx,cell,clonal,cm,conical,corolla,covering,cuneate,cut,cyme,darker,developed,elliptic,emarginate,enlarged,equal,erect,extending,facetted,filament,giving,glandular,greatly,green,growing,habit,hair,half,lanceolate,lasting,lavender-purple,leaf,lengthening,lobe,lobed,long,loosely,lower,marbled,mid-vein,midrib,mm,oblong,obovoid,occasional,often,ovate-lanceolate,ovoid,pale,pedicel,petal,petiole,pinatisect,point,pore,poricidal,purple,rarely,rotate,rounded,scorpioid,several,shallowly,shrub,simple,sinus,slit,soft-wooded,stem,stone,stout,stripe,surface,tapering,tinged,tip,tissue,triangular,unequal,unit,variable,way,well,x,year,young,younger	0-3,1.5-2,13,2-2.5,4-5,5,90-110,acuman,almost,also,anthesi,aspect,becoming,blunt,broadly,c.,capitate,cluster,column,dia,discoidal,eaf,eed,ellipsoid,except,exerted,finely,fleshy,floral,flower,fork,forked,frui,general,glabrous,gree,greyish,interacuminal,less,lon,maturity,mauve,may,minute,narrowly,nflorescence,occur,ovary,pal,pedicellate,peduncle,plurifoliat,reddish-brown,reticulate,rhachi,ripe,rugose,ruit,sessile,side,single,sometimes,somewhat,specimen,stigma,strongly,styl,succulent,terete,tub,ud,vigorous,ympodial	appressed,articulation,bract,branching,breeding,broad-based,colour,connective,form,fruit,fruiting,growth,heteromorphism,inflated,inflorescence,insertion,interjected,interpetalar,leaflet,length,margin,marking,mature,minimal,modification,needle-like,odour,orientation,paired,pattern,placement,plurifoliate,position,prickle,pseudostipule,rhizome,scale,shape,smell,specified,spot,staman,structure,symmetry,sympodial,system,texture,trichome,tuber,type,vegetative,xylopodia,zygomorphy
476	wfo-0001031646	exception_thrown	171	0	0	171	0	0.0		-7,-pinnate,.2,.5,0.2-0.8,0.5-2,0.8-1.5,1-1.8,1-10,1-6,1.2-2.5,1.5-3.5,1.5-4,15-25,18-38,1962,2-10,2-2.5,2-3,2.5-10,20,3.5-4,4-18,4-20,4-5,4-8,4-foliate,5,5-6,5-7,5-7.5,5-merou,7-8,8-15,abaxially,absen,absent,accrescent,acuminate,acut,acute,adaxially,aggregate,alyx,anther,apart,apex,apical,apparently,articulated,axe,ba,basally,base,berry,blade,blue,branched,brown,calyx,cell,chartaceous,ciliat,climbing,cm,connivent,correll,covered,cuneate,cylindrical,darker,decreasing,densely,diameter,directed,distall,eaf,eed,ellipsoidal,elliptic,elliptic-lanceolate,entire,equal,fide,filament,flattened,flower,fruit,fruiting,geminat,glabrous,glandular,globose,green,hair,high,highly,homostylous,hyaline,immature,interjected,lateral,leaf,leaflet,light,lobe,long,lower,margin,maroon,mature,mm,multicellular,nflorescence,oblique,obliquely,oblong,obtuse,orolla,ovate-lanceolat,ovate-lanceolate,part,pedicel,peduncle,perfect,petiole,petiolule,pore,present,pubescen,pubescence,pubescent,rachi,red,rotate-pentagonal,rounded,rugulose,ruit,scandent,seudostipule,shortly,shrub,simple,size,slightly,small,smooth,spaced,spreading,stem,stigma,stone,stout,style,surface,tamen,tawny,tem,tip,toward,tree,truncat,tube,uniseriate,unit,vary,vine,violet,x,yellow,ympodial	
477	wfo-0001031651	success	201	145	94	107	51	0.468	-2,-3.5,.1,.7,/3,/5,0.2-0.5,0.3-0.8,0.6-1.3,1,1.2-3,1/6-1/4,2-10,2-3,4-6,anther,apart,apex,apparently,base,berry,blade,branched,brown,calyx,cell,chartaceous,cm,concolorous,cordate,curved,densely,difoliate,discolorous,drying,elliptic,elongating,entire,equal,erect,filament,free,fruit,fruiting,glabrous,gray,herb,lateral,leaf,length,lobed,long,longer,lower,margin,mature,maturity,mm,obtuse,ovate,pedicel,petiole,poricidal,porrect,portion,prickle,prickly,purple,red,reflexed,rounded,scandent,shrub,simple,sometimes,spaced,spherical,stellate,stellate-pubescent,stem,subentire,surface,tapering,terminal,time,tip,trichome,tube,unarmed,unit,way,weakly,white,wide	-3,.6,0-20,0.1,0.1-0.15,0.1-0.2,0.1-0.25,0.15-0.2,0.3-0.5,0.3-1.5,0.6-1,0.7-1,1-1.7,1-2,1-4,1.2-2,1.3-1.6,1.5-2,1/5,2-3.5,2/3-3/,3-5,4-5,4.5-7,5-merous,abaxial,abaxially,absent,acuminat,acute,adaxial,alyx,ame,apar,apically,articulated,bark,c.,dark,deltate,diameter,dull,eaf,eed,eye,faint,filiform,flattened-reniform,flower,geminat,glabrescent,gra,herbaceous,infructescence,lanceolate,lobe,midpoint,naked,nflorescence,oblong,older,one,open,orange-brown,orolla,oung,outline,pair,peduncle,pendulous,per,perfec,pericarp,persistent,pit,prickl,primary,raised,ray,red-green,ruit,scar,shorter,small,smooth,spreading,stalk,stalked,straight,style,subsessile,tamen,terete,tertiary,thick,thick-stalked,toward,unarme,upper,variously,vary,vein,venation,visible,yellow,yellow-green,ympodial	appressed,articulation,bract,branching,breeding,broad-based,colour,connective,corolla,form,geminate,growth,hair,heteromorphism,inflated,inflorescence,insertion,interjected,interpetalar,leaflet,marking,mentioned,modification,needle-like,odour,orientation,paired,pattern,perfect,placement,pore,position,pseudostipule,rhizome,scale,shape,smell,spot,staman,stone,structure,symmetry,sympodial,system,texture,tissue,tuber,type,vegetative,xylopodia,zygomorphy
478	wfo-0001031656	exception_thrown	154	0	0	154	0	0.0		.5,/4,0.5,0.5-1,1-1.5,1-2,1-2.5,1.2-1.5,1.5-2,1.5-5,10-20,2.5-3.5,3-3.5,3-5,4-9,5-7,5-ribbed,6-8,acuminate,acute,also,anther,anthesi,apex,arising,ba,bark,base,berry,bright,calyx,capitate,closely,cm,cork,corolla,densely,dia,differing,difoliate,directly,drying,eaf,edicel,eed,ellipsoid,elliptic,enclosing,erect,extremely,filament,fleshy,flower,free,fruit,fruiting,geminat,glabrous,globose,green,greyish,hooded,known,lateral,leaf,live,lobe,lobed,lon,long,long-acuminate,lower,main,major,margin,matte,mature,middle,minor,minute,minutely,mm,nflorescence,node,oblique,often,older,one,opposite,ovary,ovate,pair,pale,paler,papillo,papillose,pedicel,peelin,persistent,petiole,planar,plant,pore,poricidal,portion,prominent,proximal,rather,red-papillose,reddish,reflexed,rib,ridged,rounded,ruit,scar,sessile,shaped,shiny,shrub,size,slightly,somewhat,spaced,specimen,stem,stigma,straight,strongly,style,surface,swollen,tall,tear-drop,terminal,thick,thickened,tip,top,transversely,tube,ud,unit,upper,vein,visible,way,white,wide,widest,woody,x,ympodial,young	
479	wfo-0001031667	success	153	132	75	78	57	0.49	1-1.5,1-4,2-3,2-5,5-9,abaxially,adaxially,apex,apical,base,branched,calyx,cell,cm,connate,cordate,corolla,covering,cuneate,cyme,dark,dehiscent,dichasial,dichasially,distal,ebracteate,filament,flower,forked,generally,globose,green,hair-like,half,herbaceous,honeycomb,interjected,introrse,irregularly,lateral,leaf,leaflet,lobed,long,lower,maturing,mm,monochasial,oblique,odd-pinnate,often,ovoid,pattern,pedicel,perennial,perfect,petiole,pilose,plant,poricidally,proximal,rounded,short,slit,spot,stellate,stripe,testal,thick,tuber-bearing,typically,unit,wall,white,Â¼	0.6-1,0.6-1.5,1.4-3,1.5-2,10-13,12-35,2-6,2.5-5,3-13,3-5,3-6-foliat,3-8,4-1.,5-15,6-10,8-13,8-15,abruptly,acumen,acuminate,acute,apically,apiculate,articulate,caudate,diameter,digestion,diminishing,dorsally,eaf,edge,eed,elliptic-lanceolate,emoval,enzyme,exceeding,flat,folded,globo,green-white,lanceolate,living,lobe,lon,lunat,make,mucilaginous,nflorescence,nther,oblong,orolla,pair,peduncle,petiolate,petiolule,plan,reveal,ruit,seed,sessile,seudostipule,size,specimen,stamen,stigma,straight,style,tal,tem,terminal,throughout,toward,vary,whit,wide,without,yellow,ympodial	3-6-foliate,4-10,anther,appressed,articulation,bract,branching,breeding,broad-based,colour,connective,form,fruit,fruiting,growth,hair,heteromorphism,inflated,inflorescence,insertion,interpetalar,length,lunate,margin,marking,mature,modification,needle-like,null,odour,orientation,paired,placement,pore,position,prickle,pseudostipule,rhizome,scale,shape,smell,staman,stem,stone,structure,surface,symmetry,sympodial,system,texture,tissue,trichome,tuber,type,vegetative,xylopodia,zygomorphy
480	wfo-0001031672	success	157	150	95	62	55	0.605	0-2,0.5,1,1-,1-2,1-5,1.5-2.5,1.5-5,2-28,3/4,4-34,4.5-5,4/5,9-lobed,abaxially,absent,acuminate,acute,adaxially,aggregate,apex,articulated,aublet,basal,base,blade,calyx,cell,chartaceous,cm,connective,cordate,densely,directed,distally,divided,entire,exceeding,fide,flower,fruit,glandular-puberulent,globose,green,greenish-brown,hair,leaf,leaving,lobe,lobed,long,lower,margin,mature,midrib,mm,moderately,narrowly,near,one,ovate,ovoid,pedicel,pedicellar,perfect,petiole,pilose,pinnately,pore,present,puberulent,purple,remant,represented,shorter,simple,sinus,slightly,small,sparsely,stellate,stone,subcoriaceous,thecae,time,tree,triangular,truncate,unbranched,unit,unlobed,whitish,wide,x,yellow	0,0.3-0.5,0.5-1,0.5-1.5,1-1.5,1-10,1.5-2,1.5-3.5,10-20,15-20,15-50,2-12,3-4-foliat,4,5-6,6,apart,ape,apiculate,axe,beyond,ciliat,cylindrical,diameter,eaf,eed,exserted,flattened,fleshy,glabrous,lanceolate,lon,membranaceous,nflorescence,nther,obtuse,occasionally,often,orolla,peduncle,pilo,presen,pubescent,rachi,radiu,rounded,ruit,spaced,stamen,stigma,style,tal,tem,tip,toward,truncat,tube,ud,vary,white,yello,ympodial	3-4-foliate,anther,appressed,articulation,bract,branching,breeding,broad-based,colour,corolla,filament,form,fruiting,growth,heteromorphism,inflated,inflorescence,insertion,interjected,interpetalar,leaflet,length,marking,modification,needle-like,null,odour,orientation,paired,pattern,placement,position,prickle,pseudostipule,rhizome,scale,shape,smell,spot,staman,stem,structure,surface,symmetry,sympodial,system,tall,texture,tissue,trichome,tuber,type,vegetative,xylopodia,zygomorphy
481	wfo-0001031684	exception_thrown	161	0	0	161	0	0.0		.25,.5,.75,/4,0.1,0.4-1.5,0.5-0.7,0.5-0.8,0.5-1,0.7-1,0.75-1,1-1.2,1-5,10-100,2,2-9,3-3.5,3-30,4-17,5-7,acuminate,acute,along,anther,anthesi,apar,apex,bark,base,bearing,beneath,berry,black,borne,branched,calyx,causing,clavate,cm,corolla,curly,decurrent,deflexed,densely,denser,dia,differing,difoliate,drying,eaf,edicel,eed,elliptic,elongated,except,expanded,exserted,extremely,filament,filiform,flower,free,fruiting,geminate,glabrous,globose,gre,greatly,green,inflorescence,internodal,irregularly,lateral,leaf,less,like,lobe,lobed,lon,long,long-triangular,lower,main,major,middle,midrib,minor,minutely,mm,nflorescence,obconic,occasionally,older,one,opposite,ovary,ovoid-reniform,pair,pale,papillo,papillose,pedicel,persistently,petiole,pitted,planar,pore,poricidal,portion,present,previously,pubescent,pulled,raised,reflexe,reflexed,rest,ruit,scar,shaped,short,shrub,single,siz,size,slender,slightly,small,soon,spaced,sparsely,stem,stigma,straight,style,surface,tall,tan,tapering,tear-drop,time,tip,tipped,tree,trichome,tube,ud,unevenly,unifoliate,uniseriate,unit,varying,vein,way,white,widely,widest,winged,x,ympodial,young	
482	wfo-0001031695	success	185	155	99	86	56	0.535	0.5-2,1-2,1-3,1-9,1.5-8,1/2,1/3,3-19,4-5,5,5-20,5-7,abaxially,adaxially,also,apex,articulated,basal,base,blade,branched,broadened,calyx,campanulate,cell,chartaceous,cm,color,connective,connivent,cordate,dark,deep,densely,directed,divided,eglandular,ellipsoidal,entire,fruit,glabrescent,glandular-puberulent,green,greenish,hair,hard,immature,lateral,laterally,lavender,leaf,leaving,lobe,lobed,long,lower,margin,midrib,mm,moderately,mottled,narrowly,oblique,obtuse,occasionally,often,ovate,pedicel,pedicellar,perfect,petiole,pilose,pilose-hirsute,pore,present,puberulent,puberulent-pubescent,purple,remnant,ripe,rounded,shrub,simple,sinus,small,sometimes,sparsely,stone,stripe,subcoriaceous,time,tree,triangular,unbranched,unit,unknown,unlobed,wide,x	0.5-1,1,1.5-2,10-,10-15,10-35,15-20,2-3,2-4,2-5,2.5-5,20-30,3-,3-10,3-17,3-7,30-40,4-10,4-6,4-foliat,6-10,6-20,6-8,7-,?,abruptly,acuminate,acute,aggregate,apart,ape,apically,apiculate,axe,beyond,capitat,cylindrical,d,diameter,dilated,eaf,eed,eglandular-pilose,exceeding,exserted,flattened,fleshy,flower,glabrate,glabrous,lanceolate,lilac,lon,nflorescence,nther,oblong,orolla,ovoid,peduncle,pilo,pilose-hirsut,presen,pubescent,purplish,rachi,radiu,ruit,shorter,slight,slightly,somewhat,spaced,stamen,stigma,style,swelling,tal,tem,thecae,tip,tomento,tube,unequal,vary,yellow,ympodial	4-foliate,anther,appressed,articulation,bract,branching,breeding,broad-based,colour,corolla,filament,form,fruiting,growth,heteromorphism,inflated,inflorescence,insertion,interjected,interpetalar,leaflet,length,marking,mature,mentioned,modification,needle-like,odour,orientation,paired,pattern,placement,position,prickle,pseudostipule,rhizome,scale,shape,smell,spot,staman,stem,structure,surface,symmetry,sympodial,system,tall,texture,tissue,trichome,tuber,type,vegetative,xylopodia,zygomorphy
483	wfo-0001031698	success	58	102	28	30	74	0.483	2.5,2.5-3,4-4.5,bark,base,difoliate,dull,fruiting,green,leaf,margin,minutely,mm,pale,papillae,pedicel,pitted,reddish-brown,reniform,repandly,rugose,shrub,stem,surface,unit,x,yellowish,young	'',2-2.5,``,ape,branch,cm,decurrent,deflexed,dia,eaf,eed,elliptic,fide,flattened,geminat,glabrous,incrassate,long,maguire,older,otherwise,paler,persistin,stout,strongly,tall,wing,winged,woody,ympodial	anther,apex,appressed,articulation,bract,branching,breeding,broad-based,calyx,cell,colour,connective,corolla,dehiscence,filament,floral,flower,form,fruit,geminate,germination,growth,hair,height,heteromorphism,inflated,inflorescence,insertion,interjected,interpetalar,leaflet,length,lower,marking,mature,modification,needle-like,null,odour,orientation,paired,pattern,per,petiole,placement,pore,position,prickle,pseudostipule,requirement,rhizome,scale,seed,shape,size,smell,spot,staman,stone,structure,symmetry,sympodial,system,texture,thicknes,tissue,trichome,tuber,type,vegetative,venation,width,xylopodia,zygomorphy
484	wfo-0001031707	success	178	146	92	86	54	0.517	-3,.5,/4,1/3,2,2-3,2-4,2-6,24,4-5,5-10-celled,6-7,8-12,9-15,abaxially,adaxially,almost,along,anther,anthesi,apex,apically,attenuate,axil,axillary,base,basiscopically,bearing,berry,calyx,cell,climbing,cm,corolla,cucullate,dense,densely,distal,drying,enlarged,filament,flat,fleshy,flower,fruiting,glabrous,globose,green,greenish,high,leaf,leaflet,lobe,lobed,long,lower,margin,minutely,mm,oblique,occasionally,open,pair,papillate,pedicel,per,petiole,pink,pinnate,planar,pointed,poricidal,pubescent,scattered,simple,slightly,smooth,somewhat,surface,ternate,time,tip,trichome,type,uniseriate,unit,vein,vine,way,white,woody,x	0.5-1,1-1.2,1-1.3,1-1.5,1-3,1.2-1.8,1.2-2,1.5-1.7,1.5-2,1.5-6,16-20,2-10,3,4-6,80-140,absent,acuminate,acute,apical,basal,brown,c.,capitate,cateniform,clavat,conical,conspicuously,diameter,distinct,eaf,edicel,eed,elliptic,endrophilum,epidermal,erect,exserted,flap-like,flattened,four-lobed,free,horizonta,inflorescenc,lanceolate,lateral,less,like,lon,narrower,narrowly,nflorescence,obovate,ovary,penden,petiolule,plant,portion,primary,quadrate,quite,raised,reddish,regular,rest,round,ruit,sagittate,scar,smaller,spaced,sparsely,stigma,stout,strongly,style,tem,terminal,thickening,tub,tube,ud,unifoliat,usually,white-lenticellate,widely,ympodial	appressed,articulation,bract,branching,breeding,broad-based,cateniforme,colour,connective,form,fruit,growth,hair,heteromorphism,inflated,inflorescence,insertion,interjected,interpetalar,length,marking,mature,modification,needle-like,null,odour,orientation,paired,pattern,placement,pore,position,prickle,pseudostipule,rhizome,scale,shape,smell,spot,staman,stellate,stem,stone,structure,symmetry,sympodial,system,texture,tissue,tuber,unifoliate,vegetative,xylopodia,zygomorphy
485	wfo-0001031723	success	228	150	102	126	48	0.447	-1/2,-16,-2,-5,-6.5,0,0.2-1,0.4-,0.7-1,1-,1-2.5,1.5-,1.5-10,1/4-1/3,1/6-,2-5.5,2-7,2/3,3-15,4-10,4-6,anther,apart,apex,apparently,articulated,base,berry,blade,branching,brown,calyx,chartaceous,cm,conical,cuneate,discolorous,drying,elongating,entire,equal,erect,filament,free,fruit,fruiting,glabrous,hair,inflated,lateral,leaf,length,long,lower,margin,marking,mature,mauve,mm,moderately,multangulate,older,orange,pale,pedicel,perpendicular,petiole,poricidal,portion,prickle,prickly,primary,recurved,red,reflexed,rounded,secondary,sessile,shrub,simple,sometimes,spaced,spherical,stalked,stellate,stellate-pubescent,stem,straight,strongly,subentire,surface,tapering,terminal,tip,trichome,tube,unarmed,unit,variously,weakly,white,wide	-1.5,-15,-6,-8,-merous,0.05-0.2,0.1-0.2,0.1-0.3,0.1-0.5,0.15,0.4,0.4-0.9,0.4-1,0.55-0.9,0.6-1,0.8-1.5,1-2,1-3,1-5,1.2-2,1.5-2.5,1/3-1/2,10-30,15-45,2-,2-3.5,2.5-4.5,2.5-5,2/3-3/4,3-10,4-,4-11,4-20,4-5,5-40,5-9,8-20,abaxial,abaxially,acuminate,acut,acute,adaxial,alyx,ame,apar,apically,ba,bark,branched,brow,c.,connivent,curved,dark,deltate,densely,diameter,dull,eaf,eed,elongated,evenly,eye,filiform,finely,flattened-reniform,flower,gently,glabrescent,gland,gland-tipped,glandular,gray,green,herbaceous,infructescence,lobe,lobed,longer,maturity,midpoint,minute,naked,narrow-deltate,near,nflorescence,obtuse,one,open,orange-brown,orolla,oung,ovate,pair,peduncle,per,perfec,pericarp,plurifoliat,porrect,ray,ruit,scar,smooth,sparsely,spreading,stalk,style,tamen,terete,tertiary,time,unarme,usually,vary,vein,venation,visible,way,whitish,woody,yellow,yellow-green,ympodial,young	appressed,articulation,bract,breeding,broad-based,cell,colour,connective,corolla,form,growth,heteromorphism,inflorescence,insertion,interjected,interpetalar,leaflet,modification,needle-like,null,odour,orientation,paired,pattern,perfect,placement,plurifoliate,pore,position,pseudostipule,rhizome,scale,shape,smell,spot,staman,stone,structure,symmetry,sympodial,system,texture,tissue,tuber,type,vegetative,xylopodia,zygomorphy
486	wfo-0001031729	success	161	142	86	75	56	0.534	-2,-45,0.5,0.5-1,0.6-,1-1.5,1-2.5,11-30,12-13,2-2.5,2-3,3-celled,4.1-16,5-7,8-9,abruptly,acuminate,along,anther,anthesi,apex,attenuate,base,beneath,branched,calyx,cell,cm,corolla,cucullate,dark,darker,drying,elliptic,filament,fruit,fruiting,glabrous,glandular,globose,green,greenish,less,lobe,lobed,long,lower,membranous,middle,mm,mottling,narrowly,nearly,never,obovate,occasionally,pair,papillae,papillate,pedicel,petiole,pink,planar,point,primary,purplish,scattered,short,shrub,single,single-stemmed,small,stem,stripe,surface,thin,time,tip,triangular,trichome,unit,usually,vein,wand-like,white,x	-0.5,..,0.5-4,1-2,1.0-1.3,1.5,1.5-2,10-20,2.5-,2.5-5,3-4,3.5-4,5-,5-6,50,apicula,apiculate-deltate,branc,branch,brittle,brow,c.,conical,curve,deltate,diameter,dry,eaf,edicel,eed,elongate,erec,flattened,flattened-capitat,flower,gradually,later,markedly,minute,minutely,nflorescence,noddin,open,outer,outline,ovary,ovate-reniform,pale,papillose,peduncle,per,pericarp,plurifoliat,pointed,quadrate,reddish,regularly,ruit,scar,sinuate,smooth,somewhat,stigma,striate,tan,testa,thing,toward,tube,tuft,ud,wall,widening,ympodial,young	2.5-4,3.5-4.5,appressed,articulation,bract,branching,breeding,broad-based,colour,connective,form,growth,hair,heteromorphism,inflated,inflorescence,insertion,interjected,interpetalar,leaf,leaflet,length,margin,marking,mature,modification,needle-like,null,odour,orientation,paired,pattern,placement,plurifoliate,pore,position,prickle,pseudostipule,rhizome,scale,shape,smell,spot,staman,stone,structure,symmetry,sympodial,system,texture,tissue,tuber,type,vegetative,xylopodia,zygomorphy
487	wfo-0001031738	exception_thrown	231	0	0	231	0	0.0		-15,-5,-6,-merous,.5,0,0-2,0-3,0.1-0.25,0.2-0.3,0.25-0.8,0.3-1,0.7-1,0.7-1.1,0.9-2.1,1-1.5,1-1.8,1-3,1-4,1.4-1.7,1.5-,1.5-4,1/,1/2-2/3,1/3,1/3-2/3,1/4-1/3,1/6-1/4,10-15,15-40,2-,2-4,2.3-3,20-200,3-4,3-6,3-7,3.5-3.8,3.5-4.5,4,4-10,4-5,4-6,4-8,5,5-8,6-15,7-12,7-12.5,8-10,8-18,abaxial,abaxially,acuminat,acute,adaxial,adaxially,almost,always,alyx,andromonoecious,anther,apar,apart,apex,apically,apparently,articulated,auriculate,bark,base,berry,blade,branched,calyx,cell,chartaceous,cm,connivent,cordate,curved,dark,deltate,densely,diameter,discolorous,distal,distance,drying,dull,eaf,eed,elongating,equal,erect,evenly,extending,filament,flattened,flattened-reniform,flower,free,frequently,fruit,fruiting,glabrescent,glabrous,gray,green,held,hermaphrodite,heterostylous,infructescence,inside,lateral,leaf,length,lobe,lobed,lobing,long,long-styled,longer,lower,lowermost,margin,mature,maturity,midpoint,midvein,mm,multangulate,narrow-deltate,nflorescence,oblong,obovate,often,older,one,open,orange,orange-brown,orolla,oung,outline,ovate,pair,pale,pedicel,peduncle,per,pericarp,petiole,pit,plant,plurifoliat,poorly,poricidal,porrect,portion,prickl,prickle,prickly,primary,prominent,pubescent,raised,ray,reflexed,resin,rounded,ruit,scar,secondary,sessile,short-styled,shorter,shrub,side,simple,small,smooth,sometimes,spaced,sparsely,spherical,spreading,stalk,stalked,staminat,stellate,stellate-pubescent,stem,sticky,stout,straight,strongly,style,surface,tamen,tapering,terete,terminal,tertiary,time,tip,tree,trichome,truncate,tube,unarmed,unit,upper,usually,variously,vary,vein,venation,visible,way,weakly,white,white-brow,wide,woody,yellow,yellow-green,yellow-orange,yellowish,ympodial,young	
488	wfo-0001031752	exception_thrown	172	0	0	172	0	0.0		-10,-100,-3,-44,-47,-6,-pubescent,0.5-1,0.5-1.5,1,1-,1-1.5,1-2,1-3,1-4,1.5-10.5,1.5-2,1.5-2.5,1.5-3,1.5-3.5,15-25,15-40,2-2.5,2-3,2-5,20-35,3-11.5,3-4,3-4-foliat,3-7,3.5-15,3.5-5,5-23,5-6,5-8,8-15,9-16,abaxially,acuminate,acute,adaxially,aggregate,apart,ape,apex,apiculate,articulated,axe,basal,base,beyond,blade,calyx,cell,chartaceous,ciliat,ciliate,cm,connective,connivent,cuneate,cylindrical,darker,deltate,densely,diameter,directed,distally,eaf,eed,ellipsoidal,elliptic,entire,equal,exceeding,exserted,flattened,fleshy,flower,fruit,fusiform,glabrate,glabrescent,glabrous,gland,glandular-puberulen,glandular-puberulent,green,immature,lanceolate,leaving,less,light,linear,lobe,lon,long,lower,margin,membranaceous,mm,moderately,narrowly,near,nearly,nflorescence,nther,oblong,obtuse,often,olde,older,orolla,ovate,ovoid,pedicel,pedicellar,peduncle,perfect,petiole,pink,pore,presen,present,puberulent,pubescent,purpl,purplish,rachi,radiu,remnant,ripe,rounded,rugose,ruit,shrub,simple,slightly,small,spaced,sparsely,stalked,stamen,stellate,stigma,stone,stripe,style,subcordate,subcoriaceous,swelling,tal,tem,thecae,time,tip,tomentose,tree,triangular,truncat,truncate,tube,ud,unbranched,unit,vary,white,wide,x,yellow,ympodial,young	
489	wfo-0001031756	exception_thrown	186	0	0	186	0	0.0		-1,-5,.1,.5,.8,/2,0,0-2,0-5,0.02-0.2,0.1,0.15-0.25,0.2,0.4-1.6,0.5-1,0.5-1.3,0.6-1.2,0.6-1.6,0.7-1.7,0.8-1,00,1-1.8,1-2,1-3,1-4,1.5-2,1.5-3.5,1.8-2.5,1/2,1/3,10,2-6,3-15,3-5,3-7,4-5,4.5,5-merous,6-9,7-10,9-14,abaxially,accrescent,acut,alyx,anther,apar,apart,apex,apically,apparently,articulated,bark,base,berry,blade,branched,broad-deltate,calyx,chartaceous,cm,color,concolorous,conical,connivent,cordate,curved,deltate,densely,diameter,drying,eaf,eed,elongating,enclosing,entire,equal,erect,evenly,eye,filament,finely,flattened-reniform,flower,free,fruit,fruiting,fully,glabrescent,glabrou,glabrous,gray,green,herbaceous,inflated,infructescence,invested,known,leaf,lobe,lobed,long,longer,lower,margin,mature,mauve,midpoint,mm,moderately,naked,nflorescence,older,one,open,orange-brown,orolla,oung,ovate,pair,pale,pedicel,peduncle,pendulous,per,perfec,pericarp,perpendicular,petiole,pitted,plurifoliat,poricidal,porrect,portion,prickl,prickle,prickly,primary,ray,red-brown,rounded,ruit,scandent,scar,sessile,shoot,short,shorter,shrub,simple,slender,small,smooth,spaced,sparsely,spherical,spreading,stalk,stalked,stellate,stellate-pubescent,stem,straight,style,surface,tamen,tapering,terete,terminal,time,tip,trichome,truncate,tube,unarmed,unit,variously,vary,vein,visible,way,white,wide,yellow-green,ympodial,young	
490	wfo-0001031786	exception_thrown	209	0	0	209	0	0.0		-5,.4,.5,/2,/3,0,0-2,0-20,0-3,0-5,0.1,0.1-0.4,0.2-0.3,0.2-2.5,0.25-0.5,0.5-1.5,0.7-1,0.7-1.6,0.7-4,0.8,0.8-1.2,1,1-2,1-3,1-4,1-6,1.2-1.6,1.5-1.9,1.5-2.5,1/3-1/2,2-13,2-3,2-7,2-8,2.5-3.5,3-4,3-5.5,4-5,5-7,5-merous,6-8,8-12,abaxially,acut,acute,almost,alyx,ame,anther,apar,apart,apex,apically,apparently,articulated,bark,base,becoming,berry,blade,branched,c.,calyx,cell,chartaceous,clavat,cm,concolorous,connivent,cuneate,curved,dark,deep,deltate,densely,diameter,distance,drying,eaf,eed,elliptic,elongating,equal,erect,evenly,extending,eye,filament,filiform,flattened,flattened-reniform,flower,free,fruit,fruiting,glabrescent,glabrous,gray,gray-brow,green,herb,herbaceous,inconspicuous,infructescence,lateral,leaf,length,lobe,lobed,lon,long,longer,lower,margin,mature,maturity,mauve,membranous,midpoint,midvein,minute,mm,naked,nflorescence,obtuse,older,one,open,orange,orange-brown,orolla,oung,outline,ovate,pair,pale,pedicel,peduncle,pendulous,per,perfec,pericarp,petiole,pit,plurifoliat,poricidal,porrect,portion,prickl,prickle,prickly,primary,raised,ray,red,red-brown,reflexed,rounded,ruit,scandent,scar,sessile,shiny,shorter,shrub,side,simple,slightly,small,smooth,sometimes,spaced,sparsely,spherical,spreading,stalk,stalked,stellate,stellate-pubescent,stem,stigma,straight,style,surface,tamen,tapering,terete,tertiary,thick,time,tip,trichome,truncate,tube,unarmed,unit,variously,vary,vein,venation,visible,way,weakly,white,wide,woody,yellow-orange,ympodial,young	
491	wfo-0001031793	success	188	135	82	106	53	0.436	.5,0,1.5-4,13-20,2-5,3-8,8-11,absent,abundant,adult,aging,almost,anther,apex,articulated,base,berry,black,blade,branched,broadly,brown,brownish,calyx,chartaceous,cm,cuneate,densely,difoliate,distal,elliptic,erect,extra-axillary,ferrugineous,filament,forked,fruit,fruiting,globose,hair,inflorescence,interpetalar,larger,leaf,lobe,long,lower,margin,mm,mostly,oblique,oblong-lanceolate,orange-yellow,pedicel,petiole,pore,porocidal,prickle,reddish,rounded,scattered,shallow,shrub,side,simple,small,sparsely,stellate,stellate-pubescent,stem,surface,tip,tissue,tree,trichome,unbranched,unit,usually,well-developed,white,x,yellow	-4,1,1-1.5,1-2,1-3,1-8,1.5-2,1/3,1/4,1/5,10-15,15-20,2-3,20,26,3-4,3/4,4,40,5-merous,7,accrescent,acumen,acuminate,acute,alyx,apparently,armed,aspect,axe,ba,bilobe,branche,broad,capitate,central,cut,diameter,eaf,eed,elongatin,erec,evident,extreme,flattened,flower,geminat,general,glandular,homostylou,linear,lobing,lon,main,many,maturing,midpoint,midrib,minutely,mucilaginous,nflorescence,obtuse,often,older,orbicular-ovate,orolla,ovate,peduncle,per,perfect,porrect,principal,pubescent,rachi,reduced,reticulation,ruit,rusty,scarcely,sessile,similar,single,sinus,size,smaller,stellate-pubescen,stigma,stipitate,stout,style,tall,tamen,tem,testa,thickened,triangular,triangular-acuminat,tube,unarmed,upward,uvenile,vary,way,woody,yellow-brown,ympodial	acrescent,appressed,articulation,bract,branch,branching,breeding,broad-based,cell,colour,connective,corolla,elongating,form,geminate,growth,heteromorphism,homostylous,inflated,insertion,interjected,leaflet,length,marking,mature,modification,needle-like,null,odour,orientation,paired,pattern,placement,position,pseudostipule,rhizome,scale,shape,smell,spot,staman,stone,structure,symmetry,sympodial,system,texture,triangular-acuminate,tuber,type,vegetative,xylopodia,zygomorphy
492	wfo-0001031829	success	138	75	24	114	51	0.174	1-2,anther,apex,base,calyx,corolla,filament,fruiting,green,growth,inflorescence,leaf,lower,margin,pedicel,petiole,pore,shrub,stem,surface,tall,trichome,unit,white	.25,.5,0.5-2.1,0.7-1,1,1.3-1.5,1.5-2,1.5-2.5,1.5-3.5,1.5-4.5,2-4,3-5-flowered,3/4,4-4.5,4-8.5,7-10,abaxially,absent,acute,adaxial,adaxially,along,anthesi,ape,apiculae,bae,bark,berry,branched,broadly,capitate,cm,conical,crystalline,deflexed,densely,denser,dia,differing,difoliate,drying,eaf,edicel,eed,elliptic,epidermi,erect,exserted,free,geminat,glabrat,glabrous,globose,greenish-brown,immature,known,large-celled,lateral,leathery,like,lobe,lobed,lon,long,main,major,minor,minute,minutely,mm,nflorescence,occasionally,often,older,opposite,ovary,overlappin,packed,pair,papillo,papillose,planar,poricidal,portion,pubescent,quadrate,revolute,ruit,scar,shaped,simple,size,soft,somewhat,sparsely,stigma,style,tapering,tear-drop,thick,tip,tub,tube,tuft,ud,uniseriate,vein,waxy,way,woody,x,yellowish,ympodial,young	appressed,articulation,bract,branching,breeding,broad-based,cell,colour,connective,form,fruit,hair,heteromorphism,inflated,insertion,interjected,interpetalar,leaflet,length,marking,mature,modification,needle-like,none,odour,orientation,paired,pattern,placement,position,prickle,pseudostipule,rhizome,scale,shape,smell,spot,staman,stellate,stone,structure,symmetry,sympodial,system,texture,tissue,tuber,type,vegetative,xylopodia,zygomorphy
493	wfo-0001031832	success	232	126	75	157	51	0.323	/50-1/10,0.2-1.5,0.7-2,1-12,3-7,accrescent,anther,apex,apical-lateral,articulated,attenuate,axillary,base,becoming,berry,blade,branched,bullate,calyx,cm,connate,continued,corolla,due,entire,filament,fleshy,forming,fruit,fruiting,globose,granular-tomentose,greenish,growth,hair,high,introrse,lateral,leaf,length,lower,margin,mixed,mm,oblong,occasionally,pale,pedicel,petiole,plurifoliate,pore,porrect-stellate,probably,ripe,rotate-stellate,rough,scabrous,sessile,short-,shrub,simple,somewhat,sparingly,stellate-pubescent,stem,surface,terminal,thick-stalked,time,tree,tube,unit,violet,white,yellow	-8,.5-1,0-150,0.1-0.3,0.2-0.6,0.3-0.8,0.3-3,0.7-1.5,0.7-1.6,0.8-1.2,1.1-2.4,1.2-1.6,1.2-2,1.2-2.5,1.3-4.2,1.5-4,1.7-4,1.8-4,1/2-3/4,14,2-3.6,2-4,2-6,2.5-6.5,2.8-4.8,3-6.5,3.5-7,4-20,4-7,5-21,5.5-10,7-10,8-25,9,abaxially,acuminate,acute,adaxially,ag,anthesi,apart,apice,apparently,axe,ba,bark,basal,blister,blunt-tipped,branch,brown,brownish,bud,capitat,chartaceous,closely,conical,dark,decurrent,dehiscing,deltoid,diameter,directed,eaf,eed,evident,exserted,extend,ferrugineous,few-rayed,flower,free,glabrescen,glabrescent,glabrous,green,half,honeycombed,indument,inserted,lackin,lanceolate,large,line,lobe,lobed,long,long-,longer,longitudinal,m.,main,midvein,minute,mostly,multangulate,nearly,nflorescence,oblanceolate,obovoid,obtuse,older,orbicular,orolla,ovate,partly,peduncle,perfect,persistent,pitted,porrect-stellat,pubescence,pubescent,rachi,rather,ray,relatively,reniform,reticulate-punctate,ruit,runk,short-stalked,side,slit,smooth,sometimes,soon,spaced,sparse,splitting,stamen,stigma,stipitate-glandular,style,subcampanulate,suborbicular,suture,swelling,tamen,terete,testa,thick,toward,translucent,unarme,unarmed,usually,vary,vein,way,weakly,whitish,wide,x,yellowish,ympodial,young	appressed,articulation,bract,branching,breeding,broad-based,cell,colour,connective,form,heteromorphism,inflated,inflorescence,insertion,interjected,interpetalar,lacking,leaflet,marking,mature,modification,needle-like,null,odour,orientation,paired,pattern,placement,position,prickle,pseudostipule,rhizome,scale,shape,smell,spot,staman,stellate,stone,structure,symmetry,sympodial,system,texture,tissue,trichome,tuber,type,vegetative,xylopodia,zygomorphy
494	wfo-0001031834	exception_thrown	150	0	0	150	0	0.0		.5,0.5,0.5-1,0.5-3,0.5-3.5,0.6-1.4,0.8-1,0.8-1.3,0.9-1.4,1,1.5,1.5-4,1.6-2,1.9-6.5,2.9-7,2/3,6-7,6.5-14,accrescent,across,acuminate,acute,anther,anthesi,apar,apex,apically,apiculate,appear,attenuate,base,berry,bi-cellular,borne,calyx,campanulate,cm,corolla,covered,deciduou,deciduous,decurrent,deflexed,deltoid,depression,dia,difoliate,eaf,edicel,eed,expanded,eye,few-flowered,filament,flattened-reniform,free,fruit,fruiting,geminat,glabrou,glabrous,globose,green,greenish-yellow,hook,hooked,incrassate,lamina,larger,leaf,leaving,less,like,lobe,lobed,lon,long,lower,major,margin,markedly,middle,minor,minute,minutely,mm,mound-like,multicellular,naked,nflorescence,often,opposite,ovary,ovate,pale,papillo,papillose,pedicel,persistent,petiole,pitted,planar,pore,poricidal,portion,proximal,pubescent,ruit,scabrous,scar,shaped,short,shrub,simple,slender,slightly,small,soon,spaced,sparsely,speck,stem,stigma,straight,style,surface,tall,tan,tapering,tear-drop,tip,trichome,tube,tufted,ud,unevenly,uni-,uniseriate,unit,upper,usually,vein,way,white,widest,woody,x,yellow,ympodial,young	
495	wfo-0001031842	exception_thrown	161	0	0	161	0	0.0		.1,.4,.5,.75,0.1-0.5,0.5-1,0.5-2,0.6-1,0.7-1,1,1-1.5,1-1.8,1-3.5,1.5-2,10-12,10-20,10-30-flowered,2-10,2-3,2.5-3,2.5-6,3-8,3/4,4.5-6,7-9,9-15,acute,anther,anthesi,apart,apex,attenuate,axil,ba,bark,base,bearing,beginning,beneath,berry,bi-lobed,brown,calyx,capitate,cm,corolla,cup-shaped,cusp,dark,decurrent,deeply,deflexed,densely,dia,differing,difoliate,dry,eaf,edicel,eed,ellipsoid,elliptic,exserte,exsertion,filament,flattened-reniform,free,fruiting,geminat,glabrous,globose,green,incrassate,inflorescenc,irregularly,later,lateral,leaf,leaf-opposed,lobe,lobed,lon,long,lower,main,major,margin,middle,minor,minutely,mm,near,new,nflorescence,often,older,one,onto,opposite,ovary,overtopping,pair,pale,paler,papillo,papillose,pedicel,petiole,pitted,pore,poricidal,portion,prominent,pubescent,quadrate,reddish,reddish-resinous,reflexed,ruit,scar,shaped,shiny,shoot,shrub,simple,size,slender,somewhat,soon,spaced,sparsely,specimen,stem,stigma,straight,strongly,style,surface,tall,tapering,tear-drop,terminal,time,tip,tree,trichome,tube,tuft,ud,uniseriate,unit,vein,way,white,widest,woody,x,yellowish,yellowish-whit,ympodial,young	
496	wfo-0001031843	exception_thrown	245	0	0	245	0	0.0		.2,.3,.5,.6,0-4,0.2-2,0.4-0.5,0.5-1,0.5-1.5,0.6-1.2,0.7-1.2,0.7-2,0.8-2,1-2,1-7,1.2-2,1.2-2.2,1.5,1.5-2,1.8-2.5,1/6-1/4,1mm,2-3,2-4,2.5,3-4,3-7,4-12,45-60Â°,5-10,5-12,6-9,abaxially,accrescent,acuminate,adaxially,age,almost,along,always,alyx,anther,anthesi,apar,apex,apically,apice,apparently,appressed,around,articulated,attenuate,bark,basal,base,becoming,berry,black,branch,branched,branching,broadly,brown,calyx,canaliculate,capitate,caudate,clearly,cm,collapsing,completely,conical,corolla,cupular,curved,cuspidate,dark,deeply,delineated,deltoid,dendritic,density,detaching,diameter,dilated,discoid,discolorous,distributed,domatia,drying,dull,eaf,eed,ellipsoi,entire,equal,erect,even,evenly,eye,fertilisation,filament,fine,finely,flat,flexuous,flower,forming,free,fruiting,glabrous,green,hand,honeycomb,inner,largely,leaf,leave,len,length,lengthening,liana,lignified,like,lobe,lobed,long,longitudinally,loop,looping,lower,m.,main,margin,midvein,mm,much,multiseriate,naked,network,never,nflorescence,nther,oblique,oblong,obovate,obscure,older,opening,orange,orange-brown,orange-yellow,orolla,outline,ovate,pair,papillo,part,partly,pattern,pedicel,peduncle,pendulous,perfec,pericarp,petiole,pit,pitted,plurifoliat,pore,poricidal,portion,present,primary,prominent,pronounced,protruding,pubescent,rachi,raised,rarely,recurve,red,reddish,reveal,ribbed,ridged,rounded,ruit,scar,see,seed,shallowly,shiny,shortly,shrub,side,simple,sinus,slender,slightly,small,smaller,smooth,sometimes,soon,sparsely,spheroidal,spreading,stem,stigma,straight,strongly,stump,style,surfac,surface,tearing,terminal,tertiary,thick-chartaceous,thickened,thin,tip,trichome,tube,tuft,twice,ud,unarmed,unit,variable,vary,vein,venation,violet,visible,weakly,white,wide,wider,without,x,ympodial,young	
497	wfo-0001031852	success	155	126	65	90	61	0.419	1-4,1-4.2,4-10,4-6,abaxially,adaxially,apex,apical,apically,base,branched,calyx,cell,cm,conical,connate,corolla,covering,dehiscent,dichasial,dichasially,distal,ebracteate,filament,generally,green,hair-like,half,herbaceous,honeycomb,interjected,introrse,lanceolate,lateral,leaf,leaflet,light,long,lower,maturing,mm,monochasial,oblique,odd-pinnate,often,pattern,pedicel,perennial,perfect,petiole,plant,poricidally,proximal,pubescent,short,slit,stellate,testal,thick,tuber-bearing,typically,unit,wall,white,Â¼	-8,0.1-1,0.5-1.3,0.5-3,1-,1-9,1.3-2.5,1.4-3,1.5-3,12-35,2-3,2-5.5,2.6-9.5,3-4,3-6-foliat,3-9,3.5-10,4-,4-5,5-15,7-,9-11,abruptly,absen,acumen,acuminate,acute,apiculate,articulate,attenuate,cyme,decurrent,diameter,digestion,diminishing,dorsally,eaf,edge,eed,elliptic,elliptic-lanceolate,emoval,enzyme,exceeding,flat,flower,folded,forked,globo,green-white,living,lobe,lon,lunat,make,mucilaginous,nflorescence,nther,oblong,orolla,ovate-elliptic,ovoid,pair,peduncle,plan,rachi,reveal,ruit,seed,sessile,seudostipule,shortly,size,specimen,stamen,stigma,straight,style,tal,tem,terminal,throughou,throughout,toward,vary,white-crea,wide,without,yellow,ympodial	3-6-foliate,absent,anther,appressed,articulation,bract,branching,breeding,broad-based,colour,connective,form,fruit,fruiting,growth,hair,heteromorphism,inflated,inflorescence,insertion,interpetalar,length,lunate,margin,marking,mature,modification,needle-like,null,odour,orientation,paired,placement,pore,poricidal,position,present,prickle,pseudostipule,rhizome,scale,shape,smell,spot,staman,stem,stone,structure,surface,symmetry,sympodial,system,texture,tissue,trichome,tuber,type,vegetative,white-cream,xylopodia,zygomorphy
498	wfo-0001031864	success	140	93	38	102	55	0.271	1.5-10,3-pinnate,accrescent,anther,apex,base,berry,calyx,chartaceous,ciliate,cm,entire,filament,flattened,fleshy,fruit,fruiting,hair,herbaceous,leaflet,lower,margin,ovoid-deltoid,pedicel,petiole,pubescent,rotate,slender,slightly,sparsely,stem,surface,trichome,unbranched,unit,unknown,vine,violet	.2,.25,.5,0.2-0.5,0.4-3,0.5-13.5,0.5-4,0.6-3.5,0.6-4,0.7-0.8,0.8-1,1-1.2,1-1.8,1-2,1-3,1-5,1-6.5,1.2-1.5,1.5,1.5-2.5,15-60,2,2-3,2.5-6,3-3.5,5-15,5-9,5-merous,7.5-8,abaxially,acuminate,acute,adaxially,alyx,apar,apical,apiculate,axe,blade,c.,capitat,clavate,color,cuneate,deltoid,dense,densely,diameter,eaf,eed,emarginate,extra-axillary,fine,flower,glabrou,glabrous,lateral,lenticular,like,lobe,lon,long,m.,middle,minutely,mm,moderately,near,nflorescence,nternode,oblique,orolla,papillose,peduncle,perfec,petiolule,plurifoliat,pointed,pubescenc,pubescence,rachi,rounded,ruit,sand-punctate,scattered,short,spaced,stigma,style,tamen,tem,terrestria,tip,truncate,tube,typical,vary,vein,wide-diameter,widely,x,ympodial	appressed,articulation,bract,branching,breeding,broad-based,cell,colour,connective,corolla,form,growth,heteromorphism,inflated,inflorescence,insertion,interjected,internode,interpetalar,leaf,length,marking,mature,modification,needle-like,none,odour,orientation,paired,pattern,placement,plurifoliate,pore,position,prickle,pseudostipule,rhizome,scale,shape,smell,spot,staman,stellate,stone,structure,symmetry,sympodial,system,texture,tissue,tuber,type,vegetative,xylopodia,zygomorphy
499	wfo-0001031864	exception_thrown	148	0	0	148	0	0.0		.2,.25,.5,0.4-3,0.5-13.5,0.5-4,0.6-3.5,0.6-4,1-1.2,1-1.8,1-2,1-3,1-5,1-6.5,1.2-1.5,1.5,1.5-2.5,15-60,2,2-3,2.5-6,3-3.5,3-5-celled,3-pinnate,5-15,5-9,5-merou,7.5-8,abaxially,absent,accrescent,acuminate,acute,adaxially,ag,alyx,anther,apart,apex,apical,apiculate,apparently,articulated,axe,ba,basally,base,blade,blue-purple,calyx,capitat,center,ciliate,clavate,cm,color,connivent,cordate,cuneate,deltoid,dense,densely,diameter,directed,distally,eaf,eed,emarginate,entire,equal,etiole,extra-axillary,filament,fine,fleshy,flower,fruit,fruiting,geminat,glabrous,hair,herb,interjected,large,lateral,leaflet,lenticular,lobe,long,longitudinal,lower,m.,margin,minutely,mm,near,nflorescence,node,oblique,oblong,opening,orolla,papillose,pedicel,peduncle,perfect,petiolule,plurifoliate,pore,pubescenc,pubescence,pubescent,rachi,rooting,rotate,rounded,scattered,short,simple,slender,slightly,slit,somewhat,spaced,sparsely,stigma,style,surface,tamen,tem,terrestrial,thick,tip,trailing,truncate,tube,unbranched,uniseriate,unit,unknown,vary,weakly,widely,wiry,woody,x,yellow,ympodial	
500	wfo-0001031871	success	185	103	49	136	54	0.265	0.4-2,1-2,36-44,4-6,anther,apex,attenuate,base,berry,cell,chartaceous,cm,corolla,deep,distal,dot,end,filament,forked,fruit,globose,green,hair,half,herb,high,homostylous,interjected,leaflet,long,lower,medium,mm,odd-pinnate,one,ovoid,pedicel,petiole,placed,plurifoliate,pore,rotate,terminal,tiny,tissue,tuber,typically,unit,white	0.6-1.2,1.4-2.1,1.5-11,1.5-2,1.5-2.1,1.6-2.7,14-22,2-3,2-4,2.9-6,3-10,3-4,3-5,3.5-4,33-40,4-7,5-merou,5.4-12.3,6-12,6-7,6.5-20.5,7-9,7.5-23,abaxially,acumen,acute,adaxiall,adaxially,ag,alyx,apart,apparently,articulated,asymmetric,axe,axillary,basiscopic,blade,brownish,bud,capitat,clavate,condition,connivent,covering,dark,diameter,digestion,dorsally,drying,eaf,edge,eed,elliptic,enzyme,erec,exceeding,flat,flower,folded,fresh,geminat,generally,glabrou,glabrous,green-white,greenish,hair-like,hal,honeycomb-shaped,lanceolate,lateral,lengthening,linear,living,lobe,make,mottled,mucilaginous,narrowly,nflorescence,orbicular,orolla,ovate,pair,peduncle,perfect,petiolulate,plant,poricidal,pubescent,purple,removed,ripe,round,rounded,ruit,seed,sessile,seudostipule,short,side,size,slit,sometimes,spaced,specimen,stamen,stigma,stolo,straight,style,subequal,subglabrou,subglabrous,subtending,symmetric,tall,tamen,tem,testal,thick,throughout,tip,tri-,tube,usually,vary,wall,wet,whitish,wide,winged,x,yellow,ympodial	appressed,articulation,bract,branching,breeding,broad-based,calyx,colour,connective,form,fruiting,geminate,growth,heteromorphism,inflated,inflorescence,insertion,interpetalar,leaf,length,margin,marking,mature,modification,needle-like,null,odour,orientation,paired,pattern,placement,position,prickle,pseudostipule,rhizome,scale,shape,smell,spot,staman,stem,stolon,stone,structure,surface,symmetry,sympodial,system,texture,trichome,type,vegetative,xylopodia,zygomorphy
501	wfo-0001031876	success	140	157	99	41	58	0.707	.5,0-flowered,0.5,1-1.5,1-4,1.5-2.2,3,5,across,acute,anther,apex,arc,arising,bark,base,bearing,beneath,berry,bright,calyx,closely,cm,convergence,corolla,cup-like,decurrent,dia,elliptic,family,filament,flower,free,fruiting,glabrous,globose,green,irregularity,lateral,leaf,less,lightly,lobe,lobed,long,long-acuminate,lower,main,major,margin,melastomataceae,member,middle,minute,mm,nearly,oblanceolate,oblique,often,opposite,pair,parallel,pedicel,perpendicular,petiole,point,pore,poricidal,portion,present,primary,prominent,raised,recurved,resemble,running,scar,secondary,shaped,shrub,simple,slender,slightly,spaced,stem,tall,tapering,tear-drop,time,tip,tube,unit,vein,venation,white,widest,winged,yellow,young	.1,0.8-1,1,1-1.6,27-35,9-15,?,anthesi,apiculate,ba,corky,differing,eaf,edicel,eed,erect,glabrou,granular,greenish-yellow,immature,known,lenticellat,minutely,nflorescence,otherwise,ovary,overlappin,papillose,persistent,reflexed,ruit,stigma,straight,styl,style,ud,unifoliat,wide,woody,x,ympodial	.8-1,appressed,articulation,bract,branching,breeding,broad-based,cell,colour,connective,form,fruit,growth,hair,heteromorphism,inflated,inflorescence,insertion,interjected,interpetalar,leaflet,length,lenticellate,marking,mature,modification,needle-like,null,odour,orientation,overlapping,paired,pattern,placement,position,prickle,pseudostipule,rhizome,scale,shape,smell,spot,staman,stone,structure,surface,symmetry,sympodial,system,texture,tissue,trichome,tuber,type,unifoliate,vegetative,xylopodia,zygomorphy
502	wfo-0001031877	exception_thrown	216	0	0	216	0	0.0		+,.3,.5,0.2,0.3-,0.3-1,0.3-1.2,0.5,0.5-1,0.6-1.2,0.8-0.9,1,1-1.5,1-3,1-3.5,1-4,1.1-,1.5,1.5-1.9,1.5-2,1.8-5,2,2-,2.5,3-5,3-6,3.5-4,5-merou,6-10,6-8,abaxially,abruptly,acuminate,acute,adaxiall,adaxially,ag,along,alyx,angled,anther,anthesi,apar,apex,apparently,ark,articulated,ascending,basal,basally,base,berry,bright,brown,calyx,capitate,cell,clavate,cm,conical,connivent,corolla,deep,deflexed,deltate,densely,diameter,distal,dried,eaf,eed,ellipsoid,ellipsoidal,enlarged,entire,erect,especially,exposed,exserted,eye,filament,flattened,fleshy,flower,free,fruit,fruiting,furcate,glabrous,globose,green,greenish,growth,hastate,ilament,impressed,internal,irregularly,lamina,later,lateral,lengthening,like,line,linear,lobe,lobed,long,long-acuminate,loosely,lower,margin,material,mature,midvein,minute,minutely,mm,nearly,new,nflorescence,occasionally,often,older,orolla,outline,pair,pale,papillate,papillo,parallel,part,pedicel,peduncle,per,perfect,pericarp,petiole,pitted,plant,plump,plurifoliat,pointing,pore,poricidal,portion,primary,prominently,pubescence,pubescent,purple,purplish,rectangular,red,reddish,reflexed,reniform,rest,ripe,rounded,ruit,scar,scrambler,seed,semi-woody,shiny,short,shorte,silky,simple,sinuate,sleeve,slender,slightly,slit,sometimes,somewhat,spaced,sparsely,spreadin,stellate,stem,stigma,strongly,style,subshru,surface,tem,terminal,testal,thin,tinged,tip,triangular,trichome,truncate,tube,twinin,ud,uniformly,uniseriate,unit,upper,usually,vary,vein,vine,visible,wall,weak,white,woody,x,yello,ympodial,young	
503	wfo-0001031880	success	180	130	78	102	52	0.433	.5,1,1-1.5,1.5,2,2-3,3-4-pluri-foliate,3-foliate,3-lobed,5-6,7-9,anther,apex,basal,base,becoming,berry,calyx,cell,ciliate,cm,cordate,corolla,crowded,densely,enlarged,entire,filament,flattened,fleshy,fruit,fruiting,gland,glandular,globose,growing,herb,heteromorphic,inflorescence,internodal,leaf,lobe,long,longest,lower,margin,mature,mid-length,mm,near,orange,pale,pedicel,petiole,pore,pubescent,purple,red,reddish,shallowly,shortest,simple,single,sometimes,spreading,stem,subshrub,surface,tip,toothed,trichome,truncate,uniseriate,unit,unlobed,upper,x,â5	0.5-1,0.5-2,0.7-0.8,1-1.3,1-2,2-4,2-9,2.5-8,3-3.5,4,4-8,5,6-9,abaxially,acuminate,acute,adaxially,age,anthesi,apart,bearing,broadly,brown,c.,capitate,color,conical,crenate,cup-shaped,curved,dark,diameter,eaf,edicel,eed,ellipsoid,elliptic,erect,exerted,flower,flush,free,glabrous,gland-tipped,green,hollow,horn,irregularly,lamina,lengthening,less,lon,markedly,maturit,middle,minutely,narrowly,nflorescence,nodding,ovary,ovate,ovoid,pair,papillo,papillose,peduncle,pericarp,pitted,plan,poricidal,portion,primary,pubescen,rachi,reflexed,ruit,scar,slender,slightly,slit,spaced,sparse,sparsely,stigma,straight,strongly,style,terminal,testal,thin,triangular,tube,ud,unicellula,upward,vein,wall,widely,widest,woody,yellow,ympodial	appressed,articulation,bract,branching,breeding,broad-based,colour,connective,form,growth,hair,heteromorphism,inflated,insertion,interjected,interpetalar,leaflet,length,marking,maturity,modification,needle-like,null,odour,orientation,paired,pattern,placement,plant,position,prickle,pseudostipule,rhizome,scale,shape,smell,spot,staman,stellate,stone,structure,symmetry,sympodial,system,texture,tissue,tuber,type,unicellular,vegetative,xylopodia,zygomorphy
504	wfo-0001031881	exception_thrown	168	0	0	168	0	0.0		.5,0.1-0.5,0.2,0.2-0.6,0.4-1,0.5-0.7,0.5-1,1-1.3,1-1.5,1-7,1.2-6,1.5-2.5,1/3,10-12,10-30,2,2-9,3-19,3.5-4,3/4,5-6,7-14,absent,acute,along,anther,anthesi,apar,apex,apparent,attenuate,axil,ba,bark,base,beneath,branch,branched,broadly,brown,bud,calyx,campanulate,capitate,cm,constriction,corolla,dark,decurrent,deflexed,deltoid,densely,dia,differing,difoliate,distal,dry,drying,eaf,edicel,eed,either,ellipsoid,elliptic,erect,evenly,exserted,filament,fleshy,free,fruit,fruiting,geminat,glabrous,globose,golden,golden-puberulent,golden-pubescent,green,greyish-brow,incrassate,inflorescenc,inflorescence,junction,lateral,leaf,lightly,like,lobe,lobed,lon,long,lower,main,major,margin,material,maturity,middle,midrib,minor,minute,minutely,mm,nflorescence,obovate,occasionally,older,one,opposite,orbicular,ovary,ovoid-reniform,pair,papillo,papillose,pedicel,petiole,pitted,planar,pore,poricidal,portion,puberulen,puberulent,pubescent,rest,rounded,ruit,scar,shape,shaped,shrub,simple,size,slender,slightly,small,somewhat,soon,spaced,sparsely,stem,stigma,straight,strong,style,surface,tall,tapering,tear-drop,tip,tree,trichome,tube,ud,uniseriate,unit,usually,vein,way,white,widest,winged,woody,x,ympodial,young	
505	wfo-0001031886	exception_thrown	169	0	0	169	0	0.0		-1.2,-25,-4,-9,.5,0,0.1,0.5-1,1-1.5,1-4,1.2-2.5,1.5-2,10-40,2,2-2.5,2-3,2-4,2-5,2.0-2.5,20-30,3-6,3.0,4,4-15,5-10,5-6,5-ridged,6-20,6-8,9-10,abaxially,abruptly,absent,acuminate,adaxially,along,anther,anthesi,anticlinal,apex,arising,attenuate,axil,axillary,basal,base,beak,bearing,berry,bright,broadly,brown,bud,calyx,capitate,cell,clavat,cm,commonly,completely,conical,corolla,deltate,diameter,distinctly,dry,eaf,earl,edicel,eed,either,elliptic,em,epidermal,equal,erec,exserted,filament,fleshy,flower,free,fruit,fruiting,glabrous,green,greenish,half,irregular,lanceolate,lateral,le,leaflet,lobe,lobed,long,lower,margin,minutely,mm,narrowed,near,nearly,nflorescence,noddin,node,oblique,occasionally,open-conical,ovary,ovoid-reniform,pair,papillae,papillate,papillose,pedicel,per,petiole,petiolule,pinnate,poricidal,portion,primary,projection,purple,rachi,raised,reddish,reflexed,ripe,rugose,ruit,scar,scattered,seed,shape,shrub,similar,simple,single,sinuous,smaller,smelling,somewhat,sparse,specimen,stigma,strongly,style,surface,terminal,thickening,time,tip,triangular,trichome,tub,tube,ud,unifoliat,uniseriate,unit,usually,vein,white,wintergreen,without,woody,x,ympodial	
506	wfo-0001031895	exception_thrown	160	0	0	160	0	0.0		-1.5,0.5,0.5-1,0.5-2,1-1.5,1.5-2,1.5-3,1.5-6,2-2.5,2.5-3,3-10,3-4,3-8,3.5-6,4,4-5,4.5-16.5,5,5-6,5-8,6-7,6-9,acute,age,anther,anthesi,apex,apparently,articulating,attenuate,bark,base,beneath,berry,blac,bluish,broadly,calyx,campanulate,capitate,cell,cm,completely,conical,corolla,cup-shaped,dark,deltate,densely,diameter,drying,eaf,eed,ellipsoid,elliptic,emarginated,enlarging,entire,erec,erect,exerted,exfoliating,expand,filament,fleshy,flower,fragrant,free,fruiting,glabrou,glabrous,globose,green,growth,immature,inflorescenc,intensely,irregular,leaf-opposed,leafy,leaving,lengthening,less,lobe,lobed,lower,margin,matte,minutely,mm,new,nflorescence,occasionally,older,once-branched,ovary,overlapping,ovoid,pair,pale,papillat,papillate,part,patch,pedicel,peduncle,peeling,peg,perfect,pericarp,petiole,pitted,planar,plurifoliat,pore,poricidal,portion,primary,reddish,reniform,revolute,ruit,scar,shiny,shoot,short,shrub,simple,sinuate,slender,slightly,slit,small,somewhat,stem,stigma,stout,straight,strongly,style,surface,tan,terminal,testal,thick,thin,tip,tree,tub,tube,ud,unit,vein,violet,way,white,woody,x,ympodial,Â¼-1/2	
507	wfo-0001031897	exception_thrown	264	0	0	264	0	0.0		.1,.5,.8,0-1,0.1-0.5,0.15,0.2-0.4,0.4-1.1,0.5-1,0.5-3,0.6,0.8-1.5,0Â°,1,1-1.5,1-2,1-2.5,1.1,1.3-2,1.5,1.5-8,1.7-3,13,2-4,2/3,4-5,462.,5-6,6-9,8,abaxial,abaxially,absent,accrescent,acute,adaxial,adaxially,age,almost,along,alyx,anther,anthesi,apar,apex,apically,apparently,appearing,appendage,arising,aristate,articulated,attenuate,axillary,bark,base,bendy,berry,black,boiteau,brachyblast,branch,branched,brown,calyx,cell,chartaceous,clavate,clearly,clustered,cm,concolorous,condensed,conical,connate,coriaceous,corolla,covering,cuneate,curved,dark,datum,dehiscing,delineated,dendritic,dense,densely,developed,developing,development,diameter,dilated,distributed,divided,domatia,dorsal,dorsifixed,dry,drying,dull,eaf,earliest,ed,elliptic,enlarged,entire,epiphyte,equal,erect,even,evenly,except,extending,eye,faint,filament,filiform,fine,flower,foliaceous,free,fruit,fruiting,glabrous,green,grey,hair,immature,indistinc,inner,inside,known,lamina,lanceolate,larger,lateral,leaf,least,lengthening,light,like,linear,lobe,lobed,long,longitudinal,longitudinally,looped,lower,m.,main,margi,margin,mauve,membranous,midvein,minute,minutely,mm,multicellular,multiseriate,naked,never,nflorescence,nther,obconical,oblon,oblong,obtuse,occasional,occasionally,one,orange,orange-brown,orolla,outside,ovate,overlapping,ovoid,pair,papillose,part,partly,pedicel,peduncle,pendulous,perfec,pericarp,persisting,petiole,plant,plurifoliat,pointed,pore,poricidal,portion,primary,prominent,pronounced,protruding,pubescent,raised,rarely,reach,reddish,revolute,ribbed,ridge,ridged,ruit,scar,secondary,see,seen,shoot,short,shrub,side,simple,sinus,slender,slightly,smaller,smoot,smooth,sometimes,sparse,sparsely,stem,stigma,stump,style,subulate,sunk,surface,tearing,terete,terminal,tertiary,thick,thin,tip,toward,trichome,tube,ud,unarmed,unbranched,unicellular,unit,usually,vary,vein,venation,visible,weakly,well-developed,white,wide,winged,wrinkle,x,ympodial,young	
508	wfo-0001032157	success	136	155	99	37	56	0.728	.5,0.25,0.5-1,0.75-1,1-3,2-3,2-5,2.2,3-6,5-8,5-9,9-17,acute,anther,apart,apex,bark,base,becoming,beginning,beneath,berry,calyx,cm,corolla,crystalline,decurrent,differing,difoliate,dry,elliptic,evenly,filament,free,fruiting,glabrous,globose,golden,green,incrassate,lateral,leaf,less,live,lobe,lobed,long,longitudinal,lower,main,major,margin,middle,minor,minutely,mm,nearly,obscure,older,one,opposite,ovoid-reniform,pair,paler,papillose,pedicel,peeling,persistent,petiole,pitted,plant,pore,poricidal,portion,raised,reddish,rounded,shaped,shiny,shrub,simple,size,slightly,spaced,stem,strip,surface,tall,tear-drop,tip,tube,unit,vein,white,widest,woody,x,yellowish,young	.75,0.6-1,1.9-2.2,5-15-flowered,7-9,anthesi,bi-lobed,caly,completely,deflexed,deltoid,dia,eaf,edicel,eed,exserted,frui,geminat,glabrou,inflorescenc,living,lon,nflorescence,ovary,papillo,reflexed,ruit,scar,slender,soon,stigma,straight,style,tapering,translucen,ud,ympodial	appressed,articulation,bract,branching,breeding,broad-based,cell,colour,connective,form,fruit,geminate,growth,hair,heteromorphism,inflated,inflorescence,insertion,interjected,interpetalar,leaflet,length,marking,mature,modification,needle-like,null,odour,orientation,paired,pattern,placement,position,prickle,pseudostipule,rhizome,scale,seed,shape,smell,spot,staman,stone,structure,symmetry,sympodial,system,texture,tissue,translucent,trichome,tuber,type,vegetative,xylopodia,zygomorphy
509	wfo-0001032161	exception_thrown	146	0	0	146	0	0.0		.5,0.4-1.2,0.5-1,0.7-4,0.75-1,0.8-1,1-1.5,1-11,1-3,1.2-1.3,1.4-2,2-7,2-8-flowered,2.5-3,3.5-4,?,abaxially,acute,adaxiall,adaxially,anther,anthesi,apex,apical,area,ba,bark,base,beneath,berry,branched,brownish-blac,calyx,closely,cm,color,conical,coriaceous,corolla,dark,deflexed,delicate,deltate,dendritic,densely,dia,difoliate,drying,eaf,edicel,eed,ellipsoid,elliptic,exserted,filament,filiform,free,fruiting,giving,glabrous,globose,golden,green,hanging,inflorescence,internodal,lamina,later,leaf,like,lobe,lobed,long,lower,many,margin,merely,middle,minute,minutely,mm,mustard,nearly,nflorescence,obovate,occasionally,older,opposite,ovary,overlappin,ovoid-reniform,pale,papillose,pedicel,pericarp,persistent,petiole,pitted,plant,plurifoliate,pore,poricidal,portion,projection,pubescent,quadrate,reflexed,rest,revolute,ruit,scar,shaped,shiny,shoot,short,shrub,simple,spaced,sparsely,stem,stigma,strongly,styl,style,sulcate,surface,tall,tan,tear-drop,thin,tip,trichome,tub,tube,ud,uniseriate,unit,usually,vein,white,widest,x,yellow,yellowish,ympodial,young	
510	wfo-0001032165	exception_thrown	197	0	0	197	0	0.0		.25,.5,0.1,0.1-0.3,0.25-0.5,0.3-1,0.75-1,1-1.2,1-1.5,1-2,1.5-4,10-25,2-2.5,2.5-3.5,3-4,3-6,3.5-8.5,4-6,5-15,5-30-flowered,5-6,5-7,5-9.5,8-9,abaxial,acute,adaxial,along,anther,anthesi,apex,apparent,appearing,ba,bark,base,beginning,beneath,berry,broadly,brown,bud,calyx,capitate,center,closely,cm,continued,corolla,cucullate,cup-shaped,dark,deciduous,decurrent,deltoid,densely,denser,dia,differing,difoliate,distal,dry,due,dull,eaf,edged,edicel,eed,ellipsoid,elliptic,end,entire,erect,even,expansion,exserted,exsertion,filament,free,fruiting,geminat,glabrous,globose,golden,golden-puberulent,golden-pubescent,green,greyish-brown,immature,inflorescenc,inflorescence,later,lateral,leaf,less,like,live,lobe,lobed,lon,long,lower,main,major,margin,markedly,medial,middle,midrib,minor,minute,minutely,mm,near,nearly,nflorescence,node,obovate,occasionally,older,once-furcate,one,onto,opposite,orbicular,ovary,overlapping,ovoid-reniform,pair,pale,paler,papillo,papillose,pedicel,petiole,pitted,planar,plant,pore,poricidal,portion,presence,prominent,puberulent,purplish,rather,rest,ridge,ripe,rounded,ruit,scar,shaepd,shape,simple,single,size,slender,slightly,slow,small,smoot,spaced,specimen,stem,stigma,stout,straight,stripe,strongly,style,surface,swollen,tall,tapering,tear-drop,terminal,thickened,time,tinged,tip,tree,trichome,tub,tube,ud,uniseriate,unit,vein,white,widest,winged,woody,x,yellowish,ympodial,young	
511	wfo-0001032167	exception_thrown	163	0	0	163	0	0.0		.5,0.5-1,0.5-1.5,0.5-2.5,0.75-3,1,1-2,1-2-celled,1-2.5,1-3,1-5,1-7,1.5,10-20,10-35,12-20,2-4,2-7,2-foliate,3-6,3-7,4-10,4-6,5-15,7-10,abaxially,absent,abundant,acute,adaxiall,adaxially,along,anther,apex,appressed,axe,base,berry,blade,brown,calyx,cell,chartaceous,ciliate,closely,cm,common,connected,cordate,curved,decurrent,dehiscing,dense,densely,denser,diameter,dm,drying,eaf,eed,elliptic,elliptic-ovoid,emarginat,entire,explosively,few-,filament,flat,flattened,flower,forming,frui,fruit,geminat,geniculate,glabrous,globose,growt,growth,hair,held,herb,immature,interpetalar,larger,linear-lanceolate,lobe,long,longer,lower,lowermost,lying,many-branched,margin,maturing,maturit,membranaceous,mesocarp,mm,moderately,near,nearly,netlike,new,nfloresence,notch,oblong,obtuse,often,older,one-celled,orolla,pedicel,peduncle,per,petiole,placenta,pressure,projection,pubescen,pubescent,purple,rachi,raised,rotate,rounded,ruit,seed,semitransparent,shorter,slightly,small,smaller,sometimes,sparsely,staman,stamen,stigma,straight,style,surface,tal,tamen,tem,tissue,triangular,tube,twisted,two-celled,unbranched,unit,upper,usually,vary,vein,wall,watery,white,wid,woody,x,yellow,ympodial	
512	wfo-0001032176	exception_thrown	177	0	0	177	0	0.0		.5,0,0.42,0.5,0.5-0.7,0.5-0.75,0.5-1,0.8-1,0.8-6,1-1.2,1-10,1.5-1.6,1.5-2.5,1.5-6,1/2,100,2-3,2.5-10,3-15,3-3.5,3-4,3-7,5-6-celled,6,6-10,7,adaxially,adhering,along,anther,anthesi,apart,apex,apical,arising,attaining,attenuate,axil,axillary,basal,base,beak,becoming,berry,branched,calyx,capitat,cateniform,cell,cm,conical,containing,copiously,corolla,creeping,cucullate,densely,denser,diameter,drying,eaf,edicel,eed,ellipsoid,elliptic,epidermal,equal,especially,exserted,fallen,filament,filiform,flower,free,fruiting,glabrous,globose,green,greenish,grey-brown,greyish,hangin,herb,inflorescenc,lateral,leaf,leaflet,lengt,lengthening,like,lobe,lobed,log,long,long-papillose,lower,margin,minute,minutely,mm,nearly,nflorescence,nodding,node,obovate,obtuse,occasionally,often,onto,open,ovary,ovoid-reniform,pair,pale,papillose,pedicel,per,petiole,petiolule,pinnate,pore,poricidal,portion,projection,pubescent,quadrate,rachi,reflexed,rest,rooting,rounded,ruit,scar,seed,separate,simple,single,sinuous,size,slightly,slit,smaller,somewhat,soon,spaced,sparsely,stem,stigma,strait,strongly,style,tem,terminal,thickening,tightly,time,tip,tree,trichome,truncate,trunk,tub,tube,ud,ultimate,unevenly,unifoliat,uniseriate,unit,vein,wall,whit,white,winged,without,x,ympodial	
513	wfo-0001032187	exception_thrown	139	0	0	139	0	0.0		-11,-2.1,-4,-4.2,-5,-9,0.1â1.4,0.5,0.5-,0.5â1,0.6â1.3,1.1â3.2,1.3â1.8,1.6â2.1,1.8â2,1.8â2.8,100,1â1.7,22,24.6â26.3,2â9,3.1â3.5,3â3.2,3â4,5-merous,5â7,7â11,9,acuminate,acute,adherent,alyx,angular,anther,ape,apex,appressed,aromatic,base,berry,blade,branch,broadly,brown,brownish,changing,cm,consisting,corolla,cyme,dark,di-foliate,dia,dull,eaf,eed,eglandular,elliptic,entire,equal,erect,filament,flowered,forked,fully,geminat,glabrescent,globose,granule,green,hair,herb,hite,hooked,hydrated,leaf,light,lobe,long,lower,many,margin,marked,mature,mm,nflorescence,numerous,obovate,occasionally,ovate,pedicel,peduncle,penden,pentagonal,per,perfec,persistent,petiolate,petiole,plant,pollen,predominantly,presen,protruding,purple,rarely,ridge,ruit,running,sclerotic,short,simple,small,soft,sometimes,sparse,spreading,stage,stellate,stem,straight,style,sub-glabrous,texture,tinged,tooth,triangular,truncate,unit,well,widest,wing,yellow,yellowish,ympodial,Â±,Â±1,Âµm,Ã	
514	wfo-0001032206	exception_thrown	216	0	0	216	0	0.0		-0.8,-2,-20,-5,..,.2,.5,0,0.2,0.2â0.4,0.2â0.5,0.5â1,0.8â1.2,00â200,0â20,0â30,0â5,1,1.1â1.2,1.2â2.2,1.5â2,1.5â2.5,1/3,1/4â1/2,1/4â1/3,1/6,10â80,11â22,1â2,1â2.3,1â3,1â4,2.5â3.3,2.7â3.5,2â2.5,2â3,2â8,3.5â9,30â80,3â4,4.5â5.8,4â6,5-merous,5â15,5â20,5â6,5â8,5â9,6â10,6â15,6â8,7â10,8â20,abaxially,accrescent,acute,adaxially,alyx,andromonoecious,anther,apar,apart,apex,apically,apparently,approximately,armed,articulated,bark,base,berry,blade,bluntly,branched,broad-deltate,brow,calyx,chartaceous,clearly,cm,concolorous,connivent,covering,cream,cuneate,curved,dark,deltate,diameter,discolorous,distal,distance,drying,eaf,eed,elliptic,equal,erect,extending,filament,flattened,flattened-reniform,flower,foliaceous,free,fruit,fruiting,functionally,gently,glabrescent,glabrous,green,green-brown,hermaphroditic,heterostylous,infructescence,lateral,leaf,lengt,length,lobe,lobed,lobing,long,long-styled,longer,lowermost,mal,margin,marking,mature,maturity,mauve,midpoint,midvein,mm,moderately,nflorescence,obtuse,often,older,one,open,orange-brown,orolla,ovate,ower,pair,pale,pedicel,peduncle,pendent,pendulous,per,pericarp,petiole,plant,plurifoliat,poricidal,porrect,portion,prickle,primary,purple,rarely,ray,reflexed,scar,secondary,sessile,short-styled,shrub,side,slender,smooth,sometimes,spaced,sparsely,spherical,spreading,stalk,stalked,stellate,stellate-pubescent,stem,stout,straight,style,surface,tamen,tapering,tertiary,time,tip,toward,trichome,truncate,tube,uit,unarmed,ung,unit,usually,variously,vary,vein,venation,visible,weakly,white,wide,woody,yellow,yellow-orange,ympodial,young	
515	wfo-0001032209	exception_thrown	257	0	0	257	0	0.0		-11,-20,-30+,.5,0.3,0.5,0.5-1,1,1-1.5,1-2,1-2-celled,1-6,1.5,1.5-,1.5-2,1.5-2.5,1.5-6,10-13,100,12-16,2,2-3,2-3-lobed,2-5,2.5-,2/3,20-30,3-7,3-9,4,4-20,5-8,5-merou,6-15,6-8,absent,acute,adaxial,ag,along,alyx,anther,anthesi,apart,apex,apiculae,apparently,appearing,arching,ark,articulated,axi,basal,base,berr,berry,bilobed,blue,branch,branched,broadly,brown,bu,calyx,canopy,capitate,cast,cell,chartaceous,climbing,cm,colour,conical,connivent,conspicuously,cordate,coriaceous,corolla,cucullat,dark,deeply,deltate,dendritic,densely,denser,diameter,distally,distinct,dried,eaf,early,ecuador,eed,ellipsoid,elliptic,enlarged,entire,equal,erect,especially,evenly,exerted,filament,finely,flattened-reniform,fleshy,flower,flowering,free,fruiting,geminat,giving,glabrescen,glabrous,globose,groove,growth,hairy,hanging,hastate,held,hollow,ilament,inflorescence,keeled,lamina,large,lateral,leaf,leathery,leaving,length,lengthening,less,like,lobe,lobed,long,longer,longest,lower,margin,markedly,material,mean,mere,metallic,middle,midrib,midvein,minute,minutely,mixture,mm,narrowly,near,nearly,new,nflorescence,nipple,occasionally,often,older,one,orolla,ovate,pair,papillae,papillat,papillate,part,particularly,pedicel,peduncle,peg,pentagonal,per,perfect,pericarp,petiole,pinnately,pinnatifid,planar,plurifoliate,pointed,pore,poricidal,portion,primary,probably,puberulent,pubescence,pubescent,purple,red,reddish,rest,rhachi,rim,ripe,ruit,sagittate,scar,several,shiny,simple,sleeve,slit,small,sometimes,somewhat,spaced,sparser,spreading,stellate,stem,stigma,stout,style,surface,tapering,tem,terminal,testa,testal,thin,third,tightly,time,tiny,tip,trichome,truncate,tube,twinin,twining,ud,unequal,uniseriate,unit,upper,usually,variable,vary,vein,vine,violet,w,wall,weight,white,widest,within,woody,x,yellow,ympodial	
516	wfo-0001032232	success	137	102	48	89	54	0.35	0.1,2-2.6,anther,apex,attenuate,base,berry,calyx,cm,corolla,decurrent,distally,elliptic,filament,filiform,fruiting,glabrous,globose,green,leaf,less,lobed,long,lower,margin,middle,minutely,mm,narrowly,opposite,pale,papillose,pedicel,petiole,pore,revolute,shrub,simple,slightly,sparsely,stem,subshrub,surface,umbonate,undulate,unit,widest,winged	.5,0.25,0.5,0.5-1,0.6-3,0.8-1,1-3,1.8-2,18.8-27.5,2,20-100-flowered,3/4,4.8-7.3,5-6,?,abruptly,age,anthesi,ba,bark,becoming,clavate,closely,cup-shaped,dark-papillose,deflexed,dia,eaf,edicel,eed,erect,erose,evenly,exfoliatin,flower,free,greenish-brown,immature,irregular,lateral,lenticellate,light,lightly,lobe,long-acuminate,main,midrib,minute,nflorescence,node,occasionally,onto,ovary,overlappin,ovoid-reniform,packed,pair,paler,papillo,pitted,poricidal,portion,prominent,raised,reflexed,rounded,ruit,scar,shaped,short-styled,somewhat,stigma,straight,style,tall,tear-drop,ti,tip,translucent,tub,tube,ud,unifoliat,vein,way,wide,widening,woody,ympodial	appressed,articulation,bract,branching,breeding,broad-based,cell,colour,connective,form,fruit,growth,hair,heteromorphism,inflated,inflorescence,insertion,interjected,interpetalar,leaflet,length,marking,mature,modification,needle-like,null,odour,orientation,paired,pattern,placement,position,prickle,pseudostipule,rhizome,scale,shape,smell,spot,staman,stone,structure,symmetry,sympodial,system,texture,tissue,trichome,tuber,type,unifoliate,vegetative,xylopodia,zygomorphy
517	wfo-0001032233	exception_thrown	160	0	0	160	0	0.0		0-2,0.3-2,1-1.5,1-2,1-3,1.5-2.5,10-15,157,2-15,2-3,2-4,2-5.5,2-6,2.5-4,20-100+,25-40,3-15,3-4,3-4.5,3-5,3.5-4,4-18,4-5,4-7,4-foliat,5-16,5-6,6-25,8-12,abaxially,absen,absent,acuminate,acute,adaxial,adaxially,aggregate,almost,apart,ape,apex,articulated,axe,basal,base,bent,beyond,biglandula,blade,branched,brow,calyx,cell,chartaceous,cm,connective,connivent,convex,cordate,coriaceous,cylindrical,dark,densely,diameter,dilated,directed,distally,eaf,eed,ellipsoidal,entire,equal,especially,exceeding,exserted,flattened,fleischmann,fleshy,flower,fruit,glabrate,glabrescent,glabrous,glandular-puberulent,globose,green,laterally,leaving,lobe,lon,long,longitudinal,lower,margin,mm,moderately,narrowly,nflorescence,nther,oblong,obtuse,orange,orolla,ovate,ovoid,pedicel,pedicellar,peduncle,perfect,petiole,pore,present,projection,puberulen,puberulent,pubescent,purple,rachise,radiu,remnant,ruit,shallowly,shorter,simple,slightly,small,somewhat,spaced,sparsely,stamen,stellate,stigma,stone,stripe,style,subcoriaceous,subpeltiform,tal,tem,thecae,time,tip,tomento,toward,tree,triangular,truncate,tube,ud,unbranched,unit,vary,vein,white,wide,x,yellow,yellow-green,yellow-orange,ympodial	
518	wfo-0001032259	success	202	128	77	125	51	0.381	-4,.5,/4,1-2,1.5-4.5,1/3,1/6-1/5,4,4-6,5-30,almost,anther,apart,apex,apparently,base,berry,blade,brown,calyx,chartaceous,cm,conical,cordate,cuneate,dark,densely,difoliate,elongating,equal,erect,evenly,filament,flattened,fruit,fruiting,geminate,glabrous,green,hair,lateral,leaf,length,lobe,lobed,long,lower,margin,mature,maturity,mauve,mm,orange,pedicel,petiole,poricidal,prickle,pubescent,recurved,red,shrub,simple,spaced,sparsely,spherical,stellate,stellate-pubescent,stem,straight,surface,terminal,tip,trichome,unit,white,wide,young	/3,0,0-10,0-2,0-20,0-4,0-5,0.1-0.2,0.1-0.3,0.15-0.3,0.45-0.6,0.5-0.8,0.5-1.5,0.7-1.1,0.8-1.3,0.9-1.2,1-1.8,1-2.5,1/2,1/4-1/3,10-30,15-40,2-2.5,2-4,2-5,2.2-3,20-60,3-4,3/,4-5,4-9,5,5-merous,5.5-8,7-16,7-8,9-22,abaxial,abaxially,acut,acute,adaxial,alyx,apar,apically,articulated,bark,becoming,branched,broad-deltate,brownish,connivent,deltate,diameter,discolorous,distance,drying,dull,eaf,eed,extending,flattened-reniform,flower,free,fully,glabrescent,gland,green-brow,infructescence,longer,midpoint,midvein,minute,moderately,nflorescence,older,one,open,opening,orange-brown,orolla,oung,ovate,pair,peduncle,pendulous,per,perfec,pericarp,porrect,portion,prickl,prickly,primary,ray,reduced,rounded,ruit,scar,sessile,shorter,side,slender,smooth,sometimes,spreading,strongly,style,tamen,tapering,terete,tertiary,time,toward,tube,unarmed,vary,vein,venation,visible,way,woody,yellow,yellow-green,ympodial	appressed,articulation,bract,branching,breeding,broad-based,cell,colour,connective,corolla,form,growth,heteromorphism,inflated,inflorescence,insertion,interjected,interpetalar,leaflet,marking,mentioned,modification,needle-like,odour,orientation,paired,pattern,perfect,placement,pore,position,present,pseudostipule,rhizome,scale,shape,smell,spot,staman,stone,structure,symmetry,sympodial,system,texture,tissue,tuber,type,vegetative,xylopodia,zygomorphy
519	wfo-0001032260	success	216	135	83	133	52	0.384	/5,0-5,0-8,0.1,0.1-0.3,0.15-0.3,0.5-2,0.5-5,0.7-1.5,1/2,1/3-1/5,2-20,6-10,anther,apart,apex,apparently,base,berry,blade,branched,calyx,cell,chartaceous,cm,connivent,cuneate,curved,deltate,densely,difoliate,elongating,erect,filament,flattened,fruit,fruiting,glabrous,lateral,leaf,length,lobed,long,lower,margin,mature,maturity,mauve,midpoint,mm,pale,pedicel,petiole,poricidal,porrect,prickle,pubescent,purple,ray,red,reflexed,rounded,scandent,shallowly,shrub,simple,spaced,sparsely,spherical,stalk,stalked,stellate,stellate-pubescent,stem,subentire,surface,tapering,terminal,tip,trichome,unit,way,yellow	-0.5,-1.5,-10,-3,-8,.1,0-,0-0.5,0-10,0-20,0.1-0.4,0.2,0.2-0.5,0.4,0.5-0.8,0.6-0.8,0.7,0.8-1.1,1-1.7,1-3,1-5,1-6,1.2-1.7,1.5-4,1/3,1/3-1/2,10-30,2,2-4,2-5,2.5,2.5-3,2.5-3.5,3-10,3-5,3-8,3-9,4-,5-,5-20,5-merous,6-8,7-15,abaxial,abaxially,acuminat,acuminate,acute,adaxial,alyx,apar,apically,articulated,bark,broad-deltate,diameter,discolorous,distance,drying,dull,eaf,eed,elliptic,equal,extending,eye,flattened-reniform,flower,free,geminat,glabrescent,glabrou,gland,glaucous,globular,gray-brow,green-brown,infructescence,lobe,lon,long-styled,longer,midvein,moderately,naked,narrow-ovate,nflorescence,older,one,open,orange-brown,orolla,oung,outline,ovate,pair,peduncle,pendulous,per,perfec,pericarp,pit,portion,prickl,prickly,primary,raised,reduced,ruit,scar,sessile,shorter,side,slender,small,smooth,spreading,strongly,style,tamen,terete,tertiary,time,tube,variously,vary,vein,venation,visible,wide,woody,yellow-green,ympodial	appressed,articulation,bract,branching,breeding,broad-based,colour,connective,corolla,form,geminate,growth,hair,heteromorphism,inflated,inflorescence,insertion,interjected,interpetalar,leaflet,marking,mentioned,modification,needle-like,odour,orientation,paired,pattern,perfect,placement,pore,position,present,pseudostipule,rhizome,scale,shape,smell,spot,staman,stone,structure,symmetry,sympodial,system,texture,tissue,tuber,type,vegetative,xylopodia,zygomorphy
520	wfo-0001032264	exception_thrown	183	0	0	183	0	0.0		.2,.5,0.25-0.5,0.25-0.75,0.5-1,0.6-2.2,0.8-10,0.8-4,1-1.5,1.2-2,1.5-1.8,1.8-3,10-22,2-50-flowered,2-6,3,3-15,3-9,4.5-5,5-9,6-17,acuminate,acute,along,anther,anthesi,apar,apex,apiculate,appearing,ba,bark,base,berry,branched,broadly,bud,bullate,calyx,cell,cell-layer,closely,cm,corolla,cup-like,curling,deciduous,deflexed,densely,dia,differing,difoliate,dry,eaf,edicel,eed,elliptic,epidermal,exserted,filament,flattened-reniform,fleshy,flower,free,fruiting,geminat,glabrous,globose,gnarled,green,greyi,habitat,hair,incrassate,inflorescence,lamina,large,larger,lateral,layer,leaf,like,live,lobe,lobed,lon,long,lower,main,major,margin,material,middle,minor,minute,minutely,mm,multiseriate,narrowly,nearly,nflorescence,occasionally,often,older,one,opposite,ovary,overlapping,ovoid,pair,pale,papillo,papillose,parallel,pedicel,peeling,petiole,pitted,planar,plant,pointed,pore,poricidal,portion,primarily,prominent,pubescent,quite,raised,red-papillose,reddish,reddish-tan,revolute,rounded-deltoid,ruit,scar,scattered,several,shaped,sheet,sheltered,short,shrub,simple,size,slender,small-capitate,small-celled,somewhat,soon,spaced,sparsely,stem,stigma,straight,style,surface,tall,tapering,tear-drop,thick,time,tip,transversely,tree,trichome,trunk,tube,ud,uniseriate,unit,upper,vein,weak,white,whitish,wide,widest,woody,x,yellowish-brown,ympodial,young	
521	wfo-0001032274	success	192	166	114	78	52	0.594	0.15-0.2,0.5,0.5-0.7,0.5-1,0.9-1,1-1.5,1-3,2-7,3-4,3-6,3/4,<,acuminate,acute,anther,apex,apparently,arching,articulated,axillary,basal,base,berry,borne,branch,calyx,cell,cm,corolla,dendritic,densely,ellipsoid,elliptic,entire,filament,filiform,fleshy,fruiting,glabrous,globose,growth,highly,inflorescence,irregular,lanceolate,lax,leaf,lengthening,like,lobe,lobed,long,lower,margin,markedly,membranous,mm,non-reproductive,obtusely,occasionally,often,once-branched,one,pair,pale,pedicel,perfect,petiole,platform,plurifoliate,pore,poricidal,primary,pubescent,purple,red,reproductive,ridge,ridged,ripe,rounded,shape,shiny,shoot,short,shrub,simple,size,sleeve,slit,somewhat,sparsely,stellate,stem,strongly,suckering,surface,terminal,tinged,tip,trichome,truncate,two,uniseriate,unit,upper,usually,variable,vein,violet,visible,way,white,x	.5,0,0.5-1.5,0.7-1.8,1-1.2,1.5-2,2,2-3.5,3-10,3-5,5-7,5-merou,ag,alyx,anthesi,apiculate,appearance,ark,ba,brown,capitate,clustered,conical,connivent,deltate,diameter,distal,eaf,eed,exserted,flattened-reniform,flower,free,geminat,glabrou,green,grey,group,ilament,less,loosely,minute,minutely,new,nflorescence,nodding,older,orolla,papillo,peduncle,peg,pendan,per,pericarp,pitted,platfor,portion,puberulent,quadrate,reddish,reflexed,ruit,scar,small,sometimes,square,stigma,style,tem,testal,thin,tube,twinin,ud,vary,woody,yellow,ympodial	5-merous,age,appressed,articulation,bract,branching,breeding,broad-based,colour,connective,form,fruit,geminate,hair,heteromorphism,inflated,insertion,interjected,interpetalar,leaflet,length,marking,mature,modification,needle-like,null,odour,orientation,paired,pattern,placement,position,prickle,pseudostipule,rhizome,scale,smell,spot,staman,stone,structure,symmetry,sympodial,system,texture,tissue,tuber,twining,type,vegetative,xylopodia,zygomorphy
522	wfo-0001032276	exception_thrown	152	0	0	152	0	0.0		-,.25,.5,0.25-1.5,0.3-1,0.5-0.75,0.5-1,0.8-1,1,1-1.5,1-2,1.8-2,2-2.5,2.5-4,3-3.5,3-6-flowered,5-7,7-8,9-18,acute,along,anther,anthesi,apart,apex,attenuate,ba,bark,base,beneath,blade,broadly,brown,calyx,capitat,cm,converging,corolla,cup-shaped,curly-tipped,dark,decurrent,deflexed,deltoid,densely,dia,dry,eaf,edicel,eed,ellipsoid,elliptic,evenly,except,exserted,filament,filiform,free,fruiting,geminate,glabrous,globose,green,greyish-gree,lamina,later,lateral,leaf,like,lobe,lobed,long,long-pubescent,lower,main,margin,material,middle,minute,minutely,mm,narrowly,nearly,nflorescence,node,non-reproductive,obovoid,occasionally,older,onto,opposite,ovary,ovoid-reniform,pair,pale,papillose,pedicel,perhaps,petiole,pitted,plant,pore,poricidal,portion,prominent,pubescent,raise,raised,reflexed,remaining,rest,ruit,scar,shaped,short,shrub,simple,slender,slightly,somewhat,soon,spaced,sparsely,stem,stigma,straight,straw-colored,strongly,style,surface,tall,tapering,tear-drop,tip,triangular,trichome,tub,tube,ud,unifoliate,uniseriate,unit,vein,white,widely,widest,winged,woody,x,yellow,ympodial,young	
523	wfo-0001032277	exception_thrown	163	0	0	163	0	0.0		.5,0.1-0.5,0.2-0.6,0.75-1,0.8-3,1-1.1,1-1.2,1-1.5,1-2,1-5,1.5-1.8,1/2,10-14,2-2.5,2-4,2-6-flowered,3-3.5,3-9,5-6,8-9,acute,along,anther,anthesi,apex,apiculate,appear,appearing,area,auriculate,ba,bark,base,beneath,berry,blade,blunt,branched,bright,calyx,closely,cm,coriaceous,corolla,cup-shaped,deltoid,densely,dia,drooping,dry,eaf,edicel,eed,ellipsoid,elliptic,erect,exserted,filament,flattened-reniform,free,fruit,fruiting,geminat,glabrous,globose,gre,green,immature,impressed,incrassate,indentation,inflorescence,internodal,lateral,lax,leaf,like,lobe,lobed,long,lower,main,margin,mature,middle,minutely,mm,nflorescence,number,obscured,occasionally,older,opposite,ovary,overlapping,pair,pale,paler,papillae,papillose,partially,pedicel,petiole,pitted,pore,poricidal,portion,prominent,puberulent,pubescenc,pubescent,raised,reddish,remaining,rest,revolute,ripe,round,rounded,ruit,scar,shrub,simple,slende,slender,small,spaced,sparsely,specimen,spicy-fragrant,stem,stigma,straight,strict,strongly,styl,style,surface,tall,tapering,tip,translucent,trichome,truncate,trunk,tub,tube,two,ud,uniseriate,unit,varying,vein,virgately,way,white,widest,woody,x,yellow,yellowish-tan,ympodial,young	
524	wfo-0001032304	exception_thrown	249	0	0	249	0	0.0		-3,.6-1.2,.9-1.4,/20,0-120,0.2-0.3,0.3-1.5,0.5-3,0.5-4.5,0.9-1.3,1,1-3.5,1.1-2,1.2-2.3,1.2-3,1.3-2.1,1.5-3.2,1.6-1.9,1.8-4,1/2,1/3-1/2,1/5,1/8,10,18,2-4,2-4.2,2-5,2.5-19.5,2/3-3/4,21,3-10,3-15,3-20,3-4.5,3-6,3.2-3.8,3.2-5.5,4-7.5,44,5-6,5.5-9,7-27,7.5-12,9-13,abaxially,accrescent,acuminate,acute,adaxially,ag,along,anther,anthesi,apart,apex,apical-lateral,apparently,appressed-tomentose,articulated,ascending,axe,axillary,ba,bark,base,becoming,berry,blackish,blade,blunt-tipped,branch,branched,broadly,brown,brownish,bud,calyx,campanulate,capitat,chartaceous,closely,cm,conical,continued,corolla,dark,decurrent,dehiscing,deltoid,dendritic,dendritic-echinoi,dendritic-echinoid,densely,diameter,directed,distal,due,eaf,echinoi,echinoid,elliptic,entire,especially,exserted,extend,few-,few-rayed,filament,fleshy,flower,free,fruit,fruiting,glabrescen,glabrescent,glabrous,granular-tomentose,green,greenish,growth,hair,high,honeycombed,inserted,introrse,juvenile,large,lateral,leaf,least,length,lobe,lobed,long,long-,long-attenuate,long-stalked,longitudinal,lower,m.,main,many,many-rayed,margin,midvein,mixed,mm,mostly,multangulat,multangulate,nflorescence,oblong,obscured,obtuse,occasionally,often,older,opaque,orbicular,orolla,ovat,ovate,ovate-lanceolate,overlapping,pale,partly,pedicel,peduncle,perfect,petiole,plant,plurifoliate,pore,porrect-stellate,present,probably,pseudo-terminal,pubescent,rachi,rarely,rather,ray,relatively,reniform,reticulate-punctate,ripe,rotate-stellate,ruit,runk,scabridulous,seed,sessile,short,short-,short-stalked,shrub,side,simple,slit,small,somewhat,spaced,sparingly,spreading,stamen,stellate-tomentose,stem,stigma,strongly,style,subglobose,suborbicular,sulcate,suture,tamen,terete,testa,thick,thick-stalked,thin,thin-,thin-stalked,time,tomentose,tomentu,touching,toward,tree,triangular-ovate,tube,unarme,unarmed,unit,usually,vary,vein,velutinous,violet,way,white,whitish,wide,within,x,yellow,yellowish,ympodial,young	
525	wfo-0001032307	exception_thrown	153	0	0	153	0	0.0		.5,/3,0.2-0.5,0.4-1.3,1-1.5,1-2,1.5-2,1.5-5,10-20,2-5,2.5-12,2.5-3,2.5-3.5,3.5-4,30,4-8,5-12,5-25-flowered,7-18,?,abaxial,acute,adaxial,along,anther,anthesi,apar,apex,bark,base,berry,blade,body,branch,branched,brow,calyx,campanulate,capitate,christmas-tree-like,cm,congested,corolla,dark,deltate,dendritic,densely,dia,eaf,edicel,eed,either,ellipsoid,elliptic,elongate,erect,exserted,filament,flat,flattened-reniform,fleshy,free,fruiting,glabrate,glabrous,globose,green,growth,immature,incrassate,inflorescenc,inflorescence,later,lateral,leaf,like,lobe,lobed,lon,long,loose,lower,main,many,margin,middle,minute,minutely,mm,new,nflorescence,older,ovary,pair,pale,papillae,papillo,pedicel,petal,petiole,pitted,planar,plant,plurifoliat,pore,poricidal,portion,prominent,pubescent,reddish,reddish-brown,rest,ruit,scar,shaped,shrub,small,spaced,sparsely,stem,stigma,stout,strongly,style,surface,tall,tan,tear-drop,terminal,thick,thickened,time,tip,tree,tree-like,trichome,truncate,tub,tube,type,ud,unevenly,upper,variable,vein,way,white,wide,widest,within,woody,ympodia,young	
526	wfo-0001032308	exception_thrown	190	0	0	190	0	0.0		0-3,0.2-2.1,0.3-5,0.7-1,0.7-1.2,1-10,1-2,1.5-2.5,1.8-2.5,1.9-3,12-16,2,2-3,2-4,2-6,3-10,3-6,3.8-5,4-7,4-8,4.8-7.7,5-7,5-merou,6,6-11,8-9,abaxially,absent,acumen,acute,adaxially,ag,along,alyx,anther,apart,apex,apparently,articulated,axe,axillary,base,berry,blade,broadly,brownish,bud,capitat,cell,chartaceous,ciliate,clavate,cm,condition,connivent,cordate,corolla,covering,cuneate,deep,diameter,digestion,distal,dorsally,dot,drying,eaf,edge,eed,elliptic,enzyme,especially,exceeding,filament,flat,flower,folded,forked,fresh,fruit,geminat,generally,glabrou,glabrous,globose,greatly,green,green-white,greenish,hair,hair-like,hal,half,homostylous,honeycomb-shaped,interjected,invested,irregular,lanceolate,larger,lateral,leaflet,leave,lengthening,like,living,lobe,lobed,long,lower,make,margin,medium,membranous,midrib,minute,minutely,mm,much,mucilaginous,narrowly,nflorescence,non-glandular,obtuse,odd-pinnate,often,orbicular,orolla,ovate,ovoid,pair,pedicel,peduncle,pentagonal,perfect,petiole,petiolulate,petiolule,plant,plurifoliate,pore,poricidal,puberulent,pubescent,pure,removed,ripe,rounded,ruit,scattered,seed,sessile,seudostipule,shape,short,slightly,slit,spaced,specimen,stamen,ste,stem,stigma,straight,style,substellate,subtending,sympodial,tamen,terminal,testal,thick,throughout,tip,tri-,trichome,truncate,tube,typically,unit,usually,vary,varying,wall,wet,white,whitish,wide,x,yellow	
527	wfo-0001032335	success	215	111	56	159	55	0.26	acute,anther,apex,attenuate,base,berry,branched,branching,bright,c.,calyx,cell,chartaceous,corolla,ellipsoidal,entire,filament,fruiting,globose,growth,inflorescence,length,lengthening,lobed,lower,many,margin,membranous,mm,multangulate,orange,pedicel,perfect,petiole,plane,plurifoliate,pore,poricidal,porrect,shrub,simple,slit,small,somewhat,stellate,stem,surface,terminal,time,tip,tree,trichome,unit,way,white,âstellate	'',.2,.5,0,0.05,0.2,0.2â0.3,0.4,0.5,0.5â1,0.9â1,1.5â2,100,100+,10â12,12â15,15,16,1â1.2,1â1.5,1â3,2.5â3,2â10,2â2.5,2â5,3361,4â14,4â5,4â6-rayed,5-merou,5â6,6â19,6â6.5,7â10,>,abaxial,abaxially,acuminate,adaxial,ag,along,alyx,anthesi,apar,appearing,ark,articulated,axe,beneath,boh,capitate,center,closely,cm,connivent,covered,cup-shaped,deltate,densely,diameter,dichasia,discolorous,drying,eaf,eed,elliptic,elongate,equal,erec,evenly,exserted,fide,flattened-reniform,flower,free,fused,glabrous,gold,golden-brow,golden-yellow,gradually,half,ilament,impressed,lamina,less,like,lobe,long,loosely,markedly,midpoint,minute,minutely,moderately,narrowing,narrowly,near,new,nflorescence,nodding,older,onto,orolla,pair,pale,papillo,part,peduncle,peltate,per,pericarp,persistent,pitted,porrect-stellate,portion,primary,pubescence,pubescent,ray,reddish,reflexed,regularly,ripe,ruit,scar,scurfy,sessile,shiny,short,short-stalked,silvery,slightly,sometimes,spaced,sparsely,square,stigma,stout,strongly,stub,style,tal,tem,testal,thin,tube,ud,unevenly,upper,vary,varying,vein,visible,wide,woody,yellow,ympodial,â4	2.5-3,5-merous,actinomorphic,age,appressed,articulation,bract,breeding,broad-based,colour,connective,dichasial,form,fruit,hair,heteromorphism,inflated,insertion,interjected,interpetalar,leaf,leaflet,marking,mature,mentioned,modification,needle-like,none,odour,orientation,paired,pattern,placement,position,present,prickle,pseudostipule,rhizome,scale,shape,smell,spot,staman,stone,structure,symmetry,sympodial,system,texture,tissue,tuber,type,vegetative,xylopodia,zygomorphy
528	wfo-0001032337	success	225	120	69	156	51	0.307	0.5-3.5,1-2,2-14,4-17,abaxially,adaxially,anther,apex,axillary,base,basiscopic,berry,borne,bud,canescent,cell,cm,corolla,cuneate,decurrent,densely,distal,end,filament,forked,fruit,generally,globose,green,hair,half,herb,homostylous,interjected,leaf,leaflet,light,long,lower,margin,mm,oblique,odd-pinnate,often,paired,pedicel,pentagonal,petiole,plant,plurifoliate,pore,pubescent,rotate,rounded,side,singly,slightly,sometimes,sparsely,stem,subtending,terminal,tissue,tri-,tuber,typically,unit,violet,violet-purple	0,0.4-1.5,1,1-10,1-4,1.2-2.8,1.4-2,1.5,1.6-4,10,2,2-3.5,2-4,2-4.5,2-7,2.3-11.5,2.3-4.8,3-4,3-8,3.6-5,4-6,4-9,4.5-14.5,5-11,5-merou,8-10,8-17,9-21,9-29,acumen,acuminate,acute,ag,along,alyx,apart,apiculate,apparently,articulated,attenuate,axe,blade,broadly,brownish,capitat,chartaceous,ciliate,clavate,condition,connivent,cordate,covering,darker,deep,diameter,digestion,dorsally,dot,drying,eaf,edge,eed,elliptic,enzyme,erec,especially,exceeding,except,flat,flower,folded,frequently,fresh,geminat,glabrou,glabrous,greatly,green-white,greenish,hair-like,honeycomb-shaped,lanceolate,lateral,lengthening,like,living,lobe,make,membranous,middl,midrib,minutely,mottled,mucilaginous,nflorescence,obtuse,orbicular,orolla,ovate,ovoid,pair,peduncle,perfect,petiolulate,petiolule,poricidal,proximal,puberulent,purple,rarely,ray,reduced,removed,ripe,ruit,scattered,seed,sessile,seudostipule,short,size,slit,small,spaced,specimen,stamen,ste,stigma,stolo,straight,style,subequal,subglabrous,subsessile,tall,tamen,tem,tertiary,testal,thick,throughout,tip,tube,unpaired,unwinged,usually,vary,wall,wet,white,whitish,wide,wing,x,yellow,ympodial	appressed,articulation,bract,branching,breeding,broad-based,calyx,colour,connective,form,fruiting,geminate,growth,heteromorphism,inflated,inflorescence,insertion,interpetalar,length,marking,mature,middle,modification,needle-like,null,odour,orientation,pattern,placement,position,prickle,pseudostipule,rhizome,scale,shape,smell,spot,staman,stolon,stone,structure,surface,symmetry,sympodial,system,texture,trichome,type,vegetative,xylopodia,zygomorphy
529	wfo-0001032344	exception_thrown	157	0	0	157	0	0.0		0.2-0.5,1-1.3,1-3,1-4,1.5-4.5,1.5-6,1.6-2.4,10-29,2-2.8,2-3,2.2-4,2.8,3-5,3-6-foliat,3-7,3-8.5,3-9,3.5-6.5,4-11,4-8,5-10,6-15,9.5-21,abaxially,abruptly,absent,acumen,acuminate,acute,adaxially,apex,apical,apically,articulate,base,belo,bluish,branched,broadly,calyx,cell,cm,connate,corolla,covering,cuneate,cyme,dark,decurrent,dehiscent,diameter,dichasial,dichasially,digestion,diminishing,distal,dorsally,dot,eaf,ebracteate,edge,eed,elliptical,emoval,enzyme,exceeding,filament,flower,forked,generally,globo,globose,green,green-white,hair-like,half,herbaceous,honeycomb,inrolled,interjected,introrse,lateral,layeral,leaf,leaflet,living,lobe,lon,long,long-attenuate,lower,lunat,make,maturing,medium,mm,monochasial,mucilaginous,nflorescence,nther,oblique,odd-pinnate,often,orolla,ovate,ovoid,pair,pattern,pedicel,peduncle,perennial,perfect,petiole,petiolule,plan,plant,poricidally,proximal,puberulent,pubescent,purple,reveal,rotate,rotate-pentagonal,ruit,scarce,seed,sessile,seudostipule,short,size,slit,smooth,sometimes,specimen,stamen,stigma,straight,style,tal,tem,terminal,testal,thick,throughout,toward,tuber-bearing,typically,unit,vary,violet,wall,white,wide,yellow,ympodial,Â¼	
530	wfo-0001032354	exception_thrown	171	0	0	171	0	0.0		0,0-5,0.3,0.5-1,0.8-1,0.8-1.2,1-10,1-2,1-3,1-5,10-lobed,2,2-2.5,2.5-3,25,250-400,29,3-4,38/2,4-6,40-75,5-10,5-15,acuminate,acute,almost,angular,anther,anthesi,apex,aspect,aster,axi,axillary,base,becoming,berry,bilobed,branch,branched,broadly,brown,c.,calyx,campanulate,capitate,cell,cm,coarsely,colour,corolla,creating,cuneate,cut,decurrent,deep,deeply,dia,discoidal,distal,eaf,eed,effect,ellipsoid,except,exerted,facetted,filament,fleshy,flower,fork,general,glabrous,glandular,globose,gre,gree,green,greenish-ivory,greyish,hair,halfway,lanceolat,large,lasting,leaf,lengthening,linear,lobe,lobed,lower,maturity,midrib,minute,minutely,mm,narrow,nflorescence,obovate,obovoid,occasionally,oval,ovary,ovate,ovoid,pair,pale,pebble-shaped,pedicel,pedicellate,peduncle,pinnatisect,plurifoliat,pore,poricidal,puberulent,pubescent,rather,rh,rotate,rounded,rugose-reticulate,ruit,secondary,seedling,several,shape,shoot,shrub,simple,single,sinus,size,slightly,slit,small,smaller,smel,soft,somewhat,sparse,spreading,stellate,stem,stigma,stone,straight,strongly,style,surface,tall,tip,trichome,tub,ud,uniseriate,unit,unpleasant,usually,variable,vein,violet,wide,wing,within,wooded,woody,x,year,ympodial,young	
531	wfo-0001032358	exception_thrown	216	0	0	216	0	0.0		.1,.2,.3,.4,.5,/2,0,0.2-4,0.5-3,0.6-0.8,0.6-1,0.7-1,1-1.6,1-2,1.3-1.7,1.5-2,1.5-2.5,1/4-1/2,12-20,13-20,15-40,2,2-10,2-3,2-4,2-5,2.2-7.5,3-10,3-4,3.5-13,4-4.5,4-7,4-8,4-merous,4.5-5,abaxially,abscissio,acute,adaxially,along,another,anther,anthesi,apart,apex,appearing,armed,away,bark,basal,base,based,berry,branched,broad,brown,bulbous,calyx,capitate,cell,center,cm,cordate,corolla,cupuliform,curved,densely,diameter,difoliate,dorsal,drying,eaf,eed,entire,equal,erect,expanding,exserted,filament,flattened,flower,free,frui,fruit,fruiting,furcate,geminate,glabrescen,glabrescent,glabrous,globose,green,growth,heteromorphic,inflorescence,internodal,interpetalar,irregular,irregularly,lamina,leaf,left,lengthening,like,linear,lobe,lobed,long,longer,lower,lowermost,margin,margined,markedly,maturity,membranous,midpoint,midrib,midvein,minutely,mm,new,nflorescence,nodding,occasionally,often,older,one,orangish,ovate,ovoid,pair,pale,paler,papillat,papillate,part,pedicel,peduncle,peg,per,perfect,pericarp,persistent,petiole,pitted,planar,pore,poricidal,porrect,portion,present,prickle,prickly,primary,pubescent,purple,ray,red,reniform,rhachi,ripening,rotate-stellate,ruffly,ruit,scar,sessile,shiny,short,short-stalked,shrub,simple,sinuate,sinus,slightly,slit,small,sometimes,somewhat,space,spaced,sparsely,spreading,staman,stellate,stem,stigma,strongly,style,surface,tan,thick,thin,three,time,tip,trichome,tub,tube,tuberculate,two,type,ud,unevenly,unisexual,unit,upper,usually,vein,way,whitish,widely,x,yellowish,ympodial,zygomorphic	
532	wfo-0001032367	exception_thrown	231	0	0	231	0	0.0		-3,.2,.4,0-0.3,0.2â0.35,0.4-0.5,0.4â0.5,0.4â0.6,0.4â1,0.5â0.8,0.5â2,0.6,0.6â0.8,0.7-1.1,0.8,0.8â2,1-2,1-2.1,1.2,100-300,1â1.5,1â1.8,2,2-3-celled,2-4,2.2â2.5,2.2â2.8,2.5â3,2â2.5,3-5,3-celled,3.2â4,3â10,3â5,3â6,4,4â6.5,5-merous,5.5â6.9,5â18,6-8,6.8â8.2,7â10,8,abaxial,abaxially,accrescent,acicular,acute,adaxial,adaxiall,adaxially,also,alyx,anther,anthesi,apex,arme,around,axi,ba,base,berry,blade,branch,broad-based,calyx,capitate,cm,congested,conical,connivent,copious,cordate,cream,curved,dark,deciduous,densely,diameter,difoliate,directed,distall,eaf,eed,enlarged,entire,equal,erect,expand,fertile,filament,flattened-reniform,flower,free,fruiting,geminat,geminate,glabrous,gland-tipped,glandular-puberulent,globose,grading,green,greenish,hair,herbarium,heterostylous,hyaline,immature,inflorescence,infructescence,lanceolate,largest,lateral,layer,leaf,least,length,light,lobe,lobed,long,long-styled,longer,lower,lowermost,major,many,margin,maturity,membranous,mesocarp,midpoint,minute,minutely,mixed,mixture,mm,moderately,mottled,narrowly,nearly,nflorescence,obtuse,often,one,orolla,oung,ovary,ovate,pair,pale,papillat,pedicel,peduncle,per,petiole,pore,poricidal,portion,prickle,prickly,puberulent,pubescence,pubescent,rarely,ray,recurved,red-brown,rest,ruit,scarcely,scattered,secondary,sessile,shallow,short-styled,shorter,shrub,similar,simple,size,slender,small,smaller,somewhat,sparsely,specimen,spongy,spreadin,spreading,staminat,ste,stellate,stem,stigma,straight,style,suborbicular,surface,tall,tamen,tapering,terete,thick,tightly,time,tip,tooth,triangular,trichome,truncate,tube,twice,unarmed,unbranched,uniformly,uniseriate,unit,usually,variable,vary,vein,white,whitish,wide,yellow,ympodial,â15,â5	
533	wfo-0001032407	success	216	177	124	92	53	0.574	0-4,0.4-4,0.5-3,0.8,1-2,1.2-7,12,2-10.5,2.5-10.5,3.1-13.5,30,38,4-7,5,5-23,5-30,6,abaxially,absent,acuminate,adaxially,along,anther,apex,arranged,asymmetrical,axillary,base,basiscopic,bead,berry,blade,bud,cell,chartaceous,cm,coarsely,commonly,conical,corolla,dark,densely,distal,elliptic,elongated,filament,finely,forked,fruit,generally,glabrous,green,hair,half,herb,homostylous,interjected,lanceolate,larger,lateral,leaf,leaflet,lengthening,less,light,like,long,lower,margin,medium,membranous,middle,minute,mm,moniliform,multiple,narrow,necklace,obtuse,odd-pinnate,orbicular,ovate,pedicel,pentagonal,petiole,petiolule,plant,plurifoliate,pore,poricidal,proximal,puberulent,pubescent,purple,rarely,ripe,rotate,round,secondary,semierect,sessile,side,simple,slit,sparsely,stem,stolon,subtending,symmetrical,tall,terminal,tip,tissue,tri-,tuber,typically,unit,unwinged,usually,white,whitish,wide,wing,x	0.3-0.6,0.3-8,0.8-0.3,1-10,1-2.4,1-5,1.4-2.7,1.5-2.2,10-19.5,10-27,2-4,2.5-9,3-15,4-11,4-48,5-merou,7-9,8-10,acumen,ag,alyx,apart,apparently,articulated,attenuate,axe,brownish,capitat,ciliate,clavate,condition,connivent,covering,decreasing,diameter,digestion,drying,eaf,edge,eed,enzyme,erec,especially,exceeding,flower,folded,fresh,geminat,glabrou,gradually,green-white,greenish,hair-like,honeycomb-shaped,living,lobe,make,minutely,mottled,mucilaginous,nflorescence,orolla,ovoid,pair,peduncle,perfect,pubescen,ray,removed,ruit,seed,seudostipule,size,spaced,specimen,stamen,ste,stigma,straight,style,subequal,tamen,tem,testal,thick,throughout,tube,vary,wall,wet,yellow,ympodial	age,appressed,articulation,bract,branching,breeding,broad-based,calyx,colour,connective,erect,form,fruiting,geminate,growth,heteromorphism,inflated,inflorescence,insertion,interpetalar,length,marking,mature,modification,needle-like,null,odour,orientation,paired,pattern,placement,position,prickle,pseudostipule,rhizome,scale,shape,smell,spot,staman,stone,structure,surface,symmetry,sympodial,system,texture,trichome,type,vegetative,xylopodia,zygomorphy,Â¼
534	wfo-0001032465	exception_thrown	233	0	0	233	0	0.0		+,-10,-11,-14,-9,.2,.5,0,0.2,0.5-,0.5-2,1-,1-1.5,1-1.7,1-celled,1.2-1.5,1.5,1.5-1.8,1.5-2,1.5-5,1/3,2,2-2.5,2.5-5.5,25,3-3.5,3-4,3-5,3-8,3-9,4,5,5-7,5-8,5-merou,9,abaxial,acuminate,acute,ag,alyx,angled,anther,anthesi,apar,apex,apically,appearing,ark,articulated,axi,basal,base,berry,black,branched,brown,calyx,capitate,cell,ciliate,clasping,cm,commonly,conical,connivent,cordate,coriaceous,corolla,de,decreasing,deep,deeper,deeply,deltate,densely,diameter,distal,drying,eaf,edge,eed,ellipsoid,elliptic,elongate,entire,erect,exserte,filament,filiform,flattened,flower,free,fringe,fruiting,glabrescen,glabrous,gland,glandular,glandular-tipped,globose,green,greenish,growing,growth,half,ilament,included,inflorescence,irregular,irregularly,janeiro,larger,later,lateral,leaf,leaving,length,lengthening,like,lobe,lobed,long,loosely,lower,margin,mature,membranous,minute,minutely,mm,narrowly,new,nflorescence,nodding,occasionally,often,older,orolla,outline,ovate,pair,paired,papillate,papillo,pedicel,peduncle,peg,pendan,pentagonal,per,perfect,pericarp,petiole,pinnate,pinnatifid,planar,plurifoliat,pore,poricidal,portion,primary,puberulent,pubescent,purplish,reddish,reniform,reticulate,revolute,rio,ripe,ruit,scar,scattered,seed,shallow,shape,shiny,similar,simple,sinus,size,sleeve,slit,somewhat,spaced,sparsely,splitting,stellate-rotate,stem,stigma,strongly,style,subshrub,surface,tem,terminal,testal,thicker,thin,time,tiny,tip,toward,transparent,trichome,truncate,tube,tuft,twinin,twining,ud,unicellular,uniseriate,unit,upper,usually,variously,vary,varying,vein,vine,violet,wall,way,white,widest,woody,x,yellowish,ympodial,young,Â½	
535	wfo-0001032494	exception_thrown	163	0	0	163	0	0.0		.1,.4,.5,0.6-1,0.75-1,0.8-1,0.9-1.2,1-1.5,1.1-1.2,1.45-1.5,1.5,1.5-8,1.6-2,1.8-4.5,16.5-20.5,2.3-2.5,2.5,2.5-8,3-4,3.4-14.5,3/4,4-8,5-40,5-6.4,8-11,accrescent,acuminate,anther,anthesi,apart,apex,appearing,attenuate,axil,ba,bark,base,beginning,beneath,berry,brown,bullate,calyx,clavate,cm,corolla,decurrent,deflexed,dia,differing,difoliate,dry,eaf,edicel,eed,equal,evenly,except,expanded,exserted,filament,flattened-reniform,flowered,free,fruit,fruiting,furcate,geminat,geminate,glabrous,globose,greenish-yellow,incrassate,inflorescenc,lateral,lax,leaf,lenticellat,light,lobe,lobed,lon,long,lower,main,major,margin,material,middle,minor,minutely,mm,narrowly,nearly,nflorescence,node,occasionally,opposite,orange,ovary,ovate,ovoid,pair,pale,papillae,papillo,papillose,pedicel,petiole,pitted,planar,pore,poricidal,portion,prominent,proximal,pubescent,quite,raised,revolute,ridge,ruit,scar,shaped,shrub,simple,size,slender,slightly,small,somewhat,spaced,stem,stigma,straight,style,surface,tall,tan,tapering,tear-drop,tip,tree,triangular,trichome,tube,two-winged,ud,uniseriate,unit,upper,vein,venation,way,white,whitish-green,widest,winged,woody,x,yellow,ympodial,zig-zag	
536	wfo-0001032507	success	206	161	103	103	58	0.5	.2,1,abaxial,abaxially,absent,abundant,acuminate,acute,adaxially,adjacent,anther,apex,armed,base,berry,blade,blue,branched,broadly,calyx,cell,chartaceous,cm,collection,compound,confluent,corolla,curved,either,elliptic,entire,fifth,filament,flower,flowering,four,fruiting,glabrous,globose,green,hair,herbaceous,herbarium,highly,individual,interpetalar,lateral,leaflet,light,long,lower,major,margin,material,midrib,mm,oblong,occasionally,often,ovate,pedicel,perennial,petiole,pinnate,pinnately,pinnatifid,pistillate,plant,pore,poricidal,present,prickle,puberulent,pulp,purple,ranging,rarely,rotate-pentagonal,rounded,shape,side,simple,single,staminate,stem,stout,surface,terminal,time,tip,tissue,unbranched,unit,usually,variable,variously,vein,vine,white,wide,widest,woody,Ã	.5,/4,0.25,0.3,0.5,0.7-1.2,0.8,1.2-1.7,1.3,1.5â2,1.5â7,10â20,15â20,1â1.5,1â10,2,2.5â4,2.5â6,20â30,2â9,3â5,3â7,4â10,5â10,5â20,5â8,6,8â15,adaxiall,ag,alyx,anthesi,apiculate,articulated,becoming,brown,bud,campanulate,connivent,cream,deep,deltate,diameter,distally,distinct,dr.,eaf,eed,ellipsoid,elongating,equal,exserted,fertile,flattened-reniform,internode,larger,lengthening,lobe,lobed,longer,minutely,narrowly,nearly,nflorescence,observe,one,orolla,pale,papery,peduncle,pentagonal,pericarp,pitted,plurifoliat,purplish,quadrate,rachi,recurve,reddish,regularly,rugose,ruit,sinus,slender,slightly,slit,sometimes,spreading,stigma,straight,strongly,style,tamen,tear,testal,tube,unequal,unlobed,vary,way,wood,yellowish,ympodial	1-1.5,1.5-7,10-20,2.5-4,3-7,5-8,8-15,appressed,articulation,bract,branching,breeding,broad-based,colour,connective,form,fruit,growth,heteromorphism,inflated,inflorescence,insertion,interjected,leaf,length,marking,mature,modification,needle-like,null,odour,orientation,otherwise,paired,pattern,placement,plurifoliate,position,pseudostipule,recurved,rhizome,scale,smell,spot,staman,stellate,stone,structure,symmetry,sympodial,system,texture,trichome,tuber,type,vegetative,xylopodia,zygomorphy
537	wfo-0001032523	exception_thrown	200	0	0	200	0	0.0		-2,-5,.2,.5,/4,0-0.15,0-10,0-12,0-15,0-3,0.1-0.2,0.2,0.2-0.4,0.3-0.5,0.4-1,0.4-1.5,0.5-1,0.6-0.7,0.6-0.8,1-1.5,1-2,1-3,1-8,1.3-1.6,1.5-3,1/3-1/2,1/4-1/3,10-50,15-30,2,2-2.4,2-2.5,2-4,2-5.5,2.5-6,2.7-3,3-15,3-4,3.5-4,4-5-merous,4-7,5-12,5-20,6-10,6-20,6-8,abaxial,abaxially,acuminat,acuminate,acute,adaxial,alyx,ame,anther,apar,apart,apex,apically,apparently,articulated,bark,base,berry,blade,branching,brow,c.,calyx,cm,conical,connivent,cuneate,curved,deltate,diameter,discolorous,drying,dull,eaf,eed,elliptic,elongating,entire,equal,erect,evenly,filament,filiform,flattened-reniform,flower,free,fruit,fruiting,gently,glabrescent,glabrou,glabrous,green,hair,herbaceous,inflated,infructescence,lateral,leaf,length,lobe,lobed,lon,long,longer,lower,margin,mature,maturity,mauve,membranous,midpoint,minute,mm,moderately,multangulate,narrow-deltate,nflorescence,older,one,open,orange,orange-brown,orolla,oung,ovate,pair,pale,pedicel,peduncle,per,perfec,pericarp,perpendicular,petiole,plurifoliat,poricidal,porrect,portion,prickle,prickly,primary,ray,recurved,red,red-brown,reflexed,ruit,scandent,scar,secondary,sessile,shrub,simple,smooth,sometimes,spaced,sparsely,spherical,spreading,stalk,stalked,stellate,stellate-pubescent,stem,straight,strongly,style,subentire,surface,tamen,tapering,terete,terminal,tertiary,time,tip,trichome,tube,unarme,unarmed,unit,variously,vary,vein,venation,visible,way,weakly,wide,woody,yellow,ympodial,young	
538	wfo-0001032524	exception_thrown	205	0	0	205	0	0.0		1-10,1-2,1-2.5,1.5-2,1.5-4,10-35,12-13,120-210,14-50,2-3,2-5,2.5-8,25-90,3-4,3-5,3-8.5,3.5-4.5,4,4-5,4.5-5,4.5-8,5-6,5-9,5-merou,50-70,6-13,6-16.5,7-35,7-8,?,abaxially,acumen,acute,adaxially,ag,along,alyx,anther,apart,apex,apparently,arranged,articulated,ascending,attenuate,axe,axillary,base,bead,berry,blade,brownish,bud,capitat,cell,chartaceous,ciliate,clavate,cm,condition,connivent,corolla,covering,cuneate,densely,diameter,different,digestion,distal,dorsally,drying,eaf,edge,eed,elliptic,enzyme,erec,especially,exceeding,except,filament,flat,flower,folded,forked,fresh,fruit,geminat,generally,glabrou,glabrous,globose,grayish-green,greatly,green,green-white,greenish,hair,hair-like,hal,half,head,herb,homostylous,honeycomb-shaped,interjected,lanceolate,lateral,leaflet,length,lengthening,light,like,lilac,living,lobe,long,lower,make,margin,membranous,middle,midrib,minutely,mm,moniliform,mucilaginous,multicellular,multiple,narrowly,necklace,nflorescence,non-glandular,obtuse,odd-pinnate,often,orolla,ovate,ovoid,pair,pedicel,peduncle,pentagonal,perfect,petiole,petiolulate,petiolule,plant,plurifoliate,pore,poricidal,proximal,puberulent,pubescent,purple,reduced,removed,ripe,rotate,rounded,ruit,seed,sessile,seudostipule,short,silky,silvery-white,size,slit,spaced,specimen,stamen,ste,stem,stigma,stolon,straight,style,subequal,subtending,tall,tamen,tem,terminal,testal,tetralobulate,thick,throughout,tip,tri-,trichome,tube,tuber,typically,unit,unwinged,usually,vary,violet,wall,wet,whitish,x,yellow,ympodial	
539	wfo-0001032532	exception_thrown	161	0	0	161	0	0.0		0-.,0.3-2.5,1-1.5,1-4,1.5-2.6,1.5-3.2,1.5-4.3,13-52,15-30,2,2-,2-10,2-13,2-3,2.8-3.6,2.8-9.5,3-10,3-5,3-6-foliat,3.4-12.2,3.7-10,4-5.5,4.5,6,6-22,8-38,abaxiall,abaxially,absent,acumen,acuminate,acute,adaxially,apex,apical,apically,articulate,attenuate,base,branched,calyx,cell,cm,coarsel,conical,connate,corolla,covering,cuneate,cyme,deep,dehiscent,diameter,dichasial,dichasially,digestion,diminishing,distal,dorsally,eaf,ebracteate,edge,eed,elliptical,emoval,enzyme,exceeding,filament,finely,flat,flower,folded,forked,generally,globo,gradually,green,green-white,hair-like,half,herbaceous,honeycomb,interjected,introrse,lateral,leaf,leaflet,light,living,lobe,lon,long,long-attenuate,lower,lunat,make,maturing,medium,minute,mm,monochasial,mucilaginous,narrowly,nflorescence,nther,oblique,obtuse,odd-pinnate,often,orolla,ovate,ovoid,pair,pattern,pedicel,peduncle,perennial,perfect,petiole,petiolule,plan,plant,poricidally,proximal,pubescent,purple,reveal,rotate,rounded,ruit,seed,sessile,seudostipule,short,size,slit,specimen,stamen,stigma,straight,style,subequal,subsessile,tal,tem,terminal,testal,thick,throughou,throughout,tip,toward,tuber-bearing,typically,unit,vary,wall,wide,yellow,ympodial,Â¼	
540	wfo-0001032536	exception_thrown	254	0	0	254	0	0.0		-3,/3,0.5,1,1-2,1-2.5,1.3-2.2,1.5,10,10-20,10-30,10-50,100,13-24,14-16,2-3,2.5-3,20-22,20-25,20-50,3,3-3.5,3-6,4-6,4-8,4-9,5,5-6,5-8,5-merous,5.5-8,7-10,<,>,abaxial,abaxially,abruptly,acute,adaxial,adaxiall,adaxially,age,almost,along,alyx,angle,anther,anthesi,apar,apex,appressed,armed,around,articulated,axi,bark,basal-most,base,berr,berry,blade,bright,bristle,bristly,broad-based,broadly,brown,calyx,capitate,caudat,caudate,cell,chartaceous,clavate,clearly,cm,conical,coriaceous,cu,curved,dark,dbh,deeply,deltate,densely,denser,depressed,diameter,difoliate,directed,diverging,eaf,eed,elliptic,enlarged,entire,equal,evenly,fading,filament,flattened,flower,free,fruit,fruiting,geminate,glabrescent,glabrous,glandular,glandular-puberulent,globose,grayish,growth,halfway,hanging,heterostylous,inflorescenc,inflorescence,infructesecnce,interpetalar,irregularly,juvenile,lamina,lateral,leaf,leaf-opposed,leaving,length,like,lobe,lobed,long,long-stalked,long-styled,lower,margin,mature,maturity,membranous,midpoint,midrib,midvein,minute,minutely,mixed,mixture,mm,multangulate,multiseriate,narrowing,narrowly,near,new,nflorescence,number,oblique,occasionally,occurring,odor,older,olive-green,once-branched,open,orolla,oung,ovary,papillae,papillat,papillate,part,pedicel,peduncle,pentagonal,per,pericarp,petiole,plant,pore,poricidal,porrect,portion,potato,prickl,prickle,prickly,primary,prominent,protuberance,pubescent,purple,rarely,ray,reddish,reniform,reproductive,rough,ruit,scar,scattered,shallowly,short-,short-styled,simple,slender,slightly,small,smooth,soft,somewhat,spaced,sparsely,spreading,stalk,staminate,stellate,stellate-pubescent,stem,stigma,strongly,style,surface,tall,tamen,tapering,terete,terminal,thick,time,tip,tissue,tree,triangular,trichome,truncate,trunk,tube,unarmed,unequal,unit,upward,urceolate,usually,vary,vein,visible,way,white,wide,wood,woody,yellow-green,yellowish,ympodial,younger	
541	wfo-0001032542	exception_thrown	161	0	0	161	0	0.0		.25,.25-0.5,.5,.5-1,/4,0.5-1,0.7-1,1-1.3,1-1.5,1-2,1-5,1.5-3.5,10-15-flowered,10-28,2-3,2-3.5,2.5-5,3-4,3-5,4-7,4-9.5,4.5-5,5-8,abaxial,abaxially,acuminate,acute,adaxially,along,anther,anthesi,apex,apical,attenuate,axi,ba,bark,basal,base,beginning,berry,bluish-green,bright,brown,calyx,capitate,closely,cm,compact,conical,corolla,dark,deflexed,deltate,dendritic,densely,di,dia,differing,difoliate,distal,dry,eaf,edicel,eed,either,elliptic,elliptic-obovate,erect,exserted,filament,flattened-reniform,free,fruiting,geminat,glabrous,globose,golden,green,growth,incrassate,inflorescenc,inflorescence,lamina,later,lateral,leaf,less,like,lobe,lobed,lon,long,loose,lower,main,major,margin,minor,minute,minutely,mm,narrowly,near,new,nflorescence,older,opposite,ovary,overlapping,pair,papillo,pedicel,persisten,petiole,pitted,planar,pore,poricidal,portion,pubescent,reddish-brown,rounded,ruit,scar,shape,shaped,shining,shrub,simple,size,slender,slightly,small,somewhat,spaced,sparsely,stem,stigma,strongly,style,surface,swollen,tear-drop,tip,treelet,triangular,trichome,tub,tube,ud,unit,vein,way,wide,woody,x,yellow-green,yellowish,ympodial,young	
542	wfo-0001032564	exception_thrown	160	0	0	160	0	0.0		.05,.05-0.1,.1,.5,0.25-0.5,0.3-1,0.75-1,1-1.2,1-1.3,1-1.5,1-2,1.3-2.5,1.5,2-2.5,4-5,4-6-flowered,5.5-9,6-7,8-9,along,anther,anthesi,apar,apart,apex,arched,aspec,ba,bark,base,becoming,beneath,berry,branch,broadly,brown,bud,calyx,clavate,cm,conical,converging,corolla,dark,deflexed,deltoid,densely,dia,dry,eaf,edicel,eed,elliptic,except,expanded,exserted,extreme,filiform,flattened,flower,fresh,fruiting,geminate,giving,glabrate,glabrous,globose,golden,green,greenish-white,greyish-red,halfway,lamina,later,lateral,leaf,like,lobe,lobed,long,long-acuminate,lower,main,margin,material,member,middle,minute,minutely,mm,narrowly,nearly,nflorescence,node,non-reproductive,obovoi,often,older,one,open,opposite,ovary,ovate,ovoid-reniform,pair,papillo,papillose,pedicel,petiole,pitted,planar,point,pore,poricidal,projection,prominent,proximal,puberulent,raised,reflexed,ripe,rounded,ruit,scar,shaped,shiny,shrub,simple,slightly,small,soon,stem,stigma,straight,strongly,style,surface,tall,tan,tapering,tear-drop,thread-like,time,tiny,tip,trichome,truncate,tube,ud,unifoliate,uniseriate,unit,vein,widest,winged,woody,x,yellowish-green,ympodial,young	
543	wfo-0001032569	exception_thrown	164	0	0	164	0	0.0		.5,/3,0.5-10,0.8-1,1-1.2,1-1.5,1-2,1-4,1.2-5,1.5,1.5-2,1.7-2,2-3,2-4,4-18,4-8,5-6,5-60-flowered,7-27,7-9,abaxially,acute,adaxially,along,anther,anthesi,apex,apparently,appearing,axi,bark,base,bearing,berry,bilobed,branched,broadly,brown,bullate,calyx,cell,closely,cm,conical,corolla,corrugated,dark,decurrent,deflexed,dendritic,dense,densely,denser,dia,differing,difoliate,dry,drying,eaf,edicel,eed,ellipsoid,elliptic,erect,exserted,filament,flattened,fleshy,free,fruiting,geminate,glabrous,globose,golden,gra,green,incrassate,inflorescence,irregularly,later,lateral,lea,leaf,like,lobe,lobed,lon,long,los,lower,main,major,margin,matted,mature,middle,minor,minutely,mm,moderately,nflorescence,obscured,occasionally,onto,open,opposite,otherwise,ovary,ovate,pair,paler,papillo,papillose,pedicel,pericar,petiole,pitted,planar,pore,poricidal,portion,present,pubecsence,pubescent,reniform,rich,ruit,scar,shaped,shrub,simple,size,somewhat,spaced,sparsely,splitting,stem,stigma,stone,strongly,style,surface,tall,tear-drop,thick,time,tip,triangular,trichome,tub,tube,tuft,ud,unifoliate,unit,vein,waxy,way,white,widest,woody,x,ympodial,young	
544	wfo-0001032576	exception_thrown	229	0	0	229	0	0.0		-10,-12,-2,-2/3,/4,/5,0,0-1.5,0-3,0-30,0-5,0.1,0.1-0.15,0.1-0.2,0.1-0.25,0.3-0.5,0.3-0.7,0.5-1,0.5-1.5,0.5-2,0.5-4,0.8-1.2,0.8-1.4,0.8-2,1-3,1-4,1.2-1.8,1.5-2,1.5-2.3,1.5-7.5,1.8-2.5,1/2,1/3,1/3-1/6,2-10,2-3,2-4,2-5,2.5-3,2.5-4,3-14,4,4-,4-5-merous,4-6,4-6.5,5-30,6-8,7-8,abaxially,acuminat,acute,alyx,anther,apar,apart,apex,apically,apparently,articulated,ascendant,ba,bark,base,berry,blade,branched,branching,bright,brow,brown,brown-green,calyx,cell,chartaceous,cm,concolorous,conical,cuneate,curved,deltate,densely,diameter,difoliate,distance,drying,dull,eaf,eed,ellipsoid,elongating,entire,equal,erect,evenly,extending,eye,faint,filament,flattened,flattened-reniform,flower,free,fruit,fruiting,geminat,glabrescent,glabrous,gland,glandular,globular,gray,green,hair,herb,herbaceous,infructescence,lanceolate,lateral,leaf,length,lobe,lobed,long,longer,lower,margin,mature,maturity,membranous,midpoint,midvein,minutely,mm,moderately,naked,narrow-deltate,narrow-ovate,near,nflorescence,obovate,obtuse,often,older,one,open,orange-brown,orolla,oung,outline,ovate,pair,pale,pedicel,peduncle,per,perfec,pericarp,petiole,pit,poricidal,porrect,portion,prickl,prickle,prickly,primary,purple,raised,ray,red,red-green,reduced,reflexed,reticulate,rounded,ruit,scandent,scar,sessile,shiny,short,shorter,shrub,side,simple,slender,slightly,small,smooth,sometimes,spaced,sparsely,spherical,spreading,stalk,stalked,stellate,stellate-pubescent,stem,straight,style,surface,tamen,tapering,terminal,tertiary,time,tip,trichome,tube,unarmed,unit,upper,usually,variously,vary,vein,venation,visible,way,white,wide,woody,yellow,yellow-green,yellow-orange,ympodial,young	
545	wfo-0001032595	success	200	156	101	99	55	0.505	-25,0-,0.5-3.5,1-2.5,1-3,1.5-2,2-4,2.3-24,3-10,3-12,3-4-foliate,4-25,4-5,abaxially,also,anther,apex,articulated,basal,base,blade,branch,branched,brownish-purple,calyx,cell,cm,connective,connivent,cordate,cream,deeply,dense,densely,directed,distally,dull,eglandular,ellipsoidal,entire,filament,finely,fork,forked,fruit,fruiting,fusiform,geminate,glabrous,glandular,greenish,hair,homostylous,lanceolate,leaf-opposed,leaving,lobe,long,longitudinal,loosely,lower,margin,mature,mm,moderately,near,oblique,often,opening,pale,pedicel,pedicellar,petiole,pilose,pore,puberulent,purplish,rarely,remnant,shrub,simple,single,slit,small,sparsely,spreading,stellate,stone,subcoriaceous,tall,time,tree,truncate,trunk,unbranched,unit,vein,violet,wide,x,yellow	-20,-pilose,0.5-1,1,1-2,1-6,1-6.5,1.5-2.5,1.5-4.5,1.5-5,12-16,15-25,15-40,2-3,25-40,3-4,3-5,4-7,5-6,5-merou,6-7,9-14,accrescen,acuminate,acute,adaxially,aggregate,along,alyx,apart,ape,apical,apiculate,axe,brownish,ciliat,coriaceous,crow,cucullate,deltate,denser,diameter,dilated,eaf,eed,equal,exceeding,flattened,flower,free,gland,larg,lon,m.,major,midrib,narrowly,nflorescence,orolla,ovate,ovoid,part,peduncle,per,perfect,pilo,produced,prominent,pseudohair,pubescent,purple,rachi,reniform,rugulose,ruit,shallow,shorter,side,slightly,spaced,stamen,stigma,strongly,style,swelling,tamen,tem,thecae,tip,tomentose,toward,triangular,tube,two,ud,umbrella-shaped,vary,white,ympodial	5-merous,accrescent,appressed,articulation,bract,branching,breeding,broad-based,colour,corolla,crown,form,growth,heteromorphism,inflated,inflorescence,insertion,interjected,interpetalar,large,leaf,leaflet,length,marking,modification,needle-like,null,odour,orientation,paired,pattern,placement,position,prickle,pseudostipule,rhizome,scale,shape,smell,spot,staman,stem,structure,surface,symmetry,sympodial,system,texture,tissue,trichome,tuber,type,vegetative,xylopodia,zygomorphy
