	coreid	status	nwords_original	nwords_result	nwords_val	nwords_recovered	nwords_omitted	nwords_created	nwords_recovered_val	nwords_created_val	common_words	original_only	result_only	common_words_val	val_only
0	wfo-0001025652	success	156	154	76	101	55	53	75	1	.3,.5,0.5-1,1,1-1.5,1.5-2,10-20,15-17,15-19,2-5,2-6,20-50,3-3.5,3-5-flowered,4,4-6,4-7,9-11,abruptly,acuminate,acute,anther,anthesi,apex,bark,base,bilobed,calyx,campanulate,cm,connate,corolla,decurrent,densely,elliptic,filament,fleshy,flower,fruit,furcate,glabrate,glabrous,green,greyish,growth,lateral,leaf,lobed,lower,main,margin,matte,minor,minutely,mm,narrowing,nearly,new,occasionally,opposite,ovary,ovoid-reniform,pair,pale,paler,papillose,parallel,pedicel,petiole,pinkish-grey,pitted,planar,plant,pore,poricidal,red-papillose,shape,shaped,shiny,shrub,simple,size,small,stem,stigma,strongly,style,surface,tan,tear-drop,tightly,tip,tree,tube,unit,vein,white,wing,winged,x,young	2-3,3-5,appearing,blade,broad,closed,closely,completely,dia,differing,difoliate,dry,eaf,edicel,eed,emerge,envelope,free,geminat,greyi,growing,irregular,like,live,lobe,lon,long,major,middle,minute,nflorescence,older,one,onto,overlappin,ovoid,papillae,papillo,portion,rather,ry,scar,soon,spaced,specimen,straight,tall,tapering,tear,thick,thicker,ud,wider,widest,ympodial	abaxial,adaxial,articulation,bract,branching,breeding,broad-based,cell,colour,connective,form,hair,height,heteromorphism,inflorescence,insertion,interjected,interpetalar,leaflet,length,marking,mature,na,needle-like,number,odour,orientation,pattern,placement,position,prickle,pseudostipule,rhizome,scale,seed,smell,spot,staman,stone,structure,symmetry,sympodial,system,texture,tissue,trichome,tuber,type,vegetative,venation,width,xylopodia,zygomorphy	.3,.5,0.5-1,1,1-1.5,1.5-2,10-20,15-17,15-19,2-5,2-6,20-50,3-3.5,3-5-flowered,4,4-6,4-7,9-11,abruptly,acuminate,acute,anthesi,base,bilobed,calyx,campanulate,cm,connate,decurrent,densely,elliptic,fleshy,furcate,glabrate,glabrous,green,greyish,lateral,leaf,lobed,main,matte,minutely,mm,narrowing,nearly,occasionally,opposite,ovoid-reniform,pair,pale,paler,papillose,parallel,pinkish-grey,pitted,planar,poricidal,red-papillose,shaped,shiny,shrub,simple,small,strongly,tan,tear-drop,tightly,tip,tree,tube,vein,white,winged,x	na
1	wfo-0001025657	success	239	110	51	67	172	43	50	1	/3,1-1.6,1.3-2,2-10,2.7-4.3,accrescent,anther,apex,articulated,ascending,base,berry,blade,bluish,blunt-tipped,branched,brown,calyx,chartaceous,cm,conical,cordate,corolla,dark,dried,entire,filament,fleshy,fruit,fruiting,hair,leaf,length,long,lower,margin,mixed,mm,multangulate,oblong,orbicular,pedicel,petiole,plurifoliate,pore,poricidal,pseudo-terminal,ray,ripe,scented,sessile,short-stalked,shrub,simple,somewhat,stellate,stem,strongly,surface,tip,tomentose-pubescent,tree,unarmed,unit,white,x,yellow	-2,0.1-0.4,0.2-0.4,0.5-2.5,1-1.1,1-1.3,1-3,1.2-1.5,1.5-1.8,1.7-1.9,12x,2-3.5,2.2-5.5,2.5-9.3,2/3,25-60,3-4,3-4.8,3-6,3.2-6,4-4.4,4-4.5,4-7,5-14,5-16,6-12,6-8,6.5-10,7-27,7-9,7-9.5,8-10.5,8.3-12,abaxially,acute,adaxially,ag,also,anthesi,apart,apparently,appearing,ark,around,axe,axillary,ba,branch,broadly,bud,capitat,central,closely,cylindrical,deltoid,dendritic-multangulat,dendritic-multangulate,dense,densely,diameter,directed,distally,due,eaf,earl,edge,eed,elliptic,especially,evident,exerted,expanded,exserted,farinose,few-rayed,flower,free,glabrous,glandula,glandular,granular,green,half,inserted,lanate-pubescent,lanceolate,lateral,lengthening,light,lobe,lobed,long-stalked,longitudinal,m.,magnification,main,midrib,minutely,narrowly,nearly,nflorescence,obtuse,occasional,often,older,open,orolla,ovat,ovate,ovate-lanceolate,overlapping,pale,part,parted,partly,peduncle,perfect,persistent,persistently,porrect-stellate,present,pubescence,pubescent,rachi,reportedly,reticulate-punctate,ruit,semi-ovate,short,short-,side,slightly,slit,soft,spaced,splitting,stamen,stellate-pubescent,stigma,stipitate-glandular,stipitate-multangulate,style,subcampanulate,subcoriaceous,suborbicular,suture,tall,tamen,tan,terete,thick-stalked,thickened,thin-stalked,time,tomentose,tomentum,transparent,tube,two-third,ud,unarme,upper,usually,vary,vein,velutinous-pubescent,way,weakly,wide,yellowish,ympodial,young	articulation,bract,branching,broad-based,cell,colour,form,growth,heteromorphism,inflorescence,insertion,interjected,interpetalar,leaflet,marking,mature,na,needle-like,odour,orientation,paired,placement,position,prickle,pseudostipule,rhizome,scale,shape,smell,spot,staman,stone,structure,symmetry,sympodial,texture,tissue,trichome,tuber,type,vegetative,xylopodia,zygomorphy	/3,1-1.6,1.3-2,2-10,2.7-4.3,accrescent,articulated,ascending,base,berry,blade,bluish,blunt-tipped,branched,brown,chartaceous,cm,conical,cordate,dark,dried,entire,fleshy,length,long,mixed,mm,multangulate,oblong,orbicular,plurifoliate,poricidal,pseudo-terminal,ray,ripe,scented,sessile,short-stalked,shrub,simple,somewhat,stellate,strongly,tip,tomentose-pubescent,tree,unarmed,white,x,yellow	na
2	wfo-0001025669	success	214	135	93	116	98	19	89	4	.5,0-7,0.1-0.3,1,1-10,1-2,1-2.2,1-4,1.3-4.2,1.4-2.5,13-35,2-3,2-4,2.2-6,2.2-6.5,2.4-7,3-5,3-7,4-6,9-24.5,absent,anther,base,blade,blue,broadly,brownish,cell,chartaceous,ciliate,clavate,cm,condition,corolla,diameter,digestion,dorsally,drying,edge,end,enzyme,extra,filament,flat,flower,folded,fresh,fruit,glabrous,globose,green,greenish,hair,herb,homostylous,honeycomb-shaped,interjected,lanceolate,lateral,leaflet,lengthening,lobe,long,margin,membranous,midrib,minute,minutely,mm,moderately,monochasium,mottled,obovate,odd-pinnate,one,orbicular,ovoid,pair,pedicel,peduncle,petiole,placed,plant,pore,poricidal,puberulent,pubescent,purple,rarely,removed,ripe,rotate,scale-like,seed,size,slightly,slit,sometimes,stem,stigma,straight,streaked,style,subglabrous,terminal,testal,tinged,tip,tube,tuber,typically,wall,white,whitish,wide,x	0-1,0-5,0.8-2.4,1-3,1.6-4.4,2,5-merou,abaxially,absen,acumen,acuminate,acute,adaxially,ag,along,alyx,apart,apex,apparently,articulation,axe,berry,capitat,clearly,connivent,contracted,covering,cuneate,decurrent,discussion,distal,distinct,eaf,eed,elliptic,erec,especially,exceeding,except,flowered,forming,geminat,glabrou,greatly,green-white,hair-like,half,highly,larger,like,living,lower,make,mucilaginous,multicellular,near,nflorescence,oblique,obtuse,often,orolla,ovate,perfect,petiolulate,petiolule,plurifoliate,proximal,reduced,rosette,rounded,ruit,see,sessile,seudostipule,short,single,spaced,species,specimen,stamen,ste,stolo,subequal,tall,tamen,tem,thick,throughout,tri-,truncate,unbranched,unequal,unit,unwinged,vary,wet,yellow,ympodial	5-merous,age,arrangement,calyx,capitate,colour,form,growth,height,inflorescence,leaf,length,placement,pseudostipule,shape,spacing,stolon,texture,type	.5,0-7,0.1-0.3,1,1-10,1-2,1-2.2,1-4,1.3-4.2,1.4-2.5,13-35,2-3,2-4,2.2-6,2.2-6.5,2.4-7,3-5,3-7,4-6,9-24.5,absent,base,blue,broadly,brownish,chartaceous,ciliate,clavate,cm,condition,corolla,digestion,dorsally,drying,end,enzyme,extra,flat,flower,folded,fresh,glabrous,globose,green,greenish,herb,homostylous,honeycomb-shaped,lanceolate,lateral,lengthening,long,membranous,minute,minutely,mm,moderately,monochasium,mottled,obovate,odd-pinnate,one,orbicular,ovoid,placed,pore,poricidal,puberulent,pubescent,purple,rarely,removed,ripe,rotate,scale-like,slightly,slit,sometimes,straight,streaked,subglabrous,tinged,tip,typically,wall,white,whitish,wide,x	5-merous,age,capitate,stolon
3	wfo-0001025697	success	181	174	89	114	67	60	85	4	-9,0-14,0.15-0.75,0.8-2,1-1.7,1-2,1-3,1.5-1.8,1.7-8.6,10-26,2-2.6,2-4,2-6,25-35,3-10,3-4,3-5,3-6,3.3-11,4-7.5,5.5-11.5,6.5-13.5,acumen,anther,apex,asymmetric,attenuate,base,basiscopic,berry,blade,blue,brownish,cell,clavate,cm,condition,coriaceous,corolla,dark,deep,diameter,digestion,distal,dorsally,drying,edge,elliptic,enzyme,filament,flat,flower,folded,forked,fresh,fruit,glabrescent,glabrous,globose,green,greenish,hair,half,herb,high,homostylous,honeycomb-shaped,interjected,lanceolate,lateral,leaf,leaflet,light,lilac,lobe,long,lower,medium,mm,odd-pinnate,ovate,ovoid,pair,pedicel,peduncle,pentagonal,petiole,plant,plurifoliate,pore,poricidal,purple,removed,rotate,rounded,seed,sessile,short,side,size,stigma,straight,stripe,style,terminal,testal,tip,tissue,tri-,tube,unit,wall,whitish,x	0.6-3.5,2-10.5,5-merou,abaxially,acuminate,acute,adaxiall,adaxially,ag,alyx,apart,apparently,articulated,axe,axillary,bud,capitat,connivent,covering,decreasing,decurrent,eaf,eed,erec,exceeding,geminat,generally,glabrou,green-white,hair-like,hal,lengthening,linear,living,make,mucilaginous,nflorescence,orbicular,orolla,perfect,petiolulate,rachi,ripe,ruit,seudostipule,slightly,slit,spaced,specimen,stamen,subequal,subglabrou,subtending,tall,tamen,tem,thick,throughout,toward,typically,unwinged,usually,vary,wet,wood,yellow,ympodial	abaxial,adaxial,appressed,arrangement,articulation,bract,branching,breeding,broad-based,calyx,capitate,colour,connective,form,fruiting,growth,height,heteromorphism,inflated,inflorescence,insertion,interpetalar,length,margin,marking,mature,modification,na,needle-like,odour,orientation,ovary,paired,pattern,placement,position,prickle,pseudostipule,rhizome,scale,shape,smell,spacing,spot,staman,stem,stone,structure,subglabrous,surface,symmetry,sympodial,system,texture,trichome,tuber,type,vegetative,woody,xylopodia	-9,0-14,0.15-0.75,0.8-2,1-1.7,1-2,1-3,1.5-1.8,1.7-8.6,10-26,2-2.6,2-4,2-6,25-35,3-10,3-4,3-5,3-6,3.3-11,4-7.5,5.5-11.5,6.5-13.5,asymmetric,attenuate,basiscopic,berry,blue,brownish,clavate,cm,condition,coriaceous,dark,deep,diameter,digestion,distal,dorsally,drying,elliptic,enzyme,flat,folded,forked,fresh,glabrescent,glabrous,globose,green,greenish,hair,half,herb,high,homostylous,honeycomb-shaped,lanceolate,lateral,light,lilac,long,medium,mm,odd-pinnate,ovate,ovoid,pentagonal,plurifoliate,poricidal,purple,removed,rotate,rounded,sessile,short,side,straight,stripe,terminal,tip,tissue,tri-,wall,whitish,x	capitate,na,subglabrous,woody
4	wfo-0001025699	success	181	118	53	68	113	50	51	2	1-1.5,1-2.5,1-3,1.5-2,1/3,4-5,acute,age,anther,apex,attenuate,base,becoming,berry,branching,calyx,cm,corolla,crystal,cup-shaped,densely,ellipsoid,entire,filament,fruiting,glabrous,globose,green,growth,inflorescence,leaf,leaf-opposed,leafy,lengthening,lobed,lower,margin,markedly,minutely,mm,papillose,pedicel,perfect,petiole,plurifoliate,pore,poricidal,rounded-sagittate,sand,shoot,short,simple,slightly,slit,somewhat,stem,surface,tangled,time,tip,tree,trichome,unit,way,white,white-spotted,x,½	.2,.5,0.5,1,1-2,1.5,10,15-20,2,2-2.5,2-6,2cm,3-15,3-3.5,3-5.5,3-8,499,5-8,5-winged,5.5-14,8-9,abaxially,absent,adaxially,almost,anthesi,apart,apparently,appearing,articulating,bark,brown,c.,campanulate,capitate,completely,conical,conspicuously,continuing,corrugate,dark,darker,deltate,diameter,difoliate,dorsal,dry,drying,eaf,eed,elliptic,erect,exerted,face,fide,flower,free,glabrou,grey-brown,immature,included,inclusion,inflorescenc,irregularly,lanceolate,leaving,less,lobe,midrib,narrowly,new,nflorescence,nodding,older,one,onto,ovary,oxalate,pair,pale,papillat,peduncle,peg,penden,per,portion,primary,red,reddish,reniform,reticulate-pitted,rounded,ruit,scar,small,spaced,stearn,stigma,straight,strongly,style,thickened,triangular,tube,ud,vein,wide,wing,winged,woody,yellow,ympodial,young	appressed,articulation,bract,breeding,broad-based,cell,colour,connective,corrugated,form,fruit,hair,heteromorphism,inflated,insertion,interjected,interpetalar,leaflet,length,marking,mature,modification,na,needle-like,odour,orientation,paired,pattern,placement,position,prickle,pseudostipule,rhizome,scale,shape,smell,spot,staman,stone,structure,symmetry,sympodial,system,texture,tissue,tuber,type,vegetative,xylopodia,zygomorphy	1-1.5,1-2.5,1-3,1.5-2,1/3,4-5,acute,age,attenuate,base,becoming,berry,cm,crystal,cup-shaped,densely,ellipsoid,entire,glabrous,globose,green,leaf-opposed,leafy,lengthening,lobed,markedly,minutely,mm,papillose,perfect,plurifoliate,pore,poricidal,rounded-sagittate,sand,shoot,short,simple,slightly,slit,somewhat,tangled,time,tip,tree,trichome,way,white,white-spotted,x,½	corrugated,na
5	wfo-0001025700	success	189	174	96	116	73	58	93	3	0-16,0.30-2.0,0.5-2,0.7-2.7,0.8-2.6,1-3,1.5-2,10-40,10.5-12,15-40,2-12,2-7,2.5-4,3-8,3.5-10.5,4-5,5-15,5-20,5.3-17.5,5.5-18,5.5-8,9-31,abaxially,acumen,adaxially,anther,apex,articulated,attenuate,axillary,base,berry,blade,brownish,bud,cell,chartaceous,clavate,cm,condition,corolla,covering,diameter,distal,dot,drying,filament,flower,forked,fresh,fruit,glabrescent,glabrous,globose,green,green-white,greenish,hair,hair-like,half,herb,high,homostylous,interjected,lanceolate,lateral,leaf,leaflet,lilac,lobe,long,lower,make,medium,mm,mucilaginous,narrowly,odd-pinnate,ovoid,pedicel,peduncle,pentagonal,petiole,petiolulate,plant,plurifoliate,pore,poricidal,purple,ripe,rotate-pentagonal,rounded,seed,short,size,sometimes,stigma,straight,style,subtending,terminal,testal,thick,throughout,tip,tissue,tri-,tube,unit,unwinged,wall,wet,white,whitish,winged,x	0.8-4,1-2,1.1-2.3,3-4,3.7-8.6,5-merou,acuman,acuminate,acute,ag,alyx,apiculate,apparently,asymmetric,axe,basal,basiscopic,capitat,connivent,considerably,decrease,decreasing,digestion,dorsally,eaf,edge,eed,elliptic,enzyme,erec,exceeding,except,flat,folded,geminat,generally,glabrou,hal,honeycomb-shaped,larger,lengthening,light,linear,living,nflorescence,orbicular,orolla,ovate,pair,par,perfect,proximal,removed,ruit,sessile,seudostipule,side,slightly,slit,specimen,stamen,subequal,subglabrou,tall,tamen,tem,toward,typically,usually,vary,whose,yellow,ympodial	appressed,arrangement,articulation,bract,branching,breeding,broad-based,calyx,capitate,colour,connective,form,fruiting,growth,height,heteromorphism,inflated,inflorescence,insertion,interpetalar,length,margin,marking,mature,modification,na,needle-like,number,odour,orientation,ovary,paired,pattern,placement,position,prickle,pseudostipule,rhizome,scale,shape,smell,spot,staman,stem,stone,structure,subglabrous,surface,symmetry,sympodial,system,texture,trichome,tuber,type,vegetative,winging,xylopodia	0-16,0.30-2.0,0.5-2,0.7-2.7,0.8-2.6,1-3,1.5-2,10-40,10.5-12,15-40,2-12,2-7,2.5-4,3-8,3.5-10.5,4-5,5-15,5-20,5.3-17.5,5.5-18,5.5-8,9-31,abaxially,acumen,adaxially,articulated,attenuate,axillary,berry,brownish,bud,cell,chartaceous,clavate,cm,condition,corolla,covering,diameter,distal,dot,drying,forked,fresh,glabrescent,glabrous,globose,green,green-white,greenish,hair,hair-like,half,herb,high,homostylous,lanceolate,lateral,lilac,long,make,medium,mm,mucilaginous,narrowly,odd-pinnate,ovoid,pentagonal,petiolulate,plurifoliate,poricidal,purple,ripe,rotate-pentagonal,rounded,seed,short,sometimes,straight,subtending,terminal,testal,thick,throughout,tip,tri-,unwinged,wall,wet,white,whitish,winged,x	capitate,na,subglabrous
6	wfo-0001025704	success	247	114	59	69	178	45	56	3	/6,1.2-3,1/2-4/5,2-3,4.5-6.5,8-17,andromonoecious,anther,apex,articulated,auriculate,base,berry,branched,calyx,cell,chartaceous,cm,connivent,cordate,covering,curved,ellipsoid,elongating,equal,evenly,filament,fruit,fruiting,green,green-yellow,lateral,leaf,length,less,lobed,long,lower,margin,mature,maturity,mauve,mm,occasionally,pedicel,petiole,poricidal,prickle,rarely,shape,shrub,small,sometimes,spherical,stellate,stem,straight,surface,tapering,terminal,tip,tree,truncate,unbranched,unit,way,white,yellow,young	0-10,0-100,0-2,0-3.5,0-5,0.1,0.1-0.3,0.1-0.5,0.15-0.8,0.3-0.8,0.5-1.5,0.7-1,1,1-2,1-3,1-3.5,1-4,1-5,1-6,1.5-2,1.5-3.2,1.5-4.5,1.8-3.5,1/4-3/4,1/5,2,2-10,2-4.5,2-5,2-7,2.5-4.5,2.7-4,3-10,3-15,3-5,3-6,4-12,4-5,5-20,5-merous,6-12,6-15,8-12,8-15,abaxial,abaxially,acute,adaxial,age,almost,alyx,apar,apart,apically,apiculate,apparently,axe,ba,bark,blade,broad-deltate,brow,deltate,densely,development,diameter,discolorous,distal,distance,drying,eaf,eed,elliptic,end,erect,extending,flattened,flattened-reniform,flower,free,glabrescent,glabrous,gray,half,hermaphrodite,heterostylous,infructescence,irregular,lobe,lobing,long-styled,longer,lowermost,midpoint,midvein,moderately,multangulate,near,nflorescence,obtuse,often,older,one,open,orange,orange-brown,orolla,oung,outline,ovate,pair,pale,peduncle,pendulous,per,pericarp,pit,plant,plurifoliat,porrect,portion,prickl,prickly,primary,prominent,raised,ray,recurved,red-brown,red-green,reflexed,retaining,round,rounded,ruit,scar,secondary,sessile,short-styled,shorter,side,slender,smooth,somewhat,spaced,sparsely,spreading,stalk,stalked,staminat,stellate-pubescen,stellate-pubescent,stout,strongly,style,tamen,terete,tertiary,throughout,time,trichome,tube,unarmed,upper,variously,vary,vein,venation,visible,warty,white-gray,wide,widening,woody,yellow-green,yellowish,ympodial,×	appressed,articulation,bract,branching,breeding,colour,connective,corolla,form,growth,hair,heteromorphism,inflated,inflorescence,insertion,interjected,interpetalar,leaflet,marking,modification,na,needle-like,odour,orientation,paired,pattern,placement,plurifoliate,pore,position,pseudostipule,rhizome,scale,spot,staman,stone,structure,symmetry,sympodial,system,texture,tissue,tuber,type,xylopodia	/6,1.2-3,1/2-4/5,2-3,4.5-6.5,8-17,andromonoecious,articulated,auriculate,base,berry,branched,chartaceous,cm,connivent,cordate,covering,curved,ellipsoid,elongating,equal,evenly,fruit,green,green-yellow,lateral,leaf,less,lobed,long,lower,mature,maturity,mauve,mm,occasionally,poricidal,rarely,shrub,small,sometimes,spherical,stellate,stem,straight,surface,tapering,terminal,tip,tree,truncate,unbranched,way,white,yellow,young	na,needle-like,plurifoliate
7	wfo-0001025729	success	177	159	83	104	73	55	80	3	.5,/4,0.25-0.5,0.7-1.2,1-1.5,1-5,1.75,2,2-3.5,3-6,4-5,4-8,5-50-flowered,6-8,9-17,abaxial,abaxially,acute,adaxially,anther,apex,apiculate,axil,bark,base,blackish,bud,calyx,cm,corolla,covering,deflexed,densely,dia,difoliate,dirty,drying,elliptic,filament,flattened-reniform,fruiting,furcate,glabrous,globose,green,greenish-yellow,greyish-brown,lamina,lateral,leaf,lobed,long,lower,main,margin,member,minor,minutely,mm,oblique,occasionally,opposite,ovary,overlapping,pair,pale,papillose,pedicel,petiole,pit,pitted,plant,pore,pubescent,ripening,rounded,scar,shaped,shiny,short,simple,size,sparsely,stem,stigma,stout,style,surface,tear-drop,tip,touching,tree,treelet,trichome,tuft,uniseriate,unit,usually,vein,way,white,woody,x,yellow	-20,1.1-1.5,1.2-1.8,1.5-2,20,7-8,abrupt,along,anthesi,apar,apical,appearing,basal,berry,black,branched,bright,bristly,covered,cyathiform,dark,deltoid,denser,diam,differing,eaf,edicel,eed,enclosed,expanded,f,fleshy,free,geminat,gently,glabrou,growing,incrassate,lat,like,live,lobe,lon,m.,mainly,major,middle,minute,nflorescence,often,older,one,overtopping,papillo,partially,poricidal,portion,prominent,quite,raised,reflexed,ruit,straight,tall,tapering,terminal,tub,tube,ud,widening,widest,ympodial,young	4-20,articulation,bract,branching,breeding,broad-based,cell,colour,connective,flower,form,fruit,geminate,growth,hair,height,heteromorphism,inflorescence,insertion,interjected,interpetalar,leaflet,length,marking,mature,modification,na,needle-like,number,odour,orientation,pattern,placement,position,prickle,pseudostipule,rhizome,scale,seed,shape,smell,spot,staman,stone,structure,symmetry,sympodial,system,texture,tissue,tuber,type,vegetative,xylopodia,zygomorphy	.5,/4,0.25-0.5,0.7-1.2,1-1.5,1-5,1.75,2,2-3.5,3-6,4-5,4-8,5-50-flowered,6-8,9-17,abaxial,acute,apiculate,axil,base,blackish,bud,cm,covering,deflexed,densely,dia,difoliate,dirty,drying,elliptic,flattened-reniform,furcate,glabrous,globose,green,greenish-yellow,greyish-brown,lamina,lateral,leaf,lobed,long,main,member,minutely,mm,oblique,occasionally,opposite,overlapping,pair,pale,papillose,pit,pitted,pubescent,ripening,rounded,shaped,shiny,short,simple,sparsely,stout,tear-drop,tip,touching,tree,treelet,trichome,tuft,uniseriate,usually,vein,way,white,woody,x,yellow	4-20,geminate,na
8	wfo-0001025749	success	215	142	77	101	114	41	74	3	0-5,0.1,0.1-0.4,0.2-1.5,0.3-1.5,0.5-1,0.5-3,0.8-0.9,1,1-10,1-13,2-10,2.5-6,3-20,5-10-12,5-20,5-6-8,abaxial,adaxial,anther,apart,apex,articulated,bark,base,berry,branched,calyx,chartaceous,cm,cuneate,curved,dark,difoliate,dull,elongating,equal,flattened,flattened-reniform,flower,fruit,fruiting,gently,glabrescent,glabrous,gray,green-brown,lateral,leaf,length,light,lobed,long,lower,margin,markedly,maturity,mauve,midpoint,mm,narrow-deltate,orange-brown,orange-red,orbicular,ovate,pale,pedicel,peduncle,per,petiole,poricidal,prickle,rarely,ray,red-brown,reduced,rounded,scar,shorter,shrub,sometimes,spaced,spherical,spreading,stalk,stellate-pubescent,stem,straight,straw-yellow,style,surface,tapering,tip,trichome,unit,white,wide,yellow,yellow-green,yellow-orange,yellowish	.5,/5,0-10,0-3,0-6,0-8,0.1-0.2,0.1-0.3,0.2,0.4-0.7,0.5-0.8,0.5-0.9,0.5-1.3,0.6-4.5,1-2,1-3,1-6,1-8.5,1-9,1.5,1.5-2,1.5-2.5,1/4-1/3,1/5-1/2,2-2.5,2/3,3-5,4-8,5-merous,6-8,abaxially,acuminat,acute,adaxially,adnate,almost,alyx,apar,apically,apparently,blade,broad-deltate,concolorous,densely,diameter,discolorous,distance,drying,eaf,eed,erect,extending,filament,filiform,free,geminat,herbaceous,indistinct,infructescence,lobe,lon,long-ovate,longer,magnification,mature,midvein,moderately,narrow-ovate,nflorescence,oblong,obtuse,occasionally,older,one,open,orange-brow,orolla,oung,pair,pendulous,perfec,pericarp,porrect,portion,prickl,prickly,primary,procumbent,purple,recurved,ruit,sessile,side,smooth,sparsely,stalked,stellate,strongly,tamen,terete,tertiary,time,toward,tube,usually,variously,vary,vein,venation,visible,way,without,ympodial,½-2/	articulation,bract,branching,broad-based,colour,corolla,form,geminate,growth,hair,height,heteromorphism,inflorescence,insertion,interjected,interpetalar,leaflet,na,needle-like,number,odour,orientation,ovary,placement,plant,position,scale,seed,shape,smell,spacing,staman,structure,symmetry,sympodial,texture,tissue,type,vegetative,width,zygomorphy	0-5,0.1,0.1-0.4,0.2-1.5,0.3-1.5,0.5-1,0.5-3,0.8-0.9,1,1-10,1-13,2-10,2.5-6,3-20,5-10-12,5-20,5-6-8,apart,articulated,base,berry,branched,chartaceous,cm,cuneate,curved,dark,difoliate,dull,elongating,equal,flattened,flattened-reniform,gently,glabrescent,glabrous,gray,green-brown,lateral,light,lobed,long,markedly,maturity,mauve,mm,narrow-deltate,orange-brown,orange-red,orbicular,ovate,pale,per,poricidal,rarely,red-brown,rounded,shrub,sometimes,spaced,spherical,spreading,stellate-pubescent,straight,straw-yellow,surface,tapering,tip,white,wide,yellow,yellow-green,yellow-orange,yellowish	geminate,na,zygomorphy
9	wfo-0001025754	success	164	133	66	78	86	55	62	4	-celled,.5,0.5-1,0.5-1.5,1,1-2,1-3,1.5,1.5-3,10-20,10-35,2-4,2-foliate,3-10,4,4-6,5-12,5-15,abundant,acuminate,acute,anther,apex,asymmetrical,base,berry,brown,calyx,center,chartaceous,ciliate,cm,cordate,cordiform,diameter,drying,edge,eglandular,entire,filament,fine,flower,fruit,glabrous,globose,hair,herb,immature,interpetalar,leaf,margin,maturing,membranaceous,mm,much-branched,oblong,parallel,pedicel,per,petiole,radiating,raised,ridge,rotate,running,semitransparent,shallow,solitary,stigma,style,surface,tissue,truncate,unbranched,unit,white,x,yellow	0.1-0.2,1-3.5,1.5-4,2-5-celled,2-7,3-5,3-6,abaxially,absent,adaxiall,adaxially,along,axe,barely,beyond,blade,branch,connected,decumbent,decurrent,dehiscing,densely,denser,dm,dried,eaf,eed,emarginat,equal,erect,explosively,exserted,flat,geminat,glandular,held,leaving,like,linear-lanceolate,lobe,long,lower,lying,main,material,maturit,mesocarp,mixed,moderately,nearly,nfloresence,notch,often,orolla,palmately,peduncle,penden,placenta,pressure,probably,pubescen,pubescent,rachi,ruit,short,slightly,small,sometimes,sparsely,stamen,stem,straight,swollen,tal,tamen,tem,triangular,tube,upright,vary,vein,visible,watery,wid,woody,ympodial	abaxial,appressed,arrangement,articulation,bract,branching,breeding,cell,colour,connective,corolla,form,fruiting,geminate,growth,heteromorphism,inflated,inflorescence,insertion,interjected,leaflet,length,marking,mature,modification,na,number,odour,orientation,ovary,paired,pattern,pendent,placement,pore,position,prickle,pseudostipule,rhizome,scale,seed,shape,spot,staman,stone,structure,symmetry,sympodial,system,texture,tuber,type,width,xylopodia,zygomorphy	-celled,.5,0.5-1,0.5-1.5,1,1-2,1-3,1.5,1.5-3,10-20,10-35,2-4,2-foliate,3-10,4,4-6,5-12,5-15,abundant,acuminate,acute,asymmetrical,berry,brown,center,chartaceous,ciliate,cm,cordate,cordiform,drying,edge,eglandular,entire,fine,flower,fruit,glabrous,globose,hair,herb,immature,margin,maturing,membranaceous,mm,much-branched,oblong,parallel,radiating,raised,ridge,rotate,running,semitransparent,shallow,solitary,truncate,unbranched,white,x,yellow	geminate,na,pendent,zygomorphy
10	wfo-0001025760	success	207	103	51	61	146	42	47	4	-6,.5,/3,1-4,2.3-4,3.5-17,anther,apex,apparently,articulated,base,berry,calyx,chartaceous,cm,connivent,cream,cuneate,curved,dark,difoliate,elongating,equal,filament,fruit,fruiting,geminate,gently,glabrous,green,hair,herb,lateral,leaf,length,lobed,long,margin,marking,maturity,membranous,mm,orange,pale,pedicel,petiole,poricidal,rounded,shape,shrub,spherical,spreading,subentire,unarmed,unbranched,unit,usually,way,weakly,white,young	-10,-12,0-0.5,0-100,0.1,0.1-0.2,0.15-0.3,0.2-0.35,0.3-1,0.4-0.8,0.45-0.9,0.5-1.5,0.5-2,0.7-2.5,0.8-1.8,1-1.5-2.5-5,1-1.8,1-2,1-3,1.5,1.5-4.5,1.5-5,1/4,1/4-1/2,1/4-1/3,1/5,2-2.5,2-3,2.1-3.5,2.5-10,2.5-8,2/3,3,3-6,3.5-9,5-10-merous,5-18,8-10-12,abaxial,abaxially,acut,acute,adaxial,almost,alyx,annual,apar,apically,bark,black,blade,broad-deltate,brow,concolorous,cultivar,deltate,diameter,discolorous,distance,drying,dull,eaf,eed,elliptic,erect,extending,flattened-reniform,flower,free,geminat,glabrescent,infructescence,lengt,lobe,longer,lower,mature,midpoint,midvein,minute,moderately,nflorescence,often,older,one,open,orange-brown,orolla,oung,ovate,pair,peduncle,pendulous,per,perennial,perfec,pericarp,porrect,portion,primary,ray,recurved,red-brown,reflexe,ruit,scar,sessile,shorter,side,simple,slender,smooth,sometimes,spaced,stalk,stalked,stellate,stellate-pubescen,stellate-pubescent,stem,stout,straight,style,surface,tamen,tapering,terete,tertiary,thick-stalked,time,tip,trichome,tube,unarme,upper,various,variously,vary,vein,venation,visible,wide,woody,yellow,yellow-green,ympodial	articulation,bract,branching,breeding,broad-based,cell,colour,corolla,form,growth,heteromorphism,inflorescence,insertion,interjected,interpetalar,leaflet,na,odour,orientation,paired,pattern,perfect,placement,pore,position,prickle,pseudostipule,reflexed,rhizome,scale,spot,staman,stone,structure,symmetry,sympodial,system,texture,tissue,tuber,type,xylopodia	-6,.5,/3,1-4,2.3-4,3.5-17,apparently,articulated,base,berry,chartaceous,cm,connivent,cream,cuneate,curved,dark,difoliate,elongating,equal,geminate,gently,glabrous,green,herb,lateral,lobed,long,marking,maturity,membranous,mm,orange,pale,poricidal,rounded,shrub,spherical,spreading,subentire,unarmed,unbranched,usually,way,weakly,white,young	broad-based,na,perfect,reflexed
11	wfo-0001025782	success	199	102	41	56	143	46	39	2	.5,1.2-6,1.5-3,4-4.5,andromonoecious,anther,apex,articulated,base,berry,calyx,chartaceous,cm,conical,connivent,cuneate,curved,difoliate,elongating,equal,evenly,filament,flattened,fruit,fruiting,geminate,gently,green,hair,lateral,leaf,length,lobed,long,lower,margin,mature,membranous,mm,pedicel,petiole,poricidal,prickle,shrub,sparsely,spherical,stellate,stellate-pubescent,stem,surface,tapering,tip,unbranched,unit,white,yellow	0-10,0-5,0.1-0.15,0.1-0.2,0.1-0.25,0.3-1,0.4-0.6,0.5-1,0.55-0.75,0.9-1.3,1,1-1.7,1-2,1-2.5,1-4,1.3-1.6,1/4-1/2,1/4-1/3,1/6,10-13,2-10,2-2.5,2-3,2-5,2-7,2.5-3.5,2/3-3/4,20,3-4,3-5,4,4.5-9,5-20,5-6.5,5-8,5-merous,5.5-6,6-14,6-8,abaxial,abaxially,acuminat,acuminate,adaxial,also,alyx,apar,apart,apically,apparently,bark,blade,brown,climbing,concolorous,deltate,densely,diameter,discolorous,distal,distance,drying,dull,eaf,eed,elliptic,elongated,extending,flattened-reniform,flower,free,geminat,glabrescent,glabrous,green-brown,hermaphrodite,heterostylous,infructescence,lengt,less,lobe,long-styled,longer,lowermost,maturity,midpoint,midvein,minute,moderately,nflorescence,occasionally,older,one,open,orange-brown,orolla,oung,pair,peduncle,pendulous,per,pericarp,plant,porrect,portion,prickl,prickly,primary,ray,red-brow,reduced,ruit,scar,sessile,short-styled,shorter,side,simple,smooth,spaced,spreading,staminat,stout,straight,style,tamen,terete,tertiary,time,toward,trichome,tube,vary,vein,venation,visible,way,weakly,wide,woody,yellow-green,ympodial,young	appressed,articulation,bract,branching,breeding,broad-based,cell,colour,connective,corolla,form,growth,heteromorphism,inflated,inflorescence,insertion,interjected,interpetalar,leaflet,marking,modification,na,needle-like,odour,orientation,paired,pattern,placement,pore,position,pseudostipule,rhizome,scale,shape,spot,staman,stone,structure,symmetry,sympodial,system,texture,tissue,tuber,type,xylopodia	.5,1.2-6,1.5-3,4-4.5,andromonoecious,articulated,base,berry,chartaceous,cm,conical,connivent,cuneate,curved,difoliate,elongating,equal,evenly,flattened,geminate,gently,green,lateral,lobed,long,membranous,mm,poricidal,shrub,sparsely,spherical,stellate,stellate-pubescent,surface,tapering,tip,unbranched,white,yellow	na,needle-like
12	wfo-0001025783	success	179	135	77	95	84	40	73	4	.5,0.5,0.5-1,0.5-1.5,0.8-3.5,1-1.2,1-3,2,2-3+,2-5,2-6.5,5,7-10,<,acute,anther,apart,apex,base,berry,branching,brown,bud,c.,cell,cluster,cm,coriaceous,corolla,dendritic,diameter,ellipsoid,elliptic,entire,flattened,fleshy,flexuous,flower,glabrous,globose,greyish,groove,growth,inserted,lateral,less,lobed,lower,margin,minutely,mm,narrowly,new,number,obtuse,pale,pedicel,peduncle,pentagonal,perfect,petiole,pitted,pubescent,purple,reniform,revolute,ripe,sagittate,scar,shiny,shoot,short,shrub,simple,sleeve,slightly,sometimes,somewhat,sparse,sparsely,stellate,stem,surface,terminal,testal,thin,time,trichome,truncate,type,uniseriate,upper,vine,violet,way	1-1.5,1.8-2,3-4,5-merou,abaxiall,abaxially,adaxiall,adaxially,along,alyx,anthesi,ape,ark,articulated,axil,branched,calyx,completely,confined,conical,densely,eaf,eed,erect,expanded,exposed,exserted,filiform,free,fruiting,glabrou,green,hromosome,ilament,keeled,known,lax,lobe,long,long/tall,mature,midrib,midvein,minute,mmm,near,nflorescence,nodding,obscured,occasionally,older,orolla,outlin,pair,penden,pericarp,plurifoliat,point,portion,possibly,primary,ruit,scarious,see,spaced,stigma,strongly,style,suture,transparent,triangular,tube,tuft,twinin,ud,unit,vary,vein,weak,wide,within,woody,yellowish,ympodial	3,articulation,bark,breeding,colour,connective,filament,form,fruit,hair,height,heteromorphism,inflorescence,leaf,length,marking,na,odour,orientation,outline,placement,plant,pore,position,prickle,rhizome,seed,shape,spacing,spot,staman,stone,symmetry,system,texture,thicknes,tuber,width,xylopodia,zygomorphy	.5,0.5,0.5-1,0.5-1.5,0.8-3.5,1-1.2,1-3,2,2-3+,2-5,2-6.5,5,7-10,<,acute,apart,apex,base,berry,brown,c.,cluster,cm,coriaceous,dendritic,ellipsoid,elliptic,entire,flattened,fleshy,flexuous,glabrous,globose,greyish,inserted,lateral,less,lobed,minutely,mm,narrowly,obtuse,pale,pentagonal,perfect,pitted,pubescent,purple,reniform,revolute,ripe,sagittate,shiny,shoot,short,shrub,simple,sleeve,slightly,sometimes,somewhat,sparse,sparsely,stellate,terminal,thin,time,trichome,truncate,uniseriate,vine,violet,way	3,na,outline,zygomorphy
13	wfo-0001025788	success	156	125	67	72	84	53	60	7	1-4,1-5,2-10,4-5.5,abaxially,acute,adaxially,apex,apical,apically,base,blue,branched,calyx,cell,cm,conical,connate,corolla,covering,cuneate,deep,dehiscent,dichasially,distal,filament,finely,generally,green,green-white,hair-like,half,herbaceous,interjected,introrse,lateral,leaf,leaflet,long,make,maturing,medium,mm,mucilaginous,oblique,obtuse,odd-pinnate,often,ovoid,pattern,pedicel,perennial,petiole,plant,poricidally,proximal,pubescent,purple,rotate,rounded,seed,short,slit,testal,thick,throughout,tip,tuber-bearing,typically,unit,wall,¼	0-6,0.5-2,1.8-2.7,1.8-3.9,10-24,14-48,15-30,2-13,2-3,2-5,2.8-9.5,2m,3-6-7-8,3-6-foliat,4-3.,4.5-10.1,4.5-12.5,5-8,6.2-12.5,8-38,abaxiall,acumen,acuminate,articulate,attenuate,cyme,diameter,dichasial,digestion,diminishing,dorsally,eaf,ebracteate,edge,eed,elliptical,emoval,enzyme,exceeding,flat,flower,folded,forked,globo,gradually,honeycomb,living,lobe,lon,long-attenuate,lower,lunat,monochasial,narrowly,nflorescence,nther,orolla,ovate,pair,peduncle,perfect,petiolule,plan,reveal,ruit,sessile,seudostipule,size,specimen,stamen,stigma,straight,style,subequal,subsessile,tal,tem,terminal,throughou,toward,vary,wide,yellow,ympodial	3-6-foliate,4-31,anther,appressed,articulation,bract,branching,breeding,colour,connective,ebbrate,form,fruit,fruiting,growth,hair,heteromorphism,inflated,inflorescence,insertion,interpetalar,length,lunate,margin,marking,mature,modification,na,odour,orientation,paired,placement,pore,position,prickle,pseudostipule,rhizome,scale,shape,spot,staman,stone,structure,symmetry,sympodial,system,texture,tissue,tuber,type,wet,xylopodia,zygomorphy	1-4,1-5,2-10,4-5.5,abaxially,acute,adaxially,apical,apically,blue,branched,cell,cm,conical,connate,covering,cuneate,deep,dehiscent,dichasially,distal,finely,generally,green,green-white,hair-like,half,herbaceous,introrse,lateral,long,make,maturing,medium,mm,mucilaginous,oblique,obtuse,odd-pinnate,often,ovoid,perennial,plant,poricidally,proximal,pubescent,purple,rotate,rounded,seed,short,slit,testal,thick,throughout,tip,tuber-bearing,typically,wall,¼	3-6-foliate,4-31,ebbrate,lunate,na,wet,zygomorphy
14	wfo-0001025792	success	203	95	44	57	146	38	41	3	1-2,1-3,3-5,4-6,5,anther,apex,articulation,axillary,base,berry,blue-mauve,blue-purple,bud,cell,chartaceous,cm,corolla,distal,filament,forked,fruit,globose,green,hair,half,herb,high,interjected,lanceolate,leaflet,long,margin,mauve,membranous,minute,mm,oblique,odd-pinnate,ovoid,pedicel,petiole,plurifoliate,pore,poricidal,purple,ripe,rotate-pentagonal,rounded,streak,subtending,terminal,tinged,tip,tri-,unit,white	0.4-0.7,1-10,1-4,10-15,2-11,2-3,2-3.5,2.5-3.5,2.5-4,21-28,3-4,3.5-6,4-12,4.5-7,5-10,5-6,5-9,5-merou,7-10,7.5-8,8-10,9-12,abaxially,acumen,acuminate,acute,adaxially,ag,along,alyx,apart,apparently,articulated,auriculate,axe,basiscopic,blade,broadly,brownish,capitat,ciliate,condition,connivent,covering,dark,decurrent,densely,developing,diameter,digestion,distinct,distinctly,dorsally,drying,eaf,edge,eed,elliptic,enzyme,especially,exceeding,except,flat,flower,folded,fresh,geminat,generally,glabrou,glabrous,greatly,green-white,greenish,hair-like,hal,homostylous,honeycomb-shaped,indistinct,lateral,lengthening,like,living,lobe,lower,make,midrib,minutely,mottle,mucilaginous,narrow,narrowly,nflorescence,often,onto,orolla,pair,papillose,peduncle,perfect,petiolulate,plant,proximal,puberulent,pubescent,rachi,reduced,removed,ruit,seed,semi-erec,semi-rosette,sessile,seudostipule,short,shortly,side,size,slightly,slit,spaced,specimen,stamen,ste,stem,stigma,straight,style,sub-rosette,subequal,tall,tamen,tem,testal,thick,throughout,tube,usually,vary,wall,wet,whitish,wing,x,yellow,ympodial,young	bract,branching,colour,connective,form,growth,heteromorphism,inflorescence,insertion,interpetalar,leaf,length,marking,na,odour,orientation,paired,placement,position,prickle,pseudostipule,rhizome,scale,shape,spot,staman,stellate,stone,structure,symmetry,sympodial,texture,tissue,trichome,tuber,type,xylopodia,zygomorphy	1-2,1-3,3-5,4-6,5,axillary,berry,blue-mauve,blue-purple,bud,chartaceous,cm,distal,forked,globose,green,half,herb,high,lanceolate,long,mauve,membranous,minute,mm,oblique,odd-pinnate,ovoid,plurifoliate,poricidal,purple,ripe,rotate-pentagonal,rounded,streak,subtending,terminal,tinged,tip,tri-,white	na,stellate,zygomorphy
15	wfo-0001025804	success	155	160	108	122	33	38	104	4	.25,.5,0.5-1,1-1.5,1-3,1.4-1.7,1.5-2,11-20,16-35,2-2.5,2.5-4,3-4.5,3.5-12,4-10,5,6-8,7-10,?,abaxially,acute,adaxially,age,anther,anthesi,apex,apiculate,attenuate,bark,base,berry,bilobed,branched,calyx,clavate,cm,conical,corolla,cream,cucullate,dark,decurrent,densely,dia,difoliate,ellipsoid,elliptic,erect,exserted,filament,flattened,fleshy,fruiting,glabrous,glandular,globose,green,incrassate,internodal,lateral,leaf,lengthening,lobe,lobed,long,main,major,many,margin,mere,middle,minor,minute,minutely,mm,nearly,obovate,occasionally,often,onto,opposite,ovary,pair,paler,papillae,papillate,papillose,pedicel,pitted,planar,plurifoliate,pore,poricidal,projection,red,reddish-brown,regularly,reniform,rim,scar,sessile,shrub,size,slit,somewhat,spaced,stem,stigma,strongly,style,surface,thick,time,tip,tube,unit,vein,white,whitish-green,widest,wing,winged,x	1.2-1.5,10-20,apar,ape,ba,c.,covered,deflexed,differing,drying,eaf,edicel,eed,flower,free,geminat,later,light,lower,near,nflorescence,older,papillat,portion,red-papillose,reddish-brow,ruit,tall,tub,ud,woody,ympodial,young	apart,branching,bud,cell,colour,diameter,form,fruit,geminate,growth,height,heteromorphism,inflorescence,length,na,odour,orientation,paired,part,placement,plant,position,prickle,pseudostipule,rhizome,seed,shape,staman,stone,structure,symmetry,sympodial,texture,thicknes,tuber,type,xylopodia,ye	.25,.5,0.5-1,1-1.5,1-3,1.4-1.7,1.5-2,11-20,16-35,2-2.5,2.5-4,3-4.5,3.5-12,4-10,5,6-8,7-10,?,abaxially,acute,adaxially,age,anthesi,apex,apiculate,attenuate,base,berry,bilobed,branched,calyx,clavate,cm,conical,cream,cucullate,dark,decurrent,densely,dia,difoliate,ellipsoid,elliptic,erect,exserted,flattened,fleshy,glabrous,globose,green,incrassate,internodal,lateral,leaf,lengthening,lobe,lobed,long,main,many,margin,mere,middle,minute,minutely,mm,nearly,obovate,occasionally,often,onto,opposite,pair,paler,papillate,papillose,pitted,planar,plurifoliate,pore,poricidal,projection,red,reddish-brown,regularly,reniform,rim,sessile,shrub,slit,somewhat,spaced,stem,strongly,surface,thick,time,tip,tube,vein,white,whitish-green,winged,x	apart,geminate,na,ye
16	wfo-0001025813	success	195	147	76	96	99	51	71	5	0-2,1-10,1-2,1-4,1.2-4.5,1.3-7,1.5-1.8,1.5-6.5,15-30,2-5,3-3.5,3-4,3-5,3-6,3-7,5-18.5,5-6,6-7,abaxially,absent,adaxially,anther,apex,base,berry,blade,blue,borne,broadly,brownish,cell,chartaceous,cm,condition,corolla,dark,densely,diameter,distal,drying,elliptic,end,extra,filament,flower,fresh,fruit,glabrous,globose,green,greenish,hair,herb,homostylous,interjected,lanceolate,lateral,leaflet,light,long,margin,membranous,minute,mm,monochasium,odd-pinnate,ovoid,pair,pedicel,peduncle,petiole,pilose,plurifoliate,pore,poricidal,pubescent,rarely,rotate,seed,singly,size,stem,strongly,style,suborbicular,terminal,tip,tri-,tube,tuber,typically,unit,violet,white,whitish,x	0.7-1.7,1-1.5,1.5-2,2-3,2-4,5-merou,acumen,acuminate,acute,ag,along,alyx,apart,apparently,articulated,axe,ciliate,connivent,contracted,covering,cuneate,decreasing,decurrent,digestion,discussion,distinct,dorsally,eaf,edge,eed,enzyme,especially,exceeding,flat,folded,geminat,glabrou,green-white,hair-like,half,highly,honeycomb-shaped,larger,lengthening,like,living,lobe,longer,lower,make,midrib,minutely,mucilaginous,near,nflorescence,obtuse,often,orbicular,orolla,ovate,ovoi,perfect,petiolulate,plant,puberulent,rachi,removed,rosette-formin,ruit,see,sessile,seudostipule,short,single-flowered,slit,sometimes,spaced,species,specimen,stamen,ste,stigma,stolo,straight,tamen,tem,testal,thick,thir,throughout,toward,unforked,unwinged,vary,vein,wall,wet,yellow,ympodial	arrangement,articulation,bract,branching,breeding,calyx,colour,connective,form,formation,fruiting,glabrousnes,growth,heteromorphism,inflorescence,insertion,interpetalar,leaf,length,marking,mature,modification,na,odour,orientation,ovary,paired,pattern,placement,position,presence,prickle,pseudostipule,rosette,rosette-forming,scale,shape,spacing,spot,staman,stolon,stone,structure,symmetry,sympodial,system,texture,third,tissue,type,zygomorphy	0-2,1-10,1-2,1-4,1.2-4.5,1.3-7,1.5-1.8,1.5-6.5,15-30,2-5,3-3.5,3-4,3-5,3-6,3-7,5-18.5,5-6,6-7,abaxially,absent,adaxially,base,berry,blue,borne,broadly,brownish,chartaceous,cm,condition,dark,densely,distal,drying,elliptic,end,extra,flower,fresh,glabrous,globose,green,greenish,hair,herb,homostylous,lanceolate,light,long,membranous,minute,mm,monochasium,odd-pinnate,ovoid,pilose,plurifoliate,poricidal,pubescent,rarely,rotate,singly,strongly,suborbicular,tip,tri-,typically,violet,white,whitish,x	na,rosette-forming,stolon,third,zygomorphy
17	wfo-0001025825	success	187	161	83	108	79	53	80	3	0-0.21,0.4-1,0.5-0.8,0.5-10.4,0.9-2,1-2,1-3,1-5.5,1.1-1.4,10-24,10.5-26,14-85,2-3.7,2-5,22-86,3-10,3-5,3.7-6.5,4-8,4-9,5-10,5-7,6-10,6.6-14,acuminate,acute,anther,apex,base,berry,blade,brownish,cell,clavate,cm,condition,coriaceous,corolla,cuneate,dark,diameter,digestion,distal,drying,elliptic,enzyme,filament,flower,forked,fresh,fruit,glabrescent,glabrous,green,greenish,hair,half,herb,high,homostylous,honeycomb-shaped,interjected,lanceolate,lateral,leaf,leaflet,light,lilac,lobe,long,medium,mm,odd-pinnate,orbicular,ovate,ovoid,pair,pedicel,peduncle,pentagonal,perfect,petiole,plant,plurifoliate,pore,poricidal,removed,rotate-pentagonal,seed,shiny,short,size,stigma,straight,streak,style,terminal,testal,tip,tissue,tri-,tube,unit,wall,white,whitish,wing,x	0.4-3,0.7-2.2,0.9-4,3-8.5,5-merou,abaxially,acumen,adaxiall,adaxially,ag,alyx,apart,apparently,articulated,asymmetric,attenuate,axe,axillary,back,basiscopic,bud,capitat,connivent,covering,decreasing,decurrent,dorsally,eaf,edge,eed,erec,exceeding,flat,folded,geminat,generally,glabrou,green-white,hair-like,hal,increasing,lengthening,living,lower,make,middle,mucilaginous,nflorescence,orolla,petiolulate,rachi,rounded,ruit,sessile,seudostipule,side,slightly,slit,smaller,spaced,specimen,stamen,subequal,subglabrou,subtending,tall,tamen,tem,thick,throughout,toward,unwinged,usually,vary,wet,wide,winged,yellow,ympodial	abaxial,adaxial,arrangement,articulation,bract,branching,breeding,calyx,capitate,colour,connective,form,fruiting,growth,height,heteromorphism,inflorescence,insertion,interpetalar,length,margin,marking,mature,modification,na,number,odour,orientation,ovary,paired,pattern,placement,position,prickle,pseudostipule,rhizome,scale,shape,spacing,spot,staman,stem,stone,structure,subglabrous,symmetry,sympodial,system,texture,tuber,type,width,xylopodia	0-0.21,0.4-1,0.5-0.8,0.5-10.4,0.9-2,1-2,1-3,1-5.5,1.1-1.4,10-24,10.5-26,14-85,2-3.7,2-5,22-86,3-10,3-5,3.7-6.5,4-8,4-9,5-10,5-7,6-10,6.6-14,acuminate,acute,berry,brownish,clavate,cm,condition,coriaceous,cuneate,dark,diameter,digestion,distal,drying,elliptic,enzyme,forked,fresh,glabrescent,glabrous,green,greenish,hair,half,herb,high,homostylous,honeycomb-shaped,lanceolate,lateral,light,lilac,long,medium,mm,odd-pinnate,orbicular,ovate,ovoid,pentagonal,perfect,plurifoliate,poricidal,removed,rotate-pentagonal,shiny,short,straight,streak,terminal,tip,tri-,wall,white,whitish,x	capitate,na,subglabrous
18	wfo-0001025838	success	215	117	60	73	142	44	57	3	0.5-1,0.7-2,1-1.5,2/3,4.5-5.5,anther,apex,articulated,attenuate,base,berry,black,branched,calyx,cell,cm,connivent,corolla,ellipsoidal,entire,erect,filament,fleshy,fruit,fruiting,glabrous,globose,greenish,growth,inflorescence,inserted,insertion,lateral,leaf,lengthening,like,lobed,loosely,many,margin,membranous,mm,nodding,often,pedicel,petiole,pore,poricidal,pubescent,purple,revolute,ripe,short,shrub,simple,sleeve,slender,slightly,slit,sometimes,stellate,stem,terminal,time,tinged,tip,tree,unit,way,white,winged,x,¾	.5,0.5,1-1.2,1.2-5,1.5-1.7,1.5-2,1.5-2.5,1.5-3.5,1.5-5,1.8-2,10-15-20,10-60,2-2.5,2-5,2.5-3,20-40,3.5-6-15,4-15,5,5-merou,6.5-7,abruptly,acuminate,adaxial,adaxially,ag,along,alyx,anthesi,apart,apiculate,appearing,archin,ark,axil,basall,branch,broad,brown,capitate,clavate,clustered,cucullate,cup-shaped,dark,decurrent,dendritic,dense,densely,denser,diameter,disintegrating,drying,eaf,eed,elliptic,exserted,extending,flattened,flower,free,glabrescent,hairy,ilament,irregularly,keeled,lamina,lanceolate,less,lobe,long,lower,m.,midrib,minute,minutely,mostly,narrowing,narrowly,never,new,nflorescence,occasionally,older,onto,orolla,ovoid,pair,pale,papillat,papillo,peduncle,per,perfect,pericarp,pitted,platform,plurifoliat,point,pointed,portion,primary,quadrate,reddish,reniform,ruit,scar,seed,shin,shiny,sinus,small,spaced,sparsely,spreading,square,stigma,strongly,style,surface,tall,tem,testal,thi,thin,trichome,tube,tuft,turbinate,twinin,ud,uniseriate,upper,vary,vein,wall,weight,wing,woody,yellow,yellowish,ympodial	age,appressed,articulation,bract,branching,breeding,colour,connective,form,hair,heteromorphism,inflated,interjected,interpetalar,leaflet,length,marking,mature,modification,na,odour,orientation,paired,pattern,placement,plurifoliate,position,prickle,pseudostipule,rhizome,scale,shape,spot,staman,stone,structure,symmetry,sympodial,system,texture,tissue,tuber,type,xylopodia	0.5-1,0.7-2,1-1.5,2/3,4.5-5.5,articulated,attenuate,base,berry,black,branched,cm,connivent,ellipsoidal,entire,erect,fleshy,glabrous,globose,greenish,inserted,lateral,lengthening,like,lobed,loosely,many,membranous,mm,nodding,often,pore,poricidal,pubescent,purple,revolute,ripe,short,shrub,simple,sleeve,slender,slightly,slit,sometimes,stellate,stem,terminal,time,tinged,tip,tree,way,white,winged,x,¾	age,na,plurifoliate
19	wfo-0001025845	success	180	167	100	114	66	53	96	4	0.3-0.5,0.4-1.5,0.5-11,0.5-2.5,1-1.8,1-4.5,1.5-13,1.5-2,1.5-2.5,1.5-7,2-15,2-3,2-5-lobed,2.5-4,3-13,3-6,4-5,4-6,6-6.5,6-9,abaxially,abundantly,acuminate,acute,adaxial,adaxially,aggregate,along,anther,apart,apex,apiculate,base,branch,calyx,cell,chartaceous,cm,compressed,corolla,cuneate,cylindrical,deltate,diameter,directed,distally,divided,eglandular,ellipsoidal,entire,especially,extra-axillary,filament,fork,fruit,glabrous,greenish,herb,laterally,leaf,light,lobe,lobed,located,lower,major,margin,membranaceous,midrib,minutely,mm,narrowly,near,nearly,obtuse,orange,ovate,ovoid,patch,pedicel,peduncle,petiole,pinnately,pore,puberulent,pubescent,rachi,radiu,rotate-stellate,sagittate,sand-punctate,shrub,side,simple,small,sparsely,stigma,stone,strongly,style,subcordate,tapered,tip,triangular,truncate,unbranched,unit,unlobed,vein,veiny,white,x,yellow,yellowish	.5,1,1-2,1.5,2,3,3-4,3-foliat,5-6,7-10,around,articulated,ascending,axe,ba,blade,brown,channe,connivent,dark,decurrent,diamete,distall,eaf,eed,elliptic,flattened,flower,free,glabrou,green,inserted,lateral,long,longitudinal,mesocarp,nflorescence,obovate,often,orolla,part,perfect,purple,rarely,rounded,rugose-verrucate,ruit,shorter,sinus,spaced,stripe,tal,tamen,tem,terminal,thecae,thick,tightly,time,tomento,truncat,tube,vary,wide,ympodial,youn	3-foliate,appressed,articulation,branching,breeding,broad-based,channel,colour,connective,decurred,form,fruiting,growth,hair,height,heteromorphism,inflated,inflorescence,insertion,length,marking,mature,modification,na,needle-like,orientation,ovary,placement,plant,position,prickle,pseudostipule,rhizome,shape,size,spacing,spot,staman,stellate,stem,structure,surface,symmetry,sympodial,system,texture,theca,thicknes,trichome,tuber,type,xylopodia,zygomorphy	0.3-0.5,0.4-1.5,0.5-11,0.5-2.5,1-1.8,1-4.5,1.5-13,1.5-2,1.5-2.5,1.5-7,2-15,2-3,2-5-lobed,2.5-4,3-13,3-6,4-5,4-6,6-6.5,6-9,abaxially,abundantly,acuminate,acute,adaxial,adaxially,aggregate,along,apart,apex,apiculate,base,branch,cell,chartaceous,cm,compressed,corolla,cuneate,cylindrical,deltate,diameter,directed,distally,divided,eglandular,ellipsoidal,entire,especially,extra-axillary,fork,glabrous,greenish,herb,laterally,light,lobed,located,membranaceous,midrib,minutely,mm,narrowly,near,nearly,obtuse,orange,ovate,ovoid,patch,petiole,pinnately,puberulent,pubescent,rotate-stellate,sagittate,sand-punctate,shrub,side,simple,small,sparsely,stone,strongly,subcordate,tapered,tip,triangular,truncate,unbranched,unlobed,veiny,white,x,yellow,yellowish	3-foliate,channel,decurred,na
20	wfo-0001025850	success	195	169	92	109	86	60	87	5	-7,.5,.8,0.5,0.5-1,0.5-3,0.6-1,1.5,15-20,30,4-5,6-7,acute,anther,anthesi,apex,articulated,base,berry,branched,brown,calyx,capitate,cell,cm,corolla,densely,diameter,divaricate,ellipsoid,elliptic,entire,exserted,filament,flattened,fleshy,flower,fruiting,glabrous,glandular,globose,green,growth,inflorescence,later,lateral,lengthening,lobed,lower,many,margin,membranous,minute,minutely,mm,narrowly,new,occasionally,openly,orange,pair,pale,papillate-puberulent,pedicel,peduncle,per,perfect,petiole,pinnatifid,pitted,plurifoliate,pore,poricidal,primary,pubescent,reddish,reniform,rhomboid,ripe,scattered,shallowly,shiny,shrub,simple,sleeve,slightly,slit,small,stellate,stem,stigma,strongly,style,surface,tan,terminal,thin,time,tip,trichome,truncate,tube,uniseriate,unit,vein,vine,white,x,young	0.5-1-3-5,0.5-1.5-5,1,1-1.5,1-celled,2,2-12,2-6.5,3-4,5-7,5-merou,abaxial,ag,along,alyx,apar,apparently,ark,axi,basal,broadly,connivent,cupped,cyathiform,deciduous,deflexed,deltate,denser,divided,drying,eaf,eed,elongate,em,erect,extending,free,geminat,glabrou,gland,half,halfway,ilament,irregularly,lamina,lax,leaving,less,lobe,long,loosely,midrib,nearly,nflorescence,nodding,node,often,older,orolla,outline,papillo,peg,planar,portion,puberulen,rounded,ruit,scar,sinuate,sinus,slender,sometimes,soon,spaced,splitting,spreadin,spreading,surfac,testal,tiny,twinin,ud,vary,woody,yellow,ympodial	5-merous,age,appressed,arrangement,articulation,bark,bract,branching,breeding,broad-based,bud,colour,connective,form,fruit,geminate,glabrousnes,hair,heteromorphism,inflated,insertion,interjected,interpetalar,leaf,leaflet,length,marking,mature,modification,na,needle-like,number,odour,orientation,ovary,paired,pattern,placement,position,prickle,pseudostipule,puberulent,rhizome,scale,seed,shape,smell,spot,staman,stone,structure,symmetry,sympodial,system,texture,tissue,tuber,type,vegetative,xylopodia	-7,.5,.8,0.5,0.5-1,0.5-3,0.6-1,1.5,15-20,30,4-5,6-7,acute,anthesi,articulated,base,berry,branched,brown,calyx,capitate,cm,densely,diameter,divaricate,ellipsoid,elliptic,entire,exserted,flattened,fleshy,glabrous,glandular,globose,green,later,lateral,lengthening,lobed,many,margin,membranous,minute,minutely,mm,narrowly,occasionally,openly,orange,pair,pale,papillate-puberulent,perfect,pinnatifid,pitted,plurifoliate,pore,poricidal,pubescent,reddish,reniform,rhomboid,ripe,scattered,shallowly,shiny,shrub,simple,sleeve,slightly,slit,small,stellate,strongly,surface,tan,terminal,thin,time,tip,trichome,truncate,uniseriate,vine,white,x,young	5-merous,age,geminate,na,puberulent
21	wfo-0001025872	success	160	126	60	76	84	50	58	2	0.25-0.5,0.6-1,1-1.5,1-2,1.2-1.5,1.7-3,10-25-flowered,2-5,2/3,4-4.5,4.5-13,6-10,6-8,acute,anther,apart,apex,base,becoming,berry,blade,branched,broadly,brownish,calyx,capitate,cm,coriaceous,corolla,cup-shaped,dark,dry,elliptic,filament,flattened-reniform,flower,fruiting,glabrous,globose,green,greenish-tan,later,lateral,leaf,live,lobed,main,margin,material,mm,narrowly,occasionally,opposite,ovary,pair,pedicel,petiole,plant,pore,red-papillose,revolute,scar,several,shaped,shrub,stigma,style,tear-drop,terminal,time,tube,unit,vein,way,white,x	.1,.5,0.5,0.5-1,1,1-1.3,1.2-1.6,2-2.5,3.5-4,along,anthesi,apically,auriculate,ba,bark,beginning,beneath,bright,crinkled,crowded,decurrent,deeply,deflexed,dense,densely,dia,eaf,edicel,eed,exserted,flattened,fleshy,free,glandular-resinous,grayish-brow,incrassate,inflorescenc,irregularly,junction,lobe,lon,long,lower,midrib,minutely,nflorescence,often,older,onto,paler,papillae,papillo,papillose,pitted,planar,plurifoliat,poricidal,portion,prominent,pubescent,rounded,rounded-triangular,ruit,simple,somewhat,soon,spaced,specimen,stem,straight,surface,tall,tapering,thick,thickened,tip,trichome,tub,ud,uniseriate,visible,woody,ympodial,young	articulation,bract,branching,breeding,cell,colour,connective,form,fruit,growth,hair,height,heteromorphism,inflorescence,insertion,interjected,interpetalar,leaflet,length,marking,mature,modification,na,number,odour,orientation,pattern,placement,plurifoliate,position,prickle,pseudostipule,rhizome,scale,seed,shape,size,spacing,spot,staman,stone,structure,symmetry,sympodial,system,texture,tissue,tuber,type,xylopodia	0.25-0.5,0.6-1,1-1.5,1-2,1.2-1.5,1.7-3,10-25-flowered,2-5,2/3,4-4.5,4.5-13,6-10,6-8,acute,apart,base,becoming,berry,branched,broadly,brownish,capitate,cm,coriaceous,cup-shaped,dark,dry,elliptic,flattened-reniform,glabrous,globose,green,greenish-tan,later,lateral,leaf,live,lobed,main,material,mm,narrowly,occasionally,opposite,pair,plant,red-papillose,revolute,several,shaped,shrub,tear-drop,terminal,time,vein,way,white,x	na,plurifoliate
22	wfo-0001025893	success	157	102	46	55	102	47	44	2	.5,1.5-2,2-2.5,accrescent,along,anther,apex,attenuate,base,beneath,berry,branched,calyx,cm,corolla,difoliate,elliptic,filament,fruit,fruiting,geminate,glabrous,globose,golden-puberulent,green,internodal,leaf,lobed,long,margin,minutely,mm,narrowly,nearly,obovate,occasionally,opposite,pedicel,petiole,pore,poricidal,red-papillose,shaped,shrub,slightly,sometimes,tear-drop,tip,unicellular,unit,usually,vein,white,woody,x	.25,.4,0.5-1.5,0.8-1,1-1.2,1-1.5,1-2.5,1-4,1.5-1.7,11-20,2-3,3-5,5-6,6-10,anthesi,bank,barely,bark,bearing,beginning,bi-lobed,blade,broadly,brownish-green,capitate,closely,cup-shaped,decurrent,deflexed,deltoid,densely,dia,dry,eaf,early,eed,ellipsoid,erect,even,exserted,faintly,flower,free,glabrate,gravelly,greyish,growing,impressed,inflorescenc,lateral,lobe,lon,long-acuminate,longitudinally,lower,main,many,material,middle,nflorescence,older,ovary,overlapping,ovoid-reniform,pair,pale,papillo,papillose,pitted,planar,plurifoliat,portion,puberulent,reflexed,river,rocky,ruit,sandy,scar,slender,spaced,specimen,stem,stigma,straight,stream,striat,style,surface,tall,tapering,thickened,time,trichome,tube,ud,visible,widest,winged,yellowish,ympodial,young	appressed,articulation,bract,branching,breeding,cell,colour,connective,form,growth,hair,heteromorphism,inflated,inflorescence,insertion,interjected,interpetalar,leaflet,length,marking,mature,modification,na,odour,orientation,paired,pattern,placement,plurifoliate,position,prickle,pseudostipule,rhizome,scale,shape,spot,staman,stone,structure,symmetry,sympodial,system,texture,tissue,tuber,type,xylopodia	.5,1.5-2,2-2.5,accrescent,along,attenuate,base,beneath,berry,branched,cm,difoliate,elliptic,fruit,geminate,glabrous,globose,golden-puberulent,green,internodal,leaf,lobed,long,minutely,mm,narrowly,nearly,obovate,occasionally,opposite,poricidal,red-papillose,shaped,shrub,slightly,sometimes,tear-drop,tip,unicellular,usually,vein,white,woody,x	na,plurifoliate
23	wfo-0001025896	success	146	154	83	96	50	58	78	5	-3,-30,0.5,0.5-2,1-1.5,1-25,1-3,1-6.5,1-8,1.5-2,1.5-9,10-15,2-2.5,2.5-14,2.5-5,4,4-5,4-6,5-15,6-10,7-,7743,abaxial,acosta,acuminate,also,angled,apart,apex,articulated,base,brownish,calyx,cell,chartaceous,cm,constricted,cuneate,cylindrical,deltate,densely,diameter,directed,eglandular,elliptic-ovate,entire,flower,forked,fruit,glabrous,gland,globose,greenish,hair,inflated,like,lobe,long,margin,membranaceous,mm,moderately,obtuse,often,orange,ovate,pale,pedicel,peduncle,petiole,pore,pubescent,purple,rachi,radiu,red,ripe,rotate-stellate,rugose,short-stalked,shrub,simple,smooth,solí,stem,stigma,stone,style,subcordate,triangular-subulate,tube,unbranched,unit,white,x,yellow	.5-2.5,10-25,2-14,4-12,4-23,5-7,6-13,abaxially,absen,acute,adaxiall,adaxially,aggregate,axe,ba,blade,branched,connivent,dendritically,distall,eaf,eed,especially,lower,many-foliat,near,nearly,nflorescence,nther,occasionally,orolla,perfect,present,puberulent,pubescen,ruit,spaced,sparsely,stalked,surface,tal,tem,time,tip,triangular-ovate,truncat,vary,vein,wide,ympodial	absent,adaxial,anther,articulation,bract,branching,breeding,colour,connective,corolla,direction,distally,filament,form,fruiting,growth,height,heteromorphism,inflorescence,insertion,interjected,interpetalar,leaf,leaflet,length,many-foliate,marking,modification,na,number,odour,orientation,ovary,paired,pattern,placement,plant,position,prickle,pseudostipule,rhizome,scale,seed,shape,spacing,spot,staman,structure,symmetry,sympodial,system,texture,tissue,trichome,truncate,tuber,type,xylopodia	-3,-30,0.5,0.5-2,1-1.5,1-25,1-3,1-6.5,1-8,1.5-2,1.5-9,10-15,2-2.5,2.5-14,2.5-5,4,4-5,4-6,5-15,6-10,7-,7743,acosta,acuminate,also,angled,apart,apex,articulated,base,brownish,chartaceous,cm,constricted,cuneate,cylindrical,deltate,densely,directed,eglandular,elliptic-ovate,entire,forked,glabrous,gland,globose,greenish,hair,inflated,like,long,membranaceous,mm,moderately,obtuse,often,orange,ovate,pale,pubescent,purple,red,ripe,rotate-stellate,rugose,short-stalked,shrub,simple,smooth,solí,stem,subcordate,triangular-subulate,tube,unbranched,white,x,yellow	absent,distally,many-foliate,na,truncate
24	wfo-0001025902	success	211	128	65	79	132	49	60	5	/2,0.1-0.5,1-1.5,1.5,1983,4-13,4-5,5-6,anther,anthesi,apex,articulated,attenuate,axi,base,becoming,berry,black,branched,branching,cabrera,calyx,cell,chartaceous,cm,corolla,dull,ellipsoid,fide,filament,fleshy,fruiting,glabrous,globose,growth,inflorescence,lanceolate,lateral,leaf,leaf-opposed,leaving,length,lengthening,linear,lobed,lower,margin,mature,mm,pedicel,peg,perfect,petiole,plurifoliate,pore,poricidal,rotate-stellate,simple,sleeve,slender,slit,small,sometimes,somewhat,spreading,stem,surface,terminal,time,tip,trichome,unit,usually,vine,violet,way,woody,x,yellowish	.2,.5,0.5-2,0.5-2.5,1-1.2,1.2-1.5,1.5-2,1.5-3,1/3,11-15,2-6,2.5-4,3-10,4,4-6,40,5-merou,8-10,8-15,8-9,>,abaxially,absent,accompanied,acute,adaxially,ag,aid,along,always,alyx,apar,ark,bark,beginning,berr,branch,broadly,c.,circular,clavate,climbin,completely,conical,connivent,deciduou,deltate,densely,diameter,eaf,eed,either,entire,except,exfoliatin,exserted,flattened-reniform,flower,free,geminat,green,ilament,less,lobe,long,loosely,low,markedly,midvei,minute,minutely,new,nflorescence,obscured,occasionally,often,older,one,orolla,ovary,pair,pale,papillat,papillose,peduncle,pendant,per,pericarp,pitted,planar,portion,primary,prominent,pubescent,revolute,ridged,rounded,ruit,scar,scattered,scrambling,semi-aquati,semi-circular,shallow,soon,spaced,sparsely,stigma,strongly,style,tangled,tapering,tem,testal,thin,tube,twining,ud,ultimate,uniseriate,vary,vegetation,vein,water,weak,weight,whitish,widely,wing,yellow,ympodial,½	5-merous,age,appressed,articulation,bract,breeding,broad-based,colour,connective,form,fruit,geminate,hair,heteromorphism,inflated,insertion,interjected,interpetalar,leaflet,marking,modification,na,needle-like,odour,orientation,paired,pattern,placement,position,prickle,pseudostipule,rhizome,scale,shape,smell,spot,staman,stone,structure,symmetry,sympodial,system,texture,tissue,tuber,type,vegetative,xylopodia,zygomorphy	/2,0.1-0.5,1-1.5,1.5,1983,4-13,4-5,5-6,anthesi,articulated,attenuate,axi,base,becoming,berry,black,branched,cabrera,chartaceous,cm,dull,ellipsoid,fide,fleshy,glabrous,globose,inflorescence,lanceolate,lateral,leaf-opposed,leaving,lengthening,linear,lobed,mature,mm,peg,perfect,plurifoliate,pore,poricidal,rotate-stellate,simple,sleeve,slender,slit,small,sometimes,somewhat,spreading,terminal,time,tip,usually,vine,violet,way,woody,x,yellowish	5-merous,age,geminate,na,zygomorphy
25	wfo-0001025906	success	188	148	76	96	92	52	74	2	0-14,0.1-2,0.15-0.6,0.20-0.60,1-2,1.1-2,2-4.4,2-6,2.6-5.2,3-10,4-10,4-12,4-7,5-6,5-7,5.2-9,8-16,8.5-12.5,anther,apex,base,berry,blade,blue,brownish,cell,clavate,cm,condition,coriaceous,corolla,covering,cuneate,dark,diameter,distal,drying,filament,flower,forked,fresh,fruit,glabrous,globose,green,greenish,hair,hair-like,half,herb,high,homostylous,interjected,lanceolate,lateral,leaf,leaflet,light,lilac,linear,long,mm,odd-pinnate,ovoid,pair,pedicel,pentagonal,petiole,plant,plurifoliate,pore,poricidal,pubescent,purple,rotate,seed,shiny,short,size,sparsely,stigma,straight,stripe,style,sub-glabrous,subglabrous,terminal,testal,thick,tip,tri-,unit,wall,white,whitish,x	0.2-0.6,1-3,1-6,1.6-12.4,1.8-4.8,16-51,3-5,4-5,5-merou,abaxially,acumen,acute,adaxiall,adaxially,ag,alyx,apart,apparently,articulated,axe,axillary,bud,capitat,connivent,decreasing,decurrency,decurrent,delimited,digestion,diminishing,dorsally,eaf,edge,eed,enzyme,erec,exceeding,falcate,first,flat,folded,geminat,generally,glabrou,green-white,hal,honeycomb-shaped,lengthening,living,lobe,lower,make,mucilaginous,next,nflorescence,obtuse,orolla,peduncle,perfect,rachi,removed,ripe,ruit,second,sessile,seudostipule,slightly,slit,smaller,spaced,specimen,stamen,subequal,subglabrou,subtending,tall,tamen,tem,third,throughout,toward,tube,typically,unwinged,usually,vary,well,wet,width,wood,yellow,ympodial	abaxial,adaxial,appressed,arrangement,articulation,bract,branching,breeding,calyx,capitate,colour,connective,form,fruiting,growth,height,heteromorphism,inflated,inflorescence,insertion,interpetalar,length,margin,marking,mature,modification,na,odour,orientation,ovary,paired,pattern,placement,position,prickle,pseudostipule,rhizome,scale,shape,spot,staman,stem,stone,structure,symmetry,sympodial,system,texture,tissue,tuber,type,xylopodia	0-14,0.1-2,0.15-0.6,0.20-0.60,1-2,1.1-2,2-4.4,2-6,2.6-5.2,3-10,4-10,4-12,4-7,5-6,5-7,5.2-9,8-16,8.5-12.5,berry,blue,brownish,cell,clavate,cm,condition,coriaceous,covering,cuneate,dark,distal,drying,forked,fresh,glabrous,globose,green,greenish,hair,hair-like,half,herb,high,homostylous,lanceolate,lateral,light,lilac,linear,long,mm,odd-pinnate,ovoid,pentagonal,plurifoliate,poricidal,pubescent,purple,rotate,shiny,short,sparsely,straight,stripe,sub-glabrous,subglabrous,terminal,testal,thick,tip,tri-,wall,white,whitish,x	capitate,na
26	wfo-0001025907	success	147	149	69	92	55	57	64	5	-4,.05,.5,.5-1,0.8-1.8,1-1.2,1-2.3,1-3,1-5,1.5-2,1.5-2.2,10-15,12-45,2,2-3.5,2-8,2/3,3-5-15,3/2,4-5,acuminate,acute,anther,apex,attenuate,axil,axillary,base,beak,berry,brown,calyx,cell,cm,conical,conspicuously,densely,diameter,elliptic,epidermal,filament,flower,fruit,fruiting,glabrous,globose,green,greenish,growth,highly,included,irregular,lower,margin,minutely,mm,nearly,new,obovate,ovary,ovoid-reniform,pair,papillate,papillose,pedicel,per,petiole,plant,poricidal,primary,projection,pubescent,red-papillate,round,rugose,seed,shrub,simple,sinuous,size,stigma,style,surface,tip,trichome,tube,uniseriate,unit,vein,white-lenticellate,without,x	0,0-60,1,3-4,absent,along,anthesi,anthesis5-7,anticlinal,appearing,bearing,breaking,c,clavat,deciduous,eaf,edicel,eed,erec,flattened,free,iquito,isolated,lamina,lobe,lobed,lon,long,near,nflorescence,occasionally,open,population,portion,raised,reflexed,remaining,ruit,scar,scattered,single-stemmed,slender,soon,sparsely,tal,tem,thickening,time,truncate,tub,ud,unifoliat,variable,white,ympodial	5-7,appressed,articulation,bract,branching,breeding,bud,clavate,colour,connective,corolla,erect,form,hair,height,heteromorphism,inflated,inflorescence,insertion,interjected,interpetalar,leaf,leaflet,length,lenticellate,lobing,marking,mature,modification,na,odour,orientation,paired,pattern,placement,pore,position,prickle,pseudostipule,rhizome,scale,shape,spot,staman,stem,stone,structure,symmetry,sympodial,system,texture,tissue,tuber,type,unifoliate,width,xylopodia	-4,.05,.5,.5-1,0.8-1.8,1-1.2,1-2.3,1-3,1-5,1.5-2,1.5-2.2,10-15,12-45,2,2-3.5,2-8,2/3,3-5-15,3/2,4-5,acuminate,acute,attenuate,axil,axillary,base,berry,brown,cm,conical,conspicuously,densely,elliptic,glabrous,globose,green,greenish,highly,irregular,lower,minutely,mm,nearly,obovate,ovoid-reniform,pair,papillate,papillose,per,poricidal,primary,projection,pubescent,red-papillate,round,rugose,shrub,simple,sinuous,tip,uniseriate,white-lenticellate,without,x	5-7,clavate,erect,na,unifoliate
27	wfo-0001026203	success	197	165	82	110	87	55	80	2	0-39,0.06-0.86,0.38-11.3,0.4-3,0.5-2.3,0.7-2.6,1-13,1-2,1-4,1-5,1-9,1.2-5.5,2-10,2-4.9,2-43,2-5,2-8.5,2.2-13.3,3-10,3-11,3.2-22,3.2-23,7-47,acumen,anther,apex,asymmetric,attenuate,base,blade,blue,brownish,cell,clavate,cm,condition,coriaceous,corolla,dark,deep,diameter,distal,drying,edge,filament,flat,flower,forked,fresh,fruit,glabrescent,glabrous,globose,green,greenish,hair,hair-like,half,herb,high,homostylous,interjected,lanceolate,lateral,leaf,leaflet,light,lilac,lobe,long,lower,medium,middle,mm,moniliform,odd-pinnate,ovate,ovoid,pair,pedicel,peduncle,pentagonal,petiole,plant,plurifoliate,pore,poricidal,rotate,rounded,seed,sessile,short,size,stigma,straight,style,subglabrous,terminal,testal,tip,tissue,tri-,tube,tuber,unit,wall,white,whitish,wide,x	0-7,0.3-11,0.3-6,0.5-3.2,1.1-7.9,3-5,5-merou,abaxially,acuminate,acute,adaxially,ag,along,alyx,apart,apparently,arranged,articulated,axe,axillary,basiscopic,bead,berry,bud,capitat,connivent,covering,decreasing,decurrent,digestion,dorsally,eaf,eed,elliptic,enzyme,erect,exceeding,folded,geminat,generally,glabrescen,glabrou,green-white,hal,honeycomb-shaped,lengthening,like,linear,living,make,mucilaginous,multiple,necklace,nflorescence,orbicular,orolla,perfect,rachi,removed,ripe,rosett,ruit,seudostipule,side,slightly,slit,sometimes,spaced,specimen,stamen,stolon,stripe,subequal,subtending,tall,tamen,tem,thick,throughout,toward,typically,unwinged,usually,vary,wet,yellow,ympodial	abaxial,adaxial,arrangement,articulation,bract,branching,breeding,broad-based,calyx,capitate,colour,connective,form,glabrousnes,growth,height,heteromorphism,inflorescence,insertion,interpetalar,length,margin,marking,mature,modification,na,needle-like,number,odour,orientation,ovary,paired,pattern,placement,position,prickle,pseudostipule,rhizome,scale,shape,smell,spot,staman,stem,stone,structure,surface,symmetry,sympodial,system,texture,trichome,type,vegetative,xylopodia	0-39,0.06-0.86,0.38-11.3,0.4-3,0.5-2.3,0.7-2.6,1-13,1-2,1-4,1-5,1-9,1.2-5.5,2-10,2-4.9,2-43,2-5,2-8.5,2.2-13.3,3-10,3-11,3.2-22,3.2-23,7-47,asymmetric,attenuate,blue,brownish,cell,clavate,cm,condition,coriaceous,dark,deep,distal,drying,flat,forked,fresh,glabrescent,glabrous,globose,green,greenish,hair,hair-like,half,herb,high,homostylous,lanceolate,lateral,light,lilac,long,medium,middle,mm,moniliform,odd-pinnate,ovate,ovoid,pentagonal,plurifoliate,poricidal,rotate,rounded,sessile,short,straight,subglabrous,terminal,testal,tip,tri-,wall,white,whitish,wide,x	capitate,na
28	wfo-0001026208	success	210	103	43	58	152	45	41	2	1-5,3.5-5,anther,apex,articulated,base,berry,branched,bright,calyx,chartaceous,cm,connivent,cuneate,dark,densely,difoliate,erect,filament,fruit,fruiting,geminate,lateral,leaf,length,lobed,long,lower,margin,mature,maturity,mauve,membranous,mm,moderately,orange,pale,pedicel,petiole,poricidal,prickle,recurved,red,rounded,shrub,sometimes,spherical,stellate,stellate-pubescent,stem,subentire,surface,tapering,terminal,tip,trichome,unit,white	.5,/3,0-20,0-4,0-5,0-8,0.1,0.1-0.2,0.1-0.25,0.1-0.3,0.5-0.8,0.5-1.2,0.6-0.8,0.6-0.9,0.7-2,0.8-1.3,0.8-1.5,1-2,1-4,1.5,1.5-2.5,1.8-2.3,1.8-2.5,1/3,1/3-1/2,1/4-1/3,1/4-1/6,2,2-20,2-3,2-4,2.5-5,2.5-6,3-30,3-5,3-6,3/,4-7,4-9,5,5-10,5-11-25,5-17,5-22,5-merous,6-22,6-8,abaxial,abaxially,acuminate,acut,acute,adaxial,alyx,apar,apart,apically,apparently,bark,becoming,blade,broad-deltate,brown,conical,curved,deltate,diameter,discolorous,distance,drying,dull,eaf,eed,elliptic,elongated,elongating,equal,evenly,extending,flattened,flattened-reniform,flower,free,geminat,glabrescent,glabrous,gray-greenish,green,green-brown,infructescence,lobe,longer,midpoint,midvein,nflorescence,older,one,open,orange-brown,orolla,oung,ovate,pair,peduncle,pendulous,per,perfec,pericarp,porrect,portion,prickly,primary,pubescent,ray,red-brow,ruit,scar,sessile,shorter,side,slender,smooth,somewhat,spaced,sparsely,spreading,stalk,stalked,stout,straight,straw-yellow,style,tamen,terete,tertiary,time,toward,tube,unarme,unarmed,usually,variously,vary,vein,venation,visible,way,wide,woody,yellow,ympodial,young	appressed,articulation,bract,branching,broad-based,cell,colour,corolla,form,growth,hair,heteromorphism,inflated,inflorescence,insertion,interjected,interpetalar,leaflet,marking,na,needle-like,odour,orientation,paired,placement,position,present,pseudostipule,rhizome,scale,shape,smell,spot,staman,stone,structure,symmetry,sympodial,texture,tissue,tuber,type,vegetative,xylopodia,zygomorphy	1-5,3.5-5,articulated,base,berry,branched,bright,chartaceous,cm,connivent,cuneate,dark,densely,difoliate,erect,geminate,lateral,lobed,long,maturity,mauve,membranous,mm,moderately,orange,pale,poricidal,recurved,red,rounded,shrub,sometimes,spherical,stellate,stellate-pubescent,subentire,surface,tapering,terminal,tip,white	na,present
29	wfo-0001026215	success	150	151	76	95	55	56	72	4	-3,.5,0,0.05,0.5-1,1-3,1.5,1.5-2,1.5-2.2,13-35,18-20,2-3,2-3.5,2-4,3/4,4-15,7-8,anther,apex,axillary,base,beak,berry,broadly,brown,calyx,cell,clavate,cm,completely,conical,conspicuously,corolla,densely,diameter,elliptic,enlarged,epidermal,erect,filament,flattened-round,fruit,fruiting,glabrous,green,greenish,herb,highly,horizontal,internode,irregular,kink,length,less,lobed,marked,markedly,mm,narrowing,nearly,often,ovary,ovoid-reniform,pair,papillae,pedicel,per,petiole,poricidal,primary,projection,purple,red-papillose,rugose,seed,shrub,simple,sinuous,stem,stigma,strongly,style,surface,tip,tube,unit,usually,vein,way,white,white-pubescent,wing,winged,without,x	.05,1,15-2,2,4-5,abaxially,abruptly,absent,acuminate,along,anthesi,anticlinal,ape,axil,bifi,continually,deltate,eaf,edicel,eed,entire,exserted,flower,free,globose,lobe,long,lower,minutely,nflorescence,noddin,nodding,occasionally,onto,papillat,papillate,portion,raised,reflexed,rounded,ruit,scar,shortsympodial,single-stemmed,small,ste,tal,tem,thickening,time,tub,ud,unifoliat,white-lenticellate,wide	appressed,articulation,bifid,bract,branching,breeding,colour,connective,form,growth,hair,height,heteromorphism,inflated,inflorescence,insertion,interjected,interpetalar,leaf,leaflet,lenticel,margin,marking,mature,modification,na,number,odour,orientation,paired,pattern,placement,plant,pore,position,prickle,pseudostipule,rhizome,scale,shape,short,size,spot,staman,stone,structure,symmetry,sympodial,system,texture,tissue,tuber,type,unifoliate,width,xylopodia	-3,.5,0,0.05,0.5-1,1-3,1.5,1.5-2,1.5-2.2,13-35,18-20,2-3,2-3.5,2-4,3/4,4-15,7-8,apex,axillary,base,berry,broadly,brown,clavate,cm,completely,conical,conspicuously,densely,elliptic,enlarged,erect,flattened-round,glabrous,green,greenish,herb,highly,horizontal,irregular,kink,less,lobed,marked,markedly,mm,narrowing,nearly,often,ovoid-reniform,pair,papillae,poricidal,primary,projection,purple,red-papillose,rugose,shrub,simple,sinuous,stem,strongly,tip,usually,vein,way,white,white-pubescent,winged,without,x	bifid,na,short,unifoliate
30	wfo-0001026229	success	299	96	49	63	236	33	45	4	1,anther,apex,articulated,asymmetric,base,berry,black,branching,corolla,cuneate,di­,elliptic,entire,fruit,glabrous,globose,green,growth,hair,immature,inflorescence,insertion,internodal,lateral,leaf,lobed,long,lower,margin,mature,membranaceous,mm,oblong,orientation,pale,pedicel,petiole,plurifoliate,pore,poricidal,purple,rarely,revolute,rounded,shrub,simple,slightly,small,spreading,stellate,stem,subopposite,surface,terminal,tree,trichome,trifoliate,type,unit,upper,white,¾	0.1–1.47,0.2–0.8,0.35,0.3–0.9,0.3–1.2,0.4,0.8–1.2,0.8–2,0.9,0.9–4.3,1-celled,1.2–4.8,1.3–1.5,1.3–1.7,1.4,1.7–11.8,1.7–2.3,1.8,1.8–5.5,1.9–2.5,1/3,13,1–1.4,1–2,1–4,2,2.3–3.4,2.8–4,2–3,2–3-celled,2–4-celled,3,35,3–4,3–5,4.5–6.5,4–6,5,5-merou,5–9,6–15,6–7,6–8,8.6–12,8–10,9–31,abaxial,abaxially,accrescent,acuminate,acute,adaxial,adaxiall,adaxially,ag,almost,also,always,alyx,anthesi,ark,associated,attenuate-caudate,axe,ba,barely,beneath,blade,branch,broadly,broken,brown,calyx,camptodromous,capitate,celled,central,changing,clavate,cm,commentary,commonly,completely,concentrated,connivent,cordate,covered,creating,cylindrical,cyme,dark,deltoid,densely,develope,developed,diameter,differing,directed,discolorous,dried,drying,eaf,eed,eglandular,ellipsoidal,elongated,even,faces,few-rayed,flattened,flower,found,free,frequently,fresh,fully,geminate,glabrescent,gland,glandular,glandular-capitate,golden,head,hirsute,hispid,hyaline,ilament,impressed,included,introrsely,involute,irregular,lamina,lanceolate,larger,less,like,lobe,long-stalked,longer,longitudinal,mainly,material,maturit,midpoint,midri,midvein,minute,mixed,moderately,much,multangulate,multangulate-stellate,multiseriate,narrow-ovate,narrowly,near,nearly,new,nflorescence,often,old,older,one,open,opening,orolla,other,oung,ovate,ovate-elliptic,pair,paired,papillose,peduncle,pedunculate,per,perfect,pink,pit,point,poorly,porrect-stellate,portion,primary,pubescent,purplish,ra,rachi,raised,ray,remnant,reniform,ruit,secondary,see,sessile,shin,shiny,short-,short-stalked,shorter,size,slit,smaller,solitary,sometimes,somewhat,sparsely,spread,spreadin,stalk,stigma,strongly,style,subsessile,supported,surfac,three,tube,tuft,ud,unbranched,unequal,usually,vary,vein,venation,vestiture,visible,weakly,whitish-green,wide,yellow,yellowish-white,ympodial	1.8-5.5,2.8-4,articulation,bract,broad-based,cell,colour,connective,filament,form,heteromorphism,length,na,needle-like,odour,pattern,placement,position,prickle,pseudostipule,rhizome,shape,smell,staman,stone,structure,symmetry,sympodial,texture,tuber,vegetative,xylopodia,zygomorphy	1,apex,articulated,asymmetric,base,berry,black,cuneate,di­,elliptic,entire,glabrous,globose,green,immature,internodal,lateral,leaf,lobed,long,mature,membranaceous,mm,oblong,pale,plurifoliate,poricidal,purple,rarely,revolute,rounded,shrub,simple,slightly,small,spreading,stellate,stem,subopposite,terminal,tree,trifoliate,upper,white,¾	1.8-5.5,2.8-4,na,zygomorphy
31	wfo-0001026230	success	144	155	81	97	47	58	73	8	.25,.5,.8,0.3-1.5,0.75-1,0.9-2,1-1.5,1-4,1.1-1.8,1.8-2.3,1.9-4.1,12.6-20.8,2-4,2-5,3-4,4.6-9.3,5-10,5-20-flowered,acuminate,acute,anther,apart,apex,apiculate,area,bark,base,beginning,berry,broadly,bud,calyx,clavate,cm,cordate,corolla,dia,difoliate,distal,elliptic,erect,except,filament,fruit,fruiting,geminate,glabrous,globose,green,grey,large,lateral,leaf,lobe,lobed,long-acuminate,main,margin,minor,minutely,mm,nearly,obtuse,older,opposite,orbicular,ovary,ovoid,pair,papillose,pedicel,petiole,pore,rounded,rusty-papillose,scar,shaped,shrub,slightly,small,stem,stigma,straight,strongly,style,tear-drop,tip,tree,tube,unit,unknown,vein,white,winged,woody,x,young	0.5-3,1-1.4,anisomorphic,anisophyllou,anthesi,appears,back,beneath,clu,completely,coroll,deflexed,deltoid,eaf,edicel,eed,enclosing,evenly,free,immature,inflorescenc,lon,long,long-triangular,lower,major,middle,nflorescence,pointed,poricidal,portion,raised,reflexed,ruit,simple,sinus,slender,spaced,surface,tall,tapering,thickened,ud,umbonate,white-lenticellat,widest,ympodial	anisophyllous,appressed,articulation,bract,branching,breeding,cell,club,colour,connective,diameter,flower,form,growth,hair,height,heteromorphism,inflated,inflorescence,insertion,interjected,interpetalar,leaflet,length,marking,mature,modification,na,number,odour,orientation,paired,pattern,placement,plant,position,prickle,pseudostipule,rhizome,scale,seed,shape,size,spacing,spot,staman,stone,structure,symmetry,sympodial,system,texture,tissue,tuber,type,white-lenticellate,xylopodia,zygomorphy	.25,.5,.8,0.3-1.5,0.75-1,0.9-2,1-1.5,1-4,1.1-1.8,1.9-4.1,12.6-20.8,2-4,2-5,3-4,4.6-9.3,5-10,5-20-flowered,acuminate,acute,apart,apiculate,area,base,beginning,berry,broadly,bud,clavate,cm,cordate,difoliate,distal,elliptic,erect,except,geminate,glabrous,globose,green,grey,large,lateral,leaf,lobed,long-acuminate,main,minutely,mm,nearly,obtuse,opposite,orbicular,ovoid,pair,papillose,petiole,rounded,rusty-papillose,shaped,shrub,slightly,small,straight,strongly,tear-drop,tip,tree,vein,white,winged,woody,x,young	.8-2.3,anisophyllous,club,di,inflorescence,na,white-lenticellate,zygomorphy
32	wfo-0001026233	success	157	148	73	87	70	61	67	6	.25,.75,0.3,0.5,0.7-0.8-1,0.8-1.55-1.9,1-,1.1,1.2-2.7,1.5,1/2,2,2-,2.4-3.5-3.8,2/3,3.5-4.5-5.5,5-30-50,6,accrescent,acute,annular,anther,apex,ascending,basal,base,berry,broadly,calyx,campanulate,capitate,cm,coat,cuneate-attenuate,densely,diameter,ellipsoidal,elliptic,embryo,entire,few-,filament,fruiting,glabrous,globose,hair,herb,herbaceous,investing,leaf,less,lilac,lobe,longitudinally,margin,mm,narrowly,non-glandular,ovate,ovule,pale,partially,petiole,pinnatisect,pore,poricidal,present,pubescent,ridged,seed,simple,slender,sparsely,stigma,style,subglobose,tip,trans-ovoidal,trichome,tube,tuberculate,unifoliate,uniseriate,unit,winged,x,yellow	0.7-0.8-1.3,0.8-4,1,2.1,2.3-7,2.6,3.2-3.7,3.2-4.7,4-5-6.2-8.1,abundant,ag,annual,antrorse,articulated,bearing,conspicuous,curved,cylindrical,difoliat,dimorphic,eaf,eed,evident,hig,interlobular,lamina,larger,lobed,long,longitudinal,lower,membrane,minutely,moderately,multicellular,near,obtuse,occasionally,opening,orolla,other,outer,papery-scarious,pinnatipartite,portion,protuberance,pubescen,ree,reticulate,rounded,ruit,scarcely,seede,serrate,shorter,slightly,slit,small,smaller,striate,strongly,styl,surface,tem,unequal,vary,venatio,verrucose,wider,ympodial	0.7-1.3,4-6.2-8.1,articulation,bract,branching,breeding,cell,colour,connective,corolla,difoliate,dimorphism,form,fruit,growth,height,heteromorphism,inflorescence,insertion,interjected,interpetalar,leaflet,length,marking,mature,modification,na,number,odour,orientation,ovary,paired,pattern,pedicel,placement,plant,position,prickle,pseudostipule,rhizome,ridging,scale,seeded,shape,size,spot,staman,stellate,stem,stone,striation,structure,symmetry,sympodial,system,texture,tissue,tuber,type,width,xylopodia	.25,.75,0.3,0.5,0.7-0.8-1,0.8-1.55-1.9,1-,1.1,1.2-2.7,1.5,1/2,2,2-,2.4-3.5-3.8,2/3,3.5-4.5-5.5,5-30-50,6,accrescent,acute,annular,ascending,basal,berry,broadly,campanulate,capitate,cm,cuneate-attenuate,densely,diameter,ellipsoidal,elliptic,entire,few-,glabrous,globose,hair,herb,herbaceous,investing,less,lilac,longitudinally,mm,narrowly,non-glandular,ovate,pale,partially,pinnatisect,poricidal,present,pubescent,ridged,simple,slender,sparsely,subglobose,tip,trans-ovoidal,tuberculate,unifoliate,uniseriate,winged,x,yellow	0.7-1.3,4-6.2-8.1,difoliate,na,seeded,stellate
33	wfo-0001026241	success	220	108	47	59	161	49	39	8	109,3-,4-,abaxially,anther,apex,articulated,base,berry,black,branching,brown,calyx,cell,cm,cordate,corolla,densely,difoliate,dry,et,filament,foliose,fruit,fruiting,galiano,geminate,glandular-pubescent,globose,herb,inflorescence,internodal,leaf,leaflet,lobed,margin,mm,orangish,papillate,pedicel,petiole,pinnatifid,pubescent,sometimes,stellate,stem,subshrub,succulent,surface,ternate,thick,thickened,tissue,trichome,unit,usually,way,white,x	.2,.3,.5,0.1–0.15,0.2–,0.3–,0.3–0.4,0.3–0.6,0.3–1,0.5,0.5–0.7,0.5–0.8,0.5–1,0.7–1.1,1-,1-celled,1.2–1.5,1.2–2,1.5–1.7,1.5–2.5,1.5–3.5,1.9–2.1,1/3–1/2,10-20,1–,1–1.1,1–1.4,1–1.5,1–2,2-flowered,2.5–3,2–2.1,2–3,3,30–50,3–3.1,4.5–5,5,5-celled,5-merous,6,adaxially,always,anthesi,apical,appearing,appears,attenuate,ba,basal,basiscopically,beak,brittle,broader,campanulate,capitate,center,conical,connecting,covered,cup,curved,curving,darker,decurrent,deflexe,dehiscing,deltate,denser,depressed-globose,dia,discrete,drying,dwarf,eaf,eglandular,elliptic,enclosed,entire,equal,erect,erose,extended,flower,foliat,free,glabrous,gland,glandular,intially,irregularly,larger,lateral,like,lobe,lon,long,longitudinal,main,midvein,mixture,much,near,nflorescence,oblique,one,onto,open,outline,ovary,ovate,ovoid,papillat,peduncle,per,perennial,perfect,pericarp,pitted,pore,portion,prolonged,pubescen,pulp,rachi,remain,reniform,robust,ruit,seed,shallowly,shiny,simple,sinuate,slightly,slit,small,smaller,somewhat,spatulate,stamen,stigma,stout,strongly,style,sulcate,taproot,terminal,testa,tip,triangular,truncate,tube,tuberculate,ud,uniseriate,vein,wide,wing,woody,ympodial	1-1.1,1-2,1/3-1/2,2-2.1,2.5-3,appressed,articulation,bract,broad-based,colour,decurred,foliate,form,growth,hair,heteromorphism,inflated,insertion,interjected,interpetalar,length,lower,marking,mature,na,needle-like,odour,orientation,paired,placement,position,prickle,pseudostipule,rhizome,scale,shape,smell,spot,staman,stone,structure,symmetry,sympodial,texture,tuber,type,vegetative,xylopodia,zygomorphy	109,3-,4-,abaxially,articulated,base,berry,black,brown,cm,cordate,densely,difoliate,dry,et,foliose,galiano,geminate,glandular-pubescent,globose,herb,internodal,lobed,mm,orangish,papillate,pinnatifid,pubescent,sometimes,stellate,subshrub,succulent,ternate,thick,thickened,usually,way,white,x	1-1.1,1-2,1/3-1/2,2-2.1,2.5-3,decurred,foliate,na
34	wfo-0001026242	success	205	74	28	40	165	34	25	3	1-1.5,1.5-4,2.5-4.5,anther,apex,base,berry,bright,cm,cuneate,difoliate,equal,erect,evenly,filament,fruit,green,hair,lateral,leaf,length,lobed,long,lower,margin,membranous,mm,pedicel,petiole,prickle,recurved,red,shrub,spherical,stem,surface,tapering,trichome,unit,white	-1.5,-6,/4,0,0-2,0-5,0.05-0.2,0.1,0.3-0.5,0.35-0.4-0.55-0.9,0.4-0.5,0.4-2,0.5,0.5-0.7,0.5-1,0.55-0.9,0.7,0.7-1.3,1-2.5,1-3,1.2-2,1.5-3,1/2,1/5-1/3,1/6-1/4,10-20,10-30-80,2-2.5,2-5,2.5-2.8,3-6.5,4-10,4-13,4-5-merous,4.5-5.5,5-18,5-7,5-8-20,6.5-8,7-17,abaxial,abaxially,acut,acute,almost,alyx,ame,apar,apart,apically,apparently,articulated,bark,blade,branched,broad-deltate,c.,calyx,concolorous,connivent,curved,deltate,densely,diameter,distance,drying,dull,eaf,eed,elliptic,elongating,extending,eye,filiform,flattened,flattened-reniform,flower,free,fruiting,geminat,glabrescent,glabrou,glabrous,glandular,green-gra,infructescence,irregularly,largely,lobe,longer,mature,maturity,midpoint,midvein,minute,moderately,multangulate,naked,narrow-deltate,nflorescence,obtuse,occasionally,older,one,open,orange-brown,orolla,oung,pair,pale,pale-brown,peduncle,per,perfec,pericarp,poricidal,porrect,portion,prickl,prickly,primary,ray,red-brown,reflexed,rounded,ruit,scar,sessile,shorte,shorter,side,simple,smooth,sometimes,spaced,sparsely,spreading,stalk,stalked,stellate,stellate-pubescent,straight,style,subentire,tamen,terete,tertiary,time,tip,tube,unarme,unarmed,upper,variously,vary,vein,venation,visible,way,weakly,wide,woody,yellow,ympodial,young	articulation,branching,broad-based,cell,colour,corolla,form,growth,heteromorphism,inflorescence,insertion,na,needle-like,odour,orientation,placement,position,present,pseudostipule,rhizome,scale,shape,smell,staman,stone,structure,symmetry,sympodial,texture,tuber,type,vegetative,xylopodia,zygomorphy	1-1.5,1.5-4,2.5-4.5,base,berry,bright,cm,cuneate,difoliate,equal,erect,evenly,green,lateral,lobed,long,membranous,mm,recurved,red,shrub,spherical,surface,tapering,white	na,present,zygomorphy
35	wfo-0001026259	success	233	120	69	75	158	45	62	7	.8,0.3–1.2,0404,1–3-celled,3.0–3.4,?,affected,age,anther,apex,appressed,base,berry,branching,calyx,cell,central,cm,corolla,decurrent,difoliate,ellipsoid,entire,et,filament,fleshy,fruit,fruiting,green,green-orange,herb,inflorescence,internodal,knapp,lateral,leaf,length,lengthening,lilac,long,lower,margin,membranous,mm,much,once-branched,pathogen,pedicel,per,perfect,petiole,pore,poricidal,purple-black,rarely,ripe,rounded,shrub,simple,slit,somewhat,star,stellate,stem,stone,surface,tightly,tip,translucent,turning,uniseriate,unit,white,yellow,yellow-green	.1,.7,0.1–0.2,0.2–0.4,0.4–0.6,0.5,0.5–0.6,0.7–0.9,0–2,1,1-celled,1.0–1.2,1.0–3.3,1.2–8.4,1.4–4.0,1.5,1.5–2.0,11–22,12–24,1m,1–2,1–2-celled,2-ridged,2/3,2–17,2–3-celled,35–45,4–5,5-merous,5–14,5–7-celled,6,7–10,8–11,abaxial,abaxially,acuminate,acute,adaxial,adaxially,anthesi,apar,arising,becoming,beyond,branch,branched,broadly,brown,close,coloured,concave-reniform,cone,congested,conical-ellipsoid,cream-coloured,cylindrical,dehiscing,deltate,densely,diameter,drop,eaf,eed,elongating,end,especially,exerted,flower,free,geminat,glabrous,globose,gradually,growt,halfway,hilum,individual,larger,leave,less,like,live,lobe,lobed,lon,longer,lowermost,minutely,narrower,narrowly,near,nearly,nflorescence,node,occasionally,often,one,outline,ovary,ovate-lanceolate,pair,pale,papillate,peduncle,pentagonal,pericarp,plant,portion,positioned,primary,pubescent,purple,purple-coloured,rachi,recurving,reduced,reflexed,relatively,remaining,ruit,scar,shiny,short,shorter,similar,slightly,smooth,sometimes,spaced,sparsely,splitting,spreading,stigma,stout,straight,strongly,style,sub-laterally,tall,tapering,tem,testal,thick,tinged,together,toward,trichome,tube,two,ud,vein,wide,winged,woody,ympodial,young,–15	articulation,bract,breeding,broad-based,colour,connective,form,geminate,growth,hair,heteromorphism,inflated,insertion,interjected,interpetalar,leaflet,marking,mature,modification,na,needle-like,odour,orientation,paired,pattern,placement,position,present,prickle,pseudostipule,rhizome,scale,shape,spot,staman,structure,symmetry,sympodial,system,texture,tissue,tuber,type,xylopodia,ye	.8,0.3–1.2,0404,1–3-celled,3.0–3.4,?,affected,age,appressed,base,berry,branching,central,cm,decurrent,difoliate,ellipsoid,entire,et,fleshy,fruit,green,green-orange,herb,internodal,knapp,lateral,leaf,lengthening,lilac,long,lower,membranous,mm,much,once-branched,pathogen,per,perfect,petiole,pore,poricidal,purple-black,rarely,ripe,rounded,shrub,simple,slit,somewhat,star,stellate,stem,surface,tightly,tip,translucent,turning,uniseriate,white,yellow,yellow-green	broad-based,geminate,na,needle-like,present,prickle,ye
36	wfo-0001026267	success	162	137	70	82	80	55	64	6	0.6-1.7,0.7-1.1,1-1.2,1-2.6,1-4,1.5-2,2.5-3,3-15,3.2-8.6,5-7,acuminate,acute,anther,apex,attenuate,bark,base,blackish,body,bright,calyx,cm,corolla,crateriform,cuneate,decurrent,difoliate,drying,filament,flattened-reniform,glabrous,globose,green,greenish-white,greyish-green,incrassate,larger,leaf,lobed,lower,margin,minor,minutely,mm,narrowly,nearly,occasionally,opposite,ovary,ovate,pale,papillose,pedicel,petiole,pitted,pitting,pore,ripening,rough,scattered,shaped,shrub,size,slender,slightly,small,stem,stigma,straight,style,surface,tapering,tear-drop,tree,trichome,tube,uniseriate,unit,white,winged,x,yellow-green	.25,.5,0.1-1,0.5-1,1-1.5,1.5-2.3,20-30-flowered,3-6.1,4-8,8-10,8.5-15,anthesi,axil,ba,beginning,beneath,berry,broadly,closely,deflexed,densely,depressed,dia,differing,distally,distinct,eaf,edicel,eed,except,exerted,free,fruiting,geminat,hard,inflorescenc,lateral,lavender,lobe,lon,long,longinflorescence,main,major,maturity,middle,often,older,one,overlapping,pair,papillo,poricidal,portion,pubescent,quickly,raised,reflexed,remaining,ruit,scar,scarious,simple,softening,soon,spaced,sparsely,tall,tan,tinge,tip,triangular,tuft,ud,vein,widest,wing,woody,ympodial,young	0.25,0.5,1,20-30,abaxial,articulation,bract,branching,breeding,broad-based,cell,colour,diameter,flower,form,fruit,geminate,growth,hair,height,heteromorphism,inflorescence,insertion,interjected,interpetalar,leaflet,length,marking,na,needle-like,number,orientation,pattern,placement,plant,position,prickle,pseudostipule,rhizome,scale,seed,shape,spot,staman,stone,structure,symmetry,sympodial,system,texture,tissue,tuber,type,xylopodia,zygomorphy	0.6-1.7,0.7-1.1,1-1.2,1-2.6,1-4,1.5-2,2.5-3,3-15,3.2-8.6,5-7,acuminate,acute,attenuate,base,blackish,body,bright,calyx,cm,crateriform,cuneate,decurrent,difoliate,flattened-reniform,glabrous,globose,green,greenish-white,greyish-green,incrassate,larger,leaf,lobed,minutely,mm,narrowly,nearly,occasionally,opposite,ovate,pale,papillose,petiole,pitted,pitting,ripening,rough,scattered,shaped,shrub,slender,slightly,small,straight,tapering,tear-drop,tree,trichome,tube,uniseriate,white,winged,x,yellow-green	0.25,0.5,1,20-30,geminate,na
37	wfo-0001026279	success	244	121	66	85	159	36	64	2	0.8-2.3,0.9-1.8-2.9,1-1.4,1-10,1-3.5,11.5-19.7-34.3,3-4,3.1-4.2,8,anther,apex,appressed,attenuate,base,berry,black,blunt-tipped,branched,brown,bud,chartaceous,cm,corolla,cuneate,dark,deltoid,dendritic-echinoid,drying,echinoid,elliptic,entire,filament,fleshy,flower,fruit,globose,granular,grayish-green,green,hair,lanceolate,lavender,leaf,length,lilac,lower,many,margin,mature,minute,mixed,mm,multangulate,narrowly,oblong,obovate,orbicular,pale,pedicel,peduncle,petiole,plant,plurifoliate,pore,poricidal,porrect-stellate,rachi,sessile,short,short-stalked,shrub,simple,stellate,stem,suborbicular,surface,time,tip,tomentose-pubescent,tree,unit,unwinged,white,x,yellowish-tan	-4,/14-1/8,0.2-0.4,0.25-0.4,0.9-1,1.1-1.6,1.1-1.9,1.5-1.8,1.5-3,1.7-2.3,1.9-3,1.9-3.2,1/2,14-27,2.4-3.2,2.5-3.2,2.6-4.8,2/3,3.1-3.6,3.4-5.2-5.9,3.5-7.8,3.8-5.1,4-7.5,5-200,5-8,8-11,8.5-10.5-11.4,9-22,abaxially,accrescent,acuminate,acute,adaxiall,adaxially,ag,anthesi,apart,apparently,appearing,ark,around,articulated,axe,axillary,ba,blade,branch,calyx,capitate,closely,completely,conical,covering,cylindrical,dendritic-echinoi,dense,diameter,directed,distally,due,eaf,earl,echinoi,edge,eed,elongated,enveloping,equal,evident,exerted,expanded,farinose,few-rayed,free,fruiting,glabrescen,glabrescent,glabrous,grayish,half,immature,inserted,lateral,lengthening,lobe,lobed,long,long-stalked,longer,longitudinal,longitudinall,m.,main,midrib,multangulate-pubescent,multiseriate,nflorescence,occasional,occasionally,often,older,open,orolla,ovate-lanceolate,overlapping,partly,perfect,present,prominent,pseudo-terminal,pubescence,reticulate-punctate,rounded,ruit,scabridulous,scabrous,scattered,secondary,semi-ovate,short-,short-decurrent,side,slightly,slit,slowly,somewhat,spaced,splitting,stalk,stamen,stigma,style,subcampanulate,subcoriaceous,subsessile,sulcate,suture,tall,tamen,tertiary,thickened,thin,thin-stalked,tomentose,tube,ud,unarme,unarmed,upper,usually,vary,vein,way,whitish,wide,yellow,yellowish,ympodial,young	abaxial,arrangement,branching,broad-based,cell,colour,connective,form,growth,height,heteromorphism,inflorescence,marking,modification,na,needle-like,orientation,placement,position,prickle,pseudostipule,pseudoterminally,rhizome,seed,shape,spot,staman,stone,structure,symmetry,sympodial,texture,trichome,tuber,type,xylopodia	0.8-2.3,0.9-1.8-2.9,1-1.4,1-10,1-3.5,11.5-19.7-34.3,3-4,3.1-4.2,8,appressed,attenuate,berry,black,blunt-tipped,branched,brown,chartaceous,cm,cuneate,dark,deltoid,dendritic-echinoid,drying,echinoid,elliptic,entire,fleshy,flower,fruit,globose,granular,grayish-green,green,lanceolate,lavender,lilac,many,minute,mixed,mm,multangulate,narrowly,oblong,obovate,orbicular,pale,plurifoliate,poricidal,porrect-stellate,sessile,short,short-stalked,shrub,simple,stellate,suborbicular,time,tip,tomentose-pubescent,tree,unwinged,white,x,yellowish-tan	na,pseudoterminally
38	wfo-0001026299	success	236	108	50	67	169	41	48	2	--,0-8,0.1-0.2-1,0.1-0.4,0.1-0.4-1,0.1-0.5,0.25-0.5,0.4-0.5,0.5,0.5-1,0.5-2.5-3.5,2-4,2-foliate,2-locular,5,acute,anther,apex,base,bract,calyx,cell,cm,corolla,dark,densely,distal,filament,fruit,fruiting,glabrous,globose,green,half,herb,imparipinnate,inflorescence,interjected,interrupted,investing,lanceolate,leaf,leaflet,less,long,loosely,margin,middle,mm,pair,pedicel,pentagonal,petiole,pseudostipule,pubescent,short,simple,sparsely,spreading,stripe,trichome,truncate,uniseriate,unit,weak-walled,wide,yellow	-10,-2.5,.5,0.1-0.2,0.1-0.25,0.15-0.2,0.2-0.25,0.2-1,0.3-0.4,0.4-2,0.5-0.6,0.5-0.6-0.8,0.5-0.7,0.6-2,0.7-3.5-5,0.8-0.9,0.8-1,0.9-1,1,1-1.4,1-celled,1.1-1.7,1.2-1.6,1.2-5,1.5-2.3,1.5-3.5-10,1.8-2,2-6,2.2-3.2,2.5,2.5-7,25,3-5-15,5-20,6-20,7-12,abaxially,absent,abundant,acroscopically,adaxially,almost,along,angled,anthesi,apical,appearance,appendage,approximately,articulated,axi,basal,basiscopically,beneath,berr,bracteate,broadly,brown,capitate,change,chota,column,conical,could,crenat,crenate-serrate,decurrent,developed,diamete,diameter,eaf,ebracteate,edicel,eed,eglandular,elliptic,entire,erect,exserted,flower,give,glandular,gree,hair-like,hal,head,intermixed,internode,irregularly,jequetepeque,lacking,larger,lateral,like,lobe,lobed,lon,long-acuminate,longer,lower,marañón,maturity,minute,minutely,mixture,multicellular,narrowly,nearly,nflorescence,node,oblique,obovate,occasionally,often,outgrowth,ovary,pale,patent,peduncle,perennial,petiolule,population,present,primary,prostrate,pubescence,purple,rachi,reflexed,regularly,rest,ruit,scarcely,scattered,secondary,sessile,silky,size,sparse,staminal,stem,sterile,stigma,stout,straight,style,surface,tall,tem,terminal,tertiary,testa,thick,tip,toward,tube,ud,unicellular,usually,valley,variously,vein,velvety,wall,way,white,winged,woody,ympodial	appressed,articulation,berry,branching,breeding,colour,connective,form,growth,hair,heteromorphism,inflated,insertion,interpetalar,length,marking,mature,na,odour,orientation,paired,pattern,placement,pore,position,prickle,rhizome,scale,shape,spot,staman,stone,structure,symmetry,sympodial,system,texture,tissue,tuber,type,xylopodia	--,0-8,0.1-0.2-1,0.1-0.4,0.1-0.4-1,0.1-0.5,0.25-0.5,0.4-0.5,0.5,0.5-1,0.5-2.5-3.5,2-4,2-foliate,2-locular,5,acute,cm,dark,densely,distal,glabrous,globose,green,half,herb,imparipinnate,interrupted,investing,lanceolate,less,long,loosely,middle,mm,pair,pentagonal,pubescent,short,simple,sparsely,spreading,stripe,trichome,truncate,uniseriate,weak-walled,wide,yellow	berry,na
39	wfo-0001026305	success	135	136	59	78	57	58	56	3	.25,/4,0.2-1,0.25-0.5,0.5-2,0.6-1,1-1.5,1.3-1.5,2-2.5,2-6-flowered,2.5-3,3-8.5,4-4.5,5-7,6-9,7-16,abaxial,acute,anther,apex,area,attenuate,base,beige-tan,calyx,closely,cm,congested,conical,corolla,dendritic,densely,difoliate,elliptic,filament,fruiting,glabrous,globose,green,greenish-white,leaf,leaf-opposed,lobed,long,lower,margin,minute,minutely,mm,occasionally,older,ovary,ovoid-reniform,papillose,pedicel,petiole,pitted,pore,pubescent,rounded,scar,shaped,shining,shrub,simple,spaced,stem,stigma,style,surface,tear-drop,tip,trichome,tube,unifoliate,unit,way,young	0.7-1,7-9,abaxially,adaxially,along,anthesi,apical,ba,bark,berry,dark,deflexed,deltate,dia,drying,eaf,edicel,eed,exserted,free,geminat,glabrate,interlocking,knob-like,lamina,lateral,like,lobe,lon,main,middle,midrib,nflorescence,overlappin,pair,pale,planar,poricidal,portion,projection,reddish-brow,ruit,scattered,slender,sparsely,strongly,styl,tall,tan,tub,ud,vein,visible,widest,woody,x,ympodial	adaxial,articulation,bract,branching,breeding,broad-based,bud,cell,colour,connective,diameter,flower,form,fruit,geminate,growth,hair,height,heteromorphism,inflorescence,insertion,interjected,interpetalar,leaflet,length,marking,modification,na,needle-like,number,odour,orientation,overlapping,pattern,placement,plant,position,prickle,pseudostipule,rhizome,scale,seed,shape,smell,spot,staman,stone,structure,symmetry,sympodial,system,texture,tissue,tuber,type,vegetative,width,xylopodia	.25,/4,0.2-1,0.25-0.5,0.5-2,0.6-1,1-1.5,1.3-1.5,2-2.5,2-6-flowered,2.5-3,3-8.5,4-4.5,5-7,6-9,7-16,acute,area,attenuate,base,beige-tan,closely,cm,congested,conical,dendritic,densely,difoliate,elliptic,glabrous,globose,green,greenish-white,leaf-opposed,lobed,long,minute,minutely,mm,occasionally,ovoid-reniform,papillose,pitted,pubescent,rounded,shaped,shining,shrub,simple,spaced,style,tear-drop,tip,trichome,unifoliate,way	geminate,na,overlapping
40	wfo-0001026307	success	193	128	90	90	103	38	72	18	.6,.8,abaxial,acute,adaxial,age,anther,apex,appressed,articulated,base,berry,black,broadly,calyx,cell,central,cm,corolla,cuneate,cylindrical,decurrent,diameter,difoliate,entire,eye,filament,flattened-reniform,free,fruit,fruiting,glabrous,glandular,globose,green,growth,herb,internodal,lateral,length,lengthening,lobed,long,lower,margin,membranous,mm,narrowing,ovate,paler,pedicel,per,petiole,pore,poricidal,portion,pubescent,purple,purple-yellow,reflexed,ripe,shallowly,shape,shrub,simple,slightly,slit,sparsely,spreading,stellate,stem,stone,straight,surface,tinged,tip,toward,translucent,trichome,tube,turning,undulate,unequal,uniseriate,unit,variable,white,wide,yellow,yellow-green	.0–1.2,.3,.5,.5–4.0,0.2–0.5,0.2–1.5,0.4,0.5–0.6,0.5–0.7,0.5–5.0,0.6,0.8–0.9,0.8–2,0.8–5,1.0–1.2,1.0–1.5,1.0–2.0,1.0–2.4,1.0–2.5,1–3-celled,1–6-celled,2.0,2.0–3.0,2.0–3.5,2.6–13,2/3,3.0–4.0,3.5–7.0,35–45,3–8,3–8-celled,4–5.7,5-merous,5–7,8–12,9,abaxially,acute-acuminate,adaxially,angled,anthesi,apar,becoming,beyond,clavate,cone,densely,eaf,eed,ellipsoid,end,exerted,facing,flower,geminat,gradually,hilum,later,like,lobe,longer,middle,minutely,narrower,new,nflorescence,one,outline,ovary,pair,papillat,peduncle,pentagonal,perfect,positioned,primary,recurved,reflexe,restricted,ruit,scar,shallow,shorter,side,spaced,ste,stigma,strongly,style,sub-laterally,tal,tem,testal,three,triangular,two,ud,unevenly,upper,vein,vigorous,weak-stemmed,ympodial	0.5-0.6,0.5-5.0,0.8-0.9,0.8-2,0.8-5,1.0-1.2,2.0-3.5,2.6-13,3-8-celled,3.0-4.0,3.5-7.0,8-12,articulation,branching,broad-based,colour,form,geminate,glandularity,inflorescence,insertion,leaf,na,needle-like,odour,orientation,placement,position,prickle,seed,size,structure,symmetry,sympodial,texture,type,width,zygomorphy	.6,.8,acute,age,apex,appressed,articulated,base,berry,black,broadly,central,cm,cuneate,cylindrical,decurrent,diameter,difoliate,entire,eye,flattened-reniform,fruit,glabrous,glandular,globose,green,herb,internodal,lateral,length,lengthening,lobed,long,lower,membranous,mm,narrowing,ovate,paler,per,pore,poricidal,pubescent,purple,purple-yellow,reflexed,ripe,shallowly,shape,shrub,simple,slightly,slit,sparsely,spreading,stellate,stem,straight,surface,tinged,tip,toward,translucent,turning,undulate,unequal,uniseriate,variable,white,wide,yellow,yellow-green	0.5-0.6,0.5-5.0,0.8-0.9,0.8-2,0.8-5,1.0-1.2,2.0-3.5,2.6-13,3-8-celled,3.0-4.0,3.5-7.0,8-12,broad-based,geminate,leaf,na,needle-like,zygomorphy
41	wfo-0001026317	success	167	103	45	57	110	46	44	1	/4,0.25-1,0.3-1.2,0.5-1,1-1.2,2-2.5,2-3-foliate,6x,age,anther,apex,attenuate,base,berry,branched,bright,calyx,cm,corolla,dendritic,densely,entire,filament,fruiting,glabrous,globose,growth,inflorescence,internodal,lengthening,lobed,many,margin,mm,orange,pedicel,perfect,petiole,plane,pore,poricidal,pubescent,rachi,shrub,simple,slit,sparsely,terminal,time,tip,trichome,uniseriate,unit,way,white,x,yellowish	.5,0.5,0.5-0.6,0.5-0.8,0.6-1-5.7,0.7-0.9,0.8-1,1-1.5,10-12,2-3.5-15,2-4,2.5-10,3,3-3.5,4-5,50-200,6-8,?,abaxially,absent,acuminate,acute,adaxially,anthesi,apart,apically,approximately,bark,brown,capitate,clonal,closely,conical,correlated,dark,deltate,dense,diameter,distally,drying,eaf,eed,elliptic,em,erec,erect,essentially,exerted,extremely,flattened,flower,found,free,geminat,halfwa,lamina,less,like,lobe,longer,lower,maturity,minutely,narrowly,new,nflorescence,nodding,occasionally,often,ovary,packed,pair,pale,papillat,papillate,peduncle,per,pericarp,pitted,planar,plant,population,portion,primary,pubescen,pubescence,pulp,red,reflexed,reniform,ruit,scar,shiny,slightly,stem,sticky,stigma,straight,style,surface,swollen,thin,toward,triangular,tube,ud,variable,vein,woody,ympodial	appressed,articulation,bract,branching,breeding,cell,colour,connective,form,fruit,hair,heteromorphism,inflated,insertion,interjected,interpetalar,leaf,leaflet,length,marking,mature,modification,na,odour,orientation,paired,pattern,placement,position,prickle,pseudostipule,rhizome,scale,shape,spot,staman,stone,structure,symmetry,sympodial,system,texture,tissue,tuber,type,xylopodia	/4,0.25-1,0.3-1.2,0.5-1,1-1.2,2-2.5,2-3-foliate,6x,age,attenuate,base,berry,branched,bright,cm,dendritic,densely,entire,glabrous,globose,internodal,lengthening,lobed,many,mm,orange,perfect,plane,poricidal,pubescent,rachi,shrub,simple,slit,sparsely,terminal,time,tip,trichome,uniseriate,way,white,x,yellowish	na
42	wfo-0001026335	success	157	145	73	92	65	53	69	4	.5,0.25-0.5,0.5-1,0.6-1,1-2,1.5-2,10-20,10-30,2,2-3,2-4,2-7.5,3-18,4-5,5-,5-15,5-7,abaxially,accrescent,acuminate,adaxially,anther,apex,base,branched,calyx,chartaceous,cm,cuneate,curved,cylindrical,dense,densely,diameter,directed,distally,elliptic,elliptic-ovate,entire,filament,flattened,flower,forked,fruit,fruiting,geminate,glabrescent,glabrous,globose,green,hair,large,leaf,leaf-opposed,longitudinal,many-foliate,margin,mm,moderately,multangulate,oblong,opening,paired,pedicel,peduncle,petiole,pore,probably,pubescence,pubescent,rachi,reticulate,ripe,rounded,sessile,shrub,simple,slightly,slit,sometimes,stellate,stem,stigma,straight,style,surface,unit,unripe,white,whitish,x,yellowish	.5-3.5,0.1-0.3,0.8-1.3,1,1-1.5,1-3,1-4,1.5-4,3-5,7-8,acute,adaxiall,ag,apart,apparently,articulated,axe,ba,blade,capitat,connivent,covering,deltate,eaf,eed,equal,erect,especially,frui,glandula,glandular,held,lanceolate,like,lobe,long,lower,midpoint,much,nflorescence,often,orolla,perfect,ray,ruit,scattered,smaller,spaced,ste,stellate-pubescent,subtending,tal,tamen,tem,time,tip,toward,tube,uprigh,usually,vary,vein,wide,yellow,ympodial	age,appressed,articulation,bract,branching,breeding,capitate,cell,colour,connective,corolla,form,growth,height,heteromorphism,inflated,inflorescence,insertion,interjected,interpetalar,leaflet,length,marking,mature,modification,na,odour,orientation,ovary,pattern,placement,plant,position,prickle,pseudostipule,rhizome,scale,seed,shape,size,spot,staman,stone,structure,symmetry,sympodial,system,texture,tissue,tuber,type,xylopodia,zygomorphy	.5,0.25-0.5,0.5-1,0.6-1,1-2,1.5-2,10-20,10-30,2,2-3,2-4,2-7.5,3-18,4-5,5-,5-15,5-7,accrescent,acuminate,base,branched,chartaceous,cm,cuneate,curved,cylindrical,dense,densely,diameter,directed,distally,elliptic,elliptic-ovate,entire,flattened,forked,geminate,glabrescent,glabrous,globose,green,large,leaf-opposed,longitudinal,many-foliate,mm,moderately,multangulate,oblong,opening,probably,pubescence,pubescent,reticulate,ripe,rounded,sessile,shrub,simple,slightly,slit,sometimes,stellate,straight,unripe,white,whitish,x,yellowish	age,capitate,na,zygomorphy
43	wfo-0001026343	success	218	100	47	59	159	41	43	4	.5,0.05-0.5,2.5-8,5-10,7-12,anther,apex,articulated,base,berry,branched,calyx,chartaceous,cm,cream,cuneate,curved,dark,elongating,equal,erect,filament,flattened,fruit,fruiting,green,lateral,leaf,length,lobed,long,lower,margin,marking,maturity,mauve,mm,orange,pale,pedicel,petiole,poricidal,prickle,purple,reflexed,rounded,shrub,small,spherical,stem,surface,tapering,tip,tree,trichome,unit,wide,yellow,young	-15,-4,-7,/2,/5,0-1,0-10,0-2,0-4,0-40,0-5,0.05-0.2,0.1-0.2,0.15,0.2,0.2-0.3,0.2-0.7-1.5,0.3,0.45-1,0.5,0.5-1.5,0.8-1.5,1-2,1-3,1-4,1.3-1.7,1.5-2,1.5-2.5-3.5,1.8-2.2,1.8-3,1/,1/3,1/4-2/3,1/5,10-30,2-3,2-3.2,2-4,2-5,2-6,2-8,2.2-3.2,3-4,3-5,3.5-4.5,5-merous,5.5-9,6-9,7-14,7-8,7-9,abaxial,abaxially,acuminat,acute,adaxial,alyx,andromonoecious,apar,apart,apically,apparently,bark,blade,broadly,brow,concolorous,connivent,deltate,densely,diameter,distal,distance,drying,dull,eed,elliptic,extending,faint,flattened-reniform,flower,free,glabrescent,glabrous,green-brown,hermaphrodite,heterostylous,infructescence,less,lobe,lobing,lon,long-styled,longer,lowermost,mature,midpoint,midvein,moderately,multangulate,narrow-deltate,nflorescence,obtuse,older,one,open,orange-brown,orolla,oung,ovate,pair,peduncle,pendulous,per,pericarp,plant,plurifoliat,porrect,portion,prickl,prickly,primary,ray,reddish,reduced,ruit,scar,secondary,sessile,short-styled,side,smooth,sometimes,spaced,sparsely,spreading,stalk,stalked,staminat,stellate,stellate-pubescent,stout,style,tamen,terete,tertiary,time,tube,unarmed,upper,variously,vary,vein,venation,visible,way,weakly,woody,ympodial	articulation,bract,branching,broad-based,cell,colour,corolla,form,growth,hair,heteromorphism,inflorescence,insertion,interjected,interpetalar,leaflet,na,needle-like,odour,orientation,paired,placement,plurifoliate,position,pseudostipule,rhizome,scale,shape,smell,staman,stone,structure,symmetry,sympodial,texture,tissue,tuber,type,vegetative,xylopodia,zygomorphy	.5,0.05-0.5,2.5-8,5-10,7-12,articulated,base,berry,branched,chartaceous,cm,cream,cuneate,curved,dark,elongating,equal,erect,flattened,green,lateral,lobed,long,marking,maturity,mauve,mm,orange,pale,poricidal,purple,reflexed,rounded,shrub,small,spherical,stem,tapering,tip,tree,wide,yellow,young	na,needle-like,plurifoliate,zygomorphy
44	wfo-0001026352	success	207	149	111	127	80	22	107	4	.3,.5,0.5,0.5-0.8,0.5-1.5,0.5-3,0.6-1.5-4.6,0.7-2,1-10,1-2-celled,1-3.5-9,1.5,10+,2,4-4.5,5-6,<,?,abaxially,almost,angle,anther,antrorsely,apart,apex,articulated,articulation,axi,bark,basal,base,bending,berry,blue,branching,brown,calyx,capitate-truncate,chartaceous,cm,cordate,corolla,curved,deciduous,densely,diameter,ellipsoid,entire,evenly,filament,flattened,fruiting,glabrous,globose,green,greenish,growth,half,herbarium,inflorescence,irregularly,lamina,leafy,leaving,length,lengthening,like,lobed,long,many,margin,mature,membranous,minutely,mm,narrowly,near,nearly,new,outline,ovate,pale,papillate,pedicel,peduncle,peg,per,petiole,pink,point,pore,poricidal,pubescent,rachi,reniform,revolute,right,scar,shallowly,shoot,short,simple,sleeve,slit,small,spaced,specimen,stellate,stem,stigma,straw-colored,style,surface,terminal,time,tip,trichome,truncate,tuberculate,uniseriate,vein,vine,violet,weak,white,woody,yellowish	0.5-1,0.9-1,1-1.5,1.2-1.7,1.5-2,12-60,2-3-celled,3-15,5-merou,6-7,7-9,acuminate,acute,adaxiall,ag,alyx,anthesi,apparently,appearance,arising,branch,broadly,cell,conical,deltate,denser,discolorous,eaf,eed,eventually,expanded,exserted,few-celled,flower,free,giving,heigh,ilament,immature,impressed,inflorescenc,junction,large,largest,leave,lobe,lower,nflorescence,older,orolla,pair,papillo,perfect,pericarp,plurifoliat,portion,primary,principal,reflexed,rest,ruit,seen,shiny,sparser,spreadin,spreading,strongly,tem,thin,third,tub,tube,ud,unit,unspecified,upper,vary,wide,widest,ympodial	age,appressed,bud,colour,form,fruit,glabrousnes,hair,inflated,leaf,na,number,odour,ovary,papillose,position,seed,shape,symmetry,texture,type,width	.3,.5,0.5,0.5-0.8,0.5-1.5,0.5-3,0.6-1.5-4.6,0.7-2,1-10,1-2-celled,1-3.5-9,1.5,10+,2,4-4.5,5-6,<,?,abaxially,almost,angle,antrorsely,apart,apex,articulated,articulation,axi,basal,base,bending,berry,blue,brown,capitate-truncate,chartaceous,cm,cordate,curved,deciduous,densely,diameter,ellipsoid,entire,evenly,flattened,glabrous,globose,green,greenish,half,herbarium,irregularly,lamina,leafy,leaving,lengthening,like,lobed,long,many,membranous,minutely,mm,narrowly,near,nearly,outline,ovate,pale,papillate,peg,per,pink,point,pore,poricidal,pubescent,reniform,revolute,right,shallowly,shoot,short,simple,sleeve,slit,small,spaced,specimen,stellate,stem,straw-colored,surface,terminal,time,tip,trichome,truncate,tuberculate,uniseriate,vein,vine,violet,weak,white,woody,yellowish	age,leaf,na,papillose
45	wfo-0001026352	success	212	172	105	123	89	49	101	4	.5,0.5,0.5-0.8,0.5-1.5,0.5-3,0.7-2,0.9-1,1-1.5,1-10,1-2-celled,1.5,10+,2,4-4.5,5-6,<,?,abaxially,acuminate,acute,adaxially,anther,antrorsely,apart,apex,articulated,articulation,axi,basal,base,berry,blue,branching,calyx,capitate-truncate,cell,chartaceous,cm,connivent,cordate,corolla,curved,densely,diameter,ellipsoid,entire,evenly,filament,flattened-reniform,form,fruiting,glabrous,globose,green,growth,half,inflorescence,irregularly,lamina,leaf,leafy,leaving,length,lengthening,like,lobed,long,lower,many,margin,mature,membranous,minutely,mm,narrowly,near,nearly,outline,pale,papillate,pedicel,peduncle,peg,per,petiole,pink,plurifoliate,pore,poricidal,pubescent,revolute,scar,shallowly,shiny,shoot,short,simple,sleeve,slit,small,spaced,spreading,stellate,stem,stigma,style,surface,terminal,time,tip,trichome,truncate,twining,uniseriate,unit,vein,vine,violet,weak,white,woody,x,yellowish	.3,0.5-1,0.6-1.5-4.6,1-3.5-9,1.2-1.7,1.5-2,12-60,2-3-celled,3-15,5-merou,6-7,7-9,ag,almost,alyx,angle,anthesi,apparently,appearance,arising,ark,bending,branch,broadly,brown,conical,deciduous,deltate,denser,discolorous,eaf,eed,eventually,expanded,exserted,few-celled,flower,free,geminat,giving,greenish,heigh,herbarium,ilament,immature,impressed,inflorescenc,junction,large,largest,lobe,new,nflorescence,older,orolla,ovate,pair,papillo,perfect,pericarp,point,portion,primary,principal,rachi,reflexed,rest,right,ruit,seen,sparser,speciman,specimen,spreadin,straw-colored,strongly,tem,thin,third,tub,tube,tuberculate,ud,unspecified,upper,vary,widest,yellow,ympodial	age,appressed,bract,breeding,broad-based,colour,connective,fruit,geminate,hair,heteromorphism,inflated,insertion,interjected,interpetalar,leaflet,marking,modification,na,needle-like,number,odour,orientation,ovary,paired,papillose,pattern,placement,position,prickle,pseudostipule,rhizome,scale,seed,shape,smell,spot,staman,stone,structure,symmetry,sympodial,system,texture,tissue,tuber,type,vegetative,xylopodia	.5,0.5,0.5-0.8,0.5-1.5,0.5-3,0.7-2,0.9-1,1-1.5,1-10,1-2-celled,1.5,10+,2,4-4.5,5-6,<,?,abaxially,acuminate,acute,adaxially,antrorsely,apart,apex,articulated,axi,basal,base,berry,blue,capitate-truncate,chartaceous,cm,connivent,cordate,curved,densely,diameter,ellipsoid,entire,evenly,flattened-reniform,glabrous,globose,green,half,irregularly,lamina,leaf,leafy,leaving,lengthening,like,lobed,long,many,membranous,minutely,mm,narrowly,near,nearly,outline,pale,papillate,peg,per,pink,plurifoliate,pore,poricidal,pubescent,revolute,shallowly,shiny,shoot,short,simple,sleeve,slit,small,spaced,spreading,stellate,stem,surface,terminal,time,tip,trichome,truncate,twining,uniseriate,vein,vine,violet,weak,white,woody,x,yellowish	age,geminate,na,papillose
46	wfo-0001026379	success	218	147	90	97	121	50	87	3	0.7-1,0.8-1.2,1-2,1/2,2.6-3.7,abaxially,accrescent,adaxially,along,anther,apex,around,articulated,axillary,base,berry,blunt-tipped,branch,branched,brown,calyx,cm,completely,corolla,covering,dark,directed,distal,distally,dried,edge,entire,enveloping,farinose,filament,finely,fleshy,free,fruit,fruiting,globose,growth,hair,lacking,large,leaf,length,lengthening,long-attenuate,lower,many,margin,mature,minutely,mm,multangulate,multangulate-pubescent,nearly,oblong,obtuse,often,ovate-lanceolate,pale,pedicel,persistently,petiole,plant,plurifoliate,pore,poricidal,porrect-stellate,present,rather,recent,rich,scabrous,scattered,sessile,short-stalked,shrub,simple,slit,small,somewhat,stellate,stellate-pubescent,stem,thin,time,tip,tree,unit,velutinous-pubescent,violet,x,yellow,young	0.2-0.38,0.2-0.4,0.7-2.5,0.9-1.2,1-1.7,1-10,1-3.7,1.3-2.1,1.5-2.3-4.5,1.7-4.9,1.8-2.6,1.8-3.2,1.8-5,1.9-3.4,13,2-2.8,2-7,2.4-5.1,2.9-4,2/3,3-11,3/4,4-5,4.1-7,5.3-10.2,50-450,6-10.6,8-13,8-15,8-29,8.3-10,9-14,acute,adaxiall,ag,anthesi,apart,apparently,attenuate,ba,bark,basal,blade,capitat,chartaceous,closely,conical,cylindrical,dendritic-echinoid,densely,diameter,eaf,echinoi,echinoid,echinoid-pubescent,eed,ellipsoid,evident,few-rayed,flower,glabrous,granular,gray-brown,grayish,hig,included,inserted,lateral,line,lobe,lobed,long,m.,main,midrib,minute,mostly,multangulat,nflorescence,obovate,older,orolla,ovate,partly,peduncle,perfect,pitted,pubescen,rachi,reniform,ruit,runk,semi-ovate,side,size,sometimes,spaced,sparse,stellate-,stellate-tomentose,stelliform,stigma,style,suture,tamen,terete,testa,tomentose-pubescent,translucent,tube,ud,uneven,upper,usually,vary,vein,vestigial,way,whitish,whitish-brown,ympodial	age,appressed,articulation,bract,branching,breeding,broad-based,cell,colour,connective,form,heteromorphism,inflated,inflorescence,insertion,interjected,interpetalar,leaflet,marking,modification,na,needle-like,odour,orientation,paired,pattern,placement,position,prickle,pseudostipule,pubescent,rhizome,scale,shape,smell,spot,staman,stone,structure,surface,symmetry,sympodial,system,texture,tissue,trichome,tuber,type,vegetative,xylopodia	0.7-1,0.8-1.2,1-2,1/2,2.6-3.7,abaxially,accrescent,adaxially,along,apex,around,articulated,axillary,base,berry,blunt-tipped,branch,branched,brown,cm,completely,covering,dark,directed,distal,distally,dried,edge,entire,enveloping,farinose,finely,fleshy,free,fruit,globose,growth,hair,lacking,large,leaf,length,lengthening,long-attenuate,many,mature,minutely,mm,multangulate,multangulate-pubescent,nearly,oblong,obtuse,often,ovate-lanceolate,pale,persistently,petiole,plant,plurifoliate,pore,poricidal,porrect-stellate,present,rather,recent,rich,scabrous,scattered,sessile,short-stalked,shrub,simple,slit,small,somewhat,stellate,stellate-pubescent,thin,time,tip,tree,velutinous-pubescent,violet,x,yellow,young	age,na,pubescent
47	wfo-0001026400	success	187	167	91	117	70	50	88	3	0.2-0.8,0.4-1,0.5-1.2,0.7-1.1,1-10,1-2,1.3-2.6,10-18,10-28,12-27,13-30,2-8,3.4-4.8,3.5-5.9,30-55,4-7,5-7,6-13,6-15,6.5-20,8-12,9-13,acumen,anther,apex,asymmetric,attenuate,base,basiscopic,blade,blue,brownish,cell,clavate,cm,condition,connivent,coriaceous,corolla,dark,deep,diameter,distal,dorsally,drying,edge,elliptic,filament,finely,flat,flower,folded,forked,fresh,fruit,glabrescent,glabrous,globose,green,green-white,greenish,hair,half,herb,high,homostylous,interjected,lanceolate,lateral,leaf,leaflet,light,lilac,linear,lobe,mm,moderately,mucilaginous,odd-pinnate,ovate,ovoid,pair,pedicel,peduncle,pentagonal,petiole,plant,plurifoliate,pore,poricidal,puberulent,pubescent,purple,ripe,rounded,seed,semi-stellate,sessile,short,side,simple,size,stigma,straight,stripe,style,terminal,throughout,tip,tissue,tri-,tube,unit,wet,white,whitish,x	0.5-1,1.7-2.2,2-6,2.4-5.9,3-6,5-merou,abaxially,acuminate,acute,adaxiall,adaxially,ag,alyx,apart,apparently,articulated,axe,axillary,berry,bud,capitat,covering,decreasing,decurrent,digestion,eaf,eed,enzyme,erec,exceeding,geminat,generally,glabrou,gree,hair-like,hal,honeycomb-shaped,lengthening,living,long,lower,make,nflorescence,orbicular,orolla,perfect,petiolulate,removed,ruit,seudostipule,slightly,slit,spaced,specimen,stamen,subequal,subtending,tall,tamen,tem,testal,thick,toward,typically,unwinged,usually,vary,wall,yellow,ympodial	abaxial,adaxial,arrangement,articulation,bract,branching,breeding,calyx,capitate,colour,connective,form,growth,height,heteromorphism,inflorescence,insertion,interpetalar,length,margin,marking,mature,modification,na,odour,orientation,ovary,paired,pattern,placement,position,prickle,pseudostipule,rhizome,scale,shape,spacing,spot,staman,stem,stone,structure,symmetry,sympodial,system,texture,tuber,type,xylopodia,zygomorphy	0.2-0.8,0.4-1,0.5-1.2,0.7-1.1,1-10,1-2,1.3-2.6,10-18,10-28,12-27,13-30,2-8,3.4-4.8,3.5-5.9,30-55,4-7,5-7,6-13,6-15,6.5-20,8-12,9-13,asymmetric,attenuate,basiscopic,blue,brownish,clavate,cm,condition,connivent,coriaceous,dark,deep,distal,dorsally,drying,elliptic,finely,flat,folded,forked,fresh,glabrescent,glabrous,globose,green,green-white,greenish,hair,half,herb,high,homostylous,lanceolate,light,lilac,linear,mm,moderately,mucilaginous,odd-pinnate,ovate,ovoid,pentagonal,plurifoliate,poricidal,puberulent,pubescent,purple,ripe,rounded,semi-stellate,sessile,short,side,simple,straight,stripe,terminal,throughout,tip,tissue,tri-,wet,white,whitish,x	capitate,na,zygomorphy
48	wfo-0001026406	success	219	115	67	78	141	37	64	3	.2,.5,1.5-5,1.8-2.4,1/4-1/2,1/4-1/3,2-3,2-6,2.5-8,6.5-7,anther,apex,articulated,base,berry,branched,calyx,chartaceous,cm,conical,connivent,cordate,cream,curved,dark,diameter,elongating,equal,erect,filament,flattened,flower,fruit,fruiting,gently,green,herb,lateral,leaf,length,lobed,long,long-styled,lower,margin,marking,mature,maturity,mauve,midvein,mm,obtuse,orange-brown,pale,pedicel,pendent,petiole,poricidal,prickle,purple,reflexed,short-styled,shrub,spherical,stellate-pubescent,stem,straight,surface,tapering,terminal,tip,trichome,unit,way,white,wide,yellow,young	0,0-3,0-30,0-5,0.3,0.3-0.5,0.3-0.5-1,0.3-0.7,0.4-0.8,0.4-0.9,0.5,0.5-1.5,0.5-2.5,0.8,00-200,1,1-2,1.3-1.5,1.5-2,1/,1/3,1/4,10-30,12-19,2-2.7,2.9-3.2,20-60,3-10.5,3-4,3.2-3.8,30-60,5,5-25,5-50,5-6,5-7,5-8,5-merous,6-12,6-15,7-10,7-8,7-9,9-15,abaxial,abaxially,acute,adaxial,adaxially,alyx,ame,andromonoecious,apar,apart,apically,apparently,bark,blade,broad-deltate,c.,deltate,densely,dirty-whitish,discolorous,distal,distance,drying,eaf,eed,elongated,extending,flattened-reniform,foliaceous,free,fully,glabrous,hermaphrodite,heterostylous,infructescence,least,lobe,lon,longer,lowermost,midpoint,moderately,nflorescence,oblong,older,one,open,opening,orolla,oung,ovate,pair,peduncle,pendulous,per,pericarp,plant,plurifoliat,porrect,portion,prickl,prickly,primary,ray,red-brown,rounded,ruit,scar,sessile,side,smooth,sometimes,spaced,sparsely,spreading,stalk,stalked,staminat,stellate,stout,style,tamen,terete,tertiary,time,tube,upper,variously,vary,vein,velvety,venation,visible,weakly,woody,yellow-brow,ympodial	articulation,bract,branching,broad-based,cell,colour,corolla,form,growth,hair,heteromorphism,inflorescence,insertion,na,needle-like,odour,orientation,placement,plurifoliate,position,pseudostipule,rhizome,scale,shape,size,smell,staman,stone,structure,symmetry,sympodial,texture,tuber,type,vegetative,xylopodia,zygomorphy	.2,.5,1.5-5,1.8-2.4,1/4-1/2,1/4-1/3,2-3,2-6,2.5-8,6.5-7,articulated,base,berry,branched,chartaceous,cm,conical,connivent,cordate,cream,curved,dark,diameter,elongating,equal,erect,flattened,flower,fruit,gently,green,herb,lateral,length,lobed,long,long-styled,marking,mature,maturity,mauve,midvein,mm,obtuse,orange-brown,pale,pendent,poricidal,purple,reflexed,short-styled,shrub,spherical,stellate-pubescent,stem,straight,tapering,terminal,tip,way,white,wide,yellow,young	na,plurifoliate,zygomorphy
49	wfo-0001026407	success	221	201	119	143	78	58	114	5	.5,/3,0.5,0.5-0.6,0.5-1,0.5-2,1,1-1.2,1-10,1.2-1.5,1.3,20-30,3.5,4-5,7-8,acute,anther,apart,apex,around,articulated,axi,basal,base,becoming,beneath,berry,black,branched,broadly,brown,brownish,calyx,capitate,cell,chartaceous,cm,congested,connivent,corolla,deep,dendritic,densely,diameter,discolorous,ellipsoid,elliptic,entire,erect,filament,flattened-reniform,fleshy,flower,free,fruiting,glabrous,globose,golden,growth,inflorescence,internodal,interpetalar,irregularly,lamina,lateral,lax,leaving,lengthening,like,lobed,long,loosely,lower,many,margin,markedly,membranous,minutely,mixture,mm,narrowly,new,oblique,obscured,occasionally,outline,pale,paler,papillate,pedicel,peduncle,peg,per,perfect,persistent,petiole,pitted,plurifoliate,pore,poricidal,portion,primary,pubescence,pubescent,purple,purplish,reddish,revolute,ripe,scar,shiny,short,shrub,simple,sleeve,slightly,slit,small,spaced,stellate,stem,stiff,stigma,style,surface,tangled,terminal,testal,time,tip,trichome,truncate,tube,unit,upper,vein,vine,violet,way,weak,woody,x,yellow	+,-11,-6,0.9-3,1.5-1.7,1.5-2,1.5-7,2-2.5,2.5-3,20-40,3.5-5.5,5,5-10,5-7,5-merou,7-10,abaxially,adaxially,ag,aid,along,always,alyx,anthesi,appearing,area,ark,berr,blunt,branch,clear,climbin,conical,deltate,dense,denser,eaf,eed,evenly,exserted,geminat,glabrescen,glabrou,golden-pubescent,ilament,leafy,lobe,midvein,near,nflorescence,numerous,often,older,open,orolla,pair,papillat,pedice,pentagonal,pericarp,planar,pubescenc,ruit,sinus,sparsely,sparser,spreading,stout,strongly,tem,thin,transition,twining,ud,undulate,usually,vary,ympodial	5-merous,age,appressed,arrangement,articulation,bark,bract,branching,breeding,broad-based,bud,colour,connective,form,fruit,geminate,glabrescent,hair,heteromorphism,inflated,insertion,interjected,leaf,leaflet,length,marking,mature,modification,na,needle-like,number,odour,orientation,ovary,paired,pattern,placement,position,prickle,pseudostipule,rhizome,scale,seed,shape,smell,spot,staman,stone,structure,symmetry,sympodial,system,texture,tissue,tuber,type,vegetative,xylopodia	.5,/3,0.5,0.5-0.6,0.5-1,0.5-2,1,1-1.2,1-10,1.2-1.5,1.3,20-30,3.5,4-5,7-8,acute,apart,apex,around,articulated,axi,basal,base,becoming,beneath,berry,black,branched,broadly,brown,brownish,capitate,chartaceous,cm,congested,connivent,deep,dendritic,densely,diameter,discolorous,ellipsoid,elliptic,entire,erect,flattened-reniform,fleshy,glabrous,globose,golden,internodal,irregularly,lamina,lateral,lax,leaving,lengthening,like,lobed,long,loosely,many,markedly,membranous,minutely,mixture,mm,narrowly,oblique,obscured,occasionally,outline,pale,paler,papillate,peg,perfect,persistent,pitted,plurifoliate,pore,poricidal,pubescence,pubescent,purple,purplish,reddish,revolute,ripe,shiny,short,shrub,simple,sleeve,slightly,slit,small,spaced,stellate,stem,stiff,tangled,terminal,time,tip,trichome,truncate,vine,violet,way,weak,woody,x,yellow	5-merous,age,geminate,glabrescent,na
50	wfo-0001026424	success	135	86	32	37	98	49	28	4	0.75-1.5,1-1.5,1.5-2,12-60,3-4,acuminate,acute,apex,axil,base,blush-violet,calyx,campanulate,cell,cm,corolla,cuneate,cyme,fork,glabrous,glandular,hair,leaf,long,minute,mm,oblique,pedicel,petiole,pinnatisect,rotate-stellate,scorpioid,shrub,simple,stem,stone,tissue	-3.5,-4,1,1-10,1-2,10,10-15,15,15-30,3-11,637/1,8-10-25,acuman,acumen,age,angular,anthesi,aspect,ba,becoming,blunt,bluntly,broad,broadly,clonal,close,common,conspicuous,cut,dia,distinct,downard,eaf,ellipsoid,elliptic,erect,exceeding,except,exerted,facetted,facing,floral,flower,forked,general,gree,growing,interacuminal,lacking,lanceolate,lanceolate-elliptic,larger,lasting,lavender,line,lobe,lobed,lon,lower,midvein,nflorescence,obovate,often,part,pedicellate,peduncle,plurifoliat,point,rachi,raised,rarely,rh,rounded,second,several,shallowly,short,sinus,slightly,soft-wooded,soon,straggly,time,tip,toward,triangular,tub,ud,unit,unwinged,usually,violet,within,woody,x,year,ympodial,young	1-3.5,1-4,8-25,anther,articulation,bract,branching,breeding,colour,connective,diameter,filament,form,fruit,growth,height,heteromorphism,inflorescence,insertion,interjected,interpetalar,leaflet,length,margin,marking,modification,na,odour,orientation,pattern,placement,plant,pore,position,prickle,pseudostipule,rhizome,scale,shape,spot,staman,symmetry,system,texture,trichome,tuber,type,width,xylopodia	0.75-1.5,1-1.5,1.5-2,12-60,3-4,acuminate,acute,axil,blush-violet,campanulate,cm,cuneate,cyme,fork,glabrous,glandular,hair,leaf,long,minute,mm,oblique,pinnatisect,rotate-stellate,scorpioid,shrub,simple,stem	1-3.5,1-4,8-25,na
51	wfo-0001026440	success	181	171	93	112	69	59	89	4	0-15,1-5,1.1-1.5,1.3-1.7,1.5-2.1,1/2,2-2.8,2-4,2.9-4.4,3-7,3-8,3/4,5-7,7-14,9,abaxially,accrescent,adaxially,anther,apex,appressed,articulated,bark,basal,base,berry,blunt-tipped,branch,branched,broadly,brown,calyx,cm,conical,corolla,dendritic-echinoid,diameter,directed,distal,distally,echinoid,elliptic,entire,filament,fleshy,fruiting,globose,granular,green,greenish-yellow,hair,large,leaf,length,lengthening,long-attenuate,lower,many,margin,minute,minutely,mm,mostly,multangulate,multangulate-pubescent,oblong,obovate,obovoid-oblong,often,ovate,pale,pedicel,peduncle,perfect,persistently,petiole,pitted,plurifoliate,pore,poricidal,porrect-stellate,reniform,ripe,scabrous,sessile,short-stalked,shrub,simple,size,slit,small,somewhat,sparse,stellate,stem,stigma,style,terete,testa,time,tip,tomentose,tomentose-pubescent,tree,truncate,tube,turning,unit,white,x,yellow,young	1.1-1.4,1.8-4.5,1.9-3.7,1/2-2/3,14-30,3-5,3.9-6.5,4-12,acute,adaxiall,ag,along,always,anthesi,apparently,axillary,ba,blade,bract-like,branche,capitat,chartaceous,closely,dense,developed,dichotomy,eaf,echinoi,eed,first,flower,free,high,included,inserted,lobe,lobed,long,m.,multangulat,nearly,nflorescence,obscure,obtuse,older,openly,orolla,pair,pubescen,rather,ruit,runk,semi-ovate,short-acuminate,sometimes,spaced,stellate-pubescent,suture,tamen,thick,thin,tomentum,translucent,ud,uneven,usually,vary,way,ympodial	age,arrangement,articulation,bract,branching,breeding,broad-based,bud,capitate,cell,colour,connective,form,fruit,growth,height,heteromorphism,inflorescence,insertion,interjected,interpetalar,leaflet,marking,modification,na,needle-like,odour,orientation,ovary,paired,pattern,placement,plant,position,prickle,pseudostipule,pubescent,rhizome,scale,seed,shape,smell,spot,staman,stone,structure,surface,symmetry,sympodial,system,texture,thicknes,tissue,trichome,trunk,tuber,type,vegetative,xylopodia	0-15,1-5,1.1-1.5,1.3-1.7,1.5-2.1,1/2,2-2.8,2-4,2.9-4.4,3-7,3-8,3/4,5-7,7-14,9,accrescent,adaxially,appressed,articulated,basal,base,berry,blunt-tipped,branched,broadly,brown,cm,conical,corolla,dendritic-echinoid,directed,distal,distally,echinoid,elliptic,entire,fleshy,globose,granular,green,greenish-yellow,hair,large,lengthening,long-attenuate,many,minute,minutely,mm,mostly,multangulate,multangulate-pubescent,oblong,obovate,obovoid-oblong,often,ovate,pale,perfect,persistently,pitted,plurifoliate,pore,poricidal,porrect-stellate,reniform,ripe,scabrous,sessile,short-stalked,shrub,simple,slit,small,somewhat,sparse,stellate,terete,time,tip,tomentose,tomentose-pubescent,tree,truncate,tube,turning,white,x,yellow	age,capitate,na,pubescent
52	wfo-0001026441	success	197	128	64	73	124	55	58	6	0-2,1-2,2-8,5,abaxially,adaxially,anther,apex,axillary,base,berry,bud,cell,chartaceous,cm,conical,corolla,distal,end,filament,forked,fruit,generally,glabrous,green,hair,half,herb,homostylous,interjected,lanceolate,leaf,leaflet,lengthening,light,like,long,lower,margin,middle,minute,mm,obtuse,odd-pinnate,one,orbicular,ovate,pale,pedicel,petiole,placed,plant,plurifoliate,pore,poricidal,pubescent,ripe,rotate,rounded,slit,sparsely,stem,subsessile,subtending,symmetrical,terminal,tip,tri-,tuber,typically,unit,usually,violet	.5,0.3-0.7,0.4-3,0.5-1.5,0.8,1-1.5,1-10,1.5-2,1.5-2.5,10,10-14,15-20,2-2.5,2-5.5,3-5,4-6,4-8,4-8.5,4.5-6.5,5-10.5,5-merou,6-15,7-20,7-8,9-14,absent,acumen,acuminate,ag,alyx,apart,apparently,articulated,attenuate,axe,blade,brownish,capitat,ciliate,condition,connivent,covering,decreasing,diameter,digestion,dorsally,drying,eaf,edge,eed,elliptic-lanceolate,enzyme,equal,erec,especially,exceeding,flat,flower,folded,fourt,fresh,geminat,glabrou,gradually,green-white,greenish,hair-like,honeycomb-shaped,internal,larger,lateral,living,lobe,make,minutely,mottled,mucilaginous,narrow,nflorescence,orolla,ovoid,pair,peduncle,perfect,petiolule,puberulent,purple,removed,ruit,secondary,seed,semierect,seudostipule,short,size,slightly,spaced,specimen,stamen,star,ste,stigma,stolo,straight,style,subequal,tall,tamen,tem,testal,thick,throughout,toward,tube,vary,wall,wet,white,whitish,wide,wing,x,yellow,ympodial	5-merous,age,appressed,articulation,bract,branching,breeding,broad-based,calyx,colour,connective,form,fourth,fruiting,geminate,growth,heteromorphism,inflated,inflorescence,insertion,interpetalar,length,marking,mature,modification,na,needle-like,odour,orientation,paired,pattern,placement,position,prickle,pseudostipule,rhizome,scale,shape,smell,spot,staman,stolon,stone,structure,surface,symmetry,sympodial,system,texture,tissue,trichome,type,vegetative,xylopodia,zygomorphy	0-2,1-2,2-8,5,abaxially,adaxially,axillary,berry,bud,chartaceous,cm,conical,distal,end,forked,generally,glabrous,green,hair,half,herb,homostylous,lanceolate,lengthening,light,like,long,middle,minute,mm,obtuse,odd-pinnate,one,orbicular,ovate,pale,placed,plant,plurifoliate,pore,poricidal,pubescent,ripe,rotate,rounded,slit,sparsely,stem,subsessile,subtending,symmetrical,terminal,tip,tri-,tuber,typically,usually,violet	5-merous,age,fourth,geminate,na,stolon
53	wfo-0001026460	success	131	113	65	81	50	32	62	3	.1,.5,0.5-1.5,1-1.5,1.5-2,1/2,10-15,13.5-21,2-2.5,5,6-7,6-9,8-10,abaxially,acute-acuminate,adaxially,anther,anthesi,apex,axi,base,berry,branched,brown,calyx,capitate,closely,cm,completely,conical,corolla,dark,deltate,distal,elliptic,erect,filament,filiform,floccose,flower,fruiting,glabrous,globose,green,greenish,inflorescence,leaf,less,lobe,lobed,long,minutely,mm,nearly,opposite,ovary,ovoid-reniform,pair,papillose,pedicel,pitted,pore,poricidal,puberulent,reddish,scar,shaped,shrub,simple,spaced,stigma,style,subshrub,surface,tear-drop,tiny,tip,trichome,tube,white,yellow	2.5-3,4.5-5,513,7-9,acut,becoming,deflexed,dia,do,drying,eaf,edicel,eed,fide,free,frui,inflorescenc,internodal,like,long-exserted,lower,major,membraneous,middle,nflorescence,often,older,pale,papillo,portion,reddish-brow,reflexed,ruit,santo,slightly,somewhat,soon,stem,tall,tapering,tub,ud,unifoliat,unit,vein,widest,woody,x,ympodial,young	acute,articulation,branching,colour,connective,diameter,form,fruit,growth,hair,height,insertion,leaflet,length,margin,marking,mature,modification,na,number,odour,paired,plant,position,seed,shape,spacing,spot,symmetry,texture,type,width	.1,.5,0.5-1.5,1-1.5,1.5-2,1/2,10-15,13.5-21,2-2.5,5,6-7,6-9,8-10,abaxially,acute-acuminate,adaxially,base,berry,branched,brown,capitate,closely,cm,completely,conical,dark,deltate,distal,elliptic,erect,filiform,floccose,glabrous,globose,green,greenish,inflorescence,leaf,less,lobed,long,minutely,mm,nearly,opposite,ovoid-reniform,papillose,pitted,poricidal,puberulent,reddish,shaped,shrub,simple,spaced,subshrub,tear-drop,tiny,tip,trichome,white,yellow	acute,fruit,na
54	wfo-0001026489	invalid_json	153	85	NA	62	91	23	NA	NA	.3,0.05-0.1,0.25-0.5,0.5-0.75,0.5-2,0.8-1.2,0.8-1.3,1-1.5,1.5-5,2-3,2-4,2-5,2.5-4,5-6,acute,anther,apex,area,base,berry,branched,broadly,calyx,cm,corolla,cup-shaped,deflexed,elliptic,filament,flattened-reniform,fruiting,glabrous,globose,incrassate,leaf,lobed,margin,minor,minutely,mm,opposite,ovary,paler,pedicel,petiole,pitted,pore,pubescent,shaped,shrub,simple,size,stigma,style,surface,tear-drop,trichome,tube,uniseriate,white,widened,x	0.5,0.5-1,0.6-1.4,0.8-3.7,1.3-3,2-8-flowered,2.5-13,2/3,8-13,along,anthesi,appearing,axil,ba,bark,beneath,brown,closely,dark,deltoid,densely,dia,differing,difoliate,dry,eaf,edicel,eed,erect,exserted,extending,flattened,fleshy,free,geminat,gra,green,lamina,later,lateral,lobe,lon,long,lower,main,major,middle,nflorescence,occasionally,often,older,one,overlappin,pair,papillo,papillose,parallel,perpendicular,planar,poricidal,portion,prominent,red-papillose,rhachi,ruit,scar,shiny,slender,somewhat,soon,spaced,specimen,stem,straight,strongly,tall,tapering,terminal,thickened,tip,tub,ud,unit,usually,vein,way,whitish,widest,woody,ympodial,young	2-8,articulation,branching,characteristic,colour,diameter,flower,form,fruit,growth,height,inflorescence,length,na,number,plant,position,seed,shape,symmetry,texture,type,value	NA	NA
55	wfo-0001026490	success	270	182	107	108	162	74	75	32	1.5,2,7-pinnate,abaxially,absent,accrescent,adaxially,along,anther,apex,articulated,base,blade,bract,branched,calyx,cauline,chartaceous,cm,connivent,corolla,crisped,darker,densely,diameter,ellipsoidal,elliptic,entire,filament,flattened,flower,fruit,fruiting,glabrous,green,immature,incurved,inflorescence,interjected,irregularly,lacking,leaf,leaflet,length,lenticular,lobe,long,lower,margin,mature,midvein,mm,moderately,mottled,nearly,node,oblique,obliquely,oblong,obtusely,orange,ovate,ovate-lanceolate,pedicel,peduncle,pentagonal,petiole,petiolule,plurifoliate,pointed,pore,present,pseudostipule,pubescence,pubescent,rachi,revolute,rounded,seed,shape,shoot,similar,simple,size,slightly,sometimes,sparsely,spur,stem,stigma,striping,style,surface,tawny,teardrop-shaped,tip,transparent,trichome,truncate,tube,unit,vine,violet,white,wide,wing,yellow,×	.5,0.1–0.2,0.1–2.5,0.2–1,0.2–1.5,0.3–3.5,0.4–0.8,0.5–1,0.5–1.5,0.5–3.5,0.5–8,0.7–3,0.8–1.5,0.8–12,1.2–8,1.5–2,1.5–3.5,1.5–5,1.8–2.2,1.9,10–20,1–1.2,1–15,1–2.5,1–3,1–8,2.5–3.5,2–2.5,2–4,2–6,2–8,3,3–4.2,3–4.5,3–5,3–5-pinnate,3–8,4.6,4–4.5,4–5,5-merous,5–7,6,7,7–15,=,acuminate,acute,ag,alyx,anthesi,apart,apical,apicall,apparently,around,axe,axillary,ba,becoming,bracteate,broadly,brown,capitat,ciliate,climbing,commonly,completely,contiguously,cordate,covered,cylindrical,decreasing,directed,distal,distally,eaf,eed,eglandular,equal,exceeding,expanded,extra-axillary,flat,free,fused,geminat,ground,large,lateral,latrorse-introrse,light,lobed,longitudinal,lowermost,lunate,main,markedly,match,mean,mean=,medium,middle,minute,multicellular,near,nflorescence,obliqu,oblon,obtuse,occasionally,one,opening,orolla,pair,papillose,part,per,perfec,perfect,pubescen,punctate,pur,radial,reflexed,reniform,resulting,rooting,ruit,sand,seudostipule,short,shorter,slender,slit,smaller,smooth,somewhat,spaced,stamen,striation,strongly,tamen,tem,terminal,thickened,toward,trailing,trichomessympodial,typically,unbranched,undulate,vary,vegetation,woody,yellowish-tan,youn,½,–4,–4.5,–8,–9.5	0.1-0.2,0.1-2.5,0.2-1,0.2-1.5,0.3-3.5,0.4-0.8,0.5-1,0.5-1.5,0.5-3.5,0.5-8,0.8-1.5,0.8-12,1-1.2,1-15,1-2.5,1-3,1.5-2,1.5-3.5,10-20,2-2.5,2-4,2-6,3-4.2,3-4.5,4-5,4.5,5-7,7-15,8,appressed,articulation,branching,breeding,broad-based,capitate,cell,colour,connective,form,geminate,growth,hair,heteromorphism,inflated,insertion,interpetalar,marking,modification,na,needle-like,odour,orientation,ovary,paired,pattern,placement,position,prickle,rhizome,scale,smell,spot,staman,stone,structure,symmetry,sympodial,system,texture,tissue,tuber,type,vegetative,xylopodia	1.5,2,7-pinnate,abaxially,absent,accrescent,adaxially,along,apex,articulated,base,branched,cauline,chartaceous,cm,connivent,crisped,darker,densely,diameter,ellipsoidal,elliptic,entire,flattened,flower,fruit,glabrous,green,immature,incurved,irregularly,lacking,leaf,lenticular,lobe,long,mature,midvein,mm,moderately,mottled,nearly,node,oblique,obliquely,oblong,obtusely,orange,ovate,ovate-lanceolate,pentagonal,plurifoliate,pointed,present,pubescent,revolute,rounded,shape,similar,simple,slightly,sometimes,sparsely,striping,tawny,teardrop-shaped,tip,transparent,truncate,vine,violet,white,wide,yellow,×	0.1-0.2,0.1-2.5,0.2-1,0.2-1.5,0.3-3.5,0.4-0.8,0.5-1,0.5-1.5,0.5-3.5,0.5-8,0.8-1.5,0.8-12,1-1.2,1-15,1-2.5,1-3,1.5-2,1.5-3.5,10-20,2-2.5,2-4,2-6,3-4.2,3-4.5,4-5,4.5,5-7,7-15,8,capitate,geminate,na
56	wfo-0001026491	success	165	162	96	106	59	56	89	7	.5,1,1.5-2,1.5-2.5,1.5-3.5,1.7,10-50,2-celled,2.5-3.5,3,3-pinnate,5-6,5-8,6-8,abaxially,absent,acuminate,acute,adaxially,anther,apex,appressed,articulated,averaging,base,bayonet,bent,berry,blade,bract,branched,branching,broadly,cellular-papillose,cellular-pilose,central,cm,conspicuously,cuneate,deciduous,deep,diameter,elliptic-lanceolate,entire,filament,flower,glistening,globose,green,hair,highly,inflorescence,interjected,lanceolate,leaf,leaflet,less,light,long,margin,middle,minutely,mm,near,oblong-elliptic,often,ovate-elliptic,ovoid,pale,pedicel,peduncle,perfect,petiole,pilose,plurifoliate,pore,poricidal,porrect-incurved,present,pubescent,purple,readily,rotate-pentagonal,rotate-substellate,rounded,row,sharp,shortly,shrub,simple,spotted,stigma,strigose,strongly,suborbicular-ovate,surface,tawny,tip,uniseriate,unit,usually,ventral,white,whitish,x,yellow	1-2,1977,2-3,2-4,5-merou,7-8,abaxiall,alyx,anderson,apparently,axe,ba,capitat,connivent,crinkly,deltoid,densely,directed,distall,eaf,eed,equal,first,geminat,greatly,growing,homostylous,lateral,lobe,lower,lunulat,mean,nflorescence,obtuse,orolla,ovate,point,rachi,rarely,reduced,ruit,scandent,seudostipule,similar,slender,small,straight,strigo,strong,subacute,tal,tamen,tem,terminal,tightly,tube,tyle,upright,ympodial	articulation,breeding,calyx,capitate,cell,colour,connective,corolla,distally,form,fruit,fruiting,geminate,growth,height,heteromorphism,inflated,insertion,interpetalar,length,lunulate,marking,mature,modification,na,number,odour,orientation,paired,pattern,placement,plant,position,prickle,pseudostipule,rhizome,scale,seed,shape,size,spot,staman,stellate,stem,stone,structure,style,symmetry,sympodial,system,texture,tissue,tuber,type,xylopodia,zygomorphy	.5,1,1.5-2,1.5-2.5,1.5-3.5,1.7,10-50,2-celled,2.5-3.5,3,3-pinnate,5-6,5-8,6-8,abaxially,absent,acuminate,acute,adaxially,apex,appressed,articulated,averaging,base,bayonet,bent,berry,branched,broadly,cellular-papillose,cellular-pilose,central,cm,conspicuously,cuneate,deciduous,deep,diameter,elliptic-lanceolate,entire,glistening,globose,green,hair,highly,lanceolate,less,light,long,middle,minutely,mm,near,oblong-elliptic,often,ovate-elliptic,ovoid,pale,perfect,pilose,plurifoliate,poricidal,porrect-incurved,present,pubescent,purple,readily,rotate-pentagonal,rotate-substellate,rounded,row,sharp,shortly,shrub,simple,spotted,strigose,strongly,suborbicular-ovate,surface,tawny,tip,uniseriate,usually,ventral,white,whitish,x,yellow	capitate,distally,geminate,lunulate,na,stellate,zygomorphy
57	wfo-0001026501	success	194	139	87	102	92	37	82	5	.5,.6,.7,/3,0,0-3,0.1,0.2-1.8,0.27-0.7,0.5-0.6,0.5-1,0.9-2.2,1,1-2,1/4,3-4,3-9,3.5-4,4-5,7-9,?,acicular,anther,apex,bark,base,berry,branched,brown,brown-green,calyx,chartaceous,cm,cuneate,densely,diameter,dull,elliptic,elongating,entire,equal,eye,filament,flattened-reniform,flower,fruit,fruiting,glabrous,gray,green,leaf,length,lobed,long,margin,mauve,midpoint,mm,moderately,naked,orange-brown,orbicular,ovate,pair,pale,per,petiole,poricidal,porrect,prickle,ray,reddish,rounded,shoot,short,shorter,shrub,simple,spherical,spreading,stalk,stalked,stellate,stellate-pubescent,stem,straight,style,surface,tapering,terminal,tip,trichome,tube,unarmed,upper,variously,vein,visible,way,white,yellow,yellow-green	.1,.35,0-1,0-2,0.05-0.3,0.5,0.5-0.9,0.6-1,0.6-1.1-1.7,0.6-2,1-2.5,1.8-2.2,1/2-2/3,1/6-1/2,2-10,2.5-4,2.8-3,3-5,4-7,5-merous,6-9,abaxially,acute,almost,alyx,apar,apart,apically,apparently,articulated,becoming,blade,borne,color,concolorous,curved,deltate,discolorous,drying,eaf,eed,elongated,erect,filiform,filiform-acuminat,flattened,free,glabrou,infructescence,known,light,lobe,longer,lower,mature,nflorescence,often,older,one,open,orolla,oung,pedicel,peduncle,pendulous,perfec,pericarp,plurifoliat,portion,prickl,prickly,primary,ruit,scandent,scar,sessile,slender,small,smooth,sometimes,somewhat,spaced,sparsely,subsessile,tamen,terete,time,unarme,unit,vary,wide,ympodial	bract,branching,breeding,broad-based,colour,connective,corolla,elongation,form,growth,hair,height,heteromorphism,inflorescence,marking,na,needle-like,number,odour,orientation,ovary,pattern,placement,plant,pore,position,ray-like,seed,shape,spot,staman,symmetry,system,texture,type,width,zygomorphy	.5,.6,.7,/3,0,0-3,0.1,0.2-1.8,0.27-0.7,0.5-0.6,0.5-1,0.9-2.2,1,1-2,1/4,3-4,3-9,3.5-4,4-5,7-9,?,acicular,base,berry,branched,brown,brown-green,chartaceous,cm,cuneate,densely,dull,elliptic,elongating,entire,equal,eye,flattened-reniform,glabrous,gray,green,lobed,long,mauve,mm,moderately,naked,orange-brown,orbicular,ovate,pair,pale,poricidal,porrect,prickle,ray,reddish,rounded,shoot,short,shorter,shrub,simple,spherical,spreading,stalked,stellate,stellate-pubescent,stem,straight,surface,tapering,terminal,tip,unarmed,upper,variously,visible,way,white,yellow,yellow-green	broad-based,na,needle-like,ray-like,zygomorphy
58	wfo-0001026513	success	138	98	34	47	91	51	32	2	.1,.25,/3,0.8-2,1-1.5,acute,anther,apex,base,berry,calyx,cm,corolla,elliptic,filament,fruit,fruiting,glabrous,globose,green,lanceolate,leaf,less,lobed,long,lower,mature,mm,opposite,pedicel,petiole,pore,poricidal,shaped,shrub,slender,small,stem,surface,tear-drop,tip,treelet,trichome,uniseriate,unit,way,white	.3,.75,1-3,2-2.2,2-5,3-5,3-6-flowered,4-5,6-8,7-9,8-16,anthesi,apiculate,area,ba,bark,broadly,caly,closely,completely,darkish,decurrent,deflexed,delicate,deltoid,dia,differentiated,dry,eaf,edicel,eed,erect,except,exserted,flower,free,gre,hirsute,immature,known,lateral,leave,live,lobe,long-styled,longer,main,middle,minute,minutely,much,nflorescence,obscure,older,ovary,overlappin,pair,pale,papillose,plant,portion,prominent,raised,reflexed,rest,ruit,scar,shiny,short-styled,simple,somewhat,soon,spaced,specimen,stigma,straight,styl,style,tall,tube,ud,undersurface,unifoliat,vein,venation,wide,widest,woody,x,ympodial,young	appressed,articulation,bract,branching,breeding,broad-based,cell,colour,connective,form,growth,hair,heteromorphism,inflated,inflorescence,insertion,interjected,interpetalar,leaflet,length,margin,marking,modification,na,needle-like,odour,orientation,paired,pattern,placement,position,prickle,pseudostipule,rhizome,scale,shape,smell,spot,staman,stone,structure,symmetry,sympodial,system,texture,tissue,tuber,type,unifoliate,vegetative,xylopodia	.1,.25,/3,0.8-2,1-1.5,acute,base,berry,cm,elliptic,glabrous,globose,green,lanceolate,leaf,less,lobed,long,mm,opposite,poricidal,shaped,shrub,slender,small,tear-drop,tip,treelet,trichome,uniseriate,way,white	na,unifoliate
59	wfo-0001026529	success	219	118	54	72	147	46	52	2	0-25,0.5-4.5,1-2,5-17,5-9,anther,apex,articulated,axillary,base,berry,blue,bud,cell,chartaceous,cm,cordate,corolla,creamy,dark,deep,distal,dot,faintly,filament,forked,fruit,glabrous,globose,green,hair,half,herb,homostylous,interjected,lanceolate,leaflet,length,lilac,long,lower,margin,medium,membranous,mm,oblique,odd-pinnate,ovoid,pedicel,pentagonal,petiole,plurifoliate,pore,poricidal,pure,rarely,ripe,rounded,scattered,shape,slightly,stem,substellate,subtending,terminal,tip,tri-,trichome,typically,unit,white,yellowish	0.3-1,1,1-10,1-3,1-4.5,1.1-2.5,1.5-2.5,1.5-4,10,10-28,11-14,12-22,120-210,2,2-5,2-7.5,20-60,3-12,3-5,3-6,3-9.5,4-8,5-15,5-merou,50-70,6-20,600-950,?,abaxially,acumen,acuminate,acute,adaxially,ag,along,alyx,apart,apparently,attenuate,axe,blade,broadly,brownish,capitat,ciliate,clavate,condition,connivent,covering,densely,diameter,digestion,dorsally,drying,eaf,edge,eed,elliptic,enzyme,erec,especially,exceeding,except,flat,flower,folded,fresh,geminat,generally,glabrou,gland,glandular,greatly,gree,green-white,greenish,hair-like,hal,head,honeycomb-shaped,lateral,lengthening,light,like,living,lobe,longer,lunate,make,midrib,minutely,moderately,mucilaginous,narrowly,nflorescence,non-glandular,often,orbicular,orolla,ovate,pair,peduncle,perfect,petiolulate,petiolule,plant,proximal,puberulent,pubescent,reduced,removed,ruit,seed,sessile,seudostipule,short,size,slit,spaced,specimen,stamen,ste,stigma,straight,style,subequal,subsessile,tall,tamen,tem,testal,tetralobulate,thick,throughout,tube,unwinged,usually,vary,varying,wall,wet,whitish,wide,wing,x,yellow,ympodial	appressed,articulation,bract,branching,broad-based,calyx,colour,connective,form,fruiting,growth,heteromorphism,inflated,inflorescence,insertion,interpetalar,leaf,marking,mature,modification,na,needle-like,odour,orientation,paired,placement,position,prickle,pseudostipule,rhizome,scale,smell,spot,staman,stellate,stone,structure,surface,symmetry,sympodial,texture,tissue,tuber,type,vegetative,xylopodia	0-25,0.5-4.5,1-2,5-17,5-9,articulated,axillary,berry,blue,bud,chartaceous,cm,cordate,creamy,dark,deep,distal,dot,faintly,forked,glabrous,globose,green,half,herb,homostylous,lanceolate,lilac,long,medium,membranous,mm,oblique,odd-pinnate,ovoid,pentagonal,plurifoliate,poricidal,pure,rarely,ripe,rounded,scattered,slightly,substellate,subtending,terminal,tip,tri-,typically,white,yellowish	na,stellate
60	wfo-0001026534	success	149	175	94	107	42	68	90	4	0.5-1,1-2.5,1-3,1.5-6,1.5-9,10-20,10-50,15-50,2-2.5,2-7,2-8,2.5-15,3-10,3-25,3-5,4-10,5-6,6-35,7-40,abaxially,absent,acuminate,acute,adaxially,apart,apex,apiculate,auriculate,basal,base,beyond,branched,bright,calyx,cell,chartaceous,cm,connective,connivent,cordate,cylindrical,darker,deltate,densely,diameter,directed,distally,eglandular,ellipsoidal,entire,equal,fleshy,flower,fruit,glabrous,glandular,hair,lanceolate,leaving,lobe,long,longitudinal,lower,margin,mm,moderately,narrowly,obtuse,often,orange,ovate,ovoid,pale,pedicel,pedicellar,peduncle,perfect,petiole,pinkish,pore,puberulent,purple,rachi,radiu,red,remnant,shorter,simple,slightly,stamen,stellate,stigma,stone,stripe,style,subcoriaceous,thecae,tip,tree,triangular,truncate,unbranched,unit,vein,white,x,yellow	-1.5,1-2,10-15,2-3,2.5-4,3-4,3-4-foliat,3.5-4,4.5-5,7-12,aggregate,ape,articulated,axe,blade,eaf,eed,exserted,flattened,lemon-yello,lon,m.,nflorescence,nther,orolla,presen,puberulen,pubescent,ruit,small,spaced,sparsely,tal,tem,time,tomento,truncat,tube,ud,vary,wide,ympodial	3-4-foliate,anther,appressed,arrangement,articulation,bract,branching,breeding,broad-based,bud,colour,corolla,direction,exsertion,filament,form,fruiting,growth,height,heteromorphism,inflated,inflorescence,insertion,interjected,interpetalar,leaf,leaflet,lemon-yellow,length,marking,mature,modification,na,needle-like,odour,orientation,ovary,paired,pattern,placement,plant,position,present,prickle,pseudostipule,rhizome,scale,shape,size,smell,spacing,spot,staman,stem,structure,surface,symmetry,sympodial,system,texture,theca,tissue,trichome,tuber,type,vegetative,xylopodia,zygomorphy	0.5-1,1-2.5,1-3,1.5-6,1.5-9,10-20,10-50,15-50,2-2.5,2-7,2-8,2.5-15,3-10,3-25,3-5,4-10,5-6,6-35,7-40,abaxially,absent,acuminate,acute,adaxially,apart,apex,apiculate,auriculate,basal,base,beyond,branched,bright,chartaceous,cm,connivent,cordate,cylindrical,darker,deltate,densely,directed,distally,eglandular,ellipsoidal,entire,equal,fleshy,fruit,glabrous,glandular,hair,lanceolate,leaving,lobe,long,longitudinal,mm,moderately,narrowly,obtuse,often,orange,ovate,ovoid,pale,pedicellar,perfect,pinkish,puberulent,purple,red,remnant,shorter,simple,slightly,stamen,stellate,stripe,subcoriaceous,thecae,tip,tree,triangular,truncate,unbranched,vein,white,x,yellow	3-4-foliate,lemon-yellow,na,present
61	wfo-0001026535	success	248	184	136	150	98	34	128	8	.5,.8,0.15,0.2,0.7-1.5,1,1-2,1.2-2,1.3,1.5-3,1/3,2-5,2.5,3-5,3.5-4,4-15,5-7,7-8,abaxial,abaxially,accrescent,adaxially,age,almost,along,anther,apically,apparently,around,bark,base,becoming,berry,black,brachyblast,branch,branched,branching,broadly,brown,calyx,chartaceous,clavate,clustered,cm,conical,corolla,cuneate,cup,dark,dendritic,dendritic-pubescent,dense,developed,developing,diameter,dilated,distributed,dorsal,dry,drying,elliptic,elongated,entire,evenly,except,filament,fine,flat,flexuous,forming,fruit,fruiting,glabrous,green-brown,known,leaf,length,liana,like,lobe,lobed,long,loose,lower,main,margin,membranous,midvein,minute,minutely,mm,network,number,oblong,obovate,older,orange-brown,ovate,ovoid,pair,partly,pedicel,peduncle,pericarp,petiole,plant,pointed,pore,poricidal,primary,prominent,pubescent,rachi,raised,rarely,ray,ridged,shrub,side,slightly,smooth,sparsely,stem,stigma,style,surface,terete,terminal,tertiary,thin,tip,tissue,trichome,truncate,tube,unarmed,unevenly,unlignified,vein,venation,violet,visible,white,widely,wider,x,yellowish,young,youngest	.1,.2,.4,0-0.5,0.1-0.2,0.2-0.3,0.2-1.5,0.5-1,1-3,1-5,1.5-2,1/2-2/3,2-3,3,3-4.5,5-10,5°,absent,acute,alternate,alyx,anthesi,apar,apex,area,articulated,clearly,concolorous,condensed,cupular,curved,deeply,delineate,delineated,deltoid,detaching,discolorous,divided,domatia,eaf,eed,ellipsoi,equal,eye,fertilisation,flower,free,frui,increasing,inside,leave,lengthening,linear,lon,loop,m.,marginal,mostly,much,naked,nflorescence,nther,obscure,orolla,outside,papillo,pendulous,perfec,plurifoliat,portion,protruding,reaching,rounded,ruit,scar,secondary,see,short,simple,sinus,slender,smaller,soon,spaced,spreading,stump,tearing,toward,translucent,tufted,two,ud,uneven,unit,vary,weakly,wide,ympodial	-0.5,0.1,1.5,45°,accrescence,angle,armament,arrangement,articulation,breeding,bud,colour,connective,ellipsoid,form,growth,hair,inflorescence,marking,na,ovary,papillose,pattern,perfect,position,presence,seed,shape,spot,symmetry,system,texture,type,zygomorphy	.5,.8,0.15,0.2,0.7-1.5,1,1-2,1.2-2,1.3,1.5-3,1/3,2-5,2.5,3-5,3.5-4,4-15,5-7,7-8,abaxial,abaxially,accrescent,adaxially,age,almost,along,apically,apparently,around,base,becoming,berry,black,brachyblast,branch,branched,branching,broadly,brown,chartaceous,clavate,clustered,cm,conical,cuneate,cup,dark,dendritic,dendritic-pubescent,dense,developed,developing,diameter,dilated,distributed,dorsal,dry,drying,elliptic,elongated,entire,evenly,except,fine,flat,flexuous,forming,fruit,glabrous,green-brown,known,leaf,liana,like,lobe,lobed,long,loose,lower,membranous,minute,minutely,mm,network,oblong,obovate,older,orange-brown,ovate,ovoid,pair,partly,pericarp,plant,pointed,pore,poricidal,prominent,pubescent,rachi,raised,rarely,ridged,shrub,side,slightly,smooth,sparsely,stem,terete,terminal,thin,tip,tissue,trichome,truncate,unarmed,unevenly,unlignified,vein,violet,visible,white,widely,wider,x,yellowish,young,youngest	-0.5,0.1,1.5,45°,ellipsoid,na,papillose,perfect
62	wfo-0001026604	success	192	135	78	91	101	44	76	2	.5,.75,2-2.5,2.3-3.5,4-4.5,5,?,age,aid,along,anther,anthesi,apex,articulated,articulation,base,berry,branching,c.,calyx,cell,clearly,climbing,cm,cordate,corolla,cupped,densely,diameter,differentiated,distal,entire,expanding,filament,fruit,fruiting,glabrous,globose,growth,inflated,leaf-opposed,lengthening,liana,lobed,lower,margin,midrib,minute,minutely,mm,nodding,oblique,papillose,pedicel,perfect,petiole,planar,point,pore,poricidal,pubescent,purple,quarter,red,ripe,shape,shrub,simple,slender,slightly,slit,stellate,stem,stout,structure,support,surface,terminal,time,tip,trichome,truncate,tube,twisting,uniseriate,unit,vining,violet,way,woody,x	.4,0,0.1,0.4-0.6,0.8-0.9,0.8-1,1-1.2,1.1-1.3,1.2-1.7,1.5-2,1.5-9,10-30,2-2.3,3-3.5,3-5,3.5-4,4.5-7,5-7,50-100,<,absent,acuminate,always,apart,appearing,atop,bark,basal,brow,brown,capitate,comical,conical,cucullate,dark,deflexed,distinct,drying,due,eaf,eed,ellipsoid,elongate,exserted,flattened,flexuous,flower,free,later,leaving,lobe,mere,narrowly,new,nflorescence,occasionally,older,outline,ovary,ovate,overall,ovoid,pair,pale,papillo,part,particularly,peduncle,peg,per,pericarp,pitted,plurifoliat,poin,portion,primary,receptacle-like,reddish,reniform,rim,ruit,scar,series,shiny,sinuate,somewhat,spaced,stigma,strongly,style,swolle,testal,thin,tub,ud,undulation,upper,vein,widely,ympodial,½	appressed,bract,breeding,broad-based,colour,connective,form,hair,heteromorphism,inflorescence,insertion,interjected,interpetalar,leaf,leaflet,length,marking,mature,na,needle-like,odour,orientation,paired,pattern,placement,plurifoliate,position,prickle,pseudostipule,rhizome,scale,smell,spot,staman,stone,symmetry,sympodial,system,texture,tissue,tuber,type,vegetative,xylopodia	.5,.75,2-2.5,2.3-3.5,4-4.5,5,?,age,aid,along,anthesi,apex,articulated,articulation,base,berry,branching,c.,calyx,clearly,climbing,cm,cordate,cupped,densely,diameter,differentiated,distal,entire,expanding,fruit,glabrous,globose,inflated,leaf-opposed,lengthening,liana,lobed,midrib,minute,minutely,mm,nodding,oblique,papillose,perfect,planar,point,poricidal,pubescent,purple,quarter,red,ripe,shrub,simple,slender,slightly,slit,stellate,stout,support,surface,terminal,time,tip,trichome,truncate,tube,twisting,uniseriate,vining,violet,way,woody,x	na,plurifoliate
63	wfo-0001026607	success	204	112	68	92	112	20	66	2	0-3,0-4,0.1-0.3,0.5-5.8,0.8-4.5,0.8-5,1-2,1-8,10-30,2-10,2-2.5,2.4-5.8,2.5-3.8,2.7-19,4-10,4-6,5,5.8-19.8,6-10,abaxially,absent,adaxially,anther,blade,brownish,cell,chartaceous,clavate,cm,condition,connivent,corolla,deep,diameter,dorsally,drying,edge,filament,flat,flower,folded,forked,forming,fresh,fruit,glabrous,globose,green,greenish,hair,hair-like,herb,homostylous,honeycomb,interjected,lanceolate,lateral,leaf,leaflet,long,margin,medium,membranous,minute,mm,moderately,odd-pinnate,ovoid,pair,pedicel,peduncle,pentagonal,plant,pore,poricidal,pubescent,rachi,rarely,ripe,rosette,seed,shaped,size,stigma,style,terminal,testal,tip,violet,wet,whitish,x	0.3-1.8,0.8-3.4,1-10,1-3.8,1-5,1.5-4,2-3,3-8,5-merou,acumen,acute,ag,along,alyx,apart,apex,apparently,articulated,attenuate,axe,axillary,base,basiscopic,berry,bud,capitat,ciliate,clearly,coarse,covering,decreasing,decurrent,digestion,distal,dot,eaf,eed,elliptic,enzyme,especially,exceeding,finely,geminat,generally,glabrou,greatly,gree,green-white,hal,half,high,larger,lengthening,like,living,lobe,lower,make,marked,midrib,minutely,much,mucilaginous,nflorescence,obtuse,often,orbicular,orolla,ovate,perfect,petiole,petiolulate,plurifoliate,present,puberulent,removed,rounded,ruit,scattered,semierec,sessile,seudostipule,short,side,simple,slit,sometimes,spaced,specimen,stamen,ste,stem,straight,subtending,tall,tamen,tem,thick,throughout,toward,tri-,tube,typically,unit,unwinged,usually,vary,wall,white,without,yellow,ympodial	arrangement,branching,calyx,capitate,colour,form,glabrousnes,growth,height,inflorescence,length,mucilaginousnes,ovary,pseudostipule,semierect,shape,staman,symmetry,texture,type	0-3,0-4,0.1-0.3,0.5-5.8,0.8-4.5,0.8-5,1-2,1-8,10-30,2-10,2-2.5,2.4-5.8,2.5-3.8,2.7-19,4-10,4-6,5,5.8-19.8,6-10,abaxially,absent,adaxially,brownish,chartaceous,clavate,cm,condition,connivent,deep,diameter,dorsally,drying,flat,folded,forked,forming,fresh,glabrous,globose,green,greenish,hair-like,herb,homostylous,honeycomb,lanceolate,long,medium,membranous,minute,mm,moderately,odd-pinnate,ovoid,pentagonal,poricidal,pubescent,rarely,ripe,rosette,shaped,tip,violet,wet,whitish,x	capitate,semierect
64	wfo-0001026613	success	159	184	113	124	35	60	106	7	0.5-1,1-10,1-2,11-19.5,2.3-8,2.5-2.8,3-5,4-5,4.5-8.5,5,5-6,5-7,5.5-7,6-12,6-8,6.2-9.5,8-18,8.5-10,8.5-9,9.5-13.5,abaxially,absent,acumen,acuminate,adaxially,along,anther,apart,apex,apparently,attenuate,axillary,base,berry,blade,borne,bud,chartaceous,ciliate,cm,conical,connivent,cordate,corolla,decreasing,densely,diameter,distal,dorsally,edge,end,especially,filament,flat,flower,folded,forked,fruit,generally,glabrous,greatly,green,hair,half,herb,homostylous,immature,interjected,lanceolate,lateral,leaf,leaflet,lengthening,like,lobe,long,lower,margin,mature,membranous,middle,midrib,minute,minutely,mm,mottled,odd-pinnate,ovate,pair,pedicel,peduncle,perfect,petiole,plant,plurifoliate,pore,poricidal,proximal,puberulent,pubescent,purple,rotate-pentagonal,singly,size,slit,stem,stigma,style,subequal,subtending,symmetrical,terminal,tip,toward,tri-,tube,tuber,typically,unit,unknown,unwinged,usually,x,yellow	0.6,1.5-4,2-7.5,3-10,5-merou,ag,alyx,articulated,axe,capitat,eaf,eed,erec,geminat,hal,larger,m-1.2,nflorescence,orolla,petiolule,pubescen,ruit,secondary,semierect,seudostipule,spaced,sparsely,ste,stolo,tall,tamen,tem,unknow,vary,ympodial	0.6-1.2,5-merous,age,arrangement,articulation,bract,branching,breeding,broad-based,calyx,capitate,cell,ciliation,colour,connective,form,geminate,growth,height,heteromorphism,inflorescence,insertion,interpetalar,length,marking,merosity,na,needle-like,number,odour,orientation,ovary,paired,pattern,placement,position,presence,prickle,pseudostipule,rhizome,scale,seed,shape,smell,spacing,spot,staman,stolon,stone,structure,surface,symmetry,sympodial,system,texture,tissue,trichome,type,vegetative,xylopodia	0.5-1,1-10,1-2,11-19.5,2.3-8,2.5-2.8,3-5,4-5,4.5-8.5,5,5-6,5-7,5.5-7,6-12,6-8,6.2-9.5,8-18,8.5-10,8.5-9,9.5-13.5,abaxially,absent,acumen,acuminate,adaxially,along,apart,apex,apparently,attenuate,axillary,base,berry,borne,bud,chartaceous,ciliate,cm,conical,connivent,cordate,corolla,decreasing,densely,distal,dorsally,end,especially,flat,flower,folded,forked,fruit,generally,glabrous,greatly,green,hair,half,herb,homostylous,immature,lanceolate,leaf,leaflet,lengthening,like,long,margin,mature,membranous,middle,midrib,minute,minutely,mm,mottled,odd-pinnate,ovate,perfect,plant,plurifoliate,pore,poricidal,proximal,puberulent,pubescent,purple,rotate-pentagonal,singly,size,slit,stem,subequal,subtending,symmetrical,terminal,tip,toward,tri-,typically,unknown,unwinged,usually,x,yellow	0.6-1.2,5-merous,age,capitate,geminate,na,stolon
65	wfo-0001026614	success	199	124	67	74	125	50	60	7	0.5,1.3-1.8,3-foliate,abaxially,acute,adaxially,anther,apex,articulated,base,berry,black,blunt-tipped,broad-based,brown,calyx,clavate,cm,commonly,dark,developed,directed,distally,dried,entire,evenly,extra-axillary,filament,fruit,fruiting,geminate,glabrous,globose,hair,homostylous,interpetalar,irregularly,leaf,linear,lobe,lobed,long,margin,mm,mottled,oblique,orange,orange-red,pair,pedicel,petiole,pore,prickle,repand,ripe,rotate-pentagonal,rounded,shallowly,shrub,simple,slightly,sometimes,sparsely,spreading,stellate,stellate-pubescent,tapering,tissue,unarmed,weakly,well,white,x,yellowish	.8,0.2,0.2–0.3,0.4-0.7,0.5–2,1-2–4-branched,1.5–2,11-15,15–30,1–2,1–3,1–5,2.2,2.2-5.5,2.5,2.5–3,20–25,2–4,2–6.5,3.2-5.2,3–10,4-7,4.5–11,4.5–5.5,5,5-merou,5.3-8.2,50,6.4-8.4,6–8,7.2-9.8,8–10,9–16,>,absent,across,acuminate,adaxiall,alyx,apart,apparently,armed,axe,ba,blade,campanulate,capitat,chartaceous,closely,concentrated,cylindrical,densely,denser,diameter,eaf,eed,erect,especially,expanded,flattened-reniform,fleshy,flower,foveolate,glabrescent,gland-tipped,globo,golden,internode,lanceolate-attenuate,lateral,less,lon,lower,midpoint,midvein,minute,minutely,nearly,nflorescence,obtuse,often,orolla,ovate,ovate-lanceolate,ovoid,peduncle,per,perfect,pubescence,pubescent,rachi,rarely,ray,reflexed,ruit,scattered,sessile,shin,side,similar,smaller,somewhat,soon,spaced,stellae,stem,stigma,style,surface,tall,tamen,tem,time,tissu,tube,ud,unarme,usually,vary,vein,wide,yellow,ympodia,young,–5	0.5-2,1-2,1-2-4-branched,1-3,4.5-5.5,5-merous,appressed,articulation,bract,branching,breeding,cell,colour,connective,corolla,form,growth,heteromorphism,inflated,inflorescence,insertion,interjected,leaflet,length,marking,mature,modification,na,odour,orientation,paired,pattern,placement,position,pseudostipule,rhizome,scale,shape,spot,staman,stone,structure,symmetry,sympodial,system,texture,tuber,type,unit,xylopodia	0.5,1.3-1.8,3-foliate,abaxially,acute,adaxially,articulated,base,berry,black,blunt-tipped,broad-based,brown,clavate,cm,commonly,dark,developed,directed,distally,dried,entire,evenly,extra-axillary,geminate,glabrous,globose,homostylous,irregularly,linear,lobe,lobed,long,mm,mottled,oblique,orange,orange-red,pair,pore,repand,ripe,rotate-pentagonal,rounded,shallowly,shrub,simple,slightly,sometimes,sparsely,spreading,stellate,stellate-pubescent,tapering,unarmed,weakly,well,white,x,yellowish	0.5-2,1-2,1-2-4-branched,1-3,4.5-5.5,5-merous,na
66	wfo-0001026642	success	193	148	76	74	119	74	53	23	0.25,5,6,abaxial,abaxially,along,annual,anther,apart,apex,axillary,base,bipinnate,black,blade,blue,borne,calyx,cell,clavate,cm,cylindrical,denser,diameter,elliptic,filament,flower,fruit,glabrous,glandular,globose,green-purple,hair,herb,lavender,leaf,length,lilac,long,mm,multicellular,number,oblong,often,pale,pedicel,peduncle,pentagonal,perennial,perfect,petiole,pinnate,pitted,pore,present,pubescent,shallowly,shoot,simple,sparsely,stigma,stone,style,surface,time,tube,uniseriate,usually,vein,violet,woody,x,yellow,–4.5	.05,.1,.8,0.1,0.1–0.3,0.2,0.4,0.4–2.2,0.5,0.5–,0.5–0.7,0.5–1.7,0.5–2.0,0.5–3.5,0.6,0.6–1.0,0.75–1.0,0.75–2.0,0.7–1.6,0.8–1.2,1.0,1.0–2.0,1.2–1.7,1.2–2.0,1.2–3.5,1.2–6.2,1.6–8.0,1.9–3.0,12–30,1–10,1–3,2.0–4.0,2.5–3.5,2.5–4.0,2.8–3.0,3.0–5.1,3–5,4.0–6.0,4–7,5.0–7.0,50–100,<,acute,adaxiall,adaxially,ag,anthesi,appressed,articulated,axe,ba,branched,brown,chartaceous,circular,connivent,dark,decreasing,decumbent,densely,divided,eaf,eed,either,equal,erect,flattened,fleshy,geminat,glabrescen,gland,half,indumentum,lobe,lon,longitudinal,lower,m.,moderately,narrow,nflorescence,obtuse,occasionally,opening,orolla,ovate,pair,pinnae,poricidal,primary,probably,rapidly,rounded,ruit,secondary,sessile,side,slit,sometimes,spaced,straight,subglabrous,tal,tamen,tem,tip,unicellular,unifoliate,unit,vary,white,wide,wing,ympodial,–1.2,–11.0,–2.0,–6,–7	0.1-0.3,0.4-2.2,0.5-2.0,0.5-3.5,0.5-6.2,0.5-8.0,0.75-1.0,0.75-2.0,0.8-1.2,1-10,1-3,1-3-6,1.2-1.7,1.2-3.5,12-30,2.0-4.0-4.5,2.8-3.0,3.0-5.1-11.0,4.0-6.0,5.0-7.0,50-100,articulation,bract,branching,breeding,colour,connective,corolla,form,glabrousnes,glandularity,growth,height,heteromorphism,history,inflorescence,insertion,interjected,interpetalar,leaflet,life,margin,marking,mature,modification,na,odour,orientation,ovary,paired,pattern,placement,plant,position,prickle,pseudostipule,rhizome,scale,seed,shape,spacing,spot,staman,stem,symmetry,system,texture,tissue,tuber,type,venation,width,xylopodia,ye	0.25,5,6,abaxial,abaxially,along,annual,apart,axillary,base,bipinnate,black,blue,borne,clavate,cm,cylindrical,denser,elliptic,fruit,glabrous,glandular,globose,green-purple,herb,lavender,lilac,long,mm,multicellular,oblong,often,pale,pentagonal,perennial,perfect,pinnate,pitted,present,pubescent,shallowly,shoot,simple,sparsely,surface,time,uniseriate,usually,vein,violet,x,yellow,–4.5	0.1-0.3,0.4-2.2,0.5-2.0,0.5-3.5,0.5-6.2,0.5-8.0,0.75-1.0,0.75-2.0,0.8-1.2,1-10,1-3,1-3-6,1.2-1.7,1.2-3.5,12-30,2.0-4.0-4.5,2.8-3.0,3.0-5.1-11.0,4.0-6.0,5.0-7.0,50-100,na,ye
67	wfo-0001026651	success	222	117	66	68	154	49	58	8	3,3-plurifoliate,8,accrescent,anisophyllous,anther,antrorse,apex,appressed,articulated,asymmetric,attenuate,base,berry,calyx,cell,chartaceous,ciliate,connivent,cyme,dark,differing,drying,dull,entire,erect,filament,flower,fruit,geminate,glabrous,globose,green,hair,herb,introrsely,lateral,leaf,length,long,margin,markedly,membranaceous,mm,mostly,much-branched,oblong-ellipsoid,pedicel,petiole,pore,revolute,ripe,rounded,shape,shrub,simple,size,slightly,sometimes,spaced,stellate,stem,sub-opposite,terminal,translucent,unbranched,unit,white	-celled,0.2–1.3,0.35–2.6,0.9–3,1,1.8,1–2,2.2–10,2.8,2–11.5,2–13,2–3,2–3.3,2–4,2–4.5,2–8,3–5,3–7,4,4–6,4–7.8,5-merou,6–10,6–14,abaxially,absent,acuminate,acute,adaxiall,adaxially,along,alyx,antror,antrorsely,apar,arcuate,ark,axi,beneath,beyond,branch,broadly,brochidodromous,brown,brownish-green,capitat,capitate,circular,cm,cordate,cylindrical,decumbent,decurrent,densely,diameter,directed,discolorous,eaf,eed,elliptic,emarginate,equal,exfoliating,exserted,eye,flattened,flexuous,frui,geniculate,glabrescent,glabrou,glandular,growt,head,highly,hilum,hollow,impressed,lanceolate,less,light,like,lobe,longitudinal,lower,lying,major,matte,midrib,minor,moderate,moderately,multicellular,naked,narrowly-elliptic,new,nflorescence,normally,obtuse,older,one,onto,opening,orolla,ovate-deltate,ovate-lanceolate,ovate-reniform,parallel,peduncle,pedunculate,per,perfect,plant,poricidal,prominent,pubescence,pubescent,reduce,region,ruit,secondary,seed,shiny,similar,single-celled,slit,small,smaller,stalk,stamen,stigma,straight,style,subapical,surface,tall,tamen,tem,trichome,turning,undulate,uniseriate,upper,usually,vary,vein,venation,visible,wide,woody,yellow,ympodial,young,×	1-2,2-13,3-7,apart,articulation,bract,branching,breeding,broad-based,colour,connective,corolla,form,fruiting,growth,heteromorphism,inflated,inflorescence,insertion,interjected,interpetalar,leaflet,marking,mature,modification,na,needle-like,odour,orientation,paired,pattern,placement,position,prickle,pseudostipule,rhizome,scale,spot,staman,stone,structure,symmetry,sympodial,system,texture,tissue,tuber,type,xylopodia	3,3-plurifoliate,8,accrescent,anisophyllous,antrorse,appressed,articulated,asymmetric,attenuate,base,berry,cell,chartaceous,ciliate,connivent,cyme,dark,differing,drying,dull,entire,erect,flower,fruit,geminate,glabrous,globose,green,hair,herb,introrsely,lateral,leaf,long,markedly,membranaceous,mm,mostly,much-branched,oblong-ellipsoid,revolute,ripe,rounded,shape,shrub,simple,size,slightly,sometimes,spaced,stellate,stem,sub-opposite,terminal,translucent,unbranched,white	1-2,2-13,3-7,apart,broad-based,na,needle-like,prickle
68	wfo-0001026656	success	211	193	109	129	82	64	104	5	0-4,1,1-1.8,1-10,1-2,1-3.8,1.1-8.1,1.5-7,2-6,2.5-17,20-60,4-10,4-13,4-8,5,5-18,5-35,5.5-27,9-11,abaxially,absent,acuminate,acute,adaxially,anther,apart,apex,attenuate,base,blade,blue,broadly,brownish,bud,cell,chartaceous,cm,condition,connate,connivent,corolla,cuneate,dark,decurrent,densely,diameter,digestion,distal,dot,drying,elliptic,enzyme,especially,filament,flower,forked,fresh,fruit,glabrous,globose,green,greenish,greenish-yellow,hair,herb,honeycomb-shaped,interjected,lanceolate,lateral,leaflet,lengthening,light,like,lobe,long,lower,lunate,margin,membranous,minutely,mm,moderately,mottled,narrowly,oblique,odd-pinnate,ovate,ovoid,pair,pedicel,peduncle,pentagonal,petiole,petiolule,plant,plurifoliate,pore,poricidal,puberulent,pubescent,purple,removed,rotate-pentagonal,scale-like,scattered,seed,slit,sometimes,somewhat,star,stem,style,subglabrous,subtending,symmetrical,terminal,testal,tip,tri-,truncate,tube,tuber,unit,unwinged,violet,wall,white,whitish,wing	0.3-3,0.3-4.2,0.4-6.5,0.7-10.5,0.9-13,1-4,1-5,10,2-8,5-merou,acumen,ag,along,alyx,articulated,bearing,borne,capitate,ciliate,clavat,covering,curved,dorsally,eaf,edge,eed,end,erec,exceeding,flat,folded,geminat,generally,glaucous,greatly,green-white,hair-like,half,homostylous,larger,living,make,middl,midvein,mucilaginous,nflorescence,non-glandular,occasionally,often,orolla,petiolulate,pubescen,rachi,ranging,ruit,seudostipule,short,singly,slightly,spaced,specimen,stamen,ste,stigma,stolo,straight,subequal,tall,tamen,tem,tertiary,therefore,thick,throughout,tinged,typically,vary,wet,wide,without,yellow,ympodial	age,appressed,arrangement,articulation,bract,branching,breeding,broad-based,calyx,ciliation,colour,connation,connective,form,fruiting,glabrousnes,growth,height,heteromorphism,inflated,inflorescence,insertion,interpetalar,leaf,length,marking,mature,middle,modification,na,needle-like,number,odour,orientation,ovary,paired,pattern,placement,position,presence,present,prickle,pseudostipule,rhizome,scale,shape,smell,spacing,spot,staman,stone,structure,surface,symmetry,sympodial,system,texture,tissue,trichome,type,vegetative,width,winged,xylopodia	0-4,1,1-1.8,1-10,1-2,1-3.8,1.1-8.1,1.5-7,2-6,2.5-17,20-60,4-10,4-13,4-8,5,5-18,5-35,5.5-27,9-11,abaxially,absent,acuminate,acute,adaxially,apart,attenuate,blue,broadly,brownish,bud,chartaceous,cm,condition,connate,connivent,corolla,cuneate,dark,decurrent,densely,digestion,distal,dot,drying,elliptic,enzyme,especially,forked,fresh,glabrous,globose,green,greenish,greenish-yellow,hair,herb,honeycomb-shaped,lanceolate,lateral,leaflet,lengthening,light,like,long,lunate,margin,membranous,minutely,mm,moderately,mottled,narrowly,oblique,odd-pinnate,ovate,ovoid,pentagonal,plurifoliate,pore,poricidal,puberulent,pubescent,purple,removed,rotate-pentagonal,scale-like,scattered,slit,sometimes,somewhat,star,stem,subglabrous,subtending,symmetrical,terminal,tip,tri-,truncate,unwinged,violet,wall,white,whitish	age,middle,na,present,winged
69	wfo-0001026663	success	247	131	67	80	167	51	64	3	0.9-1.5,1-3.2,1.1-2.1,2.9-5,abaxially,accrescent,adaxially,anther,apex,apparently,appressed,articulated,attenuate,axillary,base,berry,blunt-tipped,branched,brown,calyx,cm,completely,constricted,corolla,covering,dark,directed,distally,drying,echinoid,echinoid-pubescent,entire,enveloping,filament,fleshy,fruit,fruiting,glabrescent,globose,green,hair,immature,lanceolate,leaf,length,long,lower,many,margin,mm,multangulate,openly,ovate-lanceolate,pedicel,perfect,persistent,petiole,plurifoliate,pore,poricidal,present,rich,scabrous,shrub,simple,slightly,small,somewhat,stellate,stem,time,tip,tomentose,tree,unarmed,unit,usually,violet,white,x	-2.9,.5-2.5,/25-1/15,/3,0-160,0.2-0.6,0.3-0.8,0.4-2.2,1,1-2.5,1-5,1.1,1.2-2,1.4-2.6,1.4-3.1,1.6-2.3,1.9-2.6,1/2,1/3,1/4-1/2,10-26,10.3-13.2-15,12-14,2-12,2.1-2.6,2.5-3.7,2.8-5.3,2/3,24-45,3-5,3.5-5,3.8-5.7,31,4.5-5.7-8,4.7-25.9,5-8,5.5-7.5-9,5.5-8.8-9.7,8-17,acuminate,acute,adaxiall,ag,along,angled,anthesi,apart,around,ascending,axe,bark,becoming,blade,branch,broadly,bud,capitat,chartaceous,closely,conical,cylindrical,densely,diameter,distributed,eaf,echinoi,edge,eed,elongated,especially,evident,exserted,farinose,flared,flower,free,glabrescen,glabrous,granular,granular-tomentose,greenish-brown,grooved,inserted,lateral,lengthening,less,light,line,lined,lobe,lobed,long-stalke,long-stalked,longer,longitudinal,longitudinally,m.,main,matur,midrib,midvein,minute,multangulate-pubescent,nearly,nflorescence,obtuse,occasional,occuring,older,opening,orolla,ovate,ovate-lanceolat,pale,peduncle,porrect-stellate,pseudo-terminal,pubescence,pubescent,rachi,rather,ray,ridged,robust,ruit,runk,sessile,short,short-stalked,side,slit,sometimes,soon,spaced,sparsely,stalk,stalked,stamen,stigma,strongly,style,subcampanulate,subcoriaceous,subglabrous,subglobose,suture,tall,tamen,tangled,terete,thick,thin,tomentose-pubescent,tomentum,touching,tube,ud,unarme,upper,vary,vein,way,whitish,wide,yellow,ympodial,young	articulation,bract,branching,breeding,broad-based,cell,colour,connective,form,growth,heteromorphism,inflated,inflorescence,insertion,interjected,interpetalar,leaflet,marking,mature,modification,na,needle-like,odour,orientation,paired,pattern,placement,position,prickle,pseudostipule,pseudoterminally,rhizome,scale,shape,smell,spot,staman,stone,structure,surface,symmetry,sympodial,system,texture,tissue,trichome,tuber,type,vegetative,xylopodia,zygomorphy	0.9-1.5,1-3.2,1.1-2.1,2.9-5,abaxially,accrescent,adaxially,apparently,articulated,attenuate,axillary,base,berry,blunt-tipped,branched,brown,cm,completely,constricted,covering,dark,directed,distally,drying,echinoid,echinoid-pubescent,entire,enveloping,fleshy,fruit,glabrescent,globose,green,immature,lanceolate,leaf,long,many,mm,multangulate,openly,ovate-lanceolate,perfect,persistent,plurifoliate,poricidal,present,rich,scabrous,shrub,simple,slightly,small,somewhat,stellate,time,tip,tomentose,tree,unarmed,usually,violet,white,x	mature,na,pseudoterminally
70	wfo-0001026686	success	196	164	94	103	93	61	82	12	.4,0.6-0.9,1-2,1.2-3.4,1.5-7,1.7-2.5,2-10,3-4,3.7-8,5,5-16.5,5-8,6.5-12.7,7-9,8-10,8-14,8-27,abaxially,adaxially,anther,apex,base,berry,blade,borne,brownish,cell,chartaceous,ciliate,cm,condition,conical,corolla,densely,diameter,digestion,distal,drying,end,enzyme,especially,filament,flower,forked,fresh,fruit,glabrous,green,greenish,hair,herb,homostylous,honeycomb-shaped,interjected,lanceolate,lateral,leaf,leaflet,lengthening,light,like,long,lower,margin,middle,minute,minutely,mm,mottled,obtuse,odd-pinnate,ovoid,pedicel,petiole,plant,plurifoliate,pore,poricidal,puberulent,pubescent,purple,purple-violet,removed,ripe,rotate-stellate,round,seed,singly,size,slit,sparsely,stigma,style,terminal,testal,tip,tri-,tuber,typically,unit,wall,whitish,x	0.2-0.5,1,1-10,1-2.5,1.2-3.6,10-28,2-9,2.4-3.6,2.5-8,3-5,4-6,5-merou,absent,acumen,acuminate,ag,along,alyx,apart,apparently,articulated,axe,axillary,bud,capitat,connivent,covering,decreasing,dorsally,eaf,edge,eed,elliptic-lanceolate,equal,erec,exceeding,flat,folded,geminat,generally,glabrou,gradually,green-white,hair-like,half,larger,living,lobe,make,midrib,mucilaginous,nflorescence,often,orbicular,orolla,ovate,pair,peduncle,perfect,petiolule,pubescen,ruit,secondary,semierect,seudostipule,slightly,spaced,specimen,stamen,star,ste,stolo,straight,stripe,subequal,subsessile,subtending,symmetrical,tall,tamen,tem,thick,throughout,toward,tube,usually,vary,wet,white,wide,wing,yellow,ympodial	5-merous,age,appressed,arrangement,articulation,bract,branching,breeding,broad-based,calyx,capitate,ciliation,colour,connective,form,fruiting,growth,height,heteromorphism,inflated,inflorescence,insertion,interpetalar,length,marking,mature,modification,na,needle-like,number,odour,orientation,ovary,paired,pattern,placement,position,presence,prickle,pseudostipule,pubescence,rhizome,scale,shape,spot,staman,stellate,stem,stolon,stone,structure,surface,symmetry,sympodial,system,texture,tissue,type,width,xylopodia,¼	.4,0.6-0.9,1-2,1.2-3.4,1.5-7,1.7-2.5,2-10,3-4,3.7-8,5,5-16.5,5-8,6.5-12.7,7-9,8-10,8-14,8-27,abaxially,adaxially,berry,borne,brownish,chartaceous,ciliate,cm,condition,conical,corolla,densely,digestion,distal,drying,end,enzyme,especially,forked,fresh,glabrous,green,greenish,hair,herb,homostylous,honeycomb-shaped,lanceolate,lateral,leaf,lengthening,light,like,long,lower,margin,middle,minute,minutely,mm,mottled,obtuse,odd-pinnate,ovoid,plurifoliate,pore,poricidal,puberulent,pubescent,purple,purple-violet,removed,ripe,rotate-stellate,round,singly,slit,sparsely,terminal,tip,tri-,typically,wall,whitish,x	5-merous,age,broad-based,capitate,na,needle-like,prickle,stellate,stem,stolon,surface,¼
71	wfo-0001026696	success	139	120	58	65	74	55	52	6	0.8-7,1-4,3-3.5,4-16,9,abaxially,adaxially,apex,apical,apically,articulate,base,branched,calyx,cell,cm,connate,corolla,cuneate,decurrent,dehiscent,densely,dichasially,distal,entire,filament,generally,globose,green,green-white,hair-like,half,herbaceous,introrse,light,long,margin,maturing,mm,mucilaginous,often,ovoid,pattern,pedicel,perennial,perfect,petiole,plant,poricidally,proximal,pubescent,rounded,seed,short,simple,sinuate,slit,stellate,style,throughout,tuber-bearing,typically,unit,white-cream,¼	0.3-4.5,0.9-7.2,1,1-1.3,1.3-2.1,1.5-3,2-17,2-3,3-17,3-6,3-6-foliat,3-8.5,5-35,acumen,acute,apiculate,broadly,covering,cyme,diameter,dichasial,digestion,dorsally,eaf,ebracteate,edge,eed,emoval,enzyme,exceeding,flat,flower,folded,forked,globo,honeycomb,lanceolate,lateral,light-yello,linear,living,lobe,lon,lower,lunat,make,monochasial,nflorescence,nther,oblong,obtuse,odd-pinnate,orolla,ovate,peduncle,plan,reveal,ruit,seudostipule,specimen,stamen,stigma,straight,tal,tem,testal,thick,throughou,vary,wall,wide,without,yellow,ympodial	3-6-foliate,anther,appressed,articulation,bract,branching,breeding,colour,connective,form,fruit,fruiting,growth,hair,heteromorphism,inflated,inflorescence,insertion,interjected,interpetalar,leaf,leaflet,length,light-yellow,lunate,marking,mature,modification,na,odour,orientation,ovary,paired,placement,pore,position,prickle,pseudostipule,rhizome,scale,shape,spot,staman,stone,structure,symmetry,sympodial,system,texture,tissue,tuber,type,wet,xylopodia,ye	0.8-7,1-4,3-3.5,4-16,9,abaxially,adaxially,apical,apically,articulate,branched,cm,connate,cuneate,decurrent,dehiscent,densely,dichasially,distal,entire,generally,globose,green,green-white,hair-like,half,herbaceous,introrse,light,long,maturing,mm,mucilaginous,often,ovoid,perennial,perfect,plant,poricidally,proximal,pubescent,rounded,short,simple,sinuate,slit,stellate,throughout,tuber-bearing,typically,white-cream,¼	3-6-foliate,light-yellow,lunate,na,wet,ye
72	wfo-0001026706	success	228	142	88	97	131	45	84	4	/14-1/6,0.8-1.5,0.9-2,1-2.2-3.1,1-5,3-4.6,8-14,abaxially,accrescent,acute,adaxially,anther,apex,appearing,around,articulated,axillary,base,berry,blade,blunt-tipped,branched,calyx,cm,completely,coriaceous,corolla,covering,crisped,cuneate,dark,dendritic-multangulate,diameter,directed,distally,edge,entire,enveloping,farinose,filament,fleshy,fourth,fruit,fruiting,glabrate,globose,green,hair,herbarium,lacking,lanceolate,leaf,length,lengthening,long,longitudinal,lower,many,margin,mm,multangulate,nearly,obtuse,occasionally,ovate,ovate-lanceolate,pedicel,petiole,plurifoliate,pore,poricidal,porrect-stellate,pseudo-terminal,pubescent,sessile,short-stalked,shrub,simple,slightly,slit,small,somewhat,sparsely,specimen,stem,surface,time,tip,tomentose-pubescent,tree,unit,upper,velutinous,wavy,white,whitish,x	-5.5,.5,0-240,0.2-0.3,0.2-0.5,0.6-2.2-6.1,0.8-1.2,0.8-2.8-4.4,0.9-1.9,1.1-4,1.5-3,1/2-2/3,10-15,12,14-32,2.2-3.3,2.3-3.8,2.5-3,2.7-4,2.9-6,2/3-3/4,3.1-3.8,3.6-5.7,4,4.2-12,4.5-5.5,5-6.5,5.3-6.4,6-10,6-8,6.1-9.8-15.4,7-16,adaxiall,ag,anthesi,apart,apparently,attenuate,axe,ba,bark,becoming,branch,brown,bud,capitat,chartaceous,closely,cylindrical,dendritic-echinoid,densely,eaf,eed,exserted,flower,free,furfuraceou,glabrous,golden,grayish,indument,inserted,lackin,lateral,lobe,lobed,long-stalked,m.,main,matted,midrib,minute,mixed,multangulat,nflorescence,oblong,obscured,often,older,orolla,ovate-elliptic,pale,peduncle,perfect,persistent,pubescence,rachi,rather,reddish,reticulate-punctate,ruit,runk,semi-ovate,short-,side,softly,soon,spaced,splitting,stalked,stamen,stellate,stigma,strongly,style,subcampanulate,subconical,subglobose,suborbicular,sulcate,suture,tall,tamen,thin-walled,tomentu,touching,translucent,transparent,tube,ud,unarme,unarmed,unevenly,vary,vein,way,wide,yellow,yellowish-tan,ympodial,young	age,articulation,bract,branching,broad-based,cell,colour,form,furfuraceous,growth,heteromorphism,inflorescence,insertion,interjected,interpetalar,leaflet,marking,mature,na,needle-like,odour,orientation,paired,placement,position,prickle,pseudostipule,rhizome,scale,shape,smell,spot,staman,stone,structure,symmetry,sympodial,texture,tissue,trichome,tuber,type,vegetative,xylopodia,zygomorphy	/14-1/6,0.8-1.5,0.9-2,1-2.2-3.1,1-5,3-4.6,8-14,abaxially,accrescent,acute,adaxially,apex,appearing,around,articulated,axillary,base,berry,blade,blunt-tipped,branched,cm,completely,coriaceous,covering,crisped,cuneate,dark,dendritic-multangulate,directed,distally,edge,entire,enveloping,farinose,fleshy,fourth,fruit,glabrate,globose,green,hair,herbarium,lacking,lanceolate,leaf,length,lengthening,long,longitudinal,many,mm,multangulate,nearly,obtuse,occasionally,ovate,ovate-lanceolate,plurifoliate,pore,poricidal,porrect-stellate,pseudo-terminal,pubescent,sessile,short-stalked,shrub,simple,slightly,slit,small,somewhat,sparsely,specimen,time,tip,tomentose-pubescent,tree,upper,velutinous,wavy,white,whitish,x	age,furfuraceous,na,zygomorphy
73	wfo-0001026707	success	194	113	66	75	119	38	61	5	.5,/3,0-20,0.5-1,0.5-3,2.5-6,3-4,5-10,5-merous,?,anther,apex,apparently,articulated,attenuate,base,berry,branched,calyx,chartaceous,clustered,cm,concolorous,connivent,discolorous,drying,elongating,entire,erect,filament,fruit,fruiting,glabrous,green,known,lateral,leaf,length,lobed,long,lower,margin,mauve,mm,moderately,narrow-deltate,pedicel,petiole,poricidal,prickle,prickly,pubescent,red-brown,shrub,simple,small,sometimes,sparsely,spherical,stellate,stellate-pubescent,stem,straight,surface,tapering,terminal,tip,tree,trichome,unit,way,weakly,white,wide,¼	.8,0-3,0-5,0.05,0.05-0.15,0.1-0.2,0.3-0.8,0.6-0.7,0.6-0.8,0.7-1,0.7-1.4,0.7-1.5,1-1.7,1-3,1-5,1.5-1.8,1.6-2,1/3,1/3-1/2,1/3-3/4,1/4-1/3,1/8-1/4-1/3,11-16,2-10,2-2.3,2-6,2.5-3,2.5-4,3-4.5,3-7,3-8,4,5-25,5-7,5-8,8-15,abaxially,acute,alyx,apar,apart,apically,bark,blade,branche,broad-deltate,broadly,color,curved,cuspidat,decurrent,densely,diameter,eaf,eed,equal,eye,flattened-reniform,flower,foliaceous,free,fused,gently,glabrescent,glabrou,gray,inflated,infructescence,juvenil,less,lobe,longer,mature,midpoint,naked,narrow-oblong,nflorescence,obtuse,older,one,open,orange-brown,orolla,oung,peduncle,per,perfec,pericarp,plurifoliat,porrect,porrect-lepidote,portion,ray,reflexed,rounded,ruit,scar,sessile,shorter,slender,smooth,spaced,spreading,stalk,stalked,stout,style,tamen,terete,time,tube,unarmed,upper,variously,vary,venation,visible,yellow-green,ympodial	arrangement,articulation,branch,branching,broad-based,cell,colour,corolla,form,growth,hair,heteromorphism,inflorescence,insertion,juvenile,na,needle-like,odour,orientation,perfect,placement,plurifoliate,position,pseudostipule,rhizome,scale,shape,smell,staman,stone,structure,symmetry,sympodial,texture,tuber,type,vegetative,xylopodia	.5,/3,0-20,0.5-1,0.5-3,2.5-6,3-4,5-10,5-merous,?,apparently,articulated,attenuate,base,berry,branched,chartaceous,clustered,cm,concolorous,connivent,discolorous,drying,elongating,entire,erect,glabrous,green,known,lateral,lobed,long,lower,mauve,mm,moderately,narrow-deltate,poricidal,prickle,prickly,pubescent,red-brown,shrub,simple,small,sometimes,sparsely,spherical,stellate,stellate-pubescent,straight,surface,tapering,terminal,tip,tree,way,weakly,white,wide,¼	branch,juvenile,na,perfect,plurifoliate
74	wfo-0001026711	success	207	114	51	65	142	49	47	4	.8,0.5-1.5,1/2-2/3,3.5-5.2,acicular,anther,apex,apparently,articulated,base,berry,branched,calyx,cell,cm,cuneate,densely,difoliate,elongating,equal,erect,evenly,filament,fruit,fruiting,green,lateral,leaf,length,lobed,long,lower,margin,mature,maturity,mauve,mm,orange,pedicel,perpendicular,petiole,poricidal,prickle,purple,red,reflexed,rounded,shrub,sometimes,somewhat,spherical,stellate,stellate-pubescent,stem,straight,surface,tapering,terminal,thick-chartaceous,tip,trichome,unit,way,weakly,young	-15,-5,-7,.2,.5,0-0.2,0-2,0-25,0-4,0-5,0-6,0-7,0.1,0.15,0.2-0.3,0.3-1,0.7-0.9,0.7-0.9-1.1,0.7-1.4,0.75-1,0.8,0.8-2.2,0.9-1.5,1-2,1-2-4-6,1-30,1.5-2-2.5,1.5-2.2,1.7-4,1/,1/3,1/4,1/4-1/3,2-2.2,2-3.5,2-6,2.1-2.5,3-4,3-4.5,3-5,3-7,4-8,4.5-7,5-merous,7-8,abaxially,acuminat,acute,alyx,ame,apar,apart,apically,bark,blade,brow,c.,concolorous,connivent,curved,deltate,diameter,discolorous,distance,drying,dull,eaf,eed,elliptic,extending,faint,flattened-reniform,flower,free,geminat,glabrous,infructescence,less,lobe,longer,midpoint,midvein,moderately,narrow-deltate,nflorescence,obtuse,occasionally,older,one,open,orange-brown,orolla,oung,outline,pair,pale,peduncle,pendulous,per,perfec,pericarp,pit,porrect,portion,prickl,prickly,primary,raised,ray,reduced,ruit,scar,sessile,shallowly,shorter,side,slender,small,smooth,spaced,spreading,stalk,stalked,style,tamen,terete,tertiary,time,tube,unarmed,uniform,upper,variously,vary,vein,venation,visible,wide,woody,yellow,yellow-green,ympodial	appressed,articulation,bract,branching,breeding,broad-based,colour,corolla,form,geminate,growth,hair,heteromorphism,inflated,inflorescence,insertion,interjected,interpetalar,leaflet,marking,na,needle-like,odour,orientation,paired,pattern,perfect,placement,position,present,pseudostipule,rhizome,scale,shape,smell,spot,staman,stone,structure,symmetry,sympodial,system,texture,tissue,tuber,type,vegetative,xylopodia,zygomorphy	.8,0.5-1.5,1/2-2/3,3.5-5.2,acicular,apparently,articulated,base,berry,branched,cm,cuneate,densely,difoliate,elongating,equal,erect,evenly,green,lateral,lobed,long,maturity,mauve,mm,orange,perpendicular,poricidal,purple,red,reflexed,rounded,shrub,sometimes,somewhat,spherical,stellate,stellate-pubescent,stem,straight,tapering,terminal,thick-chartaceous,tip,way,weakly,young	geminate,na,perfect,present
75	wfo-0001026717	success	207	126	67	78	129	48	62	5	1-2,2.5-4.5,3-6,4-8,5,abaxially,adaxially,anther,apex,articulated,axillary,base,berry,bud,cell,chartaceous,cm,conical,corolla,dark,darker,distal,dorsally,filament,folded,forked,fruit,generally,glabrous,green,hair,half,herb,homostylous,interjected,lanceolate,leaf,leaflet,lengthening,light,like,lobe,long,lower,margin,membranous,middle,minute,mm,obtuse,odd-pinnate,often,orbicular,ovate,pedicel,pentagonal,petiole,plant,plurifoliate,pore,poricidal,pubescent,purple,ripe,rotate,round,sessile,slit,sparsely,stripe,subtending,terminal,tip,tri-,tuber,unit,usually,violet	0.3-0.6,0.3-2.5,0.3-5,0.6-1.5,0.8,1-10,1-2.5,1-3,1.3-2.5,1.4-2.2,1.8-3,13-28,14-22,15-34,2.2-5,2.5-5.5,3-4,3-5,3.3-11,4-6,4-9,5-11,5-13.5,5-6,5-merou,5.3-9,7-11,acumen,acuminate,ag,along,alyx,apart,apparently,attenuate,axe,blade,borne,brownish,capitat,ciliate,condition,connivent,covering,decreasing,decurrent,diameter,digestion,drying,eaf,edge,eed,elliptic,end,enzyme,equal,erec,especially,exceeding,flat,flower,fresh,geminat,glabrou,gradually,green-white,greenish,hair-like,honeycomb-shaped,larger,lateral,living,make,medium,midrib,minutely,mottled,mucilaginous,narrow,nflorescence,one-quarte,orolla,ovoid,pair,peduncle,perfect,petiolule,present,puberulent,pubescen,removed,ruit,secondary,seed,semierect,seudostipule,singly,size,slightly,spaced,specimen,stamen,ste,stigma,stolo,straight,style,subequal,subglabrous,subsessile,symmetrical,tall,tamen,tem,testal,thick,throughout,toward,tube,typically,vary,wall,wet,whitish,wide,wing,x,yellow,ympodial	age,articulation,bract,branching,breeding,broad-based,calyx,colour,form,fruiting,geminate,growth,heteromorphism,inflorescence,insertion,interpetalar,length,marking,na,needle-like,odour,one-quarter,orientation,paired,pattern,placement,position,prickle,pseudostipule,rhizome,scale,shape,smell,spot,staman,stem,stone,structure,surface,symmetry,sympodial,system,texture,tissue,trichome,type,vegetative,xylopodia	1-2,2.5-4.5,3-6,4-8,5,abaxially,adaxially,articulated,axillary,berry,bud,chartaceous,cm,conical,dark,darker,distal,dorsally,folded,forked,generally,glabrous,green,hair,half,herb,homostylous,lanceolate,lengthening,light,like,lobe,long,membranous,middle,minute,mm,obtuse,odd-pinnate,often,orbicular,ovate,pentagonal,plant,plurifoliate,pore,poricidal,pubescent,purple,ripe,rotate,round,sessile,slit,sparsely,stripe,subtending,terminal,tip,tri-,usually,violet	age,geminate,na,one-quarter,stem
76	wfo-0001026725	success	166	130	55	75	91	55	50	5	.3,.5,0.2,0.7-1.2,1-1.2,1-1.5,1-4.5,1-5,1.2-1.7,1.5-2,1.6-2,2,2.2-4,5-5.5,5-6,acute,anther,anthesi,apex,base,berry,broadly,calyx,capitate,cm,corolla,cup-shaped,elliptic,extremely,filament,flattened-reniform,fruit,fruiting,glabrous,globose,green,greenish-white,interpetalar,large,leaf,less,lobe,lower,margin,minor,minutely,mm,onto,opposite,ovary,ovate,pale,pedicel,petiole,pitted,pore,poricidal,reddish-brown,shaped,short,shrub,size,stem,stigma,style,subshrub,surface,tan,tear-drop,trichome,tube,unit,white,winged,x	/4,1.5,1/2,3.5-4,3.6-7.7,5-20-flowered,8-18.6,8-9,accrescent,apart,attenuate,axil,bark,becoming,beneath,black,bluish,brownish-papillose,character,crackin,dark,deflexed,dia,differing,difoliate,dry,drying,eaf,edicel,eed,ellipsoid,evenly,free,geminat,geographically,glandular-papillose,incrassate,inflorescenc,lateral,lobed,lon,long,main,major,margine,material,middle,nflorescence,occasionally,often,older,one,open,ovoid,pair,paler,papillo,papillose,planar,portion,prominent,proximal,pubescent,reflexed,rounded,ruit,scar,scarious,simple,sinus,slender,slightly,spaced,split,straight,stretching,tall,tapering,tip,triangular,tuft,ud,uniseriate,upper,varying,vein,way,widest,woody,ympodial,young	0.5,1,5-20,articulation,bract,branching,breeding,broad-based,cell,colour,connective,diameter,flower,form,growth,hair,height,heteromorphism,inflorescence,insertion,interjected,leaflet,length,marking,modification,na,needle-like,number,odour,orientation,pattern,placement,plant,position,prickle,pseudostipule,rhizome,scale,seed,shape,smell,spot,staman,stellate,stone,structure,symmetry,sympodial,system,texture,tissue,tuber,type,vegetative,xylopodia	.3,.5,0.2,0.7-1.2,1-1.2,1-1.5,1-4.5,1-5,1.2-1.7,1.5-2,1.6-2,2,2.2-4,5-5.5,5-6,acute,berry,broadly,capitate,cm,cup-shaped,elliptic,extremely,flattened-reniform,glabrous,globose,green,greenish-white,large,leaf,less,minutely,mm,onto,opposite,ovate,pale,petiole,pitted,poricidal,reddish-brown,shaped,short,shrub,subshrub,tan,tear-drop,white,winged,x	0.5,1,5-20,na,stellate
77	wfo-0001026733	success	183	151	83	97	86	54	79	4	-11,-13,0.3-0.5,0.5-2,1-2,1-7,10-20,2-2.5,2-3,2-6,25-40,3-7,4,5-8,abaxially,acuminate,acute-acuminate,adaxially,apex,base,calyx,cell,chartaceous,cm,connective,connivent,cordate,cylindrical,deltate,densely,diameter,directed,distally,eglandular-pilose,eglandular-pubescent,ellipsoidal,elliptic-ovate,entire,equal,flower,forked,fruit,fusiform,glabrous,glandular-,glandular-puberulent,green,greyish,hair,hirsute,immature,lanceolate,leaving,lobe,long,longitudinal,lower,margin,membranaceous,mm,moderately,narrowly,near,oblique,ovate,ovoid,pedicel,pedicellar,peduncle,petiole,pilose,pore,pubescent-pilose,rachi,radiu,remnant,shining,shorter,simple,slightly,sometimes,stellate,stigma,stone,stripe,style,thecae,tree,triangular,truncate,unbranched,unit,villous,white,x,yellow,yellowish	-4,-7,-8,.5-3,0.3-0.5-1,0.3-2,0.5,0.5-1,0.5-4,1-1.5,1-3,1.5-14,1.5-2,1.5-2.5,15-20-50,2-4,2.5-7.5,3-15,3-3.5,3-4-foliat,4-23,4-5,4.5-5,7-10-14,8-12-15,acute,aggregate,apart,ape,articulated,axe,basal,beyond,blade,capitat,ciliat,color,curled,dense,dia,eaf,eed,eglandular-villous,especially,exceeding,exserted,flattened,glabrate,gland-tipped,glandula,glandular-tomentose,linear-triangular,lon,midrib,nflorescence,nther,orolla,ovum,perfect,present,pubescent,pubescent-pilo,ripe,round,ruit,small,smooth,spaced,sparsely,stamen,submarginally,swelling,tal,tem,time,toward,tube,ud,unknow,unknown,usually,vary,vein,white-puberulent,wide,ympodial	20-50,3-4-foliate,abaxial,adaxial,anther,arrangement,articulation,bract,branching,broad-based,bud,capitate,colour,corolla,form,fruiting,growth,height,heteromorphism,inflorescence,interjected,interpetalar,leaf,leaflet,length,mature,na,needle-like,odour,orientation,ovary,placement,plant,position,prickle,pseudostipule,rhizome,scale,shape,smell,staman,stem,structure,surface,symmetry,sympodial,texture,theca,tissue,trichome,tuber,type,vegetative,xylopodia	-11,-13,0.3-0.5,0.5-2,1-2,1-7,10-20,2-2.5,2-3,2-6,25-40,3-7,4,5-8,abaxially,acuminate,acute-acuminate,adaxially,apex,base,chartaceous,cm,connivent,cordate,cylindrical,deltate,densely,directed,distally,eglandular-pilose,eglandular-pubescent,ellipsoidal,elliptic-ovate,entire,equal,forked,fruit,fusiform,glabrous,glandular-,glandular-puberulent,green,greyish,hair,hirsute,immature,lanceolate,leaving,long,longitudinal,membranaceous,mm,moderately,narrowly,near,oblique,ovate,ovoid,pedicellar,pilose,pubescent-pilose,remnant,shining,shorter,simple,slightly,sometimes,stellate,stripe,thecae,tree,triangular,truncate,unbranched,villous,white,x,yellow,yellowish	20-50,3-4-foliate,capitate,na
78	wfo-0001026734	success	266	113	52	64	202	49	47	5	0.6,2.3–5,2–3,absent,accrescent,anther,apex,articulated,asymmetric,base,berry,branched,calyx,chartaceous,corolla,cuneate,elliptic,entire,foliate,fruit,geminate,globose,green,growth,hair,immature,internodal,lateral,leaf,length,lobed,long,lower,margin,mature,maturity,membranaceous,mm,much,obtuse,paired,pale,pedicel,perfect,petiole,plane,pore,poricidal,porrect-stellate,purple,sessile,shape,shrub,simple,stellate,stem,subopposite,subsessile,surface,trichome,unbranched,unit,white,¾	0.1,0.2,0.3,0.5,0.7–0.9,0.7–1,0.8–1,1,1.6–2,1.6–2.5,1.8–2.2,1.8–3,1/4,1–1.2,1–3,2.2–7,2.5–3,2–2.4,3,3.2–3.8,3–4,3–4-celled,3–8,4–6,4–7,4–8,4–9,5-merou,5–9,8,abaxial,abaxially,acuminate,acute,adaxial,adaxiall,adaxially,ag,also,always,alyx,anthesi,apical,apice,archin,ark,associated,axi,barely,becoming,beneat,beneath,blade,branch,bright,broadly,brown,caly,camptodromous,capitate,celled,central,clavate,closely,cm,commonly,congested,connivent,covered,covering,cylindrical,cyme,dark,dense,densely,denser,diameter,differing,directed,discolorous,distally,downward,dried,drying,due,eaf,eed,eglandular,emergent,erect,f.,fewer,flat,flattened,flower,forked,found,free,frequently,glabrescen,glabrescent,glabrous,glandular,gray,held,ilament,initially,introrsely,irregular,j,lamina,lanceolate,large,less,lobe,long-attenuate,longer,longitudinal,lying,material,maturit,midpoint,midri,minute,moderately,mostly,multiseriate,narrow,near,new,nflorescence,normally,oblong,obovate,observed,often,old,older,one,one-celled,opening,orolla,other,oung,ovary,ovate,pair,papillose,peduncle,pit,pointing,porrect,portion,pubescence,pubescent,purplish,rachi,raised,rarely,ray,rayed,reaching,reniform,rounded,ruit,scandent,secondary,shiny,short-stalked,shorter,size,slightly,slit,smaller,sometimes,spaced,sparse,sparsely,spread,spreading,stalk,stigma,still,style,surfac,terminal,tube,tuft,ud,unequal,uniseriate,upward,vary,vein,venation,vestiture,visible,whole,wide,yellow,yellowish,ympodial	2,appressed,articulation,bract,branching,breeding,broad-based,cell,colour,connective,filament,form,fruiting,heteromorphism,inflated,inflorescence,insertion,interjected,interpetalar,leaflet,marking,na,needle-like,odour,orientation,pattern,placement,position,present,prickle,pseudostipule,rhizome,scale,smell,spot,staman,stone,structure,symmetry,sympodial,system,texture,tissue,tuber,type,vegetative,xylopodia,ye,zygomorphy	0.6,2.3–5,2–3,absent,accrescent,apex,articulated,asymmetric,base,berry,branched,chartaceous,cuneate,elliptic,entire,foliate,geminate,globose,green,immature,internodal,lateral,leaf,length,lobed,long,maturity,membranaceous,mm,much,obtuse,pale,perfect,plane,poricidal,porrect-stellate,purple,sessile,shrub,simple,stellate,subopposite,subsessile,trichome,unbranched,white,¾	2,na,present,ye,zygomorphy
79	wfo-0001026740	success	171	170	103	117	54	53	100	3	0-10,0.5-1,1-12,1-2,1-4,1-5,10-20,10-30,2-3,2-4,2.5-27,2.5-4.5,2.5-6,20-50,3-15,3-5,4.5-10,5-8,6-10,8-19,abaxially,absent,acuminate,acute,adaxially,also,apex,apiculate,basal,base,beyond,branched,calyx,cell,cm,connective,connivent,cordate,corky,curled,cylindrical,darker,deltate,densely,diameter,directed,distally,eglandular,ellipsoidal,elliptic,entire,equal,especially,exceeding,fleshy,flower,fruit,glabrate,glabrous,glandular-puberulent,greenish,hair,immature,lanceolate,leaving,lobe,long,lower,margin,mature,mm,moderately,near,nearly,oblong,obtuse,often,orange,ovate,ovoid,pedicel,pedicellar,peduncle,perfect,petiole,pilose,pore,present,puberulent,purple,rachi,radiu,remnant,scar,sessile,shorter,simple,slightly,sparsely,stamen,stellate,stigma,stone,stripe,style,subcoriaceous,thecae,tree,truncate,unbranched,unit,violet,whitish,woody,x,yellow,young	-17,-2,1-10,1-3,2.5-3,3-3.5,3-foliat,3.5-40,4-5,5-40,absen,acute-acuminate,aggregate,apart,ape,articulated,axe,blade,browni,ciliate,eaf,eed,exserted,flattened,lon,narrowly,nflorescence,nther,orolla,pilo,pubescent,rarely,reticulate,ruit,small,sometimes,spaced,swelling,tal,tems,time,tomentose,toward,triangular,truncat,tube,ud,unlobed,vary,vein,villous,white-puberulent,wide,ympodial	3-foliate,anther,arrangement,articulation,bract,branching,broad-based,brownish,bud,colour,corolla,exsertion,form,growth,height,heteromorphism,inflorescence,insertion,interjected,interpetalar,leaf,leaflet,length,na,needle-like,number,odour,orientation,ovary,paired,pattern,placement,plant,position,prickle,pseudostipule,rhizome,scale,shape,smell,staman,stem,structure,surface,sympodial,texture,theca,tissue,trichome,tuber,type,vegetative,xylopodia	0-10,0.5-1,1-12,1-2,1-4,1-5,10-20,10-30,2-3,2-4,2.5-27,2.5-4.5,2.5-6,20-50,3-15,3-5,4.5-10,5-8,6-10,8-19,abaxially,absent,acuminate,acute,adaxially,also,apex,apiculate,basal,base,beyond,branched,cm,connivent,cordate,corky,curled,cylindrical,darker,deltate,densely,directed,distally,eglandular,ellipsoidal,elliptic,entire,equal,especially,exceeding,fleshy,fruit,glabrate,glabrous,glandular-puberulent,greenish,hair,immature,lanceolate,leaving,lobe,long,mature,mm,moderately,near,nearly,oblong,obtuse,often,orange,ovate,ovoid,pedicellar,perfect,pilose,present,puberulent,purple,remnant,scar,sessile,shorter,simple,slightly,sparsely,stamen,stellate,stripe,subcoriaceous,thecae,tree,truncate,unbranched,violet,whitish,woody,x,yellow,young	3-foliate,brownish,na
80	wfo-0001026752	success	166	168	97	110	56	58	94	3	-4,1,1-5,1-6,1.5-12,10-20-25,15-35-50,2,2-2.5,20-30,3-18,3-4,3.5-4,4-5,abaxially,abruptly,acute,adaxially,also,apart,apex,basal,base,beyond,black,branched,calyx,campanulate,cell,chartaceous,cm,connective,connivent,cordate,coriaceous,cuneate,cylindrical,darker,densely,diameter,dilated,directed,distally,ellipsoidal,elliptic-oblong,elliptic-ovate,entire,equal,exceeding,finely,flattened,fleshy,flower,forked,fruit,glabrous,globose,green,greenish-brown,hair,immature,lanceolate,laterally,leaving,less,lobe,long,margin,mm,moderately,narrowly,near,ovoid,pedicel,pedicellar,peduncle,petiole,pilose,pore,possibly,pubescent,pubescent-pilose,purplish,rachi,rarely,rather,remnant,ripe,short-acuminate,simple,slightly,somewhat,stamen,stellate,stigma,stone,stripe,style,thecae,tree,triangular,truncate,unbranched,unit,vein,violet,white,whitish,x,yellow	0-1-2-3,1-1.5,1-12,1-2,1-3,1.5-2,1.5-2.5,2-3,2-4,2.5-20,2.5-5,3,3-5,3-foliat,4-45,7-15,8-16,absent,aggregate,ape,apiculate,articulated,axe,blade,capitat,deltate,eaf,eed,exserted,lon,lower,nearly,nflorescence,nther,obtuse,orolla,papillose,perfect,pilo,presence,present,radiu,ruit,small,spaced,tal,tem,time,tomento,tube,ud,unknow,vary,wide,yello,ympodial	3-foliate,anther,articulation,bract,branching,breeding,bud,capitate,colour,corolla,direction,exsertion,filament,form,fruiting,growth,height,heteromorphism,inflorescence,insertion,interjected,interpetalar,leaf,leaflet,length,marking,modification,na,odour,orientation,ovary,paired,pattern,placement,plant,position,prickle,pseudostipule,rhizome,scale,seed,shape,size,spacing,spot,staman,stem,structure,symmetry,sympodial,system,texture,theca,tissue,trichome,tuber,type,xylopodia	-4,1,1-5,1-6,1.5-12,10-20-25,15-35-50,2,2-2.5,20-30,3-18,3-4,3.5-4,4-5,abaxially,abruptly,acute,adaxially,also,apart,apex,basal,base,beyond,black,branched,campanulate,chartaceous,cm,connivent,cordate,coriaceous,cuneate,cylindrical,darker,densely,dilated,directed,distally,ellipsoidal,elliptic-oblong,elliptic-ovate,entire,equal,exceeding,finely,flattened,fleshy,forked,fruit,glabrous,globose,green,greenish-brown,immature,lanceolate,laterally,leaving,less,lobe,long,mm,moderately,narrowly,near,ovoid,pedicellar,pilose,possibly,pubescent,pubescent-pilose,purplish,rarely,rather,remnant,ripe,short-acuminate,simple,slightly,somewhat,stamen,stellate,stripe,thecae,tree,triangular,truncate,unbranched,vein,violet,white,whitish,x,yellow	3-foliate,capitate,na
81	wfo-0001026754	success	175	115	52	64	111	51	49	3	-6+,0.5-1,1-1.5-3,1/2,2/3,5-lobed,adaxially,anther,apex,articulated,asymmetric,axi,base,berry,branched,calyx,cm,corolla,deeply,dendritic,densely,ellipsoid,especially,filament,globose,growth,inflorescence,later,lateral,leaf,leaving,lengthening,lobed,lower,many,margin,mature,membranous,mm,oblique,pedicel,peg,petiole,pore,poricidal,pubescent,simple,sleeve,slit,small,sparsely,stellate-rotate,stem,surface,terminal,time,tip,trichome,truncate,twining,unit,vine,way,white	.5,0.5,0.9-1.1,1,10,198.,2,2-2.5,2-3,2-4,2.5-3.5,3-4-celled,30+,4-5,5,5-merou,5.5-9,7-9,9,9-11,abaxially,acute,ag,along,alyx,anthesi,apar,apparently,ark,basal,broadly,brow,cabrera,clavate,complete,conical,connivent,cucullat,denser,diameter,distal,divided,eaf,ed,elliptic,entire,exerted,extending,fide,flower,free,glabrous,half,halfway,ilament,irregularly,lamina,like,lobe,long,loosely,midvein,minute,minutely,mixture,mostly,narrowly,new,nflorescence,older,orolla,outline,pair,papillo,peduncle,perfect,pinnate,planar,plurifoliat,portion,primary,puberulent,ruit,scandent,scar,seen,slender,sometimes,spaced,splitting,spreading,stigma,style,tangled,tem,transparent,tub,tube,twinin,ud,uniseriate,upper,vary,vein,weak,within,woody,x,yellow,yellowish,ympodial	age,appressed,articulation,bract,branching,breeding,broad-based,cell,colour,connective,form,fruit,fruiting,hair,heteromorphism,inflated,insertion,interjected,interpetalar,leaflet,length,marking,modification,na,needle-like,odour,orientation,paired,pattern,placement,plurifoliate,position,prickle,pseudostipule,rhizome,scale,shape,smell,spot,staman,stone,structure,symmetry,sympodial,system,texture,tissue,tuber,type,vegetative,xylopodia	-6+,0.5-1,1-1.5-3,1/2,2/3,5-lobed,adaxially,articulated,asymmetric,axi,base,berry,branched,cm,deeply,dendritic,densely,ellipsoid,especially,globose,inflorescence,later,lateral,leaving,lengthening,lobed,many,membranous,mm,oblique,peg,pore,poricidal,pubescent,simple,sleeve,slit,small,sparsely,stellate-rotate,terminal,time,tip,trichome,truncate,twining,vine,way,white	age,na,plurifoliate
82	wfo-0001026756	success	147	96	40	48	99	48	38	2	.25,1.8-3,3-4,acute,anther,apex,attenuate,base,berry,calyx,cm,corolla,dendritic,difoliate,elliptic,exserted,filament,fleshy,fruiting,globose,green,leaf,lobed,long,mm,nearly,occasionally,opposite,ovate,pedicel,perhaps,petiole,pinkish-white,pore,poricidal,shape,shaped,shrub,somewhat,strongly,tear-drop,thick,tip,tree,tube,unifoliate,unit,white	.5,0-7-1.2,0.25-0.5,0.5-1,0.5-3,1-1.5,1-2,1.5-1.7,1.5-10,1.5-2,1.5-3,3.5-8.5,5-10,5-10-flowered,5-5.5,6-10,6-16,abaxial,abaxially,adaxially,along,anthesi,apiculate,ba,bark,bilobed,broadly,brown,closely,conical,corresponding,dark,deflexed,deltate,densely,denser,dia,differing,distal,eaf,edicel,eed,erect,free,geminat,glabrescent,glabrous,grayish-brow,hard,inflorescenc,irregular,lamina,lateral,lax,like,lobe,lower,main,major,middle,minor,minutely,nflorescence,older,ovary,overlappin,ovoid-reniform,pair,pale,papillo,pericarp,pitted,planar,portion,present,pubescence,pubescent,rest,ruit,scar,simple,soon,spaced,sparsely,stem,stigma,style,surface,tall,trichome,tub,ud,uniseriate,vein,wide,widest,woody,ympodial,young	appressed,articulation,bract,branching,breeding,cell,colour,connective,form,fruit,geminate,growth,hair,heteromorphism,inflated,inflorescence,insertion,interjected,interpetalar,leaflet,length,margin,marking,mature,modification,na,odour,orientation,paired,pattern,placement,position,prickle,pseudostipule,rhizome,scale,spot,staman,stone,structure,symmetry,sympodial,system,texture,tissue,tuber,type,xylopodia	.25,1.8-3,3-4,acute,attenuate,base,berry,calyx,cm,dendritic,difoliate,elliptic,exserted,fleshy,globose,green,leaf,lobed,long,mm,nearly,occasionally,opposite,ovate,perhaps,pinkish-white,poricidal,shaped,shrub,somewhat,strongly,tear-drop,thick,tip,tree,tube,unifoliate,white	geminate,na
83	wfo-0001026777	success	168	148	76	96	72	52	74	2	.5,0.25-0.5,0.5-1.5,0.5-5,0.9-3,1-10,1-2,1-4,1.5-3,1.5-5,2-4,3-3.5,5-50-flowered,5-7,acuminate,acute,anther,apart,apex,base,beneath,blue,branching,brown,calyx,capitate,cell,cm,corolla,cup,decurrent,dense,difoliate,distal,elliptic,end,fide,filament,flattened,flattened-reniform,fruiting,glabrous,globose,green,growth,incrassate,lateral,leaf,lobed,long,lower,margin,matted,minor,minutely,mm,narrowly,near,nearly,occasionally,often,onto,opposite,outline,ovary,papillose,pedicel,petiole,pitted,pore,pubescent,quite,russet,scar,seed,shaped,shiny,shrub,sinuate,size,slightly,smooth,stem,stigma,style,surface,tear-drop,testa,trichome,tube,uniseriate,unit,vellozo,wall,white,x	.25,/3,0.5-1,1-1.3,1-1.5,1.2-1.8,2-4.5,2-5,4-8,5-14,anthesi,apiculate,axil,ba,beginning,berry,body,campanulate,deflexed,dia,differing,eaf,edicel,eed,exserted,filiform,flexuous,free,geminat,glabrate,greyi,hyaline,inflorescenc,irregularly,like,lobe,lon,main,major,middle,new,nflorescence,older,one,overtopping,pair,papillo,planar,poricidal,portion,prominent,quadrate-deltoid,rest,ruit,somewhat,soon,spaced,sparsely,straight,tall,tapering,thread-like,tip,tuft,ud,vein,way,widest,woody,yellowish,ympodial,young	articulation,bract,breeding,broad-based,bud,colour,connective,diameter,flower,form,fruit,geminate,hair,height,heteromorphism,inflorescence,insertion,interjected,interpetalar,leaflet,length,marking,modification,na,needle-like,number,odour,orientation,pattern,placement,plant,position,prickle,pseudostipule,rhizome,scale,shape,smell,spacing,spot,staman,stone,structure,symmetry,sympodial,system,texture,tissue,tuber,type,vegetative,xylopodia	.5,0.25-0.5,0.5-1.5,0.5-5,0.9-3,1-10,1-2,1-4,1.5-3,1.5-5,2-4,3-3.5,5-50-flowered,5-7,acuminate,acute,apart,base,beneath,blue,branching,brown,capitate,cell,cm,cup,decurrent,dense,difoliate,distal,elliptic,end,fide,flattened,flattened-reniform,glabrous,globose,green,incrassate,lateral,leaf,lobed,long,matted,minutely,mm,narrowly,near,nearly,occasionally,often,onto,opposite,outline,papillose,petiole,pitted,pubescent,quite,russet,shaped,shiny,shrub,sinuate,slightly,smooth,tear-drop,testa,trichome,uniseriate,vellozo,wall,white,x	geminate,na
84	wfo-0001026819	success	218	106	50	64	154	42	48	2	0-27,1-2,10-26,4-7,anther,apex,articulated,base,blue,cell,chartaceous,connate,connivent,corolla,distal,dot,filament,forked,fruit,globose,green,greenish-yellow,hair,herb,interjected,lanceolate,leaflet,light,like,long,lower,margin,membranous,middle,mm,oblique,odd-pinnate,ovoid,pedicel,pentagonal,petiole,plurifoliate,pore,poricidal,pubescent,purple,rotate-pentagonal,scattered,slightly,sometimes,somewhat,star,stem,stripe,symmetrical,terminal,tinged,tip,tri-,tuber,unit,violet,white,whitish	0.3-4.7,0.5-1.5,1-10,1-2.3,1-5,1.2-36,1.5-10,1.5-12,1.5-3.0,1.5-3.3,1.5-3.5,1.6-3.5,10,2-5,2-6,2.5-5,3-120,3-18,3-20,3-35,3-38,4,4-10,5-30,5-merou,6-11,7,abaxially,absent,acumen,acuminate,acute,adaxially,ag,along,alyx,apart,ascending,attenuate,bearing,blade,borne,broadly,brownish,bud,capitate,ciliate,clavat,cm,condition,covering,cuneate,curved,dark,decurrent,densely,diameter,digestion,dorsally,drying,eaf,edge,eed,elliptic,end,enzyme,erec,especially,exceeding,flat,flower,folded,fresh,geminat,generally,glabrou,glabrous,glaucous,greatly,green-white,greenish,hair-like,half,homostylous,honeycomb-shaped,larger,lateral,lengthening,living,lobe,lunate,make,midvein,minutely,moderately,mottled,mucilaginous,narrowly,nflorescence,non-glandular,often,orolla,ovate,pair,pedice,peduncle,petiolule,plant,puberulent,rachi,ranging,removed,ruit,scale-like,seed,seudostipule,short,singly,slit,spaced,specimen,stamen,ste,stigma,stolo,straight,style,subequal,subglabrous,suborbicular,subrosette,subtending,tall,tamen,tem,tertiary,testal,therefore,thick,throughout,truncate,tube,typically,unwinged,usually,vary,wall,wet,wide,wing,within,without,yellow,ympodial	articulation,bract,branching,broad-based,colour,connective,form,growth,heteromorphism,inflorescence,insertion,interpetalar,leaf,length,marking,na,needle-like,odour,orientation,paired,placement,position,prickle,pseudostipule,rhizome,scale,shape,smell,spot,staman,stone,structure,surface,symmetry,sympodial,texture,tissue,trichome,type,vegetative,xylopodia,zygomorphy	0-27,1-2,10-26,4-7,articulated,blue,chartaceous,connate,connivent,distal,dot,forked,globose,green,greenish-yellow,hair,herb,lanceolate,light,like,long,membranous,middle,mm,oblique,odd-pinnate,ovoid,pentagonal,plurifoliate,poricidal,pubescent,purple,rotate-pentagonal,scattered,slightly,sometimes,somewhat,star,stem,stripe,symmetrical,terminal,tinged,tip,tri-,violet,white,whitish	na,zygomorphy
85	wfo-0001026821	success	204	183	107	128	76	55	102	5	.2,0.2-1.5,0.3-1.2,0.3-2.5,0.4-1.5,0.5-3.5,0.7-1.8,0.8-1,1-1.5,1-2,1-5,1.5-2.5,10-15,2-3.5,2-6,2-celled,2.5-18,3-18,3-7,3-branched,3-celled,4-4.5,5-12,5-20,5-34,acuminate,anther,apex,apically,appressed,articulated,base,bayonet,berry,blade,bract,broadly,brown,cell,chartaceous,cm,cordate,dark,diameter,directed,distally,due,ellipsoidal,elliptic,equal,filament,flattened,flower,forked,frequent,fruit,gglobose,glabrous,gland-tipped,green,hair,herb,homostylous,incurved,interjected,lanceolate,large,lateral,leaf-opposed,leaflet,length,light,long-attenuate,longitudinal,lower,many,margin,mature,membranous,mm,moderately,oblique,oblong,obtuse,occasional,odd-pinnate,one-celled,opening,pair,paired,pale,pedicel,peduncle,per,petiole,petiolule,pilose,plurifoliate,pore,present,puberulent,pubescent,rachi,rarely,remnant,rounded,slender,slit,small,somewhat,sparsely,stamen,stellate,stigma,stripe,style,subglabrous,substellate,surface,terminal,thickening,tri-,unbranched,unit,wall,white,x,yellow	/3,0-20,0.5-1.2,1-20,1-3,1.2-1.5,17,1977,2-15,3-11,3-6,5-10,5-merou,abaxially,acut,adaxial,adaxially,ag,alyx,anderson,angular,apart,apical,apiculate,auriculate,axe,ba,basal,ciliat,cuneate,deltate,distal,eaf,eed,especially,exceeding,fused,geminat,glabrou,greatly,interstaminal,lobe,long,lowermost,mean,membrane,minute,minutely,much,narrowly,nflorescence,obliquely,occasionally,orolla,perfect,pseudostipular,pubescen,reduced,reniform,ruit,scandent,seudostipule,short,slightly,smaller,spaced,subtended,tamen,tem,time,truncat,tube,vary,wide,winged,ympodial	5-merous,age,arrangement,articulation,branching,breeding,broad-based,calyx,colour,connective,corolla,form,fruiting,geminate,growth,heteromorphism,inflated,inflorescence,insertion,interpetalar,leaf,marking,modification,na,needle-like,odour,orientation,ovary,pattern,placement,position,prickle,pseudostipule,rhizome,scale,seed,shape,smell,spot,staman,stem,stone,structure,symmetry,sympodial,system,texture,tissue,trichome,truncate,tuber,type,vegetative,width,xylopodia	.2,0.2-1.5,0.3-1.2,0.3-2.5,0.4-1.5,0.5-3.5,0.7-1.8,0.8-1,1-1.5,1-2,1-5,1.5-2.5,10-15,2-3.5,2-6,2-celled,2.5-18,3-18,3-7,3-branched,3-celled,4-4.5,5-12,5-20,5-34,acuminate,apically,appressed,articulated,base,bayonet,berry,broadly,brown,chartaceous,cm,cordate,dark,directed,distally,due,ellipsoidal,elliptic,equal,flattened,flower,forked,frequent,fruit,gglobose,glabrous,gland-tipped,green,hair,herb,homostylous,incurved,lanceolate,large,lateral,leaf-opposed,light,long-attenuate,longitudinal,many,mature,membranous,mm,moderately,oblique,oblong,obtuse,occasional,odd-pinnate,one-celled,opening,paired,pale,pilose,plurifoliate,present,puberulent,pubescent,rarely,remnant,rounded,slender,slit,small,somewhat,sparsely,stellate,stripe,subglabrous,substellate,thickening,tri-,unbranched,wall,white,x,yellow	5-merous,age,geminate,na,truncate
86	wfo-0001026827	success	142	131	74	88	54	43	71	3	.5,/3,0.4-0.6,0.5-2,0.6-1,1-1.1,1-1.5,1-2,1-2.1,1.3-1.6,1.5-2,2-2.2,3-9,5-6,abaxially,acute,age,and/or,anther,apart,apex,arachnoid,attenuate,bark,base,branched,calyx,clavate,cm,conical,corolla,dendritic,densely,diameter,distally,ellipsoid,especially,exerted,filament,glabrescent,glabrous,growth,inflorescence,internodal,lanceolate,leaf,lengthening,like,lobed,lower,margin,minutely,mm,narrowly,new,oblanceolate,ovary,papillate,pedicel,petiole,plane,pore,poricidal,pubescent,rachi,reddish,revolute,scar,shrub,simple,sinus,slender,slit,sparsely,stem,stigma,straight,strongly,style,surface,tip,trichome,tube,uniseriate,unit,way,white,x	0.2-0.5,1-2-2.5,2-4,7-9,?,adaxiall,anthesi,appearing,branch,broadly,crowded,deciduou,deltate,dense,dry,drying,eaf,erect,fleshy,flower,free,irregularly,know,known,lamina,less,lobe,near,nflorescence,nodding,ot,pair,paler,papillat,peduncle,perfect,planar,plurifoliat,portion,primary,small,soon,stout,surfac,terminal,thick,thickened,third,tub,ud,upper,vein,widest,ympodial	adaxially,branching,breeding,broad-based,bud,cell,colour,connective,distance,exertion,form,fruit,hair,heteromorphism,length,marking,modification,na,needle-like,orientation,pattern,placement,plurifoliate,position,prickle,pseudostipule,rhizome,shape,spot,staman,stellate,stone,structure,symmetry,sympodial,system,texture,thicknes,tuber,type,width,xylopodia,zygomorphy	.5,/3,0.4-0.6,0.5-2,0.6-1,1-1.1,1-1.5,1-2,1-2.1,1.3-1.6,1.5-2,2-2.2,3-9,5-6,abaxially,acute,age,and/or,apart,apex,arachnoid,attenuate,base,branched,calyx,clavate,cm,conical,dendritic,densely,diameter,distally,ellipsoid,especially,exerted,glabrescent,glabrous,inflorescence,internodal,lanceolate,lengthening,like,lobed,minutely,mm,narrowly,oblanceolate,papillate,plane,pore,poricidal,pubescent,rachi,reddish,revolute,shrub,simple,sinus,slender,slit,sparsely,straight,strongly,surface,tip,trichome,tube,uniseriate,way,white,x	adaxially,na,plurifoliate
87	wfo-0001026830	success	198	146	94	123	75	23	93	1	0-10,0.3-1.3,0.4-1,0.5-1.0,0.5-1.2,1-10,1-11,1-2,1.1-2.7,1.5-4,10-57,2-4,2.5-4.4,2.5-5,2.7-8,4-10,4-14.5,4-7,4.4-14.5,4.5-17.5,5-11,6-13,7-18,acumen,acuminate,acute,anther,apex,attenuate,base,blade,brown,brownish,cell,ciliate,clavate,cm,condition,coriaceous,corolla,deep,diameter,distal,dorsally,drying,edge,elliptic,filament,finely,flat,flower,folded,forked,fresh,fruit,glabrescent,glabrous,globose,green,greenish,hair,hair-like,half,herb,high,homostylous,honeycomb,interjected,lanceolate,lateral,leaf,leaflet,light,linear,lobe,long,margin,medium,mm,moderately,moniliform,mucilaginous,odd-pinnate,ovate,ovoid,pair,pedicel,peduncle,pentagonal,petiole,plant,pore,poricidal,puberulent,pubescent,purple,ripe,rotate,rounded,seed,sessile,shaped,short,simple,size,stigma,straight,stripe,style,subglabrous,terminal,testal,tip,tube,tuber,typically,wall,wet,white,whitish,x,yellow,yellowish	0.9-1.9,1.4-4,2-6,3.5-8.5,5-merou,abaxially,adaxiall,adaxially,ag,along,alyx,apart,apparently,arranged,articulated,asymmetric,axe,axillary,basiscopic,bead,berry,bud,capitat,connivent,covering,decreasing,digestion,eaf,eed,enzyme,erec,exceeding,geminat,generally,glabrou,green-white,hal,lengthening,like,living,lower,make,multiple,necklace,nflorescence,orbicular,orolla,perfect,petiolulate,plurifoliate,removed,ruit,seudostipule,side,slit,spaced,specimen,stamen,stolon,subequal,subglabrou,subtending,tall,tamen,tem,thick,throughout,tissue,toward,tri-,unit,unwinged,usually,vary,ympodial	abaxial,adaxial,arrangement,articulation,branching,calyx,capitate,colour,density,form,growth,height,inflorescence,length,number,ovary,pseudostipule,shape,spacing,staman,stem,texture,type	0-10,0.3-1.3,0.4-1,0.5-1.0,0.5-1.2,1-10,1-11,1-2,1.1-2.7,1.5-4,10-57,2-4,2.5-4.4,2.5-5,2.7-8,4-10,4-14.5,4-7,4.4-14.5,4.5-17.5,5-11,6-13,7-18,acuminate,acute,attenuate,brown,brownish,cell,ciliate,clavate,cm,condition,coriaceous,deep,distal,dorsally,drying,elliptic,finely,flat,folded,forked,fresh,glabrescent,glabrous,globose,green,greenish,hair,hair-like,half,herb,high,homostylous,honeycomb,lanceolate,lateral,light,linear,long,medium,mm,moderately,moniliform,odd-pinnate,ovate,ovoid,pentagonal,poricidal,puberulent,pubescent,purple,ripe,rotate,rounded,sessile,shaped,short,simple,straight,stripe,subglabrous,testal,tip,typically,wall,wet,white,whitish,x,yellow,yellowish	capitate
88	wfo-0001026831	success	205	107	48	63	142	44	45	3	.5,0.2-1,3-5,3-6,anther,apex,articulated,attenuate,base,berry,branched,bright,calyx,cell,chartaceous,cm,cream,curved,dark,difoliate,elongating,equal,erect,filament,fruit,fruiting,gray-brown,green,lateral,leaf,length,lobed,long,lower,margin,marking,mature,maturity,mauve,membranous,mm,moderately,narrow-cuneate,orange,orange-brown,pale,pedicel,petiole,poricidal,prickle,shrub,sometimes,spherical,stellate-pubescent,stem,surface,tapering,tip,trichome,unit,white,yellow,young	-5,-6.5,/4,0-10,0-20,0-3,0-6,0.1,0.1-0.2-0.25,0.1-0.25,0.15-0.25,0.2-0.4,0.3-0.6,0.3-0.65,0.5-1.2,0.6,0.6-2,0.65-1,0.7-1.1,0.7-2,1-10,1-2,1-2.2,1-2.5,1-3,1-4,1-6,1.2-2,1.5-2.5-9,1/3,1/3-1/,1/3-2/3,1/5-1/4,2-2.5,2-3,2-4,2.3-2.9,2.5-4.5,3.5-10,5-merous,7-10,7-8,abaxially,acute,alyx,apar,apart,apically,apparently,bark,blade,broad-deltate,brow,caudat,concolorous,connivent,deltate,densely,diameter,distance,drying,dull,eaf,eed,elliptic,extending,eye,flattened-reniform,flower,free,fully,geminat,glabrescent,glabrous,herbaceous,infructescence,less,lobe,longer,midpoint,midvein,multangulate,naked,nflorescence,oblong,occasionally,older,one,open,opening,orolla,oung,outline,ovate,pair,peduncle,pendulous,per,perfec,pericarp,porrect,portion,prickl,prickly,primary,raised,ray,red-brown,reduced,rounded,ruit,scandent,scar,sessile,shiny,shorter,side,slender,smooth,spaced,sparsely,spreading,stalk,stellate,style,subsessile,tamen,terete,tertiary,time,tube,upper,usually,vary,vein,venation,visible,way,white-gray,wide,yellow-green,ympodial	appressed,articulation,bract,branching,broad-based,colour,corolla,form,geminate,growth,hair,heteromorphism,inflated,inflorescence,insertion,interjected,interpetalar,leaflet,na,needle-like,odour,orientation,paired,placement,position,present,pseudostipule,rhizome,scale,shape,smell,spot,staman,stone,structure,symmetry,sympodial,texture,tissue,tuber,type,vegetative,xylopodia,zygomorphy	.5,0.2-1,3-5,3-6,articulated,attenuate,base,berry,branched,bright,chartaceous,cm,cream,curved,dark,difoliate,elongating,equal,erect,gray-brown,green,lateral,lobed,long,marking,maturity,mauve,membranous,mm,moderately,narrow-cuneate,orange,orange-brown,pale,poricidal,shrub,sometimes,spherical,stellate-pubescent,stem,tapering,tip,white,yellow,young	geminate,na,present
89	wfo-0001026841	success	139	86	57	66	73	20	55	2	/4,0.25-0.3,0.5-0.75,0.5-1,0.6-1,0.75-1,0.8-1,0.8-3,1.5,1.5-2,2-2.5,3-6.5,3.5-5,4-8,6-8,9.2-18,acute,along,anther,base,beneath,bi-lobed,broadly,calyx,clavate,cm,conical,corolla,decurrent,elliptic,filament,filiform,fruiting,glabrous,globose,green,inflorescence,leaf,lobed,margin,minutely,mm,opposite,papillose,pedicel,petiole,pore,poricidal,pubescent,shaped,shining,shrub,simple,slender,slightly,stigma,style,tapering,tear-drop,tip,trichome,tube,uniseriate,vein,way,white	.25,.5,0.05,0.25-0.5,0.5-2,5-8-flowered,7-9,anthesi,apart,apex,arch,axi,ba,bark,berry,coroll,curly-tipped,deflexed,deltoid,dia,eaf,edicel,eed,ellipsoid,exsertion,free,glabrate,greyish-gree,hyaline,immature,joined,known,later,lateral,like,lobe,lon,long,lower,main,middle,nflorescence,older,ovary,pair,paler,papillo,portion,prominent,raised,reddish,reflexed,rest,ruit,scar,series,spaced,sparsely,stem,straight,tall,terminal,thickened,ud,unevenly,unifoliat,unit,widest,winged,woody,x,ympodial,young	5-8,colour,diameter,flower,form,fruit,growth,height,length,marking,number,plant,position,shape,spot,symmetry,texture,type,width,zygomorphy	/4,0.25-0.3,0.5-0.75,0.5-1,0.6-1,0.75-1,0.8-1,0.8-3,1.5,1.5-2,2-2.5,3-6.5,3.5-5,4-8,6-8,9.2-18,acute,along,base,beneath,bi-lobed,broadly,calyx,clavate,cm,conical,decurrent,elliptic,filiform,glabrous,globose,green,leaf,lobed,minutely,mm,opposite,papillose,petiole,poricidal,pubescent,shaped,shining,shrub,simple,slender,slightly,tapering,tear-drop,tip,tube,uniseriate,vein,way,white	5-8,zygomorphy
90	wfo-0001026849	success	177	97	40	55	122	42	36	4	0.5-1,1-1.5,1-2,2-3,38/2,637/2,anther,apex,aster,axil,base,berry,calyx,cell,cm,colour,conical,corolla,developed,entire,filament,fork,fruiting,glabrous,glandular,green,growth,hair,inflorescence,lavender,leaf,long,long-cuneate,margin,mature,minute,mm,oblong,pedicel,petiole,pore,poricidal,rh,rotate,sea,shrub,simple,slightly,stem,stone,tip,tissue,unit,violet,well	0-10,1,1-6,1.5-2.5,1.75-2,11,2,30-40-50,5,5-10,7-8,80-100-130,acute,adherent,adult,amongst,appearing,aspect,australian,brown,capitate,composed,conspicuous,curved,cut,cyme,deflexed,dia,discoidal,distinct,distinctly,eed,ellipsoid,emarginate,enlarge,erect,exceeding,except,exerted,expanded,facetted,filled,flesh,floral,flower,flowered,free,general,globose,globular,granule,greater,gree,grey-brown,half,interacuminal,large,leave,lengthening,less,linear-lanceolate,little,lobe,lon,loosely,lower,maturity,mid-vein,minutely,native,nflorescence,oblong-lanceolate,occasionally,often,ovary,pal,pale,pedicellate,peduncle,petal,plurifoliat,preparation,pruinose,purple,rarely,relatively,reproducing,reticulate,rhachi,rounded,ruit,ruiting,seed,shallow,shed,short-lived,sinus,slende,slit,soft-wooded,solanum,solitary,sometimes,somewhat,soon,stigma,stony,stout,style,surface,thus,tub,tube,ud,unarmed,undulate,uvenile,vegetatively,way,x,ympodial,young	appressed,articulation,bract,branching,breeding,connective,enlarged,form,fruit,heteromorphism,inflated,insertion,interjected,interpetalar,leaflet,length,marking,modification,na,odour,orientation,paired,pattern,placement,plurifoliate,position,prickle,pseudostipule,rhizome,scale,shape,spot,staman,structure,symmetry,sympodial,system,texture,tuber,type,xylopodia,zygomorphy	0.5-1,1-1.5,1-2,2-3,38/2,637/2,aster,axil,berry,cm,conical,developed,entire,fork,glabrous,glandular,green,hair,lavender,leaf,long,long-cuneate,minute,mm,oblong,poricidal,rh,rotate,sea,shrub,simple,slightly,stem,tip,violet,well	enlarged,na,plurifoliate,zygomorphy
91	wfo-0001026858	success	150	113	54	60	90	53	47	7	1-4,1.5-4,3-4,6-18,abaxially,adaxially,apex,apical,apically,articulate,base,branched,calyx,cell,cm,connate,cordate,corolla,cuneate,dehiscent,dichasially,distal,filament,generally,glabrescent,glabrous,globose,green,hair-like,half,herbaceous,interjected,introrse,leaf,leaflet,light,long,maturing,mm,oblique,odd-pinnate,often,pattern,pedicel,perennial,perfect,petiole,plant,poricidally,proximal,shiny,short,slightly,slit,stellate,throughout,tuber-bearing,typically,unit,¼	0-.,0.5,0.8,0.8-1,1-10,1-11.5,1-2-3-4,1-5,1.3-1.5,2-2.5,2-3,2-4,2.5-3,3-5-15-30,3-6-foliat,4-24,4.5-10.5,6-10,6-7,abruptly,acumen,acute,covering,cyme,diameter,dichasial,digestion,diminishing,dorsally,eaf,ebracteate,edge,eed,emoval,enzyme,exceeding,flat,flower,folded,forked,globo,green-white,honeycomb,lateral,living,lobe,lon,lower,lunat,make,minute,monochasial,mucilaginous,mucronate,nflorescence,nther,oblong,obtuse,orolla,ovate,ovate-lanceolate,ovoid,pair,peduncle,plan,reveal,rounded,ruit,seed,seudostipule,size,specimen,stamen,stigma,straight,style,tal,tem,testal,thick,throughou,toward,triangular,vary,wall,white-crea,wide,without,yellow,ympodial	0-2,3-6-foliate,anther,appressed,articulation,bract,branching,breeding,colour,connective,ebbrate,form,fruit,fruiting,growth,hair,heteromorphism,inflated,inflorescence,insertion,interpetalar,length,lunate,margin,marking,mature,modification,na,odour,orientation,paired,placement,pore,position,prickle,pseudostipule,rhizome,scale,shape,spot,staman,stone,structure,symmetry,sympodial,system,texture,tissue,tuber,type,white-cream,xylopodia,ye	1-4,1.5-4,3-4,6-18,abaxially,adaxially,apical,apically,articulate,branched,cm,connate,cordate,cuneate,dehiscent,dichasially,distal,generally,glabrescent,glabrous,globose,green,hair-like,half,herbaceous,introrse,light,long,maturing,mm,oblique,odd-pinnate,often,perennial,perfect,plant,poricidally,proximal,shiny,short,slightly,slit,stellate,throughout,tuber-bearing,typically,¼	0-2,3-6-foliate,ebbrate,lunate,na,white-cream,ye
92	wfo-0001026895	success	166	148	78	98	68	50	74	4	0.5-1,0.5-1.2,0.5-1.5,0.5-2,0.8-1,1-1.5,1.4-2.1,2-2.5,2-3,2.5-3.2,2/3,4.5-5,abaxial,acute,adaxial,along,anther,anthesi,apex,apically,attenuate,bark,base,broadly,brown,calyx,capitate,cm,conical,corolla,dark,deflexed,dendritic,denser,difoliate,drying,elliptic,erect,filament,filiform,flattened,fruiting,glabrous,globose,green,incrassate,internodal,lamina,leaf,lobed,lower,margin,minutely,mm,mustard,narrowly,often,ovary,pale,pedicel,petiole,pitted,pointed,pore,poricidal,pubescent,reddish,reniform,scattered,shape,shaped,shrub,shrublet,simple,size,small,somewhat,stem,stigma,style,surface,swollen,swollen-based,tan,tear-drop,tip,toothed,trichome,tube,type,uniseriate,unit,usually,vein,way,white,x,yellow	.5,0-0.5,1-5,1.5-2,2-2.3,3-12,5-6,5-8-flowered,apical,appearing,ba,berry,borne,broad,campanulate,closely,contracted,deltoid,dia,differing,eaf,edicel,eed,ellipsoid,elongate,free,geminat,glabrate,hard,lateral,like,lobe,lon,long,long-exserted,main,major,middle,minor,minute,nflorescence,obovate,older,overlappin,pair,papillo,pericarp,portion,present,projection,reddish-brow,ruit,scar,shoot,short,side,soon,spaced,sparsely,tall,thin,tub,tuft,ud,widest,woody,ympodial,young	0.5,articulation,bract,branching,breeding,broad-based,cell,colour,diameter,form,fruit,geminate,growth,hair,height,heteromorphism,inflorescence,insertion,interjected,interpetalar,leaflet,length,marking,na,needle-like,odour,orientation,pattern,placement,plant,position,prickle,pseudostipule,reddish-brown,rhizome,scale,seed,smell,spot,staman,stone,structure,symmetry,sympodial,system,texture,tissue,tuber,vegetative,xylopodia	0.5-1,0.5-1.2,0.5-1.5,0.5-2,0.8-1,1-1.5,1.4-2.1,2-2.5,2-3,2.5-3.2,2/3,4.5-5,acute,along,apically,attenuate,base,broadly,brown,capitate,cm,conical,dark,deflexed,dendritic,denser,difoliate,drying,elliptic,erect,filiform,flattened,glabrous,globose,green,incrassate,internodal,lamina,lobed,margin,minutely,mm,mustard,narrowly,often,pale,pitted,pointed,poricidal,pubescent,reddish,reniform,scattered,shaped,shrub,shrublet,simple,small,somewhat,swollen,swollen-based,tan,tear-drop,tip,toothed,trichome,type,uniseriate,usually,vein,way,white,x,yellow	0.5,geminate,na,reddish-brown
93	wfo-0001026905	success	199	121	50	69	130	52	48	2	.5,0-25,0.5-1.5,1-6,1/2-3/4,2.5-3.5,anther,apex,articulated,attenuate,base,berry,branched,calyx,cell,chartaceous,cm,connivent,difoliate,elongating,erect,filament,flattened-reniform,fruit,fruiting,glabrous,inflorescence,lateral,leaf,length,lobed,long,lower,margin,marking,mature,maturity,mauve,mm,orange,outline,pedicel,per,petiole,pit,poricidal,prickle,prickly,raised,red,rounded,shrub,small,smooth,sometimes,spherical,stellate,stellate-pubescent,stem,subentire,surface,tapering,tip,trichome,unit,usually,way,weakly,white	-4,.2,0-10,0-2,0-20,0-3,0.1,0.15,0.2-0.3,0.2-0.5,0.3-0.4,0.4-0.9,0.4-1,0.4-1.5,0.5-0.7,0.6-0.7,0.7-1.4,0.75-1.1,0.9-1.3,1-2,1-2.5,1-20,1-3.7,1-4,1.9-2.5,1/3,1/4-2/3,1/5-1/3,2-3,2.5-2.9,2/3-3/,3-5,3-8,5-6,5-merous,6-8,7-8,abaxially,acuminat,acute,alyx,ame,apar,apart,apically,apparently,bark,blade,brow,c.,cream,curved,dark,deltate,densely,diameter,discolorous,distance,drying,dull,eaf,eed,equal,extending,eye,flower,free,geminat,gray-green,green,infructescence,lobe,longer,midpoint,midvein,moderately,naked,oblong,older,one,open,orange-brown,orolla,oung,ovate,pair,pale,peduncle,pendulous,perfec,pericarp,porrect,portion,prickl,primary,ray,reduced,ruit,scar,sessile,shallowly,shorter,side,slender,somewhat,spaced,sparsely,spreading,stalk,stalked,straight,style,tamen,terete,tertiary,time,tube,unarmed,upper,variously,vary,vein,venation,visible,wide,woody,yellow,yellow-green,ympodial,young	abaxial,adaxial,appressed,articulation,bract,branching,breeding,broad-based,colour,connective,corolla,form,geminate,growth,hair,heteromorphism,inflated,insertion,interjected,interpetalar,leaflet,modification,na,needle-like,number,odour,orientation,paired,pattern,placement,pore,position,pseudostipule,rhizome,scale,seed,shape,smell,spot,staman,stone,structure,symmetry,sympodial,system,texture,tissue,tuber,type,vegetative,xylopodia,zygomorphy	.5,0-25,0.5-1.5,1-6,1/2-3/4,2.5-3.5,articulated,attenuate,base,berry,branched,cell,chartaceous,cm,connivent,difoliate,elongating,erect,flattened-reniform,glabrous,lateral,lobed,long,maturity,mauve,mm,orange,outline,per,pit,poricidal,prickly,raised,red,rounded,shrub,small,smooth,sometimes,spherical,stellate-pubescent,subentire,tapering,tip,usually,way,weakly,white	geminate,na
94	wfo-0001026923	success	177	153	87	104	73	49	84	3	.1-0.3,.5,0.25-0.5,0.5-1,0.6-0.8,0.8-1,1,1-7,1.5-4,2,2-2.5,2-6,3-5,4-18,4-5-,5-10,5-15,5-6,5-9,abaxially,acuminate,adaxially,anther,apex,articulated,base,black,branched,brown,calyx,chartaceous,cm,cuneate,curved,cylindrical,densely,diameter,directed,distally,elliptic,elliptic-ovate,entire,filament,flattened,flower,forked,fruit,geminate,glabrescent,glabrous,globose,green,hair,intermediate,large,leaf,leaf-opposed,light,like,longitudinal,many-foliate,margin,mm,moderately,multangulate,oblong,opening,paired,pedicel,peduncle,peltate,petiole,pore,possibly,pubescent,purple,rachi,red,ripening,rounded,rugulose,scale,sessile,shrub,simple,slit,small,sometimes,sparsely,stellate,stem,stigma,straight,strongly,style,surface,tree,trichome,unit,white,whitish,x,yellow,yellowish	-5,0-5,0.5,1-1.5,1-3,1-4,1.5-2,10,2-3,20-50,3-4,absent,accrescent,acute,adaxiall,ag,apart,apparently,axe,ba,blade,capitat,center,connivent,covering,deltate,denser,eaf,eed,eglandular,equal,erect,frui,fruiting,fused,gland-tippe,glandular,held,lanceolate,lateral,lobe,long,lower,midpoint,midvein,much,nearly,nflorescence,orange,orolla,perfect,pubescence,ray,relatively,ruit,short,slightly,smaller,somewhat,spaced,ste,subtending,tal,tamen,tem,time,tip,tube,uprigh,usually,vary,wide,ympodial	age,arrangement,articulation,bract,branching,breeding,capitate,cell,colour,connective,corolla,form,growth,height,heteromorphism,inflorescence,interjected,interpetalar,leaflet,length,marking,mature,modification,na,odour,orientation,ovary,pattern,placement,plant,position,prickle,pseudostipule,rhizome,seed,shape,size,spot,staman,stone,structure,symmetry,sympodial,system,texture,tissue,tuber,type,xylopodia	.1-0.3,.5,0.25-0.5,0.5-1,0.6-0.8,0.8-1,1,1-7,1.5-4,2,2-2.5,2-6,3-5,4-18,4-5-,5-10,5-15,5-6,5-9,acuminate,articulated,base,black,branched,brown,chartaceous,cm,cuneate,curved,cylindrical,densely,diameter,directed,distally,elliptic,elliptic-ovate,entire,flattened,forked,geminate,glabrescent,glabrous,globose,green,hair,intermediate,large,leaf-opposed,light,like,longitudinal,many-foliate,mm,moderately,multangulate,oblong,opening,peltate,possibly,pubescent,purple,red,ripening,rounded,rugulose,scale,sessile,shrub,simple,slit,small,sometimes,sparsely,stellate,stem,straight,strongly,tree,trichome,white,whitish,x,yellow,yellowish	age,capitate,na
95	wfo-0001026925	success	215	121	58	72	143	49	55	3	0-20,1-1.3,1-3.5,1/3-1/2,5-6,6-8,andromonoecious,anther,apex,articulated,attenuate,base,berry,branched,calyx,chartaceous,cm,connivent,cream,curved,dark,deltate,equal,filament,flattened,flower,fruit,fruiting,gently,green,hair,lateral,leaf,length,lobed,long,long-styled,lower,margin,marking,mature,maturity,mauve,membranous,mm,pale,pedicel,petiole,poricidal,porrect,prickle,rarely,reflexed,sessile,short-styled,shrub,spherical,stalked,stellate,stem,straight,surface,tapering,terminal,tip,trichome,unit,way,white,yellow,yellow-orange,young	.5,/6,0,0-10,0-2,0-5,0-7,0.1,0.1-0.2,0.1-0.3,0.2,0.5-1.5,0.5-4,0.7-1.8,0.9-1.8,00-200,1-1.4,1-25,1-3,1-4,1.5-2,1.5-2.5,1.5-4.5,1.8-2,1.8-2.5,1/3,1/4-2/3,1/6-1/3,2-4,2-5,2.4-2.6,2.4-3,2.5-6,2/,3-20,3-7,4-10,4-14,4-5,4-7,5-8,5-merous,5.5-10,6-10,6-17,7-12,abaxially,acuminat,acute,alyx,ame,apar,apart,apically,apparently,bark,blade,broad-deltate,brow,c.,concolorous,diameter,distal,distance,drying,eaf,eed,elliptic,elongating,erect,extending,flattened-reniform,free,glabrescent,glabrous,green-brown,hermaphrodite,heterostylous,infructescence,lobe,lobing,longer,lowermost,midpoint,midvein,minute,moderately,narrow-deltate,nflorescence,oblong,older,one,open,orange-brown,orolla,oung,ovate,pair,peduncle,pendent,pendulous,per,pericarp,plant,plurifoliat,portion,prickl,prickly,primary,ray,red-brown,reduced,rounded,ruit,scar,secondary,side,simple,smooth,sometimes,spaced,sparsely,spreading,stalk,staminat,stellate-pubescent,stout,style,tamen,terete,tertiary,time,translucent,tube,unarmed,upper,vary,vein,venation,visible,wide,woody,ympodial	appressed,articulation,bract,branching,breeding,broad-based,cell,colour,connective,corolla,form,growth,heteromorphism,inflated,inflorescence,insertion,interjected,interpetalar,leaflet,modification,na,needle-like,odour,orientation,paired,pattern,placement,plurifoliate,pore,position,pseudostipule,rhizome,scale,shape,smell,spot,staman,stone,structure,symmetry,sympodial,system,texture,tissue,tuber,type,vegetative,xylopodia,zygomorphy	0-20,1-1.3,1-3.5,1/3-1/2,5-6,6-8,andromonoecious,articulated,attenuate,base,berry,branched,chartaceous,cm,connivent,cream,curved,dark,deltate,equal,flattened,flower,gently,green,lateral,lobed,long,long-styled,marking,maturity,mauve,membranous,mm,pale,poricidal,porrect,prickle,rarely,reflexed,sessile,short-styled,shrub,spherical,stalked,stellate,stem,straight,tapering,terminal,tip,way,white,yellow,yellow-orange,young	na,plurifoliate,zygomorphy
96	wfo-0001026946	success	205	113	69	79	126	34	63	6	0-20,1-2,1-4,10-39,3-20,5-7,6-24,anther,apex,articulation,axillary,base,berry,blade,borne,bud,cell,chartaceous,cm,connivent,corolla,creamy,deeply,densely,distal,dot,end,extremely,filament,forked,fruit,glabrous,globose,green,half,herb,interjected,lanceolate,leaflet,lengthening,long,margin,membranous,mm,oblique,odd-pinnate,ovoid,pedicel,pentagonal,petiole,plurifoliate,pore,poricidal,proximal,pure,purple,ripe,rounded,scattered,short-pubescent,singly,size,slightly,slit,stellate,streak,subtending,terminal,tip,tri-,truncate,tuber,typically,unit,usually,variable,white,x,yellow-white	0-5,0.5-2,0.9-3.5,0.9-4.3,1,1-10,1.5-2,1.6-3.7,12-23,2,2-15,2-5,2.5-10.5,2.7-9,3-5,3-6,3.5-10,4-7,4.1-9.4,5-merou,8-15,8-25,abaxially,acumen,acuminate,acute,adaxially,ag,along,alyx,apart,apparently,attenuate,axe,broadly,brownish,capitat,ciliate,clavate,condition,covering,diameter,digestion,dorsally,drying,eaf,edge,eed,elliptic,enzyme,erec,especially,exceeding,except,flat,flower,folded,fresh,geminat,generally,glabrou,greatly,green-white,greenish,hair,hair-like,homostylous,honeycomb-shaped,lateral,like,living,lobe,lower,make,midrib,minutely,mottled,mucilaginous,narrowly,nflorescence,often,orbicular,orolla,ovate,pair,peduncle,perfect,petiolulate,petiolule,plant,puberulent,pubescen,pubescent,reduced,removed,ruit,seed,sessile,seudostipule,short,spaced,specimen,stamen,ste,stem,stigma,stolo,straight,style,subequal,tall,tamen,tem,testal,thick,thir,throughout,tube,unwinged,vary,wall,wet,whitish,wing,yellow,ympodial	age,arrangement,branching,colour,form,geminate,growth,heteromorphism,inflorescence,insertion,leaf,length,marking,na,odour,orientation,placement,position,prickle,pseudostipule,rhizome,shape,spot,staman,stolon,stone,structure,symmetry,sympodial,texture,third,type,xylopodia,zygomorphy	0-20,1-2,1-4,10-39,3-20,5-7,6-24,axillary,berry,borne,bud,chartaceous,cm,connivent,creamy,deeply,densely,distal,dot,end,extremely,forked,glabrous,globose,green,half,herb,lanceolate,lengthening,long,membranous,mm,oblique,odd-pinnate,ovoid,pentagonal,plurifoliate,pore,poricidal,proximal,pure,purple,ripe,rounded,scattered,short-pubescent,singly,slightly,slit,stellate,streak,subtending,terminal,tip,tri-,truncate,tuber,typically,usually,variable,white,x,yellow-white	age,geminate,na,stolon,third,zygomorphy
97	wfo-0001026962	success	205	110	74	91	114	19	71	3	.05,0.3-0.7,0.8-1,1,1-1.2,1-1.5,1-2,1-3,1-4.5,1-6,1.5-17,1.5-5,10-12,2-2.5,2-6,2/3-3/4,3-3.5,4-5,6-7,acute,anther,apex,bark,base,broadly,calyx,chartaceous,cm,corolla,deltate,densely,diameter,difoliate,dry,elliptic,entire,evenly,filament,flattened-reniform,fruit,glabrous,globose,green,inflorescence,internodal,leaf,lobe,lobed,margin,material,mm,narrowly,oblong,occasionally,opposite,pale,papillose,pedicel,peduncle,petiole,pore,pubescent,purplish,rachi,rounded,sagittate,shaped,shrub,simple,size,slightly,small,sometimes,somewhat,stellate,stigma,style,tear-drop,tinged,tip,tree,triangular,tube,unbranched,unifoliate,unit,way,white,x,yellow,yellowish	.5,0,0.5,0.5-0.8,0.5-1,0.5-1.5,1.5-2,1.5-3,10-20,15-22,2-5,3-6,9-12,9-17,abaxially,abrupt,abruptly,accrescent,adaxially,ag,alyx,anthesi,apparently,appearing,arising,articulated,axe,basebud,becoming,beneath,blade,brittle,bud,capitat,cell,closely,composed,connivent,constricted,cucullat,cylindrical,darker,deflexed,denser,differing,dimorphic,eaf,eed,elongate,except,exerted,flower,free,fruiting,geminat,glabrate,glabrou,ilament,incrassate,later,lateral,like,long,longitudinal,main,major,minor,minutely,nflorescence,obconic,obovoid,often,older,one,opening,orolla,oung,outline,ovate-lanceolate,overlapping,packed,pair,paten,pendent,perfect,pitted,portion,prominent,pubescen,raised,reflexed,remaining,rest,rounder,ruit,slender,slit,soon,stem,straight,surface,tal,tapering,tooth,trichome,trunk,unarmed,uniseriate,vary,vein,whit,woody,ympodial,young	abaxial,adaxial,arrangement,branching,capitate,colour,cucullate,form,geminate,growth,height,length,plant,position,seed,shape,structure,sympodial,texture	.05,0.3-0.7,0.8-1,1,1-1.2,1-1.5,1-2,1-3,1-4.5,1-6,1.5-17,1.5-5,10-12,2-2.5,2-6,2/3-3/4,3-3.5,4-5,6-7,acute,base,broadly,chartaceous,cm,deltate,densely,diameter,difoliate,dry,elliptic,entire,evenly,flattened-reniform,glabrous,globose,green,internodal,leaf,lobed,material,mm,narrowly,oblong,occasionally,opposite,pale,papillose,pubescent,purplish,rounded,sagittate,shaped,shrub,simple,slightly,small,sometimes,somewhat,stellate,tear-drop,tinged,tip,tree,triangular,unbranched,unifoliate,way,white,x,yellow,yellowish	capitate,cucullate,geminate
98	wfo-0001026964	success	128	143	75	86	42	57	69	6	.2,.5,0,0.5,0.5-1,1-1.2,1-2.5,10,10-30,2-2.5,2-4,3-5,3.5-7,4.5-8.5,acuminate,acute,along,anther,apex,attenuate,axillary,basal,base,beak,berry,calyx,cm,conical,conspicuously,corolla,diameter,elliptic,equal,exserted,filament,filiform,fruiting,glabrous,globose,green,greenish,herb,horizontal,lateral,leaflet,lenticellate,lightly,lobed,long,long-attenuate,margin,minutely,mm,nearly,obovate,onto,ovary,pair,papillate,pedicel,petiole,petiolule,pinnate,poricidal,pubescent,purple,rachi,rugose,shape,simple,size,smooth,somewhat,sparsely,stigma,style,surface,terminal,tip,trichome,tube,uniseriate,unit,winged,x,yellow	7-8,?,anthesi,bearing,capitat,differentiated,distinct,eaf,edicel,erec,fleshy,flower,free,glabrou,immature,known,line,lobe,lower,nflorescence,noddin,often,one,open,ot,portion,primary,purpli,reflexed,ruit,scar,side,slender,small,tal,tem,time,tub,ud,unifoliat,vein,ympodial	articulation,bract,branching,breeding,bud,capitate,cell,colour,connective,erect,exsertion,form,fruit,glabrousnes,growth,hair,height,heteromorphism,inflorescence,insertion,interjected,interpetalar,leaf,length,marking,modification,na,nodding,number,odour,orientation,paired,pattern,placement,plant,pore,position,prickle,pseudostipule,purplish,rhizome,scale,spot,staman,stem,stone,structure,symmetry,sympodial,system,texture,tissue,tuber,type,unifoliate,winging,xylopodia	.2,.5,0,0.5,0.5-1,1-1.2,1-2.5,10,10-30,2-2.5,2-4,3-5,3.5-7,4.5-8.5,acuminate,acute,along,attenuate,axillary,base,berry,calyx,cm,conical,conspicuously,diameter,elliptic,equal,exserted,filiform,glabrous,globose,green,greenish,herb,horizontal,lateral,lenticellate,lightly,lobed,long,long-attenuate,margin,minutely,mm,nearly,obovate,onto,pair,papillate,pinnate,poricidal,pubescent,purple,rachi,rugose,shape,simple,size,smooth,somewhat,sparsely,tip,trichome,tube,uniseriate,winged,x,yellow	capitate,erect,na,nodding,purplish,unifoliate
99	wfo-0001026981	success	249	107	51	65	184	42	45	6	-14,-2.5,0.3-0.5,0.5-30-35,1-2,1-2-cellular,1-3-celled,1/3,2-3-branched,2-locular,3-foliate,4-8,absent,accrescent,anther,apex,appressed,articulation,asymmetric,base,bract,calyx,cell,citrus-like,cm,cordate,corolla,distal,filament,fruit,fruiting,glabrescent,glandular,globose,herb,imparipinnate,interjected,interrupted,leaf,leaflet,long,lower,margin,mm,orange,patent,pedicel,pentagonal,petiole,pseudostipule,pubescent,rounded,shorter,simple,slender,sometimes,sparsely,stem,strong,surface,trichome,type,uniseriate,unit,yellow	-0.4,-4,-8,.2,.2-0.2,0-5,0.05-0.1,0.1-0.2,0.1-0.3,0.15-0.2,0.2,0.2-0.4,0.2-2,0.25-0.4,0.3.6-0.8,0.4-0.5,0.4-0.7,0.4-2,0.45-1.3,0.5,0.5-0.3,0.6-1.4,0.6-2,0.7-0.8,0.8-1.2,0.8-6,0.9-1.4,0.9-1.5,1,1-3,1-3.3,1-4,1.5-2.0,1.5-5,1.5-8.5,1.8-2.8,11,196.,2-3,3.5-14,4,4-celled,6-10,7.5,<,abaxially,absen,abundant,academy,acute,adaxially,adpressed,along,amongst,angled,anthesi,apical,appearance,appendage,articulated,axi,basiscopically,bay,beak,becoming,bracteole-like,brown,capitate,coastal,column,composed,cone,conical,d,dark,deltate,densely,diameter,eaf,ebracteate,edicel,eed,entire,erect,exserted,flower,giving,gree,green,hair-like,half,halfway,head,included,initially,internode,irregularly,jointles,larger,later,lateral,less,like,lime,linear,lobe,lobed,lon,mainly,maturity,minutely,mixed,much,multicellular,narrowly,nflorescence,obovate,occasionally,orbicular,outgrowth,ovary,ovate,pair,pale,peduncle,per,perennial,petiolule,plant,population,present,primary,procumbent,pronounced,proximal,pubescence,rachi,reflexed,rick,robust,ruit,scen,secondary,see,sessile,several,shaggy,shaped,short,silky,smaller,sparser,specimen,spreadin,staminal,sterile,stigma,straight,style,tangled,tem,terminal,tertiary,testa,thick,tightly,transparent,tub,tube,uni-,unicellular,upto,usually,variously,velvety,villous,viny,wall,wide,winged,without,ympodial,‘,’	branching,breeding,broad-based,colour,connective,form,growth,hair,heteromorphism,inflated,inflorescence,insertion,interpetalar,length,marking,mature,na,needle-like,odour,orientation,paired,pattern,placement,pore,position,prickle,rhizome,scale,scent,shape,spot,staman,stone,structure,symmetry,sympodial,system,texture,tissue,tuber,xylopodia,zygomorphy	-14,-2.5,0.3-0.5,0.5-30-35,1-2,1-2-cellular,1-3-celled,1/3,2-3-branched,2-locular,3-foliate,4-8,absent,accrescent,asymmetric,citrus-like,cm,cordate,distal,glabrescent,glandular,globose,herb,imparipinnate,interrupted,leaf,long,lower,mm,orange,patent,pentagonal,pubescent,rounded,shorter,simple,slender,sometimes,sparsely,stem,strong,surface,trichome,uniseriate,yellow	broad-based,na,needle-like,prickle,scent,zygomorphy
100	wfo-0001026992	success	243	110	55	68	175	42	54	1	/7,0.5-1.2,1.4-1.6,1.7-4.3,2.8-4.7,abruptly,accrescent,anther,apex,appressed,articulated,attenuate,base,berry,blade,blunt-tipped,branched,calyx,chartaceous,cm,completely,corolla,covering,echinoid,entire,enveloping,filament,fleshy,fruit,fruiting,geminate,globose,hair,homostylous,lanceolate,leaf,length,many,margin,mature,mm,multangulate,pedicel,petiole,plurifoliate,pore,poricidal,rather,ripe,scabridulous-,short,shrub,simple,small,sometimes,stellate,terminal,thin-textured,time,tip,tomentose,tree,unit,velutinous,violet,white,x,yellow	-2.5,0.2-0.5,0.25-0.45,0.6-1.5,0.8-3.4,00-170,1-4,1.2-1.4,1.2-1.7,1.3-2.6,1.3-4.3,1.4-1.9,1.5-3.4,1.7-1.9,1.7-2.4,1/2,10-12,12-33,2-10,2-5.6,2.3-3.3,2.6-4.6,2.8-4.6,3-4,3.3-5.5,3.3-5.6,4-8,5-15,5-merou,5.3-12.1,6-10,8,8-11,8-14,abaxial,abaxially,acuminate,acute,adaxiall,adaxially,ag,along,alyx,angled,anthesi,apart,apparently,approximately,around,axe,axillary,ba,bark,branch,broadly,brown,capitat,coriaceous,crown,cylindrical,dark,deltoid,densely,diameter,directed,distally,drying,eaf,echinoi,edge,eed,elliptic,equal,evident,exserted,farinose,flat-topped,flower,forming,free,glabrescen,glabrous,granular-tomentose,greenish,grooved,high,immature,inserted,lacking,lance-ovate,lateral,lengthening,less,line,lobe,lobed,long,long-stalked,longitudinal,longitudinally,lower,m.,main,maturity,midrib,minute,moderately,mostly,nearly,nflorescence,oblong,obtuse,occasional,occasionally,often,older,orange-tan,orolla,ovate,ovate-lanceolate,overlapping,peduncle,perfect,plant,porrect-stellate,pubescence,pubescent,rachi,rare,reniform,reticulate-punctate,ruit,runk,semi-ovate,sessile,short-,short-stalked,shorter,side,size,slit,somewhat,spaced,sparingly,split,spreading,stalked,stamen,stem,stigma,stout-stalked,style,subcampanulate,subglobose,surface,suture,tamen,tan,terete,tube,ud,unarme,unarmed,unequal,usually,vary,vein,way,weakly,whitish,wide,yellowish,ympodial,young,½	articulation,bract,branching,breeding,cell,colour,connective,form,growth,heteromorphism,inflated,inflorescence,insertion,interjected,interpetalar,leaflet,marking,modification,na,odour,orientation,paired,pattern,placement,position,prickle,pseudostipule,rhizome,scale,shape,spot,staman,stone,structure,symmetry,sympodial,system,texture,tissue,tuber,type,xylopodia	/7,0.5-1.2,1.4-1.6,1.7-4.3,2.8-4.7,abruptly,accrescent,appressed,articulated,attenuate,base,berry,blade,blunt-tipped,branched,chartaceous,cm,completely,covering,echinoid,entire,enveloping,fleshy,fruit,geminate,globose,homostylous,lanceolate,length,many,mm,multangulate,plurifoliate,poricidal,rather,ripe,scabridulous-,short,shrub,simple,small,sometimes,stellate,terminal,thin-textured,time,tip,tomentose,tree,velutinous,violet,white,x,yellow	na
101	wfo-0001026994	success	260	116	76	91	169	25	73	3	0.2-0.5,0.4-1.2,0.5,0.5-0.7,0.5-0.8,0.5-0.9,0.5-1.2,0.5-2,1.2-1.6,2.2-3.2,4,anther,articulation,base,bent,berry,bifurcate,bract,branched,bright,brown,calyx,cell,cm,corolla,crenate,dark,darker,deeply,densely,distal,eglandular,elliptic,filament,fruit,fruiting,globose,greenish,hair-like,half,herb,imparipinnate,inflorescence,interrupted,investing,irregularly,lanceolate,lateral,leaf,less,lobe,lobed,locule,long,loosely,lower,margin,medial,midvein,mm,narrowly,oblique,obovate,outgrowth,pedicel,perennial,petiole,pseudostipule,pubescent,purple,rachi,regularly,ripe,rotate-stellate,simple,size,spreading,stem,stripe,surface,testa,thick,tip,trichome,uniseriate,usually,velvety,wall,white,wide,yellow	-foliate,.2,.5,0.05-0.1,0.05-0.2,0.1,0.1-0.2,0.1-0.3,0.15-0.2,0.2-0.4,0.25,0.3-0.4,0.4-0.5-0.7,0.5-0.6,0.5-0.6-0.7,0.5-1.3,0.7-2.5,0.9-1.2,0.9-1.3,1,1-1.2,1-1.4,1-1.5,1-1.6,1-2,1.2-3.5,1.4-2.1,10-20,12-20-50,2,2-2.5-6.5-10,2-2.6,2-4,2-5-locular,3,3-branched,4-15,4-celled,5,5-7,5-7-13-20,6-20-30,8,8-12,abaxially,absent,abundant,acroscopically,acuminate,acute,additional,adpressed,along,also,amongst,andscattered,anthesi,apex,apical,apically,appearance,appendage,articulate,basal,basally,basiscopically,becoming,beneath,bifurcation,bracteate,broader,broadly,capitate,celled,column,conical,crenat,crowded,decreasing,decumbent,decurrent,developed,diameter,eaf,ebracteate,edicel,eed,erect,especially,essentially,exserted,fewer,flower,giving,glabrous,glandular,grayish,gree,green,habitat,hal,halfway,head,interjected,internode,lamina,large,larger,largest,leaflet,leave,like,lon,markedly,minutely,moderately,much,narrower,narrowing,nearly,nflorescence,node,occasionally,often,ovary,pair,paler,papillate,peduncle,petiolule,present,primary,puberulent,rarely,reflexed,robust,rocky,secondary,sessile,set,shaggy,short,silky,sinus,slightly,sometimes,sparsely,specimen,spreadin,staminal,sterile,stigma,straight,style,tall,tem,terminal,tertiary,toward,tube,ud,unicellular,unit,weak-walled,well,winged,woody,ympodial,young	abaxial,arrangement,branching,colour,decurred,form,growth,hair,history,insertion,length,life,marking,orientation,placement,position,prickle,scattered,seed,shape,specified,spot,symmetry,texture,type	0.2-0.5,0.4-1.2,0.5,0.5-0.7,0.5-0.8,0.5-0.9,0.5-1.2,0.5-2,1.2-1.6,2.2-3.2,4,bent,berry,bifurcate,branched,bright,brown,cell,cm,crenate,dark,darker,deeply,densely,distal,eglandular,elliptic,globose,greenish,hair-like,half,herb,imparipinnate,interrupted,investing,irregularly,lanceolate,lateral,less,lobe,lobed,locule,long,loosely,margin,medial,midvein,mm,narrowly,oblique,obovate,outgrowth,perennial,pubescent,purple,rachi,regularly,ripe,rotate-stellate,simple,spreading,stripe,testa,thick,tip,trichome,uniseriate,usually,velvety,wall,white,wide,yellow	decurred,scattered,specified
102	wfo-0001026996	success	188	156	82	105	83	51	78	4	0-6,0.6-1,1-2,1-3,1-4,1.8-4.4,15-28,3-10,3-7,3.3-6,3.8-14.1,4-4.4,4-8,4.5-10.5,5-8,6-8,6.9-10.9,8.7-18.6,abaxially,acumen,adaxially,anther,apex,asymmetric,attenuate,base,berry,blade,blue,brownish,cell,clavate,cm,condition,coriaceous,corolla,covering,dark,deep,diameter,drying,filament,flower,forked,fresh,fruit,glabrous,globose,green,greenish,hair-like,herb,homostylous,interjected,lanceolate,lateral,leaf,leaflet,lilac,lobe,long,medium,mm,moniliform,mottled,odd-pinnate,ovate,ovoid,pair,pedicel,peduncle,pentagonal,petiole,petiolulate,plant,plurifoliate,pore,poricidal,purple,ripe,rotate,rounded,seed,size,slightly,sometimes,stigma,straight,stripe,style,symmetric,terminal,testal,thick,tip,tissue,tri-,tube,tuber,unit,unwinged,wall,white,whitish,x	0.9-2.7,1-5,1.2-1.8,1.3-7.7,14-33,2-3,3-5,5-merou,abaxiall,acuminate,acute,ag,along,alyx,apart,apparently,arranged,articulated,axe,axillary,basiscopic,bead,bud,capitat,connivent,considerably,decreasing,digestion,distal,dorsally,eaf,edge,eed,elliptic,enzyme,erec,exceeding,flat,folded,geminat,generally,glabrou,green-white,half,honeycomb-shaped,larger,lengthening,like,linear,living,lower,make,middl,mucilaginous,multiple,necklace,nflorescence,orbicular,orolla,perfect,removed,ruit,sessile,seudostipule,side,slit,spaced,specimen,stamen,stolon,subglabrou,subtending,tall,tamen,tem,throughout,toward,typically,usually,vary,wet,yellow,ympodial	appressed,arrangement,articulation,bract,branching,breeding,calyx,capitate,colour,connective,form,fruiting,growth,hair,height,heteromorphism,inflated,inflorescence,insertion,interpetalar,length,margin,marking,mature,middle,modification,na,odour,orientation,ovary,paired,pattern,placement,position,prickle,pseudostipule,rhizome,scale,shape,spot,staman,stem,stone,structure,subglabrous,symmetry,sympodial,system,texture,type,xylopodia	0-6,0.6-1,1-2,1-3,1-4,1.8-4.4,15-28,3-10,3-7,3.3-6,3.8-14.1,4-4.4,4-8,4.5-10.5,5-8,6-8,6.9-10.9,8.7-18.6,abaxially,acumen,adaxially,asymmetric,attenuate,berry,blue,brownish,cell,clavate,cm,condition,coriaceous,covering,dark,deep,drying,forked,fresh,glabrous,globose,green,greenish,hair-like,herb,homostylous,lanceolate,lateral,lilac,long,medium,mm,moniliform,mottled,odd-pinnate,ovate,ovoid,pentagonal,petiolulate,plurifoliate,poricidal,purple,ripe,rotate,rounded,slightly,sometimes,straight,stripe,symmetric,terminal,testal,thick,tip,tri-,unwinged,wall,white,whitish,x	capitate,middle,na,subglabrous
103	wfo-0001027010	success	198	175	90	117	81	58	86	4	0-2,0-2.5,0.4-5.1,0.5-1.5,1-10,1-2,1-4,1.2-1.7,1.2-1.9,10-60,14-46,2-9.4,2.1-15.3,2.1-4.3,2.2-12.9,3-10,3-5,3-6,3-8,4-12,4-8,4.4-29,4.9-31,5-13,5-14,abaxially,adaxially,anther,apex,articulated,asymmetric,attenuate,base,basiscopic,blade,brownish,cell,clavate,cm,condition,coriaceous,corolla,deep,diameter,distal,drying,elliptic,filament,flower,forked,fresh,fruit,glabrescent,glabrous,green,green-white,greenish,hair,half,herb,high,homostylous,interjected,lanceolate,lateral,leaf,leaflet,light,lobe,long,lower,mm,moniliform,mucilaginous,occasionally,odd-pinnate,ovate,ovoid,pair,pedicel,peduncle,pentagonal,petiole,petiolulate,plant,plurifoliate,pore,poricidal,purple,ripe,rotate,rounded,scabrous,seed,sessile,short,side,size,spot,stigma,straight,stripe,style,terminal,throughout,tip,tissue,tri-,tube,tuber,unit,wet,white,whitish,wide,wing,x	0-3,1-7,1.4-6.9,2-6,3.5-13.6,5-merou,acumen,acuminate,acute,adaxiall,ag,along,alyx,apart,apparently,arranged,axe,axillary,bead,bud,capitat,coloration,connivent,covering,decreasing,digestion,dorsally,eaf,edge,eed,enzyme,erec,exceeding,flat,folded,geminat,generally,glabrescen,glabrou,hair-like,hal,honeycomb-shaped,larger,lengthening,like,living,make,multiple,narrow,necklace,nflorescence,orbicular,orolla,perfect,present,removed,ruit,scabrou,seudostipule,slightly,slit,sometimes,spaced,specimen,stamen,stolon,subequal,subtending,tall,tamen,tem,testal,thick,toward,typically,usually,vary,wall,winged,yellow,ympodial	abaxial,adaxial,appressed,arrangement,articulation,bract,branching,breeding,broad-based,calyx,capitate,colour,connective,form,fruiting,growth,height,heteromorphism,inflated,inflorescence,insertion,interpetalar,length,margin,marking,mature,modification,na,needle-like,odour,orientation,ovary,paired,pattern,placement,position,prickle,pseudostipule,rhizome,scale,shape,smell,spacing,staman,stellate,stem,stone,structure,surface,symmetry,sympodial,system,texture,trichome,type,vegetative,xylopodia,zygomorphy	0-2,0-2.5,0.4-5.1,0.5-1.5,1-10,1-2,1-4,1.2-1.7,1.2-1.9,10-60,14-46,2-9.4,2.1-15.3,2.1-4.3,2.2-12.9,3-10,3-5,3-6,3-8,4-12,4-8,4.4-29,4.9-31,5-13,5-14,abaxially,adaxially,articulated,asymmetric,attenuate,basiscopic,brownish,clavate,cm,condition,coriaceous,deep,distal,drying,elliptic,forked,fresh,glabrescent,glabrous,green,green-white,greenish,hair,half,herb,high,homostylous,lanceolate,light,long,mm,moniliform,mucilaginous,occasionally,odd-pinnate,ovate,ovoid,pentagonal,petiolulate,plurifoliate,poricidal,purple,ripe,rotate,rounded,scabrous,sessile,short,side,straight,stripe,terminal,throughout,tip,tissue,tri-,wet,white,whitish,wide,x	capitate,na,stellate,zygomorphy
104	wfo-0001027019	success	142	163	93	108	34	55	90	3	.5,/4,0-0.5,0.5-1,1-1.5,1.5-2,1.5-3,1/2,10,10-40-flowered,12-30,2-5,2-8,4-5,4-8.5,7-14,abaxially,acute,adaxially,along,anther,anthesi,apex,apparent,attenuate,bark,base,berry,branched,bright,calyx,capitate,cm,constriction,corolla,cyathiform,deflexed,densely,dia,difoliate,distal,ellipsoid,elliptic,erect,even,exserted,filament,fleshy,fruiting,glabrous,globose,golden,green,inflorescence,largely,later,leaf,like,live,lobed,long,lower,major,midrib,minor,minutely,mm,obovate,older,onto,opposite,ovary,overlapping,papillose,pedicel,petiole,plant,pore,poricidal,pubescent,scar,shaped,shrub,small,somewhat,spaced,sparsely,stem,stigma,straight,strongly,style,surface,tapering,tear-drop,tip,tree,trichome,tube,unit,waxy,way,white,wing,winged,woody,x,young	1-2,2-3,abaxial,abruptly,ba,deltoid,eaf,edicel,eed,flattened,free,geminat,glabrate,inflorescenc,lobe,lon,narrowed,nflorescence,ovoid-reniform,pale,papillo,pitted,planar,portion,reddish-brow,rest,ruit,tall,tan,third,tub,ud,widest,ympodial	appressed,articulation,bract,branching,broad-based,bud,cell,colour,exsertion,flower,form,fruit,geminate,growth,hair,height,heteromorphism,inflated,insertion,interjected,interpetalar,leaflet,length,margin,mature,na,needle-like,number,odour,orientation,paired,pattern,placement,position,prickle,pseudostipule,reddish-brown,rhizome,scale,shape,size,smell,spacing,staman,stone,structure,symmetry,sympodial,texture,tissue,tuber,type,vegetative,winging,xylopodia	.5,/4,0-0.5,0.5-1,1-1.5,1.5-2,1.5-3,1/2,10,10-40-flowered,12-30,2-5,2-8,4-5,4-8.5,7-14,acute,along,apparent,attenuate,base,berry,branched,bright,calyx,capitate,cm,constriction,cyathiform,deflexed,densely,dia,difoliate,distal,ellipsoid,elliptic,erect,even,exserted,filament,fleshy,glabrous,globose,golden,green,inflorescence,largely,later,leaf,like,live,lobed,long,midrib,minutely,mm,obovate,onto,opposite,ovary,overlapping,papillose,petiole,plant,pore,poricidal,pubescent,shaped,shrub,small,somewhat,spaced,sparsely,stem,straight,strongly,tapering,tear-drop,tip,tree,trichome,tube,waxy,way,white,wing,winged,woody,x,young	geminate,na,reddish-brown
105	wfo-0001027030	success	228	114	52	71	157	43	50	2	.5,0-4,0.15-0.2,0.5-0.7,0.6-0.7,1-3,2-foliate,anther,apex,articulation,base,basiscopically,berry,bract,branched,bright,calyx,cell,cm,corolla,crenate,decurrent,deeply,densely,distal,entire,extremely,filament,fruit,fruiting,globose,green,half,herb,imparipinnate,inflorescence,interjected,interrupted,investing,lanceolate,leaflet,long,loosely,lower,margin,mm,oblique,papillate,pedicel,petiole,present,pseudostipule,pubescent,rotate-stellate,simple,slender,soft,sometimes,somewhat,sparsely,spreading,stem,surface,trichome,truncate,uniseriate,unit,velvety,weak,wide,yellow	-15,.2,0.05-0.1,0.1-0.7,0.1-0.9,0.2,0.2-0.3,0.2-1,0.3-0.4-1.5,0.3-0.5,0.3-0.7,0.4-0.5,0.4-0.8,0.5,0.5-0.6-1.8,0.5-0.8,0.5-1,0.5-1-3.4,0.6-0.8,0.7-1,0.8-0.9,0.8-1,0.9-1.1,1,1-1.2,1-1.3,1-2-4-11,1.2-1.6,1.5-2-4.8,1.6-2,2-3,2-3-9,2-6,2-7,2-locular,2.2-3.2,3-4-celled,3-8,4-celled,5-12,8-celled,abaxial,abaxially,absent,abundant,acuminate,acute,adaxially,adpressed,angled,anthesi,apical,appearance,appendage,articulated,axi,basal,beneath,beyond,brown,capitate,column,conical,crenat,crenation,dark,darker,deeper,denser,diamete,diameter,due,eaf,edicel,eed,eglandular,elliptic,evenly,exserted,flower,giving,gland,glandular,grayish,gree,growt,hair-like,hal,halfway,internode,interspersed,irregularly,lamina,larger,lateral,less,like,lobe,lon,longer,minutely,multicellular,narrowly,near,nflorescence,node,obovate,occasionally,often,outgrowth,ovary,pair,pale,paler,peduncle,perennial,petiolule,primary,pubescence,reflexed,robust,ruit,secondary,sessile,silky,similar,size,slightly,small,smaller,spread,spreadin,staminal,sterile,stigma,straight,stripe,style,tall,tem,terminal,tertiary,testa,thick,tiny,trailing,tube,ud,unicellular,usually,vein,wall,white,winged,woody,ympodial,young	appressed,branching,breeding,broad-based,colour,form,growth,hair,heteromorphism,inflated,insertion,interpetalar,leaf,length,marking,mature,na,needle-like,odour,orientation,paired,pattern,placement,position,prickle,rhizome,scale,shape,smell,spot,staman,stone,structure,symmetry,sympodial,system,texture,tissue,tuber,type,vegetative,xylopodia,zygomorphy	.5,0-4,0.15-0.2,0.5-0.7,0.6-0.7,1-3,2-foliate,base,basiscopically,berry,branched,bright,cm,crenate,decurrent,deeply,densely,distal,entire,extremely,globose,green,half,herb,imparipinnate,interrupted,investing,lanceolate,long,loosely,mm,oblique,papillate,present,pubescent,rotate-stellate,simple,slender,soft,sometimes,somewhat,sparsely,spreading,trichome,truncate,uniseriate,velvety,weak,wide,yellow	appressed,na
106	wfo-0001027035	success	199	160	86	111	88	49	83	3	0-36,0.1-0.9,0.3-2.3,0.4-12.8,0.5-7,0.8-4.2,0.9-3.1,1-2,1-3,1-3.4,1-8,1.7-8,1.8-5.2,10-80,2-38,2-7,2.8-10.3,3-10,4-18,4-18.5,4.9-23.5,anther,apex,attenuate,axillary,base,blade,blue,brownish,bud,cell,clavate,cm,completely,condition,corolla,covering,deep,diameter,distal,drying,elliptic,filament,flower,forked,fresh,fruit,glabrescent,glabrous,globose,green,greenish,hair,hair-like,half,herb,high,homostylous,interjected,lanceolate,lateral,leaf,leaflet,light,lilac,lobe,long,medium,mm,moniliform,odd-pinnate,ovate,ovoid,pair,pedicel,peduncle,pentagonal,petiole,petiolulate,plant,plurifoliate,pore,poricidal,purple,rotate,rounded,seed,sessile,shape,short,size,stigma,straight,style,subtending,terminal,testal,thick,throughout,tip,tissue,tri-,tube,tuber,unit,usually,wall,white,whitish,wide,x	0-7,0.5-3.4,0.5-5,0.8-3,1.5-5.9,3-5,5-merou,abaxially,acumen,acuminate,acute,adaxiall,adaxially,ag,along,alyx,apart,apparently,arranged,articulated,asymmetric,axe,basiscopic,bead,capitat,coloration,connivent,decreasing,digestion,dorsally,eaf,edge,eed,enzyme,erec,exceeding,flat,folded,geminat,generally,glabrescen,glabrou,green-white,hal,honeycomb,larger,lengthening,like,living,lower,make,mucilaginous,multiple,necklace,nflorescence,orbicular,orolla,perfect,present,removed,ripe,ruit,second,seudostipule,shaped,side,slightly,slit,smaller,sometimes,spaced,specimen,stamen,stolon,stripe,subequal,subglabrous,tall,tamen,tem,toward,typically,unwinged,variable,vary,wet,yellow,ympodial	abaxial,arrangement,articulation,bract,branching,breeding,calyx,capitate,colour,connective,form,fruiting,glabrescence,growth,height,heteromorphism,inflorescence,insertion,interpetalar,length,margin,marking,mature,modification,na,number,odour,orientation,ovary,paired,pattern,placement,position,prickle,pseudostipule,rhizome,scale,spot,staman,stem,stone,structure,symmetry,sympodial,system,texture,type,xylopodia,zygomorphy	0-36,0.1-0.9,0.3-2.3,0.4-12.8,0.5-7,0.8-4.2,0.9-3.1,1-2,1-3,1-3.4,1-8,1.7-8,1.8-5.2,10-80,2-38,2-7,2.8-10.3,3-10,4-18,4-18.5,4.9-23.5,attenuate,axillary,blue,brownish,bud,cell,clavate,cm,completely,condition,covering,deep,distal,drying,elliptic,forked,fresh,glabrescent,glabrous,globose,green,greenish,hair,hair-like,half,herb,high,homostylous,lanceolate,lateral,light,lilac,long,medium,mm,moniliform,odd-pinnate,ovate,ovoid,pentagonal,petiolulate,plurifoliate,poricidal,purple,rotate,rounded,sessile,short,straight,subtending,terminal,testal,thick,throughout,tip,tri-,usually,wall,white,whitish,wide,x	capitate,na,zygomorphy
107	wfo-0001027050	success	244	130	73	89	155	41	70	3	-12,/3,1-2,2-5,2.5-3,5-7,5-9,absent,abundant,adult,anther,apex,articulated,base,berry,branch,branched,broad-based,brown,calyx,chartaceous,cm,cordate,cuneate,curved,deeply,densely,difoliate,directed,distally,drying,entire,ferruginous,filament,fruit,fruiting,glabrous,green,growth,hair,heterostylous,inflorescence,interpetalar,lanceolate,lateral,leaf,leaf-opposed,length,lobed,long,margin,mature,minute,mm,moderately,obtuse,often,pedicel,petiole,pore,poricidal,present,prickle,pubescent,ripe,rounded,scattered,several,short-stalked,shrub,small,spherical,stellate,straight,time,tip,tissue,tree,trichome,truncate,unbranched,unit,usually,way,weakly,white,wide,yellowish-green,younger	-9,.2,.5,0-0.2,0-3,0.1-0.3,0.1-3,0.2-0.5,0.2-1,0.3-1.5,0.5-3,0.8,0.9-2.1,1,1-1.5,1.5-2,1.5-6,10-13.5,12-15,15-50+,2-2.5,2-3,2-4,2-8,3-5,4-20,4-8,5,5-10,5-6,5-merous,50,6-8,7-30+,8-26,abaxial,abaxially,absen,acuminate,acute,adaxial,adaxiall,alyx,andromonoeciou,apar,arme,axe,bark,basal,blade,broad,broadly,brow,capitate,closely,coarsely,conical,connivent,diameter,distal,distall,eaf,eed,eglandular,elliptic,equal,erec,erect,except,flattened,flattened-reniform,flower,free,geminat,glandular-puberulent,half,infructescence,inside,juicy,juvenile,larger,least,less,like,lobe,long-styled,longer,lower,markedly,mid-way,midpoint,midrib,midvein,minutely,moist,mucilaginous,multiseriate,narrowly,near,nflorescence,numerous,oblique,occasionally,older,orolla,oung,ovate,ovate-lanceolate,pale,papillat,peduncle,per,pericarp,plant,porrect,portion,pricklier,prickly,ray,rest,ruit,scar,secondary,sessile,shallowly,shiny,short-styled,shorter,side,slightly,somewhat,spaced,sparsely,stalk,stalked,stellate-pubescent,stem,stigma,style,surface,tall,tamen,terete,thicker,toothed,touching,triangular,tube,unarmed,vary,whitish,woody,yellow,ympodial,young	andromonoecious,appressed,articulation,bract,branching,breeding,cell,colour,connective,corolla,form,geminate,heteromorphism,inflated,insertion,interjected,leaflet,marking,modification,na,odour,orientation,paired,pattern,placement,position,pseudostipule,rhizome,scale,shape,spot,staman,stone,structure,symmetry,sympodial,system,texture,tuber,type,xylopodia	-12,/3,1-2,2-5,2.5-3,5-7,5-9,absent,abundant,adult,articulated,base,berry,branch,branched,broad-based,brown,chartaceous,cm,cordate,cuneate,curved,deeply,densely,difoliate,directed,distally,drying,entire,ferruginous,glabrous,green,growth,heterostylous,lanceolate,lateral,leaf-opposed,lobed,long,minute,mm,moderately,obtuse,often,poricidal,present,pubescent,ripe,rounded,scattered,several,short-stalked,shrub,small,spherical,stellate,straight,time,tip,tree,trichome,truncate,unbranched,usually,way,weakly,white,wide,yellowish-green,younger	andromonoecious,geminate,na
108	wfo-0001027050	success	234	97	57	72	162	25	55	2	1-2,2-10,2-3-locular,2-foliate,5-9,absent,accrescent,anther,apex,articulated,base,branched,broad-based,calyx,chartaceous,cm,coarsely,cordate,cuneate,curved,densely,directed,distally,entire,extra-axillary,filament,forked,fruit,fruiting,glabrous,globose,green,growth,hair,inflorescence,lanceolate,leaf,leaf-opposed,length,lobed,long,margin,minute,mm,moderately,oblique,obtuse,pedicel,petiole,pore,present,prickle,rounded,shallowly,shrub,simple,slightly,small,sparsely,stellate,stellate-pubescent,straight,surface,toothed,tree,truncate,unbranched,unit,upper,usually,white,yellowish-green	.2,0-0.2,0-0.5,0-1,0-3,0.1-3,0.2-0.6,0.2-1,0.3-0.6,0.4-1,0.5-0.8,0.5-1,0.5-3,0.8,1-1.5,1-5,1.5-2,1.5-6,10-13.5,10-30,11-21,12-15,14-20,15-50+,16-40,2-2.5,2-3,2-4,2-5,2-6,2-8,2.5-3,23-40+,3-15,3-5,4-19,4-40,4-8,5,5-10,5-6,5-7,5-merous,6-8,7-30+,8-26,8-40+,abaxially,absen,abundant,across,acuminate,acute,adaxiall,adaxially,adult,andromonoecious,anvil-shape,apart,armed,axe,ba,blade,branche,broadly,brown,capitat,connivent,contiguous,cross-section,cylindrical,deeply,diameter,distall,distributed,drying,eaf,eed,eglandular,elliptic,erect,except,exocarp,ferruginous,flattened,flower,functional,geminat,glandular-puberulent,half,held,interpetalar,juicy,juvenile,lateral,less,like,lobe,longer,lower,markedly,mature,mesocarp,midpoint,midvein,minutely,moist,mucilaginous,multiseriate,narrowly,nearly,nflorescence,often,orolla,ovate,ovate-lanceolate,pair,pale,peduncle,per,pinnatifid,pitted,placenta,plant,porrect,rachi,ray,ruit,scattered,sessile,shorter,side,somewhat,spaced,stalk,stalked,stellae,stem,stigma,style,tal,tamen,tem,thick,thicker,throughout,time,tip,tissue,triangular,tube,unarme,unarmed,upright,vary,weakly,whitish,wide,x,yellow,ympodial,younger	abaxial,adaxial,articulation,branching,cell,colour,connective,corolla,form,geminate,heteromorphism,insertion,na,odour,orientation,placement,position,shape,staman,stone,structure,symmetry,sympodial,texture,type	1-2,2-10,2-3-locular,2-foliate,5-9,absent,accrescent,articulated,base,branched,broad-based,chartaceous,cm,coarsely,cordate,cuneate,curved,densely,directed,distally,entire,extra-axillary,forked,glabrous,globose,green,lanceolate,leaf-opposed,lobed,long,minute,mm,moderately,oblique,obtuse,present,rounded,shallowly,shrub,simple,slightly,small,sparsely,stellate,stellate-pubescent,straight,surface,toothed,tree,truncate,unbranched,upper,usually,white,yellowish-green	geminate,na
109	wfo-0001027091	success	142	92	45	49	93	43	41	4	1-1.6,1.1-1.6,2.3-2.9,5-11,8.5-11.5,9-13,annual,anther,arcuate,armed,berry,blue,branched,bristly,broadly,calyx,campanulate,capitate-glandular,cm,difoliate,glabrous,hair,herb,internodal,lenticular,linear-lanceolate,low,mm,oriented,ovate,pedicel,petiole,pinnatisect,prickly,radially,reticulately,ridge,somewhat,spherical,spreadingly,stellate-pentagonal,stem,surface,tapering,tube,undulate,unit,violet,wrinkled	.3,0.7,0.8,1.8-2.6,1/2-2/3,2.5-3.5,3-8,3-9,30-60,4-10,6-10,6-10-flowere,accrescent,across,acute-tipped,along,alyx,anthesi,base,beneath,blade,brown,cauline,dark,deltoid,densely,developing,dia,divided,dm,dry,eaf,eed,enveloped,extended,few-rayed,fully,geminat,gland,glandular,green,high,invested,lobe,lon,long,longer,main,maturity,mostly,narrowly,near,nflorescence,obtuse,occasionally,orolla,per,pinnatifid,rounded,ruit,scattered,sessile,short,short-stipitate,simple,slende,sometimes,sparsely,splitting,ste,stellae,strait,suffused,tamen,taprooted,terete,terminally,tightly,tigma,tub,twice,tyle,unexpande,uniseriate,usually,variously,vary,vein,vestiture,wholly,yello,ympodial,younger	apex,branching,breeding,broad-based,cell,colour,corolla,diameter,form,fruit,geminate,growth,heteromorphism,inflorescence,leaf,length,lower,margin,na,needle-like,orientation,ovary,pattern,placement,position,present,prickle,pseudostipule,rhizome,seed,shape,staman,stigma,stone,structure,style,sympodial,system,texture,tuber,type,unexpanded,xylopodia	1-1.6,1.1-1.6,2.3-2.9,5-11,8.5-11.5,9-13,annual,arcuate,armed,berry,blue,branched,bristly,broadly,campanulate,capitate-glandular,cm,difoliate,glabrous,herb,internodal,lenticular,linear-lanceolate,low,mm,oriented,ovate,pinnatisect,prickly,radially,reticulately,ridge,somewhat,spherical,spreadingly,stellate-pentagonal,stem,tapering,undulate,violet,wrinkled	geminate,na,present,unexpanded
110	wfo-0001027102	success	167	100	45	52	115	48	39	6	0.5-1,0.5-2,1.5-2,3-4,absent,accrescent,adaxially,anther,apex,articulated,base,broad,calyx,cell,chartaceous,cm,connivent,cuneate,difoliate,directed,distally,entire,filament,forked,fruit,fruiting,glabrous,globose,hair,leaf,leaf-opposed,long-tapered,margin,mm,oblong,obtuse,orange,pedicel,petiole,pore,rarely,ripe,shrub,simple,stellate,stem,stone,subcoriaceous,unbranched,unit,white,x	.5,.5-6,0.2-2,0.5,0.5-3,1-1.5,1-2,1-2.5,1-3,1-4,1-6,10-20,15,15-35,2-2.5,2-3,3,3-12,3-5,4-5,4-7,5-12,<,abaxially,absen,acuman,acuminate,acute,adaxial,adaxiall,ag,aggregate,almost,alyx,apart,appearance,axe,ba,blade,broadly,channe,ciliate,congested,corky,curved,cylindrical,deltate,densely,diameter,differing,dimorphic,eaf,eed,elliptic,few-,flattened,flower,free,geminat,giving,ilament,lanceolate,lobe,long,longitudinal,m.,major,minor,moderately,multiseriate,narrowly,nflorescence,often,one,opening,orolla,ovate,peduncle,per,perfect,portion,pubescent,rachi,roughened,rugulose,ruit,short,size,slender,slit,small,somewhat,spaced,sparsely,stigma,straight,style,surface,tal,tem,time,tip,tomentose,triangular,truncat,truncate,tube,unarme,usually,vary,wide,yellow,yellow-brown,ympodial,young	appressed,articulation,berry,bract,branching,breeding,broad-based,colour,connective,corolla,form,geminate,growth,heteromorphism,inflated,inflorescence,insertion,interjected,interpetalar,leaflet,length,marking,mature,modification,na,odour,orientation,paired,pattern,placement,position,prickle,pseudostipule,rhizome,scale,shape,spot,staman,structure,symmetry,sympodial,system,texture,tissue,tuber,type,unarmed,xylopodia	0.5-1,0.5-2,1.5-2,3-4,absent,accrescent,adaxially,apex,articulated,base,broad,chartaceous,cm,connivent,cuneate,difoliate,directed,distally,entire,forked,glabrous,globose,hair,leaf-opposed,long-tapered,mm,oblong,obtuse,orange,rarely,ripe,shrub,simple,stellate,stem,subcoriaceous,unbranched,white,x	berry,broad-based,geminate,na,prickle,unarmed
111	wfo-0001027104	success	141	136	69	77	64	59	65	4	0.15-0.35,0.5-0.8,1-3,1-4,1.2-6,1.5-2.3,1.5-4.2,10-15,2-3,2-6,3-5.5,4-15,5-15,6-7.5,acuminate,acute,apex,apically,attenuate,base,branched,calyx,cell,cm,connate,cordate,corolla,covering,cyme,dehiscent,diameter,dichasial,dichasially,distal,filament,finely,flower,globose,green,hair-like,half,herbaceous,honeycomb,lateral,linear,long,mm,monochasial,mucilaginous,narrowly,odd-pinnate,ovate,ovoid,pattern,pedicel,peduncle,perennial,perfect,petiole,plant,poricidally,proximal,pubescent,seed,stellate,style,testal,thick,throughout,tone,truncate,tuber-bearing,unit,wall,white,yellow-green,¼	1-1.5,2.2-5,3-6-foliat,abaxially,acumen,adaxially,apical,articulate,condition,digestion,dorsally,eaf,ebracteate,edge,eed,emoval,enzyme,epiphyti,epiphytic-like,exceeding,flat,folded,forked,generally,globo,green-white,growing,introrse,living,lobe,lon,lower,make,maturing,mos,mucronate,nflorescence,nther,often,orolla,ovat,plan,rarely,reveal,ruit,seudostipule,short,simple,slit,specimen,stamen,stigma,straight,tall,tem,terrestrial,throughou,typically,vary,viole,wide,without,yellow,ympodial	3-6-foliate,anther,appressed,arrangement,articulation,bract,branching,breeding,colour,connective,form,fruit,fruiting,growth,hair,height,heteromorphism,inflated,inflorescence,insertion,interjected,interpetalar,leaf,leaflet,length,margin,marking,mature,modification,na,number,odour,orientation,ovary,paired,placement,pore,position,prickle,pseudostipule,rhizome,scale,shape,spot,staman,stem,stone,structure,symmetry,sympodial,system,texture,tissue,tuber,type,violet,wet,width,xylopodia	0.15-0.35,0.5-0.8,1-3,1-4,1.2-6,1.5-2.3,1.5-4.2,10-15,2-3,2-6,3-5.5,4-15,5-15,6-7.5,acuminate,acute,apically,attenuate,base,branched,cell,cm,connate,cordate,covering,cyme,dehiscent,dichasial,dichasially,distal,finely,globose,green,hair-like,half,herbaceous,honeycomb,lateral,linear,long,mm,monochasial,mucilaginous,narrowly,odd-pinnate,ovate,ovoid,pattern,perennial,perfect,plant,poricidally,proximal,pubescent,stellate,testal,thick,throughout,tone,truncate,tuber-bearing,wall,white,yellow-green,¼	3-6-foliate,na,violet,wet
112	wfo-0001027114	success	152	127	58	75	77	52	55	3	-17,.5,1-1.2,1-1.5,1.5-1.7,1.5-2,13-21-30,2-2.5,2-3,3-4,3-7,6-8,6-9,7-9,abaxial,acute,anther,apex,appearing,base,berry,branched,calyx,cm,conical,corolla,dark,dendritic,dia,difoliate,elliptic,filament,flattened-reniform,fruiting,geminate,glabrous,globose,green,inflorescence,lateral,leaf,lobed,long,main,many,margin,minute,minutely,mm,occasionally,opposite,ovary,pair,pedicel,petiole,pitted,plurifoliate,pore,poricidal,reddish-brown,shrub,size,soft,style,surface,thickened,time,tip,trichome,tube,unit,vein,white,wide,woody	0.5-1,1-1.1-2,1-2,1/2,20-40,5,7-10,abaxially,adaxially,along,alternating,anthesi,apar,axillary,ba,bark,bushy,capitate,closely,commonly,deltate,densely,differing,drying,due,eaf,edicel,eed,erect,exserted,flowered,free,glabrou,growt,halfway,inflorescenc,investing,lamina,like,lobe,lon,lower,major,minor,nflorescence,older,opening,papillo,planar,portion,projection,pubescent,rapid,reddish,rest,ruit,scar,scattered,several,shoot,shoot-terminal,simple,slit,spaced,stem,stigma,tall,tapering,triangular,tub,ud,unevenly,uniseriate,way,yellowish,ympodial,young	appressed,articulation,bract,branching,breeding,cell,colour,connective,diameter,form,fruit,growth,hair,height,heteromorphism,inflated,insertion,interjected,interpetalar,leaflet,length,marking,mature,modification,na,odour,orientation,pattern,placement,plant,position,prickle,pseudostipule,pubescence,rhizome,scale,seed,shape,spot,staman,stone,structure,symmetry,sympodial,system,texture,tissue,tuber,type,venation,width,xylopodia	-17,.5,1-1.2,1-1.5,1.5-2,13-21-30,2-2.5,2-3,3-4,3-7,6-8,6-9,7-9,acute,appearing,berry,branched,cm,conical,dark,dendritic,difoliate,elliptic,flattened-reniform,geminate,glabrous,globose,green,lateral,leaf,lobed,long,main,many,margin,minute,minutely,mm,occasionally,opposite,pair,pitted,plurifoliate,poricidal,reddish-brown,shrub,soft,thickened,time,tip,trichome,vein,white,wide,woody	.5-1.7,di,na
113	wfo-0001027117	success	229	110	46	61	168	49	42	4	.5,1-2,2-8,4.5-6.5,accrescent,acicular,anther,apex,apparently,articulated,attenuate,base,berry,branched,calyx,cell,chartaceous,cm,connivent,cordate,enclosing,erect,evenly,filament,fruit,fruiting,glabrous,green,herb,lateral,leaf,length,lobed,long,lower,margin,mature,maturity,mauve,mm,oblong,pedicel,perpendicular,petiole,poricidal,prickle,spherical,spreading,staman,stellate,stem,straight,surface,tapering,tip,tissue,trichome,unequal,unit,yellow,young	-11,-12,-2.8,/3,0-10,0-15,0-20,0-25,0-40,0-5,0.1,0.1-0.2-0.45,0.1-0.7,0.15-0.25,0.15-0.35,0.2,0.5,0.5-1.5,0.6-0.9,0.7-0.9-1.5,0.7-1.3,0.7-1.5,0.8-1.5-6.5,1-4,1-6,1.2,1.5-2.3,1.5-5-14,1.7-2.5,1.8-2.5,1/,1/3,1/4-3/4,1/8-1/2,10-20,2-3,2-6,2.3-2.8,25-100,3-10,3-15,3-6,4-6.5,4-7,4-8,4.5-8,5-11,5-merous,6-10,6-9,7-8,abaxially,acute,almost,alyx,ame,apar,apart,apically,bark,beyond,black,blade,brittle,brown,c.,concolorous,curved,dark,deltate,densely,diameter,discolorous,distance,drying,eaf,eed,elongating,extending,fifth,fine,flattened-reniform,flower,four,free,gently,glabrescent,gra,herbarium,infructescence,irregularly,less,lobe,lon,long-acuminat,longer,membranous,midpoint,midvein,moderately,narrow-deltate,narrow-elliptic,narrow-lanceolate,nflorescence,obovate,older,one,open,orolla,oung,outline,ovate,pair,pale,peduncle,pendulous,per,perfec,pericarp,pit,plurifoliat,porrect,portion,prickl,prickly,primary,raised,ray,red-brown,reduced,reflexed,rounded,ruit,scar,sessile,shallowly,shiny,shorter,side,small,smooth,sometimes,spaced,sparsely,specimen,stalk,stalked,stellate-pubescent,style,tamen,tearing,terete,tertiary,time,translucent,tube,upper,variously,vary,vein,venation,visible,way,weakly,wide,woody,yellow-green,ympodial	appressed,articulation,bract,branching,breeding,broad-based,colour,connective,corolla,form,growth,hair,heteromorphism,inflated,inflorescence,insertion,interjected,interpetalar,leaflet,marking,modification,na,needle-like,odour,orientation,paired,pattern,perfect,placement,plurifoliate,pore,position,pseudostipule,rhizome,scale,shape,smell,spot,stone,structure,symmetry,sympodial,system,texture,tuber,type,vegetative,xylopodia,zygomorphy	.5,1-2,2-8,4.5-6.5,accrescent,acicular,apparently,articulated,attenuate,base,berry,branched,chartaceous,cm,connivent,cordate,enclosing,erect,evenly,glabrous,green,herb,lateral,lobed,long,mature,maturity,mauve,mm,oblong,perpendicular,poricidal,spherical,spreading,stellate,stem,straight,tapering,tip,unequal,yellow,young	na,perfect,plurifoliate,zygomorphy
114	wfo-0001027123	success	180	112	46	59	121	53	43	3	.3,0.3-1.6cm,1-1.5,1.5-2,4-6,5-6,acute,anther,apex,attenuate,base,branched,brown,calyx,cell,commonly,corolla,dark,elliptic,filament,flattened,fruiting,glabrous,inflorescence,leaf,less,lobed,long,loose,lower,margin,mauve-purple,mm,narrowly,pedicel,perfect,petiole,plurifoliate,reddish,reniform,shiny,short,simple,sleeve,spaced,stellate,stem,subshrub,surface,terminal,time,trichome,unit,violet,way,white,widely,x,¾	-10,.5,0.5,0.5-0.8,0.7-3.5,0.8-1.3,0.9-1.3,1,1-1.2,2-2.2,2-2.5,2-2.6,2-3,2-5.5,2-lobed,2.5-10.4,2.5-4,2.5-6,3-15-20,3-4,4-5,5-10,abaxial,adaxial,adaxially,along,anthesi,appearing,axe,axi,bark,bright,broadly,campanulate,clavate,cm,completely,conical,constricted,coriaceous,cup-shaped,darker,deltate,dendritic,densely,denser,diameter,drying,eaf,edge,eed,enlarged,erect,exerted,fide,flower,free,glandular,globose,green,inserted,lamina,lax,lewi,like,lobe,lon,loosely,midvein,minute,minutely,monopodia,nflorescence,nodding,older,outline,ovary,pair,papillae,papillate,peduncle,perhaps,petal,pitted,planar,portion,primary,prominent,pubescent,revolute,scar,scatted,scattered,shin,shinin,shining,sinuate,slightly,sometimes,soon,sparsely,stigma,stoutish,straight,strongly,style,testal,thick,tip,trailing,tub,tube,turned,ud,upper,usually,vein,warty,wood,ympodial,young	appressed,articulation,bract,branching,breeding,broad-based,colour,connective,form,fruit,growth,hair,heteromorphism,inflated,insertion,interjected,interpetalar,leaflet,length,marking,mature,modification,monopodial,na,needle-like,odour,orientation,paired,pattern,placement,pore,position,prickle,pseudostipule,rhizome,scale,seed,shape,smell,spot,staman,stone,structure,symmetry,sympodial,system,texture,tissue,tuber,type,vegetative,xylopodia,zygomorphy	.3,0.3-1.6cm,1-1.5,1.5-2,4-6,5-6,acute,attenuate,base,branched,brown,commonly,dark,elliptic,flattened,glabrous,less,lobed,long,loose,mauve-purple,mm,narrowly,perfect,plurifoliate,reddish,reniform,shiny,short,simple,sleeve,spaced,stellate,subshrub,terminal,time,trichome,violet,way,white,widely,x,¾	monopodial,na,seed
115	wfo-0001027146	success	213	192	110	135	78	57	106	4	0-11,0.3-2.2,0.7-2.4,0.8,0.8-5.8,1-10,1-2,1-2.5,1-9.5,10,13-36,2-12.2,2-13,2-4.2,2-5,3.3-6.1,3.5-22,4-11,4-12.5,4-38,4-8,6,6-10,6-17.5,6.5-52,abaxially,adaxially,anther,apart,apex,articulated,axillary,base,berry,blade,brownish,bud,cell,chartaceous,clavate,cm,coarsely,condition,conical,corolla,dark,deep,diameter,digestion,distal,drying,elliptic,enzyme,filament,finely,flower,forked,fourth,fresh,fruit,generally,glabrous,green,greenish,hair,half,herb,homostylous,honeycomb-shaped,interjected,lanceolate,lateral,leaf,leaflet,lengthening,like,lobe,long,lower,margin,medium,membranous,minute,mm,moniliform,mottled,odd-pinnate,ovate,ovoid,pair,pedicel,peduncle,pentagonal,petiole,petiolule,plant,plurifoliate,pore,poricidal,proximal,puberulent,pubescent,purple,removed,ripe,rotate,seed,simple,size,slit,stem,stigma,straight,style,subglabrous,subsessile,subtending,terminal,testal,throughout,tinged,tip,tissue,tri-,tube,tuber,unit,unwinged,violet,wall,white,whitish,wide,wing,x	0.5-3.2,0.6-3.3,0.8-3.1,1.9-10,5-merou,acumen,acuminate,ag,along,alyx,apparently,arranged,asymmetrical,attenuate,axe,basiscopic,bead,capitat,ciliate,commonly,connivent,covering,darker,decreasing,dorsally,eaf,edge,eed,erec,especially,exceeding,flat,folded,fourt,geminat,glabrou,gradually,green-white,hair-like,living,make,midrib,minutely,mucilaginous,multiple,necklace,nflorescence,orbicular,orolla,perfect,rarely,ray,ruit,secondary,semierect,sessile,seudostipule,side,sometimes,spaced,specimen,stamen,ste,stolon,subequal,subglabrou,symmetrical,tall,tamen,tem,thick,toward,typically,usually,vary,wet,yellow,ympodial	age,appressed,arrangement,articulation,bract,branching,breeding,broad-based,calyx,capitate,colour,connective,form,fruiting,geminate,glabrousnes,growth,height,heteromorphism,inflated,inflorescence,insertion,interpetalar,length,marking,mature,modification,na,needle-like,odour,orientation,ovary,paired,pattern,placement,position,prickle,pseudostipule,rhizome,scale,shape,smell,spacing,spot,staman,stone,structure,surface,symmetry,sympodial,system,texture,trichome,type,vegetative,width,xylopodia	0-11,0.3-2.2,0.7-2.4,0.8,0.8-5.8,1-10,1-2,1-2.5,1-9.5,10,13-36,2-12.2,2-13,2-4.2,2-5,3.3-6.1,3.5-22,4-11,4-12.5,4-38,4-8,6,6-10,6-17.5,6.5-52,abaxially,adaxially,apart,articulated,axillary,berry,brownish,bud,chartaceous,clavate,cm,coarsely,condition,conical,dark,deep,digestion,distal,drying,elliptic,enzyme,finely,forked,fourth,fresh,generally,glabrous,green,greenish,hair,half,herb,homostylous,honeycomb-shaped,lanceolate,lateral,lengthening,like,long,medium,membranous,minute,mm,moniliform,mottled,odd-pinnate,ovate,ovoid,pentagonal,petiolule,plant,plurifoliate,pore,poricidal,proximal,puberulent,pubescent,purple,removed,ripe,rotate,simple,slit,stem,straight,subglabrous,subsessile,subtending,terminal,throughout,tinged,tip,tri-,unwinged,violet,wall,white,whitish,wide,wing,x	age,capitate,geminate,na
116	wfo-0001027157	success	207	192	114	132	75	60	107	7	0-3,0.15-0.3,0.9-2.8,1,1-10,1-2,1-3,1-6,1.5-6.5,10-30,2-15,2-2.5,2-3,2-5,2.3-4,2.5-3,3-12,3-7,3.3-7.8,3.8-8.3,4-5,6.5-14.5,9-12,abaxially,absent,adaxially,anther,apart,apex,articulated,axillary,base,berry,blade,broadly,brownish,bud,cell,chartaceous,clavate,cm,condition,conical,cordate,corolla,covering,decurrent,deeply,densely,diameter,distal,drying,elliptic,end,filament,flower,forked,fresh,fruit,generally,glabrous,green,green-white,greenish,hair,hair-like,half,herb,homostylous,interjected,lanceolate,lateral,leaf,leaflet,lengthening,like,lobe,long,lower,make,margin,membranous,mm,mucilaginous,oblique,odd-pinnate,one,ovate,ovoid,pair,pedicel,peduncle,petiole,placed,plant,plurifoliate,pore,poricidal,puberulent,pubescent,ripe,rounded,seed,size,slightly,slit,sometimes,stellate,stem,stigma,straight,style,subsessile,subtending,terminal,testal,thick,throughout,tinged,tip,tri-,tube,tuber,typically,unit,usually,violet,wall,wet,white,whitish,x	0.7-2,1-3.8,2,5-merou,acumen,acuminate,acute,ag,along,alyx,among,apparently,attenuate,axe,capitat,ciliate,connivent,cuneate,decreasing,digestion,dorsally,eaf,edge,eed,enzyme,erec,especially,exceeding,flat,folded,geminat,glabrou,grassland,greatly,honeycomb-shaped,living,low-growing,markedly,middl,midrib,minutely,narrowly,nflorescence,obtuse,orbicular,orolla,perfect,petiolulate,petiolule,rarely,removed,ruit,semi-rosette,sessile,seudostipule,shady,short,situation,spaced,specimen,stamen,ste,stolo,sunny,tall,tamen,tem,toward,unequal,unwinged,vary,wide,woodland,yellow,ympodial	5-merous,age,appressed,arrangement,articulation,bract,branching,breeding,broad-based,calyx,capitate,colour,connective,form,fruiting,geminate,growth,height,heteromorphism,inflated,inflorescence,insertion,interpetalar,length,marking,mature,middle,modification,na,needle-like,odour,orientation,ovary,paired,pattern,placement,position,prickle,pseudostipule,rhizome,scale,shape,smell,spacing,spot,staman,stolon,stone,structure,surface,symmetry,sympodial,system,texture,tissue,trichome,type,vegetative,width,xylopodia	0-3,0.15-0.3,0.9-2.8,1,1-10,1-2,1-3,1-6,1.5-6.5,10-30,2-15,2-2.5,2-3,2-5,2.3-4,2.5-3,3-12,3-7,3.3-7.8,3.8-8.3,4-5,6.5-14.5,9-12,abaxially,absent,adaxially,apart,articulated,axillary,berry,broadly,brownish,bud,cell,chartaceous,clavate,cm,condition,conical,cordate,covering,decurrent,deeply,densely,distal,drying,elliptic,end,forked,fresh,generally,glabrous,green,green-white,greenish,hair,hair-like,half,herb,homostylous,lanceolate,lateral,lengthening,like,long,make,membranous,mm,mucilaginous,oblique,odd-pinnate,one,ovate,ovoid,placed,plant,plurifoliate,pore,poricidal,puberulent,pubescent,ripe,rounded,seed,slightly,slit,sometimes,stellate,stem,straight,subsessile,subtending,terminal,testal,thick,throughout,tinged,tip,tri-,typically,usually,violet,wall,wet,white,whitish,x	5-merous,age,capitate,geminate,middle,na,stolon
117	wfo-0001027184	success	218	108	55	64	154	44	48	7	.3,.7,0.8,1–2,1–4,3-4-,3.5–8,accrescent,anther,apex,articulated,axillary,base,blue,bract-like,broad,calyx,cell,chartaceous,cm,connivent,directed,filament,fleshy,foliaceous,fruit,fruiting,glabrous,globose,hair,imparipinnate,introrsely,leaf,leaflet,long,lower,margin,membranous,mm,oblong,obtuse,orange,pedicel,petiole,plurifoliate,pore,pseudostipule,pubescent,red,ripe,shape,slightly,sparsely,stellate,stem,surface,truncate,unbranched,unequal,unit,vine,white,x,yellow	.5,.8,0-0.2,0-0.5-2,0.2-0.4,0.4-2,0.4–0.9,0.8–1.6,0–3,1-2,1.5,1.5-5,1.8–3.5,13–18,19,1–2.5,2,2.8–4.1,2–4-celled,3-foliolate,3–,3–4-celled,4,4–12,5,5-7,7,9,abaxially,absent,acute,adaxiall,adaxially,adventitious,ag,along,always,alyx,apart,appressed,axe,axi,ba,basal,blade,borne,branch,broadly,brown,clavat,cluster,cordat,covered,cylindrical,densely,diameter,eaf,eed,elliptic,entire,epidermal,especially,extension,fasciculate,flattened,flower,free,geminat,generally,glabrescent,glabrou,grading,hairlike,half,herbaceous,ilament,lanceolate,larger,largest,lateral,leafy,least,less,light,like,lobe,longitudinal,m.,meter,midrib,minutely,mostly,much,narrowly,nearly,nflorescence,node,often,older,opening,opposite,orolla,ovate,ower,peduncle,per,petiolule,pilose,portion,prominent,prominently,puberulent,rachi,raised,rarely,reticulate,revolute,root,ruit,scarcely,secondary,several,shoot,short,simple,size,slit,small,soft-woody,somewhat,spaced,stigma,straight,style,subopposite,sulcate,terminal,tertiary,tightly,tip,tree,trunk,tube,unarme,uniform,usually,vary,vein,visible,wall,weak,ympodial,young,–9	articulation,berry,bract,branching,breeding,broad-based,colour,connective,cordate,corolla,form,growth,heteromorphism,inflorescence,insertion,interjected,interpetalar,length,marking,modification,na,needle-like,odour,orientation,paired,pattern,placement,position,present,prickle,rhizome,scale,spot,staman,stone,structure,symmetry,sympodial,system,texture,tissue,tuber,type,xylopodia	.3,.7,0.8,1–2,1–4,3-4-,3.5–8,accrescent,articulated,axillary,base,blue,bract-like,broad,chartaceous,cm,connivent,directed,fleshy,foliaceous,glabrous,globose,imparipinnate,introrsely,leaf,long,lower,membranous,mm,oblong,obtuse,orange,plurifoliate,pubescent,red,ripe,slightly,sparsely,stellate,stem,surface,truncate,unbranched,unequal,vine,white,x,yellow	berry,broad-based,cordate,na,needle-like,present,prickle
118	wfo-0001027186	success	168	129	78	88	80	41	75	3	-6,.4,.5,0.5-1,1-2.5,1.4-1.6,2-6,3-4,30-40,4-9,abaxial,acute,anthesi,apart,apex,attenuate,bark,base,berry,branched,brown,calyx,cm,corolla,dark,deflexed,dendritic,densely,diameter,ellipsoid,elliptic,enlarging,entire,exerted,filament,filiform,flower,fruit,fruiting,glabrescent,glabrous,globose,golden,green,growth,irregularly,less,lobed,longer,loose,margin,maturity,mm,much,narrowly,new,pale,pedicel,peduncle,pendent,petiole,plane,pointed,pubescent,rachi,reddish,scar,shiny,simple,slightly,soon,spaced,sparsely,spreading,stem,strongly,terminal,time,tip,tree,treelet,trichome,tube,uniseriate,unit,variably,way,white	1-1.5,1.5,1.5-2,1.5-2.5,1.6-5,15,2-lobed,2.5-3,3.5-4,4-15,5-10,6-7,9-10,?,abaxially,adaxially,age,always,anther,apparently,axil,branch,broadly,clavate,conical,dbh,deltate,denditic,denser,dry,eaf,free,immature,incrassat,keeled,lamina,lengthening,like,lobe,lower,m.,midrib,minutely,nflorescence,occasionally,ovary,ovoid,pair,papillat,papillate,perfect,pericarp,pitted,planar,plurifoliat,pore,poridical,portion,primary,pubescen,reniform,rough,ruit,scattered,seed,short,slit,small,stalk,stigma,straight,style,surface,tub,ud,vein,woody,x,yellow,ympodial	adaxial,bract,branching,bud,cell,colour,form,hair,heteromorphism,inflorescence,interjected,interpetalar,leaf,leaflet,length,marking,na,odour,orientation,paired,placement,plurifoliate,position,prickle,pseudostipule,pubescence,rhizome,scale,shape,spot,staman,stone,structure,symmetry,sympodial,texture,tissue,tuber,type,xylopodia,zygomorphy	-6,.4,.5,0.5-1,1-2.5,1.4-1.6,2-6,3-4,30-40,4-9,acute,anthesi,apart,apex,attenuate,base,berry,branched,brown,calyx,cm,dark,deflexed,dendritic,densely,diameter,ellipsoid,elliptic,enlarging,entire,exerted,filiform,fruit,glabrescent,glabrous,globose,golden,green,growth,irregularly,less,lobed,longer,loose,maturity,mm,much,narrowly,new,pale,pendent,plane,pointed,pubescent,rachi,reddish,shiny,simple,slightly,soon,spaced,sparsely,spreading,strongly,terminal,time,tip,tree,treelet,trichome,tube,uniseriate,variably,way,white	na,plurifoliate,zygomorphy
119	wfo-0001027198	success	191	172	95	117	74	55	90	5	.4,.5,0.05-1.0,0.5-0.75,0.8-1,1-1.5,1-10,1.5-10,1.5-2,10-11,11-20,2-5.5,3/4,4-9,5-6,7.5-9,acuminate,acute,anther,anthesi,apart,apex,attenuate,base,bushy,calyx,channeled,clavate,cm,complex,corky,corolla,cyathiform,decurrent,dendritic,densely,dia,difoliate,elliptic,erect,extremely,female,filament,flower,fruiting,furcate,glabrate,glabrous,globose,golden,green,inflorescence,large,lateral,leaf,lobe,lobed,long,major,male,many,margin,medium,middle,minor,minute,minutely,mm,obovate,often,older,opposite,ovary,ovoid-reniform,paler,papillose,pedicel,petiole,pitted,planar,plant,pore,puberulent,pubescent,rather,reflexed,scar,set,shaped,shining,shrub,simple,size,slightly,small,speciman,stem,stigma,style,surface,tear-drop,time,tip,tree,trichome,tube,two,type,uniseriate,unit,vein,way,white,widest,woody,x,young	0.5-1,0.7-1,1-5,5-120-flowered,abruptly,always,axil,ba,beginning,beneath,berry,broadening,caly,closely,constriction,corresponding,deltoid,differing,dry,eaf,edge,edicel,eed,entire,evenly,exserted,eye,found,free,geminat,impressed,inflorescenc,invisible,like,live,lon,lower,main,meet,naked,nearly,nflorescence,overlapping,ovoid,pale,papillo,pendan,poricidal,portion,pubescence,reddi,rest,rounded,ruit,sessile,short,slender,soon,spaced,specimen,straight,strong,styled,tall,tannish-yellow,testae,thickened,thin,top,ud,undersurface,usually,yellowish,ympodial	5-120,abaxial,adaxial,articulation,bract,branching,breeding,cell,colour,connective,diameter,form,fruit,geminate,growth,hair,height,heteromorphism,insertion,interjected,interpetalar,leaflet,length,marking,mature,modification,na,number,odour,orientation,paired,part,pattern,pendant,placement,position,prickle,pseudostipule,reddish,rhizome,scale,seed,shape,spacing,spot,staman,stone,structure,symmetry,sympodial,system,texture,tissue,tuber,xylopodia	.4,.5,0.05-1.0,0.5-0.75,0.8-1,1-1.5,1-10,1.5-10,1.5-2,10-11,11-20,2-5.5,3/4,4-9,5-6,7.5-9,acuminate,acute,anthesi,apart,attenuate,base,bushy,channeled,clavate,cm,complex,corky,cyathiform,decurrent,dendritic,densely,dia,difoliate,elliptic,erect,extremely,female,furcate,glabrate,glabrous,globose,golden,green,large,leaf,lobed,long,male,many,medium,middle,minute,minutely,mm,obovate,often,opposite,ovoid-reniform,paler,papillose,pitted,planar,puberulent,pubescent,rather,reflexed,set,shaped,shining,shrub,simple,size,slightly,small,speciman,stem,style,tear-drop,time,tree,trichome,two,type,uniseriate,way,white,woody,x,young	5-120,geminate,na,pendant,reddish
120	wfo-0001027200	success	139	122	78	91	48	31	77	1	0.05-0.25,0.25-0.5,0.5-0.75,0.6-1,0.7-2.5,1-1.5,1.2-1.5,1.5-2,1.5-5,1.6-6,2-3,2.5-3,3-3.5,3.5-6,6-8,8-15,acute,anther,apex,bark,base,beneath,branch,capitate,cm,corolla,decurrent,deeply,deflexed,densely,dia,elliptic,except,filament,fruiting,geminate,glabrous,globose,golden,green,grey-brown,horizontally,leaf,lobe,lobed,long,lower,major,minor,minute,minutely,mm,nearly,node,non-reproductive,occasionally,onto,ovary,ovoid-reniform,papillose,pedicel,petiole,pitted,pore,puberulent,shaped,shrub,size,slightly,small,sparse,sparsely,spreading,stem,stigma,style,surface,tear-drop,tip,tree,trichome,unicellular,unifoliate,uniseriate,unit,vein,white,widened,woody,x,young	0.5-1,1-1.4,9-11,across,anthesi,aspec,ba,berry,branche,broadly,brown,calyx,conical,converging,dark,deltoid,differing,eaf,eed,flattened,free,giving,impressed,inflorescence,lateral,lightly,like,lon,main,margin,middle,near,older,papillo,planar,poricidal,portion,prominent,reflexed,rest,ruit,straight,tall,tube,widest,winged,yellowish,ympodial	arrangement,branching,cell,colour,diameter,form,fruit,growth,hair,height,heteromorphism,length,na,needle-like,orientation,pattern,placement,plant,prickle,pseudostipule,rhizome,seed,shape,staman,stone,structure,sympodial,texture,tuber,type,xylopodia	0.05-0.25,0.25-0.5,0.5-0.75,0.6-1,0.7-2.5,1-1.5,1.2-1.5,1.5-2,1.5-5,1.6-6,2-3,2.5-3,3-3.5,3.5-6,6-8,8-15,acute,apex,base,beneath,branch,capitate,cm,decurrent,deeply,deflexed,densely,dia,elliptic,except,geminate,glabrous,globose,golden,green,grey-brown,horizontally,leaf,lobe,lobed,long,major,minor,minute,minutely,mm,nearly,node,non-reproductive,occasionally,onto,ovoid-reniform,papillose,petiole,pitted,puberulent,shaped,shrub,slightly,small,sparse,sparsely,spreading,stem,tear-drop,tip,tree,trichome,unicellular,unifoliate,uniseriate,vein,white,widened,woody,x,young	na
121	wfo-0001027213	success	227	105	38	56	171	49	37	1	0-2.5-3.3,0.8-1.8,1-2,2.9-3.8,accrescent,anther,apex,articulated,attenuate,base,blunt-tipped,branched,calyx,cell,cm,corolla,cuneate,filament,fruit,fruiting,glabrescent,globose,green,hair,homostylous,lanceolate,leaf,length,lower,many,margin,mm,multangulate,pedicel,petiole,plurifoliate,pore,poricidal,porrect-stellate,pseudo-terminal,scabrous,shrub,simple,stellate,stem,surface,time,tip,tree,unarmed,unit,unwinged,violet,white,x,yellow-green	/10,0-160-230,0.2-0.4,0.2-0.5,0.7-2.3-4.5,1-5,1.1-1.7,1.2-1.6,1.2-1.7,1.2-2.5,1.3-2.2,1.7-3.6,1.7-3.9,1.8-2.8,1.8-3.2,1/2-2/3,10-24,12.3-16.3-19,2-5,2.4-4.7,2.5-5.1,2.9-4.8,2/3,3.5-5,3.5-8,4-9.5,4.2-5.9,5-7.5,5-8,5-merou,5.7-6.2,8-24,8.2-10.5,9-13,abaxially,acuminate,acute,adaxially,ag,along,alyx,anthesi,apart,apparently,ark,around,axe,axillary,ba,basal,blade,branch,broadly,brown,capitat,completely,conical,covering,cylindrical,dark,decurrent,deltoid,diameter,directed,distally,drying,eaf,early,edge,eed,elliptic,entire,enveloping,epidermal,eventually,exserted,farinose,few-rayed,flower,free,glabrescen,glabrous,granular,grayish-brown,group,high,immature,inserted,lackin,lateral,lengthening,lobe,lobed,long,long-,long-stalked,longitudinal,m.,main,midrib,mixed,moderately,mostly,multangulat,nearly,nflorescence,oblanceolate,obovate,obscured,obtuse,often,older,orbicular,orolla,ovate,ovate-lanceolate,pale,partly,peduncle,perfect,porrect-stellat,prominent,pubescence,pubescent,rachi,rather,relatively,reniform,reticulate-punctate,ruit,sessile,short,short-,short-attenuate,short-stalked,side,slit,sometimes,somewhat,spaced,sparsely,stamen,stigma,style,subcampanulate,suture,tamen,terete,thick,thick-stalked,thin-stalked,ti,tomentose,tomentose-pubescent,tomentu,touching,tube,ud,unarme,vary,vein,vestigial-rayed,way,whitish,whitish-green,wide,yellow,yellow-tan,yellowish,ympodial,young	appressed,articulation,bract,branching,breeding,broad-based,colour,connective,form,growth,heteromorphism,inflated,inflorescence,insertion,interjected,interpetalar,leaflet,marking,mature,modification,na,needle-like,odour,orientation,paired,pattern,placement,position,prickle,pseudostipule,rhizome,scale,shape,smell,spot,staman,stone,structure,symmetry,sympodial,system,texture,tissue,trichome,tuber,type,vegetative,xylopodia,zygomorphy	0-2.5-3.3,0.8-1.8,1-2,2.9-3.8,accrescent,articulated,attenuate,base,blunt-tipped,branched,cm,cuneate,glabrescent,globose,green,homostylous,lanceolate,many,mm,multangulate,plurifoliate,poricidal,porrect-stellate,pseudo-terminal,scabrous,shrub,simple,stellate,time,tip,tree,unarmed,unwinged,violet,white,x,yellow-green	na
122	wfo-0001027214	success	175	96	38	51	124	45	35	3	0.25,1-1.5,1.5,2,2-9,anther,apex,base,berry,calyx,cell,cm,conical,corolla,elliptic,filament,finely,fruit,fruiting,glabrous,green,greenish,herb,inflorescence,leaflet,length,less,lobed,long,long-conical,margin,mm,nearly,occasionally,once-branched,paired,papillate,pedicel,petiole,pinnate,pointed,poricidal,pubescent,sharply,simple,tip,truncate,uniseriate,unit,white,x	..,.25,.5,0,0-16,0.3-1.5,0.3-1.7,0.5-0.8,0.5-1,0.7-2,0.7-2.5,0.8-1,1-2.8,1.2-3,1.5-1.8,1.5-6,10-13,10-15-25-38,3-4-5-9,3-6,5-6,6-12,6-12-17-20,7-12,8-9,abaxially,absent,acuminate,acute,adaxially,along,anthesi,anticlinal,apical,basal,broadly,capitat,climbing,composed,conspicuously,decurrent,deltate,densely,diameter,dr.,drying,eaf,edicel,eed,epidermal,erect,exserted,extending,flattened-round,flower,free,globose,groove,grown,height,horizontal,inflorescenc,irregular,lamina,lanceolate,lateral,like,lobe,lon,long-acuminate,lower,markedly,midrib,minutely,narrowly,nflorescence,noddin,nodding,oblique,obovate,often,onto,open,opposite,ovary,pair,papilla,per,perfectly,petiolule,portion,projection,rachi,reflexed,rest,rugose,rugosity,ruit,scar,scattered,scrambling,seed,sinuous,smaller,somewhat,stigma,style,surface,tem,terminal,thickening,time,triangular,trichome,tub,tube,ud,unevenly,unifoliat,vein,white-lenticellate,whitish,without,ympodial	appressed,articulation,bract,branching,breeding,colour,connective,form,growth,hair,heteromorphism,inflated,insertion,interjected,interpetalar,leaf,marking,mature,modification,na,odour,orientation,pattern,placement,pore,position,prickle,pseudostipule,rhizome,scale,shape,spot,staman,stone,structure,symmetry,sympodial,system,texture,tissue,tuber,type,unifoliate,xylopodia,zygomorphy	0.25,1-1.5,1.5,2,2-9,base,berry,cm,conical,elliptic,finely,glabrous,green,greenish,herb,less,lobed,long,long-conical,mm,nearly,occasionally,once-branched,papillate,pinnate,pointed,poricidal,pubescent,sharply,simple,tip,truncate,uniseriate,white,x	na,unifoliate,zygomorphy
123	wfo-0001027219	success	143	154	90	109	34	45	84	6	.5,/4,0.3,0.4-0.6,0.5,0.5-0.8,1-15,1.5-2.5,2,2-2.5,2-3,2-3.5,2-4,3-5,3-6,6-8,7-8,absent,acuminate,acute,age,anther,anthesi,apex,bark,base,berry,bright,broadly,brown,capitate,closely,cm,conical,corolla,deltate,densely,diameter,drying,edge,elliptic,entire,filament,flower,fruiting,glabrescent,glabrous,globose,green,greyish,growth,hard,heterostylous,leaf-opposed,lengthening,less,lobe,lobed,long-conical,long-styled,lower,margin,maturity,minutely,mm,new,ovary,pair,pale,papillose-pubescent,pedicel,peduncle,pendent,pericarp,petiole,planar,pore,poricidal,primary,pubescent,purple,scar,short-styled,shrub,simple,slightly,slit,sometimes,somewhat,spaced,stem,stigma,style,surface,thickened,tip,trichome,tube,uniseriate,unit,vein,violet,way,weight,white,woody,x,yellowish,–1/3	1,1-2,1-3,1.5-2,axillary,berr,c.,calyx,completely,cup-shaped,eaf,eed,erect,exerte,exfoliatin,free,glabrou,known,nflorescence,overlappin,papillo,plurifoliat,pointed,portion,ruit,sharply,shoot,short,soon,stout,terminal,tuft,ud,ympodial	arrangement,branching,breeding,broad-based,bud,cell,colour,connective,exfoliating,form,fruit,hair,heteromorphism,inflorescence,leaf,length,marking,mature,modification,na,needle-like,orientation,overlapping,papillose,pattern,placement,plurifoliate,position,prickle,pseudostipule,rhizome,shape,size,spot,staman,stone,structure,symmetry,sympodial,system,texture,tuber,type,xylopodia,zygomorphy	.5,/4,0.3,0.4-0.6,0.5,0.5-0.8,1-15,1.5-2.5,2,2-2.5,2-3,2-3.5,2-4,3-5,3-6,6-8,7-8,absent,acuminate,acute,age,anthesi,base,berry,bright,broadly,brown,capitate,closely,cm,conical,deltate,densely,drying,edge,elliptic,entire,flower,glabrescent,glabrous,globose,green,greyish,hard,heterostylous,leaf-opposed,lengthening,less,lobed,long-conical,long-styled,maturity,minutely,mm,pair,pale,papillose-pubescent,pendent,planar,pore,poricidal,pubescent,purple,short-styled,shrub,simple,slightly,slit,sometimes,somewhat,spaced,surface,thickened,tip,trichome,uniseriate,violet,way,weight,white,woody,x,yellowish,–1/3	exfoliating,na,overlapping,papillose,plurifoliate,zygomorphy
124	wfo-0001027223	success	189	100	46	60	129	40	44	2	1-2,1.8-3.5,4-6,5-21,5-8,anther,apex,asymmetric,attenuate,axillary,base,berry,bud,cell,cm,conical,corolla,deep,densely,distal,dot,filament,forked,fruit,green,hair,half,herb,hyaline,interjected,lanceolate,leaf,leaflet,long,middle,mm,odd-pinnate,ovoid,pedicel,pentagonal,petiole,plurifoliate,pore,poricidal,pubescent,purple,ripe,rotate,rounded,sometimes,stripe,subtending,terminal,tip,tissue,tri-,tuber,unit,usually,white	.5,0.19-0.75,0.3-1.2,1-3,1.3-2,1.5-3.5,16-41,2-4,2-7,3-10,3-11,3-5,3-5.2,3.5-4,3.5-6,3.5-7,3.7-9.3,5-10,5-merou,5.9-12.2,9-15,9-22,9-35,abaxially,acumen,acuminate,adaxiall,adaxially,ag,alyx,apart,apparently,articulated,axe,basiscopic,blade,brownish,capitat,clavate,condition,connivent,covering,decreasing,diameter,digestion,dorsally,drying,eaf,edge,eed,elliptic,end,enzyme,erec,exceeding,flat,flower,folded,fresh,geminat,generally,glabrou,glabrous,green-white,greenish,hair-like,hal,homostylous,honeycomb-shaped,larger,lateral,lengthening,light,like,living,lobe,lower,make,mucilaginous,nflorescence,one,orbicular,orolla,ovate,pair,peduncle,perfect,petiolulate,placed,plant,present,removed,ruit,seed,sessile,seudostipule,short,shortly,side,size,slightly,slit,spaced,specimen,stamen,ste,stigma,stolo,straight,style,subequal,tall,tamen,tem,testal,thick,throughout,toward,tube,typically,unwinged,vary,wall,wet,whitish,wide,x,yellow,ympodial	appressed,articulation,bract,branching,calyx,colour,connective,form,fruiting,growth,heteromorphism,inflated,inflorescence,insertion,interpetalar,length,margin,marking,mature,na,odour,orientation,paired,placement,position,prickle,pseudostipule,rhizome,scale,shape,spot,staman,stellate,stone,structure,symmetry,sympodial,texture,type,xylopodia	1-2,1.8-3.5,4-6,5-21,5-8,asymmetric,attenuate,axillary,berry,bud,cm,conical,deep,densely,distal,dot,forked,green,hair,half,herb,hyaline,lanceolate,long,middle,mm,odd-pinnate,ovoid,pentagonal,plurifoliate,poricidal,pubescent,purple,ripe,rotate,rounded,sometimes,stripe,subtending,terminal,tip,tri-,usually,white	na,stellate
125	wfo-0001027237	success	122	104	65	81	41	23	62	3	.5,/4,1-1.2,1.5-2,1.5-2.5,2-3,3-3.5,3-4,30-100-flowered,6-11,6-8,8,anther,anthesi,apart,bark,base,black,branched,brown,calyx,clavate,cm,completely,corolla,cucullate,cup-shaped,dark,deflexed,difoliate,drying,ellipsoid,filament,flattened,fruiting,geminate,glabrous,globose,green,greenish-white,inflorescence,internodal,later,leaf,lobed,many,margin,minutely,mm,occasionally,ovary,paler,papillose,pedicel,pitted,pore,poricidal,regularly,reniform,scar,shaped,shining,shrub,small,spaced,stem,stigma,straight,style,tapering,tear-drop,time,tip,tree,tube,unit,way,white,widely,x,young	0.5-1,5,apiculae,apiculate,appearing,ba,berry,blac,branc,broadly,deltoid,dia,edicel,eed,erect,exsertion,free,greyi,lobe,long,lower,nflorescence,older,papillate,papillo,part,plurifoliat,portion,reflexed,regulary,ruit,slender,surface,tall,terminal,ud,upper,usually,woody,x.,ympodial	0.5,branching,bud,colour,diameter,flower,form,fruit,greyish,growth,height,length,number,plant,plurifoliate,position,seed,shape,size,spacing,structure,sympodial,texture	.5,/4,1-1.2,1.5-2,1.5-2.5,2-3,3-3.5,3-4,30-100-flowered,6-11,6-8,8,apart,base,black,branched,brown,clavate,cm,completely,cucullate,cup-shaped,dark,deflexed,difoliate,drying,ellipsoid,flattened,geminate,glabrous,globose,green,greenish-white,internodal,later,lobed,many,margin,minutely,mm,occasionally,paler,papillose,pitted,poricidal,regularly,reniform,shaped,shining,shrub,small,spaced,straight,tapering,tear-drop,time,tip,tree,way,white,widely,x	0.5,greyish,plurifoliate
126	wfo-0001027238	success	203	123	59	73	130	50	55	4	.5,0-1,1-1.5,1.5-3,4-,accrescent,anther,apex,articulated,base,berry,black,calyx,chartaceous,cm,connivent,cuneate,directed,distally,entire,equal,extra-axillary,filament,fleshy,fruit,fruiting,geminate,glabrescent,glabrous,globose,hair,interpetalar,introrsely,large,lavender,leaf,longitudinal,lower,margin,membranaceous,mm,oblique,oblong,obtuse,opening,paired,pale,pedicel,petiole,plurifoliate,pore,purple,ripe,rounded,scandent,shiny,shrub,simple,slit,small,sometimes,somewhat,sprawling,stellate,stem,surface,tissue,tree,unbranched,unit,white,without,x	-5,.3,0-0.7,0-1.5,0.3-0.5,0.3-0.8,0.3-1,0.3-5,0.5-1,0.5-16,0.5-2,1-2,1.5-4,1.5-7,10,15-30,2-3,2-4,3-4,3-5,3-6,4-10,4-16,4-5,4-8,5-15,5-7,5-merou,6-15-25,6-8,abaxially,acuminate,acute,adaxiall,adaxially,ag,alyx,apparently,axe,ba,blade,branch,brown,capitat,contiguous,covering,cylindrical,dark,deltate,densely,diameter,differentiated,discolorous,eaf,eed,elliptic,elliptic-ovate,flattened,flower,foliaceous,fork,free,frui,gland,gland-tipped,green,greenish,growt,homostylous,juic,light,lighter,like,lobe,long,major,midpoint,minor,minutely,mixed,multangulate,narrowly,near,nearly,new,nflorescence,often,one,orolla,outline,part,peduncle,perfect,pericarp,pitted,porrect-stellate,pubescent,rachi,ray,reniform,ruit,sessile,short-stalked,side,similar,sparse,sparsely,ste,stellate-pubescent,stigma,straight,strongly,style,subtending,tamen,tem,time,tip,toward,triangular,tube,unarme,unequal,vary,vein,whitish,wide,yellow,yellowish,ympodial	age,appressed,articulation,bract,branching,breeding,broad-based,cell,colour,corolla,form,growth,heteromorphism,inflated,inflorescence,insertion,interjected,leaflet,length,marking,mature,na,needle-like,odour,orientation,pattern,placement,position,prickle,pseudostipule,rhizome,scale,shape,smell,spot,staman,stone,structure,symmetry,sympodial,system,texture,trichome,tuber,type,unarmed,vegetative,xylopodia,ye,zygomorphy	.5,0-1,1-1.5,1.5-3,4-,accrescent,apex,articulated,base,berry,black,chartaceous,cm,connivent,cuneate,directed,distally,entire,equal,extra-axillary,fleshy,geminate,glabrescent,glabrous,globose,introrsely,large,lavender,longitudinal,membranaceous,mm,oblique,oblong,obtuse,opening,pale,plurifoliate,purple,ripe,rounded,scandent,shiny,shrub,simple,slit,small,sometimes,somewhat,sprawling,stellate,tree,unbranched,white,without,x	age,na,unarmed,ye
127	wfo-0001027244	success	285	123	60	78	207	45	58	2	-2,0-5-10,0.2-1,0.3-0.5,0.45-0.6,0.5,2-4,2-foliate,3-5,abaxially,anther,apex,articulation,base,berry,bifurcate,bract,bracteate,branched,cage,calyx,cell,cm,cordate,corolla,curved,decurrent,densely,developed,distal,filament,fruit,fruiting,globose,green,greenish,half,herb,imparipinnate,inflorescence,interjected,interrupted,investing,leaflet,length,like,long,longer,lower,margin,middle,mm,node,oblique,often,pair,patent,pedicel,petiole,present,primary,pseudostipule,pubescent,rotate-stellate,simple,somewhat,sparsely,stem,surface,trichome,truncate,uniseriate,unit,usually,vivid,white,wide,yellow	-12,.5,0.02-0.1-0.3,0.04-0.1-0.3,0.05,0.05-1,0.07-0.15,0.1-0.5,0.1-0.6,0.1-0.7-2,0.15-0.2,0.2,0.2-0.7-3,0.25-0.4,0.3,0.3-0.4,0.3-0.6,0.3-0.8,0.4-0.6,0.4-1,0.4-1-3.5,0.5-0.8,0.5-1,0.6-0.9-1.2,0.6-09,0.7-1,0.7-1.5,0.8-1.2,0.9-1.3,0.9-1.7,1,1-2-celled,1-2.5,1-celled,1.1-1.3,1.2-1.6,1.5-2,1.5-2.1,1.5-2.4-3.2,1.5-6.5,1.7-3.0,1/2,2-3.5-13,2-4-celled,2-9,2-locular,2.1-8,3/4,4-12,4-celled,5-8-16,5-9-celled,7-12,8-celled,absent,abundance,abundant,acroscopically,acuminate,acute,adaxially,adpressed,alfway,along,also,always,amongst,angled,anthesi,apical,apparently,appearance,appendage,arequipa,around,articulated,articulatio,axi,basal,berr,broadly,brown,c.,capitate,column,common,conical,crenate,dark,deciduous,decumbent,deeper,deltate,dense,density,dentate,diamete,diameter,eaf,edicel,eed,eglandular,either,elliptic,elliptical,erect,exserted,extremely,flower,flushed,forming,general,giving,glabrescent,glabrous,gland,glandular,gree,hair-like,halfway,head,hyaline,internode,irregularly,lamina,lanceolate,larger,largest,lateral,leave,lobe,lobed,lobing,lon,midvein,minute,mixed,mixture,multicellular,narrowly,near,obovate,occasionally,onto,orbicular,outgrowth,ovary,papillate-pubescent,peduncle,perennial,petiolule,population,purple,rachi,reflexed,rest,ripe,rounded,ruit,scattered,secondary,sessile,shaggy,short,shorter,silky,sinus,size,slender,small,sometimes,sparse,sparser,spreading,staminal,sterile,stigma,stout,straight,stripe,strongly,style,tall,tem,terminal,tertiary,testa,thick,tiny,tip,tipped,toward,tube,two,ud,undulate,unicellular,united,upper,variable,variety,vein,velvety,wall,winged,woody,ympodial	appressed,branching,breeding,broad-based,colour,connective,form,growth,hair,heteromorphism,inflated,insertion,interpetalar,leaf,marking,mature,modification,na,needle-like,odour,orientation,paired,pattern,placement,pore,position,prickle,rhizome,scale,shape,smell,spot,staman,stone,structure,symmetry,sympodial,system,texture,tissue,tuber,type,vegetative,xylopodia,zygomorphy	-2,0-5-10,0.2-1,0.3-0.5,0.45-0.6,0.5,2-4,2-foliate,3-5,abaxially,berry,bifurcate,bracteate,branched,cage,cm,cordate,curved,decurrent,densely,developed,distal,fruit,globose,green,greenish,half,herb,imparipinnate,interrupted,investing,leaflet,like,long,longer,middle,mm,node,oblique,often,pair,patent,present,primary,pubescent,rotate-stellate,simple,somewhat,sparsely,stem,trichome,truncate,uniseriate,usually,vivid,white,wide,yellow	na,zygomorphy
128	wfo-0001027248	success	158	140	99	114	44	26	97	2	.5,0.5-1,0.5-2.5,0.7-1.2,1-1.5,1-2,1-5,2-2.5,2-4.5,3-4,3-7,3.5-4,4-8,5-5.5,6.5-8,7-9,abaxial,anther,anthesi,apex,appearing,arachnoid,arachnoid-pubescent,area,bark,base,beige,beneath,broadened,broadly,brown,brownish,calyx,closely,cm,conical,corolla,dark,densely,dia,difoliate,dirty,elliptic,erect,exserted,felty,filament,fleshy,fruit,fruiting,geminate,glabrescent,glabrous,globose,green,impressed,lateral,leaf,lightly,lobed,long,main,margin,merely,minor,minutely,mm,nearly,node,occasionally,opposite,ovary,ovoid-reniform,pair,pale,papillose,patch,pedicel,petiole,pitted,planar,pore,poricidal,present,pubescence,pubescent,scar,scattered,shaped,shoot,shrub,size,small,somewhat,soon,spaced,sparsely,stem,stigma,strongly,style,surface,tear-drop,tip,top,tree,trichome,tube,unifoliate,vein,white,wide,winged,young	0,1-3,3-7-flowered,6-13,abaxially,acute,adaxially,along,ape,arachnoid-pubescen,berry,brownish-gra,deflexed,deltate,denser,differing,eaf,edicel,eed,ellipsoid,free,grayish-green,lamina,later,lobe,lower,major,nflorescence,older,overlappin,papillo,per,portion,ruit,simple,specimen,tall,thick,tub,ud,unit,wid,woody,ympodial	adaxial,arrangement,brownish-gray,colour,diameter,flower,form,growth,hair,height,inflorescence,length,mature,number,overlapping,pattern,plant,position,seed,shape,spacing,symmetry,texture,type,width,winging	.5,0.5-1,0.5-2.5,0.7-1.2,1-1.5,1-2,1-5,2-2.5,2-4.5,3-4,3-7,3.5-4,4-8,5-5.5,6.5-8,7-9,anthesi,apex,appearing,arachnoid,arachnoid-pubescent,area,base,beige,beneath,broadened,broadly,brown,brownish,calyx,closely,cm,conical,dark,densely,dia,difoliate,dirty,elliptic,erect,exserted,felty,fleshy,geminate,glabrescent,glabrous,globose,green,impressed,lateral,leaf,lightly,lobed,long,main,merely,minutely,mm,nearly,node,occasionally,opposite,ovoid-reniform,pair,pale,papillose,patch,pitted,planar,pore,poricidal,present,pubescence,pubescent,scattered,shaped,shoot,shrub,small,somewhat,soon,spaced,sparsely,strongly,style,tear-drop,tip,top,tree,trichome,tube,unifoliate,vein,white,wide,winged,young	brownish-gray,overlapping
129	wfo-0001027258	success	178	110	48	57	121	53	43	5	.5,/4,0.6-2,1-1.5,4.5-5,age,anther,apex,attenuate,base,berry,calyx,cm,corolla,difoliate,elliptic,filament,fruit,fruiting,glabrous,globose,green,internodal,leaf,length,lengthening,lobed,long,lower,margin,mm,occasionally,onto,opposite,ovate,pedicel,petiole,pore,poricidal,pubescent,shrub,slightly,slit,sparsely,stem,strongly,surface,swollen,tip,treelet,trichome,uniseriate,unit,way,white,winged,x	.25,0.25-0.5,0.5-1,0.9-1.3,1-2.3,1-4,1.2-2,1.5-1.6,2-2.5,2.5-8,3-4,3-6,3.5-4,4-5,5-10-flowered,6-8,7-13,7-9,abaxially,abruptly,acuminate,acute,adaxially,along,anthesi,apar,apical,apiculae,axil,ba,bark,beneath,broadly,capitate,crystal,darker,decurrent,deflexed,deltate,dense,densely,deposit,dia,differing,dissecting,drying,eaf,edicel,eed,ellipsoid,enlarge,entire,evenly,exserted,extending,fide,flattened-reniform,fragrant,free,geminat,glabrou,greenish-yellow,incrassate,lamina,large,lateral,lenticel,lobe,main,major,microscope,middle,minor,minute,minutely,nee,nflorescence,often,older,ovary,pair,pale,papillo,papillose,pitted,planar,portion,projection,prominent,red-papillose,reddish,ruit,sand,scar,scattered,simple,size,slender,small,spaced,speck,stigma,straight,style,sweetly,tall,tiny,tub,tube,tuft,ud,urceolate,vein,visible,widening,widest,woody,yellowish,yellowish-tan,ympodial,young	appressed,articulation,bract,branching,breeding,broad-based,cell,colour,connective,enlarged,form,geminate,growth,hair,heteromorphism,inflated,inflorescence,insertion,interjected,interpetalar,leaflet,marking,mature,modification,na,needle-like,odour,orientation,paired,pattern,placement,position,present,prickle,pseudostipule,rhizome,scale,shape,smell,spot,staman,stone,structure,symmetry,sympodial,system,texture,tissue,tuber,type,vegetative,xylopodia,zygomorphy	.5,/4,0.6-2,1-1.5,4.5-5,age,attenuate,base,berry,cm,difoliate,elliptic,glabrous,globose,green,internodal,leaf,lengthening,lobed,long,mm,occasionally,onto,opposite,ovate,petiole,pore,poricidal,pubescent,shrub,slightly,slit,sparsely,strongly,swollen,tip,treelet,trichome,uniseriate,way,white,winged,x	enlarged,geminate,inflated,na,present
130	wfo-0001027260	success	170	167	101	111	59	56	95	6	-2,-7,0.25-1,0.5-1,0.5-3,0.5-6.5,0.75-1,1-2,1-3-10-17,1-4,1-4.5-14,1.5-13,15-30,2-18,3-6,5-10-25,abaxially,absent,acuminate,acute-,adaxially,age,also,apart,apex,articulated,basal,base,berry,beyond,branched,cell,chartaceous,clavate,cm,connective,cordate,cylindrical,darker,densely,diameter,directed,distally,eglandular,ellipsoidal,elliptic,elliptic-ovate,entire,equal,exceeding,fading,flower,fruit,glabrate,glabrous,globose,greenish,hair,lavender,lobe,long,longitudinal,lower,margin,membranaceous,mm,moderately,narrowly,nearly,obtuse,often,ovate,pedicel,peduncle,petiole,pilose,pink,pore,puberulent,pubescent,pubescent-pilose,purple,rachi,remnant,shorter,shrub,simple,slightly,small,sparsely,stamen,stellate,stigma,stone,stripe,strongly,style,subcoriaceous,tapered,thecae,tree,triangular,truncate,unbranched,unit,usually,vein,white,x,yellow-green,yellowish	0.8-2,1-2.5-14,1-3,1-6,1-7,1.5-2,2-10,2-2.5,2-6-20,2.5-3.5,3-11,3-4-6,3-4.5,3.5-25,4-25,4-32,4-5-foliat,5-25,5-40-60,5-merous,acute,aggregate,alyx,ape,axe,blade,connivent,diamete,eaf,eed,exserted,flattened,lanceolate,leaving,lon,nflorescence,nther,orolla,pedicellar,perfec,perfect,pilo,presen,puberulent-pubescen,puberulent-pubescent,radiu,ruit,spaced,tal,tem,time,tomento,tube,ud,vary,wide,yellow,yellow-orang,ympodial	15-40-60,2-20,4-5-foliate,anther,articulation,bract,branching,broad-based,bud,calyx,colour,corolla,exsertion,form,fruiting,growth,height,heteromorphism,inflorescence,insertion,interjected,interpetalar,leaf,leaflet,length,na,needle-like,odour,orientation,ovary,paired,pattern,placement,plant,position,present,prickle,pseudostipule,rhizome,scale,shape,smell,spacing,staman,stem,structure,surface,sympodial,texture,tissue,trichome,tuber,type,vegetative,xylopodia,yellow-orange	-2,-7,0.25-1,0.5-1,0.5-3,0.5-6.5,0.75-1,1-2,1-3-10-17,1-4,1-4.5-14,1.5-13,15-30,2-18,3-6,5-10-25,abaxially,absent,acuminate,acute-,adaxially,age,also,apart,apex,articulated,basal,base,berry,beyond,branched,chartaceous,clavate,cm,cordate,cylindrical,darker,densely,diameter,directed,distally,eglandular,ellipsoidal,elliptic,elliptic-ovate,entire,equal,exceeding,fading,glabrate,glabrous,globose,greenish,hair,lavender,lobe,long,longitudinal,membranaceous,mm,moderately,narrowly,nearly,obtuse,often,ovate,pilose,pink,puberulent,pubescent,pubescent-pilose,purple,shorter,shrub,simple,slightly,small,sparsely,stamen,stellate,stripe,strongly,subcoriaceous,tapered,thecae,tree,triangular,truncate,unbranched,usually,vein,white,x,yellow-green,yellowish	15-40-60,2-20,4-5-foliate,na,present,yellow-orange
131	wfo-0001027265	success	158	93	60	71	87	22	58	2	.3,0.1–2,0.5,0.5-1,1-3,1.2-2,1.2–1.4,1.5–1.8,1.5–2,2-3,2-3-,2–2.5,2–3,3-lobed,4-5,4–6,4–7-branched,anther,apart,articulated,base,berry,broad,chartaceous,cm,diameter,entire,extra-axillary,flattened-reniform,flower,foliate,fruit,glabrous,globose,hair,herb,hermaphroditic,leaf-opposed,light,long-attenuate,margin,minutely,mm,nearly,oblong,orange,ovate-lanceolate,partially,pedicel,peduncle,petiole,pitted,pore,puberulent,pubescent,purple,rachi,rarely,red,rotate-stellate,seed,simple,slightly,sparsely,subcoriaceous,surface,tip,unit,white,x,yellow	-2.5,.2,.5,0.2-0.4,0.5–0.6,1-1.3,1-2.5,1.2-1.3,1.5-2.5,1.5–4,2,2-4,2/3,20-30,30–50,4.5–8,5-merou,58409,abaxially,accrescent,acute,adaxiall,adaxially,alyx,apex,apparently,axe,ba,blade,calyx,capitat,ciliate,connivent,covering,croat,cylindrical,dehiscent,eaf,eed,erect,filament,frui,fruiting,geminat,granule,juic,larger,lobe,lon,long,longitudinall,low,lower,mesocarp,near,nflorescence,node,numerous,obtuse,orolla,paired,present,prominent,recurved,ripe,rooting,ruit,scarcely,sclerotic,sometimes,somewhat,spaced,stigma,style,tall,tamen,tem,time,triangular,tube,usually,vary,weak,white-puberulent,wide,winged,ympodial	30-50,articulation,branching,colour,corolla,form,growth,height,inflorescence,leaf,length,longitudinally,plant,position,shape,size,spacing,stem,structure,sympodial,texture,type	.3,0.1–2,0.5,0.5-1,1-3,1.2-2,1.2–1.4,1.5–1.8,1.5–2,2-3,2-3-,2–2.5,2–3,3-lobed,4-5,4–6,4–7-branched,apart,articulated,base,berry,broad,chartaceous,cm,entire,extra-axillary,flattened-reniform,foliate,glabrous,globose,herb,hermaphroditic,leaf-opposed,light,long-attenuate,minutely,mm,nearly,oblong,orange,ovate-lanceolate,partially,pitted,pore,puberulent,pubescent,purple,rarely,red,rotate-stellate,simple,slightly,sparsely,subcoriaceous,tip,white,x,yellow	30-50,longitudinally
132	wfo-0001027265	success	155	158	76	85	70	73	65	11	.2,0.2-0.4,0.5,0.5-1,1-3,1.2-1.3,1.2-2,2,2-3,2-3-,2/3,4-5,accrescent,acute,anther,apart,apex,articulated,base,broad,calyx,chartaceous,cm,cylindrical,diameter,entire,extra-axillary,filament,flattened-reniform,flower,foliate,fruit,fruiting,glabrous,globose,granule,hair,herb,hermaphroditic,larger,leaf-opposed,light,lobe,long-attenuate,lower,margin,minutely,mm,near,oblong,orange,ovate-lanceolate,paired,partially,pedicel,peduncle,petiole,pitted,pore,prominent,puberulent,pubescent,purple,rachi,red,ripe,rotate-stellate,scarcely,sclerotic,seed,simple,sometimes,sparsely,stigma,style,subcoriaceous,surface,tip,triangular,tube,unit,white,winged,x,yellow	-2.5,.3,.5,0.1–2,0.5–0.6,1-1.3,1-2.5,1.2–1.4,1.5-2.5,1.5–1.8,1.5–2,1.5–4,2-4,20-30,2–2.5,2–3,3-lobed,30–50,4.5–8,4–6,4–7-branched,5-merou,58409,abaxially,adaxiall,adaxially,alyx,apparently,axe,ba,blade,capitat,ciliate,connivent,covering,croat,dehiscent,eaf,eed,erect,frui,geminat,juic,lon,long,longitudinall,low,mesocarp,nearly,nflorescence,node,numerous,obtuse,orolla,rarely,recurved,rooting,ruit,slightly,somewhat,spaced,tall,tamen,tem,time,vary,weak,white-puberulent,wide,ympodial	0.1-2,1.2-1.4,1.5-1.8,1.5-2,2-2.5,30-50,4-6,4-7-branched,abaxial,adaxial,appressed,arrangement,articulation,bract,branching,breeding,broad-based,capitate,cell,colour,connective,corolla,form,growth,height,heteromorphism,inflated,inflorescence,insertion,interjected,interpetalar,leaf,leaflet,length,longitudinally,marking,mature,modification,na,needle-like,odour,orientation,ovary,pattern,placement,plant,position,presence,prickle,pseudostipule,rhizome,scale,shape,size,smell,spacing,spot,staman,stem,stone,structure,symmetry,sympodial,system,texture,tissue,trichome,tuber,type,vegetative,winging,xylopodia,zygomorphy	.2,0.2-0.4,0.5,0.5-1,1-3,1.2-1.3,1.2-2,2,2-3,2-3-,2/3,4-5,accrescent,acute,apart,apex,articulated,base,broad,chartaceous,cm,cylindrical,diameter,entire,extra-axillary,flattened-reniform,foliate,glabrous,globose,herb,hermaphroditic,larger,leaf-opposed,light,long-attenuate,lower,minutely,mm,near,oblong,orange,ovate-lanceolate,paired,partially,pitted,pore,prominent,puberulent,pubescent,purple,red,ripe,rotate-stellate,scarcely,seed,simple,sometimes,sparsely,subcoriaceous,tip,triangular,white,winged,x,yellow	0.1-2,1.2-1.4,1.5-1.8,1.5-2,2-2.5,30-50,4-6,4-7-branched,capitate,longitudinally,na
133	wfo-0001027284	success	172	112	68	81	91	31	66	2	0.1–0.5,0.1–2,0.7–0.9,0.7–1,1.2–1.5,1.5–2,1.5–5.5,1.5–8,1–1.5,1–3,2.5–3.5,3.5–14,3–4,4–12,5-merous,5–7,9–18,abaxially,accrescent,adaxially,anther,apex,axillary,base,berry,branched,brownish,calyx,cm,cordate,densely,elliptic,entire,extra-axillary,filament,fine,flower,fruit,fruiting,glabrous,globose,green,inflorescence,margin,midvein,mm,nearly,oblique,orangish,ovate,ovoid,pair,pale,pedicel,peduncle,petiole,pinnate,plurifoliate,pubescence,pubescent,rachi,rarely,rounded,sand-punctate,scandent,secondary,shrub,simple,size,sometimes,somewhat,stellate,stem-terminal,truncate,unbranched,unit,vein,venation,vine,white,x	.3,0.2–,1.5–2.5,1.8–2,1–2,2.5–3,2–16,2–2.2,4,4–6,5–8,acuminate,acute,alyx,anthesi,axe,blade,branch,c.,capitat,ciliat,climbing,conspicuous,contiguousl,cylindrical,deflected,deltoid,diameter,distally,eaf,eed,enlarged,flattened,flattened-reniform,fleshy,glabrescen,glabrou,gradually,herbaceous,immature,leafy,lobe,long,lower,m.,maturity,minutely,near,nflorescence,nternode,one,orolla,pendulou,perfec,pink,planar,pointed,prominent,reduced,reticulate-rugulose,ruit,sand-punctat,scar,seen,shortly,side,slightly,soon,spaced,sparsely,spreading,stigma,style,surface,tamen,tan,tem,thickened,thickly,time,tip,toward,tree,tube,understory,unifoliat,vary,weakly,wide,woody,ympodial	branching,cell,colour,corolla,form,growth,heteromorphism,internode,leaf,length,merosity,modification,na,odour,orientation,placement,position,prickle,pseudostipule,rhizome,shape,staman,stone,structure,symmetry,sympodial,texture,tuber,type,unifoliate,xylopodia	0.1–0.5,0.1–2,0.7–0.9,0.7–1,1.2–1.5,1.5–2,1.5–5.5,1.5–8,1–1.5,1–3,2.5–3.5,3.5–14,3–4,4–12,5-merous,5–7,9–18,abaxially,accrescent,adaxially,axillary,berry,branched,brownish,cm,cordate,densely,elliptic,entire,extra-axillary,fine,flower,fruit,glabrous,globose,green,midvein,mm,nearly,oblique,orangish,ovate,ovoid,pair,pale,pinnate,plurifoliate,pubescence,pubescent,rarely,rounded,sand-punctate,scandent,secondary,shrub,simple,sometimes,somewhat,stellate,stem-terminal,truncate,unbranched,vein,vine,white,x	na,unifoliate
134	wfo-0001027302	success	188	171	92	115	73	56	88	4	.5,0.4-5,0.5,0.5-1,0.6-1,1-1.3,1-1.5,1-2,1-3,1.2-1.6,1.5-2,10,2-3,2-6,2.2,2.7-7.5,3.5-5,3/4,5-7,6-12,7,7/8,abaxial,acuminate,acute,adaxial,age,anther,anthesi,apex,bark,base,becoming,branching,bright,brownish-yellow,capitate,clavate,cm,cordate,corolla,crispate,dendritic,densely,diameter,elliptic,filament,fine,flat-topped,flattened,fruiting,glabrous,globose,growth,later,leaf,length,lenticular,less,lobed,long,lower,margin,minutely,mm,monochasial,narrowly,nodding,occasionally,ovary,ovate,pair,pale,pedicle,pericarp,petiole,pitted,plant,plurifoliate,pore,poridical,prominent,puberulent,pubescent,pyramidal,red,reddish-brown,scar,scattered,secondary,shrub,simple,sleeve,slit-like,small,somewhat,stem,stigma,style,surface,thin,time,tiny,tip,tree,trichome,truncate,tube,undulate,unit,vein,violet,way,x,young	0.8-1,1,1.2-2.5,10-20,2,abaxially,adaxially,along,apical,appearing,ba,basal,berry,blade,broader,calyx,conical,cultivation,decurrent,deflexed,deltoid,denser,dichasia,discussion,eaf,edicel,eed,entire,especially,ew,exserted,flower,free,growing,inserted,juvenile,larger,lateral,lax,like,lobe,lon,long-triangular,m.,main,nflorescence,older,otherwise,overtopping,papillo,per,planar,portion,reflexed,ruit,scrambling,see,shade,shin,shoot,sparsely,stamen,strongly,tall,tapering,terminal,tub,ud,usually,wide,winged,woody,ympodial	articulation,bract,breeding,broad-based,bud,cell,colour,connective,dichasial,form,fruit,hair,height,heteromorphism,inflorescence,insertion,interjected,interpetalar,leaflet,marking,modification,na,needle-like,new,odour,orientation,papillose,pattern,pedicel,placement,position,prickle,prominence,pseudostipule,rhizome,scale,seed,shape,shiny,size,smell,spot,staman,stone,structure,symmetry,sympodial,system,texture,thicknes,tissue,tuber,type,vegetative,width,xylopodia	.5,0.4-5,0.5,0.5-1,0.6-1,1-1.3,1-1.5,1-2,1-3,1.2-1.6,1.5-2,10,2-3,2-6,2.2,2.7-7.5,3.5-5,3/4,5-7,6-12,7,7/8,acuminate,acute,age,anthesi,apex,base,becoming,branching,bright,brownish-yellow,capitate,clavate,cm,cordate,crispate,dendritic,densely,elliptic,fine,flat-topped,flattened,glabrous,globose,later,lenticular,less,lobed,long,minutely,mm,monochasial,narrowly,nodding,occasionally,ovate,pair,pale,pitted,plant,plurifoliate,poridical,prominent,puberulent,pubescent,pyramidal,red,reddish-brown,scattered,shrub,simple,sleeve,slit-like,small,somewhat,thin,time,tiny,tip,tree,trichome,truncate,undulate,violet,way,x,young	dichasial,na,papillose,shiny
135	wfo-0001027310	success	213	122	70	78	135	44	66	4	/3,0-20,0.7-2,1/3-3/4,4.5-5.5,8-10,andromonoecious,anther,apex,apparently,articulated,base,berry,branched,branching,broadly,calyx,chartaceous,cm,connivent,cuneate,dark,deltate,discolorous,drying,entire,erect,evenly,filament,flattened,foliaceous,fruit,fruiting,green,hair,inflated,lateral,leaf,length,lobed,long,margin,mature,maturity,mauve,mm,moderately,pedicel,petiole,poricidal,porrect-lepidote,prickle,primary,purple,red,rounded,secondary,sessile,shrub,sometimes,spherical,stellate,stellate-pubescent,stem,straight,strongly,surface,tapering,terminal,tip,tree,trichome,truncate,unarmed,unit,way,yellow,young	.8,0,0-5,0.05,0.05-0.15,0.1,0.1-0.2,0.15-0.3,0.6-1,0.9-0.17-2.2,1-1.2,1-1.7,1-6,1.1-1.5,1.5-2.2,1.5-5,1/10-1/6,1/3-1/2,11-16,2-10,2-3.1,2-4,2-5,2.2-2.5,2.8-3,2/3,20-60,22-30,3-15,4-10,4-9,4.5-7,5-10,5-20,5-7,5-merous,6-8,7-10,9-13-20,abaxial,abaxially,acut,acute,adaxial,alyx,apar,apart,apically,bark,blade,curved,densely,diameter,distal,eaf,eed,elongating,equal,faint,flattened-reniform,flower,free,fused,gently,glabrescent,glabrou,glabrous,glaucous,gray,green-brown,hermaphrodite,heterostylous,infructescence,lanceolate,less,lobe,long-styled,longer,lower,lowermost,midpoint,minutely,nflorescence,older,one,open,orange-brown,orolla,oung,pair,pale,peduncle,pendulous,per,pericarp,pitted,plant,plurifoliat,porrect,portion,prickly,pubescent,ray,reddi,reflexed,ruit,scar,shallowly,short-styled,shorter,simple,smooth,spaced,sparse,sparsely,spreading,stalk,stalked,staminat,stout,style,tamen,terete,tertiary,time,toward,tube,unarme,vary,vein,venation,visible,wide,woody,ympodial	appressed,articulation,bract,breeding,broad-based,cell,colour,connective,corolla,elengthating,form,growth,heteromorphism,inflorescence,insertion,interjected,interpetalar,leaflet,marking,modification,na,odour,orientation,paired,pattern,placement,plurifoliate,position,pseudostipule,rhizome,scale,shape,spot,staman,stone,structure,symmetry,sympodial,system,texture,tissue,tuber,type,xylopodia	/3,0-20,0.7-2,1/3-3/4,4.5-5.5,8-10,andromonoecious,apparently,articulated,base,berry,branched,branching,broadly,chartaceous,cm,connivent,cuneate,dark,deltate,discolorous,drying,entire,erect,evenly,flattened,foliaceous,fruit,green,lateral,length,lobed,long,mature,maturity,mauve,mm,moderately,poricidal,porrect-lepidote,prickle,primary,purple,red,rounded,secondary,sessile,shrub,sometimes,spherical,stellate,stellate-pubescent,stem,straight,strongly,surface,tapering,terminal,tip,tree,trichome,truncate,unarmed,way,yellow,young	broad-based,elengthating,na,plurifoliate
136	wfo-0001027317	success	144	94	64	71	73	23	61	3	.25,.5,0.1-0.2,0.4-1.5,0.8-3.5,1,1-1.5,1-2,1.4-1.6,1.5-2,2-9,3-3.5,?,acute,anther,apex,apically,base,berry,broadly,calyx,closely,cm,conical,corolla,densely,dia,ellipsoid,elliptic,erect,filament,fruit,fruiting,globose,golden,green,known,leaf,like,lobed,long,long-exserted,margin,mature,minute,mm,nearly,offset,opposite,pedicel,petiole,pointed,pore,poricidal,pubescent,rest,scar,shaped,shrub,simple,size,slightly,spaced,stem,tear-drop,tip,trichome,tube,uniseriate,white,x	0.3-1,0.5-1,0.5-3,1-5,2-3-flowered,4.5-5,7-9,abaxial,acuminate,adaxially,along,anthesi,apical,arch,ba,bark,beneath,bilobed,cucullate,deciduous,deflexed,deltoid,differing,difoliate,drying,eaf,edicel,eed,elongated,expanded,filiform,free,geminat,glabrous,greyish-whit,immature,inflorescenc,joined,lateral,lobe,lon,lower,main,major,minor,minutely,nflorescence,older,ovary,overlappin,pair,pale,papillo,papillose,portion,projection,prominent,reflexed,ruit,series,soon,sparsely,stigma,strongly,style,surface,tall,tub,ud,vein,woody,ympodia,young	branching,bud,colour,diameter,exsertion,form,growth,hair,height,inflorescence,information,length,marking,na,overlapping,plant,position,seed,shape,spot,symmetry,texture,type	.25,.5,0.1-0.2,0.4-1.5,0.8-3.5,1,1-1.5,1-2,1.4-1.6,1.5-2,2-9,3-3.5,?,acute,apex,apically,base,berry,broadly,calyx,closely,cm,conical,densely,dia,ellipsoid,elliptic,erect,fruit,globose,golden,green,known,leaf,like,lobed,long,long-exserted,mature,minute,mm,nearly,offset,opposite,pointed,poricidal,pubescent,rest,shaped,shrub,simple,slightly,spaced,stem,tear-drop,tip,trichome,tube,uniseriate,white,x	inflorescence,na,overlapping
137	wfo-0001027323	success	175	79	30	42	133	37	28	2	/3,0.5-1,1-1.5,2-6,anther,apex,attenuate,base,berry,calyx,corolla,difoliate,elliptic,filament,fruit,fruiting,furcate,glabrous,globose,leaf,lobed,margin,mm,occasionally,opposite,pedicel,petiole,pinkish-grey,plant,pore,poricidal,red-papillose,shaped,tear-drop,tip,treelet,tube,unit,way,white,winged,x	.75,1-2,1.2-1.5,10-15,14-21,2-3,2.5-3,20-45,3-5,5-20-flowered,5-7,6-11,7-9,acute,adaxial,along,anthesi,apparent,appearing,area,arising,asymmetric,ba,bark,broadened,bud,campanulate,character,closed,closely,cm,cork,decurrent,deflexed,densely,dia,differing,dried,dry,eaf,edicel,eed,elongate,entire,erect,erose,exserted,five-pointed,fleshy,flopping,flower,free,geminat,glabrate,grey,growing,held,higher,hood,hooded,immature,interpetalar,lateral,like,live,lobe,lon,long,long-triangular-deltoid,lower,main,major,matte,mature,measured,middle,minor,minutely,nflorescence,older,one,onto,ovary,overlapping,ovoid,ovoid-reniform,pair,papillae,papillo,papillose,partially,persistent,pitted,planar,portion,prominent,proximal,rather,reddish-grey,rest,ridge,ruit,scar,secondary,seen,sinus,size,slightly,small,smoot,soon,spaced,specimen,stem,stigma,straight,style,surface,tall,tan,thickened,thin,tiny,trunk,two,ud,upper,vein,visible,widest,woody,ympodial,young	articulation,bract,branching,breeding,cell,colour,connective,form,geminate,growth,hair,height,heteromorphism,inflorescence,insertion,length,marking,na,odour,orientation,placement,position,prickle,pseudostipule,rhizome,shape,spot,staman,stone,structure,symmetry,sympodial,system,texture,tuber,type,xylopodia	/3,0.5-1,1-1.5,2-6,attenuate,base,berry,difoliate,elliptic,furcate,glabrous,globose,leaf,lobed,mm,occasionally,opposite,pinkish-grey,poricidal,red-papillose,shaped,tear-drop,tip,treelet,way,white,winged,x	geminate,na
138	wfo-0001027340	success	189	206	134	147	42	59	128	6	0.5-0.9,1-10,1-2,1-3,1.5-2.7,10-16,16-22,2-3,2-4,2.5-4.5,3.5-5,3.5-9,4-6,4-7.5,5-11,5-6,6-8.5,7-18,7-8,8-14,8-9.5,abaxially,abruptly,absent,acumen,acuminate,adaxially,along,anther,apart,apex,apparently,articulated,articulation,auriculate,axillary,base,berry,blade,brownish,bud,cell,chartaceous,ciliate,cm,condition,connivent,cordate,corolla,dark,decreasing,diameter,digestion,distal,distinct,dorsally,drying,edge,elliptic,enzyme,especially,filament,flat,flower,folded,forked,fresh,fruit,generally,glabrous,globose,green,greenish,hair,half,herb,high,homostylous,honeycomb-shaped,indistinct,interjected,lanceolate,lateral,leaflet,lengthening,like,lilac-purple,lobe,long,lower,margin,membranous,midrib,minute,minutely,mm,narrow,narrowed,odd-pinnate,ovate,ovoid,pair,papillose,pedicel,peduncle,perfect,petiole,petiolulate,plant,plurifoliate,pointed,pore,poricidal,puberulent,pubescent,purple,removed,ripe,rotate,rounded,seed,sessile,short,shortly,size,slightly,slit,sparsely,splotched,stem,stigma,straight,style,subtending,terminal,testal,tinged,tip,tri-,truncate,tube,unit,usually,wall,whitish,wing,x	2-3.5,2.7-4.5,3-4,5-merou,ag,alyx,axe,capitat,covering,developing,eaf,eed,exceeding,geminat,glabrou,green-white,hair-like,hal,living,make,mucilaginous,nflorescence,orolla,purpl,ruit,semi-erec,semi-rosette,seudostipule,spaced,specimen,stamen,ste,tall,tamen,tem,thick,throughout,vary,wet,yellow,ympodial,young	5-merous,age,appressed,arrangement,bract,branching,breeding,broad-based,calyx,capitate,colour,connective,form,fruiting,geminate,growth,height,heteromorphism,inflated,inflorescence,insertion,interpetalar,leaf,length,marking,mature,modification,na,needle-like,odour,orientation,ovary,paired,pattern,placement,position,prickle,pseudostipule,rhizome,scale,shape,smell,spacing,spot,staman,stellate,stone,structure,surface,symmetry,sympodial,system,texture,tissue,trichome,tuber,type,vegetative,xylopodia	0.5-0.9,1-10,1-2,1-3,1.5-2.7,10-16,16-22,2-3,2-4,2.5-4.5,3.5-5,3.5-9,4-6,4-7.5,5-11,5-6,6-8.5,7-18,7-8,8-14,8-9.5,abaxially,abruptly,absent,acumen,acuminate,adaxially,along,apart,apex,apparently,articulated,auriculate,axillary,base,berry,brownish,bud,chartaceous,ciliate,cm,condition,connivent,cordate,corolla,dark,decreasing,diameter,digestion,distal,distinct,dorsally,drying,elliptic,enzyme,especially,flat,flower,folded,forked,fresh,fruit,generally,glabrous,globose,green,greenish,hair,half,herb,high,homostylous,honeycomb-shaped,indistinct,lanceolate,lateral,lengthening,like,lilac-purple,lobe,long,margin,membranous,midrib,minute,minutely,mm,narrow,narrowed,odd-pinnate,ovate,ovoid,papillose,perfect,petiolulate,plant,plurifoliate,pointed,pore,poricidal,puberulent,pubescent,purple,removed,ripe,rotate,rounded,sessile,short,shortly,size,slightly,slit,sparsely,splotched,stem,straight,subtending,terminal,tinged,tip,tri-,truncate,usually,wall,whitish,wing,x	5-merous,age,capitate,geminate,na,stellate
139	wfo-0001027354	success	166	115	51	67	99	48	49	2	.5,0,0.5-2,1-1.5,3.4-4,3/4,acute,age,anther,apex,appearing,base,becoming,berry,branch,branching,calyx,cm,conical,corolla,densely,elliptic,filament,fork,fruit,fruiting,globose,golden,growth,inserted,later,lateral,leaf,length,lobed,long,loosely,lower,mm,monochasial,narrowly,occasionally,pedicel,petiole,plurifoliate,pore,poricidal,pubescent,purplish-black,shrub,sleeve,slit-like,small,sparsely,stem,surface,terminal,time,tip,tree,tree-like,trichome,type,unit,violet,way,white	0.5,0.7-1.3,1,1-1.2,1-7,1.5-1.8,1.5-2,1.7-5,10,10-20,2.5-3.5,3-4,4-10,5-7,6.5-13,8-12,abaxial,abaxially,absent,adaxial,along,anthesi,apical,ba,bark,basal,belo,bi-lobed,blade,covered,dark,deltoid,dendritic,denser,diameter,dichasia,drying,eaf,edicel,eed,entire,erect,ew,exserted,flattened,flower,free,glabrate,glabrous,lenticular,less,like,lobe,loose,m.,minutely,mostly,near,nflorescence,nodding,older,ovary,pair,papillo,per,pericarp,pitted,planar,portion,pubescen,pyramidal,raised,reddish-brown,ruit,scar,secondary,side,simple,slightly,somewhat,stamen,stigma,strongly,style,tall,tapering,thecalyx,thin,tiny,tub,tube,ud,vein,wide,winged,woody,x,ympodial,young	appressed,articulation,bract,breeding,broad-based,cell,colour,connective,dichasial,form,hair,heteromorphism,inflated,inflorescence,insertion,interjected,interpetalar,leaflet,margin,marking,mature,modification,na,needle-like,odour,orientation,paired,pattern,placement,position,prickle,pseudostipule,rhizome,scale,shape,smell,spot,staman,stone,structure,symmetry,sympodial,system,texture,tissue,tuber,vegetative,xylopodia	.5,0,0.5-2,1-1.5,3.4-4,3/4,acute,age,appearing,base,becoming,berry,branch,branching,cm,conical,densely,elliptic,fork,globose,golden,inserted,later,lateral,lobed,long,loosely,mm,monochasial,narrowly,occasionally,plurifoliate,poricidal,pubescent,purplish-black,shrub,sleeve,slit-like,small,sparsely,terminal,time,tip,tree,tree-like,trichome,violet,way,white	dichasial,na
140	wfo-0001027359	success	220	115	51	63	157	52	46	5	.5,/3,0-3,0.3-1.2,0.5,anther,apex,apparently,base,berry,branched,bright,calyx,cell,chartaceous,cm,cream,cuneate,dark,difoliate,entire,equal,filament,fruit,fruiting,green,lateral,leaf,length,less,lobed,long,lower,margin,marking,mature,maturity,membranous,mm,moderately,pale,pedicel,petiole,poricidal,prickle,purple,red,reflexed,shrub,spherical,spreading,stellate,stellate-pubescent,stem,surface,tapering,terminal,tip,trichome,unit,way,white,young	-20,-3,-4,-7,.1,.2,/4,0-2,0-5,0-9,0.1,0.1-0.2,0.1-0.2-0.25,0.1-1.5,0.3-0.5,0.5-1,0.5-2,0.6-0.8,0.6-1,1-1.2,1-2,1-3,1-4,1-5,1.2-1.5-2,1.2-2,1.5-2,1.5-2.5,1.8-3.2,1/5-1/4,2-10,2-3,2-4,2.5-3.5,2.5-5.5,3-10,4-5,4-5-6.5,5-6-8-9,5-merous,6-8,7-8,abaxially,acut,acute,alyx,apar,apart,apically,articulated,ba,bark,blade,brow,concolorous,coroll,curved,deltate,densely,diameter,distinctive,drying,dull,eaf,eed,elongate,elongating,erect,eye,filiform,flattened,flattened-reniform,flower,free,geminat,glabrescent,glabrous,gray,herbaceous,infructescence,like,lobe,longer,midpoint,minutely,naked,narrow-deltate,narrow-ovate,near,nflorescence,obtuse,occasional,often,older,one,open,orange-brown,orolla,oung,outline,ovate,ovoid,pair,peduncle,per,perfec,pericarp,pit,porrect,portion,prickly,primary,rachi,raised,rarely,ray,reticulate,ruit,scandent,scar,sessile,shallowly,shorter,simple,slender,slightly,small,smooth,sometimes,spaced,sparsely,stalk,stalked,stump,style,tamen,terete,tertiary,time,tinge,tube,ud,unarme,unarmed,undulate,usually,variously,vary,vein,venation,visible,weakly,wide,woody,yellow,yellow-brown,ympodial	4-6.5,appressed,articulation,bract,branching,breeding,broad-based,colour,connective,corolla,form,geminate,growth,hair,heteromorphism,inflated,inflorescence,insertion,interjected,interpetalar,leaflet,modification,na,needle-like,odour,orientation,paired,pattern,perfect,placement,pore,position,present,pseudostipule,rhizome,scale,shape,smell,spot,staman,stone,structure,symmetry,sympodial,system,texture,tissue,tuber,type,vegetative,xylopodia,zygomorphy	.5,/3,0-3,0.3-1.2,0.5,apparently,base,berry,branched,bright,chartaceous,cm,cream,cuneate,dark,difoliate,entire,equal,green,lateral,less,lobed,long,marking,maturity,membranous,mm,moderately,pale,poricidal,prickle,purple,red,reflexed,shrub,spherical,spreading,stellate,stellate-pubescent,surface,tapering,terminal,tip,way,white,young	4-6.5,geminate,na,perfect,present
141	wfo-0001027366	success	136	90	32	42	94	48	30	2	0.5-1,1-2,2-2.5,acute,anther,apex,base,berry,bright,broadly,calyx,cm,conical,corolla,elliptic,filament,fruiting,glabrous,globose,green,greenish-white,internodal,leaf,lobed,long,margin,minutely,mm,opposite,orbicular,papillose,pedicel,petiole,pore,poridical,rounded,shaped,shrub,simple,sometimes,tear-drop,unit	.5,/2,/4,0.25-0.5,0.7-1,1-1.5,1-3,1.5-2,11-21,3-10-flowered,3-9,4-4.5,4-5,5-7,6-19,603,abaxially,adaxially,anthesi,ape,axe,ba,bark,brown,capitate,closely,conspicuously,dark,deflexed,deltate,dia,drying,eaf,edicel,eed,erect,et,except,exserted,fide,free,golden,lamina,lateral,less,lobe,lon,long-triangular,lower,main,middle,nflorescence,older,ovary,overlappin,ovoid,ovoid-reniform,packed,pair,pale,papillo,parallel,pitted,planar,pointed,portion,ramo,reddish,ruit,scar,secondary,shining,somewhat,stem,stigma,straight,style,surface,tall,tip,trichome,tub,tube,ud,unifoliat,vein,venation,way,wide,widest,woody,yellowish-gre,ympodial,young	appressed,articulation,bract,branching,breeding,cell,colour,connective,form,fruit,growth,hair,heteromorphism,inflated,inflorescence,insertion,interjected,interpetalar,leaflet,length,marking,mature,modification,na,odour,orientation,paired,pattern,placement,position,prickle,pseudostipule,rhizome,scale,shape,spot,staman,stone,structure,symmetry,sympodial,system,texture,tissue,tuber,type,unifoliate,xylopodia	0.5-1,1-2,2-2.5,acute,berry,bright,broadly,cm,conical,elliptic,glabrous,globose,green,greenish-white,internodal,leaf,lobed,long,minutely,mm,opposite,orbicular,papillose,poridical,rounded,shaped,shrub,simple,sometimes,tear-drop	na,unifoliate
142	wfo-0001027368	success	143	127	58	70	73	57	53	5	.5,0.3-2.5,0.5-3.5,0.5-5,1-2,1.5-2,2-9,3,4-6,5-15-20,5-6,acuminate,acute,adaxially,apex,articulated,base,calyx,cell,chartaceous,cm,cuneate,decurrent,deltate,densely,diameter,directed,distally,ellipsiodal,elliptic,elliptic-ovate,entire,forked,glabrous,globose,hair,lanceolate,lobe,margin,mm,moderately,narrowly,oblong,occasionally,ovoid-fusiform,pedicel,peduncle,petiole,pore,puberulent,pubescent,purple,rachi,radiu,shrub,simple,sparsely,stellate,stigma,stone,style,subcoriaceous,subhastate,triangular,truncate,unbranched,unit,unknown,white,x	-10,-15,-2-5,0.8-2,1-15-flower,1-6,1.5-2.5,2,2-2.5,2-3,2-4,3-12.5,4-many-foliat,5-10,8-13,abaxially,abruptly,absen,adaxiall,aggregate,also,apart,axe,ba,blade,branched,color,connivent,contiguous,cylindrical,darker,dendritically,denser,eaf,eed,except,gland,lenticular,lighter,long,long-stalked,lower,midvein,narrowed,nearly,nflorescence,nther,obtuse,often,orolla,otherwise,pubescen,ray,ruit,small,sometimes,spaced,stalked,star,subcapitat,tal,tem,terminal,three,time,tip,tube,usually,vary,vein,wide,yellow,ympodial	-5,4-many-foliate,abaxial,absent,adaxial,anther,articulation,bract,branching,breeding,colour,connective,corolla,filament,form,fruit,fruiting,growth,height,heteromorphism,inflorescence,insertion,interjected,interpetalar,leaf,leaflet,length,marking,mature,modification,na,odour,orientation,ovary,paired,pattern,placement,plant,position,prickle,pseudostipule,rhizome,scale,shape,spot,staman,stem,structure,subcapitate,symmetry,sympodial,system,texture,tissue,tuber,type,xylopodia	.5,0.3-2.5,0.5-3.5,0.5-5,1-2,1.5-2,2-9,3,4-6,5-15-20,5-6,acuminate,acute,adaxially,articulated,base,chartaceous,cm,cuneate,decurrent,deltate,densely,directed,distally,ellipsiodal,elliptic,elliptic-ovate,entire,forked,glabrous,globose,lanceolate,mm,moderately,narrowly,oblong,occasionally,ovoid-fusiform,puberulent,pubescent,purple,shrub,simple,sparsely,stellate,subcoriaceous,subhastate,triangular,truncate,unbranched,unknown,white,x	-5,4-many-foliate,absent,na,subcapitate
143	wfo-0001027369	invalid_json	188	60	NA	42	146	18	NA	NA	.5,.7,0-2,3-10,almost,anther,apex,base,berry,branched,calyx,cm,cordate,diameter,elongating,filiform,flower,fruit,fruiting,lateral,leaf,length,lobed,long,lower,margin,mauve,mm,narrowly,perpendicular,petiole,prickle,rounded,shrub,simple,spherical,spreading,stem,surface,tapering,terminal,winged	-10,-11,.1,.4,/4,0-1,0-15,0-3,0-5,0-6,0.05-0.15,0.1,0.1-0.2,0.1-0.3,0.2-0.5-1,0.25-0.4,0.3-1.5,0.5,0.5-0.8,0.5-1.5,0.6-0.8,1-2,1-2-4,1-2.5,1-3,1-4,1.2-2.5,1.2-3,1.5-2,1/3,2-3,2-5,3,3-4,4-5,4-8,5,5-merous,7-15,abaxially,acut,alyx,ame,apar,apart,apically,apparently,articulated,bark,blade,broad-deltate,c.,color,concolorous,curved,deltate,densely,difoliate,distance,drying,eaf,eed,equal,erect,extending,eye,filament,free,geminat,glabrou,glabrous,glaucous,gra,green,hair,herbaceous,infructescence,know,known,lanceolate,less,lobe,lon,mature,membranous,midpoint,midvein,moderately,multangulate,naked,nflorescence,older,one,open,orbicular,orolla,oung,pale,pedicel,peduncle,pendulous,per,perfec,pericarp,poricidal,porrect,portion,prickl,prickly,ray,reflexed,reniform,ruit,scandent,scar,sessile,side,slender,slightly,smooth,spaced,sparsely,stalk,stalked,stellate,stellate-pubescent,straight,strongly,style,tamen,terete,time,tip,trichome,tube,unarmed,unequal,unit,vary,venation,visible,way,wide,wider,yellow,ympodial	-5.5,2-4,branching,broad-based,characteristic,colour,corolla,form,growth,inflorescence,needle-like,number,orientation,placement,position,shape,type,value	NA	NA
144	wfo-0001027378	success	149	79	44	48	101	31	32	12	.2,anther,base,berry,blue,broadly,calyx,chartaceous,cm,cordate,deeply,extra-axillary,filament,fleshy,fruit,fruiting,leaf,light,margin,membranous,minutely,mm,ovate,ovoid,pedicel,peduncle,pentagonal,petiole,pubescent,rachi,revolute,rotate-stellate,simple,small,somewhat,spaced,sparsely,stigma,style,tooth,trichome,unbranched,unit,unknown,vine,white,widely,x	0.5–1,0.7–1,0.8–2.5,1.2–1.5,1.2–1.8,1.5–1.8,1.5–8,15–35,1–1.5,1–3,2.3–5,2.5–7,2–11,2–2.2,2–2.5,3–4.5,3–5,3–6,4–6,4–9,5-8,5-merous,5–10,5–13,5–7,6–10,6–7,abaxially,acuminate,acute,adaxial,adaxially,alyx,apar,apex,apicall,axe,blade,c.,capitat,ciliate,clavate,climbin,color,cylindrical,deltoid,densely,diameter,eaf,eed,flattened,flower,glabrou,glabrous,hair,hair-tipped,half,herbaceous,lanceolate,like,lobe,lon,long,longer,lower,m.,markedly,moderately,narrowly,nflorescence,nternode,obscure,often,orolla,palmate,papillose,perfec,plurifoliat,pointed,primary,rounded,ruit,sand-punctat,sand-punctate,scattered,short,side,slender,slightly,stem,tamen,tem,terrestrial,tip,tube,unknow,vary,vein,venation,wide,ympodial	0.2,0.7-1,0.8-2.5,15-35,2-11,2-2.2,2.5-7,4-6,5-10,articulation,branching,capitate,cell,colour,corolla,form,growth,heteromorphism,inflorescence,internode,length,na,plurifoliate,position,shape,staman,stone,structure,sympodial,texture,type	.2,berry,blue,broadly,chartaceous,cm,cordate,deeply,extra-axillary,fleshy,light,membranous,minutely,mm,ovate,ovoid,pentagonal,pubescent,revolute,rotate-stellate,simple,small,somewhat,spaced,sparsely,tooth,unbranched,unknown,vine,white,widely,x	0.2,0.7-1,0.8-2.5,15-35,2-11,2-2.2,2.5-7,4-6,5-10,capitate,na,plurifoliate
145	wfo-0001027378	success	141	122	70	87	54	35	64	6	.2,0.7-1,0.8-2.5,1-1.5,1.5-1.8,1.5-8,15-35,2-11,2-2.2,2-4,2.5-7,3-4.5,3-5,4-6,5-13,6-10,abaxially,acuminate,acute,anther,apex,base,blue,broadly,calyx,chartaceous,clavate,climbing,cm,cordate,cylindrical,deeply,diameter,directed,distally,extra-axillary,filament,fleshy,flower,fruit,fruiting,glabrous,hair,herb,lanceolate,large,leaf,light,lobe,longitudinal,margin,minutely,mm,node,oblong,opening,ovate,pedicel,peduncle,perfect,petiole,pore,pubescent,rachi,revolute,rooting,rotate-pentagonal,rounded,simple,slender,slit,small,somewhat,spaced,sparsely,stigma,style,terrestrial,tip,tooth,trailing,tube,unbranched,unknown,white,widely,x	1-3,1.2-1.5,2.3-5,3-6,4-9,5-8,5-merou,6-7,adaxially,ag,alyx,apart,apicall,apparently,articulated,axe,ba,basally,blade,capitat,ciliate,connivent,deltoid,densely,eaf,eed,equal,geminat,hair-tipped,long,longer,lower,moderately,multicellular,narrowly,nflorescence,obscure,often,orolla,plurifoliate,pubescen,scattered,short,slightly,tamen,tem,unit,unknow,vary,vein,weakly,wide,yellow,ympodial	abaxial,adaxial,age,articulation,branching,breeding,capitate,colour,connective,corolla,form,greyish,growth,habit,inflorescence,length,marking,modification,na,ovary,pattern,plant,position,seed,shape,size,spot,staman,stellate,stem,symmetry,system,texture,type,zygomorphy	.2,0.7-1,0.8-2.5,1-1.5,1.5-1.8,1.5-8,15-35,2-11,2-2.2,2-4,2.5-7,3-4.5,3-5,4-6,5-13,6-10,abaxially,acuminate,acute,base,blue,broadly,chartaceous,clavate,climbing,cm,cordate,cylindrical,deeply,directed,distally,extra-axillary,fleshy,glabrous,herb,lanceolate,large,light,longitudinal,minutely,mm,node,oblong,ovate,perfect,pubescent,revolute,rotate-pentagonal,rounded,simple,slender,slit,small,somewhat,spaced,sparsely,terrestrial,tooth,trailing,unbranched,unknown,white,widely,x	age,capitate,greyish,na,stellate,zygomorphy
146	wfo-0001027384	success	155	147	75	95	60	52	73	2	0.4-1.1,0.5-1,0.9-1,1-3,1-4,1.5-2,2.5-6.5,3-3.5,3-4,4-7,5-15-flowered,5-5.5,7-14,7.5-8,anther,anthesi,apart,apex,bark,base,berry,breaking,bud,calyx,capitate,clavate,closely,cm,corolla,cuneate,deep,difoliate,drying,ellipsoid,erect,filament,flattened-reniform,fruiting,geminate,glabrous,globose,green,incrassate,later,lateral,leaf,lobed,long,long-exserted,main,margin,minutely,mm,mustard,narrowly,obovate,older,opposite,ovary,overlapping,pair,pale,papillose,pedicel,petiole,pitted,pore,pseudo-terminal,rarely,reddish-purple,scar,section,shaped,shining,shrub,small,spaced,stem,stigma,style,surface,tear-drop,transverse,tree,tube,uniseriate,unit,vein,white,widely,woody,x,yellow,yellowish,young	.25,.5,.75,/3,1-1.3,1-1.5,3/4,abov,acute,anothe,ba,beginning,beneath,broadly,brown,dia,distal,eaf,edicel,eed,equal,free,hard,herbarium,inflorescenc,lobe,lower,member,middle,nflorescence,occasionally,paler,papillo,peeling,planar,poricidal,portion,prominent,rounded,ruit,simple,siz,slender,specimen,straight,subcoriaceous-fleshy,sulcate,tall,tapering,thick,tip,triangular,trichome,tub,tuft,ud,way,widest,without,ympodial	1.5,articulation,bract,branching,breeding,cell,colour,connective,diameter,flower,form,fruit,growth,hair,height,heteromorphism,inflorescence,insertion,interjected,interpetalar,leaflet,length,marking,na,number,odour,orientation,pattern,placement,plant,position,prickle,pseudostipule,rhizome,scale,seed,shape,size,spacing,spot,staman,stone,structure,symmetry,sympodial,system,texture,tissue,tuber,type,venation,xylopodia	0.4-1.1,0.5-1,0.9-1,1-3,1-4,1.5-2,2.5-6.5,3-3.5,3-4,4-7,5-15-flowered,5-5.5,7-14,7.5-8,apart,berry,calyx,capitate,clavate,closely,cm,cuneate,deep,difoliate,ellipsoid,erect,flattened-reniform,geminate,glabrous,globose,green,incrassate,later,lateral,leaf,lobed,long,long-exserted,main,minutely,mm,mustard,narrowly,obovate,opposite,overlapping,pair,pale,papillose,pitted,pseudo-terminal,rarely,reddish-purple,section,shaped,shining,shrub,small,spaced,surface,tear-drop,transverse,tree,tube,uniseriate,vein,white,widely,woody,x,yellow,yellowish,young	1.5,na
147	wfo-0001027389	success	154	102	46	54	100	48	43	3	.5,0.25-0.3,1,1.8-1.9,anther,apex,base,berry,calyx,cm,corolla,deflexed,dia,elliptic,except,expanded,filament,foetid,fruiting,geminate,glabrous,globose,green,inflorescence,leaf,lobed,long,margin,minutely,mm,nearly,node,non-reproductive,opposite,ovate,papillose,pedicel,petiole,pore,poricidal,puberulent,shaped,shrub,sparsely,surface,tear-drop,tip,trichome,truncate,uniseriate,unit,white,woody,x	.1,.25,0.25-0.5,0.5-0.75,0.5-1.5,0.6-1,1-1.5,1-2,11-14,2-2.5,3-3.5,3-4.5,4-5-flowered,5-7,7-8,acuminate,acute,along,anthesi,apart,ba,bark,beneath,broadening,broadly,brown,bud,conical,dark,decurrent,deltoid,dry,eaf,edicel,eed,ellipsoid,erect,evenly,exserted,filiform,foliage,free,hispidulous,lateral,like,lobe,lon,lower,main,making,material,middle,nflorescence,obovoi,occasionally,often,older,one,ovary,ovoid-reniform,pair,paler,papillo,pitted,portion,prominent,prominently,proximal,raise,raised,reddish-golden,reflexed,rest,ruit,scar,shin,side,simple,slender,slight,slightly,soon,spaced,stem,stigma,straight,style,tall,tapering,thread-like,top,tube,ud,unifoliat,vein,widest,winged,yellowish,ympodial,young	appressed,articulation,bract,branching,breeding,cell,colour,connective,form,fruit,growth,hair,heteromorphism,inflated,insertion,interjected,interpetalar,leaflet,length,marking,mature,modification,na,odour,orientation,paired,pattern,placement,position,prickle,pseudostipule,rhizome,scale,shape,spot,staman,stone,structure,symmetry,sympodial,system,texture,tissue,tuber,type,unifoliate,xylopodia,zygomorphy	.5,0.25-0.3,1,1.8-1.9,apex,base,berry,cm,deflexed,dia,elliptic,except,expanded,foetid,geminate,glabrous,globose,green,leaf,lobed,long,minutely,mm,nearly,node,non-reproductive,opposite,ovate,papillose,poricidal,puberulent,shaped,shrub,sparsely,surface,tear-drop,tip,trichome,truncate,uniseriate,white,woody,x	na,unifoliate,zygomorphy
148	wfo-0001027395	success	153	156	75	95	58	61	71	4	.25,.5,0.25-0.5,0.75-1,1-1.5,1-2,1-5,1.1-1.5,1.5-1.9,1.5-2.5,12.5-17.3,2-3,3.5-4,4-6,5-6.5,8,anther,anthesi,apex,apically,apiculate,attenuate,bark,base,beginning,calyx,capitate,closely,cm,constricted,corolla,cucullate,deflexed,deltoid,densely,dia,difoliate,erect,exserted,filament,fleshy,fruit,fruiting,glabrous,globose,green,immature,imperceptibly,known,leaf,lobe,lobed,lower,margin,minutely,mm,narrowly,nearly,obovate,occasionally,once-furcate,opposite,ovary,overlapping,ovoid,papillose,partially,pedicel,petiole,piece,pointed,pore,pubescent,scar,shaped,shrub,simple,size,small,somewhat,spaced,stem,stigma,style,tapering,tear-drop,thickened,tip,transverse,trichome,tube,uniseriate,unit,white,x	0.6-1.1,1.6-2.9,10-20-flowered,11-15,2.2-7,acute,becoming,beneath,berry,black,caly,conical,decurrent,depressed,differing,drying,eaf,edicel,eed,enlarging,exfoliating,free,geminat,inflorescenc,large,lateral,lon,long,main,major,midrib,minor,nflorescence,older,pair,papillo,planar,poricidal,portion,primary,raised,restricted,robust,ruit,rusty-papillate,secondary,shining,shiny,straight,tall,thick,ud,vein,within,without,woody,ympodial,young	10-20,abaxial,adaxial,bract,branching,breeding,broad-based,bud,cell,colour,connective,diameter,exfoliation,exsertion,flower,form,geminate,growth,hair,height,heteromorphism,inflorescence,information,interjected,interpetalar,leaflet,length,marking,modification,na,needle-like,number,odour,orientation,papillae,pattern,placement,plant,position,prickle,pseudostipule,rhizome,scale,seed,shape,smell,spacing,spot,staman,stone,structure,surface,symmetry,sympodial,system,texture,tissue,tuber,type,vegetative,xylopodia	.25,.5,0.25-0.5,0.75-1,1-1.5,1-2,1-5,1.1-1.5,1.5-1.9,1.5-2.5,12.5-17.3,2-3,3.5-4,4-6,5-6.5,8,apically,apiculate,attenuate,base,beginning,calyx,capitate,closely,cm,constricted,cucullate,deflexed,deltoid,densely,dia,difoliate,erect,exserted,fleshy,glabrous,globose,green,immature,imperceptibly,known,leaf,lobe,lobed,minutely,mm,narrowly,nearly,obovate,occasionally,once-furcate,opposite,overlapping,ovoid,papillose,partially,piece,pointed,pubescent,shaped,shrub,simple,small,somewhat,spaced,tear-drop,thickened,transverse,uniseriate,white,x	10-20,geminate,inflorescence,na
149	wfo-0001027396	success	241	157	99	107	134	50	96	3	/3,0-4,0-5,0.1-1,0.5-1.5,1,1/4-1/3,1/6,15-40,20-100,3-4-5-6,4-6,5-50,5.5-7.5,6.5-7.5,abaxially,almost,andromonoecious,anther,apart,apex,articulated,attenuate,base,berry,blade,calyx,chartaceous,cm,concolorous,connivent,cream,cuneate,dark,decurrent,densely,difoliate,discolorous,drying,elongate,erect,filament,flattened,flower,fruit,fruiting,glabrous,green,hair,herb,lateral,leaf,length,less,lobe,lobed,long,long-styled,lower,margin,marking,mature,maturity,mauve,midpoint,mm,moderately,often,pale,pedicel,perpendicular,petiole,poricidal,porrect,prickle,prickly,pubescent,purple,ray,reflexed,rotate,sessile,short-styled,shrub,side,simple,sometimes,somewhat,spaced,sparsely,spherical,stellate-pubescent,stem,straight,surface,tapering,tearing,tip,trichome,unbranched,unit,usually,way,white,yellow,yellowish,young	0-100,0-3,0-30,0.1-0.5,0.4-0.7,0.5-1,0.5-2,0.5-2.5,0.7-2.5,0.8,0.8-1.3,1-2,1-4,1.2-2,1.5-3,1.5-3.5,1.8-3,1/2-2/3,1/3,10-15,10-25,10-30,10-35,12-25,2-3,2-3.5,2-7,2.5-4,2.8-4.5,3-9,3.5-6,4-5,4-7,5-10,5-20,5-30,5-8,5-merous,6-20,7-10,7-15,8-20,abaxial,acute,adaxial,alyx,ame,apar,apically,apparently,ba,bark,black,broad,broad-deltate,brown,bulbous,c.,curved,deltate,diameter,distal,distance,eaf,eed,elliptic,elongating,equal,extending,extensive,fewer,flattened-reniform,free,fully,geminat,glabrescent,glandular,gray-brow,hermaphrodite,heterostylous,infructescence,lignified,lobing,lon,long-acuminat,longer,lowermost,midvein,near,nflorescence,obtuse,older,one,open,opening,orange,orolla,oung,pair,peduncle,pendulous,per,pericarp,plant,portion,prickl,primary,red-brown,ruit,scar,secondary,smooth,spreading,stalk,stalked,staminat,stout,style,tamen,terete,tertiary,time,tube,unarmed,upper,variously,vary,vein,venation,visible,wide,woody,yellow-green,ympodial	appressed,articulation,bract,branching,breeding,broad-based,cell,colour,connective,corolla,form,geminate,growth,heteromorphism,inflated,inflorescence,insertion,interjected,interpetalar,leaflet,modification,na,needle-like,odour,orientation,paired,pattern,placement,pore,position,pseudostipule,rhizome,scale,shape,smell,spot,staman,stellate,stone,structure,symmetry,sympodial,system,texture,tissue,tuber,type,vegetative,xylopodia,zygomorphy	/3,0-4,0-5,0.1-1,0.5-1.5,1,1/4-1/3,1/6,15-40,20-100,3-4-5-6,4-6,5-50,5.5-7.5,6.5-7.5,abaxially,almost,andromonoecious,apart,articulated,attenuate,base,berry,blade,chartaceous,cm,concolorous,connivent,cream,cuneate,dark,decurrent,densely,difoliate,discolorous,drying,elongate,erect,flattened,flower,fruit,glabrous,green,herb,lateral,leaf,length,less,lobe,lobed,long,long-styled,marking,mature,maturity,mauve,midpoint,mm,moderately,often,pale,perpendicular,poricidal,porrect,prickle,prickly,pubescent,purple,ray,reflexed,rotate,sessile,short-styled,shrub,side,simple,sometimes,somewhat,spaced,sparsely,spherical,stellate-pubescent,stem,straight,surface,tapering,tearing,tip,trichome,unbranched,usually,way,white,yellow,yellowish,young	geminate,na,stellate
150	wfo-0001027449	success	160	96	39	48	112	48	36	3	.4,0.8-1.5,3-3.5,acute,anther,apex,base,beneath,berry,calyx,cm,corolla,difoliate,elliptic,filament,fruit,fruiting,glabrous,globose,green,inflorescence,leaf,lobed,long,minutely,mm,narrowly,oblique,often,opposite,papillose,pedicel,persistent,petiole,pore,poricidal,pubescent,shaped,shrub,small,tear-drop,tip,tree,uniseriate,unit,white,woody,x	.5,.75,/3,0.5-1,0.5-1.5,0.9-1.1,1.2-1.5,1.4-1.5,1.5-2.5,10-15-flowered,2-3,2-4,3,3-7,4-6,5-6,8-15,acuminate,anthesi,appearing,area,arising,around,axil,bark,becoming,beginning,brown,bud,closely,cup,dark,deciduous,deflexed,dense,densely,density,dia,differing,dry,eaf,edicel,eed,ellipsoid,erect,exserted,extreme,forming,free,frui,geminat,glabrate,inflorescenc,lamina,later,lateral,like,lobe,lon,long-acuminate,long-triangular,lower,main,major,material,minor,nflorescence,obconic,older,one,orangish,ovary,overlapping,ovoid-reniform,packed,pair,pale,pitted,pointed,portion,prominent,raised,red-papillose,reddish-brow,reflexed,rest,ruit,scar,simple,size,slender,soon,sparse,sparsely,stem,stigma,straight,styl,style,surface,tall,tapering,trichome,trunk,tube,tuft,ud,varying,vein,way,ympodial,young	appressed,articulation,bract,branching,breeding,cell,colour,connective,form,geminate,growth,hair,heteromorphism,inflated,insertion,interjected,interpetalar,leaflet,length,margin,marking,mature,modification,na,odour,orientation,paired,pattern,placement,position,prickle,pseudostipule,rhizome,scale,shape,spot,staman,stone,structure,symmetry,sympodial,system,texture,tissue,tuber,type,xylopodia,zygomorphy	.4,0.8-1.5,3-3.5,acute,beneath,berry,cm,difoliate,elliptic,fruit,glabrous,globose,green,leaf,lobed,long,minutely,mm,narrowly,oblique,often,opposite,papillose,persistent,poricidal,pubescent,shaped,shrub,small,tear-drop,tip,tree,uniseriate,white,woody,x	geminate,na,zygomorphy
151	wfo-0001027452	success	152	128	72	86	66	42	68	4	.5,0.5-1,0.5-2,1,1-2,1-3,1-5,1.5,10-20,2-4,2-foliate,3-9,4,4-6,5-12,5-20,absent,acute,anther,apex,base,blade,branched,brown,calyx,cell,celled,center,chartaceous,ciliate,cm,connected,cordate,densely,diameter,dm,drying,elliptic,elliptic-ovoid,entire,filament,flower,fruit,glabrous,globose,hair,herb,immature,large,long,margin,membranaceous,mm,moderately,nearly,notched,oblong,obtuse,outer,pedicel,peduncle,per,perpendicular,petiole,placenta,pubescent,rachi,raised,ridge,rotate,rounded,running,seed,semitransparent,significantly,single,smoother,sparsely,style,swollen,unbranched,unit,usually,white,x,yellow	0.5-1.5,0.5-2.5,1-4.5,1.5-3,2-6,3-6,abaxially,abundant,adaxiall,adaxially,along,axe,berry,beyond,decurrent,dehiscing,denser,eaf,eed,emarginat,equal,explosively,exserted,flat,frui,geminat,growt,held,interpetalar,linear-lanceolate,lobe,lower,lying,maturing,maturit,mesocarp,new,nfloresence,often,one-,orolla,parallel,pressure,pubescen,ruit,short,slightly,smaller,sometimes,stamen,stigma,straight,tal,tamen,tem,tissue,triangular,tube,two-celled,vary,vein,wall,watery,wid,woody,ympodial	bract,branching,colour,corolla,decurren,emarginate,form,fruiting,geminate,growth,height,heteromorphism,inflorescence,interjected,leaf,leaflet,length,marking,modification,na,notching,number,orientation,ovary,placement,pore,position,prickle,pubescence,rhizome,shape,spot,staman,stem,stone,structure,symmetry,sympodial,texture,tuber,type,xylopodia	.5,0.5-1,0.5-2,1,1-2,1-3,1-5,1.5,10-20,2-4,2-foliate,3-9,4,4-6,5-12,5-20,absent,acute,branched,brown,celled,chartaceous,ciliate,cm,connected,cordate,densely,dm,drying,elliptic,elliptic-ovoid,entire,flower,fruit,glabrous,globose,hair,herb,immature,large,long,margin,membranaceous,mm,moderately,nearly,notched,oblong,obtuse,perpendicular,placenta,pubescent,raised,ridge,rotate,rounded,running,semitransparent,significantly,single,smoother,sparsely,swollen,unbranched,usually,white,x,yellow	decurren,emarginate,geminate,na
152	wfo-0001027471	success	165	180	103	126	39	54	101	2	.5,/4,0.1-0.2,0.2-0.4,0.2-0.5,0.4-1,0.5-0.6,0.5-0.7,1-1.6,1.4-3,1.5-2,2-2.5,2-lobed,3-7,4-5,6-7,acute,adaxially,age,along,anther,anthesi,apex,appressed,ascending,bark,base,berry,bifid,branched,brittle,calyx,closely,cm,conical,corolla,dendritic,densely,desnsely,diameter,difoliate,distant,drying,elliptic,entire,filament,flattened,fruiting,geminate,glabrous,globose,growth,herb,inflorescence,internodal,leaf,leaf-opposed,lengthening,less,like,lobed,lower,major,margin,maturity,midvein,minor,minutely,mixture,mm,new,nodding,occasionally,orbicular,ovary,ovate,overlapping,pair,pale,pedicel,peduncle,perfect,pericarp,petal,petiole,pitted,plane,pore,poridical,primary,pubescent,pubscent,rachi,red-orange,reniform,scar,scattered,shape,shrub,similar,simple,size,slit,small,somewhat,spaced,sparsely,stem,stigma,straight,style,subshrub,surface,tan,thickened,thin,tip,trichome,uniseriate,unit,usually,vein,way,white,x,yellowish	0.5,0.5-1.5,0.7-0.9,0.9-1,1-1.2,1-1.5,2-3,3-4,abaxially,c.,deltate,differing,eaf,eed,erec,erect,especially,flower,free,furcate-dendritic,included,lamina,lobe,long-triangular,nflorescence,node,open-conical,papillat,planar,portion,reflexed,ruit,slender,slightly,trifoliat,tube,ud,woody,ympodial	arrangement,articulation,bract,branching,breeding,broad-based,bud,cell,colour,connective,form,fruit,hair,heteromorphism,inflated,insertion,interjected,interpetalar,leaflet,length,marking,mature,modification,na,needle-like,odour,orientation,paired,papillate,pattern,placement,position,prickle,pseudostipule,pubescence,rhizome,scale,seed,smell,spacing,spot,staman,stone,structure,symmetry,sympodial,system,texture,thicknes,tissue,tuber,type,vegetative,xylopodia	.5,/4,0.1-0.2,0.2-0.4,0.2-0.5,0.4-1,0.5-0.6,0.5-0.7,1-1.6,1.4-3,1.5-2,2-2.5,2-lobed,3-7,4-5,6-7,acute,adaxially,age,along,anthesi,apex,appressed,ascending,base,berry,bifid,branched,brittle,closely,cm,conical,dendritic,densely,desnsely,diameter,difoliate,distant,drying,elliptic,entire,flattened,geminate,glabrous,globose,herb,inflorescence,internodal,leaf,leaf-opposed,lengthening,less,like,lobed,major,maturity,midvein,minutely,mixture,mm,nodding,occasionally,orbicular,ovate,overlapping,pair,pale,perfect,petal,pitted,plane,pore,poridical,pubescent,pubscent,rachi,red-orange,reniform,scattered,shrub,similar,simple,slit,small,somewhat,spaced,sparsely,stem,straight,subshrub,tan,thickened,thin,tip,trichome,uniseriate,usually,way,white,x,yellowish	na,papillate
153	wfo-0001027473	success	138	135	63	79	59	56	61	2	.25,0.25-0.5,0.5-1,0.8-1,1-1.5,1-2,1.3-2,1.5-2,1.8-2,2-2.5,2.5-3,3.5-5,4.5-13,8.5-37,?,along,anther,apex,base,berry,brown,calyx,clavate,cm,conical,corolla,decurrent,deflexed,dendritic,densely,denser,di-,filament,flattened-reniform,fruiting,glabrous,globose,green,incrassate,leaf,less,lobe,lobed,long-triangular,margin,minutely,mm,near,obovate,occasionally,ovary,pedicel,petiole,pitted,pointed,pore,poricidal,pubescent,rootstock,rusty,sessile,shape,shaped,shrub,somewhat,stem,stigma,style,subshrub,surface,tear-drop,tip,trichome,trifoliate,tube,unit,vein,white,woody	/2,1/3,5,6-9,abaxially,absen,acute,adaxially,anthesi,ape,apparently,bark,deccurent,deep,dia,differing,drying,eaf,eed,empty,erect,free,geminat,giving,later,lateral,like,long,lower,main,major,middle,minor,minute,older,overall,pair,pale,papillo,planar,portion,pubesent,ruit,sac,sparsely,sterile,strongly,tall,thick,usually,way,wide,widest,wing,winged,yellowish,yellowish-brow,ympodial,young	absent,appressed,arrangement,articulation,bract,branching,breeding,cell,colour,connective,deflexion,density,diameter,flower,form,fruit,growth,hair,height,heteromorphism,inflated,inflorescence,insertion,interjected,interpetalar,leaflet,length,marking,mature,modification,na,odour,orientation,paired,pattern,placement,plant,position,prickle,pseudostipule,rhizome,scale,seed,spot,staman,stone,structure,symmetry,sympodial,system,texture,tissue,tuber,type,width,xylopodia	.25,0.25-0.5,0.5-1,0.8-1,1-1.5,1-2,1.3-2,1.5-2,1.8-2,2-2.5,2.5-3,3.5-5,4.5-13,8.5-37,?,along,apex,base,berry,brown,clavate,cm,conical,decurrent,deflexed,dendritic,densely,denser,di-,flattened-reniform,glabrous,globose,green,incrassate,less,lobed,long-triangular,margin,minutely,mm,near,obovate,occasionally,pitted,pointed,poricidal,pubescent,rusty,sessile,shaped,shrub,somewhat,stem,subshrub,tear-drop,tip,trichome,trifoliate,vein,white,woody	absent,na
154	wfo-0001027483	success	164	134	70	79	85	55	62	8	0.6,1-4,1-5,1.5-3,2-4.5,3-6,5-6,abaxially,adaxially,apex,apical,apically,articulate,base,branched,calyx,cell,cm,coarsely,connate,corolla,cuneate,dehiscent,diameter,dichasially,distal,dot,ebracteate,filament,finely,generally,globose,green,green-white,hair-like,half,herbaceous,interjected,interpetiolar,introrse,leaf,leaflet,light,lighter,long,maturing,medium,mm,mucilaginous,odd-pinnate,often,ovoid,pattern,pedicel,perennial,perfect,petiole,plant,poricidally,proximal,pubescent,purple,ray,rotate,rounded,seed,short,slit,smooth,stigma,style,throughout,tuber-bearing,uniform,unit,violet,violet-purple,white,¼	0-1.,0.2-1.9,1,1-2,1-2.5,1.2-2.5,1.5-10,1.5-2.6,2,2-3,2-4,3-15,3-6-foliat,3.5-20,4.5-8,5-10,acumen,acute,basal,covering,cyme,decurrent,dichasial,digestion,diminishing,dorsally,eaf,edge,eed,elliptical,emoval,enzyme,erec,exceeding,flat,flower,folded,forked,globo,gradually,honeycomb,lateral,living,lobe,lon,lower,lunat,make,minute,monochasial,nflorescence,nther,obtuse,orolla,ovate,pair,peduncle,petiolule,plan,rachi,reveal,rosette,ruit,sessile,seudostipule,size,sometimes,specimen,stamen,straight,subsessile,tall,tem,terminal,testal,thick,tissu,toward,typically,vary,varying,wall,wide,yellow,ympodial	0-10,3-6-foliate,anther,appressed,articulation,bract,branching,breeding,colour,connective,form,fruit,fruiting,growth,hair,height,heteromorphism,inflated,inflorescence,insertion,interpetalar,length,lunate,margin,marking,mature,modification,na,odour,orientation,paired,placement,pore,position,prickle,pseudostipule,rhizome,scale,shape,spot,staman,stem,stone,structure,symmetry,sympodial,system,texture,tissue,tuber,type,wet,xylopodia,ye,zygomorphy	0.6,1-4,1-5,1.5-3,2-4.5,3-6,5-6,abaxially,adaxially,apical,apically,articulate,branched,cm,coarsely,connate,cuneate,dehiscent,dichasially,distal,dot,ebracteate,finely,generally,globose,green,green-white,hair-like,half,herbaceous,interpetiolar,introrse,light,lighter,long,maturing,medium,mm,mucilaginous,odd-pinnate,often,ovoid,perennial,perfect,plant,poricidally,proximal,pubescent,purple,ray,rotate,rounded,short,slit,smooth,throughout,tuber-bearing,uniform,violet,violet-purple,white,¼	0-10,3-6-foliate,lunate,na,tissue,wet,ye,zygomorphy
155	wfo-0001027506	success	213	127	67	78	135	49	63	4	.5,/2,/6,0.5-1.5,2.5-8,5-10,6-13,andromonoecious,anther,apex,articulated,base,becoming,berry,branched,brown,calyx,cell,chartaceous,cm,connivent,cordate,cream,cuneate,curved,dark,densely,elongating,entire,equal,erect,filament,flattened,fruit,fruiting,green,lateral,leaf,length,lobed,long,lower,margin,marking,mature,maturity,mauve,mm,orange,pale,pedicel,petiole,poricidal,prickle,purple,reflexed,shrub,simple,small,sometimes,spherical,stellate,stellate-pubescent,stem,subentire,surface,tapering,terminal,tip,tree,trichome,truncate,twice,unit,way,wide,yellow,young	-20,-3,-7,-7.5,.2,0-1,0-10,0-2,0-6,0-60,0.1-0.2-0.3-0.35,0.1-0.3,0.2,0.2-0.3,0.25,0.5-6,0.7-1.3,0.8-1.5,1-2,1-3,1-4,1.2-1.5,1.5-2.2,1.8,1/3,1/6-1/4,10-40,2-3.2,2.2-3.5,2.5-5,3-10,3-5,3-6,3.5-5,5-7,5-merous,6.5-10,7-8,7-9,8-10,9-13,abaxially,acuminat,acuminate,acute,alyx,ame,apar,apart,apically,apparently,bark,blade,brow,c.,concolorous,diameter,distal,dry,drying,eaf,eed,fine,flattened-reniform,flower,free,glabrescent,glabrous,hard,hermaphrodite,heterostylous,infructescence,lengt,lobe,long-styled,longer,lowermost,midpoint,moderately,multangulate,narrow-deltate,nflorescence,occasionally,older,one,open,orange-brown,orolla,oung,outline,ovate,pair,peduncle,pendulous,per,pericarp,pit,plant,plurifoliat,porrect,portion,prickl,prickly,primary,raised,ray,reddish,reduced,ruit,scar,sessile,short-styled,smooth,spaced,spreading,stalk,stalked,staminat,stout,style,tamen,terete,tertiary,time,tube,unarmed,upper,variously,vary,vein,venation,visible,woody,yellow-green,ympodial	appressed,articulation,bract,branching,breeding,broad-based,colour,connective,corolla,form,growth,hair,heteromorphism,inflated,inflorescence,insertion,interjected,interpetalar,leaflet,modification,na,needle-like,odour,orientation,paired,pattern,placement,plurifoliate,pore,position,pseudostipule,rhizome,scale,shape,smell,spot,staman,stone,structure,symmetry,sympodial,system,texture,tissue,tuber,type,vegetative,xylopodia,zygomorphy	.5,/2,/6,0.5-1.5,2.5-8,5-10,6-13,andromonoecious,articulated,base,becoming,berry,branched,brown,chartaceous,cm,connivent,cordate,cream,cuneate,curved,dark,densely,elongating,entire,equal,erect,flattened,fruit,green,lateral,length,lobed,long,marking,mature,maturity,mauve,mm,orange,pale,poricidal,purple,reflexed,shrub,simple,small,sometimes,spherical,stellate,stellate-pubescent,stem,subentire,tapering,terminal,tip,tree,truncate,twice,way,wide,yellow,young	na,needle-like,plurifoliate,zygomorphy
156	wfo-0001027548	success	216	122	81	93	123	29	75	6	0.3-1.2,0.5-2,1,1-1.5,1.5-2,10-12,acuminate,acute,almost,anther,apex,apical,area,articulated,articulation,attenuate,axi,base,berry,black,branched,branching,brown,c.,cell,cm,connivent,corolla,dark,dendritic,densely,depressed-elliptic,diameter,dull,ellipsoid,elliptic,entire,filament,flattened-reniform,flower,fruiting,glabrous,globose,green,growth,immature,inflorescence,leaf,leaving,lengthening,lilac,lobed,loosely,lower,many,margin,matte,membranous,mm,narrowly,near,pedicel,peduncle,per,perfect,petiole,plurifoliate,pore,poricidal,pubescent,ripe,scattered,simple,slender,slit,stellate,stem,surface,swollen,tapering,terminal,time,tinged,tip,trichome,type,unit,upper,usually,vine,way,white,x	-11.5,.3,0.2,0.5,1-10,1-2.5,1-3.5,1.2,1.5,1.5-2.5,10-50,3-7,4-6,4-8,4.5,5-merou,6-9,7-10,8-9,abaxiall,adaxially,ag,along,also,although,alyx,anthesi,apart,apparently,appearing,ark,basal,beneath,bent,branch,bu,calyx,capitate,conical,darker,deflexe,deltate,denser,drying,eaf,early,eed,elongate,em,exserted,extending,flexuous,free,geminat,glabrescen,glandular,half,herbarium,ilament,irregularly,lamina,less,like,lobe,lon,long,long-styled,loose,minute,minutely,mixed,new,nflorescence,occasionally,older,orolla,outline,pair,pale,papillae,papillate,papillo,pericarp,pitted,planar,point,portion,primary,prominent,puberulent,rachi,rectangular,reddish,revolute,ruit,scar,size,small,sometimes,somewhat,spaced,sparse,sparsely,specimen,spreading,stigma,strongly,style,testal,thickened,thin,tiny,transparent,tube,twinin,ud,uniseriate,vary,vein,warty,woody,yellow,ympodial	age,arrangement,broad-based,colour,form,fruit,geminate,heteromorphism,insertion,length,na,needle-like,number,odour,orientation,placement,position,prickle,rhizome,seed,shape,staman,stone,structure,symmetry,sympodial,texture,tuber,xylopodia	0.3-1.2,0.5-2,1,1-1.5,1.5-2,10-12,acuminate,acute,almost,apical,area,articulated,attenuate,axi,base,berry,black,branched,branching,brown,c.,cm,connivent,dark,dendritic,densely,depressed-elliptic,diameter,dull,ellipsoid,elliptic,entire,flattened-reniform,glabrous,globose,green,immature,leaf,leaving,lengthening,lilac,lobed,loosely,lower,many,matte,membranous,mm,narrowly,near,perfect,plurifoliate,pore,poricidal,pubescent,ripe,scattered,simple,slender,slit,stellate,stem,surface,swollen,tapering,terminal,time,tinged,tip,trichome,usually,vine,way,white,x	age,broad-based,geminate,na,needle-like,prickle
157	wfo-0001027581	success	200	89	39	47	153	42	31	8	acute,anther,apex,base,berry,branching,cm,corolla,dark,echinoid,ellipsoidal,entire,filament,globose,green,growth,leaf,length,lobed,long,lower,margin,mm,moderately,multangulate,perfect,petiole,plane,plurifoliate,pore,poricidal,pubescent,purple,ripe,sessile,short-stalked,shrub,simple,small,stellate,stem,surface,tip,tree,trichome,unevenly,unit	0.2–0.3,0.3,0.3–1,0.5–1,0.5–1.5,1,1.2–1.5,1.3–1.5,1.5,1.5–2,1.5–3,10,100+,10–16,12,12–30,15–20,1–1.5,1–3-rayed,2.5–3,200,3.5–4.5,3–3.5,4.5–16,4–8,5-merou,6–7,7–10,7–9,8,8–10,9–11,9–9.5,>,abaxial,abaxially,adaxial,ag,along,alyx,anthesi,apar,ark,articulated,axe,beneath,branched,broadly,brow,brown,bulbous,c.,calyx,clavate,clearly,closely,connivent,cup-shaped,deltate,densely,diameter,dichasia,discolorous,distally,drying,eaf,eed,elliptic,erec,evenly,exserted,flattened-reniform,flower,free,fruiting,glabrescent,glabrous,golden,gradually,greyish,ilament,inflorescence,lamina,largest,lengthening,less,like,lobe,longest,loosely,many,midvei,minute,minutely,mixed,multiseriate,narrowing,near,new,nflorescence,nodding,older,orolla,pair,papillo,part,pedicel,peduncle,per,pericarp,pitted,porrect-stellate,portion,primary,ray,reddish,reflexed,rhachi,ruit,scar,scarcely,shiny,size,slit,smaller,spaced,sparsely,spreading,stalk,stigma,stout,style,tall,tem,terminal,thin,time,tube,ud,undersurface,upper,vary,varying,vein,visible,way,weak,whit,wide,woody,yellow,yellowish,ympodial	1-3-rayed,1.5-3,2.5-3,3-3.5,4-8,breeding,broad-based,cell,colour,dichasial,form,fruit,hair,height,heteromorphism,marking,mature,na,needle-like,odour,orientation,pattern,placement,plant,prickle,pseudostipule,rhizome,shape,smell,spot,staman,stone,structure,symmetry,sympodial,system,texture,tuber,type,vegetative,xylopodia,zygomorphy	acute,berry,cm,dark,echinoid,ellipsoidal,entire,globose,green,lobed,long,mm,moderately,multangulate,perfect,plane,plurifoliate,poricidal,pubescent,purple,ripe,sessile,short-stalked,shrub,simple,small,stellate,tip,tree,trichome,unevenly	1-3-rayed,1.5-3,2.5-3,3-3.5,4-8,dichasial,na,zygomorphy
158	wfo-0001027584	success	142	130	79	93	49	37	74	5	0.5-1.5-2,0.9-1,0.9-2.5,1.5-8,10-15,100,11.5-45,2,2-10,3,3-.,4-6,4.5-20,7-10-16,abruptly,acuminate,anther,anthesi,apex,attenuate,bark,base,becoming,branch,branched,broadly,calyx,cell,cm,conical,corolla,darker,deltate,densely,ellipsoid,elliptic,filament,flattened,flower,four,fruit,fruiting,glabrous,green,herb,irregular,lamina,lobe,lobed,long,minutely,mm,nearly,open,outer,outline,ovate,pair,pale,papillate,pedicel,peduncle,per,petiole,pointed,primary,reddish,regularly,reniform,scar,scattered,shrub,single,sinuate,sparse,sparsely,stem,striate,stripe,surface,tan,testal,thickening,time,trichome,tube,uniseriate,unit,vein,wall,white,without,x	..,.5,0.5-1,1-1.2,1.2-1.4,1.5-2,1.6-1.9,2.5-3,4-7,8-9,absent,apical,beginning,beneath,brittle,brow,c.,capitat,cucullate,deflexe,diameter,dry,eaf,edicel,eed,erec,lower,margin,markedly,narrowly,nflorescence,ovary,pericarp,planar,plurifoliat,present,ruit,single-stemmed,small,smooth,stigma,style,suffruticose,thin,tip,triangular,tuft,ud,ympdoial	appressed,branching,brown,bud,colour,connective,deflexed,flowering,form,glabrousnes,growth,habit,hair,height,inflated,inflorescence,leaf,length,modification,na,number,papillation,plant,plurifoliate,pore,presence,seed,shape,size,striation,structure,symmetry,sympodial,texture,type,venation,zygomorphy	0.5-1.5-2,0.9-1,0.9-2.5,1.5-8,10-15,100,11.5-45,2,2-10,3,3-.,4-6,4.5-20,7-10-16,abruptly,acuminate,anthesi,attenuate,base,becoming,branched,broadly,cell,cm,conical,darker,deltate,densely,ellipsoid,elliptic,flattened,flower,four,glabrous,green,herb,irregular,lamina,lobed,long,minutely,mm,nearly,open,outer,outline,ovate,pair,pale,papillate,pointed,primary,reddish,regularly,reniform,scar,scattered,shrub,single,sinuate,sparse,sparsely,striate,stripe,surface,tan,time,trichome,uniseriate,vein,wall,white,without,x	brown,deflexed,na,plurifoliate,zygomorphy
159	wfo-0001027600	success	183	123	80	89	94	34	76	4	0.5-1.5,1,1-14,1-2,1-4,1.5-2,2-18,2-3,2-4,2-4.5,2.5-21,2.5-6,3-15,3-5,3-5-lobed,4-6,5-13,abaxially,acuminate,adaxial,adaxially,apex,apical,basal,base,campanulate,cm,concave,connective,cordate,cuneate,densely,diameter,directed,ellipsoidal,entire,fading,flattened,forked,fruit,glabrescent,glabrous,gland,glandular-puberulent,greenish-white,laterally,leaf,leaving,lobe,lobed,long,margin,mature,minutely,mm,moderately,oblong,occasionally,older,orange,papillose,pedicel,pedicellar,petiole,pilose,pinnately,pore,puberulent,purple,rarely,remnant,rounded,simple,sparsely,stigma,style,subcoriaceous,tree,triangular,truncate,tube,two,unbranched,unit,unlobed,x,yellow,yellow-green,young	-10,0.5-1,1-5,1.5-2.5-3,1/2-3/4,10-15-25,10-20,2-11,2-3.5,2-5,2-6,20-30,3-6,4-foliat,8-17,abruptly,absen,absent,acute,adpressed,aggregate,along,apart,ape,apiculate,articulated,axe,beyond,blade,brow,calyx,cell,channe,collection,coriaceous,cream,deltate,dilated,distally,divided,eaf,eed,elliptic,especially,exceeding,except,exserted,fleshy,flower,lon,lower,main,midrib,narrowed,nflorescence,nther,obconical,obtuse,orolla,ovate,ovoid,peduncle,perfect,pilo,puberulen,puberulence,pubescent,purplish,rachi,radiu,ruit,shorter,sinus,slightly,small,somewhat,spaced,stamen,stone,strongly,surface,tal,tem,thecae,time,tip,tomento,ud,vary,vein,white,wide,yellowish,ympodial	4-foliate,abaxial,anther,articulation,bract,branching,colour,corolla,form,growth,hair,height,inflorescence,insertion,length,marking,modification,na,odour,ovary,plant,position,seed,shape,spot,stem,structure,symmetry,sympodial,texture,tomentose,type,width,zygomorphy	0.5-1.5,1,1-14,1-2,1-4,1.5-2,2-18,2-3,2-4,2-4.5,2.5-21,2.5-6,3-15,3-5,3-5-lobed,4-6,5-13,abaxially,acuminate,adaxially,apex,apical,basal,base,campanulate,cm,concave,cordate,cuneate,densely,directed,ellipsoidal,entire,fading,flattened,forked,glabrescent,glabrous,gland,glandular-puberulent,greenish-white,laterally,leaving,lobe,lobed,long,mature,minutely,mm,moderately,oblong,occasionally,older,orange,papillose,pedicellar,pilose,pinnately,puberulent,purple,rarely,remnant,rounded,simple,sparsely,subcoriaceous,tree,triangular,truncate,two,unbranched,unlobed,x,yellow,yellow-green,young	4-foliate,na,tomentose,zygomorphy
160	wfo-0001027607	success	167	185	110	120	47	65	106	4	.1,.25,.5,0.5,0.5-1,0.8-1,1-4,1.2-1.5,1.5-3,2-2.5,2-3,2-4,2.5-3,3-3.5,3/4,4-10-flowered,5-10,5-7,8-9,acuminate,acute,age,anther,anthesi,apex,arching,area,aspect,bark,basal,base,becoming,berry,branch,calyx,cm,corky,corolla,curling,decurrent,dia,ellipsoid,elliptic,elongate,erect,evenly,except,exserted,f,filament,flattened,fruiting,geminate,gently,giving,glabrate,glabrous,globose,golden,green,lateral,leaf,less,like,lobed,long,lower,main,midrib,minute,minutely,mm,narrowly,non-reproductive,obovoid,occasionally,older,opposite,ovary,ovoid-reniform,pagoda-like,pair,papillose,pedicel,petiole,pitted,plant,pore,poricidal,present,prominent,raised,rarely,reddish-brown,scar,shaped,short,shrub,simple,soon,spaced,stem,stigma,style,surface,tapering,tear-drop,tip,treelet,trichome,tube,unifoliate,uniseriate,unit,vein,way,white,widened,winged,yellowish	0.25-0.5,1,apar,ba,branche,brown,dark,deflexed,deltoid,densely,dry,eaf,edicel,eed,filiform,free,lamina,lenticellat,lobe,lon,m.,material,middle,narrow,nflorescence,portion,pubescent,reflexed,ruit,slender,slight,slightly,small,straight,strongly,styl,tall,tan,tub,ud,widening,widest,woody,x,ympodial,young,zig-zag	apart,appressed,articulation,bract,branching,breeding,broad-based,bud,cell,colour,connective,diameter,exsertion,flower,form,fruit,growth,hair,height,heteromorphism,inflated,inflorescence,insertion,interjected,interpetalar,leaflet,length,lenticellate,margin,marking,mature,modification,na,needle-like,number,odour,orientation,paired,pattern,placement,position,prickle,pseudostipule,pubescence,rhizome,scale,seed,shape,smell,spot,staman,stellate,stone,structure,symmetry,sympodial,system,texture,tissue,tuber,type,vegetative,venation,width,xylopodia	.1,.25,.5,0.5,0.5-1,0.8-1,1-4,1.2-1.5,1.5-3,2-2.5,2-3,2-4,2.5-3,3-3.5,3/4,4-10-flowered,5-10,5-7,8-9,acuminate,acute,age,arching,area,aspect,basal,base,becoming,berry,branch,calyx,cm,corky,curling,decurrent,dia,ellipsoid,elliptic,elongate,erect,evenly,except,exserted,f,flattened,geminate,gently,giving,glabrate,glabrous,globose,golden,green,lateral,leaf,less,like,lobed,long,lower,main,midrib,minute,minutely,mm,narrowly,non-reproductive,obovoid,occasionally,older,opposite,ovoid-reniform,pagoda-like,pair,papillose,petiole,pitted,plant,pore,poricidal,present,prominent,raised,rarely,reddish-brown,shaped,short,shrub,simple,soon,spaced,stem,style,tear-drop,tip,treelet,trichome,tube,unifoliate,uniseriate,vein,way,white,widened,winged,yellowish	apart,lenticellate,na,stellate
161	wfo-0001027618	success	201	112	80	87	114	25	76	4	-pubescent,1-13,1-14,1-23,1-3,1-5,1.5-3,11-pinnate,15-35,2-5,2.5-6,3-30,3-5,3-7-pinnate,3.5-6,4,6-40,8-35,abaxially,adaxially,also,apart,apex,articulated,base,blade,branched,bud,campanulate,chartaceous,cm,compound,connective,cordate,cuneate,densely,diameter,directed,ellipsoidal,elliptic-ovate,flower,fruit,fusiform,glabrous,globose,greenish,laterally,leaf,length,long,margin,membranaceous,minutely,mm,near,oblong,obtuse,orange,ovate,pedicel,peduncle,per,pilose,pinnately,pore,puberulent,puberulent-pubescent,pubescent-pilose,purple,rachi,reticulate,ripe,shrub,simple,sometimes,spaced,sparsely,sympodial,tree,truncate,unbranched,unit,urceolate,white,wide,width,yellow	-10,0-10,0.5,0.5-1,0.5-6,1,1-1.5,1-2-8.5,1-9,1.4-4,1.5-13,1.5-7,1.5-8.5,11-16,11-22,12-27,15-30,2-11,2-11.5,2-12,2-27,2-9,3-18,3-7,4-8,5-18,5-20,5-30,5-7.5,5-merous,5.5-12,6-25,7-25,8-16,acuminat,acut,acute,aggregate,alyx,ape,ascending,axe,basal,beyond,capitate,cell,cylindrical,darker,deltate,dia,diamete,dilated,distally,eaf,eed,elliptic,entire,exceeding,exserted,fleshy,lateral,leaflet,leaving,less,lobe,lon,longitudinal,lower,mesocarp,moderately,nflorescence,nther,obovate,obtu,often,orolla,papillose,pedicellar,perfec,perfect,petiole,petiolule,pilo,presen,puberulent-pilo,pubescent,radiu,ranch,ratio,remnant,rown,ruit,runk,shallowly,shorter,slightly,small,somewhat,spreading,stamen,stigma,stone,stripe,style,tal,terminal,thecae,tomentose,triangular,tube,uni,vary,without,x	1-8.5,acuminate,anther,arrangement,branching,colour,corolla,crown,form,growth,height,inflorescence,marking,na,pattern,plant,seed,shape,size,spot,symmetry,texture,trunk,type,zygomorphy	-pubescent,1-13,1-14,1-23,1-3,1-5,1.5-3,11-pinnate,15-35,2-5,2.5-6,3-30,3-5,3-7-pinnate,3.5-6,4,6-40,8-35,abaxially,adaxially,also,apart,apex,articulated,base,branched,campanulate,chartaceous,cm,compound,cordate,cuneate,densely,diameter,directed,ellipsoidal,elliptic-ovate,flower,fruit,fusiform,glabrous,globose,greenish,laterally,long,membranaceous,minutely,mm,near,oblong,obtuse,orange,ovate,per,pilose,pinnately,puberulent,puberulent-pubescent,pubescent-pilose,purple,reticulate,ripe,shrub,simple,sometimes,spaced,sparsely,sympodial,tree,truncate,unbranched,unit,urceolate,white,wide,yellow	1-8.5,acuminate,na,zygomorphy
162	wfo-0001027622	success	203	207	127	144	59	63	119	8	.5,0-14,0-16,0.3-10,1,1-10,1.5-3.5,1.5-4.2,1.6-4.5,12-23,2-25,2-6,3-16,3-4,3-4.5,3.5-11,4-9.5,5-11,6-17,6-7,8-16,8-20,abaxially,acuminate,acute,adaxially,anther,apart,apex,axillary,base,berry,blade,blue,blue-purple,borne,broadly,brownish,bud,cell,chartaceous,clavate,cm,condition,connivent,corolla,diameter,digestion,distal,drying,elliptic,elliptical,end,enzyme,erect,except,filament,flower,forked,fresh,fruit,generally,glabrescent,glabrous,globose,greatly,green,greenish,hair,half,herb,homostylous,honeycomb-shaped,interjected,lanceolate,lateral,leaflet,lengthening,light,like,long,lower,margin,membranous,middle,mm,mottled,narrowly,oblique,odd-pinnate,often,ovate,ovoid,pair,pale,pedicel,peduncle,pentagonal,perfect,petal,petiole,petiolule,plant,plurifoliate,pore,poricidal,proximal,pubescent,purple,reduced,removed,rounded,seed,singly,size,slightly,slit,sometimes,star,stellate,stem,stigma,straight,striped,style,subequal,subglabrous,subtending,terminal,testal,tip,tri-,truncate,tuber,typically,unit,unwinged,usually,wall,whitish,wide,wing,x,yellow	1-2,1/,2-3,2.5-3.5,4-5,5-merou,acumen,ag,along,alyx,apparently,articulated,axe,capitat,ciliate,covering,decumben,different,dorsally,eaf,edge,eed,especially,exceeding,flat,folded,geminat,glabrou,green-white,hair-like,living,lobe,make,midrib,minutely,mucilaginous,nflorescence,orolla,ovate-lanceolate,population,puberulent,ruit,seudostipule,shortly,spaced,specimen,stamen,ste,stolo,tall,tamen,tem,thick,throughout,tube,vary,varying,wet,ympodial	1/3,5-merous,age,appressed,arrangement,articulation,bract,branching,breeding,broad-based,calyx,capitate,colour,connective,decumbent,form,fruiting,geminate,growth,height,heteromorphism,inflated,inflorescence,insertion,interpetalar,leaf,length,marking,mature,modification,na,needle-like,number,odour,orientation,ovary,paired,pattern,placement,position,presence,prickle,pseudostipule,rhizome,scale,shape,smell,spacing,spot,staman,stolon,stone,structure,surface,symmetry,sympodial,system,texture,tissue,trichome,type,vegetative,xylopodia	.5,0-14,0-16,0.3-10,1,1-10,1.5-3.5,1.5-4.2,1.6-4.5,12-23,2-25,2-6,3-16,3-4,3-4.5,3.5-11,4-9.5,5-11,6-17,6-7,8-16,8-20,abaxially,acuminate,acute,adaxially,apart,axillary,berry,blue,blue-purple,borne,broadly,brownish,bud,chartaceous,clavate,cm,condition,connivent,digestion,distal,drying,elliptic,elliptical,end,enzyme,erect,except,forked,fresh,generally,glabrescent,glabrous,globose,greatly,green,greenish,hair,half,herb,homostylous,honeycomb-shaped,lanceolate,lateral,lengthening,light,like,long,membranous,middle,mm,mottled,narrowly,oblique,odd-pinnate,often,ovate,ovoid,pair,pale,pentagonal,perfect,petal,plant,plurifoliate,pore,poricidal,proximal,pubescent,purple,reduced,removed,rounded,singly,slightly,slit,sometimes,star,stellate,stem,straight,striped,subequal,subglabrous,subtending,terminal,tip,tri-,truncate,typically,unwinged,usually,wall,whitish,wide,wing,x,yellow	1/3,5-merous,age,capitate,decumbent,geminate,na,stolon
163	wfo-0001027624	success	189	167	82	107	82	60	79	3	0-7,0.1-0.9,0.3-1,0.5-1.5,1-2,1-3,1-5,1.1-8.4,1.2-2.6,1.3-2.9,1.5-6.6,2.4-4.8,2.9-12,3-10,3-11,4-15.2,4-7,4-8,5-9,6-18.5,9-41,anther,apex,articulated,axillary,base,berry,blade,brownish,bud,cell,clavate,cm,condition,corolla,cuneate,deep,densely,diameter,digestion,drying,elliptic,entirely,enzyme,filament,flower,forked,fresh,fruit,glabrous,globose,green,greenish,hair,herb,homostylous,honeycomb-shaped,interjected,lanceolate,lateral,leaf,leaflet,light,like,lobe,long,lower,mm,moniliform,mottled,odd-pinnate,ovate,ovoid,pair,pedicel,peduncle,pentagonal,petiole,plant,plurifoliate,pore,poricidal,pubescent,purple,removed,rotate,seed,short,size,sometimes,stigma,straight,style,subtending,terminal,testal,tip,tri-,tube,tuber,unit,usually,wall,white,whitish,wide,x	0-3,0.4-3,0.8-5.6,2-20,2-5,2-7,3-4,3-5,5-merou,abaxially,acuman,acumen,acuminate,acute,adaxially,ag,along,alyx,apart,apparently,arranged,axe,bead,capitat,connivent,considerably,covering,decreasing,decumben,decurrent,distal,dorsally,eaf,edge,eed,erect,exceeding,flat,folded,geminat,glabrou,green-white,hair-like,half,larger,leave,lengthening,living,make,middl,mucilaginous,multiple,necklace,nflorescence,onto,orbicular,orolla,perfect,present,rachi,ruit,sessile,seudostipule,slightly,slit,spaced,specimen,stamen,stolon,tall,tamen,tem,thick,throughout,toward,typically,unwinged,vary,wet,widely,yellow,ympodial	abaxial,adaxial,appressed,arrangement,articulation,bract,branching,breeding,broad-based,calyx,capitate,colour,connective,form,fruiting,glabrousnes,growth,height,heteromorphism,inflated,inflorescence,insertion,interpetalar,length,margin,marking,mature,middle,modification,na,needle-like,odour,orientation,ovary,paired,pattern,placement,position,prickle,pseudostipule,pubescence,rhizome,scale,shape,smell,spot,staman,stem,stone,structure,surface,symmetry,sympodial,system,texture,tissue,trichome,type,vegetative,xylopodia	0-7,0.1-0.9,0.3-1,0.5-1.5,1-2,1-3,1-5,1.1-8.4,1.2-2.6,1.3-2.9,1.5-6.6,2.4-4.8,2.9-12,3-10,3-11,4-15.2,4-7,4-8,5-9,6-18.5,9-41,articulated,axillary,berry,brownish,bud,clavate,cm,condition,cuneate,deep,densely,digestion,drying,elliptic,entirely,enzyme,forked,fresh,glabrous,globose,green,greenish,hair,herb,homostylous,honeycomb-shaped,lanceolate,lateral,leaf,light,like,long,mm,moniliform,mottled,odd-pinnate,ovate,ovoid,pentagonal,plurifoliate,poricidal,pubescent,purple,removed,rotate,short,sometimes,straight,subtending,terminal,tip,tri-,usually,wall,white,whitish,wide,x	capitate,middle,na
164	wfo-0001027626	success	152	145	69	83	69	62	62	7	.3,.5,0.1–0.2,0.2–0.6,0.5–1,0.7–1,1,1.5–8,13–14,2–49,2–5,3–4,3–5,3–55,4–6,5–6,8,9–18,acuminate,along,anther,apex,arrangement,base,berry,calyx,chartaceous,clavate,cm,cordate,coriaceous,diameter,distichous,distinct,elliptical,entire,extra-axillary,filament,fleshy,flower,frequently,fruit,fruiting,glabrous,greenish-white,leaf-opposed,liana,line,margin,midvein,minutely,mm,moderately,nearly,oblique,ovate,pair,pedicel,peduncle,petiole,pinnate,possibly,pubescent,rachi,secondary,shrub,simple,slender,somewhat,spindle-shaped,stellate,stigma,style,terminal,trichome,unbranched,unit,unknown,vein,venation,white,wiry-woody,x	0.5-1,0.7–2.8,1.3–4.5,1.5–2,14–116,2–3,3–4.5,4.4–11,5-merous,abaxially,accrescen,acute,adaxially,alyx,apar,axe,blade,broadly,c.,capitat,center,ciliat,climbing,color,densely,distant,eaf,eed,glabrou,immature,lamina,lanceolate,lobe,long,lower,m.,maturity,membranous,mor,nflorescence,nternode,orolla,perfec,petal,plurifoliat,pointed,reflexed,rounded,ruit,sand-punctat,sand-punctate,scandent,scar,seen,shortly,side,spaced,sparsely,ste,tamen,tem,time,tip,truncate,tube,two,vary,wide,ympodial	abaxial,accrescent,apart,appressed,articulation,bract,branching,breeding,capitate,cell,colour,connective,corolla,distance,form,growth,hair,height,heteromorphism,inflated,inflorescence,insertion,interjected,interpetalar,leaf,leaflet,length,marking,mature,modification,na,odour,orientation,ovary,paired,pattern,perfect,placement,plant,plurifoliate,pore,position,prickle,pseudostipule,rhizome,scale,seed,shape,spacing,spot,staman,stem,stone,structure,symmetry,sympodial,system,texture,tissue,tuber,type,xylopodia	.3,.5,0.1–0.2,0.2–0.6,0.5–1,0.7–1,1,1.5–8,13–14,2–49,2–5,3–4,3–5,3–55,4–6,5–6,8,9–18,acuminate,along,berry,chartaceous,clavate,cm,cordate,coriaceous,distichous,distinct,elliptical,entire,extra-axillary,fleshy,flower,frequently,fruit,glabrous,greenish-white,leaf-opposed,liana,line,minutely,mm,moderately,nearly,oblique,ovate,pair,pinnate,possibly,pubescent,shrub,simple,slender,somewhat,spindle-shaped,stellate,terminal,unbranched,unknown,white,wiry-woody,x	accrescent,apart,capitate,na,perfect,plurifoliate,stem
165	wfo-0001027630	success	149	135	61	81	68	54	57	4	.2,0.5-1,0.5-1.2,0.5-2,1-5,1.4-1.7,1.5-2,3/4,4-6,5.5-11.2,6-10,acute,anther,anthesi,apart,apex,bark,base,branchlet,calyx,ciliate,climbing,cm,corolla,decurrent,deflexed,erose,extreme,filament,fruit,fruiting,glabrate,glabrous,globose,golden,green,hirsute,internodal,lanceolate,lateral,leaf,linear,lobed,long-acuminate,main,margin,minutely,mm,occasionally,opposite,ovary,pair,papillose,partially,pedicel,petiole,pore,pubescent,scar,shaped,shrub,slender,sparsely,stem,stigma,strongly,style,tapering,tear-drop,terminal,tip,trichome,tube,ultimate,uniseriate,unit,vein,way,white,winged,young	.1,.5,0.05-0.1,1-1.5,2-3,2-6-flowered,8-9,also,arising,beginning,berry,blunt,broadly,de,deltoid,densely,dia,distinguishable,eaf,edicel,eed,elongat,except,free,globo,immature,indistinct,inflorescenc,irregularly,knob-like,known,lobe,lon,long,lower,middle,midrib,near,nflorescence,novo,older,paler,poricidal,portion,prominent,proximal,puberulent,raised,reflexed,rest,rounded,ruit,seen,simple,spaced,straight,swollen,tall,thickened,ti,ud,unifoliat,wide,widest,wing,x,yellowish,ympodial	2-6,articulation,bract,branching,breeding,cell,colour,connective,elongate,flower,form,growth,hair,height,heteromorphism,inflorescence,insertion,interjected,interpetalar,leaflet,length,marking,modification,na,number,odour,orientation,pattern,placement,plant,position,prickle,pseudostipule,rhizome,scale,shape,slendernes,spacing,spot,staman,stone,structure,symmetry,sympodial,system,texture,thicknes,tissue,tuber,type,unifoliate,venation,width,xylopodia	.2,0.5-1,0.5-1.2,0.5-2,1-5,1.4-1.7,1.5-2,3/4,4-6,5.5-11.2,6-10,acute,apart,base,ciliate,climbing,cm,decurrent,deflexed,erose,extreme,glabrate,glabrous,globose,golden,green,hirsute,internodal,lanceolate,lateral,leaf,linear,lobed,long-acuminate,main,minutely,mm,occasionally,opposite,pair,papillose,partially,pubescent,shaped,shrub,slender,sparsely,strongly,tapering,tear-drop,tip,trichome,uniseriate,vein,way,white,winged	2-6,elongate,na,unifoliate
166	wfo-0001027661	success	220	124	59	74	146	50	54	5	+,0.5,0.5-2,4.5-6,anther,apex,articulate,base,berry,branched,bright,calyx,cell,cm,column,connivent,cordate,corolla,deeply,dendritic,ellipsoid,entire,filament,fruiting,fused,globose,green,growth,lateral,leaf,lengthening,lobe,lobed,long,lower,many,margin,markedly,membraneous,mm,pedicel,perfect,petiole,pinnatifid,pore,poricidal,purple,red,ripe,shape,shiny,simple,single,sleeve,slit,small,spot,stellate,stem,surface,terminal,ternately,tightly,time,tip,trichome,truncate,type,uniseriate,unit,vine,violet,white,woody	-10,0.5-1-7,0.6-1.1,0.6-1.5,1-1.5,1-4-15,1-5,1.2-6,1.3,1.5,1.5-2,2,2.5-3,2.5-7,30,4-8-celled,40,5-9,5-merou,6-12,6-8,6-9,8-10,<,>,abaxially,acuminate,acute,adaxiall,ag,along,alyx,anthesi,apart,ark,axi,basal,branch,broadly,capitate,commonly,conical,creeping,densely,denser,density,diameter,eaf,eed,elliptic,even,extremely,flattened,flower,free,glabrous,gre,grey,ground,herbaceous,hue,ilament,irregularly,lamina,leaf-opposed,leaving,like,long-exserted,minute,minutely,mixture,moderately,narrowing,near,new,nflorescence,occasionally,often,older,open,orolla,outline,ovate,pair,pale,papillat,papillate,papillo,peduncle,peg,pentagonal,per,pericarp,pitted,plurifoliat,pointed,portion,primary,prominent,pubescen,pubescence,pubescent,purplish,rachi,rarely,reflexed,reniform,ruit,scar,short,sinus,size,slender,spaced,sparsely,spreadin,spreading,stigma,strongly,style,swollen,tan,tangled,tem,testa,thin,trailing,triangular,tube,turbinate,two,ud,underground,unieriate,upper,usually,variable,vary,vein,way,wide,yellow,yellowish,ympodial,zig-za,¾	age,appressed,articulation,bract,branching,breeding,broad-based,colour,connective,form,fruit,hair,heteromorphism,inflated,inflorescence,insertion,interjected,interpetalar,leaflet,length,marking,mature,modification,na,needle-like,odour,orientation,paired,pattern,placement,plurifoliate,position,present,prickle,pseudostipule,rhizome,scale,smell,staman,stone,structure,symmetry,sympodial,system,texture,tissue,tuber,vegetative,xylopodia,zygomorphy	+,0.5,0.5-2,4.5-6,articulate,base,berry,branched,bright,cm,column,connivent,cordate,deeply,dendritic,ellipsoid,entire,fused,globose,green,lateral,lengthening,lobe,lobed,long,many,markedly,membraneous,mm,perfect,pinnatifid,poricidal,purple,red,ripe,shiny,simple,single,sleeve,slit,small,spot,stellate,terminal,ternately,tightly,time,tip,truncate,uniseriate,vine,violet,white,woody	age,na,plurifoliate,present,zygomorphy
167	wfo-0001027714	success	248	102	50	66	182	36	46	4	1.5-3,3-3.5,4.5-5,5,acute,almost,anther,apex,articulated,base,berry,branched,bright,calyx,cell,cm,cordate,corolla,deep,densely,ellipsoid,filament,flattened,fruit,fruiting,glabrous,globose,growth,inflorescence,juicy,lateral,leaf,lower,many,margin,mm,occasionally,pedicel,petiole,pinnatifid,pore,poricidal,pubescent,purple,red,shiny,simple,sleeve,slender,somewhat,sparsely,stellate-rotate,stem,surface,terminal,time,tiny,trichome,truncate,unit,usually,vine,violet,woody,x,yellow	+,.5,/3,0,0.4,0.5,0.5-0.7,0.6-0.7,0.9-1.5,1,1-1.5,1-1.6,1-2,1-2-8,1.5-2,1.5-2.5,1.5-5,14-16,2-2.5,2-2.5-4,2.5-4-10,2373.,4-5,5-10,5-6,5-merou,6-7,7-20,80,<,abaxial,abaxially,acuminate,adaxial,adaxially,age,aid,along,alyx,angle,anthesi,apar,apice,appearance,ark,around,axi,basal,brown,canop,capitate,channelled,climbin,confined,conical,connected,connivent,corky,creating,cucullate,cupped,deflexed,dendritic,denser,diameter,drying,eaf,eed,elliptic,elongate,enlarged,entire,especially,exserted,fide,fleshy,flower,free,furcate,giving,glabrate,glabrou,groove,hairy,hanging,ilament,immature,individual,inflated,irregularly,lamina,large,leaving,lengthening,like,lobe,lobed,lon,long,longer,loosely,marginal,mature,mere,minute,minutely,mpodial,nee,new,nflorescence,nodding,obovate,often,older,orolla,otherwise,outline,ovary,pair,pale,papillate,papillo,peduncle,peg,per,perfect,pericarp,petal,petiolule,pitted,plat,plurifoliat,portion,primary,prominent,pubescence,reaching,rectangular,reddish,reniform,rim,ripe,ruit,scar,seed,showy,similar,slightly,slit,small,spaced,spreading,stigma,strongly,style,tangled,tem,testa,testal,thecae,thick,thickened,thin,third,tip,tooth,tube,twining,ud,uniformly,uniseriate,upper,vein,visible,wall,way,weak,weight,widest,wing,yellowish,younger	articulation,branching,broad-based,colour,form,hair,heteromorphism,insertion,length,marking,na,needle-like,odour,orientation,placement,plate,plurifoliate,position,prickle,pseudostipule,rhizome,scale,shape,smell,spot,staman,stone,structure,symmetry,sympodial,texture,tuber,type,vegetative,xylopodia,zygomorphy	1.5-3,3-3.5,4.5-5,5,acute,almost,articulated,base,berry,branched,bright,cm,cordate,deep,densely,ellipsoid,flattened,glabrous,globose,juicy,lateral,many,mm,occasionally,pinnatifid,poricidal,pubescent,purple,red,shiny,simple,sleeve,slender,somewhat,sparsely,stellate-rotate,terminal,time,tiny,truncate,usually,vine,violet,woody,x,yellow	na,plate,plurifoliate,zygomorphy
168	wfo-0001027720	success	184	95	44	54	130	41	39	5	1-1.5,1-3.5,1-locular,2-branched,2-foliate,absent,anther,apex,articulated,base,calyx,chartaceous,cm,cuneate,directed,distally,entire,extra-axillary,filament,fruit,fruiting,glabrous,globose,hair,half,homostylous,inflorescence,lanceolate,leaf,length,less,lilac,long,margin,mature,minute,mm,oblique,pedicel,perfect,petiole,pore,present,prickle,red,rhizomatous,scarce,sessile,shrub,simple,slightly,stellate,tissue,unit	%,.25-0.3,0,0-15,0.15-0.25,0.25-0.35,0.3-5,0.4-0.7,0.4-0.8,0.5-0.8,0.5-1,0.6-1.2,0.8-1,1-2,1.5-2,13-23,13-35,15-25,2-3,2-4,2-7,2.8-3.1,23-35,3-13,4-,4-5.5,4-7,4.3-15,4.3-7.5,5-merous,6,7-10,7-8,7-9,8-11,8-16,9-15,abaxially,absen,acute,adaxiall,adaxially,adult,alyx,apparently,axe,ba,berry,blade,brown,capitat,confined,connivent,cylindrical,deltate,densely,diameter,distall,eaf,eed,eglandular,elliptic,erect,finger,flattened,flower,geminat,gland-tipped,green,hig,incomplete,intepetalar,juicy,juvenile,lamina,lateral,lobe,loosely,lower,markedly,mesocarp,mid-point,midpoint,midrib,narrowly,nflorescence,notched,orolla,ovate,pale,part,peduncle,per,perennial,perfec,porrect,pubescent,rachi,ray,ruit,septum,short,sparsely,stellae,stellate-pubescent,stigma,straight,style,subreniform,succulen,surface,tamen,tem,thick,thicker,time,toward,triangular,tube,unarme,unarmed,upper,vary,white,wide,without,x,yellow,yellowi,ympodial	articulation,bract,branching,breeding,broad-based,cell,colour,connective,corolla,form,geminate,growth,heteromorphism,insertion,interjected,interpetalar,leaflet,marking,na,needle-like,odour,orientation,pattern,placement,position,pseudostipule,rhizome,scale,shape,spot,staman,stem,stone,structure,symmetry,sympodial,system,texture,tuber,type,xylopodia	1-1.5,1-3.5,1-locular,2-branched,2-foliate,absent,articulated,base,chartaceous,cm,cuneate,directed,distally,entire,extra-axillary,fruit,glabrous,globose,half,homostylous,lanceolate,length,less,lilac,long,mature,minute,mm,oblique,perfect,present,red,rhizomatous,scarce,sessile,shrub,simple,slightly,stellate	broad-based,geminate,na,needle-like,stem
169	wfo-0001027720	success	272	134	75	84	188	50	71	4	0.8–1.9,1.5–2.5,1.5–9.0,1/3,3.2,3.6,3.7–5.7,anther,apex,apical,armed,articulated,attenuate,base,berry,broad-based,calyx,cm,concave,connivent,corolla,dehiscence,developed,diameter,distally,entire,especially,extra-axillary,filament,fruit,glabrous,globose,gradually,growth,hair,homostylous,increasing,internode,interpetalar,juvenile,lateral,lavender,leaf,line,long,lower,margin,mature,minute,mm,narrowly,occasionally,orange,pedicel,petiole,poorly,pore,prickle,red,short,shrub,side,simple,slightly,small,sparsely,stellate,stellate-pubescent,stem,straight,subcoriaceous,surface,tissue,tree,triangular,twice-branched,unarmed,upper,violet,wavy,wide,yellow,yellow-ferruginous,×	.0,.04,.2,.3,.5,.9,0,0.1–0.6,0.2–0.4,0.3–0.4,0.7–0.9,0.7–1.1,0.7–1.2,0.8–1.3,0.8–2.0,0.9,1.4–1.9,1.5–1.7,1.5–2.0,1.5–3.3,1.7–1.8,1.7–2.0,1.7–2.5,1.8–2.0,1.9–2.2,1/2,1/3–1/2,10.0,10.8–18.2,12–16,13.0,19.7–30.0,2.0,2.5,2.5–2.8,2.5–2.9,2–3,3.9,4.0–12.6,4.0–18.0,4–5-merou,5.1–18.6,6.5–9.5,6–8,8.0,8.0–11.9,8.2–10.5,8.5–9.4,9.5–16.0,abaxially,acuminate,acute,adaxially,adnate,aequilateral,alyx,anthesi,apiculate,apparently,appearing,attachment,axe,ba,becoming,bilobed,blade,branch,broad,brochidodromous,bud,cancellate,capitate,channel,channeled,colore,congested,conical,cream,crisped,curved,deciduous,densely,dentate,difoliate,dorsally,dry,eaf,eed,either,elliptic,emerging,endocarp,erect,exocarp,fertile,filiform,flattened-irregular,flattened-orbicular,flattened-reniform,flower,free,geminat,glandular,glossy,heavily,hooked,inclined,intersepalar,juic,lamina,large,least,like,lobe,lon,longer,m.,major,midpoint,midrib,midvein,minor,moderately,nearly,nflorescence,notched,oblique,oblong,often,orolla,ovate,part,peduncle,per,perforate,point,porrect,porrect-stellate,portion,potentially,presumably,proximal,pubescent,raised,ray,reflexed,rigid,rip,row,ruit,scattered,sessile,shorter,sinus,soon,splitting,spread,stamen,stellae,stellate-pubescen,stigma,style,subacute,suture,tall,tamen,tem,thin,time,tip,toward,translucent,truncate,tube,two,ud,vary,vein,way,weakly,white,yellow-ferruginou,yellow-tan,ympodia,young,youngest,±equal,–4	4–5-merous,appressed,articulation,bract,branching,breeding,cell,colour,connective,difuoliate,form,fruiting,geminate,heteromorphism,inflated,inflorescence,insertion,interjected,leaflet,length,marking,modification,na,needle-like,odour,orientation,paired,pattern,placement,position,pseudostipule,rhizome,scale,shape,smell,spot,staman,stone,structure,symmetry,sympodial,system,texture,trichome,tuber,type,unit,vegetative,xylopodia,zygomorphy	0.8–1.9,1.5–2.5,1.5–9.0,1/3,3.2,3.6,3.7–5.7,apex,apical,armed,articulated,attenuate,base,berry,broad-based,cm,concave,connivent,dehiscence,developed,diameter,distally,entire,especially,extra-axillary,glabrous,globose,gradually,growth,homostylous,increasing,internode,interpetalar,juvenile,lateral,lavender,line,long,mature,minute,mm,narrowly,occasionally,orange,poorly,pore,prickle,red,short,shrub,side,simple,slightly,small,sparsely,stellate,stellate-pubescent,straight,subcoriaceous,tissue,tree,triangular,twice-branched,unarmed,upper,violet,wavy,wide,yellow,yellow-ferruginous,×	4–5-merous,difuoliate,geminate,na
170	wfo-0001027757	success	186	130	59	59	127	71	39	20	12,5,anther,anthesi,apex,articulated,base,blue,branching,brown,calyx,campanulate,cell,cm,colour,dark,decurrent,diameter,filament,flattened,flower,fruit,glabrous,globose,hair,irregularly,leaf,lilac,lobed,lower,margin,mm,moderately,oblong,occasionally,ovate,pale,pedicel,peduncle,perennial,petiole,plurifoliate,pore,poricidal,pubescent,regularly,rootstock,rotate,shrub,simple,sparsely,stone,surface,tip,unbranched,unit,violet,woody,x	0.2,0.2–0.3,0.3–2.0,0.5,0.6,0.6–1.0,0.7,0–1.4,1.0–1.1,1.0–2.5,1.2–4.0,1.5–1.6,1.5–2.5,1.6–2.4,1.9–2.7,1–1.5,1–11,1–2,1–3,2,2.5,2.5–4,2.5–5.5,2.5–7,2–,2–10,3–12,3–5,4–9,5–,60–100,6–9,7–8,8–16,abaxially,absen,accrescent,acute,adaxiall,adaxially,ag,along,apart,apical,arising,axe,axillary,ba,basal,blade,borne,chartaceous,clavate,concave,connivent,convex,cylindrical,deeply,densely,directed,distally,eaf,eed,elliptic,entire,equal,erect,erose,fleshy,geminat,glabrescen,glabrou,lanceolate,leafy,lobe,lon,long,longitudinal,m.,multicellular,narrowly,nflorescence,obtuse,often,opening,opposed,orolla,pair,perfect,pitted,primary,probably,ruit,secondary,serrate,shoot,side,slit,smaller,sometimes,spaced,stigma,straight,style,tall,tamen,tem,thic,thickened,time,toward,tube,unicellular,uniseriate,unknown,vary,white,wide,yellow,ympodial,–19,–2.7,–3.2,–4.0,–5.5,–6,–9	0-1.4,0.3-2.0,1-11,1.0-1.1,1.2-4.0,1.5-1.6,1.5-2.5,2-10,2.5-4,2.5-5.5,3-12,4-9,5-8,6-9,60-100,8-16,absent,articulation,bract,breeding,broad-based,connective,corolla,form,growth,height,heteromorphism,history,inflorescence,insertion,interjected,interpetalar,leaflet,length,life,marking,modification,na,needle-like,number,odour,orientation,pattern,placement,plant,position,prickle,pseudostipule,rhizome,scale,seed,shape,size,smell,spacing,spot,staman,stem,structure,symmetry,sympodial,system,texture,thicknes,tissue,trichome,tuber,type,vegetative,width,xylopodia	12,5,anthesi,articulated,base,blue,branching,brown,campanulate,cm,dark,decurrent,flattened,fruit,glabrous,globose,irregularly,lilac,lobed,mm,moderately,oblong,occasionally,ovate,pale,perennial,plurifoliate,poricidal,pubescent,regularly,rotate,shrub,simple,sparsely,tip,unbranched,violet,woody,x	0-1.4,0.3-2.0,1-11,1.0-1.1,1.2-4.0,1.5-1.6,1.5-2.5,2-10,2.5-4,2.5-5.5,3-12,4-9,5-8,6-9,60-100,8-16,absent,length,na,width
171	wfo-0001027765	success	163	151	80	93	70	58	73	7	0.8,1,1-10,1-11.5,1-4,1-5,1.5-6,10-13,2-2.5,2-4,2.5-4.2,20-30-44,3-12,3-20,3-5-15-30,5-6,5-8,7-20,abaxially,apex,apical,base,branched,calyx,cell,cm,connate,cordate,corolla,covering,cyme,dehiscent,diameter,dichasial,dichasially,distal,filament,flower,glandular,globose,green,hair,hair-like,herbaceous,interjected,introrse,lateral,leaf,leaflet,light,long,make,maturing,mm,monochasial,mucilaginous,oblique,odd-pinnate,often,ovoid,pattern,pedicel,peduncle,perennial,perfect,petiole,pilose,plant,proximal,rounded,seed,short,simple,size,slightly,slit,stellate,stigma,straight,style,terminal,testal,thick,throughout,tone,truncate,tuber-bearing,unit,violet,wall,white,wide,¼	0-.,1-2,1-2-3-4,2-3,2.5-4,3-6-foliat,5,abaxial,abruptly,acumen,acuminate,acute,apically,apiculate,articulate,cuneate,digestion,diminishing,dorsally,eaf,ebracteate,edge,eed,elliptic,elliptic-lanceolate,emoval,enzyme,exceeding,flat,folded,forked,generally,globo,green-white,half,honeycomb,living,lobe,lon,lower,lunat,nflorescence,nther,obtuse,orolla,ovate,ovate-elliptic,ovate-lanceolate,pair,petiolate,petiolule,plan,poricidally,reveal,ruit,sessile,seudostipule,side,specimen,stamen,tal,tem,throughou,tip,toward,typically,vary,without,yellow,ympodial	0-2,3-6-foliate,anther,apicidally,appressed,arrangement,articulation,bract,branching,breeding,colour,connective,ebbrate,form,fruit,fruiting,growth,height,heteromorphism,inflated,inflorescence,insertion,interpetalar,length,lunate,margin,marking,mature,modification,na,number,odour,orientation,ovary,paired,placement,pore,position,prickle,pseudostipule,rhizome,scale,shape,spot,staman,stem,stone,structure,symmetry,sympodial,system,texture,tissue,tuber,type,wet,width,xylopodia	0.8,1,1-10,1-11.5,1-4,1-5,1.5-6,10-13,2-2.5,2-4,2.5-4.2,20-30-44,3-12,3-20,3-5-15-30,5-6,5-8,7-20,abaxially,apical,branched,cell,cm,connate,cordate,covering,cyme,dehiscent,dichasial,dichasially,distal,glandular,globose,green,hair,hair-like,herbaceous,introrse,lateral,light,long,make,maturing,mm,monochasial,mucilaginous,oblique,odd-pinnate,often,ovoid,perennial,perfect,pilose,proximal,rounded,seed,short,simple,slightly,slit,stellate,straight,testal,thick,throughout,tone,truncate,tuber-bearing,violet,wall,white,wide,¼	0-2,3-6-foliate,apicidally,ebbrate,lunate,na,wet
172	wfo-0001027807	success	116	158	75	92	24	66	73	2	.5,0-0.2,0.1-1,0.2-0.9,0.9-1,1-1.5,15-30,2-6,abaxially,acuminate,acute,adaxially,almost,apex,attenuate,barely,bark,base,berry,brittle,brown,bud,closely,cm,decurrent,deflexed,diameter,difoliate,dry,drying,elliptic,flattened,flower,fruiting,glabrous,globose,gray,grayish,green,growth,internodal,lanceolate,leaf,leaf-opposed,margin,material,midrib,minutely,mm,narrowly,new,occasionally,older,overlapping,pair,pale,paler,papillate,pedicel,peduncle,petiole,pitted,plane,primary,prominent,rachi,reddish,reniform,reproductive,revolute,scar,seemingly,shoot,shrub,simple,slightly,small,somewhat,spaced,sparsely,stem,surface,thickened,tree,unifoliate,unit,usually,vein,visible,white,winged,yellowish	0.2-0.3,0.3-0.4,0.9-2.5,2-5,3.5-9,deflexe,eaf,eed,ellipti,geminat,know,known,maturity,nflorescence,ot,papillae,parallel,reddi,ruit,slender,ud,x,ympodial,young	anther,arrangement,articulation,bract,branching,breeding,brittlenes,broad-based,cell,colour,connective,corolla,deflexion,filament,form,fruit,geminate,hair,heteromorphism,inflorescence,insertion,interjected,interpetalar,leaflet,length,lower,marking,modification,na,needle-like,number,odour,orientation,paired,papilla,pattern,placement,pore,position,prickle,pseudostipule,rhizome,scale,seed,shape,smell,spacing,spot,staman,stellate,stone,structure,symmetry,sympodial,system,texture,thicknes,tissue,trichome,tuber,type,vegetative,visibility,width,xylopodia,zygomorphy	.5,0-0.2,0.1-1,0.2-0.9,0.9-1,1-1.5,15-30,2-6,abaxially,acuminate,acute,adaxially,almost,attenuate,barely,base,berry,brittle,brown,closely,cm,decurrent,deflexed,difoliate,dry,drying,elliptic,flattened,glabrous,globose,gray,grayish,green,internodal,lanceolate,leaf,leaf-opposed,material,minutely,mm,narrowly,occasionally,overlapping,pair,pale,paler,papillate,pitted,plane,prominent,rachi,reddish,reniform,reproductive,revolute,seemingly,shoot,shrub,simple,slightly,small,somewhat,spaced,sparsely,surface,thickened,tree,unifoliate,usually,visible,white,winged,yellowish	geminate,na
173	wfo-0001027816	success	187	141	66	91	96	50	63	3	.5,0.5,0.5-1,0.6-0.8,1,1-3,1.2-2,1.5-2,12-14,4-5,<,acuminate,acute,anther,apex,articulated,attenuate,base,becoming,berry,bluish,branched,brown,calyx,capitate,cell,cm,corolla,dark,densely,diameter,ellipsoid,entire,filament,filiform,flattened,fleshy,flower,fruiting,glabrous,gland-tipped,glandular,globose,growth,inflorescence,lanceolate,lateral,leaf,less,linear,lower,margin,minute,minutely,mm,occasionally,often,orange,patent,pedicel,peduncle,per,perfect,petiole,pitted,pore,poricidal,pubescent,purple,reddish,reniform,several,shrub,simple,sparsely,stellate,stem,stigma,style,surface,terminal,time,tip,trichome,tube,uniformly,uniseriate,unit,upper,variable,x	..,0.2,0.5-2,0.7-1,1-1,1-1.5,1-4,1.8-6,2-2.5,2-4,2/3,3-3.5,3.5-4,5-30,5-merou,6-9,ag,almost,along,alyx,anthesi,apar,ark,axi,confined,conical,connivent,cupped,dense,drying,eaf,eed,em,erect,exserted,free,half,ilament,irregularly,leaving,lengthening,like,lobe,lobed,loosely,m.,markedly,new,nflorescence,nodding,older,orolla,pair,papillo,peg,perhaps,pericarp,plant,plurifoliat,portion,primary,prominen,pubescen,rectangular,red,ripe,rounded,ruit,scar,shiny,sleeve,slightly,slit,small,sometimes,somewhat,spaced,sparse,spreadin,spreading,square,testal,thin,triangular,twinin,ud,ultimate,usually,vary,vein,viscous,way,woody,yellowish,ympodial,½	appressed,articulation,bract,branching,breeding,colour,connective,form,fruit,hair,heteromorphism,inflated,insertion,interjected,interpetalar,leaflet,length,marking,mature,modification,na,number,odour,orientation,ovary,paired,papillose,pattern,placement,plurifoliate,position,prickle,pseudostipule,pubescence,rhizome,scale,seed,shape,spot,staman,stone,structure,symmetry,sympodial,system,texture,tissue,tuber,type,xylopodia	.5,0.5,0.5-1,0.6-0.8,1,1-3,1.2-2,1.5-2,12-14,4-5,<,acuminate,acute,articulated,attenuate,base,becoming,berry,bluish,branched,brown,capitate,cm,dark,densely,ellipsoid,entire,filiform,flattened,fleshy,glabrous,glandular,globose,lanceolate,lateral,less,linear,minute,minutely,mm,occasionally,often,orange,patent,perfect,pitted,poricidal,pubescent,purple,reddish,reniform,several,shrub,simple,sparsely,stellate,terminal,time,tip,uniformly,uniseriate,variable,x	na,papillose,plurifoliate
174	wfo-0001027819	success	198	186	111	125	73	61	107	4	0.5-1,1,1-2,1-4-10,10-20,10-50,2-15,2-3,2-3-5-lobed,20-35,20-40-100,25-35,3-40,3-5,4,4-10,4-5,5-6,8-10,9-12,abaxially,acute,adaxially,aggregate,apart,apex,apical,basal,base,beyond,blade,branched,cell,ciliate,cm,concave,connective,cordate,cuneate,cylindrical,deeply,densely,dia,diameter,directed,distally,ellipsoidal,entire,equal,especially,exceeding,fading,finely,fleshy,flower,forked,fruit,glabrous,globose,green,hair,leaf,length,lobe,lobed,long,lower,margin,mesocarp,mm,moderately,narrow,narrowly,near,oblong,obtuse,occasionally,pedicel,peduncle,per,perfect,petiole,pinnately,pore,present,probably,prominent,protuberance,puberulent,purple,rachi,rarely,remnant,rugose,shorter,simple,slightly,sparsely,stamen,stellate,stigma,stone,style,subcoriaceous,swelling,sympodial,thecae,toward,tree,triangular,truncate,tube,two,umbrella-shaped,unbranched,unit,unknown,unlobed,usually,whitish,wide,width,without,yellow,young	1-5,1.5-2,12-21,15-22,16-25,2,20-25,20-40,22-35,4-15,4-25,5,5-merous,also,alyx,ape,apiculat,articulated,axe,ba,color,denser,diamete,dilated,divided,eaf,eed,eglandular,eglandular-pilose,elliptic,elliptic-ovate,except,exserted,halfway,leaving,lon,main,midrib,nflorescence,nther,oblique,obtu,often,orolla,ovate,pedicellar,perfec,pilose,puberulen,puberulence,purplish,radiu,ranch,ratio,ripe,rounded,rown,ruit,runk,shallowly,short-acuminat,sinus,small,sometimes,spaced,strongly,tal,ud,uni,vary,vein,villous,x	anther,arrangement,articulation,bract,branching,breeding,broad-based,bud,colour,corolla,crown,exsertion,filament,form,growth,height,heteromorphism,inflorescence,insertion,interjected,interpetalar,leaflet,marking,mature,modification,na,needle-like,number,odour,orientation,ovary,paired,pattern,placement,plant,position,prickle,pseudostipule,rhizome,scale,seed,shape,short-acuminate,smell,spacing,spot,staman,stem,structure,surface,symmetry,system,texture,theca,tissue,trichome,trunk,tuber,type,vegetative,xylopodia	0.5-1,1,1-2,1-4-10,10-20,10-50,2-15,2-3,2-3-5-lobed,20-35,20-40-100,25-35,3-40,3-5,4,4-10,4-5,5-6,8-10,9-12,abaxially,acute,adaxially,aggregate,apart,apex,apical,basal,base,beyond,branched,cell,ciliate,cm,concave,cordate,cuneate,cylindrical,deeply,densely,diameter,directed,distally,ellipsoidal,entire,equal,especially,exceeding,fading,finely,fleshy,forked,glabrous,globose,green,hair,lobe,lobed,long,margin,mesocarp,mm,moderately,narrow,narrowly,near,oblong,obtuse,occasionally,per,perfect,pinnately,present,probably,prominent,protuberance,puberulent,purple,rarely,rugose,shorter,simple,slightly,sparsely,stamen,stellate,stone,subcoriaceous,swelling,sympodial,thecae,toward,tree,triangular,truncate,two,umbrella-shaped,unbranched,unit,unknown,unlobed,usually,whitish,wide,without,yellow,young	-3,di,na,short-acuminate
175	wfo-0001027834	success	235	100	48	57	178	43	44	4	1-1.9,1-10,absent,accrescent,acute,anther,apex,articulated,axillary,base,berry,blunt-tipped,branched,branching,calyx,cm,completely,connivent,corolla,covering,dendritic-echinoid,discolorous,echinoid,ellipsoid,entire,enveloping,equal,filament,fruit,fruiting,globose,granular-tomentose,hair,leaf,many,margin,mm,multangulate,obtuse,pedicel,petiole,plurifoliate,pore,poricidal,rounded,shrub,simple,small,stellate,subcoriaceous,time,tip,tree,unit,white,yellow,yellowish-tomentose	.5-3,0-110,0.2-0.3,0.2-0.4,0.2-0.6,0.4-1.1,0.5-2,0.9-1.8,1-1.6,1-2.5,1.1-1.6,1.1-1.8,1.4-2,1.6-2.7,1.8-4.9,1/2,10-25,2-3.8,2-8,2.2-4.3,2.3-3.4,2.4-6.2,2.7-7.3,2.9-4.2,25,3-15,3-4.3,4-5.2-6.1,4-6,4.8-6.9,5-20,5-merous,5.1-8,6.9-18.1,9-11.9,9-13,abaxial,abaxially,acuminate,adaxial,adaxially,ag,alyx,angled,anthesi,apar,apical,around,attenuate,ba,bark,becoming,blade,branch,brown,bud,capitat,closely,concentrated,coriaceous,crown,cylindrical,deltoid,dendritic-echinoi,densely,diameter,dichasia,directed,distally,drying,eaf,echinoi,edge,eed,enclosing,erec,exserted,farinose,finely,flat-topped,fleshy,flower,forming,glabrescent,glabrous,gray,grooved,high,included,inserted,lengthening,lenticular,less,light,lobe,lobed,long,long-stalked,longitudinal,longitudinally,lower,mostly,multangulat,near,nflorescence,numerous,obovate,obscured,older,orbicular,orolla,ovate,ovate-elliptic,ovate-lanceolate,pair,peduncle,perfec,persistent,porrect-stellate,primary,pseudo-terminal,pubescence,pubescent,rachi,rarely,ray,reticulate-punctate,ripe,ruit,runk,scabridulous,scar,semi-ovate,semi-spherical,sessile,short,short-stalked,slit,soft,sometimes,somewhat,spaced,sparsely,spreading,stalked,stamen,stellate-pubescent,stem,stigma,style,subcampanulate,surface,suture,tamen,though,tomentose,tomentu,tomentum,toward,trichome,tube,turbinoid,ud,unarme,usually,vary,vein,velutinous-tomentose,villous,way,whitish,whitish-tomentose,wide,x,yellowish,yellowish-tan,ympodial,young	articulation,bract,breeding,cell,colour,connective,dichasial,form,growth,heteromorphism,inflorescence,insertion,interjected,interpetalar,leaflet,length,marking,na,odour,orientation,paired,pattern,perfect,placement,position,prickle,pseudostipule,pseudoterminally,rhizome,scale,shape,spot,staman,stone,structure,symmetry,sympodial,system,texture,tissue,tuber,type,xylopodia	1-1.9,1-10,absent,accrescent,acute,articulated,axillary,base,berry,blunt-tipped,branched,cm,completely,connivent,covering,dendritic-echinoid,discolorous,echinoid,ellipsoid,entire,enveloping,equal,fruit,globose,granular-tomentose,leaf,many,mm,multangulate,obtuse,plurifoliate,poricidal,rounded,shrub,simple,small,stellate,subcoriaceous,time,tip,tree,white,yellow,yellowish-tomentose	dichasial,na,perfect,pseudoterminally
176	wfo-0001027843	success	154	89	32	41	113	48	28	4	0.5-1,2-2.5,acute,anther,apex,base,berry,calyx,corolla,deflexed,densely,difoliate,filament,fruiting,glabrous,globose,green,irregularly,leaf,lobed,margin,minutely,mm,opposite,ovate,papillose,pedicel,petiole,pore,pubescent,shape,shaped,shrub,spaced,tear-drop,trichome,uniseriate,unit,white,winged,x	.5,.75,/3,0.5-0.75,0.8-3.5,1-1.2,1-1.3,1-1.5,1.2-1.5,1.2-2.5,2-4,3-15-flowered,3-6,5-6,6-13,6-9,along,anthesi,apart,apiculate,ba,bark,bearing,becoming,beginning,beneath,broadly,clavate,cm,conical,coroll,curly,deltoid,denser,dia,differing,distally,eaf,edicel,eed,ellipsoid,erose,exsertion,flower,free,geminat,glabrate,hairy,impressed,known,lamina,larger,later,lateral,like,lobe,lon,long,long-acuminate,lower,main,major,middle,minor,near,nearly,nflorescence,occasionally,older,one,orbicular,ovary,pair,papillo,pleated,poricidal,portion,prominent,proximal,reddish-gre,reflexed,rounded,ruit,scar,simple,sinus,size,slender,slightly,somewhat,sparsely,sparser,stem,stiff,stigma,straight,strongly,style,surface,tall,tapering,time,tip,tipped,tube,two,ud,vein,way,widest,woody,ympodial,young	appressed,articulation,bract,branching,breeding,broad-based,cell,colour,connective,form,fruit,geminate,growth,hair,heteromorphism,inflated,inflorescence,insertion,interjected,interpetalar,leaflet,length,marking,mature,na,odour,orientation,paired,pattern,placement,position,prickle,pseudostipule,rhizome,scale,spot,staman,stone,structure,symmetry,sympodial,system,texture,tissue,tuber,type,xylopodia,zygomorphy	0.5-1,2-2.5,acute,berry,deflexed,densely,difoliate,glabrous,globose,green,irregularly,leaf,lobed,minutely,mm,opposite,ovate,papillose,pubescent,shaped,shrub,spaced,tear-drop,trichome,uniseriate,white,winged,x	broad-based,geminate,na,zygomorphy
177	wfo-0001027847	success	215	115	58	67	148	48	54	4	-6,/3,0.4-1,2-4,5-6,5.5-8,anther,apex,apparently,articulated,base,berry,branched,calyx,chartaceous,cm,connivent,cordate,discolorous,drying,elongating,equal,erect,evenly,filament,fruit,fruiting,glabrous,gray,green,lateral,leaf,length,lobed,long,margin,mature,maturity,mauve,mm,orange,pedicel,perpendicular,petiole,poricidal,prickle,purple,red,red-brown,retrorse,rounded,shrub,simple,spherical,stellate,stellate-pubescent,stem,strongly,surface,tapering,terminal,tip,unit,way,weakly,white,young	-2.5,-3,-5,.35,.7,/2,0-2,0-7,0.1-0.4,0.15-0.2,0.2,0.5,0.5-0.8,0.5-1,0.8,0.8-0.9,0.8-1.2,1-2,1-2.5-4,1.5-2,1.5-2.5,1.5-5,1.9-2.3,1/2,1/4,1/6-1/3,2-2.8,2-3,2-5,2.2-3,2.5-3.5,2/,3-15,3-5,3-6,3.5-6,4-5-merous,5-25,6-11,6-8,7-10,abaxially,acute,almost,alyx,ame,apar,apart,apically,bark,blade,broadly,brow,c.,curved,deltate,densely,diameter,dimorphic,distance,dull,eaf,edge,eed,elliptic,extending,faint,filiform,filiform-acuminat,finely,flattened,flattened-reniform,flower,free,geminate,glabrescent,increasing,infructescence,lobe,lon,longer,lower,middle,midpoint,midvein,minor,moderately,narrow-deltate,nflorescence,older,one,open,orange-brown,orbicular,orolla,oung,ovate,pair,peduncle,pendulous,per,perfec,pericarp,pit,pitted,plurifoliat,porrect,portion,prickl,prickly,primary,ray,reddish,ruit,scandent,scar,seed,sessile,side,size,slender,smooth,sometimes,spaced,sparsely,spreading,stalk,stalked,straight,style,tamen,terete,tertiary,time,toward,trichome,tube,unarmed,upper,usually,variously,vary,vein,venation,visible,wide,yellow,ympodial	appressed,articulation,bract,branching,breeding,broad-based,cell,colour,connective,corolla,form,growth,hair,heteromorphism,inflated,inflorescence,insertion,interjected,interpetalar,leaflet,marking,modification,na,odour,orientation,paired,pattern,perfect,placement,plurifoliate,pore,position,pseudostipule,rhizome,scale,shape,spot,staman,stone,structure,symmetry,sympodial,system,texture,tissue,tuber,type,xylopodia	-6,/3,0.4-1,2-4,5-6,5.5-8,apparently,articulated,base,berry,branched,chartaceous,cm,connivent,cordate,discolorous,drying,elongating,equal,erect,evenly,glabrous,gray,green,lateral,lobed,long,maturity,mauve,mm,orange,perpendicular,poricidal,prickle,purple,red,red-brown,retrorse,rounded,shrub,simple,spherical,stellate,stellate-pubescent,stem,strongly,surface,tapering,terminal,tip,way,weakly,white,young	broad-based,na,perfect,plurifoliate
178	wfo-0001027872	success	190	83	45	57	133	26	41	4	1,1-8,1.0-1.3,12-35,15,2,2.2-3.5,20,35,5-7,5-8,5-lobed,6-20,base,branched,ca,calyx,cm,connate,cyme,deep,dehiscent,diameter,dichasially,distal,flower,glandular-pubescent,globose,gray-green,green,hair-like,half,herbaceous,honeycomb,lanceolate,lateral,light,mm,mucilaginous,odd-pinnate,ovoid,pattern,pedicel,peduncle,perfect,plant,poricidally,purple,rhizomatous,rhizome,rotate,seed,semi-lunate,shape,type,wall,yellowish-green	0.5,1-1.2,1-4,1.5-4,10,2-3,2.8,3-6-foliat,4-6,5-10,8-11,abaxially,acumen,acuminate,acute,adaxially,angular,apex,apical,apically,apiculate,articulate,b,ba,basal,becoming,caudate,cell,celled,clasping,commonly,cordate,covering,cuneate,decreasing,densely,dichasial,digestion,eaf,ebracteate,eed,elliptic,emoval,enzyme,erect,exceeding,externally,filament,forked,four-celled,generally,glabrescent,gland,glandular,globo,green-white,homogeneously,interjected,introrse,leaflet,living,lobe,lon,long,longer,lower,make,maturing,middle,moderately,monochasial,mottled,narrowly,nearly,nflorescence,nther,obliquely,oblong,often,orolla,ovate,pair,pentagonal,perennial,petiolate,petiolulate,petiolule,puberulent,pubescent,purpl,rarely,reduced,reveal,rotate-,rounded,ruit,sessile,seudostipule,short,single,size,slightly,slit,sometimes,somewhat,specimen,stamen,ste,stigma,straight,style,subequal,symmetrically,tem,terete,terminal,testal,thick,tinged,tip,trailing,typically,unbranched,uniformly,unit,usually,vary,viole,wid,wide,wider,yellow,ympodial	anther,arrangement,articulation,branching,colour,corolla,form,fruit,glandularity,growth,height,inflorescence,leaf,length,modification,number,pore,position,present,pseudostipule,rotate-pentagonal,stem,violet,wet,width,ye	1,1-8,1.0-1.3,12-35,15,2,2.2-3.5,20,35,5-7,5-8,5-lobed,6-20,base,branched,ca,cm,connate,cyme,deep,dehiscent,dichasially,distal,glandular-pubescent,globose,gray-green,green,half,herbaceous,lanceolate,light,mm,odd-pinnate,ovoid,perfect,poricidally,purple,rhizomatous,rotate,semi-lunate,yellowish-green	present,rotate-pentagonal,violet,ye
179	wfo-0001027880	success	185	168	99	113	72	55	94	5	.25,0.3-3,0.5-5,0.6-1,0.6-1.5,0.8-1.5,1-14,1-15,1-2,1-3,1.5-2,1.5-3,10-15,2-3,2-80,4-10,4-6,abaxially,acuminate,acute,adaxially,along,anther,apex,apiculate,articulated,base,blade,branching,calyx,cell,clavate,cm,conical,cordate,coriaceous,cylindrical,densely,diameter,discolorous,entire,epiphytic,extra-axillary,filament,flattened,flower,fruit,glabrous,globose,green,greenish,hair,inflorescence,leaf,leaf-opposed,longitudinal,lower,margin,midvein,minutely,mm,multicellular,nearly,node,oblique,oblong,oblong-ovate,occasionally,often,opening,ovate,ovoid,pale,papillose,pedicel,peduncle,perfect,petiole,pink,plurifoliate,pore,pubescent,purple,rachi,red-brown,reddish,revolute,ripe,rooting,rounded,rugulose,shrub,simple,size,slightly,slit,sometimes,somewhat,sparsely,stellate,stigma,stone,style,surface,tan,truncate,unbranched,undulate,uniseriate,unit,vine,white,x	-3,0.5-1.5,0.5-1.5-3.5,1-2.5,2/,3-4,5-11,5-8,5-merou,8,absen,accrescen,ag,aggregate,alyx,apart,apparently,axe,ba,branch,chartaceous,ciliat,connivent,contiguously,curled,deltate,dense,diminishing,directed,distally,distichous,distinct,distinctly,eaf,eed,equal,fruiting,geminat,growing,increasing,internode,line,lobe,long,longer,nflorescence,orolla,pair,point,pubescen,ruit,scar,secondary,slender,spaced,ste,tamen,tem,thickened,time,tip,trailing,tree,trunk,tube,typically,usually,vary,vein,wide,yellow,ympodial	2/3,absent,age,arrangement,articulation,bract,breeding,broad-based,colour,connective,corolla,form,geminate,growth,habit,heteromorphism,insertion,interjected,interpetalar,leaflet,length,marking,mature,modification,na,needle-like,number,odour,orientation,ovary,paired,pattern,placement,position,prickle,pseudostipule,rhizome,scale,seed,shape,smell,spot,staman,stem,structure,symmetry,sympodial,system,texture,tissue,trichome,tuber,type,vegetative,xylopodia	.25,0.3-3,0.5-5,0.6-1,0.6-1.5,0.8-1.5,1-14,1-15,1-2,1-3,1.5-2,1.5-3,10-15,2-3,2-80,4-10,4-6,abaxially,acuminate,acute,adaxially,along,apiculate,articulated,base,blade,clavate,cm,conical,cordate,coriaceous,cylindrical,densely,diameter,discolorous,entire,epiphytic,extra-axillary,flattened,flower,fruit,glabrous,globose,green,greenish,leaf,leaf-opposed,longitudinal,lower,margin,midvein,minutely,mm,multicellular,nearly,node,oblique,oblong,oblong-ovate,occasionally,often,opening,ovate,ovoid,pale,papillose,perfect,pink,plurifoliate,pubescent,purple,red-brown,reddish,revolute,ripe,rooting,rounded,rugulose,shrub,simple,slightly,slit,sometimes,somewhat,sparsely,stellate,tan,truncate,unbranched,undulate,uniseriate,vine,white,x	2/3,absent,age,geminate,na
180	wfo-0001027880	success	170	129	65	78	92	51	61	4	0.5,0.5–1.5,0.6–1.5,0.8–1.5,1.5–2,1.5–3,10–15,1–14,1–15,2–3,4–10,5-merous,absent,anther,apex,arrangement,base,bluish-purple,calyx,chartaceous,cm,conical,cordate,coriaceous,densely,diameter,distichous,distinctly,entire,extra-axillary,filament,flattened,flower,fruit,glabrous,globose,greenish,hair,leaf,leaf-opposed,longer,margin,mm,mottled,nearly,oblique,oblong-ovate,often,ovate,ovoid,pedicel,peduncle,petiole,pink,pubescent,rachi,red,reddish-brown,revolute,rugulose,shrubby,simple,slender,slightly,sometimes,stellate,surface,trichome,truncate,typically,unbranched,undulate,unit,vine,white,woody,x,–3.5	.25,0.2-0.5,0.3–3,0.5–5,0.6–1,1–2,1–2.5,1–3,2-80,2/3,3–4,4–6,5–11,5–8,8,abaxially,accrescen,acuminate,acute,adaxially,along,alyx,apar,apiculate,axe,berry,blade,c.,capitat,ciliat,clavate,climbing,contiguously,curled,cylindrical,deltate,dense,discolored,distinct,eaf,eed,fruiting,green,lanceolate,line,lobe,long,lower,m.,membranous,midvein,minutely,nflorescence,nternode,occasionally,orolla,pair,pale,papillose,perfec,pinnate,plurifoliat,reddish,rip,rounded,ruit,sand-punctat,sand-punctate,scar,secondary,somewhat,spaced,sparsely,ste,stigma,style,tamen,tan,tem,thickened,time,tip,tree,trunk,tube,uniseriate,vary,vegetatio,vein,venation,wide,ympodial	articulation,bract,branching,breeding,cell,colour,connective,corolla,form,growth,heteromorphism,inflorescence,insertion,interjected,internode,interpetalar,leaflet,length,marking,mature,merosity,modification,na,odour,orientation,pattern,perfect,placement,plurifoliate,pore,position,prickle,pseudostipule,rhizome,ripe,scale,seed,shape,spot,staman,stem,stone,structure,symmetry,sympodial,system,texture,tissue,tuber,type,xylopodia	0.5,0.5–1.5,0.6–1.5,0.8–1.5,1.5–2,1.5–3,10–15,1–14,1–15,2–3,4–10,5-merous,absent,bluish-purple,chartaceous,cm,conical,cordate,coriaceous,densely,distichous,distinctly,entire,extra-axillary,flattened,flower,fruit,glabrous,globose,greenish,leaf-opposed,longer,mm,mottled,nearly,oblique,oblong-ovate,often,ovate,ovoid,pink,pubescent,red,reddish-brown,revolute,rugulose,shrubby,simple,slender,slightly,sometimes,stellate,truncate,typically,unbranched,undulate,vine,white,woody,x,–3.5	na,perfect,plurifoliate,ripe
181	wfo-0001027881	success	214	137	70	79	135	58	61	9	abundant,accrescent,acute,anther,apex,appressed,articulated,asymmetric,attenuate,base,berry,blackish,calyx,chartaceous,ciliate,cm,commonly,connivent,cordate,cordiform,densely,difoliate,drying,eglandular,entire,erect,extra-axillary,filament,flattened,flower,fruit,geminate,giving,glabrous,glandular,globose,greenish,groove,hair,herb,immature,impression,interpetalar,introrsely,lateral,leaf,light-brown,long,lower,margin,maturity,membranaceous,mm,moderately,multicelled,netlike,ovate-elliptic,parallel,pedicel,petiole,pore,projection,pubescent,raised,reniform,rotate,seed,simple,solitary,staman,stem,subapically,subopposite,surface,tissue,translucent,unbranched,unit,white	.3–0.5,0.5–2.2,0.8–1.5,1-celled,1.3–2,1.8–2.9,10–25,1–2,1–2-celled,1–2.5-3,1–2.6,1–3,1–3-celled,1–4,2.5–3.6,20–40,2–4,2–6,2–7,4–6,4–9.5,5,5-merous,6–10,7–14,7–9,8,abaxially,absent,acuminate,adaxiall,adaxially,almost,alyx,axe,ba,barely,blade,bulge,camptodromous,capitat,case,central,closely,connected,contiguous,curved,cylindrical,decurrent,dehiscing,denser,diameter,directed,dorsally,eaf,ed,emarginate,emerging,equal,exceeding,exclusively,explosively,eye,few-,fewer,forming,frequent,half,held,hollow,larger,less,like,lobe,longer,longitudinal,mainly,many-branched,maturit,mesocarp,mixed,much,multicellular,naked,near,nflorescence,normally,one,opening,orolla,other,pair,part,peduncle,per,perfec,placenta,pressure,primary,prominent,pubescence,rachi,ruit,secondary,sessile,short,side,similar,size,slightly,slit,small,smaller,sometimes,sparsely,stalk,stamen,stigma,style,tal,tamen,tem,triangular,tube,two,vary,vein,venation,visible,watery,winged,woody,yellow,ympodial,×	0.5-2.2,1-2,1-2-celled,1-4,4-6,4-9.5,arrangement,articulation,bract,branching,breeding,broad-based,cell,colour,connective,corolla,form,fruiting,growth,heteromorphism,inflated,inflorescence,insertion,interjected,leaflet,length,marking,mature,modification,na,needle-like,number,odour,orientation,paired,pattern,perfect,placement,position,prickle,pseudostipule,rhizome,scale,shape,smell,spot,stone,structure,symmetry,sympodial,system,texture,trichome,tuber,type,vegetative,xylopodia,zygomorphy	abundant,accrescent,acute,articulated,asymmetric,attenuate,base,berry,blackish,chartaceous,ciliate,cm,commonly,connivent,cordate,cordiform,densely,difoliate,drying,eglandular,entire,erect,extra-axillary,flattened,geminate,giving,glabrous,glandular,globose,greenish,groove,hair,herb,immature,impression,introrsely,lateral,leaf,light-brown,long,margin,maturity,membranaceous,mm,moderately,multicelled,netlike,ovate-elliptic,parallel,projection,pubescent,raised,reniform,rotate,simple,solitary,subapically,subopposite,translucent,unbranched,white	0.5-2.2,1-2,1-2-celled,1-4,4-6,4-9.5,na,perfect,zygomorphy
182	wfo-0001027882	success	183	103	45	61	122	42	43	2	.25,0.5-1,1.5-2,1.5-6,3-4,3.5-5,abaxially,adaxially,age,anther,apex,apparently,attenuate,base,berry,branch,branched,branching,c.,calyx,cm,corolla,difoliate,entire,filament,fork,fruiting,glabrous,globose,green,growth,inflorescence,leaf-opposed,lengthening,lobed,lower,margin,maturity,mm,pedicel,petiole,pore,poricidal,shiny,shrub,simple,slit,small,sparse,stem,surface,time,tip,tree,trichome,tube,uniseriate,unit,way,white,x	.5,0.1,06a,1,1-1.5,1-5,1.5-2.2,1.5-3-4,1.5-3.2-6,1.6-2.2,10-40,2-3,2-6,2-lobed,2.1-2.6,2.5-3,3.5-4,4-5,6-9,7-10-25,9-13,absent,acuminate,along,anthesi,apart,appearing,axil,bark,broadly,brown,caly,clavate,completely,conical,cucullate,dark,deltate,dense,densely,diameter,dry,drying,eaf,eed,elliptic,erect,et,exerted,fide,flattened,flower,free,fusiform,geminat,glabrou,hairy,hollow,hooked,irregularly,junction,kallunki,lamina,less,lobe,markedly,midrib,minutely,new,nflorescence,nodding,occasionally,ovary,ovoid,pair,pale,papillat,papillate,paulo,peduncle,penden,perfect,pitted,planar,plane,pointed,population,portion,primary,pulp,rachi,rarely,red-papillat,reddish,reniform,ruit,scar,shattering,slender,sometimes,spaced,sparsely,specimen,sticky,stigma,stout,straight,strongly,structurally,style,sweet-scented,swollen,são,thickened,tuft,ud,usually,vein,woody,yellow,yellowish,ympodial	articulation,bract,broad-based,cell,colour,form,fruit,geminate,hair,heteromorphism,insertion,interjected,interpetalar,leaf,leaflet,length,marking,na,needle-like,odour,orientation,paired,placement,position,prickle,pseudostipule,rhizome,scale,shape,smell,spot,staman,stone,structure,symmetry,sympodial,texture,tissue,tuber,type,vegetative,xylopodia	.25,0.5-1,1.5-2,1.5-6,3-4,3.5-5,abaxially,adaxially,age,apparently,attenuate,base,berry,branch,branched,c.,cm,difoliate,entire,fork,glabrous,globose,green,leaf-opposed,lengthening,lobed,maturity,mm,poricidal,shiny,shrub,simple,slit,small,sparse,time,tip,tree,trichome,uniseriate,way,white,x	geminate,na
183	wfo-0001027889	success	151	129	89	100	51	29	85	4	-2.5,-pubescent,.5,0.5-1,0.5-11,0.7-2,1,1-10,1-3.5,1.5,10-12,10-20,10-30,2-20,3-4,3-8,3-9,abaxially,acute,acute-acuminate,adaxially,apex,apiculate,basal,base,calyx,chartaceous,cm,connective,connivent,cylindrical,darker,deltate,densely,diameter,dilated,directed,distally,eglandular-puberulent,eglandular-pubescent,elliptic,entire,equal,exceeding,finely,flower,fruit,glabrous,glandular-,green,greenish,immature,introrse,laterally,leaving,length,light,lobe,long,longitudinal,margin,mm,moderately,oblong,ovate,ovoid,pedicel,pedicellar,peduncle,petiole,pore,probably,puberulent,puberulent-pubescent,rachi,radiu,remnant,ripe,shrub,simple,slightly,somewhat,sparsely,stellate,stigma,stripe,style,subcordate,subcoriaceous,thecae,tip,tree,truncate,unbranched,unit,unknown,violet,white,x,yellowish	.5-2,0,1-3,1.5-2,2-3,4-foliat,5-10,acuminate,aggregate,apart,ape,articulated,axe,beyond,blade,capitat,cell,color,eaf,eed,exserted,extending,lon,lower,narrow,nflorescence,nther,orolla,perfect,presen,present,puberulen,puberulent-pubescen,ruit,small,spaced,stamen,stone,swelling,tal,tem,time,tomento,tomentose,triangular,tube,ud,vary,wide,yello,ympodial	4-foliate,anther,articulation,branching,bud,capitate,colour,corolla,form,growth,hair,height,inflorescence,leaf,na,number,ovary,plant,position,seed,shape,size,stem,structure,sympodial,texture,theca,type,yellow	-2.5,-pubescent,.5,0.5-1,0.5-11,0.7-2,1,1-10,1-3.5,1.5,10-12,10-20,10-30,2-20,3-4,3-8,3-9,abaxially,acute,acute-acuminate,adaxially,apex,apiculate,basal,base,chartaceous,cm,connivent,cylindrical,darker,deltate,densely,dilated,directed,distally,eglandular-puberulent,eglandular-pubescent,elliptic,entire,equal,exceeding,finely,fruit,glabrous,glandular-,green,greenish,immature,introrse,laterally,leaving,light,lobe,long,longitudinal,mm,moderately,oblong,ovate,ovoid,pedicellar,probably,puberulent,puberulent-pubescent,remnant,ripe,shrub,simple,slightly,somewhat,sparsely,stellate,stripe,subcordate,subcoriaceous,thecae,tip,tree,truncate,unbranched,unknown,violet,white,x,yellowish	4-foliate,capitate,na,yellow
184	wfo-0001027901	success	156	116	61	82	74	34	59	2	.25,.5,0.3-1.2,0.5-1,0.8-1,0.8-2,0.9-2.3,1-1.5,1-2.5,1.5-1.8,1.8-4.5,2.5-3,3-5,4-5,4.7-12,abaxial,abaxially,acuminate,acute,adaxially,anther,anthesi,apex,area,attenuate,bark,base,broadened,brown,cm,corolla,dark,difoliate,direction,elliptic,filament,firm,fleshy,fruiting,glabrous,globose,inflorescence,leaf,lobed,major,matrix,minor,minutely,mm,nearly,opposite,orbicular,oriented,ovary,ovoid-reniform,papillose,pedicel,petiole,pore,pubescent,rounded,shape,shaped,shiny,shrub,simple,single,size,stigma,style,swollen,tear-drop,tip,translucent,trichome,tube,uniseriate,unit,usually,white,x,yellow	1-2,4-10-flowered,6-7,?,ba,beneath,berry,bright,brow,calyx,closely,conical,curled,deflexed,densely,dia,differing,dry,drying,eaf,edicel,eed,ellipsoid,exserted,free,fresh,geminat,green,imbedded,immature,keeled,later,lateral,like,lobe,lon,long,lower,main,material,middle,midrib,nflorescence,older,overlappin,pair,papillo,pitted,planar,poricidal,portion,prominently,reddish,reflexed,rest,ripe,ruit,scar,slender,spaced,sparsely,stem,straight,strongly,surface,tall,triangular,tub,ud,vein,widest,woody,ympodial,young	apical,articulation,cell,colour,diameter,form,fruit,geminate,growth,height,heteromorphism,insertion,length,margin,na,odour,orientation,paired,placement,plant,position,prickle,pseudostipule,rhizome,seed,staman,stone,structure,symmetry,sympodial,texture,tuber,type,xylopodia	.25,.5,0.3-1.2,0.5-1,0.8-1,0.8-2,0.9-2.3,1-1.5,1-2.5,1.5-1.8,1.8-4.5,2.5-3,3-5,4-5,4.7-12,acuminate,acute,area,attenuate,base,broadened,brown,cm,dark,difoliate,direction,elliptic,firm,fleshy,glabrous,globose,leaf,lobed,minutely,mm,nearly,opposite,orbicular,oriented,ovoid-reniform,papillose,pubescent,rounded,shaped,shiny,shrub,simple,single,style,swollen,tear-drop,tip,translucent,trichome,uniseriate,usually,white,x,yellow	geminate,na
185	wfo-0001027902	success	128	141	68	83	45	58	65	3	-2.5,0.5-1,1-1.5,1-6,10-20,15-30,2,2-12,2-15,2-3,2-8,2-9,20-50,3-4,3-5,4-25,4-5,5-20,6-37,7-9,acute,angled,apart,apex,base,branched,calyx,cell,chartaceous,cm,cordate,cylindrical,deeply,densely,diameter,distally,eglandular,entire,flower,forked,fruit,glandular,globose,hair,inflated,lobe,long,margin,mm,moderately,narrowly,obtuse,ovate,pedicel,pedicellar,peduncle,petiole,pore,puberulent,pubescent,purple,purplish,rachi,radiu,remnant,shrub,simple,small,sparsely,stellate,stigma,stone,style,subcoriaceous,tree,triangular,truncate,unbranched,unknown,usually,whitish,x,yellow	1-2,1.5-3,10-15,3-foliat,8-13,abaxially,absen,acuminate,adaxiall,adaxially,aggregate,articulated,axe,blade,color,connivent,directed,distall,eaf,eed,glabrous,leaving,like,lon,lower,nearly,nflorescence,nther,orolla,pubescen,reticulate,ripe,ruit,spaced,ste,tal,tem,time,tip,truncat,tube,unit,vary,wide,ympodial	abaxial,absent,adaxial,anther,arrangement,articulation,bract,branching,breeding,colour,connective,corolla,direction,filament,form,fruiting,growth,height,heteromorphism,inflorescence,insertion,interjected,interpetalar,leaf,leaflet,length,marking,mature,modification,na,odour,orientation,ovary,paired,pattern,placement,plant,position,prickle,pseudostipule,reticulation,rhizome,scale,seed,shape,size,spacing,spot,staman,stem,symmetry,system,texture,tissue,trichome,tuber,type,xylopodia	-2.5,0.5-1,1-1.5,1-6,10-20,15-30,2,2-12,2-15,2-3,2-8,2-9,20-50,3-4,3-5,4-25,4-5,5-20,6-37,7-9,acute,angled,apart,base,branched,chartaceous,cm,cordate,cylindrical,deeply,densely,distally,eglandular,entire,forked,glandular,globose,hair,inflated,long,margin,mm,moderately,narrowly,obtuse,ovate,puberulent,pubescent,purple,purplish,shrub,simple,small,sparsely,stellate,subcoriaceous,tree,triangular,truncate,unbranched,unknown,usually,whitish,x,yellow	absent,na,trichome
186	wfo-0001027929	success	193	156	109	112	81	44	97	12	1,1-4,1-8,1.0-1.3,10,2,2.0-3.0,20,3.5-5,35,4-30,4-5,4-6,5-lobed,acuminate,acute,along,angular,apex,apical,apically,base,branched,cell,center,cm,coat,color,connate,cordate,corolla,covering,cuneate,cyme,deep,dehiscent,diameter,dichasial,dichasially,distal,elliptic,except,filament,flower,generally,glabrous,globose,green,hair,hair-like,half,herbaceous,interjected,introrse,lanceolate,lateral,leaflet,lower,make,maturing,middle,mm,monochasial,mucilaginous,narrowly,nearly,obliquely,occasional,odd-pinnate,often,ovate,ovoid,pair,perennial,petiolule,plant,poricidally,puberulent,purple,radiating,rhizomatous,rhizome,rotate,rounded,seed,shape,short,size,slightly,slit,sometimes,spot,star,stigma,style,symmetrically,terete,terminal,testal,thick,tinged,tip,typically,unbranched,unit,vein,violet,violet-blue,wall,white,wider,without	0.2-0.9,1-10,1.5-4,15,2-3,3-6-foliat,5-10,5-6,6-15,abaxially,acumen,adaxially,apiculate,articulate,ba,basal,becoming,beyond,calyx,caudate,cente,clasping,dark,darker-violet-blue,decreasing,digestion,eaf,ebracteate,eed,embryo,emoval,enzyme,erect,exceeding,forked,formed,globo,green-white,honeycomb,included,light,living,lobe,lon,long,mostly,nflorescence,nther,oblong,orolla,pattern,pedicel,peduncle,pentagonal,perfect,petiolate,petiolulate,purpl,rarely,reduced,reveal,rotate-,ruit,semi-lunate,sessile,seudostipule,somewhat,specimen,stamen,ste,straight,subequal,tem,trailing,usually,vary,visible,wid,wide,yellow,ympodial	3-6-foliate,anther,arrangement,branching,broad-based,colour,connective,form,fruit,growth,height,heteromorphism,inflorescence,leaf,length,marking,modification,na,needle-like,number,orientation,ovary,petiole,placement,pore,position,present,prickle,pseudostipule,rotate-pentagonal,staman,stellate,stem,stone,structure,surface,symmetry,sympodial,texture,tuber,type,wet,width,xylopodia	1,1-4,1-8,1.0-1.3,10,2,2.0-3.0,20,3.5-5,35,4-30,4-5,4-6,5-lobed,acuminate,acute,along,angular,apical,apically,branched,cell,center,cm,color,connate,cordate,corolla,covering,cuneate,cyme,deep,dehiscent,dichasial,dichasially,distal,elliptic,except,generally,glabrous,globose,green,hair,hair-like,half,herbaceous,introrse,lanceolate,lateral,leaflet,lower,make,maturing,middle,mm,monochasial,mucilaginous,narrowly,nearly,obliquely,occasional,odd-pinnate,often,ovate,ovoid,perennial,plant,poricidally,puberulent,purple,radiating,rhizomatous,rotate,rounded,seed,shape,short,size,slightly,slit,sometimes,star,symmetrically,terete,testal,thick,tinged,tip,typically,unbranched,vein,violet,violet-blue,wall,white,wider,without	3-6-foliate,broad-based,leaf,na,needle-like,present,prickle,rotate-pentagonal,stellate,stem,surface,wet
187	wfo-0001027948	success	180	160	83	101	79	59	80	3	.5,0.5-0.7,0.5-2,0.8-1.2-2.2,1-1.2,1-2,1.3-1.8,1.5-4.5,10-14,14,2.2-3-8.2,2.5-3.2-5.2-6,3.7-4,5-,5-7-15-16,7.5-10,8-celled,acuminate,aggregate,anther,apex,articulate,attenuate,basal,base,berry,calyx,campanulate,cell,cm,connectival,corolla,delicate,diameter,difoliate,edentate,ellipsoidal,elliptical,filament,finely,fragrance,fruiting,glabrous,glandular,globose,head,herb,herbaceous,hollow,ill-smelling,leaf,length,light,lobe,longitudinally,lower,margin,mm,narrow,narrowly,near,non-glandular,occasionally,ovate,ovoid,pericarp,petiole,pore,poricidal,prolongation,pubescence,pubescent,purple,ridged,serrulate,simple,single-celled,slightly,small,solitary,spur-like,stalk,stem,stigma,stone,straight,striate,style,sub-opposite,sub-shrub,tip,trichome,tube,unequal,unit,verrucate,violet,viscid-pubescent,x,¼,½	0-,0.4,0.6,1.6,1/10,13-15,2-,3.5,5,6-celled,7,abaxially,abundant,accrescen,adaxially,ag,antrorse,ape,ature,bicellular,branch,c.,crushed,cuticle,dark,diamete,directed,dorsally,eaf,erect,flexuous,free,generally,hig,inconspicuous,inserted,lamina,long,long-stalked,longer,longitudinal,many-,midvein,odorles,opening,orolla,pair,papillate,patent,portion,reduced,ree,ruit,saddle-shape,scarce,scarcely,secondary,seed,seeded,seen,separated,short-stalked,shorter,sinus,slit,smooth,striat,tem,thecae,thickened,time,tooth,triangular,twice,upward,vary,vein,ventrifixed,ympodial	accrescent,appressed,arrangement,articulation,bract,branching,breeding,broad-based,colour,connective,edentation,form,fruit,growth,hair,height,heteromorphism,inflated,inflorescence,insertion,interjected,interpetalar,leaflet,marking,mature,modification,na,needle-like,odour,orientation,ovary,paired,pattern,pedicel,placement,plant,position,prickle,pseudostipule,rhizome,ridging,saddle-shaped,scale,shape,size,smell,spot,staman,structure,surface,symmetry,sympodial,system,texture,tissue,tuber,type,vegetative,xylopodia	.5,0.5-0.7,0.5-2,0.8-1.2-2.2,1-1.2,1-2,1.3-1.8,1.5-4.5,10-14,14,2.2-3-8.2,2.5-3.2-5.2-6,3.7-4,5-,5-7-15-16,7.5-10,8-celled,acuminate,aggregate,apex,articulate,attenuate,basal,base,berry,campanulate,cell,cm,connectival,delicate,diameter,difoliate,edentate,ellipsoidal,elliptical,finely,glabrous,glandular,globose,herb,herbaceous,hollow,ill-smelling,light,longitudinally,margin,mm,narrow,narrowly,near,non-glandular,occasionally,ovate,ovoid,poricidal,prolongation,pubescent,purple,ridged,serrulate,simple,single-celled,slightly,small,solitary,spur-like,stone,straight,striate,sub-opposite,sub-shrub,tip,trichome,unequal,verrucate,violet,viscid-pubescent,x,¼,½	accrescent,na,saddle-shaped
188	wfo-0001027961	success	177	159	78	100	77	59	72	6	.5,0.5-1,1-1.5,1-5,2-2.5,3-3.5,4.5-5,5-8,6-9,8-10,?,abaxially,acute,always,anther,apex,articulated,asymmetric,base,berry,branched,calyx,clavate,cm,cordate,corolla,curling,densely,diameter,ellipsoid,elliptic,entire,fading,filament,flower,fruiting,glabrous,globose,green,growth,immature,inflorescence,irregularly,lateral,lobe,lobed,lower,many,margin,mature,membranous,midrib,minute,minutely,mm,new,obovate,observed,occasionally,often,other,pedicel,peduncle,perfect,petiole,pinnatifid,plurifoliate,pore,poricidal,present,pubescent,purple,reddish,rotate-stellate,scar,simple,slightly,spaced,sparsely,stem,stigma,style,surface,terminal,time,tip,triangular,trichome,truncate,tube,twining,uniseriate,unit,upper,vine,violet,white,white-pubescent,woody,x	0.25,0.25-0.5,0.9-1,1,1-3,1-4,1-9,10-50,2.3-2.5,2.5-9,5-merou,7-9,<,adaxiall,adaxially,age,alyx,anthesi,apar,ark,axil,broadly,brow,c.,clear,conical,connivent,deltate,distributed,eaf,early,eed,equalling,exserted,free,fusiform,geminat,ilament,lamina,lengthening,lon,long,loosely,maturity,nflorescence,older,one,orolla,pair,papillo,pendan,pericarp,pinched,planar,portion,primary,probably,pubescen,ruit,shiny,sleeve,slender,slit,small,spreading,tem,thin,transition,tuft,twinin,ud,unequal,vary,vein,way,yellow,ympodial	apart,appressed,arrangement,articulation,bark,bract,branching,breeding,broad-based,brown,cell,colour,connective,form,fruit,geminate,hair,heteromorphism,inflated,insertion,interjected,interpetalar,leaf,leaflet,length,longest,marking,modification,na,needle-like,odour,orientation,ovary,paired,papillose,pattern,placement,position,presence,prickle,pseudostipule,rhizome,scale,seed,shape,smell,spot,staman,stone,structure,symmetry,sympodial,system,texture,tissue,tuber,type,vegetative,xylopodia	.5,0.5-1,1-1.5,1-5,2-2.5,3-3.5,4.5-5,5-8,6-9,8-10,?,abaxially,acute,always,articulated,asymmetric,base,berry,branched,clavate,cm,cordate,curling,densely,ellipsoid,elliptic,entire,fading,glabrous,globose,green,immature,irregularly,lateral,lobed,many,mature,membranous,minute,minutely,mm,obovate,observed,occasionally,often,other,perfect,pinnatifid,plurifoliate,poricidal,present,pubescent,purple,reddish,rotate-stellate,simple,slightly,spaced,sparsely,terminal,time,tip,triangular,truncate,twining,uniseriate,vine,violet,white,white-pubescent,woody,x	apart,brown,geminate,longest,na,papillose
189	wfo-0001027966	success	207	116	60	67	140	49	51	9	1-2,1-4.2,10,3-4,4,absent,anther,apex,asymmetrical,axillary,base,berry,blue-violet,bud,cell,chartaceous,cm,commonly,conical,corolla,filament,forked,fruit,green,hair,hair-like,herb,homostylous,interjected,lanceolate,leaf,leaflet,lengthening,light,long,lower,margin,membranous,middle,minute,mm,moniliform,odd-pinnate,pedicel,pentagonal,petiole,plurifoliate,pore,poricidal,proximal,purple,rarely,ripe,rotate,sessile,slit,stem,subsessile,subtending,symmetrical,terminal,tip,tissue,tri-,tuber,unit,usually	0.4-0.5,0.7-3,0.8,0.8-2.5,1-1.8,1-10,1-3,1-5,1.2-4.5,1.3-2.2,1.5-3,1.5-5.2,10-30,2.2-2.9,2.5-10.5,2.8-9,3-5,3-7,40-80,5-10,5-6,5-9.5,5-merou,5.5-14,6-11,abaxially,acumen,acuminate,adaxially,ag,along,alyx,apart,apparently,arranged,articulated,attenuate,axe,basiscopic,bead,blade,brownish,capitat,ciliate,condition,connivent,covering,decreasing,densely,diameter,digestion,distal,dorsally,drying,eaf,edge,eed,elliptic,enzyme,erec,especially,exceeding,flat,flower,folded,fresh,geminat,generally,glabrou,glabrous,gradually,green-white,greenish,half,honeycomb-shaped,larger,lateral,less,like,living,lobe,make,medium,mottled,mucilaginous,multiple,narrow,necklace,nflorescence,orbicular,orolla,ovate,ovoid,pair,pale,peduncle,perfect,petiolule,plant,pubescent,ray,removed,ruit,secondary,seed,semierect,seudostipule,shorter,side,size,slightly,somewhat,spaced,sparsely,specimen,stamen,ste,stigma,stolon,straight,subequal,tall,tamen,tem,testal,thick,throughout,tube,tyle,typically,violet,wall,wet,white,whitish,wide,wing,x,yellow,ympodial	age,appressed,articulation,bract,branching,breeding,broad-based,calyx,colour,connective,form,fruiting,growth,heteromorphism,inflated,inflorescence,insertion,interpetalar,length,marking,mature,modification,na,needle-like,odour,orientation,paired,pattern,placement,position,prickle,pseudostipule,rhizome,scale,shape,spot,staman,stellate,stone,structure,surface,symmetry,sympodial,system,texture,type,xylopodia,zygomorphy,¼	1-2,1-4.2,10,3-4,4,absent,asymmetrical,axillary,berry,blue-violet,bud,chartaceous,cm,commonly,conical,forked,green,hair-like,herb,homostylous,lanceolate,leaf,lengthening,light,long,lower,membranous,middle,minute,mm,moniliform,odd-pinnate,pentagonal,plurifoliate,pore,poricidal,proximal,purple,rarely,ripe,rotate,sessile,slit,stem,subsessile,subtending,symmetrical,terminal,tip,tri-,usually	age,broad-based,na,needle-like,prickle,stellate,surface,zygomorphy,¼
190	wfo-0001028014	success	218	117	54	65	153	52	50	4	/5,0.2-1.6-2.5,0.5-1,1/4-1/2,4.5-7,anther,apex,apparently,articulated,base,berry,branched,calyx,cell,chartaceous,cm,connivent,cordate,curved,difoliate,elongating,equal,filament,flattened,fruit,fruiting,glabrous,lateral,leaf,length,lobed,long,lower,margin,mature,maturity,mauve,membranous,mm,occasionally,orange,pedicel,petiole,poricidal,prickle,purple,red,reflexed,rounded,shrub,simple,spherical,spreading,stellate,stellate-pubescent,stem,straight,strongly,surface,tapering,terminal,tip,trichome,unit,way	-15,-4,-6,.5,0-10,0-3,0-5,0-6,0.1-0.2,0.15,0.15-0.3-0.5,0.2,0.2-0.4,0.2-0.4-1,0.2-1,0.25,0.3-0.4,0.5,0.5-1.5,0.5-2,0.5-3,0.6-0.9,0.7-1,0.7-1.6,0.9-1.2,1-10,1-2,1-2-20,1-3,1-4,1.3-2.4,1.5,1.5-2,1.8-3,1/4,1/4-2/3,2-3,2-4.5,2-6.5,2.5-4,3-10,4-10,5-merous,6-10,6-11,abaxially,acuminat,almost,alyx,ame,apar,apart,apically,around,bark,black,blade,broad-deltate,brown,brown-green,c.,concolorous,decurrent,deltate,densely,diameter,discolorous,distance,drying,eaf,edge,eed,erect,extending,eye,flattened-reniform,flower,free,geminat,glabrescent,glabrou,gland,globular,gray,gray-green,herbaceous,infructescence,lobe,lon,longer,midpoint,midvein,moderately,naked,nflorescence,obtuse,older,one,open,orange-gra,orolla,oung,outer,outline,ovate,pair,pale,peduncle,pendulous,per,perfec,pericarp,pit,porrect,portion,prickl,prickly,primary,raised,ray,reduced,rough,ruit,scandent,scar,seed,sessile,shiny,shorter,side,slender,smooth,sometimes,spaced,stalk,stalked,style,tamen,terete,tertiary,time,tube,vary,vein,venation,visible,visibly,weakly,wide,winged,yellow,yellow-green,ympodial	appressed,articulation,bract,branching,breeding,broad-based,colour,connective,corolla,form,geminate,growth,hair,heteromorphism,inflated,inflorescence,insertion,interjected,interpetalar,leaflet,marking,modification,na,needle-like,odour,orientation,paired,pattern,perfect,placement,pore,position,present,pseudostipule,rhizome,scale,shape,smell,spot,staman,stone,structure,symmetry,sympodial,system,texture,tissue,tuber,type,vegetative,xylopodia,zygomorphy	/5,0.2-1.6-2.5,0.5-1,1/4-1/2,4.5-7,apparently,articulated,base,berry,branched,chartaceous,cm,connivent,cordate,curved,difoliate,elongating,equal,flattened,fruit,glabrous,lateral,length,lobed,long,mature,maturity,mauve,membranous,mm,occasionally,orange,poricidal,purple,red,reflexed,rounded,shrub,simple,spherical,spreading,stellate,stellate-pubescent,straight,strongly,surface,tapering,terminal,tip,way	geminate,na,perfect,present
191	wfo-0001028017	success	158	117	63	69	89	48	60	3	1,3-12,abaxially,absent,adaxially,apex,articulated,basal,base,calyx,cell,chartaceous,cm,connective,connivent,cream,cuneate,directed,distally,eglandular,ellipsoidal,entire,exceeding,forked,fruit,fusiform,glabrous,glandular,green,greenish,hair,immature,introrse,lanceolate,leaving,lobe,long,margin,mm,near,oblique,pedicel,pedicellar,perfect,petiole,pointed,pore,purple,purplish,rarely,remnant,ripe,shorter,simple,slightly,sometimes,stellate,stellate-campanulate,stone,subcoriaceous,tan,thecae,tree,truncate,unbranched,unit,white,without,yellow	-2.5,0.3-1,1-10,1-2,1-3,1.5-2,10-22,13-40,15-35,15-50-flower,2,2-3,2-4,2.5-5,3,3-14,3-4,3-foliat,40-50,5,5-7,5-9,6-7,6-8,9-11,absen,acuminate,acute,aggregate,apart,ape,apiculate,axe,beyond,blade,brown,ciliat,clavate,cylindrical,densely,diameter,eaf,eed,eglandular-puberulent,eglandular-pubescent,elliptic,exserted,flattened,fleshy,flower,glandular-,glandular-puberulent,lon,lower,moderately,narrowly,nflorescence,nther,obtuse,orolla,ovate,ovoid,peduncle,puberulen,pubescent,rachi,radiu,ruit,short-acuminate,small,spaced,sparsely,stamen,stigma,style,tal,tem,time,tip,tomentose,triangular,truncat,tube,ud,vary,vein,wide,x,ympodial	3-foliate,anther,appressed,arrangement,articulation,berry,bract,branching,breeding,colour,corolla,filament,form,fruiting,growth,heteromorphism,inflated,inflorescence,insertion,interjected,interpetalar,leaf,leaflet,length,marking,mature,na,odour,orientation,pattern,placement,position,prickle,pseudostipule,rhizome,scale,shape,spot,staman,structure,symmetry,sympodial,system,texture,tissue,tuber,type,xylopodia	1,3-12,abaxially,absent,adaxially,apex,articulated,basal,base,chartaceous,cm,connivent,cream,cuneate,directed,distally,eglandular,ellipsoidal,entire,exceeding,forked,fusiform,glabrous,glandular,green,greenish,hair,immature,introrse,lanceolate,leaving,lobe,long,margin,mm,near,oblique,pedicellar,perfect,pointed,purple,purplish,rarely,remnant,ripe,shorter,simple,slightly,sometimes,stellate,stellate-campanulate,subcoriaceous,tan,thecae,tree,truncate,unbranched,white,without,yellow	3-foliate,berry,na
192	wfo-0001028033	success	157	142	64	83	74	59	60	4	1.4–1.8,2–4,2–foliate,3–4,3–5,4–12,4–5,50,6–12,abaxially,anther,apex,attenuate,base,brochidodromous,brown,calyx,cell,chartaceous,ciliate,cm,cylindrical,cyme,darker,decurrent,densely,diameter,discolorous,drying,elliptic,entire,few-branched,filament,flower,fruit,glabrescent,glabrous,green,greenish,growth,herb,hispid-pubescent,introrsely,lateral,length,light,like,lobe,long,lower,margin,mm,new,oblong,pedicel,perfect,petiole,pore,pubescence,pubescent,rhizomatous,shiny,shrub,simple,slightly,solitary,sparsely,spreading,stellate,stem,stigma,straight,style,surface,trichome,unbranched,uniseriate,unit,upright,venation,white,wide,woody	.6,1.5,1–4,1–5,2–3,3,3–11,5-merou,5–7,acuminate,acute,adaxiall,adaxially,along,alyx,anthesi,ark,ascending,becoming,blade,branch,capitat,connivent,contiguou,cordate,deeply,denser,directed,eaf,eed,emarginate,equal,eye,florescence,geminat,high,know,known,linear-lanceolate,lobed,longitudinal,mainly,membranaceous,midrib,naked,nearly,older,onto,opening,order,orolla,ovate-lanceolate,poricidal,prominent,prostrat,recurved,ruit,secondary,sessile,shin,shorter,slit,strongly,subapical,tamen,tem,tube,unknown,vary,vein,visible,yellow,ympodial,×	5-merous,appressed,arrangement,articulation,bark,bract,branching,breeding,broad-based,capitate,colour,connective,corolla,form,fruiting,hair,height,heteromorphism,inflated,inflorescence,insertion,interjected,interpetalar,leaf,leaflet,marking,mature,modification,na,needle-like,odour,orientation,ovary,paired,pattern,placement,plant,position,prickle,pseudostipule,rhizome,scale,seed,shape,smell,spot,staman,stone,structure,symmetry,sympodial,system,texture,tissue,tuber,type,vegetative,xylopodia,ye	1.4–1.8,2–4,2–foliate,3–4,3–5,4–12,4–5,50,6–12,abaxially,attenuate,brochidodromous,brown,chartaceous,ciliate,cm,cylindrical,cyme,darker,decurrent,densely,discolorous,drying,elliptic,entire,few-branched,glabrescent,glabrous,green,greenish,herb,hispid-pubescent,introrsely,lateral,light,like,long,mm,oblong,perfect,pubescence,pubescent,rhizomatous,shiny,shrub,simple,slightly,solitary,sparsely,spreading,stellate,stem,straight,surface,trichome,unbranched,uniseriate,upright,white,wide	5-merous,capitate,na,ye
193	wfo-0001028067	success	138	85	47	59	79	26	46	1	0.5-2,1-10-30,1-7,1.5-2.5,10-25,2,2-2.5,2.5-3,3-5,5-7,6-18,7-11-compound,acuminate,acute,apex,base,calyx,cm,cuneate,dark,diameter,elliptic-fusiform,elliptic-ovate,entire,flattened,fruit,glabrous,hair,leaf,lobe,margin,mm,moderately,narrowly,obtuse,pedicel,petiole,pink,pinnately,pore,puberulent,purple,radiu,rarely,shrub,simple,slightly,sparsely,stellate,strongly,subcoriaceous,tip,tomentulose,triangular,triangular-deltate,truncate,unbranched,x,yellow	0.5-1,0.5-1.5,1,1-11,1-2,1-3,2-3,3-17,3-4,3-7,4-foliat,6-12,7-20,7-9,8-13,abaxially,adaxiall,adaxially,aggregate,along,apart,articulated,axe,basiscopically,blade,cell,chartaceous,color,compound,connivent,cylindrical,decurrent,directed,distall,eaf,eed,especially,flower,glabrou,lateral,leaflet,leaving,lon,long,lower,midrib,nearly,nflorescence,nther,often,orolla,pedicellar,peduncle,per,puberulen,rachi,remnant,ripe,ruit,several,smal,spaced,stigma,stone,style,tal,tem,time,truncat,tube,unequal,unit,unknown,upper,usually,vary,wide,ympodial,zigzag	abaxial,adaxial,anther,arrangement,articulation,branching,colour,connective,corolla,form,fruiting,growth,height,inflorescence,length,modification,na,plant,position,seed,shape,size,spacing,stem,texture,type	0.5-2,1-10-30,1-7,1.5-2.5,10-25,2,2-2.5,2.5-3,3-5,5-7,6-18,7-11-compound,acuminate,acute,base,cm,cuneate,dark,elliptic-fusiform,elliptic-ovate,entire,flattened,glabrous,mm,moderately,narrowly,obtuse,pink,pinnately,puberulent,purple,rarely,shrub,simple,slightly,sparsely,stellate,strongly,subcoriaceous,tomentulose,triangular,triangular-deltate,truncate,unbranched,x,yellow	na
194	wfo-0001028069	success	249	103	39	59	190	44	36	3	0.3-0.45,0.6-4,1-2.7,2-3-branched,2-locular,3-foliate,accrescent,anther,apex,appressed,base,bract,calyx,cell,citru,cm,corolla,decurrent,deep,densely,eglandular,filament,fruit,fruiting,glabrescent,globose,herb,imparipinnate,interjected,interrupted,leaf,leaflet,length,linear,long,lower,margin,mm,oblique,occasionally,orange,pale,patent,pedicel,pentagonal,petiole,present,pseudostipule,pubescent,scent,simple,stem,strong,surface,trichome,uniseriate,unit,weak,yellow	.1,.1-0.2,.2,.5,0.05-0.1,0.1-0.15,0.1-0.2,0.1-0.2-0.4,0.1-0.3,0.1-0.5,0.1-0.6,0.2-0.3,0.2-0.5,0.3,0.3-0.4,0.3-0.6,0.3-0.7,0.3-1,0.4,0.4-0.5,0.4-0.8,0.4-1,0.5,0.5-0.7,0.5-1.8,0.5-2,0.6-1.1,0.7-1,0.7-1.3,0.7-1.5,0.8-1.2,1-2-celled,1-3.5,1-4.5,1.4,1.5-2.0,1.5-3.5-6,1.6-3.2,10,10-12,12,2-17,2-4,2-7,3,3-5-22-30,4-celled,5-25,6-10-30,<,abaxially,absen,abundant,acute,adjacent,adpressed,along,alternate,always,among,anthesi,apical,appearance,appendage,articulated,axi,ba,basal,basioscopically,becoming,berry,bilaterally,bracteole-like,bright,brown,column,composed,cone-shaped,conical,cordate,cuneate,curving,deeply,dense,diameter,due,eaf,ebracteate,edicel,eed,erect,exserted,flower,forming,fusion,giving,gland,gland-tippe,gland-tipped,glandular,glandular-villous,gree,green,hair-like,half,halfway,head,included,initially,internode,larger,later,lateral,less,like,lime,lobe,lobed,lon,longer,longest,maturity,middl,midvein,minute,minutely,multicellular,narrowly,nflorescence,obovate,often,one,outgrowth,ovary,ovate,pair,peduncle,per,perennial,petiolule,plant,population,primary,procumbent,pubescence,quaternary,rarely,reflexed,robust,rounded,ruit,scarcely,secondary,sessile,several,shaggy,short,shorter,silky,single-celled,size,slender,smaller,somewhat,staminal,sterile,stigma,straight,style,subopposite,symmetric,tangled,tem,terminal,tertiary,testa,thick,tightly,toward,transparent,tube,ud,unicellular,usually,varying,viny,wall,wide,winged,ympodial	absent,articulation,branching,breeding,broad-based,colour,form,growth,hair,heteromorphism,inflated,inflorescence,insertion,interpetalar,marking,mature,middle,na,needle-like,odour,orientation,paired,pattern,placement,position,prickle,rhizome,scale,shape,smell,spot,staman,stone,structure,symmetry,sympodial,system,texture,tissue,tuber,type,vegetative,xylopodia,zygomorphy	0.3-0.45,0.6-4,1-2.7,2-3-branched,2-locular,3-foliate,accrescent,citru,cm,decurrent,deep,densely,eglandular,glabrescent,globose,herb,imparipinnate,interrupted,linear,long,mm,oblique,occasionally,orange,pale,patent,pentagonal,present,pubescent,scent,simple,strong,trichome,uniseriate,weak,yellow	absent,middle,na
195	wfo-0001028075	success	196	95	52	72	124	23	49	3	1-10,1.5-2.5,1.5-7,1.6-2.7,10-35,2-4.5,2-6,2.5-10,3-11,3-23.5,5-14,5-17,5-7,5-8,5-9,7-13,7-30,8-12,anther,blade,cell,chartaceous,ciliate,cm,corolla,dark,diameter,flower,forked,fruit,glabrescent,glabrous,globose,green,greenish,hair-like,herb,homostylous,honeycomb-shaped,lanceolate,lateral,leaf,leaflet,light,long,margin,membranous,mm,odd-pinnate,ovoid,pale,pedicel,peduncle,pentagonal,petiole,plant,pore,poricidal,rotate,seed,size,slightly,stigma,style,terminal,testal,tuber,wet,white,whitish,wide,x	.5,1-2,1-2.7,1-3,2-3,4-12,4-7,5-12,5-merou,abaxially,absent,acuman,acumen,acuminate,acute,adaxially,ag,along,alyx,apart,apex,apparently,articulated,axe,axillary,base,berry,borne,broadly,brownish,bud,capitat,condition,connivent,covering,cuneate,decreasing,differentiated,digestion,distal,distally,distinctively,dorsally,dot,drying,eaf,edge,eed,elliptic-lanceolate,end,enzyme,erec,especially,exceeding,filament,flat,folded,fresh,geminat,generally,glabrescen,green-white,half,interjected,larger,lengthening,ligulate,living,lobe,lower,make,middl,midrib,minutely,much,mucilaginous,narrow,nflorescence,oblique,obtuse,often,orolla,ovate,ovate-elliptic,pair,perfect,petiolule,plurifoliate,puberulent,purple,reflexed,removed,rounded,ruit,scattered,seudostipule,singly,slit,sometimes,spaced,specimen,stamen,star,stolo,straight,subcordate,subtending,tall,tamen,tem,thick,throughout,tip,toward,tri-,tube,typically,unit,usually,vary,wall,wing,yellow,ympodial	arrangement,articulation,branching,calyx,capitate,colour,form,growth,hair,height,inflorescence,length,middle,mucilaginousnes,ovary,presence,present,pseudostipule,shape,spacing,stem,symmetry,texture	1-10,1.5-2.5,1.5-7,1.6-2.7,10-35,2-4.5,2-6,2.5-10,3-11,3-23.5,5-14,5-17,5-7,5-8,5-9,7-13,7-30,8-12,chartaceous,ciliate,cm,dark,forked,glabrescent,glabrous,globose,green,greenish,hair-like,herb,homostylous,honeycomb-shaped,lanceolate,light,long,membranous,mm,odd-pinnate,ovoid,pale,pentagonal,poricidal,rotate,slightly,wet,white,whitish,wide,x	capitate,middle,present
196	wfo-0001028076	success	195	95	36	48	147	47	31	5	1-2,4-5,absent,anther,apex,articulated,base,berry,cell,chartaceous,conical,corolla,filament,forked,fruit,green,hair,hair-like,herb,homostylous,interjected,lanceolate,leaf,leaflet,light,margin,membranous,mm,odd-pinnate,pedicel,pentagonal,petiole,plurifoliate,pore,poricidal,proximal,purple,ripe,rotate,sessile,slit,subsessile,symmetrical,terminal,tip,tri-,tuber,unit	.5,0.4-0.5,0.5,1-1.3,1-10,1-3,1.2-2.2,1.8-2.2,110,12-22,13-14,2-12,2-3,2-5.4,2.2-2.6,2.2-3.7,2.5-3,2.5-4,2.6-3.8,4.5-7,5,5-20,5-6,5-6.5,5-merou,7-8,?,abaxially,acumen,acuminate,adaxially,ag,alyx,apart,apparently,attenuate,axe,axillary,blade,borne,brownish,bud,capitat,ciliate,cm,condition,connivent,covering,decreasing,densely,diameter,digestion,distal,dorsally,drying,eaf,edge,eed,elliptic,end,enzyme,erec,especially,exceeding,flat,flower,folded,fresh,geminat,generally,glabrou,glabrous,gradually,green-white,greenish,half,honeycomb-shaped,larger,lateral,lengthening,less,like,living,lobe,long,lower,make,medium,minute,mucilaginous,nflorescence,obtuse,orolla,ovate,ovoid,pair,peduncle,perfect,petiolule,plant,pubescen,pubescent,rarely,ray,removed,round,ruit,secondary,seed,semierect,seudostipule,singly,size,slightly,spaced,specimen,stamen,ste,stem,stigma,stolo,straight,style,subequal,subtending,tall,tamen,tem,testal,thick,thir,throughout,toward,tube,typically,unwinged,usually,vary,wall,wet,white,whitish,wide,wing,x,yellow,ympodial	age,appressed,articulation,bract,branching,breeding,calyx,colour,connective,form,fruiting,growth,heteromorphism,inflated,inflorescence,insertion,interpetalar,length,marking,mature,modification,na,odour,orientation,paired,pattern,placement,position,present,prickle,pseudostipule,rhizome,scale,shape,spot,staman,stone,structure,symmetry,sympodial,system,texture,third,tissue,type,xylopodia,zygomorphy	1-2,4-5,absent,articulated,berry,chartaceous,conical,forked,green,hair-like,herb,homostylous,lanceolate,light,membranous,mm,odd-pinnate,pentagonal,plurifoliate,poricidal,proximal,purple,ripe,rotate,sessile,slit,subsessile,symmetrical,terminal,tip,tri-	age,na,present,third,zygomorphy
197	wfo-0001028105	success	150	90	32	41	109	49	29	3	0.6-1,3.5-4,abaxially,adaxially,anther,apex,attenuate,base,berry,calyx,cm,corolla,difoliate,elliptic,filament,fruiting,glabrous,globose,green,leaf,lobed,long,margin,mm,opposite,pedicel,petiole,pore,poricidal,pubescent,shaped,shrub,simple,small,tear-drop,tip,tree,trichome,uniseriate,unit,white	.1,.4,.5,0.3-1.5,0.5,0.5-1,0.5-2,1-1.2,1-1.5,1-2.5,1.5,1.5-1.8,1.5-2,1.5-4.5,2,2-2.2,2-5,3-5-celled,3-6,5-7-flowered,6-7,9.5-15,acuminate,acute,anthesi,apar,apical,axi,axil,ba,bark,bilobed,clavate,conical,dark,deflexed,dense,dia,differing,distinct,drying,eaf,edicel,eed,ellipsoid,erect,evenly,exserted,filiform,flattened-reniform,free,geminat,glandular,greenish-yello,incrassate,lamina,lateral,like,lobe,lon,lower,main,major,middle,minor,minutely,nearly,nflorescence,occasionally,older,olive-green,ovary,pair,pale,papillo,papillose,pitted,planar,portion,projection,quadrate,reddish-brown,reflexed,ruit,scar,scattered,size,slightly,spaced,sparsely,spreading,stem,stigma,straight,strongly,style,surface,tall,tub,tube,tuft,ud,vein,widest,woody,x,yellowish,ympodial,young	0.1-1,appressed,articulation,bract,branching,breeding,cell,colour,connective,form,fruit,geminate,growth,hair,heteromorphism,inflated,inflorescence,insertion,interjected,interpetalar,leaflet,length,marking,mature,modification,na,odour,orientation,paired,pattern,placement,position,prickle,pseudostipule,rhizome,scale,shape,spot,staman,stone,structure,symmetry,sympodial,system,texture,tissue,tuber,type,xylopodia	0.6-1,3.5-4,abaxially,adaxially,attenuate,berry,cm,difoliate,elliptic,glabrous,globose,green,leaf,lobed,long,mm,opposite,poricidal,pubescent,shaped,shrub,simple,small,tear-drop,tip,tree,trichome,uniseriate,white	0.1-1,geminate,na
198	wfo-0001028109	success	202	121	78	92	110	29	75	3	0.4-0.8,1.5-2.5,1.5-5.5,12-40,2-15,2.3-2.9,2.5-3,2.5-5,2/3-3/4,3-7,30-150,5-13-20,5-30,abaxial,acuminate,acute,adaxial,almost,anther,apart,apex,bark,base,berry,branching,bright,calyx,chartaceous,cm,connivent,cuneate,deltate,densely,dull,elliptic,entire,equal,evenly,filament,flattened-reniform,flower,fruit,fruiting,glabrescent,gray-green,green,green-brown,lateral,leaf,length,light,lobed,long,margin,mature,maturity,mauve,mm,moderately,multangulate,orange-brown,per,perpendicular,petiole,poricidal,prickle,primary,red,red-brown,reflexed,secondary,shrub,simple,small,sometimes,spherical,stalked,stellate,stellate-pubescent,stem,tapering,terminal,tip,tree,trichome,unarmed,way,weakly,white,wide,yellow,young	-7,.5,/3,0.05-0.15,0.05-0.2,0.1,0.1-0.2,0.3,0.4-1.5,0.45-0.65,0.5-1.2,0.5-2.5-4,0.6-0.8,0.7,0.8-1.5,0.8-1.6,1.5-10,1/8-1/4,10-25,10-30,15-100,2-4,20-60,3-4-13,3.5-6,3/4,4-5-merous,8-12,8-15,8-25,abaxially,acut,alyx,ame,apar,apically,apparently,articulated,blade,brow,c.,curved,diameter,dimorphic,discolorous,drying,eaf,eed,elongating,erect,free,fully,geminate,gently,glabrou,glabrous,infructescence,lobe,long-styled,longer,lower,midpoint,minor,nflorescence,obtuse,occasionally,older,one,open,opening,orolla,oung,pair,pedicel,peduncle,perfec,pericarp,plurifoliat,porrect,portion,prickl,prickly,ray,recurved,ruit,scar,sessile,slender,smooth,spaced,spreading,stalk,straight,strongly,style,surface,tamen,terete,tertiary,time,tube,unarme,unit,usually,vary,vein,venation,visible,woody,ympodial	3-13,appressed,brown,colour,corolla,form,growth,hair,heteromorphism,inflated,inflorescence,marking,modification,na,number,odour,orientation,pore,position,seed,shape,size,spacing,spot,staman,symmetry,texture,type,width	0.4-0.8,1.5-2.5,1.5-5.5,12-40,2-15,2.3-2.9,2.5-3,2.5-5,2/3-3/4,3-7,30-150,5-13-20,5-30,acuminate,acute,almost,apart,base,berry,bright,chartaceous,cm,connivent,cuneate,deltate,densely,dull,elliptic,entire,equal,evenly,flattened-reniform,glabrescent,gray-green,green,green-brown,lateral,light,lobed,long,maturity,mauve,mm,moderately,multangulate,orange-brown,per,perpendicular,poricidal,primary,red,red-brown,reflexed,secondary,shrub,simple,small,sometimes,spherical,stalked,stellate,stellate-pubescent,stem,tapering,terminal,tip,tree,trichome,unarmed,way,weakly,white,wide,yellow,young	3-13,brown,na
199	wfo-0001028115	success	159	141	72	87	72	54	69	3	.6,0.42,0.7-0.8-1.1,1-3,1.1-1.8,1.1-1.8-2.5,1.4-1.7,1.7-2.2,1.8-3.5,2-3.2,2.5-3-4.5-5.2,3-5,4.7-5-8.5,5-15,6-10,abaxially,abundant,adaxially,anther,apex,articulate,attenuate,base,berry,blue,calyx,campanulate,capitate,cm,coat,curved,diameter,ellipsoidal,elliptical,entire,evident,filament,fruiting,glabrescent,globose,herb,inflated,length,light,linear,lobe,long,margin,mm,moderately,narrowly,near,non-glandular,ovate,pair,pale,papery-scarious,petiole,pinnatifid,pinnatipartite,pinnatisect,pore,poricidal,pubescent,rarely,reticulate,seed,simple,slightly,stem,stigma,style,tip,trans-ovoidal,triangular,trichome,tube,tuberculate,unifoliate,uniseriate,unit,venation,violet,wide,wider,x,yellow	.2,0.2-0.3,0.5,0.6-0.7,0.8-1-2.4,1.3-1.8,12-13.5,2-3-6.5,7-7.5,9-17,accrescent,acuminat,acute,ag,alternate,amply,annular,antrorse,basal,blade,connectival,difoliat,dorsal,eaf,eed,embryo,especially,exceeding,glabrous,glandular,growing,half,herbaceous,hig,longer,longitudinal,longitudinally,lower,mixed,much,multi-seeded,nerve,oblong,one,opening,opposite,orolla,papillo,portion,prolongation,prostrate,ree,ridged,ruit,scarce,segment,similar,slender,slit,small,smooth,sometimes,strongly,styl,subsessil,tem,time,unequal,vary,width,winged,ympodial	arrangement,articulation,bract,branching,breeding,cell,colour,connective,corolla,difoliate,form,fruit,growth,hair,height,heteromorphism,inflorescence,insertion,interjected,interpetalar,leaf,leaflet,marking,mature,modification,na,odour,orientation,ovary,paired,pattern,pedicel,placement,plant,position,prickle,pseudostipule,rhizome,scale,shape,size,spot,staman,stone,structure,symmetry,sympodial,system,texture,tissue,tuber,type,xylopodia,zygomorphy	.6,0.42,0.7-0.8-1.1,1-3,1.1-1.8,1.1-1.8-2.5,1.4-1.7,1.7-2.2,1.8-3.5,2-3.2,2.5-3-4.5-5.2,3-5,4.7-5-8.5,5-15,6-10,abaxially,abundant,adaxially,apex,articulate,attenuate,berry,blue,campanulate,capitate,cm,curved,ellipsoidal,elliptical,entire,evident,glabrescent,globose,herb,inflated,light,linear,long,mm,moderately,narrowly,near,non-glandular,ovate,pair,pale,papery-scarious,pinnatifid,pinnatipartite,pinnatisect,poricidal,pubescent,rarely,reticulate,simple,slightly,style,tip,trans-ovoidal,triangular,tuberculate,unifoliate,uniseriate,venation,violet,wide,wider,x,yellow	difoliate,na,zygomorphy
200	wfo-0001028131	success	207	91	51	67	140	24	48	3	0.8-1,0.8-1.1,5-6.5,absent,anther,apex,attenuate,base,berry,branched,calyx,chartaceous,cm,connivent,cream,curved,dark,densely,difoliate,dull,equal,filament,flattened,flattened-reniform,fruit,fruiting,green,herb,lateral,leaf,length,lobed,lower,margin,marking,maturity,mauve,membranous,mm,narrow-obovate,narrow-ovate,orange,orange-brown,pale,per,petiole,poricidal,prickle,prickly,purple,red,reflexed,simple,spherical,spreading,stellate,stellate-pubescent,stem,style,surface,tapering,tip,trichome,unarmed,unit,yellow,young	.1,.5,/5,0-0.6-1.2,0-2,0-3,0-30,0-4,0.05-0.2,0.1-0.15,0.1-0.3,0.2-1.5,0.3-0.7,0.4-0.8,0.5-1.1,0.7-1.1,1-10,1-3,1-4,1-5,1.5-3,1.5-5,1.8-2,1.8-2.2,1/4-2/3,1/5,2-2.8,2-4,2-5,2-6.5,2/3,3-6,4-6,5-8,5-merous,6-7,7-8,abaxial,abaxially,acuminat,adaxial,alyx,apar,apart,apically,apparently,articulated,bark,blade,broad-deltate,cell,concolorous,deltate,diameter,distance,drying,eaf,eed,elongating,epidermi,erect,extending,eye,filiform,flower,free,geminat,glabrescent,glabrous,gland,infructescence,lanceolate,lengt,like,lobe,long,longer,mature,midpoint,midvein,moderately,naked,nflorescence,oblong,obtuse,often,older,one,open,orolla,oung,outline,pair,pale-brown,pale-gra,pedicel,peduncle,pendulous,perfec,pericarp,pit,porrect,portion,prickl,primary,raised,ray,reduced,rounded,ruit,scar,sessil,sessile,shiny,shorter,side,small,smooth,sometimes,spaced,sparsely,straight,strongly,sunk,tamen,terete,tertiary,time,tube,unarme,upper,vary,vein,venation,visible,way,wide,woody,yellow-green,ympodial	20-30,branching,broad-based,colour,corolla,form,geminate,growth,hair,heteromorphism,inflorescence,needle-like,number,orientation,position,present,seed,shape,staman,structure,symmetry,sympodial,texture,type	0.8-1,0.8-1.1,5-6.5,absent,attenuate,berry,branched,chartaceous,cm,connivent,cream,curved,dark,densely,difoliate,dull,equal,flattened,flattened-reniform,green,herb,lateral,lobed,marking,maturity,mauve,membranous,mm,narrow-obovate,narrow-ovate,orange,orange-brown,pale,poricidal,prickly,purple,red,reflexed,simple,spherical,spreading,stellate,stellate-pubescent,tapering,tip,unarmed,yellow,young	20-30,geminate,present
201	wfo-0001028148	success	157	96	38	47	110	49	35	3	1.5,2,5-7,apex,articulated,base,blue-black,branched,calyx,cell,cm,connivent,dark,decurrent,entire,fleshy,fruit,glaucous,globose,hair,highly,less,margin,mature,mm,ovate,pedicel,petiole,pink,plicate,pore,purple,rhizomatous,ripe,rotate-stellate,shrub,simple,slender,sometimes,stone,succulent,tapered,treelet,unit,violet,whitish,x	-6,.5-4,0.25-0.5,0.5-1.5,0.6-3.5,0.75-2,1-15,1-3.5,1.5-2.5,10-30,12-15,15,2-3,2-7,2.5-4,20-50,3.5-4,3.5-9,4-10,4.5-10,5,5-10,5-20,5-8,6-18,abaxially,absen,acute,adaxially,aggregate,angled,apart,apiculate,axe,ba,blade,broadly,central,chartaceous,cylindrical,deltate,densely,diameter,directed,distal,distall,eaf,eed,elliptic,especially,except,flower,fresh,glabrous,light-colored,lobe,long,lower,many-foliat,margi,material,midrib,minute,moderately,narrowly,nflorescence,nther,obtuse,often,orange,orolla,part,peduncle,perfect,plicae,puberulence,puberulent,puberulent-pubescent,rachi,radiu,rarely,ridge,ruit,scalloped,slightly,smoot,smooth,spaced,sparse,star,stigma,style,surface,tal,tem,thickened,time,tip,triangular,truncat,tube,unbranched,usually,vary,white,wide,winge,yellow,ympodial,young	absent,anther,appressed,articulation,bract,branching,breeding,colour,connective,corolla,filament,form,fruiting,growth,heteromorphism,inflated,inflorescence,insertion,interjected,interpetalar,leaf,leaflet,length,many-foliate,marking,modification,na,odour,orientation,paired,pattern,placement,position,prickle,pseudostipule,rhizome,scale,shape,spot,staman,structure,symmetry,sympodial,system,texture,tissue,tuber,type,xylopodia	1.5,2,5-7,articulated,base,blue-black,branched,cm,connivent,dark,decurrent,entire,fleshy,glaucous,globose,highly,less,mm,ovate,pink,plicate,purple,rhizomatous,ripe,rotate-stellate,shrub,simple,slender,sometimes,succulent,tapered,treelet,violet,whitish,x	absent,many-foliate,na
202	wfo-0001028161	invalid_json	124	94	NA	72	52	22	NA	NA	0.1-0.25,0.25-0.5,0.7-1.7,1-1.5,1-2,1-2.3,1.5-4.5,2-9,2.5-3,3-4,3-7,4-5,6-9,7.5-12,abaxially,acuminate,acute,adaxially,along,anthesi,apex,attenuate,bark,base,branched,brown,cell,closely,cm,dendritic,densely,denser,elliptic,fruiting,globose,green,incrassate,lanceolate,leaf,main,major,margin,minor,minutely,mm,narrowly,older,opposite,orbicular,outline,ovoid-reniform,pale,pedicel,petiole,pitted,pubescent,reddish-brown,rounded,shape,shrub,simple,sinuate,size,somewhat,sparsely,stem,surface,tan,trichome,vein,x,young	.5,1-1.3,1/3,2-5-flowered,9-11,arising,ba,berry,branch,calyx,congested,consisting,corolla,deflexed,dia,differing,difoliate,distal,eaf,edicel,eed,exserted,geminat,glabrescen,inflorescenc,later,lateral,like,lon,long,middle,nflorescence,obovoid,often,overlappin,pair,probably,pubescence,rest,ruit,scar,short,spaced,strongly,tall,tapering,thin,tub,ud,unit,widest,ympodial	0.5,1,2-5,characteristic,colour,diameter,flower,form,fruit,glabrescent,growth,height,inflorescence,length,number,placement,plant,position,seed,texture,type,value	NA	NA
203	wfo-0001028164	success	196	97	56	65	131	32	52	4	/4,1-1.5,1-4.5,2.5-4,anther,apex,articulated,attenuate,base,berry,branched,bright,calyx,cm,connivent,difoliate,elongating,entire,equal,erect,evenly,filament,fruit,fruiting,glabrous,green,hair,lateral,leaf,length,lobed,long,lower,margin,mature,maturity,mauve,membranous,midvein,minute,mm,pale,pedicel,petiole,poricidal,recurved,red,shallowly,shrub,simple,sometimes,spherical,spreading,stellate,stem,surface,tapering,terminal,tip,unarmed,undulate,unit,way,white,young	-14,-8,0-20,0.05-0.2,0.05-1.5,0.1,0.3-0.8,0.4-0.8-1,0.5-0.8,0.5-1,0.7-1.1,0.8-1.5,0.9-1.6,1,1.5-2.5,1.8-2.5,1/3,1/6-1/4,12-20,2-2.5,2.5-4.5,2.5-4.5-6,2.8-4,3-17,3-7,3.6-4.8,4-13,4-5-merous,4-7,4-8,6-8,8-15,8-17,abaxial,abaxially,acuminate,acute,almost,alyx,ame,apar,apically,apparently,bark,blade,c.,concolorous,curved,dark,deltate,densely,diameter,drying,dull,eaf,eed,elliptic,eye,filiform,flattened-reniform,flower,free,geminat,glabrescen,glabrescent,glabrou,glandular,gray,infructescence,less,lobe,long-acuminat,longer,midpoint,moderately,multangulate,naked,narrow-deltate,nflorescence,obtuse,often,older,one,open,orange-brown,orolla,oung,pair,peduncle,per,perfec,pericarp,porrect,portion,primary,ray,red-brown,reflexe,ruit,scar,sessile,shorte,shorter,side,smooth,spaced,sparsely,stalk,stalked,stellate-pubescent,straight,style,tamen,terete,tertiary,time,trichome,tube,unarme,upper,variously,vary,vein,venation,visible,wide,woody,yellow,yellow-gra,yellow-green,ympodial	articulation,branching,cell,colour,corolla,form,geminate,growth,heteromorphism,inflorescence,insertion,na,odour,orientation,placement,position,prickle,pseudostipule,reflexed,rhizome,scale,shape,staman,stone,structure,symmetry,sympodial,texture,tuber,type,xylopodia,zygomorphy	/4,1-1.5,1-4.5,2.5-4,articulated,attenuate,base,berry,branched,bright,cm,connivent,difoliate,elongating,entire,equal,erect,evenly,fruit,glabrous,green,hair,lateral,length,lobed,long,mature,maturity,mauve,membranous,midvein,minute,mm,pale,poricidal,recurved,red,shallowly,shrub,simple,sometimes,spherical,spreading,stellate,tapering,terminal,tip,unarmed,undulate,way,white,young	geminate,na,reflexed,zygomorphy
204	wfo-0001028180	success	147	169	103	113	34	56	96	7	.05,.5,/2,1-1.2,1-1.5,1-1.8,1-3,1.5-5,15-28,2-2.2,2-3,2.5-3,3-10,3-4,4.5-5,5-6,5-8,7,8-10,abaxially,acute,adaxially,along,anther,apex,attenuate,bark,base,beginning,berry,c.,calyx,capitate,closely,cm,conical,corolla,cucullate,dark,darker,densely,dia,difoliate,distinctly,drying,elliptic,elongate,erect,falcate,filament,fleshy,four-angled,fruiting,glabrous,globose,golden,green,larger,lateral,leaf,leathery,lobed,long,lower,main,margin,midrib,minor,minutely,mm,nearly,obscure,onto,opposite,ovary,ovoid-reniform,pair,pale,papillose,pedicel,petiole,pinkish-white,pitted,pore,puberulent,pubescent,scar,shaped,shiny,size,small,somewhat,spaced,sparsely,stem,stigma,style,surface,tan,tear-drop,thick,tip,tree,trichome,tube,uniseriate,unit,vein,way,white,winged,x,yellow-gray	0.7-1,20-30-flowered,anthesi,ba,deflexed,deltate,differing,eaf,eed,free,geminat,glabrat,gold,irregularly,know,lobe,lon,major,nflorescence,older,overlappin,planar,poricidal,portion,ruit,simple,straight,styl,tall,ud,underside,woody,ympodial,young	abaxial,articulation,bract,branching,breeding,broad-based,bud,cell,colour,connective,form,fruit,geminate,glabrate,growth,hair,height,heteromorphism,inflorescence,insertion,interjected,interpetalar,known,leaflet,length,marking,na,needle-like,odour,orientation,overlapping,pattern,placement,plant,position,prickle,pseudostipule,rhizome,scale,seed,shape,smell,spot,staman,stone,structure,symmetry,sympodial,system,texture,tissue,tuber,type,vegetative,venation,xylopodia	.05,.5,/2,1-1.2,1-1.5,1-1.8,1-3,1.5-5,15-28,2-3,2.5-3,3-10,3-4,4.5-5,5-6,5-8,7,8-10,abaxially,acute,adaxially,along,attenuate,base,beginning,berry,c.,capitate,closely,cm,conical,cucullate,dark,darker,densely,dia,difoliate,distinctly,drying,elliptic,elongate,erect,falcate,filament,fleshy,four-angled,glabrous,globose,golden,green,larger,lateral,leaf,leathery,lobed,long,main,margin,midrib,minutely,mm,nearly,obscure,onto,opposite,ovoid-reniform,pair,pale,papillose,petiole,pinkish-white,pitted,puberulent,pubescent,shaped,shiny,small,somewhat,spaced,sparsely,style,surface,tan,tear-drop,thick,tip,tree,trichome,tube,uniseriate,vein,way,white,winged,x,yellow-gray	-2.2,di,geminate,glabrate,known,na,overlapping
205	wfo-0001028182	success	150	87	45	58	92	29	42	3	0.5-0.6,0.9-1,1-1.5,2-6.5,3-5,along,anther,apex,arching,bark,base,beneath,branch,calyx,capitate,ciliate,cm,conical,cordate,corolla,filament,filiform,glabrous,inflorescence,leaf,like,lobed,long-acuminate,margin,midrib,mm,narrowly,nearly,ovate,pedicel,petiole,pore,poricidal,purplish,scar,shaped,shiny,shrub,simple,slender,somewhat,stem,stigma,style,tear-drop,tip,trichome,truncate,tube,uniseriate,unit,white,zig-zag	.5,0-90,0.1-0.2,0.5,0.5-1,0.8-1,2,2-2.5,3,4-6,5-15-flowered,5-ribbed,6-9,anthesi,apart,apiculae,apiculate,axi,bending,black,blade,brown,deflexed,deltoid,densely,dia,dry,eaf,edicel,eed,ellipsoid,evenly,except,extreme,flower,free,globose,gre,hemiepiphyte,internodal,keeled,know,known,later,lateral,lax,less,lobe,long,lower,main,material,minute,minutely,nflorescence,obovoid,older,opposite,ovary,pair,papillo,papillose,planar,portion,present,prominent,proximal,pubescent,reflexed,rib,rounded,ruit,sca,slightly,spaced,sparsely,sparser,specimen,spindly,still,strongly,surface,tapering,third,time,ud,unifoliat,vein,widest,x,ympodial,young	branching,cell,colour,form,fruit,grey,growth,hair,heteromorphism,length,na,odour,orientation,placement,prickle,pseudostipule,rhizome,seed,shape,staman,stone,structure,symmetry,sympodial,texture,tuber,type,unifoliate,xylopodia	0.5-0.6,0.9-1,1-1.5,2-6.5,3-5,along,arching,base,beneath,capitate,ciliate,cm,conical,cordate,filiform,glabrous,like,lobed,long-acuminate,midrib,mm,narrowly,nearly,ovate,pedicel,poricidal,purplish,scar,shaped,shiny,shrub,simple,slender,somewhat,stem,tear-drop,tip,trichome,truncate,uniseriate,white,zig-zag	grey,na,unifoliate
206	wfo-0001028183	success	235	102	50	57	178	45	43	7	0.5-2.5,0.7-2,2.8-4.2,accrescent,adaxially,anther,apex,apparently,articulated,attenuate,axillary,base,berry,blunt-tipped,branched,calyx,cell,chartaceous,cm,corolla,cuneate,dull,entire,filament,fruit,fruiting,globose,hair,leaf,lower,many,margin,mm,oblong,pedicel,petiole,plurifoliate,pore,poricidal,porrect-stellate,pseudoterminal,purple,ripe,scabrous,shrub,simple,somewhat,stellate,stem,streak,surface,time,tree,unit,violet,white,yellowish-tomentose	-10,.5-3,0.1,0.1-0.2,0.1-0.4,0.1-0.9,0.2-0.3,0.2-0.4,0.2-0.5,0.5,0.6,0.7-1.2,0.8-1.4,0.8-3.1-5.3,1.1-1.8,1.2-1.4,1.3-1.4,1.3-1.7,1.4-2.8,1.5-3.4,1.6-2.3,1.7-2.7,1.9-3.7,1/3-1/2,10-15,11-30,2-4.2,2-5,2.2-5.7,2.5-4.1,2.6-4.4,3.2-4.6-6.4,3.5-6.6,4.5-9,5-8,5-8.5,5.2-6.2,50-400,6.6-20,7.5-23,8-9.1,9-13,abaxial,abaxially,acute,ag,along,alyx,anthesi,apart,around,axi,bark,blade,branch,brown,bud,capitate,central,closely,cylindrical,dark,deltoid,dendritic-multangulate,diameter,directed,distally,distantly,drying,eaf,earl,edge,eed,elliptic,elongated,epidermal,especially,evident,except,exserted,farinose,few-rayed,flower,free,glabrescen,glabrescent,glabrous,granular-punctate,group,half,high,inserted,lackin,lanceolate,lateral,lengthening,lobe,lobed,lon,long,long-decurrent,longitudinal,m.,main,midrib,multangulate,narrowly,nearly,nflorescence,obovoid,older,open,orangish-tan,orolla,ovate-lanceolate,overlapping,peduncle,perfec,porrect-stellat,present,prominent,pubescence,pubescent,rachi,rarely,relatively,reportedly,reticulate-punctate,ruit,runk,sessile,short,short-,side,slit,small,soon,spaced,sparingly,sparse,spherical,splitting,stage,stalk,stamen,stigma,stipitate-glandular,stout,strongly,style,sub-lenticular,subcampanulate,suture,tamen,tan,terete,thick,thin,thin-textured,tip,tomentose,touching,translucent,tube,ud,unarme,upper,usually,vary,vein,way,whitish,wide,x,yellow,yellowish,ympodial,young	articulation,bract,branching,breeding,broad-based,colour,connective,form,growth,heteromorphism,inflorescence,insertion,interjected,interpetalar,lacking,leaflet,length,marking,na,needle-like,odour,orientation,paired,pattern,perfect,placement,position,prickle,pseudostipule,rhizome,scale,shape,spot,staman,stone,structure,symmetry,sympodial,system,texture,tissue,tuber,type,xylopodia,zygomorphy	0.5-2.5,0.7-2,2.8-4.2,accrescent,adaxially,apparently,articulated,attenuate,axillary,base,berry,blunt-tipped,branched,chartaceous,cm,cuneate,dull,entire,globose,leaf,lower,many,mm,oblong,plurifoliate,poricidal,porrect-stellate,pseudoterminal,purple,ripe,scabrous,shrub,simple,somewhat,stellate,stem,streak,surface,time,tree,violet,white,yellowish-tomentose	broad-based,lacking,na,needle-like,perfect,prickle,zygomorphy
207	wfo-0001028227	success	235	124	59	73	162	51	57	2	0.8-1.4,0.9-1.4,1-4.2-6.2,3-4.9,abaxially,accrescent,acute,adaxially,anther,apex,apparently,appressed,articulated,axillary,base,berry,blunt-tipped,branched,brownish,calyx,cm,corolla,cuneate,directed,distally,echinoid,entire,filament,fleshy,fruit,fruiting,globose,gray,green,hair,lacking,leaf,long,lower,many,margin,mm,multangulate,oblong,obtuse,ovate-lanceolate,pale,pedicel,petiole,plurifoliate,pore,poricidal,present,pseudoterminal,purple,ripe,scabridulous,sessile,shrub,simple,somewhat,stellate,stem,surface,time,tip,tomentose,tree,unit,velutinous,violet,x,yellow	-2/3,.5-4,0-250,0.1,0.2,0.2-0.3,0.2-0.4,0.2-0.5,0.3,0.4,0.5,0.7-2.1,0.8,0.9,0.9-1.2,1,1-1.7,1-2.5,1.1-3.1,1.2-2,1.3-4,1.4,1.4-2.6,1.5-2.3,1.7-2.8,1.9,1.9-4.2,1.9-5.8,1/2,1/2-3/4,10,10-24,11-15,2-12,2-3.8,2.5-7.8,2.6-5.9,2.9-4.7,3.7-6.3,3.7-7,4-13,4.8-7.6,5-7.5,6-16,6.7-15,8.1-18,8.5-22,abaxial,acuminate,ag,age,along,alyx,anthesi,apart,around,attenuate,bark,becoming,blade,blunt-tippe,branch,brown,bud,c.,closely,cylindrical,dark,decurrent,deltoid,dendritic-echinoid,diameter,drying,eaf,early,echinoi,edge,eed,elliptic,elongate,ength,exserted,farinose,flower,free,glabrescent,glabrous,granular-tomentose,grayish,high,inserted,lanceolate,lateral,lengthening,less,lobe,lobed,lon,longitudinal,m.,main,midrib,midvein,mostly,nflorescence,oblong-lanceolate,obscured,occasionally,often,older,orangish-tan,orbicular,orolla,ovate-orbicula,overlapping,peduncle,perfec,porrect-stellate,prominent,pubescence,pubescent,quarter,rachi,relatively,reticulate-punctate,rounded,ruit,runk,side,slightly,slit,spaced,sparsely,stalk,stamen,stigma,stout,style,subcampanulate,sublenticular,subspherical,sulcate,suture,tamen,thick,thicker,thin,tomentu,touching,tube,ud,unarme,upper,usually,vary,vein,way,well,wide,yellowish,ympodial,young	articulation,bract,branching,breeding,broad-based,cell,colour,connective,form,growth,heteromorphism,inflated,inflorescence,insertion,interjected,interpetalar,leaflet,length,marking,mature,modification,na,needle-like,odour,orientation,paired,pattern,perfect,placement,position,prickle,pseudostipule,rhizome,scale,shape,smell,spot,staman,stone,structure,symmetry,sympodial,system,texture,tissue,trichome,tuber,type,vegetative,xylopodia,zygomorphy	0.8-1.4,0.9-1.4,1-4.2-6.2,3-4.9,abaxially,accrescent,acute,adaxially,apparently,appressed,articulated,axillary,base,berry,blunt-tipped,branched,brownish,cm,cuneate,directed,distally,echinoid,entire,fleshy,globose,gray,green,lacking,leaf,long,many,mm,multangulate,oblong,obtuse,ovate-lanceolate,pale,plurifoliate,poricidal,present,pseudoterminal,purple,ripe,scabridulous,sessile,shrub,simple,somewhat,stellate,time,tip,tomentose,tree,velutinous,violet,x,yellow	na,perfect
208	wfo-0001028228	success	143	131	87	106	37	25	86	1	.5,0.1-1.7,0.75,1-1.5,1.1-1.2,1.1-2.5,1.2-1.8,1.5-2,1.8-3.4,10-30-flowered,2,2-5,2-8,2.1-4.2,2.8-6.5,3/4,6-7,6-8,7.5-12.5,abruptly,acute,age,anther,anthesi,apex,area,bark,base,becoming,brown,calyx,campanulate,clavate,closely,cm,coriaceous,corolla,dark,deflexed,difoliate,distal,dry,elliptic,exserted,filament,fragrant,fruiting,glabrous,globose,green,greenish-yellow,lateral,leaf,lobed,long,main,major,material,middle,minor,minute,minutely,mm,narrowing,obovate,occasionally,opposite,ovary,overlapping,ovoid,ovoid-reniform,pair,pale,papillose,pedicel,petiole,pore,portion,reticulate,rounded,scar,shaped,shining,shrub,small,spaced,stem,stigma,straight,style,surface,sweetly,tear-drop,terminal,thickened,tip,tree,tube,unit,usually,vein,way,white,widest,x,young	ba,beginning,beneath,berry,caly,deltoid,dia,eaf,edicel,eed,erect,free,geminat,impressed,inflorescenc,lobe,lon,lower,margin,nflorescence,older,planar,poricidal,prominent,ruit,shinin,simple,slender,slightly,styl,tall,tapering,thick-margined,ud,weight,woody,ympodial	bud,colour,diameter,exsertion,flower,form,fragrance,fruit,geminate,growth,height,inflorescence,length,number,pattern,plant,position,seed,shape,size,spacing,structure,sympodial,texture,width	.5,0.1-1.7,0.75,1-1.5,1.1-1.2,1.1-2.5,1.2-1.8,1.5-2,1.8-3.4,10-30-flowered,2,2-5,2-8,2.1-4.2,2.8-6.5,3/4,6-7,6-8,7.5-12.5,abruptly,acute,age,area,base,becoming,brown,calyx,campanulate,clavate,closely,cm,coriaceous,dark,deflexed,difoliate,distal,dry,elliptic,exserted,fragrant,glabrous,globose,green,greenish-yellow,lateral,leaf,lobed,long,main,material,middle,minute,minutely,mm,narrowing,obovate,occasionally,opposite,overlapping,ovoid,ovoid-reniform,pair,pale,papillose,reticulate,rounded,shaped,shining,shrub,small,spaced,straight,style,sweetly,tear-drop,thickened,tip,tree,tube,usually,vein,way,white,widest,x,young	geminate
209	wfo-0001028263	success	156	120	60	65	91	55	51	9	1-3,1-4,6,6-8,abaxially,adaxially,apex,apical,apically,base,branched,calyx,cell,cm,conical,connate,cordate,corolla,cuneate,darker,deep,dehiscent,dichasially,distal,filament,green,green-white,hair-like,half,herbaceous,interjected,introrse,leaf,leaflet,light,long,maturing,medium,mm,mucilaginous,oblique,odd-pinnate,often,ovoid,pattern,pedicel,perennial,perfect,petiole,plant,poricidally,proximal,puberulent,pubescent,rotate,seed,short,slit,strigose,throughout,tuber-bearing,typically,unit,violet,¼	0.25,1-2,11-13,11-23,14-44,2,2-3,2-4,2.6,3,3-6-foliat,3.4,3.5-4.2,4,4-5,5-7,5-7.5,8-1.,8-14,9,abaxiall,acumen,acuminate,acute,articulate,atenuate,broadly,covering,cyme,diameter,dichasial,digestion,diminishing,dorsally,eaf,ebracteate,edge,eed,elliptical,emoval,enzyme,equal,exceeding,first,flat,flower,folded,forked,generally,globo,gradually,honeycomb,lateral,living,lobe,lon,lower,lunat,make,monochasial,nflorescence,nther,orolla,ovate,pair,peduncle,plan,reveal,ruit,sessile,seudostipule,size,specimen,stamen,stigma,straight,style,tal,tem,terminal,testal,thick,throughou,toward,truncate,two,vary,wall,wide,yellow,ympodial	3-6-foliate,8-19,anther,appressed,articulation,bract,branching,breeding,colour,connective,ebbrate,form,fruit,fruiting,growth,hair,heteromorphism,inflated,inflorescence,insertion,interpetalar,length,lunate,margin,marking,mature,modification,na,odour,orientation,paired,placement,pore,position,prickle,pseudostipule,rhizome,scale,shape,spot,staman,stellate,stone,structure,symmetry,sympodial,system,texture,tissue,tuber,type,wet,xylopodia,ye,zygomorphy	1-3,1-4,6,6-8,abaxially,adaxially,apical,apically,branched,cm,conical,connate,cordate,cuneate,darker,deep,dehiscent,dichasially,distal,green,green-white,hair-like,half,herbaceous,introrse,light,long,maturing,medium,mm,mucilaginous,oblique,odd-pinnate,often,ovoid,perennial,perfect,plant,poricidally,proximal,puberulent,pubescent,rotate,short,slit,strigose,throughout,tuber-bearing,typically,violet,¼	3-6-foliate,8-19,ebbrate,lunate,na,stellate,wet,ye,zygomorphy
210	wfo-0001028280	success	87	88	54	58	29	30	50	4	.5,0.7-1,1-2,1-2-flowered,2-2.5,2-3,7-8,acuminate,almost,apex,arching,attenuate,axil,bark,base,berry,ciliate,closely,cm,completely,dark,elliptic,flattened,fruiting,glabrous,globose,green,lanceolate,lateral,leaf,main,middle,minutely,mm,narrowly,new,onto,opposite,pair,papillae,pedicel,pendant,petiole,present,rounded,scar,shrub,simple,somewhat,spaced,stem,surface,tip,unit,vein,widest,winged,woody	1.5-2.7,6-9,anthesi,ape,branch,brow,decurrent,dia,eaf,eed,immature,know,known,lon,long,lower,margin,nflorescence,older,ruit,sessil,small,tall,ud,ultimate,unifoliat,x,ympodial,young	branching,brown,ciliation,colour,decurren,decurrency,diameter,flower,form,fruit,glabrousnes,growth,height,inflorescence,length,number,orientation,pattern,plant,position,presence,sessile,shape,spacing,structure,sympodial,texture,type,unifoliate,width	.5,0.7-1,1-2,1-2-flowered,2-2.5,2-3,7-8,acuminate,almost,apex,arching,attenuate,axil,base,berry,ciliate,closely,cm,completely,dark,elliptic,flattened,glabrous,globose,green,lanceolate,lateral,leaf,main,middle,minutely,mm,narrowly,new,onto,opposite,pair,pendant,petiole,present,rounded,shrub,simple,somewhat,spaced,surface,vein,widest,winged,woody	brown,decurren,sessile,unifoliate
211	wfo-0001028281	success	258	91	43	62	196	29	41	2	0.5-1,0.75-1,2-locular,3-foliate,acute,anther,apex,articulation,base,basiscopically,bract,branching,broadly,cell,cm,corolla,dark,darker,deep,densely,developed,distal,eglandular,elongate-triangular,extended,filament,form,fruit,globose,golden,green,half,imparipinnate,inflorescence,interjected,interrupted,leaf,leaflet,margin,medial,mm,narrowly,node,oblique,once-branched,pale,pedicel,petiole,present,pseudostipule,pubescent,rotate,shrub,sparsely,stripe,type,uniseriate,unit,usually,vine,well,yellow	+,-3,-5,-8,.2,.4,.5,0.05-0.4,0.1-0.15,0.15-0.2,0.2-0.3,0.2-0.5,0.2-0.5-1,0.2-0.7-0.9,0.3-0.5,0.3-1,0.5-0.6,0.5-0.7,0.5-1.1,0.5-1.2,0.5-1.2-1.5,0.7-1-1.5,0.7-1.2,0.7-2.5-7,0.8-1,1,1-1.5,1-1.5-2,1-1.5-6,1-3,1-5,1.0-1.6,1.1-1.4,1.1-2.4,1.2-1.6,1.4-4,1.7-2.5,10-18,10-30-45,2-13,2-4,2-4-celled,2-6.5-10,2.1-3.0,2.5-6-15,20-30,3-16-20,3-5,3-8.5,5-8-celled,6,7-30-36,abaxial,abaxially,absent,acuminate,adaxial,almost,alternate,anthesi,apical,appearance,appendage,appressed,arising,autogamous,axi,bent,berr,blade,bracteate,brown,calyx,capitate,column,composed,conical,covering,decreasing,decurrent,diameter,doubly,dry,eaf,edicel,eed,either,elliptic,elongate,enclosing,entire,exerted,exserted,flower,fragile,free,fruiting,generally,giving,glabrous,gland,glandular,gree,hair-like,hal,halfway,head,included,internode,large,largest,lateral,less,like,lobe,lon,long,longest,lower,material,midvein,minute,mixture,multi-celled,multi-cellular,multicellular,nflorescence,obovate,occasionally,opposite,orbicular,other,outgrowth,ovary,ovate,pair,paler,patent,peduncle,petiolule,point,population,portion,primarily,primary,probably,proximal,rachi,regularly,rest,ruit,secondary,serrat,serrate,sessile,set,shorter,silky,size,small,smaller,smooth,sometimes,sparser,sprawling,staminal,stem,sterile,stiff,stigma,straight,strongly,style,subopposite,surface,tem,terminal,tertiary,testa,thick,thin,three,tip,toward,transparent,trichome,tube,ud,unicellular,vein,wall,weak,weak-walled,wide,winged,ympodial	colour,growth,hair,heteromorphism,insertion,interpetalar,length,marking,na,odour,orientation,paired,placement,position,prickle,rhizome,scale,shape,spot,staman,stone,structure,symmetry,sympodial,texture,tissue,tuber,xylopodia,zygomorphy	0.5-1,0.75-1,2-locular,3-foliate,acute,basiscopically,broadly,cm,dark,darker,deep,densely,developed,distal,eglandular,elongate-triangular,extended,globose,golden,green,half,imparipinnate,interrupted,medial,mm,narrowly,node,oblique,once-branched,pale,present,pubescent,rotate,shrub,sparsely,stripe,uniseriate,usually,vine,well,yellow	na,zygomorphy
212	wfo-0001028317	success	204	87	57	65	139	22	54	3	/5,0.6-1.2,0.8-1.1,1-1.3,1-4,1/4-2/3,5-8,almost,anther,apex,base,berry,branched,bright,calyx,chartaceous,cm,cream,cuneate,curved,dark,elongating,filament,fruit,fruiting,green,hair,herb,lateral,leaf,length,lobed,long,lower,margin,marking,mature,maturity,mauve,mm,obtuse,pale,petiole,poricidal,prickle,purple,red,reflexed,shrub,simple,sometimes,spherical,spreading,stellate-pubescent,stem,straight,style,surface,tapering,terminal,tip,trichome,way,white,young	-1.5,-5,0,0-1,0-5,0.1,0.1-0.25,0.1-0.3,0.1-0.4,0.3-0.4,0.3-1,0.5-3.5,0.6-0.8,0.6-1.5,0.8-2.5,1-3,1.1-1.9,1.4-2,1.8-2.5,1/,1/3-1/4,1/5,2-2.8,2-4,2-4.5,2.5-6.5,2.8-3.3,2/3,3-10,3-4,3-5,4-5-merous,4-6,4-8,6-10,abaxially,absent,acuminat,acute,alyx,apar,apart,apically,apparently,articulated,bark,blade,broad-deltate,brow,brown,concolorous,deltate,densely,diameter,difoliate,distance,drying,dull,eaf,eed,equal,erect,extending,eye,filiform,flattened-reniform,flower,free,geminat,glabrous,gray,herbaceous,infructescence,lanceolate,lobe,longer,midpoint,midvein,minute,moderately,naked,nflorescence,oblong,older,one,open,orange-brown,orolla,oung,ovate,pair,pedicel,peduncle,pendulous,per,perfec,pericarp,porrect,portion,prickl,prickly,primary,ray,reduced,rounded,ruit,scandent,scar,sessile,shorter,side,smooth,spaced,sparsely,stalk,stalked,stellate,subsessile,tamen,terete,tertiary,time,toward,translucent,truncate,tube,unarme,unarmed,unit,upper,variously,vary,vein,venation,visible,wide,yellow,yellow-green,ympodial	branching,broad-based,colour,corolla,form,growth,heteromorphism,inflorescence,na,needle-like,odour,orientation,placement,position,shape,smell,staman,symmetry,texture,type,vegetative,zygomorphy	/5,0.6-1.2,0.8-1.1,1-1.3,1-4,1/4-2/3,5-8,almost,base,berry,branched,bright,chartaceous,cm,cream,cuneate,curved,dark,elongating,fruit,green,herb,lateral,leaf,length,lobed,long,lower,marking,mature,maturity,mauve,mm,obtuse,pale,poricidal,purple,red,reflexed,shrub,simple,sometimes,spherical,spreading,stellate-pubescent,stem,straight,surface,tapering,terminal,tip,way,white,young	na,needle-like,zygomorphy
213	wfo-0001028323	success	164	102	52	64	100	38	49	3	0.2-1,0.5,1-1.5,1.5-2.5,3.5-4,anther,apex,appressed,attenuate,bark,base,berry,blue-green,c.,cell,cm,coriaceous,corolla,dark,dendritic,ellipsoid,elliptic,entire,erect,fading,filament,glabrous,grey,growth,inflorescence,internodal,leaf-opposed,less,lobed,margin,maturity,minute,mm,new,occasionally,ovoid,pale,perfect,petiole,pore,poricidal,pubescent,shiny,shoot,short,shrub,simple,sometimes,sparsely,stem,thick,tip,trichome,uniseriate,unit,violet,way,white,x	-2,0.2-0.5,0.4-1.3,0.5-1,0.6-1,0.8,0.9-1.2,1,1-1.2,1-2,1.1-4.5,1.5,2-3,2-9,3,3-5,3-6,5-6,7.5-9,abaxially,abscissio,absent,acute,along,anthesi,apart,apparently,articulated,ba,brown,calyx,capiatate,conical,cup-shaped,deltate,densely,diameter,drying,eaf,eed,fleshy,flower,free,fruiting,glabrescen,glabrescent,globose,included,lanceolate,lengthening,like,lobe,longer,lower,main,minutely,nflorescence,ovary,ovate,pair,papillat,papillose,pedicel,peduncle,peg,pericarp,pitted,planar,plurifoliat,portion,primary,proceed,reddish,remaining,revolute,rounded,ruit,scar,scattered,sinus,small,soft,somewhat,soon,sparely,splitting,stigma,straight,style,surface,tearing,testal,thin,tube,tuft,ud,vein,wall,woody,ympodial	abaxial,adaxial,bract,branching,breeding,colour,connective,form,fruit,hair,heteromorphism,leaf,length,marking,mature,na,odour,orientation,paired,placement,plurifoliate,position,prickle,pseudostipule,rhizome,shape,spot,staman,stone,structure,symmetry,sympodial,system,texture,tuber,type,xylopodia,zygomorphy	0.2-1,0.5,1-1.5,1.5-2.5,3.5-4,appressed,attenuate,base,berry,blue-green,c.,cm,coriaceous,dark,dendritic,ellipsoid,elliptic,entire,erect,fading,glabrous,grey,internodal,leaf-opposed,less,lobed,maturity,minute,mm,occasionally,ovoid,pale,perfect,poricidal,pubescent,shiny,shoot,short,shrub,simple,sometimes,sparsely,thick,tip,uniseriate,violet,way,white,x	na,plurifoliate,zygomorphy
214	wfo-0001028329	success	215	108	56	64	151	44	52	4	0.8-1.4,0.9-1.3,1-6,2-3,anther,apex,apical-lateral,articulated,asperous,axillary,base,becoming,berry,blunt-tipped,branched,calyx,cm,corolla,dichotomously,entire,filament,finely,fleshy,fruit,granular-tomentose,green,growth,hair,introrse,large,lateral,leaf,length,long-attenuate,margin,minutely,mm,obelliptic,oblong,obtuse,pedicel,perfect,petiole,plurifoliate,pore,present,pseudo-terminal,ripe,short-,shrub,simple,slightly,small,stellate,stellate-rotate,subglobose,tree,turning,unarmed,unit,velutinous,white,x,yellow	.5-3,.75-2,.75-5.75,/10-3/10,0-100,0.2-0.3,0.8-1.1,1.0-1.4,1.1-2.5,1.3-1.8,1.3-2,1.5-2.3,1.5-2.75,1.5-3.5,1.5-8,10-34,12,2-4,2.2-3.9,2.6-5,2.75-4.5,3-14,3-8,3.75-7,3/4,4-15,4-5,5-10,6-11,6-8,6-9,7-19,abaxially,absen,acuminate,acute,adaxially,ag,angled,anthesi,apart,apparently,axe,ba,bark,blade,branch,brown,bud,chartaceous,closely,conical,continued,cylindrical,dehiscing,deltoid,dendritic-echinoi,dendritic-echinoid,diameter,distantly,distinct,due,eaf,echinoid,eed,flower,free,glabrescen,glabrous,granular,gray,grooved,high,honeycombed,inserted,lengthening,lobe,lobed,long,longitudinally,lower,main,midvein,moderately,mostly,multangulat,multangulate,nflorescence,obovate,obscured,occasional,older,orbicular,orolla,ovate,ovate-elliptic,pale,peduncle,porrect-stellate,pubescent,rachi,rather,receptacle,relatively,reniform,reticulate-punctate,ruit,runk,sessil,sessile,several,short-stalked,side,slit,sometimes,spaced,sparse,sparsely,stalked,stellat,stellate-pubescent,stelliform,stem,stigma,style,subcapitat,suborbicular,suture,swollen,tamen,testa,thick,thickened,thin,time,tomentose,tomentu,touching,toward,tube,unarme,usually,vary,vein,vestigial,way,whitish,wide,yellowish,ympodial,young	absent,articulation,bract,branching,breeding,cell,colour,connective,form,fruiting,glabrescent,heteromorphism,inflorescence,insertion,interjected,interpetalar,leaflet,marking,modification,na,odour,orientation,paired,pattern,placement,position,prickle,pseudostipule,rhizome,scale,shape,spot,staman,stone,structure,symmetry,sympodial,system,texture,tissue,tuber,type,xylopodia,zygomorphy	0.8-1.4,0.9-1.3,1-6,2-3,apex,apical-lateral,articulated,asperous,axillary,base,becoming,berry,blunt-tipped,branched,cm,dichotomously,entire,finely,fleshy,granular-tomentose,green,introrse,large,lateral,leaf,long-attenuate,minutely,mm,obelliptic,oblong,obtuse,perfect,plurifoliate,pore,present,pseudo-terminal,ripe,short-,shrub,simple,slightly,small,stellate,stellate-rotate,subglobose,tree,turning,unarmed,velutinous,white,x,yellow	absent,glabrescent,na,zygomorphy
215	wfo-0001028337	success	192	115	54	70	122	45	47	7	.5,0.3-0.5,0.7-0.9,1-1.8,1-3,1.8-2,2-2.2-2.5,2-4,4-5,5-25,5-6,8-10,abaxial,adaxial,anther,apex,base,berry,branched,calyx,chartaceous,cm,connivent,dark,densely,diameter,entire,erect,evenly,filament,flattened-reniform,flower,fruit,fruiting,glabrescent,glaucous,green,green-brown,hair,inflorescence,juvenile,lateral,leaf,length,lobed,margin,marking,mauve,mm,moderately,narrow-oblong,orange-brown,pedicel,per,petiole,poricidal,prickle,shrub,simple,spherical,stellate,stellate-pubescent,stem,surface,tapering,terminal,trichome,unit,white,young	-4,.8,/3,0-6,0.05-0.15,0.05-1,0.1-0.3,0.4-0.7-2,0.4-0.8,0.7-1,1,1-2,1.5-3,1.5-4,1/2,1/3-2/3,1/4-1/3,1/8-1/4,11-16,15-50,3-4,5-8,5-merous,6-7,8-14,abaxially,acut,alyx,apar,apart,ape,apically,apparently,articulated,bark,blade,color,conical,cuneate,curved,deltate,discolorous,drying,eaf,eed,elongating,equal,eye,free,fused,gently,glabrou,glabrous,gray,gray-brown,infructescence,juvenil,known,lobe,long,long-styled,longer,lower,mature,midpoint,minutely,naked,nflorescence,occasionally,older,one,open,orolla,oung,pale,peduncle,perfect,pericarp,pitted,plurifoliat,porrect,porrect-lepidote,portion,prickly,primary,ray,reddish,reflexed,rounded,ruit,scar,sessile,shallowly,shoot,short,short-styled,shorter,slender,small,smooth,spaced,sparse,staminate,stout,straight,strongly,style,tamen,terete,time,tip,toward,tube,unarme,unarmed,usually,vary,vein,visible,way,wide,ympodial	absent,adult,articulation,bract,branching,breeding,broad-based,cell,colour,connective,corolla,form,growth,height,heteromorphism,insertion,na,needle-like,number,orientation,pattern,placement,plant,plurifoliate,pore,position,present,pseudostipule,rhizome,scale,seed,shape,spot,staman,stone,structure,symmetry,sympodial,system,texture,tuber,type,width,xylopodia,zygomorphy	.5,0.3-0.5,0.7-0.9,1-1.8,1-3,1.8-2,2-2.2-2.5,2-4,4-5,5-25,5-6,8-10,base,berry,branched,chartaceous,cm,connivent,dark,densely,entire,erect,evenly,flattened-reniform,glabrescent,glaucous,green,green-brown,lateral,lobed,marking,mauve,mm,moderately,narrow-oblong,orange-brown,poricidal,shrub,simple,spherical,stellate,stellate-pubescent,stem,tapering,terminal,white,young	absent,broad-based,na,needle-like,plurifoliate,present,zygomorphy
216	wfo-0001028339	success	195	122	73	85	110	37	70	3	.5,1-1.2,1-2,1-5,1.1-1.4,1.2-1.5,1.5,1.5-2,3.5-4,8182,across,anther,anthesi,apex,appressed,base,beneath,berry,blue,broadly,bud,calyx,cm,connate,corolla,cuneate,cup-shaped,deflexed,dia,difoliate,dried,filament,flattened,flower,fruiting,glabrous,globose,growth,later,leaf,lobed,long,lower,margin,minutely,mm,mustard,nearly,oblique,opposite,ovate,ovoid-reniform,papillate,pedicel,pitted,pore,schwarz,shaped,shrub,simple,size,slender,small,somewhat,specimen,speckled,stem,strongly,surface,tapering,tear-drop,texture,tightly,tree,trichome,tube,uniseriate,unit,urceolate,vein,white,woody,x,yellow,young	0.05-0.1,0.8-1.2,1-1.5,1.7-3.2,10-30-flowered,10.2-18.5,2.5-5,3.4-5.5,43191,5-7,5-angled,5.8-7.9,7-11,8-10,acuminate,acute,almost,appearance,appearing,attenuate,bark,becoming,brown,capitate,carinate,carpel,closely,covered,crystalline,dark,decurrent,densely,differing,distinctly,dry,eaf,edicel,eed,enclosed,epidermi,erect,evenly,exserted,fide,filiform,first,floccose,free,frui,geminat,glabrate,grainy,greyish-brown,irregular,large-celled,lateral,leave,like,little,lobe,lon,long-triangular,main,major,middle,minor,nee,nflorescence,obscure,occasionally,older,one,ovary,overlappin,ovoid,papery,papillose,petiole,planar,poricidal,portion,proximal,pulp,red-brown,reflexed,ruit,scar,secondary,septum,shining,slightly,spaced,sparsely,stigma,straight,strong,style,tall,tip,tub,ud,venation,white-lenticellat,white-papillo,white-speckled,wide,widest,winged,yellowish,ympodial	10-30,bract,branching,broad-based,cell,colour,form,fruit,geminate,hair,height,heteromorphism,inflorescence,length,marking,na,needle-like,number,orientation,placement,plant,position,prickle,pseudostipule,rhizome,scale,seed,shape,spot,staman,stone,structure,symmetry,sympodial,tuber,type,xylopodia	.5,1-1.2,1-2,1-5,1.1-1.4,1.2-1.5,1.5,1.5-2,3.5-4,8182,across,anthesi,appressed,base,beneath,berry,blue,broadly,bud,calyx,cm,connate,cuneate,cup-shaped,deflexed,dia,difoliate,dried,flattened,flower,glabrous,globose,later,leaf,lobed,long,minutely,mm,mustard,nearly,oblique,opposite,ovate,ovoid-reniform,papillate,pitted,schwarz,shaped,shrub,simple,slender,small,somewhat,specimen,speckled,strongly,tapering,tear-drop,tightly,tree,trichome,tube,uniseriate,urceolate,vein,white,woody,x,yellow,young	10-30,geminate,na
217	wfo-0001028351	success	175	186	117	126	49	60	109	8	.2,.8,.8–1.0,0,0.2,0.5,0.6,1.0–2.0,2,2.0–2.5,2–4,3,3–4,40,5,5.0,5.0–5.5,5.5–10.5,5–7,6–12,8–15,abaxially,absent,acute,adaxially,along,annual,anther,anthesi,apart,apex,apical,articulated,basal,base,becoming,blue,branching,brown,calyx,capitate,cell,chartaceous,clavate,cm,colour,convex,cylindrical,densely,diameter,directed,distally,erect,filament,flattened,flower,fruit,glabrous,glandular,globose,green,hair,herb,lanceolate,leaf,like,lobe,lobed,long,longitudinal,lower,margin,midvein,mm,moderately,multicellular,narrowly,number,oblong,obtuse,occasionally,opening,opposed,ovate,pair,pale,pedicel,peduncle,pentagonal,perennial,petiole,pitted,pore,present,pubescent,regularly,serrate,shallowly,shaped,shiny,side,simple,slender,slit,smaller,stem,stigma,stone,straight,style,surface,tardily,teardrop,truncate,tube,unbranched,unicellular,uniseriate,unknown,velutinous,white,wing,winged,woody,x,–3.0	0.1,0–,1.0–,1.0–1.6,1.0–2.5,1.4–1.5,1.5–4.0,1.6–,10,2.0–5.0,2.1–3.5,2/3,2–2.5,3.4–5.0,4,6.5–8.5,adaxiall,ag,axe,ba,blade,connivent,eaf,eed,equal,fleshy,geminat,indumentum,lamin,lon,m.,nfloresence,orolla,perfect,plurifoliate,probably,ruit,spaced,sparsely,tal,tamen,tem,time,unit,vary,wide,ympodial,young,–	0–1.0–2.5,1.0–1.5–4.0,1.5,1.6–2.0–5.0,age,appressed,arrangement,articulation,bract,breeding,broad-based,connective,corolla,form,fruiting,growth,height,heteromorphism,inflated,inflorescence,insertion,interjected,interpetalar,lamina,leaflet,length,marking,mature,modification,na,needle-like,odour,orientation,ovary,paired,pattern,placement,plant,position,prickle,pseudostipule,rhizome,scale,seed,shape,size,smell,spacing,spot,staman,symmetry,system,texture,tissue,trichome,tuber,type,vegetative,xylopodia,zygomorphy	.2,.8,.8–1.0,0,0.2,0.5,0.6,1.0–2.0,2,2.0–2.5,2–4,3,3–4,40,5,5.0,5.0–5.5,5.5–10.5,5–7,6–12,8–15,abaxially,absent,acute,adaxially,along,annual,anthesi,apart,apex,apical,articulated,basal,base,becoming,blue,branching,brown,capitate,chartaceous,clavate,cm,convex,cylindrical,densely,directed,distally,erect,flattened,flower,fruit,glabrous,glandular,globose,green,hair,herb,lanceolate,leaf,like,lobe,lobed,long,longitudinal,midvein,mm,moderately,multicellular,narrowly,number,oblong,obtuse,occasionally,opening,opposed,ovate,pair,pale,pentagonal,perennial,pitted,present,pubescent,regularly,serrate,shallowly,shaped,shiny,side,simple,slender,slit,smaller,straight,surface,tardily,teardrop,truncate,unbranched,unicellular,uniseriate,unknown,velutinous,white,wing,winged,woody,x,–3.0	0–1.0–2.5,1.0–1.5–4.0,1.5,1.6–2.0–5.0,age,lamina,na,zygomorphy
218	wfo-0001028353	invalid_json	177	129	NA	110	67	19	NA	NA	/3,0.2-0.4,0.5,0.9-1.2,1,1-4,1.4-2,1.5-2,1.5-5,2,2-3,2-4,3,3-5,4-7,6-8,7,acute,age,anther,apex,base,becoming,beneath,berry,bluntly,bright,campanulate,capitate,cell,centre,clasping,cm,coarsely,conical,cordate,corolla,dark,deep,deeply,densely,diameter,elliptic,erect,filament,fleshy,fracturing,fruiting,glabrous,globose,green,greenish,herb,heteromorphic,hollow,honey-comb,internodal,leaf,lengthening,less,like,long,margin,midrib,minute,minutely,mm,nodding,often,ovary,ovoid,pale,papery,papillose,pedicel,pericarp,petiole,pitted,plant,plump,pore,poricidal,pubescent,purple,rhomboid,ripe,scattered,short,simple,size,slender,slit,somewhat,sparsely,stem,stigma,style,surface,tan,testal,thin,tip,toothed,trichome,truncate,uniseriate,vein,way,x,yellow	.5,0.5-1-2,1-2,8-10,abaxially,accrescent,along,anthesi,apart,area,calyx,ciliate,cup-shaped,curved,decreasing,decumben,difoliate,distally,dry,drying,eaf,edicel,eed,ellipsoid,emarginated,exerted,flower,free,frui,geminat,gree,growing,horn,horned,inserted,lobe,lon,lower,m.,material,nflorescence,open,outline,pair,papillate,peduncle,point,portion,primary,principal,reddish,ruit,scar,sessil,sessile,shallow,sleeve,slightly,straight,strongly,toward,tube,ud,unit,wall,wrinkled,ympodial	abaxial,arrangement,branching,characteristic,colour,form,fruit,growth,hair,height,inflorescence,length,position,seed,shape,texture,thicknes,type,value	NA	NA
219	wfo-0001028390	success	147	147	66	78	69	69	61	5	-10,0.5,0.5-1,0.5-1.5,0.5-2.5,1-2.5,1-5,1.5-2,1.5-3.5,10-15,3-4,3-5,4-5,5-7,7-8,acute,angled,apex,apiculate,base,calyx,cell,chartaceous,cm,cuneate,cylindrical,deltate,densely,diameter,directed,divided,elliptic,entire,felty-pubescent,forked,glabrous,globose,hair,lanceolate,lobe,lower,margin,mm,near,obtuse,often,orange,ovate,pedicel,peduncle,petiole,pore,pseudohair,pubescent,rachi,radiu,rarely,shrub,simple,slightly,small,sparsely,stellate,stigma,stone,style,subclavate,subcordate,subcoriaceous,truncate,unbranched,unequally,unit,violet,white,white-pubescent,x,yellow	.5-3.3,0,1,1-3,1.5-5.5,2,2.5,4-11,6-many-foliat,7,9,abaxially,absen,adaxiall,adaxially,aggregate,apart,articulated,axe,blade,branched,connivent,curled,dendritically,dendritically-branched,dense,distall,eaf,eed,eglandular,flower,gland,leaving,less,like,lon,long,midvein,mixed,moderately,mostly,narrowly,nflorescence,nther,occasionally,orolla,peg,perfect,presen,puberulent,pubescen,ripe,ruit,scar,short,spaced,stalked,ste,subcapitat,tal,tem,time,tip,triangular,tube,usually,vary,wide,ympodial	6-many-foliate,abaxial,absent,adaxial,anther,appressed,articulation,bract,branching,breeding,broad-based,colour,connective,corolla,direction,distally,filament,form,fruit,fruiting,growth,height,heteromorphism,inflated,inflorescence,insertion,interjected,interpetalar,leaf,leaflet,length,marking,mature,modification,na,needle-like,odour,orientation,ovary,paired,pattern,placement,plant,position,prickle,pseudostipule,rhizome,scale,seed,shape,smell,spacing,spot,staman,stem,structure,subcapitate,surface,symmetry,sympodial,system,texture,tissue,trichome,tuber,type,vegetative,xylopodia,zygomorphy	-10,0.5,0.5-1,0.5-1.5,0.5-2.5,1-2.5,1-5,1.5-2,1.5-3.5,10-15,3-4,3-5,4-5,5-7,7-8,acute,angled,apex,apiculate,base,chartaceous,cm,cuneate,cylindrical,deltate,densely,directed,divided,elliptic,entire,felty-pubescent,forked,glabrous,globose,lanceolate,mm,near,obtuse,often,orange,ovate,pseudohair,pubescent,rarely,shrub,simple,slightly,small,sparsely,stellate,subclavate,subcordate,subcoriaceous,truncate,unbranched,unequally,violet,white,white-pubescent,x,yellow	6-many-foliate,absent,distally,na,subcapitate
220	wfo-0001028405	success	149	113	54	55	94	58	42	12	1-4,1.5-6.5,4-6,9-15,apex,apical,articulate,base,branched,calyx,cell,cm,conical,connate,corolla,dehiscent,dichasially,distal,ebracteate,filament,generally,green,green-white,hair-like,half,herbaceous,interjected,introrse,leaf,leaflet,long,lower,maturing,mm,oblique,odd-pinnate,often,ovoid,pattern,pedicel,perennial,perfect,petiole,plant,poricidally,proximal,puberulent,seed,short,slit,stellate,throughout,tuber-bearing,unit,¼	0.4-0.5,0.5-3,1-9,1.3-8,10-11,2,2-2.5,2-3,2-4,3-20,3-4,3-6-foliat,3.5-10,3.5-6.5,4-11.5,6-7,7-14.5,8-15,abaxially,absen,acumen,acute,adaxially,apically,apiculate,attenuate,covering,cyme,decurrent,diameter,dichasial,digestion,diminishing,dorsally,eaf,edge,eed,elliptic,elliptic-lanceolate,emoval,enzyme,exceeding,flat,flower,folded,forked,globo,gradually,honeycomb,lanceolate,lateral,living,lobe,lon,lunat,make,monochasial,mucilaginous,nflorescence,nther,oblong,orolla,ovate-elliptic,pair,peduncle,plan,rachi,reveal,ruit,seudostipule,short-acuminate,short-petiolate,size,specimen,stamen,stigma,straight,style,subsessile,tal,tem,terminal,testal,thick,throughou,toward,typically,vary,wall,whit,wide,without,yellow,ympodial	3-6-foliate,absent,anther,apicidally,appressed,articulation,bract,branching,breeding,broad-based,colour,connective,form,fruit,fruiting,growth,hair,heteromorphism,inflated,inflorescence,insertion,interpetalar,length,lunate,margin,marking,mature,modification,na,needle-like,odour,orientation,paired,placement,pore,position,present,prickle,pseudostipule,rhizome,scale,shape,spot,staman,stem,stone,structure,surface,symmetry,sympodial,system,texture,tissue,tuber,type,white,xylopodia,zygomorphy	1-4,1.5-6.5,4-6,9-15,apical,articulate,branched,cm,conical,connate,dehiscent,dichasially,distal,ebracteate,generally,green,green-white,hair-like,half,herbaceous,introrse,leaf,long,lower,maturing,mm,oblique,odd-pinnate,often,ovoid,perennial,perfect,plant,poricidally,proximal,puberulent,short,slit,stellate,throughout,tuber-bearing,¼	3-6-foliate,absent,apicidally,broad-based,lunate,na,needle-like,present,stem,surface,white,zygomorphy
221	wfo-0001028429	success	162	122	70	76	86	46	64	6	1-4,1.5-3,2-4,2.5-7.5,4-14,abaxially,adaxially,apex,apical,apically,articulate,base,branched,calyx,cell,cm,connate,cordate,corolla,covering,cuneate,darker,dehiscent,dichasially,distal,especially,filament,glabrescent,glabrous,globose,green,greenish,hair,hair-like,half,herbaceous,interjected,introrse,lateral,leaf,leaflet,light,long,maturing,medium,mm,oblique,odd-pinnate,often,ovoid,pattern,pedicel,pentagonal,perennial,perfect,petiole,plant,poricidally,proximal,rotate,scattered,short,slightly,slit,spot,testal,thick,throughout,tuber-bearing,unit,vein,violet,wall,white,yellow,¼	0.2-0.4,0.8-1.2,0.9-2.3,1-2.5,1.5-4,10-11,10-27,10.5-21,2-1.,2-3,2-8,2.5-12,2.5-4,2.7-3.6,3-6,3-6-foliat,5-12,6-18,6-28,7-7,abaxiall,acumen,acuminate,acute,broadly,cyme,diameter,dichasial,digestion,diminishing,dorsally,eaf,ebracteate,edge,eed,elliptical,emoval,enzyme,exceeding,flat,flower,folded,forked,generally,globo,gradually,green-white,honeycomb,living,lobe,lon,long-attenuate,lower,lunat,make,monochasial,mucilaginous,narrowly,nflorescence,nther,obovate,orolla,ovate,pair,peduncle,petiolule,plan,reveal,ruit,seed,seudostipule,size,specimen,stamen,stigma,straight,style,tal,tem,terminal,throughou,toward,typically,vary,wide,ympodial	2-19,3-6-foliate,anther,articulation,bract,branching,breeding,colour,connective,ebbrate,form,fruit,fruiting,growth,heteromorphism,inflorescence,insertion,interpetalar,length,lunate,margin,marking,na,odour,orientation,paired,placement,pore,position,prickle,pseudostipule,rhizome,scale,shape,staman,stone,structure,symmetry,sympodial,system,texture,tissue,tuber,type,xylopodia,zygomorphy	1-4,1.5-3,2-4,2.5-7.5,4-14,abaxially,adaxially,apical,apically,articulate,branched,cell,cm,connate,cordate,covering,cuneate,darker,dehiscent,dichasially,distal,especially,glabrescent,glabrous,globose,green,greenish,hair,hair-like,half,herbaceous,introrse,lateral,light,long,maturing,medium,mm,oblique,odd-pinnate,often,ovoid,pentagonal,perennial,perfect,plant,poricidally,proximal,rotate,scattered,short,slightly,slit,spot,testal,thick,throughout,tuber-bearing,vein,violet,wall,white,yellow,¼	2-19,3-6-foliate,ebbrate,lunate,na,zygomorphy
222	wfo-0001028436	success	150	113	73	87	63	26	69	4	.5,0.5-1,1-2,1-2-celled,1-3,1.5,1.5-2,10-20,2-4,4,5-10,5-15,5-8,7,8-12,abaxially,absent,abundant,acute,adaxially,anther,apex,base,berry,blade,brown,calyx,center,chartaceous,ciliate,connected,decurrent,diameter,dm,dried,edge,elliptic,entire,filament,fine,flower,fruit,fruiting,glabrous,globose,hair,interpetalar,leaf,linear,linear-lancolate,lobe,margin,membranaceous,mm,moderately,much-branched,nearly,notch,oblong,often,older,parallel,pedicel,per,petiole,placenta,presence,pubescent,radiating,raised,rhizomatous,ridge,rotate,running,shallow,shrub,small,stem,surface,taproot,tissue,tube,two-celled,unbranched,white,woody,x	0.2-0.4,0.5,0.8-1.5,1.5-2.5,1st,2-3,2.5-3,2nd,5-12,adaxiall,along,apically,appearance,appearing,axe,beyond,cell,cm,cordat,deflated,dehiscent,difficult,due,eaf,eed,evaluat,explosively,exserted,flat,frui,geniculate,glabrescen,lengt,like,long,lower,lying,nflorescence,orolla,oung,peduncle,pointing,pubescen,rachi,reaching,ruit,sparsely,stamen,stigma,structure,style,swollen,tal,tamen,tear,thick,triangular,unifoliate,unit,vary,wid,wrinkled,ympodial	branching,colour,connective,cordate,corolla,form,glabrescent,growth,height,inflorescence,length,marking,na,number,odour,position,rhizomatousnes,root,seed,shape,spot,staman,symmetry,texture,type,young	.5,0.5-1,1-2,1-2-celled,1-3,1.5,1.5-2,10-20,2-4,4,5-10,5-15,5-8,7,8-12,abaxially,absent,abundant,acute,adaxially,base,berry,brown,center,chartaceous,ciliate,connected,decurrent,dm,dried,edge,elliptic,entire,fine,flower,fruit,glabrous,globose,hair,linear,linear-lancolate,margin,membranaceous,mm,moderately,much-branched,nearly,notch,oblong,often,parallel,petiole,placenta,pubescent,radiating,raised,rhizomatous,ridge,rotate,running,shallow,shrub,small,taproot,two-celled,unbranched,white,woody,x	cordate,glabrescent,length,na
223	wfo-0001028465	success	159	173	104	115	44	58	96	8	0.75,1-2,1-4,1.5-2.9,10,10-24,11-23,2,2-3,2-4,2-6,2-9.3,2.4-2.8,2.5-4,3-4,3-5,3-8,3.8-7,4-8,4.5-5.5,5-7,7-15,8-10,9-19,acumen,acuminate,acute,apex,apical,apically,attenuate,base,branched,broadly,calyx,cell,cm,connate,corolla,covering,cuneate,cyme,dehiscent,diameter,dichasial,dichasially,distal,dorsally,edge,elliptical,exceeding,filament,flat,flower,folded,forked,generally,globose,green,hair-like,half,herbaceous,interjected,interpetalar,introrse,lateral,leaf,leaflet,lobe,long,make,maturing,medium,mm,monochasial,mucilaginous,oblique,odd-pinnate,often,ovoid,pair,pattern,pedicel,peduncle,perennial,perfect,petiole,petiolule,plant,poricidally,proximal,puberulent,pubescent,purple,rotate,seed,sessile,short,slit,spot,stamen,stigma,straight,strigose,style,terminal,testal,thick,throughout,tuber-bearing,unit,wall,white,yellow,¼	1.2-2,3-6-foliat,4-1.,abaxially,adaxially,articulate,decurrent,digestion,diminishing,eaf,ebracteate,eed,emoval,enzyme,equal,first,globo,gradually,green-white,honeycomb,living,lon,lower,lunat,nflorescence,nther,orolla,plan,rachi,rarely,reveal,ruit,seudostipule,size,specimen,tal,tem,tissu,toward,two,typically,vary,wide,ympodial	3-6-foliate,4-18,anther,appressed,arrangement,articulation,bract,branching,breeding,colour,connective,dehiscence,ebbrate,form,fruit,fruiting,growth,hair,height,heteromorphism,inflated,inflorescence,insertion,length,lunate,margin,marking,mature,modification,na,number,odour,orientation,ovary,paired,placement,pore,position,prickle,pseudostipule,rhizome,scale,shape,staman,stem,stone,structure,symmetry,sympodial,system,texture,tissue,tuber,type,wet,width,xylopodia,zygomorphy	0.75,1-2,1-4,1.5-2.9,10,10-24,11-23,2,2-3,2-4,2-6,2-9.3,2.4-2.8,2.5-4,3-4,3-5,3-8,3.8-7,4-8,4.5-5.5,5-7,7-15,8-10,9-19,acumen,acuminate,acute,apical,apically,attenuate,branched,broadly,cell,cm,connate,covering,cuneate,cyme,dehiscent,dichasial,dichasially,distal,dorsally,elliptical,exceeding,flat,folded,generally,globose,green,hair-like,half,herbaceous,interpetalar,introrse,lateral,lobe,long,make,maturing,medium,mm,monochasial,mucilaginous,oblique,odd-pinnate,often,ovoid,perennial,perfect,petiolule,plant,poricidally,proximal,puberulent,pubescent,purple,rotate,seed,sessile,short,slit,spot,stamen,stigma,straight,strigose,style,testal,thick,throughout,tuber-bearing,wall,white,yellow,¼	3-6-foliate,4-18,ebbrate,lunate,na,tissue,wet,zygomorphy
224	wfo-0001028468	success	255	122	65	75	180	47	58	7	-5.5,.3-0.4,0.2-1.5,0.5-3.5,0.6-1.2,0.7-2.5,accrescent,along,anther,apex,appressed,articulated,attenuate,base,berry,blue,broad-based,brown,calyx,central,chartaceous,clavate,cm,compressed,connivent,corolla,densely,directed,distally,extra-axillary,filament,fruit,fruiting,glabrous,hair,interpetalar,lateral,laterally,length,light,lobed,margin,mm,moderately,oblique,oblong-lanceolate,occasionally,orange,orangish,pedicel,perfect,petiole,pore,prickle,purple,rotate-stellate,shallowly,short,shrub,simple,somewhat,stellate-pubescent,stem,subcuneate,subglobose,subshrub,surface,tissue,unbranched,unifoliate,unit,usually,vein,x,yellow	-1.3,-10,-3,-4,-7,.1-0.2,.1-0.3,.1-0.4,.2,.2-0.4,.3,.5,.5-1.5,.5-1.6,.6-1,/10-1/5,/4-1/3,0.05,0.1,0.2-0.3,0.2-0.6,0.4-1,0.4-4,0.5-2,0.5-3,0.5-3.3,0.5-8,0.6-2,0.8-3.5,1,1.2-1.5,1.3-2,1.5-2.2,1.5-3.1,1.6,1/3-1/2,1/5-1/2,16,2,2-9,2.2-3,2.5-4,2.8-4.1,2/3-3/4,20,3-4,4-6,4-9,5-21,5-9,6-10,6-9,abaxially,acuminate,acute,adaxially,apart,ark,armed,axe,becoming,beyond,blade,broadly,bu,bud,c.,campanulate,cauline,commonly,compresse,d.,dark,decreasing,density,diameter,distal,distantly,dry,eaf,eed,ellipsoid,equal,exserted,flattened,flower,foveate,geminat,glabrescent,gradually,gray,green,greenish,half,increasing,inserted,introrsel,lamin,lobe,long,longer,lower,m.,main,midpoint,midvein,minutely,mixed,mostly,multangulat,multangulate,narrowly,nflorescence,oblong-conical,obtuse,older,orolla,ovate,overlapping,ovoid,pair,pale,papillo,peduncle,per,porrect-stellate,proximal,pubescence,pubescent,rachi,ray,recurved,reduced,relatively,reticulate,rhombic,ruit,sessile,short-,short-stalked,side,similar,similarly,slightly,spaced,sparsely,specimen,stalk,stamen,stelliform,stigma,straight,style,subacuminate,subcapitate,subchartaceous,subelliptic,sublenticular,subreniform,subsessile,tal,tamen,terete,testa,thick,thick-stalked,thicknes,time,touching,toward,triangular,tube,unarmed,upper,vary,way,wide,yellowish,ympodial,young	articulation,bract,branching,breeding,cell,colour,connective,form,geminate,growth,heteromorphism,inflated,inflorescence,insertion,interjected,introrsely,leaf,leaflet,marking,mature,modification,na,needle-like,none,odour,orientation,paired,pattern,placement,position,pseudostipule,rhizome,scale,shape,spot,staman,stellate,stone,structure,symmetry,sympodial,system,texture,tuber,type,xylopodia,zygomorphy	-5.5,.3-0.4,0.2-1.5,0.5-3.5,0.6-1.2,0.7-2.5,accrescent,along,articulated,attenuate,base,berry,blue,broad-based,brown,central,chartaceous,clavate,cm,compressed,connivent,densely,directed,distally,extra-axillary,glabrous,lateral,laterally,light,lobed,mm,moderately,oblique,oblong-lanceolate,occasionally,orange,orangish,perfect,prickle,purple,rotate-stellate,shallowly,short,shrub,simple,somewhat,stellate-pubescent,stem,subcuneate,subglobose,subshrub,surface,unbranched,unifoliate,usually,vein,x,yellow	geminate,introrsely,na,needle-like,none,stellate,zygomorphy
225	wfo-0001028470	success	185	196	112	133	52	63	107	5	0-18,0.25-0.75,0.9-2.2,0.9-2.3,1-12.3,1-2,1-3,1.6-3.2,11.8-21,12-44,2-10,2-7,2-8,2.1-3.9,3-10,3-5,3.5-16,3.5-7,4-6,4-7,5.5-11.6,6-33,abaxially,adaxially,anther,apex,articulated,asymmetric,attenuate,axillary,base,basiscopic,berry,blade,brownish,bud,cell,chartaceous,clavate,cm,condition,corolla,covering,dark,deep,diameter,distal,dorsally,dot,drying,edge,end,filament,flat,flower,folded,forked,fresh,fruit,generally,glabrous,green,green-white,greenish,hair,hair-like,half,herb,high,homostylous,interjected,lanceolate,lateral,leaf,leaflet,lengthening,light,lobe,long,lower,make,medium,mm,mottled,mucilaginous,odd-pinnate,one,ovoid,pair,pedicel,peduncle,pentagonal,petiole,petiolulate,placed,plant,plurifoliate,pore,poricidal,purple,ripe,rounded,scarce,seed,short,side,size,slit,sometimes,stigma,straight,style,substellate,subtending,terminal,testal,thick,throughout,tip,tissue,tri-,tube,tuber,typically,unit,unwinged,usually,wall,wet,white,whitish,wing,x	1.5-2.8,2-5,3.2-5.5,5-merou,acumen,acute,adaxiall,ag,alyx,apart,apparently,axe,capitat,connivent,decreasing,digestion,eaf,eed,elliptic,enzyme,erec,exceeding,geminat,glabrescent,glabrou,hal,honeycomb-shaped,living,nflorescence,orbicular,orolla,ovate,perfect,pubescent,removed,ruit,sessile,seudostipule,spaced,specimen,stamen,stolo,subequal,subglabrou,tall,tamen,tem,toward,vary,wide,yellow,ympodial	abaxial,adaxial,age,appressed,arrangement,articulation,bract,branching,breeding,broad-based,calyx,capitate,colour,connective,form,fruiting,growth,height,heteromorphism,inflated,inflorescence,insertion,interpetalar,length,margin,marking,mature,modification,na,needle-like,number,odour,orientation,ovary,paired,pattern,placement,position,presence,prickle,pseudostipule,rhizome,scale,shape,smell,spacing,spot,staman,stem,stolon,stone,structure,subglabrous,surface,symmetry,sympodial,system,texture,trichome,type,vegetative,width,xylopodia	0-18,0.25-0.75,0.9-2.2,0.9-2.3,1-12.3,1-2,1-3,1.6-3.2,11.8-21,12-44,2-10,2-7,2-8,2.1-3.9,3-10,3-5,3.5-16,3.5-7,4-6,4-7,5.5-11.6,6-33,abaxially,adaxially,articulated,asymmetric,attenuate,axillary,basiscopic,berry,brownish,bud,cell,chartaceous,clavate,cm,condition,covering,dark,deep,distal,dorsally,dot,drying,end,flat,folded,forked,fresh,generally,glabrous,green,green-white,greenish,hair,hair-like,half,herb,high,homostylous,lanceolate,lateral,lengthening,light,long,make,medium,mm,mottled,mucilaginous,odd-pinnate,one,ovoid,pentagonal,petiolulate,placed,plurifoliate,pore,poricidal,purple,ripe,rounded,scarce,seed,short,side,slit,sometimes,straight,substellate,subtending,terminal,testal,thick,throughout,tip,tissue,tri-,typically,unwinged,usually,wall,wet,white,whitish,wing,x	age,capitate,na,stolon,subglabrous
226	wfo-0001028476	success	242	93	36	54	188	39	35	1	-6,0.4-0.6,0.5,1-4,2-foliate,2-locular,3-foliate,absent,anther,apex,base,bract,branched,calyx,cell,cm,corolla,dark,distal,filament,fruit,fruiting,globose,green,half,herb,imparipinnate,inflorescence,interjected,interrupted,leaf,leaflet,less,long,margin,minutely,mm,pedicel,petiole,present,pseudostipule,pubescent,purple,rarely,simple,sparsely,stellate,stripe,trichome,truncate,uniseriate,unit,weak-walled,yellow	-8,.05-0.1,.5,0-0.5,0-3-12-20,0.1-0.15,0.1-0.4,0.15-0.2,0.15-0.4,0.2-0.3,0.2-0.5,0.2-0.5-1,0.2-0.6,0.25-0.4,0.25-0.5,0.3-0.4,0.3-0.5,0.3-0.7,0.3-1.2,0.4-0.5,0.4-1.5,0.5-0.6,0.5-1.7,0.7-2.5,0.8-1.2,0.8-1.6,1,1-1.2,1-1.4,1-1.5,1-2,1-2-celled,1-6,1-celled,1.1-1.5,1.1-1.6,1.2-2.5,1.8-2.5,2,2-6,2.4-3,3-7,3.5-13-16,4-celled,5-15,6-12-30,7-10,8-30,abaxially,abundant,acroscopically,acuminate,acute,age,almost,along,also,alternate,anthesi,ape,apical,appearance,appendage,articulated,axi,basal,basiscopically,becoming,bifurcate,bifurcation,bracteate,bright,brown,capitate,column,conical,curved,decurrent,deeply,diamete,diameter,eaf,ebracteate,edicel,eed,elliptic,elongate,entire,especially,exserted,first,flower,fortaleza,give,glabrescent,glandular,gradually,gree,hair-like,hal,head,hyaline,incurved,internode,irregularly,lanceolate,largest,lateral,like,lobe,lobed,lon,lower,main,maturity,midvein,minute,mixed,narrowly,nflorescence,node,numerous,oblique,obovate,occasionally,often,outgrowth,ovary,pair,pale,peduncle,perennial,petiolule,population,primary,prominent,puberulent,pubescence,rachi,recurve,reflexed,regularly,rest,rounded,ruit,río,scattered,secondary,sessile,set,short,silky,sinus,slightly,smaller,sprawling,spreading,staminal,stem,sterile,stiff,stigma,straight,style,subopposite,surface,tall,tem,terminal,tertiary,testa,thick,tip,toward,tube,ud,unicellular,uniformly,unpaired,usually,vein,wall,white,wid,wide,winged,woody,ympodial	appressed,articulation,branching,breeding,colour,connective,form,growth,hair,heteromorphism,inflated,insertion,interpetalar,length,marking,na,odour,orientation,paired,pattern,placement,pore,position,prickle,rhizome,scale,shape,spot,staman,stone,structure,symmetry,sympodial,system,texture,tissue,tuber,type,xylopodia	-6,0.4-0.6,0.5,1-4,2-foliate,2-locular,3-foliate,absent,branched,cm,dark,distal,globose,green,half,herb,imparipinnate,interrupted,less,long,minutely,mm,present,pubescent,purple,rarely,simple,sparsely,stellate,stripe,trichome,truncate,uniseriate,weak-walled,yellow	na
227	wfo-0001028481	success	194	162	86	108	86	54	82	4	.1,.5,0.5-1,0.6-1,0°,1-3,1-4,1.5,1.8-2.5,2.5-3,3-3.5,3-4,3-6,5.5-7.5,8,absent,acuminate,almost,along,anther,apex,apically,attenuate,bark,base,branch,branched,brown,chartaceous,clavate,cm,colour,conical,corolla,cuneate,dendritic,dendritic-pubescent,diameter,dilated,discolorous,distributed,dry,drying,elliptic,entire,equal,evenly,filament,flaking,glabrous,green,leaf,length,less,liana,like,lobed,long,longitudinally,lower,main,margin,midvein,mm,oblique,oblong,occasional,often,orange-brown,pair,pedicel,peduncle,petiole,pore,poricidal,primary,pubescent,ray,reddish,ridged,scar,shortly,shrub,side,size,small,sparsely,stem,stigma,stump,style,surface,terminal,tertiary,thickly,tip,trichome,tube,unarmed,unit,unknown,vein,venation,visible,white,x,yellowish,young	.3,0-2,0.1-0.2,0.15,1-1.4,1-2,1.5-2,1/2-2/3,2-3,3,3-4.5,abaxially,acute,adaxially,age,alyx,anthesi,apar,apparently,articulated,canaliculate,clearly,close,cupular,deeply,delineated,deltoid,density,different,divided,domatia,dorsifixed,eaf,eed,ellipsoi,erect,except,extending,extent,eye,faint,flat,flexuous,flower,free,increasing,know,known,lamina,lengthening,linear,lobe,lon,long-acuminate,longer,m.,mostly,naked,narrowly,nflorescence,nther,orolla,ovate,perfec,plurifoliat,portion,protruding,rachi,raised,ribbed,ruit,see,simple,sinus,slender,smoot,smoothly,spreading,tearing,together,toward,ud,uneven,vary,wide,ympodial	angle,apart,arrangement,articulation,bract,branching,breeding,broad-based,calyx,cell,connective,form,fruit,fruiting,growth,habit,hair,heteromorphism,inflorescence,interjected,interpetalar,leaflet,marking,na,needle-like,number,odour,orientation,ovary,placement,plant,plurifoliate,position,prickle,protrusion,pseudostipule,rhizome,scale,shape,smell,smooth,spot,staman,stone,structure,symmetry,sympodial,system,texture,tissue,tuber,type,vegetative,xylopodia	.1,.5,0.5-1,0.6-1,0°,1-3,1-4,1.5,1.8-2.5,2.5-3,3-3.5,3-4,3-6,5.5-7.5,8,absent,acuminate,almost,along,anther,apically,attenuate,base,branch,branched,brown,chartaceous,clavate,cm,conical,cuneate,dendritic,dendritic-pubescent,dilated,discolorous,distributed,dry,drying,elliptic,entire,equal,evenly,flaking,glabrous,green,less,liana,like,lobed,long,longitudinally,midvein,mm,oblique,oblong,occasional,often,orange-brown,pair,poricidal,pubescent,ray,reddish,ridged,shortly,shrub,side,small,sparsely,stem,stump,terminal,thickly,tip,trichome,unarmed,unknown,visible,white,x,yellowish,young	apart,na,plurifoliate,smooth
228	wfo-0001028482	success	224	114	49	64	160	50	47	2	.1,/3,1-4,1.1-5,2-celled,3-4,acute,anther,apex,asymmetric,base,berry,bifurcate,branched,calyx,chartaceous,cm,corolla,curved,diffusely,difoliate,entire,expanding,filament,flower,fruit,fruiting,glandular,globose,green,growth,hard,internodal,leaf-opposed,lobed,lower,margin,maturity,mm,occasionally,pedicel,petiole,poricidal,reddish,revolute,simple,size,slightly,stem,straight,subcoriaceous,subglobose,surface,tip,tree,trichome,twice,unifoliate,unit,usually,vegetative,way,white,x	.5,0,0.2,0.5,0.5-1,0.5-5,0.7-1.1,00,1-1.5,1-11,1-2,1.2-1.6,1.5-2,1.5-3,10,2-3,3-12,4-5,5-25,6-50,7-14,abaxially,acuminate,adaxially,age,alternate,angled,anthesi,apiculae,ascending,bark,basal,becoming,berr,bifid,bilobed,bright,broadly,brochiodromous,brownish,bud,campanulate,capitate,channeled,circinate,closely,constriction,coriaceous,corky,corrugated,creamy,cucullate,cymose,deciduous,deflexed,deltate,densely,diameter,discolorous,distally,distinct,dry,drying,eaf,eed,ellipsoid,elliptic,emarginate,embryo,enlarged,exerted,exfoliating,flattened-reniform,fleshy,free,fresh,geminat,glabrou,glabrous,golden,grayish,halfway,heterostylous,impressed,incrassate,individual,investing,irregular,keeled,lengthening,less,lobe,long,markedly,materia,material,midrib,midvein,minute,minutely,new,nflorescence,nodding,obovate,olive,ovary,overlappin,pair,pale,papillat,peduncle,pentamerous,per,pericarp,petal,pitted,pore,portion,primary,pubescent,row,ruit,scandent,scar,shaped,shiny,short,slit,small,sometimes,somewhat,soon,spaced,sparsely,stigma,stout,style,subpyramidal,tan,tear-drop,tightly,tiny,transparent,transversely,truncate,tub,tube,tuberculate,tuft,two,ud,uniseriate,vein,venation,woody,yellow,yellowish,ympodial,young,µm	appressed,articulation,bract,branching,breeding,broad-based,cell,colour,connective,form,geminate,hair,heteromorphism,inflated,inflorescence,insertion,interjected,interpetalar,leaf,leaflet,length,marking,mature,na,needle-like,odour,orientation,paired,pattern,placement,position,prickle,pseudostipule,rhizome,scale,shape,smell,spot,staman,stone,structure,symmetry,sympodial,system,texture,tissue,tuber,type,xylopodia,zygomorphy	.1,/3,1-4,1.1-5,2-celled,3-4,acute,asymmetric,base,berry,bifurcate,branched,chartaceous,cm,curved,diffusely,difoliate,entire,expanding,flower,glandular,globose,green,hard,internodal,leaf-opposed,lobed,maturity,mm,occasionally,poricidal,reddish,revolute,simple,size,slightly,straight,subcoriaceous,subglobose,tip,tree,twice,unifoliate,usually,way,white,x	geminate,na
229	wfo-0001028487	success	195	174	97	119	76	55	93	4	0-9,0.3-0.7,0.4-1.5,0.9-3,1-2,1-3,1-3.2,1.1-1.5,1.4-1.7,1.7-7,10-4.3,10-41,15-28,2-4,2-4.8,2-6,2.5-3.5,3-10,3-19,3-5,3.4-7.8,4-7,4.6-13.6,5-6,7.8-16.4,acuminate,acute,anther,apex,asymmetric,attenuate,axillary,base,basiscopic,berry,blade,brownish,bud,cell,central,clavate,cm,condition,coriaceous,corolla,dark,deep,diameter,distal,drying,elliptic,filament,flower,forked,fresh,fruit,glabrescent,glabrous,green,greenish,hair,half,herb,high,homostylous,interjected,lanceolate,leaf,leaflet,light,lobe,long,medium,mm,moniliform,mucilaginous,narrow,odd-pinnate,orbicular,ovate,ovoid,pedicel,peduncle,pentagonal,petiole,petiolulate,plant,plurifoliate,pore,poricidal,purple,ripe,rounded,seed,short,side,size,sometimes,star,stigma,straight,style,substellate,subtending,terminal,tip,tissue,tri-,tube,tuber,unit,unwinged,usually,wet,white,whitish,wide,wing,x	3-4,5-merou,abaxially,acumen,adaxiall,adaxially,ag,along,alyx,apart,apparently,arranged,articulated,axe,bead,capitat,connivent,considerably,covering,decreasing,digestion,dorsally,eaf,edge,eed,enzyme,erec,exceeding,flat,folded,geminat,generally,glabrou,green-white,hair-like,hal,honeycomb-shaped,lateral,lengthening,like,living,lower,make,multiple,necklace,nflorescence,orolla,pair,perfect,removed,ruit,scabrous,scarce,second,sessile,seudostipule,slit,smaller,spaced,specimen,stamen,stolon,subequal,subglabrou,tall,tamen,tem,testal,thick,throughout,toward,typically,vary,wall,yellow,ympodial	abaxial,adaxial,appressed,arrangement,articulation,bract,branching,breeding,calyx,capitate,colour,connective,form,fruiting,growth,height,heteromorphism,inflated,inflorescence,insertion,interpetalar,length,margin,marking,mature,modification,na,number,odour,orientation,ovary,paired,pattern,placement,position,presence,prickle,pseudostipule,rhizome,scale,shape,spacing,spot,staman,stellate,stem,stone,structure,subglabrous,symmetry,sympodial,system,texture,type,xylopodia	0-9,0.3-0.7,0.4-1.5,0.9-3,1-2,1-3,1-3.2,1.1-1.5,1.4-1.7,1.7-7,10-4.3,10-41,15-28,2-4,2-4.8,2-6,2.5-3.5,3-10,3-19,3-5,3.4-7.8,4-7,4.6-13.6,5-6,7.8-16.4,acuminate,acute,asymmetric,attenuate,axillary,basiscopic,berry,brownish,bud,central,clavate,cm,condition,coriaceous,dark,deep,distal,drying,elliptic,forked,fresh,glabrescent,glabrous,green,greenish,hair,half,herb,high,homostylous,lanceolate,light,long,medium,mm,moniliform,mucilaginous,narrow,odd-pinnate,orbicular,ovate,ovoid,pentagonal,petiolulate,plurifoliate,poricidal,purple,ripe,rounded,short,side,sometimes,star,straight,substellate,subtending,terminal,tip,tissue,tri-,unwinged,usually,wet,white,whitish,wide,wing,x	capitate,na,stellate,subglabrous
230	wfo-0001028489	success	222	114	62	69	153	45	57	5	/4,0-50,0.3-0.5,0.3-1.2-2.5,1/3-1/2,3.5-6,acicular,anther,apex,apparently,articulated,base,berry,branched,calyx,cell,chartaceous,cm,connivent,cordate,cream,cuneate,dark,difoliate,elongating,equal,erect,filament,fruit,fruiting,glabrous,green,hair,lateral,leaf,length,lobed,long,margin,marking,mature,maturity,mauve,membranous,mm,moderately,orange,pale,pedicel,perpendicular,petiole,poricidal,prickle,purple,shrub,simple,sometimes,spherical,stellate,stellate-pubescent,stem,straight,tapering,tip,truncate,unit,way,white,young	-10,-4,-5,-6,0-10,0-15,0-20,0-3,0.1,0.1-0.6,0.2,0.2-0.3-0.5,0.2-0.4-0.6,0.2-0.5,0.2-0.6,0.2-0.7,0.3-0.7,0.3-1,0.4-0.8,0.5-0.8,0.5-1,0.5-1.1,0.5-1.5,0.6-1.2,0.7-3,1-3,1-4,1-6,1-7,1.5-3,1.5-4,1.8-2.2,1.8-4,1.8-5.5,1/3,1/4-1/2,2-3,2-4,2-6,2.1-3,3-7,4-10,4-13,4-8,5-25,5-8,5-merous,7.5,abaxially,acute,alyx,apar,apart,apically,ba,bark,beyond,blade,broad-deltate,caudat,concolorous,curved,deltate,densely,diameter,distance,drying,dull,eaf,eed,elliptic,extending,eye,flattened-reniform,flower,free,geminat,gray,herbaceous,infructescence,less,lobe,lon,longer,lower,midpoint,midvein,minute,naked,nflorescence,obtuse,occasionally,often,older,one,open,orange-brown,orange-green,orolla,oung,outline,ovate,pair,peduncle,pendulous,per,perfec,pericarp,porrect,portion,prickly,primary,protruding,raised,ray,red-brown,rounded,ruit,scar,sessile,shiny,side,slender,smooth,spaced,sparsely,spreading,stalk,style,subsessile,surface,tamen,terete,tertiary,time,toward,trichome,tube,unarme,unarmed,upper,vary,vein,venation,visible,weakly,white-gra,wide,woody,yellow,yellow-green,yellow-orange,ympodial	appressed,articulation,bract,branching,breeding,colour,connective,corolla,form,geminate,growth,heteromorphism,inflated,inflorescence,insertion,interjected,interpetalar,leaflet,modification,na,none,odour,orientation,paired,pattern,perfect,placement,position,pseudostipule,rhizome,scale,shape,spot,staman,stone,structure,symmetry,sympodial,system,texture,tissue,tuber,type,xylopodia,zygomorphy	/4,0-50,0.3-0.5,0.3-1.2-2.5,1/3-1/2,3.5-6,acicular,apparently,articulated,base,berry,branched,chartaceous,cm,connivent,cordate,cream,cuneate,dark,difoliate,elongating,equal,erect,fruit,glabrous,green,lateral,leaf,length,lobed,long,marking,mature,maturity,mauve,membranous,mm,moderately,orange,pale,perpendicular,poricidal,purple,shrub,simple,sometimes,spherical,stellate,stellate-pubescent,stem,straight,tapering,tip,truncate,way,white,young	geminate,na,none,perfect,zygomorphy
231	wfo-0001028492	success	130	139	70	81	49	58	62	8	0.2-2,0.5-1,1-2.5,1-4,1-5,1.5-2.5,1.5-6,15-20,2-2.5,2-3,3,3-6,4,5-15,5-8,6-11,8-15,acute,aggregate,angled,apart,apex,axi,base,calyx,cell,chartaceous,cm,colored,containing,crystal,cylindrical,dark,deltate,diameter,elliptic-ovate,entire,forked,fruit,glabrous,globose,hair,herb,leaving,lobe,margin,mm,narrowly,pedicel,peduncle,petiole,pore,purple,rachi,radiu,rarely,reticulate,ripe,rounded,sand-punctate,scar,shrub,simple,somewhat,stellate,stigma,stone,style,subcordate,subcoriaceous,succulent,triangular,triangular-ovate,tube,unbranched,unit,unknown,veiny,white-punctate,whitish,x	-5-foliat,1.5-3,1.75-3.5,2-4,2-5,2.5-9,5-25-flower,6-12,abaxially,absen,adaxially,apiculate,articulated,axe,blade,ciliolate,color,connivent,directed,distall,eaf,eed,except,glabrou,irregularly,long,lower,nflorescence,nther,obtuse,orolla,pubescent,punctate,ruit,san,spaced,sparse,splitting,tal,tem,time,tip,truncat,unevenly,vary,white,wide,x1-3,ympodial	4-5-foliate,5-25,abaxial,absent,adaxial,anther,arrangement,articulation,bract,branching,colour,corolla,direction,distally,flower,form,growth,height,heteromorphism,inflorescence,interjected,interpetalar,leaf,leaflet,length,na,number,odour,orientation,ovary,placement,plant,position,prickle,pseudostipule,pubescence,punctation,reticulation,rhizome,sand,scale,seed,shape,spacing,staman,stem,structure,symmetry,sympodial,tall,texture,tissue,trichome,truncate,tuber,type,width,xylopodia	0.2-2,0.5-1,1-2.5,1-4,1-5,1.5-2.5,1.5-6,15-20,2-2.5,2-3,3,3-6,4,5-15,5-8,6-11,8-15,acute,angled,apart,axi,base,cell,chartaceous,cm,colored,containing,crystal,cylindrical,dark,deltate,elliptic-ovate,entire,forked,glabrous,globose,herb,leaving,mm,narrowly,purple,rarely,reticulate,ripe,rounded,sand-punctate,scar,shrub,simple,somewhat,stellate,subcordate,subcoriaceous,succulent,triangular,triangular-ovate,unbranched,unknown,veiny,white-punctate,whitish,x	4-5-foliate,5-25,absent,distally,na,sand,tall,truncate
232	wfo-0001028501	success	195	174	90	114	81	60	87	3	0-3,0-3.2,0-4,0.3-0.7,0.8-1.6,0.8-1.7,1,1-2,1-8,1.8-10.7,13-41,2-4,2.8-18,2.8-4.9,3-10,3-5,3-7,3.1-10.4,3.1-12,4-8,4.8-18,6.6-21.1,8-10,8-34,adaxially,anther,apex,base,berry,blade,brownish,cell,clavate,cm,condition,coriaceous,corolla,covering,dark,decurrent,diameter,distal,drying,filament,flower,forked,fresh,fruit,glabrescent,glabrous,green,greenish,hair,hair-like,half,herb,high,homostylous,interjected,lanceolate,lateral,leaf,leaflet,light,lobe,long,lower,medium,mm,moniliform,mottled,narrow,narrowly,odd-pinnate,ovoid,pair,pedicel,peduncle,petiole,plant,plurifoliate,pore,poricidal,purple,pyriform,ripe,rotate,scarce,seed,sessile,short,simple,size,sometimes,spot,stigma,straight,style,terminal,testal,thick,tip,tri-,tube,tuber,unit,unwinged,usually,wall,white,whitish,wide,wing,x	0.3-3.3,0.6-5.8,1-3,2-5,5-merou,abaxially,acumen,acuminate,acute,adaxiall,ag,along,alyx,apart,apparently,arranged,articulated,attenuate,axe,axillary,bead,broadly,bud,capitat,connivent,considerably,decreasing,digestion,dorsally,eaf,edge,eed,elliptic,enzyme,erec,exceeding,flat,folded,geminat,generally,glabrou,green-white,hal,honeycomb-shaped,larger,lengthening,like,linear,living,make,mucilaginous,multiple,necklace,nflorescence,onto,orbicular,orolla,ovate,perfect,present,rachi,removed,ruit,seudostipule,slit,spaced,specimen,stamen,stolon,subglabrou,subtending,tall,tamen,tem,throughout,toward,typically,vary,wet,yellow,ympodial	abaxial,adaxial,appressed,arrangement,articulation,bract,branching,breeding,broad-based,calyx,capitate,colour,connective,form,fruiting,growth,height,heteromorphism,inflated,inflorescence,insertion,interpetalar,length,margin,marking,mature,modification,na,needle-like,number,odour,orientation,ovary,paired,pattern,placement,position,presence,prickle,pseudostipule,rhizome,scale,shape,smell,spacing,staman,stem,stone,structure,subglabrous,surface,symmetry,sympodial,system,texture,tissue,trichome,type,vegetative,xylopodia	0-3,0-3.2,0-4,0.3-0.7,0.8-1.6,0.8-1.7,1,1-2,1-8,1.8-10.7,13-41,2-4,2.8-18,2.8-4.9,3-10,3-5,3-7,3.1-10.4,3.1-12,4-8,4.8-18,6.6-21.1,8-10,8-34,adaxially,berry,brownish,cell,clavate,cm,condition,coriaceous,covering,dark,decurrent,distal,drying,forked,fresh,glabrescent,glabrous,green,greenish,hair,hair-like,half,herb,high,homostylous,lanceolate,lateral,light,long,medium,mm,moniliform,mottled,narrow,narrowly,odd-pinnate,ovoid,plurifoliate,poricidal,purple,pyriform,ripe,rotate,scarce,sessile,short,simple,sometimes,spot,straight,terminal,testal,thick,tip,tri-,unwinged,usually,wall,white,whitish,wide,wing,x	capitate,na,subglabrous
233	wfo-0001028502	success	158	121	49	69	89	52	43	6	0.5-1,1-2,1.5-2,1.5-2.5,1.5-6,1.6-2.4,2-4,2-5,2-7,2-8,3.5-15,3.5-4,abaxial,abaxially,acute,adaxially,anther,anthesi,apex,base,beige,blade,branched,calyx,campanulate,clavate,cm,congested,corolla,densely,elliptic,filament,flattened-reniform,fruiting,glabrous,globose,inflorescence,lateral,leaf,lobed,margin,minutely,mm,obovate,ovary,papillose,pedicel,petiole,pitted,pore,poricidal,pubescent,reddish-brown,seed,shining,shrub,small,stigma,structure,style,surface,terminal,time,tree,tree-like,trichome,tube,warty,white	.5,/2,1.5-3,2-2.5,5-15,5-6,6-8,?,age,along,apar,ba,bark,body,branch,brown,cazalet,christmas-tree-like,closely,cone,constricted,dark,deltate,dendritic,denser,dia,eaf,edicel,eed,erect,exserted,fawn,fide,flat,fleshy,flower,free,glabrat,heteromorphic,impressed,included,incrassate,inflorescenc,later,lengthening,light,like,lobe,lon,long,long-styled,lower,main,matted,middle,narrower,nflorescence,often,older,packed,pair,papillo,planar,plurifoliat,portion,prominent,rest,ruit,scar,scattered,short-styled,slit,spaced,stem,tall,thick,tip,tub,ud,unclear,unevenly,vein,way,wide,widest,within,woody,ympodia,young	0.5,1,4-6,articulation,bract,branching,breeding,cell,colour,connective,diameter,form,fruit,growth,hair,height,heteromorphism,insertion,interjected,interpetalar,leaflet,length,marking,mature,modification,na,odour,orientation,pattern,placement,plant,plurifoliate,position,prickle,pseudostipule,rhizome,scale,shape,spot,staman,stone,symmetry,sympodial,system,texture,tissue,tuber,type,unit,width,xylopodia,ye	0.5-1,1-2,1.5-2,1.5-2.5,1.5-6,1.6-2.4,2-4,2-5,2-7,2-8,3.5-15,3.5-4,acute,beige,branched,campanulate,clavate,cm,congested,densely,elliptic,flattened-reniform,glabrous,globose,lateral,lobed,minutely,mm,obovate,papillose,pitted,poricidal,pubescent,reddish-brown,shining,shrub,small,terminal,time,tree,tree-like,warty,white	0.5,1,4-6,na,plurifoliate,ye
234	wfo-0001028505	success	168	77	48	58	110	19	46	2	.1,.3,.5,0.25-0.5,0.8-1,0.8-1.5,10-14-flowered,10-15,2,3.5-5,anther,bark,basal,base,berry,cm,corolla,deflexed,dia,drying,f,filament,gently,glabrous,globose,green,grey,leaf,lobed,margin,minutely,mm,narrowly,opposite,ovate,ovoid-reniform,pale,papillose,pedicel,petiole,pitted,pore,poricidal,pubescent,rounded,seed,shape,shaped,shrub,size,tapering,tear-drop,tip,truncate,tube,white,woody,x	.01,/3,1,1-3,1.2-2.5,1/3,2.5-4.5,3-5,7-8,acuminate,acute,anthesi,apex,aspect,ba,barely,beneath,black,blade,body,branch,bright,broadly,bud,calyx,characteristic,conical,darker,deciduous,decurrent,delicate,deltoid,differentiated,differing,difoliate,distance,distinct,dried,dry,eaf,edicel,eed,elliptic,erect,expanded,exserted,exsertion,flattened,free,fruiting,geminat,greatly,incrassate,lateral,live,lobe,lon,long,lower,m.,main,major,materia,material,member,minor,minute,nflorescence,obovoid,obvious,older,ovary,overlapping,pair,plant,portion,prominent,proximal,purple,reflexed,ruit,scar,short,simple,slightly,somewhat,soon,specimen,stem,stigma,straight,strongly,style,surface,tall,tan,touching,trichome,ud,unicellular,uniseriate,unit,usually,vein,way,whit,widest,yellowish,ympodial,young	articulation,colour,decurren,flower,form,fruit,growth,hair,inflorescence,insertion,length,marking,number,position,spot,symmetry,texture,type,zygomorphy	.1,.3,.5,0.25-0.5,0.8-1,0.8-1.5,10-14-flowered,10-15,2,3.5-5,basal,berry,cm,deflexed,dia,drying,f,gently,glabrous,globose,green,grey,leaf,lobed,margin,minutely,mm,narrowly,opposite,ovate,ovoid-reniform,pale,papillose,pitted,poricidal,pubescent,rounded,shaped,shrub,tapering,tear-drop,tip,truncate,white,woody,x	decurren,zygomorphy
235	wfo-0001028524	success	236	124	61	75	161	49	59	2	0.6-1.4,1.2-1.3,2-6,3-4.3,4-6,accrescent,acute,anther,apex,apical-lateral,apparently,articulated,axillary,base,becoming,berry,blunt-tipped,branched,calyx,chartaceous,cm,continued,corolla,cream,dehiscing,due,entire,extend,filament,fruit,fruiting,glabrous,greenish,growth,hair,interpetalar,introrse,lacking,lanceolate,large,lateral,leaf,length,longitudinal,lower,margin,mm,oblong,obtuse,ovate,pedicel,perfect,petiole,plurifoliate,pore,present,probably,pseudo-terminal,ripe,rounded,simple,slightly,slit,somewhat,stellate,stem,subcoriaceous,subglobose,time,tissue,tree,unit,x,yellow,yellowish	-2.7,-3,.5-1,/10-3/10,0-150,0.3,0.3-0.8,0.5-3.5,1-5,1.1-1.2,1.5-1.6,1.5-3,1.8-2.5,1/3-2/3,10-20,11,2-3.8,2.5-3.4,2.5-3.8,2.5-4,2.8-3.5,3-10,3-15,3.3-4,3.4-3.6,4-8,4.3-6,6-7,6-9,7-10,7-11,8-13,9-14,abaxially,acuminate,adaxially,ag,along,anthesi,apart,ascending,axe,ba,bark,blade,branch,brown,bud,capitat,closely,conical,dark,deltoid,densely,diameter,distal,dm,eaf,echinoi,echinoid,eed,elliptic,exserted,ferrugineous,few-,few-rayed,first,fleshy,flower,free,glabrescen,glabrescent,granular-tomentose,gray,green,half,high,honeycombed,indument,inserted,lanceolat,late,later,lobe,lobed,long,m.,main,many-rayed,matted,midvei,midvein,mixed,multangulate,nearly,nflorescence,obscured,often,older,orbicular,orolla,ovate-lanceolate,overlapping,pale,partly,peduncle,persistent,porrect-stellate,prominent,pubescent,rachi,rather,ray,relatively,reniform,reticulate-punctate,ruit,runk,scabridulous,sessile,short,short-stalked,side,small,spaced,sparingly,sparsely,stalked,stamen,stelliform,stigma,stout-stalked,strongly,style,suborbicular,sulcate,suture,tamen,terete,testa,thick,thick-stalked,thin,thin-stalked,tomentose,tomentu,touching,translucent,tube,unarme,unarmed,usually,vary,vein,velutinous,warty,way,wide,yellowish-green,ympodial,young	age,appressed,articulation,bract,branching,breeding,broad-based,cell,colour,connective,form,heteromorphism,inflated,inflorescence,insertion,interjected,leaflet,marking,mature,modification,na,needle-like,odour,orientation,paired,pattern,placement,position,prickle,pseudostipule,rhizome,scale,shape,smell,spot,staman,stone,structure,surface,symmetry,sympodial,system,texture,trichome,tuber,type,vegetative,xylopodia,zygomorphy	0.6-1.4,1.2-1.3,2-6,3-4.3,4-6,accrescent,acute,apical-lateral,apparently,articulated,axillary,base,becoming,berry,blunt-tipped,branched,chartaceous,cm,continued,cream,dehiscing,due,entire,extend,glabrous,greenish,growth,introrse,lacking,lanceolate,large,lateral,leaf,longitudinal,mm,oblong,obtuse,ovate,perfect,plurifoliate,pore,present,probably,pseudo-terminal,ripe,rounded,simple,slightly,slit,somewhat,stellate,stem,subcoriaceous,subglobose,time,tree,x,yellow,yellowish	age,na
236	wfo-0001028525	success	257	118	65	72	185	46	59	6	0.5-1.5,1-2,1mm,2,4-5,6,accrescent,almost,anther,apex,apically,apparently,attenuate,base,berry,black,branched,branching,broadly,brown,calyx,chartaceous,cm,cordate,corolla,dendritic,developed,dilated,drying,elongated,entire,filament,form,frequently,fruit,fruiting,leaf,less,liana,light,lobed,lumpy,margin,mature,mauve,membranous,mm,much,oblong,orange-brown,partly,pedicel,petiole,pore,poricidal,pyriform,shrub,simple,slender,slightly,smaller,sometimes,spheroidal,stem,structure,terminal,tip,truncate,unit,weakly,whitish,x	.25,.4,0.2-0.3,0.2-0.6,0.5,0.5-2.5,0°,1-1.5,1-2.5,1-4,1.1-1.7,1.2-1.6,1.5,1.5-3,1/3-3/4,10,10-13,2-2.5,2-3,2.5-5,3,3-5,3-7,4,4-15,4-7,7,7-13,7.5,acuminate,acute,age,along,alternate,alyx,anthesi,apar,apart,apice,around,articulated,axil,bark,becoming,brachyblast,branch,capitate,centre,clavate,clearly,clum,clustered,conical,cup,curved,dark,deeply,delineated,deltoid,dendritic-pubescent,densely,density,detaching,developing,diameter,discolorous,divided,domatia-like,dorsal,dorsifixed,eaf,eed,ellipsoi,equal,erect,eye,fertilisation,fewer,fine,flat,flattened,flexible,flexuous,flower,formed,forming,free,frui,glabrescent,glabrous,green-brown,grey,increasing,inside,known,lamina,lateral,laterally,leave,lengthening,like,linear,lobe,long,longer,longitudinally,loop,loose,lower,m.,main,midvein,minute,multicellular-dendritic,naked,narrowly,nflorescence,nther,obconical,obscuring,often,one,orolla,outside,ovate,overlapping,ovoid,pair,peduncle,pendulous,perfec,pericarp,plurifoliat,portion,primary,prominent,protruding,puberulous,pubescent,rachi,ray,red-brown,ridged,rounded,ruit,scar,scattered,sessile,side,sinus,size,small,smoot,smooth,somewhat,soon,sparsely,spreading,stigma,stripe,stump,style,surface,tangling,tearing,terete,tertiary,thick,thin,toward,trichome,tube,ud,unarmed,uneven,vary,vein,venation,visible,well-developed,white,wide,wider,ympodial,young	appressed,articulation,bract,breeding,broad-based,cell,colour,connective,growth,hair,heteromorphism,inflated,inflorescence,insertion,interjected,interpetalar,leaflet,length,marking,modification,na,odour,orientation,paired,pattern,perfect,placement,plurifoliate,position,prickle,pseudostipule,rhizome,scale,shape,spot,staman,stellate,stone,symmetry,sympodial,system,texture,tissue,tuber,type,xylopodia	0.5-1.5,1-2,1mm,2,4-5,6,accrescent,almost,anther,apex,apically,apparently,attenuate,base,berry,black,branched,broadly,brown,chartaceous,cm,cordate,dendritic,developed,dilated,drying,elongated,entire,frequently,fruit,less,liana,light,lobed,lumpy,mature,mauve,membranous,mm,much,oblong,orange-brown,partly,poricidal,pyriform,shrub,simple,slender,slightly,smaller,sometimes,spheroidal,stem,terminal,tip,truncate,weakly,whitish,x	broad-based,na,perfect,plurifoliate,prickle,stellate
237	wfo-0001028528	success	155	131	70	84	71	47	65	5	.5,0.9-1.2,1.5,1.8-2,2-3,2-4,3.5-4,3/4,8-9,absent,age,anther,apex,attenuate,bark,base,becoming,berry,bi-lobed,blackish,branch,branching,cm,coriaceous,corolla,decurrent,dendritic,diameter,elliptic,erect,except,filament,flattened,fork,fruiting,glabrous,globose,growth,later,leaf,lobed,long,lower,margin,minutely,mm,narrowly,obovate,outline,ovary,pedicel,per,petiole,pitted,plurifoliate,pore,poricidal,prominent,pubescent,reddish-brown,revolute,round,scar,shiny,shrub,sleeve,slit-like,sparsely,stem,stigma,strongly,style,surface,terminal,time,tip,trichome,tube,unit,violet,way,white,winged,x	1-2,1.1-1.2,2.5-3,3.5-6,4-5,4-6,6-10,6-7,?,abaxial,acuminate,acute,adaxial,adaxially,along,anthesi,apical,ba,basal,calyx,conical,densely,denser,dichasia,eaf,edicel,eed,ew,exserted,flower,free,glabrat,glandular,immature,impressed,inserted,leave,like,lobe,m.,midvein,minute,mucronate,nflorescence,nodding,occasionally,older,pair,papillo,pericarp,petal,planar,portion,pyramidal,ruit,secondary,short,somewhat,stamen,ste,tall,tapering,thin,triangular,tub,ud,vein,wide,woody,ympodial,young	bract,breeding,broad-based,bud,cell,colour,connective,dichasial,form,fruit,glabrate,hair,height,heteromorphism,inflorescence,insertion,length,marking,modification,na,needle-like,new,orientation,papillose,pattern,placement,plant,position,prickle,pseudostipule,rhizome,seed,shape,size,spot,staman,stone,structure,symmetry,sympodial,system,texture,tuber,type,width,xylopodia,zygomorphy	.5,0.9-1.2,1.5,1.8-2,2-3,2-4,3.5-4,3/4,8-9,absent,age,attenuate,base,becoming,berry,bi-lobed,blackish,branch,branching,cm,coriaceous,decurrent,dendritic,elliptic,erect,except,flattened,fork,glabrous,globose,later,leaf,lobed,long,margin,minutely,mm,narrowly,obovate,outline,per,pitted,plurifoliate,poricidal,prominent,pubescent,reddish-brown,revolute,round,shiny,shrub,sleeve,slit-like,sparsely,strongly,surface,terminal,time,tip,trichome,violet,way,white,winged,x	dichasial,glabrate,na,papillose,zygomorphy
238	wfo-0001028529	success	164	157	80	97	67	60	77	3	0.1,0.5,0.5-2,0.8-1.3,0.8-3,0.8-3.2,1,1.5,2.5-3,2/3,5-6,6-9,7-8,8-14,age,anther,anthesi,apart,apex,attenuate,bark,base,becoming,brown,bud,calyx,cm,corolla,dark,decurrent,dia,distal,erect,exfoliating,exserted,filament,fruiting,furcate,glabrous,globose,green,heterostylous,hyaline,internodal,lanceolate,lateral,leaf,less,lobed,long,lower,main,major,middle,minor,minutely,mm,narrowly,nearly,oblanceolate,opposite,ovary,ovoid-reniform,pair,paler,pedicel,petiole,pitted,planar,pore,prominent,reflexed,scar,shape,shaped,shrub,simple,size,slender,slightly,smooth,somewhat,soon,stem,subshrub,surface,tapering,tear-drop,tube,vein,way,white,widest,winged,woody,x,yellowish	.2,1-1.2,1-1.5,3-40-flowered,3-5,across,acuminate,acute,apiculate,beginning,beneath,berry,bluish,capitate,cast,close,cork,course,deflexe,deltoid,eaf,edicel,eed,ellipsoi,elliptic,evenly,flower,free,growing,hrub,immature,indistinct,inflorescenc,lenticellat,linear,lobe,lon,metallic,minute,much,nflorescence,occasionally,older,one,papillae,papillo,papillose,poricidal,portion,present,range,river,ruit,scattered,short,small,spaced,species,stigma,straight,style,tall,tip,ud,umbonate,variable,young	abaxial,articulation,bract,branching,breeding,broad-based,cell,colour,connective,corky,deflexed,exsertion,form,fruit,glabrousnes,growth,hair,height,heteromorphism,inflorescence,insertion,interjected,interpetalar,leaflet,length,margin,marking,modification,na,needle-like,odour,orientation,part,pattern,placement,plant,position,prickle,pseudostipule,rhizome,scale,seed,smell,spacing,spot,staman,stone,structure,symmetry,sympodial,system,texture,tissue,trichome,tuber,type,unit,vegetative,xylopodia,zygomorphy	0.1,0.5,0.5-2,0.8-1.3,0.8-3,0.8-3.2,1,1.5,2.5-3,2/3,5-6,6-9,7-8,8-14,age,anthesi,apart,attenuate,base,becoming,brown,calyx,cm,dark,decurrent,dia,distal,erect,exfoliating,exserted,furcate,glabrous,globose,green,heterostylous,hyaline,internodal,lanceolate,lateral,leaf,less,lobed,long,main,middle,minutely,mm,narrowly,nearly,oblanceolate,opposite,ovoid-reniform,pair,paler,pitted,planar,prominent,reflexed,shaped,shrub,simple,slender,slightly,smooth,somewhat,soon,subshrub,tapering,tear-drop,tube,vein,way,white,winged,woody,x,yellowish	corky,deflexed,na
239	wfo-0001028532	success	186	131	67	88	98	43	64	3	0-19,0.2-1,1-2,1-3,1.4-1.6,15-36,2-8,2.2-4.2,3-7,3.9-5,4-7,5-9,5.5-15,6.5-9.2,7.5-15.2,abaxially,adaxially,anther,apex,asymmetric,attenuate,base,blade,brownish,cell,chartaceous,cm,condition,corolla,dark,deep,diameter,drying,filament,flower,forked,fresh,fruit,glabrous,globose,green,greenish,hair-like,herb,homostylous,interjected,lanceolate,lateral,leaf,leaflet,medium,mm,moniliform,mottled,odd-pinnate,ovate,ovate-lanceolate,ovoid,pair,pedicel,pentagonal,petiole,petiolulate,plant,plurifoliate,pore,poricidal,purple,ripe,rotate,rounded,seed,size,slightly,sometimes,spot,symmetric,terminal,tip,tissue,tri-,tuber,unit,unwinged,usually,white,whitish,x	1-1.6,1-1.7,1-5,1.3-8.7,17-42,2-3,2-6,3-10,3-5,3.3-4.4,5-merou,abaxiall,acumen,acuminate,acute,ag,along,alyx,apart,apparently,arranged,articulated,axe,axillary,basiscopic,bead,berry,bud,capitat,clavate,connivent,covering,decreasing,digestion,distal,dorsally,eaf,edge,eed,enzyme,erec,exceeding,flat,folded,geminat,generally,glabrou,green-white,half,honeycomb-shaped,larger,lengthening,like,linear,living,lobe,long,lower,make,middl,mucilaginous,multiple,necklace,nflorescence,orbicular,orolla,peduncle,perfect,removed,ruit,second,sessile,seudostipule,side,slit,spaced,specimen,stamen,stigma,stolon,straight,style,subequal,subtending,tall,tamen,tem,testal,thick,throughout,toward,tube,typically,vary,wall,wet,yellow,ympodial	5-merous,arrangement,articulation,bract,branching,breeding,calyx,colour,connective,form,growth,hair,height,heteromorphism,inflorescence,insertion,interpetalar,length,margin,marking,mature,middle,modification,na,number,odour,orientation,pattern,placement,position,prickle,pseudostipule,scale,shape,staman,stem,stone,structure,symmetry,sympodial,system,texture,type	0-19,0.2-1,1-2,1-3,1.4-1.6,15-36,2-8,2.2-4.2,3-7,3.9-5,4-7,5-9,5.5-15,6.5-9.2,7.5-15.2,abaxially,adaxially,asymmetric,attenuate,brownish,chartaceous,cm,condition,dark,deep,drying,forked,fresh,glabrous,globose,green,greenish,hair-like,herb,homostylous,lanceolate,medium,mm,moniliform,mottled,odd-pinnate,ovate,ovate-lanceolate,ovoid,pentagonal,petiolulate,plurifoliate,poricidal,purple,ripe,rotate,rounded,slightly,sometimes,spot,symmetric,terminal,tip,tri-,unwinged,usually,white,whitish,x	5-merous,middle,na
240	wfo-0001028547	success	221	126	64	80	141	46	62	2	.7,/5,1-2.5,10-12,2-4,anther,apex,articulated,base,berry,branched,branching,bright,calyx,cell,chartaceous,cm,conical,connivent,cream,cuneate,curved,deltate,discolorous,drying,elongating,entire,equal,erect,filament,flattened,fruit,fruiting,glabrous,green,inflorescence,lateral,leaf,length,lobed,long,lower,margin,marking,mature,maturity,mauve,mm,moderately,orange,pale,pedicel,perfect,petiole,poricidal,porrect,prickle,purple,red,reflexed,shallowly,shrub,simple,sometimes,somewhat,spherical,stellate,stellate-pubescent,stem,straight,subsessile,surface,tapering,terminal,tip,trichome,truncate,unit,way,young	-3,.2,.5,.8,/2,0,0-1,0-10,0-15,0-2,0-30,0-5,0.05-0.15,0.1-0.2,0.15,0.2-0.35,0.3-0.4,0.5-1.5-2.5-3,0.7-1,0.8-1,1-2,1-4,1-5,1.2-1.4,1.5-2.5,1.7-2,1/3-1/2,1/5-1/4,2-1.5,2-2.5,2-6,2.5-2.8,2.8-3.2,3-5,3.5-4.5-6,4-5,4-6,5-merous,6-8,7-10-13,7-9,abaxial,abaxially,absent,acute,adaxial,alyx,apar,apart,ape,apically,apparently,appearing,bark,blade,bulbous,dark,densely,diameter,distance,dull,eaf,eed,elongate,extending,faint,flattened-reniform,flower,free,gently,glabrescent,glabrou,gray-brow,infructescence,lobe,lon,long-acuminate,long-styled,longer,midpoint,midvein,narrow-deltate,nflorescence,oblong,occasionally,often,older,one,open,orange-brown,orolla,oung,outline,ovate,pair,peduncle,pendulous,per,pericarp,pit,plurifoliat,portion,prickl,prickly,primary,raised,ray,reddish,rounded,ruit,scandent,scar,sessile,short-styled,side,slender,small,smooth,spaced,spreading,stalk,stalked,staminate,style,tamen,terete,tertiary,thin-acuminat,time,tube,usually,vary,vein,venation,villous,wide,woody,yellow,yellow-green,yellow-orange,ympodial	appressed,articulation,bract,breeding,broad-based,colour,connective,corolla,form,growth,hair,heteromorphism,inflated,insertion,interjected,interpetalar,leaflet,modification,na,needle-like,odour,orientation,paired,pattern,placement,plurifoliate,pore,position,pseudostipule,rhizome,scale,shape,smell,spot,staman,stone,structure,symmetry,sympodial,system,texture,tissue,tuber,type,vegetative,xylopodia	.7,/5,1-2.5,10-12,2-4,articulated,base,berry,branched,branching,bright,chartaceous,cm,conical,connivent,cream,cuneate,curved,deltate,discolorous,drying,elongating,entire,equal,erect,flattened,glabrous,green,lateral,leaf,lobed,long,marking,maturity,mauve,mm,moderately,orange,pale,perfect,poricidal,porrect,purple,red,reflexed,shallowly,shrub,simple,sometimes,somewhat,spherical,stellate,stellate-pubescent,stem,straight,subsessile,tapering,terminal,tip,truncate,way,young	na,plurifoliate
241	wfo-0001028587	success	178	94	39	48	130	46	37	2	.5,0.8-1.8,accrescent,acute,anther,apex,base,becoming,berry,calyx,cm,corolla,cup,difoliate,drying,filament,fruit,fruiting,geminate,glabrous,globose,green,greenish-white,leaf,length,lobed,long,mm,nearly,obovate,open,opposite,ovate,pedicel,petiole,pore,poricidal,pubescent,shrub,simple,slit-like,subumbellate,tip,type,uniseriate,unit,upon,white	.4,.75,0,0.3,0.3-1,0.5,0.5-1,0.7-1.2,0.8-1.6,0.8-2.9,1-1.3,1-1.5,1-2,1-4,1.3-5.1,1/4,2-5,2.1-6.9,2.5,3-8,6-8,6.5-17.7,8-10,8-10-flowered,abruptly,across,acuminate,anthesi,bark,baseflower,brown,ca,chartaceou,closely,coat,cracking,deflexed,degree,densely,dia,different,distal,eaf,edicel,eed,ellipsoid,erect,flower,forming,free,geminat,impressed,keeled,lamina,lateral,layer,like,lobe,lon,long-styled,lower,main,major,middle,midrib,minor,minute,minutely,narrowing,nflorescence,obe,obovoid,occasionally,often,older,outer,ovary,overlappin,ovoid-reniform,pair,paler,papillo,papillose,peeling,per,persistent,pitted,portion,puberulent,pubescence,pubesent,reflexed,ruit,scar,scattered,seed,short,slender,slightly,spaced,sparsely,stem,stiff,stigma,straight,straw-colored,style,surface,tall,terminal,thickened,thin,transversel,triangular,trichome,tube,two,ud,umbonate,unicellular,upper,usually,variable,vein,wide,widest,woody,x,ympodial,young	appressed,articulation,bract,branching,breeding,cell,colour,connective,form,growth,hair,heteromorphism,inflated,inflorescence,insertion,interjected,interpetalar,leaflet,margin,marking,mature,modification,na,odour,orientation,paired,pattern,placement,position,prickle,pseudostipule,rhizome,scale,shape,spot,staman,stone,structure,symmetry,sympodial,system,texture,tissue,tuber,xylopodia,zygomorphy	.5,0.8-1.8,accrescent,acute,base,becoming,berry,cm,cup,difoliate,drying,fruit,geminate,glabrous,globose,green,greenish-white,leaf,lobed,long,mm,nearly,obovate,open,opposite,ovate,pore,poricidal,pubescent,shrub,simple,slit-like,subumbellate,tip,uniseriate,upon,white	na,zygomorphy
242	wfo-0001028594	success	142	143	66	86	56	57	61	5	.5,0-100,0.8-1.8,1-1.2,1-1.3,1-1.5,1-2,1.5-9,12,12-14,2,3-4,3-9,6-20,abaxially,acuminate,acute,anther,apex,axillary,base,becoming,black,bottle-shaped,calyx,cell,cm,conical,corolla,densely,diameter,drying,ellipsoid,elliptic,epidermal,especially,exserted,filament,flattened-reniform,fruit,fruiting,glabrous,globose,green,hair-like,herb,immature,inflorescence,leaf,length,long,lower,margin,maturity,minute,minutely,mm,orange-brown,ovary,ovate,pedicel,per,petiole,planar,projection,pubescent,purple,rectangular,reddish,reflexed,regular,rounded,simple,slightly,smooth,somewhat,sparsely,stigma,strongly,style,surface,trichome,tube,unit,violet,x	0.3-1.0,1-3,3-6,5-6,6-7,adaxially,along,anthesi,axil,bearing,berry,capitat,climbing,denser,eaf,edicel,eed,floo,flower,forest,free,glabrat,inflorescenc,lax,like,lobe,lon,nflorescence,noddin,obtuse,often,open,pair,papillate,pendent,portion,primary,quit,rest,ruit,scar,scattered,side,soft,spreading,strait,tem,time,tip,trailing,tub,ud,unifoliat,uniseriate,vein,ympodial	arrangement,articulation,bract,branching,breeding,broad-based,bud,capitate,colour,connective,exsertion,form,growth,hair,height,heteromorphism,insertion,interjected,interpetalar,leaflet,marking,modification,na,needle-like,nodding,number,odour,orientation,pattern,placement,plant,pore,position,prickle,pseudostipule,rhizome,scale,seed,shape,size,smell,spot,staman,stem,stone,straith,structure,symmetry,sympodial,system,texture,tissue,tuber,type,unifoliate,vegetative,xylopodia	.5,0-100,0.8-1.8,1-1.2,1-1.3,1-1.5,1-2,1.5-9,12,12-14,2,3-4,3-9,6-20,abaxially,acuminate,acute,axillary,becoming,black,bottle-shaped,cm,conical,densely,drying,ellipsoid,elliptic,especially,exserted,flattened-reniform,glabrous,globose,green,hair-like,herb,immature,long,margin,maturity,minute,minutely,mm,orange-brown,ovate,planar,projection,pubescent,purple,rectangular,reddish,reflexed,regular,rounded,simple,slightly,smooth,somewhat,sparsely,strongly,violet,x	capitate,na,nodding,straith,unifoliate
243	wfo-0001028660	success	204	154	73	98	106	56	70	3	0.2-1.1,0.5-2.8,0.5-5.5,0.9-2.5,1-2,1.5-2.8,1.5-4,1.5-7.6,2-11,2-5,2-6,2-9,3-30,3.8-13,4-6,5-8,6,7-10,abaxially,absent,adaxially,anther,apex,axillary,base,berry,blade,blue,broadly,brownish,bud,cell,chartaceous,cm,condition,corolla,decurrent,densely,diameter,distal,drying,entirely,filament,flower,forked,fresh,fruit,glabrous,globose,green,greenish,hair,herb,homostylous,interjected,lanceolate,lateral,leaflet,long,lower,margin,membranous,mm,oblique,odd-pinnate,ovoid,pair,pedicel,peduncle,pentagonal,petiole,plant,plurifoliate,pore,poricidal,pubescent,purple,rarely,ripe,rotate,seed,size,sparsely,stem,style,substellate,subtending,terminal,tinged,tip,tri-,tuber,typically,unit,unwinged,white,whitish,x	0-5,0.1-0.3,0.3-1.1,0.7-4.2,0.8-1,1-10,20,3-5,3-7,3-9,5-merou,acumen,acute,ag,along,alyx,apart,apparently,articulated,attenuate,axe,borne,capitat,ciliate,clavate,connivent,covering,decumbent,digestion,dorsally,dot,eaf,edge,eed,elliptic,end,enzyme,erec,especially,exceeding,except,flat,folded,geminat,generally,glabrou,greatly,green-white,hair-like,half,honeycomb-shaped,lengthening,less,like,linear,living,lobe,make,middl,midrib,minutely,mucilaginous,narrowly,nflorescence,obtuse,often,orbicular,orolla,ovate,perfect,petiolulate,petiolule,proximal,puberulent,reduced,removed,ruit,scabrous,scattered,sessile,seudostipule,short,singly,slit,spaced,specimen,stamen,ste,stigma,stolo,straight,subequal,sunny,tall,tamen,tem,testal,thick,throughout,tube,usually,vary,wall,wet,yellow,ympodial	appressed,arrangement,articulation,bract,branching,breeding,broad-based,calyx,colour,connective,form,fruiting,growth,height,heteromorphism,inflated,inflorescence,insertion,interpetalar,leaf,length,marking,mature,middle,modification,na,needle-like,odour,orientation,ovary,paired,pattern,placement,position,presence,present,prickle,pseudostipule,rhizome,scale,shape,smell,spot,staman,stone,structure,surface,symmetry,sympodial,system,texture,tissue,trichome,type,vegetative,xylopodia	0.2-1.1,0.5-2.8,0.5-5.5,0.9-2.5,1-2,1.5-2.8,1.5-4,1.5-7.6,2-11,2-5,2-6,2-9,3-30,3.8-13,4-6,5-8,6,7-10,abaxially,absent,adaxially,axillary,berry,blue,broadly,brownish,bud,chartaceous,cm,condition,decurrent,densely,distal,drying,entirely,forked,fresh,glabrous,globose,green,greenish,herb,homostylous,lanceolate,long,membranous,mm,oblique,odd-pinnate,ovoid,pentagonal,plurifoliate,poricidal,pubescent,purple,rarely,ripe,rotate,sparsely,substellate,subtending,terminal,tinged,tip,tri-,typically,unwinged,white,whitish,x	middle,na,present
244	wfo-0001028667	success	128	111	75	81	47	30	68	7	.5,0.4-0.7-2.6,0.7-4,1-1.5,1-2-1.5,1-6,3,5,5-20,8-10,acute,apex,articulated,axillary,base,berry,branch,branched,cell,clustered,cm,completely,coriaceous,creamy,diameter,discolorous,dry,elliptic,entire,exfoliating,flattened,flower,fruiting,glabrous,growth,inflorescence,irregularly,leaf,like,lower,margin,minutely,mm,narrowly,new,occasionally,other,outer,pale,pedicel,peduncle,per,petiole,pitted,reniform,revolute,scar,shiny,shoot,short,simple,sleeve,slender,slightly,small,spaced,stem,straw-colored,strongly,surface,terminal,tip,twice,unit,vein,vine,white,woody,wrinkling,x,yellow	1-4.5,1.3-2,3-11,5-merou,aid,alyx,anthesi,apar,appearing,ark,around,calyx,climbin,climbing,conical,corolla,curling,deciduous,eaf,eed,ellipsoid,exfoliatin,exserted,fide,fragrant,lobe,long,mentz,midrib,nflorescence,older,orolla,papilla,papillat,pendan,perfect,plurifoliat,primary,soon,support,tem,triangular,tube,twining,ud,visible,ympodial	apart,arrangement,articulation,bark,branching,broad-based,colour,discoloration,exfoliation,form,hair,insertion,length,needle-like,number,orientation,papillae,pendant,placement,plurifoliate,position,present,prickle,seed,shape,size,structure,sympodial,texture,type	.5,0.4-0.7-2.6,0.7-4,1-1.5,1-2-1.5,1-6,3,5,5-20,8-10,acute,apex,articulated,axillary,base,branch,branched,cell,clustered,cm,completely,coriaceous,creamy,diameter,discolorous,dry,elliptic,entire,exfoliating,flattened,glabrous,inflorescence,irregularly,leaf,like,lower,minutely,mm,narrowly,occasionally,other,outer,pale,pitted,reniform,revolute,shiny,shoot,short,simple,sleeve,slender,slightly,small,spaced,stem,straw-colored,strongly,surface,terminal,tip,twice,vine,white,woody,wrinkling,x,yellow	apart,broad-based,needle-like,pendant,plurifoliate,present,prickle
245	wfo-0001028688	success	137	109	53	65	72	44	51	2	.5,0.4-1,0.5-1,0.9-1,1-3,1-5,1.1-1.2,1.4-2.8,2-3,5-11,5-6,across,acuminate,acute,anther,anthesi,apex,area,base,calyx,clavate,cm,corolla,deflexed,difoliate,filament,furcate,glabrous,golden,lanceolate,leaf,lobed,lower,mm,near,nearly,occasionally,opposite,ovary,overtopping,papillose,pedicel,petiole,pilose,pore,poricidal,shaped,shoot,shrub,size,slender,stem,stigma,straight,style,tapering,tear-drop,tip,trichome,tube,uniseriate,unit,usually,white,x	0.5,0.5-0.75,0.5-1.5,1-1.5,1-1.8,2.2-4.8,along,apar,bark,beneath,bi-cellular,branch,curl-tipped,deciduous,decreasing,deltoid,densely,densest,dia,differing,eaf,edicel,eed,elliptic,exfoliatin,exserted,free,geminat,globose,interpetalar,irregularly,know,known,like,lobe,lon,long,major,markedly,membraneous,middle,minor,minutely,nflorescence,often,older,paler,planar,portion,proximal,pubescent,reddish-brown,ruit,scar,shiny,sinus,slightly,soon,spaced,sparsely,styl,tall,terminal,thickened,thin,tub,ud,vein,wide,widest,ympodial,young	abaxial,adaxial,branching,breeding,broad-based,cell,colour,deflexion,form,fruit,fruiting,geminate,growth,hair,height,heteromorphism,inflorescence,leaflet,length,marking,modification,na,needle-like,orientation,placement,plant,position,prickle,pseudostipule,rhizome,shape,spot,staman,stone,structure,surface,symmetry,sympodial,system,texture,tuber,type,xylopodia,zygomorphy	.5,0.4-1,0.5-1,0.9-1,1-3,1-5,1.1-1.2,1.4-2.8,2-3,5-11,5-6,across,acuminate,acute,area,base,calyx,clavate,cm,deflexed,difoliate,furcate,glabrous,golden,lanceolate,leaf,lobed,mm,near,nearly,occasionally,opposite,overtopping,papillose,pilose,poricidal,shaped,shoot,shrub,slender,straight,style,tapering,tear-drop,tip,trichome,tube,uniseriate,usually,white,x	geminate,na
246	wfo-0001028698	success	166	122	64	65	101	57	52	12	1-4,2-10,5-15,5-6,apex,apical,apically,articulate,base,branched,calyx,cell,cm,conical,connate,corolla,dark,dehiscent,dichasially,distal,dot,ellipsoid,filament,green,green-white,hair-like,half,herbaceous,interjected,introrse,leaf,leaflet,light,long,lower,maturing,medium,mm,oblique,odd-pinnate,often,ovoid,pattern,pedicel,pentagonal,perennial,perfect,petiole,plant,poricidally,proximal,puberulent,pubescent,raised,rotate,seed,short,slit,strigose,throughout,tuber-bearing,unit,violet,white,¼	0-1.,0.3-0.75,1-2,1-9.8,1.8-5,1.9-4,13-25,2-3,2-4,3-17,3-5,3-6-foliat,3.5,4-14,5-8,6,6-13,6-27,8-10,9-35,abaxiall,abaxially,acumen,acuminate,acute,adaxially,broadly,commonly,covering,cuneate,cyme,darker,decurrent,diameter,dichasial,digestion,diminishing,dorsally,eaf,ebracteate,edge,eed,elliptical,emoval,enzyme,equal,exceeding,first,flat,flower,folded,forked,generally,globo,gradually,honeycomb,lateral,living,lobe,lon,long-attenuate,lunat,make,minute,monochasial,mucilaginous,nflorescence,nther,orolla,ovate,pair,peduncle,petiolule,plan,rachi,rarely,reveal,ruit,sessile,seudostipule,size,smooth,specimen,stamen,stigma,straight,style,tal,tem,terminal,testal,thick,toward,two,typically,usually,vary,wall,wide,yellow,ympodial	0-10,3-6-foliate,anther,appressed,articulation,bract,branching,breeding,broad-based,colour,connective,form,fruit,fruiting,growth,hair,heteromorphism,inflated,inflorescence,insertion,interpetalar,length,lunate,margin,marking,mature,modification,na,needle-like,odour,orientation,paired,placement,pore,position,prickle,pseudostipule,rhizome,scale,shape,spot,staman,stellate,stem,stone,structure,surface,symmetry,sympodial,system,texture,tissue,tuber,type,xylopodia,ye,zygomorphy	1-4,2-10,5-15,5-6,apical,apically,articulate,branched,cm,conical,connate,dark,dehiscent,dichasially,distal,dot,ellipsoid,green,green-white,hair-like,half,herbaceous,introrse,leaf,light,long,lower,maturing,medium,mm,oblique,odd-pinnate,often,ovoid,pentagonal,perennial,perfect,plant,poricidally,proximal,puberulent,pubescent,raised,rotate,short,slit,strigose,throughout,tuber-bearing,violet,white,¼	0-10,3-6-foliate,broad-based,lunate,na,needle-like,prickle,stellate,stem,surface,ye,zygomorphy
247	wfo-0001028716	success	145	158	92	106	39	52	87	5	.2,.5,0.5,0.6-1.9,0.75,1-2,1.9-5.5,10-40-flowered,11-16.4,2-4,2.2-7.9,2.5-8,3.6-8.8,8-9,9-10,acuminate,anther,anthesi,apart,apex,appearing,bark,base,beginning,beneath,bi-cellular,branched,brown,calyx,cm,corolla,cuneate,dark,decurrent,difoliate,ellipsoid,elliptic,evenly,except,filament,fruit,geminate,glabrous,glandular,hirsute,lateral,leaf,less,like,lobe,lobed,long,long-triangular,main,major,middle,minor,minutely,mm,nearly,node,often,older,opposite,orbicular,ovary,ovate,pair,papillose,pedicel,petiole,pointed,pore,prominent,proximal,puberulent,pubescent,raised,reflexed,rounded,scar,shape,shaped,shrub,simple,size,slightly,spaced,sparsely,stem,straight,strongly,style,tear-drop,tip,trichome,truncate,tube,uniseriate,unit,vein,white,widening,widest,x,young	5-6,7-8,across,anisophyllou,asymmetric,ba,becoming,deflexed,dia,differing,eaf,edicel,eed,fertilization,fifth,filiform,free,inflorescenc,intermediate,know,known,lengthening,lenticellat,lon,lower,markedly,much,nflorescence,one,poricidal,portion,remaining,ruit,stigm,tall,triangular,two,ud,ympodial	anisophyllous,articulation,bract,branching,breeding,bud,cell,colour,diameter,flower,form,growth,hair,height,heteromorphism,inflorescence,insertion,interjected,interpetalar,leaflet,length,lenticellate,marking,modification,na,number,odour,orientation,pattern,placement,plant,position,prickle,pseudostipule,rhizome,scale,seed,spacing,spot,staman,stigma,stone,structure,symmetry,sympodial,system,texture,tissue,tuber,type,unknown,xylopodia	.2,.5,0.5,0.6-1.9,0.75,1-2,1.9-5.5,10-40-flowered,11-16.4,2-4,2.2-7.9,2.5-8,3.6-8.8,8-9,9-10,acuminate,anthesi,apart,appearing,base,beginning,beneath,bi-cellular,branched,brown,calyx,cm,cuneate,dark,decurrent,difoliate,ellipsoid,elliptic,evenly,except,geminate,glabrous,glandular,hirsute,lateral,leaf,less,like,lobe,lobed,long,long-triangular,main,middle,minutely,mm,nearly,node,often,opposite,orbicular,ovate,pair,papillose,petiole,pointed,prominent,proximal,puberulent,pubescent,raised,reflexed,rounded,shaped,shrub,simple,slightly,spaced,sparsely,stem,straight,strongly,tear-drop,trichome,truncate,uniseriate,vein,white,widening,widest,x,young	anisophyllous,inflorescence,lenticellate,na,stigma
248	wfo-0001028723	success	211	180	110	123	88	57	104	6	-1.5,0-0.5,0.2,0.8-1,0°,1,1-1.8,1-2.2,1-2.5,1/3-1/2,1/5-1/3,10-15,2-2.5,2-2.7,2-4,3-4,3.5-4,4-5,5,5-6,5-7,abaxial,abaxially,acute,adaxially,almost,anther,anthesi,apex,apically,apparently,bark,base,brachyblast,branch,branched,branching,broadly,brown,calyx,capitate,clustered,cm,common,conical,corolla,dark,decurrent,dendritic,developed,diameter,dilated,domatia,drying,elliptic,entire,except,faint,filament,fine,flat,flexuous,flower,glabrous,green,junction,leaf,length,less,liana,lobed,long,long-attenuate,longitudinally,main,margin,membranous,midvein,minutely,mm,mostly,obconical,oblong,obovate,occasional,orange-brown,pair,pedicel,peduncle,petiole,poorly,pore,poricidal,primary,pubescent,raised,ray,ridged,short,shrub,side,simple,slender,smooth,sparsely,stem,stigma,style,surface,terminal,tertiary,tip,trichome,unarmed,unevenly,unit,vein,venation,white,widely,wrinkled,x,youngest	.3,.5,0.8-2,1-1.5,10-16,2.5,4,age,alternate,alyx,another,apar,apice,articulated,becoming,clearly,concolorous,curved,delineated,deltoid,densely,density,divided,dorsifixed,eaf,eed,ellipsoi,equal,ey,formed,free,frequent,gradual,increasing,inner,know,known,lengthening,like,lobe,lower,m.,middle,much,multiply,naked,narrowly,nflorescence,nther,obtuse,one,orolla,outer,ovate,overlapping,pale,papillo,perfec,plurifoliat,portion,prominent,protruding,rachi,region,regular,ruit,scar,separated,sinus,small,smaller,spreading,stump,surrounding,tearing,tissu,toward,transition,tube,tuft,ud,uneven,vary,visible,wide,yellow,ympodial,young	angle,arrangement,articulation,bract,bud,cell,colour,connective,division,ellipsoid,form,fruit,growth,habit,hair,heteromorphism,inflorescence,insertion,interjected,interpetalar,leaflet,marking,modification,na,number,odour,orientation,ovary,paired,papillose,pattern,perfect,placement,plant,plurifoliate,position,presence,prickle,protrusion,pseudostipule,rhizome,scale,seed,shape,size,spot,staman,stellate,stone,structure,symmetry,sympodial,texture,tissue,tuber,type,xylopodia	-1.5,0-0.5,0.2,0.8-1,0°,1,1-1.8,1-2.2,1-2.5,1/3-1/2,1/5-1/3,10-15,2-2.5,2-2.7,2-4,3-4,3.5-4,4-5,5,5-6,5-7,abaxial,abaxially,acute,adaxially,almost,anther,anthesi,apex,apically,apparently,base,brachyblast,branch,branched,broadly,brown,capitate,clustered,cm,common,conical,corolla,dark,decurrent,dendritic,developed,dilated,drying,elliptic,entire,except,faint,fine,flat,flexuous,glabrous,green,junction,leaf,length,less,liana,lobed,long,long-attenuate,longitudinally,membranous,midvein,minutely,mm,mostly,obconical,oblong,obovate,occasional,orange-brown,pair,poorly,poricidal,primary,pubescent,raised,ray,ridged,short,shrub,side,simple,slender,smooth,sparsely,stem,terminal,tip,trichome,unarmed,unevenly,vein,white,widely,wrinkled,x,youngest	ellipsoid,na,papillose,perfect,plurifoliate,stellate
249	wfo-0001028736	success	180	166	122	129	51	37	116	6	0.2-0.4,0.5-1.5,0.5-1mm,0.5-2,1,1-2,1-3,1/6,10-15,2-4,2-5,3-6,3-8,3.5-5,4-12,4-6,40-70,5-10,6-8,abaxially,absent,acute,adaxially,anther,apex,apical,apparently,armed,attenuate,base,berry,brown,chartaceous,cm,connivent,cordate,created,cut,cylindrical,dark,decurrent,densely,diameter,difoliate,directed,either,extra-axillary,filament,flattened,flower,fruit,geminate,glabrous,glandular,globose,green,hair,immature,leaf,length,less,light,like,lobe,lobed,long,lower,major,many,mature,midpoint,midvein,mm,moderately,mottled,multicellular,multiseriate,nearly,netlike,obtuse,occasionally,onto,orange,pair,pedicel,per,perfect,petiole,pit,pore,porrect-stellate,prickle,pubescent,purple,raised,ray,recurved,red,reniform,rhombic,ridge,roselike,shrub,side,simple,sinus,small,sparsely,stalk,stellate,stem,stigma,style,surface,tapering,thin-skinned,unarmed,unbranched,unicellular,uniseriate,unit,unlobed,vein,way,white,wide,x,yellow,yellow-white	0.5,0.5-1,1-1.5,1.5,1.5-3,2-7,3-5,4-9,5-15,5-merou,6-13x3-8,accrescent,adaxiall,alyx,apar,axe,beyond,blade,calyx,contiguous,discolorous,eaf,eed,exserted,filiform,frui,fruiting,glabrou,gree,introsel,m.,midrib,narrowly,nflorescence,occasional,orolla,peduncle,rachi,ruit,scanden,slightly,spaced,stamen,ste,tamen,tem,triangular,tube,unequa,vary,ympodial	5-merous,apart,branching,broad-based,cell,colour,corolla,form,growth,height,heteromorphism,inflorescence,introsely,na,needle-like,number,orientation,ovary,placement,plant,position,present,pseudostipule,pubescence,rhizome,seed,shape,spacing,staman,stone,structure,sympodial,texture,tuber,type,unequal,xylopodia	0.2-0.4,0.5-1.5,0.5-1mm,0.5-2,1,1-2,1-3,1/6,10-15,2-4,2-5,3-6,3-8,3.5-5,4-12,4-6,40-70,5-10,6-8,abaxially,absent,acute,adaxially,apex,apical,apparently,armed,attenuate,base,berry,brown,chartaceous,cm,connivent,cordate,created,cut,cylindrical,dark,decurrent,densely,difoliate,directed,either,extra-axillary,flattened,flower,fruit,geminate,glabrous,glandular,globose,green,hair,immature,leaf,less,light,like,lobe,lobed,long,many,mature,midpoint,midvein,mm,moderately,mottled,multicellular,multiseriate,nearly,netlike,obtuse,occasionally,onto,orange,pair,per,perfect,petiole,pit,pore,porrect-stellate,prickle,pubescent,purple,raised,ray,recurved,red,reniform,rhombic,ridge,roselike,shrub,side,simple,small,sparsely,stellate,stem,surface,tapering,thin-skinned,unarmed,unbranched,unicellular,uniseriate,unlobed,way,white,wide,x,yellow,yellow-white	5-merous,apart,introsely,na,present,unequal
250	wfo-0001028737	success	151	154	85	96	55	58	78	7	0.2-0.5,0.7-2,1,1-2.5,1-4,1-6,1.5-3.5,10,12-14,16-30,2-5,2.8-3.5,3-4,3-5,4-6.5,4-9,5-6,6,7-15,abaxially,adaxially,apex,apical,apically,apiculate,base,branched,calyx,caudate,cell,cm,connate,corolla,covering,cyme,dehiscent,diameter,dichasial,dichasially,distal,ebracteate,elliptic-lanceolate,exceeding,filament,glabrescent,glandular,globose,green,hair-like,half,herbaceous,interjected,introrse,lanceolate,lateral,leaf,leaflet,lobe,long,make,maturing,mm,monochasial,mucilaginous,oblique,oblong,odd-pinnate,often,ovoid,pair,pattern,pedicel,peduncle,perennial,perfect,petiole,plant,poricidally,proximal,seed,short,size,slit,stamen,stellate,stigma,straight,style,terminal,testal,thick,throughout,tuber-bearing,unit,wall,¼	2-3,3-6-foliat,4-10,absen,acumen,acuminate,acute,articulate,attenuate,decurrent,digestion,diminishing,dorsally,eaf,edge,eed,emoval,enzyme,flat,flower,folded,forked,generally,globo,gradually,green-white,honeycomb,larger,living,lon,lower,nflorescence,nther,orolla,pinnatifi,plan,rachi,reveal,ruit,second,sessile,seudostipule,specimen,strongly,tal,tem,throughou,toward,typically,vary,whit,wide,without,yellow,ympodial	3-6-foliate,absent,anther,appressed,arrangement,articulation,bract,branching,breeding,colour,connective,form,fruit,fruiting,growth,hair,height,heteromorphism,inflated,inflorescence,insertion,interpetalar,length,margin,marking,mature,modification,na,odour,orientation,ovary,paired,pinnatifid,placement,pore,position,prickle,pseudostipule,rhizome,scale,shape,spot,staman,stem,stone,structure,symmetry,sympodial,system,texture,tissue,tuber,type,wet,white,width,xylopodia,zygomorphy	0.2-0.5,0.7-2,1,1-2.5,1-4,1-6,1.5-3.5,10,12-14,16-30,2-5,2.8-3.5,3-4,3-5,4-6.5,4-9,5-6,6,7-15,apical,apically,apiculate,branched,caudate,cell,cm,connate,covering,cyme,dehiscent,diameter,dichasial,dichasially,distal,ebracteate,elliptic-lanceolate,exceeding,glabrescent,glandular,globose,green,hair-like,half,herbaceous,introrse,lanceolate,lateral,lobe,long,make,maturing,mm,monochasial,mucilaginous,oblique,oblong,odd-pinnate,often,ovoid,perennial,perfect,plant,poricidally,proximal,seed,short,slit,stamen,stellate,stigma,straight,style,testal,thick,throughout,tuber-bearing,wall,¼	3-6-foliate,absent,na,pinnatifid,wet,white,zygomorphy
251	wfo-0001028777	success	203	175	115	126	77	49	110	5	-10,-3,.5,0-2,0.1-0.2,0.1-0.3,0.2,0.4-0.8,0.5-1.3,0.8-2.2-2.5,1,1-2,1-2.5,1-2.5-4,1-3,1.5-3,1.5-4,1.8-2.5,1/4,1/4-1/2,2.5-5,3.5-5,3/4-4/5,4-5-merous,4.5-8,8-12,acute,anther,apex,apically,articulated,attenuate,base,berry,blade,branched,calyx,chartaceous,cm,concolorous,connivent,dark,deltate,diameter,discolorous,drying,elongating,entire,equal,erect,filament,flower,fruit,fruiting,glabrescent,glabrous,green,green-brown,inflorescence,leaf,length,less,lobe,lobed,long,lower,margin,marking,mature,maturity,mauve,midpoint,mm,moderately,multangulate,obovate,occasionally,one,open,orange,ovate,pale,pedicel,peduncle,perfect,petiole,poricidal,porrect,ray,reflexed,retuse,rounded,scar,sessile,shoot,short,short-styled,shorter,shrub,simple,small,sometimes,spherical,stalked,staminate,stellate,stellate-pubescent,stem,surface,tapering,terete,terminal,time,tip,tree,trichome,truncate,unarmed,unit,usually,variously,way,white,wide,yellow-green,young	-4,.8,.9,0-30,0.6-1,0.7-1.2,0.7-1.3,0.8-1,1.5,2-3,2.5,2.5-3,6-10,7-11,8-15,abaxially,acuminat,alyx,ame,apar,ape,bark,briefly,c.,curved,deciduou,eaf,eed,faint,flattened-reniform,free,glabrescen,infructescence,lengt,long-styled,longer,minute,narrow-deltate,nflorescence,older,orange-brown,orolla,oung,pair,per,pericarp,plurifoliat,portion,present,primary,recurved,red-brown,reflexe,ruit,shorte,smooth,somewhat,soon,spaced,sparsely,spreading,stalk,stout,strongly,style,tamen,tertiary,tube,unarme,vary,vein,venation,visible,whole,wider,woody,ympodial	acuminate,apart,appressed,arming,articulation,branching,breeding,broad-based,cell,colour,connective,corolla,form,growth,hair,height,heteromorphism,inflated,modification,na,needle-like,number,odour,opennes,orientation,placement,plant,plurifoliate,pore,position,prickle,pseudostipule,relative,rhizome,shape,size,spacing,spot,staman,stone,structure,symmetry,sympodial,system,texture,tuber,type,xylopodia,zygomorphy	-10,-3,.5,0-2,0.1-0.2,0.1-0.3,0.2,0.4-0.8,0.5-1.3,0.8-2.2-2.5,1,1-2,1-2.5,1-2.5-4,1-3,1.5-3,1.5-4,1.8-2.5,1/4,1/4-1/2,2.5-5,3.5-5,3/4-4/5,4-5-merous,4.5-8,8-12,acute,apex,apically,articulated,attenuate,base,berry,blade,branched,chartaceous,cm,concolorous,connivent,dark,deltate,discolorous,drying,elongating,entire,equal,erect,flower,fruit,glabrescent,glabrous,green,green-brown,inflorescence,leaf,length,less,lobed,long,marking,mature,maturity,mauve,mm,moderately,multangulate,obovate,occasionally,one,open,orange,ovate,pale,perfect,poricidal,porrect,ray,reflexed,retuse,rounded,sessile,shoot,short,short-styled,shorter,shrub,simple,small,sometimes,spherical,stalked,staminate,stellate,stellate-pubescent,surface,tapering,terete,terminal,time,tip,tree,truncate,unarmed,usually,variously,way,white,wide,yellow-green,young	acuminate,apart,na,plurifoliate,zygomorphy
252	wfo-0001028791	success	252	108	59	75	177	33	58	1	-9,0-6,0.05-0.2,0.4-0.65,1-2-celled,1-3-celled,2-3.5,2-7,2-locular,3-4,4-5+,4-celled,5-plurifoliate,8-10-celled,absent,acuminate,anther,apex,articulation,base,branched,breaking,calyx,cell,cm,conical,corolla,deciduous,deltate,densely,developed,dichotomously,filament,fruit,fruiting,glabrous,glandular,globose,green,head,imparipinnate,interjected,interrupted,leaf,leaflet,liana,long,many,margin,middle,mm,near,oblique,pair,pedicel,per,petiole,poorly,pseudostipule,pubescent,short,simple,somewhat,sparsely,stellate,time,transparent,trichome,truncate,uniseriate,unit,usually,vine,woody,yellow	+,.5,0.05,0.2-0.3,0.2-0.4-0.6,0.2-0.8-1.5,0.25-0.3,0.3-0.4,0.3-0.5,0.3-0.6,0.3-0.8,0.4-0.5,0.4-0.6,0.4-1.1,0.45-0.55,0.5,0.6-0.8,0.6-0.9,0.7-1.5,0.8-1,0.8-1.3,1-1.5,1-2,1-3,1-celled,1.5-2,1.5-2.5-4.5,1.6-4.5,1.7-2.1,1.8-3.3,10,100,2-3,2-7-celled,2.8-3.0,20-to,3-5-10,3-5-22,4-11.5,4-15,5-15,5-9-35,50-80,9-30,abaxially,absen,abundant,acute,adaxially,addition,ag,along,anthesi,apical,appearance,appendage,articulated,basal,basiscopically,beneath,berr,border,broadly,brown,bullate,capitate,clambering,colo.,column,consistently,dark,darker,densest,diameter,eaf,ebracteate,edicel,eed,eglandular,elliptic,elongating,enlarged,entire,even,exserted,extended,flower,free,give,glabrescent,gree,grow,growing,hair-like,half,halfway,internode,lamina,large,lateral,leaving,less,like,lobe,lon,lower,midvein,minutely,mixture,much,multicellular,nflorescence,obovate,occasionally,often,outgrowth,ovary,pale,paler,papillate,peduncle,petiolule,plant,present,primary,protuberance,pubescence,rachi,reflexed,rest,rough,round,ruit,sandpapery,scandent,secondary,seed,sessile,shorter,silky,single,slightly,small,smaller,sometimes,sparse,spreading,stamen,staminal,stem,sterile,stiff,stigma,straight,style,surface,tal,tem,terminal,tertiary,testa,thick,thickened,tip,touch,tube,ud,unicellular,upper,vegetation,vein,wall,white,wide,winged,ympodial,–1-2-celled	bract,branching,colour,form,growth,hair,heteromorphism,inflorescence,insertion,interpetalar,length,marking,na,odour,orientation,paired,placement,position,prickle,rhizome,scale,shape,spot,staman,stone,structure,symmetry,sympodial,texture,tissue,tuber,type,xylopodia	-9,0-6,0.05-0.2,0.4-0.65,1-2-celled,1-3-celled,2-3.5,2-7,2-locular,3-4,4-5+,4-celled,5-plurifoliate,8-10-celled,absent,acuminate,branched,breaking,cm,conical,deciduous,deltate,densely,developed,dichotomously,glabrous,glandular,globose,green,head,imparipinnate,interrupted,leaf,liana,long,many,middle,mm,near,oblique,pair,per,poorly,pubescent,short,simple,somewhat,sparsely,stellate,time,transparent,trichome,truncate,uniseriate,usually,vine,woody,yellow	na
253	wfo-0001028798	success	214	106	53	61	153	45	48	5	0-1,0.9-1.2,1.1-2,1/20,2-3,3.3-5.6,accrescent,acuminate,anther,apex,apical-lateral,attenuate,base,berry,blade,blunt-tipped,branched,calyx,chartaceous,cm,corolla,decurrent,entire,extend,filament,fleshy,fruit,fruiting,growth,hair,introrse,large,leaf,length,less,long,longitudinal,lower,margin,mm,nearly,oblong,obovate,pale,pedicel,petiole,plurifoliate,pore,rotate-stellate,shrub,simple,slightly,slit,somewhat,stem,subcoriaceous,subglobose,time,unit,x,yellow	.5-5,0-60,0.2-0.4,0.5-2,1-3,1-4.5,1-6,1.5-1.8,1/2-2/3,10,15-19,2-3.75,2-6,2-7,2.4-4.4,2.5-3.5,2.6-4,2/3,3-4,3-5,3.8-4.2,4-5.4,5-8,5.25-7.5,6-10,6-8,7-8,8-18,8.5-13,abaxially,acute,adaxially,ag,anthesi,apart,apparently,articulated,axe,axillary,ba,becoming,boat-shaped,branch,bud,capitat,conical,continued,curved,cylindrical,dehiscing,densely,diameter,distal,dm,downward,due,eaf,echinoi,echinoid,eed,exserted,flower,free,glabrous,granular,granular-tomentose,green,greenish,hal,high,included,inserted,irregularly,lacking,lanceolate,lateral,lined,lobe,lobed,m.,main,many,midvein,minutely,mixed,multangulat,multangulate,nflorescence,oblanceolat,oblanceolate,obscured,obtuse,often,orbicular,orolla,oung,ovate-lanceolate,overlapping,peduncle,perfect,persistent,persistently,porrect-stellate,present,probably,prominent,pseudo-terminal,pubescent,quite,rachi,rather,ray,ripe,rough,rough-granular,ruit,semi-ovate,sessile,short,short-stalked,side,small,spaced,sparingly,splitting,stalked,stamen,stellate-pubescent,stigma,strongly,style,subcampanulate,sulcate,suture,tamen,thick,tip,tomentose,tomentu,tomentum,toward,translucent,tube,unarme,unarmed,unknow,vary,vein,velutinous,way,wide,yellowish,ympodial	age,articulation,bract,branching,broad-based,cell,colour,form,heteromorphism,inflorescence,insertion,interjected,interpetalar,leaflet,marking,na,needle-like,none,odour,orientation,paired,placement,position,prickle,pseudostipular,pseudostipule,rhizome,scale,shape,smell,spot,staman,stone,structure,surface,symmetry,sympodial,texture,tissue,trichome,tuber,type,vegetative,xylopodia,zygomorphy	0-1,0.9-1.2,1.1-2,1/20,2-3,3.3-5.6,accrescent,acuminate,apex,apical-lateral,attenuate,base,berry,blade,blunt-tipped,branched,chartaceous,cm,decurrent,entire,extend,fleshy,introrse,large,leaf,length,less,long,longitudinal,mm,nearly,oblong,obovate,pale,petiole,plurifoliate,pore,rotate-stellate,shrub,simple,slightly,slit,somewhat,subcoriaceous,subglobose,time,x,yellow	age,na,none,pseudostipular,zygomorphy
254	wfo-0001028815	success	196	103	38	55	141	48	37	1	1-2,1-4,1-5,2-4,3-5,anther,apex,articulation,base,berry,cell,chartaceous,cm,corolla,cuneate,dark,distal,filament,forked,fruit,glabrous,globose,green,hair,hair-like,half,herb,high,homostylous,interjected,lanceolate,leaflet,lilac-purple,lower,margin,medium,membranous,mm,odd-pinnate,ovoid,pedicel,petiole,plurifoliate,pore,poricidal,purple,red-purple,rotate,rounded,stem,terminal,tinged,tip,tri-,unit	0.4-0.8,0.5-1,1-10,1-3.5,10-15,14-28,2-4.5,2-9,2.5-6.5,22-35,3-4,3-7,4-10,5-6,5-7,5-merou,6-10,6-8,7-16,abaxially,acumen,acute,adaxially,ag,along,alyx,apart,apparently,articulated,auriculate,axe,axillary,basiscopic,blade,broadly,brownish,bud,capitat,ciliate,condition,connivent,covering,decreasing,decurrent,developing,diameter,digestion,distinct,dorsally,drying,eaf,edge,eed,elliptic,elliptic-lanceolate,enzyme,especially,exceeding,flat,flower,folded,fresh,geminat,generally,glabrou,green-white,greenish,hal,honeycomb-shaped,indistinct,lateral,lengthening,like,living,lobe,long,make,midrib,minutely,mucilaginous,narrowly,nflorescence,obtuse,onto,orolla,ovate,pair,papillose,peduncle,perfect,petiolulate,plant,pointed,puberulent,pubescent,purpl,rachi,removed,ripe,rugose,ruit,seed,semi-erec,semi-rosette,sessile,seudostipule,short,side,size,slightly,slit,spaced,sparsely,specimen,splotched,stamen,ste,stigma,straight,style,subtending,tall,tamen,tem,terminated,testal,thick,throughout,triangular-lanceolate,tube,unwinged,usually,vary,wall,wet,whitish,winged,x,yellow,ympodial,young	appressed,bract,branching,broad-based,calyx,colour,connective,form,fruiting,growth,heteromorphism,inflated,inflorescence,insertion,interpetalar,leaf,length,marking,mature,modification,na,needle-like,odour,orientation,paired,placement,position,prickle,pseudostipule,rhizome,scale,shape,smell,spot,staman,stone,structure,surface,symmetry,sympodial,texture,tissue,trichome,tuber,type,vegetative,xylopodia,zygomorphy	1-2,1-4,1-5,2-4,3-5,berry,chartaceous,cm,cuneate,dark,distal,forked,glabrous,globose,green,hair-like,half,herb,high,homostylous,lanceolate,lilac-purple,medium,membranous,mm,odd-pinnate,ovoid,plurifoliate,poricidal,purple,red-purple,rotate,rounded,terminal,tinged,tip,tri-	na
255	wfo-0001028876	success	127	95	49	62	65	33	46	3	.5,/4,0.4-1,0.5-2,1-2,1.5-2,4-5,5-6,abaxial,acute,anther,apex,attenuate,bark,base,branched,brown,calyx,capitate,cm,conical,corolla,dark,dendritic,densely,difoliate,elliptic,filament,glabrous,internodal,leaf,lobed,minutely,mm,occasionally,opposite,ovary,papillose,pedicel,petiole,pore,pubescent,sagittate,shaped,shining,shrub,simple,small,sparsely,stigma,style,subshrub,surface,tear-drop,trichome,tube,type,uniseriate,unit,way,white,x	1.5-3,2-2.3,3-5,3-8,4-8,abaxially,adaxially,along,anthesi,closely,dia,drying,eaf,edicel,eed,ellipsoid,flower,free,geminat,glabrat,golden,hroughout,included,inflorescenc,know,known,lamina,lateral,leave,like,lobe,long,long-triangular,lower,main,middle,midrib,nflorescence,nodding,older,overlappin,pair,papillae,papillo,planar,poricidal,portion,reddish,rest,rounded,ruti,scar,slender,spaced,speciman,stem,straight,tall,tip,tub,ud,vein,widest,ympodial,young	branching,cell,colour,diameter,form,fruit,geminate,glabrate,growth,hair,height,heteromorphism,inflorescence,length,na,odour,orientation,papilla,placement,plant,position,prickle,rhizome,seed,shape,staman,stone,structure,symmetry,sympodial,texture,tuber,xylopodia	.5,/4,0.4-1,0.5-2,1-2,1.5-2,4-5,5-6,acute,apex,attenuate,base,branched,brown,capitate,cm,conical,dark,dendritic,densely,difoliate,elliptic,glabrous,internodal,leaf,lobed,minutely,mm,occasionally,opposite,papillose,pubescent,sagittate,shaped,shining,shrub,simple,small,sparsely,subshrub,tear-drop,trichome,uniseriate,way,white,x	geminate,glabrate,na
256	wfo-0001028883	success	207	125	80	90	117	35	71	9	1,2,50,6,absent,accrescent,acuminate,almost,anther,antrorse,apex,articulated,attenuate,base,berry,brochidodromous,calyx,cell,chartaceous,ciliate,circular,cm,completely,concolorous,connivent,coriaceous,curved,cyme,dark,drying,dull,elliptic,elliptic-ovate,entire,exfoliating,filament,flattened,flower,fruit,glabrous,globose,green,growth,herb,lateral,leaf,length,margin,minor,mm,moderately,narrowly,normally,notably,oblong,obtuse,pedicel,peduncle,per,petiole,pore,poricidal,pubescence,pubescent,rachi,rarely,reniform,ripe,rounded,seed,shiny,shrub,similar,simple,size,slightly,small,sparsely,stellate,stem,subopposite,surface,trichome,unbranched,undulate,uniseriate,venation,white,whitish,×	0.3–0.6,0.4–1.2,0.5–2,0.6,1.5–7,1–2,1–6,2–3,2–5,3–5,4,4–6,5,5-merou,6–10,6–12,abaxially,acute,adaxiall,adaxially,along,alyx,antrorsely,apar,arched,ark,ascending,axi,becoming,blade,branch,brow,capitat,capitate,common,cylindrical,decurrent,deltate,densely,diameter,differing,directed,eaf,eed,emarginate,equal,erect,eye,frui,geminate,geniculat,glabrescent,glabrou,glandular,greenish,head,hilum,hollow,impressed,introrsely,less,light,like,lobe,long,longitudinal,lower,lying,membranaceous,midrib,multicellular,naked,new,nflorescence,often,older,onto,opening,orolla,ovate-lanceolate,parallel,pendan,perfect,plurifoliate,present,primarily,prominent,region,ruit,secondary,sessile,shap,single,single-celled,slit,sometimes,spaced,sparse,spreading,stalk,stigma,straight,style,subapical,subsessile,swollen,tall,tamen,tem,unit,vary,vein,visible,wide,woody,yellow,ympodial	0.3-0.6,0.4-1.2,1-2,2-3,2-5,3-5,4-6,6-12,appressed,arrangement,articulation,bark,colour,connective,corolla,form,fruiting,hair,height,heteromorphism,inflated,inflorescence,marking,na,number,orientation,plant,position,shape,spot,staman,stone,symmetry,texture,type	1,2,50,6,absent,accrescent,acuminate,almost,antrorse,articulated,attenuate,base,berry,brochidodromous,cell,chartaceous,ciliate,circular,cm,completely,concolorous,connivent,coriaceous,curved,cyme,dark,drying,dull,elliptic,elliptic-ovate,entire,exfoliating,flattened,flower,fruit,glabrous,globose,green,herb,lateral,leaf,mm,moderately,narrowly,normally,notably,oblong,obtuse,poricidal,pubescent,rarely,reniform,ripe,rounded,shiny,shrub,similar,simple,slightly,small,sparsely,stellate,stem,subopposite,surface,unbranched,undulate,uniseriate,white,whitish,×	0.3-0.6,0.4-1.2,1-2,2-3,2-5,3-5,4-6,6-12,na
257	wfo-0001028885	success	212	101	45	53	159	48	39	6	0.7-2,1-2,3-5,3.5-4.5,acute,anther,apex,attenuate,base,berry,black,branched,calyx,cell,cm,connivent,corolla,ellipsoid,entire,filament,fleshy,fruiting,globose,growth,inflorescence,lateral,leaf,lobed,long,loosely,margin,mm,pedicel,perfect,petiole,poricidal,purple,ripe,scandent,short,shrub,simple,sleeve,slightly,stellate,stem,terminal,time,tip,uniseriate,unit,vine,woody	.5,0.3-0.5-1,0.5-1,0.5-5,1-1.2,1-1.5,1-3,1.5-1.7,1.5-3.5,10-20,2,2-2.5,2-3.5-8.5,2.3-2.5,2.5-3.5,2/3,4-5,5-merou,7-8,7-9,9-11,9-12,?,abaxial,adaxial,adaxially,ag,along,alyx,anthesi,apart,apiculate,apparently,archin,ark,articulated,basal,blackish,branch,broadly,brown,capitate,collapsing,cup-shaped,dark,dark-pigmented,decurrent,deltate,dendriti,densely,diameter,distal,dried,drying,eaf,eed,elliptic,erect,exserted,extending,flower,free,furcate,glabrescent,glabrou,glabrous,glandular,golden,gradually,groove,groupe,height,ilament,immature,inserted,irregularly,known,lamina,lanceolate,leaving,lengthening,less,like,live,lobe,lower,material,midvein,minute,minutely,mostly,multicellular,narrowing,narrowly,new,nflorescence,noddin,nodding,occasionally,often,older,orolla,pair,papillo,part,peduncle,peg,pericarp,pigmentation,plant,plurifoliat,pore,portion,primary,pubescent,quarter,recorded,reddish,retaining,revolute,rhachi,ruit,scar,scattered,shin,shiny,slender,slit,small,smaller,sometimes,spaced,sparsely,spheroidal,spreading,stigma,strongly,style,surface,tangled,tem,thin,third,trichome,tube,twinin,ud,upper,usually,vary,vein,wall,way,weak,weak-walled,wide,winged,ympodial,¾	appressed,articulation,bract,branching,breeding,broad-based,colour,connective,form,fruit,hair,heteromorphism,inflated,insertion,interjected,interpetalar,leaflet,length,marking,mature,modification,na,needle-like,odour,orientation,paired,pattern,placement,plurifoliate,position,present,prickle,pseudostipule,rhizome,scale,shape,spot,staman,stone,structure,symmetry,sympodial,system,texture,tissue,tuber,type,xylopodia	0.7-2,1-2,3-5,3.5-4.5,acute,attenuate,base,berry,black,branched,cm,connivent,ellipsoid,entire,fleshy,globose,lateral,lobed,long,loosely,mm,perfect,poricidal,purple,ripe,scandent,short,shrub,simple,sleeve,slightly,stellate,stem,terminal,time,tip,uniseriate,vine,woody	broad-based,na,needle-like,plurifoliate,present,prickle
258	wfo-0001028888	success	207	203	127	144	63	59	122	5	0-3.5,0-7,0.15-0.5,1-1.5,1-10,1-2,10-25,12.5-25,2-5,2-6,2.3-5,2.3-7,2.5-3.3,3-4,3.6-12.5,4-25,4-7,5-10,5-7,6-11,8-11,8-13.5,abaxially,acumen,adaxially,anther,apart,apex,apparently,axillary,base,berry,blade,broadly,brownish,bud,cell,center,chartaceous,clavate,cm,condition,connivent,corolla,covered,diameter,digestion,distal,dot,drying,elliptic,end,enzyme,except,filament,flower,forked,fresh,fruit,generally,glabrous,glaucous,globose,greatly,green,greenish,hair,half,herb,homostylous,honeycomb-shaped,interjected,lanceolate,lateral,leaflet,lengthening,like,lobe,long,low,lower,margin,membranous,middle,mm,mottled,oblique,odd-pinnate,often,one,orbicular,ovate,ovoid,pair,pedicel,peduncle,pentagonal,perfect,petiole,petiolulate,placed,plant,plurifoliate,pore,poricidal,proximal,pubescent,purple,reduced,removed,ripe,rounded,scattered,seed,sessile,short,size,slightly,slit,sometimes,sparsely,stem,stigma,straight,streak,style,subequal,subglabrous,substellate,subtending,terminal,testal,tip,tri-,tube,tuber,typically,unit,usually,violet,wall,white,whitish,x	0-5,1,1-3,1.5-4,3-5,3.8-8.3,5-merou,acuminate,acute,ag,along,alyx,apiculate,articulated,axe,capitat,central,ciliate,covering,cuneate,dorsally,eaf,edge,eed,erec,especially,exceeding,flat,folded,geminat,glabrou,green-white,hair-like,hal,less,living,make,midrib,minutely,mucilaginous,nflorescence,orolla,petiolule,puberulent,ruit,seudostipule,spaced,specimen,stamen,ste,stolo,tall,tamen,tem,thick,throughout,truncate,unwinged,vary,wet,wing,yellow,ympodial	age,appressed,arrangement,articulation,bract,branching,breeding,broad-based,calyx,capitate,colour,connective,form,fruiting,geminate,glabrousnes,growth,height,heteromorphism,inflated,inflorescence,insertion,interpetalar,leaf,length,marking,mature,modification,na,needle-like,odour,orientation,ovary,paired,pattern,placement,position,prickle,pseudostipule,rhizome,scale,shape,smell,spacing,spot,staman,stolon,stone,structure,surface,symmetry,sympodial,system,texture,tissue,trichome,type,vegetative,xylopodia	0-3.5,0-7,0.15-0.5,1-1.5,1-10,1-2,10-25,12.5-25,2-5,2-6,2.3-5,2.3-7,2.5-3.3,3-4,3.6-12.5,4-25,4-7,5-10,5-7,6-11,8-11,8-13.5,abaxially,adaxially,apart,apparently,axillary,berry,broadly,brownish,bud,center,chartaceous,clavate,cm,condition,connivent,corolla,covered,diameter,digestion,distal,dot,drying,elliptic,end,enzyme,except,flower,forked,fresh,generally,glabrous,glaucous,globose,greatly,green,greenish,hair,half,herb,homostylous,honeycomb-shaped,lanceolate,lateral,lengthening,like,lobe,long,low,membranous,middle,mm,mottled,oblique,odd-pinnate,often,one,orbicular,ovate,ovoid,pair,pentagonal,perfect,petiolulate,placed,plant,plurifoliate,pore,poricidal,proximal,pubescent,purple,reduced,removed,ripe,rounded,scattered,sessile,short,size,slightly,slit,sometimes,sparsely,stem,straight,streak,subequal,subglabrous,substellate,subtending,terminal,tip,tri-,typically,usually,violet,wall,white,whitish,x	age,capitate,geminate,na,stolon
259	wfo-0001028920	invalid_json_followup	152	128	NA	95	57	33	NA	NA	.25,.5,0.2-1,0.5-1,0.8-1.1,1-1.2,1-1.5,1-2.4,1-3,2-2.5,3-3.5,6-6.5,abaxially,acute,adaxially,anther,anthesi,apex,arachnoid-pubescent,area,attenuate,bark,base,berry,brown,brownish,calyx,closely,cm,congested,corolla,dark,decurrent,dendritic,difoliate,ellipsoid,elliptic,erect,exserted,felty,filament,flower,fruiting,glabrous,globose,green,later,leaf,lightly,lobed,long-styled,major,minor,minutely,mm,nearly,obovate,obovoid,occasionally,opposite,ovary,ovoid-reniform,papillose,pedicel,petiole,pitted,pore,poricidal,pubescent,scar,shape,shaped,short-styled,shrub,simple,size,small,spaced,stem,stigma,strongly,style,surface,tear-drop,tip,tree,trichome,tube,tuft,unifoliate,uniseriate,white,winged,x,young	1.5-2,2-7,3-15-flowered,3-4,5-9,6-15,acuminate,arachnoid,axil,ba,broadly,conical,cucullate,deflexed,deltate,dense,densely,dia,differing,eaf,edicel,eed,fleshy,free,geminat,glabrate,gray-brow,lateral,lobe,lon,long,lower,main,middle,nflorescence,older,overlappin,pair,planar,portion,present,pubescence,ruit,somewhat,soon,sparsely,styl,tall,tapering,thick,tub,ud,unit,vein,widest,woody,ympodial	3-15,arrangement,branching,bud,characteristic,colour,connective,diameter,exsertion,form,fruit,geminate,gray-brown,growth,hair,height,inflorescence,length,marking,na,number,overlapping,plant,position,seed,spacing,spot,stellate,symmetry,texture,type,value,zygomorphy	NA	NA
260	wfo-0001028929	success	209	67	38	50	159	17	37	1	.5,.9,0.7-2,5-25,5-6,8-10,acicular,anther,base,berry,branched,calyx,chartaceous,cm,connivent,cuneate,dull,elliptic,elongating,equal,filament,flattened-reniform,fruit,fruiting,inflorescence,lateral,leaf,length,lobed,long,margin,maturity,mm,obovate,orange-brown,pale,per,petiole,poricidal,prickle,red,shrub,spherical,stem,straight,style,tapering,tip,white,yellow	-2,.7,/5,0-1,0-10,0-2,0-20,0-3,0.1,0.15-0.3,0.2-0.3,0.2-0.4,0.2-0.8,0.3-0.6,0.4-0.8,0.5-1.5,0.5-2,0.7-1,0.8-1,1,1-1.1,1-3,1.5-2.4,1/2-2/3,1/4-1/3,2-3,2-4,2-6,2-9,2.2-2.3,2.5-4,2.7-3,2/3-3/4,3-20,3-4,4-6,5-7.5,5-merous,6-8,7-9,abaxial,abaxially,acute,adaxial,alyx,apar,apart,ape,apex,apically,apparently,articulated,bark,blade,cell,concolorous,curved,densely,diameter,difoliate,discolorous,distance,drying,eaf,eed,erect,extending,flower,foliaceous,free,geminat,gently,glabrescent,glabrou,glabrous,gra,hair,infructescence,lobe,lon,long-styled,longer,lower,mature,midpoint,midvein,minute,minutely,narrow-deltate,narrow-ovate,nflorescence,oblong,obtu,obtuse,occasionally,older,one,open,orolla,oung,outline,pair,patch,pedicel,peduncle,pendulous,perfect,pericarp,perpendicular,pit,porrect,portion,prickl,prickly,primary,raised,ray,red-brown,red-green,reticulate,rounded,ruit,scar,sessile,short-styled,side,simple,slender,small,smooth,sometimes,spaced,spreading,stalk,stalked,staminate,stellate,stellate-pubescent,subsessile,surface,tamen,terete,tertiary,time,trichome,tube,unarmed,unit,usually,variously,vary,vein,venation,visible,way,wide,woody,yellow-green,ympodial	branching,colour,corolla,form,growth,heteromorphism,number,orientation,placement,position,seed,shape,staman,symmetry,texture,type,zygomorphy	.5,.9,0.7-2,5-25,5-6,8-10,acicular,berry,branched,chartaceous,cm,connivent,cuneate,dull,elliptic,elongating,equal,flattened-reniform,lateral,lobed,long,maturity,mm,obovate,orange-brown,pale,per,poricidal,red,shrub,spherical,stem,straight,tapering,tip,white,yellow	zygomorphy
261	wfo-0001028963	success	197	96	59	76	121	20	59	0	/2,0-0.4,0.3-0.6,0.3-0.7,0.3-1,0.3-1.5,0.45-0.6,0.6-0.9,0.8-1.8,0.9-1.5,2-2.3,2-4,2-9,2.4-2.8,3-4.5,3.5-4.2,4-10,5-25,anther,base,berry,bright,calyx,chartaceous,cm,connivent,densely,diameter,dull,elongating,evenly,filament,flattened-reniform,flower,free,fruiting,glabrous,gray-green,green,herb,inflorescence,lateral,leaf,length,lobe,lobed,long,maturity,mauve,mm,moderately,orange,pale,pedicel,per,petiole,poricidal,portion,purple,red,shrub,simple,spherical,stellate,stellate-pubescent,stem,style,tapering,terminal,tip,tube,unarmed,unbranched,way,yellow-orange,young	.5,0-2,0.1,0.1-0.2,0.1-0.25,0.15-0.3,0.6-1,1-4,1.5-2,1/,1/4-1/3,1/5,1/6,2-3,2-5,4-8,5-merous,6-10,7-8,abaxially,acute,alyx,apar,ape,apex,apically,apparently,articulated,attenuate,bark,becoming,blade,broad-deltate,brown,cell,concolorous,curved,cuspidat,deltate,difoliate,discolorous,drying,eaf,eed,entire,equal,erect,eye,frui,geminat,glabrescent,gra,herbaceous,infructescence,lanceolate,less,light,long-styled,longer,lower,margin,mature,midpoint,naked,narrow-cuneate,narrow-elliptic,narrowly,nflorescence,obtuse,occasionally,older,one,open,orolla,oung,outline,pair,peduncle,pendulous,perfect,pericarp,pit,porrect,primary,raised,ray,ruit,scar,sessile,short-styled,shorter,slender,slightly,small,smooth,spaced,spreading,stalk,stalked,staminate,straight,subsessile,surface,tamen,terete,tertiary,time,trichome,unarme,unit,upper,usually,variously,vary,vein,venation,visible,wide,winged,woody,ympodial	arming,branching,colour,corolla,form,fruit,growth,hair,height,number,ovary,plant,position,seed,shape,size,staman,texture,type,width	/2,0-0.4,0.3-0.6,0.3-0.7,0.3-1,0.3-1.5,0.45-0.6,0.6-0.9,0.8-1.8,0.9-1.5,2-2.3,2-4,2-9,2.4-2.8,3-4.5,3.5-4.2,4-10,5-25,base,berry,bright,chartaceous,cm,connivent,densely,dull,elongating,evenly,flattened-reniform,glabrous,gray-green,green,herb,lateral,lobed,long,maturity,mauve,mm,moderately,orange,pale,per,poricidal,purple,red,shrub,simple,spherical,stellate,stellate-pubescent,tapering,terminal,tip,unarmed,unbranched,way,yellow-orange,young	
262	wfo-0001028971	success	224	111	55	66	158	45	52	3	.1-0.2,0.2-0.5-0.8,1.5-2.2,2-foliate,3-14,6-8.5,along,anther,apex,articulated,attenuate,base,broad-based,calyx,cm,coarsely,connivent,densely,dentate,directed,elongate-deltoid,essentially,extra-axillary,filament,form,fruit,globose,hair,inflorescence,lateral,leaf,length,linear-lanceolate,long,margin,midrib,minute,mixture,mm,obtuse,often,orange,pedicel,perennial,petiole,pore,prickle,principal,ripe,scattered,sessile,short,similar,simple,spreading-hirsute,stellate,stem,stipitate,thin-textured,trichome,truncate,unbranched,unit,vein,white,x	-1.4,0.1-0.4,0.1-0.5,0.25-0.6,0.25-1.25,0.3-0.6,0.4-0.9,0.4-1.5,0.8-2.5,05-2.5,1-2,1-5,1.5-4,1.75-2.5,1/5-1/2,10-15,15-30,2-5,2.2-3.5,2.5-3.5,2.5-4.5,2.5-5,20-35,3-5,3-6,4-5,4-9,5-10,5-15,5-8,6-16,6-9,7-16,abaxially,acute,acute-,adaxiall,adaxially,also,apart,appearance,appearing,armed,ascending,axe,ba,bearing,becoming,blade,branched,broadly,campanulate,capitat,cauline,close,compressed,cylindrical,delicate,deltoid,diameter,distal,distall,eaf,eed,elongate,entire,erect,farinaceous,felty,felty-pubescent,female-sterile,flower,frequently,geminat,glabrous,grading,growt,inserted,interlobal,invested,lanceolate,largest,later,laterally,least,lenticular,lignescent,like,lobe,lon,longer,longest,lower,major,manifestly,maturit,midpoint,minutely,much,multiseriate,narrowly,nflorescence,numerous,occasionally,one,orolla,other,outline,ovate,ovate-apiculate,ovate-lanceolate,pair,peduncle,per,persistent,pitted,prickly,pubescent,rachi,ray,reduced,reniform-ovate,round-tipped,ruit,sericeous,short-stalked,shorter,side,sinus,smaller,sometimes,spaced,sparse,spreadingly,stalk,ste,stellae,stellate-pubescent,stigma,style,surface,tal,tamen,tan,tem,termination,time,tooth-like,tube,underdeveloped,usually,variable,variously,vary,well-developed,wide,yellow,ympodial	appressed,articulation,bract,branching,breeding,cell,colour,connective,corolla,distally,fruiting,geminate,growth,heteromorphism,inflated,insertion,interjected,interpetalar,leaflet,marking,mature,modification,na,odour,orientation,paired,pattern,placement,position,pseudostipule,rhizome,scale,shape,spot,staman,stone,structure,symmetry,sympodial,system,texture,tissue,tuber,type,xylopodia	.1-0.2,0.2-0.5-0.8,1.5-2.2,2-foliate,3-14,6-8.5,along,articulated,attenuate,base,broad-based,cm,coarsely,connivent,densely,dentate,directed,elongate-deltoid,essentially,extra-axillary,globose,hair,lateral,linear-lanceolate,long,midrib,minute,mixture,mm,obtuse,often,orange,perennial,petiole,principal,ripe,scattered,sessile,short,similar,simple,spreading-hirsute,stellate,stem,stipitate,thin-textured,trichome,truncate,unbranched,vein,white,x	distally,geminate,na
263	wfo-0001028975	success	163	131	64	75	88	56	60	4	.5,0.1-1,1,1-3,1-5,1.5-1.8,3-3.5,6-6.5,8-9,?,acute,along,anther,apex,area,bark,base,broad,brown,calyx,cm,conical,corolla,dark,decurrent,deflexed,densely,denser,elliptic,filament,fruit,fruiting,glabrous,globose,golden,green,leaf,length,lobed,lower,minutely,mm,nearly,once-furcate,opposite,ovary,ovoid-reniform,pedicel,petiole,pitted,pore,pubescent,shaped,shiny,short,shrub,simple,slender,small,sparsely,stem,stigma,style,surface,tapering,tear-drop,tip,tree,trichome,tube,uniseriate,unit,varying,vein,white	.2,0.5-1,1.2-1.5,1.5-2,2.2-6,3-10-flowered,3-6.5,5-ribbed,5.5-10,7.5-15,acuminate,anthesi,apart,appearing,beneath,berry,closely,conically,corky,cup-shaped,dia,differing,difoliate,eaf,edicel,eed,entire,epidermi,equal,erect,exserted,extension,free,geminat,hyaline,immature,large-celled,late,lateral,like,lobe,lon,long,main,mainly,major,margin,member,mere,middle,minor,narrowly,nflorescence,obscured,occasionally,older,one,pair,papillo,poricidal,portion,prominent,pubescenc,raised,reddi,reflexed,remaining,rib,ruit,scar,sinus,size,slightly,somewhat,spaced,straight,strongly,tall,triangular,tub,ud,upper,wide,widest,woody,x,ympodial,young	3-10,abaxial,articulation,bract,branching,breeding,broad-based,bud,cell,colour,connective,density,diameter,flower,form,growth,hair,height,heteromorphism,inflorescence,interjected,interpetalar,leaflet,marking,modification,na,needle-like,number,orientation,papillose,pattern,placement,plant,position,prickle,pseudostipule,pubescence,reddish,rhizome,scale,seed,shape,spot,staman,stone,structure,symmetry,sympodial,system,texture,tissue,tuber,type,width,xylopodia,zygomorphy	.5,0.1-1,1,1-3,1-5,1.5-1.8,3-3.5,6-6.5,8-9,?,acute,along,area,base,broad,brown,calyx,cm,conical,dark,decurrent,deflexed,densely,denser,elliptic,glabrous,globose,golden,green,leaf,length,lobed,minutely,mm,nearly,once-furcate,opposite,ovoid-reniform,petiole,pitted,pubescent,shaped,shiny,short,shrub,simple,slender,small,sparsely,style,tapering,tear-drop,tip,tree,trichome,tube,uniseriate,varying,vein,white	3-10,na,papillose,reddish
264	wfo-0001028980	success	168	140	67	89	79	51	64	3	.5,1.2-1.8,1.2-3,1.5-2,1.5-6,2.5-5,20-25-flowered,3/4,4-5,5-6,6,acuminate,acute,anther,anthesi,apex,bark,base,calyx,capitate,cm,coarsely,corky,corolla,deflexed,densely,difoliate,dry,elliptic,expanded,filament,flattened-reniform,fleshy,fruiting,furcate,glabrous,glandular,globose,green,incrassate,leaf,lobe,lobed,long,margin,material,minor,minutely,mm,opposite,ovary,ovate,ovoid,pedicel,petiole,pitted,planar,pore,pubescent,reddish,reflexed,scar,seed,shaped,sharply,shrub,simple,size,slightly,small,speciman,stem,stigma,style,surface,tall,tear-drop,tree,trichome,tube,type,unit,usually,way,white,woody,x,yellowish,young	.1,.75,/3,0.5-1.5,1-1.2,1.5-1.8,2.5,3-4,5-8,6-8,7-12,along,apart,axil,basal,beginning,beneath,berry,black,broadly,clearly,conical,cucullate,deltoid,dia,differentiated,differing,drying,eaf,edicel,eed,exserted,extending,f,free,frui,geminat,glabrate,impressed,inflorescenc,lamina,lateral,lenticellat,like,lon,lower,m.,main,major,member,middle,nflorescence,occasionally,older,one,pair,pale,paler,papillose,peduncle,pit,poricidal,portion,prominent,ruit,scarious,shining,soon,sparsely,strongly,tapering,thick,ti,tip,ud,uniseriate,vein,widest,ympodial	articulation,bract,branching,breeding,bud,cell,colour,connective,flower,form,fruit,geminate,growth,hair,height,heteromorphism,inflorescence,insertion,interjected,interpetalar,leaflet,length,lenticellate,lobing,marking,modification,na,number,odour,orientation,pattern,placement,plant,position,prickle,pseudostipule,pubescence,rhizome,scale,shape,spot,staman,stone,structure,symmetry,sympodial,system,texture,tissue,tuber,xylopodia	.5,1.2-1.8,1.2-3,1.5-2,1.5-6,2.5-5,20-25-flowered,3/4,4-5,5-6,6,acuminate,acute,anthesi,base,capitate,cm,coarsely,corky,deflexed,densely,difoliate,dry,elliptic,expanded,flattened-reniform,fleshy,furcate,glabrous,glandular,globose,green,incrassate,leaf,lobed,long,material,minutely,mm,opposite,ovate,ovoid,pitted,planar,pubescent,reddish,reflexed,shaped,sharply,shrub,simple,slightly,small,speciman,tall,tear-drop,tree,type,usually,way,white,woody,x,yellowish	geminate,lenticellate,na
265	wfo-0001028984	success	173	158	94	106	67	52	91	3	-3,0.5-1,1-1.7,1-2,1-2-4-6,1-6,1-9,1.2-4,1.5,10-20,2-2.5,2-3,20-40,3-26,4-30,4-6,4-6.3,7-14,abaxially,abruptly,acuminate,acute,adpressed,age,almost,also,apart,apex,apical,articulated,basal,base,broad,broadly,calyx,campanulate,cell,chartaceous,cm,concave,connective,cordate,densely,diameter,dilated,directed,distally,eglandular,ellipsoid-fusiform,entire,forked,fruit,glabrous,gland,globose,greenish,hair,lanceolate,laterally,leaving,lobe,long,margin,mm,moderately,narrowed,obconical,obtuse,often,ovate,ovoid,pale,pedicel,pedicellar,peduncle,petiole,pilose,pore,presence,puberulent,pubescent-pilose,purple,rachi,radiu,rarely,remnant,shrub,simple,small,sparsely,stigma,stone,strongly,style,subcoriaceous,tip,tree,truncate,turning,two,unbranched,unit,unknown,violet,x,yellow	-2,-2.5,-9,1-2.5,12-20,15-35-65,2-16,2-3-10-14,2-3-28,3-6,4-5,4-7,4-foliat,5-10,5-6,8-15,absen,adaxially,aggregate,ape,axe,blade,color,eaf,eed,equalling,especially,exceeding,fleshy,flower,glandular-puberulent,lon,longer,lower,minutely,near,nflorescence,nther,orolla,papillose,perfect,pilo,possibly,present,puberulent-pubescent,pubescent-pilo,ripe,ruit,shorter,slightly,spaced,stamen,swelling,tal,tem,thecae,time,tomento,tomentose,toward,triangular,tube,ud,unknow,vary,wide,ympodial	2-10-14,4-foliate,anther,arrangement,articulation,bract,branching,bud,colour,corolla,filament,form,growth,height,heteromorphism,inflorescence,insertion,interjected,interpetalar,leaf,leaflet,length,marking,mature,modification,na,odour,orientation,ovary,paired,placement,plant,position,prickle,pseudostipule,rhizome,seed,shape,spacing,spot,staman,stem,structure,symmetry,sympodial,texture,theca,tissue,tuber,type,width,xylopodia	-3,0.5-1,1-1.7,1-2,1-2-4-6,1-6,1-9,1.2-4,1.5,10-20,2-2.5,2-3,20-40,3-26,4-30,4-6,4-6.3,7-14,abaxially,abruptly,acuminate,acute,adpressed,age,almost,also,apart,apex,apical,articulated,basal,base,broad,broadly,campanulate,chartaceous,cm,concave,cordate,densely,dilated,directed,distally,eglandular,ellipsoid-fusiform,entire,forked,fruit,glabrous,gland,globose,greenish,hair,lanceolate,laterally,leaving,lobe,long,mm,moderately,narrowed,obconical,obtuse,often,ovate,ovoid,pale,pedicellar,pilose,puberulent,pubescent-pilose,purple,rarely,remnant,shrub,simple,small,sparsely,strongly,style,subcoriaceous,tip,tree,truncate,turning,two,unbranched,unknown,violet,x,yellow	2-10-14,4-foliate,na
266	wfo-0001028997	success	136	135	67	79	57	56	64	3	.5,0.5-0.7,0.5-1.5,1-1.2,1-1.5,2-2.5,3-4,3.3.5,4-10,4-4.5,4-angled,5-6,anther,apex,appearing,area,attenuate,bark,base,berry,branched,broadened,calyx,cm,coriaceous,corolla,difoliate,dry,elliptic,elliptic-obovate,erect,filament,flattened-reniform,fragrant,fruiting,glabrous,globose,green,height,incrassate,later,leaf,lobed,long,many,margin,merely,minutely,mm,mustard,nearly,opposite,ovary,papillose,pedicel,petiole,pitted,pore,poricidal,revolute,scar,shaped,shrub,spaced,stem,stigma,style,surface,tear-drop,terminal,time,tip,trifoliate,unevenly,unknown,white,x,yellow,young	0.5-1,0.8-1.1,2-3.5,20-50-flowered,6-10,6-7,abaxially,acute,adaxially,anthesi,apar,ba,conical,cucullate,deflexed,dia,drying,eaf,edicel,eed,exserted,filiform,free,geminat,glabrou,golden,greenish-brow,lateral,lobe,lon,lower,main,matte,middle,nflorescence,older,pair,pale,partially,pericarp,portion,quadrate,ruit,shiny,specimen,strongly,styl,tan,thick,thickened,tub,tube,ud,vein,widest,woody,ympodia	apart,appressed,arrangement,articulation,bract,branching,breeding,bud,cell,colour,connective,diameter,form,fruit,greenish-brown,growth,hair,heteromorphism,inflated,inflorescence,insertion,interjected,interpetalar,leaflet,length,marking,mature,modification,na,odour,orientation,paired,pattern,placement,plant,position,prickle,pseudostipule,rhizome,scale,seed,shape,size,spot,staman,stone,structure,symmetry,sympodial,system,texture,tissue,tuber,type,unit,xylopodia	.5,0.5-0.7,0.5-1.5,1-1.2,1-1.5,2-2.5,3-4,3.3.5,4-10,4-4.5,4-angled,5-6,apex,appearing,area,attenuate,base,berry,branched,broadened,cm,coriaceous,difoliate,dry,elliptic,elliptic-obovate,erect,flattened-reniform,fragrant,glabrous,globose,green,incrassate,later,leaf,lobed,long,many,margin,merely,minutely,mm,mustard,nearly,opposite,papillose,pitted,poricidal,revolute,shaped,shrub,spaced,style,tear-drop,terminal,time,tip,trifoliate,unevenly,unknown,white,x,yellow,young	apart,greenish-brown,na
267	wfo-0001029003	success	207	181	106	131	76	50	102	4	0-6,0.3-0.5,0.5,1-10,1-2,1-3,1-5,1.2-1.9,1.2-2.5,1.5-2.3,11-32,12.2-30,13-36,2.5-10,3,3-20,3-5,3.5-7.5,4-8,5,5-10.5,5-12.5,7-15.5,7-9,9-14,abaxially,acumen,adaxially,anther,apart,apex,articulated,axillary,base,berry,blade,blue-violet,brownish,bud,cell,chartaceous,cm,condition,conical,corolla,diameter,digestion,distal,drying,elliptic,end,enzyme,filament,flower,forked,fourth,fresh,fruit,glabrous,green,greenish,hair,half,herb,homostylous,honeycomb-shaped,interjected,lanceolate,lateral,leaf,leaflet,lengthening,light,like,lobe,long,margin,medium,membranous,middle,minute,mm,mottled,obtuse,odd-pinnate,one,ovoid,pair,pale,pedicel,peduncle,pentagonal,petiole,pigmentation,placed,plant,plurifoliate,pore,poricidal,proximal,pubescent,purple,rarely,removed,ripe,rotate,rounded,seed,size,slit,sometimes,sparsely,stem,stigma,style,subcapitate,subglabrous,subtending,terminal,testal,tip,tri-,tube,tuber,typically,unit,usually,violet,wall,whitish,x	0.4-3,1,1-2.5,2-6,2.5-7.5,5-merou,absent,acuminate,ag,alyx,apparently,attenuate,axe,capitat,ciliate,connivent,covering,decreasing,dorsally,eaf,edge,eed,elongated,equal,erec,especially,exceeding,flat,folded,geminat,generally,glabrou,gradually,green-white,hair-like,hal,highly,larger,living,lower,make,mucilaginous,nflorescence,orbicular,orolla,ovate,perfect,petiolule,prostrate,ray,ruit,secondary,sessile,seudostipule,slightly,spaced,specimen,stamen,ste,stolo,straight,subequal,symmetrical,tall,tamen,tem,thick,throughout,toward,vary,wet,white,wide,wing,yellow,ympodial	age,arrangement,articulation,bract,branching,breeding,calyx,capitate,colour,connective,form,fruiting,glabrousnes,growth,height,heteromorphism,inflorescence,insertion,interpetalar,length,marking,mature,modification,na,odour,orientation,ovary,paired,pattern,placement,position,prickle,pseudostipule,rhizome,scale,shape,spacing,spot,staman,stolon,stone,structure,symmetry,sympodial,system,texture,tissue,type,width,xylopodia	0-6,0.3-0.5,0.5,1-10,1-2,1-3,1-5,1.2-1.9,1.2-2.5,1.5-2.3,11-32,12.2-30,13-36,2.5-10,3,3-20,3-5,3.5-7.5,4-8,5,5-10.5,5-12.5,7-15.5,7-9,9-14,abaxially,adaxially,apart,articulated,axillary,berry,blue-violet,brownish,bud,chartaceous,cm,condition,conical,digestion,distal,drying,elliptic,end,enzyme,forked,fourth,fresh,glabrous,green,greenish,hair,half,herb,homostylous,honeycomb-shaped,lanceolate,lateral,lengthening,light,like,long,medium,membranous,middle,minute,mm,mottled,obtuse,odd-pinnate,one,ovoid,pale,pentagonal,pigmentation,placed,plurifoliate,pore,poricidal,proximal,pubescent,purple,rarely,removed,ripe,rotate,rounded,slit,sometimes,sparsely,stem,subcapitate,subglabrous,subtending,terminal,tip,tri-,typically,usually,violet,wall,whitish,x	age,capitate,na,stolon
268	wfo-0001029006	success	217	138	75	89	128	49	72	3	-+,0.4-2.5,1-1.5,1-4,2-3,3.5-4,5,adaxial,age,anther,anthesi,apex,articulated,asymmetrical,axi,base,berry,blackish,branched,c.,calyx,cell,chartaceous,cm,connivent,corolla,deeply,ellipsoid,filament,filiform,fruiting,glabrous,globose,groove,growth,inflated,inflorescence,irregular,later,lateral,leaving,lengthening,lobe,lobed,long,loosely,lower,many,margin,membranous,minutely,mm,nodding,oblique,occasionally,often,pale,pedicel,peg,perfect,petiole,pinnatifid,pore,poricidal,puberulent,purple,ripe,rotate-stellate,sagittate,simple,sleeve,slit,small,spreading,stem,surface,terminal,time,tip,trichome,truncate,twining,unit,usually,vine,violet,way,white,x	.5,0.2,0.5,0.5-2,0.5-4,1,1-5,1.2-1.5,1.8-2.2,1/3,10,10-20,2-6,2.5,4-6,5-6,5-merou,50,7-8,7-9,<,>,abaxially,acuminate,acute,adaxiall,ag,along,alyx,apar,area,ark,axil,basal,beyond,bilobed,black,bright,broadest,clavat,conical,deltate,dense,depending,diameter,drying,eaf,eed,elliptic,elongate,entire,exserted,extending,flattened,flower,free,green,growing,ilament,intramarginal,irregularly,keeled,lamina,markedly,midrib,minute,narrowly,nearly,new,nflorescence,obvious,older,one,orolla,pair,papillate,part,peduncle,pendan,pentagonal,per,pericarp,pitted,planar,plurifoliat,portion,primary,puberulen,pubescent,purplish,reaching,reddish,reniform,ruit,scar,shiny,size,smaller,sometimes,somewhat,spaced,sparsely,stigma,strong,strongly,style,sunligh,tan,tem,testal,thin,tiny,tube,tuft,twinin,ud,uniseriate,upper,variable,variously,vary,vein,widest,within,woody,ympodial,young,zig-zag	5-merous,appressed,articulation,bract,branching,breeding,broad-based,colour,form,fruit,hair,heteromorphism,insertion,interjected,interpetalar,leaf,leaflet,length,marking,mature,na,needle-like,odour,orientation,paired,pattern,placement,plurifoliate,position,prickle,pseudostipule,rhizome,scale,shape,smell,spot,staman,stone,structure,symmetry,sympodial,system,texture,tissue,tuber,type,vegetative,xylopodia,zygomorphy	-+,0.4-2.5,1-1.5,1-4,2-3,3.5-4,5,adaxial,age,anthesi,articulated,asymmetrical,axi,base,berry,blackish,branched,c.,chartaceous,cm,connivent,deeply,ellipsoid,filiform,glabrous,globose,groove,inflorescence,irregular,later,lateral,leaving,lengthening,lobe,lobed,long,loosely,many,membranous,minutely,mm,nodding,oblique,occasionally,often,pale,peg,perfect,pinnatifid,poricidal,puberulent,purple,ripe,rotate-stellate,sagittate,simple,sleeve,slit,small,spreading,surface,terminal,time,tip,truncate,twining,usually,vine,violet,way,white,x	5-merous,na,plurifoliate
269	wfo-0001029031	success	211	121	63	78	133	43	62	1	.5-1.2,0.5-1.5,4-5-,accrescent,acuminate,adaxially,angle,anther,apex,articulated,base,becoming,berry,black,bluish,branched,calyx,chartaceous,cm,corolla,cuneate,densely,directed,distally,entire,erect,filament,fleshy,flower,forked,fruit,fruiting,geminate,glabrescent,globose,green,hair,held,immature,large,lateral,leaf,leaf-opposed,length,like,lower,many-foliate,margin,mm,oblong,obtuse,occasionally,paired,pedicel,peltate-stellate,petiole,pore,possibly,pseudoterminal,pubescent,ripening,rounded,shrub,simple,slightly,small,sometimes,somewhat,sparsely,stellate,stem,surface,tree,trichome,unbranched,unit,usually,white	-8,.1-0.3,0-5,0.1-0.5,0.5,0.5-4,0.6-1.2,0.7-1.1,1-1.5,1-2,1-2.5,1-2.6-3.6,1-3,1-5,1-9.4-11.4,1.3-3.3,1.5-2.8,1.5-3.5,1.8-2.7,1.8-4,1/3,10,13.5,2-10.7,2-3,2-3.3,2-5,2.5-5.5,2.5-5.6,20-150,3-10,3-10-12.3,4-7.5,5-17,6-12,6-21,abaxially,absent,acute,adaxiall,ag,apart,apexacute,apparently,around,axe,ba,bilobe,blade,brown,capitate,center,connivent,covering,curved,cylindrical,deltate,denser,diameter,eaf,edge,eed,eglandula,eglandular,elliptic,elliptic-ovate,equal,farinose,flattened,frui,fused,glabrous,impressed,inserted,lanceolate,least,light,lobe,long,longitudinal,major,midpoint,midvein,nearly,nflorescence,opening,orange,orolla,outline,peduncle,peltate,perfect,porrect-stellate,prominent,pubescen,pubescence,rachi,rarely,ray,reniform,rugulose,ruit,sessile,short,short-stalked,side,silvery,slit,smaller,spaced,ste,stellate-pubescent,stigma,straight,strongly,style,suborbicular,subtending,tall,tamen,tem,time,tip,tube,unarme,vary,vein,whitish,wide,x,yellow,yellowish,ympodial	appressed,articulation,bract,branching,broad-based,cell,colour,form,growth,heteromorphism,inflated,inflorescence,insertion,interjected,interpetalar,leaflet,marking,mature,na,needle-like,odour,orientation,placement,position,prickle,pseudostipule,rhizome,scale,shape,smell,spot,staman,stone,structure,symmetry,sympodial,texture,tissue,tuber,type,vegetative,xylopodia,zygomorphy	.5-1.2,0.5-1.5,4-5-,accrescent,acuminate,adaxially,angle,apex,articulated,base,becoming,berry,black,bluish,branched,chartaceous,cm,cuneate,densely,directed,distally,entire,erect,fleshy,flower,forked,fruit,geminate,glabrescent,globose,green,hair,held,immature,large,lateral,leaf-opposed,like,many-foliate,mm,oblong,obtuse,occasionally,peltate-stellate,possibly,pseudoterminal,pubescent,ripening,rounded,shrub,simple,slightly,small,sometimes,somewhat,sparsely,stellate,stem,tree,unbranched,usually,white	na
270	wfo-0001029048	success	162	128	74	81	81	47	71	3	.01,.2,.5,/3,0.5,0.5-1.7,1,anther,anthesi,apex,arching,attenuate,basal,base,beneath,berry,bicellular,calyx,cm,corolla,decurrent,dia,elliptic,except,filament,filiform,fruiting,geminate,glabrous,globose,golden,greenish-white,greenish-yellow,hanging,hispidulous,leaf,less,like,lobe,lobed,long,margin,matte,middle,minute,minutely,mm,node,non-reproductive,obtuse,opposite,pale,pedicel,petiole,planar,pore,poricidal,puberulent,reflexed,ripe,shaped,sharply,shrub,slender,slightly,stem,tapering,tear-drop,thread-like,tip,trichome,tube,uni-,unifoliate,unit,vein,way,widest,winged,x,young	0.5-1,0.8-1,1-2,1-8,1.5-2,11,14,2,25,26,3-4,3-7,3.5-4,4-6,5-8,8-10,9-15,acuminate,angle,another,apar,apparent,bearing,becoming,blade,branch,bright,broadly,conical,eaf,edicel,eed,elongated,expanded,f,flower,free,glabrate,greatly,green,greenish-yello,incrassate,lateral,live,lower,main,midrib,much,nflorescence,obovoid,older,one,ovary,ovoid-reniform,pair,papillo,papillose,parallel,pitted,portion,right,rounded,ruit,scar,small-capitate,somewhat,spaced,specimen,stigma,straight,style,surface,tall,tan,time,translucent,ud,unevenly,widely,ympodial,zig-zag	appressed,articulation,bract,branching,breeding,cell,colour,connective,form,fruit,growth,hair,heteromorphism,inflated,inflorescence,insertion,interjected,interpetalar,leaflet,length,marking,mature,modification,na,odour,orientation,paired,pattern,placement,position,prickle,pseudostipule,rhizome,scale,shape,spot,staman,stone,structure,symmetry,sympodial,system,texture,tissue,tuber,type,xylopodia	.01,.2,.5,/3,0.5,1,anthesi,arching,attenuate,basal,base,beneath,berry,bicellular,calyx,cm,decurrent,elliptic,except,filiform,geminate,glabrous,globose,golden,greenish-white,greenish-yellow,hanging,hispidulous,leaf,less,like,lobe,lobed,long,matte,middle,minute,minutely,mm,node,non-reproductive,obtuse,opposite,pale,petiole,planar,pore,poricidal,puberulent,reflexed,ripe,shaped,sharply,shrub,slender,slightly,stem,tapering,tear-drop,thread-like,tip,trichome,tube,uni-,unifoliate,vein,way,widest,winged,x,young	.5-1.7,di,na
271	wfo-0001029055	success	169	118	75	86	83	32	68	7	0.4-1.5,1-4,1-5,1.8-3.5,14-50,2.2-3,3-10,4-10,4-6,4-7,5-24,5.5-9,6-14,8-9,9-22,apical,apically,base,branched,cm,connate,corolla,cyme,dark,dehiscent,diameter,dichasial,dichasially,diminishing,distal,dorsally,edge,filament,flat,flower,folded,gland,green,green-white,herbaceous,interjected,introrse,lateral,leaf,leaflet,longitudional,maturing,mm,monochasial,mucilaginous,odd-pinnate,often,outline,ovoid,pedicel,peduncle,pentagonal,perennial,perfect,petiole,pilose,plant,poricidally,proximal,pubescent,purple,rotate,seed,short,short-stalked,size,slit,sometimes,stigma,straight,stripe,style,terminal,throughout,toward,triangular,tuber-bearing,type,unit,yellow,¼	1-2.6,1.6-3.5,1.7-2.2,2-1.,2-3,2-4,2.5-8,3,3-6,3-6-foliat,abaxially,acumen,acuminate,acute,adaxially,apex,articulate,attenuate,calyx,cell,cordate,covered,covering,cuneate,decurrent,densely,digestion,eaf,ebracteate,eed,elliptcal,elliptical,emoval,enzyme,exceeding,first,forked,generally,globo,hair,hair-like,half,honeycomb,living,lobe,lon,long,long-attenuate,longer,lower,lunat,make,near,nflorescence,nther,oblique,orolla,ovate,pair,pattern,plan,rarely,reveal,ruit,second,sessile,seudostipule,short-petiolate,specimen,spreading,stamen,tal,tem,testal,thick,time,typically,vary,wall,whit,wide,widest,ympodial	2-11,3-6-foliate,anther,arrangement,articulation,bract,branching,colour,dehiscence,ebbrate,form,fruit,globose,growth,height,inflorescence,length,lunate,mucilage,number,ovary,perfection,presence,pseudostipule,shape,stem,structure,sympodial,texture,wet,white,width	0.4-1.5,1-4,1-5,1.8-3.5,14-50,2.2-3,3-10,4-10,4-6,4-7,5-24,5.5-9,6-14,8-9,9-22,apical,apically,base,branched,cm,connate,cyme,dark,dehiscent,dichasial,dichasially,diminishing,distal,dorsally,flat,folded,gland,green,green-white,herbaceous,introrse,leaf,longitudional,maturing,mm,monochasial,mucilaginous,odd-pinnate,often,outline,ovoid,pentagonal,perennial,perfect,pilose,poricidally,proximal,pubescent,purple,rotate,short,short-stalked,slit,sometimes,straight,stripe,throughout,toward,triangular,tuber-bearing,type,yellow,¼	2-11,3-6-foliate,ebbrate,globose,lunate,wet,white
272	wfo-0001029059	success	199	164	103	114	85	50	96	7	.5,0.1-0.5,0.1-1,0.5-1,1-3,1-4,1-6,1.2-3,1.3-1.7,10-19,3-6.5,3.5-6,3.5-8,4-10.5,6-10,acute,along,anther,anthesi,apex,apiculae,apiculate,arising,base,berry,branched,bud,calyx,closely,cm,cordate,corolla,covered,cuneate,deflexed,deltoid,dense,densely,dia,difoliate,dirty,ellipsoid,elliptic,exserted,extremely,fruiting,geminate,glabrous,globose,hispidulous,inflorescence,interpetalar,lateral,leaf,lobe,lobed,long,major,margin,member,membranous,minor,minute,minutely,mm,nearly,oblique,occasionally,often,opposite,orbiculate,pair,pedicel,petiole,planar,pointed,pore,poricidal,pubescence,pubescent,purplish,rest,ripe,rounded,scar,shallowly,shape,shaped,shrub,simple,size,slender,small,somewhat,soon,spaced,sparse,tapering,tear-drop,tinge,tip,tree,trichome,tube,uniseriate,unit,variable,vein,waxy,white,woody,x,yellowish-green,young	0.2,0.2-0.5,0.5,1-1.2,1-1.5,1.5-2,1.5-2.8,2.5,3-3.5,5,5-15-flowered,7-9,anisophyllou,apar,ape,bark,beneath,bout,clavate,coiba,connivent,de,deep,differing,eaf,edicel,eed,expanded,extending,filament,flattened-reniform,foetid,free,glabrate,greatly,impressed,incrassate,isla,lamina,lon,longest,lower,main,middle,narrowly,nflorescence,older,one,orange,orangish-yellow,ovary,pale,paler,panama,papillo,papillose,partially,pitted,population,portion,prominent,reddish-gre,ruit,sinus,specimen,stem,stigma,straight,style,surface,tall,terminal,thickened,ti,tightly,triangular,ud,underside,unicellular,usually,wide,widest,yellowish,yellowish-tan,ympodial	5-15,abaxial,anisophyllous,apart,appressed,arrangement,bract,branching,breeding,cell,colour,connective,exsertion,flower,form,fruit,growth,hair,height,heteromorphism,inflated,interjected,leaflet,length,mature,modification,na,number,odour,orientation,pattern,placement,plant,position,prickle,pseudostipule,rhizome,scale,staman,stone,structure,symmetry,sympodial,system,texture,tissue,tuber,type,xylopodia,zygomorphy	.5,0.1-0.5,0.1-1,0.5-1,1-3,1-4,1-6,1.2-3,1.3-1.7,10-19,3-6.5,3.5-6,3.5-8,4-10.5,6-10,acute,along,anthesi,apiculate,arising,base,berry,branched,calyx,closely,cm,cordate,covered,cuneate,deflexed,deltoid,dense,densely,difoliate,dirty,ellipsoid,elliptic,exserted,extremely,geminate,glabrous,globose,hispidulous,inflorescence,leaf,lobe,lobed,long,major,margin,member,membranous,minute,minutely,mm,nearly,oblique,occasionally,often,opposite,orbiculate,pair,planar,pointed,poricidal,pubescence,pubescent,purplish,rest,ripe,rounded,shallowly,shaped,shrub,simple,slender,small,somewhat,soon,spaced,sparse,tear-drop,tinge,tip,tree,trichome,tube,uniseriate,variable,vein,waxy,white,woody,x,yellowish-green,young	-3,5-15,anisophyllous,apart,di,na,zygomorphy
273	wfo-0001029072	success	233	107	57	66	167	41	54	3	1-1.5,1/4-1/2,2-7,4.2-6.5,5-50,5-7,andromonoecious,anther,apex,articulated,base,berry,branched,bright,calyx,chartaceous,cm,conical,connivent,cordate,cream,cuneate,curved,dark,densely,filament,flattened,fruit,fruiting,glabrous,green,herb,lateral,leaf,length,lobed,long,long-styled,margin,marking,mature,mauve,mm,pale,pedicel,petiole,poricidal,prickle,prickly,reflexed,short-styled,shrub,simple,sometimes,spherical,stellate,stellate-pubescent,surface,tapering,terminal,tip,unit,way,white,yellow,young	-15,.5,/6,0,0-2,0-20,0-4,0-8,0.1-0.4,0.2-0.3,0.2-0.4,0.3,0.4-0.9,0.5-2,0.5-3,0.7,0.8-1.5,0.8-2.5,00-200,1,1-1.2,1-25,1-3,1.5-2.5,1.5-2.6,1.5-3.2,1/3,1/4-1/3,1/4-1/3-1/2,12-19,2-10,2-5,2-8,2.2-2.5,2.2-3.2,2.5-3.5,2.5-3.8,2.5-4.5,20-50,3-10,3-20,3-5,3-50,3-8,3.5-6,3/,4-10,4-5-merous,4.5-9,5-10,5-9,7-10,7-15,8-20,8-27,abaxial,abaxially,acute,adaxial,adaxially,alyx,ame,angled,apar,apart,apically,apparently,bark,blade,broad-deltate,broadly,c.,clearly,deltate,diameter,dirty,discolorous,distal,distance,drying,dull,eaf,eed,elongated,elongating,equal,erect,extending,flattened-reniform,flower,free,gently,gra,green-brown,hermaphrodite,heterostylous,infructescence,least,lobe,longer,longitudinal,lower,lowermost,maturity,midpoint,midvein,moderately,multangulate,narrow-deltate,nflorescence,obtu,older,one,open,orange-brown,orolla,oung,ovate,pair,peduncle,pendent,pendulous,per,pericarp,plant,plurifoliat,porrect,portion,prickl,primary,raised,ray,ridge,rounded,ruit,scar,sessile,side,smooth,spaced,sparsely,spreading,stalk,stalked,staminat,stem,stout,straight,strongly,style,tamen,tertiary,time,trichome,tube,unarmed,upper,variously,vary,vein,venation,visible,weakly,whitish,wide,woody,ympodial	articulation,bract,branching,breeding,cell,colour,connective,corolla,form,growth,hair,heteromorphism,inflorescence,insertion,interjected,interpetalar,leaflet,na,odour,orientation,pattern,placement,plurifoliate,position,present,pseudostipule,rhizome,scale,shape,spot,staman,stone,structure,symmetry,sympodial,system,texture,tissue,tuber,type,xylopodia	1-1.5,1/4-1/2,2-7,4.2-6.5,5-50,5-7,andromonoecious,articulated,base,berry,branched,bright,chartaceous,cm,conical,connivent,cordate,cream,cuneate,curved,dark,densely,flattened,glabrous,green,herb,lateral,lobed,long,long-styled,marking,mature,mauve,mm,pale,poricidal,prickle,prickly,reflexed,short-styled,shrub,simple,sometimes,spherical,stellate,stellate-pubescent,surface,tapering,terminal,tip,way,white,yellow,young	na,plurifoliate,present
274	wfo-0001029073	success	211	128	70	84	127	44	67	3	.5,0.6-2,1.5-2,10-15,2-3,2/3,4-5,acute,adaxially,along,anther,apex,basal,base,berry,broad-based,calyx,cell,chartaceous,cm,corolla,dark,densely,difoliate,dimorphic,entire,except,filament,fruiting,glabrous,globose,golden,growth,inflorescence,internodal,interpetalar,leaf,length,like,lobed,long,lower,margin,maturity,midvein,mm,multangulate,oblique,occasionally,opposite,orange,pedicel,perfect,petiole,plurifoliate,pore,poricidal,prickle,pubescent,purple,shallowly,short-stalked,shrub,simple,sinuate,slightly,sometimes,splitting,stellate,stem,straight,surface,tapering,tip,tissue,trichome,truncate,unequally,unisexual,unit,way,x,zygomorphic,½	.7,0.3-1,0.5,0.5-1,0.6-0.7,1-1.2,1-1.5,1-2.5,1-3,1.1-1.5,1.2-1.6,10-16,2,2-4,3.5-9,4-6,5-6,5-8,5-merous,6-9,7-10,8-14,abaxially,acuminate,another,anthesi,apart,armed,articulated,away,awn-like,ba,bark,beneath,brown,conical,cream,curved,darker,dense,diameter,discolorous,drying,eaf,eed,elliptic,enlarged,equal,erect,exserted,flattened,flower,four,free,frui,geminat,gre,hooked,lamina,lanceolate,lengthening,linear,lobe,long-styled,midpoint,minutely,mixture,narrowly,new,nflorescence,nodding,older,one,pair,pale,paler,papillose,peduncle,per,pericarp,planar,porrect,portion,prickly,primary,pubescence,ray,rectangular,reniform,reticulate,ruit,scar,sessile,shiny,short,shorter,slit,somewhat,spaced,sparsely,stigma,strongly,style,styled,tan,testal,thin,three,ti,triangular,tube,two,ud,unarmed,underside,unequal,upper,upward,vein,visible,wall,whitish,wide,woody,yellow,yellowish,ympodial	appressed,articulation,bract,branching,breeding,colour,connective,form,fruit,geminate,hair,heteromorphism,inflated,insertion,interjected,leaflet,marking,mature,modification,na,needle-like,odour,orientation,paired,pattern,placement,position,pseudostipule,rhizome,scale,shape,smell,spot,staman,stone,structure,symmetry,sympodial,system,texture,tuber,type,vegetative,xylopodia	.5,0.6-2,1.5-2,10-15,2-3,2/3,4-5,acute,adaxially,along,basal,base,berry,broad-based,calyx,chartaceous,cm,dark,densely,difoliate,dimorphic,entire,except,glabrous,globose,golden,internodal,interpetalar,leaf,like,lobed,long,maturity,midvein,mm,multangulate,oblique,occasionally,opposite,orange,perfect,plurifoliate,poricidal,pubescent,purple,shallowly,short-stalked,shrub,simple,sinuate,slightly,sometimes,splitting,stellate,stem,straight,tapering,tip,tissue,trichome,truncate,unequally,unisexual,way,x,zygomorphic,½	fruit,geminate,na
275	wfo-0001029074	success	173	177	101	114	59	63	95	6	.1,.5,0,0.2-1,0.3-0.8,0.5-1,0.5-1.2,0.7-0.8,1-1.2,1-1.5,1-2,1.4-1.8,1.5-2,1.5-4,2-2.3,2-7,3-,3.5-5,5-6,acute,age,anther,apart,apex,articulation,bark,base,berry,black,broadly,calyx,capitate,cm,conical,corolla,cuneate,deflexed,densely,diameter,ellipsoid,entire,exerted,expanding,filament,flattened,fruiting,globose,green,grey,growth,herb,immature,internodal,lacking,leaf,lengthening,less,like,lobed,lower,margin,markedly,midpoint,minutely,mixture,mm,new,opposite,ovary,ovate,pale,pedicel,peduncle,per,perfect,petiole,pitted,pore,poricidal,pubescent,purplish,ray,reniform,ripening,rounded,sagittate,scar,sessile,simple,slit,small,sparsely,stalked,stellate,stem,stigma,strongly,style,subshrub,surface,tip,trichome,truncate,tube,underside,uniformly,unit,way,white,woody,x,yellow,yellowish,¾	0.3-0.4,0.7-0.95,1,1-3-6,11,2-4,2-5,5-7,abaxially,absent,adaxially,almost,along,anthesi,apparently,appearing,basa,denser,eaf,eed,flower,free,frui,glabrescen,glabrous,lignescent,lobe,longest,midvein,nflorescence,obscuring,often,older,pair,papillat,pericarp,petal,planar,plurifoliat,portion,primary,prominent,pulp,reflexed,ruit,scattered,somewhat,stalk,stellate-pubescent,swollen,thin,triangular,tub,ud,uniseriate,usually,vein,watery,ympodial	abaxial,adaxial,appressed,arrangement,basal,bract,branching,breeding,broad-based,bud,cell,colour,connective,form,fruit,glabrescent,hair,height,heteromorphism,inflated,inflorescence,insertion,interjected,interpetalar,leaflet,length,marking,mature,modification,na,needle-like,number,odour,orientation,paired,papillate,pattern,placement,plant,plurifoliate,position,prickle,pseudostipule,rhizome,scale,seed,shape,size,smell,spot,staman,stone,structure,symmetry,sympodial,system,texture,tissue,tuber,type,vegetative,xylopodia,zygomorphy	.1,.5,0,0.2-1,0.3-0.8,0.5-1,0.5-1.2,0.7-0.8,1-1.2,1-1.5,1-2,1.4-1.8,1.5-2,1.5-4,2-2.3,2-7,3-,3.5-5,5-6,acute,age,apart,apex,articulation,base,berry,black,broadly,calyx,capitate,cm,conical,cuneate,deflexed,densely,diameter,ellipsoid,entire,exerted,expanding,flattened,globose,green,grey,herb,immature,internodal,lacking,leaf,lengthening,less,like,lobed,markedly,midpoint,minutely,mixture,mm,opposite,ovate,pale,per,perfect,pitted,poricidal,pubescent,purplish,ray,reniform,ripening,rounded,sagittate,sessile,simple,slit,small,sparsely,stalked,stellate,strongly,subshrub,surface,tip,trichome,truncate,tube,underside,uniformly,way,white,woody,x,yellow,yellowish,¾	basal,fruit,glabrescent,na,papillate,plurifoliate
276	wfo-0001029075	success	217	134	89	108	109	26	85	4	.3,.5,0-8,0.8-1.5,1-2,1-2.5,10-20,2-4,2-5,2.5-3,30-60,4-10,4-14,4-7,4.5-6.5,5-10,5-8.5,6-12,7-17,7-9,8-9,abaxially,abruptly,acumen,adaxially,anther,blade,broadly,brown,brownish,canescent,cm,condition,corolla,dark,densely,diameter,dot,drying,end,filament,flecked,flower,forked,fresh,fruit,glabrescent,glabrous,glandular-pilose,glandular-puberulent,gray-green,green,greenish,hair,herb,homostylous,interjected,lanceolate,lateral,leaf,leaflet,light,like,lobe,long,long-spatulate,mm,narrowed,odd-pinnate,orne,ovoid,pair,pedicel,peduncle,pentagonal,petal,petiole,plant,pore,poricidal,pubescent,purple,seed,short,singly,size,slightly,small,sometimes,stem,stigma,style,subquadrate,substellate,terminal,tip,tuber,typically,unwinged,upper,white,whitish,whitish-gray,wide,x,yellow,yellow-green,yellowish-white	0-3,0.5-0.8,0.8-1.2,1-10,1-3,2.7-4.2,4-5,5-8,5-merou,ag,along,alyx,apart,apex,apparently,articulated,attenuate-acuminate,atypically,axe,axillary,base,berry,bud,cell,ciliate,clavifor,connivent,covering,cuneate,decreasing,decurrent,digestion,distal,dorsally,eaf,edge,eed,elliptic-lanceolate,enzyme,erect,erect-ascendin,especially,etota,exceeding,flat,folded,geminat,generally,glabrou,gradually,greatly,green-white,hair-like,half,honeycomb-shaped,larger,lengthening,living,lower,make,margin,middl,midrib,minutely,mucilaginous,narrowly,nflorescence,orbicular,orolla,ovate,perfect,petiolulate,petiolule,plurifoliate,pointed,puberulent,rachi,removed,rounded,ruit,sec,sessile,seudostipule,slit,spaced,specimen,stamen,ste,stolo,straight,subequal,subobtuse,subtending,tall,tamen,tem,testal,thick,throughout,toward,tri-,tube,unit,usually,vary,wall,wet,woody,ympodial	abaxial,adaxial,arrangement,articulation,branching,calyx,claviform,colour,form,growth,height,inflorescence,length,marking,middle,number,ovary,position,presence,pseudostipule,shape,spot,stolon,symmetry,texture,zygomorphy	.3,.5,0-8,0.8-1.5,1-2,1-2.5,10-20,2-4,2-5,2.5-3,30-60,4-10,4-14,4-7,4.5-6.5,5-10,5-8.5,6-12,7-17,7-9,8-9,abaxially,abruptly,acumen,adaxially,broadly,brown,brownish,canescent,cm,condition,dark,densely,dot,drying,end,flecked,forked,fresh,glabrescent,glabrous,glandular-pilose,glandular-puberulent,gray-green,green,greenish,hair,herb,homostylous,lanceolate,light,like,lobe,long,long-spatulate,mm,narrowed,odd-pinnate,orne,ovoid,pentagonal,petal,poricidal,pubescent,purple,short,singly,slightly,small,sometimes,stem,subquadrate,substellate,tip,typically,unwinged,upper,white,whitish,whitish-gray,wide,x,yellow,yellow-green,yellowish-white	claviform,middle,stolon,zygomorphy
277	wfo-0001029084	success	192	131	84	103	89	28	81	3	.5,0.8-2.1,1-10,1-2,1-4,1.1-2.2,1.5-2.5,10-50,2-3.5,3-6,3.5-8,4-17,4-7,4.5-6.5,5,5-7,6-13,7-9,8-23,abaxially,adaxially,anther,berry,blade,brownish,cell,chartaceous,ciliate,cm,condition,conical,corolla,diameter,digestion,dorsally,drying,edge,enzyme,especially,filament,flat,flower,folded,forked,fresh,fruit,glabrous,green,greenish,herb,homostylous,honeycomb-shaped,lanceolate,lateral,leaf,leaflet,lengthening,light,lilac,long,margin,middle,midrib,minute,minutely,mm,moniliform,mottled,mucilaginous,narrow,odd-pinnate,ovate-lanceolate,ovoid,pair,pedicel,petiole,plant,pore,poricidal,proximal,puberulent,pubescent,purple,removed,ripe,rotate,seed,size,slit,sparsely,style,subglabrous,terminal,testal,tip,tube,tuber,unwinged,wall,wet,whitish,wing,x	0.8-2,1-3,2-4,2-5,3.5-7.5,4.5-10,5-merou,absent,acumen,acuminate,ag,along,alyx,apart,apex,apparently,arranged,articulated,axe,axillary,base,bead,bud,capitat,connivent,covering,darker,decreasing,distal,eaf,eed,exceeding,geminat,generally,glabrou,gradually,green-white,hair-like,half,interjected,interpetalar,larger,like,living,lobe,lon,lower,make,multiple,necklace,nflorescence,obtuse,orolla,peduncle,perfect,petiolule,pilose,plurifoliate,ray,ruit,secondary,semierec,seudostipule,spaced,specimen,stamen,stigma,stolon,subequal,subglabrou,subsessile,subtending,symmetrical,tall,tamen,tem,thick,thir,throughout,tissue,toward,tri-,typically,unit,usually,vary,wide,yellow,ympodial	5-merous,age,arrangement,articulation,branching,calyx,ciliation,colour,folding,form,growth,hair,height,inflorescence,length,mucilaginousnes,number,ovary,position,pseudostipule,shape,spacing,staman,stem,texture,third,type,width	.5,0.8-2.1,1-10,1-2,1-4,1.1-2.2,1.5-2.5,10-50,2-3.5,3-6,3.5-8,4-17,4-7,4.5-6.5,5,5-7,6-13,7-9,8-23,abaxially,adaxially,berry,brownish,chartaceous,ciliate,cm,condition,conical,corolla,digestion,dorsally,drying,enzyme,especially,flat,folded,forked,fresh,glabrous,green,greenish,herb,homostylous,honeycomb-shaped,lanceolate,lateral,lengthening,light,lilac,long,margin,middle,minute,minutely,mm,moniliform,mottled,mucilaginous,narrow,odd-pinnate,ovate-lanceolate,ovoid,pore,poricidal,proximal,puberulent,pubescent,purple,removed,ripe,rotate,slit,sparsely,subglabrous,tip,unwinged,wall,wet,whitish,wing,x	5-merous,age,third
278	wfo-0001029088	success	149	157	84	94	55	63	79	5	.3,0.1,0.9–1.5,1.3–4.5,15–25,1–1.6,2.5–20,2.5–4.2,25–30,2–2.5,3–16,4–8,5-merous,5–8,<,abaxially,accrescent,acuminate,adaxially,anther,apex,base,berry,bronze-brown,calyx,capitate,cm,cordate,cylindrical,densely,diameter,entire,extra-axillary,filament,flattened,fleshy,flower,fragrant,fruit,fruiting,glabrous,greenish-brown,hair,half,heavy,herbaceous,immature,juicy,lanceolate,leaf,lenticular,light,lower,margin,mature,membranous,minutely,mm,moderately,near,obtuse,ovoid-rhomboid,papillose,pedicel,peduncle,petiole,pubescent,purplish,rachi,reddish-brown,revolute,rounded,rugose,sand-punctate,scent,shortly,simple,slender,slightly,somewhat,sparsely,stellate,stigma,stout,straight,strongly,style,surface,sweet,unbranched,unit,vine,white,x	.2,0.6–3.2,1.5–2,1.5–3,1–1.2,1–1.5,1–3,2-lobe,2–3,3.5–7,3.5–8,5,6-10,acute,alyx,apar,apicall,axe,blade,c.,ciliate,climbing,eaf,eed,emarginate,flavor,glabrou,groun,lobe,long,m.,narrowly,nflorescence,nternode,orolla,palmate,perfec,plurifoliat,primary,ruit,spaced,swee,tamen,tem,terrestrial,tip,truncate,truncate-acuminat,tube,vary,vein,venation,wider,ympodial,–7	2-lobed,appressed,articulation,bract,branching,breeding,broad-based,cell,colour,connective,corolla,form,growth,height,heteromorphism,inflated,inflorescence,insertion,interjected,internode,interpetalar,juicines,leaflet,length,marking,merosity,modification,na,needle-like,odour,orientation,ovary,paired,pattern,perfect,placement,plant,plurifoliate,pore,position,prickle,pseudostipule,rhizome,scale,seed,shape,smell,spot,staman,stem,stone,structure,symmetry,sympodial,system,texture,tissue,trichome,tuber,type,vegetative,xylopodia,zygomorphy	.3,0.1,0.9–1.5,1.3–4.5,15–25,1–1.6,2.5–20,2.5–4.2,25–30,2–2.5,3–16,4–8,5-merous,5–8,<,abaxially,accrescent,acuminate,adaxially,apex,berry,bronze-brown,capitate,cm,cordate,cylindrical,densely,entire,extra-axillary,flattened,fleshy,flower,fragrant,fruit,glabrous,greenish-brown,hair,half,heavy,herbaceous,immature,juicy,lanceolate,leaf,lenticular,light,lower,mature,membranous,minutely,mm,moderately,near,obtuse,ovoid-rhomboid,papillose,pubescent,purplish,reddish-brown,revolute,rounded,rugose,sand-punctate,scent,shortly,simple,slender,slightly,somewhat,sparsely,stellate,stout,straight,strongly,sweet,unbranched,vine,white,x	2-lobed,na,perfect,plurifoliate,zygomorphy
279	wfo-0001029089	success	177	110	53	61	116	49	50	3	/4,0.1-0.25,1-1.5,4.5-5,acute,anther,apex,base,beneath,berry,branched,calyx,caniculate,cm,corolla,dark,densely,difoliate,drying,elliptic,filament,fruiting,furcate,glabrous,globose,golden,green,leaf,lobed,long,margin,middle,minutely,mm,occasionally,opposite,otherwise,papillose,pedicel,petiole,pore,poricidal,pubescent,purplish,resinous,shaped,shiny,shrub,simple,small,somewhat,tear-drop,tip,tree,uniseriate,unit,usually,way,white,widest,x	.5,.75,0.5-0.6,0.5-1,0.8-1,0.8-1.2,1,1.5-2,1.5-6,1/2,10-25,2.5-3.5,5-10,5-20-flowered,5-6,5-9,6-7,8-9,abrupt,along,anthesi,apart,apiculate,axil,ba,bark,beginning,bilobed,bud,campanulate,closely,completely,covered,covering,cracking,decurrent,deflexed,dia,differing,eaf,edicel,eed,either,enclosed,entire,erect,expand,exserted,flattened-reniform,free,geminat,glabrou,impressed,incrassate,inflorescenc,lamina,later,lateral,like,lobe,lon,lower,main,major,material,member,minor,nflorescence,obovoid,older,one,ovary,overlapping,pair,papillo,part,peeling,persistent,pinkish,pitted,planar,portion,primary,prominent,reddish-grey,resinou,rounded,rounded-deltoid,ruit,scar,secretion,size,slightly,smooth,spaced,stem,stigma,still,straight,style,surface,tall,tan,tapering,trichome,tub,tube,ud,underside,varnish,varnished,vein,widening,woody,ympodial,young	appressed,articulation,bract,branching,breeding,cell,colour,connective,form,fruit,geminate,growth,hair,heteromorphism,inflated,inflorescence,insertion,interjected,interpetalar,leaflet,length,marking,mature,modification,na,odour,orientation,paired,pattern,placement,position,prickle,pseudostipule,rhizome,scale,shape,spot,staman,stone,structure,symmetry,sympodial,system,texture,tissue,tuber,type,xylopodia,zygomorphy	/4,0.1-0.25,1-1.5,4.5-5,acute,base,beneath,berry,branched,caniculate,cm,dark,densely,difoliate,drying,elliptic,furcate,glabrous,globose,golden,green,leaf,lobed,long,middle,minutely,mm,occasionally,opposite,otherwise,papillose,poricidal,pubescent,purplish,resinous,shaped,shiny,shrub,simple,small,somewhat,tear-drop,tip,tree,uniseriate,usually,way,white,widest,x	geminate,na,zygomorphy
280	wfo-0001029091	success	207	98	42	56	151	42	39	3	-4,2-3,20-30,anther,apex,aromatic,articulation,axil,base,berry,broadly,calyx,cell,colour,conspicuous,corolla,cuneate,elliptic,filament,flushed,fork,fruiting,glandular,globular,hair,intense,leaf,long,minutely,mm,oblong,ochre-yellow,ovate,ovoid,pattern,pedicel,pentagonal,petiolate,petiole,pore,poricidal,pubescent,reddish-purple,shortly,shrub,simple,slightly,sparsely,speckled,stellate-rotate,stem,stone,tip,tissue,unit,violet-purple	-4.5,0.3-0.5-0.8-1,0.5-1,1,1-10,1-2,1.5-2,1.5-2-3,10,10-20,10-toothed,15-40,170-210,2-12,2-2.5,2.5-4,3,3-11-lobed,3-4,3-5-7-15,46/1,5,635/1,7-8,acuminate,acute,age,appearing,articulated,aspect,ba,becoming,blunt,bluntly,brownish,buff,campanulate,capitate,clonal,close,cm,common,cut,cyme,dark,deeply,develop,developed,dia,discoidal,downward,eed,effect,ellipsoid,emarginated,erect,exceeding,exerted,flattened,floral,flower,forked,fresh,general,giving,globose,gree,grey,growing,half,interacuminal,irregular,irregularly,juvenile,lacking,larger,lasting,later,lateral,lavende,lavender,lengthening,light,line,linear,linear-lanceolate,lobe,long-triangular,lower,may,mid-vein,mineral,narrowly,nflorescence,obovate,obscure,occasionally,overlain,ower,pale,pedicellate,peduncle,petiol,plurifoliat,point,rachi,raised,readily,relatively,reticulate-concentric,rh,ridge,ridged,ripe,rounded,ruit,scarcely,separate,several,shallowly,shed,sigmoid,sinus,slender,slit,soft,soft-wooded,soon,stigma,straggly,style,subulate,succulent,surface,swollen,tall,toward,transverse,triangular,tub,ud,upper,usually,violet,well,winged,without,woody,x,year,ympodial	appressed,bract,branching,breeding,connective,form,fruit,glabrous,growth,heteromorphism,inflated,inflorescence,insertion,interjected,interpetalar,leaflet,length,margin,marking,mature,na,odour,orientation,paired,placement,plurifoliate,position,prickle,pseudostipule,rhizome,scale,shape,spot,staman,structure,symmetry,sympodial,system,texture,tuber,type,xylopodia	-4,2-3,20-30,aromatic,axil,base,berry,broadly,conspicuous,cuneate,elliptic,flushed,fork,glandular,globular,intense,leaf,long,minutely,mm,oblong,ochre-yellow,ovate,ovoid,pentagonal,petiolate,poricidal,pubescent,reddish-purple,shortly,shrub,simple,slightly,sparsely,speckled,stellate-rotate,stem,tip,violet-purple	glabrous,na,plurifoliate
281	wfo-0001029101	success	230	164	96	116	114	48	88	8	/3,0-2,0.1-0.4,0.1-0.5,0.2,0.4-1.5,0.5-1,0.7-1.5-2,1-1.5,1-3,1.3-2,10-14,2.5-6,3-10,3-4,3-7,4-12,5-6,5-7,5-merous,5.5-8,8-15,abaxial,adaxial,andromonoecious,anther,apart,apex,articulated,bark,base,berry,branched,calyx,cell,chartaceous,cm,concolorous,connivent,cuneate,darker,discolorous,drying,elliptic,elongating,equal,erect,filament,flattened,flower,fruit,fruiting,glabrescent,glabrous,heterostylous,lateral,leaf,length,lobe,lobed,long,long-styled,lower,margin,marking,maturity,mauve,midpoint,mm,moderately,narrow-deltate,obovate,obtuse,older,orange-brown,ovate,pair,pale,pedicel,peduncle,petiole,plant,poricidal,porrect,present,prickle,primary,rarely,ray,reflexed,sessile,short-styled,shrub,simple,sometimes,sparsely,spherical,stalk,stalked,stellate,stellate-pubescent,stem,straight,surface,tapering,terete,tip,trichome,unit,variously,vein,way,wide,yellow,yellow-orange,young	-15,.5,/4,0-100,0-20,0-5,0-8,0.1,0.1-0.7,0.1-1,0.8-3.5,00-200,1,1-4,1-8,1.3-2.6,1.4-2.2,1.5-2,1.5-2.5,1.7,1.8-3,1/5-1/4,10-20,2-20,2-3-4,2-6,2.5-3.5,2.8-3.3,2/3-3/4,3-5-9,30-100,4-7,5-20,5-7-13,5-8,6-8,abaxially,acute,almost,always,alyx,apar,apically,apparently,blade,broad-deltate,brown-green,cream,dark,deltate,diameter,distal,distance,dull,eaf,eed,extending,flattened-reniform,free,green,green-brow,hermaphrodite,infructescence,lengt,like,lon,longer,lowermost,mature,midvein,multangulate,nflorescence,oblong,often,one,open,orolla,oung,outline,pendulous,per,pericarp,pit,plurifoliat,portion,prickl,prickly,raised,reduced,rounde,rounded,ruit,scar,secondary,side,small,smooth,spaced,spreading,staminat,style,suborbicular,tamen,tertiary,thick,time,tube,vary,venation,visible,well-developed,woody,yellow-green,ympodial	3-9,5-13,appressed,articulation,branching,breeding,broad-based,colour,connective,corolla,form,green-brown,growth,hair,height,heteromorphism,inflated,inflorescence,modification,na,needle-like,number,odour,orientation,pattern,placement,plurifoliate,pore,position,presence,pseudostipule,rhizome,shape,size,spacing,spot,staman,stone,structure,symmetry,sympodial,system,texture,tuber,type,width,xylopodia,zygomorphy	/3,0-2,0.1-0.4,0.1-0.5,0.2,0.4-1.5,0.5-1,0.7-1.5-2,1-1.5,1-3,1.3-2,10-14,2.5-6,3-10,3-4,3-7,4-12,5-6,5-7,5-merous,5.5-8,8-15,andromonoecious,apart,articulated,base,berry,branched,chartaceous,cm,concolorous,connivent,cuneate,darker,discolorous,drying,elliptic,elongating,equal,erect,flattened,glabrescent,glabrous,heterostylous,lateral,leaf,lobed,long,long-styled,lower,maturity,mauve,mm,moderately,narrow-deltate,obovate,obtuse,orange-brown,ovate,pair,pale,poricidal,porrect,present,prickle,rarely,reflexed,sessile,short-styled,shrub,simple,sometimes,sparsely,spherical,stalked,stellate,stellate-pubescent,stem,straight,surface,tapering,terete,tip,variously,way,wide,yellow,yellow-orange	3-9,5-13,broad-based,green-brown,na,needle-like,plurifoliate,zygomorphy
282	wfo-0001029106	success	198	97	49	64	134	33	47	2	.5,/3,0-5,1-5,2-8,3-4,4-6,anther,apex,articulated,base,berry,branched,calyx,cell,cm,concolorous,cuneate,curved,discolorous,drying,elongating,equal,erect,filament,fruit,fruiting,gently,lateral,leaf,length,lobed,long,lower,margin,maturity,mauve,membranous,mm,obtuse,orange,pedicel,petiole,poricidal,prickle,red,reflexed,shrub,simple,sparsely,spherical,spreading,stellate-pubescent,stem,straight,subentire,surface,tapering,tip,trichome,unit,way,weakly,white	.1,0-0.3,0-10,0-2,0-20,0-6,0.1,0.2-0.4,0.2-1,0.25-0.7,0.5,0.5-0.8,0.5-0.9,0.5-1,0.5-2.5,0.9-1.2,1-1.6,1-2,1.5-1.8,1.5-2,1.5-3.5,1/4,1/5-1/4,2-3.5,2-4,2-5.5,2-6,2.2-3,2/,3-25,3-3.5,4-8,5-14,5-8,5-merous,6-8,abaxially,acuminat,acute,alyx,ame,apar,apart,apically,apparently,appearing,bark,blade,c.,deltate,densely,diameter,distance,eaf,eed,elliptic,extending,eye,flattened,flattened-reniform,flower,free,glabrescent,glabrous,infructescence,light,lobe,lon,longer,mature,midpoint,midvein,naked,nflorescence,older,one,open,orange-brow,orange-brown,orbicular,orolla,oung,outline,ovate,pair,pale,peduncle,pendulous,per,perfec,pericarp,pit,plurifoliat,porrect,portion,prickl,prickly,primary,raised,ray,rounded,scandent,scar,sessile,shallow,shiny,shorter,side,size,slender,small,smooth,sometimes,spaced,stalk,stalked,stellate,style,tamen,terete,tertiary,time,tube,uit,variously,vary,vein,venation,visible,wide,woody,yellow-orange,yellowish-green,ympodial	articulation,branching,broad-based,colour,corolla,form,growth,hair,heteromorphism,inflorescence,insertion,na,needle-like,odour,orientation,placement,plurifoliate,position,pseudostipule,rhizome,scale,shape,smell,staman,stone,structure,symmetry,sympodial,texture,tuber,type,vegetative,xylopodia	.5,/3,0-5,1-5,2-8,3-4,4-6,articulated,base,berry,branched,cm,concolorous,cuneate,curved,discolorous,drying,elongating,equal,erect,gently,lateral,lobed,long,maturity,mauve,membranous,mm,obtuse,orange,poricidal,red,reflexed,shrub,simple,sparsely,spherical,spreading,stellate-pubescent,straight,subentire,surface,tapering,tip,way,weakly,white	na,plurifoliate
283	wfo-0001029112	success	190	172	95	113	77	59	89	6	0.9-1.7,1-10,1-2,1.4-2.5,1.5-2,10-17,10-21,2-3.5,2.5-4.5,2.6-3,2.7-4.2,2.7-5.7,20,3-5,3-6,3-7,3.5-4.5,3.5-7,5,6.5-5.5,9.5-13,abaxially,adaxially,anther,apex,axillary,base,berry,blade,brownish,bud,cell,chartaceous,ciliate,cm,condition,conical,corolla,covering,densely,diameter,distal,dorsally,drying,edge,filament,flat,flower,folded,forked,fresh,fruit,glabrous,green,green-white,greenish,hair,hair-like,herb,homostylous,interjected,lanceolate,lateral,leaf,leaflet,lengthening,light,like,lower,make,margin,middle,minute,mm,moniliform,mottled,mucilaginous,obtuse,odd-pinnate,ovoid,pair,pale,pedicel,peduncle,petiole,plant,plurifoliate,pore,poricidal,pubescent,purple,ripe,rotate,seed,size,slit,stigma,style,subtending,symmetrical,terminal,testal,thick,throughout,tip,tri-,tuber,unit,violet,wall,wet,whitish,x	0-2,0.5,1-3,1-4,1.5-1.8,2.7-3.5,3-4,5-8,5-merou,acumen,acuminate,ag,along,alyx,apart,apparently,arranged,articulated,axe,bead,capitat,connivent,decreasing,digestion,eaf,eed,elliptic-lanceolate,enzyme,equal,especially,exceeding,geminat,generally,glabrou,gradually,half,honeycomb-shaped,larger,living,lobe,long,multiple,narrow,necklace,nflorescence,orolla,ovate,perfect,petiolule,present,pubescen,ray,removed,ruit,secondary,semierec,seudostipule,slightly,spaced,specimen,stamen,ste,stolon,subequal,tall,tamen,tem,thir,toward,tube,typically,usually,vary,wide,wing,yellow,ympodial	age,appressed,arrangement,articulation,bract,branching,breeding,broad-based,calyx,capitate,colour,connective,form,fruiting,growth,height,heteromorphism,inflated,inflorescence,insertion,interpetalar,length,marking,mature,modification,na,needle-like,odour,orientation,ovary,paired,pattern,placement,position,prickle,pseudostipule,rhizome,scale,shape,smell,spacing,spot,staman,stem,stone,structure,surface,symmetry,sympodial,system,texture,third,tissue,trichome,type,vegetative,width,xylopodia,zygomorphy	0.9-1.7,1-10,1-2,1.4-2.5,1.5-2,10-17,10-21,2-3.5,2.5-4.5,2.6-3,2.7-4.2,2.7-5.7,20,3-5,3-6,3-7,3.5-4.5,3.5-7,5,6.5-5.5,9.5-13,abaxially,adaxially,axillary,berry,brownish,bud,cell,chartaceous,ciliate,cm,condition,conical,covering,densely,distal,dorsally,drying,flat,folded,forked,fresh,glabrous,green,green-white,greenish,hair,hair-like,herb,homostylous,lanceolate,lateral,lengthening,light,like,make,margin,middle,minute,mm,moniliform,mottled,mucilaginous,obtuse,odd-pinnate,ovoid,pale,plurifoliate,pore,poricidal,pubescent,purple,ripe,rotate,seed,slit,subtending,symmetrical,terminal,testal,thick,throughout,tip,tri-,violet,wall,wet,whitish,x	age,capitate,na,stem,third,zygomorphy
284	wfo-0001029120	success	168	176	111	122	46	54	106	5	.05,.5,.75,/2,0.1-0.5,0.5-1.5,0.7-1,1-1.5,1.1-1.5,2.6-7,3-3.5,6-8,6.5-16.5,abrupt,acuminate,acute,anther,anthesi,apart,apex,bark,basal,base,beginning,beneath,black,bud,bullate,calyx,cell,cm,corolla,dark,decurrent,deflexed,densely,dia,difoliate,drying,erose,especially,f,filament,fleshy,glabrous,globose,golden,greenish-brown,hirsute,internodal,lanceolate,larger,leaf,like,lobe,lobed,long,lower,margin,midrib,minor,minutely,mm,narrow,narrower,narrowly,nearly,occasionally,often,opposite,outer,ovary,ovate,pale,paler,papillose,pedicel,peduncle,petiole,point,pore,portion,present,prominently,pubescent,raised,reproductive,scar,scattered,shaped,shrub,simple,slightly,sparsely,stem,stigma,style,surface,sympodial,tapering,tear-drop,terminal,thickened,tip,trichome,tube,unbranched,unifoliate,uniseriate,unit,urceolate,vein,venation,way,white,wide,widening,widest,x,yellow,yellow-green,young	1.1-2,2.5-3.5,5-10-flowered,5-8,8511,dry,eaf,edicel,eed,epidermi,evenly,fide,free,geminat,inflorescenc,infloresence,know,known,large,later,lateral,lehmann,lon,long-triangular,main,middle,nflorescence,older,pair,peduncl,petaloid,poricidal,proximal,rest,ruit,slender,spaced,specimen,speckle,straight,tall,tub,ud,upper,white-papillo,ympodial	articulation,bract,branching,breeding,broad-based,colour,decument,density,form,fruit,geminate,growth,hair,height,heteromorphism,inflorescence,insertion,interjected,interpetalar,leaflet,length,marking,na,needle-like,odour,orientation,pattern,placement,plant,position,prickle,pseudostipule,pubescence,rhizome,scale,seed,shape,size,smell,spacing,spot,staman,stone,structure,symmetry,system,texture,tissue,tuber,type,vegetative,white-papillose,width,xylopodia	.05,.5,.75,/2,0.1-0.5,0.5-1.5,0.7-1,1-1.5,1.1-1.5,2.6-7,3-3.5,6-8,6.5-16.5,abrupt,acuminate,acute,apart,basal,base,beginning,beneath,black,bud,bullate,calyx,cm,dark,decurrent,deflexed,densely,dia,difoliate,erose,especially,f,fleshy,glabrous,globose,golden,greenish-brown,hirsute,internodal,lanceolate,larger,leaf,like,lobe,lobed,long,margin,midrib,minor,minutely,mm,narrow,narrower,narrowly,nearly,occasionally,often,opposite,outer,ovate,pale,paler,papillose,peduncle,petiole,point,present,prominently,pubescent,raised,reproductive,scattered,shaped,shrub,simple,slightly,sparsely,stem,style,surface,sympodial,tapering,tear-drop,thickened,tip,trichome,tube,unbranched,unifoliate,uniseriate,unit,urceolate,vein,venation,way,white,wide,widening,widest,x,yellow,yellow-green,young	decument,geminate,inflorescence,na,white-papillose
285	wfo-0001029121	success	159	137	64	78	81	59	56	8	0,0.2-2,1-4,1-5,1.1-3.9,1.2-2.5,15-30,2-10,2-13,2-3,2-3-celled,3.8-11,4-5.5,4.5-10.0,5-20,5-8,8-16,9-33,apex,apically,base,blue,branched,calyx,cell,cm,conical,connate,corolla,cuneate,cyme,deep,dehiscent,diameter,dichasially,distal,filament,flower,forked,glabrous,green,green-white,hair,herbaceous,interjected,lateral,leaf,leaflet,long,medium,mm,mucilaginous,oblique,odd-pinnate,ovoid,pair,pattern,pedicel,peduncle,perennial,perfect,petiole,plant,poricidally,proximal,purple,rarely,rotate,rounded,scattered,seed,short,style,terminal,tuber-bearing,unit,yellow,¼	0-2,1.2-3.3,10,2-3-5-6,3-6-foliat,3.6-9,4-10,abaxiall,abaxially,acumen,acuminate,acute,adaxially,apical,articulate,attenuate,commonly,covering,dichasial,digestion,diminishing,dorsally,eaf,ebracteate,edge,eed,elliptical,emoval,enzyme,exceeding,flat,folded,generally,globo,gradually,hair-like,half,honeycomb,introrse,living,lobe,lon,lower,lunat,make,maturing,monochasial,narrowly,nflorescence,nther,obtuse,often,orolla,ovate,petiolule,plan,reveal,ruit,sessile,seudostipule,short-attenuate,size,slit,specimen,stamen,stigma,straight,subequal,tal,tem,testal,thick,throughou,throughout,tip,toward,typically,vary,wall,wide,ympodial	2-6,3-6-foliate,6,anther,appressed,arrangement,articulation,bract,branching,breeding,colour,connective,form,fruit,fruiting,growth,height,heteromorphism,inflated,inflorescence,insertion,interpetalar,length,lunate,margin,marking,mature,modification,na,number,odour,orientation,ovary,paired,placement,pore,position,prickle,pseudostipule,rhizome,scale,shape,spot,staman,stellate,stem,stone,structure,symmetry,sympodial,system,texture,tissue,tuber,type,wet,width,xylopodia,zygomorphy	0,0.2-2,1-4,1-5,1.1-3.9,1.2-2.5,15-30,2-10,2-13,2-3,2-3-celled,3.8-11,4-5.5,4.5-10.0,5-20,5-8,8-16,9-33,apically,blue,branched,cm,conical,connate,cuneate,cyme,deep,dehiscent,dichasially,distal,forked,glabrous,green,green-white,hair,herbaceous,long,medium,mm,mucilaginous,oblique,odd-pinnate,ovoid,perennial,perfect,poricidally,proximal,purple,rarely,rotate,rounded,scattered,short,tuber-bearing,yellow,¼	2-6,3-6-foliate,6,lunate,na,stellate,wet,zygomorphy
286	wfo-0001029125	success	196	176	102	107	89	69	80	22	.1,.2,0.5,0.9,1,abaxial,acuminate,adaxial,age,anther,apex,appressed,attenuate,base,berry,black,branching,brownish,calyx,cell,central,closely,cm,concave-reniform,conical,corolla,cuneate,densely,diameter,difoliate,ellipsoid,end,entire,filament,flower,fruit,fruiting,glabrous,globose,green,herb,hilum,internodal,lateral,leaf,lengthening,live,long,lower,margin,maturity,maximum,minutely,mm,narrower,oblique,occasionally,one,orange,ovary,ovate-lanceolate,pale,papillate,pedicel,peduncle,per,petiole,plant,pore,poricidal,pubescent,purple,purple-tinged,purplish,reflexed,ridged,ripe,scar,scattered,seed,shiny,simple,slightly,slit,small,spaced,spreading,star,stellate,stem,stigma,stone,style,subshrub,surface,terete,tip,toward,trichome,tube,turning,unequal,uniseriate,unit,white,yellow,¼	.0–3.5,.1–1.4,.4,.5–2.0,.6,0.5–0.6,0.5–1.0,0.8–0.9,1.0–1.2,1.0–1.5,1.0–4.0,1.5–2.0,1.5–3.0,1.7-3.0–3.4,1.8–3.5,1–2-celled,2.5–12.0,2/3,20–100,2–3-celled,2–4,3.5–4,35–45,3–5,3–5-celled,4–8,5-merous,5–6,6,6–7,abaxially,acute,adaxially,along,anthesi,apar,apparently,arising,articulated,ba,beyond,cone,delicate,deltate,eaf,eed,especially,exerted,free,geminat,growt,later,like,lobe,lobed,lon,nearly,nflorescence,often,outline,pair,pentagonal,perfect,place,portion,positioned,primary,reflexe,ruit,shorter,single,sparsely,stemmed,straight,strongly,sub-lateral,tall,tem,testal,tinged,traingular,ud,usually,vein,whitewith,wide,woody,ympodial,young	0.4,0.5-0.6,0.5-1.0,0.6,0.8-0.9,1-2-celled,1.0-1.2,1.0-1.5,1.0-4.0,1.5-3.0,1.7-3.0-3.4,2-3-celled,2-4,2.5-12.0,3-5-celled,3.5-4,35-45,6-7,apart,articulation,bract,breeding,broad-based,bud,colour,connective,form,geminate,growth,hair,heteromorphism,inflated,inflorescence,insertion,interjected,interpetalar,leaflet,length,marking,mature,modification,na,needle-like,number,odour,orientation,paired,pattern,placement,position,prickle,pseudostipule,rhizome,scale,shape,smell,spot,staman,structure,symmetry,sympodial,system,texture,tissue,tuber,type,vegetative,width,xylopodia	.1,0.5,0.9,1,acuminate,age,apex,appressed,attenuate,base,berry,black,brownish,central,closely,cm,concave-reniform,conical,cuneate,densely,difoliate,ellipsoid,end,entire,flower,fruit,glabrous,globose,green,herb,internodal,lateral,lengthening,live,long,lower,maturity,maximum,minutely,mm,narrower,oblique,occasionally,one,orange,ovate-lanceolate,pale,papillate,per,plant,poricidal,pubescent,purple,purple-tinged,purplish,reflexed,ridged,ripe,scattered,seed,shiny,simple,slightly,slit,small,spaced,spreading,star,stellate,subshrub,terete,tip,toward,trichome,turning,unequal,uniseriate,white,yellow,¼	0.4,0.5-0.6,0.5-1.0,0.6,0.8-0.9,1-2-celled,1.0-1.2,1.0-1.5,1.0-4.0,1.5-3.0,1.7-3.0-3.4,2,2-3-celled,2-4,2.5-12.0,3-5-celled,3.5-4,35-4,6-7,apart,geminate,na
287	wfo-0001029150	success	177	110	43	55	122	55	40	3	0.8-1,0.8–1.5,1.2–1.5,1–5,2.5–3,accrescent,adaxially,anther,apex,apiculate,base,berry,branched,calyx,conical,ellipsoidal,entire,extra-axillary,filament,fleshy,fruit,fruiting,glabrous,leaf,long,lower,margin,membranaceous,mm,moderately,nearly,oblique,opposed,pedicel,petiole,pubescent,rarely,rounded,rounded-deltoid,sand-punctate,shortly,simple,slender,slightly,somewhat,stellate,stem,surface,tip,trichome,truncate,unit,vine,white,x	.5,0.3,0.3-0.5,0.3–0.5,0.5–1.1,0.8–1,0.8–3.5,1.5,1.5–2,1.5–2.2,15,1–1.5,1–11,1–2,1–6,2.5–5,2.5–8,2–10,2–2.5,2–3,3-5,3–10,3–4,3–50,5-merous,6,7–8,8-shaped,9–12,abaxially,across,acute,adaxiall,alyx,apar,apicall,apically,attenuate,axe,blade,c.,canopy,capitat,ciliate,climbing,cm,color,cros,cylindrical,delicate,diameter,distant,dried,eaf,eed,elliptical,enlarged,except,flattened,flower,flush,glabrou,inconspicuous,lamina,lanceolate,larger,light,living,lobe,lon,m.,material,midvein,minutely,mor,nflorescence,nternode,older,orolla,ovate,pair,pale,peduncle,perfec,pinkish-white,pinnate,plurifoliat,pointed,rachi,reaching,rugose,ruit,scar,secondary,section,side,small,spaced,sparsely,specimen,stigma,strong,style,tamen,tan,teardrop-shaped,tem,thick,thickened,time,translucent,tree,tube,understory,vary,vegetation,vein,venation,wide,wiry,woody,ympodial	appressed,articulation,bract,branching,breeding,broad-based,cell,colour,connective,corolla,form,growth,hair,heteromorphism,inflated,inflorescence,insertion,interjected,interpetalar,leaflet,length,marking,mature,modification,na,needle-like,odour,orientation,paired,pattern,perfect,placement,plurifoliate,pore,position,prickle,pseudostipule,rhizome,scale,shape,smell,spot,staman,stone,structure,symmetry,sympodial,system,texture,tissue,tuber,type,vegetative,xylopodia,zygomorphy	0.8-1,0.8–1.5,1.2–1.5,1–5,2.5–3,accrescent,adaxially,apiculate,berry,branched,conical,ellipsoidal,entire,extra-axillary,fleshy,glabrous,leaf,long,membranaceous,mm,moderately,nearly,oblique,opposed,pubescent,rarely,rounded,rounded-deltoid,sand-punctate,shortly,simple,slender,slightly,somewhat,stellate,tip,truncate,vine,white,x	na,perfect,plurifoliate
288	wfo-0001029152	success	197	93	36	51	146	42	32	4	0.5-1,2.5-3,anther,apex,attenuate,base,berry,calyx,cm,completely,corolla,cuneate,difoliate,elliptic,enclosing,filament,fruit,fruiting,glabrous,globose,green,inflorescence,leaf,lobed,long,lower,margin,minutely,mm,obovate,opposite,pale,papillose,pedicel,petiole,pore,poricidal,red-floccose,shape,shaped,shrub,small,stem,surface,tear-drop,tip,tree,trichome,tube,unit,white	.1,.5,0.25-0.5,0.75-1,0.8-1,0.9-1.3,1,1-1.5,1-2,1-3,1-4,1.1-1.3,1.5-1.7,1.5-2,2-2.5,2-3,2-4,2-5,3-5,3-8-flowered,4-6,6-8,61-25,8.5-16,acuminate,acute,anthesi,appearanc,appearing,appressed,area,ba,bark,beginning,beneath,blade,branch,broadened,broadly,brown,bud,citronella,closely,conical,corky,dark,deciduous,decurrent,deep,deflexed,deltoid,densely,dia,differing,distal,dry,eaf,edicel,eed,ellipsoi,erect,et,exsertion,fide,flattened,floccose,flower,fragrance,free,geminat,giving,greyish-red,held,hyaline,inflorescenc,keeled,large-lenticellate,late,lateral,lightly,live,lobe,lon,long-styled,longer,main,major,material,middle,midrib,minor,nearly,nflorescence,often,older,one,ovary,overlapping,ovoid-reniform,pair,per,pitted,planar,plane,plant,portion,prominent,prominently,quite,red,reddish,reddish-floccose,reflexed,reminiscent,rounded,ruit,scar,shiny,short-styled,simple,single,size,slender,slightly,somewhat,soon,spaced,stigma,straight,styl,style,tall,tapering,terminal,third,tillett,ud,usually,vein,weak,widest,winged,woody,x,ympodial,young	articulation,bract,branching,broad-based,cell,colour,decurred,form,geminate,growth,hair,heteromorphism,insertion,interjected,interpetalar,leaflet,length,marking,na,needle-like,odour,orientation,placement,position,prickle,pseudostipule,rhizome,scale,smell,spot,staman,stone,structure,symmetry,sympodial,texture,tissue,tuber,type,vegetative,xylopodia,zygomorphy	0.5-1,2.5-3,attenuate,berry,cm,completely,corolla,cuneate,difoliate,elliptic,enclosing,glabrous,globose,green,leaf,lobed,long,minutely,mm,obovate,opposite,pale,papillose,poricidal,red-floccose,shaped,shrub,small,tear-drop,tip,tree,white	decurred,geminate,na,zygomorphy
289	wfo-0001029156	success	65	70	38	48	17	22	35	3	0.5,1.5-2,10-12,4-6,6,6-8,<,almost,bark,berry,cell,center,cm,completely,deeply,diameter,exfoliating,flattened,fruiting,glabrous,golden,growth,lateral,liana,margin,minutely,mm,multiseriate,new,pale,pedicel,per,pitted,rectangular,reniform,rib-like,seed,shiny,sinuate,stem,surface,tan,testal,thickening,trichome,vine,wall,woody	-3,1,2,apex,apparently,eed,epiphytic,fide,long,markedly,minute,nee,noddin,occasionally,older,shreddy,wide	2-3,appressed,breeding,calyx,colour,form,fruit,hair,inflated,length,mature,na,nodding,number,plant,prickle,pseudostipule,shape,system,texture,type,width	0.5,1.5-2,10-12,4-6,6,6-8,<,almost,center,cm,completely,deeply,exfoliating,flattened,glabrous,golden,lateral,liana,margin,minutely,mm,multiseriate,pale,pitted,rectangular,reniform,rib-like,seed,shiny,sinuate,tan,thickening,vine,wall,woody	2-3,na,nodding
290	wfo-0001029156	success	65	65	39	46	19	19	33	6	0.5,1,1.5-2,10-12,2,4-6,6-8,<,berry,cell,center,cm,deeply,diameter,flattened,fruiting,glabrous,golden,growth,lateral,liana,margin,minute,minutely,mm,multiseriate,new,pale,pedicel,per,pitted,rectangular,reniform,rib-like,seed,shiny,sinuate,stem,surface,tan,testal,thickening,trichome,vine,wall,woody	-3,almost,apex,apparently,ark,completely,eed,em,epiphytic,exfoliating,fide,lon,markedly,nee,noddin,occasionally,older,shreddy,x	2-3,6,bark,colour,exfoliation,form,fruit,height,length,long,na,nodding,number,plant,reproduction,shape,type,width,ye	0.5,1,1.5-2,10-12,2,4-6,6-8,<,berry,center,cm,deeply,flattened,golden,lateral,liana,margin,minute,minutely,mm,multiseriate,pale,pitted,rectangular,reniform,rib-like,seed,sinuate,tan,thickening,vine,wall,woody	2-3,6,long,na,nodding,ye
291	wfo-0001029163	success	148	130	61	75	73	55	56	5	0.3-2.5,0.5-1,1-2,1.5-2.5,1.5-3,13-18,2,2-18,2-3,2-6,2.5-3,3-4,4-20,4-6,5-8,7-9,acuminate,acute,apex,base,calyx,cell,chartaceous,cm,connivent,cuneate,cylindrical,decurrent,deltate,densely,diameter,distally,elliptic,elliptic-ovate,entire,free,fruit,glabrous,globose,hair,herb,lanceolate,lenticular,lobe,margin,mm,moderately,nearly,obtuse,pedicel,peduncle,petiole,pore,pseudohair,puberulent,puberulent-pubescent,purple,rachi,radiu,shrub,simple,slightly,stellate,stem,stigma,stone,style,subcoriaceous,unbranched,unit,unknown,white,whitish,x,yellow	-4,-9,1,1.5-2,10-20-30,2-7,20-30,3-14,3-5,4-5-foliat,4.5-23,5-12-25,9-15,abaxial,abaxially,absen,adaxiall,adaxially,aggregate,apart,articulated,axe,band,blade,color,denser,directed,distall,eaf,eed,eglandular,flower,glandular,leaving,like,lon,long,lower,narrowed,narrowly,nflorescence,nther,orolla,papillose,pedicellar,perennial,projection,puberulent-pubescen,pubescence,remnant,ripe,roughened,ruit,scale-like,small,sometimes,spaced,sparsely,stalked,subapical,surface,tal,tem,thickened,time,tip,triangular,truncat,tube,vary,vein,wide,ympodial	10-30,4-5-foliate,absent,anther,articulation,bract,branching,breeding,colour,connective,corolla,filament,form,fruiting,growth,height,heteromorphism,inflorescence,insertion,interjected,interpetalar,leaf,leaflet,length,marking,mature,modification,na,odour,orientation,ovary,paired,pattern,placement,plant,position,prickle,pseudostipule,rhizome,scale,seed,shape,size,spot,staman,structure,symmetry,sympodial,system,texture,tissue,truncate,tuber,type,xylopodia	0.3-2.5,0.5-1,1-2,1.5-2.5,1.5-3,13-18,2,2-18,2-3,2-6,2.5-3,3-4,4-20,4-6,5-8,7-9,acuminate,acute,base,chartaceous,cm,connivent,cuneate,cylindrical,decurrent,deltate,densely,distally,elliptic,elliptic-ovate,entire,free,glabrous,globose,herb,lanceolate,lenticular,mm,moderately,nearly,obtuse,pseudohair,puberulent,puberulent-pubescent,purple,shrub,simple,slightly,stellate,subcoriaceous,unbranched,unknown,white,whitish,x,yellow	10-30,4-5-foliate,absent,na,truncate
292	wfo-0001029171	success	137	131	61	77	60	54	58	3	-,-10,-10-15,1-3,1-4.5,1-5,1.5-2,1.5-7.5,10-25,10-35,2-3,3-4,3.5-18,3.5-6.5,4-10-15,5-8,6-,8-17,acuminate,acute,apart,apex,base,branched,calyx,cell,chartaceous,cm,cuneate,decurrent,deltate,dendritically,densely,diameter,eglandular,elliptic,entire,flower,forked,fruit,glabrous,gland,globose,hair,lanceolate,lobe,margin,mm,moderately,narrowly,orange,ovate-elliptic,pedicel,peduncle,perfect,petiole,pore,puberulent,pubescent,purple,rachi,radiu,rarely,red,ripe,shrub,simple,slightly,sometimes,stellate,stone,triangular,tube,unbranched,unit,white,x	0.5,11-20,4-5,5-6,7-9,abaxially,abruptly,absen,adaxially,aggregate,also,and/or,angled,articulated,axe,ba,blade,connivent,cylindrical,dense,directed,distall,eaf,eed,except,glandula,glandular,like,long,lower,many-foliat,midrib,narrowed,near,nearly,nflorescence,nther,obtuse,often,orolla,rugose,ruit,shoot,short-stalked,smooth,spaced,sparsely,ste,stigma,style,tal,tem,time,tip,truncat,usually,vary,wide,yellow,ympodial	absent,anther,articulation,axi,bract,branching,breeding,colour,connective,corolla,filament,form,fruiting,growth,height,heteromorphism,inflorescence,insertion,interjected,interpetalar,leaf,leaflet,length,many-foliate,marking,modification,na,number,odour,orientation,paired,pattern,placement,plant,position,prickle,pseudostipule,rhizome,scale,shape,size,spacing,spot,staman,stem,structure,symmetry,sympodial,system,texture,tissue,tuber,type,xylopodia	-,-10,-10-15,1-3,1-4.5,1-5,1.5-2,1.5-7.5,10-25,10-35,2-3,3-4,3.5-18,3.5-6.5,4-10-15,5-8,6-,8-17,acuminate,acute,apart,base,branched,chartaceous,cm,cuneate,decurrent,deltate,dendritically,densely,eglandular,elliptic,entire,forked,glabrous,globose,lanceolate,mm,moderately,narrowly,orange,ovate-elliptic,perfect,puberulent,pubescent,purple,rarely,red,ripe,shrub,simple,slightly,sometimes,stellate,triangular,unbranched,white,x	absent,many-foliate,na
293	wfo-0001029215	success	49	97	34	37	12	60	31	3	-1.8-2.3,0.3-0.5,0.5-0.7,0.5-2.5,1,2.3-2.9,appearance,border,brown,calyx,cell,cm,coarse,diameter,elongating,entire,fruit,hair-like,herb,lateral,lobe,markedly,mm,narrowly,obovate,outgrowth,pubescent,round,shrub,silky,small,smelling,strong,testa,wall,winged,woody	.2,eed,fide,give,long,spreadin,surface,tall,thick,weigend,wide,xyledecor	0.2,anther,apex,articulation,base,bract,branching,breeding,colour,connective,corolla,elongation,filament,form,growth,hair,height,heteromorphism,inflorescence,insertion,interjected,interpetalar,leaf,leaflet,length,margin,marking,modification,na,odour,orientation,paired,pattern,pedicel,petiole,placement,plant,pore,position,prickle,pseudostipule,rhizome,seed,shape,spot,spreading,staman,stone,structure,symmetry,sympodial,system,texture,thicknes,tissue,tuber,type,unit,width,xylopodia	-1.8-2.3,0.3-0.5,0.5-0.7,0.5-2.5,1,2.3-2.9,brown,cell,cm,coarse,elongating,entire,hair-like,herb,lateral,markedly,mm,narrowly,obovate,outgrowth,pubescent,round,shrub,silky,small,smelling,strong,testa,wall,winged,woody	0.2,na,spreading
294	wfo-0001029216	success	240	116	60	71	169	45	52	8	0.4-0.5,0.5,1.2-6,2,2-locular,3-foliate,absent,accrescent,allogamous,and/or,anther,apex,apical,appendage,articulation,base,basiscopically,branch,bright,calyx,cell,cm,corolla,decurrent,deep,distal,facultatively,filament,fruit,fruiting,glabrescent,globose,herb,imparipinnate,inflorescence,interjected,interrupted,leaflet,length,linear,long,lower,margin,minute,mm,multicellular,multilocular,oblique,often,orange,pedicel,pentagonal,petiole,present,pseudostipule,pubescent,rarely,red,shape,simple,sparsely,stem,sterile,strong,surface,unicellular,uniseriate,unit,usually,varying,yellow	+,-5,.5,.8-1,0.1-0.3,0.1-0.5,0.1-0.6,0.1-0.8,0.2-0.25,0.2-0.3,0.2-0.3-0.5,0.2-0.4,0.2-0.8,0.3-0.4,0.3-0.5,0.3-2,0.4,0.5-0.8,0.5-1.5,0.5-2,0.6-0.8,0.6-1,0.8-2.5,1-1.2,1-2,1-3,1-4,1-6,1.5-2.3,1.5-2.5-10,1.5-3,1/,10,10-14,10-20-35,2-4.5,2.5-3.3,3,3-4,3-5,3-7,3-7-10,4,5,5-15-flower,6-10,<,absen,acroscopically,acute,adpressed,always,angeld,annual,anthesi,appearance,articulated,attenuate,axi,basal,becoming,biennial,brown,capitate,cente,column,composed,cone,conical,cordate,crenate,cultivar,deeply,dentate,diameter,eaf,edicel,eed,elliptic,entire,erect,exserted,extending,fasciated,fruited,giving,gland-tipped,glandular,gree,green,hair-like,half,halfway,included,initially,internode,lanceolate,large,larger,later,lateral,less,like,lobe,lobulate,lon,longer,mainly,maturity,minutely,mixture,narrowly,near,nflorescence,numerous,obovate,one,outgrowth,ovary,ovate,pair,pale,particularly,peduncle,perennial,petiolule,plant,population,primary,procumbent,reflexe,ruit,scen,secondary,sessile,shaggy,shaped,short,silky,sometimes,somewhat,sparse,spreading,staminal,stigma,straight,strongly,style,tangled,tem,terminal,tertiary,testa,thick,thickening,tip,total,toward,trichome,truncate,tube,ud,variety,villous,viny,wall,wide,winged,ympodial	1/3,appressed,bract,branching,breeding,broad-based,colour,connective,form,growth,hair,heteromorphism,inflated,insertion,interpetalar,leaf,marking,mature,modification,na,needle-like,odour,orientation,paired,pattern,placement,pore,position,prickle,rhizome,scale,scent,spot,staman,stone,structure,symmetry,sympodial,system,texture,tissue,tuber,type,xylopodia,zygomorphy	0.4-0.5,0.5,1.2-6,2,2-locular,3-foliate,absent,accrescent,allogamous,and/or,apical,appendage,basiscopically,branch,bright,cm,decurrent,deep,distal,facultatively,glabrescent,globose,herb,imparipinnate,interrupted,linear,long,lower,minute,mm,multicellular,multilocular,oblique,often,orange,pentagonal,present,pubescent,rarely,red,shape,simple,sparsely,stem,sterile,strong,surface,unicellular,uniseriate,usually,varying,yellow	1/3,broad-based,leaf,na,needle-like,prickle,scent,zygomorphy
295	wfo-0001029226	success	206	113	58	69	137	44	54	4	1-1.5,1-2,1-3,3-3.5,anther,apex,articulated,base,berry,branched,bright,calyx,cell,cm,cordate,corolla,decurrent,ellipsoid,entire,filament,fruiting,globose,green,growth,herbaceous,lateral,lavender,leaf,lengthening,like,lobe,lobed,long,lower,many,margin,membranous,mm,open,pale,pedicel,petiole,pinnatifid,pore,poricidal,pubescent,red,shrub,simple,sleeve,slender,slit,small,spot,spreading,stellate,stem,surface,terminal,thin,time,tip,trichome,unit,vine,way,white,wide,¾	-7,-9,.5,.75,0-1,0.5,0.5-5,1-celled,10-40+,2,2-3,2-6,2-9,2.5-10,3-6,30,4,4-6,5-7,5-merou,7-11,8-13,>,acuminate,acute,ag,alyx,anthesi,apart,apparently,ark,ba,basal,black,blue,breaking,capitate,completely,congested,conical,connivent,dark,deltate,densely,diameter,distall,divided,dry,eaf,eed,elongate,enation,exserted,flattened,flexuous,flower,free,glabrescent,glabrous,gland,glandular,hairy,ilament,irregularly,juice,longer,loosely,lyrate,material,mature,mere,minute,minutely,new,nflorescence,occasionally,often,older,one,orolla,overtopping,pair,papillat,papillate,papillo,peduncle,per,perfect,pinnate,pitted,plurifoliat,portion,primary,reflexed,remainin,reniform,rim,ripe,ruit,sagittate,scar,scarlet,seed,shiny,short-glandular,shorter,sometimes,spaced,sparsely,sprawling,spreadin,staining,stigma,strongly,style,tan,tangled,tem,testal,third,translucent,truncate,tube,twinin,ud,uniformly,uniseriate,usually,vary,vein,wall,weak,widest,winged,woody,yellowish,ympodial	age,articulation,bract,branching,broad-based,colour,form,fruit,hair,heteromorphism,inflorescence,insertion,interjected,interpetalar,leaflet,length,marking,na,needle-like,odour,orientation,paired,placement,plurifoliate,position,prickle,pseudostipule,rhizome,scale,shape,smell,staman,stone,structure,symmetry,sympodial,texture,tissue,tuber,twining,type,vegetative,width,xylopodia	1-1.5,1-2,1-3,3-3.5,articulated,base,berry,branched,bright,cm,cordate,decurrent,ellipsoid,entire,globose,green,herbaceous,lateral,lavender,lengthening,like,lobe,lobed,long,many,membranous,mm,open,pale,petiole,pinnatifid,pore,poricidal,pubescent,red,shrub,simple,sleeve,slender,slit,small,spot,spreading,stellate,stem,terminal,thin,time,tip,vine,way,white,wide,¾	age,na,plurifoliate,twining
296	wfo-0001029236	success	159	140	62	83	76	57	60	2	0.2-0.7,0.45-0.5,0.5-1.5,0.9-2.3,1-1.5,1-2,1/2,3,6-9,abaxially,absent,anther,anthesi,apex,apically,bark,base,berry,branching,cm,coriaceous,corolla,deflexed,dendritic,densely,diameter,dichasial,elliptic,filament,flattened,fleshy,fruit,fruiting,glabrous,globose,grey-brown,growth,leaf,lenticular,lobed,lower,margin,middle,mm,narrowly,near,nodding,obscurely,occasionally,ovary,pale,pedicel,per,petiole,plurifoliate,pointed,pore,poricidal,prominent,pubescent,purplish,purplish-black,reddish-brown,revolute,scar,scattered,shrub,sleeve,slightly,stem,stigma,strongly,style,surface,terminal,tip,trichome,tube,unit,violet,way,winged,x	.5,0.2-1,0.5,1.4-1.7,2-4,2-5,adaxial,age,apical,apparently,appearing,axi,ba,basal,becoming,bi-lobe,branch,branchlet,broadly,calyx,compact,completely,conical,cupulate,decurrent,deltate,eaf,edicel,eed,erect,ew,except,exserted,flower,free,inserted,later,lateral,less,lobe,long,m.,many,midvein,minutely,nflorescence,obscure,older,overtopping,packe,pericarp,persistent,pitted,portion,ruit,secondary,shiny,shoot,short,simple,slit-like,sparsely,stamen,tall,tapering,thin,time,trongly,tub,ud,usually,venation,wide,woody,ympodial,young	articulation,bi-lobed,bract,breeding,broad-based,bud,cell,colour,connective,deflexion,form,hair,height,heteromorphism,inflorescence,insertion,interjected,interpetalar,leaflet,length,marking,modification,na,needle-like,new,number,odour,orientation,pattern,placement,plant,position,prickle,prominence,pseudostipule,pubescence,rhizome,scale,seed,shape,size,smell,spot,staman,stone,structure,symmetry,sympodial,system,texture,tissue,tuber,type,vegetative,width,winging,xylopodia	0.2-0.7,0.45-0.5,0.5-1.5,0.9-2.3,1-1.5,1-2,1/2,3,6-9,abaxially,absent,anthesi,apex,apically,base,berry,cm,coriaceous,deflexed,dendritic,densely,diameter,dichasial,elliptic,flattened,fleshy,glabrous,globose,grey-brown,lenticular,lobed,middle,mm,narrowly,near,nodding,obscurely,occasionally,pale,plurifoliate,pointed,poricidal,prominent,pubescent,purplish,purplish-black,reddish-brown,revolute,scattered,shrub,sleeve,slightly,strongly,terminal,tip,trichome,violet,way,winged,x	bi-lobed,na
297	wfo-0001029246	success	207	98	51	60	147	38	49	2	/5,0.1-0.4-1.5,1-1.5,3.5-5,8-16,abaxially,acuminate,anther,apex,articulated,base,berry,c.,calyx,chartaceous,cm,connivent,cuneate,elongating,entire,equal,filament,flattened,fruit,fruiting,lateral,leaf,length,lobed,long,margin,mature,maturity,mauve,midvein,mm,moderately,narrow-deltate,orange-red,pale,pedicel,petiole,poricidal,prickle,purple,recurved,shrub,simple,sometimes,sparsely,spherical,stellate-pubescent,straight,surface,tapering,tip,unbranched,unit,way,white	-4,0-1,0-15,0-5,0.1-0.3,0.15-0.3,0.2-1.5,0.3-0.5,0.3-0.8,0.5,0.5-1.5,0.7-1.3,0.7-1.5,0.7-2,0.8-1.1,0.8-3,0.9-1.3,1-1.8,1-10,1-3,1-4,1-5,1-8,1.2-2,1.5-2.3,1.5-2.5,1.5-6,1.7-6,1.8-3,1/10-1/5,1/3,2,2-3,2-3.5,2-5,2.5-3.2,2.8-4,2/3,2/3-3/,3-20,3-5,4-6,5-20,5-6-8,5-merous,6-10,6-8,7-12,abaxial,acuminat,acute,adaxial,almost,alyx,apar,apart,apically,apparently,bark,blade,broad-deltate,concolorous,curved,deltate,densely,diameter,discolorous,distance,drying,dull,eaf,eed,elliptic,erect,extending,eye,flattened-reniform,flower,free,glabrescent,glabrous,infructescence,less,lobe,lon,longer,lower,midpoint,naked,narrow-ovate,nflorescence,oblong,obtuse,older,one,open,orange-brow,orange-brown,orolla,oung,pair,peduncle,pendulous,per,perfec,pericarp,plurifoliat,porrect,portion,prickl,prickly,primary,procumbent,pubescent,ray,rounded,ruit,scar,sessile,side,smooth,spaced,spreading,stellate,stem,stout,strongly,style,tamen,terete,tertiary,time,trichome,tube,unarmed,upper,usually,vary,vein,venation,visible,wide,woody,yellow,yellow-orange,ympodial,¼	articulation,bract,branching,cell,colour,corolla,form,growth,hair,heteromorphism,inflorescence,insertion,interjected,interpetalar,leaflet,marking,na,odour,orientation,paired,placement,plurifoliate,position,pseudostipule,rhizome,scale,shape,spot,staman,stone,structure,symmetry,sympodial,texture,tissue,tuber,type,xylopodia	/5,0.1-0.4-1.5,1-1.5,3.5-5,8-16,abaxially,acuminate,articulated,base,berry,c.,chartaceous,cm,connivent,cuneate,elongating,entire,equal,flattened,fruit,lateral,length,lobed,long,mature,maturity,mauve,midvein,mm,moderately,narrow-deltate,orange-red,pale,poricidal,purple,recurved,shrub,simple,sometimes,sparsely,spherical,stellate-pubescent,straight,surface,tapering,tip,unbranched,way,white	na,plurifoliate
298	wfo-0001029286	success	224	134	75	100	124	34	71	4	0-0.5,0.4-1.2,0.8,1-1.5,1.5-2,1.5-4,2-3,2.5-3,4-5,4-6,4.5-7,5-6,6-9,7-10,abaxial,abaxially,acute,adaxially,almost,anther,apex,apiculate,articulation,attenuate,bark,base,branched,branching,broadly,brown,capitate,chartaceous,clustered,cm,conical,corolla,dendritic,density,diameter,domatia,entire,faint,filament,flat,formed,glabrescent,glabrous,green,grey,hair,increasing,inside,isolated,leaf,length,liana,light,lilac,lobed,margin,mauve,membranous,midvein,minutely,mm,oblong,obovate,outside,pair,pedicel,peduncle,petiole,pore,poricidal,primary,prominent,raised,scar,simple,smooth,sometimes,sparsely,stem,stigma,stump,style,surface,terminal,tertiary,time,tip,toward,translucent-violet,trichome,tube,unarmed,unit,vein,venation,x	.4,.5,0.1,0.15-0.4,0.6-1.2,0°,1-2,1.5-8,1/8,15-50,3-4,4.5,5,6-8,abscising,age,along,altered,alyx,another,anthesi,apar,apart,apically,apice,apparently,arising,around,articulated,axil,becoming,branch,canaliculate,clearly,closer,concave,concolorous,crenulate,curved,cuspidate,delineated,deltoid,dilated,distributed,drying,eaf,eed,equal,except,extending,fertilization,flexuous,flower,forming,free,fresh,globo,inflorescenc,junction,know,known,lamina,lengthening,less,lobe,long,lower,m.,main,margi,mas,meeting,middle,much,multicellular,narrowly,nflorescence,nther,obconical,occasional,often,one,orolla,ovate,papillo,perfec,plurifoliat,portion,protruding,rachi,rarely,regular,rounded,ruit,separated,shallowly,side,slender,smaller,somewhat,soon,specimen,spreading,stretchy,tangled,tearing,terete,textur,thick,thickened,thinner,tissue,together,translucent,tuft,ud,uneven,vary,visible,wide,widely,yellowish,ympodial,young	arrangement,breeding,bud,colour,connective,form,fruit,globose,growth,habit,inflorescence,marking,modification,na,number,odour,ovary,papillose,pattern,plant,plurifoliate,position,prominence,protrusion,seed,shape,spacing,spot,structure,symmetry,sympodial,system,texture,type	0-0.5,0.4-1.2,0.8,1-1.5,1.5-2,1.5-4,2-3,2.5-3,4-5,4-6,4.5-7,5-6,6-9,7-10,abaxially,acute,adaxially,almost,anther,apex,apiculate,attenuate,base,branched,broadly,brown,capitate,chartaceous,clustered,cm,conical,dendritic,entire,faint,flat,formed,glabrescent,glabrous,green,grey,increasing,inside,isolated,liana,light,lilac,lobed,mauve,membranous,minutely,mm,oblong,obovate,outside,pair,poricidal,prominent,raised,simple,smooth,sometimes,sparsely,stump,terminal,time,tip,toward,translucent-violet,trichome,unarmed,x	globose,na,papillose,plurifoliate
299	wfo-0001029310	success	214	102	44	58	156	44	42	2	.5,2-3.5,20-60,5-6,accrescent,andromonoecious,anther,apex,articulated,base,berry,branched,calyx,cm,conical,connivent,cordate,difoliate,enclosing,equal,filament,fruit,fruiting,hair,herb,inflated,lateral,leaf,length,lobed,long,lower,margin,mature,mauve,membranous,mm,pedicel,perpendicular,petiole,pinnatifid,poricidal,prickle,shrub,simple,spherical,stellate,stem,straight,strongly,surface,tapering,tip,tissue,toward,truncate,unit,yellow	.1,.6,/4,/6,0-20,0-5,0.1-0.2,0.2-0.3,0.2-0.8,0.5,0.5-3,0.6-1.1,00,1,1-1.5,1-2,1-4,1.2-1.5,1.8-3,1/,10,10-13-16,10-15,10-20,15-20-25,2-4,2.5-6,2/3-3/4,20-40,200-500,3-4,3-5,3.5,4-10,4-8,45-60,5,5-10,5-12,5-20,5-30,5-7,5-8,5-merous,6-8,7-12,7-13,8,abaxially,acute,alyx,ame,apar,apart,apically,apparently,bark,beyond,blade,brown,c.,concolorous,dark,deltate,diameter,distal,distance,drying,dull,eaf,eed,elliptic,elongating,erect,extending,filifor,flattened-reniform,flower,free,geminat,gently,glabrescent,glabrous,gray,hermaphrodite,heterostylous,infructescence,lobe,lobing,lon,long-styled,longer,lowermost,maturity,midpoint,midvein,minute,moderately,narrow-deltate,nflorescence,older,one,open,orange-green,ornately,orolla,oung,pair,peduncle,pendent,pendulous,per,pericarp,plant,porrect,portion,prickl,prickly,primary,ray,recurved,red-brow,retrorse,ruit,scar,secondary,sessile,short-styled,shorter,side,smooth,sometimes,spaced,sparsely,spreading,stalk,stalked,staminat,stellate-pubescent,stout,style,tamen,terete,tertiary,time,trichome,tube,variously,vary,vein,venation,visible,way,wide,woody,ympodial	appressed,articulation,bract,branching,breeding,broad-based,cell,colour,connective,corolla,form,geminate,growth,heteromorphism,inflorescence,insertion,interjected,interpetalar,leaflet,marking,modification,na,needle-like,odour,orientation,paired,pattern,placement,position,pseudostipule,rhizome,scale,shape,spot,staman,stone,structure,symmetry,sympodial,system,texture,tuber,type,xylopodia	.5,2-3.5,20-60,5-6,accrescent,andromonoecious,apex,articulated,base,berry,branched,cm,conical,connivent,cordate,difoliate,enclosing,equal,hair,herb,lateral,lobed,long,mature,mauve,membranous,mm,perpendicular,pinnatifid,poricidal,shrub,simple,spherical,stellate,stem,straight,strongly,tapering,tip,toward,truncate,yellow	geminate,na
300	wfo-0001029317	success	151	90	33	42	109	48	30	3	0.5,1,7-8,anther,apex,attenuate,base,calyx,corolla,densely,difoliate,filament,fruiting,geminate,inflorescence,leaf,lobed,long,margin,minutely,mm,narrowly,nearly,opposite,ovate,papillose,pedicel,petiole,pore,poricidal,probably,pubescent,shaped,shrub,soft,tear-drop,tip,trichome,uniseriate,unit,white,x	.5,0.25,0.5-0.75,0.5-1,0.8-1,1-1.5,1.5-3.5,10-16,10-30-flowered,11-14,2-3,2.5-5,6-8,6.5-11,8-9,acuminate,along,anthesi,apar,area,barely,beneath,broadly,brow,bud,ca,channeled,closely,cm,cup-like,deciduou,deflexed,deltoid,denser,dia,differing,dry,eaf,edicel,eed,ellipsoi,epidermi,erect,exserted,extreme,free,frui,glabrate,glabrous,globose,grayish,immature,known,lateral,like,lobe,lon,lower,main,major,middle,minor,nflorescence,occasionally,often,older,one,otherwise,ovary,overlapping,ovoid,pair,paler,portion,prominent,proximal,rachi,raised,reflexed,remaining,rest,rounded,ruit,scar,simple,size,slender,slightly,soon,spaced,sparsely,specimen,stem,stigma,straight,styl,style,tall,tapering,thickened,tube,tuft,ud,vein,visible,widest,yellowish,ympodial,young	2,appressed,articulation,bract,branching,breeding,cell,colour,connective,form,fruit,growth,hair,heteromorphism,inflated,insertion,interjected,interpetalar,leaflet,length,marking,mature,modification,na,odour,orientation,paired,pattern,placement,position,prickle,pseudostipule,rhizome,scale,shape,spot,staman,stellate,stone,structure,symmetry,sympodial,system,texture,tissue,tuber,type,xylopodia	0.5,1,7-8,attenuate,base,densely,difoliate,geminate,leaf,lobed,long,minutely,mm,narrowly,nearly,opposite,ovate,papillose,poricidal,probably,pubescent,shaped,shrub,soft,tear-drop,tip,trichome,uniseriate,white,x	2,na,stellate
301	wfo-0001029332	success	196	116	48	63	133	53	43	5	1-1.5,1-3,1.5-2,1/3,2-2.5,4-10,8.5-9.5,abaxial,adaxial,andromonoecious,anther,apex,articulated,base,berry,calyx,chartaceous,cm,connivent,cordate,curved,densely,difoliate,elongating,erect,filament,flattened-reniform,flower,fruit,fruiting,glabrescent,lateral,leaf,length,lobed,long,lower,margin,mature,mauve,mm,orange-brown,ovate,pale,pedicel,petiole,poricidal,prickle,rounded,shrub,simple,spherical,spreading,stellate,stellate-pubescent,stem,surface,terminal,trichome,unbranched,unit,weakly,yellow	.5,/3,0,0-0.5,0-100,0-2,0-20,0-4,0-5,0.1,0.1-0.2,0.15-0.2,0.15-0.25,0.5-1,0.8-1,1-2,1-4,1.3-1.5,1/2,1/4,1/4-1/3,10-30,2,2-4,2.5-3.5,2.8-3.7,2/,2/3-3/4,3-4,3-6,3.5-5,4-15,5-6,5-8,5-merous,6-8,abaxially,alyx,apar,apart,apically,apparently,bark,becoming,blade,broad-deltate,concolorous,conical,diameter,distal,distance,drying,eaf,eed,equal,extending,flattened,free,geminat,glabrous,gland,globular,grayi,herbaceous,hermaphrodite,heterostylous,infructescence,less,lobe,long-acuminat,long-styled,longer,lowermost,maturity,midpoint,midvein,moderately,narrow-deltate,nflorescence,often,older,one,open,orolla,oung,pair,peduncle,pendulous,per,pericarp,plant,porrect,portion,prickl,prickly,primary,pubescent,ray,reduced,ruit,scandent,scar,sessile,short-styled,shorter,side,slender,smooth,spaced,stalk,stalked,staminat,style,subsessile,tamen,tapering,terete,tertiary,time,tip,tube,upper,variously,vary,vein,venation,visible,way,wide,woody,yellow-green,yellow-orange,ympodial	50-100,articulation,bract,branching,breeding,broad-based,cell,colour,connective,corolla,form,geminate,growth,hair,heteromorphism,inflorescence,insertion,interjected,interpetalar,leaflet,marking,modification,na,needle-like,number,odour,orientation,pattern,placement,pore,position,pseudostipule,rhizome,scale,seed,shape,smell,spot,staman,stone,structure,symmetry,sympodial,system,texture,tissue,tuber,type,vegetative,width,xylopodia,ye,zygomorphy	1-1.5,1-3,1.5-2,1/3,2-2.5,4-10,8.5-9.5,andromonoecious,articulated,base,berry,chartaceous,cm,connivent,cordate,curved,densely,difoliate,elongating,erect,flattened-reniform,glabrescent,lateral,lobed,long,lower,mauve,mm,orange-brown,ovate,pale,poricidal,rounded,shrub,simple,spherical,spreading,stellate,stellate-pubescent,terminal,unbranched,weakly,yellow	50-100,geminate,na,ye,zygomorphy
302	wfo-0001029333	success	155	147	84	95	60	52	77	7	.25,.5,/4,0.5,0.7-1,1-1.2,1-1.5,1-15,1-2,1-3,1-7,1.5-2,1.5-2.5,1.5-3,10-15-flowered,17-26,2-2.5,3-7,3-7.5,5-6,8-15,abaxial,abaxially,acuminate,acute,adaxially,anther,apex,auriculate,base,berry,broadly,calyx,clavate,cm,conical,corolla,dendritic,dendritic-pubescent,dia,difoliate,elliptic-obovate,filament,flattened-reniform,flower,fruiting,geminate,glabrous,globose,green,incrassate,leaf,lobed,long,long-styled,margin,minor,minutely,mm,obovate,occasionally,opposite,orbicular,ovary,pale,paler,pedicel,petiole,pitted,pore,pubescent,reddish-brown,rounded,sessile,shape,shaped,shining,short-styled,shrub,size,small,somewhat,stigma,style,surface,tear-drop,time,tree,trichome,truncate,tube,type,unit,way,wide	0.5-1,100,9-13,along,anisophyllou,anthesi,ba,bark,beige,beneath,contracted,deflexed,densely,denser,differing,dry,eaf,edicel,eed,erect,exserted,free,fresh,golden,heteromorphic,inflorescenc,lateral,like,lobe,lon,lower,main,major,nflorescence,older,overlappin,pair,papillo,planar,poricidal,portion,present,pubescence,rest,ruit,scar,simple,slender,spaced,sparsely,stem,strongly,tall,tip,triangular,ud,vein,woody,ympodial,young	1,anisophyllous,articulation,bract,branching,breeding,cell,colour,connective,diameter,form,fruit,growth,hair,height,heteromorphism,inflorescence,insertion,interjected,interpetalar,leaflet,length,marking,mature,modification,na,number,odour,orientation,papillose,pattern,placement,plant,position,prickle,pseudostipule,rhizome,scale,seed,spot,staman,stellate,stone,structure,symmetry,sympodial,system,texture,tissue,tuber,width,xylopodia	.25,.5,/4,0.5,0.7-1,1-1.2,1-1.5,1-15,1-2,1-3,1-7,1.5-2,1.5-2.5,1.5-3,10-15-flowered,17-26,2-2.5,3-7,3-7.5,5-6,8-15,abaxial,abaxially,acuminate,acute,adaxially,apex,auriculate,base,berry,broadly,clavate,cm,conical,dendritic,dendritic-pubescent,dia,difoliate,elliptic-obovate,flattened-reniform,geminate,glabrous,globose,green,incrassate,leaf,lobed,long,long-styled,margin,minutely,mm,obovate,occasionally,opposite,orbicular,pale,paler,pitted,pubescent,reddish-brown,rounded,sessile,shaped,shining,short-styled,shrub,small,somewhat,surface,tear-drop,time,tree,trichome,truncate,way,wide	.7-1,1,anisophyllous,di,na,papillose,stellate
303	wfo-0001029334	success	211	112	48	61	150	51	44	4	0-4,1,1-2,1.3-4.5,4-5.5,absent,almost,anther,apex,articulated,base,berry,borne,cell,chartaceous,cm,cordate,corolla,densely,end,filament,forked,fruit,glabrous,globose,green,hair,herb,homostylous,interjected,lanceolate,leaflet,long,lower,margin,membranous,mm,oblique,odd-pinnate,ovoid,pedicel,petiole,plurifoliate,pore,poricidal,puberulent,pure,ripe,rounded,singly,stellate,stem,terminal,tinged,tip,tri-,tuber,typically,unit,violet,white	.2,0.15-0.3,1-10,1-3,1-6,1.5-3.9,1.5-6,1.8-2.9,2,2-2.5,2-4,2-5,2-8,2.5-3,3-5,3-7,3.2-5.8,3.3-6.5,4-8.5,5-10,5-merou,7.5-15.5,8-30,9-12,abaxially,acumen,acute,adaxially,ag,along,alyx,among,apart,apparently,attenuate,axe,axillary,blade,broadly,brownish,bud,capitat,ciliate,clavate,condition,connivent,covering,cuneate,decreasing,decurrent,diameter,digestion,distal,dorsally,drying,eaf,edge,eed,elliptic,enzyme,erect,especially,exceeding,except,flat,flower,folded,fresh,geminat,generally,glabrou,gradually,grassland,greatly,green-white,greenish,hair-like,half,honeycomb-shaped,lateral,lengthening,like,living,lobe,low-growin,make,middl,midrib,minutely,mucilaginous,narrowly,nflorescence,obtuse,often,orbicular,orolla,ovate,pair,peduncle,perfect,petiolulate,petiolule,plant,proximal,pubescent,rarely,reduced,removed,ruit,seed,semi-rosette,sessile,seudostipule,shady,short,situation,size,slightly,slit,spaced,specimen,stamen,ste,stigma,stolo,straight,style,subequal,subsessile,subtending,sunny,tall,tamen,tem,testal,thick,throughout,toward,tube,unwinged,usually,vary,wall,wet,whitish,wide,woodland,x,yellow,ympodial	appressed,articulation,bract,branching,broad-based,calyx,colour,connective,form,fruiting,geminate,growth,heteromorphism,inflated,inflorescence,insertion,interpetalar,leaf,length,marking,mature,middle,modification,na,needle-like,odour,orientation,paired,placement,position,prickle,pseudostipule,rhizome,scale,shape,smell,spot,staman,stolon,stone,structure,surface,symmetry,sympodial,texture,tissue,trichome,type,vegetative,xylopodia,zygomorphy	0-4,1,1-2,1.3-4.5,4-5.5,absent,almost,articulated,berry,borne,chartaceous,cm,cordate,densely,end,forked,glabrous,globose,green,herb,homostylous,lanceolate,long,membranous,mm,oblique,odd-pinnate,ovoid,plurifoliate,poricidal,puberulent,pure,ripe,rounded,singly,stellate,terminal,tinged,tip,tri-,tuber,typically,violet,white	geminate,middle,na,stolon
304	wfo-0001029344	success	147	100	40	53	94	47	36	4	0.4-1,0.5-1,0.5-1.5,1,1.5-3,2-3,abundant,acute,anther,apex,base,berry,brown,calyx,chartaceous,ciliate,cm,cordate,diameter,difoliate,drying,entire,filament,fruit,globose,hair,herb,immature,interpetalar,lobe,lower,margin,membranaceous,mm,moderately,oblong,obtuse,pedicel,petiole,pubescent,rhizomatous,rotate,rounded,semitransparent,sparsely,surface,tissue,triangular,tube,unit,white,x,yellow	.5,0.5-3,1-2,1-3,1-5,1-6,1.5,1.5-4,10-20,10-35,2-3-celled,2-4,2-7,3-10,4-6,5-12,5-15,abaxially,absent,adaxiall,adaxially,along,axe,beyond,blade,center,connected,decurrent,dehiscing,densely,denser,dm,eaf,edge,eed,elliptic,elliptic-ovoid,emarginat,equal,explosively,exserted,fine,flat,flower,frui,geminat,glabrous,held,lacking,linear-lanceolate,long,lying,maturing,maturit,mesocarp,nearly,nflorescence,notch,obvious,often,one-,orolla,parallel,peduncle,per,placenta,pressure,pubescen,rachi,radiating,raised,ridge,ruit,running,shallow,short,slightly,sometimes,stamen,stigma,straight,style,swollen,tal,tamen,tem,two-celled,unbranched,vary,vein,watery,wid,woody,ympodial	articulation,branching,broad-based,cell,colour,corolla,emarginate,form,fruiting,geminate,growth,heteromorphism,inflorescence,insertion,interjected,leaf,leaflet,length,marking,na,needle-like,odour,orientation,paired,placement,position,prickle,pseudostipule,pubescence,rhizome,scale,shape,smell,spot,staman,stem,stone,structure,symmetry,sympodial,texture,trichome,tuber,type,vegetative,xylopodia,zygomorphy	0.4-1,0.5-1,0.5-1.5,1,1.5-3,2-3,abundant,acute,apex,berry,brown,chartaceous,ciliate,cm,cordate,difoliate,drying,entire,globose,herb,immature,membranaceous,mm,moderately,oblong,obtuse,pubescent,rhizomatous,rotate,rounded,semitransparent,sparsely,triangular,white,x,yellow	emarginate,geminate,na,zygomorphy
305	wfo-0001029363	success	152	109	79	88	64	21	74	5	.25,.75,/4,0-0.1,0.1-0.5,0.2-1.1,0.5,0.5-1,1,1.5-1.7,1.5-3.5,3-7,4-11,6-7,anther,anthesi,axil,base,becoming,beneath,berry,bi-lobed,calyx,capitate,closely,cm,corolla,deflexed,dia,drying,edge,elliptic,filament,free,fruit,fruiting,glabrous,globose,green,internodal,lateral,leaf,lobe,lobed,long,main,meeting,minutely,mm,narrowly,occasionally,opposite,overlapping,pale,paler,papillose,pedicel,petiole,pore,poricidal,portion,pubescent,reflexed,scar,shrub,slender,slit-like,small,somewhat,spaced,stigma,style,surface,tapering,terminal,thickened,tip,tree,trichome,tube,tuft,uniseriate,unit,upon,usually,vein,way,white	1-1.2,2-6,5-7-flowered,6-8,7-10,acuminate,acute,apex,ba,bark,beginning,bud,coroll,cup-shaped,deep,deltoid,densely,eaf,edicel,eed,erect,except,exsertion,greyish,immature,inflorescenc,known,lamina,larger,later,lon,lower,margin,maroon,mature,middle,minute,much,near,nflorescence,obtuse,often,older,ovary,pair,papillo,prominent,ruit,shiny,simple,sparse,sparsely,stem,straight,tall,ud,unifoliat,white-papillose,wide,widest,woody,yellowish,ympodial,young	5-7,colour,diameter,flower,form,growth,inflorescence,length,marking,number,position,shape,spacing,spot,structure,symmetry,sympodial,texture,unifoliate,width,zygomorphy	.25,.75,/4,0-0.1,0.1-0.5,0.2-1.1,0.5,0.5-1,1,1.5-1.7,1.5-3.5,3-7,4-11,anthesi,axil,base,becoming,beneath,berry,bi-lobed,calyx,capitate,closely,cm,deflexed,dia,drying,edge,elliptic,glabrous,globose,green,internodal,lateral,leaf,lobe,lobed,long,main,meeting,minutely,mm,narrowly,occasionally,opposite,overlapping,pale,paler,papillose,pore,poricidal,pubescent,reflexed,shrub,slender,slit-like,small,somewhat,spaced,surface,tapering,terminal,thickened,tip,tree,trichome,tube,tuft,uniseriate,upon,usually,vein,way,white	-7,5-7,di,unifoliate,zygomorphy
306	wfo-0001029364	success	151	147	75	89	62	58	69	6	0.2-0.5,1-2-6,1-3,1-4,1-5,1.5-2,2,2-6,4-9,5-11,5-9,7-9,8-10,?,acuminate,anther,apart,apex,base,blue,calyx,cell,center,chartaceous,cm,corolla,cream,cuneate,cylindrical,deep,diameter,directed,distally,elliptic,entire,extra-axillary,fide,filament,finger,fruit,glabrous,gland-tipped,globose,green,greenish,hair,herb,immature,lobe,margin,membranaceous,minutely,mm,narrowly,nearly,obtuse,pedicel,peduncle,petiole,pore,presence,puberulent,pubescent,rachi,radiu,ripe,rusby,sagittate,shallow,shrub,side,simple,small,sparsely,spot,stellate,stigma,stone,strongly,style,tapered,triangular,unbranched,unit,unknown,vein,white,x,yellow	-2,-3,-6,.5,1,191.,2-4-12,2-foliat,3-4,5-10-27,6-8,8-15,abaxially,according,acute,adaxially,aggregate,around,articulated,axe,ba,bitter,blade,color,connivent,curled,darker,distall,eaf,ed,flower,free,glandular-puberulen,inserted,long,lower,major,mesocarp,moderately,nflorescence,orolla,ovate,part,perfect,present,puberulen,ruit,short-tomentose,shorter,spaced,tal,tamen,tem,thecae,tightly,time,tomento,truncat,tube,vary,wide,ympodial	1-2,10-27,2-foliate,4-12,abaxial,adaxial,appressed,articulation,bract,branching,breeding,colour,connective,form,fruiting,growth,height,heteromorphism,inflated,inflorescence,insertion,interjected,interpetalar,leaf,leaflet,length,marking,mature,modification,na,odour,orientation,ovary,paired,pattern,placement,plant,position,prickle,pseudostipule,rhizome,scale,seed,shape,size,spacing,staman,stem,structure,symmetry,sympodial,system,texture,tissue,truncate,tuber,type,xylopodia	0.2-0.5,1-2-6,1-3,1-4,1-5,1.5-2,2,2-6,4-9,5-11,5-9,7-9,8-10,?,acuminate,apart,base,blue,center,chartaceous,cm,corolla,cream,cuneate,cylindrical,deep,directed,distally,elliptic,entire,extra-axillary,fide,finger,glabrous,gland-tipped,globose,green,greenish,hair,herb,immature,lobe,membranaceous,minutely,mm,narrowly,nearly,obtuse,puberulent,pubescent,ripe,rusby,sagittate,shallow,shrub,side,simple,small,sparsely,spot,stellate,strongly,tapered,triangular,unbranched,unknown,white,x,yellow	1-2,10-27,2-foliate,4-12,na,truncate
307	wfo-0001029368	success	139	136	72	78	61	58	62	10	.2,.5,0.5-2,0.9-1,1.5-1.6,1.5-3,1.5-4,11-13,16-25,2-5,2.5-4,5-6,acuminate,acute,anther,apex,bark,base,berry,broadly,calyx,capitate,closely,cm,corolla,crumpled,densely,dia,distal,elliptic,erect,filament,fruit,fruiting,glabrous,globose,golden,green,half,herb,inflorescence,internodal,known,lateral,leaf,long,lower,main,margin,minutely,mm,obtuse,one,opposite,ovary,papillose,parallel,pedicel,petiole,pore,poricidal,puberulent,shaped,shrub,simple,somewhat,spaced,stem,stigma,style,tear-drop,tip,trichome,uniseriate,unit,vein,white,x	.25,0,1.5-2,?,abaxially,adaxially,along,anthesi,apparently,bearing,bitter,borne,breaking,brow,coarse,conical,cup,deflexed,eaf,edicel,eed,exserted,few-branched,fide,flattened,flower,free,indistinct,inflorescenc,lamina,lanceolate,leaving,like,lobe,margi,middle,midrib,minute,nflorescence,non-flower,older,overlappin,pair,papillo,portion,reflexed,rest,ruit,scar,straight,strongly,tall,tube,ud,unifoliat,upper,widest,winged,woody,ympodial,young	abaxial,adaxial,articulation,bract,branching,breeding,broad-based,brown,bud,cell,colour,connective,diameter,form,growth,hair,height,heteromorphism,insertion,interjected,interpetalar,leaflet,length,marking,modification,na,needle-like,odour,orientation,overlapping,paired,pattern,placement,plant,position,presence,prickle,pseudostipule,rhizome,scale,seed,shape,spot,staman,stone,structure,surface,symmetry,sympodial,system,texture,tissue,tuber,type,unifoliate,venation,width,xylopodia	.2,.5,0.5-2,0.9-1,1.5-1.6,1.5-3,1.5-4,11-13,16-25,2-5,2.5-4,5-6,acuminate,acute,apex,berry,broadly,capitate,closely,cm,crumpled,densely,dia,distal,elliptic,erect,glabrous,globose,golden,green,half,herb,inflorescence,internodal,known,lateral,leaf,long,lower,main,minutely,mm,obtuse,one,opposite,papillose,parallel,poricidal,puberulent,shaped,shrub,simple,somewhat,spaced,stem,tear-drop,tip,trichome,uniseriate,vein,white,x	.5-1.6,broad-based,brown,di,na,needle-like,overlapping,prickle,surface,unifoliate
308	wfo-0001029370	success	223	127	64	76	147	51	59	5	1-3,1.5-6,1/4-1/3,15-30,5-12,5.5-7,almost,andromonoecious,anther,apex,articulated,basal,base,berry,branched,calyx,chartaceous,cm,conical,connivent,cordate,cream,curved,discolorous,drying,elongating,equal,erect,filament,flattened,fruit,fruiting,green,herb,lateral,leaf,length,lobe,lobed,long,lower,margin,marking,mature,maturity,mauve,mm,multangulate,overlapping,pale,pattern,pedicel,perpendicular,petiole,poricidal,prickle,rotate,shrub,simple,slightly,sometimes,spherical,stalked,stem,straight,strongly,surface,tapering,tip,trichome,unit,way,white,wide,yellow,young	.1,.3,.5,/4,0-10,0-100,0-3,0-35,0.1,0.1-0.15,0.2,0.3,0.5-1,0.5-2.2,1,1-2,1-4,1.8-2.5,1.8-2.8,1/3-1/2,10-17,10-17-20,10-40,10-50,12-17,2-10,2-20,2-3,2-6,2.5-3.5,3-4,3.5-4,3.5-8,3/,4-6,4-7,4-9,5-10,5-merous,6-15-32,7-11,7-13,8-14,8-20,8-23,abaxial,abaxially,acut,adaxial,alyx,ame,apar,apart,apically,apparently,bark,blade,broad-deltate,c.,clearly,dark,densely,diameter,distal,distance,eaf,eed,elongate,extending,fewer,fine,flattened-reniform,flower,free,fully,gently,glabrescent,glabrous,greenish,hermaphrodite,heterostylous,infructescence,long-styled,longer,lowermost,midpoint,midvein,mixture,moderately,nflorescence,obtuse,often,older,one,open,opening,orange,orange-brown,ornate,orolla,oung,ovate,pair,peduncle,pendulous,per,pericarp,plant,plurifoliat,porrect,portion,prickl,prickly,primary,ray,red-brown,reticulate,rounded,ruit,scar,sessile,shiny,short-styled,side,smooth,spaced,spreading,stalk,staminat,stellate-pubescent,stout,style,tamen,terete,tertiary,time,tube,unarmed,variously,vary,vein,venation,visible,white-gra,whitish,woody,ympodial	appressed,articulation,bract,branching,breeding,broad-based,cell,colour,connective,corolla,form,growth,hair,heteromorphism,inflated,inflorescence,insertion,interjected,interpetalar,leaflet,mentioned,modification,na,needle-like,odour,orientation,paired,placement,plurifoliate,pore,position,pseudostipule,rhizome,scale,shape,smell,spot,staman,stellate,stone,structure,symmetry,sympodial,system,texture,tissue,tuber,type,vegetative,xylopodia,zygomorphy	1-3,1.5-6,1/4-1/3,15-30,5-12,5.5-7,almost,andromonoecious,articulated,basal,base,berry,branched,chartaceous,cm,conical,connivent,cordate,cream,curved,discolorous,drying,elongating,equal,erect,flattened,green,herb,lateral,lobe,lobed,long,marking,maturity,mauve,mm,multangulate,overlapping,pale,perpendicular,poricidal,rotate,shrub,simple,slightly,sometimes,spherical,stalked,stem,straight,strongly,surface,tapering,tip,way,white,wide,yellow,young	mentioned,na,plurifoliate,stellate,zygomorphy
309	wfo-0001029373	success	199	92	43	51	148	41	35	8	3,5,acute,anther,apex,appressed,articulated,base,berry,calyx,cell,cm,corolla,curved,ellipsoid,enclosing,entire,filament,fruit,fruiting,glabrous,green,growth,hair,herb,internodal,lateral,leaf,long,lower,margin,mm,obtuse,ovate-lanceolate,pedicel,petiole,plurifoliate,pore,poricidal,shallowly,shape,simple,stellate,stem,straight,surface,tip,trichome,unit,white,wide	.0–1.2,.2,.3,.5,.5–2.0,0.3–0.5,0.4–1.6,0.5–1.2,0.5–1.8,0.6–0.7,1.0–1.2,1.0–1.6,1.2–1.5,1.3–2.2,1.4–3.5,1.5–2.0,1.5–2.5,1.5–2.7,1.8–2.0,1.8–2.3,180°,2-celled,2.0–2.5,2.7–3.0,20–30,2–4-celled,3.5–4.0,30–40,3–5,4–5,4–6,5-merous,5–6,6.8,8–9,abaxial,abaxially,accrescent,acuminate,adaxial,adaxially,age,anthesi,apar,appearanc,arising,bark,basal,bayonet,beyond,broadly,bud,capped,clavate,cone,conical,deltate,densely,developing,diameter,distal,eaf,eed,elongate,enclosed,exerted,finger,flattened-reniform,flower,free,fully,geminat,glandular-tipped,globose,grey-brown,half,halfway,hilum,immature,individual,laterally,lengthening,less,like,live,lobe,lobed,lon,mature,mesocarp,middle,minute,minutely,moderately,mouth,new,nflorescence,node,older,outline,ovary,pair,papillate,peduncle,pentagonal,per,perfect,pitted,plant,portion,positioned,primary,pubescent,reflexed,resembling,root,rounded,ruit,scar,seen,seudostipule,short,slightly,slit,smoot,spaced,spreading,stigma,still,style,tall,tem,terete,testal,thicker-walled,trailing,tub,tube,ud,uniseriate,upper,vein,woody,yellow,yellow-green,yellowish,ympodial,–5	0.5-1.2,1.0-1.2,2.7-3.0,articulation,bract,branching,broad-based,colour,connective,form,geminate,heteromorphism,inflorescence,insertion,interjected,interpetalar,leaflet,length,marking,na,needle-like,odour,orientation,paired,placement,position,prickle,pseudostipule,rhizome,scale,spot,staman,stone,structure,symmetry,sympodial,texture,tissue,tuber,type,xylopodia	3,5,acute,appressed,articulated,base,berry,cm,curved,ellipsoid,enclosing,entire,glabrous,green,herb,internodal,lateral,leaf,long,lower,mm,obtuse,ovate-lanceolate,plurifoliate,poricidal,shallowly,simple,stellate,stem,straight,surface,tip,trichome,white,wide	0.5-1.2,1.0-1.2,2.7-3.0,broad-based,geminate,na,needle-like,prickle
310	wfo-0001029402	success	113	116	73	86	27	30	69	4	0.5-1,0.5-2,1-2.5,11-17,15-30,2,2-10,2-3,3-5,3-6,4-6,4-7,4-8,5-25,6-16,7-8,7-9,8-15,abaxial,abaxially,acuminate,acute,adaxially,apart,apex,articulated,band,base,branched,calyx,chartaceous,ciliolate,cm,connivent,cylindrical,deltate,diameter,directed,elliptic,fleshy,flower,forked,free,glabrate,glabrous,hair,inrolled,lanceolate,lobe,long,margin,mm,moderately,narrowed,narrowly,often,papillose,pedicel,peduncle,petiole,pore,pubescence,pubescent,rachi,radiu,roughened,scale-like,shrub,simple,somewhat,sparsely,stellate,stigma,style,surface,tapered,thickened,time,tip,triangular,tube,unit,unknown,violet,wide,x	3-4,7-11,axe,blade,color,denser,distall,eaf,eed,glabrou,leaving,lower,many-foliat,nearly,nflorescence,nther,orolla,rachise,ruit,scar,spaced,tal,tem,truncat,unknow,vary,ympodial	anther,articulation,branching,colour,corolla,direction,distally,form,fruit,growth,height,inflorescence,leaf,length,many-foliate,na,ovary,plant,ratio,seed,shape,size,spacing,stem,structure,sympodial,texture,truncate,type,width	0.5-1,0.5-2,1-2.5,11-17,15-30,2,2-10,2-3,3-5,3-6,4-6,4-7,4-8,5-25,6-16,7-8,7-9,8-15,abaxially,acuminate,acute,adaxially,apart,apex,articulated,band,base,branched,chartaceous,ciliolate,cm,connivent,cylindrical,deltate,directed,elliptic,fleshy,forked,free,glabrate,glabrous,hair,inrolled,lanceolate,long,mm,moderately,narrowed,narrowly,often,papillose,pubescence,pubescent,roughened,scale-like,shrub,simple,somewhat,sparsely,stellate,tapered,thickened,time,tip,triangular,unknown,violet,wide,x	distally,many-foliate,na,truncate
311	wfo-0001029404	success	154	139	79	94	60	45	75	4	0.5-1,1-4,2,2-3,2-8,2.5-3,20-35,3-4,5-10,5-20,5-6,6-8,6-9,abaxially,absent,acuminate,adaxially,anther,apex,apiculate,auriculate,base,branched,calyx,cell,center,chartaceous,cm,connective,connivent,cordate,cream,cylindrical,dark,darker,deltate,densely,diameter,directed,distally,ellipsoidal,entire,flattened,fruit,glabrous,green,hair,lanceolate,leaving,lemon,light,lobe,long,longitudinal,margin,mm,moderately,mottling,narrowly,obtuse,orange,ovate,ovoid,pedicel,pedicellar,peduncle,perfect,petiole,pink,pore,puberulent,pubescent,purple,rachi,radiu,remnant,shrub,simple,somewhat,star,stellate,stigma,stone,style,subcoriaceous,toward,tree,triangular,unbranched,unit,vein,white,x,yellow	-1.5,-10,-3,-5,0-60-flower,1,1.5-2,15-25,2-4,2-5,2.5-22,3-5,3-8.5,4-foliat,5-24,6.5-34,8-12,acute,aggregate,apart,ape,articulated,axe,basal,beyond,blade,eaf,eed,eglandular,exserted,fleshy,flower,glandular,glandular-puberulen,less,lon,lower,nflorescence,nther,orang,orolla,presen,ripe,ruit,shorter,slightly,small,spaced,sparsely,tal,tem,thecae,time,tomento,truncat,tube,ud,vary,wide,ympodial	4-foliate,articulation,branching,breeding,bud,colour,corolla,direction,filament,form,growth,height,heteromorphism,inflorescence,leaf,length,marking,mature,modification,na,orientation,ovary,pattern,placement,plant,present,prickle,pseudostipule,rhizome,seed,shape,size,spot,staman,stem,structure,symmetry,sympodial,system,texture,theca,truncate,tuber,type,xylopodia	0.5-1,1-4,2,2-3,2-8,2.5-3,20-35,3-4,5-10,5-20,5-6,6-8,6-9,abaxially,absent,acuminate,adaxially,apiculate,auriculate,base,branched,center,chartaceous,cm,connivent,cordate,cream,cylindrical,dark,darker,deltate,densely,directed,distally,ellipsoidal,entire,flattened,fruit,glabrous,green,lanceolate,leaving,lemon,light,long,longitudinal,mm,moderately,mottling,narrowly,obtuse,orange,ovate,ovoid,pedicellar,perfect,pink,puberulent,pubescent,purple,remnant,shrub,simple,somewhat,star,stellate,subcoriaceous,toward,tree,triangular,unbranched,vein,white,x,yellow	4-foliate,na,present,truncate
312	wfo-0001029406	success	136	101	52	69	67	32	50	2	0.3-1,0.5-1,0.6-1,0.7-1.5,1-1.5,1-10,1-2,1.5-2.2,1.5-2.5,1.5-5,2,2-11,2-3,2.5-3.5,28,3-9,30,4-18,4-6,abaxially,acute,adaxially,anther,apex,arachnoid,arachnoid-pubescent,bark,base,broadly,calyx,clavate,cm,conical,corolla,dark,difoliate,elliptic,filament,fruiting,glabrous,globose,grayish-brown,green,greenish-white,leaf,lobed,minor,mm,nearly,ovary,ovoid,ovoid-reniform,pedicel,petiole,pore,pubescent,shaped,shiny,shrub,slightly,small,stigma,style,tear-drop,tree,trichome,tube,unit,white	.5,7-12,along,anthesi,ba,berry,brown,brownish,bullate,conspicuously,deciduous,deflexed,deltate,densely,dia,differing,dry,eaf,eed,felt-like,free,geminat,grayish-green,impressed,large,lateral,lenticel,lilac,lobe,lon,long,lower,main,major,margin,matted,maturity,middle,minutely,occasionally,often,older,pair,pale,papillo,papillose,pitted,planar,pointed,population,poricidal,portion,ruit,size,soon,stem,surface,tall,tinge,tip,vein,waxy,wide,widest,woody,ympodial,young	branching,cell,colour,diameter,form,fruit,geminate,growth,hair,height,heteromorphism,inflorescence,length,mature,na,odour,orientation,placement,plant,position,prickle,scale,seed,shape,staman,stone,structure,symmetry,sympodial,texture,type,width	0.3-1,0.5-1,0.6-1,0.7-1.5,1-1.5,1-10,1-2,1.5-2.2,1.5-2.5,1.5-5,2,2-11,2-3,2.5-3.5,28,3-9,30,4-18,4-6,acute,arachnoid,arachnoid-pubescent,base,broadly,clavate,cm,conical,dark,difoliate,elliptic,glabrous,globose,grayish-brown,green,greenish-white,lobed,mm,nearly,ovoid,ovoid-reniform,pubescent,shaped,shiny,shrub,slightly,small,tear-drop,tree,trichome,white	geminate,na
313	wfo-0001029407	success	204	104	49	58	146	46	46	3	.5,/3,anther,apex,apparently,articulated,base,berry,bright-red,calyx,chartaceous,connivent,cuneate,curved,densely,difoliate,discolorous,drying,entire,erect,evenly,filament,flattened,fruit,fruiting,geminate,glabrous,green,lateral,leaf,length,lobed,margin,mature,maturity,mauve,mm,orange,pedicel,petiole,poricidal,prickle,rarely,rounded,shrub,simple,spherical,stellate,stellate-pubescent,strongly,surface,tapering,tip,unbranched,unit,way,white,young	-10,-2,-6,0-15,0-2,0-4,0-5,0.1-0.2,0.1-0.25,0.15-0.4,0.2-0.3,0.4-0.7,0.4-1,0.5-0.7,0.5-1.5,0.5-2,0.6,0.6-0.9,0.7-1.2,1,1-1.4,1-2,1-3,1-4,1-4.5-7,1.5,1.8-2.5,1/3,1/3-1/2,1/5,1/8-1/5,2-3,2-4,2-5,2.5-3,3-4,3-6,3.5-4.5,4-15-25,4-9,4.5-6,5-7,5-merous,6-13,6-20,7-8,abaxial,abaxially,acut,acute,adaxial,almost,alyx,apar,apart,apically,bark,blade,brow,cm,dark,deltate,diameter,dull,eaf,eed,elliptic,elongating,equal,flattened-reniform,flower,free,geminat,glabrescent,gray-greenish,green-brown,infructescence,lengt,lobe,long,longer,lower,midpoint,moderately,nflorescence,obtuse,occasionally,older,one,open,orange-brown,orolla,oung,ovate,pair,pale,peduncle,pendulous,per,perfec,pericarp,porrect,portion,prickl,prickly,primary,pubescent,ray,recurved,reflexed,ruit,scar,sessile,shorter,side,slender,smooth,sometimes,spaced,sparsely,spreading,stalk,stalked,stem,stout,straight,straw-yellow,style,tamen,terete,tertiary,thick,time,trichome,tube,upper,vary,vein,venation,visible,weakly,wide,woody,yellow,yellow-green,ympodial	appressed,articulation,bract,branching,breeding,cell,colour,connective,corolla,form,growth,hair,heteromorphism,inflated,inflorescence,insertion,interjected,interpetalar,leaflet,marking,na,odour,orientation,paired,pattern,perfect,placement,pore,position,present,pseudostipule,rhizome,scale,shape,spot,staman,stone,structure,symmetry,sympodial,system,texture,tissue,tuber,type,xylopodia	.5,/3,apparently,articulated,base,berry,bright-red,chartaceous,connivent,cuneate,curved,densely,difoliate,discolorous,drying,entire,erect,evenly,flattened,geminate,glabrous,green,lateral,leaf,lobed,mature,maturity,mauve,mm,orange,poricidal,rarely,rounded,shrub,simple,spherical,stellate,stellate-pubescent,strongly,surface,tapering,tip,unbranched,way,white,young	na,perfect,present
314	wfo-0001029408	success	243	141	79	89	154	52	74	5	0.7-1.2,0.9-1.6,1-8,2.2-3.7,3-5,accrescent,acute,anther,apex,apical-lateral,articulated,base,becoming,berry,blunt-tipped,branched,calyx,cm,continued,corolla,cuneate,dehiscing,dendritic-multangulate,directed,due,echinoid,entire,extend,filament,fleshy,fruit,fruiting,glabrous,globose,growth,hair,homostylous,interpetalar,introrse,large,lateral,leaf,length,lilac,long,long-,longitudinal,lower,margin,mixed,mm,mostly,multangulate,near,oblong,pale,partly,pedicel,persistent,petiole,plurifoliate,pore,porrect-stellate,pseudo-terminal,purplish,rarely,rather,ray,ripe,rotate-stellate,sessile,short-,short-attenuate,short-stalked,shrub,simple,slightly,slit,small,stem,thick-textured,thin-stalked,time,tissue,tree,unit,white,x,yellow	-1.5,-10.5,.2-3.5-4.5,/10,0,0-100,0.2-0.3,0.3-5,0.5-2.5,0.9-1.3,1.1-1.5,1.4-1.9,1.5-3,1.6-2.8,1.7-2.4,1.8-3.5,1/2,1/2-3/4,1/4,11-31,2-12,2-3.5,2-4,2-5,2.5-7,2/3,3.5-5,4-14,4-20,4-7.5,5-24,5-6,5-6.5,5-8,5-merou,7-12,abaxially,acuminate,adaxiall,adaxially,ag,alyx,anthesi,apart,axe,axillary,ba,barely,bark,blade,branch,broadly,brown,bud,capitat,chartaceous,clavate,conical,dark,decurrent,deltoid,dendritic-echinoi,densely,develope,diameter,distal,distall,eaf,echinoi,eed,elliptic,exserted,faintly,few-rayed,flower,free,gray,green,high,honeycombed,indument,inserted,lacking,lanate,lanceolate,lobe,lobed,long-attenuate,long-stalked,m.,main,many,midvein,moderately,nearly,nflorescence,obscured,obtuse,often,older,orbicular,orolla,ovate,ovate-lanceolate,overlapping,part,peduncle,perfect,present,pubescent,rachi,relatively,reniform,reticulate-punctate,ribbed,ruit,runk,side,sometimes,spaced,stamen,stelliform,stigma,style,subcampanulate,suborbicular,subovate,suture,tamen,terete,testa,thick,thick-stalked,tomentose,tomentu,tomentum,top,touching,toward,tube,turbinate,unarme,unarmed,usually,vary,vein,velutinous,way,well,whitish,wide,yellowish,ympodial,young	5-merous,age,appressed,articulation,bract,branching,breeding,broad-based,cell,colour,connective,dendritic-echinoid,distally,form,heteromorphism,inflated,inflorescence,insertion,interjected,leaflet,marking,mature,modification,na,needle-like,odour,orientation,paired,pattern,placement,position,prickle,pseudostipule,rhizome,scale,shape,smell,spot,staman,stone,structure,surface,symmetry,sympodial,system,texture,trichome,tuber,type,vegetative,xylopodia,zygomorphy	0.7-1.2,0.9-1.6,1-8,2.2-3.7,3-5,accrescent,acute,apex,apical-lateral,articulated,base,becoming,berry,blunt-tipped,branched,cm,continued,cuneate,dehiscing,dendritic-multangulate,directed,due,echinoid,entire,extend,fleshy,glabrous,globose,growth,hair,homostylous,introrse,large,lateral,lilac,long,long-,longitudinal,mixed,mm,mostly,multangulate,near,oblong,pale,partly,persistent,plurifoliate,pore,porrect-stellate,pseudo-terminal,purplish,rarely,rather,ray,ripe,rotate-stellate,sessile,short-,short-attenuate,short-stalked,shrub,simple,slightly,slit,small,stem,thick-textured,thin-stalked,time,tree,white,x,yellow	5-merous,age,dendritic-echinoid,distally,na
315	wfo-0001029417	success	213	202	119	143	70	59	114	5	.5,0-7,0.2-0.6,0.7-3,1-10,1-2,1-4,1-8,1.3-8,1.5-1.8,1.5-8,12,2.5-10,2.8-3.5,3-14,3-5,4-7,5-15,6-11,8-15,8-9,abaxially,adaxially,along,anther,apart,apex,axillary,base,basiscopic,berry,blade,blue,borne,brownish,bud,cell,chartaceous,clavate,cm,coarsely,condition,corolla,dark,decurrent,deep,diameter,digestion,distal,dorsally,dot,drying,edge,end,enzyme,erect,especially,filament,flat,flower,folded,forked,fresh,fruit,glabrous,globose,green,greenish,hair,half,herb,homostylous,honeycomb-shaped,interjected,lanceolate,lateral,leaflet,lengthening,like,lobe,long,lower,lunate,margin,medium,membranous,midrib,minute,minutely,mm,moderately,non-glandular,odd-pinnate,often,ovoid,pair,pedicel,peduncle,pentagonal,petiole,pilose,plant,plurifoliate,pore,poricidal,puberulent,pubescent,purple,removed,ripe,rotate,scattered,seed,sessile,short,side,singly,size,slightly,slit,sometimes,stem,stigma,straight,style,subtending,terminal,testal,tinged,tip,tri-,trichome,tube,tuber,typically,unit,violet,wall,white,whitish,wide,widely,x	0.4-8,1,1-1.5,1.5-10,2-4,5-merou,acumen,acuminate,acute,ag,alyx,apiculate,apparently,articulated,attenuate,axe,broadly,capitat,central,ciliate,connivent,covering,decreasing,eaf,eed,erec,exceeding,geminat,generally,glabrou,greatly,green-white,hair-like,hal,linear,living,make,mucilaginous,narrowly,nflorescence,orbicular,orolla,ovate,perfect,petiolulate,rapidly,rarely,rounded,ruit,seudostipule,short-petiolulate,spaced,specimen,stamen,star,ste,stolo,subequal,tall,tamen,tem,thick,throughout,unwinged,usually,vary,wet,wing,yellow,ympodial	age,appressed,arrangement,articulation,bract,branching,breeding,broad-based,calyx,capitate,colour,connective,form,fruiting,glabrousnes,growth,height,heteromorphism,inflated,inflorescence,insertion,interpetalar,leaf,length,marking,mature,modification,na,needle-like,odour,orientation,ovary,paired,pattern,placement,position,presence,prickle,pseudostipule,rhizome,scale,shape,smell,spacing,spot,staman,stellate,stolon,stone,structure,surface,symmetry,sympodial,system,texture,tissue,type,vegetative,xylopodia	.5,0-7,0.2-0.6,0.7-3,1-10,1-2,1-4,1-8,1.3-8,1.5-1.8,1.5-8,12,2.5-10,2.8-3.5,3-14,3-5,4-7,5-15,6-11,8-15,8-9,abaxially,adaxially,along,apart,axillary,basiscopic,berry,blue,borne,brownish,bud,chartaceous,clavate,cm,coarsely,condition,dark,decurrent,deep,digestion,distal,dorsally,dot,drying,end,enzyme,erect,especially,flat,folded,forked,fresh,glabrous,globose,green,greenish,hair,half,herb,homostylous,honeycomb-shaped,lanceolate,lateral,lengthening,like,long,lunate,medium,membranous,midrib,minute,minutely,mm,moderately,non-glandular,odd-pinnate,often,ovoid,pentagonal,pilose,plurifoliate,pore,poricidal,puberulent,pubescent,purple,removed,ripe,rotate,scattered,sessile,short,side,singly,slightly,slit,sometimes,stem,straight,subtending,terminal,tinged,tip,tri-,trichome,typically,violet,wall,white,whitish,wide,widely,x	age,capitate,na,stellate,stolon
316	wfo-0001029461	success	210	134	64	83	127	51	62	2	-1.5,0-4,0.6-1,0.7-1,1-6,3-20,4.5-7,5-10,almost,andromonoecious,anther,apart,apex,attenuate,base,becoming,berry,black,breaking,brittle,broad-deltate,brown,calyx,cell,chartaceous,cm,cuneate,curved,elliptic,evenly,filament,flattened,flattened-reniform,flower,fruit,fruiting,glabrous,green,leaf,length,long,lower,margin,mature,maturity,mauve,mm,moderately,oblong,orange,ovate,pedicel,petiole,poricidal,porrect,prickle,reflexed,sessile,shiny,shrub,simple,slightly,sometimes,spaced,sparsely,spherical,stalked,staman,stellate,stellate-pubescent,stem,straight,surface,tip,trichome,unarmed,unequal,unit,weakly,wide,yellow,young,zygomorphic	-3,-4.5,.5,0-2,0.1,0.1-0.25,0.15-0.25,0.8,0.8-1.5,1-1.5-2,1-1.6,1-2,1-3,1-3-6,1-4,1.2-1.7,1.2-1.8,1.3-2.2-3.2,1.5-2-4-5,1/3,1/3-2/3,1/4-1/2,1/4-3/4,2-2.4,2-2.8,2-3,2.5-3,4-10-14,4-6.5,4-7,4.7-7.2,5-25,5-merous,7-10,7-12,8-9,abaxially,acuminat,alyx,ame,apically,bark,blade,c.,concolorous,dark,densely,diameter,discolorous,distal,distance,drying,dull,eaf,eed,elongating,erect,extending,faint,fifth,fine,four,free,glabrescent,gra,hermaphrodite,heterostylous,infructescence,lengt,lobe,lobed,long-styled,longer,lowermost,midpoint,midvein,obovate,obtuse,older,orolla,oung,outline,pair,pendulous,per,pericarp,pit,plant,plurifoliat,portion,prickl,prickly,primary,raised,ray,reddish,reduced,rounded,ruit,shallow,short-styled,shorter,side,slender,small,smooth,spreading,stalk,staminat,strongly,style,subentire,tamen,terete,tertiary,time,tube,unarme,upper,variously,vary,vein,venation,visible,way,woody,ympodial	abaxial,adaxial,appressed,articulation,bract,branching,breeding,broad-based,colour,connective,corolla,form,growth,hair,heteromorphism,inflated,inflorescence,insertion,interjected,interpetalar,leaflet,marking,na,needle-like,odour,orientation,paired,pattern,placement,plurifoliate,pore,position,pseudostipule,rhizome,scale,seed,shape,smell,spot,stone,structure,symmetry,sympodial,system,texture,tissue,tuber,type,vegetative,xylopodia,zygomorphy	-1.5,0-4,0.6-1,0.7-1,1-6,3-20,4.5-7,5-10,almost,andromonoecious,apart,attenuate,base,becoming,berry,black,breaking,brittle,broad-deltate,brown,chartaceous,cm,cuneate,curved,elliptic,evenly,flattened,flattened-reniform,glabrous,green,long,maturity,mauve,mm,moderately,oblong,orange,ovate,poricidal,porrect,reflexed,sessile,shiny,shrub,simple,slightly,sometimes,spaced,sparsely,spherical,stalked,stellate-pubescent,stem,straight,tip,unarmed,unequal,weakly,wide,yellow,young,zygomorphic	na,plurifoliate
317	wfo-0001029462	success	163	117	71	83	80	34	66	5	-2,-4,0.5-1,0.5-2,1-3,1-6,2-6.5,2.5-3.5,20-35,3-27,3-7,5-30,6-9,abaxially,abruptly,acuminate,acute,apex,base,broad,calyx,campanulate,chartaceous,cm,connective,connivent,constricted,cuneate,cylindrical,dark,densely,diameter,directed,eglandular,ellipsoidal,elliptic,entire,flattened,fruit,glabrous,green,hair,lanceolate,laterally,light,lobe,longitudinal,margin,membranaceous,minutely,mm,moderately,near,obtuse,occasionally,ovate,ovoid,pedicel,peduncle,petiole,pore,puberulent,pubescent-pilose,purplish,rachi,radiu,reticulate,rounded,simple,somewhat,sparsely,stigma,stripe,style,tip,tree,triangular,truncate,unbranched,unit,white,x,yellow	-5,1,1-2,1-4-15-30,1.5,1.5-2,1.5-3,1.5-7,10-15-25,10-22,2-3,2.5-5.5,3,3-18,3-4,3-5,3-6,4-20-30,4-foliat,7-19,7-8,8-9,absent,adaxially,aggregate,apart,ape,articulated,axe,basal,beyond,blade,cell,ciliate,curled,dentate,eaf,eed,equal,exceeding,exserted,flower,leaving,lon,long,lower,m.,narrowly,nflorescence,nther,often,orolla,oval,pedicellar,perfect,pubescent,pubescent-pilo,purpl,remnant,ruit,shorter,slightly,small,smooth,spaced,stamen,stellate-,stone,tal,tem,thecae,time,tomentose,truncat,tube,ud,vary,wide,without,ympodial	1-15,10-25,4-foliate,abaxial,adaxial,anther,articulation,branching,bud,colour,corolla,form,fruiting,growth,height,inflorescence,leaf,length,na,ovary,plant,position,purple,seed,shape,size,spacing,stem,structure,symmetry,sympodial,texture,theca,type	-2,-4,0.5-1,0.5-2,1-3,1-6,2-6.5,2.5-3.5,20-35,3-27,3-7,5-30,6-9,abaxially,abruptly,acuminate,acute,base,broad,campanulate,chartaceous,cm,connivent,constricted,cuneate,cylindrical,dark,densely,directed,eglandular,ellipsoidal,elliptic,entire,flattened,glabrous,green,lanceolate,laterally,light,longitudinal,membranaceous,minutely,mm,moderately,near,obtuse,occasionally,ovate,ovoid,puberulent,pubescent-pilose,purplish,reticulate,rounded,simple,somewhat,sparsely,stripe,tip,tree,triangular,truncate,unbranched,white,x,yellow	1-15,10-25,4-foliate,na,purple
318	wfo-0001029464	success	232	133	76	87	145	46	72	4	0.2-0.5,1-10,1-3,1/4-1/2,1/4-1/3,12-50,5.5-7.5,abaxial,acicular,adaxial,andromonoecious,annual,anther,apex,around,articulated,base,berry,black,branched,calyx,chartaceous,cm,connivent,cordate,cultivar,cup-shaped,curved,difoliate,ellipsoid,elongating,equal,flattened-reniform,fruit,fruiting,glabrescent,glabrous,glaucous,globular,green,hair,herb,lateral,leaf,length,lobed,long,lower,margin,maroon,mature,maturity,mauve,mm,moderately,mottled,oblong,obtuse,orange-brown,ovate,ovoid,pedicel,per,petiole,pink,plant,poricidal,prickle,purple,red-brown,simple,sometimes,stellate,stellate-pubescent,stem,striped,surface,tapering,terminal,tip,unit,usually,variously,way,white,yellow-green,young	.9,0-2,0-30,0-5,0-80,0.2,0.2-0.7,0.3-0.7,0.3-1,0.5,0.5-2,0.8-2,00-200,1,1-8,1.2-3,1.5-2,1/,1/4,1/4-1/3-2/3,10-15,10-23,10-40,10-50,2-3,2-3.5,2-4,2.2-2.5,2.4-4,2.5-5,2.5-8,2.9-3.2,3-20,3-5,3-7,3.5-5,4-7,4-8,4-8-merous,5-17,5-8,5.5-6,6-15,7-10,8-13,8-15,9-15,abaxially,acute,alyx,ame,apar,apart,apically,apparently,bark,blade,broad,broad-deltate,brow,brown,c.,dark,deltate,diameter,discolorous,distal,distance,drying,eaf,eed,elongated,erect,extending,filament,flower,free,fully,geminat,green-brown,hermaphrodite,heterostylous,infructescence,less,lobe,long-acuminat,long-styled,longer,lowermost,midpoint,midvein,minute,narrow-deltate,nflorescence,occasionally,often,older,one,open,opening,orolla,oung,pair,peduncle,pendent,pendulous,pericarp,porrect,portion,prickl,prickly,primary,ray,rounded,ruit,scar,sessile,short-styled,side,smooth,spaced,sparsely,spreading,stalk,stalked,staminat,straight,style,tamen,terete,tertiary,time,translucent,trichome,tube,unarmed,upper,vary,vein,venation,visible,wide,woody,yellow-orange,ympodial	100-200,appressed,articulation,bract,branching,breeding,broad-based,cell,colour,connective,corolla,form,geminate,growth,height,heteromorphism,history,inflated,inflorescence,insertion,life,marking,na,needle-like,number,odour,orientation,pattern,placement,position,pseudostipule,rhizome,scale,seed,shape,spot,staman,stone,structure,symmetry,sympodial,system,texture,tuber,type,xylopodia	0.2-0.5,1-10,1-3,1/4-1/2,1/4-1/3,12-50,5.5-7.5,acicular,andromonoecious,annual,around,articulated,base,berry,black,branched,chartaceous,cm,connivent,cordate,cultivar,cup-shaped,curved,difoliate,ellipsoid,elongating,equal,flattened-reniform,fruit,glabrescent,glabrous,glaucous,globular,green,herb,lateral,length,lobed,long,maroon,mature,maturity,mauve,mm,moderately,mottled,oblong,obtuse,orange-brown,ovate,ovoid,per,pink,poricidal,prickle,purple,red-brown,simple,sometimes,stellate,stellate-pubescent,stem,striped,tapering,terminal,tip,usually,variously,way,white,yellow-green,young	100-200,broad-based,geminate,na
319	wfo-0001029546	success	203	186	110	128	75	58	105	5	0-2,0.3-1,1-2,1-4.5,1.5-2,2-9,2.2-2.8,3.5-5,4-10,4.5-12.5,4.5-7,5,5-10,5-18,5-8,6.3-19.5,7-10,8-19.5,abaxially,absent,adaxially,anther,apex,articulated,axillary,base,berry,blade,blue,brownish,bud,cell,chartaceous,clavate,cm,condition,connivent,cordate,corolla,curved,decreasing,densely,diameter,digestion,distal,dot,drying,elliptical,enzyme,filament,flower,forked,frequently,fresh,fruit,generally,glabrous,glandular,globose,greatly,green,greenish,hair,half,herb,homostylous,honeycomb-shaped,interjected,lanceolate,lateral,leaf,leaflet,lengthening,like,lobe,long,longer,lower,lunate,membranous,mm,non-glandular,oblique,odd-pinnate,often,ovoid,pair,pedicel,pentagonal,petiole,plant,plurifoliate,pore,poricidal,pubescent,rarely,regular,removed,ripe,rotate-pentagonal,seed,short,simple,size,slightly,slit,soft,stem,stigma,straight,style,subequal,subtending,terminal,testal,tinged,tip,tri-,trichome,tube,typically,unit,wall,white,whitish,wide,wing,x	1-10,1-3.2,1-5,1.5-6.2,1.6-6.5,2-4,3-8,5-merou,8,8-17,acumen,acuminate,acute,adaxiall,ag,alyx,apart,apiculate,apparently,attenuate,axe,broadly,capitat,covered,covering,decumben,decurrent,dorsally,eaf,edge,eed,elliptic,erect,exceeding,flat,folded,geminat,glabrou,green-white,hair-like,living,make,middl,minutely,mottle,mucilaginous,nearly,nflorescence,orbicular,ovate,peduncle,perfect,petiolule,purple,rachi,ruit,sessile,seudostipule,sometimes,spaced,specimen,stamen,ste,tall,tamen,tem,thick,throughout,truncate,unwinged,usually,vary,wet,yellow,ympodial	age,appressed,arrangement,articulation,bract,branching,breeding,broad-based,calyx,capitate,colour,connective,form,fruiting,geminate,glabrousnes,growth,height,heteromorphism,inflated,inflorescence,insertion,interpetalar,length,margin,marking,mature,middle,modification,na,needle-like,odour,orientation,ovary,paired,pattern,placement,position,prickle,pseudostipule,rhizome,scale,shape,smell,spot,staman,stone,structure,surface,symmetry,sympodial,system,texture,tissue,tuber,type,vegetative,xylopodia	0-2,0.3-1,1-2,1-4.5,1.5-2,2-9,2.2-2.8,3.5-5,4-10,4.5-12.5,4.5-7,5,5-10,5-18,5-8,6.3-19.5,7-10,8-19.5,abaxially,absent,adaxially,articulated,axillary,base,berry,blue,brownish,bud,chartaceous,clavate,cm,condition,connivent,cordate,curved,decreasing,densely,diameter,digestion,distal,dot,drying,elliptical,enzyme,forked,frequently,fresh,generally,glabrous,glandular,globose,greatly,green,greenish,hair,half,herb,homostylous,honeycomb-shaped,lanceolate,lateral,leaf,lengthening,like,long,longer,lunate,membranous,mm,non-glandular,oblique,odd-pinnate,often,ovoid,pentagonal,plant,plurifoliate,poricidal,pubescent,rarely,regular,removed,ripe,rotate-pentagonal,short,simple,size,slightly,slit,soft,stem,straight,subequal,subtending,terminal,tinged,tip,tri-,trichome,typically,wall,white,whitish,wide,x	age,capitate,geminate,middle,na
320	wfo-0001029552	success	161	145	76	93	68	52	72	4	.25,.5,0.5,0.6-1,1-1.5,1-2,1-3,1-5,1.5-2,1.5-6.5,12,2-2.5,2-9,2.5-3,5-10-flowered,abaxial,abaxially,acute,adaxially,along,anther,apex,area,bark,base,branched,broadened,calyx,clavate,cm,conical,corolla,dendritic,densely,elliptic,erect,filament,flattened-reniform,flower,fruiting,glabrous,globose,green,incrassate,inflorescence,lamina,leaf,like,lobed,long-styled,main,margin,minor,minutely,mm,nearly,occasionally,opposite,orbicular,ovary,pale,paler,pedicel,petiole,pitted,pore,pubescent,rest,scattered,shape,shaped,shining,short-styled,shrub,simple,size,small,somewhat,sparsely,stem,stigma,style,surface,tear-drop,tip,tree,tree-like,trichome,tube,unit,vein,white,x	0.1-0.5,1-1.3,10-20,5.5-8,6-9,abruptly,acuminate,anthesi,berry,broadly,closely,contracted,decurrent,deflexed,deltate,denser,dia,differing,difoliate,drying,eaf,edicel,eed,exserted,free,geminat,greyish-brow,heteromorphic,inflorescenc,later,lateral,lobe,lon,long,lower,major,middle,minute,nflorescence,older,onto,overlappin,pair,papillo,persistent,planar,poricidal,portion,present,reflexed,rounded,ruit,scar,slender,slightly,spaced,strongly,swollen,tall,tan,tub,ud,wide,widest,woody,yellowish,ympodial,young	alternate,arrangement,articulation,bract,branching,breeding,cell,colour,connective,diameter,form,fruit,greyish-brown,growth,hair,height,heteromorphism,insertion,interjected,interpetalar,leaflet,length,marking,mature,modification,na,number,odour,orientation,papillose,pattern,placement,plant,position,prickle,pseudostipule,rhizome,scale,seed,spot,staman,stone,structure,symmetry,sympodial,system,texture,tissue,tuber,type,width,xylopodia	.25,.5,0.5,0.6-1,1-1.5,1-2,1-3,1-5,1.5-2,1.5-6.5,12,2-2.5,2-9,2.5-3,5-10-flowered,acute,along,area,base,branched,broadened,clavate,cm,conical,dendritic,densely,elliptic,erect,flattened-reniform,glabrous,globose,green,incrassate,inflorescence,lamina,leaf,like,lobed,long-styled,main,margin,minutely,mm,nearly,occasionally,opposite,orbicular,pale,paler,pitted,pubescent,rest,scattered,shaped,shining,short-styled,shrub,simple,small,somewhat,sparsely,stem,style,surface,tear-drop,tip,tree,tree-like,trichome,vein,white,x	alternate,greyish-brown,na,papillose
321	wfo-0001029584	success	180	181	103	123	57	58	97	6	0-30,1,1-2,1-6,1.5-6.5,16.2-33,2-3,2-4,3-10,3-7,4-14,4-5,4.5-11.5,6-7,6.1-9.4,7-14,8-15,9.7-23.4,9.8-17,abaxially,adaxially,anther,apex,articulated,asymmetric,axillary,base,basiscopic,blade,borne,brownish,bud,cell,clavate,cm,condition,connivent,coriaceous,corolla,covering,dark,dense,densely,diameter,distal,drying,end,filament,finer,flower,forked,fresh,fruit,generally,glabrescent,glabrous,green,green-white,greenish,hair,hair-like,half,herb,homostylous,interjected,lateral,leaf,leaflet,light,lobe,long,lower,make,margin,middle,mm,mucilaginous,oblong-lanceolate,odd-pinnate,ovoid,pair,pedicel,peduncle,pentagonal,petiole,petiolulate,plant,plurifoliate,pore,poricidal,proximal,pubescent,purple,seed,short,side,simple,singly,size,stigma,straight,style,substellate,subtending,terminal,testal,thick,throughout,tip,tissue,tri-,tube,tuber,typically,unit,unwinged,usually,wall,wet,white,whitish,x,yellow	1-3,2.4-6.3,3-5,4-15,5-merou,5.3-13.3,acumen,acuminate,acute,ag,alyx,apart,apparently,attenuate,axe,capitat,considerably,decreasing,digestion,dorsally,eaf,edge,eed,elliptic,enzyme,erry,flat,folded,geminat,hal,honeycomb-shaped,larger,lengthening,linear,living,nflorescence,orbicular,orolla,ovate,perfect,present,removed,second,semi-erec,sessile,seudostipule,slit,spaced,specimen,stolo,tall,tamen,tem,toward,unknow,vary,ympodial	5-merous,abaxial,adaxial,arrangement,articulation,berry,bract,branching,breeding,broad-based,calyx,capitate,colour,connective,form,fruiting,geminate,growth,height,heteromorphism,inflorescence,insertion,interpetalar,length,marking,mature,modification,na,needle-like,odour,orientation,ovary,paired,pattern,placement,position,presence,prickle,pseudostipule,rhizome,scale,shape,smell,spot,staman,stem,stolon,stone,structure,surface,symmetry,sympodial,system,texture,trichome,type,vegetative,xylopodia	0-30,1,1-2,1-6,1.5-6.5,16.2-33,2-3,2-4,3-10,3-7,4-14,4-5,4.5-11.5,6-7,6.1-9.4,7-14,8-15,9.7-23.4,9.8-17,abaxially,adaxially,articulated,asymmetric,axillary,basiscopic,borne,brownish,bud,cell,clavate,cm,condition,connivent,coriaceous,covering,dark,dense,densely,distal,drying,end,finer,forked,fresh,generally,glabrescent,glabrous,green,green-white,greenish,hair,hair-like,half,herb,homostylous,lateral,light,long,make,middle,mm,mucilaginous,oblong-lanceolate,odd-pinnate,ovoid,pentagonal,petiolulate,plant,plurifoliate,poricidal,proximal,pubescent,purple,seed,short,side,simple,singly,straight,substellate,subtending,terminal,testal,thick,throughout,tip,tissue,tri-,typically,unwinged,usually,wall,wet,white,whitish,x,yellow	5-merous,berry,capitate,geminate,na,stolon
322	wfo-0001029593	success	181	139	67	88	93	51	64	3	-10,0.5-1,0.5-5,0.8-1,0.8-1.2,1,1-1.2,1-1.5,1-8,1.6-2.3,2,2-5,2.3,2.3-3.0,3-4,3.5-8,35-60,4-6,5-10,5-15,7.5-15,9-15,abaxially,anther,apex,apically,arising,attenuate,axil,axillary,basal,base,brown,capitate,cell,cm,conical,densely,diameter,elliptic,epidermal,filament,flower,fruit,fruiting,glabrous,globose,green,irregular,lateral,leaf,leaflet,long,mm,obovate,occasionally,once-branched,ovary,ovoid-reniform,pair,papillose,pedicel,per,petiole,pinnate,plant,pointed,projection,pubescence,pubescent,seed,shape,shrub,simple,sinuous,slightly,smaller,somewhat,stigma,style,terminal,trichome,uniseriate,unit,usually,without,woody,x	0.05,1-2,10-50,100,2-14,2-3,7-25,abruptly,acuminate,acute,adaxially,age,always,anthesi,anticlinal,basiscopically,bearing,berry,broadly,calyx,cateniform,clavat,colony,cone,decurrent,deltate,dry,drying,eaf,edicel,eed,enlarged,entire,exserted,extremely,filiform,free,glabrescent,growing,half,hollow,included,lamina,large,lobe,lower,markedly,minutely,much,narrowing,nflorescence,noddin,oblique,often,onto,open,opposite,perfectly,petiolule,place,poricidal,portion,primary,pubescen,purple,rachi,rarely,reflecting,rest,ruit,scar,short-styled,similar,single-stemmed,small,smooth,sparsely,surface,tall,tem,thickening,tip,tub,tube,ud,unifoliat,variable,vein,white,white-lenticellate,wider,winged,ympodial	arrangement,articulation,bract,branching,breeding,bud,clavate,colour,connective,corolla,form,growth,hair,height,heteromorphism,inflorescence,insertion,interjected,interpetalar,length,margin,marking,mature,modification,na,number,odour,orientation,pattern,placement,pore,position,prickle,pseudostipule,rhizome,scale,size,spot,staman,stem,stone,structure,symmetry,sympodial,system,texture,tissue,tuber,type,unifoliate,xylopodia	-10,0.5-1,0.5-5,0.8-1,0.8-1.2,1,1-1.2,1-1.5,1-8,1.6-2.3,2,2-5,2.3,2.3-3.0,3-4,3.5-8,35-60,4-6,5-10,5-15,7.5-15,9-15,abaxially,apically,arising,attenuate,axil,axillary,brown,capitate,cm,conical,densely,diameter,elliptic,glabrous,globose,green,irregular,lateral,long,mm,obovate,occasionally,once-branched,ovoid-reniform,pair,papillose,pinnate,pointed,projection,pubescent,shrub,simple,sinuous,slightly,smaller,somewhat,trichome,uniseriate,usually,without,woody,x	clavate,na,unifoliate
323	wfo-0001029601	success	187	156	80	103	84	53	75	5	0-37,0.2-0.8,0.5-5.8,1-2,1-3,1-4,1-53,1.7-6.5,2,2-12,2-7,2-9,2.3-5.9,2.8-10.5,3-10,3-7,4-13.5,5-41,6-10,6.6-22,6.8-14.5,anther,apex,attenuate,base,berry,blade,borne,brownish,cell,clavate,cm,condition,coriaceous,corolla,covering,dark,diameter,dot,drying,end,filament,flower,forked,fresh,fruit,glabrous,globose,green,greenish,hair,hair-like,herb,homostylous,interjected,lanceolate,lateral,leaf,leaflet,light,lobe,long,middle,mm,narrow,odd-pinnate,ovoid,pair,pedicel,peduncle,pentagonal,petiole,plant,plurifoliate,pore,poricidal,puberulent,ripe,rotate,rounded,seed,singly,size,slightly,small,stigma,straight,style,terminal,testal,thick,tip,tissue,tri-,tube,tuber,typically,unit,wall,white,whitish,wing,x	0.5-8,1.1-2.7,1.2-2.3,2-3,2.2-4.5,3-5,5-merou,abaxiall,abaxially,acumen,acuminate,acute,adaxially,ag,alyx,apart,apparently,articulated,asymmetric,axe,axillary,basiscopic,bud,capitat,connivent,decreasing,digestion,distal,dorsally,eaf,edge,eed,elliptic,enzyme,erec,exceeding,flat,folded,geminat,generally,glabrescent,glabrou,green-white,half,honeycomb-shaped,larger,lengthening,linear,living,lower,make,middl,mucilaginous,nflorescence,orbicular,orolla,ovate,perfect,petiolulate,removed,ruit,sessile,seudostipule,short,side,slit,spaced,specimen,stamen,stolo,subequal,subglabrou,subtending,tall,tamen,tem,throughout,toward,unwinged,usually,vary,wet,yellow,ympodial	abaxial,adaxial,arrangement,articulation,bract,branching,breeding,calyx,capitate,colour,connective,form,fruiting,growth,height,heteromorphism,inflorescence,insertion,interpetalar,length,margin,marking,mature,modification,na,number,odour,orientation,ovary,paired,pattern,placement,position,presence,prickle,pseudostipule,rhizome,scale,shape,spot,staman,stellate,stem,stolon,stone,structure,subglabrous,symmetry,sympodial,system,texture,type,xylopodia	0-37,0.2-0.8,0.5-5.8,1-2,1-3,1-4,1-53,1.7-6.5,2,2-12,2-7,2-9,2.3-5.9,2.8-10.5,3-10,3-7,4-13.5,5-41,6-10,6.6-22,6.8-14.5,attenuate,berry,borne,brownish,cell,clavate,cm,condition,coriaceous,covering,dark,dot,drying,end,forked,fresh,glabrous,globose,green,greenish,hair-like,herb,homostylous,lanceolate,lateral,light,long,middle,mm,narrow,odd-pinnate,ovoid,pentagonal,plurifoliate,poricidal,puberulent,ripe,rotate,rounded,singly,slightly,small,straight,terminal,testal,thick,tip,tri-,typically,wall,white,whitish,wing,x	capitate,na,stellate,stolon,subglabrous
324	wfo-0001029621	success	165	101	57	66	99	35	55	2	0.5-0.75,0.5-1,0.7-1.1,0.8-4.5,1-1.5,2/3,3.5-4.5,6-20,6-8,accrescent,acute,anther,apex,attenuate,base,becoming,berry,branched,calyx,cluster,cm,corolla,decurrent,filament,fruit,fruiting,glabrous,globose,green,lanceolate,later,lateral,leaf,lobed,main,many,margin,mm,oblanceolate,often,onto,pair,pedicel,pore,poricidal,ripe,sessile,shaped,shiny,shrub,somewhat,stem,surface,tear-drop,terminal,time,tip,tube,unit,vein,way,white,whorl-like,woody,x,yellowish	.1,0.5-1.2,0.5-1.5,0.8-1,1-2,1.5-2,1.5-2.5,1.5-5,1/3,2.5-3,3-3.5,5-20-flowered,7-9,along,anthesi,apar,appearing,appressed,area,bark,beneath,borne,brown,caudate,completely,constricted,course,cup-shaped,dark,deltoid,densely,dia,distal,dry,eaf,edicel,eed,ellipsoid,elongate,enclosed,erect,exsertio,fleshy,free,geminate,glabrate,irregularly,late,like,live,lobe,lon,long,lower,material,merely,middle,minutely,nflorescence,occasionally,older,ovary,ovoid-reniform,pale,papillate,papillo,papillose,pitted,planar,plant,plurifoliat,portion,prominent,puberulent,quite,rarely,reddish,reddish-gre,river,ruit,scar,small,spaced,ste,stigma,straight,style,tall,tan,tapering,thick,trichome,ud,uniseriate,widened,widest,yellow,ympodial,young	arrangement,articulation,branching,cell,colour,diameter,form,growth,heteromorphism,inflorescence,insertion,length,marking,na,odour,orientation,placement,plurifoliate,position,prickle,pseudostipule,rhizome,shape,size,spot,staman,stone,structure,symmetry,sympodial,texture,tuber,type,venation,xylopodia	0.5-0.75,0.5-1,0.7-1.1,0.8-4.5,1-1.5,2/3,3.5-4.5,6-20,6-8,accrescent,acute,attenuate,base,becoming,berry,branched,cluster,cm,decurrent,fruit,glabrous,globose,green,lanceolate,later,lateral,lobed,main,many,mm,oblanceolate,often,onto,pair,pore,poricidal,ripe,sessile,shaped,shiny,shrub,somewhat,stem,surface,tear-drop,terminal,time,tip,vein,way,white,whorl-like,woody,x,yellowish	na,plurifoliate
325	wfo-0001029622	success	182	148	75	90	92	58	70	5	.1,.5,0.5-0.7,0.5-1,0.6-0.9,0.8-1,1-1.2,1-1.5,1-4,1.5,2-11,2.5-3,3-4,30-35,4-6.5,absent,accrescent,acute,anther,apex,attenuate,bark,base,brown,calyx,chartaceous,cm,corolla,deflexed,diameter,difoliate,elliptic,entire,filament,flower,fruit,fruiting,geminate,glabrous,globose,green,inflorescence,internodal,jointed,known,leaf,lobed,long-acuminate,longitudinal,major,margin,mature,minor,mm,narrowly,oblong,occasionally,opening,opposite,ovate,pedicel,peduncle,petiole,pore,rachi,reddish,rounded,sagittate,shaped,shiny,shrub,simple,single,size,slightly,slit,somewhat,stellate,stem,stigma,style,tapering,tear-drop,tip,trichome,tube,uniseriate,unit,white,x	.2,/3,0.3,0.5,1-2.7,2-4,2-5,3-5,40,45-50,5-6,7-11,abaxially,adaxially,ag,alyx,anthesi,apparently,appearing,arising,axe,axil,beneath,blade,bud,capitat,connivent,consisting,cylindrical,deciduous,differing,dimorphic,eaf,eed,elongate,except,free,glabrou,ilament,immature,included,interlaced,lamina,lateral,less,lobe,long,long-triangular,m.,main,measured,midrib,minute,minutely,nflorescence,obconic,often,older,one,onto,orolla,oung,ovate-lanceolate,pair,papillose,pendent,portion,present,probably,raised,reflexed,remaining,ruit,scar,second,slende,slender,straight,tal,thin,thus,tuft,ud,unarme,unifoliat,vary,vein,way,within,yellow,ympodial,young	abaxial,adaxial,age,appressed,armament,articulation,bract,branching,breeding,capitate,cell,colour,connective,form,glabrousnes,growth,hair,height,heteromorphism,inflated,information,insertion,interjected,interpetalar,leaflet,length,marking,modification,na,odour,orientation,ovary,paired,pattern,placement,plant,position,prickle,pseudostipule,rhizome,scale,seed,shape,shinynes,spot,staman,stone,structure,symmetry,sympodial,system,texture,tissue,tuber,type,unarmed,xylopodia,zygomorphy	.1,.5,0.5-0.7,0.5-1,0.6-0.9,0.8-1,1-1.2,1-1.5,1-4,1.5,2-11,2.5-3,3-4,30-35,4-6.5,absent,accrescent,acute,attenuate,base,brown,chartaceous,cm,deflexed,diameter,difoliate,elliptic,entire,flower,fruit,geminate,glabrous,globose,green,internodal,jointed,known,leaf,lobed,long-acuminate,longitudinal,major,mature,minor,mm,narrowly,oblong,occasionally,opening,opposite,ovate,reddish,rounded,sagittate,shaped,shiny,shrub,simple,single,slightly,slit,somewhat,stellate,tapering,tear-drop,tip,trichome,uniseriate,white,x	age,capitate,na,unarmed,zygomorphy
326	wfo-0001029625	success	166	187	119	131	35	56	113	6	..,.1-0.2,0.5-1,0.5-1.3,0.5-2,0.5-2mm,0.8-1.4,0.8-1.8,1-1.5,1-2,1-3,2,3,3-3.5,3-5-8,4-10,4-4,4-5-celled,4-7-celled,4-9,5,5-10-15,5-6,6-9,9-25,abaxial,along,anther,anthesi,bark,base,beneath,branch,branched,brittle,calyx,cell,cm,conical,corolla,cucullate,darker,deflexed,deltate,densely,denser,diameter,dry,elliptic,erect,filament,flattened,four,fruit,fruiting,glabrescent,glabrous,gland,gland-tipped,globose,green,greenish,growth,herb,hyaline,inflorescence,lamina,later,lighter,like,lobe,lobed,long,margin,markedly,midline,mixed,mm,narrowly,nearly,occasionally,outer,outline,ovary,ovate-reniform,pale,papillate,pedicel,peduncle,per,pericarp,planar,point,pointed,pubescent,purplish,rarely,reddish,regularly,scattered,shrub,single,sinuate,slightly,small,smooth,sparsely,stem,stigma,striate,stripe,strongly,style,surface,tan,testa,thin,time,tinged,tip,triangular,trichome,tube,uniseriate,unit,vein,wall,weight,white,x,young	.5,1.2-1.6,100,2.5-.,3-3,8-13,apical,branc,brow,capitat,cel,deflexe,distinct,eaf,edicel,eed,flower,frui,glandular,lower,middle,minute,new,nflorescence,open,pair,plurifoliat,primary,ruit,scar,single-stemmed,tuft,ud,without,ympodial	apex,arrangement,articulation,bract,branching,breeding,brown,capitate,colour,connective,form,hair,height,heteromorphism,insertion,interjected,interpetalar,leaf,leaflet,length,marking,mature,modification,na,number,odour,orientation,pattern,petiole,placement,plant,plurifoliate,pore,position,prickle,pseudostipule,pubescence,rhizome,scale,seed,shape,size,spot,staman,stellate,stone,structure,symmetry,sympodial,system,texture,tissue,tuber,type,xylopodia,zygomorphy	..,.1-0.2,0.5-1,0.5-1.3,0.5-2,0.5-2mm,0.8-1.4,0.8-1.8,1-1.5,1-2,1-3,2,3,3-3.5,3-5-8,4-10,4-4,4-5-celled,4-7-celled,4-9,5,5-10-15,5-6,6-9,9-25,abaxial,along,anthesi,base,beneath,branched,brittle,cell,cm,conical,cucullate,darker,deflexed,deltate,densely,denser,diameter,dry,elliptic,erect,flattened,four,fruit,glabrescent,glabrous,gland,gland-tipped,globose,green,greenish,herb,hyaline,inflorescence,lamina,later,lighter,like,lobe,lobed,long,margin,markedly,midline,mixed,mm,narrowly,nearly,occasionally,outer,outline,ovate-reniform,pale,papillate,pericarp,planar,point,pointed,pubescent,purplish,rarely,reddish,regularly,scattered,shrub,single,sinuate,slightly,small,smooth,sparsely,striate,stripe,strongly,surface,tan,thin,time,tinged,tip,triangular,trichome,uniseriate,vein,wall,weight,white,x,young	brown,capitate,na,plurifoliate,stellate,zygomorphy
327	wfo-0001029645	success	160	176	102	113	47	63	97	5	.5-1,0.2-0.5,0.3-0.5,0.5-2.5,0.5-7,1,1-1.5,1-2,1-4,1.3-7,1.5-2,2-4,2.5-17,2.5-4,3-10,3-15,3-7,3.5-4,337,4-5,4-8,5,5-8,6-12,7-12,750,?,acuminate,acute,aggregate,along,anther,apart,apex,base,blue,calyx,cell,chartaceous,cm,corolla,cuneate,cylindrical,deltate,diameter,directed,distally,entire,et,except,extra-axillary,fide,filament,finger,fruit,glabrous,gland-tipped,globose,green,greenish,hair,herb,immature,kayap,line,lobe,lower,margin,membranaceous,mesocarp,minutely,mm,moderately,nearly,obtuse,ovate,ovate-elliptic,pedicel,peduncle,perfect,petiole,pore,puberulent,purple,rachi,radiu,rarely,red,rotate-stellate,sagittate,short,short-tomentose,side,simple,small,smith,sparsely,stigma,stone,strongly,style,subcordate,tapered,triangular,truncate,tube,unbranched,vein,white,wide,x,yellow,±	-1,1.5,2-3-foliat,abaxially,abundantly,adaxially,around,articulated,axe,ba,blade,brown,connivent,decurrent,distall,eaf,eed,flattened,flower,free,glabrou,inserted,knapp,long,major,nflorescence,orolla,part,puberulen,rugose-verrucate,ruit,sand-punctate,shorter,shru,spaced,tal,tamen,tem,thecae,tightly,time,tomento,truncat,unit,vary,veiny,ympodial	0.5-1,appressed,arrangement,articulation,bract,branching,breeding,broad-based,colour,connective,decurred,form,fruiting,growth,height,heteromorphism,inflated,inflorescence,insertion,interjected,interpetalar,leaf,leaflet,length,marking,mature,modification,na,needle-like,odour,orientation,ovary,paired,pattern,placement,plant,position,prickle,pseudostipule,rhizome,scale,shape,shrub,size,smell,spacing,spot,staman,stellate,stem,surface,symmetry,system,texture,theca,tissue,tomentose,trichome,tuber,type,vegetative,xylopodia,zygomorphy	.5-1,0.2-0.5,0.3-0.5,0.5-2.5,0.5-7,1,1-1.5,1-2,1-4,1.3-7,1.5-2,2-4,2.5-17,2.5-4,3-10,3-15,3-7,3.5-4,337,4-5,4-8,5,5-8,6-12,7-12,750,?,acuminate,acute,aggregate,along,apart,apex,base,blue,cell,chartaceous,cm,corolla,cuneate,cylindrical,deltate,directed,distally,entire,et,except,extra-axillary,fide,finger,glabrous,gland-tipped,globose,green,greenish,hair,herb,immature,kayap,line,lobe,membranaceous,mesocarp,minutely,mm,moderately,nearly,obtuse,ovate,ovate-elliptic,perfect,petiole,puberulent,purple,rarely,red,rotate-stellate,sagittate,short,short-tomentose,side,simple,small,smith,sparsely,stone,strongly,subcordate,tapered,triangular,truncate,unbranched,white,wide,x,yellow,±	0.5-1,decurred,na,shrub,tomentose
328	wfo-0001029646	success	141	96	37	44	97	52	33	4	1-4,4-5.5,5-15,apex,apical,apically,attenuate,base,branched,calyx,cell,cm,corolla,dehiscent,dichasially,distal,ebracteate,filament,finely,free,globose,green,hair-like,half,herbaceous,leaf,long,mm,pattern,pedicel,perennial,petiole,plant,poricidally,proximal,pubescent,simple,stellate,tone,tuber-bearing,unit,white,yellow-green,¼	0.1-0.6,0.5,0.5-0.8,0.7-2.2,1.5-2,1.5-4.9,10-15,2-3,3-14,3-6-foliat,6-8,7-15,abaxially,acumen,acuminate,acute,adaxially,articulate,commonly,covering,cyme,diameter,dichasial,digestion,dorsally,eaf,edge,eed,elliptic,emoval,enzyme,epiphytic,equaling,flat,flower,folded,forked,generally,globo,green-white,ground,growing,honeycomb,introrse,lateral,linear,living,lobe,lon,lower,make,maturing,monochasial,mos,mould,mucilaginous,mucronate,narrowly,nflorescence,nther,oak,often,orolla,ovat,ovate,ovoid,peduncle,perfect,pine,plan,rarely,reveal,ruit,seed,seudostipule,short,slit,specimen,stamen,stigma,straight,style,tall,tem,testal,thick,throughou,throughout,tree,typically,vary,viole,wall,wide,without,yellow,ympodial	3-6-foliate,anther,appressed,articulation,berry,bract,branching,breeding,colour,connective,form,fruit,fruiting,growth,hair,heteromorphism,inflated,inflorescence,insertion,interjected,interpetalar,leaflet,length,margin,marking,mature,modification,na,odour,orientation,paired,placement,pore,position,prickle,pseudostipule,rhizome,scale,shape,spot,staman,stone,structure,symmetry,sympodial,system,texture,tissue,tuber,type,violet,xylopodia	1-4,4-5.5,5-15,apical,apically,attenuate,branched,cm,dehiscent,dichasially,distal,ebracteate,finely,free,globose,green,hair-like,half,herbaceous,long,mm,perennial,plant,poricidally,proximal,pubescent,simple,stellate,tone,tuber-bearing,white,yellow-green,¼	3-6-foliate,berry,na,violet
329	wfo-0001029652	success	160	131	65	84	76	47	63	2	.25,.5,0.75-1,0.8-1,1-2,1-3,1.5-2,2-2.5,2-4,2.5-3,3.5-4,3/4,4-4.5,abaxially,adaxially,anther,apex,arching,attenuate,bark,base,calyx,cm,conical,corolla,curling,dia,difoliate,elliptic-ovate,filament,flower,fruiting,glabrous,globose,golden,green,greenish-white,heteromorphic,hispid,leaf,lobed,long,long-styled,margin,minor,minute,minutely,mm,narrowly,near,occasionally,opposite,ovary,ovoid-reniform,pale,papillose,pedicel,petiole,pitted,pore,poricidal,pubescent,reddish-brown,shaped,short-styled,shrub,simple,size,slender,stem,stigma,style,surface,tan,tear-drop,tip,trichome,tube,undulate,uniseriate,unit,way,white,x	.3,0.5-1,0.5-4,1,2,25,6-15,7-9,along,anthesi,apar,ape,apical,arch,ba,bearing,berry,broadly,cone,deciduous,deflexed,deltate,denser,differing,drying,eaf,edicel,eed,evenly,exserted,filiform,free,geminat,golden-red,hard,included,joining,lamina,lateral,like,lobe,lon,long-acuminate,lower,main,major,maturity,middle,midrib,nflorescence,older,pair,papillo,pericarp,portion,projection,reflexed,ruit,scar,series,slende,slightly,soon,spaced,sparsely,swollen,tall,thickened,time,tub,ud,vein,widest,within,ympodial,young	articulation,bract,branching,breeding,cell,colour,connective,diameter,form,fruit,geminate,growth,hair,height,heteromorphism,inflorescence,insertion,interjected,interpetalar,leaflet,length,marking,modification,na,orientation,pattern,placement,plant,position,prickle,pseudostipule,rhizome,scale,seed,shape,spot,staman,stone,structure,symmetry,sympodial,system,texture,tissue,tuber,type,xylopodia	.25,.5,0.75-1,0.8-1,1-2,1-3,1.5-2,2-2.5,2-4,2.5-3,3.5-4,3/4,4-4.5,apex,arching,attenuate,base,cm,conical,curling,dia,difoliate,elliptic-ovate,flower,glabrous,globose,golden,green,greenish-white,heteromorphic,hispid,leaf,lobed,long,long-styled,minute,minutely,mm,narrowly,near,occasionally,opposite,ovoid-reniform,pale,papillose,pitted,poricidal,pubescent,reddish-brown,shaped,short-styled,shrub,simple,slender,tan,tear-drop,tip,trichome,undulate,uniseriate,way,white,x	geminate,na
330	wfo-0001029673	success	159	174	100	116	43	58	97	3	.5,0.5-1,0.7-1.1,0.8-1,1-10,1-2,1.2-3.5,1.5-1.8,1.5-2,10-20,2-2.5,2-4,2.5,3-5,3/4,4-6,5.5-15,abaxial,abaxially,absent,accrescent,acuminate,acute,adaxial,adaxially,age,anther,anthesi,apex,appearing,bark,base,becoming,berry,black,branch,branching,broadly,calyx,clavate,cm,corolla,decurrent,deep,deflexed,dendritic,densely,diameter,elliptic,exserted,filament,fork,fruit,fruiting,glabrous,globose,greyish,greyish-yellow,growth,later,lateral,leaf,length,lenticular,long,lower,minutely,mm,monochasial,narrowly,nodding,occasionally,ovary,overtopping,pair,pedicel,pericarp,petal,petiole,pitted,plurifoliate,pore,poricidal,prominent,pubescent,purple,pyramidal,reddish-brown,scar,secondary,shoot,shrub,sleeve,slit-like,small,somewhat,sparsely,stem,stigma,strongly,style,surface,terminal,thin,time,tip,tree,trichome,tube,unit,vein,violet,winged,woody,x,young	0.75-1,1-5,2-3,5-25,along,apical,basal,blade,conical,deltoid,denser,dichasia,eaf,edicel,eed,ew,flower,free,greyish-yello,individual,inserted,lamina,like,lobe,lon,longer,m.,nflorescence,older,papillo,planar,portion,reflexed,ruit,slightly,stamen,tall,tapering,triangular,tub,ud,wide,ympodial	articulation,bract,breeding,broad-based,bud,cell,colour,connective,dichasial,exsertion,form,hair,height,heteromorphism,inflorescence,insertion,interjected,interpetalar,leaflet,margin,marking,mature,modification,na,needle-like,new,odour,orientation,papillose,pattern,placement,plant,position,prickle,prominence,pseudostipule,rhizome,scale,seed,shape,size,smell,spot,staman,stone,structure,symmetry,sympodial,system,texture,tissue,tuber,type,vegetative,venation,width,winging,xylopodia	.5,0.5-1,0.7-1.1,0.8-1,1-10,1-2,1.2-3.5,1.5-1.8,1.5-2,10-20,2-2.5,2-4,2.5,3-5,3/4,4-6,5.5-15,abaxially,absent,accrescent,acuminate,acute,adaxially,age,anthesi,apex,appearing,base,becoming,berry,black,branch,branching,broadly,calyx,clavate,cm,decurrent,deep,deflexed,dendritic,densely,diameter,elliptic,exserted,fork,fruit,glabrous,globose,greyish,greyish-yellow,later,lateral,leaf,length,lenticular,long,minutely,mm,monochasial,narrowly,nodding,occasionally,overtopping,pair,petal,pitted,plurifoliate,pore,poricidal,prominent,pubescent,purple,pyramidal,reddish-brown,secondary,shoot,shrub,sleeve,slit-like,small,somewhat,sparsely,strongly,surface,terminal,thin,time,tip,tree,trichome,tube,vein,violet,winged,woody,x	dichasial,na,papillose
331	wfo-0001029680	success	212	124	87	103	109	21	84	3	.0,0.1,0.5–1.5,0.6–1.2,0.6–2.0,1.0–1.1,1.0–1.5,1.0–1.8,1.1–1.2,1.4–7.5,1.6–2.7,1.7–7,1.8–3.8,11–16,11–25,12,1–2,2.2–4.2,3.0–4.2,3.3–5.5,3–6,4.0–16,4.0–6.5,4.5–20,4–10,5,50,5–11,8–32,anther,anthesi,apart,articulated,base,becoming,bipinnate,blue,calyx,clavate,cm,diameter,divided,equal,filament,flattened,fleshy,flower,fruit,globose,green,hair,herb,leaf,length,light,lobe,long,margin,mm,multicellular,oblong,obovate,pair,pedicel,peduncle,pentagonal,petiole,pinnae,pinnate,pitted,pore,primary,purple,red,ripe,rotate,shallowly,shaped,simple,size,sometimes,stem,stigma,style,surface,tear-drop,time,tripinnate,tube,turning,unicellular,uniseriate,violet,white,wide,winged,woody,x,–10,–12.5,–19,–3,–3.2	0.4,0.6,0.9–1.0,1,1.0,1.4–2.5,1.5,10,1–3,1–6,1–8,2–20,3–22,4.5–7.0,4–30,5.5–8.5,7–10,abaxially,absen,acute,adaxiall,adaxially,ag,along,annual,apex,appressed,arequipa,arranged,asymmetrically,axe,axillary,ba,beyond,blade,borne,branched,brown,cell,connivent,cylindrical,decreasing,decurrent,densely,difoliate,eaf,eed,entire,erect,extending,flange,forming,geminat,glabrous,indistinct,irregularly,lon,longitudinal,lower,m.,midrib,moderately,narrow,nflorescence,node,obtuse,occasionally,often,opening,orolla,ovate,pale,parallel,pendant,perfect,plurifoliate,poricidal,prostrate,pubescent,rapidly,rarely,ruit,running,secondary,shoot,side,spaced,sparsely,specimen,split,stone,straight,subglabrous,tacna,tal,tamen,tem,terminal,tertiary,tip,unit,usually,vary,wing,winge,yellow,ympodial,–46,–48	4.5—7.0,absent,articulation,branching,colour,corolla,decurred,form,growth,height,inflorescence,number,plant,ratio,seed,shape,spacing,staman,texture,type,width	.0,0.1,0.5–1.5,0.6–1.2,0.6–2.0,1.0–1.1,1.0–1.5,1.0–1.8,1.1–1.2,1.4–7.5,1.6–2.7,1.7–7,1.8–3.8,11–16,11–25,12,1–2,2.2–4.2,3.0–4.2,3.3–5.5,3–6,4.0–16,4.0–6.5,4.5–20,4–10,5,50,5–11,8–32,anthesi,apart,articulated,base,becoming,bipinnate,blue,clavate,cm,divided,equal,flattened,fleshy,fruit,globose,green,herb,light,long,mm,multicellular,oblong,obovate,pair,pentagonal,petiole,pinnae,pinnate,pitted,primary,purple,red,ripe,rotate,shallowly,shaped,simple,sometimes,tear-drop,time,tripinnate,turning,unicellular,uniseriate,violet,white,wide,winged,woody,x,–10,–12.5,–19,–3,–3.2	4.5—7.0,absent,decurred
332	wfo-0001029704	success	144	104	46	57	87	47	44	2	.5,1-4,1.5-2.5,140-185,3-4-celled,3-5,anther,apex,base,berry,blue,branch,broadly,calyx,cell,cm,composed,corolla,cuneate,diam,ellipsoid,enlarged,extra-axillary,few-flowered,filament,flower,fork,fruiting,globose,green,leaf,lengthening,minute,mm,moderately,mottled,occasionally,pedicel,petiole,pinnatisect,pore,poricidal,pubescent,purple,shrub,simple,single,slit,stellate,stone,stout,striped,tip,trichome,unit,variously,white	0-1.5,0.5,1,1-2,1.5,1.5-2.5-3,1.5-3,1000-1200,15-25,2-2.5,2-3,2-5,4,4-7,5,7-10,7-10-14-17,9-20,acuman,acuminate,acute,along,also,anthesi,apparently,aspect,axi,brown,c.,conical,cunate,cut,dark,deeply,deflexed,dia,eaf,eed,erect,especially,exerted,flowering,glabrous,gradually,halfway,lanceolate,less,lobe,lobed,long,lower,midrib,minutely,nflorescence,obovate,obovoid,one,ovary,peduncle,plurifoliat,record,reddish,reticulate,rounded,ruit,shoot,short,sinus,sombre,sprawling,stigma,straight,style,subdiscoidal,subglobo,surface,swollen,tub,tube,twig,ud,variable,vein,within,x,ympodial,young	appressed,articulation,bract,branching,breeding,colour,connective,form,fruit,growth,hair,heteromorphism,inflated,inflorescence,insertion,interjected,interpetalar,leaflet,length,margin,marking,mature,modification,na,odour,orientation,paired,pattern,placement,plurifoliate,position,prickle,pseudostipule,rhizome,scale,shape,spot,staman,structure,symmetry,sympodial,system,texture,tissue,tuber,type,xylopodia	.5,1-4,1.5-2.5,140-185,3-4-celled,3-5,berry,blue,branch,broadly,cm,composed,cuneate,diam,ellipsoid,enlarged,extra-axillary,few-flowered,flower,fork,globose,green,lengthening,minute,mm,moderately,mottled,occasionally,pinnatisect,pore,poricidal,pubescent,purple,shrub,simple,single,slit,stellate,stout,striped,tip,trichome,variously,white	na,plurifoliate
333	wfo-0001029727	success	257	118	53	68	189	50	51	2	-3,/3,0-40,0-8,0.4-1,0.7-0.9,3-7,4-merous,4.5,5.5-7,anther,apex,apparently,articulated,base,berry,branched,calyx,chartaceous,climber,cm,colourles,cordate,corolla,cupular,curved,deltoid,densely,drying,erect,filament,flattened-reniform,lateral,leaf,length,lobed,long,lower,margin,mature,mauve,mm,obconical,orange-brown,pedicel,perfect,petiole,pore,poricidal,prickle,prickly,rounded,shallowly,shape,shrub,simple,stellate,stellate-pubescent,stem,straight,subentire,surface,tapering,terminal,tip,trichome,unit,yellowish	.5,0-15,0-2,0-20,0-30,0-4,0-5,0.1-5,0.15-0.2,0.15-0.3,0.2,0.2-0.5,0.2-2.5,0.3,0.4,0.5,0.5-1.2,0.5-3,0.7-1,1,1-1.2,1-2,1-2-5,1-4,1.2-2,1.5-2.3,1.5-2.5,1.5-3,1.5-5.5-10,1.6-3,1/2-2/3,1/3-1/2,1/4,1/8-1/5-1/3,2.5,2.5-3.2,2.5-5.5,2.8-4,3-11,3-6,3/,4-7,4-merou,4.5-5.5-7,5-12,5-8,5-9,6-11,7-10,abaxial,abaxially,acicular,acuminate,acute,adaxial,age,almost,along,alternate,alyx,ame,anthesi,apar,apart,apically,bark,blade,bristle,brown,c.,clavate,connivent,covered,darker,deltate,developing,diameter,different,dimorphic,discolorous,divided,eaf,edge,eed,elongating,equal,except,extending,ferrugineous,filiform,filiform-acuminat,finely,fissure,flower,free,geminate,glabrous,increasing,inside,lengthening,less,like,lobe,lon,longer,m.,middle,midpoint,midvein,minor,minutely,mixture,moderately,narrow-deltate,nflorescence,nther,oblong,occasional,older,one,open,orolla,oung,outside,ovate,pair,papillo,papillose,peduncle,per,perfec,pit,pitted,plurifoliat,porrect,portion,prickl,primary,protruding,pubescent,raised,rarely,ray,red-brow,red-brown,reddish,reduced,regular,scandent,scar,seed,series,sessile,short,sinus,size,smooth,sometimes,spaced,spreading,stalk,stalked,stigma,strongly,style,tamen,tearing,terete,tertiary,time,toward,translucent,transverse,tube,unarmed,uneven,upper,variable,variously,vary,vein,venation,violet,visible,way,wide,x,ympodial,young	appressed,articulation,bract,branching,breeding,broad-based,cell,colour,connective,form,fruit,fruiting,growth,hair,heteromorphism,inflated,inflorescence,insertion,interjected,interpetalar,leaflet,marking,modification,na,needle-like,odour,orientation,paired,pattern,placement,plurifoliate,position,pseudostipule,rhizome,scale,smell,spot,staman,stone,structure,symmetry,sympodial,system,texture,tissue,tuber,type,vegetative,xylopodia,zygomorphy	-3,/3,0-40,0-8,0.4-1,0.7-0.9,3-7,4-merous,4.5,5.5-7,apparently,articulated,base,berry,branched,chartaceous,climber,cm,colourles,cordate,cupular,curved,deltoid,densely,drying,erect,flattened-reniform,lateral,length,lobed,long,mauve,mm,obconical,orange-brown,perfect,poricidal,prickly,rounded,shallowly,shrub,simple,stellate,stellate-pubescent,straight,subentire,surface,tapering,terminal,tip,yellowish	na,plurifoliate
334	wfo-0001029731	success	246	107	41	57	189	50	38	3	.5,1/3,accrescent,almost,anther,apex,apically,base,becoming,berry,branched,branching,calyx,coriaceous,corolla,cuneate,dilated,entire,epiphyte,filament,flattened,fleshy,fruit,fruiting,glabrous,hair,leaf,liana,lobed,long-ellipsoid,lower,margin,mature,mauve,mm,oblong,often,pedicel,petiole,pore,poricidal,pyriform,reflexed,rounded,simple,sometimes,sparsely,stem,succulent,surface,terminal,thick,tip,trichome,unit,white,yellow-green	.6,0.05,0.1-0.8,0.25-0.3,1,1-1.5,1-2,1-2.5,1.5,1.5-2.5,1.5-3,10-20,1994,2,2-3,2-6,2.5,2.5-4.5,3,3-10,3-4,31,4,4-5,4-9,6,6-7,7-11,8-9,abaxially,acquiring,acuminate,acute,adaxially,age,along,alyx,anthesi,apar,apparently,arcy,articulated,bark,basal,basally,beak,black,boundary,branch,broadly,brown,bumpy,clavate,clearly,cm,concolorous,conical,connate,crinkled,darker,delimited,delineated,deltoid,dense,development,diameter,different,distributed,domatia,dorsal,dorsifixed,dry,drying,dull,eaf,early,elliptic,elongating,enlarge,equal,erect,even,evenly,exserted,faint,filiform,fine,finely,flaring,flower,free,ground,iscoid,lamina,large,later,lateral,lengthening,less,like,linear,lobe,lon,long,longitudinal,longitudinally,main,maturity,midvein,much,narrowly,nflorescence,nther,obconical,obovate,obtuse,occasionally,orange-brown,orolla,pair,papillae,papillose,part,peduncle,pendulous,perfec,pericarp,persisting,plurifoliat,portion,primary,prominent,protruding,rachi,raised,rakotozafy,rarely,reported,revolute,ribbed,ridge,ridged,ruit,scar,see,several,shallowly,shorter,sinus,slender,slightly,small,smaller,smoot,stigma,straight,stretched,stump,style,sunk,tearing,thickened,thinner,though,time,toward,tub,tube,tuft,ud,usually,vary,vein,venation,ventral,visibl,visible,well-developed,wide,widely,wing,winged,woody,wrinkling,x,yellow,ympodial,young,’	appressed,articulation,bract,breeding,broad-based,cell,colour,connective,form,growth,heteromorphism,inflated,inflorescence,insertion,interjected,interpetalar,leaflet,length,marking,modification,na,needle-like,odour,orientation,paired,pattern,placement,plurifoliate,position,prickle,pseudostipule,rhizome,scale,shape,smell,spot,staman,stellate,stone,structure,symmetry,sympodial,system,texture,tissue,tuber,type,vegetative,xylopodia,zygomorphy	.5,1/3,accrescent,almost,apically,base,becoming,berry,branched,coriaceous,cuneate,dilated,entire,epiphyte,flattened,fleshy,glabrous,liana,lobed,long-ellipsoid,lower,mauve,mm,oblong,often,poricidal,pyriform,reflexed,rounded,simple,sometimes,sparsely,succulent,terminal,thick,tip,white,yellow-green	na,plurifoliate,stellate
335	wfo-0001029741	success	137	161	82	104	33	57	78	4	.4,.5,0.5-1.5,0.8-3.5,0.9-1.2,1-1.5,1-3.5,1.1-1.3,1.5-4,1.5-6,10-50-flowered,2-2.5,2.2-9,2.5-7.8,3,9.5-22.5,?,acute,age,anther,anthesi,apex,apiculate,attenuate,base,becoming,berry,black,branched,calyx,capitate,closely,cm,completely,corolla,dark,deflexed,deltoid,dia,difoliate,dry,early,elliptic,erect,exserted,filament,flower,fruit,fruiting,furcate,glabrous,globose,green,growth,inflorescence,known,lateral,leaf,lenticellate,lighter,lobe,lobed,long,major,minor,minutely,mm,nearly,new,opposite,ovary,ovate,overlapping,papillose,pedicel,petiole,pore,poricidal,prominent,raised,reddish-brown,scar,shaped,shrub,size,slender,slightly,spaced,stem,stigma,straight,style,tapering,tear-drop,tip,tree,tube,unit,usually,vein,weak,white,woody,x	1.5,accrescent,ca,caly,differing,divisio,drying,eaf,edicel,eed,free,geminat,glabrou,immature,lon,lower,main,middle,nflorescence,pair,papillo,planar,portion,produced,proximal,quite,ruit,tall,ud,variable,widest,wood,ympodial	accrescence,articulation,bract,branching,breeding,bud,cell,colour,connective,diameter,exsertion,form,geminate,glabrousnes,hair,height,heteromorphism,insertion,interjected,interpetalar,leaflet,length,lobing,margin,marking,mature,maturity,modification,na,number,odour,orientation,paired,pattern,placement,plant,position,presence,prickle,pseudostipule,rhizome,scale,seed,shape,spacing,spot,staman,stone,structure,symmetry,sympodial,system,texture,tissue,tuber,type,xylopodia	.4,.5,0.5-1.5,0.8-3.5,0.9-1.2,1-1.5,1-3.5,1.1-1.3,1.5-4,1.5-6,10-50-flowered,2.2-9,2.5-7.8,3,9.5-22.5,?,acute,age,apiculate,attenuate,base,becoming,berry,black,branched,calyx,capitate,closely,cm,completely,dark,deflexed,deltoid,dia,difoliate,dry,early,elliptic,erect,exserted,furcate,glabrous,globose,green,known,leaf,lenticellate,lighter,lobed,long,minutely,mm,nearly,opposite,ovate,overlapping,papillose,pore,poricidal,prominent,raised,reddish-brown,shaped,shrub,slender,slightly,spaced,straight,tapering,tear-drop,tip,tree,tube,usually,weak,white,woody,x	-2.5,di,geminate,na
336	wfo-0001029744	success	113	116	64	81	32	35	60	4	0.3-0.6,0.5-1,1,1.5,2,2-4,5-8,50,8-10-flowered,8-11,abaxially,acute,adaxially,apart,apex,bark,base,beginning,blunt,branch,calyx,cm,deltate,dendritic,densely,difoliate,elliptic,entire,extreme,flattened,flexuous,form,fruit,geminate,glabrescent,glabrous,golden,incrassate,lanceolate,leaf,lobe,long-acuminate,margin,mature,minutely,mm,narrowly,oblanceolate,oblique,occasionally,older,opposite,ovoid-reniform,pair,pale,pedicel,petiole,pitted,primary,pubescent,revolute,scar,shape,shrub,simple,single-celled,slightly,sometimes,somewhat,stem,surface,thin,tip,trichome,unifoliate,uniseriate,unit,vein,white,x,young	1.5-3.2,7-15,along,brow,denser,distinct,eaf,eed,examined,fide,inflorescenc,lamina,leave,looping,lower,major,marginal,minor,nflorescence,node,non-reproductive,pubescence,see,similar,small,smaller,smith,spaced,thee,ud,unicellular,ympodial	arrangement,brown,bud,cell,colour,flower,growth,hair,height,heteromorphism,inflorescence,length,na,number,odour,plant,position,presence,prickle,pseudostipule,rhizome,seed,seen,size,smell,spacing,staman,stone,structure,sympodial,texture,tuber,type,vegetative,xylopodia	0.3-0.6,0.5-1,1,1.5,2,2-4,5-8,50,8-10-flowered,8-11,acute,apart,base,beginning,blunt,branch,cm,deltate,dendritic,densely,difoliate,elliptic,entire,extreme,flattened,flexuous,geminate,glabrescent,glabrous,golden,incrassate,lanceolate,leaf,long-acuminate,minutely,mm,narrowly,oblanceolate,oblique,occasionally,opposite,ovoid-reniform,pair,pale,pitted,pubescent,revolute,shrub,simple,single-celled,slightly,sometimes,somewhat,thin,tip,trichome,unifoliate,uniseriate,white,x	brown,inflorescence,na,seen
337	wfo-0001029746	success	179	155	80	99	80	56	76	4	.5,0.3-2,0.5-1,0.7-1,1-1.5,1.5,2-2.5,2-8,3-4,3-4-pluri-foliate,8-10,8-11,age,anther,anthesi,apart,apex,base,berry,broadly,calyx,cell,centre,ciliate,cm,cordate,corolla,cup-shaped,darker,densely,diameter,ellipsoid,elliptic,enlarged,entire,erect,exerted,filament,flattened,fleshy,flush,fruit,fruiting,gland-tipped,glandular,globose,greenish,herb,heteromorphic,hollow,inflorescence,internodal,leaf,lengthening,lobe,lower,margin,mature,minutely,mm,narrowly,nodding,orange,ovate,pale,papillose,pedicel,peduncle,petiole,pore,poricidal,principal,pubescent,purple,rachi,red,reddish,reflexed,scar,simple,single,slightly,slit,somewhat,sparsely,spreading,stem,strongly,subshrub,surface,tip,triangular,trichome,tube,uniseriate,unit,vein,x,–3	1,1-1.3,1.2-1.5,2,2-4,2-7,3,3-4.5,3-6,4-9,6,6-7,abaxially,acuminate,acute,adaxially,bearing,becoming,blackish,brown,c.,capitate,color,conical,crenate,crowded,curved,dark,eaf,edicel,eed,flower,free,glabrous,growing,horn,irregularly,lamina,less,lon,long,longer,longest,markedly,maturit,mid-length,mixed,near,nflorescence,occasionally,ovary,ovoid,pair,papillo,pericarp,pitted,plan,portion,primary,pubescen,ruit,shallowly,shortest,slender,spaced,sparse,stigma,straight,style,testal,thin,third,ud,upper,upward,wall,widely,widest,woody,ympodial	appressed,arrangement,articulation,bract,branching,breeding,broad-based,bud,ciliation,colour,connective,flushnes,form,growth,hair,heteromorphism,inflated,insertion,interjected,interpetalar,leaflet,length,marking,maturity,modification,na,needle-like,odour,orientation,paired,pattern,placement,position,present,prickle,pseudostipule,pubescence,rhizome,scale,shape,smell,spacing,spot,staman,stone,structure,symmetry,sympodial,system,texture,tissue,tuber,type,vegetative,xylopodia,zygomorphy	.5,0.3-2,0.5-1,0.7-1,1-1.5,1.5,2-2.5,2-8,3-4,3-4-pluri-foliate,8-10,8-11,age,apart,berry,broadly,calyx,centre,ciliate,cm,cordate,cup-shaped,darker,densely,ellipsoid,elliptic,enlarged,entire,erect,exerted,flattened,fleshy,flush,fruit,gland-tipped,glandular,globose,greenish,herb,heteromorphic,hollow,internodal,lengthening,lobe,mature,minutely,mm,narrowly,nodding,orange,ovate,pale,papillose,poricidal,principal,pubescent,purple,rachi,red,reddish,reflexed,simple,single,slightly,slit,somewhat,sparsely,spreading,strongly,subshrub,tip,triangular,uniseriate,vein,x,–3	maturity,na,present,zygomorphy
338	wfo-0001029769	success	142	122	72	74	68	48	66	6	.25,.5,0.5-1.5,1-1.2,1-3,1.5-2,1.5-2.5,2.5-3,3.5-4,4,4-5,5-8,6-17,8-9,acuminate,acute,anther,apex,base,brochidodromu,brown,calyx,cm,conical,corolla,cyathiform,dark,deflexed,densely,elliptic,exserted,fresh,fruiting,glabrous,globose,green,horizontally,internodal,lateral,leaf,lobed,main,margin,minutely,mm,nearly,opposite,ovoid-reniform,pair,papillose,pedicel,petiole,pitted,pore,poricidal,puberulent,pubescent,scar,shaped,shrub,simple,smooth,somewhat,sparsely,surface,swollen,tear-drop,tip,tube,unit,vein,white,wide,x	2.5-8,30-60-flowered,7-8,8.5-17,abaxially,adaxially,along,anthesi,apar,ape,archin,ba,bark,bearing,berry,branch,capitate,cerro,curl-tipped,deltoid,dia,eaf,edicel,eed,filament,filiform,flower,free,golden,hen,inglé,less,like,lobe,lon,long,lower,midrib,nflorescence,older,onto,ovary,papillo,portion,reflexed,ried,ruit,scattered,spaced,stem,stigma,straight,style,tall,three,time,trichome,tub,two,ud,unevenly,unifoliat,uniseriate,widely,winged,woody,ympodial,young	abaxial,adaxial,apart,arching,branching,bud,cell,colour,deflexion,diameter,dried,exsertion,form,fruit,growth,height,heteromorphism,inflorescence,length,marking,na,odour,orientation,pattern,placement,plant,position,prickle,pseudostipule,pubescence,rhizome,seed,shape,size,spacing,spot,staman,stone,structure,symmetry,sympodial,texture,tuber,type,unifoliate,venation,xylopodia,zygomorphy	.25,.5,0.5-1.5,1-1.2,1-3,1.5-2,1.5-2.5,2.5-3,3.5-4,4,4-5,5-8,6-17,8-9,acuminate,acute,apex,base,brochidodromu,brown,calyx,cm,conical,cyathiform,dark,deflexed,densely,elliptic,exserted,fresh,glabrous,globose,green,horizontally,internodal,lateral,leaf,lobed,main,margin,minutely,mm,nearly,opposite,ovoid-reniform,pair,papillose,pitted,pore,poricidal,puberulent,pubescent,shaped,shrub,simple,smooth,somewhat,sparsely,swollen,tear-drop,tip,tube,vein,white,wide,x	apart,arching,dried,na,unifoliate,zygomorphy
339	wfo-0001029780	invalid_json	204	159	NA	139	65	20	NA	NA	1-2,11-24,120-210,15-22,15-45,2-12,2-2.5,2-2.8,2-3.5,2-5.5,20-60,3,3-6,3.5-7.3,4-6,4.5-6,5-7,5.5-13,50-70,600-950,8-12,?,abaxially,absent,adaxially,along,anther,blade,borne,brownish,cell,chartaceous,ciliate,cm,condition,connivent,corolla,covering,dark,densely,diameter,distal,dorsally,drying,edge,end,especially,except,filament,flat,flower,folded,forked,fresh,fruit,generally,glabrous,gland,glandular,globose,greatly,green,green-white,greenish,hair,hair-like,half,head,herb,homostylous,interjected,lanceolate,lateral,leaflet,length,lengthening,like,longer,make,margin,membranous,midrib,minute,minutely,mm,mucilaginous,non-glandular,odd-pinnate,often,orbicular,ovate,ovoid,pair,pale,pedicel,peduncle,petiole,petiolulate,petiolule,pinkish,plant,pore,poricidal,proximal,puberulent,pubescent,rarely,reduced,ripe,rotate,seed,sessile,short,singly,size,slit,stem,stigma,straight,streak,stripe,style,subequal,terminal,testal,tetralobulate,thick,throughout,tip,trichome,tuber,typically,usually,wall,wet,white,whitish,x,yellow	1-1.2,1-10,1.4-1.9,1.5-2,2.4-4.2,5-merou,5.5,acumen,acute,ag,alyx,apart,apex,apparently,articulated,attenuate,axe,axillary,base,berry,bud,capitat,cordate,cuneate,decumbent,digestion,eaf,eed,enzyme,erec,exceeding,geminat,glabrou,hal,high,honeycomb-shaped,invested,living,lobe,long,lower,nflorescence,obtuse,orolla,perfect,plurifoliate,removed,ruit,seudostipule,spaced,specimen,stamen,ste,stolo,subtending,tall,tamen,tem,tri-,truncate,tube,unit,unwinged,vary,ympodial	5-merous,age,arrangement,branching,calyx,capitate,characteristic,colour,form,growth,height,inflorescence,leaf,ovary,presence,pseudostipule,shape,stolon,texture,value	NA	NA
340	wfo-0001029784	success	229	108	52	66	163	42	47	5	.5,0-4,0.1-0.5,0.25-0.3,0.3-0.5,0.3-1,0.5-1.5,2-4,2-foliate,acute,anther,apex,articulation,base,berry,bract,calyx,cell,cm,corolla,dark,developed,distal,eglandular,enclosing,filament,fruit,fruiting,globose,golden,green,half,herb,imparipinnate,inflorescence,interjected,interrupted,lanceolate,leaflet,long,loosely,lower,margin,mm,node,often,pair,pedicel,pentagonal,petiole,present,pseudostipule,pubescent,simple,soft,sparsely,stem,stripe,surface,trichome,truncate,unit,velvety,white,wide,yellow	.1,.2,0.1-0.15,0.1-0.2-0.3,0.2,0.2-0.3,0.2-0.5,0.2-0.7-1.2,0.3-0.35,0.3-0.4,0.4-0.45,0.4-0.5,0.4-0.6,0.4-1-2,0.5,0.5-1.2-2.5,0.6-1,0.9-1.2,1,1-1.1,1-1.2,1-1.5,1-2,1-2-4.5,1-2-celled,1-2.5-3.5,1-4,1.0-1.3,1.5-3-5,1.7-2.6,1/3,2,2-2.5-5,2-3-celled,2-5-14,2-locular,2/3,3-5-8,5-10-12,abaxial,abaxially,absent,abundant,acuminate,adaxially,adpressed,along,angled,anthesi,apical,appearance,appendage,arising,articulated,axi,basal,basicopically,beneath,broadly,brown,capitate,column,conical,crenate-serrate,crenation,decurrent,deeper,densely,diameter,distributed,due,eaf,edicel,eed,elliptic,entire,evenly,exserted,flower,giving,glabrescent,glabrous,glandular,gree,hair-like,hal,halfway,head,included,internode,interspersed,irregularly,lamina,larger,lateral,like,live,lobe,lon,long-acuminate,markedly,maturing,mostly,multicellular,narrowly,nflorescence,northern,obovate,occasionally,orbicular,outgrowth,ovary,pale,paler,patent,peduncle,perennial,petiolule,plant,population,primary,proximal,pubescence,rarely,reflexed,ripe,robust,ruit,scattered,secondary,sessile,silky,smaller,sometimes,somewhat,sparse,spreadin,staminal,sterile,stigma,stout,straight,strongly,style,tem,terminal,tertiary,testa,thick,trailing,tube,ud,undulate,unicellular,uniseriate,unseriate,usually,vein,wall,winged,woody,x,ympodial	appressed,branching,breeding,broad-based,colour,form,growth,hair,heteromorphism,inflated,insertion,interpetalar,leaf,length,marking,mature,modification,na,odour,orientation,paired,pattern,placement,pore,position,prickle,rhizome,scale,shape,spot,spreading,staman,stone,structure,symmetry,sympodial,system,texture,tissue,tuber,type,xylopodia	.5,0-4,0.1-0.5,0.25-0.3,0.3-0.5,0.3-1,0.5-1.5,2-4,2-foliate,acute,berry,cm,dark,developed,distal,eglandular,enclosing,globose,golden,green,half,herb,imparipinnate,interrupted,lanceolate,long,loosely,lower,mm,node,often,pair,pentagonal,present,pubescent,simple,soft,sparsely,stem,stripe,surface,trichome,truncate,velvety,white,wide,yellow	broad-based,leaf,na,prickle,spreading
341	wfo-0001029785	success	223	115	52	68	155	47	50	2	0-2,1-2,1.2-3.2,3.5-5,6,abaxially,absent,adaxially,anther,apex,articulation,axillary,base,berry,bud,cell,chartaceous,cm,commonly,corolla,cuneate,dark,darker,distal,filament,forked,fruit,globose,green,hair,herb,interjected,lanceolate,leaf,leaflet,long,lower,margin,membranous,middle,minute,mm,oblique,odd-pinnate,outer,ovoid,pedicel,pentagonal,petiole,plurifoliate,pore,poricidal,purple,quite,ripe,rotate,rounded,scale-like,slightly,stem,subtending,terminal,tip,tri-,tuber,unit,variable,violet	0-3,0.1-0.5,0.3-2.2,0.4-4.9,0.8-1,1-1.2,1-10,1-5,1.5-3.6,1.8-3.5,1.8-7,10-26,2-4,3-4,3-6,3-8,3.8-7.2,4-10.5,5-16,5-9,5-merou,8-11,acumen,acute,ag,along,alyx,apart,apparently,attenuate,axe,blade,borne,broadly,brownish,capitat,clavate,condition,connivent,cordate,covering,decreasing,decumbent,denser,diameter,digestion,dorsally,drying,eaf,edge,eed,elliptic,end,enzyme,erec,especially,exceeding,flat,flower,folded,fresh,geminat,generally,glabrou,glabrous,greatly,green-white,greenish,hair-like,half,homostylous,honeycomb-shaped,invested,larger,lateral,lengthening,like,living,lobe,make,markedly,medium,midrib,minutely,mottled,much,mucilaginous,multiple-celled,nflorescence,non-glandular,obovate,obtuse,one-quarte,orbicular,orolla,ovate,pair,pale,peduncle,perfect,petiolulate,petiolule,plant,point,present,puberulent,pubescent,purple-tinged,rarely,removed,ruit,seed,sessile,seudostipule,shallowly,short,singly,size,slit,sometimes,spaced,sparsely,specimen,stamen,ste,stigma,stolo,straight,stripe,style,subglabrous,tall,tamen,tem,testal,thick,throughout,toward,truncate,tube,typically,unbranched,unequal,unwinged,usually,vary,vein,wall,wet,white,whitish,wide,x,yellow,ympodial	appressed,bract,branching,broad-based,calyx,colour,connective,form,fruiting,growth,heteromorphism,inflated,inflorescence,insertion,interpetalar,length,marking,mature,modification,na,needle-like,odour,one-quarter,orientation,paired,placement,position,prickle,pseudostipule,rhizome,scale,shape,smell,spot,staman,stone,structure,surface,symmetry,sympodial,texture,tissue,trichome,type,vegetative,xylopodia,zygomorphy	0-2,1-2,1.2-3.2,3.5-5,6,abaxially,absent,adaxially,axillary,berry,bud,chartaceous,cm,commonly,corolla,cuneate,dark,darker,distal,forked,globose,green,herb,lanceolate,long,margin,membranous,middle,minute,mm,oblique,odd-pinnate,outer,ovoid,pentagonal,plurifoliate,poricidal,purple,quite,ripe,rotate,rounded,scale-like,slightly,subtending,terminal,tip,tri-,variable,violet	na,one-quarter
342	wfo-0001029789	success	167	142	62	86	81	56	60	2	0.2-0.5,0.5-2.8,0.8-3.5,1-10,1-3,1.7-8.5,1.8-6.5,12,2-25,2-6,2-6.5,2.7-4.7,3-8.5,4-10,4-13,5-7,7-16.6,7-21,8-9,abaxially,adaxially,anther,apex,base,blade,blue,chartaceous,clavate,cm,corolla,decurrent,diameter,distal,filament,flower,forked,fruit,glabrous,hair,half,herb,homostylous,interjected,lanceolate,lateral,leaf,leaflet,lilac,lower,membranous,minute,minutely,mm,mottled,odd-pinnate,orbicular,ovary,ovate,pedicel,peduncle,pentagonal,petiole,plant,plurifoliate,pore,poricidal,pubescent,rachi,rotate,sessile,short,simple,size,sparsely,star,stigma,straight,style,subglabrous,terminal,tip,tri-,typically,unit,white,x	0-2,1-2,1.5-2,2-3,3-5,5-merou,6,6-7,acumen,acuminate,acute,adaxiall,ag,alyx,apart,apparently,articulated,attenuate,axe,axillary,basiscopic,broadly,bud,capitat,connivent,dark,decreasing,dorsally,eaf,edge,eed,erec,exceeding,flat,folded,formed,geminat,generally,greatly,green,hal,lant,lengthening,light,like,linear,lobe,long,long-attenuate,lunate,maturing,narrowly,never,nflorescence,orolla,pair,perfect,petiolulate,pubescen,purpl,rarely,seudostipule,side,slightly,slit,spaced,stamen,ste,sterile,subequal,subtending,tall,tamen,tem,tinged,toward,tube,usually,vary,yellow,ympodial	arrangement,articulation,bract,branching,breeding,broad-based,calyx,capitate,cell,colour,connective,density,form,fruiting,growth,height,heteromorphism,inflorescence,insertion,interpetalar,length,margin,marking,modification,na,needle-like,number,odour,orientation,paired,pattern,placement,position,prickle,pseudostipule,rhizome,scale,shape,smell,spacing,spot,staman,stem,stone,structure,surface,symmetry,sympodial,system,texture,tissue,trichome,tuber,type,vegetative,xylopodia	0.2-0.5,0.5-2.8,0.8-3.5,1-10,1-3,1.7-8.5,1.8-6.5,12,2-25,2-6,2-6.5,2.7-4.7,3-8.5,4-10,4-13,5-7,7-16.6,7-21,8-9,abaxially,adaxially,blue,chartaceous,clavate,cm,decurrent,distal,forked,glabrous,half,herb,homostylous,lanceolate,lilac,membranous,minute,minutely,mm,mottled,odd-pinnate,orbicular,ovate,pentagonal,plurifoliate,poricidal,pubescent,rotate,sessile,short,simple,sparsely,star,straight,subglabrous,terminal,tip,tri-,typically,white,x	capitate,na
343	wfo-0001029810	success	149	125	85	91	58	34	74	11	0.5-3,1-1.3,1-1.5,1-10,1-2,1-3,1.1-2.3,1.5-3,2-3,2-5,2.5-3,3-3.5,3-4,4-10,5-6,acuminate,acute,adaxially,along,anther,apex,apically,arachnoid,attenuate,bark,base,brown,calyx,capitate,closely,cm,conical,corolla,dark,dendritic,dia,difoliate,elliptic,filament,fruiting,glabrous,globose,green,inflorescence,internodal,large,leaf,lenticel,lobed,long,lower,minor,minutely,mm,narrowly,nearly,occasionally,opposite,ovary,ovoid-reniform,pale,papillose,pedicel,petiole,pitted,pointed,pore,pubescent,reddish-brown,shaped,shining,shrub,size,slender,small,spaced,sparsely,stem,stigma,style,surface,tan,tapering,tear-drop,tree,trichome,tube,unit,vein,white,wide	.25,.5,0.5-1,3-6,5-15-flowered,5-16,8-12,abaxially,anthesi,ape,berry,compact,compressed,congested,deflexed,deltate,densely,differing,drying,eaf,edicel,eed,ellipsoid,exserted,fleshy,free,geminat,glabrou,later,lateral,less,like,lobe,lon,main,major,margin,middle,nflorescence,older,overlappin,papillo,planar,poricidal,portion,rest,ruit,scar,simple,tall,tip,tub,ud,widest,woody,yellowish,ympodial,young	0.25,0.5,1.5,5-15,articulation,broad-based,colour,diameter,flower,form,fruit,geminate,growth,hair,height,insertion,length,mature,na,needle-like,number,orientation,overlapping,placement,plant,position,prickle,seed,shape,structure,sympodial,texture,type,width	0.5-3,1-1.3,1-1.5,1-10,1-2,1-3,1.1-2.3,1.5-3,2-3,2-5,2.5-3,3-4,4-10,5-6,acuminate,acute,adaxially,along,apex,apically,arachnoid,attenuate,base,brown,calyx,capitate,closely,cm,conical,dark,dendritic,dia,difoliate,elliptic,glabrous,globose,green,internodal,large,leaf,lobed,long,lower,minutely,mm,narrowly,nearly,occasionally,opposite,ovoid-reniform,pale,papillose,pitted,pointed,pubescent,reddish-brown,shaped,shining,shrub,slender,small,spaced,sparsely,stem,surface,tan,tapering,tear-drop,tree,trichome,tube,vein,white,wide	-3.5,0.25,0.5,1.5,5-15,broad-based,di,geminate,na,needle-like,overlapping
344	wfo-0001029811	success	224	97	42	54	170	43	38	4	0.5-2,1.5-6,15-23,20-100,7-9,andromonoecious,anther,apex,articulated,base,berry,calyx,cell,chartaceous,cm,connivent,cordate,cuneate,dark,elongating,equal,filament,fruit,fruiting,glabrous,hair,herb,lateral,leaf,length,lobed,long,margin,marking,mature,maturity,mauve,mm,pedicel,petiole,poricidal,prickle,shrub,simple,sometimes,spherical,stellate,stem,straight,tapering,tip,unbranched,unit,yellow	-3,-merous,.5,/3,0,0-30,0-35,0.1-0.3,0.1-0.4,0.2,0.2-0.6,0.3-1,0.3-1.5,0.8-1.5,1,1-1.5,1-2.5,1-3,1.3-1.7,1.5-2.5,1/,1/2-2/3,1/3,1/3-2/3,10-22,13-20,15-50,2-2.5,2-5,2-5.5,2.5-3,2.8-3.2,3-5,3-5.5,3-7,3.5-4.5,4-8,4.5-5,5-11,5-17,5-40,5-6,5-9,6-12,7-18,8-12,8-18,abaxial,abaxially,acicular,adaxial,alyx,apar,apart,apically,apparently,bark,blade,broad-deltate,brown,cream,densely,diameter,discolorous,distal,distance,drying,eaf,eed,elongate,erect,extending,eye,faint,fewer,flattened,flattened-reniform,flower,free,glandular,green,green-brow,hermaphrodite,heterostylous,inflated,infructescence,less,lobe,lobing,long-acuminat,long-styled,longer,lower,lowermost,midpoint,midvein,minute,moderately,multangulate,naked,narrow-deltate,nflorescence,obtuse,often,older,one,open,orange-brown,orolla,oung,outline,ovate,pair,pale,peduncle,pendulous,per,pericarp,perpendicular,pit,plant,plurifoliat,porrect,portion,prickl,prickly,primary,raised,ray,ruit,scandent,scar,secondary,sessile,short,short-styled,shorter,side,slightly,small,smooth,spaced,sparsely,spreading,stalk,stalked,staminat,stellate-pubescent,stout,style,surface,tamen,terete,tertiary,time,trichome,tube,unarmed,upper,usually,vary,vein,venation,visible,way,wide,woody,yellow-green,ympodial,young	articulation,bract,branching,breeding,broad-based,colour,connective,corolla,form,growth,heteromorphism,inflorescence,insertion,interjected,interpetalar,leaflet,modification,na,needle-like,odour,orientation,paired,pattern,placement,plurifoliate,pore,position,pseudostipule,rhizome,scale,shape,spot,staman,stone,structure,symmetry,sympodial,system,texture,tissue,tuber,type,xylopodia	0.5-2,1.5-6,15-23,20-100,7-9,andromonoecious,articulated,base,berry,chartaceous,cm,connivent,cordate,cuneate,dark,elongating,equal,glabrous,herb,lateral,lobed,long,maturity,mauve,mm,poricidal,prickle,shrub,simple,sometimes,spherical,stellate,stem,straight,tapering,tip,unbranched,yellow	broad-based,na,needle-like,plurifoliate
345	wfo-0001029978	success	208	198	120	139	69	59	115	5	0.3-0.4,0.5-0.6,0.8,0.9-2.3,1-10,1-2,1.3-1.5,1.4-1.5,1.5-3.1,11-19,15-27,2-4,3-5,3-7,3.1-6.3,3.2-2.5,3.5-9.5,3.7-8.1,4-11,4-7,4.2-5.2,5,5-16.5,8-10,abaxially,adaxially,anther,apart,apex,articulated,asymmetrical,axillary,base,berry,blade,brownish,bud,cell,chartaceous,clavate,cm,coarsely,commonly,condition,conical,connivent,corolla,dark,decreasing,diameter,digestion,distal,dorsally,drying,edge,enzyme,filament,finely,flat,flower,folded,forked,fresh,fruit,glabrous,gradually,green,greenish,hair,herb,homostylous,honeycomb-shaped,interjected,lanceolate,lateral,leaf,leaflet,lengthening,less,light,like,lobe,long,lower,margin,medium,membranous,middle,minute,minutely,mm,moniliform,mottled,odd-pinnate,orbicular,ovate,ovoid,pedicel,peduncle,pentagonal,petiole,plant,plurifoliate,pore,poricidal,puberulent,pubescent,purple,removed,ripe,rotate,seed,sessile,simple,size,slit,sparsely,stem,stigma,straight,style,subequal,subsessile,subtending,symmetrical,terminal,testal,tip,tissue,toward,tri-,tube,tuber,unit,wall,whitish,wide,wing,x	0.3-0.7,0.7-1.9,1.8-5,5-merou,acumen,acuminate,ag,along,alyx,apparently,arranged,attenuate,axe,basiscopic,bead,capitat,ciliate,covering,darker,eaf,eed,elliptic,erec,especially,exceeding,fourt,geminat,generally,glabrou,green-white,hair-like,half,larger,living,make,midrib,mucilaginous,multiple,narrow,necklace,nflorescence,orolla,pair,perfect,petiolule,pubescen,ray,ruit,secondary,semierect,seudostipule,side,slightly,spaced,specimen,stamen,ste,stolon,tall,tamen,tem,thick,throughout,typically,usually,vary,wet,yellow,ympodial	age,appressed,arrangement,articulation,bract,branching,breeding,broad-based,calyx,capitate,colour,connective,form,fourth,fruiting,geminate,growth,height,heteromorphism,inflated,inflorescence,insertion,interpetalar,length,marking,mature,modification,na,needle-like,number,odour,orientation,ovary,paired,pattern,placement,position,prickle,pseudostipule,pubescence,rhizome,scale,shape,smell,spacing,spot,staman,stone,structure,surface,symmetry,sympodial,system,texture,trichome,type,vegetative,width,xylopodia	0.3-0.4,0.5-0.6,0.8,0.9-2.3,1-10,1-2,1.3-1.5,1.4-1.5,1.5-3.1,11-19,15-27,2-4,3-5,3-7,3.1-6.3,3.2-2.5,3.5-9.5,3.7-8.1,4-11,4-7,4.2-5.2,5,5-16.5,8-10,abaxially,adaxially,apart,articulated,asymmetrical,axillary,base,berry,brownish,bud,chartaceous,clavate,cm,coarsely,commonly,condition,conical,connivent,dark,decreasing,diameter,digestion,distal,dorsally,drying,enzyme,finely,flat,flower,folded,forked,fresh,fruit,glabrous,gradually,green,greenish,hair,herb,homostylous,honeycomb-shaped,lanceolate,lateral,leaf,leaflet,lengthening,less,light,like,long,medium,membranous,middle,minute,minutely,mm,moniliform,mottled,odd-pinnate,orbicular,ovate,ovoid,pentagonal,plurifoliate,pore,poricidal,puberulent,pubescent,purple,removed,ripe,rotate,sessile,simple,size,slit,sparsely,stem,straight,subequal,subsessile,subtending,symmetrical,terminal,tip,toward,tri-,wall,whitish,wide,x	age,capitate,fourth,geminate,na
346	wfo-0001029980	success	173	188	117	137	36	51	114	3	.1,.5,0.1-0.25,0.25-0.5,0.25-1,0.5-1,0.5-1.2,0.5-2.5,0.5-5,0.7-1.3,0.8-1.2,0.9-4.5,1-1.5,1-1.7,1.2-2.5,1.5-2,1.5-6,2-5,2/3,3-4,3-9,5-10,5-50-flowered,6.4-17,acute,anther,apex,appearing,appressed,bark,base,berry,black,bright,brown,bud,calyx,cm,conical,corolla,curved,dark,decurrent,deflexed,deltoid,density,dia,difoliate,dried,elliptic,especially,exserted,filament,five,flattened-reniform,fruiting,glabrous,globose,gray,greatly,green,greenish-white,incrassate,knob,lateral,leaf,live,lobe,lobed,long,main,major,margin,material,middle,minor,minutely,mm,near,node,older,one,onto,opposite,orbicular,ovary,ovate,pair,pale,paler,papillose,pedicel,petiole,pitted,plant,pore,poricidal,proximal,puberulent,rounded,scar,shape,shaped,shiny,shrub,side,simple,size,slender,slightly,small-capitate,somewhat,soon,stem,stigma,straight,style,surface,tan,tapering,tear-drop,tip,trichome,tube,tuft,unicellular,uniseriate,unit,varying,vein,way,white,widest,winged,woody,x,young	2-6,abaxially,adaxially,anthesi,apar,axil,ba,closely,differing,drying,eaf,edicel,eed,elevation,free,geminat,high,impressed,lon,lower,nflorescence,often,overlapping,portion,prominent,race,reflexed,ruit,spaced,specimen,tall,ud,venezuelan,whit,yellowish,ympodial	abaxial,apart,articulation,bract,branching,breeding,cell,colour,connective,flower,form,fruit,geminate,growth,hair,height,heteromorphism,inflorescence,insertion,interjected,interpetalar,leaflet,length,marking,mature,modification,na,odour,orientation,part,pattern,placement,position,prickle,pseudostipule,rhizome,scale,seed,spacing,spot,staman,stone,structure,symmetry,sympodial,system,texture,tissue,tuber,type,xylopodia	.1,.5,0.1-0.25,0.25-0.5,0.25-1,0.5-1,0.5-1.2,0.5-2.5,0.5-5,0.7-1.3,0.8-1.2,0.9-4.5,1-1.5,1-1.7,1.2-2.5,1.5-2,1.5-6,2-5,2/3,3-4,3-9,5-10,5-50-flowered,6.4-17,acute,appearing,appressed,base,berry,black,bright,brown,bud,calyx,cm,conical,curved,dark,decurrent,deflexed,deltoid,dia,difoliate,dried,elliptic,especially,exserted,five,flattened-reniform,glabrous,globose,gray,greatly,green,greenish-white,incrassate,knob,lateral,leaf,live,lobed,long,main,material,middle,minutely,mm,near,node,one,onto,opposite,orbicular,ovate,pair,pale,paler,papillose,petiole,pitted,plant,pore,poricidal,proximal,puberulent,rounded,shaped,shiny,shrub,side,simple,slender,slightly,small-capitate,somewhat,soon,straight,tan,tapering,tear-drop,tip,trichome,tube,tuft,unicellular,uniseriate,varying,vein,way,white,winged,woody,x,young	apart,geminate,na
347	wfo-0001029989	success	161	109	45	58	103	51	43	2	.2,1-2.5,3-5,abaxially,acute,adaxially,anther,apex,base,berry,branched,calyx,cm,congested,conical,corolla,dendritic,densely,difoliate,elliptic,filament,fruiting,glabrous,globose,golden,green,greenish-black,inflorescence,internodal,leaf,lobed,long,lower,margin,mm,nearly,occasionally,opposite,pedicel,petiole,pore,poricidal,pubescent,shaped,shining,shrub,simple,small,stem,surface,tear-drop,tip,tree,tree-like,trichome,unifoliate,unit,white	.5,/2,0.25-0.5,0.5-1,0.5-1.5,1-1.5,1-2,1-4,1.3-2.3,1.5-2.5,10-14,2.5-3,3-8,3.5-8,4-4.5,5-10-flowered,5-6,7-20,abaxial,anthesi,bark,branch,broadly,brownish-re,capitate,central,closely,collection,deflexed,deltoid,dense,described,dia,dimaeter,discussion,drying,due,eaf,edicel,eed,erect,exserted,flattened,fleshy,free,geminat,gray,heteromorphic,incrassate,inflorescenc,lamina,lateral,lenticular,like,lobe,lon,main,middle,minutely,nflorescence,nodding,northern,older,ovary,overlappin,pair,papillo,peru,peruvian,perú,petal,petaloid,pitted,planar,population,portion,probably,pubescence,reddish,reddish-brown,rest,ruit,scar,scattered,see,short-style,somewhat,spaced,sparsely,stigma,style,tall,tube,ud,vein,way,wide,widest,woody,x,yellow,ympodial,young	appressed,articulation,bract,branching,breeding,broad-based,cell,colour,connective,form,fruit,growth,hair,heteromorphism,inflated,insertion,interjected,interpetalar,leaflet,length,marking,mature,modification,na,needle-like,odour,orientation,paired,pattern,placement,position,present,prickle,pseudostipule,rhizome,scale,shape,smell,spot,staman,stone,structure,symmetry,sympodial,system,texture,tissue,tuber,type,vegetative,xylopodia	.2,1-2.5,3-5,abaxially,acute,adaxially,base,berry,branched,cm,congested,conical,dendritic,densely,difoliate,elliptic,glabrous,globose,golden,green,greenish-black,internodal,leaf,lobed,long,mm,nearly,occasionally,opposite,poricidal,pubescent,shaped,shining,shrub,simple,small,tear-drop,tip,tree,tree-like,trichome,unifoliate,white	na,present
348	wfo-0001030000	success	146	128	64	71	75	57	61	3	1,1-2,1.5-2,4-5,abaxially,acute,adaxially,also,apex,apiculate,articulated,base,calyx,cell,connective,connivent,conspicuous,cucullate,deltate,densely,directed,distally,eglandular,ellipsoidal,fruit,glabrous,globose,green,hair,immature,laterally,leaving,long,lower,margin,mature,mm,moderately,narrowly,oblong,occasionally,orange,pedicel,pedicellar,perfect,pilose,pore,puberulent,pubescent,purplish,rachi,remnant,scar,shrub,slightly,small,sparsely,spotted,stellate,stone,subcoriaceous,tinge,tip,tree,triangular,unbranched,unit,white,x,yellow,yellow-brown	-4,-pilose,0.5-1,0.5-14,0.5-2-2.5,0.5-3,1-10,1-2.5-3,1.5-2.5-3.5,1.5-3-16,10-20,10-30-50,15-25,2-2.5,2-3,2-4,2-5,2.5-4-4.5-7,25-30-50,3-4,3-4-foliat,3.5-5,7-15,absent,aggregate,apart,ape,axe,biglandula,chartaceous,ciliat,cm,coriaceous,creamy-whit,dia,diameter,dilated,eed,equal,exceeding,flattened,flower,lobe,lon,nflorescence,nther,obtuse,orolla,ovoid,peduncle,produced,pubescen,radiu,rarely,ruit,shorter,smal,spaced,stamen,stigma,strongly,style,swelling,tal,tem,thecae,tomentose,truncate,tube,ud,umbrella-shaped,vary,wide,yellowish,ympodial	4-foliate,anther,appressed,articulation,bract,branching,breeding,broad-based,colour,corolla,filament,fleshy,form,fruiting,growth,heteromorphism,inflated,inflorescence,insertion,interjected,interpetalar,leaf,leaflet,length,marking,modification,na,needle-like,odour,orientation,paired,pattern,petiole,placement,position,prickle,pseudostipule,rhizome,scale,shape,smell,spot,staman,stem,structure,surface,symmetry,sympodial,system,texture,tissue,trichome,tuber,type,vegetative,xylopodia,zygomorphy	1,1-2,1.5-2,4-5,abaxially,acute,adaxially,also,apex,apiculate,articulated,base,connivent,conspicuous,cucullate,deltate,densely,directed,distally,eglandular,ellipsoidal,glabrous,globose,green,hair,immature,laterally,leaving,long,mature,mm,moderately,narrowly,oblong,occasionally,orange,pedicellar,perfect,pilose,puberulent,pubescent,purplish,rachi,remnant,scar,shrub,slightly,small,sparsely,spotted,stellate,subcoriaceous,tinge,tip,tree,triangular,unbranched,white,x,yellow,yellow-brown	4-foliate,fleshy,na
349	wfo-0001030000	success	167	190	111	122	45	68	106	5	-pilose,0.5-1,0.5-1-5,0.5-13,0.5-14,0.5-3,1,1-10,1-2,1.5-2,1.5-3-16,15-25,2-2.5,2-5,25-30-50,3-4,3.5-5,4-5,abaxially,absent,acuminate,acute,adaxially,also,apex,apiculate,articulated,basal,base,calyx,cell,chartaceous,cm,connective,connivent,conspicuous,cordate,coriaceous,deltate,densely,dia,diameter,dilated,directed,distally,eglandular,ellipsoidal,elliptic,entire,equal,exceeding,flattened,flower,fruit,glabrescent,glabrous,globose,green,hair,immature,laterally,leaving,lobe,long,lower,margin,mature,mm,moderately,oblique,oblong,obtuse,occasionally,often,orange,ovate,ovoid,pedicel,pedicellar,peduncle,perfect,petiole,pilose,pore,produced,puberulent,pubescent,purplish,rachi,radiu,rarely,remnant,scar,shorter,shrub,simple,slightly,small,sparsely,spotted,stellate,stigma,stone,strongly,style,subcoriaceous,swelling,thecae,tinge,tip,tree,truncate,umbrella-shaped,unbranched,unit,vein,white,wide,x,yellow,yellow-brown,yellowish	-4,0.5-2-2.5,1-1.5-2,1-2.5-3,1.5-2.5-3.5,10-20,10-30-50,2-3,2-4,2-4-25,2.5-4-4.5-7,3-4-foliat,3-5-25,7-15,aggregate,apart,ape,axe,biglandula,blade,ciliat,creamy-whit,cucullate,eaf,eed,lon,narrowly,nflorescence,nther,orolla,pilo,pubescen,ruit,smal,spaced,stamen,tal,tem,time,tomentose,triangular,tube,ud,vary,ympodial	3-4-foliate,30-50,anther,appressed,arrangement,articulation,biglandular,bract,branching,breeding,broad-based,bud,colour,corolla,creamy-white,direction,filament,form,fruiting,growth,height,heteromorphism,inflated,inflorescence,insertion,interjected,interpetalar,leaf,leaflet,length,marking,modification,na,needle-like,number,odour,orientation,ovary,paired,pattern,placement,plant,position,prickle,pseudostipule,rhizome,scale,seed,shape,size,smell,spot,staman,stem,structure,surface,symmetry,sympodial,system,texture,theca,tissue,trichome,tuber,type,vegetative,xylopodia,zygomorphy	-pilose,0.5-1,0.5-1-5,0.5-13,0.5-14,0.5-3,1,1-10,1-2,1.5-2,1.5-3-16,15-25,2-2.5,2-5,25-30-50,3-4,3.5-5,4-5,abaxially,absent,acuminate,acute,adaxially,also,apex,apiculate,articulated,basal,base,chartaceous,cm,connivent,conspicuous,cordate,coriaceous,deltate,densely,dia,dilated,directed,distally,eglandular,ellipsoidal,elliptic,entire,equal,exceeding,flattened,fruit,glabrescent,glabrous,globose,green,hair,immature,laterally,leaving,lobe,long,mature,mm,moderately,oblique,oblong,obtuse,occasionally,often,orange,ovate,ovoid,pedicellar,perfect,pilose,produced,puberulent,pubescent,purplish,rachi,rarely,remnant,scar,shorter,shrub,simple,slightly,small,sparsely,spotted,stellate,strongly,subcoriaceous,swelling,thecae,tinge,tip,tree,truncate,umbrella-shaped,unbranched,vein,white,wide,x,yellow,yellow-brown,yellowish	3-4-foliate,30-50,biglandular,creamy-white,na
350	wfo-0001030004	success	177	147	70	90	87	57	63	7	0-0.5,0-1.5,0.2-1,0.8-1.1,1-1.5,1-2,1.2-2,1.5-2.5,15,2-20,3-3.5,3-4,3.5-5,4-15,5-25,9-30,abaxial,across,acute,anther,apex,bark,base,branched,branching,calyx,capitate,cm,corolla,dendritic,densely,dia,elliptic,exserted,filament,flattened-reniform,fleshy,fruiting,glabrous,globose,green,inflorescence,later,lateral,leaf,lobed,long,loose,lower,many,margin,minutely,mm,nearly,obovate,obovoid,ovary,pale,pedicel,petiole,plant,plurifoliate,pore,pubescence,pubescent,scar,seed,sessile,shaped,shrub,small,sparsely,stem,stigma,strongly,style,surface,tan,tear-drop,terminal,time,translucent,tree,trichome,tube,variously,white,wide,x,yellowish-green	.3,0.3-1,15-20,20-200-flowered,abaxially,acuminate,adaxially,along,always,anthesi,apar,appearanc,axillary,barely,basal,berry,blade,body,broadly,bushy,collection,cone,conical,crotaloid,decurrent,deltate,dense,denser,diamete,distal,drying,eaf,edicel,eed,erect,especially,flat,free,giving,greenish-yello,hard,incrassate,juvenile,knob,lamina,large,like,lobe,main,middle,much,nflorescence,occasionally,often,older,onto,pair,papillate,papillo,pericarp,pitted,planar,poricidal,portion,possessing,prominent,rest,ruit,simple,spaced,stout,surpassing,tall,thick,thin,tip,tub,tuft,ud,unevenly,vein,widest,winged,woody,yellowish,ympodia,young	adaxial,apart,articulation,bract,breeding,broad-based,bud,cell,colour,connective,diameter,exsertion,form,fruit,greenish-yellow,growth,hair,height,heteromorphism,insertion,interjected,interpetalar,leaflet,length,marking,modification,na,needle-like,odour,orientation,papillose,pattern,placement,position,prickle,pseudostipule,rhizome,scale,shape,size,smell,spacing,spot,staman,stone,structure,symmetry,sympodial,system,texture,tissue,tuber,type,unit,vegetative,width,xylopodia	0-0.5,0-1.5,0.2-1,1-1.5,1-2,1.2-2,1.5-2.5,15,2-20,3-3.5,3.5-5,4-15,5-25,9-30,across,acute,base,branched,calyx,capitate,cm,dendritic,densely,elliptic,exserted,flattened-reniform,fleshy,glabrous,globose,green,later,lateral,lobed,long,loose,many,minutely,mm,nearly,obovate,obovoid,pale,plurifoliate,pubescent,sessile,shaped,shrub,small,sparsely,strongly,tan,tear-drop,terminal,time,translucent,tree,trichome,tube,variously,white,wide,x,yellowish-green	-4,.8-1.1,apart,di,greenish-yellow,na,papillose
351	wfo-0001030007	success	168	184	117	130	38	54	113	4	.05,.4,.5,0.1-0.5,0.2-1,0.8-1,1-1.5,1-15,1-2,1.5-5,1.6-2.2,15-20,2-4,2-7,3-5,3/4,4.5-5,7-10,7-9,acuminate,acute,along,anther,anthesi,apart,apex,base,becoming,beneath,berry,branched,brown,bud,calyx,campanulate,clavate,closely,cm,corolla,densely,dia,difoliate,dry,elliptic,erect,exserted,filament,flattened,fleshy,fruiting,glabrate,glabrous,globose,golden,golden-pubescent,green,incrassate,lateral,leaf,like,live,lobed,long,longer,lower,main,major,margin,material,middle,midrib,minor,minutely,mm,oblique,obovoid,occasionally,older,one,onto,opposite,outline,ovary,pair,pale,papillose,pedicel,petiole,pitted,plant,pore,poricidal,pubescent,raised,reniform,rest,rounded,scar,shaped,short,shrub,slightly,small,soft,soon,spaced,sparsely,specimen,stem,stigma,style,surface,tear-drop,thick,tip,tree,trichome,tube,two,type,uniseriate,unit,vein,way,white,widest,winged,woody,x,young	0.5-1,6-10-flowered,abrupt,ba,bark,broadly,cork,dark,decurrent,deltoid,edicel,eed,free,geminateleaf,gre,hooded,impressed,inflorescenc,lobe,lon,nflorescence,papillo,planar,portion,prominent,ruit,shorter,simple,slender,straight,tall,tapering,thickened,trunk,tub,ud,widening,ympodial	articulation,bract,branching,breeding,broad-based,cell,colour,connective,corky,development,form,fruit,geminate,growth,hair,height,heteromorphism,inflorescence,insertion,interjected,interpetalar,leaflet,length,marking,mature,modification,na,needle-like,odour,orientation,paired,pattern,placement,position,prickle,pseudostipule,rhizome,scale,seed,shape,size,smell,spot,staman,stone,structure,symmetry,sympodial,system,texture,tissue,tuber,vegetative,xylopodia	.05,.4,.5,0.1-0.5,0.2-1,0.8-1,1-1.5,1-15,1-2,1.5-5,1.6-2.2,15-20,2-4,2-7,3-5,3/4,4.5-5,7-10,7-9,acuminate,acute,along,apart,base,becoming,beneath,berry,branched,brown,bud,calyx,campanulate,clavate,closely,cm,corolla,densely,dia,difoliate,dry,elliptic,erect,exserted,flattened,fleshy,glabrate,glabrous,globose,golden,golden-pubescent,green,incrassate,lateral,leaf,like,live,lobed,long,longer,main,major,material,middle,midrib,minutely,mm,oblique,obovoid,occasionally,one,onto,opposite,outline,pair,pale,papillose,petiole,pitted,plant,pore,poricidal,pubescent,raised,reniform,rest,rounded,shaped,short,shrub,slightly,small,soft,soon,spaced,sparsely,specimen,stem,tear-drop,thick,tip,tree,trichome,two,type,uniseriate,vein,way,white,widest,winged,woody,x,young	corky,geminate,inflorescence,na
352	wfo-0001030010	success	156	83	43	52	104	31	41	2	/4,1-1.5,1.2-1.5,1.5-2,4-4.5,anther,apex,attenuate,base,berry,calyx,cm,corolla,difoliate,filament,fruit,fruiting,furcate,glabrous,globose,green,leaf,lobed,long,margin,minutely,mm,obovate,often,opposite,pedicel,persistent,petiole,pore,poricidal,puberulent,reddish,shaped,shrub,simple,small,surface,tear-drop,tiny,tip,tree,trichome,unit,way,white,woody,x	.5,.75,0.5-5,0.7-1,0.9-1.1,1-1.3,1-2,10-15,10-50-flowered,11-12,2-2.2,2-7,2.5,20-40,3-5,5-7,7-10,acuminate,acute,anthesi,appearing,area,bark,basal,beneath,brown,bud,closely,cyathiform,dark,deciduous,decurrent,deflexed,deltate,dia,differing,distal,dry,eaf,edicel,eed,ellipsoid,exserted,f,fleshy,free,geminat,glabrate,grey,hooded,lateral,lobe,lon,lower,m.,main,major,materia,material,middle,midrib,minor,minute,near,nearly,nflorescence,occasionally,older,one,orange,ovary,overlappin,ovoid-reniform,pair,papillose,pitted,planar,portion,prominent,rather,ruit,scar,shin,size,slightly,smooth,soon,spaced,stem,stigma,straight,styl,style,tall,tapering,trunk,tube,ud,uniseriate,vein,widest,winged,ympodial,young	articulation,branching,cell,colour,form,geminate,growth,hair,heteromorphism,inflorescence,insertion,length,marking,na,orientation,placement,position,prickle,pseudostipule,rhizome,shape,spot,staman,stone,structure,symmetry,sympodial,texture,tuber,type,xylopodia	/4,1-1.5,1.2-1.5,1.5-2,4-4.5,attenuate,base,berry,cm,difoliate,fruit,furcate,glabrous,globose,green,leaf,lobed,long,minutely,mm,obovate,often,opposite,persistent,poricidal,puberulent,reddish,shaped,shrub,simple,small,surface,tear-drop,tiny,tip,tree,trichome,way,white,woody,x	geminate,na
353	wfo-0001030023	success	168	161	82	95	73	66	75	7	0.5-1,1,1-8,1.5-7,10-25,13-20,2-3,2.5-3.5,20-30,3-4.5,3-5,4,4-12,5-6,6-7,7-9,acute,adaxially,apex,apiculate,base,branched,calyx,cell,cm,connective,connivent,cordate,cuneate,cylindrical,deeply,densely,diameter,dilated,directed,distally,ellipsoidal,elliptic,entire,especially,finely,flattened,fleshy,fruit,glabrous,glandular-puberulent,globose,greenish-white,hair,highly,lanceolate,lobe,loosely,lower,margin,membranaceous,mm,moderately,narrowly,near,oblique,oblong,occasionally,often,ovate,pedicel,peduncle,peltiform,petiole,pore,present,probably,puberulent,pubescent,purplish-,rachi,radiu,short-acuminate,simple,somewhat,sparsely,stellate,stigma,stone,style,subcoriaceous,tip,tree,triangular,truncate,unit,unknown,x,yellowish,young	-,0-100+,1-2,1-4-10,1.5-2,10-30-50+,12-18,2,4-foliat,5,5-11-40+,5-16,6-26,abaxially,aggregate,apart,ape,articulated,axe,basal,beyond,blade,capitat,ciliate,color,denser,eaf,eed,exceeding,except,exserted,flower,forked,glandular-puberulen,leaving,lon,long,main,narrow,nflorescence,nther,obtuse,orolla,pedicellar,perfect,presen,prominent,pubescen,pubescence,pubescent-pilo,remnant,ripe,ruit,shorter,slightly,small,spaced,stamen,swelling,tal,tem,thecae,time,tube,ud,unbranched,unknow,usually,vary,vein,villous,wide,ympodial	1-10,10-50+,4-foliate,5-40+,abaxial,adaxial,anther,appressed,articulation,bract,branching,broad-based,bud,capitate,colour,corolla,filament,form,fruiting,growth,height,heteromorphism,inflated,inflorescence,interjected,interpetalar,leaf,leaflet,length,marking,modification,na,needle-like,odour,orientation,ovary,paired,placement,plant,position,prickle,pseudostipule,pubescent-pilose,rhizome,scale,seed,shape,size,smell,spacing,spot,staman,stem,structure,surface,symmetry,sympodial,texture,theca,tissue,trichome,tuber,type,vegetative,xylopodia,zygomorphy	0.5-1,1,1-8,1.5-7,10-25,13-20,2-3,2.5-3.5,20-30,3-4.5,3-5,4,4-12,5-6,6-7,7-9,acute,adaxially,apiculate,base,branched,cm,connivent,cordate,cuneate,cylindrical,deeply,densely,dilated,directed,distally,ellipsoidal,elliptic,entire,especially,finely,flattened,fleshy,glabrous,glandular-puberulent,globose,greenish-white,highly,lanceolate,loosely,membranaceous,mm,moderately,narrowly,near,oblique,oblong,occasionally,often,ovate,peltiform,present,probably,puberulent,pubescent,purplish-,short-acuminate,simple,somewhat,sparsely,stellate,subcoriaceous,tip,tree,triangular,truncate,unknown,x,yellowish,young	1-10,10-50+,4-foliate,5-40+,capitate,na,pubescent-pilose
354	wfo-0001030032	success	250	112	47	69	181	43	46	1	0.4-1.5,0.5-0.6,0.5-1.5,1.5-2,2-3-locular,2-4,2-5,4-5,5-plurifoliate,7-16,anther,apex,articulation,base,branched,breaking,bright,calyx,cell,cm,completely,corolla,decurrent,deltate,densely,diameter,filament,fruit,fruiting,glabrous,golden,green,imparipinnate,interjected,interrupted,irregularly,leaf,leaflet,length,long,lower,many,margin,middle,mm,opposite,pedicel,petiole,pseudostipule,pubescent,reflexed,rotate,rotate-stellate,simple,slightly,splitting,stem,subopposite,surface,thickened,time,trichome,truncate,uniseriate,unit,vine,wide,woody,yellow	+,.05,.5,0.1-0.4,0.1-0.5,0.2,0.2-0.3,0.2-0.5,0.25-0.4,0.5,0.5-0.7,0.5-1,0.5-2,0.6-1.1,0.7-0.8,0.8-1.0,0.8-1.1,1-1.3,1-1.5,1-2-celled,1-3,1-celled,1.5-2.5,11-20,13-35,2,2-10,2-3.5,2-60,2-lobed,2.4-3.5,3,3-5,3.0-3.5,3.5-12,30,4-6-celled,4-celled,4.3-5.0,6-11,60-80,7.5-10,8-10,8-10-celled,8-20,abaxially,absent,abundant,acuminate,acute,adaxial,adaxially,along,also,anthesi,apical,appearance,appendage,articulated,basal,basally,basiscopically,bent,border,branche,brown,capitate,clambering,column,conical,conspicuou,dark,densest,desne,dry,eaf,ebracteate,edicel,eed,elliptic,entire,exserted,flower,free,give,glandular,gree,greenish-brown,hair-like,halfway,hea,head,herbarium,internode,lamina,large,larger,lateral,leave,like,lobe,longest,markedly,midvein,mixed,moderately,much,multicellular,nflorescence,node,oblanceolate,oblique,obovate,occasionally,often,older,onto,orbicular,outgrowth,ovary,pair,pale,paler,patent,peduncle,petiolule,pithy,present,primary,pubescence,rachi,rest,rough,round,ruit,secondary,seed,set,shorter,silky,smaller,soft,sometimes,somewhat,sparsely,sparser,specimen,spreading,stamen,staminal,sterile,stigma,straight,style,swollen,tall,tangled,tem,terminal,tertiary,testa,thick,tiny,tip,touch,transparent,tube,ud,unicellular,usually,vegetatio,vein,venation,wall,weaker-walled,well-developed,white,winged,ympodial,younger,½-3/4	appressed,bract,branching,breeding,broad-based,colour,form,growth,hair,heteromorphism,inflated,inflorescence,insertion,interpetalar,marking,mature,na,needle-like,odour,orientation,paired,pattern,placement,position,prickle,rhizome,scale,shape,smell,spot,staman,stone,structure,symmetry,sympodial,system,texture,tissue,tuber,type,vegetative,xylopodia,zygomorphy	0.4-1.5,0.5-0.6,0.5-1.5,1.5-2,2-3-locular,2-4,2-5,4-5,5-plurifoliate,7-16,branched,breaking,bright,cm,completely,decurrent,deltate,densely,diameter,glabrous,golden,green,imparipinnate,interrupted,irregularly,long,many,middle,mm,opposite,pubescent,reflexed,rotate,rotate-stellate,simple,slightly,splitting,subopposite,thickened,time,truncate,uniseriate,vine,wide,woody,yellow	na
355	wfo-0001030048	success	156	112	48	60	96	52	46	2	.5,0.5-1.5,1.2-2,3-5,abaxially,acute,adaxially,anther,apex,apically,arachnoid,base,berry,blue,calyx,cm,corolla,deflexed,densely,dia,difoliate,elliptic,filament,fleshy,fruiting,glabrous,globose,green,internodal,leaf,lobed,long,lower,margin,matted,middle,mm,nearly,opposite,pale,pedicel,petiole,pointed,pore,poricidal,shaped,shiny,shrub,small,stem,surface,tear-drop,tip,tree,trichome,trifoliate,unit,white,widest,woody	1-1.5,1-2,1.3-1.6,1.5-3.5,1.5-7,10-16,2-3,2-5,3-3.5,4-15,4-4.5,5-10-flowered,5-8,5973,abaxial,along,anthesi,ape,apparently,bark,becoming,bi-colored,bi-lobed,broadly,brown,clavate,closely,completely,conical,covered,decurrent,deltate,drying,eaf,edicel,eed,ellipsoid,exserted,felt-like,fide,four-angle,free,geminat,glabrate,golden,greyish,impressed,inflorescenc,lamina,lateral,lightly,like,lobe,lon,main,minutely,nflorescence,occasionally,older,onto,ovary,overlappin,ovoid-reniform,pair,papillo,papillose,pitted,planar,portion,prominent,pubescent,rather,reddish-brown,rest,ruit,scar,simple,solomon,somewhat,spaced,sparsely,stigma,strongly,style,tall,tan,thick,thickened,tub,tube,ud,vein,wide,yellowish,ympodial,young	appressed,articulation,bract,branching,breeding,broad-based,cell,colour,connective,form,fruit,geminate,growth,hair,heteromorphism,inflated,inflorescence,insertion,interjected,interpetalar,leaflet,length,marking,mature,modification,na,needle-like,odour,orientation,paired,pattern,placement,position,prickle,pseudostipule,rhizome,scale,shape,smell,spot,staman,stone,structure,symmetry,sympodial,system,texture,tissue,tuber,type,vegetative,xylopodia	.5,0.5-1.5,1.2-2,3-5,abaxially,acute,adaxially,apically,arachnoid,base,berry,blue,cm,deflexed,densely,dia,difoliate,elliptic,fleshy,glabrous,globose,green,internodal,leaf,lobed,long,matted,middle,mm,nearly,opposite,pale,pointed,poricidal,shaped,shiny,shrub,small,tear-drop,tip,tree,trichome,trifoliate,white,widest,woody	geminate,na
356	wfo-0001030053	success	140	144	68	88	52	56	64	4	0.5,0.5-1,1-1.3,1-13,1.3-3.5,1.8-2,10-20,100,2.5-3,3.5-4,5,7-9,<,abruptly,acuminate,acute,anthesi,apart,apex,apical,base,berry,branched,brown,calyx,cell,cm,coriaceous,corolla,decurrent,diameter,elliptic,entire,exserted,far,fine,flattened,flower,fragrant,fruiting,glabrous,greenish,growth,inflorescence,long,many,margin,minutely,mm,new,nipple,pair,pale,parallel,pedicel,peduncle,per,petiole,pitted,primary,rectangular,reniform,revolute,scar,secondary,shining,shiny,simple,sleeve,slightly,small,stem,strongly,surface,terminal,testal,time,truncate,tube,turbinate,unit,vein,venation,vine,white,woody,x,yellowish	1.5-5.5,2-2.5,4-7-11,5-merou,abscission,aiding,alyx,apiculae,ark,around,articulated,bfeore,branch,climbin,completely,cyathiform,eaf,eed,fide,filiform,frui,hyaline,irregularly,leaving,lobe,lobed,lower,mentz,near,nflorescence,older,orolla,papilla,papillo,peg,pendant,perfect,plurifoliat,rim,shallowly,shin,spaced,spreadin,spreading,support,tem,tiny,tip,twining,ud,usually,ympodial	anther,arrangement,articulation,bark,bract,branching,breeding,bud,colour,connective,exsertion,filament,form,fragrance,fruit,hair,heteromorphism,insertion,interjected,interpetalar,leaf,leaflet,length,marking,mature,modification,na,number,odour,orientation,papillose,pattern,placement,plurifoliate,pore,position,prickle,pseudostipule,rhizome,scale,seed,shape,size,spacing,spot,staman,stone,structure,symmetry,sympodial,system,texture,tissue,tuber,type,xylopodia	0.5,0.5-1,1-1.3,1-13,1.3-3.5,1.8-2,10-20,100,2.5-3,3.5-4,5,7-9,<,abruptly,acuminate,acute,anthesi,apart,apical,base,branched,brown,calyx,cm,coriaceous,decurrent,elliptic,entire,exserted,far,fine,flattened,fragrant,glabrous,greenish,long,many,minutely,mm,nipple,pair,pale,parallel,pitted,rectangular,reniform,revolute,shining,shiny,simple,sleeve,slightly,small,strongly,terminal,time,truncate,tube,turbinate,vine,white,woody,x,yellowish	fruit,na,papillose,plurifoliate
357	wfo-0001030057	success	141	130	104	109	32	21	101	3	-2,1-10,1-2,2-3-celled,2-4,2-4.5,2-6,20-30,20-80,3-5,3.5-8,4-10,5.5-12,7-14,8,8-19,abaxially,absent,adaxially,apart,apparently,articulated,axillary,base,blade,borne,broadly,brownish,bud,cell,chartaceous,cm,condition,covering,decreasing,diameter,digestion,distal,drying,elliptic,end,enzyme,extremely,flower,forked,fresh,fruit,generally,globose,greatly,green,green-white,greenish,hair,hair-like,half,herb,high,honeycomb-shaped,interjected,lateral,leaf,leaflet,like,long,lunate,make,membranous,mm,mottled,mucilaginous,narrow,odd-pinnate,ovate,ovoid,pedicel,peduncle,perfect,petiole,petiolule,plant,pubescent,purple,removed,scale-like,seed,short,singly,size,small,stem,subglabrous,suborbicular,subtending,tall,terminal,testal,thick,throughout,toward,tuber,typically,unwinged,usually,wall,wet,whitish,wing,x	2.1-4.1,4.3-8.2,acuminate,acute,apex,axe,berry,cordate,cuneate,eaf,eed,erec,geminat,glabrou,larger,living,nflorescence,pair,plurifoliate,ruit,seudostipule,sometimes,spaced,specimen,ste,stolo,tem,thir,tri-,truncate,unit,ympodial	arrangement,articulation,branching,colour,form,glabrous,growth,height,inflorescence,length,pattern,position,presence,pseudostipule,sex,shape,spacing,stolon,texture,third,type	-2,1-10,1-2,2-3-celled,2-4,2-4.5,2-6,20-30,20-80,3-5,3.5-8,4-10,5.5-12,7-14,8,8-19,abaxially,absent,adaxially,apart,apparently,articulated,axillary,base,borne,broadly,brownish,bud,cell,chartaceous,cm,condition,covering,decreasing,diameter,digestion,distal,drying,elliptic,end,enzyme,extremely,flower,forked,fresh,fruit,generally,globose,greatly,green,green-white,greenish,hair,hair-like,half,herb,high,honeycomb-shaped,lateral,leaf,like,long,lunate,make,membranous,mm,mottled,mucilaginous,narrow,odd-pinnate,ovate,ovoid,perfect,plant,pubescent,purple,removed,scale-like,seed,short,singly,size,small,stem,subglabrous,suborbicular,subtending,tall,terminal,testal,thick,throughout,toward,typically,unwinged,usually,wall,wet,whitish,wing,x	glabrous,stolon,third
358	wfo-0001030057	success	197	215	142	153	44	62	134	8	-10,-2,.5-3.5,1-10,1-2,2-3-celled,2-4,2-4.5,2-5,2-6,20-30,20-80,3.5-8,4-10,5-10,5-6,5.5-12,7-14,8,8-19,abaxially,absent,acumen,acuminate,acute,adaxially,along,anther,apart,apex,apparently,articulated,axillary,base,berry,blade,borne,brownish,bud,cell,chartaceous,ciliate,cm,condition,connivent,cordate,corolla,cuneate,decreasing,diameter,digestion,distal,dorsally,drying,edge,elliptic,end,enzyme,especially,extremely,filament,flat,flower,folded,forked,fresh,fruit,generally,glabrous,globose,greatly,green,greenish,greenish-yellow,hair,half,herb,high,homostylous,honeycomb-shaped,interjected,lanceolate,lateral,leaf,leaflet,lengthening,like,linear,lobe,long,lower,lunate,margin,membranous,middle,midrib,minutely,mm,mottled,narrow,odd-pinnate,ovate,ovate-lanceolate,ovoid,pedicel,peduncle,pentagonal,perfect,petal,petiole,plant,plurifoliate,pore,poricidal,puberulent,pubescent,purple,removed,rotate,scale-like,seed,short,singly,size,slit,small,sometimes,star,stem,stigma,straight,striped,style,subglabrous,subtending,terminal,testal,tip,toward,tri-,truncate,tube,tuber,typically,unit,unwinged,usually,wall,white,whitish,wing,x,yellow	2-3,2.1-4.1,3-5,4.3-8.2,5-merou,ag,alyx,axe,broadly,covering,eaf,eed,erec,exceeding,geminat,glabrou,globo,green-white,hair-like,larger,living,make,mucilaginous,nflorescence,orolla,pair,petiolule,ruit,seudostipule,spaced,specimen,stamen,ste,stolo,suborbicular,tall,tamen,tem,thick,thir,throughout,vary,wet,ympodial	5-merous,age,appressed,arrangement,articulation,bract,branching,breeding,broad-based,calyx,colour,connective,form,fruiting,geminate,glabrousnes,growth,height,heteromorphism,inflated,inflorescence,insertion,interpetalar,length,marking,mature,modification,na,needle-like,odour,orientation,ovary,paired,pattern,placement,position,presence,prickle,pseudostipule,rhizome,scale,shape,smell,spacing,spot,staman,stellate,stolon,stone,structure,surface,symmetry,sympodial,system,texture,third,tissue,trichome,type,vegetative,xylopodia,zygomorphy	-10,-2,.5-3.5,1-10,1-2,2-3-celled,2-4,2-4.5,2-5,2-6,20-30,20-80,3.5-8,4-10,5-10,5-6,5.5-12,7-14,8,8-19,abaxially,absent,acumen,acuminate,acute,adaxially,along,apart,apex,apparently,articulated,axillary,base,berry,borne,brownish,bud,chartaceous,ciliate,cm,condition,connivent,cordate,corolla,cuneate,decreasing,diameter,digestion,distal,dorsally,drying,elliptic,end,enzyme,especially,extremely,flat,flower,folded,forked,fresh,fruit,generally,glabrous,globose,greatly,green,greenish,greenish-yellow,hair,half,herb,high,homostylous,honeycomb-shaped,lanceolate,lateral,leaf,lengthening,like,linear,long,lunate,margin,membranous,middle,midrib,minutely,mm,mottled,narrow,odd-pinnate,ovate,ovate-lanceolate,ovoid,pentagonal,perfect,petal,plant,plurifoliate,pore,poricidal,puberulent,pubescent,purple,removed,rotate,scale-like,short,singly,size,slit,small,sometimes,star,stem,straight,striped,subglabrous,subtending,terminal,tip,toward,tri-,truncate,typically,unwinged,usually,wall,white,whitish,wing,x,yellow	5-merous,age,geminate,na,stellate,stolon,third,zygomorphy
359	wfo-0001030080	success	186	171	89	114	72	57	88	1	0.3-7,0.4-1.5,0.5-4,1-2,1.5-2,1.5-2.5,1.8-4.5,2-3,2-4,2.1-7.1,3-5,4-12,4-7,5-13.5,5-7,5.5-9.9,6.5-18.6,8-16,8-23,9.9-33,abaxially,absent,acuminate,adaxially,anther,apex,axillary,base,berry,blade,brownish,bud,cell,cm,condition,coriaceous,corolla,covering,cuneate,dark,decurrent,diameter,distal,dot,drying,elliptic,filament,flower,forked,fresh,fruit,glabrous,green,green-white,greenish,hair,hair-like,half,herb,high,homostylous,interjected,lanceolate,lateral,leaf,leaflet,light,lobe,long,lower,make,mm,moniliform,mottled,mucilaginous,odd-pinnate,onto,ovate,ovoid,pair,pedicel,peduncle,petiole,plant,plurifoliate,pore,poricidal,purple,pyriform,rachi,seed,size,sometimes,stellate,strongly,style,subtending,terminal,testal,thick,throughout,tiny,tip,tri-,tube,tuber,unit,usually,wall,wet,white,whitish,winged,x	1-3,1999,3-10,3.3-7.7,5-merou,abaxiall,acumen,ag,along,alyx,apart,apparently,arranged,articulated,axe,bead,capitat,ccording,clavate,connivent,decreasing,digestion,dorsally,eaf,edge,eed,enzyme,erec,exceeding,flat,folded,geminat,generally,glabrescent,glabrou,hal,honeycomb-shaped,inconspicuous,larger,lengthening,like,linear,living,medium,multiple,necklace,nflorescence,ochoa,orolla,perfect,removed,second,seudostipule,slightly,slit,spaced,specimen,stamen,stigma,stolon,straight,subequal,tall,tamen,tem,toward,typically,unknown,vary,width,yellow,ympodial	abaxial,adaxial,appressed,arrangement,articulation,bract,branching,breeding,broad-based,calyx,colour,connective,form,fruiting,growth,height,heteromorphism,inflated,inflorescence,insertion,interpetalar,length,margin,marking,mature,modification,na,needle-like,odour,orientation,paired,pattern,placement,position,prickle,pseudostipule,rhizome,scale,shape,smell,spacing,spot,staman,stem,stone,structure,surface,symmetry,sympodial,system,texture,tissue,trichome,type,vegetative,xylopodia,zygomorphy	0.3-7,0.4-1.5,0.5-4,1-2,1.5-2,1.5-2.5,1.8-4.5,2-3,2-4,2.1-7.1,3-5,4-12,4-7,5-13.5,5-7,5.5-9.9,6.5-18.6,8-16,8-23,9.9-33,abaxially,absent,acuminate,adaxially,axillary,berry,brownish,bud,cell,cm,condition,coriaceous,covering,cuneate,dark,decurrent,distal,dot,drying,elliptic,forked,fresh,glabrous,green,green-white,greenish,hair-like,half,herb,high,homostylous,lanceolate,lateral,light,long,make,mm,moniliform,mottled,mucilaginous,odd-pinnate,onto,ovate,ovoid,plurifoliate,poricidal,purple,pyriform,rachi,seed,sometimes,stellate,strongly,subtending,terminal,testal,thick,throughout,tiny,tip,tri-,usually,wall,wet,white,whitish,winged,x	na
360	wfo-0001030081	success	157	135	67	80	77	55	62	5	.5,0.5-1,0.5-1.5,1,1-5,1.5,1.5-3,10-20,10-35,2-4,2-foliate,3-10,4-6,5-12,5-15,absent,abundant,acute,anther,apex,base,berry,brown,calyx,cell,center,chartaceous,ciliate,cm,densely,diameter,drying,edge,elliptic,elliptic-ovoid,entire,few-branched,filament,fine,flower,fruit,glabrous,globose,hair,herb,immature,interpetalar,margin,maturing,membranaceous,mm,moderately,nearly,oblong,obtuse,parallel,pedicel,peduncle,per,petiole,pubescent,rachi,radiating,raised,ridge,rotate,rounded,running,semitransparent,shallow,single-,sparsely,style,surface,tissue,unit,usually,white,x,yellow	0.25-0.5,0.5-2.5,1-2,1-2-celled,1-3,1-4,1.5-7,1st,2-7,2nd,3-6,abaxially,adaxiall,adaxially,along,apically,axe,beyond,blade,connected,cordate,decurrent,dehiscing,denser,dm,eaf,eed,emarginat,equal,explosively,exserted,flat,frui,geminat,geniculate,held,linear-lanceolate,lobe,long,longer,lower,lying,maturit,mesocarp,nfloresence,notch,often,one,orolla,other,placenta,pointing,pressure,pubescen,rarely,ruit,short,slightly,small,sometimes,stamen,stigma,straight,swollen,tal,tamen,tem,triangular,tube,two-celled,unbranched,vary,vein,watery,wid,woody,ympodial	appressed,arrangement,articulation,bract,branching,breeding,colour,connective,corolla,decument,form,fruiting,geminate,growth,heteromorphism,inflated,inflorescence,insertion,interjected,leaf,leaflet,length,marking,mature,modification,na,number,odour,orientation,ovary,paired,pattern,placement,pore,position,prickle,pseudostipule,rhizome,scale,seed,shape,simple,spot,staman,stem,stone,structure,symmetry,sympodial,system,texture,tuber,type,xylopodia,zygomorphy	.5,0.5-1,0.5-1.5,1,1-5,1.5,1.5-3,10-20,10-35,2-4,2-foliate,3-10,4-6,5-12,5-15,absent,abundant,acute,berry,brown,center,chartaceous,ciliate,cm,densely,drying,edge,elliptic,elliptic-ovoid,entire,few-branched,fine,flower,fruit,glabrous,globose,herb,immature,margin,maturing,membranaceous,mm,moderately,nearly,oblong,obtuse,parallel,pubescent,radiating,raised,ridge,rotate,rounded,running,semitransparent,shallow,single-,sparsely,usually,white,x,yellow	decument,geminate,na,simple,zygomorphy
361	wfo-0001030083	success	146	148	78	89	57	59	72	6	0.5-2,0.8-1,0.8-3,1-1.5,1-2,1.5-3,10-30,2,2-3,2-5-flowered,3-4,3/4,4-15,4-6,9-11,accrescent,acute,anther,apex,bark,base,beginning,calyx,closely,cm,corolla,decurrent,deeply,elliptic,fleshy,flower,fruit,fruiting,glabrous,globose,green,greenish-white,internodal,lateral,leaf,lobe,lobed,long-acuminate,long-styled,main,membranous,minutely,mm,narrowly,near,onto,opposite,ovary,ovate,overlapping,ovoid-reniform,pair,pale,papillose,pedicel,petiole,pitted,pore,poricidal,red-papillose,scar,shaped,short-styled,shrub,small-capitate,somewhat,spaced,stem,stigma,strongly,style,surface,tear-drop,thin,tip,translucent,unit,vein,way,white,winged,woody,x,young	.5,.75,0.1,0.25-0.5,0.5-1,anthesi,berry,broadly,cup-shaped,dar,deciduous,deflexed,deltoid,dia,dry,drying,eaf,edicel,eed,elongate,exserted,greyish-re,hyaline,inflorescenc,lon,long,lower,middle,nflorescence,older,paler,papillae,prominent,proximal,raised,reddish-gold,reflexed,ruit,shallowly,simple,single-stemmed,slender,slightly,soon,specimen,straight,tall,tan,tapering,terminal,thickened,tub,tube,ud,unifoliat,widest,ympodial	0.75,arrangement,articulation,bract,branching,breeding,bud,cell,colour,connective,diameter,filament,form,greyish-red,growth,hair,height,heteromorphism,inflorescence,insertion,interjected,interpetalar,leaflet,length,margin,marking,mature,modification,na,number,odour,orientation,pattern,placement,plant,position,prickle,pseudostipule,rhizome,scale,seed,shape,size,spacing,spot,staman,stellate,stone,structure,symmetry,sympodial,system,texture,tissue,tuber,type,unifoliate,width,xylopodia	0.5-2,0.8-1,0.8-3,1-1.5,1-2,1.5-3,10-30,2,2-3,2-5-flowered,3-4,3/4,4-15,4-6,9-11,accrescent,acute,base,beginning,closely,cm,decurrent,deeply,elliptic,fleshy,fruit,glabrous,globose,green,greenish-white,internodal,lateral,leaf,lobed,long-acuminate,long-styled,main,membranous,minutely,mm,narrowly,near,onto,opposite,ovate,overlapping,ovoid-reniform,pair,pale,papillose,petiole,pitted,poricidal,red-papillose,shaped,short-styled,shrub,small-capitate,somewhat,spaced,stem,strongly,tear-drop,thin,tip,translucent,vein,way,white,winged,woody,x	0.75,greyish-red,inflorescence,na,stellate,unifoliate
362	wfo-0001030093	success	181	114	50	63	118	51	48	2	0.1-0.3,0.5-1.1,0.75-1,2-2.5,anther,apex,attenuate,base,beneath,berry,calyx,campanulate,cm,corolla,cuneate,difoliate,elliptic,erect,filament,fruiting,furcate,glabrous,globose,green,greenish-white,growth,hirsutulous,leaf,lobed,long,lower,many,margin,mm,narrowly,nearly,obovate,occasionally,often,opposite,pedicel,petiole,pore,poricidal,present,shaped,shiny,shrub,simple,small,stem,surface,tear-drop,terminal,time,tip,tree,trichome,uniseriate,unit,vein,white,x	.2,.5,0,0.2,0.2-0.5,0.2-1,0.6-1.5,1-1.5,1-12,1-5,1.3-4.5,2.5-11,3-4,3.5-12,4-6,5-50-flowered,5-8,7-30,7-9,8-9,acuminate,acute,anthesi,apar,bark,becoming,branched,brownish-tan,case,clavate,closely,collection,commonly,continues,deflexed,deltoid,densely,dia,differing,eaf,edicel,eed,ellipsoid,especially,evenly,except,expanded,exserted,flower,forest,free,geminat,golden,greyish-brow,guyanese,hyaline,impressed,inundated,lateral,like,lobe,lon,long-styled,main,major,member,middle,minor,minutely,new,nflorescence,older,one,onto,open,orbicular,ovary,ovoid-reniform,pair,pale,paler,papillo,persisting,pitted,plant,population,portion,puberulent,pubescent,quite,reflexed,remaining,ruit,scar,shoot,short-styled,size,slender,slightly,soon,southern,spaced,stigma,straight,style,tall,tapering,thickened,tiny,tub,tube,ud,underside,widest,woody,yellowish,ympodial,young	appressed,articulation,bract,branching,breeding,broad-based,cell,colour,connective,form,fruit,geminate,hair,heteromorphism,inflated,inflorescence,insertion,interjected,interpetalar,leaflet,length,marking,mature,modification,na,needle-like,odour,orientation,paired,pattern,placement,position,prickle,pseudostipule,rhizome,scale,shape,smell,spot,staman,stone,structure,symmetry,sympodial,system,texture,tissue,tuber,type,vegetative,xylopodia	0.1-0.3,0.5-1.1,0.75-1,2-2.5,attenuate,base,beneath,berry,campanulate,cm,cuneate,difoliate,elliptic,erect,furcate,glabrous,globose,green,greenish-white,hirsutulous,leaf,lobed,long,many,mm,narrowly,nearly,obovate,occasionally,often,opposite,poricidal,present,shaped,shiny,shrub,simple,small,tear-drop,terminal,time,tip,tree,trichome,uniseriate,vein,white,x	geminate,na
363	wfo-0001030145	success	152	115	79	92	60	23	77	2	0.2-2,0.3-1-2.5,0.5,0.5-1,0.5-4,1,1-2,1-5,1.5,1.5-2,1.5-4.5,1.5-7,10-12,2.5-6.5,3-10,3-4,4-5,8-11,abaxially,acute,adaxially,adpressed,also,apart,apex,basal,base,calyx,campanulate,cell,chartaceous,cm,compound,connective,cuneate,deltate,densely,diameter,directed,distally,ellipsoidal,elliptic-ovate,entire,exceeding,fleshy,forked,fruit,glabrous,glandular,globose,hair,herb,lanceolate,leaf,less,lobe,long,margin,mm,moderately,narrowly,near,obtuse,ovate-elliptic,pedicel,peduncle,petiole,pilose,pore,puberulent,rachi,radiu,shorter,shrub,simple,sinuate,slender,slightly,somewhat,sparsely,stone,style,subcordate,subcoriaceous,ternately,thecae,triangular,truncate,unbranched,unknown,violet,x	-2,-3,1-1.5,1-3,2-3,2-4,3,3-5,4-8,4-foliat,6-40,absent,aggregate,ape,articulated,axe,beyond,blade,color,cylindrical,dunal,eaf,eed,elliptic,exserted,fide,flower,larger,lateral,leaflet,leaving,lon,lower,nflorescence,nther,orolla,pedicellar,presen,puberulen,reddish,remnant,ripe,ruit,spaced,stamen,stigma,tal,tem,terminal,time,tomento,toward,truncat,tube,ud,unit,vary,wide,yellow,ympodial	anther,articulation,branching,bud,colour,corolla,form,growth,height,inflorescence,length,na,plant,position,present,seed,shape,size,spacing,stem,texture,theca,type	0.2-2,0.3-1-2.5,0.5,0.5-1,0.5-4,1,1-2,1-5,1.5,1.5-2,1.5-4.5,1.5-7,10-12,2.5-6.5,3-10,3-4,4-5,8-11,abaxially,acute,adaxially,adpressed,also,apart,apex,basal,base,campanulate,chartaceous,cm,compound,cuneate,deltate,densely,directed,distally,ellipsoidal,elliptic-ovate,entire,exceeding,fleshy,forked,glabrous,glandular,globose,hair,herb,lanceolate,less,lobe,long,mm,moderately,narrowly,near,obtuse,ovate-elliptic,pilose,puberulent,shorter,shrub,simple,sinuate,slender,slightly,somewhat,sparsely,style,subcordate,subcoriaceous,ternately,thecae,triangular,truncate,unbranched,violet,x	na,present
364	wfo-0001030146	success	210	125	65	73	137	52	58	7	acute,anther,anthesi,apex,appearing,articulated,base,berry,branched,branching,c.,calyx,cell,cm,connivent,coriaceous,corolla,cup-shaped,densely,echinoid,ellipsoidal,entire,filament,fruiting,globose,gradually,green,growth,inflorescence,leaf,length,lengthening,like,lobed,long,loosely,lower,many,margin,mm,multangulate,narrowing,nodding,pedicel,peltate,perfect,petiole,plurifoliate,pore,poricidal,pubescent,ray,revolute,ripe,scurfy,simple,slit,small,stellate,stem,stout,surface,terminal,time,tip,tree,treelet,trichome,unevenly,unit,varying,way,white	.1,.2,.5,0.2–0.4,0.5,0.5–1,0.6–0.7,0.6–2,0.9–1,1.2–1.5,1.5–2,16–20,1–1.1,1–1.5,2.5–9,20,20–30,2–5,3–4,3–6,40–50,4–30,4–4.5,5-merou,5–8,6.5–16,60+,6–7,8–15,9–9.5,>,abaxial,abaxially,absent,acuminate,adaxial,ag,almost,along,alyx,apar,ark,axe,beig,beneath,bright,brown,brownish,capitate,center,closely,covered,dark,deeply,deltate,dense,diameter,dichasia,discolorous,drying,eaf,edge,eed,elliptic,elongate,erec,exserted,flattened-reniform,flower,free,fresh,fused,glabrous,golden,halfway,ilament,impressed,lamina,layer,less,lobe,midpoint,minutely,narrowly,new,nflorescence,older,olive,orolla,pair,pale,papillose,part,peduncle,per,pericarp,persistent,pitted,plant,portion,primary,projection,pubescence,reddish,reflexed,regularly,rhachi,ruit,scar,sessile,shiny,short-stalked,spaced,sparsely,stigma,strongly,style,subtended,tall,tan,tangled,tem,testal,thin,tiny,tube,ud,undersurface,upper,vary,vein,visible,wide,woody,yellow,ympodial,–18	0.6-2,1-1.5,3-4,age,appressed,articulation,bract,breeding,broad-based,colour,connective,dichasial,form,fruit,hair,heteromorphism,inflated,insertion,interjected,interpetalar,leaflet,marking,mature,modification,na,needle-like,odour,orientation,paired,pattern,placement,position,prickle,pseudostipule,rhizome,scale,shape,smell,spot,staman,stone,structure,symmetry,sympodial,system,texture,tissue,tuber,type,vegetative,xylopodia,zygomorphy	acute,anthesi,appearing,articulated,base,berry,branched,branching,c.,cm,connivent,coriaceous,cup-shaped,densely,echinoid,ellipsoidal,entire,globose,gradually,green,length,lengthening,like,lobed,long,loosely,many,mm,multangulate,narrowing,nodding,pedicel,peltate,perfect,plurifoliate,pore,poricidal,pubescent,ray,revolute,ripe,scurfy,simple,slit,small,stellate,stem,stout,terminal,time,tip,tree,treelet,trichome,unevenly,varying,way,white	0.6-2,1-1.5,3-4,age,dichasial,na,zygomorphy
365	wfo-0001030147	success	156	113	50	59	97	54	44	6	0.5-2,1-4,1-5,2-10,2-13,2-5,4-5.5,apex,apically,articulate,base,blue,branched,calyx,cell,cm,conical,connate,corolla,cuneate,deep,dehiscent,diameter,dichasially,distal,ebracteate,filament,finely,generally,green,green-white,hair-like,half,herbaceous,interjected,leaf,leaflet,long,medium,mm,mucilaginous,oblique,odd-pinnate,ovoid,pattern,pedicel,perennial,petiole,plant,poricidally,proximal,pubescent,purple,rotate,rounded,seed,tuber-bearing,unit,¼	0-5,1.0-2.0,1.0-2.2,10-19,14-35,15-30,2,2-10.5,2-3,2.5-7.5,3-5-7-8,3-6-foliat,4-3.,4.2-7.5,4.5-10,5-8,8-38,abaxiall,abaxially,acumen,acuminate,acute,adaxially,apical,attenuate,covering,cyme,dichasial,digestion,diminishing,dorsally,eaf,edge,eed,elliptical,emoval,enzyme,exceeding,flat,flower,folded,forked,globo,gradually,honeycomb,introrse,lateral,living,lobe,lon,long-attenuate,lower,lunat,make,maturing,monochasial,narrowly,nflorescence,nther,obtuse,often,orolla,ovate,pair,peduncle,perfect,petiolule,plan,reveal,ruit,sessile,seudostipule,short,size,slit,specimen,stamen,stigma,straight,style,subequal,subsessile,tal,tem,terminal,testal,thick,throughou,throughout,tip,toward,typically,vary,wall,wide,yellow,ympodial	3-6-foliate,4-31,anther,appressed,articulation,bract,branching,breeding,colour,connective,form,fruit,fruiting,growth,hair,height,heteromorphism,inflated,inflorescence,insertion,interpetalar,length,lunate,margin,marking,mature,modification,na,odour,orientation,paired,placement,pore,position,prickle,pseudostipule,rhizome,scale,shape,spot,staman,stem,stone,structure,symmetry,sympodial,system,texture,tissue,tuber,type,xylopodia,ye,zygomorphy	0.5-2,1-4,1-5,2-10,2-13,2-5,4-5.5,apically,articulate,blue,branched,cm,conical,connate,cuneate,deep,dehiscent,dichasially,distal,ebracteate,finely,generally,green,green-white,hair-like,half,herbaceous,long,medium,mm,mucilaginous,oblique,odd-pinnate,ovoid,perennial,plant,poricidally,proximal,pubescent,purple,rotate,rounded,tuber-bearing,¼	3-6-foliate,4-31,lunate,na,ye,zygomorphy
366	wfo-0001030151	success	174	188	101	122	52	66	98	3	-3,0.2-0.5,0.3-0.5,0.5,0.5-1,1-1.5,1-17,1-2,1-3,1-5,1.5-2,1.5-2.5,10-20,10-25,15-35-50,2-11,2-25,2-3,2-6,2-7-compound,20-30,3-14,3-5,3.5-32,4-5,5-6,6-9,?,absent,abundantly,acuminate,acute,adaxial,adaxially,apart,apex,around,base,beyond,blade,blotch,calyx,cell,chartaceous,cm,connate,connective,cordate,cuneate,cylindrical,decurrent,deltate,diameter,directed,distally,elliptic,entire,except,flower,fruit,glabrous,globose,hair,lanceolate,leaf,leaflet,lilac-tinged,line,lobe,long,longitudinal,lower,margin,membranaceous,mm,narrowly,near,oblique,oblong,obovate,obtuse,often,pedicel,peduncle,perfect,petiole,pinnately,pore,puberulent,purplish,pyriform,rachi,radiu,remnant,ring,sand-punctate,shallowly,simple,slightly,sometimes,somewhat,sparsely,stamen,stellate,stigma,stone,stripe,style,surface,time,tree,triangular,truncate,tube,unbranched,unit,white,whitish,wide,x,yellow,yellow-green	1,4-foliat,abaxially,aggregate,ape,apiculate,articulated,axe,basal,channe,ciliat,compound,eaf,eed,eglandular,exceeding,exserted,glabrate,glandular,glandular-puberulent,leaving,less,lon,nflorescence,nther,orolla,pedicellar,presence,probably,ripe,ruit,sand-punctat,scattered,short,shorter,slender,small,spaced,stalked,tal,tem,thecae,tip,toward,truncat,ud,unknow,vary,vein,veiny,white-puberulent,ympodial	4-foliate,anther,appressed,articulation,bract,branching,breeding,broad-based,bud,channel,colour,corolla,exsertion,filament,form,fruiting,growth,height,heteromorphism,inflated,inflorescence,insertion,interjected,interpetalar,length,marking,mature,modification,na,needle-like,number,odour,orientation,ovary,paired,pattern,placement,plant,position,prickle,pseudostipule,punctation,ratio,rhizome,scale,seed,shape,size,smell,spacing,spot,staman,stem,structure,symmetry,sympodial,system,texture,theca,tissue,trichome,tuber,type,vegetative,xylopodia,zygomorphy	-3,0.2-0.5,0.3-0.5,0.5,0.5-1,1-1.5,1-17,1-2,1-3,1-5,1.5-2,1.5-2.5,10-20,10-25,15-35-50,2-11,2-25,2-3,2-6,2-7-compound,20-30,3-14,3-5,3.5-32,4-5,5-6,6-9,?,absent,abundantly,acuminate,acute,adaxial,adaxially,apart,around,base,beyond,blotch,chartaceous,cm,connate,cordate,cuneate,cylindrical,decurrent,deltate,directed,distally,elliptic,entire,except,glabrous,globose,hair,lanceolate,lilac-tinged,line,long,longitudinal,membranaceous,mm,narrowly,near,oblique,oblong,obovate,obtuse,often,perfect,petiole,pinnately,puberulent,purplish,pyriform,ring,sand-punctate,shallowly,simple,slightly,sometimes,somewhat,sparsely,stamen,stellate,stripe,style,time,tree,triangular,truncate,unbranched,white,whitish,wide,x,yellow,yellow-green	4-foliate,channel,na
367	wfo-0001030153	invalid_json_followup	147	124	NA	89	58	35	NA	NA	.1,.2,/3,0.2-1,1-1.5,1-10,1-2,1-2.5,1.3-1.5,2-8,2.5-4,3-4,3-50,3.5-10.5,6-8,absent,acuminate,acute,anther,anthesi,apart,apex,attenuate,bark,base,berry,branched,calyx,cm,corolla,dark,densely,diameter,distinct,domatia,ellipsoid,elliptic,entire,erect,exerted,filament,flower,fruiting,glabrous,globose,green,growth,impressed,lanceolate,less,lobed,margin,minutely,mm,narrowly,new,nodding,occasionally,older,pair,papillate,pedicel,peduncle,petiole,pit-like,plane,pore,poricidal,primary,rachi,revolute,ripe,scar,simple,slightly,small,stem,strongly,time,tip,tree,treelet,tube,vein,way,white,x,yellowish,young	0.8-0.9,0.8-1.3,1-1.2,1.3-1.9,1.5-2,2-lobed,3-5,5-6,abaxially,adaxially,age,ape,apiculate,apparently,axil,brittle,broadly,caly,campanulate,clavate,conical,deltate,dot,dry,eaf,enlarged,free,glabrou,internodal,irregularly,known,lengthening,lobe,lower,markedly,membranous,nflorescence,ot,ovary,paler,papillat,perfect,plurifoliat,portion,resinous,ruit,slit,spaced,specimen,stigma,straight,style,surface,terminal,thin,ud,unit,ympodial	abaxial,adaxial,appressed,branching,breeding,bud,character,characteristic,colour,connective,erectnes,exertion,form,fruit,hair,hairines,impression,inflated,inflorescence,leaf,length,marking,modification,na,number,presence,shape,size,spacing,spot,symmetry,system,type,value,width	NA	NA
368	wfo-0001030167	success	141	102	48	49	92	53	38	10	.8,accrescent,acuminate,acute,anther,apex,base,berry,calyx,chartaceous,ciliate,cm,entire,extra-axillary,filament,flattened,fruit,fruiting,glabrous,green,less,margin,maturity,membranaceous,mm,near,obtuse,ovate,ovoid,pedicel,petal,petiole,pointed,reflexed,rounded,simple,somewhat,stellate,stigma,style,symmetrical,thinly,tip,unbranched,unit,vine,weakly,white,x	.9,0.1–0.2,0.5–0.6,0.5–0.7,0.6,0.6–0.8,0.7–1.2,0.8–1,1.2–2.5,1.5–2,1.5–7,12,14–19,15–20,17–58,1–1.2,1–1.5,2–3,2–4.5,4.5–8,4–10,4–4.5,4–5,4–7,5-merous,8–10,abaxially,adaxially,along,alyx,apar,apically,axe,blade,branch,c.,ciliat,clavate,climbing,contiguously,densely,diameter,eaf,eed,enlarged,fertile,flower,gap,glabrou,herbaceous,immature,lanceolate,lobe,long,lower,m.,membranous,minutely,moderately,nearly,nflorescence,nternode,orolla,pair,peduncle,penden,perfec,pinnate,plurifoliat,rachi,ruit,sand-punctate,scar,secondary,seen,slender,slightly,spaced,sparsely,subequal,tamen,tem,time,truncat,tube,unknown,vary,vegetation,vein,venation,wide,ympodial	0.1-0.2,0.7-1.2,1-1.5,1.5-2,4-4.5,articulation,bract,branching,breeding,cell,colour,connective,corolla,form,growth,hair,heteromorphism,inflorescence,insertion,interjected,interpetalar,leaf,leaflet,length,marking,na,odour,orientation,paired,pattern,perfect,placement,plurifoliate,position,prickle,pseudostipule,rhizome,scale,shape,spot,staman,stone,structure,symmetry,sympodial,system,texture,tissue,truncate,tuber,type,xylopodia,zygomorphy	.8,accrescent,acuminate,acute,apex,berry,chartaceous,ciliate,cm,entire,extra-axillary,flattened,glabrous,green,less,margin,maturity,membranaceous,mm,near,obtuse,ovate,ovoid,petal,pointed,reflexed,rounded,simple,somewhat,stellate,symmetrical,thinly,tip,unbranched,vine,weakly,white,x	0.1-0.2,0.7-1.2,1-1.5,1.5-2,4-4.5,na,perfect,plurifoliate,truncate,zygomorphy
369	wfo-0001030176	success	171	156	88	100	71	56	82	6	-6.25,.2,.7,.75-1.5,0.4-1.5,0.5-2,0.6-0.9,0.7-1.4,0.7–0.8,1,1.5-2,1.6,1/3,1/6,2-3,2-foliate,2.25-3.25,2.5,3-5,3-lobed,3.75-5,4-9,6-8,accrescent,acute,anther,apex,articulated,attenuate,basal,base,berry,bilobed,blade,branch,broad,broadly,calyx,chartaceous,ciliate,cm,connivent,covering,cylindrical,decumbent,depressed-globose,diameter,especially,extra-axillary,few-branched,filament,flattened-reniform,flower,fruit,fruiting,glabrous,hair,herb,hermaphroditic,lanceolate-oblong,light,lobe,long,margin,midrib,mm,nearly,oblong,ovate,pale,partially,pedicel,peduncle,petiole,plant,pore,prostrate,pubescent,rachi,rarely,recurved,ripe,rotate-stellate,simple,slightly,sometimes,somewhat,sparsely,stigma,style,tip,tube,unbranched,unit,violet,white,x,yellow,yellow-orange,young	-1.4,-4.25,0.5,1-2,1-5,1.2,1.2-2.5,1.5-2.5,2.5–7.5,2.5–9,2–3,5-merou,6–8,abaxially,adaxiall,adaxially,alyx,angulate,apart,apparently,asymmetrically,axe,ba,bi-lobed,capitat,contact,dehiscent,downward,eaf,eed,erec,forming,geminat,hold,interlobal,juic,lance-ovate,lateral,line,lon,longitudinall,lower,major,mesocarp,minutely,near,nflorescence,node,numerous,often,orolla,patch,perfect,recurve,rooting,round,ruit,sinus,soil,spaced,tamen,tem,terminal,time,triangular,vary,vein,white-puberulent,wide,winged,ympodial	abaxial,adaxial,arrangement,articulation,bract,branching,capitate,cell,colour,connective,corolla,erect,form,geminate,growth,habit,height,heteromorphism,inflorescence,insertion,interjected,interpetalar,leaf,leaflet,length,longitudinally,marking,modification,na,number,odour,orientation,ovary,paired,placement,position,prickle,pseudostipule,rhizome,scale,seed,shape,size,spot,staman,stellate,stem,stone,structure,symmetry,sympodial,texture,tissue,tuber,type,xylopodia	-6.25,.2,.7,.75-1.5,0.4-1.5,0.5-2,0.6-0.9,0.7-1.4,0.7–0.8,1,1.5-2,1.6,1/3,1/6,2-3,2-foliate,2.25-3.25,2.5,3-5,3-lobed,3.75-5,4-9,6-8,accrescent,acute,articulated,attenuate,basal,base,berry,bilobed,blade,broad,broadly,chartaceous,ciliate,cm,connivent,covering,cylindrical,decumbent,depressed-globose,especially,extra-axillary,few-branched,flattened-reniform,flower,fruit,glabrous,hair,herb,hermaphroditic,lanceolate-oblong,light,long,midrib,mm,nearly,oblong,ovate,pale,partially,pore,prostrate,pubescent,rarely,recurved,ripe,rotate-stellate,simple,slightly,sometimes,somewhat,sparsely,tip,unbranched,violet,white,x,yellow,yellow-orange,young	capitate,erect,geminate,longitudinally,na,stellate
370	wfo-0001030180	success	135	94	37	47	88	47	35	2	.5,0.5-1,3-8,?,accrescent,anther,apex,attenuate,base,becoming,berry,calyx,corolla,filament,fruit,fruiting,furcate,glabrous,globose,green,interpetalar,leaf,linear,lobed,long,minutely,mm,opposite,papillate,papillose,pedicel,petiole,pore,poricidal,puberulent,shaped,shrub,slightly,sparsely,tear-drop,thin,tip,uniseriate,unit,white,woody,x	.1,.75,0.05-1,0.8-2,0.9-1.8,1-1.5,1.1-1.2,10-30-flowered,3-4,4.5-5,6,8-10,8.5-23,abruptly,anthesi,apart,apiculate,appearing,bark,clavate,clu,cm,dark,decurrent,deflexe,deltoid,dia,eaf,edicel,eed,ellipsoid,erect,exserted,free,glabrate,height,immature,inflorescenc,known,lateral,lenticellat,lobe,lon,long-acuminate,lower,main,middle,minute,narrowing,nearly,nflorescence,occasionally,older,ovary,overlapping,pair,peduncl,planar,plurifoliat,portion,prominent,proximal,raised,rounded,ruit,scar,sinus,slender,soon,spaced,stem,stigma,straight,style,surface,terminal,trichome,tube,ud,unevenly,unknown,vein,widely,widest,winged,yellowish,ympodial,young	appressed,articulation,bract,branching,breeding,cell,colour,connective,form,growth,hair,heteromorphism,inflated,inflorescence,insertion,interjected,leaflet,length,margin,marking,mature,modification,na,odour,orientation,paired,pattern,placement,plurifoliate,position,prickle,pseudostipule,rhizome,scale,shape,spot,staman,stone,structure,symmetry,sympodial,system,texture,tissue,tuber,type,xylopodia	.5,0.5-1,3-8,?,accrescent,attenuate,becoming,berry,fruit,furcate,glabrous,globose,green,leaf,linear,lobed,long,minutely,mm,opposite,papillate,papillose,poricidal,puberulent,shaped,shrub,slightly,sparsely,tear-drop,thin,tip,uniseriate,white,woody,x	na,plurifoliate
371	wfo-0001030189	success	185	159	80	95	90	64	72	8	/3,0-1,0.1-0.2,0.2-0.3,0.5-1.6,0.9-1.1,1,1-1.5,1-2,1-3-cellular,1-4-cellular,1.3-4.2,1.5-4.5,1/3,2-3,2-5.5,3.2-4.5,4-5.5,5-6,abaxially,anther,apex,apparently,appressed,articulated,base,berry,branched,calyx,chartaceous,cm,cordate,curved,densely,diameter,dull,entire,filament,flattened-reniform,flower,fruit,fruiting,glabrescent,glabrous,lateral,leaf,length,lobed,lower,margin,mature,maturity,mauve,midpoint,mm,moderately,oblong,obtuse,orange,ovate,pedicel,peduncle,per,petiole,poricidal,porrect,purple,ray,red,rounded,scar,sessile,shrub,simple,slender,sometimes,sparsely,spherical,stalked,stellate,stellate-pubescent,stem,style,surface,tapering,terminal,tip,trichome,unarmed,unit,upper,variously,way,yellow,yellow-green	.2,0-15,0-30,0.1,0.2-0.5,1-4-cellula,1.1-2.7-4,1.5-2,1.5-5,1/,1/6-1/3-1/2,2,2.5-4,3-4,4-13,5-10,5-8,5-8-10,5-merous,6-10,6-12,8-18,acut,alyx,apar,apically,bark,blade,concolorous,connivent,deltate,drying,eaf,eed,elliptic,elongating,equal,erect,evenly,faint,foliaceous,free,frui,glabrescen,gland-tipped,gray,green,infructescence,lobe,long,longer,nflorescence,often,older,one,open,orolla,oung,pair,perfec,pericarp,plurifoliat,portion,primary,recurved,red-brow,reflexed,ruit,scandent,shorter,smooth,somewhat,spaced,spreading,stalk,strongly,tamen,terete,tertiary,time,tube,unarme,vary,vein,venation,visible,wide,woody,ympodial,young	0.1-1,0.1-2,10-15,20-30,apart,armament,articulation,bract,branching,breeding,broad-based,cell,cellularity,colour,connective,corolla,form,growth,hair,height,heteromorphism,inflorescence,insertion,interjected,interpetalar,leaflet,marking,modification,na,needle-like,number,odour,orientation,ovary,paired,pattern,perfect,placement,plant,plurifoliate,pore,position,prickle,pseudostipule,rhizome,scale,seed,shape,smell,spacing,spot,staman,stone,structure,symmetry,sympodial,system,texture,tissue,tuber,type,vegetative,width,xylopodia	/3,0-1,0.1-0.2,0.2-0.3,0.5-1.6,0.9-1.1,1,1-1.5,1-2,1-3-cellular,1-4-cellular,1.3-4.2,1.5-4.5,1/3,2-3,2-5.5,3.2-4.5,4-5.5,5-6,abaxially,apparently,appressed,articulated,base,berry,branched,chartaceous,cm,cordate,curved,densely,dull,entire,flattened-reniform,fruit,glabrescent,glabrous,lateral,lobed,maturity,mauve,mm,moderately,oblong,obtuse,orange,ovate,per,poricidal,porrect,purple,red,rounded,sessile,shrub,simple,slender,sometimes,sparsely,spherical,stalked,stellate,stellate-pubescent,tapering,terminal,tip,unarmed,upper,variously,way,yellow,yellow-green	0.1-1,0.1-2,10-15,20-30,apart,na,perfect,plurifoliate
372	wfo-0001030219	success	191	143	72	75	116	68	53	19	0.5,1.5,15,3,5,60,anther,apex,apparently,articulated,base,black,blue,brown,calyx,cell,cm,deeply,diameter,difoliate,filament,flattened,flower,fruit,glabrous,globose,green,hair,incised,indistinct,internode,leaf,lilac,lobe,long,longitudinal,margin,marking,mm,moderately,multicellular,number,oblong,opening,opposed,ovate,pale,pedicel,pentagonal,perennial,perfect,petiole,pore,present,pubescent,purple,rapidly,serrate,shrub,simple,size,sparsely,split,stigma,stone,stripe,style,time,tube,uniseriate,unit,velutinous,wing,woody,x	0.1–0.3,0.2–2.3,0.4–1.0,0.5–,0.7–1.1,0.8–3.0,0–,1.0–1.2,1.0–1.5,1.0–2.0,1.0–2.2,1.3–2.9,1.4–2.8,1.6–,10,1–2.5,2.0–2.5,2.0–3.2,2.0–5.5,2.4–6.0,2–,2–2.5,2–3,2–4.5,4.5–5.5,4.8–11.5,4–5,4–7,5–,5–8,6–,6–10,6–8,7–11,8–18,9–10,9–12,abaxiall,abaxially,acut,acute,adaxiall,adaxially,adnate,ag,along,anisophyllous,anthesi,apart,apical,appearing,arising,arranged,axe,ba,basal,blade,bract–like,branched,chartaceous,clavat,concave,connivent,convex,cylindrical,decreasing,decurrent,densely,diamete,directed,distally,eaf,eed,elliptic,equal,erect,geminat,glabrescent,lanceolate,lower,nflorescence,olive,oppositely,orolla,pair,paler,peduncle,pitted,procumbent,red–purple,regularly,rounded,ruit,sessile,shallowly,sid,side,smaller,spaced,straight,strongly,surface,tal,tamen,tem,two,unicellular,vary,white,wide,winged,yellow,ympodial,–3.0,–7.0,–9.5	0.1-0.3,0.7-1.1,1.0-1.2,1.6-3.2,2-3,2-4.5,2.0-2.5,2.4-6.0,4.5-5.5,4.8-11.5,5-11,5-8,6-8,9-10,abaxial,adaxial,arrangement,articulation,bract,branching,breeding,clavate,colour,connective,corolla,decurred,form,growth,height,heteromorphism,inflorescence,insertion,interjected,interpetalar,leaflet,length,mature,modification,na,odour,opposite,orientation,ovary,paired,pattern,placement,plant,position,prickle,pseudostipule,red-purple,rhizome,scale,seed,shape,spot,staman,stem,structure,symmetry,sympodial,system,texture,tissue,tuber,type,width,xylopodia	0.5,1.5,15,3,5,60,apparently,articulated,base,black,blue,brown,cm,deeply,diameter,difoliate,flattened,glabrous,globose,green,incised,indistinct,leaf,lilac,long,longitudinal,marking,mm,moderately,multicellular,oblong,opening,opposed,ovate,pale,pentagonal,perennial,perfect,present,pubescent,purple,rapidly,serrate,shrub,simple,sparsely,split,stripe,time,uniseriate,velutinous,woody,x	0.1-0.3,0.7-1.1,1.0-1.2,1.6-3.2,2-3,2-4.5,2.0-2.5,2.4-6.0,4.5-5.5,4.8-11.5,5-11,5-8,6-8,9-10,clavate,decurred,na,opposite,red-purple
373	wfo-0001030225	success	151	146	66	84	67	62	64	2	-11,.5-2.5,0-20,0-45,0-5,1,1-4,1-6,1.5,1.5-2.5-7,10-15-30,10-30,2,2-2.5-4,2-3,2-6,3-11-compound,3-4,3-5,4-5,acuminate,acute,apex,apical,articulated,base,calyx,campanulate,cm,connective,cordate,coriaceous,cuneate,cylindrical,deltate,densely,diameter,dilated,elliptic-ovate,entire,fleshy,flower,forked,fruit,glabrous,gland,globose,leaf,leaflet,lobe,lower,margin,mm,moderately,oblong,obtuse,pedicel,peduncle,perfect,petiole,pinnately,pore,possibly,puberulent,purple,rachi,radiu,shallowly,shrub,simple,small,stalked,stellate,stigma,strongly,style,succulent,tree,truncate,two,unbranched,unit,unknown,x	-1.5,.5,2-18,3-20,3-foliat,8-15,abaxially,absent,adaxially,apart,ape,apically,ature,axe,basal,beyond,bilobed,blade,color,compound,conivent,directed,distally,eaf,eed,equal,especially,exceeding,expanded,exserted,glabrate,immature,laterally,leaving,less,long,minutely,narrowly,nflorescence,nther,one,orolla,papillose,prominent,puberulen,scar,see,seen,slightly,somewhat,spaced,sparsely,stamen,tal,tem,thecae,time,tip,tomento,toward,triangular,tube,ud,unknow,vary,wide,ympodial	3-foliate,anther,arrangement,articulation,bract,branching,breeding,broad-based,bud,cell,colour,corolla,filament,form,growth,hair,height,heteromorphism,inflorescence,insertion,interjected,interpetalar,length,marking,modification,na,needle-like,number,odour,orientation,ovary,paired,pattern,placement,plant,position,prickle,pseudostipule,rhizome,scale,shape,size,smell,spacing,spot,stalk,staman,stem,stone,structure,surface,symmetry,sympodial,system,texture,theca,tissue,trichome,tuber,type,vegetative,xylopodia	-11,.5-2.5,0-20,0-45,0-5,1,1-4,1-6,1.5,1.5-2.5-7,10-15-30,10-30,2,2-2.5-4,2-3,2-6,3-11-compound,3-4,3-5,4-5,acuminate,acute,apical,articulated,base,campanulate,cm,cordate,coriaceous,cuneate,cylindrical,deltate,densely,dilated,elliptic-ovate,entire,fleshy,forked,glabrous,gland,globose,mm,moderately,oblong,obtuse,perfect,pinnately,possibly,puberulent,purple,shallowly,shrub,simple,small,stalked,stellate,strongly,succulent,tree,truncate,two,unbranched,unknown,x	3-foliate,na
374	wfo-0001030250	success	169	129	63	79	90	50	60	3	.5,0.5-1,1-1.5,1-3,1.1-1.2,1.1-3.5,1.25-1.5,1.7-7,11.2-22,11.3,2-2.5,2.1-6,2.5-3.25,25,3.4-6.6,3.5-4,5-6,6-8,across,anther,apart,apex,attenuate,base,broadly,calyx,capitate,cm,conical,corolla,cuneate,cup-shaped,dark,decurrent,dia,difoliate,elliptic,elliptic-ovate,filament,glabrous,globose,green,greenish-white,greenish-yellow,inflorescence,lateral,leaf,long,long-acuminate,main,minor,minutely,mm,occasionally,opposite,orbicular,ovary,ovoid-reniform,pair,pedicel,petiole,pitted,pore,poricidal,scar,seed,shape,shaped,shrub,simple,size,stem,stigma,style,tear-drop,tip,unit,vein,x	/4,0-seeded,1.4-1.5,1.9-2.6,3-5,4-7,5-50-flowered,anthesi,appearing,arching,bark,beginning,beneath,berry,brown,bullate,carinate-hooded,consisting,curved,deflexed,differing,dry,eaf,edicel,eed,exerted,five,free,fresh,fruiting,geminat,glabrou,horizontally,inflorescenc,irregularly,lobe,lobed,lon,lower,major,maturity,middle,n,nflorescence,node,older,one,orbiculate,pale,paler,papillo,papillose,pendulous,pit,portion,projection,prominent,proximal,raised,reflexed,rim,ruit,sea-green,shallow,slender,slightly,smooth,soon,spaced,specimen,spreading,straight,surface,tall,tan,tapering,translucent,translucent-green,tube,two,ud,usually,way,white-lenticellat,white-lenticellate,wide,widest,winged,woody,ympodial	articulation,bract,branching,breeding,bud,cell,colour,connective,form,fruit,geminate,growth,hair,height,heteromorphism,insertion,interjected,interpetalar,leaflet,length,margin,marking,mature,modification,na,odour,orientation,pattern,placement,plant,position,prickle,pseudostipule,rhizome,scale,spacing,spot,staman,stone,structure,symmetry,sympodial,system,texture,tissue,tuber,type,venation,xylopodia,zygomorphy	.5,0.5-1,1-1.5,1-3,1.1-1.2,1.1-3.5,1.25-1.5,1.7-7,11.2-22,11.3,2-2.5,2.1-6,2.5-3.25,25,3.4-6.6,3.5-4,5-6,6-8,across,apart,attenuate,broadly,capitate,cm,conical,cuneate,cup-shaped,dark,decurrent,dia,difoliate,elliptic,elliptic-ovate,glabrous,globose,green,greenish-white,greenish-yellow,lateral,leaf,long,long-acuminate,main,minutely,mm,occasionally,opposite,orbicular,ovoid-reniform,pair,petiole,pitted,poricidal,shaped,shrub,simple,tear-drop,tip,vein,x	geminate,na,zygomorphy
375	wfo-0001030271	success	195	95	43	57	138	38	41	2	0-2,1-2,1.4-2.1,2-6,4-7,anther,apex,asymmetric,attenuate,base,berry,blue,cell,cm,coriaceous,corolla,deep,filament,forked,fruit,glabrous,green,herb,homostylous,interjected,lanceolate,leaf,leaflet,light,lilac,long,medium,mm,moniliform,odd-pinnate,ovoid,pedicel,pentagonal,petiole,petiolulate,plurifoliate,pore,poricidal,ripe,rotate,rounded,slightly,sometimes,spot,symmetric,terminal,tip,tissue,tri-,tuber,unit,white	0.15-0.75,0.5-1.2,0.7-9.5,0.9-2.5,0.9-3.6,1-2.5,1-3,1-4,1-6,1-7,1.9-6.6,15-61,2-2.7,2-3,2-4,2.4-5.6,3-10,3-5,3.4-7.5,4-22,5-8,5-merou,5.6-12.3,6-15,abaxially,acumen,acute,adaxiall,adaxially,ag,along,alyx,apart,apparently,arranged,articulated,axe,axillary,basiscopic,bead,blade,brownish,bud,capitat,clavate,coloration,completely,condition,connivent,considerably,covering,dark,decreasing,diameter,digestion,distal,dorsally,drying,eaf,edge,eed,elliptic,enzyme,erect,exceeding,flat,flower,folded,fresh,geminat,generally,glabrou,green-white,greenish,habi,hair-like,half,honeycomb-shaped,larger,lateral,lengthening,like,linear,living,lobe,lower,make,middl,mottled,mucilaginous,multiple,necklace,nflorescence,orbicular,orolla,ovate,pair,peduncle,perfect,plant,purple,removed,rosette,ruit,seed,sessile,seudostipule,side,size,slit,spaced,specimen,stamen,stigma,stolon,straight,style,subtending,tall,tamen,tem,testal,thick,throughout,toward,tube,typically,unwinged,usually,vary,vein,wall,wet,whitish,wide,x,yellow,ympodial	articulation,bract,branching,calyx,colour,connective,form,fruiting,growth,hair,heteromorphism,inflorescence,insertion,interpetalar,length,margin,marking,mature,middle,na,odour,orientation,paired,placement,position,prickle,pseudostipule,rhizome,scale,shape,staman,stone,structure,symmetry,sympodial,texture,type,xylopodia	0-2,1-2,1.4-2.1,2-6,4-7,asymmetric,attenuate,berry,blue,cm,coriaceous,deep,forked,glabrous,green,herb,homostylous,lanceolate,light,lilac,long,medium,mm,moniliform,odd-pinnate,ovoid,pentagonal,petiolulate,plurifoliate,poricidal,ripe,rotate,rounded,slightly,sometimes,spot,symmetric,terminal,tip,tri-,white	middle,na
376	wfo-0001030272	success	179	113	50	61	118	52	46	4	-6,.5,/4,0.7-2.5,3.5-5,anther,apex,apparently,articulated,base,berry,bright,calyx,cm,connivent,difoliate,elongating,entire,erect,evenly,filament,fruit,fruiting,glabrous,green,hair,lateral,leaf,length,lobed,long,long-attenuate,lower,margin,mature,maturity,mauve,membranous,mm,pedicel,petiole,poricidal,red,shallowly,shrub,simple,spherical,spreading,stellate,stem,surface,tapering,terminal,tip,trichome,unarmed,unbranched,undulate,unit,way,young	.3,0-20,0.05-0.1,0.05-1.5,0.5-1,0.5-1.5,0.5-2,0.6-0.9,0.65-1,0.8-1.5,1,1-1.5,1-2.8,1.2-1.8,1.5-2.5,1.5-3,1/3,1/3-2/3,10-20,2-2.5,2-6.5,2.5-3,2.5-3.5,2.8-3.5,3-8,4-10,4-15,4-6,4-8,5-7,5-merous,abaxially,acut,acute,almost,alyx,ame,apar,apically,ba,bark,blade,c.,concolorous,deltate,densely,diameter,drying,eaf,eed,elliptic,equal,flattened-reniform,flower,free,geminat,glabrescen,glabrescent,gland,glandular,gra,infructescence,less,lobe,longer,midpoint,minute,moderately,multangulate,narrow-deltate,near,nflorescence,obtuse,older,one,open,orange-brown,orolla,oung,pair,peduncle,per,perfec,pericarp,porrect,portion,primary,ray,red-brown,reduced,reflexe,rounded,ruit,scar,sessile,shorte,slender,smooth,sometimes,spaced,sparsely,stellate-pubescent,straight,style,tamen,terete,tertiary,time,tube,unarme,upper,vary,vein,venation,visible,wide,woody,ympodial	appressed,articulation,bract,branching,breeding,broad-based,cell,colour,connective,corolla,form,geminate,growth,heteromorphism,inflated,inflorescence,insertion,interjected,interpetalar,leaflet,marking,modification,na,needle-like,odour,orientation,paired,pattern,perfect,placement,pore,position,prickle,pseudostipule,reflexed,rhizome,scale,shape,smell,spot,staman,stone,structure,symmetry,sympodial,system,texture,tissue,tuber,type,vegetative,xylopodia	-6,.5,/4,0.7-2.5,3.5-5,apparently,articulated,base,berry,bright,cm,connivent,difoliate,elongating,entire,erect,evenly,fruit,glabrous,green,lateral,length,lobed,long,long-attenuate,mature,maturity,mauve,membranous,mm,poricidal,red,shallowly,shrub,simple,spherical,spreading,stellate,tapering,terminal,tip,unarmed,unbranched,undulate,way,young	geminate,na,perfect,reflexed
377	wfo-0001030287	success	148	167	84	100	48	67	77	7	-40,-many,0-15,0.5-1,1,1-10,1-15,1-2,1-2.5,1-4,1-5.5,1.5-10,1.5-2.5,1966,2,2-10,2-12,2-3-9-11,2-5,4-5,4-6,4.5-6,8-13,?,acute,aggregate,apart,apex,base,blade,bluish,calyx,cell,chartaceous,cm,compound,cylindrical,deltate,dendritic,dendritically,densely,diameter,directed,down,eglandular,ellipsoidal,elliptic-ovate,entire,fide,flattened,flower,forked,glabrous,glandular,hair,herb,lanceolate,leaf,leaflet,lilac,lobe,long,lower,margin,membranaceous,mm,moderately,narrowly,oblong,ovoid,pedicel,peduncle,petiole,pinnately,pore,puberulent,pubescent,purple,rachi,radiu,rugulose,scar,shrub,simple,slightly,smith,stellate,stigma,stone,strongly,style,subcordate,subcoriaceous,tip,truncate,unbranched,unit,unknown,x,yellow	-foliat,.5-2.5,1-3,2.5-4,3,5-10,abaxially,adaxiall,adaxially,articulated,axe,basiscopically,branched,color,connivent,decurrent,dendritic-pubescen,distall,eaf,eed,gland,lateral,leaving,lon,long-stalked,nflorescence,nther,obtuse,often,orolla,pedicellar,presen,ruit,scattered,spaced,sparsely,sparser,stalked,subcapitat,tal,tem,time,triangular,tube,upper,vary,wide,ympodial	-foliate,anther,appressed,articulation,bract,branching,breeding,broad-based,colour,connective,corolla,dendritic-pubescent,direction,distally,filament,form,fruit,fruiting,growth,height,heteromorphism,inflated,inflorescence,insertion,interjected,interpetalar,length,marking,mature,modification,na,needle-like,odour,orientation,ovary,paired,pattern,placement,plant,position,present,prickle,pseudostipule,rhizome,scale,seed,shape,size,smell,spacing,spot,staman,stem,structure,subcapitate,surface,symmetry,sympodial,system,texture,tissue,trichome,tuber,type,vegetative,xylopodia,zygomorphy	-40,-many,0-15,0.5-1,1,1-10,1-15,1-2,1-2.5,1-4,1-5.5,1.5-10,1.5-2.5,1966,2,2-10,2-12,2-3-9-11,2-5,4-5,4-6,4.5-6,8-13,?,acute,apart,base,bluish,chartaceous,cm,compound,cylindrical,deltate,dendritic,dendritically,densely,directed,down,eglandular,ellipsoidal,elliptic-ovate,entire,fide,flattened,forked,glabrous,glandular,hair,herb,lanceolate,lilac,long,membranaceous,mm,moderately,narrowly,oblong,ovoid,pinnately,puberulent,pubescent,purple,rugulose,shrub,simple,slightly,smith,stellate,strongly,subcordate,subcoriaceous,tip,truncate,unbranched,unknown,x,yellow	-foliate,dendritic-pubescent,distally,na,present,subcapitate,zygomorphy
378	wfo-0001030300	success	232	106	50	62	170	44	43	7	0.2-1.5,0.5,0.5-4,0.6-0.8-1,1-celled,2-4,2-foliate,2-locular,4-celled,absent,anther,apex,articulation,base,bract,calyx,cell,cm,cordate,corolla,developed,eglandular,filament,fruit,fruiting,glandular,globose,golden,green,herb,imparipinnate,inflorescence,interjected,interrupted,leaflet,less,long,margin,mm,node,once-branched,pair,pedicel,pentagonal,petiole,pore,present,pseudostipule,pubescent,simple,slightly,stem,surface,tip,trichome,uniseriate,unit,usually,well,wide,yellow,zygomorphic	-7,.5,0.1,0.1-0.15,0.15-1,0.2,0.2-0.5,0.4-0.5,0.4-1.5,0.4-4.5,0.5-0.6,0.5-0.6-0.9,0.5-1,0.5-5,0.6-0.7-1,0.7-0.8,0.7-1.2,0.7-1.5,0.8-1,0.8-3,0.8-4,0.9-1,1,1-1.3,1-2,1-2-celled,1-4,1-6,1.2-2.2-7.5,1.4-2.4,1.5-2.5,1.5-3.5-13,2-2.1,2-2.5,2-3,3/4,4-11,6-15,6-8-celled,9-12,abaxially,abundant,acute,adaxial,adaxially,almost,although,always,anthesi,apical,appearance,appendage,articulated,ba,basal,bent,beyond,bifid,bracteate,brittle,broadly,brown,capitate,coherent,column,crenat,crenate,curved,deltate,densely,diamete,diameter,distal,eaf,edicel,eed,ellipsoidal,elliptical,elongate,entire,even,exserted,face,finely,flower,frequently,give,glabrous,glutinous-viscose,gree,hair-like,halfway,head,internode,introrse,irregularly,lamina,large,larger,lateral,leave,like,lobe,lon,longer,markedly,midvein,minute,moderately,multicellular,narrowly,nflorescence,oblique,obovate,occasionally,orbicular,outgrowth,ovary,pale,papillae,partially,peduncle,perennial,petal,petiolule,pith,plant,population,primary,pubescence,reflexed,rest,rounded,ruit,secondary,silky,sparsely,spathulate,spreadin,spreading,staminal,sterile,stigma,straight,strongly,style,tall,tem,terminal,tertiary,testa,thick,triangular,tube,two,ud,underlying,unicellular,united,upper,vein,velvety,wall,weak,wider,winged,woody,yellowish,yellowish-green,ympodial	appressed,branching,breeding,broad-based,colour,connective,form,growth,hair,heteromorphism,inflated,insertion,interpetalar,leaf,length,lower,marking,mature,modification,na,needle-like,odour,orientation,paired,pattern,placement,position,prickle,rhizome,scale,shape,spot,staman,stellate,stone,structure,symmetry,sympodial,system,texture,tissue,tuber,type,xylopodia	0.2-1.5,0.5,0.5-4,0.6-0.8-1,1-celled,2-4,2-foliate,2-locular,4-celled,absent,base,cm,cordate,developed,eglandular,glandular,globose,golden,green,herb,imparipinnate,interrupted,less,long,mm,node,once-branched,pair,pentagonal,present,pubescent,simple,slightly,stem,surface,tip,trichome,uniseriate,usually,well,wide,yellow,zygomorphic	broad-based,leaf,lower,na,needle-like,prickle,stellate
379	wfo-0001030311	success	182	102	41	57	125	45	39	2	.2,.5,0.6–1,0.8–1.2,1.5–5.5,1–1.5,2–2.5,3–5,5-pinnate,accrescent,acute,anther,apex,base,berry,brown,calyx,chartaceous,clavate,cm,cordate,densely,diameter,entire,extra-axillary,filament,flattened,fruit,fruiting,green,hair,half,leaflet,lower,margin,membranaceous,mm,oblique,obtuse,ovoid-rhomboid,papillose,pedicel,petiole,pubescent,purplish,slightly,sparsely,stellate,stem,stigma,style,surface,trichome,unbranched,vine,white,x	.5–1.8,0.1,0.1–0.2,0.3–1.5,0.4–2,0.5–0.8,0.5–1,0.5–2,0.5–2.5,0.6–2.4,0.8–4,0.8–4.5,1.2–7,1.5–2,1.5–3,1.5–6,1.5–8,1.8–2,15–22,1–1.2,1–2,1–2.5,1–3,2.2–2.5,2.2–3,2.5–9,2–10,2–6,3–7,5–10,<,abaxially,acuminate,adaxial,adaxially,along,alyx,apar,apical,appearance,axe,basal,blade,c.,capitat,ciliat,ciliate,color,cuneate,deltoid,dense,distal,eaf,eed,elliptical,especially,falcate,fallen,flower,giving,glabrou,glabrous,granular,groov,groove,ground,herbaceous,lanceolate,lateral,lenticular,like,lobe,log,lon,long,m.,membranous,midvein,minutely,nflorescence,nternode,obovate,occasionally,orangish,orolla,pair,peduncle,petiolulate,petiolule,plurifoliat,present,proximal,pubescence,rachi,rhomboid,rounded,ruit,sand-punctate,scattered,sessile,short,shortly,side,slender,smaller,spaced,strongly,tamen,tan,tem,terrestrial,thick,thickened,thinner,tip,trailing,tube,unit,upper,vary,vein,wide,wide-diameter,widely,ympodial	appressed,articulation,bract,branching,broad-based,capitate,cell,colour,corolla,form,growth,heteromorphism,inflated,inflorescence,insertion,interjected,interpetalar,leaf,length,marking,mature,na,needle-like,odour,orientation,paired,placement,position,prickle,pseudostipule,rhizome,scale,shape,smell,spot,staman,stone,symmetry,texture,tissue,tuber,type,vegetative,xylopodia,zygomorphy	.2,.5,0.6–1,0.8–1.2,1.5–5.5,1–1.5,2–2.5,3–5,5-pinnate,accrescent,acute,berry,brown,chartaceous,clavate,cm,cordate,densely,entire,extra-axillary,flattened,green,half,lower,membranaceous,mm,oblique,obtuse,ovoid-rhomboid,papillose,pubescent,purplish,slightly,sparsely,stellate,unbranched,vine,white,x	capitate,na
380	wfo-0001030311	success	201	104	53	65	136	39	50	3	.5,0.6-1,0.8-1.2,1-1.5,1.5-5.5,2-2.5,5-pinnate,absent,acute,anther,apex,articulated,basally,base,brown,cell,chartaceous,cm,cordate,densely,diameter,directed,distally,entire,filament,flattened,fruit,green,hair,herb,interjected,large,leaflet,long,longitudinal,lower,margin,membranaceous,minutely,mm,oblique,oblong,obtuse,opening,ovoid-rhomboid,pedicel,petiole,plurifoliate,pore,pubescent,purplish,simple,slender,slightly,slit,sparsely,stellate,stem,stone,surface,unbranched,uniseriate,unit,white,x	.2,.5-1.8,0-2.5,0.1,0.4-2,0.5-0.8,0.5-1,0.5-2,0.6-2.4,0.8-4,0.8-4.5,1-1.2,1-2.5,1-3,1.2-7,1.5-2,1.5-3,1.5-6,1.5-8,1.8-2,15-22,2-10,2-6,2.2-2.5,2.2-3,2224,3-5,3-7,5-10,5-merou,8031,<,abaxially,absen,accrescent,acuminate,adaxial,adaxially,ag,aggregate,along,alyx,apart,apical,apparently,appearance,axe,ba,basal,blade,capitat,ciliat,ciliate,clavate,color,connivent,cuneate,deltoid,dense,dig,distal,eaf,eed,elliptical,equal,especially,falcate,fallen,flower,formation,g,geminat,gh,giving,glabrous,granular,groov,groove,ground,half,lateral,lenticular,like,lobe,log,lon,m.,midvein,nflorescence,node,obovate,occasionally,orangish,orolla,pair,papillose,peduncle,perfect,petiolulate,petiolule,pittier,present,proximal,rachi,rhomboid,rooting,rounded,ruit,scattered,sessile,short,shortly,side,sinple,smaller,spaced,stigma,strongly,style,tamayo,tamen,tan,tem,thick,thickened,thinner,tip,trailing,tube,upper,vary,vein,wide,widely,yellow,ympodial	age,articulation,branching,broad-based,calyx,colour,corolla,form,fruiting,geminate,growth,heteromorphism,inflorescence,insertion,leaf,length,na,needle-like,odour,orientation,placement,position,prickle,pseudostipule,rhizome,scale,shape,size,smell,staman,structure,symmetry,sympodial,texture,trichome,tuber,type,vegetative,xylopodia	.5,0.6-1,0.8-1.2,1-1.5,1.5-5.5,2-2.5,5-pinnate,absent,acute,articulated,basally,base,brown,chartaceous,cm,cordate,densely,diameter,directed,distally,entire,flattened,green,hair,herb,large,long,longitudinal,margin,membranaceous,minutely,mm,oblique,oblong,obtuse,opening,ovoid-rhomboid,plurifoliate,pubescent,purplish,simple,slender,slightly,slit,sparsely,stellate,unbranched,uniseriate,white,x	age,geminate,na
381	wfo-0001030335	success	153	105	40	50	103	55	37	3	0.25-0.5,2-2.5,2-5,3/4,acute,anther,apex,base,berry,calyx,corolla,densely,elliptic,filament,filiform,fruiting,glabrous,globose,green,horizontally,leaf,lobed,long,lower,mm,narrowly,onto,opposite,papillose,pedicel,petiole,pore,poricidal,pubescent,ripe,shaped,shrub,simple,spreading,stem,surface,tear-drop,tip,trichome,uniseriate,unit,way,white,x,yellowish-green	.1,.25,.5,.75,0-5,0.05-0.2,0.1-0.5,0.5-1,0.7-1,1-1.5,1-2,1-3-flowered,1.1-1.4,1.1.5,2-2.2,2-4.5,2.5-3,5-6,5-7,7-13,acuminate,along,anthesi,aspec,ba,bark,beneath,bi-lobed,branch,bud,cm,conical,dark,deciduous,decurrent,deflexed,deltoid,dia,dry,eaf,edicel,eed,erect,except,expanded,exserted,flattened,free,geminate,gently,giving,greyish-red,lamina,lateral,lenticellate,lightly,like,lobe,lon,main,material,middle,minute,minutely,nflorescence,obovoid,occasionally,often,older,ovary,ovoid-reniform,pair,pale,papillo,pitted,portion,prominent,puberulen,puberulent,raised,reflexed,ruit,slightly,soon,sparsely,stigma,straight,strongly,style,tall,tan,tapering,tube,ud,underside,unifoliat,vein,widest,winged,woody,yellow,ympodial,young	appressed,articulation,bract,branching,breeding,broad-based,cell,colour,connective,decurred,form,fruit,growth,hair,heteromorphism,inflated,inflorescence,insertion,interjected,interpetalar,leaflet,length,margin,marking,mature,modification,na,needle-like,odour,orientation,paired,pattern,placement,position,prickle,pseudostipule,rhizome,scale,shape,smell,spot,staman,stone,structure,symmetry,sympodial,system,texture,tissue,tuber,type,unifoliate,vegetative,xylopodia,zygomorphy	0.25-0.5,2-2.5,2-5,3/4,acute,base,berry,densely,elliptic,filiform,glabrous,globose,green,horizontally,leaf,lobed,long,mm,narrowly,onto,opposite,papillose,petiole,poricidal,pubescent,ripe,shaped,shrub,simple,spreading,tear-drop,tip,uniseriate,way,white,x,yellowish-green	decurred,na,unifoliate
382	wfo-0001030336	success	262	143	92	109	153	34	90	2	-1.5,-10,0-2-9,0.1-0.5,0.1-0.7,0.1-1,0.15-0.9,0.2-1,0.2-1.5-2,0.3-1.1,0.5,0.5-0.7,1-3,1.6-7,2-foliate,4-10-19,4-celled,anther,apex,articulation,base,basiscopically,bent,berry,bifurcate,bract,bracteate,bright,calyx,cell,cm,cordate,corolla,crenate,darker,decurrent,densely,developed,eglandular,entire,extremely,filament,flushed,fruit,fruiting,glandular,globose,grayish,green,greenish,half,head,herb,imparipinnate,inflorescence,interjected,interrupted,investing,lanceolate,large,leaf,leaflet,less,like,long,loosely,lower,margin,markedly,midvein,mixed,mm,node,oblique,occasionally,once-branched,pedicel,petiole,petiolule,present,proximal,pseudostipule,pubescent,purple,rotate,scattered,sessile,shorter,simple,slightly,soft,sparse,spreading,stellate,stem,surface,surrounding,ten,tip,trichome,truncate,uniseriate,unit,usually,velvety,weak-walled,white,wide,yellow	.5,0.1-0.3,0.15-0.2,0.2,0.2-0.25,0.2-0.8,0.3-0.4,0.5-1,0.5-1.5,0.6-0.8,0.6-1.5,0.8-0.9,0.8-1.2,0.8-1.3,0.8-3,1,1-1.4,1-1.5,1-celled,1.0-1.4,1.5-2,1.5-3.5,1.5-4-10,1.5-5,1.7-2.3,1.8-3.0,1/4-1/3,10,2-4,2-locular,2/3,3-5,4,4-8-16,6,8-20,8-celled,absent,acute,adpressed,almost,amongst,anthesi,apical,appearance,appearing,appendage,articulated,basal,bluntly,branch,brown,capitate,clavat,coat,column,completely,conical,curved,dark,deeply,diamete,diameter,distal,divided,eaf,edicel,eed,elliptic,elongate,entir,erect,essentially,exserted,first,flower,giving,glandula,hair-like,halfway,internode,larger,largest,lateral,leave,lobe,lobed,lon,longer,maturity,mere,middl,minute,minutely,mostly,narrowing,narrowly,nflorescence,obovate,often,orbicular,outgrowth,ovary,pair,pale,papillate,part,peduncle,perennial,population,primary,puberulent,rachi,range,reflexed,rest,rounded,ruit,secondary,shaggy,shrub,silky,sinus,small,sometimes,southern,spreadin,staminal,sterile,stigma,straight,stripe,strongly,style,tall,tem,terminal,tertiary,testa,thick,tube,two,ud,unicellular,uniformly,united,upper,wall,way,winged,woody,ympodial,young	branching,broad-based,colour,form,growth,hair,heteromorphism,insertion,length,marking,mature,middle,na,needle-like,odour,orientation,placement,position,prickle,rhizome,shape,smell,spot,staman,stone,structure,symmetry,sympodial,texture,tuber,type,vegetative,xylopodia,zygomorphy	-1.5,-10,0-2-9,0.1-0.5,0.1-0.7,0.1-1,0.15-0.9,0.2-1,0.2-1.5-2,0.3-1.1,0.5,0.5-0.7,1-3,1.6-7,2-foliate,4-10-19,4-celled,basiscopically,bent,berry,bifurcate,bracteate,bright,cm,cordate,crenate,darker,decurrent,densely,developed,eglandular,entire,extremely,flushed,glandular,globose,grayish,green,greenish,half,head,herb,imparipinnate,interrupted,investing,lanceolate,large,leaf,less,like,long,loosely,margin,markedly,midvein,mixed,mm,node,oblique,occasionally,once-branched,pedicel,petiolule,present,proximal,pubescent,purple,rotate,scattered,sessile,shorter,simple,slightly,soft,sparse,spreading,stellate,stem,surrounding,ten,tip,trichome,truncate,uniseriate,usually,velvety,weak-walled,white,wide,yellow	middle,na
383	wfo-0001030342	success	155	91	32	39	116	52	26	6	3-pinnate,accrescent,anther,apex,base,berry,calyx,chartaceous,cm,cordate,cuneate,entire,extra-axillary,filament,fruit,fruiting,glabrous,greenish,leaf,leaflet,margin,membranous,mm,mottled,oblique,often,ovoid-rhomboid,pedicel,petiole,pubescent,slightly,stellate,unbranched,undulate,unit,vine,white,x,yellowish	.2,.5,0.1–0.2,0.3–1.2,0.5–1,0.5–3,0.5–5,0.8–1.5,0.8–4,1-5,1-6.5,1.2–3,1.5,1.5–13,1.5–2,1.5–5,1.5–7.5,10–25,1–1.2,1–1.5,1–2.5,1–3,1–5.5,1–6,1–7,2–,2–2.5,2–4,3,3–12,4–5,4–8,5-merous,6–7,abaxially,abundant,acuminate,acute,adaxially,along,alyx,apar,apical,apiculate,axe,blade,broadly,brown,c.,capitat,ciliat,cylindrical,deltoid,dense,diameter,eaf,eed,elliptical,flattened,flower,glabrou,herbaceous,lanceolate,lateral,lenticular,light,like,lobe,lon,long,lower,m.,minutely,nflorescence,nternode,obtuse,orolla,peduncle,perfec,petiolule,plurifoliat,pointed,proximal,pubescen,rachi,rarely,revolute,rhomboid,rounded,ruit,sand-punctate,scattered,side,slender,smooth,spaced,sparsely,stem,stigma,style,surface,tamen,tem,terrestria,tip,trichome,truncate,truncate-acuminat,tube,vary,vein,wide,wide-diameter,widely,ympodial,–7	1-1.5,1.5-13,2-2.5,appressed,articulation,bract,branching,breeding,cell,colour,connective,corolla,form,growth,hair,heteromorphism,inflated,inflorescence,insertion,interjected,interpetalar,length,marking,mature,modification,na,odour,orientation,paired,pattern,perfect,placement,plurifoliate,pore,position,prickle,pseudostipule,rhizome,scale,shape,spot,staman,stone,structure,symmetry,sympodial,system,texture,tissue,tuber,type,xylopodia	3-pinnate,accrescent,berry,chartaceous,cm,cordate,cuneate,entire,extra-axillary,glabrous,greenish,membranous,mm,mottled,oblique,often,ovoid-rhomboid,pubescent,slightly,stellate,unbranched,undulate,vine,white,x,yellowish	1-1.5,1.5-13,2-2.5,na,perfect,plurifoliate
384	wfo-0001030342	success	151	141	70	89	62	52	65	5	.2,.5,0.5-3,1-1.5,1-3,1-6.5,1.5-13,1.5-2,1.5-5,10-25,2-2.5,2-3,3-12,3-pinnate,4-5,absent,accrescent,acuminate,acute,adaxially,anther,apex,basally,base,blade,brown,calyx,chartaceous,cm,cordate,cuneate,cylindrical,deltoid,diameter,entire,extra-axillary,filament,flower,fruit,fruiting,glabrous,hair,herb,interjected,lanceolate,leaf,leaflet,lenticular,light,lobe,longitudinal,margin,membraceous,mm,node,oblique,oblong,obtuse,opening,pedicel,peduncle,perfect,petiole,petiolule,plurifoliate,pore,pubescent,rachi,rarely,rooting,sagittate,simple,slender,slightly,slit,stellate,stigma,style,terrestrial,tip,truncate,tube,unbranched,undulate,uniseriate,unit,white,x,yellow	-7,0.5-1,0.5-5,0.8-4,1-1.2,1-5,1-5.5,1-6,1-7,1.2-3,1.5-7.5,4-8,5-merou,6-7,abaxially,abundant,ag,along,alyx,apart,apical,apiculate,apparently,articulated,axe,ba,broadly,capitat,ciliat,connivent,directed,distally,eaf,eed,elliptical,equal,geminat,lateral,long,lower,minutely,nflorescence,orolla,proximal,pubescen,revolute,rhomboid,rounded,scattered,side,smooth,spaced,surface,tamen,tem,trailing,truncate-acuminat,vary,vein,wide,widely,ympodial	2-7,age,arrangement,articulation,bract,branching,breeding,capitate,cell,colour,connective,corolla,form,geminate,growth,habit,heteromorphism,inflorescence,insertion,interpetalar,length,marking,modification,na,number,odour,orientation,ovary,paired,pattern,placement,position,prickle,pseudostipule,rhizome,scale,seed,shape,size,spot,staman,stem,stone,structure,symmetry,sympodial,system,texture,tissue,tuber,type,xylopodia	.2,.5,0.5-3,1-1.5,1-3,1-6.5,1.5-13,1.5-2,1.5-5,10-25,2-2.5,2-3,3-12,3-pinnate,4-5,absent,accrescent,acuminate,acute,adaxially,basally,base,brown,chartaceous,cm,cordate,cuneate,cylindrical,deltoid,diameter,entire,extra-axillary,glabrous,hair,herb,lanceolate,lenticular,light,longitudinal,membraceous,mm,node,oblique,oblong,obtuse,opening,perfect,plurifoliate,pubescent,rarely,sagittate,simple,slender,slightly,slit,stellate,terrestrial,tip,truncate,unbranched,undulate,uniseriate,white,x,yellow	2-7,age,capitate,geminate,na
385	wfo-0001030353	success	222	120	70	72	150	48	63	7	.2,0.5-0.9,1/2-2/3,1/6,1/6-1/4-1/2,2-10,3.5-4,5,andromonoecious,anther,apex,articulated,base,berry,blade,calyx,chartaceous,cm,conical,connivent,cuneate,curved,ellipsoid,erect,evenly,filament,flattened,free,fruit,fruiting,green,lateral,leaf,length,less,lobed,long,margin,mature,maturity,mauve,mm,multangulate,pedicel,petiole,poricidal,porrect,portion,prickle,reflexed,sessile,shape,shrub,simple,small,sometimes,stalked,stellate,stem,straight,subentire,tapering,terminal,tip,tree,tube,unbranched,unit,way,weakly,yellow,young	-3,-5,-merous,.1-0.2,.5,.7,0,0-15,0-2,0-6,0.1-0.2,0.1-0.3,0.15-0.3,0.5-1.5,0.8,0.8-1.2,1-2,1-3,1-5,1-6,1-7,1.2-1.8,1.8-2.2,1.8-3,1/,1/3,1/5,10-15,11-16,2-7,2.5-4,2.8-3.7,20-200,3-4,3-5.5,4-4.5,4-5,4-5-6,5-6,6,6-15,6-8,7-10,8-15,abaxial,abaxially,acute,adaxial,almost,alyx,apar,apart,apically,apiculat,apparently,bark,broad-deltate,brown,c.,deltate,densely,development,diameter,discolorous,distal,distance,drying,eaf,eed,elliptic,elongating,equal,extending,flattened-reniform,flower,glabrescent,glabrous,half,hermaphrodite,heterostylous,infructescence,lobe,long-styled,longer,lower,lowermost,midpoint,midvein,moderately,narrow-deltate,nflorescence,older,one,open,orange-brown,orolla,oung,pair,patch,peduncle,pendulous,per,pericarp,plant,plurifoliat,pointed,prickly,primary,ray,red-brown,reddish-green,retaining,rounded,ruit,scar,short-styled,shorter,side,smooth,somewhat,spaced,sparsely,spreading,stalk,staminat,stellate-pubescent,stout,strongly,style,surface,tamen,terete,tertiary,throughout,time,trichome,unarme,unarmed,upper,vary,vein,venation,visible,warty,whit,white-gray,wide,wo,woody,ympodial	/,appressed,articulation,bract,branching,breeding,broad-based,cell,colour,connective,corolla,form,growth,hair,heteromorphism,inflated,inflorescence,insertion,interjected,interpetalar,leaflet,marking,na,none,odour,orientation,paired,pattern,placement,plurifoliate,position,pseudostipule,rhizome,scale,spot,staman,stone,structure,symmetry,sympodial,system,texture,tissue,tuber,type,xylopodia,ye,zygomorphy	.2,0.5-0.9,1/2-2/3,1/6,1/6-1/4-1/2,2-10,3.5-4,5,andromonoecious,articulated,base,berry,blade,chartaceous,cm,conical,connivent,cuneate,curved,ellipsoid,erect,evenly,filament,flattened,free,fruit,green,lateral,leaf,length,less,lobed,long,mature,maturity,mauve,mm,multangulate,poricidal,porrect,portion,prickle,reflexed,sessile,shrub,simple,small,sometimes,stalked,stellate,stem,straight,subentire,tapering,terminal,tip,tree,tube,unbranched,way,weakly,yellow,young	/,broad-based,na,none,plurifoliate,ye,zygomorphy
386	wfo-0001030407	success	182	163	87	108	74	55	81	6	.2,.5,0.7-3.2,1-10,1-2,1.5-5,12-14,12-15,2-5,2-6.7,2-7,3-10.5,3-6.5,3-9,3.5-9.5,30-60,4-5,5,6-7,6.5-18.5,7-8,abaxially,absent,adaxially,anther,apex,base,berry,blade,brownish,cell,chartaceous,ciliate,cm,condition,conical,corolla,densely,diameter,digestion,dorsally,drying,edge,end,enzyme,filament,flat,flower,folded,forked,fresh,fruit,glabrous,green,greenish,hair,herb,homostylous,honeycomb-shaped,interjected,lanceolate,lateral,leaf,leaflet,lengthening,light,like,lobe,long,margin,middle,minute,mm,mottled,obtuse,odd-pinnate,one,ovoid,pedicel,peduncle,pentagonal,petiole,plant,plurifoliate,pore,poricidal,proximal,pubescent,purple,removed,ripe,round,seed,size,slit,stigma,style,symmetrical,terminal,testal,tip,tri-,tube,tuber,unit,wall,whitish,x	1-3,1-4,2-2.5,3-4,5-merou,acumen,acuminate,ag,alyx,apart,apparently,articulated,axe,axillary,bud,capitat,connivent,covering,decreasing,distal,eaf,eed,elliptic-lanceolate,especially,exceeding,geminat,generally,glabrou,gradually,green-white,hair-like,half,larger,living,lower,make,mucilaginous,nflorescence,orolla,ovate,pair,perfect,petiolule,placed,pubescen,ray,ruit,secondary,semierec,seudostipule,spaced,specimen,stamen,ste,stolo,subequal,subsessile,subtending,tall,tamen,tem,thick,thir,throughout,toward,typically,unwinged,usually,vary,wet,white,wide,yellow,ympodial	age,appressed,arrangement,articulation,bract,branching,breeding,calyx,capitate,colour,connective,form,fruiting,growth,height,heteromorphism,inflated,inflorescence,insertion,interpetalar,length,marking,mature,modification,na,number,odour,orientation,ovary,paired,pattern,placement,position,prickle,pseudostipule,pubescence,rhizome,scale,shape,spacing,spot,staman,stem,stolon,stone,structure,symmetry,sympodial,system,texture,third,tissue,type,width,xylopodia	.2,.5,0.7-3.2,1-10,1-2,1.5-5,12-14,12-15,2-5,2-6.7,2-7,3-10.5,3-6.5,3-9,3.5-9.5,30-60,4-5,5,6-7,6.5-18.5,7-8,abaxially,absent,adaxially,berry,brownish,chartaceous,ciliate,cm,condition,conical,densely,digestion,dorsally,drying,end,enzyme,flat,folded,forked,fresh,glabrous,green,greenish,hair,herb,homostylous,honeycomb-shaped,lanceolate,lateral,lengthening,light,like,long,margin,middle,minute,mm,mottled,obtuse,odd-pinnate,one,ovoid,pentagonal,plurifoliate,pore,poricidal,proximal,pubescent,purple,removed,ripe,round,slit,symmetrical,terminal,tip,tri-,wall,whitish,x	age,capitate,na,stem,stolon,third
387	wfo-0001030420	success	159	162	98	111	48	51	94	4	-pubescent,0.5-1,0.5-1-1.5,0.5-4,0.5-8,1-2,1-3,1-4,1-6,1.5-3,1.5-5,10-15-25-30,10-25-35,2-3,2-3-lobed,2-5,2-9,4-7,5-15-20,5-6,5-6-7,7-22,abaxially,absent,acuminate,acute,adaxially,also,apart,apex,basal,base,beyond,calyx,cell,chartaceous,cm,connective,connivent,cordate,dark,deltate,densely,diameter,directed,distally,eglandular,ellipsoidal,elliptic-ovate,elongated,entire,equal,flower,forked,fruit,glabrate,glandular-,glandular-puberulent,hair,lanceolate,leaf,leaving,lobe,lobed,long,margin,mm,moderately,narrowly,nearly,obtuse,often,ovate,pedicel,pedicellar,peduncle,perfect,petiole,pilose,pinnately,pore,puberulent,pubescent,pubescent-pilose,purple,rachi,radiu,rarely,remnant,shorter,shrub,simple,small,sparsely,stamen,stellate,stigma,stone,style,subcoriaceous,thecae,tip,tree,triangular,truncate,unbranched,unknown,unlobed,vein,x,yellow	-4,1-2-6-9,1-7.5,1/2,2-14.5,2-3-7,4-foliat,5-7-19,7/8,aggregate,ape,articulated,axe,blade,color,cylindrical,divided,eaf,eed,eglandular-pilo,eglandular-puberulent,exserted,glabrous,lon,lower,midrib,nflorescence,nther,orolla,presen,puberulent-pubescent,pubescent-pilo,ripe,ruit,sinus,spaced,tal,tem,time,tomento,truncat,tube,ud,unit,vary,wide,yello,ympodial	-9,anther,articulation,bract,branching,breeding,bud,colour,corolla,eglandular-pilose,exsertion,filament,form,growth,height,heteromorphism,inflorescence,insertion,interjected,interpetalar,leaflet,length,lobing,marking,na,odour,orientation,ovary,paired,placement,plant,position,present,prickle,pseudostipule,rhizome,scale,seed,shape,spacing,spot,staman,stem,symmetry,system,texture,theca,tissue,tuber,type,xylopodia	-pubescent,0.5-1,0.5-1-1.5,0.5-4,0.5-8,1-2,1-3,1-4,1-6,1.5-3,1.5-5,10-15-25-30,10-25-35,2-3,2-3-lobed,2-5,2-9,4-7,5-15-20,5-6,5-6-7,7-22,abaxially,absent,acuminate,acute,adaxially,also,apart,apex,basal,base,beyond,chartaceous,cm,connivent,cordate,dark,deltate,densely,directed,distally,eglandular,ellipsoidal,elliptic-ovate,elongated,entire,equal,forked,glabrate,glandular-,glandular-puberulent,hair,lanceolate,leaving,lobe,lobed,long,mm,moderately,narrowly,nearly,obtuse,often,ovate,pedicellar,perfect,pilose,pinnately,puberulent,pubescent,pubescent-pilose,purple,rarely,remnant,shorter,shrub,simple,small,sparsely,stamen,stellate,subcoriaceous,thecae,tip,tree,triangular,truncate,unbranched,unknown,unlobed,vein,x,yellow	-9,eglandular-pilose,na,present
388	wfo-0001030426	success	157	115	56	62	95	53	48	8	1-4,1-4.2,10,4-10,6-8,apex,apical,apically,articulate,base,branched,calyx,cell,cm,connate,corolla,dehiscent,dichasially,distal,filament,generally,glandular,globose,green,green-white,hair-like,half,heart-shaped,herbaceous,interjected,introrse,leaf,leaflet,long,maturing,mm,oblique,odd-pinnate,often,ovoid,pattern,pedicel,perennial,perfect,petiole,pilose,plant,poricidally,proximal,rounded,seed,short,slit,spot,stellate,stripe,throughout,tuber-bearing,typically,unit,white,¼	0.3-7,0.3-8,0.4-0.7,1.5-3,1.5-6.5,1.7-3.2,15-25-30,2,2-3,2.5-4,2.5-6,3-12,3-4,3-6,3-6-foliat,4-6.5,6-11.5,9,abaxially,absen,acumen,acute,adaxially,apiculate,caudate,covering,cyme,decurrent,diameter,dichasial,digestion,diminishing,dorsally,eaf,ebracteate,edge,eed,elliptic-lanceolate,emoval,enzyme,exceeding,flat,flower,folded,forked,globo,gradually,honeycomb,lanceolate,larger,lateral,linear,linear-lanceolate,linear-oblong,living,lobe,lon,lower,make,monochasial,mucilaginous,nflorescence,nther,oblong,obtuse,orolla,pair,peduncle,pinnatifi,plan,rachi,reveal,ruit,second,sessile,seudostipule,size,specimen,stamen,stigma,straight,style,tal,tem,terminal,testal,thick,toward,vary,wall,whit,wide,without,yellow,ympodial	3-6-foliate,absent,anther,appressed,articulation,berry,bract,branching,breeding,colour,connective,ebbrate,form,fruit,fruiting,growth,hair,heteromorphism,inflated,inflorescence,insertion,interpetalar,length,margin,marking,mature,modification,na,odour,orientation,paired,pinnatifid,placement,pore,position,prickle,pseudostipule,rhizome,scale,shape,staman,stone,structure,symmetry,sympodial,system,texture,tissue,tuber,type,xylopodia,ye,zygomorphy	1-4,1-4.2,10,4-10,6-8,apical,apically,articulate,branched,cm,connate,dehiscent,dichasially,distal,generally,glandular,globose,green,green-white,hair-like,half,heart-shaped,herbaceous,introrse,long,maturing,mm,oblique,odd-pinnate,often,ovoid,perennial,perfect,pilose,plant,poricidally,proximal,rounded,short,slit,spot,stellate,stripe,throughout,tuber-bearing,typically,white,¼	3-6-foliate,absent,berry,ebbrate,na,pinnatifid,ye,zygomorphy
389	wfo-0001030430	success	171	166	89	82	89	84	63	26	.2,.5,5,abundant,acute,anther,anthesi,apart,apex,axillary,base,blue,brittle,brown,calyx,capitate,cell,clavate,cm,cylindrical,decurrent,densely,diameter,elliptic,few-seeded,filament,flattened,fleshy,flower,fruit,glabrous,globose,green,hair,leaf,lobe,lobed,long,longitudinal,lower,margin,mm,moderately,oblong,occasionally,opening,ovate,pair,pale,pedicel,peduncle,pentagonal,perennial,perfect,petiole,pitted,pore,present,pubescent,purple,regularly,rounded,shallowly,shaped,shrub,simple,slit,stigma,stone,straight,style,subglabrous,surface,tear-drop,terminal,time,tube,violet,white,wide,woody,x	0.25,0.3,0.4,0.5,0.5–12,0.6,0.6–0.8,0.6–1.0,0.8–3.0,0.8–5.6,0.9–1.0,0–20,1.0–1.2,1.0–1.5,1.0–2.0,1.2–2.0,1.3–8.0,1.4–1.5,1.5–1.7,1.6–1.8,1.8–5.0,12–20,12–30,1–3,1–9,2.0–3.0,2.0–4.2,2–3,3.0–4.5,30–200,3–17,3–24,3–4,3–5,3–8,5.5–12,5–10,5–6,6–10,abaxially,adaxiall,adaxially,ag,apical,appressed,articulated,axe,ba,basal,blade,borne,branched,bud,chartaceous,connivent,convex,dentate,diamete,eaf,eed,equal,erect,especially,geminat,indumentum,lon,m.,multicellular,nflorescence,orolla,poricidal,ruit,serrate,shoot,side,spaced,tal,tamen,tem,tip,toward,unifoliate,uniseriate,unit,vary,yellow,ympodial,–2.7,–40	0-20,0.5-12,0.8-3.0,0.8-5.6,1-3,1.0-1.2,1.0-2.0,1.2-2.0,1.3-8.0,1.4-1.5,1.6-1.8,12-20,12-30,2-3,2.7,3-17,3-4,3-5,3-8,3.0-4.5,30-200,40,5-10,5-6,abaxial,adaxial,age,arrangement,articulation,bract,branching,breeding,broad-based,colour,connective,corolla,form,growth,height,heteromorphism,history,inflorescence,insertion,interjected,interpetalar,leaflet,length,life,marking,mature,modification,na,needle-like,number,odour,orientation,ovary,paired,pattern,placement,plant,position,prickle,pseudostipule,ratio,rhizome,scale,seed,shape,size,smell,spacing,spot,staman,stem,symmetry,system,texture,tissue,trichome,tuber,type,vegetative,xylopodia	.2,.5,5,abundant,acute,anthesi,apart,axillary,base,blue,brittle,brown,capitate,clavate,cm,cylindrical,decurrent,densely,diameter,elliptic,few-seeded,flattened,fleshy,fruit,glabrous,globose,green,lobe,lobed,long,longitudinal,mm,moderately,oblong,occasionally,opening,ovate,pair,pale,pentagonal,perennial,perfect,pitted,present,pubescent,purple,regularly,rounded,shallowly,shaped,shrub,simple,slit,straight,subglabrous,tear-drop,terminal,time,violet,white,wide,woody,x	0-20,0.5-12,0.8-3.0,0.8-5.6,1-3,1.0-1.2,1.0-2.0,1.2-2.0,1.3-8.0,1.4-1.5,1.6-1.8,12-20,12-30,2-3,2.7,3-17,3-4,3-5,3-8,3.0-4.5,30-200,40,5-10,5-6,age,na
390	wfo-0001030441	success	178	112	70	79	99	33	66	4	0.5,0.5-0.75,0.5-3,1-1.5,1-2-celled,1.5-2,3-4,<,anther,apex,articulated,attenuate,base,berry,branched,bright,c.,calyx,cell,cm,corolla,decurrent,ellipsoid,entire,eye,filament,free,fruiting,glabrous,glandular,globose,green,growth,lateral,leaving,lengthening,lobe,lobed,long,making,many,margin,markedly,membranous,minutely,mm,occasionally,onto,open,pedicel,peg,petiole,pore,poricidal,portion,pubescent,red,ripe,short,shrub,simple,slightly,slit,spot,spreading,stellate,terminal,time,tip,trichome,undulate,uniseriate,unit,usually,vine,violet,way,white,woody	+,.5,0.5-1,1,1-1.4,1.2-1.4,10-40,2,2-10,2-3,2-5.5,2.5,30,4-5,5-14,5-6,5-7,5-7.5,5-merou,6-11,>,acuminate,acute,ag,along,alyx,anthesi,apart,ark,brow,capitate,closely,deltate,diameter,distall,eaf,eed,elliptic,exerted,flattened,flexuous,flower,glabrou,glandula,hair,ilament,impressed,irregularly,juicy,lon,lower,midvein,narrowly,new,nflorescence,older,orolla,otherwise,pair,pale,papillat,papillose,peduncle,per,perfect,pericarp,plant,plurifoliat,primary,reflexed,reniform,ridged,ruit,scandent,scar,shiny,shrubby,small,somewhat,spaced,spreadin,stem,stigma,strongly,style,surface,tem,thin,trailing,triangular,tube,ud,upper,vary,vein,wall,wide,yellow,ympodial	age,articulation,branching,colour,form,fruit,heteromorphism,inflorescence,insertion,leaf,length,marking,na,odour,orientation,placement,plurifoliate,position,prickle,pseudostipule,rhizome,shape,staman,stone,structure,symmetry,sympodial,texture,tuber,type,width,xylopodia,zygomorphy	0.5,0.5-0.75,0.5-3,1-1.5,1-2-celled,1.5-2,3-4,<,articulated,attenuate,base,berry,branched,bright,c.,cm,decurrent,ellipsoid,entire,eye,glabrous,glandular,globose,green,lateral,leaving,lengthening,lobe,lobed,long,making,many,markedly,membranous,minutely,mm,occasionally,onto,open,peg,petiole,pore,poricidal,pubescent,red,ripe,short,shrub,simple,slightly,slit,spot,spreading,stellate,terminal,time,tip,trichome,undulate,uniseriate,usually,vine,violet,way,white,woody	age,na,plurifoliate,zygomorphy
391	wfo-0001030444	success	196	172	87	115	81	57	83	4	0-24,0.15-0.8,0.8-2,1,1-10,1-2,1-4,1-5,11-45,2-3,2-8,2.3-3.6,2.4-3.8,3-10,3-5,4-17,4-39,4-7,5.3-9,6.1-12.8,7.1-17.5,9.4-20.1,acumen,acuminate,acute,anther,apex,asymmetric,attenuate,axillary,base,berry,blade,blue,brownish,bud,cell,ciliate,clavate,cm,condition,coriaceous,corolla,dark,deep,diameter,distal,dot,drying,elliptic,filament,flower,forked,fresh,fruit,glabrous,green,greenish,half,herb,high,homostylous,interjected,lanceolate,lateral,leaf,leaflet,light,lilac,lobe,margin,medium,mm,moniliform,mucilaginous,narrow,odd-pinnate,ovate,ovoid,pair,pedicel,peduncle,pentagonal,petiole,plant,plurifoliate,pore,poricidal,purple,ripe,rotate,rough,rounded,seed,size,sometimes,stigma,straight,style,subtending,symmetric,terminal,tip,tissue,touch,tri-,tube,tuber,unit,unwinged,usually,white,whitish,wing,x	1.1-2.7,1.2-1.8,2-6,3.7-6.8,5-merou,abaxiall,abaxially,adaxially,ag,along,alyx,apart,apparently,arranged,articulated,axe,basiscopic,bead,capitat,connivent,covering,decreasing,digestion,dorsally,eaf,edge,eed,enzyme,erec,exceeding,flat,folded,geminat,general,generally,glabrou,green-white,hair-like,hal,honeycomb-shaped,larger,lengthening,like,linear,living,long,lower,make,multiple,necklace,nflorescence,orbicular,orolla,perfect,petiolulate,removed,ruit,sessile,seudostipule,shortly,side,slit,spaced,specimen,stamen,stolon,subequal,tall,tamen,tem,testal,thick,throughout,toward,typically,vary,wall,wet,wide,yellow,ympodial	abaxial,adaxial,appressed,arrangement,articulation,bract,branching,breeding,calyx,capitate,colour,connective,form,fruiting,growth,hair,height,heteromorphism,inflated,inflorescence,insertion,interpetalar,length,marking,mature,modification,na,number,odour,orientation,ovary,paired,pattern,placement,position,presence,prickle,property,pseudostipule,rhizome,roughnes,scale,shape,spacing,spot,staman,stellate,stem,stone,structure,symmetry,sympodial,system,texture,type,xylopodia,ye	0-24,0.15-0.8,0.8-2,1,1-10,1-2,1-4,1-5,11-45,2-3,2-8,2.3-3.6,2.4-3.8,3-10,3-5,4-17,4-39,4-7,5.3-9,6.1-12.8,7.1-17.5,9.4-20.1,acuminate,acute,asymmetric,attenuate,axillary,berry,blue,brownish,bud,ciliate,clavate,cm,condition,coriaceous,dark,deep,distal,dot,drying,elliptic,forked,fresh,glabrous,green,greenish,half,herb,high,homostylous,lanceolate,light,lilac,medium,mm,moniliform,narrow,odd-pinnate,ovate,ovoid,pentagonal,plurifoliate,poricidal,purple,ripe,rotate,rough,rounded,sometimes,straight,subtending,symmetric,terminal,tip,touch,tri-,unwinged,usually,white,whitish,wing,x	capitate,na,stellate,ye
392	wfo-0001030445	success	226	90	38	49	177	41	35	3	0.6-2.2,1.3-2,accrescent,anther,apex,base,berry,black,branched,calyx,cm,corolla,decurrent,drying,entire,filament,fruit,fruiting,globose,green,hair,homostylous,leaf,long,lower,many,margin,mm,oblong,pedicel,petiole,plurifoliate,pore,poricidal,porrect-stellate,pseudoterminal,relatively,shrub,simple,small,stellate,stem,surface,thin,time,tissue,tree,unit,yellowish	.1,.5,/5-2/3,0.1-0.7,0.2,0.2-0.4,0.2-0.5,0.2-0.7,0.3,0.4,0.5,0.6-3.5,0.7,0.8,1,1-1.3,1-7,1.1-4.3,1.3,1.3-1.8,1.5-2.1,1.6-2,1.7-2.4,1.8-3.5,10-14,10-16,14,15-35,2.1-5.2,2.2-2.9,2.2-3.5,2.4-4.7,3-5.4,3.1-5,3.4-5.6,3.5-4.2,4.1-8.7,4.2-10,5-125,5-merou,5.2-7.1,5.9-15,5.9-8.3,6.1-9.1,7.5-16,8.1-10,8.2-18,abaxial,abaxially,acuminate,acute,adaxially,ag,along,alyx,apart,appressed,around,articulated,axillary,bark,blade,blunt-tippe,blunt-tipped,branch,brown,brownish-yellow,bud,bulbous-based,capitate,concentrated,cylindrical,deltoid-reniform,diameter,directed,distally,eaf,earl,edge,eed,elliptic,elliptical,elongated,erect,exserted,ferruginous,ferruginous-granular,ferruginous-tomentose,flower,free,geminate,glabrate,glabrescen,glabrous,greyish-tan,high,inserted,intermediate,lackin,lateral,lengthening,lobe,lobed,lon,longitudinal,m.,main,midrib,midvein,mostly,multangulat,multangulate,nflorescence,oblong-lanceolate,obovate,obscured,obtuse,older,open,orange,orangish-tan,orbicular,orolla,ovate,ovate-lanceolate,peduncle,porrect-stellat,pubescence,pubescent,rachi,ray,reniform,resorption,reticulate-punctate,rounded,ruit,runk,semi-spherical,sessile,side,slightly,slit,somewhat,soon,spaced,sparse,sparsely,splitting,stalk,stamen,stigma,stout,style,subcampanulate,sulcate,suture,tamen,thick,thick-textured,thicknes,thin-,tip,tomentose,tomentum,tube,unarme,vary,vein,vestigial-rayed,way,white,wide,x,yellow,yellowish-tan,ympodial,young	articulation,bract,branching,breeding,broad-based,cell,colour,connective,form,growth,heteromorphism,inflorescence,insertion,interjected,interpetalar,leaflet,length,marking,na,needle-like,odour,orientation,pattern,placement,position,prickle,pseudostipule,rhizome,scale,shape,spot,staman,stone,structure,symmetry,sympodial,system,texture,tuber,type,xylopodia	0.6-2.2,1.3-2,accrescent,base,berry,black,branched,cm,decurrent,drying,entire,globose,green,homostylous,leaf,long,lower,many,mm,oblong,plurifoliate,poricidal,porrect-stellate,pseudoterminal,relatively,shrub,simple,small,stellate,stem,surface,thin,time,tree,yellowish	broad-based,na,needle-like
393	wfo-0001030447	success	276	109	58	64	212	45	51	7	.2,.5,0.5,0.8-3.5,1.5-7,1/4-1/3,2.5-10,accrescent,anther,apex,base,berry,calyx,cell,chartaceous,cm,corolla,cuneate,curved,difoliate,equal,filament,free,fruit,fruiting,gently,globose,lateral,leaf,length,less,lobed,long,lower,margin,mm,moderately,oblique,orange-red,pedicel,perfect,petiole,point,pore,poricidal,prickle,rounded,shallowly,shrub,simple,slender,sparse,stellate,stellate-pubescent,stem,straight,surface,tapering,trichome,unbranched,unit,white,wide,widest	.3,/5,0,0.1,0.1-0.3,0.15-0.3,0.2,0.2-0.4,0.4-0.7,0.4-0.9,0.5-0.65,0.5-10,0.5-3,0.7-1,0.8-1.7,1,1-1.5,1-10,1-2,1-2.5,1-3,1-5,1-6,1.5,1.5-2.5,1.8-2.5,1/3,1/3-1/2,1/3-2/3,2-4,2.2-2.8,2.5-6.5,3,3-4.5,3-5,30-45°,4-8,5,5-15,5-merou,6,6-10,6-16,6-7,6-8,6-9,6.5-9,7-8,8,abaxially,acute,adaxially,age,always,alyx,apar,apart,apical,apically,apparently,armed,articulated,axe,bark,beyond,blade,branche,broad-deltate,c.,characteristically,clavate,covering,cupular,dark,deltate,densely,development,diameter,discolorous,distance,divided,drying,eaf,eed,elongating,erect,exserted,extending,filiform,fine,finely,finger-hair,flat,flattened,flattened-reniform,flower,geminat,glabrescent,glabrous,herbaceous,infructescence,irregula,irregular,lengthening,lobe,long-ovoi,long-styled,longer,longitudinal,mature,maturity,midpoint,midvein,minute,mostly,narrow-deltate,nflorescence,obconical,oblong,obtuse,often,older,one,open,opening,orange,orange-brown,orange-translucent,orolla,oung,outline,ovate,pair,pale,papillo,peduncle,pendulous,per,pericarp,persisting,pit,porrect,portion,primary,pronounced,prostrate,pubescent,purple,rachi,raised,ray,red-brown,reduced,rest,ri,ridge,ridged,ruit,scar,sessile,shallow,shiny,short-styled,shorter,shortly,side,sinus,slit,small,smooth,sometimes,somewhat,spaced,sparsely,spherical,spreading,stalk,stalked,stigma,stout,straw-yellow,stump,style,subsessile,tamen,terete,terminal,tertiary,thick,thin,throughout,time,tip,toward,translucent,tube,ud,unarmed,unequal,usually,variously,vary,vein,venation,visible,weakly,woody,x,yellow,yellow-orange,ympodial,×	articulation,bract,branched,branching,breeding,broad-based,colour,connective,form,geminate,growth,hair,heteromorphism,inflorescence,insertion,interjected,interpetalar,leaflet,marking,na,needle-like,none,odour,orientation,paired,pattern,placement,position,pseudostipule,rhizome,scale,shape,spot,staman,stone,structure,symmetry,sympodial,system,texture,tissue,tuber,type,xylopodia,zygomorphy	.2,.5,0.5,0.8-3.5,1.5-7,1/4-1/3,2.5-10,accrescent,base,berry,chartaceous,cm,cuneate,curved,difoliate,equal,free,gently,globose,lateral,leaf,length,less,lobed,long,lower,mm,moderately,oblique,orange-red,perfect,point,poricidal,prickle,rounded,shallowly,shrub,simple,slender,sparse,stellate,stellate-pubescent,stem,straight,surface,tapering,trichome,unbranched,white,wide,widest	branched,broad-based,geminate,na,needle-like,none,zygomorphy
394	wfo-0001030453	success	127	93	39	53	74	40	36	3	.25,.5,/4,1-1.3,1-1.5,1.5-1.6,1.5-2.5,3-3.5,4-5,9-14,abaxially,acuminate,acute,adaxially,anther,apex,arachnoid,attenuate,base,broadly,calyx,clavate,cm,corolla,cup-shaped,divided,elliptic,filament,floccose,glabrous,leaf,minutely,mm,narrowly,opposite,ovary,pedicel,petiole,pore,reddish,shaped,shiny,shrub,simple,stigma,style,surface,tear-drop,trichome,tube,unit,way,white	0.25-0.5,0.8-1.5,9-12,along,anthesi,arachnoid-pubescent,axi,bark,closely,dark,deflexed,delicate,deltate,dendritic,densely,dia,eaf,edicel,eed,ellipsoid,especially,exserted,fine,flat,free,glabrate,know,known,later,lateral,less,lobe,lon,long,lower,main,margin,middle,midrib,minute,near,nearly,nflorescence,occasionally,older,overlappin,pair,papillat,papillose,planar,poricidal,portion,pubescent,reddish-brow,rounded,ruit,scar,slender,soon,spaced,sparsely,stem,straight,strongly,tall,tip,tub,ud,unifoliat,vein,wide,widest,ympodial,young	abaxial,articulation,bract,branching,cell,colour,diameter,form,fruit,growth,hair,height,heteromorphism,inflorescence,insertion,length,na,odour,orientation,papillate,placement,plant,position,prickle,pseudostipule,rhizome,scale,seed,shape,staman,stone,structure,symmetry,sympodial,texture,tuber,type,unifoliate,width,xylopodia	.25,.5,/4,1-1.3,1-1.5,1.5-1.6,1.5-2.5,3-3.5,4-5,9-14,acuminate,acute,arachnoid,attenuate,base,broadly,clavate,cm,cup-shaped,divided,elliptic,floccose,glabrous,leaf,minutely,mm,narrowly,opposite,reddish,shaped,shiny,shrub,simple,tear-drop,way,white	na,papillate,unifoliate
395	wfo-0001030486	success	141	129	66	84	57	45	62	4	.5,0.8-2.2,1-1.5,1-5,1.1-1.4,1.5-2,10-14.5,2-3,2-5.5,3-3.5,3/4,4-4.5,4-6.5,4.5-5,6-7,acute,anther,anthesi,apex,bark,base,calyx,clavate,closely,cm,completely,conical,corolla,deflexed,dia,difoliate,ellipsoid,elliptic,exserted,filament,fleshy,fruiting,glabrous,globose,green,internodal,later,leaf,lobed,lower,minor,minutely,mm,older,opposite,ovary,overlapping,ovoid-reniform,pale,papillose,pedicel,petiole,pitted,pore,poricidal,scar,shaped,shrub,size,slightly,small,spaced,stem,stigma,style,surface,tapering,tear-drop,tip,treelet,tube,unit,usually,way,white,woody,x,yellow-green,young	1.7-2,1/2,1/4,10-12,3-5,5-8-flowered,abaxially,adaxially,ba,basal,beneath,berry,brown,clustered,dark,deltate,differing,distal,dry,drying,eaf,edicel,eed,erect,f,free,fresh,geminat,inflorescenc,lateral,lobe,lon,long,m.,main,major,margin,material,middle,nflorescence,pair,papillo,planar,portion,reddish,ruit,shin,simple,stout,tall,tan,thickened,tub,ud,vein,widest,ympodial	5-8,broad-based,bud,cell,colour,exsertion,flower,form,fruit,geminate,growth,hair,height,heteromorphism,inflorescence,length,marking,mature,modification,na,needle-like,number,orientation,placement,plant,position,prickle,pseudostipule,rhizome,seed,shape,shiny,spacing,spot,staman,stone,structure,symmetry,sympodial,texture,trichome,tuber,type,xylopodia,zygomorphy	.5,0.8-2.2,1-1.5,1-5,1.1-1.4,1.5-2,10-14.5,2-3,2-5.5,3-3.5,3/4,4-4.5,4-6.5,4.5-5,6-7,acute,base,calyx,clavate,closely,cm,completely,conical,deflexed,dia,difoliate,ellipsoid,elliptic,exserted,fleshy,glabrous,globose,green,internodal,later,leaf,lobed,minutely,mm,opposite,overlapping,ovoid-reniform,pale,papillose,pitted,poricidal,shaped,shrub,slightly,small,spaced,tapering,tear-drop,tip,treelet,tube,usually,way,white,woody,x,yellow-green	5-8,geminate,na,shiny
396	wfo-0001030489	success	196	122	77	80	116	42	71	6	0.75-0.9,1.6-2.1,1/5-1/2,2.1-2.9,3-8,abaxially,abruptly,adaxially,anther,apex,apical-lateral,appressed,appressed-pubescent,articulated,attenuate,axillary,base,becoming,berry,blade,blunt-tipped,branched,calyx,chartaceous,cm,continued,corolla,dichotomously,due,echinoid,entire,filament,fleshy,fruit,glabrate,greenish,growth,hair,introrse,large,lateral,leaf,length,longitudinal,margin,minute,minutely,mm,mostly,multangulate,narrowly,oblong,obtuse,pedicel,petiole,plurifoliate,pore,porrect-stellate,probably,pubescent,pulverulent,ripe,short,short-stalked,shrub,simple,slender,slit,small,somewhat,sparse,stellate-rotate,stem,subglobose,tree,turn,unit,white,x,yellow	-6.5,.5-2.8,.5-3,.75-5.25,0.25-0.4,0.5-3,0.6-0.9,0.9-1.1,1-1.3,1-3,1-3.75,1.1-1.3,1.2-1.5,1.2-1.6,1.7-2,1.75-2,1.9-2.6,1/3-1/2,100,12-24,3-6,4-8,4.5-9,5,5-6,6-8,7-15,absen,acuminate,acute,adaxiall,ag,anthesi,apart,apparently,axe,ba,bark,branch,broadly,brown,bud,cinereous,closely,conical,cylindrical,dehiscing,deltoid,densely,diameter,eaf,echinoi,eed,elliptic,elongate,flower,free,glabrous,globose,high,honeycombed,inserted,lobe,lobed,long,long-acuminate,long-exserted,lower,main,midvein,nflorescence,older,orolla,ovate,ovate-lanceolate,pale,peduncle,perfect,pseudo-terminal,puberulent,pulverulen,rachi,reniform,reticulate-punctate,ruit,runk,sessile,several,side,smooth,spaced,sparingly,stellate-pubescent,stigma,style,subcampanulate,subcapitat,suborbicular,tamen,terete,testa,thick,time,tomentose,toward,tube,unarme,unarmed,usually,vary,vein,way,wide,yellowish,ympodial,young	absent,age,articulation,bract,branching,cell,colour,connective,form,fruiting,heteromorphism,inflorescence,insertion,interjected,interpetalar,leaflet,marking,na,odour,orientation,paired,placement,position,prickle,pseud-terminal,pseudostipule,rhizome,scale,shape,spot,staman,stellate,stone,structure,symmetry,sympodial,texture,tissue,tuber,type,xylopodia,zygomorphy	0.75-0.9,1.6-2.1,1/5-1/2,2.1-2.9,3-8,abaxially,abruptly,adaxially,apex,apical-lateral,appressed,appressed-pubescent,articulated,attenuate,axillary,base,becoming,berry,blade,blunt-tipped,branched,chartaceous,cm,continued,dichotomously,due,echinoid,entire,fleshy,glabrate,greenish,growth,hair,introrse,large,lateral,leaf,length,longitudinal,minute,minutely,mm,mostly,multangulate,narrowly,oblong,obtuse,plurifoliate,pore,porrect-stellate,probably,pubescent,pulverulent,ripe,short,short-stalked,shrub,simple,slender,slit,small,somewhat,sparse,stellate-rotate,stem,subglobose,tree,turn,white,x,yellow	absent,age,na,pseud-terminal,stellate,zygomorphy
397	wfo-0001030509	success	218	106	52	59	159	47	46	6	2-2.5,2/3-3/4,4.5-8,andromonoecious,anther,apex,articulated,base,berry,calyx,chartaceous,connivent,cordate,cream,cuneate,dark,difoliate,entire,erect,filament,fruit,fruiting,glabrous,green,herb,inflated,lateral,leaf,length,lobed,margin,marking,maturity,mauve,mm,orange,pale,pedicel,perpendicular,petiole,poricidal,prickle,purple,rounded,shrub,simple,sometimes,spherical,stellate,stem,tapering,terminal,tip,unbranched,unit,way,weakly,yellow,young	-6,/3,0-0.3,0-10,0-100,0-15,0-2,0-3,0-5,0.1,0.1-0.2,0.1-0.25,0.1-0.3,0.2,0.3-2.5,0.5-1.5,0.6-1,0.8-1.2,0.8-4,1-1.5,1-2,1-3,1-4,1-6,1.3-2,1.5-2,1.7-2,1/,1/3-2/3,1/4,2-3,2-4.2,2-4.5,2-6,2.8-3,3-10,3-4,4.5-10,4.5-12,5-10,5-merous,7-15,7-9,8-16,abaxially,alyx,apar,apart,apical,apically,apparently,bark,becoming,blade,broad-deltate,brow,cm,curved,densely,diameter,discolorous,distal,distance,drying,eaf,eed,elongating,equal,extending,eye,flattened-reniform,flower,free,geminat,glabrescent,gland,globular,gray,half,herbaceous,hermaphrodite,heterostylous,infructescence,lobe,long,long-acuminat,long-styled,longer,lower,lowermost,mature,midpoint,midvein,moderately,naked,narrow-deltate,narrow-oblong,nflorescence,obtuse,occasional,occasionally,often,older,one,open,orange-brown,orolla,oung,ovate,pair,peduncle,pendulous,per,pericarp,plant,porrect,portion,prickly,primary,ray,reduced,ruit,scar,short-styled,shorte,shorter,side,slender,smooth,spaced,sparsely,spreading,stalk,stalked,staminat,stellate-pubescent,straight,style,subsessile,surface,tamen,terete,tertiary,time,trichome,tube,unarme,unarmed,upper,usually,variously,vary,vein,venation,visible,wide,woody,yellow-green,ympodial	appressed,articulation,bract,branching,breeding,broad-based,cell,colour,connective,corolla,form,geminate,growth,hair,heteromorphism,inflorescence,insertion,interjected,interpetalar,leaflet,modification,na,needle-like,odour,orientation,paired,pattern,placement,position,present,pseudostipule,rhizome,scale,shape,spot,staman,stone,structure,symmetry,sympodial,system,texture,tissue,tuber,type,xylopodia,zygomorphy	2-2.5,2/3-3/4,4.5-8,andromonoecious,articulated,base,berry,chartaceous,connivent,cordate,cream,cuneate,dark,difoliate,entire,erect,glabrous,green,herb,inflated,lateral,lobed,marking,maturity,mauve,mm,orange,pale,perpendicular,poricidal,purple,rounded,shrub,simple,sometimes,spherical,stellate,stem,tapering,terminal,tip,unbranched,way,weakly,yellow,young	broad-based,geminate,na,needle-like,present,zygomorphy
398	wfo-0001030516	success	172	141	69	83	89	58	62	7	0.4-1.5,1-4,1-7,1.1-4.1,1.8-2.4,2-12,2-3,3-8,4-22,4-6,4-7,4.2-10.7,6-15,9-22,9-32,acute,apex,apically,base,branched,calyx,cell,cm,cordate,corolla,cuneate,cyme,dehiscent,diameter,dichasial,dichasially,diminished,distal,dorsally,edge,filament,flat,flower,folded,gland,globose,gradually,green,hair,herbaceous,interjected,lateral,leaf,leaflet,light,lobe,long,long-attenuate,mm,monochasial,oblique,odd-pinnate,pattern,pedicel,peduncle,pentagonal,perennial,perfect,petiole,pilose,plant,poricidally,proximal,puberulent,pubescent,rotate,short-stalked,size,slightly,spreading,terminal,toward,triangular,tuber-bearing,type,unit,wide,¼	1-2.5,1.1-3.5,1.5-2,1.7,2-2.,2-4,3-6,3-6-foliat,3-9.8,4-4,8-9,abaxially,acumen,acuminate,adaxially,apical,articulate,connate,covered,covering,darker,decurrent,densely,digestion,eaf,ebracteate,eed,elliptical,emoval,enzyme,exceeding,first,forked,generally,globo,green-white,hair-like,half,honeycomb,introrse,less,living,lon,longer,lower,lunat,make,maturing,mucilaginous,nflorescence,nther,often,orolla,outline,ovate,ovoid,pair,plan,rarely,reveal,ruit,second,seed,sessile,seudostipule,short,short-petiolate,slit,sometimes,specimen,stamen,stigma,straight,stripe,style,tal,tem,testal,thick,throughout,time,triangulat,typically,vary,wall,whit,yellow,ympodial,’	2-21,3-6-foliate,anther,arrangement,articulation,bract,branching,breeding,colour,connective,direction,ebbrate,fork,form,fruit,fruiting,growth,height,heteromorphism,inflorescence,insertion,interpetalar,length,lunate,margin,marking,modification,na,number,odour,orientation,paired,perfection,placement,pore,position,presence,prickle,pseudostipule,rhizome,scale,shape,spot,staman,stem,stone,structure,symmetry,sympodial,system,texture,tissue,trichome,tuber,white,width,xylopodia,zygomorphy	0.4-1.5,1-4,1-7,1.1-4.1,1.8-2.4,2-12,2-3,3-8,4-22,4-6,4-7,4.2-10.7,6-15,9-22,9-32,acute,apically,base,branched,cm,cordate,cuneate,cyme,dehiscent,dichasial,dichasially,diminished,distal,dorsally,flat,folded,gland,globose,gradually,green,herbaceous,leaf,light,long,long-attenuate,mm,monochasial,oblique,odd-pinnate,pentagonal,perennial,perfect,pilose,poricidally,proximal,puberulent,pubescent,rotate,short-stalked,slightly,spreading,toward,triangular,tuber-bearing,type,wide,¼	2-21,3-6-foliate,ebbrate,lunate,na,white,zygomorphy
399	wfo-0001030551	success	162	164	89	98	64	66	81	8	0-2,0.5-1,0.6-1.5,1-10,1-2,1-2.5,1-3.5,1-4,1-5,1.5-2.5,10-20,2,20-25-30,3-12,4-5,5-6,abaxially,abruptly,acuminate,acute,adaxially,adpressed,also,apart,apex,basal,base,blue,broad,calyx,campanulate,cell,chartaceous,clavate,cm,concave,connective,cordate,densely,dia,diameter,dilated,distally,ellipsoidal,entire,fading,flower,fruit,glandular-puberulent,globose,hair,lanceolate,leaving,lobe,long,lower,margin,mm,moderately,narrow,narrowed,oblong-fusiform,obtuse,often,ovate,ovate-elliptic,ovoid,pedicel,pedicellar,peduncle,petiole,pilose,pore,puberulent,puberulent-pubescent,pubescent-pilose,rachi,radiu,remnant,round,shrub,simple,small,sparsely,stellate,stigma,stone,style,subcoriaceous,tip,triangular-elliptic,truncate,unbranched,unit,unknown,violet,x,yellowish	-5,1,1-2-6-12,1.5-2-3,1.5-2.5-5,13.,2.5-4,3-4-7,3-5,3-8,4-10-40,4-5-6,4-foliat,5-17,9-20,absent,aggregate,ape,articulated,axe,beyond,bilobe,blade,color,directed,eaf,ed,equal,et,exceeding,exserted,fleshy,glabrous,laterally,lon,martinelli,narrowly,nflorescence,nther,orolla,papillose,perfect,puberulen,pubescent-pilo,ripe,ruit,seen,shorter,slightly,spaced,stamen,tal,tem,thecae,time,tomento,triangular,tube,ud,unknow,vary,wide,widening,ympodial	-12,1-6,10-40,3-7,4-6,4-foliate,anther,articulation,bilobed,bract,branching,breeding,broad-based,bud,colour,corolla,filament,form,growth,height,heteromorphism,inflorescence,insertion,interjected,interpetalar,leaf,leaflet,length,marking,mature,modification,na,needle-like,odour,orientation,ovary,paired,pattern,placement,plant,position,prickle,pseudostipule,rhizome,scale,seed,shape,smell,spacing,spot,staman,stem,structure,surface,symmetry,sympodial,system,texture,theca,tissue,trichome,tuber,type,vegetative,xylopodia,zygomorphy	0-2,0.5-1,0.6-1.5,1-10,1-2,1-2.5,1-3.5,1-4,1-5,1.5-2.5,10-20,2,20-25-30,3-12,4-5,5-6,abaxially,abruptly,acuminate,acute,adaxially,adpressed,also,apart,apex,basal,base,blue,broad,campanulate,chartaceous,clavate,cm,concave,cordate,densely,dia,dilated,distally,ellipsoidal,entire,fading,fruit,glandular-puberulent,globose,lanceolate,leaving,lobe,long,mm,moderately,narrow,narrowed,oblong-fusiform,obtuse,often,ovate,ovate-elliptic,ovoid,pedicellar,pilose,puberulent,puberulent-pubescent,pubescent-pilose,remnant,round,shrub,simple,small,sparsely,stellate,style,subcoriaceous,tip,triangular-elliptic,truncate,unbranched,unknown,violet,x,yellowish	-12,1-6,10-40,3-7,4-6,4-foliate,bilobed,na
400	wfo-0001030570	success	170	133	79	85	85	48	74	5	0.5-1,1,1-1.5,1-2,1-3,1-8,1.5,2-7-lobed,2-8,3-5,3.5-5,4-7,abaxially,absent,adaxially,apex,articulated,basal,base,calyx,campanulate,cell,cm,connective,connivent,cordate,directed,distally,eglandular,ellipsoidal,elliptic-oblong,exceeding,flattened,forked,fruit,glabrous,glandular-puberulent,globose,green,hair,lanceolate,leaf,leaving,lobe,long,margin,mm,narrowly,near,occasionally,ovate,pedicel,pedicellar,petiole,pilose,pinnately,pore,pubescent,punctate,purplish,rarely,remnant,rounded,rugose,shorter,simple,slightly,sometimes,sparsely,stellate,stone,subcoriaceous,submarginally,thecae,tree,triangular,truncate,unbranched,unit,unknown,unlobed,vein,white,x,yellow	.3-0.5-1,0-1-3,0.3-0.5,0.5-2-3,1-3-6,1-4,1-5,1.5-2.5,1/2,10-25,15-35,2-2.5,2-3,2-4,2-5,2-7,2.5-22,20-30,3-10,3-6,4-25,4-5,4-foliat,4/5,5-10-17,8-15-20,acuminate,acute,aggregate,apart,ape,apiculate,axe,beyond,blade,color,cylindrical,diameter,dilated,divided,eaf,eed,entire,exserted,fleshy,flower,glabrat,lobed,lon,lower,midrib,nflorescence,nther,obtuse,often,orolla,ovoid,peduncle,perfect,pilo,presen,purpl,rachi,radiu,ripe,ruit,sinus,small,somewhat,spaced,stamen,stigma,style,tal,tem,time,tip,tomento,truncat,tube,ud,unequal,vary,wide,ympodial	4-foliate,anther,articulation,bract,branching,colour,corolla,filament,form,fruiting,glabrate,growth,height,heteromorphism,inflorescence,insertion,interjected,interpetalar,leaflet,length,marking,modification,na,odour,orientation,placement,plant,position,present,prickle,pseudostipule,purple,rhizome,scale,seed,shape,size,spot,staman,stem,structure,symmetry,sympodial,texture,tissue,tuber,type,xylopodia	0.5-1,1,1-1.5,1-2,1-3,1-8,1.5,2-7-lobed,2-8,3-5,3.5-5,4-7,abaxially,absent,adaxially,apex,articulated,basal,base,campanulate,cm,connivent,cordate,directed,distally,eglandular,ellipsoidal,elliptic-oblong,exceeding,flattened,forked,glabrous,glandular-puberulent,globose,green,hair,lanceolate,leaving,lobe,long,mm,narrowly,near,occasionally,ovate,pedicellar,pilose,pinnately,pubescent,punctate,purplish,rarely,remnant,rounded,rugose,shorter,simple,slightly,sometimes,sparsely,stellate,subcoriaceous,submarginally,thecae,tree,triangular,truncate,unbranched,unknown,unlobed,vein,white,x,yellow	4-foliate,glabrate,na,present,purple
401	wfo-0001030581	success	187	146	109	112	75	34	89	20	.5,1,1-4-celled,2,9,abaxial,abaxially,acute,adaxial,adaxially,aggregate,along,angle,angled,anther,anthesi,apex,appressed,articulated,basal,base,berry,black,calyx,cell,central,clustered,cm,corolla,decurrent,densely,denser,diameter,ellipsoid,elliptic,entire,filament,flattened-reniform,flower,free,fruit,fruiting,globose,green,growth,herb,inflorescence,intermodal,lacking,later,lateral,leaf,less,like,lobe,long,margin,markedly,maturity,minute,minutely,mm,near,new,occasionally,often,once-branched,outline,ovate,pedicel,peduncle,pentagonal,per,petiole,pitted,plant,portion,pubescent,purplish,rachi,reflexed,ridge,ripe,scar,shallow,shiny,shorter,simple,somewhat,sparsely,spreading,stellate,stem,stone,strongly,surface,tangled,terete,testal,third,translucent,trichome,tube,turning,uniseriate,upper,usually,vein,white,wide,yellow,yellowish	.3,0.2–0.8,0.4–0.6,0.4–1.6,0.5,0.5–0.7,0.5–2.5,0.6–0.7,0.7–0.8,0.9–1,1.2–1.5,1.8–8,1–2,1–2-celled,1–2.5,1–4-celled,20–50,2–3-celled,35–45,3–4,3–5,4.5–12,4–7,4–9,5-merous,5–6,5–8,apar,becoming,beyond,branched,bright,capitate,cone,conical,difoliate,drop,eaf,eed,exserted,florescence,geminat,glabrous,halfway,individual,leave,live,lobed,lon,lower,narrowly,ovary,pair,papillate,perfect,primary,reflexe,remaining,rounded,ruit,slightly,spaced,sprawlin,stigma,straight,style,tall,tem,ud,unit,winged,woody,ympodial,–15,–5	0.2-0.8,0.3,0.4-0.6,0.4-1.6,0.5-2.5,0.6-0.7,0.7-0.8,0.9-1,1-2.5,1.2-1.5,1.8-8,15,20-50,3-5,35-45,4-7,4-9,4.5-12,5,apart,articulation,branching,colour,form,hair,height,length,number,position,seed,shape,spacing,type,width	.5,1,1-4-celled,2,9,abaxially,acute,adaxially,aggregate,along,angle,angled,anthesi,appressed,articulated,basal,base,berry,black,cell,central,clustered,cm,decurrent,densely,denser,ellipsoid,elliptic,entire,flattened-reniform,globose,green,herb,intermodal,lacking,later,lateral,leaf,less,like,lobe,long,markedly,maturity,minute,minutely,mm,near,occasionally,often,once-branched,outline,ovate,pentagonal,petiole,pitted,portion,pubescent,purplish,reflexed,ridge,ripe,shallow,shiny,shorter,simple,somewhat,sparsely,spreading,stellate,stem,stone,strongly,surface,tangled,terete,third,translucent,trichome,tube,turning,uniseriate,upper,usually,vein,white,wide,yellow,yellowish	0.2-0.8,0.3,0.4-0.6,0.4-1.6,0.5-2.5,0.6-0.7,0.7-0.8,0.9-1,1-2.5,1.2-1.5,1.8-8,15,20-50,3-5,35-45,4-7,4-9,4.5-12,5,apart
402	wfo-0001030583	success	166	113	49	63	103	50	47	2	0.2-1,0.5-1,1-1.5,1/2,3-4,3/4,abaxially,acute,adaxially,along,anther,apex,base,berry,calyx,cell,cm,corolla,deep,dendritic,densely,difoliate,elliptic,enlarged,filament,form,fruit,fruiting,glabrous,globose,green,immature,leaf,lobed,long,lower,margin,midvein,mm,narrowly,occasionally,opposite,orange-red,pedicel,petiole,pore,poricidal,pubescent,ripe,shaped,shrub,simple,stem,surface,tear-drop,tip,trichome,uniseriate,unit,way,white,x,yellow	.2,.5,0.1-0.5,0.3-1,0.4-2.7,0.7-4.5,0.8-1,0.9-3.5,1,1-2,1-8,1.5-4,2.5,2.5-3,2.5-9,4-6,5-6,5-7,6-7,abaxial,anthesi,ba,bark,brow,closely,conical,corky,crisped,cultivar,cultivated,dark,deflexed,dia,differing,dry,eaf,edicel,eed,ellipsoid,erect,especially,flattened-reniform,flower,free,frui,geminat,golden,included,incrassate,irregular,lateral,leave,like,live,lobe,lon,long-rectangular,long-triangular,main,major,minor,minutely,nflorescence,often,older,outline,ovary,overlapping,pair,pale,papery,papillo,papillose,pericarp,pitted,planar,plant,portion,prostrate,rest,rounded,ruit,scar,size,small,small-capitate,soon,spaced,spathulate,specimen,stigma,stout,style,tall,tan,testal,thin,tube,ud,vein,woody,ympodial,young	appressed,articulation,bract,branching,breeding,broad-based,colour,connective,geminate,growth,hair,heteromorphism,inflated,inflorescence,insertion,interjected,interpetalar,leaflet,length,marking,mature,modification,na,needle-like,odour,orientation,paired,pattern,placement,position,prickle,pseudostipule,rhizome,scale,shape,smell,spot,staman,stone,structure,symmetry,sympodial,system,texture,tissue,tuber,type,vegetative,xylopodia,zygomorphy	0.2-1,0.5-1,1-1.5,1/2,3-4,3/4,abaxially,acute,adaxially,along,base,berry,cm,deep,dendritic,densely,difoliate,elliptic,enlarged,fruit,glabrous,globose,green,immature,leaf,lobed,long,midvein,mm,narrowly,occasionally,opposite,orange-red,poricidal,pubescent,ripe,shaped,shrub,simple,tear-drop,tip,trichome,uniseriate,way,white,x,yellow	geminate,na
403	wfo-0001030605	success	144	177	99	113	31	64	93	6	.4,.5,0.1,0.3-0.5,1-4,1/3-1/2,12-19-flowered,2,2-3,2.5,7,abaxially,acute,adaxially,almost,along,anther,anthesi,apart,apex,apical,area,attenuate,base,beginning,berry,branch,branched,brown,calyx,cinereous,cm,commonly,conical,coriaceous,corolla,covered,cylindrical,dark,dendritic-echinoid,densely,dia,difoliate,dry,ellipsoid,entire,exerted,filament,fruiting,glabrate,glabrous,globose,gold,green,growth,inflorescence,internodal,leaf,less,light,lobed,long,lower,margin,material,minutely,mm,nearly,new,obovate,obtuse,occasionally,olive,opposite,ovary,overlapping,ovoid-reniform,pedicel,peduncle,petiole,pitted,pore,poricidal,pubescent,rarely,revolute,rounded,scar,shaped,shiny,shrub,simple,slender,slightly,smooth,soon,sparsely,stigma,style,surface,tear-drop,thickened,tinged,tip,trichome,tube,unifoliate,unit,vein,way,white,woody,x	1,1.5-2,1.5-5.5,1.7,5-12.5,ape,beneath,deflexed,drying,eaf,edicel,eed,free,geminat,inflorescenc,lobe,midrib,nflorescence,otherwise,ovate,papillate,papillosefruit,portion,reflexed,scattered,somewhat,sparesly,tub,ud,yellow,ympodial	appressed,arrangement,articulation,bract,branching,breeding,broad-based,bud,cell,colour,connective,density,diameter,distance,exertion,flower,form,fruit,geminate,hair,heteromorphism,inflated,insertion,interjected,interpetalar,leaflet,length,marking,mature,modification,na,needle-like,number,odour,orientation,papillose,pattern,placement,position,prickle,pseudostipule,rhizome,scale,seed,shape,size,smell,spot,staman,stellate,stem,stone,structure,symmetry,sympodial,system,texture,tissue,tuber,type,vegetative,xylopodia,ye,zygomorphy	.4,.5,0.1,0.3-0.5,1-4,1/3-1/2,12-19-flowered,2,2-3,2.5,7,abaxially,acute,adaxially,almost,along,apart,apex,area,attenuate,base,beginning,berry,branched,brown,calyx,cinereous,cm,commonly,conical,coriaceous,covered,cylindrical,dark,dendritic-echinoid,densely,dia,difoliate,dry,ellipsoid,entire,exerted,glabrate,glabrous,globose,gold,green,inflorescence,internodal,leaf,less,light,lobed,long,material,minutely,mm,nearly,obovate,obtuse,occasionally,olive,opposite,overlapping,ovoid-reniform,pitted,pore,poricidal,pubescent,rarely,revolute,rounded,shaped,shiny,shrub,simple,slender,slightly,smooth,soon,sparsely,style,tear-drop,thickened,tinged,tip,trichome,tube,unifoliate,vein,way,white,x	geminate,na,papillose,stellate,ye,zygomorphy
404	wfo-0001030624	success	170	80	43	50	120	30	40	3	.5,0.5,0.5-1,1.5-2,2-3,3-3.5,anther,anthesi,apex,attenuate,base,berry,cell,cm,corolla,difoliate,dimorphic,elliptic,falcate,filament,furcate,glabrous,globose,green,large,leaf,lobed,long,major,margin,minor,mm,narrowly,nearly,occasionally,opposite,pedicel,petiole,planar,pore,poricidal,round,short,shrub,simple,small,tree,unit,white,x	.25,0.5-1.5,0.9-1,1-3,1.2-1.8,1.2-2,2,2-10,2.5-5.5,25-40-flowered,3,3.5-4,4.5-8,6-13,7-9,acute,apart,apiculate,appearing,axil,ba,bark,beginning,branch,caly,calyx,clavate,decurrent,deflexed,dia,differing,distal,dry,eaf,edicel,eed,ellipsoid,end,erect,except,expanded,exserted,extreme,flattened-reniform,free,fruiting,geminat,glabrate,glandular,greyish,hyaline,incrassate,inflorescenc,later,lateral,like,lobe,lon,longitudinally,lower,main,material,middle,midrib,minutely,near,nflorescence,older,one,outer,ovary,pair,pale,papillose,pitted,portion,prominent,puberulent,raised,remaining,rugo,ruit,scar,shining,size,slender,slightly,somewhat,soon,spaced,square,stem,stigma,straight,style,surface,tall,tapering,thickened,three,ti,tip,trichome,trunk,tube,tuft,two,ud,unevenly,uniseriate,vein,wall,widest,woody,yellow,yellowish,yellowish-green,yellowish-grey,ympodial,young	articulation,branching,colour,form,fruit,geminate,growth,heteromorphism,inflorescence,insertion,length,na,odour,orientation,placement,position,prickle,pseudostipule,rhizome,shape,staman,stone,structure,symmetry,sympodial,texture,tuber,type,xylopodia,zygomorphy	.5,0.5,0.5-1,1.5-2,2-3,3-3.5,anthesi,attenuate,base,berry,cm,difoliate,dimorphic,elliptic,falcate,furcate,glabrous,globose,green,large,leaf,lobed,long,major,minor,mm,narrowly,nearly,occasionally,opposite,planar,poricidal,round,short,shrub,simple,small,tree,white,x	geminate,na,zygomorphy
405	wfo-0001030638	success	177	147	98	118	59	29	94	4	0.1,0.5-0.7,0.5-1,0.5-1.5,0.5-2,0.7-1.5,1-1.2,1-1.5,1-2,1.5-2,1.6-2.2,2-5,2.5-4,3-10,3-13,4-6,8,8-11,8-9,acute,anther,anthesi,apex,apically,bark,base,berry,branched,broadly,bud,calyx,closely,cm,conspicuously,corky,corolla,cup-shaped,deltoid,densely,dia,difoliate,elliptic,erect,exfoliating,filament,flattened,fleshy,fruit,fruiting,geminate,glabrate,glabrous,glandular,globose,green,inflorescence,large,later,lateral,leaf,less,like,lobe,lobed,main,minor,minutely,mm,nearly,obovate,occasionally,older,open,opposite,ovary,overlapping,pair,pale,papillose,pedicel,persistent,petiole,poricidal,rather,red,red-glandular,roundish,rugose,scar,seed,shape,shaped,shrub,simple,size,spaced,stem,stigma,style,surface,tear-drop,terminal,thick,thickening,tip,transversely,tree,trichome,tube,uniseriate,unit,usually,vein,wall,white,woody,x,young	0.5,1.4-1.7,2-3,2-7-flowered,along,appear,appearing,axi,axil,ba,beginning,beneath,blade,cucullate,deflexed,differing,dry,eaf,eed,entire,extending,free,geminat,gre,impressed,irregular,known,lamina,lon,long,lower,major,margin,material,middle,near,nflorescence,often,one,ovoi,paler,papillae,papillo,planar,pore,portion,present,prominent,reddish,rest,ruit,soon,speciman,straight,tall,tapering,thickened,widest,ympodial	appressed,branching,colour,diameter,flower,form,glandularity,grey,growth,hair,height,inflated,length,marking,mature,modification,na,ovoid,persistence,plant,position,spacing,spot,structure,symmetry,sympodial,texture,type,zygomorphy	0.1,0.5-0.7,0.5-1,0.5-1.5,0.5-2,0.7-1.5,1-1.2,1-1.5,1-2,1.5-2,1.6-2.2,2-5,2.5-4,3-10,3-13,4-6,8,8-11,8-9,acute,anthesi,apically,base,berry,branched,broadly,closely,cm,conspicuously,corky,cup-shaped,deltoid,densely,dia,difoliate,elliptic,erect,exfoliating,flattened,fleshy,fruit,geminate,glabrate,glabrous,glandular,globose,green,large,later,leaf,less,like,lobed,minutely,mm,nearly,obovate,occasionally,older,open,opposite,overlapping,pair,pale,papillose,persistent,poricidal,rather,red,red-glandular,roundish,rugose,shaped,shrub,simple,spaced,stem,style,surface,tear-drop,terminal,thick,thickening,tip,transversely,tree,trichome,uniseriate,usually,wall,white,woody,x,young	grey,na,ovoid,zygomorphy
406	wfo-0001030661	success	180	124	79	98	82	26	76	3	.5,0,0.5-0.6,0.5-0.75,0.5-2,1-1.5,1.5-2,1.5-7,4-15,5-10,acute,anther,apex,articulated,attenuate,base,berry,branch,branched,brown,calyx,cell,clustered,cm,connivent,corolla,densely,diameter,ellipsoid,elliptic,entire,filament,flattened,flower,fruiting,glabrous,globose,group,growth,inflorescence,insertion,lateral,leaf,lengthening,lobed,loosely,lower,many,margin,mature,membranous,minutely,mm,narrowly,occasionally,pale,pedicel,peduncle,per,perfect,petiole,pitted,platform,pore,poricidal,pubescent,rectangular,red,reddish,reniform,scar,shrub,simple,sleeve,slender,slit,small,sparsely,stellate,stem,surface,terminal,testal,time,tinged,tip,tree,trichome,uniseriate,upper,usually,violet,way,white,x,yellowish,½,¾	.2,0.7-0.8,1-.,1-1.2,1-1.2-7,1-1.3,1-1.4,12-16-24,2-2.5,2-3-20,3-3.5,3-4,4-6,5-5.5,5-merou,50-100+,ag,along,alyx,anthesi,ark,brow,capitate,conical,dar,deltate,denser,drying,eaf,eed,em,erec,erect,exserted,extending,free,glabrescent,glabrou,ilament,lamina,lobe,lon,long,midrib,minute,near,never,new,nflorescence,nodding,older,onto,orolla,otherwise,pair,papillo,pericarp,planar,plurifoliat,point,portion,primary,ruit,scattered,shiny,slightly,spreading,stigma,strongly,style,tangled,thin,tube,twinin,ud,unit,vary,vein,winged,woody,yellow,ympodial	1-5,age,appressed,articulation,bark,branching,colour,connective,form,fruit,hair,height,inflated,length,marking,modification,na,number,plant,position,seed,shape,spot,symmetry,texture,type	.5,0,0.5-0.6,0.5-0.75,0.5-2,1-1.5,1.5-2,1.5-7,4-15,5-10,acute,apex,articulated,attenuate,base,berry,branch,branched,brown,clustered,cm,connivent,densely,ellipsoid,elliptic,entire,flattened,glabrous,globose,group,inflorescence,lateral,lengthening,lobed,loosely,many,mature,membranous,minutely,mm,narrowly,occasionally,pale,perfect,pitted,platform,pore,poricidal,pubescent,rectangular,red,reddish,reniform,shrub,simple,sleeve,slender,slit,small,sparsely,stellate,terminal,time,tinged,tip,tree,trichome,uniseriate,usually,violet,way,white,x,yellowish,½,¾	1-5,age,na
407	wfo-0001030676	success	219	133	77	83	136	50	74	3	-3.9,/10-1/5,1,1-1.2,2.2-5.7,abaxially,abruptly,adaxially,anther,anthesi,apex,apical-lateral,appressed-tomentose,axillary,base,becoming,berry,blade,blunt-tipped,branched,calyx,cm,continued,corolla,dichotomously,due,echinoid,entire,exserted,filament,finely,fleshy,fruit,glabrescent,granular-tomentose,green,growth,hair,introrse,large,lateral,leaf,length,lengthen,longitudinal,lower,margin,minute,minutely,mm,mostly,oblique,oblong,obtuse,often,openly,pedicel,petiole,plurifoliate,pore,probably,pubescent,ripe,scabrous,sessile,short-attenuate,shrub,simple,slit,small,stellate,stem,strongly,subglobose,tip,tree,tuft,unit,usually,velutinous,white,x,yellow	-2.5,-8.5,0-100,0.4,0.6-1.2-1.6,1-3,1.1-1.4,1.1-1.9,1.2-1.3,1.3-1.5,1.7-2,1/4,11-14,14-17,16,19-35,2.1-2.3,2.1-2.6,2.4-3.1,2.5-5.5,2.75-3.25,3-3.5,3-5,3-6,4-6,4-6.5,7-10,7-8,7-9,8-10,8-12,acute,along,angled,apart,apparently,appearing,articulated,ba,bark,branch,brown,bud,chartaceous,closely,conical,crown,cylindrical,dehiscing,deltoid,densely,diameter,eaf,echinoi,eed,elongate,except,flat-topped,flower,forming,free,glabrescen,glabrous,globose,greenish,grooved,high,honeycombed,horizontal,initially,inserted,lackin,lamina,lined,lobe,lobed,long,longitudinally,main,midvei,midvein,moderately,multangulate,nearly,nflorescence,oblong-elliptic,occasional,older,opening,orolla,ovate,ovate-lanceolate,parallel,peduncle,perfect,pseudo-terminal,pulverulent,rachi,rather,ray,reniform,reticulate-punctate,ridged,ruit,runk,scattered,short-stalked,side,somewhat,spaced,sparsely,spreading,stellate-pubescent,stigma,style,subcampanulate,subcapitat,suborbicular,tamen,tending,terete,testa,thick,thin,time,tomentose,tube,unarme,vary,vein,way,whitish,wide,yellowish,ympodial,young	appressed,articulation,bract,branching,broad-based,cell,colour,connective,form,fruiting,heteromorphism,inflated,inflorescence,insertion,interjected,interpetalar,lacking,leaflet,marking,mature,modification,na,needle-like,odour,orientation,paired,placement,position,prickle,pseud-terminal,pseudostipule,rhizome,scale,shape,smell,spot,staman,stone,structure,surface,symmetry,sympodial,texture,tissue,trichome,tuber,type,vegetative,xylopodia,zygomorphy	-3.9,/10-1/5,1,1-1.2,2.2-5.7,abaxially,abruptly,adaxially,anthesi,apex,apical-lateral,appressed-tomentose,axillary,base,becoming,berry,blade,blunt-tipped,branched,calyx,cm,continued,dichotomously,due,echinoid,entire,exserted,finely,fleshy,glabrescent,granular-tomentose,green,growth,hair,introrse,large,lateral,leaf,length,lengthen,longitudinal,minute,minutely,mm,mostly,oblique,oblong,obtuse,often,openly,plurifoliate,pore,probably,pubescent,ripe,scabrous,sessile,short-attenuate,shrub,simple,slit,small,stellate,stem,strongly,subglobose,tip,tree,tuft,usually,velutinous,white,x,yellow	lacking,na,pseud-terminal
408	wfo-0001030686	success	182	133	76	90	92	43	71	5	.2,.5,0.5-1,1-1.1,1-1.2,1-2,1.6-3,15,2-2.5,2-3,2-6.5,2.5-4,2.5-8,5-12,5-25,acute,age,anther,anthesi,apart,apex,bark,base,beneath,berry,black,breast,brown,calyx,centre,cm,corolla,cup-shaped,dark,darker,densely,denser,diameter,difoliate,elliptic,entire,exerted,filament,form,fruit,fruiting,globose,golden,height,internodal,lamina,leaf,leaf-opposed,lengthening,lepidote,lilac,long,margin,maturity,midrib,mm,oblique,orange,pale,paler,pedicel,petiole,pore,poricidal,pubescent,purple,shallow,shallowly,short,simple,slit,stem,strongly,style,surface,time,tip,tree,trichome,tube,uniformly,unit,usually,x,yellow	.5-1,1-1.5,1.2-1.5,1.5-2,1.5-4.5,1972,3-3.5,5-30,5-6,8-9,?,abaxially,aborted,abruptly,acuminate,adam,adaxially,basal,bifid,branched,brittle,bu,c.,closely,conical,deeply,different,discolorous,dry,drying,eaf,edicel,eed,empty,erect,fide,flattened,flower,fragrant,free,geminat,glabrescen,glabrous,half,heteromorphic,less,lobe,lobed,lower,many,midvein,minutely,nflorescence,noddin,older,ovary,overlapping,pair,papillae,papillose,peduncle,pericarp,pitted,planar,plant,portion,primary,pubescen,rachi,ruit,scar,scarious,seed,shiny,slightly,somewhat,space,spaced,sparsely,spreading,stellate,stigma,styl,thin,tissue,ud,vein,visible,way,woody,ympodial,–	0.5,appressed,arrangement,bract,branching,breeding,bud,cell,colour,connective,density,geminate,glabrescent,growth,hair,heteromorphism,inflated,inflorescence,length,marking,modification,na,odour,orientation,placement,position,prickle,pubescence,rhizome,shape,size,spacing,spot,staman,stone,structure,symmetry,sympodial,system,texture,tuber,type,xylopodia	.2,.5,0.5-1,1-1.1,1-1.2,1-2,1.6-3,15,2-2.5,2-3,2-6.5,2.5-4,2.5-8,5-12,5-25,acute,age,apart,beneath,berry,black,brown,calyx,centre,cm,cup-shaped,dark,darker,densely,denser,difoliate,elliptic,entire,exerted,form,globose,golden,internodal,lamina,leaf-opposed,lengthening,lepidote,lilac,long,maturity,midrib,mm,oblique,orange,pale,paler,pore,poricidal,pubescent,purple,shallow,shallowly,short,simple,slit,strongly,style,surface,time,tip,tree,tube,uniformly,usually,x,yellow	0.5,bud,geminate,glabrescent,na
409	wfo-0001030709	success	214	125	61	74	140	51	56	5	1-4.5,1.3-1.4,1/4,10-14,5-10,6-7,8-15,anther,apex,articulated,base,berry,branched,bright,calyx,chartaceous,cm,conical,connivent,cordate,dull,elliptic,elongating,equal,erect,filament,flattened-reniform,flower,fruit,fruiting,inflorescence,lateral,leaf,length,lobed,long,lower,margin,mature,maturity,mauve,mm,moderately,orange-brown,pedicel,per,perfect,perpendicular,petiole,poricidal,prickle,purple,red-green,red-orange,seed,shrub,simple,spherical,stellate,stellate-pubescent,stem,straight,style,surface,tapering,terminal,tip,trichome,truncate,unit,upper,venation,yellow,yellow-green	-9,0-2,0-2-8,0-20,0-30,0-5,0.1-0.2,0.15-0.5,0.2-0.5,0.3-1.5,0.4,0.7-1,0.8-4,0.9-1.5,1-1.2,1-1.6,1-6,1.4-2,1.6-2.1,1.9-2.8,1/2-2/3,1/3-1/2,1/4-1/3,10-50,2-4,2-5,2-6,2.3-3,2/3-3/4,3-5-9,4-5-merous,5-20,5-6,5-7,6-10,6-21,6-8,7-8,7-9,8-11,abaxially,acuminate,acute,adaxially,almost,alyx,ame,apar,apart,ape,apically,apparently,bark,blade,broad-deltate,brow,c.,cuspidate,deltate,diameter,discolorous,distance,drying,eaf,edge,eed,extending,finely,free,glabrescent,glabrous,increasing,infructescence,lanceolate,lengt,lobe,lobing,lon,long-acuminat,longer,middle,midpoint,midvein,narrow-deltate,nflorescence,occasionally,often,older,one,open,orolla,oung,pair,peduncle,pendulous,pericarp,pit,pitted,plurifoliat,porrect,portion,prickl,prickly,primary,ray,reflexed,retrorse,rounded,ruit,scar,secondary,short-styled,shorter,side,size,slender,smooth,sometimes,spaced,sparsely,spreading,stalk,stalked,tamen,terete,tertiary,time,toward,tube,unarmed,usually,variously,vary,vein,visible,way,weakly,wide,woody,ympodial	20-30,articulation,bract,branching,breeding,broad-based,cell,colour,connective,corolla,form,growth,hair,heteromorphism,insertion,interjected,interpetalar,leaflet,marking,modification,na,needle-like,number,odour,orientation,ovary,paired,pattern,placement,plurifoliate,pore,position,pseudostipule,rhizome,scale,shape,smell,spot,staman,stone,structure,symmetry,sympodial,system,texture,tissue,tuber,type,vegetative,xylopodia,zygomorphy	1-4.5,1.3-1.4,1/4,10-14,5-10,6-7,8-15,articulated,base,berry,branched,bright,chartaceous,cm,conical,connivent,cordate,dull,elliptic,elongating,equal,erect,flattened-reniform,lateral,leaf,lobed,long,lower,maturity,mauve,mm,moderately,orange-brown,per,perfect,perpendicular,poricidal,prickle,purple,red-green,red-orange,shrub,simple,spherical,stellate,stellate-pubescent,stem,straight,surface,tapering,terminal,tip,truncate,upper,yellow,yellow-green	20-30,broad-based,na,plurifoliate,zygomorphy
410	wfo-0001030714	invalid_json	177	132	NA	115	62	17	NA	NA	.2,.5,/3,0.1-0.3,0.5,0.5-0.8,0.5-1.9-3,0.7-0.8,1-1.2,1-1.3,1-2.5,1.2-1.5,1.2-4,1/3,2-2.5,20,3-3.5,>,abaxial,acuminate,acute,adaxially,age,along,anther,apex,bark,basal,base,becoming,beneath,berry,blue,blue-black,branching,calyx,clavate,cm,conical,cordate,corolla,dark,densely,diameter,ellipsoid,elliptic,entire,especially,except,filament,flattened,fruit,glabrous,globose,greyish,growth,leaving,lengthening,liana,lobe,lobed,long,many,margin,membranous,midrib,minute,minutely,mm,narrowly,new,ob-ellipsoid,ob-elliptic,oblique,ovary,pale,paler,papillate,pedicel,peduncle,peg,per,petiole,pitted,pore,poricidal,pubescent,quadrate,reniform,ripe,scar,shape,simple,slightly,slit,spaced,sparsely,stellate,stem,stigma,style,surface,time,tip,trichome,truncate,tube,uniseriate,vein,vine,violet,way,widely,x,yellow	0.3-0.4,0.8-1,1-1.5,1.4-3.5,1.5-2,2-2.6,3-7,5-100,5-6,7-17,abaxially,aid,anthesi,apar,articulating,campanulate,climbin,cup,denser,eaf,eed,exserted,fide,flower,free,grading,gradually,gree,herbaceous,howard,joined,leaf-opposed,like,lower,narrow,nflorescence,nodding,node,occasionally,older,overall,pair,papillat,pedice,perfect,planar,plurifoliat,portion,primary,prominent,ruit,strongly,submarginal,tapering,terminal,thickened,tub,twining,ud,unit,woody,ympodial	apart,articulation,bud,characteristic,colour,form,green,hair,inflorescence,leaf,length,number,seed,size,texture,type,value	NA	NA
411	wfo-0001030733	success	130	126	77	90	40	36	69	8	/4,0.5-1,1-1.2,1-1.5,1-2,1.5-5,1.7-2.7,2-2.5,3-4,3-5,4-15,4.5-5,6-7,?,acuminate,acute,along,anther,anthesi,apex,bark,base,berry,bi-lobed,broadly,brown,calyx,capitate,clearly,closely,cm,conical,coriaceous,corolla,dark,densely,denser,ellipsoid,elliptic,embryo,erect,exserted,filament,fruiting,glabrous,globose,green,later,leaf,lobed,margin,minutely,mm,moderately,narrowly,opposite,ovary,ovoid-reniform,pedicel,petiole,planar,pore,pubescent,rounded,scar,shaped,shrub,simple,smooth,somewhat,spaced,stem,stigma,strongly,style,surface,tear-drop,testa,thick,tip,treelet,trichome,tube,uniseriate,vein,visible,way,white,woody,young	.5,5-8-flowered,6-9,abaxially,adaxially,ape,decurrent,deltate,dia,eaf,eed,elongate,free,grayish-brow,lamina,lateral,like,lobe,lon,long,lower,main,middle,nflorescence,older,onto,overlappin,pair,papillo,poricidal,portion,ruit,sparsely,tall,ud,unifoliat,unit,widest,x,ympodial	0.5,1.5,2,5-8,abaxial,adaxial,arrangement,bud,colour,density,diameter,exsertion,flower,form,fruit,grayish-brown,growth,height,inflorescence,length,lobing,number,orientation,overlapping,papillose,plant,position,seed,shape,spacing,symmetry,texture,type,unifoliate,visibility,width	/4,0.5-1,1-1.2,1-1.5,1-2,1.5-5,1.7-2.7,2-2.5,3-4,3-5,4-15,4.5-5,6-7,?,acuminate,acute,along,anthesi,apex,base,berry,bi-lobed,broadly,brown,capitate,clearly,closely,cm,conical,coriaceous,dark,densely,denser,ellipsoid,elliptic,erect,exserted,glabrous,globose,green,later,leaf,lobed,minutely,mm,moderately,narrowly,opposite,ovoid-reniform,planar,pubescent,rounded,shaped,shrub,simple,smooth,somewhat,spaced,strongly,tear-drop,testa,thick,treelet,uniseriate,vein,visible,way,white,woody	0.5,1.5,2,5-8,grayish-brown,overlapping,papillose,unifoliate
412	wfo-0001030772	success	154	163	90	109	45	54	85	5	.05,.2,.25,.5,0.2-0.8-2,0.25-0.5,0.5-1,0.75-1,0.9-1,0.9-3.1,1-2,1-2.5,1.2-5,1.4-1.6,1.5-2,3-3.5,3-5,4.2-6.5,5-10-flowered,9-15,anther,anthesi,apex,attenuate,bark,base,becoming,beneath,berry,bud,calyx,capitate,closely,cm,corolla,dark,deflexed,dia,difoliate,ellipsoid,elliptic,erect,extreme,filament,fruit,fruiting,gently,glabrous,globose,green,grey,later,leaf,lenticellate,lobe,lobed,long,long-acuminate,margin,methyl,minor,minutely,mm,nearly,node,occasionally,opposite,ovary,overlapping,ovoid-reniform,pale,paler,papillose,pedicel,per,petiole,pitted,pore,poricidal,ripe,rounded,salicylate,scar,shape,shaped,shining,shrub,size,slender,slightly,spaced,stem,stigma,strongly,style,surface,swollen,tapering,tear-drop,tip,trichome,tube,uniseriate,unit,white,wintergreen,woody,x,young	2-7,5-6,8-10,acuminate,acute,archin,ba,beginning,branch,differing,eaf,edicel,eed,free,geminat,impressed,inflorescenc,large,lateral,lon,long-triangular,lower,main,major,middle,nflorescence,older,one,pair,papillo,portion,prominent,reflexed,ruit,simple,smelling,soon,straight,tall,tan,ud,usually,vein,widest,ympodial	appressed,arching,articulation,bract,branching,breeding,cell,colour,connective,diameter,flower,form,geminate,growth,hair,height,heteromorphism,inflated,inflorescence,insertion,interjected,interpetalar,leaflet,length,marking,mature,modification,na,number,odour,orientation,paired,pattern,placement,plant,position,prickle,pseudostipule,rhizome,scale,seed,spacing,spot,staman,stone,structure,symmetry,sympodial,system,texture,tissue,tuber,type,xylopodia	.05,.2,.25,.5,0.2-0.8-2,0.25-0.5,0.75-1,0.9-1,0.9-3.1,1-2,1-2.5,1.2-5,1.4-1.6,1.5-2,3-3.5,3-5,4.2-6.5,5-10-flowered,9-15,anthesi,attenuate,base,becoming,beneath,berry,bud,calyx,capitate,closely,cm,dark,deflexed,dia,difoliate,ellipsoid,elliptic,erect,extreme,gently,glabrous,globose,green,grey,later,leaf,lenticellate,lobed,long,long-acuminate,methyl,minutely,mm,nearly,node,occasionally,opposite,overlapping,ovoid-reniform,pale,paler,papillose,pitted,poricidal,ripe,rounded,salicylate,shaped,shining,shrub,slender,slightly,spaced,strongly,swollen,tapering,tear-drop,tip,trichome,tube,uniseriate,white,wintergreen,woody,x,young	.5-1,arching,di,geminate,na
413	wfo-0001030781	success	213	192	117	131	82	61	112	5	0-5,0.5-6,1-10,1-12,1-2,1.5-9,10-40,15-35,2-20,2.5-14,3-4,4-15,5-6,5-7,5-8,7.5-9,abaxially,adaxially,along,anther,apex,axillary,base,berry,broadly,brown,brownish,bud,cell,chartaceous,ciliate,cm,condition,connivent,corolla,covering,cuneate,dark,deep,densely,diameter,distal,dot,drying,elliptic,especially,filament,finely,flower,forked,fresh,fruit,glabrous,glandular,globose,gray-green,green,green-white,greenish,hair,hair-like,half,herb,high,homostylous,interjected,lanceolate,lateral,leaf,leaflet,lengthening,light,like,long,lower,make,margin,membranous,midrib,minutely,mm,mucilaginous,obovate,odd-pinnate,ovate,ovoid,pair,papillose,pedicel,peduncle,pentagonal,petiole,pilose,plant,plurifoliate,pore,poricidal,puberulent,pubescent,purple,rarely,rotate-pentagonal,scattered,seed,simple,slit,small,sometimes,somewhat,sparsely,stem,stigma,straight,style,subovoid,subtending,terminal,testal,thick,throughout,tip,tri-,tuber,unit,unwinged,violet,wall,wet,white,whitish,x	0.2-4,0.5-8,1-1.5,1-4,1-8,1.5-12,1.5-2,1.6-2.2,2-3,2.5-3.5,3-6,5-merou,6-7,abruptly,acumen,ag,alyx,apart,apiculate,apparently,articulated,axe,blade,borne,caly,capitat,decreasing,decurrent,digestion,dorsally,eaf,edge,eed,end,enzyme,erect,exceeding,flat,folded,geminat,generally,glabrou,gradually,honeycomb-shaped,larger,living,lobe,low-growin,narrowed,nflorescence,orbicular,orolla,ovate-lanceolate,perfect,petiolulate,pointed,rachi,removed,rounded,ruit,sessile,seudostipule,short,singly,size,slightly,spaced,specimen,stamen,ste,stolo,tall,tamen,tem,toward,tube,typically,usually,vary,wide,yellow,ympodial	abaxial,adaxial,age,appressed,arrangement,articulation,bract,branching,breeding,broad-based,calyx,capitate,colour,connective,form,fruiting,growth,height,heteromorphism,inflated,inflorescence,insertion,interpetalar,length,marking,mature,modification,na,needle-like,number,odour,orientation,ovary,paired,pattern,pilosity,placement,position,presence,present,prickle,pseudostipule,rhizome,scale,shape,smell,spacing,spot,staman,stone,structure,surface,symmetry,sympodial,system,texture,tissue,trichome,type,vegetative,xylopodia	0-5,0.5-6,1-10,1-12,1-2,1.5-9,10-40,15-35,2-20,2.5-14,3-4,4-15,5-6,5-7,5-8,7.5-9,abaxially,adaxially,along,axillary,base,berry,broadly,brown,brownish,bud,cell,chartaceous,ciliate,cm,condition,connivent,corolla,covering,cuneate,dark,deep,densely,distal,dot,drying,elliptic,especially,finely,forked,fresh,glabrous,glandular,globose,gray-green,green,green-white,greenish,hair,hair-like,half,herb,high,homostylous,lanceolate,lateral,lengthening,light,like,long,make,margin,membranous,midrib,minutely,mm,mucilaginous,obovate,odd-pinnate,ovate,ovoid,papillose,pentagonal,pilose,plurifoliate,pore,poricidal,puberulent,pubescent,purple,rarely,rotate-pentagonal,scattered,seed,simple,slit,small,sometimes,somewhat,sparsely,stem,straight,subovoid,subtending,terminal,testal,thick,throughout,tip,tri-,unwinged,violet,wall,wet,white,whitish,x	age,calyx,capitate,na,present
414	wfo-0001030782	success	198	164	93	116	82	48	90	3	0-7,0.4-1.5,1-2,1-3,1-6,1.3-1.6,1.5-2,1.6-4.6,11-47,12-30,15,2,2.2-4,3-10,4-11.6,4-6,4.6-26,5-20,6-8,7-15.6,abaxially,adaxially,anther,apex,base,berry,blade,broadly,brownish,cell,clavate,cm,condition,coriaceous,corolla,covering,dark,deep,diameter,distal,drying,elliptic,filament,flower,forked,fresh,fruit,glabrescent,glabrous,globose,green,green-white,greenish,hair,hair-like,half,herb,high,homostylous,interjected,lanceolate,lateral,leaf,leaflet,light,lilac,lobe,long,make,medium,mm,moniliform,mottled,mucilaginous,odd-pinnate,ovate,ovoid,pair,pedicel,pentagonal,petiole,plant,plurifoliate,pore,poricidal,prominently,purple,rachi,ripe,rotate,rounded,scarce,seed,short,size,stigma,straight,style,terminal,testal,thick,throughout,tip,tissue,tri-,tube,tuber,unit,usually,wall,wet,white,whitish,wide,winged,x	0-1,1-5,1.2-3.9,1.5-7.5,13-22,2-3,2.4-11.5,3-5,5-merou,abaxiall,acumen,acuminate,acute,ag,along,alyx,apart,apparently,arranged,articulated,asymmetric,attenuate,axe,axillary,basiscopic,bead,bud,capitat,connivent,cuneate,decreasing,digestion,dorsally,eaf,edge,eed,enzyme,exceeding,flat,folded,geminat,generally,glabrou,hal,honeycomb-shaped,inconspicuous,lengthening,like,living,lower,multiple,necklace,nflorescence,orbicular,orolla,peduncle,perfect,petiolulate,removed,ruit,second,sessile,seudostipule,side,slit,smaller,sometimes,spaced,specimen,stamen,stolon,subequal,subtending,tal,tamen,tem,totally,toward,typically,vary,yellow,ympodial	abaxial,adaxial,arrangement,articulation,bract,branching,breeding,calyx,capitate,colour,connective,form,fruiting,growth,height,heteromorphism,inflorescence,insertion,interpetalar,length,margin,marking,modification,na,odour,orientation,ovary,paired,pattern,placement,position,prickle,pseudostipule,rhizome,scale,shape,spot,staman,stem,stone,structure,symmetry,sympodial,system,texture,trichome,type,xylopodia	0-7,0.4-1.5,1-2,1-3,1-6,1.3-1.6,1.5-2,1.6-4.6,11-47,12-30,15,2,2.2-4,3-10,4-11.6,4-6,4.6-26,5-20,6-8,7-15.6,abaxially,adaxially,berry,broadly,brownish,cell,clavate,cm,condition,coriaceous,covering,dark,deep,distal,drying,elliptic,forked,fresh,glabrescent,glabrous,globose,green,green-white,greenish,hair,hair-like,half,herb,high,homostylous,lanceolate,lateral,light,lilac,long,make,medium,mm,moniliform,mottled,mucilaginous,odd-pinnate,ovate,ovoid,pentagonal,plurifoliate,poricidal,prominently,purple,ripe,rotate,rounded,scarce,seed,short,straight,terminal,testal,thick,throughout,tip,tri-,usually,wall,wet,white,whitish,wide,winged,x	capitate,na,trichome
415	wfo-0001030802	success	171	100	43	53	118	47	40	3	0.75-1,1-1.1,3-3.5x,anther,apex,base,berry,calyx,cm,cordate,corolla,deeply,densely,difoliate,evenly,filament,filiform,fruit,fruiting,glandular,globose,halfway,hanging,heart-shaped,internodal,leaf,length,lobed,long-triangular,margin,minutely,mm,papillate,pedicel,persistently,petiole,pore,poricidal,pubescent,red,shaped,shrub,simple,stigma,subshrub,surface,tear-drop,tip,unifoliate,uniseriate,unit,white,yellowish	.3,.5,.5mm,0,0.25-0.4,0.5-0.75,0.5-1,0.5-1.5,0.7-1cm,0.9-1,1,1-1.2,1-1.5,2-2.5,2-3,2-5,2.5-3,3-4,3-6,4-5mm,4-6,5-10-flowered,abaxially,abrupt,acuminate,acute,adaxially,along,anthesi,appearing,bark,basal,becoming,beginning,beneath,brown,bud,campanulate,cucullate,deflexed,denser,dia,dry,eaf,edicel,eed,ellipsoid,except,exerted,exudate,flattened-reniform,free,geminat,glabrous,gland,glandurla,incrassate,inflorescenc,invest,irregularly,lamina,later,lateral,line,live,lobe,long,lower,m.,main,markedly,material,midvein,near,nflorescence,obconic,older,ovary,ovoid,pair,pale,palmate,papillose,per,pitted,plant,portion,prominent,pubescen,raised,reddish,ruit,scar,single-celled,slender,somewhat,soon,spaced,specimen,stem,stigm,straight,strongly,style,tapering,tipped,trichoem,trichome,tube,ud,variable,vein,widely,woody,x,yellow,ympodial,young	0.5,appressed,articulation,bract,branching,breeding,cell,colour,connective,form,geminate,growth,hair,heteromorphism,inflated,inflorescence,insertion,interjected,interpetalar,leaflet,marking,mature,modification,na,odour,orientation,paired,pattern,placement,position,prickle,pseudostipule,rhizome,scale,shape,spot,staman,stone,structure,symmetry,sympodial,system,texture,tissue,tuber,type,xylopodia	0.75-1,1-1.1,3-3.5x,base,berry,cm,cordate,deeply,densely,difoliate,evenly,filiform,fruit,glandular,globose,halfway,hanging,heart-shaped,internodal,lobed,long-triangular,minutely,mm,papillate,persistently,poricidal,pubescent,red,shaped,shrub,simple,stigma,subshrub,surface,tear-drop,tip,unifoliate,uniseriate,white,yellowish	0.5,geminate,na
416	wfo-0001030809	success	154	120	54	64	90	56	45	9	1-1.5,1.2-1.4,1.4-1.5,1.5-3.5,2-2.5,4.5-5,6-8,8,acute,anther,apex,base,berry,branched,calyx,clavate,cm,corolla,curl-tipped,deflexed,dia,difoliate,elliptic,falcate,filament,fruit,fruiting,glabrous,globose,golden,green,hair,interpetalar,known,leaf,lobed,mature,membranous,mm,nearly,opposite,ovary,ovate,pedicel,petiole,pore,pubescent,round,several,simple,size,small,stigma,style,terminal,time,tomentose,tree,trichome,tube,unequal,uniseriate,unit,white	.5,0.2,0.5-1,1-1.25,1.5-2.4,2.3-5.5,20-60-flowered,5-8,9.9-12,across,along,also,anthesi,apar,appearing,bark,beneath,broadly,caly,campanulate,curved,dark-papillo,deciduous,deltoid,dense,densely,distally,eaf,edicel,eed,ellipsoid,erect,especially,evenly,exserted,free,geminat,hidden,large,lateral,leave,like,lobe,lon,long,long-papillose,lower,main,major,markedly,middle,midrib,minor,minutely,nflorescence,older,one,overtopping,planar,poricidal,portion,present,ruit,scar,scattered,shinin,shining,shoot,sinus,slender,slightly,soon,spaced,stem,straight,tall,tapering,three,tip,triangular,two,ud,underside,vein,wide,widest,x,yellow-brown,ympodial,young	1.5,2,20-60,abaxial,appressed,articulation,bract,branching,breeding,cell,colour,connective,dark-papillose,flower,form,geminate,growth,height,heteromorphism,inflated,inflorescence,information,insertion,interjected,leaflet,length,margin,marking,modification,na,number,odour,orientation,pattern,placement,plant,position,prickle,pseudostipule,rhizome,scale,seed,shape,spot,staman,stellate,stone,structure,symmetry,sympodial,system,texture,tissue,tuber,type,xylopodia	1-1.5,1.2-1.4,1.4-1.5,1.5-3.5,4.5-5,6-8,8,acute,base,berry,branched,clavate,cm,curl-tipped,deflexed,difoliate,elliptic,falcate,fruit,glabrous,globose,golden,green,known,leaf,lobed,mature,membranous,mm,nearly,opposite,ovate,pubescent,round,several,simple,small,terminal,time,tomentose,tree,trichome,unequal,uniseriate,white	-2.5,1.5,2,20-60,dark-papillose,di,geminate,na,stellate
417	wfo-0001030810	success	191	114	71	66	125	48	46	25	0.2,0.3,5,abaxially,adaxially,anther,bipinnate,blue,brown,calyx,cell,cm,colour,dark,densely,diameter,divided,elliptic,elliptical,erect,filament,fleshy,flower,fruit,globose,green,hair,leaf,lobe,long,margin,mm,moderately,multicellular,oblong,older,pair,pale,pedicel,peduncle,pentagonal,pinnae,pinnate,pitted,pore,primary,pubescent,shallowly,shaped,shrub,simple,size,stem,stone,subglabrous,surface,tear-drop,time,tomentose,tube,unicellular,uniseriate,unknown,violet,woody,x	0.2–0.3,0.4,0.5–,0.5–0.8,0.6–1.0,0.7–1.4,0.8–5.5,0.95–2.0,0–,1,1.0–1.5,1.0–2.0,1.0–3.0,1.1–2.0,1.1–2.2,1.2–1.5,1.5–1.9,1–2,1–3,1–5,2.9–4.5,20–100,2–3,2–4,3.0–5.0,3.3–5.5,3.3–8.5,3.5–4.6,3–19,4–14,4–5,4–7,5–15,5–30,5–32,6–10,6–22,7–10,7–11,8–10,absen,accrescent,acute,adaxiall,ag,along,anthesi,apart,apex,articulated,axe,axillary,ba,base,blade,borne,branched,chartaceous,clavate,connivent,cylindrical,decreasing,denser,eaf,eed,equal,especially,flattened,geminat,glabrous,greyish,half,hig,indumentum,irregular,leafy,lon,longitudinal,lower,m.,midrib,midvein,narrow,nflorescence,obtu,occasionally,opening,opposed,orolla,oung,perfect,petiole,plurifoliate,poricidal,rarely,reflexed,rounded,ruit,secondary,shiny,shoot,side,slit,sometimes,spaced,sparsely,stigma,straight,style,tamen,tardily,tip,unit,vary,white,wide,wing,yellow,ympodial,–2.5,–3,–3.4,–4.5,–5.0,–8	0.6-1.0,0.8-5.5,1-2,1.0-1.5,1.0-2.0,1.1-2.2,1.2-1.5,1.5-1.9,2.5,2.9-4.5,20-100,3,3.3-5.5,3.3-8.5,3.5-4.6,4-14,4-5,5.0,6-10,6-22,7-10,7-11,absent,appressed,arrangement,branching,corolla,form,fruiting,growth,height,heteromorphism,inflated,inflorescence,length,marking,na,number,plant,seed,shape,spot,staman,symmetry,texture,type,young,zygomorphy	0.2,0.3,5,abaxially,adaxially,bipinnate,blue,brown,cm,dark,densely,divided,elliptic,elliptical,erect,fleshy,globose,green,long,mm,moderately,multicellular,oblong,older,pair,pale,pentagonal,pinnae,pinnate,pitted,primary,pubescent,shallowly,shaped,shrub,simple,subglabrous,tear-drop,time,tomentose,unicellular,uniseriate,unknown,violet,woody,x	0.6-1.0,0.8-5.5,1-2,1.0-1.5,1.0-2.0,1.1-2.2,1.2-1.5,1.5-1.9,2.5,2.9-4.5,20-100,3,3.3-5.5,3.3-8.5,3.5-4.6,4-14,4-5,5.0,6-10,6-22,7-10,7-11,absent,na,young
418	wfo-0001030822	success	146	134	64	84	62	50	60	4	.2,0.1-0.2,0.5-1.5,0.8-1,1-1.2,1-1.5,11-15.5,2-2.5,2-5,3-3.5,3-5,3.5-7,5-6,abaxially,acute,adaxially,anther,apex,attenuate,base,calyx,clavate,closely,clustered,cm,corolla,decurrent,dia,difoliate,elliptic-obovate,exserted,filament,flattened-reniform,flower,fruiting,glabrous,globose,green,inflorescence,internodal,later,leaf,lobed,long,long-ellipsoid,margin,minutely,mm,near,nearly,occasionally,older,opposite,ovary,pale,pedicel,petiole,pitted,pore,red-papillose,revolute,scar,shaped,shiny,shrub,size,spaced,sparsely,stem,stigma,strongly,style,surface,tan,tear-drop,tip,tube,unit,usually,white,winged,x,yellowish-brown,young	0-0.5,0.4,0.4-1,0.9-1,1.5-2,2-3.8,5-7,8-9,anthesi,ba,beneath,berry,broadly,completely,cucullat,cucullate,cup,deflexed,deltate,differing,eaf,edicel,eed,erect,filiform,fleshy,free,geminat,incrassate,inflorescenc,lateral,lobe,lon,lower,main,major,middle,minor,minute,nflorescence,onto,open,pair,papillo,papillose,perhaps,planar,poricidal,portion,present,ruit,simple,slightly,somewhat,tall,tapering,ud,vein,widest,woody,yellowish,ympodial	articulation,bract,branching,breeding,bud,cell,colour,connective,diameter,exsertion,form,fruit,geminate,growth,hair,height,heteromorphism,insertion,interjected,interpetalar,leaflet,length,marking,mature,modification,na,odour,orientation,pattern,placement,plant,position,prickle,pseudostipule,rhizome,scale,seed,shape,spot,staman,stone,structure,symmetry,sympodial,system,texture,tissue,tuber,type,xylopodia	.2,0.1-0.2,0.5-1.5,0.8-1,1-1.5,11-15.5,2-2.5,2-5,3-3.5,3-5,3.5-7,5-6,acute,attenuate,base,calyx,clavate,closely,clustered,cm,decurrent,difoliate,elliptic-obovate,exserted,flattened-reniform,glabrous,globose,green,inflorescence,internodal,later,leaf,lobed,long,long-ellipsoid,minutely,mm,near,nearly,occasionally,opposite,pale,pitted,red-papillose,revolute,shaped,shiny,shrub,spaced,sparsely,strongly,tan,tear-drop,tip,tube,usually,white,winged,x,yellowish-brown	-1.2,di,geminate,na
419	wfo-0001030871	success	248	147	75	99	149	48	71	4	0.3-4,0.4-1.8,0.6-1.5,0.7-1.3,1-1.3,1-18,1.3-2,1.8-2.6,2-8,3-32,3-4.4,3-6,3.5-14,30,5-33,5-7,6-40,9-13,abruptly,accrescent,adaxial,anther,apex,apical-lateral,appressed,attenuate,bark,base,berry,blunt-tipped,branched,brown,bud,calyx,chartaceous,cm,corolla,dark,deltoid,diameter,elliptic,entire,extend,filament,fleshy,flower,fruit,fruiting,grayish,green,greenish,growth,hair,introrse,large,lateral,leaf,length,long,longitudinal,lower,main,margin,mm,mostly,narrowly,oblong,ovate,pale,pedicel,peduncle,petiole,plurifoliate,pore,probably,purple,rachi,reniform,ripe,rotate-stellate,shrub,simple,slit,somewhat,stellate-tomentose,stem,suborbicular,terminal,time,tomentose,tree,unarmed,unit,vein,violet,white,x,yellow,yellowish	.2-3,.8-3.5,.9-1.2,/30-1/5,0-120,0.2-0.4,0.7-2.5,1.3-3,1.4-2.7,1.5-3,1.5-6,1.8-3.5,1/2,1/2-3/4,1/4,1/4-1/3,11,2-3,2.8-4.5,3-5,4.5-6.5,4.8-9.5,7-12,abaxially,acuminate,acute,adaxially,ag,along,anthesi,apart,apparently,appressed-tomentose,articulated,axe,axillary,ba,becoming,blade,branch,campanulate,capitat,closely,conical,continued,decurrent,dehiscing,dendritic-echinoi,dendritic-echinoid,dendritic-multangulate,densely,directed,distal,due,eaf,earl,early,echinoi,echinoid,eed,elongate,equal,erect,evident,exserted,free,glabrescen,glabrescent,glabrous,granular-tomentose,held,high,honeycombed,inserted,lobe,lobed,long-,long-stalked,longer,m.,midvein,minute,mixed,multangulat,multangulate,nearly,nflorescence,nodding,obtuse,occasionally,often,older,open,orbicula,orbicular,orolla,ovate-lanceolate,overlapping,partly,perfect,plait,porrect-stellate,present,prominent,pubescent,rather,ray,reflexed,relatively,reticulate-punctate,ruit,runk,scabridulous,sessile,short,short-,short-stalked,side,small,sometimes,soon,spaced,sparingly,sparsely,splitting,stamen,stigma,striate,strongly,style,subglobose,sulcate,suture,tamen,terete,testa,thick,thick-stalked,thin-stalked,toward,tube,unarme,usually,vary,velutinous,way,wide,ympodial,young	abaxial,age,arrangement,bract,branching,broad-based,cell,colour,connective,form,height,heteromorphism,inflated,inflorescence,interjected,interpetalar,leaflet,marking,mature,na,needle-like,orientation,placement,plant,position,prickle,pseudostipule,rhizome,scale,seed,shape,size,spot,staman,stellate,stone,structure,surface,symmetry,sympodial,texture,tissue,trichome,trunk,tuber,type,xylopodia,zygomorphy	0.3-4,0.4-1.8,0.6-1.5,0.7-1.3,1-1.3,1-18,1.3-2,1.8-2.6,2-8,3-32,3-4.4,3-6,3.5-14,30,5-33,5-7,6-40,9-13,abruptly,accrescent,apical-lateral,attenuate,berry,blunt-tipped,branched,brown,chartaceous,cm,dark,deltoid,diameter,elliptic,entire,extend,fleshy,grayish,green,greenish,introrse,large,long,longitudinal,mm,mostly,narrowly,oblong,ovate,pale,plurifoliate,pore,probably,purple,reniform,ripe,rotate-stellate,shrub,simple,slit,somewhat,stellate-tomentose,suborbicular,terminal,time,tomentose,tree,unarmed,violet,white,x,yellow,yellowish	age,na,stellate,zygomorphy
420	wfo-0001030872	success	166	175	107	120	46	55	101	6	.5,0.5,0.5-1,0.8-1,0.8-2,1-1.2,1-1.5,1-2,1.2-1.5,1.2-3,1.5-2,1.5-5,12-18,2-5,4-6,4-6-flowered,5-6,5.5-7,6-12.5,acuminate,acute,age,anther,anthesi,apex,appearing,area,bark,base,beginning,berry,black,brown,calyx,closed,closely,cm,completely,consisting,corky,corolla,dark,deflexed,dia,difoliate,dry,ellipsoid-ovoid,elliptic,erect,exserted,filament,fleshy,fruiting,glabrate,glabrous,globose,green,hooded,known,large,leaf,lenticel,lenticellate,less,like,live,lobe,lobed,long,margin,material,middle,minor,minutely,mm,nearly,nerve,oblique,older,one,opposite,ovary,ovate,overlapping,pair,pale,papillose,pedicel,petiole,pore,primary,proximal,rather,red-glandular-puberulent,rest,rounded,scar,shaped,shining,size,small,soon,spaced,specimen,stem,stigma,strongly,style,tapering,tear-drop,tip,tree,treelet,tube,unit,white,widest,woody,x,young	3-7,adaxial,along,broadly,caly,center,crateriform,cucullate,darker,deltoid,densely,eaf,edicel,eed,free,full,geminat,incurved,inflorescenc,lon,lower,major,nflorescence,paler,petal,planar,poricidal,portion,prominent,puberulent,raised,reddish-glandular,reddish-glandular-puberulent,relative,ridge,ruit,shorter,side,simple,slightly,straight,styl,tall,thickened,ud,ympodial	appressed,articulation,bract,branching,breeding,bud,cell,colour,connective,exsertion,flower,form,fruit,geminate,growth,hair,height,heteromorphism,inflated,inflorescence,insertion,interjected,interpetalar,leaflet,length,marking,mature,modification,na,number,odour,orientation,pattern,placement,plant,position,prickle,pseudostipule,rhizome,scale,seed,shape,spot,staman,state,stone,structure,symmetry,sympodial,system,texture,tissue,tuber,type,xylopodia	.5,0.5,0.5-1,0.8-1,0.8-2,1-1.2,1-1.5,1-2,1.2-1.5,1.2-3,1.5-5,12-18,2-5,4-6,4-6-flowered,5-6,5.5-7,6-12.5,acuminate,acute,age,appearing,area,base,beginning,berry,black,brown,calyx,closed,closely,cm,completely,consisting,corky,dark,deflexed,dia,difoliate,dry,ellipsoid-ovoid,elliptic,erect,exserted,fleshy,glabrate,glabrous,globose,green,hooded,known,large,leaf,lenticel,lenticellate,less,like,live,lobe,lobed,long,material,middle,minutely,mm,nearly,nerve,oblique,one,opposite,ovate,overlapping,pair,pale,papillose,primary,proximal,rather,red-glandular-puberulent,rest,rounded,shaped,shining,small,soon,spaced,specimen,stem,strongly,style,tapering,tear-drop,tip,tree,treelet,tube,white,widest,woody,x,young	-1.5,.5-2,di,geminate,inflorescence,na
421	wfo-0001030882	success	144	115	72	96	48	19	70	2	.1,.5,0.5-0.75,0.5-1,0.5-1.1,0.8-2.4,0.9-1.1,1-1.3,1-1.5,1-4,1.6-2,2,2-5.4,2-6,2.2-4.6,3-3.5,3/4,6.5-15.6,8-12,accrescent,acuminate,anther,anthesi,apex,attenuate,bark,base,berry,calyx,capitate,closely,cm,corolla,crenulate,deflexed,elliptic,filament,fruit,fruiting,glabrous,globose,green,lateral,leaf,lightly,lobe,lobed,main,major,margin,minor,minutely,mm,narrowly,nearly,older,opposite,ovary,overlapping,ovoid,ovoid-reniform,pair,pale,paler,papillose,pedicel,petiole,pitted,pore,scar,shaped,shrub,simple,size,slightly,small,spaced,stem,stigma,style,surface,tan,tapering,tear-drop,terminal,thickened,transversely,tree,truncate,tube,vein,way,white,woody,x,young	0.75-1,0.8-1.1,?,beginning,beneath,conical,deltoid,dia,differing,difoliate,eaf,edicel,eed,erect,exserted,extreme,free,geminat,inflorescenc,lon,long,lower,middle,nflorescence,occasionally,one,papillo,peelin,planar,poricidal,portion,prominent,raised,ruguse,ruit,short,slender,soon,straight,tall,thick,tip,tub,ud,unit,widest,yellowish,ympodial	bud,colour,diameter,form,growth,height,inflorescence,length,modification,peeling,plant,position,rugose,seed,shape,spacing,texture,type,venation	.1,.5,0.5-0.75,0.5-1,0.5-1.1,0.8-2.4,0.9-1.1,1-1.3,1-1.5,1-4,1.6-2,2,2-5.4,2-6,2.2-4.6,3-3.5,3/4,6.5-15.6,8-12,accrescent,acuminate,attenuate,base,berry,capitate,closely,cm,crenulate,deflexed,elliptic,glabrous,globose,green,lateral,leaf,lightly,lobed,main,minutely,mm,narrowly,nearly,opposite,overlapping,ovoid,ovoid-reniform,pair,pale,paler,papillose,pitted,shaped,shrub,simple,slightly,small,spaced,tan,tapering,tear-drop,terminal,thickened,transversely,tree,truncate,vein,way,white,woody,x	peeling,rugose
422	wfo-0001030883	success	179	153	83	108	71	45	81	2	-3,.05,.1,.5,0.5-3,0.5-5,1-1.3,1-4,1.5-2,1.5-3.5,18-44.5,2-5,20-50-flowered,3-4,3/4,5-6,9.5-27.5,accrescent,acuminate,acute,anther,anthesi,apart,apex,bark,base,brown,calyx,cell,clavate,cm,corolla,dark,dia,difoliate,dry,elliptic,filament,fruit,fruiting,furcate,geminate,glabrous,glandular,globose,green,hard,imbedded,inflorescence,leaf,little,live,lobe,lobed,long,long-acuminate,massive,material,minute,minutely,mm,oblique,occasionally,opposite,ovary,ovate,ovoid-reniform,pale,papillate,papillose,pedicel,petaloid,petiole,pitted,placenta,plant,pore,puberulent,pulp,russet,scar,seed,shaped,shrub,size,slender,slightly,sometimes,stem,stigma,stout,straight,strongly,style,surface,tan,tapering,tear-drop,time,tip,trichome,tube,uniseriate,unit,way,white,woody,x	1-1.1,1-1.2,1-1.5,10-18,3-3.5,across,appearing,approximatately,arching,becoming,berry,branched,bu,collapsed,collection,deflexed,differing,eaf,edicel,eed,epidermal,erect,evenly,finely,fleshy,free,geminat,hollow,laminar,large,later,lateral,lenticellat,less,like,living,lon,lower,main,malodorous,markedly,middle,midrib,narrowly,nflorescence,older,pair,papillo,perpendicular,poricidal,portion,present,proximal,quite,rather,reflexed,reticulate,ruit,soon,spaced,tall,thick,triangular,two,ud,upper,vein,wall,widest,ympodial,young	bract,branching,breeding,bud,colour,connective,diameter,flower,form,glandularity,growth,hair,height,heteromorphism,interjected,interpetalar,leaflet,length,lenticellation,marking,modification,na,number,orientation,pattern,placement,position,prickle,pseudostipule,rhizome,scale,shape,spacing,spot,staman,stone,structure,symmetry,sympodial,system,texture,tissue,tuber,type,xylopodia	-3,.05,.1,.5,0.5-3,0.5-5,1-1.3,1-4,1.5-2,1.5-3.5,18-44.5,2-5,20-50-flowered,3-4,3/4,5-6,9.5-27.5,accrescent,acuminate,acute,apart,base,brown,calyx,clavate,cm,dark,dia,difoliate,dry,elliptic,furcate,geminate,glabrous,glandular,globose,green,hard,imbedded,leaf,little,live,lobed,long,long-acuminate,massive,material,minute,minutely,mm,oblique,occasionally,opposite,ovate,ovoid-reniform,pale,papillate,papillose,petaloid,pitted,placenta,plant,puberulent,russet,shaped,shrub,slender,slightly,sometimes,stout,straight,strongly,tan,tear-drop,time,tube,uniseriate,way,white,woody,x	bud,na
423	wfo-0001030884	success	218	143	71	88	130	55	62	9	0.5,0.5-1.2,0.8-1,1-1.5,1.5-2,4.5-5,9-11,abaxially,abruptly,acute,along,anther,anthesi,apex,base,berry,broad-based,c.,calyx,capitate,cm,decurrent,di-,diameter,filament,flower,fruiting,geminate,glabrous,green,greenish,growth,inflorescence,lateral,leaf,leafy,length,lobed,long,long-styled,lower,margin,mature,minutely,mm,occasionally,ovoid-reniform,pedicel,peduncle,petiole,pore,poricidal,present,prickle,principal,pubescent,reflexed,sagittate,scar,shallowly,short-styled,shrub,simple,size,slender,spherical,spreading,stellate,stellate-pubescent,stem,stiff,stigma,strongly,style,surface,tapering,tip,treelet,trichome,trifoliate,unicellular,unit,vein,way,weakly,white,wide,winged	.2,.5,.7,0.3,0.3-0.5,0.4-3,0.9-5,1,1-1.2,1-3,1.5,1.5-2.5,10,100,2,2-5,4-13,4-5,5,5-30,5-6,5-merous,5.5-7,6-10,6-25,6-8,7-8,>,abaxial,adaxial,adaxiall,also,alyx,andromonoeciou,apar,arme,articulated,bark,basal,blade,brown,conical,connivent,curved,dark,densely,differing,directed,discolorous,distal,eaf,eed,elliptic,equal,extend,extending,flowering,free,glandular,gray-tinged,gree,half,herbaceous,heterostylous,infructescence,like,lobe,long-stalked,long-triangular,magnification,midpoint,midrib,minute,mixture,moderately,new,nflorescence,node,older,one,onto,open,orolla,oung,outlin,ovary,pair,pale,papillat,per,plant,porrect,portion,prickly,primary,ray,red,reddish,reflexe,regularly,rest,ruit,scattered,sessile,shap,short,short-stalked,similar,spaced,sparsely,still,tall,tamen,tannish,time,tube,unarmed,uniformly,uniseriate,upward,usually,vary,varying,visible,wing,without,woody,yellow,ympodial,young	0.7,adaxially,andromonoecious,apart,appressed,articulation,bract,branching,breeding,cell,colour,connective,corolla,form,fruit,hair,heteromorphism,inflated,insertion,interjected,interpetalar,leaflet,marking,modification,na,needle-like,none,odour,orientation,paired,papillate,pattern,placement,position,pseudostipule,rhizome,scale,seed,shape,smell,spacing,spot,staman,stone,structure,symmetry,sympodial,system,texture,tissue,tuber,type,vegetative,xylopodia,zygomorphy	0.5,0.5-1.2,0.8-1,1-1.5,1.5-2,4.5-5,9-11,abaxially,abruptly,acute,along,anthesi,base,berry,c.,capitate,cm,decurrent,di-,geminate,glabrous,green,greenish,lateral,leafy,lobed,long,mature,minutely,mm,occasionally,ovoid-reniform,poricidal,present,principal,pubescent,reflexed,sagittate,shallowly,shrub,simple,slender,spherical,spreading,stellate,stellate-pubescent,stiff,strongly,surface,tapering,tip,treelet,trichome,trifoliate,unicellular,unit,vein,way,weakly,white,wide,winged	0.7,adaxially,andromonoecious,apart,na,none,papillate,sympodial,zygomorphy
424	wfo-0001030899	success	145	122	74	88	57	34	69	5	.5-2,0.3-0.5,0.5-1,1,1-2,1-3,1.5-2,10-13,10-20,2,2-3,2-3.5,2.5-3.5,3-12,3-4,3-5,3-foliate,3.5-4,4-5,5-10,5-6.5,7-27,8-11,acuminate,apex,base,beyond,bronze,calyx,chartaceous,cm,connective,cordate,coriaceous,deeply,densely,diameter,directed,ellipsoidal,end,entire,extrorse,flattened,flower,fruit,glandular-puberulent,globose,green,inside,less,lobe,long,margin,mm,narrowly,obconical,oblong,obtuse,outside,ovate,ovoid,pedicel,peduncle,perfect,petiole,pore,puberulent,pubescent,purple,rachi,radiu,remnant,shrub,simple,slightly,splotch,stamen,stellate,stigma,stripe,style,triangular,tube,unbranched,unit,upward,x,yellow	0.5,1-1.5,1-6,20-25-45,6.5-31-45,?,abaxially,absent,acute,adaxially,aggregate,apart,ape,articulated,axe,basal,blade,cell,connivent,desc,dilated,distally,eaf,eed,ex,exceeding,exserted,glabrous,leaving,light,lon,lower,mucronate,nflorescence,nther,orang,orolla,pedicellar,peltifor,presen,puberulen,ruit,shorter,spaced,stone,strongly,tal,tem,thecae,time,tomento,ud,vary,vein,white,wide,ympodial	20-25,6.5-31,anther,arrangement,articulation,branching,bud,colour,corolla,exsertion,form,growth,hair,height,inflorescence,leaf,length,na,ovary,peltiform,plant,position,seed,shape,size,spacing,stem,structure,symmetry,sympodial,texture,theca,tomentose,type	.5-2,0.3-0.5,0.5-1,1,1-2,1-3,1.5-2,10-13,10-20,2,2-3,2-3.5,2.5-3.5,3-12,3-4,3-5,3-foliate,3.5-4,4-5,5-10,5-6.5,7-27,8-11,acuminate,base,beyond,bronze,chartaceous,cm,cordate,coriaceous,deeply,densely,directed,ellipsoidal,end,entire,extrorse,flattened,glandular-puberulent,globose,green,inside,less,long,mm,narrowly,obconical,oblong,obtuse,outside,ovate,ovoid,perfect,puberulent,pubescent,purple,shrub,simple,slightly,splotch,stamen,stellate,stripe,triangular,unbranched,upward,x,yellow	20-25,6.5-31,na,peltiform,tomentose
425	wfo-0001030902	success	158	161	79	96	62	65	74	5	-2,-20,0.6-1.5,1-2,1-6,1.5-13,1.5-2,1.5-2.5,10-15,15-50,2,2-3,2-5,2.5-4,3-20,3.5-4,30-50,4,4-22,4-6,4-7,5-7,5-9,absent,acuminate,acute,adaxially,angled,apart,apex,base,branched,brown-pilose,calyx,cell,cm,connective,connivent,cordate,dark,deltate,densely,diameter,directed,distally,eglandular,ellipsoidal,entire,flattened,fleshy,flower,forked,fruit,glabrescent,glabrous,glandular,globose,hair,laterally,lobe,long,lower,margin,mm,oblong,obtuse,occasionally,orange,ovate,pedicel,pedicellar,peduncle,petiole,pore,present,puberulence,purple,rachi,radiu,rarely,reddish,remnant,simple,sparse,sparsely,stellate,stigma,stone,style,subcoriaceous,tree,truncate,unbranched,unit,x,yellow	0-15,1.5-2-3-5,2.5,3-13,3-4,4-foliat,6-24,8-14,abaxially,aggregate,along,ape,apically,apiculate,articulated,axe,basal,beyond,blade,brow,cylindrical,dilated,eaf,eed,equalling,exceeding,except,exserted,glabrat,glandular-puberulen,leaving,lon,mature,narrowly,nflorescence,nther,orolla,perfect,pinkish,presen,purplish,ruit,shorter,slightly,small,somewhat,spaced,stamen,subcapitat,tal,tem,thecae,time,tip,tomento,triangular,tube,ud,vary,vein,wide,ympodial	4-foliate,abaxial,adaxial,anther,articulation,bract,branching,broad-based,bud,colour,corolla,filament,form,fruiting,glabrate,glandular-puberulent,growth,height,heteromorphism,inflorescence,insertion,interjected,interpetalar,leaf,leaflet,length,marking,modification,na,needle-like,number,odour,orientation,ovary,paired,pilosity,placement,plant,position,presence,prickle,pseudostipule,rhizome,scale,seed,shape,smell,spacing,spot,staman,stem,structure,subcapitate,surface,symmetry,sympodial,texture,theca,tissue,trichome,tuber,type,vegetative,xylopodia,zygomorphy	-2,-20,0.6-1.5,1-2,1-6,1.5-13,1.5-2,1.5-2.5,10-15,15-50,2,2-3,2-5,2.5-4,3-20,3.5-4,30-50,4,4-22,4-6,4-7,5-7,5-9,absent,acuminate,acute,adaxially,angled,apart,apex,base,branched,brown-pilose,cm,connivent,cordate,dark,deltate,densely,diameter,directed,distally,eglandular,ellipsoidal,entire,flattened,fleshy,forked,glabrescent,glabrous,globose,hair,laterally,long,mm,oblong,obtuse,occasionally,orange,ovate,present,purple,rarely,reddish,simple,sparse,sparsely,stellate,subcoriaceous,tree,truncate,unbranched,x,yellow	4-foliate,glabrate,glandular-puberulent,na,subcapitate
426	wfo-0001030914	success	186	112	56	66	120	46	53	3	/4,0-0.25,1-1.5,1.5-3,3-4,acute,anther,apex,attenuate,base,beneath,berry,calyx,campanulate,cm,corolla,difoliate,elliptic,erect,filament,fruiting,furcate,glabrous,globose,green,inflorescence,leaf,lemon-yellow,length,lobed,long,many,margin,minutely,mm,narowly,obovate,onto,opposite,otherwise,pale,papillose,pedicel,petiole,pore,poricidal,puberulent,ripe,shape,shaped,shrub,simple,small,sparsely,tear-drop,time,tip,tree,trichome,uniseriate,unit,usually,way,white,winged,x	.1,.5,0.1-0.5,0.5-1,0.7-1,0.8-1,0.8-1.3,1-2,1.2-1.5,1.5-2,1.5-8,2-10,2-2.5,2.5-11,2.5-3,3.5-17,5-17,5-25-flowered,7-10,7-8,9-35,along,anthesi,bark,blade,bud,capitate,closely,constriction,dark,decurrent,deflexed,deltoid,densely,dia,differing,distal,dry,eaf,edicel,eed,ellipsoid,equal,even,evenly,exserted,flower,free,geminat,glabrate,golden,greyish-brow,individual,later,lateral,like,live,lobe,lon,long-styled,lower,main,major,middle,minor,nflorescence,occasionally,often,older,one,ovary,overlappin,ovoid-reniform,pair,papillo,pitted,planar,plant,portion,prominent,pubescent,quite,raised,reddish-brown,rest,rounded,ruit,scar,short-styled,size,slender,slightly,sometimes,soon,spaced,specimen,stem,stigma,straight,style,surface,tall,tan,tapering,thick,third,ti,trunk,tub,tube,ud,variable,vein,weight,widest,within,woody,yellow,ympodial,young	appressed,articulation,bract,branching,breeding,cell,colour,connective,form,fruit,geminate,growth,hair,heteromorphism,inflated,insertion,interjected,interpetalar,leaflet,marking,mature,modification,na,odour,orientation,paired,pattern,placement,position,prickle,pseudostipule,rhizome,scale,spot,staman,stone,structure,symmetry,sympodial,system,texture,tissue,tuber,type,xylopodia,zygomorphy	/4,0-0.25,1-1.5,1.5-3,3-4,acute,attenuate,base,beneath,berry,campanulate,cm,difoliate,elliptic,erect,furcate,glabrous,globose,green,leaf,lemon-yellow,lobed,long,many,minutely,mm,narowly,obovate,onto,opposite,otherwise,pale,papillose,petiole,poricidal,puberulent,ripe,shaped,shrub,simple,small,sparsely,tear-drop,time,tip,tree,trichome,uniseriate,usually,way,white,winged,x	geminate,na,zygomorphy
427	wfo-0001030918	success	223	110	45	59	164	51	42	3	0-10,0.3-1.5,0.6-2.5,5.5-7,anther,apex,apparently,articulated,base,berry,branched,calyx,cell,chartaceous,cm,connivent,cuneate,difoliate,elongating,equal,erect,filament,fruit,fruiting,lateral,leaf,length,lobed,long,lower,margin,mature,maturity,mauve,mm,moderately,orange,pedicel,perpendicular,petiole,poricidal,prickle,purple,red,reflexed,shrub,simple,somewhat,spherical,spreading,stellate,stellate-pubescent,stem,surface,tapering,terminal,tip,trichome,unit	-4,-5,-9,.5,.7,0-20,0-25,0-4,0-6,0.1,0.1-0.25,0.2-0.4,0.25-0.45,0.5-0.7,0.5-2,0.5-2.5-4.5,0.6,0.7-1.2,0.7-1.7,1,1-1.5,1-1.8-2.3,1-2,1-4,1.5-2,1.5-2.5-3.2,1.5-5.5-6,1/2-2/3,1/3,1/3-1/2,1/3-1/2-3/4,1/4-1/3,2-10,2-2.5,2-25-40,2-3,2-4,2-7,2-8,2.8-3,2/,3-15,3-4,3-6.5,3-7,3.5-6,4-7,5-7,5-8,5-merous,6-8,7-10-12,abaxial,abaxially,acicular,acute,adaxial,alyx,ame,apar,apart,apically,bark,blade,brow,c.,caudat,curved,dark,deltate,densely,diameter,discolorous,distance,drying,dull,eaf,elliptic,elongated,evenly,extending,faint,flattened,flattened-reniform,flower,free,geminat,glabrescent,glabrous,green,green-brown,infructescence,lobe,lobing,longer,midpoint,midvein,mixture,narrow-deltate,nflorescence,oblong,obtuse,occasionally,older,one,open,orange-brown,orolla,oung,outline,pair,pale,peduncle,pendulous,per,perfec,pericarp,pit,porrect,portion,prickl,prickly,primary,pubescent,raised,ray,red-brown,reduced,ruit,scandent,scar,secondary,seed,sessile,side,slender,small,smooth,sometimes,spaced,sparsely,stalk,stalked,straight,strongly,style,tamen,terete,tertiary,time,tube,upper,usually,vary,vein,venation,visible,way,weakly,wide,woody,yellow,ympodial,young	appressed,articulation,bract,branching,breeding,broad-based,colour,connective,corolla,form,geminate,growth,hair,heteromorphism,inflated,inflorescence,insertion,interjected,interpetalar,leaflet,marking,modification,na,needle-like,odour,orientation,paired,pattern,perfect,placement,pore,position,pseudostipule,rhizome,scale,shape,smell,spot,staman,stone,structure,symmetry,sympodial,system,texture,tissue,tuber,type,vegetative,xylopodia,zygomorphy	0-10,0.3-1.5,0.6-2.5,5.5-7,apparently,articulated,base,berry,branched,chartaceous,cm,connivent,cuneate,difoliate,elongating,equal,erect,lateral,lobed,long,maturity,mauve,mm,moderately,orange,perpendicular,poricidal,purple,red,reflexed,shrub,simple,somewhat,spherical,spreading,stellate,stellate-pubescent,stem,surface,tapering,terminal,tip	geminate,na,perfect
428	wfo-0001030943	success	167	146	82	96	71	50	79	3	1-1.5,1.8-2.2,1/2,2-6,3-4,3/4,7-13.5,7-8,8-10,abaxial,abaxially,acuminate,acute,adaxial,adaxially,age,along,anther,anthesi,apex,bark,base,becoming,berry,black,branching,calyx,cm,corolla,decurrent,deflexed,dendritic,densely,drying,echinoid,elliptic,erect,exserted,filament,fruiting,globose,golden,golden-yellow,growth,horizontal,large,lateral,leaf,lobed,long,main,mm,narrowly,nodding,outline,overtopping,pair,pale,pedicel,petiole,plurifoliate,pore,poricidal,pubescent,purplish-black,raised,scar,scattered,secondary,shoot,showy,shrub,sleeve,slit-like,small,somewhat,sparsely,stem,strongly,surface,terminal,time,tip,tree,tree-like,trichome,tube,unit,vein,violet,way,woody,x,yellow,yellowish-white,young	.5,0,0.5-1,0.5-3,1-1.2,1.1,1.5-2,10-25,12-15,3,4-4.5,4-5,4-6,absent,apical,basal,belo,bi-lobed,branch,conical,cupulate,dark,denser,diameter,eaf,edicel,eed,elongate,ew,fide,flattened,flower,free,glabrat,glabrous,im,inserted,lenticular,lobe,lon,lower,m.,minute,minutely,monochasia,nflorescence,often,older,ovary,papillo,pearce,per,pericarp,pitted,planar,portion,reddish-brown,ruit,slightly,stamen,stigma,style,tall,tapering,thin,triangular,tub,ud,upper,wide,ympodial	articulation,bract,breeding,bud,cell,colour,deflexion,exsertion,form,fruit,glabrate,hair,height,heteromorphism,inflorescence,insertion,interjected,interpetalar,leaflet,length,margin,marking,monochasial,na,new,odour,orientation,pattern,placement,plant,position,prickle,pseudostipule,rhizome,scale,shape,size,spot,staman,stone,structure,symmetry,sympodial,system,texture,tissue,tuber,type,width,xylopodia	1-1.5,1.8-2.2,1/2,2-6,3-4,3/4,7-13.5,7-8,8-10,abaxially,acuminate,acute,adaxially,age,along,anthesi,base,becoming,berry,black,branching,calyx,cm,decurrent,deflexed,dendritic,densely,drying,echinoid,elliptic,erect,exserted,globose,golden,golden-yellow,horizontal,large,lateral,lobed,long,main,mm,narrowly,nodding,outline,overtopping,pair,pale,petiole,plurifoliate,poricidal,pubescent,purplish-black,raised,scattered,secondary,shoot,showy,shrub,sleeve,slit-like,small,somewhat,sparsely,strongly,terminal,time,tip,tree,tree-like,trichome,tube,vein,violet,way,woody,x,yellow,yellowish-white	glabrate,monochasial,na
429	wfo-0001030959	success	164	134	66	78	86	56	63	3	.2,.8,/5,0.5-1.5,0.7-1.2,1-10,1-7,1.2-1.8,10-15,2.5-5,4-6,4-8,5-6,5-9,5-merous,abaxially,anther,apart,apex,apparently,articulated,base,branched,brown,brown-green,cm,color,connivent,cuneate,diameter,difoliate,elliptic,filament,flower,fresh,glandular,hair,inflorescence,known,lateral,leaf,length,lobed,long,long-acuminate,lower,margin,membranous,minute,mm,numerous,pedicel,peduncle,perpendicular,petiole,poricidal,prickle,scar,several,shrub,simple,sparsely,stellate,stellate-pubescent,stem,straight,straw,style,subentire,surface,tapering,tip,toward,trichome,unit,usually,way,yellow	.05,0.5,1-2,1.5-2,1.5-3.5,1/5-1/10,2-4,2.5-4,2.5-4.5,6-8,9-12,almost,alyx,ame,apar,apically,armed,bark,blade,c.,concolorous,curved,deltate,densely,distributed,drying,eaf,eed,equal,erect,evenly,free,geminat,gently,glabrescent,glabrou,glabrous,green-brow,know,less,like,lobe,long-acuminat,longer,midpoint,narrow-deltate,nflorescence,older,one,open,orolla,oung,pair,part,perfec,porrect,portion,present,prickl,prickly,primary,prominent,ray,ruit,scrambling,secondary,sessile,short,side,slender,spaced,spreading,tamen,terete,tertiary,time,tube,unarmed,vary,vein,venation,visible,whole,wide,ympodial,youngest	articulation,bract,branching,breeding,broad-based,calyx,cell,colour,connective,corolla,form,fruit,fruiting,geminate,growth,heteromorphism,insertion,interjected,interpetalar,leaflet,marking,mature,merosity,modification,na,needle-like,odour,orientation,ovary,paired,pattern,perfect,placement,pore,position,pseudostipule,rhizome,scale,seed,shape,smell,spacing,spot,staman,stone,structure,symmetry,sympodial,system,texture,tissue,tuber,type,vegetative,width,xylopodia	.2,.8,/5,0.5-1.5,0.7-1.2,1-10,1-7,1.2-1.8,10-15,2.5-5,4-6,4-8,5-6,5-9,5-merous,abaxially,apart,apex,apparently,articulated,base,branched,brown,brown-green,cm,color,connivent,cuneate,difoliate,elliptic,flower,fresh,glandular,hair,known,lateral,lobed,long,long-acuminate,membranous,minute,mm,numerous,perpendicular,poricidal,prickle,several,shrub,simple,sparsely,stellate,stellate-pubescent,stem,straight,straw,subentire,surface,tapering,tip,toward,usually,way,yellow	geminate,na,perfect
430	wfo-0001030982	success	215	111	62	75	140	36	57	5	0.2-3,0.5,1,2/3,4-5,acute,adaxially,age,anisophyllous,anther,apex,appressed,base,berry,brownish,calyx,channelled,chartaceous,closely,cm,corolla,cuneate,difoliate,dry,drying,entire,filament,fleshy,form,fresh,fruit,fruiting,geminate,glabrous,globose,green,growth,leaf,lengthening,lobed,long,lower,margin,material,maturity,minutely,mm,opposite,packed,papillate,pedicel,petiole,pore,poricidal,reflexed,rhizomatous,sagittate,separated,simple,sinuate,slightly,slit,somewhat,stem,subshrub,surface,tightly,tip,trichome,uniseriate,unit,vegetative,way,white,x	-2-2.5,.1,.2,.5,0.05,0.05-0.5,0.1,0.1-0.15,0.3-2,0.5-0.9,0.5-1,0.5-3,1-1.5,1-8,1.5,1.5-2,1.5-3,3-21,3-8,4-12,6-8,abaxially,acuminate,angular,anthesi,ape,ba,beneath,broadly,brown,bud,caducous,capitate,central,ciliate,conic,conical,cream,cucullate,curved,dark,deflexed,deltate,diameter,differing,distall,distally,distichou,eaf,edicel,eed,ellipsoid,elliptic,enlarged,exerted,extension,external,flattened-reniform,flower,foliage,free,glabrescent,glandular,glandular-papillose,golden-green,greenish,hilum,impressed,inconspicuously,internal,isostylous,larger,later,less,like,live,lobe,major,materia,midvein,minor,mostly,near,new,nflorescence,oblique,obovate,occasionally,often,olive,one,ovary,ovate,overlappin,pair,pale,papillae,papillat,papillose,peduncle,pitted,planar,plant,portion,primary,projection,prominent,prominently,puberulent,pubescent,reddish,rest,revolute,ruit,scar,seed,shoot,sigmoidally,situated,size,sparsely,stamen,stigma,straight,stripe,strongly,style,testa,tetramerous,time,transverse,tub,tube,ud,vein,veined,weakly,yellowish,ympodial,young	.5-2,articulation,broad-based,cell,colour,distichous,hair,heteromorphism,inflorescence,insertion,length,marking,na,needle-like,odour,orientation,overlapping,placement,position,prickle,pseudostipule,rhizome,scale,shape,smell,spot,staman,stone,structure,symmetry,sympodial,texture,tuber,type,xylopodia,zygomorphy	0.2-3,0.5,1,2/3,4-5,acute,adaxially,age,anisophyllous,appressed,base,berry,brownish,channelled,chartaceous,closely,cm,cuneate,difoliate,dry,drying,entire,fleshy,fresh,geminate,glabrous,globose,green,leaf,lengthening,lobed,long,material,maturity,minutely,mm,opposite,packed,papillate,poricidal,reflexed,rhizomatous,sagittate,separated,simple,sinuate,slightly,slit,somewhat,subshrub,tightly,tip,trichome,uniseriate,way,white,x	.5-2,distichous,na,overlapping,zygomorphy
431	wfo-0001030989	success	177	177	104	115	62	62	96	8	.5,0.5-1,1-1.5,12-15,15-27.5,2-3.5,3-20,3-4,3-5.5,3-7.5,4-5,4-8,5,5.5-7.9,6-13,6-6.5,9-10,abaxially,adaxially,anther,apex,axillary,base,berry,blade,brownish,bud,cell,chartaceous,ciliate,cm,condition,conical,connivent,corolla,covering,densely,diameter,distal,dorsally,drying,edge,end,especially,filament,flat,flower,folded,forked,fresh,fruit,generally,glabrous,green,green-white,greenish,hair,hair-like,half,herb,homostylous,interjected,lanceolate,lateral,leaf,leaflet,lengthening,light,like,long,lower,make,margin,minute,mm,mucilaginous,obtuse,occurring,odd-pinnate,ovoid,pedicel,petiole,plant,plurifoliate,pore,poricidal,proximal,pubescent,ripe,rotate,seed,singly,size,slit,sparsely,stem,style,subtending,terminal,testal,thick,throughout,tip,tri-,tuber,typically,unit,unwinged,usually,violet,wall,wet,whitish,wide,x	1-10,1-2,4-7,5-merou,acuminate,ag,alyx,apart,apparently,articulated,axe,capitat,decreasing,digestion,eaf,eed,enzyme,erec,geminat,glabrou,gradually,honeycomb-shaped,larger,living,lobe,nflorescence,orbicular,orolla,ovate,ovate-lanceolate,pair,pale,peduncle,perfect,petiolule,present,pubescen,ray,removed,ruit,secondary,semierect,seudostipule,spaced,specimen,ste,stigma,stolo,subequal,subsessile,symmetrical,tall,tamen,tem,thir,toward,triangular,tube,vary,wider,yellow,ympodial	5-merous,age,appressed,arrangement,articulation,bract,branching,breeding,broad-based,calyx,ciliation,colour,connective,form,fruiting,geminate,growth,height,heteromorphism,inflated,inflorescence,insertion,interpetalar,length,marking,mature,modification,na,needle-like,number,occurrence,odour,orientation,ovary,paired,pattern,placement,position,prickle,pseudostipule,rhizome,scale,shape,smell,spot,staman,stellate,stolon,stone,structure,surface,symmetry,sympodial,system,texture,third,tissue,trichome,type,vegetative,xylopodia,zygomorphy	.5,0.5-1,1-1.5,12-15,15-27.5,2-3.5,3-20,3-4,3-5.5,3-7.5,4-5,4-8,5,5.5-7.9,6-13,6-6.5,9-10,abaxially,adaxially,axillary,berry,brownish,bud,cell,chartaceous,ciliate,cm,condition,conical,connivent,corolla,covering,densely,distal,dorsally,drying,end,especially,flat,folded,forked,fresh,generally,glabrous,green,green-white,greenish,hair,hair-like,half,herb,homostylous,lanceolate,lateral,lengthening,light,like,long,make,margin,minute,mm,mucilaginous,obtuse,occurring,odd-pinnate,ovoid,plant,plurifoliate,pore,poricidal,proximal,pubescent,ripe,rotate,seed,singly,slit,sparsely,stem,subtending,terminal,testal,thick,throughout,tip,tri-,typically,unwinged,usually,violet,wall,wet,whitish,wide,x	5-merous,age,geminate,na,stellate,stolon,third,zygomorphy
432	wfo-0001030991	success	203	122	67	74	129	48	60	7	.5,0.5,3-5-5.5,3-5-lobed,absent,along,anther,apex,apparently,appressed,attenuate,base,berry,calyx,cell,color,connivent,corolla,diameter,different,ellipsoidal,entire,eye,filament,filiform,fruiting,furcate,glabrous,globose,growth,herb,inflorescence,lateral,leaf,leaf-opposed,lengthening,lobed,loosely,lower,margin,mm,nearly,occasionally,often,pedicel,petiole,pinnatifid,pore,poricidal,red,ripe,scattered,short,shrub,simple,sleeve,slit,small,somewhat,spreading,stellate,stem,surface,terminal,tip,trichome,uniseriate,unit,variably,vein,violet,white,winged,x	0,0.1,0.2,0.2-0.7,0.3-0.4,0.5-0.7,0.5-1,0.5-1.5,0.5-3.5,0.6-0.8,0.7-1.2,1-1.5,1-1.6,1-2.2,1-2.5,1-7,1.5,10-20,2-plurifoliat,2.5-10,2.5-3,2/3,4-10,5-merou,9-11,<,abaxially,acuminate,acute,adaxiall,adaxially,ag,alyx,angled,anthesi,arising,ark,articulated,ascending,basal,brown,bulbous,capitate,cm,conical,densely,distally,drying,eaf,eed,ellipsoid,elliptic,elongate,enlarged,exerted,flattened,flower,free,frui,fusiform,glabrescen,grey,ilament,incised,lanceolate,leave,less,like,lobe,long-triangular,midrib,minute,minutely,narrowly,new,nflorescence,nodding,older,orolla,outline,packed,pair,papillo,part,particularly,peduncle,pendant,per,perfect,pericarp,pitted,platfor,pointing,portion,primary,pseudoumbel,pubescent,rectangular,reflexed,reniform,rest,rootstoc,ruit,scar,shallowly,shiny,slightly,sparsely,stigma,strongly,style,suffrutescent,tangled,tem,testal,thin,tightly,tube,twinin,ud,uniformly,upper,vary,weak,weight,woody,yellowish,ympodial,young	2-plurifoliate,age,articulation,artificial,bract,branching,breeding,broad-based,colour,connective,form,fruit,hair,heteromorphism,inflated,insertion,interjected,interpetalar,leaflet,length,marking,mature,modification,na,needle-like,odour,orientation,paired,pattern,placement,position,prickle,pseudostipule,rhizome,scale,shape,spot,staman,stone,structure,symmetry,sympodial,system,texture,tissue,tuber,type,xylopodia	.5,0.5,3-5-5.5,3-5-lobed,absent,along,apparently,attenuate,base,berry,color,connivent,diameter,different,ellipsoidal,entire,eye,filiform,furcate,glabrous,globose,herb,lateral,leaf,leaf-opposed,lengthening,lobed,loosely,lower,mm,nearly,occasionally,often,pinnatifid,pore,poricidal,red,ripe,scattered,short,shrub,simple,sleeve,slit,small,somewhat,spreading,stellate,stem,surface,terminal,tip,trichome,uniseriate,variably,vein,violet,white,winged,x	2-plurifoliate,age,artificial,broad-based,na,needle-like,prickle
433	wfo-0001031005	success	231	94	37	49	182	45	34	3	.5,1-2,2.5,accrescent,almost,anther,apex,apically,apparently,attenuate,base,berry,black,blue,branched,branching,calyx,chartaceous,cm,corolla,dendritic,dilated,drying,entire,filament,form,fruit,fruiting,leaf,length,liana,lobed,margin,membranous,mm,oblong,ovoid,pedicel,petiole,pore,poricidal,purple,simple,slender,sparsely,strongly,terminal,tip,unit	.4,/3-1/2,0-0.5,0.1,0.3-0.5,0.5-1.5,0.8,0.9,1,1-1.5,1-2.5,1-3,1.5-2.5,1.5-4,10,2-3.2,2.3-3,2.5-4,3-10,3-4,3-6.5,4-6,5,5-7,5-8,5°,6-12,abaxial,abaxially,acuminate,acute,adaxially,age,along,alyx,anthesi,apar,articulated,bark,brachyblast,branch,brown,capitate,clearly,clum,clustered,common,concolorous,conical,cupular,curved,dark,datum,deeply,delineated,deltoid,dendritic-pubescent,denser,density,detaching,developing,diameter,discolorous,divided,domatia,eaf,ellipsoi,elliptic,elongated,equal,evenly,extending,eye,fertilisation,fine,flat,flattened,flexuous,flower,forming,free,glabrous,greenish,immature,increasing,inside,junction,known,lateral,leave,lengthening,like,linear,lobe,long,longitudinally,loop,lower,m.,main,midvein,minute,much,naked,network,nflorescence,nther,obovate,obscure,occasional,occasionally,often,older,onl,orange-brown,orolla,ou,outside,ovate,pair,peduncle,pendulous,perfec,pericarp,plurifoliat,pointed,portion,primary,prominent,protruding,pubescent,rachi,raised,ray,region,rest,ridged,ruit,scar,secondary,seed,short,side,smaller,smoot,smooth,sometimes,somewhat,soon,spread,spreading,standing,stem,stigma,stump,style,surface,surrounding,tangling,tearing,terete,tertiary,thick-chartaceous,thin,toward,trichome,tube,ud,unarmed,uneven,usually,vary,vein,venation,visible,weakly,well-developed,white,wide,x,ympodial,young	appressed,articulation,bract,breeding,cell,colour,connective,growth,hair,heteromorphism,inflated,inflorescence,insertion,interjected,interpetalar,leaflet,marking,mature,modification,na,odour,orientation,paired,pattern,perfect,placement,plurifoliate,position,prickle,pseudostipule,rhizome,scale,shape,spot,staman,stone,structure,symmetry,sympodial,system,texture,tissue,tuber,type,xylopodia	.5,1-2,2.5,accrescent,almost,apically,apparently,attenuate,base,berry,black,blue,branched,branching,chartaceous,cm,dendritic,dilated,drying,entire,liana,lobed,membranous,mm,oblong,ovoid,poricidal,purple,simple,slender,sparsely,strongly,terminal,tip	na,perfect,plurifoliate
434	wfo-0001031007	success	205	156	111	126	79	30	105	6	.5,0.5-1,0.5-10,0.75-1.5,1,1-1.2,1-1.5,1-3.5,1.2-1.5,1.5-2,4-6,4.5-5,5,50-100,7-10,acute,alfway,almost,along,anther,apex,articulated,base,becoming,beginning,berry,bifid,black,branched,branching,brown,c.,calyx,capitate,cell,chartaceous,clustered,cm,completely,connivent,corolla,cuneate,dark,dendritic,diameter,drying,dull,ellipsoid,elliptic,entire,extending,filament,flattened-reniform,fleshy,flower,fruit,fruiting,glabrous,globose,growth,herbarium,inflorescence,irregularly,lamina,lax,leaving,lengthening,lilac,lobed,long,loose,loosely,lower,many,margin,matte,minutely,mm,narrowly,near,new,occasionally,often,outline,pedicel,peduncle,peg,per,perfect,petiole,pitted,pore,poricidal,prominent,pubescent,reddish,revolute,round-rectangular,sagittate,scar,shrub,simple,sleeve,slit,spaced,sparsely,specimen,stellate,stellate-pentagonal,stem,stigma,style,surface,tangled,terminal,testal,time,tip,trichome,twining,upper,usually,vein,vine,woody,x	0.2,0.5,1.3-2.5-5,1.6-2,1.9-3,1/3,11-14,15,2.5-5-12,3-4,4-7,5-merou,5.5-6,6,8-10,<,abaxiall,abruptly,ag,alyx,anthesi,apar,apparently,ark,broad,broadly,campanulate,cup-shaped,deltate,densely,dilated,eaf,eed,exserted,free,geminat,glabrescen,glabrou,ilament,impressed,intramarginal,junction,lobe,looping,m.,markedly,midvein,multi-celled,narrowing,nflorescence,nodding,older,orolla,pale,papillat,papillate,pericarp,planar,plurifoliate,portion,primary,rat,ruit,shiny,slender,slightly,splitting,spreading,stout,strongly,thin,tiny,tube,ud,unit,vary,way,yellow,ympodial	5-merous,age,apart,appressed,arrangement,articulation,bark,bud,colour,form,hair,inflated,leaf,length,marking,mature,na,number,odour,orientation,ovary,paler,position,present,seed,shape,spot,symmetry,texture,type	.5,0.5-1,0.5-10,0.75-1.5,1,1-1.2,1-1.5,1-3.5,1.2-1.5,1.5-2,4-6,4.5-5,5,50-100,7-10,acute,alfway,almost,along,apex,articulated,base,becoming,beginning,berry,bifid,black,branched,brown,c.,capitate,cell,chartaceous,clustered,cm,completely,connivent,cuneate,dark,dendritic,diameter,drying,dull,ellipsoid,elliptic,entire,extending,flattened-reniform,fleshy,flower,glabrous,globose,herbarium,irregularly,lamina,lax,leaving,lengthening,lilac,lobed,long,loose,loosely,many,margin,matte,minutely,mm,narrowly,near,occasionally,often,outline,peg,perfect,pitted,pore,poricidal,prominent,pubescent,reddish,revolute,round-rectangular,sagittate,shrub,simple,sleeve,slit,spaced,sparsely,specimen,stellate,stellate-pentagonal,tangled,terminal,testal,time,tip,trichome,twining,usually,vein,vine,woody,x	5-merous,age,apart,na,paler,present
435	wfo-0001031007	success	204	181	100	122	82	59	95	5	.5,0.2,0.5-1,0.5-10,0.75-1.5,1,1-1.2,1-1.5,1-3.5,1.2-1.5,1.5-2,1.6-2,15,3-4,4-6,4.5-5,5,5.5-6,6,7-10,<,acute,alfway,almost,along,anther,apex,articulated,bark,base,becoming,beginning,berry,bifid,black,branching,broad,brown,c.,calyx,capitate,cell,chartaceous,clustered,cm,completely,corolla,cuneate,dendritic,densely,diameter,ellipsoid,elliptic,entire,extending,filament,flattened,fleshy,fruit,fruiting,glabrous,globose,growth,inflorescence,irregularly,lamina,lax,leaving,lilac,lobe,long,loose,lower,many,margin,mm,narrowly,near,new,occasionally,often,papillate,pedicel,peduncle,peg,per,perfect,petiole,pore,poricidal,prominent,pubescent,reddish,reniform,revolute,sagittate,scar,shrub,simple,sleeve,spaced,sparsely,stellate,stellate-rotate,stem,stigma,style,surface,tall,tangled,terminal,time,tip,trichome,tube,unit,upper,usually,vein,vine,wide,woody	0.5,1.3-2.5-5,1.9-3,1/3,11-14,2.5-5-12,4-7,5-merou,50-100,8-10,abaxially,abruptly,adaxial,ag,alyx,anthesi,apar,apparently,branched,broadly,campanulate,cup-shaped,dark,deltate,dilated,drying,dull,eaf,eed,exserted,flower,free,glabrescen,glabrou,herbarium,ilament,impressed,intramarginal,junction,lengthening,lobed,looping,m.,markedly,matte,midvein,minutely,multi-celled,narrowing,nflorescence,nodding,older,orolla,outline,pale,papillat,pericarp,pitted,planar,plurifoliat,portion,primary,rat,round-rectangular,ruit,shiny,slender,slightly,slit,specimen,splitting,spreading,stout,strongly,testal,thin,tiny,twinin,ud,vary,way,ympodial	apart,appressed,articulation,bract,breeding,broad-based,bud,colour,connective,form,glabrescent,hair,height,heteromorphism,inflated,insertion,interjected,interpetalar,leaf,leaflet,length,lobing,marking,mature,modification,na,needle-like,number,odour,orientation,ovary,paired,pattern,placement,plant,plurifoliate,position,present,prickle,pseudostipule,rhizome,scale,seed,shape,smell,spot,staman,stone,structure,symmetry,sympodial,system,texture,tissue,tuber,type,vegetative,width,xylopodia	.5,0.2,0.5-1,0.5-10,0.75-1.5,1,1-1.2,1-1.5,1-3.5,1.2-1.5,1.5-2,1.6-2,15,3-4,4-6,4.5-5,5,5.5-6,6,7-10,<,acute,alfway,almost,along,apex,articulated,base,becoming,beginning,berry,bifid,black,broad,brown,c.,capitate,chartaceous,clustered,cm,completely,cuneate,dendritic,densely,diameter,ellipsoid,elliptic,entire,extending,flattened,fleshy,glabrous,globose,irregularly,lamina,lax,leaving,lilac,long,loose,many,margin,mm,narrowly,near,occasionally,often,papillate,peg,perfect,poricidal,prominent,pubescent,reddish,reniform,revolute,sagittate,shrub,simple,sleeve,spaced,sparsely,stellate,stellate-rotate,tall,tangled,terminal,time,tip,trichome,usually,vein,vine,wide,woody	apart,glabrescent,na,plurifoliate,present
436	wfo-0001031036	success	150	175	100	114	36	61	96	4	.2,.25,.5,0.8-1,0.8-1.2,1-1.3,1-2.5,1.2-1.5,1.5-3,10-20-flowered,12-15,2-2.5,2.2-3.7,3-4,3.5-5.5,4.5-6.5,5-6,7-8,abaxially,acuminate,acute,adaxially,along,angle,anther,anthesi,apex,axil,base,berry,bi-lobed,brown,calyx,closely,cm,corolla,crisped,dark,decurrent,deflexed,dia,difoliate,dry,ellipsoid,elliptic,enlarged,erect,exserted,filament,flattened-reniform,fleshy,fresh,fruiting,glabrous,globose,green,greenish-white,knob-like,lateral,leaf,lobed,long,main,major,margin,material,middle,minor,minutely,mm,nearly,oblique,older,onto,opposite,ovary,pair,papillose,pedicel,perhaps,petiole,pitted,pointed,pore,poricidal,sagittate,scar,shaped,shiny,shrub,simple,size,slightly,spaced,stem,stigma,strongly,style,surface,tear-drop,thickened,tip,trichome,tube,uniseriate,unit,usually,vein,white,widest,winged,woody,x,young	0.5-1,3-5,arising,ba,becoming,broadly,conical,differing,drying,eaf,edicel,eed,filiform,free,geminat,lamina,lobe,lon,lower,nflorescence,overlappin,papillo,planar,portion,rounded,ruit,short,sinus,soon,spathulate,tall,tapering,tub,ud,yellowish,ympodial	appressed,articulation,bract,branching,breeding,bud,cell,colour,connective,diameter,exsertion,flower,form,fruit,geminate,growth,hair,height,heteromorphism,inflated,inflorescence,insertion,interjected,interpetalar,leaflet,length,lobing,marking,mature,modification,na,number,odour,orientation,overlapping,paired,pattern,placement,plant,position,prickle,pseudostipule,rhizome,scale,seed,shape,spacing,spot,staman,stellate,stone,structure,symmetry,sympodial,system,texture,tissue,tuber,type,width,xylopodia	.2,.25,.5,0.8-1,0.8-1.2,1-1.3,1-2.5,1.2-1.5,1.5-3,10-20-flowered,12-15,2-2.5,2.2-3.7,3-4,3.5-5.5,4.5-6.5,5-6,7-8,abaxially,acuminate,acute,adaxially,along,angle,axil,base,berry,bi-lobed,brown,calyx,closely,cm,crisped,dark,decurrent,deflexed,dia,difoliate,dry,ellipsoid,elliptic,enlarged,erect,exserted,flattened-reniform,fleshy,fresh,glabrous,globose,green,greenish-white,knob-like,lateral,leaf,lobed,long,main,margin,material,middle,minutely,mm,nearly,oblique,onto,opposite,pair,papillose,perhaps,petiole,pitted,pointed,poricidal,sagittate,shaped,shiny,shrub,simple,slightly,spaced,stem,strongly,surface,tear-drop,thickened,tip,trichome,tube,uniseriate,usually,vein,white,widest,winged,woody,x	geminate,na,overlapping,stellate
437	wfo-0001031064	success	179	90	32	45	134	45	30	2	.5,1-2,2.5-3,3.5-4,anther,apex,attenuate,base,berry,calyx,cell,cm,conical,corolla,elongate,filament,fruit,fruiting,green,inflorescence,leaf,leaflet,lightly,lobed,long,margin,mm,nearly,pair,pedicel,petiole,pinnate,poricidal,pubescent,purple,rugose,shrub,simple,sparsely,tip,trichome,uniseriate,unit,white,x	.0-2.5,.05,.5-1,0,0-15,0.5,0.5-0.7,0.5-0.8,1,1-1.2,1-3,1.2,1.5-2,1.7-4.2,10-12,10-12.5,10-17,2,3,3-5.5,3-7,4-5-celled,5-10.5,5-6,6-16,7-16,8-10-celled,abaxially,acroscopic,acuminate,adaxially,along,anthesi,anticlinal,arising,axil,basal,bearing,blade,bright,broader,clavat,commentary,completely,conspicuous,dark,deltate,densely,denser,diameter,distal,dr.,eaf,edicel,eed,epidermal,erec,exserted,fleshy,flower,free,glabrous,globose,half,highly,irregular,irregularly,lamina,lateral,leave,lenticel,like,lobe,lon,lost,lower,minute,minutely,narrower,near,nflorescence,nodding,node,obovate,occasionally,often,open,ovary,ovate,ovoid-reniform,papillate,per,petiolule,planar,portion,projection,prominent,pubescen,rachi,ruit,scar,scattered,see,short-pubescent,side,single,sinuous,sinus,slender,smaller,somewhat,splitting,stem,stigma,strongly,style,surface,swollen,tal,tem,terminal,thickening,time,translucent,tub,tube,ud,unifoliat,usually,vein,wand-like,winged,without,ympodial	appressed,articulation,bract,branching,breeding,colour,connective,form,growth,hair,heteromorphism,inflated,insertion,interjected,interpetalar,length,marking,mature,modification,na,odour,orientation,paired,pattern,placement,pore,position,prickle,pseudostipule,rhizome,scale,shape,spot,staman,stone,structure,symmetry,sympodial,system,texture,tissue,tuber,type,unifoliate,xylopodia	.5,1-2,2.5-3,3.5-4,attenuate,base,berry,cm,conical,elongate,green,lightly,lobed,long,mm,nearly,pair,pinnate,poricidal,pubescent,purple,rugose,shrub,simple,sparsely,tip,trichome,uniseriate,white,x	na,unifoliate
438	wfo-0001031071	success	186	147	69	95	91	52	66	3	0-10,0.2-0.8,1-2,1-3,1.5-2.2,2-5,2-8,2.1-3,2.4-3.4,3-10,3.8-5.4,4-25,4-6,5-9.4,6-8,7-16.5,7-8,8-28,anther,apex,base,berry,blade,blue,brownish,cell,clavate,cm,color,condition,coriaceous,corolla,dark,deep,diameter,drying,filament,flower,forked,fresh,fruit,glabrous,globose,green,green-white,greenish,herb,homostylous,interjected,lanceolate,lateral,leaf,leaflet,lilac,lobe,long,medium,mm,moniliform,mottled,mucilaginous,odd-pinnate,ovate,ovoid,pair,pedicel,peduncle,pentagonal,petiole,plant,plurifoliate,pore,poricidal,purple,rotate,seed,size,slightly,spot,star,stigma,straight,style,terminal,throughout,tip,tissue,tri-,tube,tuber,unit,wet,white,whitish,x	0.4-2,1-1.5,1-7,2-3,3-5,3-6,5-merou,5.7-8.8,abaxiall,abaxially,acumen,acute,adaxially,ag,along,alyx,apart,apparently,arranged,articulated,asymmetric,attenuate,axe,axillary,basiscopic,bead,bud,capitat,connivent,covering,decreasing,digestion,distal,dorsally,eaf,edge,eed,elliptic,enzyme,erec,exceeding,flat,folded,geminat,generally,glabrou,hair-like,half,honeycomb-shaped,lengthening,like,living,lower,make,middl,multiple,narrowly,necklace,nflorescence,orbicular,orolla,perfect,petiolulate,removed,ripe,round,ruit,sessile,seudostipule,short,side,slit,spaced,specimen,stamen,stolon,subequal,subtending,tall,tamen,tem,testal,thick,toward,typically,usually,vary,wall,winged,yellow,ympodial	abaxial,adaxial,appressed,arrangement,articulation,bract,branching,breeding,calyx,capitate,colour,connective,form,fruiting,growth,hair,height,heteromorphism,inflated,inflorescence,insertion,interpetalar,length,margin,marking,mature,middle,modification,na,number,odour,orientation,ovary,paired,pattern,placement,position,prickle,pseudostipule,rhizome,scale,shape,staman,stem,stone,structure,symmetry,sympodial,system,texture,type,xylopodia	0-10,0.2-0.8,1-2,1-3,1.5-2.2,2-5,2-8,2.1-3,2.4-3.4,3-10,3.8-5.4,4-25,4-6,5-9.4,6-8,7-16.5,7-8,8-28,berry,blue,brownish,clavate,cm,color,condition,coriaceous,dark,deep,drying,forked,fresh,glabrous,globose,green,green-white,greenish,herb,homostylous,lanceolate,lilac,long,medium,mm,moniliform,mottled,mucilaginous,odd-pinnate,ovate,ovoid,pentagonal,plurifoliate,poricidal,purple,rotate,slightly,spot,star,straight,terminal,throughout,tip,tri-,wet,white,whitish,x	capitate,middle,na
439	wfo-0001031097	success	174	129	79	79	95	50	68	11	1,1-4,4-6,5-11,abaxial,abaxially,adaxially,along,apex,apical,apically,articulate,base,branched,calyx,cell,cm,connate,corolla,cuneate,darker,deep,dehiscent,dichasially,distal,dotted,ebracteate,edge,filament,generally,green,hair-like,half,herbaceous,interjected,interpetalar,introrse,leaf,leaflet,light,lighter,long,lower,margin,maturing,medium,mm,mottled,narrow,oblique,odd-pinnate,often,ovoid,pattern,pedicel,pentagonal,perennial,perfect,petal,petiole,plant,poricidally,proximal,puberulent,pubescent,purple,rarely,rotate,short,side,slit,sometimes,strigose,tuber-bearing,typically,unit,violet,violet-blue,¼	0.45,0.5,1-3,1-4.5,1.5,1.6-5.5,1.8-2.5,1.8-2.6,13-30,2-3,2-3.3,2-4,3-5,3-6-foliat,3.5-6,3.7-8.4,4-7,5-12,5-9,8-11,9-21,acumen,acuminate,acute,covering,cyme,decurrent,diameter,dichasial,digestion,diminishing,dorsally,eaf,eed,elliptical,emoval,enzyme,exceeding,flat,flower,folded,forked,frequently,globo,gree,green-white,highly,honeycomb,lateral,living,lobe,lon,lunat,make,monochasial,mucilaginous,nflorescence,noticeably,nther,obovate,orolla,ovate,pair,peduncle,petiolulate,petiolule,plan,rachi,rapidly,reveal,ruit,seed,sessile,seudostipule,size,specimen,stamen,stigma,straight,style,tal,tem,terminal,testal,thick,throughout,tissu,toward,vary,vbase,wall,wide,without,yellow,ympodial	2,3-6-foliate,anther,articulation,bract,branching,breeding,broad-based,colour,connective,form,fruit,fruiting,growth,hair,heteromorphism,inflorescence,insertion,length,lunate,marking,modification,na,needle-like,odour,orientation,paired,placement,pore,position,prickle,pseudostipule,rhizome,scale,shape,spot,staman,stem,stone,structure,surface,symmetry,sympodial,system,texture,tissue,tuber,type,xylopodia,zygomorphy	1,1-4,4-6,5-11,abaxial,abaxially,adaxially,along,apical,apically,articulate,branched,cm,connate,cuneate,darker,deep,dehiscent,dichasially,distal,dotted,ebracteate,edge,generally,green,hair-like,half,herbaceous,interpetalar,introrse,leaf,light,lighter,long,lower,margin,maturing,medium,mm,mottled,narrow,oblique,odd-pinnate,often,ovoid,pattern,pentagonal,perennial,perfect,petal,plant,poricidally,proximal,puberulent,pubescent,purple,rarely,rotate,short,side,slit,sometimes,strigose,tuber-bearing,typically,violet,violet-blue,¼	2,3-6-foliate,broad-based,lunate,na,needle-like,prickle,stem,surface,tissue,zygomorphy
440	wfo-0001031101	success	191	145	84	100	91	45	80	4	-5,/2,/2-equal,0.5-0.8,0.5-3,0.8-1-2.3,1-2,1-2-5-8,1.4-1.7,1/4-1/2,10-30,2-6,2.5-4-10-16,3-15,3.5-4.5,4-5-merous,4.5-9,abaxial,acuminate,adaxial,almost,anther,apex,apical,apparently,articulated,bark,base,berry,branched,bright,calyx,cm,connivent,difoliate,elongating,entire,erect,evenly,filament,flower,fruiting,glabrescent,glabrous,glandular,green,green-brown,hair,lateral,leaf,length,lobed,long,long-acute,lower,margin,mature,maturity,mauve,membranous,minute,mm,moderately,multangulate,obtuse,often,orange-red,ovate,pale,pedicel,peduncle,petiole,poricidal,porrect,red,rounded,sessile,shrub,simple,sparsely,spherical,stalked,stellate,stellate-pubescent,stem,style,surface,tapering,terete,terminal,tip,trichome,unarmed,unit,variously,way,white,wide,yellow-green,young	-20,-8,0.05-0.2,0.1-0.2,0.1-0.3,0.3-0.5,0.6-0.8-1,0.7-0.8,1-3,1.3-2,1.3-2.5,1.5-3,1/3-1/2,2-2.8,2-4,2.5-3.5,2.5-3.8,3-10,3-8,4-7,5-20-30,5-6,6-10-20,8-15-30,abaxially,alyx,ame,apar,apically,ba,blade,c.,concolorous,deltate,diameter,drying,dull,eaf,eed,equal,filiform,flattened-reniform,free,frui,geminat,herbaceous,infructescence,lobe,long-acuminat,longer,midpoint,narrow-deltate,near,nflorescence,older,one,open,orange-brown,orolla,oung,pair,pendulous,per,perfec,pericarp,portion,primary,ray,red-brow,resembling,ruit,scandent,scar,smooth,spaced,spreading,stalk,stellate-pubescen,straight,tamen,tertiary,time,tube,umbel,unarme,vary,vein,venation,visible,yellow,ympodial	appressed,armament,articulation,branching,breeding,broad-based,cell,colour,corolla,form,fruit,geminate,growth,height,heteromorphism,inflated,inflorescence,marking,modification,na,needle-like,number,odour,orientation,ovary,placement,plant,pore,prickle,pseudostipule,red-brown,rhizome,shape,size,spot,staman,stone,structure,symmetry,sympodial,system,texture,tuber,type,xylopodia	-5,/2,/2-equal,0.5-0.8,0.5-3,0.8-1-2.3,1-2,1-2-5-8,1.4-1.7,1/4-1/2,10-30,2-6,2.5-4-10-16,3-15,3.5-4.5,4-5-merous,4.5-9,acuminate,almost,apical,apparently,articulated,base,berry,branched,bright,cm,connivent,difoliate,elongating,entire,erect,evenly,glabrescent,glabrous,glandular,green,green-brown,hair,lateral,length,lobed,long,long-acute,mature,maturity,mauve,membranous,minute,mm,moderately,multangulate,obtuse,often,orange-red,ovate,pale,poricidal,porrect,red,rounded,sessile,shrub,simple,sparsely,spherical,stalked,stellate,stellate-pubescent,tapering,terete,terminal,tip,unarmed,variously,way,white,wide,yellow-green,young	fruit,geminate,na,red-brown
441	wfo-0001031114	success	208	181	106	123	85	58	100	6	.2,.5,0.5,0.5-1,0.7-1.5,0.8-1.2,1-10,1-7,1.5-4,2-17,2-3,2-4,2-7,2.5-3,2/3,3-10,3-4,4-10,4.5-6,6-7,abaxially,accrescent,acute,adaxially,anther,apex,base,becoming,berry,branched,brown,calyx,chartaceous,cm,connivent,cylindrical,dark,deltate,densely,diameter,directed,distal,distally,echinoid,elliptic-ovate,entire,especially,filament,first,flattened,fleshy,flower,fruit,fruiting,geminate,glabrous,globose,green,hair,homostylous,interpetalar,introrsely,large,leaf,leaf-opposed,light,lobe,longitudinal,lower,margin,membanaceous,mm,multangulate,nearly,oblong,obtuse,opening,outline,ovate,paired,pedicel,peduncle,petiole,plurifoliate,pore,porrect,purple,rachi,reniform,ripe,rounded,rugulose,shrub,simple,slightly,slit,small,somewhat,sparsely,stellate,stellate-pubescent,stem,stigma,straight,strongly,style,subcoriaceous,subcuneate,surface,thickened,tip,tissue,toward,tree,truncate,tube,unit,white,white-pubescent,without,x,yellow,yellowish	.1,0-0.3,0.3-0.5,1-1.5,1-2,1-4.5,1-8,1.5-2.5,10-15,25-50,3-5,3-7,4-5,4-8,5-10,5-8,5-merou,7-15,absen,acuminate,adaxiall,ag,alyx,apart,apparently,articulated,axe,ba,blade,capitat,covering,differentiated,discolorous,dried,eaf,eed,equal,erect,free,frui,highly,impressed,juic,lacking,like,long,long-stalked,major,midpoint,minor,nflorescence,nodding,often,one,orolla,part,perfect,pericarp,prominent,pubescent,ray,ruit,sessile,short,short-,short-stalked,side,spaced,stalk,ste,subcucullate,subtending,tall,tamen,tem,thin,time,triangular,unarme,vary,vein,white-stellate,whitish,wide,ympodial	5-merous,age,appressed,articulation,bract,branching,breeding,broad-based,capitate,cell,colour,connective,corolla,form,growth,height,heteromorphism,inflated,inflorescence,insertion,interjected,leaflet,length,marking,mature,modification,na,needle-like,odour,orientation,ovary,pattern,placement,plant,position,prickle,pseudostipule,rhizome,scale,seed,shape,size,smell,spot,staman,stone,structure,symmetry,sympodial,system,texture,trichome,tuber,type,unarmed,vegetative,xylopodia,ye	.2,.5,0.5,0.5-1,0.7-1.5,0.8-1.2,1-10,1-7,1.5-4,2-17,2-3,2-4,2-7,2.5-3,2/3,3-10,3-4,4-10,4.5-6,6-7,abaxially,accrescent,acute,adaxially,apex,base,becoming,berry,branched,brown,chartaceous,cm,connivent,cylindrical,dark,deltate,densely,diameter,directed,distal,distally,echinoid,elliptic-ovate,entire,especially,first,flattened,fleshy,geminate,glabrous,globose,green,hair,homostylous,introrsely,large,leaf-opposed,light,longitudinal,margin,membanaceous,mm,multangulate,nearly,oblong,obtuse,opening,outline,ovate,plurifoliate,porrect,purple,reniform,ripe,rounded,rugulose,shrub,simple,slightly,slit,small,somewhat,sparsely,stellate,stellate-pubescent,straight,strongly,subcoriaceous,subcuneate,thickened,tip,toward,tree,truncate,white,white-pubescent,without,x,yellow,yellowish	5-merous,age,capitate,na,unarmed,ye
442	wfo-0001031116	success	191	141	80	90	101	51	76	4	.5,/4,0-10,0.05-0.15,1/6-1/4,3.5-4,4-7,9-13,almost,anther,apex,apparently,arachnoid,articulated,attenuate,base,berry,blade,branching,bristle,calyx,cm,collapsed,connivent,discolorous,drying,elongating,epidermi,erect,filament,flat,fragile,fruit,fruiting,glaucous-green,hair,lateral,leaf,length,lobed,long,lower,margin,mature,mauve,membranous,mm,moderately,multangulate,obtuse,orange-red,pair,pedicel,petiole,poricidal,primary,recurved,red-brown,reflexed,rounded,secondary,sessile,shrub,simple,slender,small,sometimes,sparsely,spherical,stalked,stellate,stellate-pubescent,stem,straight,style,subentire,surface,tapering,tertiary,tip,tree,trichome,unarmed,unit,upper,vein,venation,visible,way,weakly	.2,.8,0,0.1,0.3-0.5,0.4-0.7,0.7-0.9,0.7-1,1,1-5,1/2,1/3-2/,10-14,15-25,2-5,2.7-3.2,30-100,30-50,4-10,5,5-15,5-merous,8-11,abaxial,abaxially,acuminate,adaxial,alyx,ame,apar,apart,apically,bark,broad-deltate,brow,c.,caudate,clearly,densely,diameter,dirty-white,dull,eaf,eed,elliptic,elongated,equal,evenly,flattened-reniform,flexuous,flower,free,glabrescent,glabrous,green,infructescence,less,lobe,longer,maturity,midpoint,minute,narrow-deltate,nflorescence,obovate,obtu,often,older,one,open,orange-brown,orolla,oung,peduncle,per,perfec,pericarp,perpendicular,plurifoliat,portion,ray,ruit,scar,sharply,shortly,single,smooth,soft,spaced,stalk,tamen,terete,time,tube,unarme,vary,wide,woody,yellow,ympodial,young	appressed,articulation,bract,breeding,broad-based,cell,colour,connective,corolla,form,growth,heteromorphism,inflated,inflorescence,insertion,interjected,interpetalar,leaflet,marking,modification,na,needle-like,odour,orientation,pattern,perfect,placement,plurifoliate,pore,position,prickle,pseudostipule,rhizome,scale,shape,smell,spot,staman,stone,structure,symmetry,sympodial,system,texture,tissue,tuber,type,vegetative,width,xylopodia,zygomorphy	.5,/4,0-10,0.05-0.15,1/6-1/4,3.5-4,4-7,9-13,almost,apparently,arachnoid,articulated,attenuate,base,berry,blade,branching,bristle,cm,collapsed,connivent,discolorous,drying,elongating,epidermi,erect,flat,fragile,fruit,glaucous-green,lateral,leaf,length,lobed,long,mature,mauve,membranous,mm,moderately,multangulate,obtuse,orange-red,pair,poricidal,primary,recurved,red-brown,reflexed,rounded,secondary,sessile,shrub,simple,slender,small,sometimes,sparsely,spherical,stalked,stellate,stellate-pubescent,straight,subentire,surface,tapering,tertiary,tip,tree,trichome,unarmed,vein,venation,visible,way,weakly	na,perfect,plurifoliate,zygomorphy
443	wfo-0001031128	success	208	85	46	52	156	33	41	5	/4,0.5-0.8,anther,apex,base,berry,branched,branching,calyx,cm,concolorous,cuneate,drying,elliptic,elongating,entire,equal,evenly,filament,fruit,fruiting,green,inflorescence,lateral,leaf,length,lobed,long,margin,mature,maturity,mauve,membranous,mm,pale,petiole,poricidal,purple-black,red,shallowly,short-attenuate,shrub,simple,spherical,tapering,terminal,tip,undulate,unit,way,white,young	0,0-10,0-30,0.05-0.2,0.05-0.25,0.2,0.2-0.4,0.3-0.8,0.5-0.7,0.5-1.5,0.5-5,0.6-1,0.8-1.7,1,1-1.6,1-2-5-6.5,1.2-2,1.5-3,1.5-3.5,1/,1/6-1/3,10-35,2-9.5,2.3-3-4-4.5,2.5-10,2.5-3.5,20-50,20-60-100,3-4,3.5-4.5,4-5-merous,4-7,5-10-20,5-15,5-19,5-30,8-12,8-23,abaxial,abaxially,acute,almost,alyx,apar,apart,ape,apically,apparently,articulated,bark,blade,bristle,brown,connivent,deltate,densely,diameter,dull,eaf,eed,elongated,erect,eye,filiform,flattened-reniform,flexuous,flower,free,glabrescent,glabrous,gland,glandular,gra,hair,infructescence,less,lobe,lon,long-acuminat,long-acuminate,longer,lower,midpoint,minute,moderately,multangualte,multangulate,naked,narrow-deltate,near,nflorescence,occasionally,often,older,one,open,orange-brown,orolla,oung,pair,pedicel,peduncle,per,perfect,pericarp,perpendicular,plurifoliat,portion,primary,ray,recurved,red-brown,reduced,reflexed,ruit,scar,secondary,sessile,short-styled,side,single,smooth,soft,spaced,spreading,stalk,stalked,staminate,stellate,stellate-pubescent,stem,straight,style,surface,tamen,terete,tertiary,time,trichome,tube,unarme,unarmed,usually,variously,vary,vein,venation,visible,weakly,whitish,wide,woody,yellow,yellow-brown,yellow-green,ympodial	1-6.5,2.3-4.5,bract,cell,colour,corolla,form,growth,heteromorphism,interjected,interpetalar,leaflet,na,odour,orientation,placement,plurifoliate,position,prickle,pseudostipule,rhizome,shape,staman,stone,structure,symmetry,sympodial,texture,tissue,tuber,type,xylopodia,zygomorphy	/4,0.5-0.8,base,berry,branched,cm,concolorous,cuneate,drying,elliptic,elongating,entire,equal,evenly,fruit,green,lateral,length,lobed,long,mature,maturity,mauve,membranous,mm,pale,poricidal,purple-black,red,shallowly,short-attenuate,shrub,simple,spherical,tapering,terminal,tip,undulate,way,white,young	1-6.5,2.3-4.5,na,plurifoliate,zygomorphy
444	wfo-0001031135	success	187	190	111	126	61	64	108	3	0-2,0.5-2,0.7-2,1-1.5,1-10,1-3,1-4,1.5-2,1.5-3,1.5-9,10-20,2,2-2.5,2-23,2-3,2-3.5,2-4,2-5-9-pinnate,2.5-28,3-4,3-5,3.5-12,4-5,5-30,abaxially,acuminate,acute,adaxially,adpressed,also,apex,articulated,basal,base,broad,calyx,campanulate,cell,cm,compound,connective,cordate,cuneate,cylindrical,darker,deltate,densely,diameter,dilated,directed,distally,eglandular-pubescent,ellipsoidal,entire,equal,exceeding,fading,flattened,flower,frequently,fruit,fusiform,glandular-,green,hair,laterally,leaf,leaflet,leaving,light,lobe,lobed,long,longitudinal,lower,margin,mm,moderately,narrowed,obconical,oblong,obtuse,often,ovoid,pedicel,pedicellar,peduncle,peltiform,perfect,petiole,pilose,pink,pinnately,pinnatifid,pore,puberulent,pubescent,purple,rachi,radiu,remnant,ripe,shorter,shrub,simple,slightly,sparsely,stigma,stone,stripe,strongly,style,subcoriaceous,thecae,tip,tree,truncate,unbranched,unit,unlobed,violet,white,whitish,x,yellow-green,yellowish	-7,1-2.5,1-3-10,2-5,4-foliat,5-11,7-15,absent,aggregate,along,apart,ape,axe,basiscopically,beyond,biglandula,blade,chartaceous,color,coriaceous,decurrent,deflexed,eaf,eed,ellipsoida,elliptic,especially,exserted,glabrous,interstitial,irregularly,lateral,lon,midrib,nflorescence,nther,oblique,occasionally,orolla,ovate,papillose,pilo,present,ruit,small,smaller,spaced,stamen,tal,tem,time,tomento,toward,triangular,tube,ud,unknow,upper,vary,wide,ympodial	4-foliate,anther,appressed,arrangement,articulation,biglandular,bract,branching,breeding,broad-based,bud,colour,corolla,filament,form,fruiting,growth,height,heteromorphism,inflated,inflorescence,insertion,interjected,interpetalar,length,marking,mature,modification,na,needle-like,odour,orientation,ovary,paired,pattern,placement,plant,position,prickle,pseudostipule,rhizome,scale,seed,shape,size,smell,spot,staman,stellate,stem,structure,surface,symmetry,sympodial,system,texture,theca,tissue,trichome,tuber,type,vegetative,xylopodia,zygomorphy	0-2,0.5-2,0.7-2,1-1.5,1-10,1-3,1-4,1.5-2,1.5-3,1.5-9,10-20,2,2-2.5,2-23,2-3,2-3.5,2-4,2-5-9-pinnate,2.5-28,3-4,3-5,3.5-12,4-5,5-30,abaxially,acuminate,acute,adaxially,adpressed,also,apex,articulated,basal,base,broad,campanulate,cm,compound,cordate,cuneate,cylindrical,darker,deltate,densely,diameter,dilated,directed,distally,eglandular-pubescent,ellipsoidal,entire,equal,exceeding,fading,flattened,frequently,fruit,fusiform,glandular-,green,laterally,leaving,light,lobe,lobed,long,longitudinal,mm,moderately,narrowed,obconical,oblong,obtuse,often,ovoid,pedicellar,peltiform,perfect,pilose,pink,pinnately,pinnatifid,puberulent,pubescent,purple,remnant,ripe,shorter,shrub,simple,slightly,sparsely,stripe,strongly,style,subcoriaceous,thecae,tip,tree,truncate,unbranched,unlobed,violet,white,whitish,x,yellow-green,yellowish	4-foliate,biglandular,na
445	wfo-0001031144	success	227	141	84	106	121	35	82	2	.2,.5,0.8-1.4,1-1.5,1-4,2-3,2-6,2/3,25,3-7,4,6,acute,adaxially,anther,apart,apex,articulated,asymmetric,base,berry,branch,bright,broadly,brown,calyx,cell,closer,cm,connivent,cordate,corolla,diameter,divaricate,ellipsoid,elliptic,filament,form,four,fruiting,glabrous,globose,groove,growth,inflated,inflorescence,later,lateral,leaf,leaflet,lobed,longest,loosely,lower,many,margin,membranous,mm,near,new,number,oblique,occasionally,open,pair,pale,pedicel,peduncle,petiole,pinnately,pinnatifid,plurifoliate,pore,poricidal,pubescent,red,reddish,ripe,scar,shiny,simple,sleeve,slightly,small,sparsely,stellate-rotate,stem,surface,terete,terminal,tiny,tip,together,triangular,trichome,truncate,uniseriate,unit,upper,vine,violet,way,white,woody,x,½	0.2,0.5,1-2-9-11,1.1-2.5,100,2,2-3.5-10-13,2.5-3,3-4.5,4-20,4-4.5,4-6,5,5-9,5-merou,7-10,<,acuminate,ag,alyx,anthesi,apicula,apiculae,appearing,ark,around,away,axi,basal,basiscopically,blac,branche,brow,capitate,commonly,corresponding,cupped,curved,densely,drying,eaf,eed,elongate,elongating,entire,exserted,extending,flattened,flattened-reniform,flower,free,geminat,ilament,irregularly,lamina,larger,leaving,lengthening,less,like,lobe,long,longer,markedly,mere,minute,minutely,nflorescence,often,older,one,orolla,outline,papillo,peg,pendant,pentagonal,per,perfect,pericarp,pitted,portion,primary,progress,quite,rim,ruit,seed,slit,smaller,sometimes,spaced,spreading,stigma,strongly,style,tan,tangle,tem,testal,thin,third,tube,tuft,twinin,twining,two,ud,unequal,usually,variable,vary,vein,wall,weight,widest,wing,wood,yellow,yellowish,ympodial	arrangement,articulation,bark,branching,breeding,bud,colour,connective,fruit,geminate,hair,heteromorphism,length,marking,modification,na,odour,orientation,placement,position,prickle,rhizome,shape,spacing,spot,staman,stone,structure,symmetry,sympodial,system,texture,tuber,type,xylopodia	.2,.5,0.8-1.4,1-1.5,1-4,2-3,2-6,2/3,25,3-7,4,6,acute,adaxially,apart,apex,articulated,asymmetric,base,berry,branch,bright,broadly,brown,closer,cm,connivent,cordate,divaricate,ellipsoid,elliptic,four,glabrous,globose,groove,inflated,inflorescence,later,lateral,lobed,longest,loosely,many,membranous,mm,near,oblique,occasionally,open,pair,pale,pinnately,pinnatifid,plurifoliate,poricidal,pubescent,red,reddish,ripe,shiny,simple,sleeve,slightly,small,sparsely,stellate-rotate,terete,terminal,tiny,tip,together,triangular,trichome,truncate,uniseriate,vine,violet,way,white,woody,x,½	geminate,na
446	wfo-0001031152	success	232	112	71	86	146	26	67	4	-10,0.2-1.5,0.3-1.3,1-1.5,1-6,1.2-1.8,11,2.7-3.7,4-19,4-8,5-6,8-20,abaxially,accrescent,acute,adaxially,anther,apical-lateral,attenuate,base,becoming,berry,blunt-tipped,branch,branched,bud,bullate,calyx,cm,corolla,diameter,entire,extend,filament,fleshy,flower,fruit,fruiting,globose,greenish,growth,hair,introrse,lanceolate,large,lateral,lavender,leaf,length,lilac,longitudinal,margin,mixed,mm,multangulate,oblanceolate,oblong,openly,pale,pedicel,peduncle,petiole,plurifoliate,pore,porrect-stellate,probably,rachi,ripe,rotate-stellate,scabrous,sessile,short-,shrub,simple,slit,somewhat,stellate-pubescent,terminal,thick-stalked,time,tree,unit,violet,x,yellow,young	-1.5,-5.5,.4,/100-1/16,0-100,0.2-0.3,0.3-3,1-3,1.1-2.2,1.1-3,1.3-4,1.4-2.6,1.5-3,1.5-3.5,1/2-2/3,1/2-3/4,13-27,2-5,2.5-7.5,2.7-4.5,2.7-6,2.8-4,3.7-7,4-6,4-7,6.5-10,9-13,acuminate,ag,along,anthesi,apart,apex,apparently,articulated,axe,axillary,ba,basal,blade,blister,brown,capitat,chartaceous,closely,conical,continued,decurrent,dehiscing,deltoid,densely,directed,due,eaf,earl,eed,evident,exserted,few-rayed,free,glabrescen,glabrous,granular-tomentose,green,high,honeycombed,inserted,lackin,less,lobe,lobed,long,long-,longer,lower,m.,main,midvein,moderately,mostly,multangulat,narrowly,nearly,nflorescence,obtuse,occasionally,one,open,orbicular,orolla,ovate,partly,perfect,persistently,pitted,pubescent,rather,ray,reddish,reddish-brown,relatively,reniform,reticulate-punctate,ruit,runk,short-stalked,side,slightly,soon,spaced,sparingly,sparsely,splitting,stamen,stelliform,stem,stigma,stipitate-glandular,stout-stalked,strongly,style,suborbicular,surface,suture,swelling,tamen,terete,testa,thick,thin,thin-,thin-stalked,tomentose,touching,toward,tube,unarme,unarmed,usually,variously,vary,vein,way,wide,yellowish,ympodial	age,arrangement,branching,cell,colour,form,glabrescent,height,heteromorphism,inflorescence,marking,na,odour,plant,position,shape,spot,staman,stone,structure,symmetry,sympodial,texture,trunk,type,zygomorphy	-10,0.2-1.5,0.3-1.3,1-1.5,1-6,1.2-1.8,11,2.7-3.7,4-19,4-8,5-6,8-20,abaxially,accrescent,acute,adaxially,apical-lateral,attenuate,becoming,berry,blunt-tipped,branched,bullate,cm,entire,extend,fleshy,flower,fruit,globose,greenish,introrse,lanceolate,large,lateral,lavender,lilac,longitudinal,mixed,mm,multangulate,oblanceolate,oblong,openly,pale,plurifoliate,pore,porrect-stellate,probably,ripe,rotate-stellate,scabrous,sessile,short-,shrub,simple,slit,somewhat,stellate-pubescent,terminal,thick-stalked,time,tree,violet,x,yellow,young	age,glabrescent,na,zygomorphy
447	wfo-0001031202	success	198	105	48	61	137	44	46	2	0-0.5,0-1,1-5,3.5-4,accrescent,anther,apart,apex,base,berry,broadly,calyx,cm,complex,corky,corolla,cup-shaped,difoliate,erect,filament,fruit,fruiting,furcate,glabrous,globose,green,greenish-white,inflorescence,irregularly,leaf,long,many,margin,minutely,mm,obovate,overtopping,pedicel,petiole,pore,poricidal,puberulent,raised,shape,shaped,shrub,slightly,small,spaced,tear-drop,terminal,time,tip,tree,trichome,uniseriate,unit,usually,variable,white,woody	.1,.5,0.1-0.3,0.5,0.5-1,0.6-1.1,0.8-1,1-1.5,1-1.7,1.5-2,1.5-2.5,1.5-9,15-40,2-3,2-8,2.5-13,2.5-3.5,2.5-4,2/3,20-100-flowered,6-25,9-11,9-20,abrupt,acute,along,anthesi,apiculate,axi,bark,beneath,bud,capitate,completely,condition,cordate,decurrent,deflexed,deltoid,densely,dia,differing,distal,dry,due,eaf,edicel,eed,enclosed,exserted,extremely,fleshy,flower,free,frui,geminat,glabrate,golden,greyi,hard,large,later,lateral,like,live,lobe,lobed,lon,long-ellipsoid,long-styled,longer,lower,main,major,material,middle,minor,minute,narrowing,nflorescence,occasional,occasionally,often,older,one,opposite,orbicular,ovary,ovoid-reniform,pair,pale,paler,papillo,papillose,pitted,planar,plant,portion,prominent,pubescent,quite,reddish-brown,rounded,ruit,scar,scattered,sessile,shoot,short-styled,size,slender,sparsely,specimen,stem,stigma,straight,style,surface,tall,tan,tapering,thick,thickened,thicker,third,tub,tube,ud,vein,way,weight,whitish,widest,winged,x,ympodial,young	appressed,articulation,bract,branching,breeding,cell,colour,connective,form,geminate,growth,hair,heteromorphism,inflated,insertion,interjected,interpetalar,leaflet,length,marking,mature,na,odour,orientation,paired,pattern,placement,position,prickle,pseudostipule,rhizome,scale,spot,staman,stone,structure,symmetry,sympodial,system,texture,tissue,tuber,type,xylopodia	0-0.5,0-1,1-5,3.5-4,accrescent,apart,berry,broadly,cm,complex,corky,cup-shaped,difoliate,erect,furcate,glabrous,globose,green,greenish-white,irregularly,leaf,long,many,minutely,mm,obovate,overtopping,poricidal,puberulent,raised,shaped,shrub,slightly,small,spaced,tear-drop,terminal,time,tip,tree,trichome,uniseriate,usually,variable,white,woody	geminate,na
448	wfo-0001031207	success	217	105	58	67	150	38	55	3	/5,0.25-0.5,0.5-1,1/3-equal,5-8,anther,apex,apparently,articulated,base,berry,branched,calyx,cell,chartaceous,cm,cordate,curved,densely,difoliate,elongating,equal,erect,evenly,filament,fruit,fruiting,gently,glabrous,green,herb,lateral,leaf,length,lobed,long,margin,mature,maturity,mauve,mm,moderately,obtuse,pale,pedicel,perpendicular,petiole,poricidal,prickle,red,reflexed,shrub,simple,sometimes,spherical,spreading,stellate-pubescent,stem,straight,subentire,tapering,terminal,tip,unit,way,white,young	-11,-4,-7,.1,0-0.5,0-10,0-20,0-5,0-8,0.1-0.2,0.1-0.3-0.4,0.1-0.5,0.2,0.2-0.3,0.3-0.5,0.6-0.9,0.6-1.2,0.7-2,0.8,0.85-1.4,0.9-1.6,1,1-3,1-4,1-5,1.4-2,1.5-5,1/,1/3,1/4-1/3,1/4-1/3-1/2,2-3,2-4,2.1-2.3,2.5-3-5,2.8-3,3-5,3.5-7,5-merous,6-8,6.5-8,9-5,abaxially,acuminat,acute,alyx,ame,apar,apart,apically,bark,blade,bristle,bristly,broad-deltate,brow,c.,concolorous,dark,diameter,discolorous,distance,drying,dull,eaf,eed,elongated,extending,eye,filiform,flattened-reniform,flower,free,geminat,glabrescent,gray,herbaceous,infructescence,lanceolate,less,like,lobe,longer,lower,midpoint,midvein,multangulate,naked,narrow-deltate,nflorescence,oblong,occasionally,older,one,open,orange-brown,orolla,oung,outline,ovate,pair,peduncle,pendulous,per,perfec,pericarp,persistent,pit,porrect,portion,prickl,prickly,primary,raised,ray,rounded,ruit,scandent,scar,sessile,shorter,side,small,smooth,spaced,stalk,stalked,stellate,style,surface,tamen,terete,tertiary,time,toward,trichome,tube,unarmed,upper,usually,variously,vary,vein,venation,visible,weakly,wide,yellow,yellow-green,ympodial	articulation,bract,branching,colour,corolla,form,geminate,growth,hair,heteromorphism,inflorescence,insertion,interjected,interpetalar,leaflet,marking,na,odour,orientation,paired,placement,position,present,pseudostipule,rhizome,scale,shape,spot,staman,stone,structure,symmetry,sympodial,texture,tissue,tuber,type,xylopodia	/5,0.25-0.5,0.5-1,1/3-equal,5-8,apparently,articulated,base,berry,branched,chartaceous,cm,cordate,curved,densely,difoliate,elongating,equal,erect,evenly,fruit,gently,glabrous,green,herb,lateral,length,lobed,long,mature,maturity,mauve,mm,moderately,obtuse,pale,perpendicular,poricidal,red,reflexed,shrub,simple,sometimes,spherical,spreading,stellate-pubescent,stem,straight,subentire,tapering,terminal,tip,way,white,young	geminate,na,present
449	wfo-0001031218	success	154	138	85	96	58	42	81	4	0.5,0.5-1,1-2,1-4,15-25,2-2.5,2-22,2-3,3-14,3-5,4-5,4-8,40,6-7,abaxially,acuminate,apex,apiculate,articulated,basal,base,beyond,branched,calyx,cell,cm,connective,connivent,cordate,coriaceous,cylindrical,dark,diameter,directed,distally,eglandular,eglandular-pilose,ellipsoidal,entire,equal,exceeding,exserted,fruit,glabrous,glandular,glandular-puberulent,globose,greenish-purple,hair,introrse,lanceolate,lavender,leaving,less,lobe,long,margin,minutely,mm,mottled,oblique,obtuse,orange,ovate,ovate-elliptic,ovoid,pedicel,pedicellar,peduncle,petiole,pore,present,puberulent,purple,rachi,radiu,remnant,ripe,shorter,simple,slightly,sometimes,sparsely,stamen,stellate,stigma,stone,style,subcoriaceous,thecae,tip,tree,unit,violet,x,yellow	-5,1-3,10-19,2.5-3,3,4-28,4-7,4-foliat,40-100+,5-37,5-7,5.5-7,6-10,6-9,8-17,8-20,acute,adaxially,aggregate,apart,ape,axe,blade,densely,eaf,eed,especially,flattened,flower,glabrou,lon,lower,moderately,narrowly,nflorescence,nther,orolla,papillo,perfect,presen,pubescent,purpl,ruit,small,spaced,succulent,tal,tem,time,tomento,toward,triangular,truncat,tube,ud,vary,wide,ympodial	4-foliate,abaxial,adaxial,anther,appressed,articulation,branching,breeding,bud,colour,corolla,filament,form,fruiting,growth,height,inflated,inflorescence,leaf,length,marking,mature,modification,ovary,papillose,pattern,plant,position,shape,spot,stem,structure,symmetry,sympodial,system,texture,theca,trichome,truncate,type,unknown,zygomorphy	0.5,0.5-1,1-2,1-4,15-25,2-2.5,2-22,2-3,3-14,3-5,4-5,4-8,40,6-7,abaxially,acuminate,apex,apiculate,articulated,basal,base,beyond,branched,cm,connivent,cordate,coriaceous,cylindrical,dark,directed,distally,eglandular,eglandular-pilose,ellipsoidal,entire,equal,exceeding,exserted,fruit,glabrous,glandular,glandular-puberulent,globose,greenish-purple,hair,introrse,lanceolate,lavender,leaving,less,lobe,long,minutely,mm,mottled,oblique,obtuse,orange,ovate,ovate-elliptic,ovoid,pedicellar,present,puberulent,purple,remnant,ripe,shorter,simple,slightly,sometimes,sparsely,stamen,stellate,subcoriaceous,thecae,tip,tree,violet,x,yellow	4-foliate,papillose,truncate,unknown
450	wfo-0001031225	invalid_json_followup	163	167	NA	134	29	33	NA	NA	.25,.5,/3,0.2,0.2-0.75,0.5,0.5-1,0.7-6,0.75-1,1-1.5,1-1.7,1-3,1-5,1.5-5,2,2.5-3,3-9,3/4,5-50-flowered,5-6,6-8,7-9,9-16,acute,anther,anthesi,apart,apex,bark,base,beginning,broadly,bud,calyx,characteristic,closely,cm,conspicuous,corolla,cup-shaped,darker,decurrent,dia,difoliate,dry,ellipsoid,elliptic,erect,exserted,filament,fragrant,fruiting,furcate,glabrate,glabrous,globose,green,growth,inflorescence,lateral,leaf,less,like,live,lobe,lobed,long,main,major,margin,middle,minor,minute,minutely,mm,narrowly,often,older,opposite,outline,ovary,ovate,ovoid-reniform,pair,pale,papillose,pedicel,petiole,pitted,plant,pore,prominent,proximal,pubescent,raised,red-papillose,reflexed,rhomboidal,rounded,scar,shape,shaped,shrub,size,slender,slightly,small,soon,spaced,specimen,stem,stigma,strongly,style,surface,sweetly,swelling,tan,tapering,tear-drop,tip,tree,trichome,tube,unevenly,uniseriate,unit,vein,way,white,widest,woody,x,young	0.1-0.75,0.8-1,along,berry,deltoid,differentiated,differing,eaf,edicel,eed,flattene,free,geminat,greyish-brow,inflorescenc,lon,lower,much,nflorescence,one,papillo,poricidal,portion,rest,ruit,straight,tall,ud,ympodial	abaxial,adaxial,branching,breeding,colour,connective,diameter,flattened,flower,form,fragrance,fruit,geminate,greyish-brown,hair,height,length,marking,modification,na,pattern,point,position,seed,spacing,spot,structure,symmetry,sympodial,system,texture,type,value	NA	NA
451	wfo-0001031231	success	174	108	55	67	107	41	53	2	1-3,1.5-2,37/2,37/3,80-110,almost,anther,apex,aromatic,axillary,base,berry,branch,branched,calyx,campanula,campanulate,cell,colour,corolla,developed,elliptic,entire,equal,erect,facetted,filament,fork,glandular,globose,green,hair,lanceolate,leaf,lengthening,loosely,marbled,margin,minute,mm,oblong,occasionally,often,pedicel,pentagonal,petal,plant,pore,poricidal,purple,rh,ripening,rotate,rounded,shrub,simple,slit,sometimes,stone,stout,tinged,tip,tissue,unit,vigorous,violet,well	.5,0.5-1.5-2,1-1.5,1-2,1-4,13,2-3,2-4,2.5-3,25-35,3-4,4-8,5-7,8-10,absent,acumen,acuminate,acute,adherent,along,anthesi,aspect,axi,basal,becoming,beyond,blunt,bluntly,brown,clonal,cluster,cm,dark,declinate,dia,discoidal,eaf,eed,ellipsoid,exceeding,except,exerted,expanded,fleshy,flower,flowering,folded,general,glabrous,gree,greyish,habit,herbarium,interacuminal,juvenile,lasting,len,less,lobe,lon,long,lower,mature,mauve,midrib,nflorescence,ovary,pedice,pedicellate,peduncle,pinnatisect,plurifoliat,projecting,rarely,readily,recurve,ripe,rugose-ruminate,ruit,seed,sessile,several,shallow,shed,short,sinus,slightly,small,soft,specimen,stigma,stonrgly,style,succulent,surface,toward,translucent,triangular,tub,ud,usually,variable,without,wooded,x,year,ympodial	articulation,bract,branching,breeding,connective,form,fruit,fruiting,growth,heteromorphism,inflorescence,insertion,interjected,interpetalar,leaflet,length,marking,na,odour,orientation,paired,pattern,petiole,placement,plurifoliate,position,prickle,pseudostipule,rhizome,scale,shape,spot,staman,structure,symmetry,sympodial,system,texture,tuber,type,xylopodia	1-3,1.5-2,37/2,37/3,80-110,almost,aromatic,axillary,berry,branch,branched,campanula,campanulate,developed,elliptic,entire,equal,erect,facetted,fork,glandular,globose,green,hair,lanceolate,lengthening,loosely,marbled,minute,mm,oblong,occasionally,often,pentagonal,petal,plant,pore,poricidal,purple,rh,ripening,rotate,rounded,shrub,simple,slit,sometimes,stout,tinged,tip,vigorous,violet,well	na,plurifoliate
452	wfo-0001031252	success	170	142	75	92	78	50	72	3	0.2-1.5,0.3-1.1,1-2,12-20,2.8-3.6,3-10,3-6,5-8,5-9,5.5-6.5,7-18,absent,acute,anther,apex,attenuate,axillary,base,berry,brownish,bud,cell,ciliate,clavate,cm,condition,coriaceous,corolla,covering,cuneate,dark,deep,diameter,distal,drying,elliptic,entire,filament,flower,forked,fresh,fruit,glabrous,globose,green,greenish,hair-like,half,herb,high,homostylous,interjected,lanceolate,lateral,leaflet,long,margin,medium,mm,moniliform,mottled,ovate,ovoid,pedicel,petiole,plant,plurifoliate,pore,poricidal,purple,rotate,rounded,seed,serrate,simple,sometimes,stigma,straight,stripe,style,subtending,terminal,testal,thick,tip,tri-,tuber,unit,unwinged,wall,white,whitish	0.4-3,1-3,1.3-1.9,1.75-5.2,16-33,2-3,2.5-7,3-5,5-17,5-merou,abaxially,acumen,adaxiall,adaxially,ag,along,alyx,apart,apparently,arranged,articulated,axe,bead,blade,capitat,connivent,digestion,dorsally,eaf,edge,eed,enzyme,erec,exceeding,flat,folded,geminat,generally,glabrou,green-white,hal,honeycomb-shaped,lengthening,light,like,linear,living,lobe,lower,make,mucilaginous,multiple,necklace,nflorescence,orolla,peduncle,perfect,removed,ripe,ruit,seudostipule,slit,spaced,specimen,stamen,stolon,tall,tamen,tem,throughout,tube,typically,usually,vary,wet,x,yellow,ympodial	5-merous,arrangement,articulation,bract,branching,breeding,calyx,capitate,colour,connective,form,fruiting,growth,hair,height,heteromorphism,inflorescence,insertion,interpetalar,leaf,length,marking,mature,modification,na,number,odour,orientation,ovary,paired,pattern,placement,position,prickle,pseudostipule,rhizome,scale,shape,spot,staman,stem,stone,structure,symmetry,sympodial,system,texture,tissue,type,xylopodia	0.2-1.5,0.3-1.1,1-2,12-20,2.8-3.6,3-10,3-6,5-8,5-9,5.5-6.5,7-18,absent,acute,attenuate,axillary,berry,brownish,bud,cell,ciliate,clavate,cm,condition,coriaceous,covering,cuneate,dark,deep,distal,drying,elliptic,entire,forked,fresh,glabrous,globose,green,greenish,hair-like,half,herb,high,homostylous,lanceolate,lateral,long,medium,mm,moniliform,mottled,ovate,ovoid,plurifoliate,poricidal,purple,rotate,rounded,serrate,simple,sometimes,straight,stripe,subtending,terminal,testal,thick,tip,tri-,unwinged,wall,white,whitish	5-merous,capitate,na
453	wfo-0001031257	success	200	168	113	125	75	43	107	6	0,0.5-0.8,0.7-1,0.75-2.5,1-1.3,11.5-15,2-,2-4.5-6,3.5-5.7,4-10,5-8.5-12,6-celled,8,abaxially,abundant,adaxially,aggregate,anther,anthesi,antrorse,apex,ascending,attenuate,basal,base,berry,blue-violet,bud,calyx,cell,cm,coarsely,coat,connectival,corolla,cuneate,curved,dark,dentate,diameter,difoliate,directed,dorsally,edentate,ellipsoidal,embryo,endosperm,epidermal,erect,filament,finely,flexuous,foliage,fruiting,glandular,globose,hair-like,herb,herbaceous,hollow,honey-combed,lamina,lateral,leaf,length,light,like,little,lobe,long,long-stalked,longer,longitudinally,lower,many-seeded,margin,midvein,mm,non-glandular,odorles,outward,ovate,pair,papillate,patent,petiole,pore,prolongation,pubescent,purple,rarely,ridged,ring,robust,secondary,seed,serrate,shrub,simple,slightly,small,solitary,somewhat,spur-like,stem,stone,strand,striate,thickened,thickening,tooth,trans-ovoidal,trichome,tube,unequal,unit,upward,vein,ventrifixed,verrucate,viscid,wall,white,within,yellow	0.4,0.5,1-1.2,1.1-1.2,1.5,1.5-1.7,1.5-2,1/10,3,3.5-4-,4.5-5,4.5-6-12,5,5-,7-10-16-22.5,7.5-9,8-celled,accrescen,acuminate,ag,bicellular,branch,broad,campanulate,cotyledon,cuticle,deep,densely,diamete,eaf,eed,elliptical,free,geminat,glabrous,half,head,high,inconspicuous,inserted,lon,longitudinal,narrowly,opening,orolla,pericarp,poricidal,portion,reduced,ree,rest,ruit,saddle-shape,scarce,scarcely,separated,short-stalked,shorter,single-celled,sinus,slit,smooth,stalk,stigma,style,subglobose,tem,thecae,time,tip,triangular,vary,viscid-pubescen,x,ympodial	3.5-4.5-5,accrescent,arrangement,bract,branching,broad-based,colour,connective,form,fruit,geminate,growth,hair,height,heteromorphism,inflorescence,interjected,interpetalar,leaflet,mature,na,needle-like,orientation,pattern,placement,plant,position,prickle,pseudostipule,rhizome,scale,shape,staman,stellate,structure,surface,sympodial,texture,tissue,tuber,type,viscid-pubescent,xylopodia	0,0.5-0.8,0.7-1,0.75-2.5,1-1.3,11.5-15,2-,2-4.5-6,3.5-5.7,4-10,5-8.5-12,6-celled,8,abaxially,abundant,adaxially,aggregate,anthesi,antrorse,ascending,attenuate,basal,base,berry,blue-violet,bud,cell,cm,coarsely,connectival,cuneate,curved,dark,dentate,diameter,difoliate,directed,dorsally,edentate,ellipsoidal,erect,filament,finely,flexuous,foliage,glandular,globose,hair-like,herb,herbaceous,hollow,honey-combed,lamina,lateral,leaf,light,like,little,long,long-stalked,longer,longitudinally,many-seeded,midvein,mm,non-glandular,odorles,outward,ovate,pair,papillate,patent,prolongation,pubescent,purple,rarely,ridged,ring,robust,secondary,serrate,shrub,simple,slightly,small,solitary,somewhat,spur-like,stone,strand,striate,thickened,thickening,tooth,trans-ovoidal,trichome,tube,unequal,upward,vein,ventrifixed,verrucate,viscid,wall,white,within,yellow	3.5-4.5-5,accrescent,geminate,na,stellate,viscid-pubescent
454	wfo-0001031270	success	234	146	92	108	126	38	85	7	+,0.5-1,1,1-4,1.5,1.5-2,1/3,10,100,2-3,2-4,3-10,5,5-10,5-15,7-12,9-10,>,abaxial,accrescent,adaxial,anther,apart,apex,articulated,base,berry,bipinnatifid,bright,brown,calyx,cell,cm,curved,deeply,depressed-spherical,diameter,difoliate,elliptic,filament,flower,free,fruiting,glandular,growth,herb,inflorescence,investing,lateral,leaf,leaf-opposed,length,lobe,lobed,long,longer,lower,margin,membranous,minute,mm,obovate,occasionally,outline,ovoid,pale,pedicel,peduncle,per,petiole,pinnatifid,poricidal,portion,prickle,red,reddish,reflexed,reniform,ripe,scar,scattered,shallowly,simple,sinuate,slender,slightly,spherical,spreading,stalk,stellate,stem,straight,strongly,surface,tan,tapering,tightly,tip,trichome,truncate,tube,uniseriate,unit,way,white,yellow,yellowish,½	.5,0.4-1.5,1-1.2,1-3,1.2-1.6,10-12,2-2.5,2-20,2-7,2.5-3,3-20,3-5,4-5,5-6,5-merous,6-17,6-50,8,abaxially,acute,adaxiall,along,alyx,anthesi,arme,associated,bark,basal,beginning,blade,brow,c.,capitate,celled,clavate,colored,conical,connivent,consistently,densely,differentiated,directed,distal,eed,ellipti,entire,equal,erect,few-rayed,frui,geminat,glabrous,gland,glandular-pubescent,green,heavily,heterostylous,infructescence,later,leafy,like,live,lon,long-styled,loosely,midpoint,midvein,minutely,mixture,multangulate,multiseriate,narrowly,new,nflorescence,often,older,orolla,oung,pair,papillo,pericarp,pitted,plant,pore,prickly,primary,pubescent,rachi,ray,rest,rounded,ruit,secondary,sessile,shallow,shining,short-stalked,short-styled,shrub,single,size,small,sparsely,staminat,stigma,straw-colored,style,tall,tamen,terete,testal,thin,thus,tissue,upward,usually,vary,varying,vein,well,wice,wid,wide,wing,woody,ympodial	20,appressed,arrangement,articulation,branching,broad-based,colour,corolla,form,fruit,geminate,hair,heteromorphism,inflated,insertion,mature,na,needle-like,number,odour,orientation,placement,position,pseudostipule,rhizome,seed,shape,staman,stone,structure,symmetry,sympodial,texture,tuber,type,width,xylopodia,zygomorphy	+,0.5-1,1,1-4,1.5,1.5-2,1/3,10,100,2-3,2-4,3-10,5,5-10,5-15,7-12,9-10,>,accrescent,apart,articulated,base,berry,bipinnatifid,bright,brown,cm,curved,deeply,depressed-spherical,difoliate,elliptic,flower,glandular,herb,investing,lateral,leaf,leaf-opposed,lobed,long,longer,lower,membranous,minute,mm,obovate,occasionally,outline,ovoid,pale,per,pinnatifid,poricidal,prickle,red,reddish,reflexed,reniform,ripe,scattered,shallowly,simple,sinuate,slender,slightly,spherical,spreading,stalk,stellate,stem,straight,strongly,surface,tan,tapering,tightly,tip,truncate,uniseriate,way,white,yellow,yellowish,½	20,broad-based,fruit,geminate,na,needle-like,zygomorphy
455	wfo-0001031283	success	51	51	30	33	18	18	28	2	0.1-0.15-0.25,0.4-0.5,0.5-0.7,0.7,2.2-2.8,30-40,acute,apex,base,brown,calyx,cell,cm,diameter,erect,fruit,hair-like,lateral,mm,narrowly,obovate,outgrowth,pale,pleasant,pubescent,shrub,smelling,somewhat,sprawling,testa,wall,winged,woody	.7-2.3,appearance,eed,elongating,fide,give,lo,lobe,long,markedly,moore,silky,small,spreadin,surface,tall,thick,wide	1.7-2.3,colour,form,fruiting,growth,hair,height,leaf,length,odour,plant,seed,shape,spreading,texture,thicknes,type,width	0.1-0.15-0.25,0.4-0.5,0.5-0.7,0.7,2.2-2.8,30-40,acute,brown,cell,cm,erect,hair-like,lateral,mm,narrowly,obovate,outgrowth,pale,pleasant,pubescent,shrub,smelling,somewhat,sprawling,testa,wall,winged,woody	1.7-2.3,spreading
456	wfo-0001031287	success	147	153	74	90	57	63	68	6	0.5-1.5,0.9-1,1,1-1.2,1-1.3,1-1.5,1-5,1.5-2,1.5-5.5,2-2.5,3-4,3-5,4-5,4.5-5,5-14,6-7,anther,anthesi,apex,attenuate,bark,base,bi-lobed,calyx,cm,conical,connective,corolla,dark,dendritic,densely,difoliate,divergently,ellipsoid,elliptic,elongate,erect,exserted,filament,fleshy,fruiting,geminate,glabrous,globose,green,greenish-white,internodal,later,leaf,lobe,lobed,lower,many,margin,minutely,mm,nearly,ovary,ovoid-reniform,pale,papillose,pedicel,petiole,pitted,plurifoliate,pointed,pore,pubescent,red-papillose,reflexed,scar,shaped,shoot,short,shrub,somewhat,stem,stigma,strongly,style,surface,tan,tear-drop,thick,trichome,tube,tuft,unit,white,young	.5,4-6,6-10-flowered,abaxially,acute,adaxially,apar,ape,axil,bearing,berry,branch,coriaceous,deflexed,deltate,dia,eaf,edicel,eed,enlarged,free,frui,knob,lamina,lateral,lon,long,main,membranous,middle,nflorescence,occasionally,older,onto,pair,papillo,planar,poricidal,portion,reddish-brow,rounded,ruit,simple,sinus,small,spaced,thin,tip,tub,ud,unevenly,vein,widest,winged,woody,x,ympodial	0.5,1.5,6-10,abaxial,adaxial,articulation,bract,branching,breeding,broad-based,bud,cell,colour,diameter,flower,form,fruit,growth,hair,height,heteromorphism,inflorescence,insertion,interjected,interpetalar,leaflet,length,marking,modification,na,needle-like,number,odour,orientation,pattern,placement,plant,position,prickle,pseudostipule,reddish-brown,reflexion,rhizome,scale,seed,shape,smell,spacing,spot,staman,stone,structure,symmetry,sympodial,system,texture,thicknes,tissue,tuber,type,vegetative,width,xylopodia	0.5-1.5,0.9-1,1,1-1.2,1-1.3,1-1.5,1-5,1.5-2,1.5-5.5,2-2.5,3-4,3-5,4-5,4.5-5,5-14,6-7,attenuate,base,bi-lobed,calyx,cm,conical,dark,dendritic,densely,difoliate,divergently,ellipsoid,elliptic,elongate,erect,exserted,fleshy,geminate,glabrous,globose,green,greenish-white,internodal,later,lobed,many,minutely,mm,nearly,ovoid-reniform,pale,papillose,pitted,plurifoliate,pointed,pubescent,red-papillose,reflexed,shaped,shoot,short,shrub,somewhat,strongly,tan,tear-drop,thick,trichome,tube,tuft,white,young	0.5,1.5,6-10,fruit,na,reddish-brown
457	wfo-0001031300	success	216	114	52	68	148	46	49	3	-4,-6,0.2-0.4,0.2-0.5,0.5-1.5,0.5-2,2-3,2-6,6-8,acute,apex,articulated,attenuate,base,berry,branched,brown-green,calyx,cell,chartaceous,cm,creeping,curved,difoliate,elongating,equal,erect,filament,flattened,flower,fruit,fruiting,glabrous,gray-green,hair,lateral,leaf,length,lobed,long,lower,margin,mature,maturity,membranous,mm,oblanceolate,orange,pale,pedicel,petiole,porrect,prickle,red,rounded,shrub,simple,sparsely,spherical,stellate-pubescent,stem,surface,trichome,uniradiate,unit,white,yellow-green,yellow-orange	-5,.5,/4,0-15,0-20,0-3,0-8,0.1,0.1-0.5,0.1-0.6,0.15-0.7,0.2-0.7,0.2-1,0.3,0.3-0.6,0.3-1.3,0.5-0.9,0.5-18,0.6-0.8,0.6-1,0.6-1.2,0.7-0.9,0.7-1.2-2.2,0.8-1.5,1-2,1-4,1-5,1.2-1.7,1.3-2,1.5-3.5,1/2-3/4,1/3-1/2,1/6-1/4,10-30,2-3-4,2-4,2-5.5,2.2-2.3,2.2-2.7,2.5-3.2,3-4,4.5-6,5-15,5-merous,abaxially,absent,also,alyx,anther,apar,apart,apically,apparently,ba,bark,blade,brow,bulbous,caudat,concolorous,connivent,deltate,densely,diameter,distance,drying,dull,eaf,eed,extending,eye,filiform,flattened-reniform,free,geminat,geniculate,glabrescent,herbaceous,highly,infructescence,lobe,lon,longer,midpoint,midvein,minute,moderately,naked,near,nflorescence,oblong,obtuse,older,one,open,orange-brown,orange-green,orolla,oung,outline,pair,peduncle,pendulous,per,perfec,pericarp,pit,poricidal,portion,prickl,prickly,primary,pubescent,raised,rarely,ray,reduced,ruit,scar,sessile,side,small,smooth,spaced,spreading,stalk,stalked,stellate,style,tamen,tapering,terete,tertiary,thin,time,tip,tube,vary,vein,venation,visible,way,weakly,wide,wider,winged,yellow,ympodial	appressed,articulation,bract,branching,broad-based,colour,corolla,form,geminate,growth,heteromorphism,inflated,inflorescence,insertion,interjected,interpetalar,leaflet,marking,na,needle-like,number,odour,orientation,pattern,placement,position,present,pseudostipule,rhizome,scale,shape,smell,spot,staman,stone,structure,symmetry,sympodial,texture,tissue,tuber,type,vegetative,width,xylopodia,zygomorphy	-4,-6,0.2-0.4,0.2-0.5,0.5-1.5,0.5-2,2-3,2-6,6-8,acute,articulated,attenuate,base,berry,branched,brown-green,chartaceous,cm,creeping,curved,difoliate,elongating,equal,erect,flattened,glabrous,gray-green,lateral,lobed,long,maturity,membranous,mm,oblanceolate,orange,pale,porrect,red,rounded,shrub,simple,sparsely,spherical,stellate-pubescent,surface,uniradiate,white,yellow-green,yellow-orange	geminate,na,present
458	wfo-0001031310	success	203	162	92	112	91	50	86	6	0-4,1-10,1-3,1-6,1.5-4,15-40,2-3,2.5-5.5,2.5-8.5,3-10,4-10,4-12,4.5-4.8,5-7,5.5-21,abaxially,absent,adaxially,anther,apex,base,blade,blue,blue-purple,broadly,brown,brownish,cell,chartaceous,cm,condition,conspicuously,corolla,decurrent,diameter,digestion,distal,drying,elliptic,enzyme,extremely,filament,flower,forked,fresh,fruit,glabrous,globose,green,greenish,hair,half,herb,high,homostylous,honeycomb-shaped,interjected,lanceolate,lateral,leaf,leaflet,lengthening,less,light,margin,membranous,mm,mottled,multicellular,odd-pinnate,ovate-elliptic,ovoid,pair,pale,pedicel,peduncle,petiole,pilose,plant,plurifoliate,pore,poricidal,pubescent,purple,removed,rotate,seed,simple,size,slightly,slit,small,sometimes,somewhat,sparsely,stem,stigma,straight,streak,style,terminal,testal,tip,tissue,tri-,tuber,unit,unwinged,wall,white,whitish,x	.5,0-3,0.5-3,1-2,1-5.5,5-6,5-merou,6-7,acumen,acuminate,ag,along,alyx,apart,apparently,articulated,attenuate,axe,axillary,berry,borne,bud,caly,ciliate,connivent,covering,cuneate,decreasing,dorsally,eaf,edge,eed,end,erect-decumben,especially,exceeding,flat,folded,geminat,generally,glabrou,gradually,green-white,hair-like,larger,like,living,lobe,long,lower,make,midrib,minutely,mucilaginous,narrowly,nflorescence,obtuse,orolla,ovate,ovate-lanceolate,perfect,petiolule,pointed,puberulent,rachi,rosette-forming,ruit,seudostipule,shortly,singly,spaced,specimen,stamen,ste,stolo,subellipsoi,subrosette-forming,subtending,tall,tamen,tem,thick,throughout,toward,tube,typically,usually,vary,wet,yellow,ympodial	age,arrangement,articulation,bract,branching,breeding,calyx,colour,connective,form,growth,height,heteromorphism,inflorescence,insertion,interpetalar,length,marking,mature,modification,na,number,odour,orientation,ovary,paired,pattern,pilosity,placement,position,presence,present,prickle,pseudostipule,rhizome,scale,shape,spacing,spot,staman,stone,structure,subellipsoid,symmetry,sympodial,system,texture,type,xylopodia,zygomorphy	0-4,1-10,1-3,1-6,1.5-4,15-40,2-3,2.5-5.5,2.5-8.5,3-10,4-10,4-12,4.5-4.8,5-7,5.5-21,abaxially,absent,adaxially,base,blue,blue-purple,broadly,brown,brownish,chartaceous,cm,condition,conspicuously,decurrent,digestion,distal,drying,elliptic,enzyme,extremely,forked,fresh,glabrous,globose,green,greenish,hair,half,herb,high,homostylous,honeycomb-shaped,lanceolate,lateral,lengthening,less,light,membranous,mm,mottled,multicellular,odd-pinnate,ovate-elliptic,ovoid,pale,pilose,plurifoliate,pore,poricidal,pubescent,purple,removed,rotate,simple,slightly,slit,small,sometimes,somewhat,sparsely,stem,straight,streak,terminal,tip,tri-,unwinged,wall,white,whitish,x	age,calyx,na,present,subellipsoid,zygomorphy
459	wfo-0001031316	success	207	153	85	99	108	54	80	5	-2,/3,0.3-1,0.5-2,0.8-1.8,1.3-3.5,1.5-2,2-3,2.5-8,3-8,4-7,4-9,5-10,5-8,6-20,8-11,abaxial,acuminate,acute,adaxial,anther,apex,apparently,articulated,base,becoming,berry,blue-mauve,branched,bright,broad,calyx,cm,connivent,cream,dark,densely,diameter,difoliate,elongating,entire,erect,fifth,filament,flower,four,fruit,fruiting,glabrescent,glabrous,green,hair,lateral,leaf,length,lobed,long,lower,margin,marking,maturity,membranous,mm,moderately,multangulate,obtuse,orange,ovate,pale,pedicel,peduncle,petiole,poricidal,porrect,purple,red-brown,reflexed,sessile,shrub,simple,sometimes,spherical,stalked,stellate,stellate-pubescent,stem,surface,tapering,terminal,tip,trichome,unarmed,unequal,unit,way,white-green,wide,yellow-green,young	.1,0.05-0.1,0.05-0.15,0.1-0.2,0.4-0.6,0.4-0.8,0.6-1,0.8-1.2,0.9-1.3,1-5,1.2-2.1,1.5-2-3,1.5-3.5,1.5-5,1/3-1/2,1/3-2/3,2-20,2-4,3-10,3.5-3.8,3.8-5,4,5-15,5-6,5-merous,8-12,8-25,abaxially,almost,alyx,ame,apar,apically,bark,blade,c.,colored,concolorous,contrast,curved,discolorous,drying,dull,eaf,eed,eye,flattened-reniform,foliaceou,free,geminat,glabrou,gray,held,herbaceous,infructescence,inward,lobe,long-acuminat,longer,lowermost,mature,midpoint,minute,naked,narrow-deltate,nflorescence,older,one,open,orange-brown,orolla,oung,pair,pendulous,per,perfec,pericarp,portion,primary,ray,red-brow,ruit,scar,slender,smooth,spaced,sparsely,spreading,stalk,stellate-pubescen,strongly,style,tamen,terete,tertiary,time,tube,unarme,usually,variously,vary,vein,venation,visible,white,whitish,yellow,ympodial	armament,articulation,bract,branching,breeding,broad-based,cell,colour,connective,corolla,foliaceous,form,geminate,growth,height,heteromorphism,inflorescence,insertion,interjected,interpetalar,leaflet,mentioned,modification,na,needle-like,odour,orientation,paired,pattern,perfect,placement,plant,pore,position,prickle,pseudostipule,rhizome,scale,shape,size,smell,spot,staman,stone,structure,symmetry,sympodial,system,texture,tissue,tuber,type,vegetative,xylopodia	-2,/3,0.3-1,0.5-2,0.8-1.8,1.3-3.5,1.5-2,2-3,2.5-8,3-8,4-7,4-9,5-10,5-8,6-20,8-11,acuminate,acute,anther,apparently,articulated,base,becoming,berry,blue-mauve,branched,bright,broad,cm,connivent,cream,dark,densely,diameter,difoliate,elongating,entire,erect,fifth,four,glabrescent,glabrous,green,lateral,lobed,long,marking,maturity,membranous,mm,moderately,multangulate,obtuse,orange,ovate,pale,poricidal,porrect,purple,red-brown,reflexed,sessile,shrub,simple,sometimes,spherical,stalked,stellate,stellate-pubescent,tapering,terminal,tip,trichome,unarmed,unequal,way,white-green,wide,yellow-green,young	foliaceous,geminate,mentioned,na,perfect
460	wfo-0001031333	success	194	177	103	116	78	61	97	6	.5,0.1-0.5,0.5,1-1.5,1-4,1.2-2,1.5,1.5-1.7,1.5-2,1/2,2.5-3,3-4,3/4,5-7,7-10,7-9,?,abaxially,acuminate,acute,adaxially,adjacent,anther,apart,apex,base,berry,bilobed,branched,broadly,brown,calyx,capitate,cell,clustered,cm,conical,densely,diameter,ellipsoidal,elliptic,entire,filament,flattened,flower,glabrescent,glabrous,globose,golden,green,greenish,growth,half,high,immature,inflorescence,lamina,leaving,like,lobed,long,lower,many,margin,membranous,minute,minutely,mm,narrowly,near,new,ovate,pair,pale,pedicel,peduncle,peg,pentagonal,perfect,petiole,pitted,pore,poricidal,primary,pubescent,pubescent-papillate,reniform,scar,simple,small,somewhat,sparsely,stellate,stem,stigma,style,surface,tangled,terminal,testal,time,tip,trichome,truncate,tube,twining,unevenly,uniseriate,unit,vein,vine,way,white,whitish,x,yellowish	+,1-5,2,2-3,2.7-7,30-40,5-8,5-merou,50,<,>,adaxiall,ag,almost,alyx,anthesi,appearing,ark,articulated,branche,collection,composed,crea,cupped,denser,eaf,eed,exserted,free,fruting,glabrescen,ilament,lengthening,less,lobe,m.,matte,mere,nflorescence,nodding,occasionally,older,orolla,outline,papillat,penden,per,pericarp,planar,plurifoliat,portion,quadrate,rest,rhachi,ruit,sinus,slightly,slit,soon,splitting,ste,striped,strongly,tem,thickened,thin,trailing,triangular,ud,undersurface,undulation,unequal,upper,vary,venation,woody,yellow,ympodial	5-merous,appressed,arrangement,articulation,bark,bract,branch,branching,breeding,broad-based,bud,colour,connective,corolla,cream,form,fruit,fruiting,hair,heteromorphism,inflated,insertion,interjected,interpetalar,leaf,leaflet,length,marking,mature,modification,na,needle-like,odour,orientation,ovary,paired,papillate,pattern,placement,plurifoliate,position,prickle,pseudostipule,rhizome,scale,seed,shape,smell,spot,staman,stone,structure,symmetry,sympodial,system,texture,tissue,tuber,type,vegetative,xylopodia	.5,0.1-0.5,0.5,1-1.5,1-4,1.2-2,1.5,1.5-1.7,1.5-2,1/2,2.5-3,3-4,3/4,5-7,7-10,7-9,?,abaxially,acuminate,acute,adaxially,adjacent,apart,apex,base,berry,bilobed,branched,broadly,brown,capitate,clustered,cm,conical,densely,diameter,ellipsoidal,elliptic,entire,flattened,glabrescent,glabrous,globose,golden,green,greenish,half,high,immature,inflorescence,lamina,leaving,like,lobed,long,lower,many,membranous,minute,minutely,mm,narrowly,near,ovate,pair,pale,peg,pentagonal,perfect,pitted,poricidal,pubescent,pubescent-papillate,reniform,simple,small,somewhat,sparsely,stellate,stem,surface,tangled,terminal,time,tip,trichome,truncate,twining,unevenly,uniseriate,vein,vine,way,white,whitish,x,yellowish	5-merous,branch,cream,na,papillate,plurifoliate
461	wfo-0001031333	success	194	108	52	61	133	47	49	3	0.5,1-1.5,1-4,1-5-2,2.5-3,?,acute,anther,anthesi,apex,base,berry,branched,broadly,calyx,cell,cm,corolla,ellipsoid,entire,filament,fruiting,globose,green,growth,high,immature,inflorescence,leaving,lengthening,like,long,many,margin,membranous,mm,near,nodding,pedicel,peg,perfect,petiole,pore,poricidal,pubescent,rest,rotate-stellate,simple,slit,small,sparsely,stellate,terminal,time,tip,trichome,truncate,uniseriate,unit,vine,white	+,.5,0.1-0.5,1-5,1.5,1.5-1.7,1.5-2,1/2,2,2-3,2.7-7,3,3-4,3/4,30-40,5-7,5-8,5-merou,50,7-10,7-9,<,>,abaxially,acuminate,adaxiall,adaxially,adjacent,ag,almost,alyx,apart,appearing,articulated,bark,bilobed,branche,brown,capitate,clustered,composed,conical,cream,cupped,densely,denser,diameter,eaf,eed,elliptic,exserted,flattened,flower,free,glabrescen,glabrescent,glabrous,golden,greenish,half,ilament,lamina,less,lobe,lobed,lower,m.,matte,mere,minute,minutely,narrowly,new,nflorescence,occasionally,older,orolla,outline,ovate,pair,pale,papillat,peduncle,penden,per,pericarp,pitted,planar,plurifoliat,portion,primary,pubescent-papillate,quadrate,reniform,rhachi,ruit,scar,sinus,slightly,somewhat,soon,spaced,splitting,stem,stigma,striped,strongly,style,surface,tangled,testal,thickened,thin,trailing,triangular,tub,tube,twinin,ud,undersurface,undulation,unequal,unevenly,upper,vary,vein,venation,way,whitish,wide,woody,yellowish,ympodial	age,appressed,articulation,bract,branching,breeding,colour,connective,form,fruit,hair,heteromorphism,inflated,insertion,interjected,interpetalar,leaf,leaflet,length,marking,mature,modification,na,odour,orientation,paired,pattern,placement,plurifoliate,position,prickle,pseudostipule,rhizome,scale,shape,spot,staman,stone,structure,symmetry,sympodial,system,texture,tissue,tuber,type,xylopodia	0.5,1-1.5,1-4,1-5-2,2.5-3,?,acute,anthesi,base,berry,branched,broadly,cm,ellipsoid,entire,globose,green,high,immature,inflorescence,leaving,lengthening,like,long,many,membranous,mm,near,nodding,peg,perfect,pore,poricidal,pubescent,rest,rotate-stellate,simple,slit,small,sparsely,stellate,terminal,time,tip,trichome,truncate,uniseriate,vine,white	age,na,plurifoliate
462	wfo-0001031359	success	166	160	85	106	60	54	81	4	.02,.25,.5,/4,0.5-1,0.5-6,0.75-1,1-4,1.1-1.6,1.2-1.6,1.2-2.5,1.3-1.6,1.5-2,1.6-2.8,1.9-2.3,12-21,2.5-3,3-3.5,3.6-8.8,5-angled,5.3-7.5,6-7,acuminate,anther,apart,apex,attenuate,bark,base,beginning,berry,bi-lobed,brown,calyx,cm,corolla,curled,dark,deflexed,dia,difoliate,dull,elliptic,filament,flattened-reniform,fruiting,glabrous,globose,green,incrassate,interpetalar,lamina,leaf,live,lobed,long,major,margin,membraneous,minor,minutely,mm,narrowly,near,nearly,obovoid,opposite,outline,ovary,paler,papillae,papillose,pedicel,petiole,pit,pitted,plant,pore,ripe,round,rusty,scar,shaped,shiny,shrub,simple,size,slender,stem,stigma,style,surface,tapering,tear-drop,trichome,tube,tuft,undulate,uniseriate,unit,vein,way,white,x,yellow-orange,young	5-30-flowered,5-7,angle,anthesi,apiculate,appearing,axil,ba,beneath,broadly,differing,distal,dried,eaf,edicel,eed,evenly,extending,free,geminat,inflorescenc,internodal,lateral,lobe,lon,lower,main,middle,nflorescence,occasionally,often,older,one,originating,pair,papillo,planar,poricidal,portion,reflexed,ridged,ruit,sinus,slightly,somewhat,spaced,specimen,straight,strongly,tall,tan,tip,triangular,tub,ud,white-lenticellat,widest,woody,yellow,ympodial	abaxial,adaxial,articulation,bract,branching,breeding,bud,cell,colour,connective,diameter,form,fruit,geminate,growth,hair,height,heteromorphism,inflorescence,insertion,interjected,leaflet,length,marking,mature,modification,na,odour,orientation,origin,paired,pattern,placement,position,prickle,pseudostipule,rhizome,scale,seed,shape,spacing,spot,staman,stone,structure,symmetry,sympodial,system,texture,tissue,tuber,type,white-lenticellate,xylopodia	.02,.25,.5,/4,0.5-1,0.5-6,0.75-1,1-4,1.1-1.6,1.2-1.6,1.2-2.5,1.3-1.6,1.5-2,1.6-2.8,1.9-2.3,12-21,2.5-3,3-3.5,3.6-8.8,5-angled,5.3-7.5,6-7,acuminate,apart,attenuate,base,beginning,berry,bi-lobed,brown,calyx,cm,curled,dark,deflexed,dia,difoliate,dull,elliptic,flattened-reniform,glabrous,globose,green,incrassate,lamina,leaf,live,lobed,long,membraneous,minutely,mm,narrowly,near,nearly,obovoid,opposite,outline,paler,papillose,pitted,plant,ripe,round,rusty,shaped,shiny,shrub,simple,slender,tear-drop,trichome,tube,tuft,undulate,uniseriate,vein,way,white,x,yellow-orange	geminate,inflorescence,na,white-lenticellate
463	wfo-0001031362	success	138	128	57	74	64	54	53	4	.2,.3,.5,0.5-1,0.7-1,1-1.1,1-1.5,1.5-2,2-2.5,3-6,?,anther,anthesi,apex,attenuate,bark,base,brown,calyx,cell,closely,cm,conical,corolla,dendritic,densely,filament,flattened-reniform,fruiting,glabrous,globose,golden,incrassate,internodal,lanceolate,leaf,like,lobed,long,lower,margin,minutely,mm,nearly,older,opposite,orange-red,ovary,packed,papillose,pedicel,petiole,pitted,pore,pubescent,pubesent,red,rest,shaped,shrub,simple,small-capitate,sparsely,stem,stigma,style,subshrub,surface,tear-drop,trichome,tube,unit,white,young	0.4-0.5,1-3,1-3-flowered,1-4,3-4,abaxially,acute,adaxially,along,appearance,berry,branch,bushy,denser,dia,eaf,edicel,eed,ellipsoid,erect,exceeding,exserted,flattened,free,giving,golden-brow,inflorescenc,lamina,lateral,lobe,lon,long-triangular,main,middle,nflorescence,nodding,outline,overlappin,pair,pale,papillo,pericarp,planar,plurifoliat,poricidal,portion,rectangular,rounded,ruit,scar,shiny,slender,somewhat,spaced,straight,tan,thin,tip,ud,vein,widest,woody,x,ympodial	abaxial,adaxial,articulation,bract,branching,breeding,broad-based,colour,connective,diameter,form,fruit,golden-brown,growth,hair,heteromorphism,inflorescence,insertion,interjected,interpetalar,leaflet,length,marking,modification,na,needle-like,odour,orientation,paired,pattern,placement,plurifoliate,position,prickle,pseudostipule,rhizome,scale,seed,shape,smell,spot,staman,stone,structure,symmetry,sympodial,system,texture,tissue,tuber,type,vegetative,width,xylopodia	.2,.3,.5,0.5-1,0.7-1,1-1.1,1-1.5,1.5-2,2-2.5,3-6,?,attenuate,base,brown,closely,cm,conical,dendritic,densely,flattened-reniform,glabrous,globose,golden,incrassate,internodal,lanceolate,leaf,like,lobed,long,margin,minutely,mm,nearly,opposite,orange-red,packed,papillose,pitted,pubescent,pubesent,red,rest,shaped,shrub,simple,small-capitate,sparsely,stem,subshrub,tear-drop,trichome,white	golden-brown,inflorescence,na,plurifoliate
464	wfo-0001031400	success	160	140	59	77	83	63	53	6	-3,0.25-0.8,0.6-1.8,0.7-6,0.8-1.1,1-2,1-4,1.2-2,1.5-5,10-11,2-5,4-13,4-17,4-6.5,4-7,4-7-25,5-12.5,6-23,7-28,apex,apically,base,branched,calyx,cell,cm,connate,corolla,cyme,dark,deeply,dehiscent,diameter,dichasial,dichasially,distal,filament,flower,globose,green,hair-like,half,herbaceous,interjected,lateral,leaf,leaflet,lower,mm,monochasial,oblique,odd-pinnate,ovoid,pair,pattern,pedicel,peduncle,perennial,perfect,petiole,plant,poricidally,proximal,puberulent,seed,stellate,structure,style,subglabrous,terminal,tone,tuber-bearing,unit,violet,wall,white,¼	0.4-1.7,1,2,2-3,2-9,3-6-foliat,abaxial,abaxially,abruptly,absen,acumen,acute,adaxially,apical,apiculate,articulate,covering,cuneate,decurrent,digestion,diminishing,dorsally,eaf,ebracteate,edge,eed,emoval,enzyme,exceeding,flat,folded,forked,forming,generally,globo,green-white,honeycomb,introrse,linear,linear-lanceolate,living,lobe,lon,long,lunat,make,maturing,mucilaginous,nflorescence,nther,oblong,occasionally,often,orolla,plan,rachi,reveal,ruit,sessile,seudostipule,short,side,size,slit,specimen,stamen,stigma,straight,stripe,tal,tem,testal,thick,throughout,tip,toward,trilobe,typically,vary,wide,without,yellow,ympodial	3-6-foliate,absent,anther,appressed,arrangement,articulation,bract,branching,breeding,broad-based,colour,connective,ebbrate,form,fruit,fruiting,growth,hair,height,heteromorphism,inflated,inflorescence,insertion,interpetalar,length,lunate,margin,marking,mature,modification,na,needle-like,number,odour,orientation,ovary,paired,placement,pore,position,present,prickle,pseudostipule,rhizome,scale,shape,smell,spot,staman,stem,stone,surface,symmetry,sympodial,system,texture,tissue,trichome,tuber,type,vegetative,width,xylopodia	-3,0.25-0.8,0.6-1.8,0.7-6,0.8-1.1,1-2,1-4,1.2-2,1.5-5,10-11,2-5,4-13,4-17,4-6.5,4-7,4-7-25,5-12.5,6-23,7-28,apically,branched,cm,connate,cyme,dark,deeply,dehiscent,dichasial,dichasially,distal,globose,green,hair-like,half,herbaceous,mm,monochasial,oblique,odd-pinnate,ovoid,perennial,perfect,plant,poricidally,proximal,puberulent,stellate,subglabrous,tone,tuber-bearing,violet,white,¼	3-6-foliate,absent,ebbrate,lunate,na,present
465	wfo-0001031401	success	182	131	69	88	94	43	67	2	0.6-1.2,1,1-1.5,1-6,1.1-3,1.5-2,1/2,2-5,2.5-4,3.5-4,3/4,5-7,5-9,abaxial,adaxial,age,anther,apex,attenuate,bark,base,becoming,berry,black,branching,brown,calyx,cm,corolla,dark,dendritic,densely,dichasial,drying,elliptic,filament,fruit,fruiting,globose,golden,golden-yellow,growth,leaf,lobed,matted,mm,narrowly,new,occasionally,pair,pedicel,petiole,plurifoliate,pore,poricidal,prominently,puberulent,pubescent,purplish-black,pyramidal,raised,scar,secondary,shiny,short,shrub,slit-like,small,sometimes,somewhat,sparsely,stem,strongly,terminal,time,tip,tree,tree-like,trichome,unit,usually,vein,violet,way,white,winged,x,yellow	0.5,0.8-1.2,1-1.4,2-2.4,3,5,7-9,8-10,abaxially,acute,adaxially,along,anthesi,apical,appearing,axi,basal,bi-lobed,blade,branch,clearly,conical,deciduous,deflexed,deltoid,denser,diameter,differentiated,eaf,ecuador,ecuadorian,edicel,eed,ew,exserted,finely,flattened,flower,fork,free,glabrous,impressed,inserted,lateral,lenticular,less,lobe,long,long-triangular,lower,m.,mesophyll,minutely,monochasia,near,nflorescence,noddin,nodding,node,often,older,outline,ovary,overtopping,papillo,per,pericarp,pitted,planar,portion,pubescen,reddish-brown,rounded,roundish,ruit,shoot,sleev,specimen,stamen,ste,stigma,style,surface,tall,tapering,thin,tub,tube,ud,visible,wide,woody,ympodial,young	bract,breeding,bud,cell,colour,form,hair,height,heteromorphism,inflorescence,interjected,interpetalar,leaflet,length,marking,monochasial,na,odour,orientation,pattern,placement,plant,position,prickle,pseudostipule,rhizome,scale,shape,size,spot,staman,stone,structure,symmetry,sympodial,system,texture,tissue,tuber,type,venation,width,xylopodia	0.6-1.2,1,1-1.5,1-6,1.1-3,1.5-2,1/2,2-5,2.5-4,3.5-4,3/4,5-7,5-9,age,attenuate,base,becoming,berry,black,brown,cm,dark,dendritic,densely,dichasial,drying,elliptic,globose,golden,golden-yellow,lobed,matted,mm,narrowly,occasionally,pair,plurifoliate,poricidal,prominently,puberulent,pubescent,purplish-black,pyramidal,raised,secondary,shiny,short,shrub,slit-like,small,sometimes,somewhat,sparsely,strongly,terminal,time,tip,tree,tree-like,usually,vein,violet,way,white,winged,x,yellow	monochasial,na
466	wfo-0001031480	success	233	104	43	61	172	43	39	4	/3,0.5-2,1-2,6-8,andromonoecious,anther,apex,articulated,base,berry,branched,branching,bright,calyx,cell,cm,cuneate,difoliate,ellipsoid,entire,erect,filament,fruit,fruiting,hair,lateral,leaf,length,lobed,long,lower,margin,marking,mature,maturity,mauve,mm,pale,pedicel,petiole,poricidal,prickle,purple,red,shallowly,shrub,simple,spherical,spreading,stem,surface,tapering,terminal,thick-chartaceous,tip,trichome,truncate,unarmed,unit,way,weakly	0-0.5,0-1,0-2,0-30,0-5,0.1-0.25,0.1-0.3,0.1-0.4,0.15-0.3,0.2-0.35,0.4,0.4-0.8,0.5-3-10,0.6-0.8,0.7,0.8,0.8-1,1-1.3,1-1.5,1-3,1-4,1.5-2.2,1.7-2.2,1.8-3,1/2,1/3,1/4,1/6-1/5,2-2.7,2-3,2-5,2-6,2-6-30,3,3-10,3-6,3-7,3.5-7,4-5,4-6,5-8,5-merous,6-13,7-8,8-12,abaxial,abaxially,acuminat,acute,adaxial,alyx,apar,apart,apically,apparently,ba,bark,blade,broad-deltate,cream,curved,dark,deltate,densely,diameter,discolorous,distal,distance,drying,dull,eaf,eed,elongate,elongating,equal,extending,eye,faint,flattened,flattened-reniform,flower,free,geminat,glabrescent,glabrous,glandular,green,hermaphrodite,heterostylous,inconspicuous,infructescence,lobe,long-styled,longer,lowermost,midpoint,midvein,minutely,moderately,naked,near,nflorescence,obtuse,often,older,one,open,orange-brown,orolla,oung,outline,ovate,pair,peduncle,pendulous,per,pericarp,persistent,pit,plant,porrect,portion,prickly,primary,pubescent,raised,ray,red-brow,red-brown,red-green,red-yellow-green,reduced,reticulate,rounded,ruit,scandent,scar,sessile,short-styled,shorter,side,slender,slightly,small,smooth,somewhat,spaced,sparsely,stalk,stalked,staminat,stellate,stellate-pubescent,straight,style,tamen,terete,tertiary,time,tube,unarme,upper,variously,vary,vein,venation,visible,wide,woody,yellow,ympodial,young	articulation,bract,breeding,broad-based,colour,corolla,form,geminate,growth,heteromorphism,inflorescence,insertion,interjected,interpetalar,leaflet,na,needle-like,odour,orientation,paired,pattern,placement,position,present,pseudostipule,rhizome,scale,shape,smell,spot,staman,stone,structure,symmetry,sympodial,system,texture,tissue,tuber,type,vegetative,xylopodia,zygomorphy	/3,0.5-2,1-2,6-8,andromonoecious,articulated,base,berry,branched,bright,cm,cuneate,difoliate,ellipsoid,entire,erect,lateral,lobed,long,maturity,mauve,mm,pale,poricidal,purple,red,shallowly,shrub,simple,spherical,spreading,tapering,terminal,thick-chartaceous,tip,truncate,unarmed,way,weakly	geminate,na,present,zygomorphy
467	wfo-0001031483	success	154	119	62	77	77	42	60	2	.5,/2,0.5-2,1,1-2,1.1-2.5,1.7-5.5,11-20.5,2-2.5,2-3,2.5-3.2,3-4,3-8-flowered,7-10,acuminate,acute,almost,anther,apart,apex,attenuate,base,berry,calyx,cm,corky,corolla,decurrent,deflexed,difoliate,filament,filiform,flower,fruiting,fusiform,glabrous,green,internode,leaf,lenticellate,less,linear,lobed,lower,major,minor,mm,oblanceolate,oblong,obovate,obovoid,opposite,orbiculate,ovoid-reniform,pair,pale,pedicel,pore,poricidal,rounded,scar,shape,shaped,shrub,simple,slightly,stem,subshrub,tapering,tear-drop,tip,turbinate,unit,vein,way,white,x	0,0.5,1.2-1.4,1/3,6-10,across,anew,anthesi,ba,bearing,beginning,beneath,blade,ca,caly,clavate,continuous,cork,deltoid,dia,distal,dry,eaf,edicel,eed,end,evenly,exserted,free,fresh,geminat,indistinc,indistinct,larger,lateral,lea,lobe,long,main,markedly,minutely,nflorescence,often,ovary,paler,papillo,papillose,per,petiole,planar,pointed,portion,prominent,quite,raised,ruit,short,short-triangular,slender,somewhat,soon,spaced,stigma,straight,strongly,style,tall,tan,third,tube,ud,variable,widest,wing,winged,woody,ympodial	appressed,broad-based,bud,cell,colour,connective,form,fruit,geminate,growth,height,heteromorphism,inflated,inflorescence,length,marking,modification,na,needle-like,number,orientation,placement,plant,position,prickle,pseudostipule,rhizome,seed,size,spacing,spot,staman,stone,structure,surface,symmetry,sympodial,texture,tuber,type,xylopodia,zygomorphy	.5,/2,0.5-2,1,1-2,1.1-2.5,1.7-5.5,11-20.5,2-2.5,2-3,2.5-3.2,3-4,3-8-flowered,7-10,acuminate,acute,almost,apart,attenuate,base,berry,cm,corky,decurrent,deflexed,difoliate,filiform,fusiform,glabrous,green,leaf,lenticellate,less,linear,lobed,mm,oblanceolate,oblong,obovate,obovoid,opposite,orbiculate,ovoid-reniform,pair,pale,poricidal,rounded,shaped,shrub,simple,slightly,stem,subshrub,tapering,tear-drop,tip,turbinate,way,white,x	geminate,na
468	wfo-0001031492	success	175	104	38	55	120	49	36	2	.5,0.7-1.3,1-1.5,2-5,4-4.5,age,anther,apex,attenuate,base,becoming,berry,branching,calyx,cm,conical,corolla,decurrent,densely,echinoid,elliptic,filament,fruit,fruiting,globose,growth,leaf,lobed,long,lower,medium,mm,narrowly,pedicel,petiole,plurifoliate,pore,poricidal,predominantly,pubescent,purplish-black,shrub,size,sleeve,slit-like,stem,surface,terminal,time,tip,tree,tree-like,trichome,unit,violet	/4,0.5,0.9-1.1,08,1-1.3,1.3-2,1.5-1.8,1.5-2.5,10-15,2-10,2-3,20,3-4,3-5,4-10,6-8,8-11,8-9,abaxially,absent,acuminate,acute,adaxially,anthesi,apical,appearing,axe,ba,bark,basal,beneath,bi-lobed,bitter,dark,dbh,deciduous,deltoid,dendritic,denser,diameter,distinguishable,drying,dull,eaf,edicel,eed,erect,ew,exserted,flattened,flower,free,glabrous,golden,grey,inserted,juice,lamina,lateral,lenticular,lightly,lobe,m.,minutely,monochasia,nflorescence,nodding,occasionally,older,ovary,overtopping,pair,papillo,per,pericarp,pitted,planar,portion,prominent,pyramidal,rather,reddish-brown,remaining,ruit,scar,scarcely,scattered,secondary,shiny,shoot,short,slightly,sometimes,somewhat,sparsely,stamen,ste,sticky,stigma,strongly,style,sunken,tall,tapering,thin,tub,tube,ud,undersurface,upper,upturned,vein,way,wide,winged,woody,x,ympodial,young,younger	appressed,articulation,bract,breeding,broad-based,cell,colour,form,hair,heteromorphism,inflated,inflorescence,insertion,interjected,interpetalar,leaflet,length,margin,marking,mature,monochasial,na,needle-like,odour,orientation,pattern,placement,position,prickle,pseudostipule,rhizome,scale,shape,smell,spot,staman,stone,structure,symmetry,sympodial,system,texture,tissue,tuber,type,vegetative,width,xylopodia,zygomorphy	.5,0.7-1.3,1-1.5,2-5,4-4.5,age,attenuate,becoming,berry,cm,conical,decurrent,densely,echinoid,elliptic,globose,lobed,long,medium,mm,narrowly,plurifoliate,poricidal,predominantly,pubescent,purplish-black,shrub,size,sleeve,slit-like,terminal,time,tip,tree,tree-like,violet	monochasial,na
469	wfo-0001031503	success	139	146	74	87	52	59	70	4	-10,-15,-30,-7,0.3-3,0.5-1,0.5-4,1-2.5,1-3,1-5,1-7,1.5-2,1.5-3,1.5-8,10-19,2-3,2.5-10,3-4,3-5,3-6,6-7,7-10,acuminate,acute,angled,apart,apex,articulated,base,branched,calyx,cell,chartaceous,cm,cuneate,cylindrical,decurrent,deltate,densely,diameter,directed,distally,elliptic,entire,flower,forked,glabrous,globose,hair,lanceolate,lobe,margin,mm,moderately,often,orange,ovate,pedicel,peduncle,petiole,pore,present,puberulent,pubescent,rachi,radiu,rarely,reddish,ripe,rounded,rugose-pubescent,shrub,simple,slightly,sparsely,stellate,stigma,stone,style,subclavate,truncate,unbranched,unequal,unit,white,x,yellow	1-1.5-7,1.7-3.5-6,3-15-25,5613,6-many-foliat,7-15,abaxially,abruptly,absen,adaxially,aggregate,axe,ba,blade,connivent,curled,distall,eaf,eed,eglandular,except,fide,gland,long,lower,mostly,narrowed,narrowly,nflorescence,nther,obtuse,occasionally,orolla,perfect,ruit,spaced,stalked,subcapitat,tal,tem,time,tip,toward,triangular,tube,uniseriate,usually,vary,vein,venturi,wide,ympodial	6-many-foliate,abaxial,absent,adaxial,anther,arrangement,articulation,bract,branching,breeding,colour,connective,corolla,direction,filament,form,fruit,growth,height,heteromorphism,inflorescence,insertion,interjected,interpetalar,leaf,leaflet,length,marking,mature,modification,na,odour,orientation,ovary,paired,pattern,placement,plant,position,prickle,pseudostipule,rhizome,scale,seed,shape,spacing,spot,staman,stem,structure,subcapitate,symmetry,sympodial,system,texture,tissue,tuber,type,xylopodia	-10,-15,-30,-7,0.3-3,0.5-1,0.5-4,1-2.5,1-3,1-5,1-7,1.5-2,1.5-3,1.5-8,10-19,2-3,2.5-10,3-4,3-5,3-6,6-7,7-10,acuminate,acute,angled,apart,apex,articulated,base,branched,chartaceous,cm,cuneate,cylindrical,decurrent,deltate,densely,directed,distally,elliptic,entire,forked,glabrous,globose,lanceolate,mm,moderately,often,orange,ovate,present,puberulent,pubescent,rarely,reddish,ripe,rounded,rugose-pubescent,shrub,simple,slightly,sparsely,stellate,subclavate,truncate,unbranched,unequal,white,x,yellow	6-many-foliate,absent,na,subcapitate
470	wfo-0001031586	success	166	96	36	52	114	44	35	1	0.1-1,0.5-1,1-1.2,1-1.5-2,1-2,1.3-5,1.5-2,2,3-11,5-6,anther,apex,base,calyx,capitate,cm,corolla,cream-colored,deltate,elliptic,filament,glabrous,green,greenish,inflorescence,leaf,lobe,lobed,margin,mm,nearly,opposite,pale,pedicel,petiole,pore,ridged,rounded,shaped,shiny,shrub,simple,size,stigma,style,tear-drop,trichome,tube,unit,white,x,yellow	.25,0.5-0.8,1,1.4-2.5,2-2.5,5-10,7-10-flowered,abrupt,absent,acute,anthesi,apart,apparently,appearing,attenuate,bark,becoming,beneath,borne,branch,bright,broadly,bud,campanulate,closer,completely,conical,cucullate,deflexed,dia,differing,difoliate,distance,drying,eaf,edicel,eed,ellipsoid,exerted,exfoliatin,fleshy,flower,free,fresh,geminate,globose,gree,inflorescenc,know,known,later,lateral,leave,long,lower,main,major,material,may,minor,minutely,mucro,near,new,nflorescence,notched,occasionally,older,olive,one,onto,open,ovary,overtopping,pair,paler,papillate,papillose,planar,poricidal,portion,present,prominent,raised,remaining,ruit,scar,shap,shin,slender,small,sometimes,somewhat,soon,spaced,sparsely,stem,straight,surface,swollen,tall,tapering,thick,thickened,tip,truncate,trunk,ud,uniseriate,vein,widely,yellowish,ympodial,young	articulation,bract,branching,breeding,cell,colour,connective,form,fruit,growth,hair,height,heteromorphism,insertion,interjected,interpetalar,leaflet,length,marking,modification,na,odour,orientation,pattern,placement,plant,position,prickle,pseudostipule,rhizome,scale,shape,spot,staman,stone,structure,symmetry,sympodial,system,texture,tissue,tuber,type,xylopodia	0.1-1,0.5-1,1-1.2,1-1.5-2,1-2,1.3-5,1.5-2,2,3-11,5-6,base,capitate,cm,cream-colored,deltate,elliptic,glabrous,green,greenish,leaf,lobed,mm,nearly,opposite,pale,ridged,rounded,shaped,shiny,shrub,simple,tear-drop,white,x,yellow	na
471	wfo-0001031587	success	142	83	53	68	74	15	50	3	.5,0.8-1,1-1.5,1.5-2,1.7-2,10-15,2-9-celled,2/3,3-4,5,6-7,6-8,abaxially,acute,anther,apart,apex,attenuate,bark,base,bi-lobed,broadly,calyx,clavate,cm,conical,corolla,dendritic,elliptic-ovoid,filament,fleshy,furcate,glabrous,golden-red,inflorescence,leaf,lobed,minor,minutely,mm,oblique,ovary,pale,pedicel,petiole,pore,rarely,reddish-grey,shape,shaped,simple,size,soft,stem,stigma,style,tear-drop,thick,thickened,tree,trichome,tube,uniseriate,verrucose,way,white,winged,x	12-16,17-30,2,2-2.5,7-9,adaxially,along,anthesi,axi,closely,cone,decurrent,deflexed,deltate,densely,denser,dia,differing,drying,eaf,edicel,eed,elliptic,erect,evenly,exserted,fide,free,globose,included,irregular,know,known,lamina,later,lateral,like,lobe,long,loose,lower,lowered,main,major,middle,mostly,ocasionally,occasional,older,overlappin,pair,papillate,papillo,parallel,perpendicular,persisten,poricidal,portion,pubescent,rect,rest,ruit,scar,somewhat,spaced,steinbach,surface,tall,tip,tub,ud,vein,widest,young	colour,diameter,form,fruit,growth,hair,height,length,na,occasionally,papillose,plant,spacing,texture,type	.5,0.8-1,1-1.5,1.5-2,1.7-2,10-15,2-9-celled,2/3,3-4,5,6-7,6-8,abaxially,acute,apart,apex,attenuate,base,bi-lobed,broadly,clavate,cm,conical,dendritic,elliptic-ovoid,fleshy,furcate,glabrous,golden-red,lobed,minutely,mm,oblique,pale,rarely,reddish-grey,shaped,simple,soft,tear-drop,thick,thickened,tree,trichome,uniseriate,verrucose,way,white,winged,x	na,occasionally,papillose
472	wfo-0001031589	success	221	104	47	61	160	43	42	5	0.1-0.5,0.2-0.5,1/3-1/4,2-10,2.8-4,8-14,anther,apex,articulated,attenuate,base,berry,bright,calyx,cell,chartaceous,cm,connivent,difoliate,elongating,equal,erect,filament,flower,fruit,fruiting,lateral,leaf,length,lobed,long,lower,margin,marking,mature,mauve,membranous,mm,narrow-cuneate,pedicel,petiole,poricidal,prickle,reflexed,shrub,simple,solitary,sometimes,somewhat,spherical,stellate-pubescent,stem,straight,surface,tapering,tip,trichome,unit,way,white,yellow	-15,-6,-6.5,.5,/6,0,0-1,0-10,0-3,0-30,0.1,0.15-0.3,0.2-0.4-0.5,0.2-3,0.4,0.5-1,0.55-0.7,0.6-1.2,0.7,0.8-2.3,0.9-1.3,0.9-1.6,1,1-1.8,1-5,1.2-1.5,1.5-5,1.7-2.5,1.8-2.9,1/3,1/3-1/2,10-30,2-3-4,2-3.5,2.5-4.5,2.5-6,3-4,3-5,3/4,4-6.5,4/5,5-8,5-merous,6-8,8-30,abaxially,acute,alyx,ame,apart,apically,apparently,bark,blade,broadly,brow,brown-green,c.,caudat,concolorous,cream,dark,deltate,densely,density,diameter,discolorous,distance,drying,dull,eed,elliptic,extending,eye,flattened-reniform,free,geminat,glabrescent,glabrous,gray-green,green,higher,infructescence,lengt,lobe,lon,long-obovate,longer,maturity,midpoint,midvein,moderately,multangulate,naked,narrow,nflorescence,oblong,obovate,occasionally,often,older,orange-brown,orange-green,orolla,oung,outline,pair,pale,part,pendulous,per,perfec,pericarp,pit,plant,porrect,portion,prickl,prickly,primary,raised,ray,rounded,ruit,scandent,sessile,shiny,shorter,side,small,smooth,spaced,sparsely,spreading,stalk,stalked,stellate,stout,style,subentire,subsessile,tamen,terete,tertiary,time,tube,upper,vary,vein,venation,visible,weakly,whole,wide,winged,woody,yellow-green,yellow-orange,ympodial,young	appressed,articulation,bract,branching,broad-based,colour,corolla,form,geminate,growth,hair,heteromorphism,inflated,inflorescence,insertion,interjected,interpetalar,leaflet,na,needle-like,odour,orientation,paired,placement,position,pseudostipule,rhizome,scale,shape,smell,spot,staman,stone,structure,symmetry,sympodial,texture,tissue,tuber,type,vegetative,xylopodia,zygomorphy	0.1-0.5,0.2-0.5,1/3-1/4,2-10,2.8-4,8-14,articulated,attenuate,base,berry,bright,chartaceous,cm,connivent,difoliate,elongating,equal,erect,flower,lateral,lobed,long,mauve,membranous,mm,narrow-cuneate,poricidal,reflexed,shrub,simple,solitary,sometimes,somewhat,spherical,stellate-pubescent,straight,surface,tapering,tip,way,white,yellow	appressed,geminate,na,needle-like,zygomorphy
473	wfo-0001031609	success	153	98	44	55	98	43	42	2	1-10,1-6,1.5-2,2,2-3-9-lobed,3-24,3-5,4-6,4.5-60,abaxially,absent,adaxially,apex,articulated,base,brownish,calyx,campanulate,cell,cm,connective,connivent,cuneate,elliptic,elliptic-ovate,entire,forked,fruit,glabrous,globose,green,inflorescence,leaf,lobed,margin,mm,obovate,orange,pedicel,petiole,pinnately,pore,ripe,shrub,simple,small,stellate,stone,succulent,tree,unbranched,unit,unlobed,x,yellow	.5,/4,0-30,0.4-3,0.5-1,0.5-3,1.3-3,1.5-3,10-25,2-3,2.5-4,20-25,3-foliat,4,4-5,5-25,5/6,8-20,absen,acute,aggregate,ape,apiculate,around,axe,barely,beyond,bilobe,blade,branch,brow,conspicuous,contiguous,dark,deltate,dia,diameter,dilated,directed,distally,divided,eaf,eed,ellipsoidal,emerging,equal,exceeding,exserted,flattened,fleshy,flower,glabrou,laterally,leaving,lobe,long,lower,midrib,minutely,nearly,nflorescence,nther,obconical,obtuse,occasionally,orolla,papillose,pedicellar,peduncle,point,puberulent,rachi,radiu,reticulate,rounded,ruit,scar,shallowly,sinus,stamen,stigma,strongly,style,succulen,tal,tem,thecae,time,tip,tomento,triangular,truncate,tube,two,ud,vary,wide,ympodial	3-foliate,anther,arrangement,articulation,bract,branching,colour,corolla,filament,form,fruiting,growth,hair,height,heteromorphism,insertion,length,lobing,marking,mature,modification,na,odour,orientation,placement,plant,position,prickle,pseudostipule,rhizome,shape,size,spot,staman,stem,structure,succulence,symmetry,sympodial,texture,tuber,type,xylopodia	1-10,1-6,1.5-2,2,2-3-9-lobed,3-24,3-5,4-6,4.5-60,abaxially,absent,adaxially,articulated,base,brownish,campanulate,cm,connivent,cuneate,elliptic,elliptic-ovate,entire,forked,glabrous,globose,green,lobed,mm,obovate,orange,pinnately,ripe,shrub,simple,small,stellate,succulent,tree,unbranched,unlobed,x,yellow	3-foliate,na
474	wfo-0001031615	success	154	116	63	70	84	46	58	5	.5,0.5-1,1-1.6,2-3,acute,anther,anthesi,apex,attenuate,base,berry,calyx,closely,cm,corolla,decurrent,dia,difoliate,distal,elliptic,exserted,filament,fruit,fruiting,furcate,glabrous,globose,green,inflorescence,interpetalar,leaf,lobe,lobed,long,margin,middle,minutely,mm,nearly,occasionally,opposite,packed,papillose,pedicel,petiole,pore,poricidal,reflexed,scarcely,shaped,shrub,simple,sinus,slender,slightly,small,tapering,tear-drop,thin,tip,tree,trichome,tube,tuft,unicellular,uniseriate,unit,white,widest,winged	0,0.5,0.8-1,0.9-1.1,1.3-1.8,1.5,1.5-5,11-15.5,2-4.2,3.8-6.1,4-6.5,5-20-flowered,5-6,6-8,8-10,acuminate,arising,axil,ba,bark,becoming,bilobed,brown,caly,capitate,dark,dark-papillo,deep,deflexed,deltoid,differing,eaf,edicel,eed,expanded,flattened-reniform,free,geminat,glandular,impressed,incrassate,lamina,lateral,less,lon,lower,main,major,maroo,minor,minute,nflorescence,older,one,ovary,overlappin,pair,paler,papillae,per,pitted,portion,prominent,ruit,scar,shiny,size,somewhat,stem,stigma,straight,style,subumbellate,surface,tall,terminal,thickened,ud,urceolate,vein,woody,x,ympodial,young	appressed,articulation,bract,branching,breeding,cell,colour,connective,form,geminate,growth,hair,heteromorphism,inflated,insertion,interjected,leaflet,length,marking,mature,modification,na,odour,orientation,paired,pattern,placement,position,prickle,pseudostipule,rhizome,scale,shape,spot,staman,stone,structure,symmetry,sympodial,system,texture,tissue,tuber,type,xylopodia,zygomorphy	.5,0.5-1,2-3,acute,anthesi,attenuate,base,berry,calyx,closely,cm,decurrent,difoliate,distal,elliptic,exserted,furcate,glabrous,globose,green,inflorescence,interpetalar,leaf,lobe,lobed,long,middle,minutely,mm,nearly,occasionally,opposite,packed,papillose,pore,poricidal,reflexed,scarcely,shaped,shrub,simple,sinus,slender,slightly,small,tapering,tear-drop,thin,tip,tree,trichome,tube,tuft,unicellular,uniseriate,white,widest,winged	-1.6,di,geminate,na,zygomorphy
475	wfo-0001031618	success	184	149	82	95	89	54	79	3	0-3,1-1.5,1-1.5-2,1-7,1.5-2,2-3,3-4,4-5,40-60,90-110,acute,anther,apex,axil,base,becoming,berry,bluntly,branch,calyx,capitate,cell,cm,corolla,cuneate,cyme,darker,discoidal,ellipsoid,elliptic,equal,exerted,facetted,filament,finely,glabrous,glandular,green,greyish,growing,hair,lanceolate,lavender-purple,leaf,lengthening,less,lobe,long,marbled,maturity,minute,mm,narrowly,oblong,obovoid,often,ovary,ovoid,pale,pedicel,peduncle,petiole,pinatisect,point,pore,poricidal,purple,reddish-brown,reticulate,ripe,rotate,rounded,rugose,scorpioid,shrub,simple,slit,somewhat,stem,stigma,stone,stripe,strongly,succulent,surface,tapering,terete,tinged,tip,tissue,triangular,unequal,variable,x,young	0.5-1.5,1.5-3.5,10-18,10-lobed,13,2-2.5,3,3-8,5,5-12,acuman,almost,also,anthesi,appearance,appearing,aspect,beyond,blunt,broadly,c.,clonal,cluster,column,conical,covering,cut,developed,dia,eaf,eed,emarginate,enlarged,erect,except,extending,fleshy,floral,flower,fork,forked,frui,general,giving,greatly,gree,habit,half,interacuminal,lasting,lobed,lon,loosely,lower,mauve,may,mid-vein,midrib,nflorescence,occasional,occur,ovate-lanceolate,pal,pedicellate,petal,plurifoliat,rarely,rhachi,ruit,sessile,several,shallowly,side,single,sinus,soft-wooded,sometimes,specimen,stout,styl,tub,ud,unit,vigorous,way,well,year,ympodial,younger	appressed,arrangement,articulation,bract,branching,breeding,bud,colour,connective,diameter,form,fruit,fruiting,growth,height,heteromorphism,inflated,inflorescence,insertion,interjected,interpetalar,leaflet,length,margin,marking,mature,modification,na,number,odour,orientation,paired,pattern,placement,plant,plurifoliate,position,prickle,pseudostipule,rhizome,scale,seed,shape,size,spot,staman,style,symmetry,system,texture,tube,tuber,type,xylopodia	0-3,1-1.5,1-1.5-2,1-7,1.5-2,2-3,3-4,4-5,40-60,90-110,acute,axil,becoming,berry,bluntly,branch,calyx,capitate,cm,cuneate,cyme,darker,discoidal,ellipsoid,elliptic,equal,exerted,facetted,finely,glabrous,glandular,green,greyish,growing,hair,lanceolate,lavender-purple,leaf,lengthening,less,long,marbled,maturity,minute,mm,narrowly,oblong,obovoid,often,ovoid,pale,pinatisect,point,pore,poricidal,purple,reddish-brown,reticulate,ripe,rotate,rounded,rugose,scorpioid,shrub,simple,slit,somewhat,stripe,strongly,succulent,tapering,terete,tinged,tip,triangular,unequal,variable,x,young	na,plurifoliate,tube
476	wfo-0001031646	success	169	163	97	118	51	45	93	4	-pinnate,.2,.5,0.2-0.8,0.5-2,0.8-1.5,1-1.8,1-10,1-6,1.2-2.5,1.5-3.5,1.5-4,15-25,2-10,2-2.5,2-3,2.5-10,20,3.5-4,4-18,4-20,4-5,4-foliate,5-6,5-7,5-7.5,7-8,8-15,abaxially,absent,acuminate,acute,adaxially,anther,apart,apex,articulated,base,berry,blade,blue,branched,brown,calyx,cell,chartaceous,cm,cuneate,cylindrical,darker,densely,diameter,directed,ellipsoidal,elliptic-lanceolate,entire,filament,flattened,flower,fruit,glabrous,globose,green,hair,highly,homostylous,immature,interjected,leaf,leaflet,light,lobe,margin,maroon,mature,mm,multicellular,oblique,obliquely,oblong,obtuse,ovate-lanceolate,part,pedicel,peduncle,petiole,petiolule,pore,present,pubescence,pubescent,rachi,red,rotate-pentagonal,rounded,rugulose,scandent,shortly,shrub,simple,size,small,smooth,spreading,stem,stigma,stone,style,surface,tawny,tip,tube,uniseriate,unit,vine,violet,x,yellow	18-38,1962,4-8,5-merou,absen,accrescent,acut,aggregate,alyx,apical,apparently,axe,ba,basally,ciliat,climbing,connivent,correll,covered,decreasing,distall,eaf,eed,elliptic,equal,fide,fruiting,geminat,glandular,high,hyaline,lateral,long,lower,nflorescence,orolla,ovate-lanceolat,perfect,pubescen,ruit,seudostipule,slightly,spaced,stout,tamen,tem,toward,tree,truncat,vary,ympodial	articulation,bract,branching,breeding,colour,connective,corolla,distally,form,geminate,growth,heteromorphism,inflorescence,insertion,interpetalar,length,marking,modification,na,odour,orientation,ovary,paired,pattern,placement,position,prickle,pseudostipule,rhizome,scale,seed,shape,spacing,spot,staman,structure,symmetry,sympodial,system,texture,tissue,truncate,tuber,type,xylopodia	-pinnate,.2,.5,0.2-0.8,0.5-2,0.8-1.5,1-1.8,1-10,1-6,1.2-2.5,1.5-3.5,1.5-4,15-25,2-10,2-2.5,2-3,2.5-10,20,3.5-4,4-18,4-20,4-5,4-foliate,5-6,5-7,5-7.5,7-8,8-15,abaxially,absent,acuminate,acute,adaxially,apart,articulated,base,berry,blue,branched,brown,chartaceous,cm,cuneate,cylindrical,darker,densely,directed,ellipsoidal,elliptic-lanceolate,entire,flattened,flower,fruit,glabrous,globose,green,hair,highly,homostylous,immature,light,maroon,mature,mm,multicellular,oblique,obliquely,oblong,obtuse,ovate-lanceolate,part,present,pubescence,pubescent,red,rotate-pentagonal,rounded,rugulose,scandent,shortly,shrub,simple,small,smooth,spreading,stem,tawny,tip,uniseriate,vine,violet,x,yellow	distally,geminate,na,truncate
477	wfo-0001031651	success	199	140	71	95	104	45	69	2	.1,.7,/3,/5,0-20,0.3-0.8,0.6-1,0.7-1,1-4,1/6-1/4,3-5,4-6,abaxial,adaxial,anther,apart,apex,apparently,articulated,base,berry,blade,branched,brown,calyx,cell,chartaceous,cm,curved,diameter,dull,elliptic,entire,equal,erect,eye,faint,filament,flattened-reniform,free,fruit,fruiting,gray,herb,lateral,leaf,length,lobed,lower,margin,mature,maturity,mm,naked,obtuse,orange-brown,ovate,pair,pedicel,per,petiole,poricidal,portion,prickle,prickly,primary,purple,red,red-green,reflexed,rounded,scar,shrub,spherical,spreading,stellate,stellate-pubescent,stem,subentire,surface,tapering,terminal,tertiary,tip,trichome,tube,unarmed,vein,venation,visible,way,weakly,white,yellow,yellow-green	-3,-3.5,.6,0.1,0.1-0.15,0.1-0.2,0.1-0.25,0.15-0.2,0.2-0.5,0.3-0.5,0.3-1.5,0.6-1.3,1-1.7,1-2,1.2-2,1.2-3,1.3-1.6,1.5-2,1/5,2-10,2-3,2-3.5,2/3-3/,4-5,4.5-7,5-merous,abaxially,absent,acuminat,acute,alyx,ame,apar,apically,bark,c.,concolorous,cordate,dark,deltate,densely,difoliate,discolorous,drying,eaf,eed,elongating,filiform,flower,geminat,glabrescent,glabrous,gra,herbaceous,infructescence,lanceolate,lobe,long,longer,midpoint,nflorescence,oblong,older,one,open,orolla,oung,outline,peduncle,pendulous,perfec,pericarp,persistent,pit,porrect,prickl,raised,ray,ruit,scandent,shorter,simple,small,smooth,sometimes,spaced,stalk,stalked,straight,style,subsessile,tamen,terete,thick,thick-stalked,time,toward,unarme,unit,upper,variously,vary,wide,ympodial	articulation,bract,branching,breeding,broad-based,colour,corolla,form,growth,hair,heteromorphism,inflorescence,insertion,interjected,interpetalar,leaflet,marking,na,needle-like,number,odour,orientation,perfect,placement,position,pseudostipule,rhizome,scale,seed,shape,smell,spacing,spot,staman,stone,symmetry,system,texture,tissue,tuber,type,vegetative,width,xylopodia,zygomorphy	.1,.7,/3,/5,0-20,0.3-0.8,0.6-1,0.7-1,1-4,1/6-1/4,3-5,4-6,apart,apparently,articulated,base,berry,blade,branched,brown,chartaceous,cm,curved,dull,elliptic,entire,equal,erect,eye,faint,flattened-reniform,fruit,gray,herb,lateral,leaf,length,lobed,mature,maturity,mm,naked,obtuse,orange-brown,ovate,pair,poricidal,prickly,purple,red,red-green,reflexed,rounded,shrub,spherical,spreading,stellate,stellate-pubescent,subentire,tapering,terminal,tip,unarmed,visible,way,weakly,white,yellow,yellow-green	na,perfect
478	wfo-0001031656	success	154	150	80	95	59	55	73	7	.5,0.5-1,1-2.5,1.5-2,1.5-5,10-20,2.5-3.5,3-3.5,3-5,4-9,5-ribbed,6-8,acuminate,acute,anther,anthesi,apex,bark,base,berry,bright,calyx,capitate,closely,cm,corolla,dia,difoliate,drying,ellipsoid,elliptic,enclosing,erect,filament,fleshy,fruit,fruiting,glabrous,globose,green,greyish,known,leaf,live,lobe,lobed,long,long-acuminate,lower,margin,matte,mature,middle,minor,minutely,mm,oblique,opposite,ovary,ovate,pale,papillose,pedicel,persistent,petiole,plant,pore,poricidal,proximal,rather,red-papillose,reddish,rounded,scar,sessile,shaped,shiny,shrub,size,somewhat,spaced,stigma,strongly,style,surface,tear-drop,thick,tip,transversely,unit,upper,white,widest,woody,x	/4,0.5,1-1.5,1-2,1.2-1.5,5-7,also,arising,ba,cork,densely,differing,directly,eaf,edicel,eed,extremely,flower,free,geminat,hooded,lateral,lon,main,major,minute,nflorescence,node,often,older,one,pair,paler,papillo,peelin,planar,portion,prominent,reflexed,rib,ridged,ruit,slightly,specimen,stem,straight,swollen,tall,terminal,thickened,top,tube,ud,vein,visible,way,wide,ympodial,young	appressed,articulation,bract,branching,breeding,bud,cell,colour,connective,corky,form,geminate,growth,hair,height,heteromorphism,inflated,inflorescence,information,insertion,interjected,interpetalar,leaflet,length,marking,modification,na,odour,orientation,paired,pattern,peeling,persistence,placement,point,position,prickle,pseudostipule,rhizome,scale,seed,shape,spot,staman,stellate,stone,structure,symmetry,sympodial,system,texture,tissue,tuber,type,xylopodia	.5,0.5-1,1-2.5,1.5-2,1.5-5,10-20,2.5-3.5,3-3.5,3-5,4-9,5-ribbed,6-8,acuminate,acute,anthesi,berry,bright,capitate,closely,cm,corolla,difoliate,drying,ellipsoid,elliptic,enclosing,erect,fleshy,fruit,glabrous,globose,green,greyish,known,leaf,live,lobed,long,long-acuminate,matte,mature,middle,minutely,mm,oblique,opposite,ovate,pale,papillose,persistent,plant,pore,poricidal,proximal,rather,red-papillose,reddish,rounded,sessile,shaped,shiny,shrub,somewhat,spaced,strongly,surface,tear-drop,thick,tip,transversely,white,woody,x	.5-3.5,corky,di,geminate,na,peeling,stellate
479	wfo-0001031667	success	153	119	60	62	91	57	47	13	1-1.5,1-4,2-5,5-9,apex,apical,apically,articulate,base,branched,calyx,cell,cm,connate,cordate,corolla,cuneate,dark,dehiscent,dichasially,distal,filament,generally,globose,green,hair-like,half,herbaceous,interjected,introrse,leaf,leaflet,long,lower,maturing,mm,mucilaginous,oblique,odd-pinnate,often,ovoid,pattern,pedicel,perennial,perfect,petiole,pilose,plant,poricidally,proximal,rounded,seed,short,slit,spot,stellate,stripe,tuber-bearing,typically,unit,white,¼	0.6-1,0.6-1.5,1.4-3,1.5-2,10-13,12-35,2-3,2-6,2.5-5,3-13,3-5,3-6-foliat,3-8,4-1.,5-15,6-10,8-13,8-15,abaxially,abruptly,acumen,acuminate,acute,adaxially,apiculate,caudate,covering,cyme,diameter,dichasial,digestion,diminishing,dorsally,eaf,ebracteate,edge,eed,elliptic-lanceolate,emoval,enzyme,exceeding,flat,flower,folded,forked,globo,green-white,honeycomb,irregularly,lanceolate,lateral,living,lobe,lobed,lon,lunat,make,monochasial,nflorescence,nther,oblong,orolla,pair,peduncle,petiolate,petiolule,plan,reveal,ruit,sessile,seudostipule,size,specimen,stamen,stigma,straight,style,tal,tem,terminal,testal,thick,throughout,toward,vary,wall,whit,wide,without,yellow,ympodial	3-6-foliate,4-10,anther,appressed,articulation,bract,branching,breeding,broad-based,colour,connective,ebbrate,form,fruit,fruiting,growth,hair,heteromorphism,inflated,inflorescence,insertion,interpetalar,length,lunate,margin,marking,mature,modification,na,needle-like,odour,orientation,paired,placement,pore,position,prickle,pseudostipule,rhizome,scale,shape,staman,stem,stone,structure,surface,symmetry,sympodial,system,texture,tissue,tuber,type,wet,xylopodia,ye,zygomorphy	1-1.5,1-4,2-5,5-9,apical,apically,articulate,branched,cm,connate,cordate,cuneate,dark,dehiscent,dichasially,distal,generally,globose,green,hair-like,half,herbaceous,introrse,long,maturing,mm,mucilaginous,oblique,odd-pinnate,often,ovoid,perennial,perfect,pilose,plant,poricidally,proximal,rounded,short,slit,spot,stellate,stripe,tuber-bearing,typically,white,¼	3-6-foliate,4-10,broad-based,ebbrate,lunate,na,needle-like,prickle,stem,tuber,wet,ye,zygomorphy
480	wfo-0001031672	success	157	147	78	98	59	49	76	2	0,0.3-0.5,0.5,0.5-1,0.5-1.5,1,1-10,1-2,1-5,1.5-2,1.5-2.5,1.5-3.5,1.5-5,10-20,15-20,15-50,2-12,4,4.5-5,5-6,6,9-lobed,abaxially,acuminate,acute,adaxially,apex,apiculate,base,beyond,calyx,cell,chartaceous,cm,connective,cordate,cylindrical,densely,diameter,directed,distally,entire,flattened,fleshy,flower,fruit,glabrous,glandular-puberulent,globose,green,greenish-brown,hair,lanceolate,leaf,lobe,lobed,margin,mature,mm,moderately,narrowly,near,obtuse,occasionally,ovate,ovoid,pedicel,peduncle,petiole,pilose,pinnately,pore,present,puberulent,purple,rachi,radiu,rounded,simple,sparsely,stamen,stellate,stigma,stone,style,subcoriaceous,tip,tree,triangular,truncate,tube,unbranched,unit,unlobed,white,whitish,x,yellow	0-2,1-1.5,1-1.5-2.5,2-28,3-4-foliat,3/4,4-34,4/5,absent,aggregate,apart,ape,articulated,aublet,axe,basal,blade,ciliat,divided,eaf,eed,exceeding,exserted,fide,leaving,lon,long,lower,membranaceous,midrib,nflorescence,nther,often,one,orolla,pedicellar,perfect,pilo,presen,pubescent,remant,represented,ruit,shorter,sinus,slightly,small,spaced,tal,tem,thecae,time,toward,truncat,ud,vary,wide,yello,ympodial	3-4-foliate,anther,articulation,bract,branching,bud,colour,corolla,exsertion,filament,form,fruiting,growth,height,heteromorphism,inflorescence,interjected,interpetalar,leaflet,length,lobing,marking,modification,na,orientation,ovary,placement,plant,position,prickle,pseudostipule,rhizome,scale,seed,shape,size,spacing,spot,staman,stem,structure,symmetry,sympodial,texture,theca,tissue,tuber,type,xylopodia	0,0.3-0.5,0.5,0.5-1,0.5-1.5,1,1-10,1-2,1-5,1.5-2,1.5-2.5,1.5-3.5,1.5-5,10-20,15-20,15-50,2-12,4,4.5-5,5-6,6,9-lobed,abaxially,acuminate,acute,adaxially,apex,apiculate,base,beyond,chartaceous,cm,cordate,cylindrical,densely,directed,distally,entire,flattened,fleshy,glabrous,glandular-puberulent,globose,green,greenish-brown,lanceolate,lobed,mm,moderately,narrowly,near,obtuse,occasionally,ovate,ovoid,pilose,pinnately,present,puberulent,purple,rounded,simple,sparsely,stamen,stellate,subcoriaceous,tip,tree,triangular,truncate,unbranched,unlobed,white,whitish,x,yellow	3-4-foliate,na
481	wfo-0001031684	success	161	136	64	81	80	55	61	3	/4,0.4-1.5,0.5-0.7,0.5-0.8,0.5-1,0.75-1,1-5,2-9,3-3.5,3-30,4-17,acute,along,anther,apex,bark,base,beneath,branched,clavate,cm,corolla,curly,decurrent,densely,difoliate,elliptic,filament,fruiting,geminate,glabrous,globose,green,inflorescence,internodal,irregularly,leaf,like,lobed,long,lower,major,minutely,mm,occasionally,older,opposite,ovary,ovoid-reniform,pale,papillose,pedicel,persistently,petiole,pore,pubescent,scar,shaped,shrub,size,slightly,small,sparsely,stem,stigma,style,surface,tan,tear-drop,tipped,tree,trichome,unifoliate,uniseriate,unit,vein,way,white,winged,x,young	.25,.5,.75,0.1,0.7-1,1-1.2,10-100,2,5-7,acuminate,anthesi,apar,bearing,berry,black,borne,calyx,causing,deflexed,denser,dia,differing,drying,eaf,edicel,eed,elongated,except,expanded,exserted,extremely,filiform,flower,free,gre,greatly,lateral,less,lobe,lon,long-triangular,main,middle,midrib,minor,nflorescence,obconic,one,pair,papillo,pitted,planar,poricidal,portion,present,previously,pulled,raised,reflexe,reflexed,rest,ruit,short,single,siz,slender,soon,spaced,straight,tall,tapering,time,tip,tube,ud,unevenly,varying,widely,widest,ympodial	apart,arrangement,articulation,bract,branching,breeding,broad-based,bud,cell,colour,connective,form,fruit,grey,growth,hair,height,heteromorphism,insertion,interjected,interpetalar,leaflet,length,margin,marking,modification,na,needle-like,odour,orientation,pattern,placement,plant,position,prickle,pseudostipule,rhizome,scale,seed,shape,smell,spacing,spot,staman,stone,structure,symmetry,sympodial,system,texture,tissue,tuber,type,vegetative,xylopodia	/4,0.4-1.5,0.5-0.7,0.5-0.8,0.5-1,0.75-1,1-5,2-9,3-3.5,3-30,4-17,acute,along,base,beneath,branched,clavate,cm,curly,decurrent,densely,difoliate,elliptic,geminate,glabrous,globose,green,internodal,irregularly,leaf,like,lobed,long,minutely,mm,occasionally,opposite,ovoid-reniform,pale,papillose,persistently,petiole,pubescent,shaped,shrub,slightly,small,sparsely,stem,tan,tear-drop,tipped,tree,trichome,unifoliate,uniseriate,vein,way,white,winged,x	apart,grey,na
482	wfo-0001031695	success	183	137	77	93	90	44	73	4	0.5-1,1-2,1-3,1-9,1.5-2,1.5-8,2-3,2-4,2-5,2.5-5,20-30,3-10,3-19,30-40,4-10,4-5,5,5-20,5-7,6-10,6-20,6-8,?,abruptly,acuminate,apex,articulated,base,branched,broadened,calyx,campanulate,cell,chartaceous,cm,connective,cordate,dark,deep,diameter,directed,eglandular,ellipsoidal,entire,fleshy,fruit,glabrous,green,greenish,hair,hard,immature,lanceolate,laterally,lavender,leaf,lilac,lobe,lobed,lower,margin,mm,mottled,narrowly,oblique,oblong,occasionally,ovate,pedicel,petiole,pilose,pilose-hirsute,pore,present,puberulent,purple,purplish,radiu,remnant,shrub,simple,sometimes,stigma,stone,stripe,style,subcoriaceous,tree,triangular,unbranched,unit,x,yellow	0.5-2,1,1/2,1/3,10-15-20,10-35,3-17,3-4-6,3-7,4-6,4-foliat,7-10-15,abaxially,acute,adaxially,aggregate,also,apart,ape,apically,apiculate,axe,basal,beyond,blade,capitat,color,connivent,cylindrical,d,densely,dilated,divided,eaf,eed,eglandular-pilose,exceeding,exserted,flattened,flower,glabrate,glabrescent,glandular-puberulent,lateral,leaving,lon,long,midrib,moderately,nflorescence,nther,obtuse,often,orolla,ovoid,pedicellar,peduncle,perfect,pilo,pilose-hirsut,presen,puberulent-pubescent,pubescent,rachi,ripe,rounded,ruit,shorter,sinus,slight,slightly,small,somewhat,spaced,sparsely,stamen,swelling,tal,tem,thecae,time,tip,tomento,tube,unequal,unknown,unlobed,vary,wide,ympodial	10-20,4-foliate,anther,articulation,bract,branching,broad-based,capitate,colour,corolla,exsertion,form,fruiting,growth,height,inflorescence,insertion,length,mature,na,needle-like,orientation,ovary,placement,plant,position,prickle,pseudostipule,rhizome,scale,shape,spacing,stem,structure,surface,symmetry,sympodial,texture,theca,trichome,tuber,type,width,xylopodia	0.5-1,1-2,1-3,1-9,1.5-2,1.5-8,2-3,2-4,2-5,2.5-5,20-30,3-10,3-19,30-40,4-10,4-5,5,5-20,5-7,6-10,6-20,6-8,?,abruptly,acuminate,articulated,base,branched,broadened,campanulate,chartaceous,cm,cordate,dark,deep,directed,eglandular,ellipsoidal,entire,fleshy,glabrous,green,greenish,hard,immature,lanceolate,laterally,lavender,lilac,lobed,mm,mottled,narrowly,oblique,oblong,occasionally,ovate,pilose,pilose-hirsute,present,puberulent,purple,purplish,shrub,simple,sometimes,stripe,subcoriaceous,tree,triangular,unbranched,x,yellow	10-20,4-foliate,capitate,na
483	wfo-0001031698	success	56	91	37	40	16	51	32	5	2-2.5,2.5,2.5-3,4-4.5,bark,base,branch,cm,decurrent,deflexed,difoliate,dull,elliptic,flattened,fruiting,glabrous,green,incrassate,leaf,margin,minutely,mm,pale,paler,papillae,pedicel,pitted,reddish-brown,reniform,repandly,rugose,shrub,stout,strongly,surface,unit,winged,woody,x,yellowish	ape,dia,eaf,eed,fide,geminat,long,maguire,older,otherwise,persistin,stem,tall,wing,ympodial,young	1,apex,bract,branching,breeding,calyx,cell,colour,corolla,diameter,filament,form,fruit,geminate,growth,hair,height,heteromorphism,inflorescence,interjected,interpetalar,leaflet,length,marking,na,orientation,pattern,persistence,persisting,placement,plant,position,prickle,pseudostipule,rhizome,scale,seed,shape,size,spot,staman,stone,structure,symmetry,sympodial,system,texture,tissue,tuber,type,xylopodia	2-2.5,2.5,2.5-3,4-4.5,base,cm,decurrent,deflexed,difoliate,dull,elliptic,flattened,glabrous,green,incrassate,minutely,mm,pale,paler,papillae,pitted,reddish-brown,reniform,repandly,rugose,shrub,stout,strongly,winged,woody,x,yellowish	1,apex,geminate,na,persisting
484	wfo-0001031707	success	178	145	73	92	86	53	69	4	.5,0.5-1,1-1.2,1-1.3,1-1.5,1.5-1.7,1.5-6,16-20,2-3,2-4,2-6,4-5,8-12,80-140,9-15,abaxially,acuminate,acute,adaxially,almost,along,anther,apex,apically,attenuate,axillary,base,basiscopically,berry,brown,calyx,capitate,cell,cm,conical,corolla,dense,densely,diameter,elliptic,enlarged,filament,flattened,fleshy,flower,fruiting,glabrous,globose,green,greenish,lanceolate,leaf,leaflet,lower,margin,mm,narrowly,oblique,obovate,occasionally,ovary,pair,pedicel,per,petiole,petiolule,pink,pinnate,pointed,poricidal,pubescent,reddish,round,sagittate,scattered,simple,slightly,somewhat,sparsely,stigma,style,surface,tip,trichome,tube,type,uniseriate,unit,vein,vine,white,x	-3,/4,1-3,1.2-1.8,1.2-2,1.5-2,1/3,2,2-10,24,3,4-6,5-10-celled,6-7,absent,anthesi,apical,axil,basal,bearing,c.,cateniform,clavat,climbing,conspicuously,cucullate,distal,distinct,drying,eaf,edicel,eed,endrophilum,epidermal,erect,exserted,flap-like,flat,four-lobed,free,high,horizonta,inflorescenc,lateral,less,like,lobe,lobed,lon,long,minutely,narrower,nflorescence,open,papillate,penden,planar,plant,portion,primary,quadrate,quite,raised,regular,rest,ruit,scar,smaller,smooth,spaced,stout,strongly,tem,terminal,ternate,thickening,time,tub,ud,unifoliat,usually,way,white-lenticellate,widely,woody,ympodial	arrangement,articulation,bract,branching,breeding,broad-based,cateniforme,clavate,colour,connective,form,fruit,growth,hair,heteromorphism,inflorescence,insertion,interjected,interpetalar,length,marking,modification,na,needle-like,number,odour,orientation,pattern,placement,pore,position,prickle,pseudostipule,rhizome,scale,seed,shape,size,smell,spot,staman,stem,stone,structure,symmetry,sympodial,system,texture,tissue,tuber,unifoliate,vegetative,xylopodia	.5,0.5-1,1-1.2,1-1.3,1-1.5,1.5-1.7,1.5-6,16-20,2-3,2-4,2-6,4-5,8-12,80-140,9-15,abaxially,acuminate,acute,adaxially,almost,along,apically,attenuate,axillary,base,basiscopically,berry,brown,capitate,cm,conical,dense,densely,elliptic,enlarged,flattened,fleshy,glabrous,globose,green,greenish,lanceolate,mm,narrowly,oblique,obovate,occasionally,pair,per,pink,pinnate,pointed,poricidal,pubescent,reddish,round,sagittate,scattered,simple,slightly,somewhat,sparsely,tip,trichome,uniseriate,vein,vine,white,x	cateniforme,clavate,na,unifoliate
485	wfo-0001031723	success	218	119	57	74	144	45	54	3	0.2-1,0.4-1-2.5-5,2-7,2/3-3/4,4-6,anther,apex,apparently,articulated,base,berry,branching,calyx,chartaceous,cm,conical,connivent,cuneate,dark,drying,entire,equal,erect,evenly,filament,fruit,fruiting,green,hair,inflated,lateral,leaf,length,lobed,long,lower,margin,marking,mature,maturity,mauve,mm,multangulate,pale,pedicel,perpendicular,petiole,poricidal,prickle,primary,recurved,red,reflexed,rounded,secondary,sessile,shrub,simple,sometimes,spherical,stalked,stem,straight,subentire,surface,tapering,terminal,tip,trichome,unarmed,unit,way,white,young	-1.5,-15,-6,-8,-merous,0-2,0.05-0.2,0.1-0.2,0.1-0.3,0.1-0.5,0.15,0.4,0.4-0.9,0.4-1,0.55-0.9,0.6-1,0.7-1,0.8-1.5,1-15-45,1-2,1-2-5.5-6.5,1-3,1-3-10,1-5,1-5-40,1.2-2,1.5-10,1.5-2.5,1.5-4-10-16,1/3-1/2,1/6-1/4-1/3-1/2,10-30,2-3.5,2-4-11,2.5-4.5,2.5-5,2/3,3-15,4-10-30,4-20,4-5,5-9,8-20,abaxial,abaxially,acuminate,acut,acute,adaxial,alyx,ame,apar,apart,apically,ba,bark,blade,branched,brow,brown,c.,curved,deltate,densely,diameter,discolorous,dull,eaf,eed,elongated,elongating,eye,filiform,finely,flattened-reniform,flower,free,gently,glabrescent,glabrous,gland,gland-tipped,glandular,gray,herbaceous,infructescence,lobe,longer,midpoint,minute,moderately,naked,narrow-deltate,near,nflorescence,obtuse,older,one,open,orange,orange-brown,orolla,oung,ovate,pair,peduncle,per,perfec,pericarp,plurifoliat,porrect,portion,prickly,ray,ruit,scar,smooth,spaced,sparsely,spreading,stalk,stellate,stellate-pubescent,strongly,style,tamen,terete,tertiary,time,tube,unarme,usually,variously,vary,vein,venation,visible,weakly,whitish,wide,woody,yellow,yellow-green,ympodial	appressed,articulation,bract,breeding,broad-based,cell,colour,corolla,form,growth,heteromorphism,inflorescence,insertion,interjected,interpetalar,leaflet,na,needle-like,odour,orientation,paired,pattern,perfect,placement,plurifoliate,position,pseudostipule,rhizome,scale,shape,smell,spot,staman,stone,structure,symmetry,sympodial,system,texture,tissue,tuber,type,vegetative,xylopodia,zygomorphy	0.2-1,0.4-1-2.5-5,2-7,2/3-3/4,4-6,apparently,articulated,base,berry,chartaceous,cm,conical,connivent,cuneate,dark,drying,entire,equal,erect,evenly,green,lateral,lobed,long,marking,maturity,mauve,mm,multangulate,pale,perpendicular,poricidal,primary,recurved,red,reflexed,rounded,secondary,sessile,shrub,simple,sometimes,spherical,stalked,stem,straight,subentire,tapering,terminal,tip,unarmed,way,white,young	na,perfect,plurifoliate
486	wfo-0001031729	success	159	166	82	99	60	67	74	8	-2,..,0.5,0.5-1,0.5-4,0.6-1-2.5,1-1.5,1-2,1.0-1.3,1.5,1.5-2,2-2.5,2-3,2.5-,2.5-5,3-4,3.5-4,5-10-20,5-6,5-7,abruptly,acuminate,anther,apex,apiculate-deltate,attenuate,base,branch,branched,calyx,cell,cm,conical,corolla,darker,deltate,diameter,elliptic,elongate,filament,flattened,flower,fruit,fruiting,glabrous,globose,green,greenish,later,less,lobe,lobed,long,lower,markedly,middle,mm,mottling,nearly,obovate,occasionally,outer,outline,ovary,ovate-reniform,pair,pale,papillate,pedicel,peduncle,per,petiole,pink,pointed,purplish,quadrate,reddish,regularly,short,shrub,sinuate,small,smooth,somewhat,stem,stigma,striate,stripe,surface,tan,testa,time,trichome,tube,unit,wall,white,x,young	-0.5,1-1.5-2,11-30-45,12-13,3-celled,4.1-16,50,8-9,along,anthesi,apicula,beneath,branc,brittle,brow,c.,cucullate,curve,dark,dry,drying,eaf,edicel,eed,erec,flattened-capitat,glandular,gradually,membranous,minute,minutely,narrowly,never,nflorescence,noddin,open,papillae,papillose,pericarp,planar,plurifoliat,point,primary,ruit,scar,scattered,single,single-stemmed,thin,thing,tip,toward,triangular,tuft,ud,usually,vein,wand-like,widening,ympodial	0-0.5,1,appressed,arrangement,articulation,bract,branching,breeding,broad-based,bud,colour,connective,curved,erect,flattened-capitate,form,glabrousnes,growth,hair,height,heteromorphism,inflated,inflorescence,insertion,interjected,interpetalar,leaf,leaflet,length,margin,marking,mature,modification,na,needle-like,nodding,number,odour,orientation,paired,pattern,placement,plant,plurifoliate,pore,position,prickle,pseudostipule,rhizome,scale,seed,shape,smell,spot,staman,stone,structure,symmetry,sympodial,system,texture,tissue,tuber,type,vegetative,xylopodia,zygomorphy	-2,..,0.5,0.5-1,0.5-4,0.6-1-2.5,1-1.5,1-2,1.0-1.3,1.5,1.5-2,2-2.5,2-3,2.5-,2.5-5,3-4,3.5-4,5-10-20,5-6,5-7,abruptly,acuminate,apiculate-deltate,attenuate,base,branched,cell,cm,conical,darker,deltate,elliptic,elongate,flattened,glabrous,globose,green,greenish,later,less,lobed,long,markedly,mm,mottling,nearly,obovate,occasionally,outer,outline,ovate-reniform,pale,papillate,pink,pointed,purplish,quadrate,reddish,regularly,short,shrub,sinuate,smooth,somewhat,striate,stripe,surface,tan,time,trichome,wall,white,x,young	0-0.5,1,curved,erect,flattened-capitate,na,nodding,plurifoliate
487	wfo-0001031738	success	230	124	71	79	151	45	68	3	0.7-1,1.5-4,1/2-2/3,1/4-1/3,4,4-6,6-15,andromonoecious,anther,apex,articulated,auriculate,base,berry,branched,calyx,cell,chartaceous,cm,connivent,cordate,curved,densely,elongating,equal,erect,evenly,filament,flattened,frequently,fruit,fruiting,green,lateral,leaf,length,lobed,long,margin,mature,maturity,mm,multangulate,orange,pale,pedicel,petiole,poricidal,porrect,prickle,prickly,prominent,shrub,simple,small,sometimes,spherical,stalked,stellate,stellate-pubescent,stem,straight,strongly,surface,tapering,terminal,tip,tree,trichome,truncate,unarmed,unit,variously,way,weakly,white,yellow,yellow-orange,young	-5,-merous,.5,0-15,0-2,0-3,0.1-0.25,0.2-0.3,0.25-0.8,0.3-1,0.7-1.1,0.9-2.1,1-1.5,1-1.8,1-3,1-4,1.4-1.7,1.5-2-4-5,1/,1/3,1/3-2/3,1/6-1/4,10-15,15-40,2-3-4,2.3-3,20-200,3-4,3-6,3-7,3.5-3.8,3.5-4.5,4-10,4-5,4-8,5,5-6,5-8,7-12,7-12.5,8-10,8-10-15,8-18,abaxial,abaxially,acuminat,acute,adaxial,adaxially,almost,always,alyx,apar,apart,apically,apparently,bark,blade,dark,deltate,diameter,discolorous,distal,distance,drying,dull,eaf,eed,extending,flattened-reniform,flower,free,glabrescent,glabrous,gray,held,hermaphrodite,heterostylous,infructescence,inside,lobe,lobing,long-styled,longer,lower,lowermost,midpoint,midvein,narrow-deltate,nflorescence,oblong,obovate,often,older,one,open,orange-brown,orolla,oung,outline,ovate,pair,peduncle,per,pericarp,pit,plant,plurifoliat,poorly,portion,prickl,primary,pubescent,raised,ray,reflexed,resin,rounded,ruit,scar,secondary,sessile,short-styled,shorter,side,smooth,spaced,sparsely,spreading,stalk,staminat,sticky,stout,style,tamen,terete,tertiary,time,tube,upper,usually,vary,vein,venation,visible,white-brow,wide,woody,yellow-green,yellowish,ympodial	appressed,articulation,bract,branching,breeding,broad-based,colour,connective,corolla,form,growth,hair,heteromorphism,inflated,inflorescence,insertion,interjected,interpetalar,leaflet,marking,modification,na,odour,orientation,paired,pattern,placement,plurifoliate,position,pseudostipule,rhizome,scale,shape,spot,staman,stone,structure,symmetry,sympodial,system,texture,tissue,tuber,type,xylopodia	0.7-1,1.5-4,1/2-2/3,1/4-1/3,4,4-6,6-15,andromonoecious,articulated,auriculate,base,berry,branched,chartaceous,cm,connivent,cordate,curved,densely,elongating,equal,erect,evenly,flattened,frequently,fruit,green,lateral,length,lobed,long,mature,maturity,mm,multangulate,orange,pale,poricidal,porrect,prickle,prickly,prominent,shrub,simple,small,sometimes,spherical,stalked,stellate,stellate-pubescent,stem,straight,strongly,surface,tapering,terminal,tip,tree,trichome,truncate,unarmed,variously,way,weakly,white,yellow,yellow-orange,young	broad-based,na,plurifoliate
488	wfo-0001031752	success	166	181	103	117	49	64	101	2	-10,0.5-1,1,1-1.5,1-3,1-4,1.5-10.5-44,1.5-3.5-6,15-25,15-40-100,2-2.5,2-3,2-5,20-35,3-4,3.5-15-47,3.5-5,5-6,5-8,abaxially,acuminate,acute,apart,apex,apiculate,basal,base,calyx,cell,chartaceous,cm,connective,connivent,cuneate,cylindrical,darker,deltate,densely,diameter,directed,distally,ellipsoidal,elliptic,entire,equal,exceeding,flattened,fleshy,flower,fruit,fusiform,glabrate,glabrescent,glabrous,gland,glandular-puberulent,green,immature,lanceolate,leaving,less,light,lobe,long,lower,margin,membranaceous,mm,moderately,near,nearly,oblong,obtuse,often,older,ovate,ovoid,pedicel,pedicellar,peduncle,perfect,petiole,pink,pore,present,puberulent,pubescent,purplish,rachi,radiu,remnant,ripe,rounded,rugose,shrub,simple,slightly,small,sparsely,stalked,stellate,stigma,stone,stripe,style,subcordate,subcoriaceous,thecae,tip,tree,truncate,unbranched,white,wide,x,yellow,young	-pubescent,0.5-1.5,1-1.5-2.5-3,1-2,1.5-2,1.5-3,3-11.5,3-4-foliat,3-7,5-23,8-15,9-16,adaxially,aggregate,ape,articulated,axe,beyond,blade,ciliat,ciliate,eaf,eed,exserted,glandular-puberulen,linear,lon,narrowly,nflorescence,nther,olde,orolla,presen,purpl,ruit,spaced,stamen,swelling,tal,tem,time,tomentose,triangular,truncat,tube,ud,unit,vary,ympodial	abaxial,adaxial,anther,arrangement,articulation,bract,branching,breeding,broad-based,bud,colour,corolla,filament,form,growth,hair,height,heteromorphism,inflorescence,insertion,interjected,interpetalar,leaf,leaflet,length,marking,mature,modification,na,needle-like,number,odour,orientation,ovary,paired,pattern,placement,plant,position,prickle,pseudostipule,purple,rhizome,scale,seed,shape,size,smell,spacing,spot,staman,stem,surface,symmetry,system,texture,theca,tissue,trichome,tuber,type,vegetative,xylopodia,zygomorphy	-10,0.5-1,1,1-1.5,1-3,1-4,1.5-10.5-44,1.5-3.5-6,15-25,15-40-100,2-2.5,2-3,2-5,20-35,3-4,3.5-15-47,3.5-5,5-6,5-8,abaxially,acuminate,acute,apart,apex,apiculate,basal,base,chartaceous,cm,connivent,cuneate,cylindrical,darker,deltate,densely,directed,distally,ellipsoidal,elliptic,entire,equal,exceeding,flattened,fleshy,fruit,fusiform,glabrate,glabrescent,glabrous,gland,glandular-puberulent,green,immature,lanceolate,leaving,less,light,lobe,long,membranaceous,mm,moderately,near,nearly,oblong,obtuse,often,older,ovate,ovoid,pedicellar,perfect,pink,present,puberulent,pubescent,purplish,remnant,ripe,rounded,rugose,shrub,simple,slightly,small,sparsely,stalked,stellate,stripe,subcordate,subcoriaceous,thecae,tip,tree,truncate,unbranched,white,wide,x,yellow,young	na,purple
489	wfo-0001031756	success	186	103	52	64	122	39	50	2	.5,/2,0.5-1,0.8-1,10,3-7,accrescent,anther,apex,articulated,base,berry,branched,calyx,chartaceous,cm,color,conical,connivent,cordate,elongating,enclosing,entire,evenly,filament,free,fruit,fruiting,fully,glabrous,green,known,leaf,lobed,long,margin,mature,mauve,mm,pale,pedicel,perpendicular,petiole,poricidal,portion,prickle,shoot,short,shrub,simple,spherical,stellate-pubescent,stem,straight,style,tapering,terminal,tip,truncate,tube,unit,way,white,young	-5,.1,.8,0,0-1,0-2,0-5,0.02-0.2,0.1,0.15-0.25,0.2,0.4-1.6,0.5-1.3,0.6-1.2,0.6-1.6,0.7-1.7,00,1-1.8,1-2,1-3,1-4,1.5-2,1.5-3.5,1.8-2.5,1/2,1/3,2-6,3-15,3-5,4-5,4.5,5-merous,6-9,7-10,9-14,abaxially,acut,alyx,apar,apart,apically,apparently,bark,blade,broad-deltate,concolorous,curved,deltate,densely,diameter,drying,eaf,eed,equal,erect,eye,finely,flattened-reniform,flower,glabrescent,glabrou,gray,herbaceous,inflated,infructescence,invested,lobe,longer,lower,midpoint,moderately,naked,nflorescence,older,one,open,orange-brown,orolla,oung,ovate,pair,peduncle,pendulous,per,perfec,pericarp,pitted,plurifoliat,porrect,prickl,prickly,primary,ray,red-brown,rounded,ruit,scandent,scar,sessile,shorter,slender,small,smooth,spaced,sparsely,spreading,stalk,stalked,stellate,surface,tamen,terete,time,trichome,unarmed,variously,vary,vein,visible,wide,yellow-green,ympodial	articulation,bract,branching,cell,colour,corolla,form,growth,hair,heteromorphism,inflorescence,insertion,interjected,interpetalar,leaflet,length,marking,na,odour,orientation,paired,placement,plurifoliate,position,pseudostipule,rhizome,scale,shape,spot,staman,stone,structure,symmetry,sympodial,texture,tissue,tuber,type,xylopodia	.5,/2,0.5-1,0.8-1,10,3-7,accrescent,apex,articulated,base,berry,branched,chartaceous,cm,color,conical,connivent,cordate,elongating,enclosing,entire,evenly,fruit,fully,glabrous,green,known,lobed,long,mature,mauve,mm,pale,perpendicular,poricidal,shoot,short,shrub,simple,spherical,stellate-pubescent,stem,straight,tapering,terminal,tip,truncate,way,white,young	na,plurifoliate
490	wfo-0001031786	success	207	117	54	64	143	53	48	6	0-20,0.2-2.5,2-7,2-8,6-8,anther,apex,articulated,base,berry,branched,calyx,cell,chartaceous,cm,cuneate,curved,deep,elliptic,elongating,equal,erect,filament,flattened-reniform,flower,fruit,fruiting,glabrous,herb,lateral,leaf,length,lobed,long,lower,margin,mature,mauve,membranous,mm,orange,ovate,pale,pedicel,per,petiole,poricidal,prickle,red,shrub,simple,sparsely,spherical,stellate,stellate-pubescent,stem,surface,tapering,tip,trichome,truncate,unit,white,yellow-orange	.4,.5,/2,/3,0-2,0-3,0-5,0.1,0.1-0.4,0.2-0.3,0.25-0.5,0.5-1.5,0.7-1,0.7-1.6,0.7-4,0.8,0.8-1.2,1,1-2,1-3,1-4,1-6,1.2-1.6,1.5-1.9,1.5-2.5,1/3-1/2,2-13,2-3,2.5-3.5,3-4,3-5.5,4-5,5-7,5-merous,8-12,abaxially,acut,acute,almost,alyx,ame,apar,apart,apically,apparently,bark,becoming,blade,c.,clavat,concolorous,connivent,dark,deltate,densely,diameter,distance,drying,eaf,eed,evenly,extending,eye,filiform,flattened,free,glabrescent,gray,gray-brow,green,herbaceous,inconspicuous,infructescence,lobe,lon,longer,maturity,midpoint,midvein,minute,naked,nflorescence,obtuse,older,one,open,orange-brown,orolla,oung,outline,pair,peduncle,pendulous,perfec,pericarp,pit,plurifoliat,porrect,portion,prickl,prickly,primary,raised,ray,red-brown,reflexed,rounded,ruit,scandent,scar,sessile,shiny,shorter,side,slightly,small,smooth,sometimes,spaced,spreading,stalk,stalked,stigma,straight,style,tamen,terete,tertiary,thick,time,tube,unarmed,variously,vary,vein,venation,visible,way,weakly,wide,woody,ympodial,young	0.5-1,abaxial,adaxial,articulation,bract,branching,breeding,broad-based,colour,connective,corolla,form,growth,hair,heteromorphism,inflorescence,insertion,interjected,interpetalar,leaflet,marking,modification,na,needle-like,number,odour,orientation,pattern,perfect,placement,plurifoliate,pore,position,pseudostipule,rhizome,scale,seed,shape,smell,spot,staman,stone,structure,symmetry,sympodial,system,texture,tissue,tuber,type,vegetative,xylopodia,zygomorphy	0-20,0.2-2.5,2-7,2-8,6-8,articulated,base,berry,branched,chartaceous,cm,cuneate,curved,deep,elliptic,elongating,equal,erect,flattened-reniform,glabrous,herb,lateral,leaf,lobed,long,lower,mauve,membranous,mm,orange,ovate,pale,per,poricidal,red,shrub,simple,sparsely,spherical,stellate,stellate-pubescent,stem,surface,tapering,tip,truncate,white,yellow-orange	0.5-1,na,needle-like,perfect,plurifoliate,zygomorphy
491	wfo-0001031793	success	188	83	47	58	130	25	44	3	-4,.5,1.5-4,10-15,2-3,2-5,accrescent,acuminate,aging,almost,anther,apex,articulated,base,berry,black,branched,broadly,brownish,calyx,chartaceous,cm,cuneate,densely,difoliate,extra-axillary,filament,forked,fruit,fruiting,globose,hair,inflorescence,leaf,lobe,margin,mm,oblique,oblong-lanceolate,orange-yellow,pedicel,petiole,pore,porocidal,rounded,shallow,shrub,small,sparsely,stellate,stellate-pubescent,tree,unbranched,unit,usually,well-developed,white,yellow	0,1,1-1.5,1-2,1-3,1-8,1.5-2,1/3,1/4,1/5,13-20,15-20,20,26,3-4,3-8,3/4,4,40,5-merous,7,8-11,absent,abundant,acumen,acute,adult,alyx,apparently,armed,aspect,axe,ba,bilobe,blade,branche,broad,brown,capitate,central,cut,diameter,distal,eaf,eed,elliptic,elongatin,erec,erect,evident,extreme,ferrugineous,flattened,flower,geminat,general,glandular,homostylou,interpetalar,larger,linear,lobing,lon,long,lower,main,many,maturing,midpoint,midrib,minutely,mostly,mucilaginous,nflorescence,obtuse,often,older,orbicular-ovate,orolla,ovate,peduncle,per,perfect,porrect,prickle,principal,pubescent,rachi,reddish,reduced,reticulation,ruit,rusty,scarcely,scattered,sessile,side,similar,simple,single,sinus,size,smaller,stellate-pubescen,stem,stigma,stipitate,stout,style,surface,tall,tamen,tem,testa,thickened,tip,tissue,triangular,triangular-acuminat,trichome,tube,unarmed,upward,uvenile,vary,way,woody,x,yellow-brown,ympodial	articulation,branching,cell,colour,connective,corolla,form,geminate,growth,height,heteromorphism,length,na,pattern,plant,position,shape,staman,stone,structure,symmetry,sympodial,texture,type,zygomorphy	-4,.5,1.5-4,10-15,2-3,2-5,accrescent,acuminate,aging,almost,articulated,base,berry,black,branched,broadly,brownish,chartaceous,cm,cuneate,densely,difoliate,extra-axillary,forked,globose,lobe,mm,oblique,oblong-lanceolate,orange-yellow,porocidal,rounded,shallow,shrub,small,sparsely,stellate,stellate-pubescent,tree,unbranched,usually,well-developed,white,yellow	geminate,na,zygomorphy
492	wfo-0001031829	success	138	95	38	49	89	46	36	2	.25,1.5-2,2-4,3/4,4-4.5,acute,anther,apex,base,berry,branched,calyx,corolla,difoliate,elliptic,filament,fruiting,globose,green,growth,inflorescence,leaf,leathery,lobed,long,margin,mm,occasionally,opposite,pedicel,petiole,pore,poricidal,pubescent,revolute,shaped,shrub,simple,somewhat,sparsely,tear-drop,thick,tip,trichome,uniseriate,unit,way,white,x	.5,0.5-2.1,0.7-1,1,1-2,1.3-1.5,1.5-2.5,1.5-3.5,1.5-4.5,3-5-flowered,4-8.5,7-10,abaxially,absent,adaxial,adaxially,along,anthesi,ape,apiculae,bae,bark,broadly,capitate,cm,conical,crystalline,deflexed,densely,denser,dia,differing,drying,eaf,edicel,eed,epidermi,erect,exserted,free,geminat,glabrat,glabrous,greenish-brown,immature,known,large-celled,lateral,like,lobe,lon,lower,main,major,minor,minute,minutely,nflorescence,often,older,ovary,overlappin,packed,pair,papillo,papillose,planar,portion,quadrate,ruit,scar,size,soft,stem,stigma,style,surface,tall,tapering,tub,tube,tuft,ud,vein,waxy,woody,yellowish,ympodial,young	appressed,articulation,bract,branching,breeding,cell,colour,connective,form,fruit,geminate,hair,heteromorphism,inflated,insertion,interjected,interpetalar,leaflet,length,marking,mature,modification,na,odour,orientation,paired,pattern,placement,position,prickle,pseudostipule,rhizome,scale,shape,spot,staman,stone,structure,symmetry,sympodial,system,texture,tissue,tuber,type,xylopodia	.25,1.5-2,2-4,3/4,4-4.5,acute,base,berry,branched,difoliate,elliptic,globose,green,leaf,leathery,lobed,long,mm,occasionally,opposite,poricidal,pubescent,revolute,shaped,shrub,simple,somewhat,sparsely,tear-drop,thick,tip,trichome,uniseriate,way,white,x	geminate,na
493	wfo-0001031832	success	232	119	68	75	157	44	63	5	/50-1/10,0.2-1.5,0.7-1.5,0.7-2,2-3.6,3-7,abaxially,accrescent,adaxially,anther,apex,apical-lateral,articulated,attenuate,axillary,base,becoming,berry,blade,blunt-tipped,branched,bullate,calyx,cm,continued,corolla,due,entire,extend,filament,fruit,fruiting,glabrescent,globose,greenish,growth,hair,introrse,large,lateral,leaf,length,longitudinal,margin,mm,oblong,pale,pedicel,perfect,petiole,pitted,plurifoliate,pore,probably,pubescent,ripe,rotate-stellate,scabrous,shrub,simple,slit,somewhat,soon,sparingly,stellate-pubescent,stem,terminal,time,tree,unit,violet,white,x,yellow,young	-8,.5-1,0-150,0.1-0.3,0.2-0.6,0.3-0.8,0.3-3,0.7-1.6,0.8-1.2,1-12,1.1-2.4,1.2-1.6,1.2-2,1.2-2.5,1.3-4.2,1.5-4,1.7-4,1.8-4,1/2-3/4,14,2-4,2-6,2.5-6.5,2.8-4.8,3-6.5,3.5-7,4-20,4-7,5-21,5.5-10,7-10,8-25,9,acuminate,acute,ag,anthesi,apart,apice,apparently,axe,ba,bark,basal,blister,branch,brown,brownish,bud,capitat,chartaceous,closely,conical,connate,dark,decurrent,dehiscing,deltoid,diameter,directed,eaf,eed,evident,exserted,ferrugineous,few-rayed,fleshy,flower,forming,free,glabrescen,glabrous,granular-tomentose,green,half,high,honeycombed,indument,inserted,lackin,lanceolate,line,lobe,lobed,long,long-,longer,lower,m.,main,midvein,minute,mixed,mostly,multangulate,nearly,nflorescence,oblanceolate,obovoid,obtuse,occasionally,older,orbicular,orolla,ovate,partly,peduncle,persistent,porrect-stellat,porrect-stellate,pubescence,rachi,rather,ray,relatively,reniform,reticulate-punctate,rough,ruit,runk,sessile,short-,short-stalked,side,smooth,sometimes,spaced,sparse,splitting,stamen,stigma,stipitate-glandular,style,subcampanulate,suborbicular,surface,suture,swelling,tamen,terete,testa,thick,thick-stalked,toward,translucent,tube,unarme,unarmed,usually,vary,vein,way,weakly,whitish,wide,yellowish,ympodial	age,articulation,bract,branching,breeding,cell,colour,connective,form,heteromorphism,inflorescence,insertion,interjected,interpetalar,lacking,leaflet,marking,modification,na,odour,orientation,paired,pattern,placement,position,prickle,pseudostipule,rhizome,scale,shape,sparing,spot,staman,stellate,stone,structure,symmetry,sympodial,system,texture,tissue,tuber,type,xylopodia	/50-1/10,0.2-1.5,0.7-1.5,0.7-2,2-3.6,3-7,abaxially,accrescent,adaxially,apical-lateral,articulated,attenuate,axillary,base,becoming,berry,blade,blunt-tipped,branched,bullate,cm,continued,due,entire,extend,glabrescent,globose,greenish,growth,introrse,large,lateral,leaf,length,longitudinal,mm,oblong,pale,perfect,pitted,plurifoliate,pore,probably,pubescent,ripe,rotate-stellate,scabrous,shrub,simple,slit,somewhat,soon,sparingly,stellate-pubescent,stem,terminal,time,tree,violet,white,x,yellow,young	age,lacking,na,sparing,stellate
494	wfo-0001031834	success	150	169	96	113	37	56	93	3	.5,0.5,0.5-1,0.5-3,0.5-3.5,0.6-1.4,0.8-1,0.8-1.3,0.9-1.4,1,1.5,1.5-4,1.6-2,1.9-6.5,2.9-7,2/3,6-7,6.5-14,accrescent,across,acuminate,acute,anther,anthesi,apex,apically,attenuate,base,berry,calyx,campanulate,cm,corolla,deciduous,decurrent,deflexed,deltoid,depression,dia,difoliate,expanded,filament,flattened-reniform,fruit,fruiting,glabrous,globose,green,greenish-yellow,hooked,incrassate,lamina,leaf,less,lobe,lobed,long,lower,major,margin,middle,minor,minute,minutely,mm,opposite,ovary,ovate,pale,papillose,pedicel,petiole,pitted,planar,pore,poricidal,proximal,pubescent,scabrous,scar,shaped,short,shrub,simple,slender,slightly,small,soon,sparsely,stem,stigma,straight,style,surface,tan,tapering,tear-drop,tip,trichome,tube,tufted,uniseriate,unit,upper,usually,vein,way,white,widest,woody,x,yellow,young	apar,apiculate,appear,bi-cellular,borne,covered,deciduou,eaf,edicel,eed,eye,few-flowered,free,geminat,glabrou,hook,larger,leaving,like,lon,markedly,mound-like,multicellular,naked,nflorescence,often,papillo,persistent,portion,ruit,spaced,speck,tall,ud,unevenly,uni-,ympodial	apart,articulation,bract,branching,breeding,broad-based,bud,cell,colour,connective,form,geminate,growth,hair,height,heteromorphism,inflorescence,insertion,interjected,interpetalar,leaflet,length,marking,mature,modification,na,needle-like,odour,orientation,pattern,placement,plant,position,prickle,pseudostipule,rhizome,scale,seed,shape,size,smell,spacing,spot,staman,stone,structure,symmetry,sympodial,system,texture,tissue,tuber,type,vegetative,width,xylopodia	.5,0.5,0.5-1,0.5-3,0.5-3.5,0.6-1.4,0.8-1,0.8-1.3,0.9-1.4,1,1.5,1.5-4,1.6-2,1.9-6.5,2.9-7,2/3,6-7,6.5-14,accrescent,across,acuminate,acute,anthesi,apically,attenuate,base,berry,calyx,campanulate,cm,deciduous,decurrent,deflexed,deltoid,depression,dia,difoliate,expanded,flattened-reniform,fruit,glabrous,globose,green,greenish-yellow,hooked,incrassate,lamina,leaf,less,lobe,lobed,long,middle,minute,minutely,mm,opposite,ovate,pale,papillose,petiole,pitted,planar,poricidal,proximal,pubescent,scabrous,shaped,short,shrub,simple,slender,slightly,small,soon,sparsely,straight,tan,tapering,tear-drop,tip,trichome,tube,tufted,uniseriate,usually,vein,way,white,widest,woody,x,yellow	apart,geminate,na
495	wfo-0001031842	success	161	128	57	74	87	54	54	3	0.1-0.5,0.5-1,0.5-2,0.6-1,1-1.5,1-1.8,1-3.5,1.5-2,10-20,2-10,2-3,2.5-3,2.5-6,3-8,4.5-6,7-9,9-15,acute,anther,apart,apex,attenuate,base,bi-lobed,brown,capitate,cm,corolla,cup-shaped,dark,deeply,difoliate,dry,ellipsoid,elliptic,filament,flattened-reniform,fruiting,glabrous,globose,green,incrassate,later,leaf,margin,minor,mm,opposite,ovary,paler,pedicel,petiole,pitted,pore,scar,shaped,shiny,shrub,size,specimen,stem,stigma,strongly,style,surface,tear-drop,terminal,tree,trichome,uniseriate,unit,white,x,young	.1,.4,.5,.75,0.7-1,1,10-12,10-30-flowered,3/4,anthesi,axil,ba,bark,bearing,beginning,beneath,berry,calyx,cusp,decurrent,deflexed,densely,dia,differing,eaf,edicel,eed,exserte,exsertion,free,geminat,inflorescenc,irregularly,lateral,leaf-opposed,lobe,lobed,lon,long,lower,main,major,middle,minutely,near,new,nflorescence,often,older,one,onto,overtopping,pair,pale,papillo,papillose,poricidal,portion,prominent,pubescent,quadrate,reddish,reddish-resinous,reflexed,ruit,shoot,simple,slender,somewhat,soon,spaced,sparsely,straight,tall,tapering,time,tip,tube,tuft,ud,vein,way,widest,woody,yellowish,yellowish-whit,ympodial	10-30,articulation,bract,branching,breeding,bud,cell,colour,connective,diameter,flower,form,fruit,geminate,glabrousnes,growth,hair,height,heteromorphism,inflorescence,insertion,interjected,interpetalar,leaflet,length,marking,na,number,odour,orientation,pattern,placement,plant,position,prickle,pseudostipule,rhizome,scale,seed,shape,spacing,spot,staman,stone,structure,symmetry,sympodial,system,texture,tissue,tuber,type,width,xylopodia	0.1-0.5,0.5-1,0.5-2,0.6-1,1-1.5,1-1.8,1-3.5,1.5-2,10-20,2-10,2-3,2.5-3,2.5-6,3-8,4.5-6,7-9,9-15,acute,apart,attenuate,bi-lobed,brown,capitate,cm,cup-shaped,dark,deeply,difoliate,dry,ellipsoid,elliptic,flattened-reniform,glabrous,globose,green,incrassate,later,leaf,mm,opposite,paler,pitted,shaped,shiny,shrub,specimen,strongly,tear-drop,terminal,tree,uniseriate,white,x,young	10-30,geminate,na
496	wfo-0001031843	success	245	205	122	145	100	60	116	6	.5,0-4,0.5-1,0.5-1.5,0.6-1.2,0.7-2,0.8-2,1-7,1.2-2,1.5,1.5-2,1/6-1/4,2-3,2.5,3-4,4-12,6-9,abaxially,accrescent,adaxially,almost,along,anther,anthesi,apex,apically,apparently,appressed,attenuate,bark,basal,base,becoming,berry,black,branch,branched,branching,brown,calyx,canaliculate,capitate,cm,completely,conical,corolla,cupular,curved,dark,deeply,diameter,dilated,discoid,distributed,drying,dull,entire,equal,erect,evenly,filament,fine,finely,flat,fruiting,glabrous,green,honeycomb,leaf,length,liana,lobed,long,longitudinally,lower,main,margin,midvein,mm,multiseriate,network,oblique,oblong,obovate,opening,orange,orange-brown,orange-yellow,pair,part,partly,pattern,pedicel,peduncle,pericarp,petiole,pitted,pore,poricidal,primary,prominent,pubescent,raised,rarely,red,reddish,ridged,scar,seed,shallowly,shiny,shortly,shrub,side,simple,slender,slightly,smooth,sometimes,sparsely,spheroidal,stem,stigma,straight,stump,style,surface,terminal,tertiary,thick-chartaceous,thin,tip,trichome,tube,twice,unarmed,unit,vein,venation,violet,visible,white,wider,x,young	.2,.3,.6,0.2-2,0.4-0.5,0.7-1.2,1-2,1.2-2.2,1.8-2.5,1mm,2-4,3-7,45-60°,5-10,5-12,acuminate,age,always,alyx,apar,apice,around,articulated,broadly,caudate,clearly,collapsing,cuspidate,delineated,deltoid,dendritic,density,detaching,discolorous,domatia,eaf,eed,ellipsoi,even,eye,fertilisation,flexuous,flower,forming,free,hand,inner,largely,leave,len,lengthening,lignified,like,lobe,loop,looping,m.,much,naked,never,nflorescence,nther,obscure,older,orolla,outline,ovate,papillo,pendulous,perfec,pit,plurifoliat,portion,present,pronounced,protruding,rachi,recurve,reveal,ribbed,rounded,ruit,see,sinus,small,smaller,soon,spreading,strongly,surfac,tearing,thickened,tuft,ud,variable,vary,weakly,wide,without,ympodial	apart,arming,arrangement,articulation,bract,breeding,broad-based,cell,colour,connective,form,fruit,glabrousnes,growth,hair,heteromorphism,inflorescence,insertion,interjected,interpetalar,leaflet,lobing,marking,mature,modification,na,needle-like,number,odour,orientation,ovary,paired,papillose,perfect,placement,plurifoliate,position,prickle,pseudostipule,recurved,rhizome,scale,shape,size,smell,spacing,spot,staman,stone,structure,symmetry,sympodial,system,texture,thicknes,tissue,tuber,type,vegetative,xylopodia	.5,0-4,0.5-1,0.5-1.5,0.6-1.2,0.7-2,0.8-2,1-7,1.2-2,1.5,1.5-2,1/6-1/4,2-3,2.5,3-4,4-12,6-9,abaxially,accrescent,adaxially,almost,along,anthesi,apically,apparently,appressed,attenuate,basal,base,becoming,berry,black,branch,branched,brown,canaliculate,capitate,cm,completely,conical,corolla,cupular,curved,dark,deeply,dilated,discoid,distributed,drying,dull,entire,equal,erect,evenly,fine,finely,flat,glabrous,green,honeycomb,length,liana,lobed,long,longitudinally,mm,multiseriate,network,oblique,oblong,obovate,opening,orange,orange-brown,orange-yellow,pair,part,partly,pattern,peduncle,pitted,poricidal,prominent,pubescent,raised,rarely,red,reddish,ridged,shallowly,shiny,shortly,shrub,side,simple,slender,slightly,smooth,sometimes,sparsely,spheroidal,straight,stump,terminal,thick-chartaceous,thin,tip,twice,unarmed,vein,violet,visible,white,wider,x,young	apart,na,papillose,perfect,plurifoliate,recurved
497	wfo-0001031852	success	152	111	51	58	94	53	44	7	1-4,1-4.2,4-10,4-6,apex,apical,articulate,base,branched,calyx,cell,cm,conical,connate,corolla,dehiscent,dichasially,distal,ebracteate,filament,generally,green,green-white,hair-like,half,herbaceous,interjected,introrse,lanceolate,leaf,leaflet,light,long,maturing,mm,oblique,odd-pinnate,often,ovoid,pattern,pedicel,perennial,perfect,petiole,plant,poricidally,proximal,pubescent,seed,short,slit,stellate,throughout,tuber-bearing,typically,unit,white,¼	0.1-1,0.5-1.3,0.5-3,1-2-3,1-9,1.3-2.5,1.4-3,1.5-3,2-3,2-5.5,2.6-9.5,3-4,3-6-foliat,3-9,3.5-10,4-4-5-8,5-15,7-12-35,9-11,abaxially,abruptly,absen,acumen,acuminate,acute,adaxially,apically,apiculate,attenuate,covering,cyme,decurrent,diameter,dichasial,digestion,diminishing,dorsally,eaf,edge,eed,elliptic,elliptic-lanceolate,emoval,enzyme,exceeding,flat,flower,folded,forked,globo,honeycomb,lateral,living,lobe,lon,lower,lunat,make,monochasial,mucilaginous,nflorescence,nther,oblong,orolla,ovate-elliptic,pair,peduncle,plan,rachi,reveal,ruit,sessile,seudostipule,shortly,size,specimen,stamen,stigma,straight,style,tal,tem,terminal,testal,thick,throughou,toward,vary,wall,white-crea,wide,without,yellow,ympodial	3-6-foliate,absent,anther,apicidally,appressed,articulation,bract,branching,breeding,colour,connective,form,fruit,fruiting,growth,hair,heteromorphism,inflated,inflorescence,insertion,interpetalar,length,lunate,margin,marking,mature,modification,na,odour,orientation,paired,placement,pore,position,prickle,pseudostipule,rhizome,scale,shape,spot,staman,stone,structure,symmetry,sympodial,system,texture,tissue,tuber,type,white-cream,xylopodia,ye	1-4,1-4.2,4-10,4-6,apical,articulate,branched,cm,conical,connate,dehiscent,dichasially,distal,ebracteate,generally,green,green-white,hair-like,half,herbaceous,introrse,lanceolate,light,long,maturing,mm,oblique,odd-pinnate,often,ovoid,perennial,perfect,plant,poricidally,proximal,pubescent,short,slit,stellate,throughout,tuber-bearing,typically,white,¼	3-6-foliate,absent,apicidally,lunate,na,white-cream,ye
498	wfo-0001031864	success	140	156	81	97	43	59	76	5	.2,.25,.5,0.2-0.5,0.5-13.5,0.5-4,0.7-0.8,0.8-1,1-1.2,1-1.8,1-2,1-5,1-6.5,1.2-1.5,1.5-10,1.5-2.5,15-60,2-3,2.5-6,3-3.5,3-pinnate,5-merous,7.5-8,abaxially,acuminate,acute,adaxially,anther,apex,apiculate,base,blade,calyx,chartaceous,ciliate,clavate,cm,cuneate,deltoid,dense,diameter,entire,extra-axillary,filament,fine,flattened,fleshy,flower,fruit,glabrous,hair,herbaceous,leaflet,lenticular,like,lobe,long,lower,margin,middle,minutely,mm,near,oblique,ovoid-deltoid,papillose,pedicel,peduncle,petiole,petiolule,pointed,pubescence,pubescent,rachi,rotate,rounded,scattered,short,slender,slightly,sparsely,stem,stigma,style,surface,tip,trichome,truncate,tube,unbranched,unit,unknown,vine,violet,wide-diameter,widely,x	0.4-3,0.6-3.5,0.6-4,1-3,1.5,2,5-15,5-9,accrescent,alyx,apar,apical,axe,berry,c.,capitat,color,densely,eaf,eed,emarginate,fruiting,glabrou,lateral,lon,m.,moderately,nflorescence,nternode,orolla,perfec,plurifoliat,pubescenc,ruit,sand-punctate,spaced,tamen,tem,terrestria,typical,vary,vein,ympodial	abaxial,adaxial,articulation,bract,branching,breeding,broad-based,capitate,cell,colour,corolla,form,growth,habit,heteromorphism,inflorescence,insertion,interjected,internode,interpetalar,leaf,length,marking,mature,merosity,na,needle-like,odour,orientation,ovary,paired,pattern,perfect,placement,plant,plurifoliate,position,prickle,pseudostipule,rhizome,scale,seed,shape,size,smell,spot,staman,stone,structure,symmetry,sympodial,system,terrestrial,texture,tissue,tuber,type,vegetative,xylopodia	.2,.25,.5,0.2-0.5,0.5-13.5,0.5-4,0.7-0.8,0.8-1,1-1.2,1-1.8,1-2,1-5,1-6.5,1.2-1.5,1.5-10,1.5-2.5,15-60,2-3,2.5-6,3-3.5,3-pinnate,5-merous,7.5-8,abaxially,acuminate,acute,adaxially,apex,apiculate,chartaceous,ciliate,clavate,cm,cuneate,deltoid,dense,diameter,entire,extra-axillary,fine,flattened,fleshy,glabrous,hair,herbaceous,lenticular,like,long,middle,minutely,mm,near,oblique,ovoid-deltoid,papillose,pointed,pubescence,pubescent,rotate,rounded,scattered,short,slender,slightly,sparsely,stem,tip,trichome,truncate,unbranched,unknown,vine,violet,wide-diameter,widely,x	capitate,na,perfect,plurifoliate,terrestrial
499	wfo-0001031864	success	148	139	86	101	47	38	81	5	.2,.25,.5,0.4-3,0.5-13.5,0.5-4,0.6-3.5,0.6-4,1-1.2,1-1.8,1-2,1-3,1-5,1-6.5,1.5-2.5,15-60,2-3,2.5-6,3-3.5,3-5-celled,3-pinnate,7.5-8,abaxially,absent,adaxially,anther,apex,apical,apparently,articulated,basally,base,blade,blue-purple,calyx,center,ciliate,clavate,cm,cordate,cuneate,dense,densely,diameter,directed,distally,entire,equal,extra-axillary,filament,fine,fleshy,flower,glabrous,hair,herb,interjected,large,lateral,leaflet,lenticular,long,longitudinal,margin,mm,near,oblique,oblong,opening,papillose,pedicel,peduncle,perfect,petiolule,plurifoliate,pore,pubescence,pubescent,rachi,rotate,rounded,scattered,short,simple,slender,slit,somewhat,sparsely,stigma,style,surface,terrestrial,thick,tip,unbranched,uniseriate,unit,unknown,widely,woody,x	1.2-1.5,1.5,2,5-15,5-9,5-merou,accrescent,acuminate,acute,ag,alyx,apart,apiculate,axe,ba,capitat,color,connivent,deltoid,eaf,eed,emarginate,etiole,fruit,fruiting,geminat,lobe,lower,m.,minutely,nflorescence,node,orolla,pubescenc,rooting,slightly,spaced,tamen,tem,trailing,truncate,tube,vary,weakly,wiry,yellow,ympodial	5-merous,abaxial,adaxial,age,articulation,capitate,cell,colour,corolla,form,geminate,growth,heteromorphism,inflorescence,leaf,length,na,odour,orientation,ovary,petiole,placement,position,prickle,rhizome,seed,shape,size,staman,stem,stone,structure,symmetry,sympodial,texture,tuber,type,xylopodia	.2,.25,.5,0.4-3,0.5-13.5,0.5-4,0.6-3.5,0.6-4,1-1.2,1-1.8,1-2,1-3,1-5,1-6.5,1.5-2.5,15-60,2-3,2.5-6,3-3.5,3-5-celled,3-pinnate,7.5-8,abaxially,absent,adaxially,apparently,articulated,basally,base,blue-purple,center,ciliate,clavate,cm,cordate,cuneate,dense,densely,diameter,directed,distally,entire,equal,extra-axillary,fine,fleshy,glabrous,hair,herb,large,lenticular,long,longitudinal,mm,near,oblique,oblong,opening,papillose,perfect,plurifoliate,pubescence,pubescent,rotate,rounded,scattered,short,simple,slender,slit,somewhat,sparsely,terrestrial,thick,tip,unbranched,uniseriate,unknown,widely,woody,x	5-merous,age,capitate,geminate,na
500	wfo-0001031871	success	185	196	121	140	45	56	114	7	0.4-2,0.6-1.2,1-2,1.5-11,1.5-2,1.5-2.1,1.6-2.7,14-22,2-3,2-4,3-10,3-4,3-5,3.5-4,33-40,36-44,4-6,4-7,5.4-12.3,6-12,6-7,6.5-20.5,7-9,7.5-23,abaxially,acumen,adaxially,anther,apart,apex,articulated,asymmetric,attenuate,axillary,base,berry,blade,brownish,bud,cell,chartaceous,clavate,cm,condition,connivent,corolla,dark,deep,diameter,digestion,distal,dorsally,dot,drying,edge,elliptic,end,enzyme,filament,flat,flower,folded,forked,fresh,fruit,generally,glabrous,globose,green,greenish,hair,half,herb,high,homostylous,honeycomb-shaped,interjected,lanceolate,lateral,leaflet,lengthening,linear,lobe,long,medium,mm,mottled,narrowly,odd-pinnate,one,orbicular,ovate,ovoid,pair,pedicel,peduncle,petiole,petiolulate,placed,plant,plurifoliate,pore,poricidal,pubescent,purple,removed,ripe,rotate,rounded,seed,sessile,short,size,slit,sometimes,stigma,straight,style,subequal,subglabrous,subtending,symmetric,terminal,testal,tiny,tip,tissue,tri-,tube,tuber,typically,unit,usually,wall,white,whitish,wide,winged,x,yellow	1.4-2.1,2.9-6,5-merou,acute,adaxiall,ag,alyx,apparently,axe,basiscopic,capitat,covering,eaf,eed,erec,exceeding,geminat,glabrou,green-white,hair-like,hal,living,lower,make,mucilaginous,nflorescence,orolla,perfect,round,ruit,seudostipule,side,spaced,specimen,stamen,stolo,subglabrou,tall,tamen,tem,thick,throughout,vary,wet,ympodial	age,appressed,arrangement,articulation,bract,branching,breeding,calyx,capitate,colour,connective,form,fruiting,geminate,growth,height,heteromorphism,inflated,inflorescence,insertion,interpetalar,leaf,length,margin,marking,mature,modification,na,number,odour,orientation,ovary,paired,pattern,placement,position,prickle,pseudostipule,rhizome,scale,shape,spacing,spot,staman,stellate,stem,stolon,stone,structure,symmetry,sympodial,system,texture,type,xylopodia,zygomorphy	0.4-2,0.6-1.2,1-2,1.5-11,1.5-2,1.5-2.1,1.6-2.7,14-22,2-3,2-4,3-10,3-4,3-5,3.5-4,33-40,36-44,4-6,4-7,5.4-12.3,6-12,6-7,6.5-20.5,7-9,7.5-23,abaxially,acumen,adaxially,apart,articulated,asymmetric,attenuate,axillary,berry,brownish,bud,chartaceous,clavate,cm,condition,connivent,dark,deep,digestion,distal,dorsally,dot,drying,elliptic,end,enzyme,flat,folded,forked,fresh,generally,glabrous,globose,green,greenish,hair,half,herb,high,homostylous,honeycomb-shaped,lanceolate,lateral,lengthening,linear,long,medium,mm,mottled,narrowly,odd-pinnate,one,orbicular,ovate,ovoid,petiolulate,placed,plant,plurifoliate,pore,poricidal,pubescent,purple,removed,ripe,rotate,rounded,sessile,short,size,slit,sometimes,straight,subequal,subglabrous,subtending,symmetric,terminal,tiny,tip,tri-,typically,usually,wall,white,whitish,wide,winged,x,yellow	age,capitate,geminate,na,stellate,stolon,zygomorphy
501	wfo-0001031876	success	140	115	47	58	82	57	44	3	.1,.5,0-flowered,0.8-1,1,1-1.5,1-1.6,1.5-2.2,27-35,9-15,acute,anther,apex,base,beneath,bright,calyx,cm,corolla,decurrent,elliptic,flower,fruiting,glabrous,globose,granular,green,greenish-yellow,leaf,lightly,lobed,long-acuminate,lower,margin,minutely,mm,nearly,oblanceolate,oblique,opposite,pedicel,petiole,pore,poricidal,prominent,raised,shaped,shrub,slightly,stem,tear-drop,tip,tube,unit,venation,white,winged,yellow	0.5,1-4,3,5,?,across,anthesi,apiculate,arc,arising,ba,bark,bearing,berry,closely,convergence,corky,cup-like,dia,differing,eaf,edicel,eed,erect,family,filament,free,glabrou,immature,irregularity,known,lateral,lenticellat,less,lobe,long,main,major,melastomataceae,member,middle,minute,nflorescence,often,otherwise,ovary,overlappin,pair,papillose,parallel,perpendicular,persistent,point,portion,present,primary,recurved,reflexed,resemble,ruit,running,scar,secondary,simple,slender,spaced,stigma,straight,styl,style,tall,tapering,time,ud,unifoliat,vein,wide,widest,woody,x,ympodial,young	articulation,bract,branching,breeding,broad-based,cell,colour,connective,diameter,form,fruit,growth,hair,height,heteromorphism,inflorescence,insertion,interjected,interpetalar,leaflet,length,marking,modification,na,needle-like,number,odour,orientation,paired,pattern,placement,plant,position,prickle,pseudostipule,rhizome,scale,shape,smell,spot,staman,stone,structure,surface,symmetry,sympodial,system,texture,tissue,trichome,tuber,type,unifoliate,vegetative,width,xylopodia,zygomorphy	.1,.5,0-flowered,0.8-1,1,1-1.5,1-1.6,1.5-2.2,27-35,9-15,acute,base,beneath,bright,cm,decurrent,elliptic,glabrous,globose,granular,green,greenish-yellow,leaf,lightly,lobed,long-acuminate,minutely,mm,nearly,oblanceolate,oblique,opposite,petiole,poricidal,prominent,raised,shaped,shrub,slightly,tear-drop,tip,white,winged,yellow	na,unifoliate,zygomorphy
502	wfo-0001031877	invalid_json	213	134	NA	113	100	21	NA	NA	+,.5,0.3-1,0.3-1-3.5,0.3-1.2,0.5,0.5-1,0.6-1.2,1-1.5,1-3,1-4,1.1-1.8-5,1.5,1.5-1.9,2-6-10,2.5,3.5-4,6-8,acuminate,acute,adaxially,angled,anther,apex,articulated,basally,base,berry,bright,brown,capitate,cell,clavate,cm,corolla,deep,deltate,densely,diameter,ellipsoid,ellipsoidal,entire,exposed,filament,flattened,flower,fruit,fruiting,glabrous,globose,greenish,growth,hastate,later,lateral,lengthening,line,lobed,margin,mature,minute,minutely,mm,nearly,new,outline,pale,pedicel,peduncle,per,perfect,petiole,pitted,plump,pore,poricidal,prominently,pubescent,purple,red,reddish,reniform,ripe,scar,scrambler,seed,short,silky,simple,sleeve,slightly,slit,somewhat,sparsely,stellate,stem,stigma,style,surface,terminal,testal,tinged,tip,triangular,trichome,tube,uniseriate,usually,vine,wall,weak,white,x	.3,0.2,0.8-0.9,1,1.5-2,2,3-5,3-6,5-merou,abaxially,abruptly,adaxiall,ag,along,alyx,anthesi,apar,apparently,ark,ascending,basal,calyx,conical,connivent,deflexed,distal,dried,eaf,eed,enlarged,erect,especially,exserted,eye,fleshy,free,furcate,green,ilament,impressed,internal,irregularly,lamina,like,linear,lobe,long,long-acuminate,loosely,lower,material,midvein,nflorescence,occasionally,often,older,orolla,pair,papillate,papillo,parallel,part,pericarp,plant,plurifoliat,pointing,portion,primary,pubescence,purplish,rectangular,reflexed,rest,rounded,ruit,semi-woody,shiny,shorte,sinuate,slender,sometimes,spaced,spreadin,strongly,subshru,tem,thin,truncate,twinin,ud,uniformly,unit,upper,vary,vein,visible,woody,yello,ympodial,young	5-merous,age,apart,articulation,bark,bud,characteristic,colour,form,hair,inflorescence,leaf,length,number,ovary,shape,size,spacing,type,value,yellow	NA	NA
503	wfo-0001031880	success	180	117	53	67	113	50	50	3	1-1.5,1.5,2-3,3-3.5,3-4-pluri-foliate,3-foliate,3-lobed,5-6,7-9,age,anther,apex,base,berry,calyx,cell,cm,cordate,corolla,densely,diameter,enlarged,filament,flattened,fleshy,flush,fruit,fruiting,glandular,globose,herb,heteromorphic,inflorescence,internodal,leaf,lengthening,longest,lower,margin,mature,mid-length,mm,orange,pale,pedicel,petiole,pore,poricidal,pubescent,purple,rachi,red,reddish,shortest,simple,slit,spreading,stem,subshrub,surface,tip,trichome,truncate,uniseriate,unit,x,–5	.5,0.5-1,0.5-2,0.7-0.8,1,1-1.3,1-2,2,2-4,2-9,2.5-8,4,4-8,5,6-9,abaxially,acuminate,acute,adaxially,anthesi,apart,basal,bearing,becoming,broadly,brown,c.,capitate,ciliate,color,conical,crenate,crowded,cup-shaped,curved,dark,eaf,edicel,eed,ellipsoid,elliptic,entire,erect,exerted,flower,free,glabrous,gland,gland-tipped,green,growing,hollow,horn,irregularly,lamina,less,lobe,lon,long,markedly,maturit,middle,minutely,narrowly,near,nflorescence,nodding,ovary,ovate,ovoid,pair,papillo,papillose,peduncle,pericarp,pitted,plan,portion,primary,pubescen,reflexed,ruit,scar,shallowly,single,slender,slightly,sometimes,spaced,sparse,sparsely,stigma,straight,strongly,style,terminal,testal,thin,toothed,triangular,tube,ud,unicellula,unlobed,upper,upward,vein,wall,widely,widest,woody,yellow,ympodial	appressed,articulation,bract,branching,breeding,broad-based,colour,connective,form,growth,hair,heteromorphism,inflated,insertion,interjected,interpetalar,leaflet,length,marking,maturity,modification,na,needle-like,odour,orientation,paired,pattern,placement,position,present,prickle,pseudostipule,rhizome,scale,shape,smell,spot,staman,stone,structure,symmetry,sympodial,system,texture,tissue,tuber,type,vegetative,xylopodia,zygomorphy	1-1.5,1.5,2-3,3-3.5,3-4-pluri-foliate,3-foliate,3-lobed,5-6,7-9,age,berry,cm,cordate,densely,diameter,enlarged,flattened,fleshy,flush,fruit,glandular,globose,herb,heteromorphic,internodal,lengthening,longest,mature,mid-length,mm,orange,pale,pore,poricidal,pubescent,purple,rachi,red,reddish,shortest,simple,slit,spreading,subshrub,tip,trichome,truncate,uniseriate,x,–5	maturity,na,present
504	wfo-0001031881	success	168	110	44	60	108	50	42	2	0.2-0.6,0.5-0.7,1-1.5,1.5-2.5,1/3,3.5-4,3/4,acute,anther,apex,attenuate,base,beneath,branched,calyx,cm,corolla,densely,difoliate,distal,elliptic,filament,fleshy,fruit,fruiting,glabrous,globose,green,inflorescence,leaf,lobed,long,lower,margin,mm,obovate,opposite,pedicel,petiole,pore,poricidal,pubescent,shape,shaped,shrub,simple,small,sparsely,stem,surface,tear-drop,tip,tree,trichome,uniseriate,unit,usually,way,white,x	.5,0.1-0.5,0.2,0.4-1,0.5-1,1-1.3,1-7,1.2-6,10-12,10-30,2,2-9,3-19,5-6,7-14,absent,along,anthesi,apar,apparent,axil,ba,bark,branch,broadly,brown,bud,campanulate,capitate,constriction,dark,decurrent,deflexed,deltoid,dia,differing,dry,drying,eaf,edicel,eed,either,ellipsoid,erect,evenly,exserted,free,geminat,golden,golden-puberulent,golden-pubescent,greyish-brow,incrassate,inflorescenc,junction,lateral,lightly,like,lobe,lon,main,major,material,maturity,middle,midrib,minor,minute,minutely,nflorescence,occasionally,older,one,orbicular,ovary,ovoid-reniform,pair,papillo,papillose,pitted,planar,portion,puberulen,puberulent,rest,rounded,ruit,scar,size,slender,slightly,somewhat,soon,spaced,stigma,straight,strong,style,tall,tapering,tube,ud,vein,widest,winged,woody,ympodial,young	appressed,articulation,bract,branching,breeding,broad-based,cell,colour,connective,form,geminate,growth,hair,heteromorphism,inflated,insertion,interjected,interpetalar,leaflet,length,marking,mature,modification,na,needle-like,odour,orientation,paired,pattern,placement,position,prickle,pseudostipule,rhizome,scale,smell,spot,staman,stone,structure,symmetry,sympodial,system,texture,tissue,tuber,type,vegetative,xylopodia,zygomorphy	0.2-0.6,0.5-0.7,1-1.5,1.5-2.5,1/3,3.5-4,3/4,acute,attenuate,base,beneath,branched,cm,densely,difoliate,distal,elliptic,fleshy,glabrous,globose,green,leaf,lobed,long,mm,obovate,opposite,poricidal,pubescent,shaped,shrub,simple,small,sparsely,tear-drop,tip,tree,uniseriate,usually,way,white,x	geminate,na
505	wfo-0001031886	success	168	104	40	52	116	52	37	3	0.5-1,1-1.5,2-2.5,2-5,5-ridged,anther,apex,attenuate,axillary,base,berry,bud,calyx,cell,cm,conical,corolla,distinctly,dry,earl,elliptic,filament,fruit,fruiting,glabrous,green,greenish,leaflet,lobed,long,lower,margin,minutely,mm,nearly,papillose,pedicel,petiole,pinnate,poricidal,rugose,shape,shrub,simple,specimen,strongly,surface,tip,unit,white,wintergreen,x	-1.2,-4,-9,.5,0,0.1,1-4,1.2-2.5,1.5-2,10-40,2,2-3,2-4,2.0-2.5,20-30,3-6,3.0,4,4-15-25,5-10,5-6,6-20,6-8,9-10,abaxially,abruptly,absent,acuminate,adaxially,along,anthesi,anticlinal,arising,axil,basal,beak,bearing,bright,broadly,brown,capitate,clavat,commonly,completely,deltate,diameter,eaf,edicel,eed,either,em,epidermal,equal,erec,exserted,fleshy,flower,free,half,irregular,lanceolate,lateral,le,lobe,narrowed,near,nflorescence,noddin,node,oblique,occasionally,open-conical,ovary,ovoid-reniform,pair,papillae,papillate,per,petiolule,portion,primary,projection,purple,rachi,raised,reddish,reflexed,ripe,ruit,scar,scattered,seed,similar,single,sinuous,smaller,smelling,somewhat,sparse,stigma,style,terminal,thickening,time,triangular,trichome,tub,tube,ud,unifoliat,uniseriate,usually,vein,without,woody,ympodial	appressed,articulation,bract,branching,breeding,broad-based,colour,connective,form,growth,hair,heteromorphism,inflated,inflorescence,insertion,interjected,interpetalar,leaf,length,marking,mature,modification,na,needle-like,odour,orientation,paired,pattern,placement,pore,position,prickle,pseudostipule,rhizome,scale,smell,spot,staman,stem,stone,structure,symmetry,sympodial,system,texture,tissue,tuber,type,unifoliate,vegetative,xylopodia,zygomorphy	0.5-1,1-1.5,2-2.5,2-5,5-ridged,attenuate,axillary,base,berry,bud,cm,conical,distinctly,dry,earl,elliptic,glabrous,green,greenish,lobed,long,margin,minutely,mm,nearly,papillose,pinnate,poricidal,rugose,shrub,simple,specimen,strongly,tip,white,wintergreen,x	na,unifoliate,zygomorphy
506	wfo-0001031895	success	160	133	65	81	79	52	62	3	0.5,0.5-1,1-1.5,1.5-3,1.5-6,2-2.5,2.5-3,4.5-16.5,5,6-7,acute,age,anther,anthesi,apex,attenuate,base,berry,bluish,campanulate,capitate,cell,cm,corolla,dark,densely,diameter,elliptic,entire,filament,fleshy,glabrous,globose,green,growth,leaf-opposed,leafy,leaving,lengthening,less,lobed,lower,margin,minutely,mm,occasionally,once-branched,papillate,pedicel,peduncle,peg,petiole,planar,pore,poricidal,revolute,shoot,short,shrub,simple,slightly,slit,small,somewhat,stem,stigma,stout,straight,style,surface,terminal,thick,tip,tree,tube,unit,violet,way,white,x,¼-1/2	-1.5,0.5-2,1.5-2,3-10,3-4,3-8,3.5-6,4,4-5,5-6,5-8,6-9,apparently,articulating,bark,beneath,blac,broadly,calyx,completely,conical,cup-shaped,deltate,drying,eaf,eed,ellipsoid,emarginated,enlarging,erec,erect,exerted,exfoliating,expand,flower,fragrant,free,fruiting,glabrou,immature,inflorescenc,intensely,irregular,lobe,matte,new,nflorescence,older,ovary,overlapping,ovoid,pair,pale,papillat,part,patch,peeling,perfect,pericarp,pitted,plurifoliat,portion,primary,reddish,reniform,ruit,scar,shiny,sinuate,slender,strongly,tan,testal,thin,tub,ud,vein,woody,ympodial	arrangement,articulation,bract,branching,breeding,broad-based,colour,connective,form,fruit,hair,heteromorphism,inflorescence,insertion,interjected,interpetalar,leaf,leaflet,length,marking,mature,modification,na,needle-like,odour,orientation,paired,pattern,placement,plurifoliate,position,prickle,pseudostipule,rhizome,shape,size,smell,spot,staman,stone,structure,symmetry,sympodial,system,texture,tissue,trichome,tuber,type,vegetative,xylopodia,zygomorphy	0.5,0.5-1,1-1.5,1.5-3,1.5-6,2-2.5,2.5-3,4.5-16.5,5,6-7,acute,age,anthesi,attenuate,base,berry,bluish,campanulate,capitate,cm,dark,densely,elliptic,entire,fleshy,glabrous,globose,green,leaf-opposed,leafy,leaving,lengthening,less,lobed,minutely,mm,occasionally,once-branched,papillate,peg,planar,poricidal,revolute,shoot,short,shrub,simple,slightly,slit,small,somewhat,stout,straight,terminal,thick,tip,tree,violet,way,white,x,¼-1/2	inflorescence,na,plurifoliate
507	wfo-0001031897	success	264	112	56	65	199	47	51	5	.1,.5,0-1,0.1-0.5,0.15,5-6,accrescent,almost,anther,apex,apically,apparently,attenuate,base,berry,black,branched,calyx,cell,chartaceous,cm,coriaceous,corolla,cuneate,curved,dendritic,densely,dilated,dry,drying,entire,epiphyte,filament,fruit,fruiting,hair,leaf,lobed,long,lower,margin,mauve,mm,never,oblong,orange-brown,ovoid,pedicel,petiole,pore,poricidal,revolute,ridged,shrub,simple,slightly,sparsely,stem,surface,terminal,thick,tip,unit,white,x	.8,0.2-0.4,0.4-1.1,0.5-1,0.5-3,0.6,0.8-1.5,0°,1,1-1.5,1-2,1-2.5,1.1,1.3-2,1.5,1.5-8,1.7-3,13,2-4,2/3,4-5,462.,6-9,8,abaxial,abaxially,absent,acute,adaxial,adaxially,age,along,alyx,anthesi,apar,appearing,appendage,arising,aristate,articulated,axillary,bark,bendy,boiteau,brachyblast,branch,brown,clavate,clearly,clustered,concolorous,condensed,conical,connate,covering,dark,datum,dehiscing,delineated,dense,developed,developing,development,diameter,distributed,divided,domatia,dorsal,dorsifixed,dull,eaf,earliest,ed,elliptic,enlarged,equal,erect,even,evenly,except,extending,eye,faint,filiform,fine,flower,foliaceous,free,glabrous,green,grey,immature,indistinc,inner,inside,known,lamina,lanceolate,larger,lateral,least,lengthening,light,like,linear,lobe,longitudinal,longitudinally,looped,m.,main,margi,membranous,midvein,minute,minutely,multicellular,multiseriate,naked,nflorescence,nther,obconical,oblon,obtuse,occasional,occasionally,one,orange,orolla,outside,ovate,overlapping,pair,papillose,part,partly,peduncle,pendulous,perfec,pericarp,persisting,plant,plurifoliat,pointed,portion,primary,prominent,pronounced,protruding,pubescent,raised,rarely,reach,reddish,ribbed,ridge,ruit,scar,secondary,see,seen,shoot,short,side,sinus,slender,smaller,smoot,smooth,sometimes,sparse,stigma,stump,style,subulate,sunk,tearing,terete,tertiary,thin,toward,trichome,tube,ud,unarmed,unbranched,unicellular,usually,vary,vein,venation,visible,weakly,well-developed,wide,winged,wrinkle,ympodial,young	appressed,articulation,bract,branching,breeding,broad-based,colour,connective,form,growth,heteromorphism,inflated,inflorescence,insertion,interjected,interpetalar,leaflet,length,marking,mature,modification,na,odour,orientation,paired,pattern,perfect,placement,plurifoliate,position,prickle,pseudostipule,rhizome,scale,shape,spot,staman,stone,structure,symmetry,sympodial,system,texture,tissue,tuber,type,xylopodia	.1,.5,0-1,0.1-0.5,0.15,5-6,accrescent,almost,apically,apparently,attenuate,base,berry,black,branched,chartaceous,cm,coriaceous,cuneate,curved,dendritic,densely,dilated,dry,drying,entire,epiphyte,leaf,lobed,long,lower,mauve,mm,never,oblong,orange-brown,ovoid,poricidal,revolute,ridged,shrub,simple,slightly,sparsely,stem,surface,terminal,thick,tip,white,x	broad-based,na,perfect,plurifoliate,prickle
508	wfo-0001032157	success	136	130	68	81	55	49	63	5	.5,0.5-1,0.6-1,0.75-1,1-3,2-3,2-5,2.2,3-6,5-15-flowered,9-17,acute,anther,anthesi,apart,apex,bark,base,becoming,beginning,beneath,bi-lobed,calyx,cm,completely,corolla,crystalline,decurrent,deflexed,deltoid,difoliate,dry,elliptic,filament,fruiting,glabrous,globose,golden,green,incrassate,leaf,live,lobe,lobed,longitudinal,margin,minor,minutely,mm,nearly,opposite,ovary,ovoid-reniform,paler,papillose,pedicel,peeling,persistent,petiole,pitted,plant,pore,reddish,scar,shaped,shiny,shrub,size,slender,slightly,stigma,strip,style,surface,tapering,tear-drop,tube,unit,white,woody,x	.75,0.25,1.9-2.2,5-8,5-9,7-9,berry,caly,dia,differing,eaf,edicel,eed,evenly,exserted,free,frui,geminat,glabrou,inflorescenc,lateral,less,living,lon,long,lower,main,major,middle,nflorescence,obscure,older,one,pair,papillo,poricidal,portion,raised,reflexed,rounded,ruit,simple,soon,spaced,stem,straight,tall,tip,translucen,ud,vein,widest,yellowish,ympodial,young	articulation,bract,branching,cell,colour,deflexion,diameter,flower,form,fruit,geminate,glabrousnes,growth,hair,height,heteromorphism,inflorescence,insertion,interjected,interpetalar,leaflet,length,na,number,odour,orientation,paired,placement,position,prickle,rhizome,scale,seed,shape,smell,spacing,staman,stone,structure,symmetry,sympodial,texture,tissue,trichome,tuber,type,vegetative,xylopodia,zygomorphy	.5,0.5-1,0.6-1,0.75-1,1-3,2-3,2-5,2.2,3-6,5-15-flowered,9-17,acute,apart,base,becoming,beginning,beneath,bi-lobed,calyx,cm,completely,crystalline,decurrent,deflexed,deltoid,difoliate,dry,elliptic,glabrous,globose,golden,green,incrassate,leaf,live,lobed,longitudinal,minutely,mm,nearly,opposite,ovoid-reniform,paler,papillose,peeling,persistent,petiole,pitted,plant,reddish,shaped,shiny,shrub,slender,slightly,strip,surface,tapering,tear-drop,tube,white,woody,x	fruit,geminate,inflorescence,na,zygomorphy
509	wfo-0001032161	success	146	92	35	45	101	47	33	2	.5,2-7,2.5-3,acute,anther,apex,base,berry,calyx,coriaceous,corolla,dendritic,difoliate,drying,elliptic,filament,fruiting,globose,golden,green,inflorescence,internodal,leaf,lobed,long,margin,mm,mustard,nearly,opposite,pedicel,petiole,plurifoliate,pore,poricidal,revolute,shaped,shrub,simple,tear-drop,tip,trichome,unit,white,yellow	0.4-1.2,0.5-1,0.7-4,0.75-1,0.8-1,1-1.5,1-11,1-3,1.2-1.3,1.4-2,2-8-flowered,3.5-4,?,abaxially,adaxiall,adaxially,anthesi,apical,area,ba,bark,beneath,branched,brownish-blac,closely,cm,color,conical,dark,deflexed,delicate,deltate,densely,dia,eaf,edicel,eed,ellipsoid,exserted,filiform,free,giving,glabrous,hanging,lamina,later,like,lobe,lower,many,merely,middle,minute,minutely,nflorescence,obovate,occasionally,older,ovary,overlappin,ovoid-reniform,pale,papillose,pericarp,persistent,pitted,plant,portion,projection,pubescent,quadrate,reflexed,rest,ruit,scar,shiny,shoot,short,spaced,sparsely,stem,stigma,strongly,styl,style,sulcate,surface,tall,tan,thin,tub,tube,ud,uniseriate,usually,vein,widest,x,yellowish,ympodial,young	appressed,articulation,bract,branching,breeding,cell,colour,connective,form,fruit,growth,hair,heteromorphism,inflated,insertion,interjected,interpetalar,leaflet,length,marking,mature,modification,na,odour,orientation,paired,pattern,placement,position,prickle,pseudostipule,rhizome,scale,shape,spot,staman,stellate,stone,structure,symmetry,sympodial,system,texture,tissue,tuber,type,xylopodia	.5,2-7,2.5-3,acute,base,berry,coriaceous,dendritic,difoliate,drying,elliptic,globose,golden,green,internodal,leaf,lobed,long,mm,mustard,nearly,opposite,plurifoliate,poricidal,revolute,shaped,shrub,simple,tear-drop,tip,trichome,white,yellow	na,stellate
510	wfo-0001032165	success	197	115	53	63	134	52	50	3	0.25-0.5,0.75-1,1-2,2.5-3.5,acute,anther,apex,base,berry,broadly,calyx,center,cm,corolla,cup-shaped,deciduous,decurrent,difoliate,elliptic,erect,filament,fruiting,glabrous,globose,golden,golden-puberulent,green,inflorescence,leaf,lobed,long,lower,margin,minute,minutely,mm,nearly,node,obovate,onto,opposite,pedicel,petiole,pore,poricidal,purplish,ripe,shape,stem,surface,tapering,tear-drop,terminal,tinged,tip,tree,trichome,tube,uniseriate,unit,white,x,young	.25,.5,0.1,0.1-0.3,0.3-1,1-1.2,1-1.5,1.5-4,10-25,2-2.5,3-4,3-6,3.5-8.5,4-6,5-15,5-30-flowered,5-6,5-7,5-9.5,8-9,abaxial,adaxial,along,anthesi,apparent,appearing,ba,bark,beginning,beneath,brown,bud,capitate,closely,continued,cucullate,dark,deltoid,densely,denser,dia,differing,distal,dry,due,dull,eaf,edged,edicel,eed,ellipsoid,end,entire,even,expansion,exserted,exsertion,free,geminat,golden-pubescent,greyish-brown,immature,inflorescenc,later,lateral,less,like,live,lobe,lon,main,major,markedly,medial,middle,midrib,minor,near,nflorescence,occasionally,older,once-furcate,one,orbicular,ovary,overlapping,ovoid-reniform,pair,pale,paler,papillo,papillose,pitted,planar,plant,portion,presence,prominent,puberulent,rather,rest,ridge,rounded,ruit,scar,shaepd,simple,single,size,slender,slightly,slow,small,smoot,spaced,specimen,stigma,stout,straight,stripe,strongly,style,swollen,tall,thickened,time,tub,ud,vein,widest,winged,woody,yellowish,ympodial	appressed,articulation,bract,branching,breeding,broad-based,cell,colour,connective,form,fruit,geminate,growth,hair,heteromorphism,inflated,insertion,interjected,interpetalar,leaflet,length,marking,mature,modification,na,needle-like,odour,orientation,paired,pattern,placement,position,prickle,pseudostipule,rhizome,scale,shaped,smell,spot,staman,stone,structure,symmetry,sympodial,system,texture,tissue,tuber,type,vegetative,xylopodia,zygomorphy	0.25-0.5,0.75-1,1-2,2.5-3.5,acute,base,berry,broadly,calyx,center,cm,cup-shaped,deciduous,decurrent,difoliate,elliptic,erect,glabrous,globose,golden,golden-puberulent,green,leaf,lobed,long,minute,minutely,mm,nearly,node,obovate,onto,opposite,petiole,poricidal,purplish,ripe,surface,tapering,tear-drop,terminal,tinged,tip,tree,trichome,tube,uniseriate,white,x,young	geminate,na,shaped
511	wfo-0001032167	success	163	138	69	85	78	53	64	5	0.5-1,0.5-2.5,1-2,1-2.5,1-5,10-20,10-35,12-20,2-7,2-foliate,3-6,3-7,4-6,5-15,7-10,absent,abundant,anther,apex,appressed,base,berry,brown,calyx,cell,chartaceous,ciliate,cm,cordate,densely,diameter,dm,drying,elliptic,elliptic-ovoid,entire,few-,filament,flattened,flower,forming,fruit,glabrous,globose,growth,hair,herb,immature,interpetalar,many-branched,margin,maturing,membranaceous,mm,moderately,nearly,netlike,oblong,obtuse,pedicel,peduncle,per,petiole,projection,pubescent,purple,rachi,raised,rotate,rounded,seed,semitransparent,sparsely,staman,style,surface,tissue,twisted,unbranched,unit,usually,wall,white,x,yellow	.5,0.5-1.5,0.75-3,1,1-2-celled,1-3,1-7,1.5,2-4,4-10,abaxially,acute,adaxiall,adaxially,along,axe,blade,closely,common,connected,curved,decurrent,dehiscing,dense,denser,eaf,eed,emarginat,explosively,flat,frui,geminat,geniculate,growt,held,larger,linear-lanceolate,lobe,long,longer,lower,lowermost,lying,maturit,mesocarp,near,new,nfloresence,notch,often,older,one-celled,orolla,placenta,pressure,pubescen,ruit,shorter,slightly,small,smaller,sometimes,stamen,stigma,straight,tal,tamen,tem,triangular,tube,two-celled,upper,vary,vein,watery,wid,woody,ympodial	arrangement,articulation,bract,branching,breeding,colour,connective,corolla,decument,emarginate,form,fruiting,geminate,height,heteromorphism,inflated,inflorescence,insertion,interjected,leaf,leaflet,length,marking,mature,modification,na,number,odour,orientation,ovary,paired,pattern,placement,plant,pore,position,prickle,pseudostipule,rhizome,scale,shape,spot,stem,stone,structure,symmetry,sympodial,system,texture,tuber,type,xylopodia,zygomorphy	0.5-1,0.5-2.5,1-2,1-2.5,1-5,10-20,10-35,12-20,2-7,2-foliate,3-6,3-7,4-6,5-15,7-10,absent,abundant,berry,brown,cell,chartaceous,ciliate,cm,cordate,densely,dm,drying,elliptic,elliptic-ovoid,entire,few-,flattened,flower,forming,fruit,glabrous,globose,herb,immature,many-branched,maturing,membranaceous,mm,moderately,nearly,netlike,oblong,obtuse,petiole,projection,pubescent,purple,raised,rotate,rounded,semitransparent,sparsely,twisted,unbranched,usually,wall,white,x,yellow	decument,emarginate,geminate,na,zygomorphy
512	wfo-0001032176	success	177	114	60	68	109	46	57	3	.5,0.5-1,0.8-6,1-1.2,1.5-2.5,5-6-celled,along,anther,anthesi,apex,attenuate,axillary,base,berry,branched,calyx,cell,cm,conical,corolla,cucullate,densely,drying,elliptic,filament,filiform,fruiting,green,greenish,herb,leaf,leaflet,lengthening,like,lobe,lobed,long,margin,minute,minutely,mm,nearly,nodding,occasionally,onto,papillose,pedicel,petiole,pinnate,pore,poricidal,pubescent,rachi,reflexed,simple,slightly,slit,somewhat,sparsely,stem,tip,trichome,tube,uniseriate,unit,white,winged,x	0,0.42,0.5,0.5-0.7,0.5-0.75,0.8-1,1-10,1.5-1.6,1.5-6,1/2,100,2-3,2.5-10,3-15,3-3.5,3-4,3-7,6,6-10,7,adaxially,adhering,apart,apical,arising,attaining,axil,basal,beak,becoming,capitat,cateniform,containing,copiously,creeping,denser,diameter,eaf,edicel,eed,ellipsoid,epidermal,equal,especially,exserted,fallen,flower,free,glabrous,globose,grey-brown,greyish,hangin,inflorescenc,lateral,lengt,log,long-papillose,lower,nflorescence,node,obovate,obtuse,often,open,ovary,ovoid-reniform,pair,pale,per,petiolule,portion,projection,quadrate,rest,rooting,rounded,ruit,scar,seed,separate,single,sinuous,size,smaller,soon,spaced,stigma,strait,strongly,style,tem,terminal,thickening,tightly,time,tree,truncate,trunk,tub,ud,ultimate,unevenly,unifoliat,vein,wall,whit,without,ympodial	appressed,articulation,bract,branching,cateniforme,colour,connective,form,fruit,growth,hair,heteromorphism,inflated,inflorescence,insertion,interjected,interpetalar,length,marking,mature,modification,na,odour,orientation,paired,pattern,placement,position,prickle,pseudostipule,reproduction,rhizome,scale,shape,spot,staman,stone,structure,symmetry,sympodial,texture,tissue,tuber,type,unifoliate,xylopodia	.5,0.5-1,0.8-6,1-1.2,1.5-2.5,5-6-celled,along,anthesi,attenuate,axillary,base,berry,branched,calyx,cm,conical,cucullate,densely,drying,elliptic,filiform,green,greenish,herb,lengthening,like,lobe,lobed,long,margin,minute,minutely,mm,nearly,nodding,occasionally,onto,papillose,pinnate,pore,poricidal,pubescent,rachi,reflexed,simple,slightly,slit,somewhat,sparsely,stem,tip,trichome,tube,uniseriate,white,winged,x	cateniforme,na,unifoliate
513	wfo-0001032187	success	132	162	85	99	33	63	79	6	0.1–1.4,0.5,0.5-1.1–3.2,0.5–1,0.6–1.3,1.3–1.8,1.6–2.1,1.8–2,1.8–2.8,1–1.7-2.1,22,24.6–26.3,2–9-11,3.1–3.5-4.2,3–3.2-4,3–4-5,5-merous,5–7-9,7–11,9,acuminate,acute,adherent,anther,apex,appressed,aromatic,base,berry,blade,branch,broadly,brown,brownish,changing,cm,corolla,cyme,dark,di-foliate,dull,eglandular,elliptic,entire,equal,erect,filament,flowered,forked,glabrescent,globose,green,hair,herb,leaf,light,lobe,long,lower,many,margin,mature,mm,obovate,occasionally,ovate,pedicel,peduncle,pentagonal,per,persistent,petiolate,petiole,plant,pollen,predominantly,purple,rarely,simple,soft,sparse,spreading,stage,stellate,stem,style,sub-glabrous,texture,tinged,triangular,truncate,unit,widest,yellow,yellowish,±,±1,µm,×	100,alyx,angular,ape,consisting,dia,eaf,eed,fully,geminat,granule,hite,hooked,hydrated,marked,nflorescence,numerous,penden,perfec,presen,protruding,ridge,ruit,running,sclerotic,short,small,sometimes,straight,tooth,well,wing,ympodial	adherence,arrangement,articulation,bract,branching,breeding,broad-based,calyx,cell,colour,connective,diameter,flower,form,fruit,geminate,growth,height,heteromorphism,inflorescence,insertion,interjected,interpetalar,leaflet,length,marking,na,needle-like,number,odour,orientation,paired,pattern,pendent,perfect,placement,point,position,present,prickle,pseudostipule,rhizome,scale,seed,shape,size,smell,spot,staman,stone,structure,surface,symmetry,sympodial,system,tissue,trichome,tuber,type,vegetative,white,width,xylopodia	0.1–1.4,0.5,0.5-1.1–3.2,0.5–1,0.6–1.3,1.3–1.8,1.6–2.1,1.8–2,1.8–2.8,1–1.7-2.1,22,24.6–26.3,2–9-11,3.1–3.5-4.2,3–3.2-4,3–4-5,5-merous,5–7-9,7–11,9,acuminate,acute,adherent,apex,appressed,aromatic,base,berry,branch,broadly,brown,brownish,changing,cm,cyme,dark,di-foliate,dull,eglandular,elliptic,entire,equal,erect,flowered,forked,glabrescent,globose,green,herb,light,long,many,mature,mm,obovate,occasionally,ovate,pentagonal,persistent,petiolate,predominantly,purple,rarely,simple,soft,sparse,spreading,stage,stellate,sub-glabrous,tinged,triangular,truncate,yellow,yellowish,±,±1,µm,×	geminate,na,pendent,perfect,present,white
514	wfo-0001032206	success	213	120	75	70	143	50	54	21	1-2,accrescent,acute,andromonoecious,anther,apex,articulated,base,berry,branched,calyx,chartaceous,cm,connivent,covering,cream,cuneate,dark,diameter,equal,erect,filament,flattened-reniform,flower,fruit,fruiting,glabrescent,green,leaf,length,lobed,long-styled,margin,marking,mature,maturity,mauve,midvein,mm,moderately,obtuse,orange-brown,pale,pedicel,peduncle,pendent,petiole,plant,poricidal,prickle,purple,rarely,reflexed,short-styled,shrub,sometimes,spherical,stellate,stellate-pubescent,stem,straight,surface,tapering,tip,truncate,unit,usually,white,yellow,young	..,.2,.5,0,0-5,0.2,0.2–0.4,0.2–0.5-0.8,0.5–1,0.8–1.2,00–200,0–20,0–30,0–5,1.1–1.2,1.2–2.2,1.5–2,1.5–2.5,1/3,1/4–1/2,1/4–1/3,1/6,10–80,11–22,1–2,1–2.3,1–3,1–4,2.5–3.3,2.7–3.5,2–2.5,2–3,2–8,3.5–9,30–80,3–4,4.5–5.8,4–6,5-merous,5–15,5–20,5–6,5–8,5–9,6–10,6–15-20,6–8,7–10,8–20,abaxially,adaxially,alyx,apar,apart,apically,apparently,approximately,armed,bark,blade,bluntly,broad-deltate,brow,clearly,concolorous,curved,deltate,discolorous,distal,distance,drying,eaf,eed,elliptic,extending,flattened,foliaceous,free,functionally,gently,glabrous,green-brown,hermaphroditic,heterostylous,infructescence,lateral,lengt,lobe,lobing,long,longer,lowermost,mal,midpoint,nflorescence,often,older,one,open,orolla,ovate,ower,pair,pendulous,per,pericarp,plurifoliat,porrect,portion,primary,ray,scar,secondary,sessile,side,slender,smooth,spaced,sparsely,spreading,stalk,stalked,stout,style,tamen,tertiary,time,toward,trichome,tube,uit,unarmed,ung,variously,vary,vein,venation,visible,weakly,wide,woody,yellow-orange,ympodial	/,0.5-1.5,0.8-1.2,1-2.3,1-3,1.2-2.2,1/4-1/2,1/4-1/3,2-2.5,2-3,2.7-3.5,3-4,3.5-9,4.5-5.8,5-15,5-20,5-6,6-15-20,8-20,articulation,branching,breeding,cell,colour,connective,corolla,form,growth,hair,height,heteromorphism,inflorescence,insertion,modification,na,plurifoliate,pore,position,seed,shape,spot,staman,stone,structure,symmetry,sympodial,system,texture,type,width	1-2,accrescent,acute,andromonoecious,articulated,base,berry,branched,chartaceous,cm,connivent,covering,cream,cuneate,dark,equal,erect,flattened-reniform,fruit,glabrescent,green,length,lobed,long-styled,marking,mature,maturity,mauve,midvein,mm,moderately,obtuse,orange-brown,pale,pendent,poricidal,purple,rarely,reflexed,short-styled,shrub,sometimes,spherical,stellate,stellate-pubescent,straight,surface,tapering,tip,truncate,usually,white,yellow,young	/,0.5-1.5,0.8-1.2,1-2.3,1-3,1.2-2.2,1/4-1/2,1/4-1/3,2-2.5,2-3,2.7-3.5,3-4,3.5-9,4.5-5.8,5-15,5-20,5-6,6-15-20,8-20,na,plurifoliate
515	wfo-0001032209	success	252	131	80	89	163	42	76	4	1-2,1-2-celled,1-6,1.5-2,2-3-lobed,2-5,5-8,acute,along,anther,anthesi,apex,articulated,base,berry,blue,branched,calyx,cell,chartaceous,cm,colour,cordate,coriaceous,corolla,deeply,dendritic,densely,entire,filament,fruiting,glabrous,globose,growth,hastate,inflorescence,lateral,leaf,length,lengthening,lobed,margin,markedly,metallic,minutely,mixture,mm,nearly,occasionally,often,one,pedicel,perfect,petiole,pinnately,pinnatifid,plurifoliate,pore,poricidal,puberulent,pubescent,purple,red,ripe,sagittate,several,simple,sleeve,slit,small,sometimes,spreading,stellate,stem,stout,tapering,terminal,time,tiny,tip,trichome,truncate,unit,variable,vine,violet,white,woody,x	.5,0.3,0.5,0.5-1,1,1-1.5,1.5,1.5-2.5,1.5-3-9-11,1.5-6,10-13,100,12-16,2,2-3,2.5-6-15-20,2/3,20-30,3-7,4,4-20-30+,5-merou,6-8,absent,adaxial,ag,alyx,apart,apiculae,apparently,appearing,arching,ark,axi,basal,berr,bilobed,branch,broadly,brown,bu,canopy,capitate,cast,climbing,conical,connivent,conspicuously,cucullat,dark,deltate,denser,diameter,distally,distinct,dried,eaf,early,ecuador,eed,ellipsoid,elliptic,enlarged,equal,erect,especially,evenly,exerted,finely,flattened-reniform,fleshy,flower,flowering,free,geminat,giving,glabrescen,groove,hairy,hanging,held,hollow,ilament,keeled,lamina,large,leathery,leaving,less,like,lobe,long,longer,longest,lower,material,mean,mere,middle,midrib,midvein,minute,narrowly,near,new,nflorescence,nipple,older,orolla,ovate,pair,papillae,papillat,papillate,part,particularly,peduncle,peg,pentagonal,per,pericarp,planar,pointed,portion,primary,probably,pubescence,reddish,rest,rhachi,rim,ruit,scar,shiny,somewhat,spaced,sparser,stigma,style,surface,tem,testa,testal,thin,third,tightly,tube,twinin,twining,ud,unequal,uniseriate,upper,usually,vary,vein,w,wall,weight,widest,within,yellow,ympodial	5-merous,age,articulation,bract,branching,breeding,connective,form,fruit,geminate,hair,heteromorphism,insertion,interjected,interpetalar,leaflet,marking,modification,na,odour,orientation,paired,pattern,placement,position,prickle,pseudostipule,rhizome,scale,shape,spot,staman,stone,structure,symmetry,sympodial,system,texture,tissue,tuber,type,xylopodia	1-2,1-2-celled,1-6,1.5-2,2-3-lobed,2-5,5-8,acute,along,anther,anthesi,articulated,base,berry,blue,branched,chartaceous,cm,colour,cordate,coriaceous,deeply,dendritic,densely,entire,glabrous,globose,hastate,lateral,length,lengthening,lobed,markedly,metallic,minutely,mixture,mm,nearly,occasionally,often,one,perfect,pinnately,pinnatifid,plurifoliate,pore,poricidal,puberulent,pubescent,purple,red,ripe,sagittate,several,simple,sleeve,slit,small,sometimes,spreading,stellate,stem,stout,tapering,terminal,time,tiny,tip,trichome,truncate,variable,vine,violet,white,woody,x	5-merous,age,geminate,na
516	wfo-0001032232	success	137	137	59	76	61	61	55	4	.5,0.1,0.5-1,0.6-3,0.8-1,1-3,1.8-2,18.8-27.5,2,2-2.6,4.8-7.3,5-6,anther,anthesi,apex,attenuate,bark,base,clavate,closely,cm,corolla,cup-shaped,deflexed,elliptic,evenly,filament,filiform,flower,fruiting,glabrous,globose,green,greenish-brown,lateral,leaf,lenticellate,less,light,lightly,long-acuminate,lower,main,margin,minutely,mm,narrowly,opposite,ovary,ovoid-reniform,packed,pair,pale,papillose,pedicel,petiole,pitted,pore,poricidal,revolute,scar,shaped,shrub,slightly,stem,stigma,style,subshrub,surface,tear-drop,tip,translucent,undulate,unit,vein,winged	0.25,0.5,20-100-flowered,3/4,?,abruptly,age,ba,becoming,berry,calyx,dark-papillose,decurrent,dia,distally,eaf,edicel,eed,erect,erose,exfoliatin,free,immature,irregular,lobe,lobed,long,middle,midrib,minute,nflorescence,node,occasionally,onto,overlappin,paler,papillo,portion,prominent,raised,reflexed,rounded,ruit,short-styled,simple,somewhat,sparsely,straight,tall,ti,tub,tube,ud,umbonate,unifoliat,way,wide,widening,widest,woody,ympodial	20-100,arrangement,articulation,bract,branching,breeding,broad-based,bud,cell,colour,connective,diameter,form,fruit,growth,hair,height,heteromorphism,inflorescence,insertion,interjected,interpetalar,leaflet,length,marking,modification,na,needle-like,number,odour,orientation,packing,pattern,placement,plant,position,prickle,pseudostipule,rhizome,scale,seed,shape,smell,spot,staman,stone,structure,symmetry,sympodial,system,texture,tissue,trichome,tuber,type,unifoliate,vegetative,width,winging,xylopodia,zygomorphy	.5,0.1,0.5-1,0.6-3,0.8-1,1-3,1.8-2,18.8-27.5,2,2-2.6,4.8-7.3,5-6,attenuate,clavate,closely,cm,cup-shaped,deflexed,elliptic,evenly,filiform,glabrous,globose,green,greenish-brown,lateral,leaf,lenticellate,less,light,lightly,long-acuminate,main,minutely,mm,narrowly,opposite,ovoid-reniform,packed,pair,pale,papillose,pitted,poricidal,revolute,shaped,shrub,slightly,subshrub,tear-drop,tip,translucent,undulate,vein,winged	20-100,na,unifoliate,zygomorphy
517	wfo-0001032233	success	160	166	81	99	61	67	77	4	0-2,1-1.5,1-2,1-3,1.5-2.5,10-15,157,2-15,2-3,2-4,2-5.5,2-6,2.5-4,25-40,3-15,3-4,3-4.5,3-5,3.5-4,4-5,4-7,5-16,5-6,8-12,absent,adaxial,adaxially,almost,apex,base,branched,calyx,cell,chartaceous,cm,connective,cordate,coriaceous,dark,densely,diameter,directed,ellipsoidal,entire,flattened,fleischmann,fruit,glabrescent,glabrous,glandular-puberulent,globose,green,laterally,lobe,longitudinal,lower,margin,mm,moderately,narrowly,oblong,obtuse,orange,ovate,ovoid,pedicel,pedicellar,peduncle,petiole,pore,present,puberulent,pubescent,purple,radiu,remnant,shallowly,simple,slightly,somewhat,sparsely,stellate,stigma,stone,stripe,style,subcoriaceous,subpeltiform,tree,triangular,truncate,tube,unbranched,unit,white,x,yellow,yellow-green,yellow-orange	0.3-2,20-100+,4-18,4-foliat,6-25,abaxially,absen,acuminate,acute,aggregate,apart,ape,articulated,axe,basal,bent,beyond,biglandula,blade,brow,connivent,convex,cylindrical,dilated,distally,eaf,eed,equal,especially,exceeding,exserted,fleshy,flower,glabrate,leaving,lon,long,nflorescence,nther,orolla,perfect,projection,puberulen,rachise,ruit,shorter,small,spaced,stamen,tal,tem,thecae,time,tip,tomento,toward,ud,vary,vein,wide,ympodial	4-foliate,abaxial,anther,articulation,bract,branching,breeding,broad-based,brown,bud,colour,corolla,exsertion,filament,form,fruiting,growth,hair,height,heteromorphism,inflorescence,insertion,interjected,interpetalar,leaf,leaflet,length,marking,mature,modification,na,needle-like,odour,orientation,ovary,paired,pattern,placement,plant,position,prickle,pseudostipule,rachi,rhizome,scale,seed,shape,size,smell,spot,staman,stem,structure,surface,symmetry,sympodial,system,texture,theca,tissue,tomentose,trichome,tuber,type,vegetative,xylopodia,zygomorphy	0-2,1-1.5,1-2,1-3,1.5-2.5,10-15,157,2-15,2-3,2-4,2-5.5,2-6,2.5-4,25-40,3-15,3-4,3-4.5,3-5,3.5-4,4-5,4-7,5-16,5-6,8-12,absent,adaxially,almost,base,branched,chartaceous,cm,cordate,coriaceous,dark,densely,directed,ellipsoidal,entire,flattened,fleischmann,glabrescent,glabrous,glandular-puberulent,globose,green,laterally,longitudinal,mm,moderately,narrowly,oblong,obtuse,orange,ovate,ovoid,present,puberulent,pubescent,purple,shallowly,simple,slightly,somewhat,sparsely,stellate,stripe,subcoriaceous,subpeltiform,tree,triangular,truncate,unbranched,white,x,yellow,yellow-green,yellow-orange	4-foliate,brown,na,tomentose
518	wfo-0001032259	success	201	112	65	88	113	24	65	0	-4,.5,0-20,0-4,0.45-0.6,0.5-0.8,0.9-1.2,1-2,1-2.5,1.5-4.5,2-4,20-60,4,4-6,abaxial,acute,adaxial,almost,anther,apart,apex,articulated,base,berry,brown,calyx,chartaceous,cm,conical,connivent,cordate,cuneate,dark,densely,diameter,difoliate,dull,elongating,equal,evenly,filament,flattened,flattened-reniform,flower,free,fruit,fruiting,geminate,glabrous,green,lateral,leaf,length,lobed,long,margin,maturity,mauve,mm,orange,orange-brown,ovate,pedicel,per,petiole,poricidal,portion,prickle,recurved,red,scar,shrub,side,simple,slender,spherical,stellate-pubescent,straight,style,surface,tapering,terminal,tip,tube,unit,white,yellow,young	/3,/4,0-10,0-2,0-5,0.1-0.2,0.1-0.3,0.15-0.3,0.5-1.5,0.7-1.1,0.8-1.3,1-1.8,1/2,1/3,1/4-1/3,1/6-1/5,10-30,15-40,2-2.5,2-5,2.2-3,3-4,3/,4-5,4-9,5,5-30,5-merous,5.5-8,7-16,7-8,9-22,abaxially,acut,alyx,apar,apically,apparently,bark,becoming,blade,branched,broad-deltate,brownish,deltate,discolorous,distance,drying,eaf,eed,erect,extending,fully,glabrescent,gland,green-brow,hair,infructescence,lobe,longer,lower,mature,midpoint,midvein,minute,moderately,nflorescence,older,one,open,opening,orolla,oung,pair,peduncle,pendulous,perfec,pericarp,porrect,prickl,prickly,primary,pubescent,ray,reduced,rounded,ruit,sessile,shorter,smooth,sometimes,spaced,sparsely,spreading,stellate,stem,strongly,tamen,terete,tertiary,time,toward,trichome,unarmed,vary,vein,venation,visible,way,wide,woody,yellow-green,ympodial	articulation,branching,colour,corolla,form,growth,height,heteromorphism,inflorescence,insertion,number,ovary,placement,plant,position,seed,shape,spacing,staman,structure,sympodial,texture,type,width	-4,.5,0-20,0-4,0.45-0.6,0.5-0.8,0.9-1.2,1-2,1-2.5,1.5-4.5,2-4,20-60,4,4-6,acute,almost,apart,articulated,base,berry,brown,chartaceous,cm,conical,connivent,cordate,cuneate,dark,densely,difoliate,dull,elongating,equal,evenly,flattened,flattened-reniform,geminate,glabrous,green,lateral,lobed,long,maturity,mauve,mm,orange,orange-brown,ovate,per,poricidal,recurved,red,shrub,side,simple,slender,spherical,stellate-pubescent,straight,tapering,terminal,tip,white,yellow,young	
519	wfo-0001032260	success	210	131	70	88	122	43	69	1	-3,/5,0-10-30,0-20,0.2-0.5,0.5-2,0.7-1.5,0.8-1.1,1.5-4,3-10,3-8,6-10,abaxial,abaxially,acuminate,acute,adaxial,anther,apex,articulated,base,berry,branched,calyx,chartaceous,cm,connivent,cuneate,curved,deltate,densely,diameter,discolorous,drying,dull,elliptic,equal,erect,filament,flattened,flattened-reniform,flower,fruit,fruiting,glaucous,green-brown,lateral,leaf,length,lobed,long,lower,margin,maturity,mauve,mm,orange-brown,ovate,pale,pedicel,per,petiole,poricidal,porrect,prickle,purple,red,reflexed,rounded,shallowly,shrub,simple,spherical,stalked,stellate,stellate-pubescent,stem,strongly,subentire,surface,tapering,terminal,tip,trichome,way,wide,yellow,yellow-green	-10,-8,.1,0-0.5,0-10,0-5,0-5-20,0-8,0.1,0.1-0.3,0.1-0.4,0.15-0.3,0.4,0.5-0.8,0.5-5,0.6-0.8-1.5,0.7,1-1.7,1-3,1-5,1-6,1.2-1.7,1/2,1/3,1/3-1/2,1/3-1/5,2,2-20,2-4,2-5,2.5,2.5-3,2.5-3.5,3-5,3-9,4-5-merous,5-6-8,7-15,acuminat,alyx,apar,apart,apically,apparently,bark,blade,broad-deltate,cell,difoliate,distance,eaf,eed,elongating,extending,eye,free,geminat,glabrescent,glabrou,glabrous,gland,globular,gray-brow,infructescence,lobe,lon,long-styled,longer,mature,midpoint,midvein,moderately,naked,narrow-ovate,nflorescence,older,one,open,orolla,oung,outline,pair,peduncle,pendulous,perfec,pericarp,pit,portion,prickl,prickly,primary,pubescent,raised,ray,reduced,ruit,scandent,scar,sessile,shorter,side,slender,small,smooth,spaced,sparsely,spreading,stalk,style,tamen,terete,tertiary,time,tube,unit,variously,vary,vein,venation,visible,woody,ympodial	articulation,bract,branching,breeding,broad-based,colour,connective,corolla,form,growth,hair,heteromorphism,inflorescence,insertion,interjected,interpetalar,leaflet,marking,modification,na,needle-like,number,orientation,pattern,placement,pore,position,pseudostipule,rhizome,scale,seed,shape,size,spot,staman,symmetry,system,texture,tissue,tuber,type,width,xylopodia	-3,/5,0-10-30,0-20,0.2-0.5,0.5-2,0.7-1.5,0.8-1.1,1.5-4,3-10,3-8,6-10,abaxially,acuminate,acute,articulated,base,berry,branched,chartaceous,cm,connivent,cuneate,curved,deltate,densely,diameter,discolorous,drying,dull,elliptic,equal,erect,flattened,flattened-reniform,glaucous,green-brown,lateral,lobed,long,maturity,mauve,mm,orange-brown,ovate,pale,poricidal,porrect,purple,red,reflexed,rounded,shallowly,shrub,simple,spherical,stalked,stellate,stellate-pubescent,stem,strongly,subentire,tapering,terminal,tip,way,wide,yellow,yellow-green	na
520	wfo-0001032264	success	183	157	79	101	82	56	71	8	0.25-0.5,0.25-0.75,0.5-1,0.6-2.2,0.8-10,1-1.5,1.2-2,1.5-1.8,1.8-3,3,3-15,4.5-5,acute,anther,anthesi,apex,apiculate,bark,base,branched,broadly,bud,calyx,cell,cell-layer,cm,corolla,cup-like,deciduous,difoliate,elliptic,epidermal,filament,flattened-reniform,fleshy,flower,fruiting,glabrous,globose,green,hair,incrassate,inflorescence,layer,leaf,lobed,lower,margin,minutely,mm,multiseriate,narrowly,nearly,occasionally,older,one,opposite,ovary,ovoid,pale,pedicel,peeling,petiole,pitted,plant,pointed,pore,pubescent,red-papillose,reddish,reddish-tan,revolute,scattered,several,shaped,sheet,shrub,simple,size,slender,small-capitate,soon,stem,stigma,style,surface,tapering,tear-drop,thick,time,tip,transversely,tree,trichome,tube,uniseriate,unit,white,x,yellowish-brown,young	.2,.5,0.8-4,10-22,2-50-flowered,2-6,3-9,5-9,6-17,acuminate,along,apar,appearing,ba,berry,bullate,closely,curling,deflexed,densely,dia,differing,dry,eaf,edicel,eed,exserted,free,geminat,gnarled,greyi,habitat,lamina,large,larger,lateral,like,live,lobe,lon,long,main,major,material,middle,minor,minute,nflorescence,often,overlapping,pair,papillo,papillose,parallel,planar,poricidal,portion,primarily,prominent,quite,raised,rounded-deltoid,ruit,scar,sheltered,short,small-celled,somewhat,spaced,sparsely,straight,tall,trunk,ud,upper,vein,weak,whitish,wide,widest,woody,ympodial	0.5,1,2-50,4,4-8,articulation,bract,branching,breeding,broad-based,colour,connective,deciduousnes,diameter,form,fruit,geminate,greyish,growth,height,heteromorphism,insertion,interjected,interpetalar,leaflet,length,marking,modification,na,needle-like,number,odour,orientation,pattern,placement,position,prickle,pseudostipule,rhizome,scale,seed,shape,smell,spot,staman,stone,structure,symmetry,sympodial,system,texture,tissue,tuber,type,vegetative,xylopodia	0.25-0.5,0.25-0.75,0.5-1,0.6-2.2,0.8-10,1-1.5,1.2-2,1.5-1.8,1.8-3,3,3-15,4.5-5,acute,apiculate,base,branched,broadly,calyx,cell-layer,cm,cup-like,deciduous,difoliate,elliptic,flattened-reniform,fleshy,glabrous,globose,green,incrassate,leaf,lobed,minutely,mm,multiseriate,narrowly,nearly,occasionally,one,opposite,ovoid,pale,peeling,pitted,pointed,pubescent,red-papillose,reddish,reddish-tan,revolute,scattered,several,shaped,sheet,shrub,simple,slender,small-capitate,soon,tapering,tear-drop,thick,time,transversely,tree,trichome,tube,uniseriate,white,x,yellowish-brown	0.5,1,2-50,4,4-8,geminate,greyish,na
521	wfo-0001032274	success	192	113	47	60	132	53	40	7	0.5-1,1-1.5,3-4,3/4,acute,anther,apex,arching,base,berry,calyx,cell,connivent,corolla,ellipsoid,entire,filament,filiform,fleshy,fruiting,glabrous,globose,growth,inflorescence,leaf,lengthening,lobed,loosely,lower,margin,markedly,membranous,mm,occasionally,once-branched,pedicel,perfect,petiole,plurifoliate,pore,poricidal,purple,red,shape,shiny,shrub,simple,slit,somewhat,stellate,stem,surface,terminal,tip,trichome,truncate,unit,way,white,x	.5,0,0.15-0.2,0.5,0.5-0.7,0.5-1.5,0.7-1.8,0.9-1,1-1.2,1-3,1.5-2,2,2-3.5,2-7,3-10,3-5,3-6,5-7,5-merou,<,acuminate,ag,alyx,anthesi,apiculate,apparently,appearance,ark,articulated,axillary,ba,basal,borne,branch,brown,capitate,clustered,cm,conical,deltate,dendritic,densely,diameter,distal,eaf,eed,elliptic,exserted,flattened-reniform,flower,free,geminat,glabrou,green,grey,group,highly,ilament,irregular,lanceolate,lax,less,like,lobe,long,minute,minutely,new,nflorescence,nodding,non-reproductive,obtusely,often,older,one,orolla,pair,pale,papillo,peduncle,peg,pendan,per,pericarp,pitted,platfor,platform,portion,primary,puberulent,pubescent,quadrate,reddish,reflexed,reproductive,ridge,ridged,ripe,rounded,ruit,scar,shoot,short,size,sleeve,small,sometimes,sparsely,square,stigma,strongly,style,suckering,tem,testal,thin,tinged,tube,twinin,two,ud,uniseriate,upper,usually,variable,vary,vein,violet,visible,woody,yellow,ympodial	5-merous,age,appressed,articulation,bract,branching,breeding,broad-based,colour,connective,form,fruit,hair,heteromorphism,inflated,insertion,interjected,interpetalar,leaflet,length,marking,mature,modification,na,needle-like,none,odour,orientation,paired,pattern,placement,position,present,prickle,pseudostipule,rhizome,scale,smell,specified,spot,staman,stone,structure,symmetry,sympodial,system,texture,tissue,tuber,type,vegetative,xylopodia,zygomorphy	0.5-1,1-1.5,3-4,3/4,acute,arching,base,berry,connivent,ellipsoid,entire,filiform,fleshy,glabrous,globose,lengthening,lobed,loosely,markedly,membranous,mm,occasionally,once-branched,perfect,plurifoliate,poricidal,purple,red,shiny,shrub,simple,slit,somewhat,stellate,terminal,tip,truncate,way,white,x	5-merous,age,na,none,present,specified,zygomorphy
522	wfo-0001032276	invalid_json_followup	152	120	NA	99	53	21	NA	NA	-,.25,.5,0.25-1.5,0.3-1,0.5-0.75,0.5-1,1,1-1.5,1-2,1.8-2,2-2.5,2.5-4,3-3.5,3-6-flowered,5-7,9-18,acute,along,anther,anthesi,apex,attenuate,base,beneath,blade,broadly,brown,calyx,cm,corolla,cup-shaped,dark,decurrent,deltoid,dia,dry,elliptic,filament,filiform,free,fruiting,glabrous,globose,green,lamina,leaf,like,lobe,lobed,long,long-pubescent,material,minute,minutely,mm,narrowly,nearly,occasionally,onto,opposite,ovary,ovoid-reniform,pale,papillose,pedicel,perhaps,petiole,pitted,plant,pore,poricidal,portion,prominent,pubescent,reflexed,rest,shaped,short,shrub,simple,slender,sparsely,stigma,strongly,style,surface,tapering,tear-drop,tip,triangular,trichome,tube,uniseriate,vein,white,winged,x,yellow	0.8-1,7-8,apart,ba,bark,capitat,converging,curly-tipped,deflexed,densely,eaf,edicel,eed,ellipsoid,evenly,except,exserted,geminate,greyish-gree,later,lateral,lower,main,margin,middle,nflorescence,node,non-reproductive,obovoid,older,pair,raise,raised,remaining,ruit,scar,slightly,somewhat,soon,spaced,stem,straight,straw-colored,tall,tub,ud,unifoliate,unit,widely,widest,woody,ympodial,young	8,capitate,characteristic,colour,decurren,diameter,flower,form,fruit,growth,height,inflorescence,length,number,position,seed,shape,size,texture,type,value	NA	NA
523	wfo-0001032277	success	163	106	41	56	107	50	38	3	.5,0.8-3,3-3.5,acute,anther,apex,base,berry,branched,bright,calyx,cm,coriaceous,corolla,cup-shaped,elliptic,filament,fruit,fruiting,globose,green,immature,inflorescence,internodal,lax,leaf,long,lower,margin,mature,mm,number,opposite,pedicel,petiole,pore,poricidal,revolute,ripe,round,shrub,simple,slender,small,spicy-fragrant,stem,surface,tip,translucent,trichome,uniseriate,unit,varying,virgately,white,yellow	0.1-0.5,0.2-0.6,0.75-1,1-1.1,1-1.2,1-1.5,1-2,1-5,1.5-1.8,1/2,10-14,2-2.5,2-4,2-6-flowered,3-9,5-6,8-9,along,anthesi,apiculate,appear,appearing,area,auriculate,ba,bark,beneath,blade,blunt,closely,deltoid,densely,dia,drooping,dry,eaf,edicel,eed,ellipsoid,erect,exserted,flattened-reniform,free,geminat,glabrous,gre,impressed,incrassate,indentation,lateral,like,lobe,lobed,main,middle,minutely,nflorescence,obscured,occasionally,older,ovary,overlapping,pair,pale,paler,papillae,papillose,partially,pitted,portion,prominent,puberulent,pubescenc,pubescent,raised,reddish,remaining,rest,rounded,ruit,scar,slende,spaced,sparsely,specimen,stigma,straight,strict,strongly,styl,style,tall,tapering,truncate,trunk,tub,tube,two,ud,vein,way,widest,woody,x,yellowish-tan,ympodial,young	appressed,articulation,bract,branching,breeding,broad-based,cell,colour,connective,form,geminate,growth,hair,heteromorphism,inflated,insertion,interjected,interpetalar,leaflet,length,marking,modification,na,needle-like,odour,orientation,paired,pattern,placement,position,prickle,pseudostipule,rhizome,scale,shape,smell,spot,staman,stellate,stone,structure,symmetry,sympodial,system,texture,tissue,tuber,type,vegetative,xylopodia	.5,0.8-3,3-3.5,acute,berry,branched,bright,cm,coriaceous,cup-shaped,elliptic,globose,green,immature,internodal,lax,leaf,long,mm,number,opposite,poricidal,revolute,ripe,round,shrub,simple,slender,small,spicy-fragrant,tip,translucent,trichome,uniseriate,varying,virgately,white,yellow	geminate,na,stellate
524	wfo-0001032304	success	249	132	70	80	169	52	67	3	/20,0.5-4.5,0.9-1.3,1.1-2,1/5,2-5,3.2-3.8,accrescent,adaxially,anther,apex,apical-lateral,apparently,articulated,axillary,base,becoming,berry,blade,blunt-tipped,branched,calyx,cm,continued,corolla,dehiscing,due,entire,extend,filament,fleshy,fruit,fruiting,glabrescent,greenish,growth,hair,introrse,large,lateral,leaf,length,long-attenuate,longitudinal,lower,margin,mm,oblong,pale,pedicel,perfect,petiole,plant,plurifoliate,pore,present,probably,pseudo-terminal,ripe,rotate-stellate,scabridulous,short-,shrub,simple,slit,small,somewhat,stellate-tomentose,stem,subglobose,time,tree,unit,usually,velutinous,violet,white,x,yellow,young	-3,.6-1.2,.9-1.4,0-120,0.2-0.3,0.3-1.5,0.5-3,1,1-3.5,1.2-2.3,1.2-3,1.3-2.1,1.5-3.2,1.6-1.9,1.8-4,1/2,1/3-1/2,1/8,10,18,2-4,2-4.2,2.5-19.5,2/3-3/4,21,3-10,3-15,3-20,3-4.5,3-6,3.2-5.5,4-7.5,44,5-6,5.5-9,7-27,7.5-12,9-13,abaxially,acuminate,acute,ag,along,anthesi,apart,appressed-tomentose,ascending,axe,ba,bark,blackish,branch,broadly,brown,brownish,bud,campanulate,capitat,chartaceous,closely,conical,dark,decurrent,deltoid,dendritic,dendritic-echinoi,dendritic-echinoid,densely,diameter,directed,distal,eaf,echinoi,echinoid,elliptic,especially,exserted,few-,few-rayed,flower,free,glabrescen,glabrous,granular-tomentose,green,high,honeycombed,inserted,juvenile,least,lobe,lobed,long,long-,long-stalked,m.,main,many,many-rayed,midvein,mixed,mostly,multangulat,multangulate,nflorescence,obscured,obtuse,occasionally,often,older,opaque,orbicular,orolla,ovat,ovate,ovate-lanceolate,overlapping,partly,peduncle,porrect-stellate,pubescent,rachi,rarely,rather,ray,relatively,reniform,reticulate-punctate,ruit,runk,seed,sessile,short,short-stalked,side,spaced,sparingly,spreading,stamen,stigma,strongly,style,suborbicular,sulcate,suture,tamen,terete,testa,thick,thick-stalked,thin,thin-,thin-stalked,tomentose,tomentu,touching,toward,triangular-ovate,tube,unarme,unarmed,vary,vein,way,whitish,wide,within,yellowish,ympodial	age,appressed,articulation,bract,branching,breeding,broad-based,cell,colour,connective,form,heteromorphism,inflated,inflorescence,insertion,interjected,interpetalar,leaflet,marking,mature,modification,na,needle-like,odour,orientation,paired,pattern,placement,position,prickle,pseudostipule,rhizome,scale,shape,smell,spot,staman,stellate,stone,structure,surface,symmetry,sympodial,system,texture,tissue,trichome,tuber,type,vegetative,xylopodia,zygomorphy	/20,0.5-4.5,0.9-1.3,1.1-2,1/5,2-5,3.2-3.8,accrescent,adaxially,apical-lateral,apparently,articulated,axillary,base,becoming,berry,blade,blunt-tipped,branched,cm,continued,dehiscing,due,entire,extend,fleshy,glabrescent,greenish,growth,introrse,large,lateral,leaf,length,long-attenuate,longitudinal,mm,oblong,pale,perfect,plant,plurifoliate,pore,present,probably,pseudo-terminal,ripe,rotate-stellate,scabridulous,short-,shrub,simple,slit,small,somewhat,stellate-tomentose,stem,subglobose,time,tree,usually,velutinous,violet,white,x,yellow,young	age,na,stellate
525	wfo-0001032307	success	153	116	82	97	56	19	78	4	.5,/3,0.2-0.5,0.4-1.3,1-2,1.5-5,10-20,2-5,2.5-12,2.5-3,2.5-3.5,3.5-4,30,4-8,5-12,7-18,acute,anther,anthesi,apex,bark,base,branch,branched,calyx,capitate,cm,corolla,dark,dendritic,densely,dia,ellipsoid,elliptic,elongate,erect,exserted,filament,flattened-reniform,fleshy,fruiting,glabrate,glabrous,globose,green,growth,incrassate,inflorescence,later,lateral,leaf,like,lobed,long,main,many,margin,minute,minutely,mm,ovary,pair,pale,papillae,pedicel,petiole,plant,pore,prominent,pubescent,reddish-brown,rest,scar,shaped,shrub,small,spaced,sparsely,stem,stigma,stout,strongly,style,tan,tear-drop,terminal,thick,time,tree,tree-like,trichome,truncate,tube,unevenly,vein,way,white	1-1.5,1.5-2,5-25-flowered,?,abaxial,adaxial,along,apar,berry,blade,body,brow,campanulate,christmas-tree-like,congested,deltate,eaf,edicel,eed,either,flat,free,immature,inflorescenc,lobe,lon,loose,lower,middle,new,nflorescence,older,papillo,petal,pitted,planar,plurifoliat,poricidal,portion,reddish,ruit,surface,tall,thickened,tip,tub,type,ud,upper,variable,wide,widest,within,woody,ympodia,young	apart,branching,brown,bud,colour,dense,diameter,exsertion,form,fruit,height,length,papillose,position,pubescence,seed,shape,venation,width	.5,/3,0.2-0.5,0.4-1.3,1-2,1.5-5,10-20,2-5,2.5-12,2.5-3,2.5-3.5,3.5-4,30,4-8,5-12,7-18,acute,base,branched,calyx,capitate,cm,dark,dendritic,densely,dia,ellipsoid,elliptic,elongate,erect,exserted,flattened-reniform,fleshy,glabrate,glabrous,globose,green,incrassate,inflorescence,later,lateral,like,lobed,long,main,many,margin,minute,minutely,mm,pair,pale,papillae,prominent,pubescent,reddish-brown,rest,shaped,shrub,small,spaced,sparsely,stout,strongly,tan,tear-drop,terminal,thick,time,tree,tree-like,trichome,truncate,tube,unevenly,vein,way,white	apart,brown,dense,papillose
526	wfo-0001032308	success	190	136	100	117	73	19	96	4	1-10,1-2,1.5-2.5,1.8-2.5,1.9-3,2-6,4-7,4-8,6,8-9,abaxially,absent,acumen,acute,adaxially,along,anther,apart,apex,axillary,base,broadly,brownish,bud,cell,ciliate,clavate,cm,condition,connivent,cordate,corolla,deep,diameter,digestion,distal,dorsally,dot,drying,edge,enzyme,especially,filament,flat,flower,folded,forked,fresh,fruit,generally,glabrous,globose,green,greenish,hair,half,homostylous,honeycomb-shaped,interjected,invested,irregular,lanceolate,lateral,leaflet,lengthening,like,long,margin,medium,midrib,minute,minutely,mm,narrowly,non-glandular,odd-pinnate,often,orbicular,ovate,ovoid,pedicel,peduncle,pentagonal,petiole,petiolulate,plant,pore,poricidal,puberulent,pubescent,pure,removed,ripe,rounded,scattered,seed,sessile,shape,short,slightly,slit,stigma,straight,style,substellate,subtending,terminal,testal,tip,trichome,tube,typically,wall,white,whitish,x,yellow	0-3,0.2-2.1,0.3-5,0.7-1,0.7-1.2,12-16,2,2-3,2-4,3-10,3-6,3.8-5,4.8-7.7,5-7,5-merou,6-11,ag,alyx,apparently,articulated,axe,berry,blade,capitat,chartaceous,covering,cuneate,eaf,eed,elliptic,exceeding,geminat,glabrou,greatly,green-white,hair-like,hal,larger,leave,living,lobe,lobed,lower,make,membranous,much,mucilaginous,nflorescence,obtuse,orolla,pair,perfect,petiolule,plurifoliate,ruit,seudostipule,spaced,specimen,stamen,ste,stem,sympodial,tamen,thick,throughout,tri-,truncate,unit,usually,vary,varying,wet,wide	age,arrangement,articulation,branching,capitate,colour,form,growth,herb,inflorescence,leaf,length,ovary,position,pseudostipule,spacing,staman,symmetry,texture	1-10,1-2,1.5-2.5,1.8-2.5,1.9-3,2-6,4-7,4-8,6,8-9,abaxially,absent,acute,adaxially,along,apart,axillary,broadly,brownish,bud,ciliate,clavate,cm,condition,connivent,cordate,corolla,deep,digestion,distal,dorsally,dot,drying,enzyme,especially,flat,folded,forked,fresh,generally,glabrous,globose,green,greenish,hair,half,homostylous,honeycomb-shaped,invested,irregular,lanceolate,lateral,lengthening,like,long,margin,medium,midrib,minute,minutely,mm,narrowly,non-glandular,odd-pinnate,often,orbicular,ovate,ovoid,pentagonal,petiolulate,plant,pore,poricidal,puberulent,pubescent,pure,removed,ripe,rounded,scattered,sessile,short,slightly,slit,straight,substellate,subtending,terminal,tip,trichome,typically,wall,white,whitish,x,yellow	age,capitate,herb,leaf
527	wfo-0001032335	success	214	122	61	71	143	51	56	5	acute,anther,anthesi,apex,articulated,attenuate,base,berry,branched,branching,bright,c.,calyx,cell,chartaceous,cm,connivent,corolla,densely,ellipsoidal,entire,filament,fruiting,globose,growth,inflorescence,length,lengthening,lobed,long,loosely,lower,many,margin,membranous,mm,multangulate,nodding,onto,orange,pedicel,peltate,perfect,petiole,plane,plurifoliate,pore,poricidal,porrect-stellate,pubescent,ray,ripe,shrub,simple,slit,small,somewhat,stellate,stem,surface,terminal,time,tip,tree,trichome,unevenly,unit,varying,way,white,–4	.2,.5,0,0.05,0.2,0.2–0.3,0.4,0.5,0.5–1,0.9–1,1.5–2,100,100+,10–12,12–15,15,16,1–1.2,1–1.5,1–3,2.5–3,2–10,2–2.5,2–5,3361,4–14,4–5,4–6-rayed,5-merou,5–6,6–19,6–6.5,7–10,>,abaxial,abaxially,acuminate,adaxial,ag,along,alyx,apar,appearing,ark,axe,beneath,boh,capitate,center,closely,covered,cup-shaped,deltate,diameter,dichasia,discolorous,drying,eaf,eed,elliptic,elongate,equal,erec,evenly,exserted,fide,flattened-reniform,flower,free,fused,glabrous,gold,golden-brow,golden-yellow,gradually,half,ilament,impressed,lamina,less,like,lobe,markedly,midpoint,minute,minutely,moderately,narrowing,narrowly,near,new,nflorescence,older,orolla,pair,pale,papillo,part,peduncle,per,pericarp,persistent,pitted,porrect,portion,primary,pubescence,reddish,reflexed,regularly,ruit,scar,scurfy,sessile,shiny,short,short-stalked,silvery,slightly,sometimes,spaced,sparsely,square,stigma,stout,strongly,stub,style,tal,tem,testal,thin,tube,ud,upper,vary,vein,visible,wide,woody,yellow,ympodial,–stellate	1-3,2.5-3,age,appressed,articulation,bract,breeding,broad-based,colour,connective,dichasial,form,fruit,hair,heteromorphism,inflated,insertion,interjected,interpetalar,leaf,leaflet,marking,mature,modification,na,needle-like,odour,orientation,paired,pattern,placement,position,prickle,pseudostipule,rhizome,scale,shape,smell,spot,staman,stone,structure,symmetry,sympodial,system,texture,tissue,tuber,type,vegetative,xylopodia	acute,anthesi,articulated,attenuate,base,berry,branched,branching,bright,c.,chartaceous,cm,connivent,densely,ellipsoidal,entire,globose,length,lengthening,lobed,long,loosely,many,membranous,mm,multangulate,nodding,onto,orange,peltate,perfect,petiole,plane,plurifoliate,pore,poricidal,porrect-stellate,pubescent,ray,ripe,shrub,simple,slit,small,somewhat,stellate,terminal,time,tip,tree,trichome,unevenly,varying,way,white,–4	1-3,2.5-3,age,dichasial,na
528	wfo-0001032337	success	225	125	97	106	119	19	93	4	0.5-3.5,1-2,1.4-2,2-3.5,2.3-4.8,4-17,4-6,4-9,5-11,8-10,8-17,9-29,abaxially,adaxially,along,anther,berry,blade,brownish,canescent,cell,chartaceous,ciliate,clavate,cm,condition,connivent,corolla,covering,darker,densely,diameter,distal,dorsally,dot,drying,edge,especially,filament,flat,folded,forked,fresh,fruit,generally,glabrous,globose,green,green-white,greenish,hair,hair-like,half,herb,lanceolate,lateral,leaf,leaflet,lengthening,light,like,make,margin,membranous,midrib,minutely,mm,mucilaginous,odd-pinnate,often,ovoid,pentagonal,petiole,plant,plurifoliate,pore,poricidal,puberulent,pubescent,ray,ripe,rotate,scattered,seed,size,slit,sometimes,sparsely,stem,stigma,straight,style,testal,thick,throughout,tip,tri-,unit,usually,violet,violet-purple,wall,wet,white,whitish,x	0,0.4-1.5,1,1-10,1-4,1.2-2.8,1.5,1.6-4,10,2,2-14,2-4,2-4.5,2-7,2.3-11.5,3-4,3-8,3.6-5,4.5-14.5,5-merou,9-21,acumen,acuminate,acute,ag,alyx,apart,apex,apiculate,apparently,articulated,attenuate,axe,axillary,base,basiscopic,borne,broadly,bud,capitat,cordate,cuneate,decurrent,deep,digestion,eaf,eed,elliptic,end,enzyme,erec,exceeding,except,flower,frequently,geminat,glabrou,greatly,homostylous,honeycomb-shaped,interjected,living,lobe,long,lower,middl,mottled,nflorescence,oblique,obtuse,orbicular,orolla,ovate,pair,paired,pedicel,peduncle,perfect,petiolulate,petiolule,proximal,purple,rarely,reduced,removed,rounded,ruit,sessile,seudostipule,short,side,singly,slightly,small,spaced,specimen,stamen,ste,stolo,subequal,subglabrous,subsessile,subtending,tall,tamen,tem,terminal,tertiary,tissue,tube,tuber,typically,unpaired,unwinged,vary,wide,wing,yellow,ympodial	age,arrangement,branching,capitate,colour,form,geminate,growth,heteromorphism,inflorescence,length,na,pseudostipule,shape,staman,stone,structure,sympodial,texture	0.5-3.5,1-2,1.4-2,2-3.5,2.3-4.8,4-17,4-6,4-9,5-11,8-10,8-17,9-29,abaxially,adaxially,along,berry,brownish,canescent,cell,chartaceous,ciliate,clavate,cm,condition,connivent,corolla,covering,darker,densely,distal,dorsally,dot,drying,especially,flat,folded,forked,fresh,generally,glabrous,globose,green,green-white,greenish,hair,hair-like,half,herb,lanceolate,lateral,lengthening,light,like,make,margin,membranous,midrib,minutely,mm,mucilaginous,odd-pinnate,often,ovoid,pentagonal,plant,plurifoliate,pore,poricidal,puberulent,pubescent,ray,ripe,rotate,scattered,seed,slit,sometimes,sparsely,stem,straight,testal,thick,throughout,tip,tri-,usually,violet,violet-purple,wall,wet,white,whitish,x	age,capitate,geminate,na
529	wfo-0001032344	success	157	112	68	83	74	29	63	5	0.2-0.5,1-1.3,1-4,1.5-6,10-29,2-2.8,3-5,3-7,3-8.5,3-9,3.5-6.5,4-11,4-8,5-10,6-15,9.5-21,absent,acute,apical,apically,base,bluish,branched,broadly,calyx,cm,connate,corolla,cuneate,dark,dehiscent,diameter,dichasially,distal,elliptical,filament,flower,globose,green,hair-like,half,herbaceous,interjected,introrse,lateral,leaf,leaflet,lobe,long-attenuate,maturing,medium,mm,oblique,odd-pinnate,often,ovate,ovoid,pedicel,peduncle,perennial,perfect,petiole,plant,poricidally,proximal,puberulent,pubescent,purple,rotate,rotate-pentagonal,scarce,seed,short,size,slit,style,terminal,tuber-bearing,typically,unit,violet,wall,¼	1-3,1.5-4.5,1.6-2.4,2-3,2.2-4,2.8,3-6-foliat,abaxially,abruptly,acumen,acuminate,adaxially,apex,articulate,belo,cell,covering,cyme,decurrent,dichasial,digestion,diminishing,dorsally,dot,eaf,ebracteate,edge,eed,emoval,enzyme,exceeding,forked,generally,globo,green-white,honeycomb,inrolled,layeral,living,lon,long,lower,lunat,make,monochasial,mucilaginous,nflorescence,nther,orolla,pair,pattern,petiolule,plan,reveal,ruit,sessile,seudostipule,smooth,sometimes,specimen,stamen,stigma,straight,tal,tem,testal,thick,throughout,toward,vary,white,wide,yellow,ympodial	3-6-foliate,7,anther,arrangement,articulation,branching,colour,form,fruit,growth,height,inflorescence,length,lunate,na,number,ovary,pore,position,present,pseudostipule,shape,stem,structure,symmetry,sympodial,texture,type,width	0.2-0.5,1-1.3,1-4,1.5-6,10-29,2-2.8,3-5,3-7,3-8.5,3-9,3.5-6.5,4-11,4-8,5-10,6-15,9.5-21,absent,acute,apical,apically,bluish,branched,broadly,cm,connate,cuneate,dark,dehiscent,dichasially,distal,elliptical,globose,green,half,herbaceous,introrse,lobe,long-attenuate,maturing,medium,mm,oblique,odd-pinnate,often,ovate,ovoid,perennial,perfect,plant,poricidally,proximal,puberulent,pubescent,purple,rotate,rotate-pentagonal,scarce,short,slit,tuber-bearing,typically,violet,¼	3-6-foliate,7,lunate,na,present
530	wfo-0001032354	success	171	102	49	62	109	40	44	5	1-2,1-3,250-400,3-4,38/2,40-75,anther,anthesi,apex,aster,axillary,base,becoming,berry,branch,branched,broadly,cell,coarsely,colour,corolla,cuneate,discoidal,filament,fork,glabrous,globose,green,greenish-ivory,hair,leaf,lengthening,lower,maturity,minutely,mm,obovate,occasionally,oval,ovoid,pebble-shaped,pedicel,pinnatisect,pore,poricidal,puberulent,rh,rotate,rugose-reticulate,shape,shrub,simple,slit,somewhat,stellate,stem,stone,surface,tip,trichome,unit,violet	0,0-5,0.3,0.5-1,0.8-1,0.8-1.2,1-10,1-5,10-lobed,2,2-2.5,2.5-3,25,29,4-6,5-10,5-15,acuminate,acute,almost,angular,aspect,axi,bilobed,brown,c.,calyx,campanulate,capitate,cm,creating,cut,decurrent,deep,deeply,dia,distal,eaf,eed,effect,ellipsoid,except,exerted,facetted,fleshy,flower,general,glandular,gre,gree,greyish,halfway,lanceolat,large,lasting,linear,lobe,lobed,midrib,minute,narrow,nflorescence,obovoid,ovary,ovate,pair,pale,pedicellate,peduncle,plurifoliat,pubescent,rather,rounded,ruit,secondary,seedling,several,shoot,single,sinus,size,slightly,small,smaller,smel,soft,sparse,spreading,stigma,straight,strongly,style,tall,tub,ud,uniseriate,unpleasant,usually,variable,vein,wide,wing,within,wooded,woody,x,year,ympodial,young	arrangement,articulation,branching,broad-based,decurren,form,fruit,growth,height,heteromorphism,inflorescence,insertion,length,margin,marking,mature,modification,na,needle-like,none,number,orientation,placement,plant,plurifoliate,position,prickle,pseudostipule,rhizome,seed,spot,staman,structure,symmetry,sympodial,texture,tuber,type,xylopodia,zygomorphy	1-2,1-3,250-400,3-4,38/2,40-75,anthesi,aster,axillary,becoming,berry,branch,branched,broadly,coarsely,cuneate,discoidal,fork,glabrous,globose,green,greenish-ivory,lengthening,maturity,minutely,mm,obovate,occasionally,oval,ovoid,pebble-shaped,pinnatisect,poricidal,puberulent,rh,rotate,rugose-reticulate,shrub,simple,slit,somewhat,stellate,tip,violet	decurren,na,none,plurifoliate,zygomorphy
531	wfo-0001032358	success	216	150	81	104	112	46	78	3	.2,.4,0.2-4,0.5-3,0.7-1,1.5-2,13-20,2-10,2-3,2-4,3-10,3-4,4-8,acute,anther,apart,apex,appearing,base,berry,branched,calyx,capitate,cell,cm,cordate,corolla,curved,densely,entire,expanding,filament,flattened,fruit,fruiting,furcate,geminate,glabrescent,globose,green,growth,heteromorphic,inflorescence,internodal,interpetalar,irregularly,leaf,long,lower,margin,markedly,membranous,minutely,mm,occasionally,orangish,ovate,ovoid,pale,part,pedicel,peduncle,perfect,persistent,petiole,pitted,pore,poricidal,porrect,prickle,prickly,pubescent,purple,red,reniform,ripening,rotate-stellate,scar,sessile,short-stalked,shrub,simple,sinuate,slightly,somewhat,spaced,staman,stellate,stem,stigma,strongly,style,surface,tan,time,tip,trichome,tuberculate,type,unevenly,unisexual,unit,yellowish,zygomorphic	.1,.3,.5,/2,0,0.6-0.8,0.6-1,1-1.6,1-2,1.3-1.7,1.5-2.5,1/4-1/2,12-20,15-40,2,2-5,2.2-7.5,3.5-13,4-4.5,4-7,4-merous,4.5-5,abaxially,abscissio,adaxially,along,another,anthesi,armed,away,bark,basal,based,broad,brown,bulbous,center,cupuliform,diameter,difoliate,dorsal,drying,eaf,eed,equal,erect,exserted,flower,free,frui,glabrescen,glabrous,irregular,lamina,left,lengthening,like,linear,lobe,lobed,longer,lowermost,margined,maturity,midpoint,midrib,midvein,new,nflorescence,nodding,often,older,one,pair,paler,papillat,papillate,peg,per,pericarp,planar,portion,present,primary,ray,rhachi,ruffly,ruit,shiny,short,sinus,slit,small,sometimes,space,sparsely,spreading,thick,thin,three,tub,tube,two,ud,upper,usually,vein,way,whitish,widely,x,ympodial	abaxial,adaxial,articulation,bract,branching,breeding,broad-based,bud,colour,connective,difeoliate,form,hair,heteromorphism,insertion,interjected,leaflet,length,marking,mature,modification,na,needle-like,odour,orientation,paired,pattern,placement,position,pseudostipule,rhizome,scale,seed,shape,smell,spot,stone,structure,symmetry,sympodial,system,texture,tissue,tuber,vegetative,xylopodia	.2,.4,0.2-4,0.5-3,0.7-1,1.5-2,13-20,2-10,2-3,2-4,3-10,3-4,4-8,acute,apart,appearing,berry,branched,capitate,cm,cordate,curved,densely,entire,expanding,flattened,fruit,furcate,geminate,glabrescent,globose,green,heteromorphic,internodal,irregularly,long,lower,markedly,membranous,minutely,mm,occasionally,orangish,ovate,ovoid,pale,part,perfect,persistent,pitted,poricidal,porrect,prickly,pubescent,purple,red,reniform,ripening,rotate-stellate,sessile,short-stalked,shrub,simple,sinuate,slightly,somewhat,spaced,stellate,strongly,tan,time,tip,trichome,tuberculate,unevenly,unisexual,yellowish,zygomorphic	broad-based,difeoliate,na
532	wfo-0001032367	success	231	125	63	73	158	52	58	5	8,abaxially,accrescent,acicular,adaxially,anther,apex,base,berry,broad-based,calyx,cm,cordate,dark,difoliate,directed,filament,free,fruiting,geminate,glabrous,gland-tipped,globose,green,greenish,hair,heterostylous,immature,inflorescence,largest,lateral,leaf,length,light,lobed,long,lower,margin,maturity,membranous,mm,moderately,mottled,nearly,pale,pedicel,petiole,pore,poricidal,prickle,prickly,recurved,shrub,simple,small,somewhat,sparsely,spreading,stellate,stem,straight,surface,tapering,tip,trichome,truncate,unbranched,uniseriate,unit,usually,variable,white,yellow	-3,.2,.4,0-0.3,0.2–0.35,0.4-0.5,0.4–0.5,0.4–0.6,0.4–1,0.5–0.8,0.5–2,0.6,0.6–0.8,0.7-1.1,0.8,0.8–2,1-2,1-2.1,1.2,100-300,1–1.5,1–1.8,2,2-3-celled,2-4,2.2–2.5,2.2–2.8,2.5–3,2–2.5,3-5,3-celled,3.2–4,3–10,3–5,3–6,4,4–6.5,5-merous,5.5–6.9,5–18,6-8,6.8–8.2,7–10,abaxial,acute,adaxial,adaxiall,also,alyx,anthesi,arme,around,axi,ba,blade,branch,capitate,congested,conical,connivent,copious,cream,curved,deciduous,densely,diameter,distall,eaf,eed,enlarged,entire,equal,erect,expand,fertile,flattened-reniform,flower,geminat,glandular-puberulent,grading,herbarium,hyaline,infructescence,lanceolate,layer,least,lobe,long-styled,longer,lowermost,major,many,mesocarp,midpoint,minute,minutely,mixed,mixture,narrowly,nflorescence,obtuse,often,one,orolla,oung,ovary,ovate,pair,papillat,peduncle,per,portion,puberulent,pubescence,pubescent,rarely,ray,red-brown,rest,ruit,scarcely,scattered,secondary,sessile,shallow,short-styled,shorter,similar,size,slender,smaller,specimen,spongy,spreadin,staminat,ste,stigma,style,suborbicular,tall,tamen,terete,thick,tightly,time,tooth,triangular,tube,twice,unarmed,uniformly,vary,vein,whitish,wide,ympodial,–15,–5	1-1.8,3-6,5.5-6.9,appressed,articulation,bract,branching,breeding,cell,colour,connective,corolla,distally,form,fruit,growth,heteromorphism,inflated,insertion,interjected,interpetalar,leaflet,marking,mature,modification,na,needle-like,odour,orientation,paired,pattern,placement,position,pseudostipule,rhizome,scale,shape,smell,spot,staman,stone,structure,symmetry,sympodial,system,texture,tissue,tuber,type,vegetative,xylopodia,zygomorphy	8,abaxially,accrescent,acicular,adaxially,base,berry,broad-based,cm,cordate,dark,difoliate,directed,free,geminate,glabrous,gland-tipped,globose,green,greenish,hair,heterostylous,immature,largest,lateral,length,light,lobed,long,maturity,membranous,mm,moderately,mottled,nearly,pale,poricidal,prickle,prickly,recurved,shrub,simple,small,somewhat,sparsely,spreading,stellate,straight,tapering,tip,trichome,truncate,unbranched,uniseriate,usually,variable,white,yellow	1-1.8,3-6,5.5-6.9,distally,na
533	wfo-0001032407	success	216	107	42	60	156	47	40	2	0-4,1-2,2-10.5,2-4,4-7,5,anther,apex,axillary,base,berry,bud,cell,chartaceous,cm,conical,corolla,dark,filament,forked,fruit,glabrous,green,hair,herb,interjected,lanceolate,leaf,leaflet,light,long,lower,margin,membranous,middle,minute,mm,obtuse,odd-pinnate,pedicel,pentagonal,petiole,plurifoliate,pore,poricidal,proximal,purple,rarely,ripe,rotate,round,stem,subtending,terminal,tip,tissue,tri-,tuber,unit,white	0.3-0.6,0.3-8,0.4-4,0.5-3,0.8,0.8-0.3,1-10,1-2.4,1-5,1.2-7,1.4-2.7,1.5-2.2,10-19.5,10-27,12,2.5-10.5,2.5-9,3-15,3.1-13.5,30,38,4-11,4-48,5-23,5-30,5-merou,6,7-9,8-10,abaxially,absent,acumen,acuminate,adaxially,ag,along,alyx,apart,apparently,arranged,articulated,asymmetrical,attenuate,axe,basiscopic,bead,blade,brownish,capitat,ciliate,clavate,coarsely,commonly,condition,connivent,covering,decreasing,densely,diameter,digestion,distal,drying,eaf,edge,eed,elliptic,elongated,enzyme,erec,especially,exceeding,finely,flower,folded,fresh,geminat,generally,glabrou,gradually,green-white,greenish,hair-like,half,homostylous,honeycomb-shaped,larger,lateral,lengthening,less,like,living,lobe,make,medium,minutely,moniliform,mottled,mucilaginous,multiple,narrow,necklace,nflorescence,orbicular,orolla,ovate,ovoid,pair,peduncle,perfect,petiolule,plant,puberulent,pubescen,pubescent,ray,removed,ruit,secondary,seed,semierect,sessile,seudostipule,side,simple,size,slit,spaced,sparsely,specimen,stamen,ste,stigma,stolon,straight,style,subequal,symmetrical,tall,tamen,tem,testal,thick,throughout,tube,typically,unwinged,usually,vary,wall,wet,whitish,wide,wing,x,yellow,ympodial	appressed,articulation,bract,branching,broad-based,calyx,colour,connective,form,fruiting,growth,heteromorphism,inflated,inflorescence,insertion,interpetalar,length,marking,mature,modification,na,needle-like,odour,orientation,paired,placement,position,prickle,pseudostipule,rhizome,scale,shape,smell,spot,staman,stone,structure,surface,symmetry,sympodial,texture,trichome,type,vegetative,xylopodia,zygomorphy,¼	0-4,1-2,2-10.5,2-4,4-7,5,axillary,berry,bud,chartaceous,cm,conical,dark,forked,glabrous,green,herb,lanceolate,light,long,membranous,middle,minute,mm,obtuse,odd-pinnate,pentagonal,plurifoliate,poricidal,proximal,purple,rarely,ripe,rotate,round,subtending,terminal,tip,tri-,white	na,¼
534	wfo-0001032465	success	229	121	67	74	155	47	58	9	1-1.5,3-4,4,9,anther,apex,articulated,axi,base,berry,black,branched,calyx,cell,cordate,coriaceous,corolla,deeply,densely,ellipsoid,filament,filiform,fruiting,glandular,globose,growth,inflorescence,later,lateral,leaf,leaving,length,lengthening,lobe,lower,margin,mature,membranous,minute,mm,pair,paired,pedicel,peg,petiole,pinnate,pinnatifid,pore,poricidal,pubescent,purplish,ripe,shape,simple,sleeve,slit,sparsely,stellate-rotate,stem,surface,terminal,time,tiny,tip,trichome,truncate,twining,uniseriate,unit,vine,violet,white,woody,x	+,-11,.2,.5,0,0.2,0.5-1.5-5,0.5-2,0.5-2.5-5.5-9,1-1.7,1-3-8-14,1-5-8-10,1-celled,1.2-1.5,1.5,1.5-1.8,1.5-2,1/3,2,2-2.5,25,3-3.5,3-5,3-9,5,5-7,5-8,5-merou,abaxial,acuminate,acute,ag,alyx,angled,anthesi,apar,apically,appearing,ark,basal,brown,capitate,ciliate,clasping,cm,commonly,conical,connivent,de,decreasing,deep,deeper,deltate,diameter,distal,drying,eaf,edge,eed,elliptic,elongate,entire,erect,exserte,flattened,flower,free,fringe,glabrescen,glabrous,gland,glandular-tipped,green,greenish,growing,half,ilament,included,irregular,irregularly,janeiro,larger,like,lobed,long,loosely,minutely,narrowly,new,nflorescence,nodding,occasionally,often,older,orolla,outline,ovate,papillate,papillo,peduncle,pendan,pentagonal,per,perfect,pericarp,planar,plurifoliat,portion,primary,puberulent,reddish,reniform,reticulate,revolute,rio,ruit,scar,scattered,seed,shallow,shiny,similar,sinus,size,somewhat,spaced,splitting,stigma,strongly,style,subshrub,tem,testal,thicker,thin,toward,transparent,tube,tuft,twinin,ud,unicellular,upper,usually,variously,vary,varying,vein,wall,way,widest,yellowish,ympodial,young,½	5-merous,age,appressed,articulation,bract,branching,breeding,broad-based,colour,connective,form,fruit,hair,heteromorphism,inflated,insertion,interjected,interpetalar,leaflet,marking,modification,na,needle-like,odour,orientation,pattern,placement,plurifoliate,position,present,prickle,pseudostipule,rhizome,scale,spot,staman,stellate,stone,structure,symmetry,sympodial,system,texture,tissue,tuber,type,xylopodia	1-1.5,3-4,4,9,articulated,axi,base,berry,black,branched,cordate,coriaceous,deeply,densely,ellipsoid,filiform,glandular,globose,inflorescence,later,lateral,leaf,leaving,lengthening,lobe,lower,membranous,minute,mm,pair,peg,pinnate,pinnatifid,pore,poricidal,pubescent,purplish,ripe,simple,sleeve,slit,sparsely,stellate-rotate,stem,surface,terminal,time,tiny,tip,trichome,truncate,twining,uniseriate,vine,violet,white,woody,x	5-merous,age,broad-based,na,needle-like,plurifoliate,present,prickle,stellate
535	wfo-0001032494	invalid_json	163	112	NA	87	76	25	NA	NA	.1,.4,.5,0.6-1,0.75-1,0.8-1,0.9-1.2,1-1.5,1.45-1.5,1.5,1.5-8,1.6-2,1.8-4.5,2.3-2.5,2.5,2.5-8,3-4,3.4-14.5,3/4,5-40,acuminate,anther,anthesi,apart,apex,attenuate,bark,base,brown,calyx,clavate,cm,corolla,decurrent,filament,flattened-reniform,fruit,fruiting,furcate,glabrous,globose,greenish-yellow,incrassate,leaf,light,lobe,lobed,margin,minor,minutely,mm,narrowly,occasionally,opposite,ovary,ovate,pale,papillose,pedicel,petiole,pitted,pore,revolute,scar,shaped,shrub,simple,size,small,stem,stigma,style,surface,tan,tear-drop,tree,trichome,tube,two-winged,uniseriate,unit,way,white,whitish-green,winged,x,zig-zag	1.1-1.2,16.5-20.5,4-8,5-6.4,8-11,accrescent,appearing,axil,ba,beginning,beneath,berry,bullate,deflexed,dia,differing,difoliate,dry,eaf,edicel,eed,equal,evenly,except,expanded,exserted,flowered,free,geminat,geminate,inflorescenc,lateral,lax,lenticellat,lon,long,lower,main,major,material,middle,nearly,nflorescence,node,orange,ovoid,pair,papillae,papillo,planar,poricidal,portion,prominent,proximal,pubescent,quite,raised,ridge,ruit,slender,slightly,somewhat,spaced,straight,tall,tapering,tip,triangular,ud,upper,vein,venation,widest,woody,yellow,ympodial	abaxial,branching,characteristic,colour,diameter,difoliation,flower,form,glabrousnes,growth,height,inflorescence,length,lenticellate,number,plant,position,seed,shape,spacing,sympodial,texture,type,value,ye	NA	NA
536	wfo-0001032507	success	206	123	69	73	133	50	59	10	abaxial,abaxially,absent,abundant,adaxially,anther,apex,armed,articulated,base,berry,blue,branched,calyx,cell,chartaceous,cm,collection,compound,connivent,corolla,curved,elliptic,filament,flowering,four,fruiting,glabrous,globose,green,hair,herbarium,highly,interpetalar,leaflet,lengthening,light,margin,material,midrib,mm,oblong,occasionally,often,one,ovate,pedicel,petiole,pinnately,plant,pore,poricidal,present,prickle,puberulent,pulp,purple,ranging,rarely,rotate-pentagonal,shape,simple,slit,surface,terminal,tip,tissue,unbranched,unit,variable,vine,white,widest	.2,.5,/4,0.25,0.3,0.5,0.7-1.2,0.8,1,1.2-1.7,1.3,1.5–2,1.5–7,10–20,15–20,1–1.5,1–10,2,2.5–4,2.5–6,20–30,2–9,3–5,3–7,4–10,5–10,5–20,5–8,6,8–15,acuminate,acute,adaxiall,adjacent,ag,alyx,anthesi,apiculate,becoming,blade,broadly,brown,bud,campanulate,confluent,cream,deep,deltate,diameter,distally,distinct,dr.,eaf,eed,either,ellipsoid,elongating,entire,equal,exserted,fertile,fifth,flattened-reniform,flower,herbaceous,individual,internode,larger,lateral,lobe,lobed,long,longer,lower,major,minutely,narrowly,nearly,nflorescence,observe,orolla,pale,papery,peduncle,pentagonal,perennial,pericarp,pinnate,pinnatifid,pistillate,pitted,plurifoliat,purplish,quadrate,rachi,recurve,reddish,regularly,rounded,rugose,ruit,side,single,sinus,slender,slightly,sometimes,spreading,staminate,stem,stigma,stout,straight,strongly,style,tamen,tear,testal,time,tube,unequal,unlobed,usually,variously,vary,vein,way,wide,wood,woody,yellowish,ympodial,×	1-1.5,1.5-7,2.5-4,4-10,age,appressed,articulation,bract,branching,breeding,colour,connective,dioecious,form,fruit,growth,heteromorphism,inflated,inflorescence,insertion,interjected,leaf,length,marking,mature,modification,na,odour,orientation,paired,pattern,placement,plurifoliate,position,pseudostipule,recurved,rhizome,scale,spot,staman,stone,structure,symmetry,sympodial,system,texture,tuber,type,xylopodia,zygomorphy	abaxial,abaxially,absent,abundant,adaxially,armed,articulated,base,berry,blue,branched,chartaceous,cm,collection,compound,connivent,curved,elliptic,flowering,four,glabrous,globose,green,hair,herbarium,highly,lengthening,light,material,midrib,mm,oblong,occasionally,often,one,ovate,pinnately,plant,pore,poricidal,present,prickle,puberulent,pulp,purple,ranging,rarely,rotate-pentagonal,shape,simple,slit,surface,terminal,tip,unbranched,variable,vine,white,widest	1-1.5,1.5-7,2.5-4,4-10,age,dioecious,na,plurifoliate,recurved,zygomorphy
537	wfo-0001032523	success	200	136	69	85	115	51	64	5	-5,.2,.5,/4,0.6-0.7,1.5-3,15-30,2-2.4,2-5.5,2.7-3,3.5-4,5-20,6-10,abaxial,abaxially,acuminate,adaxial,anther,apex,articulated,base,berry,branching,calyx,cm,connivent,cuneate,diameter,elliptic,entire,erect,evenly,filament,flattened-reniform,flower,fruit,fruiting,glabrescent,green,hair,lateral,leaf,length,lobed,long,lower,margin,mature,maturity,mauve,membranous,minute,mm,moderately,ovate,pedicel,per,petiole,poricidal,prickle,primary,recurved,red,reflexed,secondary,shrub,simple,sparsely,spherical,stellate,stellate-pubescent,stem,straight,subentire,surface,tapering,terminal,tip,trichome,unarmed,unit,way,weakly,wide,young	-2,0-0.15,0-10,0-12,0-15,0-3,0.1-0.2,0.2,0.2-0.4,0.3-0.5,0.4-1,0.4-1.5,0.5-1,0.6-0.8,1-1.5,1-2,1-3,1-8,1.3-1.6,1/3-1/2,1/4-1/3,10-50,2,2-2.5,2-4,2.5-6,3-15,3-4,4-5-merous,4-7,5-12,6-20,6-8,acuminat,acute,alyx,ame,apar,apart,apically,apparently,bark,blade,brow,c.,conical,curved,deltate,discolorous,drying,dull,eaf,eed,elongating,equal,filiform,free,gently,glabrou,glabrous,herbaceous,inflated,infructescence,lobe,lon,longer,midpoint,multangulate,narrow-deltate,nflorescence,older,one,open,orange,orange-brown,orolla,oung,pair,pale,peduncle,perfec,pericarp,perpendicular,plurifoliat,porrect,portion,prickly,ray,red-brown,ruit,scandent,scar,sessile,smooth,sometimes,spaced,spreading,stalk,stalked,strongly,style,tamen,terete,tertiary,time,tube,unarme,variously,vary,vein,venation,visible,woody,yellow,ympodial	articulation,bract,breeding,broad-based,cell,colour,connective,corolla,form,growth,heteromorphism,inflorescence,insertion,interjected,interpetalar,leaflet,marking,modification,na,needle-like,number,odour,orientation,pattern,perfect,placement,plurifoliate,pore,position,present,pseudostipule,rhizome,scale,seed,shape,size,smell,spot,staman,stone,structure,symmetry,sympodial,system,texture,tissue,tuber,type,vegetative,xylopodia,zygomorphy	-5,.2,.5,/4,0.6-0.7,1.5-3,15-30,2-2.4,2-5.5,2.7-3,3.5-4,5-20,6-10,abaxially,acuminate,articulated,base,berry,cm,connivent,cuneate,diameter,elliptic,entire,erect,evenly,flattened-reniform,glabrescent,green,hair,lateral,leaf,lobed,long,maturity,mauve,membranous,minute,mm,moderately,ovate,poricidal,primary,recurved,red,reflexed,secondary,shrub,simple,sparsely,spherical,stellate,stellate-pubescent,stem,straight,subentire,tapering,terminal,tip,unarmed,way,weakly,wide,young	na,perfect,plurifoliate,present,zygomorphy
538	wfo-0001032524	success	205	154	81	107	98	47	79	2	1-2,1-2.5,1.5-4,10-35,12-13,14-50,2-5,2.5-8,25-90,3.5-4.5,4.5-8,5-6,5-9,6-13,6-16.5,7-8,abaxially,adaxially,anther,apex,axillary,base,berry,blade,brownish,bud,cell,chartaceous,cm,condition,connivent,corolla,cuneate,densely,diameter,digestion,distal,drying,enzyme,filament,flower,forked,fresh,fruit,glabrous,globose,grayish-green,green,greenish,hair,hair-like,half,herb,homostylous,honeycomb-shaped,interjected,lanceolate,lateral,leaflet,length,lengthening,light,like,lilac,long,margin,membranous,middle,minutely,mm,moniliform,mucilaginous,odd-pinnate,ovoid,pair,pedicel,peduncle,pentagonal,petiole,plant,plurifoliate,pore,poricidal,puberulent,pubescent,purple,ripe,rotate,rounded,seed,size,slit,stem,style,subtending,terminal,testal,tip,tri-,tuber,typically,unit,unwinged,violet,wet,whitish,x	1-10,1.5-2,120-210,2-3,3-4,3-5,3-8.5,4,4-5,4.5-5,5-merou,50-70,7-35,?,acumen,acute,ag,along,alyx,apart,apparently,arranged,articulated,ascending,attenuate,axe,bead,capitat,ciliate,clavate,covering,different,dorsally,eaf,edge,eed,elliptic,erec,especially,exceeding,except,flat,folded,geminat,generally,glabrou,greatly,green-white,hal,head,living,lobe,lower,make,midrib,multicellular,multiple,narrowly,necklace,nflorescence,non-glandular,obtuse,often,orolla,ovate,perfect,petiolulate,petiolule,proximal,reduced,removed,ruit,sessile,seudostipule,short,silky,silvery-white,spaced,specimen,stamen,ste,stigma,stolon,straight,subequal,tall,tamen,tem,tetralobulate,thick,throughout,trichome,tube,usually,vary,wall,yellow,ympodial	age,appressed,arrangement,articulation,bract,branching,breeding,calyx,colour,connective,form,fruiting,growth,height,heteromorphism,inflated,inflorescence,insertion,interpetalar,leaf,marking,mature,modification,na,odour,orientation,ovary,paired,pattern,placement,position,prickle,pseudostipule,rhizome,scale,shape,spot,staman,stone,structure,symmetry,sympodial,system,texture,tissue,type,xylopodia	1-2,1-2.5,1.5-4,10-35,12-13,14-50,2-5,2.5-8,25-90,3.5-4.5,4.5-8,5-6,5-9,6-13,6-16.5,7-8,abaxially,adaxially,axillary,berry,brownish,bud,chartaceous,cm,condition,connivent,cuneate,densely,distal,drying,enzyme,forked,fresh,glabrous,globose,grayish-green,green,greenish,hair,hair-like,half,herb,homostylous,honeycomb-shaped,lanceolate,lengthening,light,like,lilac,long,membranous,middle,minutely,mm,moniliform,odd-pinnate,ovoid,pentagonal,plurifoliate,pore,poricidal,puberulent,pubescent,purple,ripe,rotate,rounded,slit,stem,subtending,terminal,tip,tri-,typically,unwinged,violet,wet,whitish,x	age,na
539	wfo-0001032532	success	160	112	71	82	78	30	64	7	0.3-2.5,1-4,1.5-2.6,1.5-4.3,13-52,15-30,2-10,2-13,2-3,2.8-3.6,2.8-9.5,3-10,3.4-12.2,4-5.5,4.5,6,6-22,8-38,acute,apically,base,branched,calyx,cm,conical,connate,corolla,cyme,deep,dehiscent,diameter,dichasially,diminishing,distal,filament,finely,flower,forked,generally,gradually,green,green-white,hair-like,half,herbaceous,honeycomb,interjected,lateral,leaf,leaflet,light,lobe,long-attenuate,medium,mm,mucilaginous,odd-pinnate,ovoid,pattern,pedicel,peduncle,perennial,perfect,petiole,plant,poricidally,proximal,pubescent,purple,rotate,seed,size,straight,style,subequal,terminal,toward,tuber-bearing,unit,wall,yellow,¼	0-.,1-1.5,1.5-3.2,2,2-3-5,3-6-foliat,3.7-10,abaxiall,abaxially,absent,acumen,acuminate,adaxially,apex,apical,articulate,attenuate,cell,coarsel,covering,cuneate,dichasial,digestion,dorsally,eaf,ebracteate,edge,eed,elliptical,emoval,enzyme,exceeding,flat,folded,globo,introrse,living,lon,long,lower,lunat,make,maturing,minute,monochasial,narrowly,nflorescence,nther,oblique,obtuse,often,orolla,ovate,pair,petiolule,plan,reveal,rounded,ruit,sessile,seudostipule,short,slit,specimen,stamen,stigma,subsessile,tal,tem,testal,thick,throughou,throughout,tip,typically,vary,wide,ympodial	0-2,2-5,3-6-foliate,anther,arrangement,articulation,branching,coarsely,colour,form,fruit,growth,height,inflorescence,length,lunate,number,ovary,pore,position,present,pseudostipule,shape,stem,structure,sympodial,texture,type,wet,width	0.3-2.5,1-4,1.5-2.6,1.5-4.3,13-52,15-30,2-10,2-13,2-3,2.8-3.6,2.8-9.5,3-10,3.4-12.2,4-5.5,4.5,6,6-22,8-38,acute,apically,base,branched,cm,conical,connate,cyme,deep,dehiscent,dichasially,diminishing,distal,finely,forked,generally,gradually,green,green-white,half,herbaceous,lateral,leaf,leaflet,light,lobe,long-attenuate,medium,mm,odd-pinnate,ovoid,perennial,perfect,plant,poricidally,proximal,pubescent,purple,rotate,size,straight,subequal,toward,tuber-bearing,yellow,¼	0-2,2-5,3-6-foliate,coarsely,lunate,present,wet
540	wfo-0001032536	success	254	115	57	75	179	40	54	3	14-16,2-3,4-9,abruptly,anther,apex,appressed,articulated,base,berry,bright,broad-based,calyx,cell,chartaceous,cm,curved,densely,depressed,difoliate,equal,fading,filament,fruit,fruiting,geminate,globose,growth,heterostylous,inflorescence,interpetalar,juvenile,lateral,leaf,leaf-opposed,length,long,lower,margin,mature,membranous,mm,narrowing,oblique,odor,once-branched,papillate,pedicel,pentagonal,petiole,plant,pore,poricidal,potato,prickle,prickly,purple,shallowly,simple,slightly,somewhat,sparsely,stellate,stem,surface,tapering,tip,tissue,tree,truncate,unequal,unit,usually,white,yellow-green	-3,/3,0.5,1,1-2,1-2.5,1.3-2.2,1.5,10,10-20,10-30,10-50,100,13-24,2.5-3,20-22,20-25,20-50,3,3-3.5,3-6,4-6,4-8,5,5-6,5-8,5-merous,5.5-8,7-10,<,>,abaxial,abaxially,acute,adaxial,adaxiall,adaxially,age,almost,along,alyx,angle,anthesi,apar,armed,around,axi,bark,basal-most,berr,blade,bristle,bristly,broadly,brown,capitate,caudat,caudate,clavate,clearly,conical,coriaceous,cu,dark,dbh,deeply,deltate,denser,diameter,directed,diverging,eaf,eed,elliptic,enlarged,entire,evenly,flattened,flower,free,glabrescent,glabrous,glandular,glandular-puberulent,grayish,halfway,hanging,inflorescenc,infructesecnce,irregularly,lamina,leaving,like,lobe,lobed,long-stalked,long-styled,maturity,midpoint,midrib,midvein,minute,minutely,mixed,mixture,multangulate,multiseriate,narrowly,near,new,nflorescence,number,occasionally,occurring,older,olive-green,open,orolla,oung,ovary,papillae,papillat,part,peduncle,per,pericarp,porrect,portion,prickl,primary,prominent,protuberance,pubescent,rarely,ray,reddish,reniform,reproductive,rough,ruit,scar,scattered,short-,short-styled,slender,small,smooth,soft,spaced,spreading,stalk,staminate,stellate-pubescent,stigma,strongly,style,tall,tamen,terete,terminal,thick,time,triangular,trichome,trunk,tube,unarmed,upward,urceolate,vary,vein,visible,way,wide,wood,woody,yellowish,ympodial,younger	articulation,bract,branching,breeding,colour,connective,corolla,form,hair,heteromorphism,inflated,insertion,interjected,leaflet,marking,modification,na,needle-like,odour,orientation,paired,pattern,placement,position,pseudostipule,rhizome,scale,shape,spot,staman,stone,structure,symmetry,sympodial,system,texture,tuber,type,xylopodia,zygomorphy	14-16,2-3,4-9,abruptly,appressed,articulated,base,berry,bright,broad-based,chartaceous,cm,curved,densely,depressed,difoliate,equal,fading,geminate,globose,heterostylous,juvenile,lateral,leaf-opposed,long,membranous,mm,narrowing,oblique,odor,once-branched,papillate,pentagonal,plant,poricidal,potato,prickle,prickly,purple,shallowly,simple,slightly,somewhat,sparsely,stellate,stem,tapering,tip,tree,truncate,unequal,usually,white,yellow-green	na,needle-like,zygomorphy
541	wfo-0001032542	success	161	123	56	75	86	48	53	3	.25,/4,0.5-1,1-1.5,1-5,1.5-3.5,2-3.5,2.5-5,4.5-5,5-8,abaxial,anther,apex,attenuate,bark,base,berry,bluish-green,bright,brown,calyx,capitate,cm,conical,corolla,dark,deflexed,dendritic,densely,difoliate,elliptic-obovate,filament,flattened-reniform,fruiting,glabrous,globose,golden,green,growth,incrassate,inflorescence,leaf,less,lobed,long,margin,minor,minute,mm,opposite,ovary,pedicel,petiole,pore,pubescent,reddish-brown,shape,shaped,shining,shrub,size,small,somewhat,sparsely,stem,stigma,style,tear-drop,treelet,trichome,tube,unit,way,wide,yellow-green	.25-0.5,.5,.5-1,0.7-1,1-1.3,1-2,10-15-flowered,10-28,2-3,3-4,3-5,4-7,4-9.5,abaxially,acuminate,acute,adaxially,along,anthesi,apical,axi,ba,basal,beginning,closely,compact,deltate,di,dia,differing,distal,dry,eaf,edicel,eed,either,elliptic,erect,exserted,free,geminat,inflorescenc,lamina,later,lateral,like,lobe,lon,loose,lower,main,major,minutely,narrowly,near,new,nflorescence,older,overlapping,pair,papillo,persisten,pitted,planar,poricidal,portion,rounded,ruit,scar,simple,slender,slightly,spaced,strongly,surface,swollen,tip,triangular,tub,ud,vein,woody,x,yellowish,ympodial,young	adaxial,articulation,bract,branching,breeding,cell,colour,connective,deflexion,form,fruit,geminate,hair,heteromorphism,insertion,interjected,interpetalar,leaflet,length,marking,mature,modification,na,odour,orientation,pattern,persistence,persistent,placement,position,prickle,pseudostipule,rhizome,scale,seed,spot,staman,stone,structure,symmetry,sympodial,system,texture,tissue,tuber,type,width,xylopodia	.25,/4,0.5-1,1-1.5,1-5,1.5-3.5,2-3.5,2.5-5,4.5-5,5-8,attenuate,base,berry,bluish-green,bright,brown,capitate,cm,conical,dark,deflexed,dendritic,densely,difoliate,elliptic-obovate,flattened-reniform,glabrous,globose,golden,green,incrassate,leaf,less,lobed,long,margin,minute,mm,opposite,pubescent,reddish-brown,shaped,shining,shrub,small,somewhat,sparsely,tear-drop,treelet,trichome,way,wide,yellow-green	geminate,na,persistent
542	wfo-0001032564	success	160	102	39	52	108	50	38	1	0.75-1,1-1.2,1-2,anther,apex,arched,base,becoming,berry,calyx,corolla,elliptic,except,flattened,fruiting,geminate,glabrous,globose,green,greenish-white,leaf,lobed,long,lower,margin,minute,mm,narrowly,nearly,node,non-reproductive,opposite,ovate,pedicel,petiole,pore,poricidal,ripe,shaped,shiny,shrub,stem,surface,tear-drop,tip,trichome,truncate,unifoliate,uniseriate,unit,x,yellowish-green	.05,.05-0.1,.1,.5,0.25-0.5,0.3-1,1-1.3,1-1.5,1.3-2.5,1.5,2-2.5,4-5,4-6-flowered,5.5-9,6-7,8-9,along,anthesi,apar,apart,aspec,ba,bark,beneath,branch,broadly,brown,bud,clavate,cm,conical,converging,dark,deflexed,deltoid,densely,dia,dry,eaf,edicel,eed,expanded,exserted,extreme,filiform,flower,fresh,giving,glabrate,golden,greyish-red,halfway,lamina,later,lateral,like,lobe,long-acuminate,main,material,member,middle,minutely,nflorescence,obovoi,often,older,one,open,ovary,ovoid-reniform,pair,papillo,papillose,pitted,planar,point,projection,prominent,proximal,puberulent,raised,reflexed,rounded,ruit,scar,simple,slightly,small,soon,stigma,straight,strongly,style,tall,tan,tapering,thread-like,time,tiny,tube,ud,vein,widest,winged,woody,ympodial,young	appressed,articulation,bract,branching,breeding,broad-based,cell,colour,filament,form,fruit,growth,hair,heteromorphism,inflated,inflorescence,insertion,interjected,interpetalar,leaflet,length,marking,mature,na,needle-like,odour,orientation,pattern,placement,position,prickle,pseudostipule,rhizome,scale,shape,smell,spot,staman,stone,structure,symmetry,sympodial,system,texture,tissue,tuber,type,vegetative,xylopodia,zygomorphy	0.75-1,1-1.2,1-2,arched,base,becoming,berry,elliptic,except,flattened,geminate,glabrous,globose,green,greenish-white,leaf,lobed,long,minute,mm,narrowly,nearly,node,non-reproductive,opposite,ovate,poricidal,ripe,shaped,shiny,shrub,tear-drop,tip,truncate,unifoliate,uniseriate,x,yellowish-green	na
543	wfo-0001032569	success	164	108	45	59	105	49	42	3	.5,/3,1-1.5,1-2,1.2-5,5-6,anther,apex,apparently,appearing,base,berry,branched,calyx,cell,cm,corolla,decurrent,dendritic,difoliate,elliptic,filament,fleshy,fruiting,geminate,globose,green,inflorescence,leaf,lobed,long,lower,margin,mature,mm,occasionally,onto,opposite,ovate,pedicel,petiole,pore,poricidal,present,shaped,shrub,simple,stem,stone,surface,tear-drop,thick,tip,trichome,unifoliate,unit,way,white,x	0.5-10,0.8-1,1-1.2,1-4,1.5,1.5-2,1.7-2,2-3,2-4,4-18,4-8,5-60-flowered,7-27,7-9,abaxially,acute,adaxially,along,anthesi,axi,bark,bearing,bilobed,broadly,brown,bullate,closely,conical,corrugated,dark,deflexed,dense,densely,denser,dia,differing,dry,drying,eaf,edicel,eed,ellipsoid,erect,exserted,flattened,free,glabrous,golden,gra,incrassate,irregularly,later,lateral,lea,like,lobe,lon,los,main,major,matted,middle,minor,minutely,moderately,nflorescence,obscured,open,otherwise,ovary,pair,paler,papillo,papillose,pericar,pitted,planar,portion,pubecsence,pubescent,reniform,rich,ruit,scar,size,somewhat,spaced,sparsely,splitting,stigma,strongly,style,tall,time,triangular,tub,tube,tuft,ud,vein,waxy,widest,woody,ympodial,young	appressed,articulation,bract,branching,breeding,broad-based,colour,connective,form,fruit,growth,hair,heteromorphism,inflated,insertion,interjected,interpetalar,leaflet,length,marking,modification,na,needle-like,odour,orientation,paired,pattern,pericarp,placement,position,prickle,pseudostipule,rhizome,scale,shape,smell,spot,staman,stellate,structure,symmetry,sympodial,system,texture,tissue,tuber,type,vegetative,xylopodia	.5,/3,1-1.5,1-2,1.2-5,5-6,apparently,appearing,base,berry,branched,cm,decurrent,dendritic,difoliate,elliptic,fleshy,geminate,globose,green,leaf,lobed,long,mm,occasionally,onto,opposite,ovate,petiole,poricidal,present,shaped,shrub,simple,tear-drop,thick,tip,trichome,unifoliate,way,white,x	na,pericarp,stellate
544	wfo-0001032576	success	227	116	73	85	142	31	70	3	/5,0.5-2,0.5-4,0.8-1.2,0.8-2,2-10,2-4,4-6.5,5-30,anther,apart,apex,articulated,bark,base,berry,branched,branching,bright,brown,brown-green,chartaceous,cm,conical,cuneate,curved,dull,entire,equal,erect,evenly,flattened,flattened-reniform,flower,fruit,glabrescent,glandular,gray,green,hair,herb,lanceolate,lateral,leaf,length,lobed,long,lower,margin,maturity,membranous,mm,moderately,orange-brown,ovate,pedicel,per,petiole,poricidal,prickle,purple,red,red-green,scar,shrub,simple,slightly,sometimes,spaced,spherical,spreading,stellate-pubescent,stem,straight,style,surface,tapering,terminal,tip,way,white,wide,yellow,yellow-green,young	-10,-12,/4,0-1.5,0-2,0-3,0-30,0-5,0.1,0.1-0.15,0.1-0.2,0.1-0.25,0.3-0.5,0.3-0.7,0.5-1,0.5-1.5,0.8-1.4,1-3,1-4,1.2-1.8,1.5-2,1.5-2.3,1.5-7.5,1.8-2.5,1/2-2/3,1/3,1/3-1/6,2-3,2-5,2.5-3,2.5-4,3-14,4,4-5-merous,4-6,4-6-8,6-8,7-8,abaxially,acuminat,acute,alyx,apar,apically,apparently,ascendant,ba,blade,brow,calyx,cell,concolorous,deltate,densely,diameter,difoliate,distance,drying,eaf,eed,ellipsoid,elongating,extending,eye,faint,filament,free,fruiting,geminat,glabrous,gland,globular,herbaceous,infructescence,lobe,longer,mature,midpoint,midvein,minutely,naked,narrow-deltate,narrow-ovate,near,nflorescence,obovate,obtuse,often,older,one,open,orolla,oung,outline,pair,pale,peduncle,perfec,pericarp,pit,porrect,portion,prickl,prickly,primary,raised,ray,reduced,reflexed,reticulate,rounded,ruit,scandent,sessile,shiny,short,shorter,side,slender,small,smooth,sparsely,stalk,stalked,stellate,tamen,tertiary,time,trichome,tube,unarmed,unit,upper,usually,variously,vary,vein,venation,visible,woody,yellow-orange,ympodial	abaxial,adaxial,articulation,bract,colour,corolla,form,growth,heteromorphism,inflorescence,insertion,na,needle-like,number,odour,orientation,ovary,placement,position,pseudostipule,rhizome,scale,seed,shape,staman,symmetry,texture,tuber,type,xylopodia,zygomorphy	/5,0.5-2,0.5-4,0.8-1.2,0.8-2,2-10,2-4,4-6.5,5-30,apart,articulated,base,berry,branched,bright,brown,brown-green,chartaceous,cm,conical,cuneate,curved,dull,entire,equal,erect,evenly,flattened,flattened-reniform,glabrescent,gray,green,herb,lanceolate,lateral,leaf,lobed,long,lower,maturity,membranous,mm,moderately,orange-brown,ovate,per,poricidal,purple,red,red-green,shrub,simple,slightly,sometimes,spaced,spherical,spreading,stellate-pubescent,stem,straight,surface,tapering,terminal,tip,way,white,wide,yellow,yellow-green,young	na,needle-like,zygomorphy
545	wfo-0001032595	success	197	129	73	81	116	48	68	5	0-0.5-3.5,1-3,1.5-2,2-4,3-10,3-4-foliate,4-5,aggregate,also,anther,apex,basal,base,branch,branched,brownish-purple,calyx,cell,cm,connective,cordate,coriaceous,deeply,densely,dull,eglandular,ellipsoidal,entire,filament,finely,fork,forked,fruit,fruiting,fusiform,geminate,glabrous,glandular,greenish,hair,lanceolate,leaf-opposed,leaving,lobe,long,longitudinal,lower,margin,mature,mm,moderately,narrowly,near,oblique,often,opening,pale,pedicel,pedicellar,petiole,pilose,pore,puberulent,rarely,remnant,shrub,simple,slit,small,sparsely,stellate,stone,subcoriaceous,tree,triangular,truncate,unbranched,unit,violet,x,yellow	-pilose,0.5-1,1,1-2,1-2.5,1-6,1-6.5-20,1.5-2.5,1.5-4.5,1.5-5,12-16,15-25,15-40,2-3,2.3-24,25-40,3-12-25,3-4,3-5,4-25,4-7,5-6,5-merou,6-7,9-14,abaxially,accrescen,acuminate,acute,adaxially,along,alyx,apart,ape,apical,apiculate,articulated,axe,blade,brownish,ciliat,connivent,cream,crow,cucullate,deltate,dense,denser,diameter,dilated,directed,distally,eaf,eed,equal,exceeding,flattened,flower,free,gland,homostylous,larg,lon,loosely,m.,major,midrib,nflorescence,orolla,ovate,ovoid,part,peduncle,per,perfect,pilo,produced,prominent,pseudohair,pubescent,purple,purplish,rachi,reniform,rugulose,ruit,shallow,shorter,side,single,slightly,spaced,spreading,stamen,stigma,strongly,style,swelling,tall,tamen,tem,thecae,time,tip,tomentose,toward,trunk,tube,two,ud,umbrella-shaped,vary,vein,white,wide,ympodial	accrescent,articulation,bract,branching,broad-based,colour,corolla,form,growth,heteromorphism,inflorescence,insertion,interjected,interpetalar,large,leaf,leaflet,length,marking,mentioned,na,needle-like,odour,orientation,paired,placement,position,prickle,pseudostipule,rhizome,scale,shape,smell,spot,staman,stem,structure,surface,symmetry,sympodial,texture,tissue,trichome,tuber,type,vegetative,xylopodia,zygomorphy	0-0.5-3.5,1-3,1.5-2,2-4,3-10,3-4-foliate,4-5,aggregate,also,basal,base,branch,branched,brownish-purple,cell,cm,cordate,coriaceous,deeply,densely,dull,eglandular,ellipsoidal,entire,finely,fork,forked,fusiform,geminate,glabrous,glandular,greenish,hair,lanceolate,leaf-opposed,leaving,lobe,long,longitudinal,mature,mm,moderately,narrowly,near,oblique,often,opening,pale,pedicellar,pilose,puberulent,rarely,remnant,shrub,simple,slit,small,sparsely,stellate,stone,subcoriaceous,tree,triangular,truncate,unbranched,violet,x,yellow	accrescent,large,mentioned,na,zygomorphy
