	coreid	status	nwords_original	nwords_result	nwords_recovered	nwords_omitted	nwords_created	prop_recovered	common_words	original_only	result_only
0	wfo-0001025652	exception_thrown	156	0	0	156	0	0.0		.3,.5,0.5-1,1,1-1.5,1.5-2,10-20,15-17,15-19,2-3,2-5,2-6,20-50,3-3.5,3-5,3-5-flowered,4,4-6,4-7,9-11,abruptly,acuminate,acute,anther,anthesi,apex,appearing,bark,base,bilobed,blade,broad,calyx,campanulate,closed,closely,cm,completely,connate,corolla,decurrent,densely,dia,differing,difoliate,dry,eaf,edicel,eed,elliptic,emerge,envelope,filament,fleshy,flower,free,fruit,furcate,geminat,glabrate,glabrous,green,greyi,greyish,growing,growth,irregular,lateral,leaf,like,live,lobe,lobed,lon,long,lower,main,major,margin,matte,middle,minor,minute,minutely,mm,narrowing,nearly,new,nflorescence,occasionally,older,one,onto,opposite,ovary,overlappin,ovoid,ovoid-reniform,pair,pale,paler,papillae,papillo,papillose,parallel,pedicel,petiole,pinkish-grey,pitted,planar,plant,pore,poricidal,portion,rather,red-papillose,ry,scar,shape,shaped,shiny,shrub,simple,size,small,soon,spaced,specimen,stem,stigma,straight,strongly,style,surface,tall,tan,tapering,tear,tear-drop,thick,thicker,tightly,tip,tree,tube,ud,unit,vein,white,wider,widest,wing,winged,x,ympodial,young	
1	wfo-0001025657	success	239	200	160	79	40	0.669	-2,0.1-0.4,0.5-2.5,1-1.1,1-1.3,1-3,1.2-1.5,1.3-2,1.5-1.8,1.7-1.9,12x,2-10,2-3.5,2.2-5.5,2.5-9.3,2.7-4.3,2/3,25-60,3-4,3-6,4-4.4,5-14,5-16,6-12,6-8,7-27,7-9,7-9.5,8.3-12,abaxially,acute,adaxially,anther,anthesi,apart,apex,articulated,axe,axillary,base,berry,blade,blunt-tipped,branch,branched,broadly,brown,bud,calyx,central,chartaceous,closely,cm,conical,cordate,corolla,dark,deltoid,dendritic-multangulate,diameter,dried,elliptic,entire,especially,expanded,exserted,filament,fleshy,flower,fruit,fruiting,glabrous,glandular,granular,green,hair,half,lanate-pubescent,lateral,leaf,length,lobe,lobed,long,long-stalked,lower,magnification,main,margin,midrib,minutely,mixed,mm,multangulate,narrowly,nearly,oblong,obtuse,often,orbicular,ovate,overlapping,pale,part,parted,partly,pedicel,peduncle,persistently,petiole,plurifoliate,porrect-stellate,present,pseudo-terminal,rachi,ray,reticulate-punctate,ripe,scented,sessile,short,short-,short-stalked,shrub,side,simple,slightly,soft,spaced,stellate,stem,stigma,stipitate-glandular,strongly,style,subcampanulate,suborbicular,surface,tall,tan,terete,thick-stalked,thin-stalked,time,tomentose,tomentose-pubescent,tree,tube,unarmed,unit,usually,vein,velutinous-pubescent,way,weakly,wide,x,yellow,yellowish,young	/3,0.2-0.4,1-1.6,3-4.8,3.2-6,4-4.5,4-7,6.5-10,8-10.5,accrescent,ag,also,apparently,appearing,ark,around,ascending,ba,bluish,capitat,cylindrical,dendritic-multangulat,dense,densely,directed,distally,due,eaf,earl,edge,eed,evident,exerted,farinose,few-rayed,free,glandula,inserted,lanceolate,lengthening,light,longitudinal,m.,nflorescence,occasional,older,open,orolla,ovat,ovate-lanceolate,perfect,persistent,pore,poricidal,pubescence,pubescent,reportedly,ruit,semi-ovate,slit,somewhat,splitting,stamen,stellate-pubescent,stipitate-multangulate,subcoriaceous,suture,tamen,thickened,tip,tomentum,transparent,two-third,ud,unarme,upper,vary,white,ympodial	appearance,arrangement,bark,border,capitate,characteristic,colour,corrugation,distal,drying,exertion,form,giving,glabrousnes,growth,history,inflorescence,interjected,leaflet,life,lobing,mentioned,midpoint,new,number,ovary,per,prickle,primary,pseudostipule,seed,shape,size,sympodial,terminal,texture,thicknes,type,variation,width
2	wfo-0001025669	success	216	187	142	74	45	0.657	.5,0-5,0-7,0.1-0.3,0.8-2.4,1,1-10,1-2,1-2.2,1-3,1-4,1.3-4.2,1.4-2.5,1.6-4.4,13-35,2,2-3,2-4,2.2-6,2.2-6.5,2.4-7,3-5,3-7,9-24.5,abaxially,absent,acumen,acuminate,acute,adaxially,anther,apart,apex,apparently,articulation,axe,base,berry,blade,blue,broadly,brownish,cell,ciliate,clavate,cm,condition,connivent,contracted,corolla,covering,cuneate,diameter,distal,drying,elliptic,especially,exceeding,filament,flower,flowered,forming,fresh,fruit,glabrous,globose,green,greenish,hair,half,herb,highly,interjected,lanceolate,lateral,leaflet,like,lobe,long,make,margin,minute,mm,moderately,monochasium,mottled,mucilaginous,multicellular,near,oblique,obovate,obtuse,odd-pinnate,often,orbicular,ovate,ovoid,pedicel,peduncle,perfect,petiole,petiolulate,petiolule,plant,pubescent,purple,rarely,ripe,rosette,rounded,scale-like,seed,sessile,short,single,size,slightly,sometimes,spaced,stamen,stem,stigma,straight,streaked,style,subglabrous,terminal,testal,thick,tinged,tip,truncate,tube,typically,unbranched,unwinged,wall,wet,white,whitish,wide,x	'',0-1,4-6,5-merou,``,absen,ag,along,alyx,capitat,chartaceous,clearly,decurrent,digestion,discussion,distinct,dorsally,eaf,edge,eed,end,enzyme,erec,except,extra,flat,folded,geminat,glabrou,greatly,green-white,hair-like,homostylous,honeycomb-shaped,larger,lengthening,living,lower,membranous,midrib,minutely,nflorescence,one,orolla,pair,placed,plurifoliate,pore,poricidal,proximal,puberulent,reduced,removed,rotate,ruit,see,seudostipule,slit,species,specimen,ste,stolo,subequal,tall,tamen,tem,throughout,tri-,tuber,unequal,unit,vary,yellow,ympodial	'extra,'hair-like,appearance,arrangement,bark,border,branch,bud,calyx,capitate,characteristic,colour,corrugation,erect,exertion,form,fruiting,giving,glabrousnes,growth,height,history,inflorescence,leaf,length,life,lobing,mentioned,midpoint,new,number,ovary,per,prickle,primary,pseudostipule,ray,shape,surface,texture,thicknes,type,variation,vein,width
3	wfo-0001025697	success	181	167	121	60	46	0.669	-9,0-14,0.15-0.75,0.6-3.5,1-1.7,1-2,1-3,1.5-1.8,1.7-8.6,10-26,2-10.5,2-2.6,2-6,25-35,3-10,3-4,3-5,3-6,3.3-11,4-7.5,6.5-13.5,abaxially,acumen,acuminate,acute,adaxially,anther,apart,apex,apparently,articulated,asymmetric,attenuate,axe,axillary,base,basiscopic,berry,blue,brownish,bud,cell,clavate,cm,condition,connivent,coriaceous,corolla,covering,dark,decurrent,deep,diameter,distal,drying,elliptic,exceeding,filament,flower,forked,fresh,fruit,generally,glabrescent,glabrous,globose,green,greenish,hair,half,herb,high,interjected,lanceolate,lateral,leaf,leaflet,light,lilac,linear,lobe,long,make,medium,mm,mucilaginous,odd-pinnate,ovate,ovoid,pedicel,peduncle,perfect,petiole,plant,purple,rachi,ripe,rounded,seed,sessile,short,side,size,slightly,stamen,stigma,straight,stripe,style,subtending,terminal,testal,thick,tissue,tube,unwinged,usually,wall,wet,whitish,x	0.8-2,2-4,5-merou,5.5-11.5,adaxiall,ag,alyx,blade,capitat,decreasing,digestion,dorsally,eaf,edge,eed,enzyme,erec,flat,folded,geminat,glabrou,green-white,hair-like,hal,homostylous,honeycomb-shaped,lengthening,living,lower,nflorescence,orbicular,orolla,pair,pentagonal,petiolulate,plurifoliate,pore,poricidal,removed,rotate,ruit,seudostipule,slit,spaced,specimen,subequal,subglabrou,tall,tamen,tem,throughout,tip,toward,tri-,typically,unit,vary,wood,yellow,ympodial	'hair-like,appearance,arrangement,bark,border,branch,calyx,capitate,characteristic,colour,corrugation,erect,exertion,form,fruiting,geminate,giving,glabrousnes,growth,height,history,inflorescence,length,life,lobing,margin,mentioned,midpoint,new,number,ovary,per,prickle,primary,pseudostipule,ray,shape,stem,surface,texture,thicknes,type,variation,vein,width,woody
4	wfo-0001025699	exception_thrown	181	0	0	181	0	0.0		.2,.5,0.5,1,1-1.5,1-2,1-2.5,1-3,1.5,1.5-2,1/3,10,15-20,2,2-2.5,2-6,2cm,3-15,3-3.5,3-5.5,3-8,4-5,499,5-8,5-winged,5.5-14,8-9,abaxially,absent,acute,adaxially,age,almost,anther,anthesi,apart,apex,apparently,appearing,articulating,attenuate,bark,base,becoming,berry,branching,brown,c.,calyx,campanulate,capitate,cm,completely,conical,conspicuously,continuing,corolla,corrugate,crystal,cup-shaped,dark,darker,deltate,densely,diameter,difoliate,dorsal,dry,drying,eaf,eed,ellipsoid,elliptic,entire,erect,exerted,face,fide,filament,flower,free,fruiting,glabrou,glabrous,globose,green,grey-brown,growth,immature,included,inclusion,inflorescenc,inflorescence,irregularly,lanceolate,leaf,leaf-opposed,leafy,leaving,lengthening,less,lobe,lobed,lower,margin,markedly,midrib,minutely,mm,narrowly,new,nflorescence,nodding,older,one,onto,ovary,oxalate,pair,pale,papillat,papillose,pedicel,peduncle,peg,penden,per,perfect,petiole,plurifoliate,pore,poricidal,portion,primary,red,reddish,reniform,reticulate-pitted,rounded,rounded-sagittate,ruit,sand,scar,shoot,short,simple,slightly,slit,small,somewhat,spaced,stearn,stem,stigma,straight,strongly,style,surface,tangled,thickened,time,tip,tree,triangular,trichome,tube,ud,unit,vein,way,white,white-spotted,wide,wing,winged,woody,x,yellow,ympodial,young,Â½	
5	wfo-0001025700	success	189	168	123	66	45	0.651	0-16,0.30-2.0,0.5-2,0.7-2.7,0.8-2.6,1-3,1.1-2.3,1.5-2,10-40,10.5-12,15-40,2-12,2-7,2.5-4,3-4,3-8,3.5-10.5,3.7-8.6,5-15,5-20,5.5-18,5.5-8,9-31,abaxially,acumen,acuminate,acute,adaxially,anther,apex,apiculate,apparently,articulated,asymmetric,attenuate,axe,axillary,basal,base,basiscopic,berry,blade,brownish,bud,cell,clavate,cm,condition,connivent,corolla,covering,diameter,distal,dot,drying,elliptic,exceeding,filament,flower,forked,fresh,fruit,glabrescent,glabrous,globose,green,greenish,hair,half,herb,high,interjected,lanceolate,lateral,leaf,leaflet,light,lilac,linear,lobe,long,make,medium,mm,mucilaginous,narrowly,odd-pinnate,orbicular,ovate,ovoid,pedicel,peduncle,perfect,petiole,petiolulate,plant,purple,ripe,rounded,seed,sessile,short,side,size,sometimes,stamen,stigma,straight,style,subtending,terminal,testal,thick,tissue,tube,unwinged,usually,wall,wet,white,whitish,winged,x	0.8-4,1-2,4-5,5-merou,5.3-17.5,acuman,ag,alyx,capitat,chartaceous,considerably,decrease,decreasing,digestion,dorsally,eaf,edge,eed,enzyme,erec,except,flat,folded,geminat,generally,glabrou,green-white,hair-like,hal,homostylous,honeycomb-shaped,larger,lengthening,living,lower,nflorescence,orolla,pair,par,pentagonal,plurifoliate,pore,poricidal,proximal,removed,rotate-pentagonal,ruit,seudostipule,slightly,slit,specimen,subequal,subglabrou,tall,tamen,tem,throughout,tip,toward,tri-,typically,unit,vary,whose,yellow,ympodial	'hair-like,appearance,arrangement,bark,border,branch,calyx,capitate,characteristic,colour,corrugation,erect,exertion,form,fruiting,giving,glabrousnes,growth,height,history,inflorescence,length,life,lobing,margin,mentioned,midpoint,new,number,ovary,part,per,prickle,primary,pseudostipule,ray,shape,stem,surface,texture,thicknes,type,variation,vein,width
6	wfo-0001025704	success	248	190	154	94	36	0.621	-10,-2,/6,0,0-2,0-5,0.1,0.1-0.5,0.15-0.8,1,1-4,1-6,1.2-3,1.5-2,1.8-3.5,1/4-3/4,2,2-10,2-3,2-7,2.5-4.5,3-10,3-15,3-6,5-20,5-merous,6-12,8-12,8-15,8-17,abaxial,acute,adaxial,andromonoecious,anther,apart,apex,apically,apiculate,auriculate,bark,base,blade,broad-deltate,calyx,chartaceous,cm,cordate,covering,curved,deltate,densely,diameter,discolorous,distal,distance,drying,elliptic,elongating,erect,extending,filament,flattened,flower,fruit,fruiting,glabrescent,glabrous,gray,half,hermaphrodite,heterostylous,lateral,leaf,length,less,lobe,lobed,lobing,long,long-styled,longer,lower,lowermost,margin,mature,midpoint,midvein,mm,moderately,multangulate,obtuse,occasionally,often,older,orange,orange-brown,ovate,pair,pedicel,peduncle,pendulous,per,petiole,plant,porrect,prickle,prickly,primary,prominent,ray,red-brown,red-green,reflexed,rounded,scar,secondary,sessile,shape,short-styled,shorter,shrub,side,small,sometimes,spaced,sparsely,stalk,stalked,stellate-pubescent,stem,straight,strongly,style,surface,terete,terminal,tertiary,time,tree,trichome,truncate,tube,unarmed,unit,variously,vein,venation,visible,white-gray,wide,woody,yellow-green,young	-3,-5,0-100,0-3.5,0.1-0.3,0.3-0.8,0.5-1.5,0.7-1,1-3.5,1.5-3.2,1.5-4.5,1/2-4/5,1/5,2-4.5,2-5,2.7-4,3-5,4-12,4-5,4.5-6.5,6-15,abaxially,age,almost,alyx,apar,apparently,articulated,axe,ba,berry,branched,brow,cell,connivent,development,eaf,eed,ellipsoid,end,equal,evenly,flattened-reniform,free,green,green-yellow,infructescence,irregular,maturity,mauve,near,nflorescence,one,open,orolla,oung,outline,pale,pericarp,pit,plurifoliat,poricidal,portion,prickl,raised,rarely,recurved,retaining,round,ruit,slender,smooth,somewhat,spherical,spreading,staminat,stellate,stellate-pubescen,stout,tamen,tapering,throughout,tip,unbranched,upper,vary,warty,way,white,widening,yellow,yellowish,ympodial,Ã	appearance,arrangement,border,branch,brown,bud,characteristic,colour,corolla,corrugation,exertion,form,giving,glabrousnes,growth,height,history,inflorescence,interjected,leaflet,life,new,number,ovary,plurifoliate,pseudostipule,seed,size,staminate,stigma,sympodial,texture,thicknes,type,variation,width
7	wfo-0001025729	success	177	198	152	25	46	0.859	-20,.5,/4,0.25-0.5,0.7-1.2,1-1.5,1-5,1.1-1.5,1.2-1.8,1.5-2,1.75,2,2-3.5,20,3-6,4-5,4-8,5-50-flowered,6-8,7-8,9-17,abaxial,abaxially,abrupt,acute,adaxially,along,anther,anthesi,apex,apical,apiculate,axil,bark,basal,base,berry,black,blackish,branched,bright,bristly,bud,calyx,cm,corolla,covered,covering,cyathiform,dark,deflexed,deltoid,densely,denser,dia,differing,difoliate,dirty,drying,elliptic,enclosed,expanded,f,filament,flattened-reniform,fleshy,free,fruiting,furcate,gently,glabrous,globose,green,greenish-yellow,greyish-brown,incrassate,lamina,lateral,leaf,like,live,lobe,lobed,long,main,mainly,major,margin,member,middle,minor,minute,minutely,mm,oblique,occasionally,older,one,opposite,ovary,overlapping,pair,pale,papillose,partially,pedicel,petiole,pit,pitted,plant,portion,prominent,pubescent,quite,raised,reflexed,ripening,rounded,scar,shiny,short,simple,size,sparsely,stem,stigma,stout,straight,style,surface,tall,tapering,terminal,tip,touching,tree,treelet,trichome,tube,tuft,uniseriate,unit,usually,vein,way,white,widening,widest,woody,x,yellow,young	apar,appearing,diam,eaf,edicel,eed,geminat,glabrou,growing,lat,lon,lower,m.,nflorescence,often,overtopping,papillo,pore,poricidal,ruit,shaped,tear-drop,tub,ud,ympodial	..,4-20,apart,appearance,arrangement,border,branch,characteristic,colour,corrugation,diameter,distal,exertion,form,fruit,geminate,giving,glabrousnes,growth,height,history,inflorescence,interjected,late,leaflet,length,life,lobing,midpoint,new,null,number,peduncle,per,prickle,primary,pseudostipule,ray,seed,shape,sympodial,texture,thicknes,type,variation,width
8	wfo-0001025749	success	217	194	154	63	40	0.71	-12,.5,/5,0-10,0-5,0.1-0.3,0.2,0.2-1.5,0.3-1.5,0.4-0.7,0.5-0.8,0.5-0.9,0.5-1.3,0.5-3,0.6-4.5,0.8-0.9,1,1-10,1-13,1-2,1-3,1-6,1-8.5,1-9,1.5,1.5-2,1.5-2.5,2-2.5,2.5-6,2/3,3-20,3-5,4-8,5-10,5-20,6-8,abaxially,acute,adaxially,anther,apart,apex,apically,apparently,bark,base,berry,branched,broad-deltate,calyx,cm,cuneate,curved,dark,densely,diameter,distance,drying,dull,erect,extending,filament,filiform,flattened,flattened-reniform,flower,free,fruit,fruiting,gently,glabrescent,glabrous,gray,green-brown,infructescence,lateral,leaf,length,light,lobe,lobed,long,long-ovate,lower,margin,maturity,mauve,midpoint,midvein,mm,moderately,narrow-deltate,narrow-ovate,oblong,obtuse,occasionally,older,one,open,orange-brown,orange-red,orbicular,ovate,pair,pale,pedicel,peduncle,per,petiole,poricidal,porrect,portion,prickle,prickly,primary,procumbent,purple,rarely,ray,recurved,red-brown,reduced,rounded,sessile,shrub,side,sometimes,spaced,sparsely,spherical,spreading,stalk,stalked,stellate-pubescent,stem,straight,straw-yellow,style,surface,tapering,terete,time,tip,trichome,tube,variously,vein,way,white,wide,yellow,yellow-green,yellow-orange,yellowish	-1,0-3,0-6,0-8,0.1,0.1-0.2,0.1-0.4,0.5,1/4-1/3,1/5-1/2,2-10,5-,5-merous,abaxial,acuminat,adaxial,adnate,almost,alyx,apar,articulated,blade,chartaceous,concolorous,difoliate,discolorous,eaf,eed,elongating,equal,geminat,herbaceous,indistinct,lon,longer,magnification,markedly,mature,nflorescence,orange-brow,orolla,oung,pendulous,perfec,pericarp,prickl,ruit,scar,shorter,smooth,stellate,strongly,tamen,tertiary,toward,unit,usually,vary,venation,visible,without,ympodial,Â½-2/	acuminate,appearance,arrangement,border,branch,bud,characteristic,colour,corolla,corrugation,distal,exertion,form,giving,glabrousnes,growth,height,history,inflorescence,interjected,leaflet,life,lobing,mentioned,new,number,ovary,plant,pseudostipule,seed,shape,size,stigma,terminal,texture,thicknes,type,variation,width,Â½-2/3
9	wfo-0001025754	success	164	173	122	42	51	0.744	-celled,.5,0.5-1,0.5-1.5,1,1-2,1-3,1-3.5,1.5,1.5-3,1.5-4,10-20,10-35,2-4,2-5-celled,2-7,2-foliate,3-10,3-5,4,4-6,5-12,5-15,abaxially,absent,acuminate,acute,adaxially,anther,apex,asymmetrical,axe,base,berry,beyond,blade,branch,brown,calyx,center,chartaceous,ciliate,cm,connected,cordate,cordiform,decumbent,decurrent,densely,diameter,dm,drying,edge,eglandular,entire,equal,exserted,filament,fine,flower,fruit,glabrous,globose,hair,herb,immature,leaf,leaving,like,linear-lanceolate,lobe,long,main,margin,maturing,membranaceous,mm,moderately,much-branched,nearly,notch,oblong,often,palmately,parallel,pedicel,peduncle,per,petiole,placenta,pubescent,rachi,radiating,raised,ridge,running,semitransparent,shallow,short,slightly,small,solitary,sometimes,sparsely,stamen,stem,stigma,straight,style,surface,swollen,triangular,truncate,tube,unbranched,unit,upright,vein,white,woody,x,yellow	0.1-0.2,3-6,abundant,adaxiall,along,barely,dehiscing,denser,dried,eaf,eed,emarginat,erect,explosively,flat,geminat,glandular,held,interpetalar,lower,lying,material,maturit,mesocarp,mixed,nfloresence,orolla,penden,pressure,probably,pubescen,rotate,ruit,tal,tamen,tem,tissue,vary,visible,watery,wid,ympodial	appearance,arrangement,bark,border,bud,characteristic,colour,corolla,corrugation,distal,emarginate,exertion,form,fruiting,geminate,giving,glabrousnes,growth,height,history,inflorescence,infloresence,interjected,lateral,leaflet,length,life,lobing,midpoint,new,null,number,ovary,pendent,plant,prickle,primary,pseudostipule,ray,seed,shape,size,sympodial,tall,terminal,texture,thicknes,type,variation,wide,width
10	wfo-0001025760	success	210	220	198	12	22	0.943	-10,-12,-3,-5,-6,.5,/3,0-0.5,0-100,0.1,0.1-0.2,0.15-0.3,0.2-0.35,0.3-1,0.4-0.8,0.45-0.9,0.5-1.5,0.5-2,0.7-2.5,0.8-1.8,1,1-,1-1.8,1-2,1-4,1.5,1.5-2.5,1.5-4.5,1.5-5,1/4,1/4-1/2,1/4-1/3,1/5,2-2.5,2-3,2.1-3.5,2.3-4,2.5-10,2.5-8,2/3,3,3-6,3.5-17,3.5-9,5-10-merous,5-18,8-10,abaxial,abaxially,acut,acute,adaxial,almost,annual,anther,apar,apex,apically,apparently,articulated,bark,base,berry,black,blade,broad-deltate,brow,calyx,chartaceous,cm,concolorous,connivent,cream,cultivar,cuneate,curved,dark,deltate,diameter,difoliate,discolorous,distance,drying,dull,elliptic,elongating,equal,erect,extending,filament,flattened-reniform,flower,free,fruit,fruiting,geminat,geminate,gently,glabrescent,glabrous,green,hair,herb,infructescence,lateral,leaf,lengt,length,lobe,lobed,long,longer,margin,marking,mature,maturity,membranous,midpoint,midvein,minute,mm,moderately,often,older,one,open,orange,orange-brown,ovate,pair,pale,pedicel,peduncle,pendulous,per,perennial,perfec,pericarp,petiole,poricidal,porrect,portion,primary,ray,recurved,red-brown,reflexe,rounded,scar,sessile,shape,shorter,shrub,side,simple,slender,smooth,sometimes,spaced,spherical,spreading,stalk,stalked,stellate,stellate-pubescen,stellate-pubescent,stem,stout,straight,style,subentire,surface,tapering,terete,tertiary,thick-stalked,time,tip,trichome,tube,unarmed,unbranched,unit,upper,usually,various,variously,vein,venation,visible,way,weakly,white,wide,woody,yellow,yellow-green,young	alyx,eaf,eed,lower,nflorescence,orolla,oung,ruit,tamen,unarme,vary,ympodial	arrangement,branch,bud,characteristic,colour,corolla,corrugation,form,glabrousnes,growth,height,history,inflorescence,life,new,ovary,plant,seed,size,stamen,sympodial,texture
11	wfo-0001025782	success	200	198	160	40	38	0.8	-2,.5,0-10,0-5,0.1-0.15,0.1-0.25,0.3-1,0.4-0.6,0.5-1,0.55-0.75,0.9-1.3,1,1-1.7,1-2,1-2.5,1-4,1.2-6,1.3-1.6,1.5-3,1/4-1/3,1/6,10-13,2-2.5,2-3,2-5,2.5-3.5,2/3-3/4,20,3-4,3-5,4,4-4.5,4.5-9,5-20,5.5-6,6-14,6-8,abaxial,acuminate,adaxial,also,anther,apart,apex,apically,apparently,articulated,bark,base,berry,blade,brown,calyx,chartaceous,climbing,cm,concolorous,conical,connivent,cuneate,curved,deltate,densely,diameter,difoliate,discolorous,distal,distance,drying,dull,elliptic,elongated,elongating,evenly,extending,filament,flattened,flattened-reniform,flower,free,fruit,fruiting,geminate,gently,glabrescent,glabrous,green,green-brown,hair,lateral,leaf,length,less,lobe,lobed,long,long-styled,longer,margin,mature,maturity,membranous,midpoint,midvein,minute,mm,moderately,occasionally,older,one,open,orange-brown,pair,pedicel,peduncle,pendulous,per,petiole,plant,poricidal,porrect,portion,prickle,prickly,primary,ray,reduced,sessile,shrub,side,simple,smooth,spaced,sparsely,spherical,stellate,stellate-pubescent,stem,stout,straight,style,surface,tapering,terete,time,tip,toward,trichome,tube,unbranched,unit,vein,way,weakly,white,wide,woody,yellow,yellow-green,young	0.1-0.2,1/4-1/2,2-10,2-7,5-6.5,5-8,5-merous,abaxially,acuminat,alyx,andromonoecious,apar,eaf,eed,equal,geminat,hermaphrodite,heterostylous,infructescence,lengt,lower,lowermost,nflorescence,orolla,oung,pericarp,prickl,red-brow,ruit,scar,short-styled,shorter,spreading,staminat,tamen,tertiary,vary,venation,visible,ympodial	appearance,arrangement,border,branch,bud,characteristic,colour,corolla,corrugation,exertion,form,giving,glabrousnes,growth,height,history,inflorescence,interjected,leaflet,life,lobing,new,null,number,ovary,pseudostipule,red-brown,seed,shape,size,stigma,sympodial,terminal,texture,thicknes,type,variation,width
12	wfo-0001025783	success	179	171	131	48	40	0.732	.5,0.5,0.5-1.5,0.8-3.5,1-1.2,1-1.5,1-3,1.8-2,2-3+,2-5,2-6.5,3-4,5,7-10,<,abaxially,acute,adaxially,along,anther,anthesi,apex,axil,base,berry,branched,branching,brown,bud,c.,calyx,cell,cm,completely,confined,conical,corolla,dendritic,diameter,ellipsoid,elliptic,entire,expanded,exserted,filiform,flattened,flexuous,flower,free,fruiting,glabrous,globose,green,greyish,groove,growth,keeled,lateral,lax,less,lobe,lobed,long,long/tall,lower,margin,midrib,midvein,minute,minutely,mm,mmm,narrowly,near,new,number,obscured,obtuse,occasionally,pair,pale,pedicel,peduncle,pentagonal,petiole,pitted,point,portion,possibly,primary,pubescent,purple,reniform,revolute,ripe,sagittate,scarious,shiny,shoot,short,shrub,simple,slightly,sometimes,sparse,sparsely,stem,stigma,strongly,style,surface,terminal,testal,thin,time,transparent,triangular,trichome,truncate,tube,tuft,type,uniseriate,upper,vein,vine,violet,way,wide,woody,yellowish	0.5-1,2,5-merou,abaxiall,adaxiall,alyx,apart,ape,ark,articulated,cluster,coriaceous,densely,eaf,eed,erect,exposed,fleshy,glabrou,hromosome,ilament,inserted,known,mature,nflorescence,nodding,older,orolla,outlin,penden,perfect,pericarp,plurifoliat,ruit,scar,see,sleeve,somewhat,spaced,stellate,suture,twinin,ud,unit,vary,weak,within,ympodial	appearance,arrangement,bark,border,characteristic,colour,corrugation,distal,drying,exertion,filament,form,fruit,giving,glabrousnes,history,inflorescence,interjected,leaf,leaflet,length,life,lobing,mentioned,midpoint,outline,ovary,per,prickle,pseudostipule,ray,seed,seen,shape,size,texture,thicknes,twining,variation,width
13	wfo-0001025788	success	158	165	112	46	53	0.709	-8,0-6,0.5-2,1-4,1-5,1.8-2.7,1.8-3.9,10-24,14-48,15-30,2-10,2-13,2-3,2-5,2.8-9.5,2m,3-,4-5.5,4.5-10.1,4.5-12.5,5-8,6-7,6.2-12.5,8-38,abaxially,acumen,acuminate,acute,adaxially,apex,articulate,base,blue,branched,calyx,cell,cm,conical,connate,corolla,covering,cuneate,cyme,deep,diameter,dichasial,dichasially,diminishing,distal,ebracteate,elliptical,exceeding,filament,finely,flower,forked,generally,gradually,green,green-white,half,herbaceous,interjected,lateral,leaf,leaflet,lobe,long,long-attenuate,make,medium,mm,monochasial,mucilaginous,narrowly,oblique,obtuse,odd-pinnate,ovate,ovoid,pair,pedicel,peduncle,perennial,perfect,petiole,petiolule,plant,proximal,pubescent,purple,rounded,seed,size,stamen,stigma,straight,style,subequal,terminal,testal,thick,throughout,tip,toward,tuber-bearing,typically,unit,wall,wide,yellow,Â¼	3-6-foliat,4-3.,abaxiall,apical,apically,attenuate,dehiscent,digestion,dorsally,eaf,edge,eed,emoval,enzyme,flat,folded,globo,hair-like,honeycomb,introrse,living,lon,lower,lunat,maturing,nflorescence,nther,often,orolla,pattern,plan,poricidally,reveal,rotate,ruit,sessile,seudostipule,short,slit,specimen,subsessile,tal,tem,throughou,vary,ympodial	'hair-like,3-6-foliate,4-31,anther,appearance,arrangement,bark,border,branch,bud,characteristic,colour,corrugation,drying,exertion,form,fruit,fruiting,giving,glabrousnes,globose,growth,height,history,inflorescence,length,life,lobing,lunate,margin,mentioned,midpoint,new,number,ovary,per,prickle,primary,pseudostipule,ray,shape,stem,surface,sympodial,tall,texture,thicknes,tube,type,variation,vein,wet,width
14	wfo-0001025792	success	203	168	124	79	44	0.611	0.4-0.7,1-10,1-2,1-3,1-4,10-15,2-3,2-3.5,2.5-3.5,2.5-4,21-28,3-5,3.5-6,4-6,4.5-7,5,5-10,5-9,7-10,7.5-8,8-10,9-12,abaxially,acumen,acuminate,acute,adaxially,anther,apart,apex,apparently,axe,axillary,base,berry,blue-mauve,blue-purple,brownish,bud,cell,ciliate,cm,condition,connivent,corolla,covering,dark,densely,developing,diameter,distal,distinctly,drying,elliptic,especially,filament,flower,forked,fresh,fruit,generally,globose,green,greenish,hair,half,herb,interjected,lanceolate,lateral,leaflet,like,lobe,long,make,margin,mauve,minute,mm,mucilaginous,narrow,narrowly,oblique,odd-pinnate,ovoid,papillose,pedicel,peduncle,perfect,petiole,petiolulate,plant,proximal,pubescent,purple,ripe,rounded,seed,semi-rosette,sessile,short,shortly,size,stem,stigma,streak,style,sub-rosette,subtending,tall,terminal,testal,thick,tinged,tip,tube,usually,wall,wet,white,whitish,wing,x,young	2-11,3-4,4-12,5-6,5-merou,ag,along,alyx,articulated,articulation,auriculate,basiscopic,blade,broadly,capitat,chartaceous,decurrent,digestion,distinct,dorsally,eaf,edge,eed,enzyme,exceeding,except,flat,folded,geminat,glabrou,glabrous,greatly,green-white,hair-like,hal,high,homostylous,honeycomb-shaped,indistinct,lengthening,living,lower,membranous,midrib,minutely,mottle,nflorescence,often,onto,orolla,pair,plurifoliate,pore,poricidal,puberulent,rachi,reduced,removed,rotate-pentagonal,ruit,semi-erec,seudostipule,side,slightly,slit,spaced,specimen,stamen,ste,straight,subequal,tamen,tem,throughout,tri-,unit,vary,yellow,ympodial	'hair-like,appearance,arrangement,bark,border,branch,calyx,capitate,characteristic,colour,corrugation,exertion,form,fruiting,giving,glabrousnes,growth,height,history,inflorescence,leaf,length,life,lobing,mentioned,midpoint,mottled,new,number,ovary,per,prickle,primary,pseudostipule,ray,semi-erect,shape,surface,texture,thicknes,type,variation,vein,width
15	wfo-0001025804	success	155	168	124	31	44	0.8	.25,.5,0.5-1,1-1.5,1-3,1.2-1.5,1.4-1.7,1.5-2,10-20,11-20,16-35,2-2.5,2.5-4,3-4.5,3.5-12,4-10,5,6-8,7-10,?,abaxially,acute,adaxially,anther,anthesi,apex,apiculate,attenuate,bark,base,berry,bilobed,branched,calyx,clavate,cm,conical,corolla,covered,cream,cucullate,dark,decurrent,densely,dia,differing,drying,ellipsoid,elliptic,erect,exserted,filament,flattened,fleshy,flower,free,fruiting,glabrous,glandular,globose,green,incrassate,internodal,later,lateral,leaf,light,lobe,lobed,long,main,major,many,margin,mere,minor,minute,minutely,mm,near,nearly,obovate,occasionally,often,older,onto,opposite,ovary,pair,paler,papillae,papillate,pedicel,pitted,planar,poricidal,portion,projection,red,red-papillose,reddish-brown,reniform,rim,sessile,shrub,size,somewhat,stem,stigma,strongly,style,surface,tall,thick,time,tip,tube,vein,white,whitish-green,wing,winged,x,young	age,apar,ape,ba,c.,deflexed,difoliate,eaf,edicel,eed,geminat,lengthening,lower,middle,nflorescence,papillat,papillose,plurifoliate,pore,reddish-brow,regularly,ruit,scar,slit,spaced,tub,ud,unit,widest,woody,ympodial	appearance,arrangement,border,branch,bud,characteristic,colour,corrugation,diameter,distal,exertion,form,fruit,giving,glabrousnes,growth,height,history,inflorescence,interjected,leaflet,length,life,lobing,mentioned,midpoint,new,number,peduncle,per,petiole,plant,prickle,primary,pseudostipule,ray,seed,shape,terminal,texture,thicknes,type,variation,width
16	wfo-0001025813	success	197	183	138	59	45	0.701	0-2,0.7-1.7,1-1.5,1-10,1-2,1-4,1.2-4.5,1.3-7,1.5-1.8,1.5-6.5,15-30,2-3,3-3.5,3-4,3-5,3-6,3-7,5-18.5,5-6,6-7,abaxially,acumen,acuminate,acute,adaxially,anther,apart,apex,apparently,articulated,axe,base,berry,blade,blue,borne,broadly,brownish,cell,cm,condition,connivent,contracted,corolla,covering,cuneate,dark,decurrent,densely,diameter,distal,distinct,drying,elliptic,end,filament,flower,fresh,fruit,geminat,glabrous,globose,green,green-white,greenish,hair,half,herb,highly,interjected,lanceolate,larger,lateral,leaflet,light,like,lobe,long,longer,make,margin,mm,monochasium,mucilaginous,near,obtuse,odd-pinnate,often,orbicular,ovate,ovoid,pedicel,peduncle,perfect,petiole,petiolulate,pilose,plant,plurifoliate,pubescent,rachi,rarely,seed,sessile,short,single-flowered,singly,size,sometimes,spaced,species,stem,stigma,stolo,straight,strongly,style,suborbicular,terminal,testal,thick,throughout,tri-,tube,tuber,typically,unforked,unit,unwinged,vein,violet,wall,wet,white,whitish,x,yellow,ympodial	'',1.5-2,2-4,2-5,5-merou,``,absent,ag,along,alyx,chartaceous,ciliate,decreasing,digestion,discussion,dorsally,eaf,edge,eed,enzyme,especially,exceeding,extra,flat,folded,glabrou,hair-like,homostylous,honeycomb-shaped,lengthening,living,lower,membranous,midrib,minute,minutely,nflorescence,orolla,ovoi,pair,pore,poricidal,puberulent,removed,rosette-formin,rotate,ruit,see,seudostipule,slit,specimen,stamen,ste,tamen,tem,thir,tip,toward,vary	'extra,'hair-like,appearance,arrangement,bark,border,branch,bud,calyx,characteristic,colour,corrugation,description,exertion,form,fruiting,giving,glabrousnes,growth,height,history,inflorescence,leaf,length,life,lobing,mentioned,midpoint,new,number,ovary,per,prickle,primary,pseudostipule,ray,rosette-forming,shape,surface,texture,thicknes,third,type,variation,width
17	wfo-0001025825	success	187	163	118	69	45	0.631	0-0.21,0.4-1,0.4-3,0.5-10.4,0.7-2.2,0.9-2,1-2,1-3,1-5.5,1.1-1.4,10-24,10.5-26,14-85,2-3.7,2-5,22-86,3-10,3-5,3-8.5,3.7-6.5,4-8,4-9,6-10,6.6-14,abaxially,acumen,acuminate,acute,adaxially,anther,apex,apparently,asymmetric,attenuate,axe,axillary,back,base,basiscopic,berry,brownish,bud,cell,clavate,cm,condition,connivent,coriaceous,corolla,covering,dark,decurrent,diameter,distal,drying,elliptic,filament,flower,forked,fresh,fruit,generally,glabrous,green,greenish,half,herb,interjected,lanceolate,lateral,leaf,leaflet,light,lilac,lobe,long,make,medium,mm,mucilaginous,odd-pinnate,ovate,ovoid,pedicel,peduncle,perfect,petiole,petiolulate,plant,plurifoliate,rachi,rounded,seed,sessile,shiny,side,size,slightly,stigma,streak,style,subtending,terminal,testal,thick,tissue,tri-,tube,unwinged,usually,wall,wet,white,whitish,wide,wing,winged,x	0.5-0.8,0.9-4,5-10,5-7,5-merou,adaxiall,ag,alyx,apart,articulated,blade,capitat,cuneate,decreasing,digestion,dorsally,eaf,edge,eed,enzyme,erec,exceeding,flat,folded,geminat,glabrescent,glabrou,green-white,hair,hair-like,hal,high,homostylous,honeycomb-shaped,increasing,lengthening,living,lower,middle,nflorescence,orbicular,orolla,pair,pentagonal,pore,poricidal,removed,rotate-pentagonal,ruit,seudostipule,short,slit,smaller,spaced,specimen,stamen,straight,subequal,subglabrou,tall,tamen,tem,throughout,tip,toward,unit,vary,yellow,ympodial	'hair-like,appearance,arrangement,bark,border,branch,calyx,capitate,characteristic,colour,corrugation,erect,exertion,form,fruiting,geminate,giving,glabrousnes,growth,height,history,inflorescence,length,life,lobing,margin,mentioned,midpoint,new,number,ovary,per,prickle,primary,pseudostipule,ray,shape,stem,surface,texture,thicknes,type,variation,vein,width
18	wfo-0001025838	exception_thrown	217	0	0	217	0	0.0		-20,.5,0.5,0.5-1,0.7-2,1-1.2,1-1.5,1.2-5,1.5-1.7,1.5-2,1.5-2.5,1.5-3.5,1.5-5,1.8-2,10-15,10-60,2-2.5,2-5,2.5-3,2/3,20-40,3.5-,4-15,4.5-5.5,5,5-merou,6-15,6.5-7,abruptly,acuminate,adaxial,adaxially,ag,along,alyx,anther,anthesi,apart,apex,apiculate,appearing,archin,ark,articulated,attenuate,axil,basall,base,berry,black,branch,branched,broad,brown,calyx,capitate,cell,clavate,clustered,cm,connivent,corolla,cucullate,cup-shaped,dark,decurrent,dendritic,dense,densely,denser,diameter,disintegrating,drying,eaf,eed,ellipsoidal,elliptic,entire,erect,exserted,extending,filament,flattened,fleshy,flower,free,fruit,fruiting,glabrescent,glabrous,globose,greenish,growth,hairy,ilament,inflorescence,inserted,insertion,irregularly,keeled,lamina,lanceolate,lateral,leaf,lengthening,less,like,lobe,lobed,long,loosely,lower,m.,many,margin,membranous,midrib,minute,minutely,mm,mostly,narrowing,narrowly,never,new,nflorescence,nodding,occasionally,often,older,onto,orolla,ovoid,pair,pale,papillat,papillo,pedicel,peduncle,per,perfect,pericarp,petiole,pitted,platform,plurifoliat,point,pointed,pore,poricidal,portion,primary,pubescent,purple,quadrate,reddish,reniform,revolute,ripe,ruit,scar,seed,shin,shiny,short,shrub,simple,sinus,sleeve,slender,slightly,slit,small,sometimes,spaced,sparsely,spreading,square,stellate,stem,stigma,strongly,style,surface,tall,tem,terminal,testal,thi,thin,time,tinged,tip,tree,trichome,tube,tuft,turbinate,twinin,ud,uniseriate,unit,upper,vary,vein,wall,way,weight,white,wing,winged,woody,x,yellow,yellowish,ympodial,Â¾	
19	wfo-0001025845	success	180	160	112	68	48	0.622	.5,0.3-0.5,0.4-1.5,0.5-11,1-1.8,1-4.5,1.5,1.5-13,1.5-2,1.5-2.5,1.5-7,2,2-15,2-5-lobed,2.5-4,3-13,4-5,4-6,5-6,6-6.5,6-9,abaxially,abundantly,acuminate,acute,adaxial,adaxially,along,anther,apart,apex,apiculate,base,branch,brown,calyx,chartaceous,cm,compressed,corolla,cuneate,cylindrical,dark,decurrent,deltate,diameter,distally,eglandular,ellipsoidal,entire,especially,extra-axillary,filament,flattened,flower,fork,fruit,glabrous,green,greenish,herb,lateral,laterally,leaf,light,lobe,lobed,located,longitudinal,margin,membranaceous,minutely,mm,narrowly,obtuse,often,orange,ovoid,pedicel,peduncle,perfect,petiole,pinnately,puberulent,pubescent,purple,rugose-verrucate,sagittate,sand-punctate,shrub,side,simple,sparsely,stigma,stripe,strongly,style,subcordate,tapered,terminal,thick,tip,triangular,truncate,tube,unbranched,unlobed,vein,white,wide,x,yellow	0.5-2.5,1,1-2,2-3,3,3-4,3-6,3-foliat,7-10,aggregate,around,articulated,ascending,axe,ba,blade,cell,channe,connivent,diamete,directed,distall,divided,eaf,eed,elliptic,free,glabrou,inserted,long,lower,major,mesocarp,midrib,near,nearly,nflorescence,obovate,orolla,ovate,part,patch,pore,rachi,radiu,rarely,rotate-stellate,rounded,ruit,shorter,sinus,small,spaced,stone,tal,tamen,tem,thecae,tightly,time,tomento,truncat,unit,vary,veiny,yellowish,ympodial,youn	appearance,arrangement,bark,border,bud,channel,characteristic,colour,corrugation,distal,drying,exertion,form,fruiting,giving,glabrousnes,growth,height,history,inflorescence,interjected,leaflet,length,life,lobing,mentioned,midpoint,new,number,ovary,per,plant,prickle,primary,pseudostipule,ray,seed,shape,size,stem,surface,tall,texture,thicknes,type,variation,width,young
20	wfo-0001025850	success	197	183	142	55	41	0.721	-5,-7,.5,.8,0.5,0.5-,0.5-1,0.5-3,0.6-1,1,1-1.5,1-3,1-celled,1.5,1.5-5,15-20,2,2-6.5,3-4,30,4-5,5-7,6-7,acute,along,anther,anthesi,apex,basal,base,berry,branched,broadly,brown,calyx,capitate,cell,cm,connivent,corolla,cyathiform,deciduous,deltate,denser,diameter,divaricate,divided,drying,ellipsoid,elliptic,elongate,entire,erect,exserted,filament,flattened,fleshy,flower,fruiting,glabrous,gland,glandular,globose,green,growth,half,halfway,inflorescence,irregularly,lamina,later,lateral,lax,less,lobe,lobed,long,loosely,many,margin,membranous,midrib,minute,minutely,mm,narrowly,nearly,new,node,occasionally,often,older,openly,orange,outline,pair,pale,pedicel,peduncle,per,petiole,pinnatifid,pitted,primary,pubescent,reddish,reniform,rhomboid,ripe,rounded,scattered,shallowly,shrub,simple,sinuate,sinus,slender,slightly,soon,splitting,spreading,stem,stigma,strongly,style,surface,tan,terminal,testal,time,tip,trichome,truncate,tube,uniseriate,vein,vine,white,woody,x,yellow,young	2-12,5-merou,abaxial,ag,alyx,apar,apparently,ark,articulated,axi,cupped,deflexed,densely,eaf,eed,em,extending,free,geminat,glabrou,ilament,leaving,lengthening,lower,nflorescence,nodding,orolla,papillate-puberulent,papillo,peg,perfect,planar,plurifoliate,pore,poricidal,portion,puberulen,ruit,scar,shiny,sleeve,slit,small,sometimes,spaced,spreadin,stellate,surfac,thin,tiny,twinin,ud,unit,vary,ympodial	appearance,arrangement,bark,border,branch,bud,characteristic,colour,corrugation,distal,exertion,form,fruit,giving,glabrousnes,height,history,interjected,leaf,leaflet,length,life,lobing,mentioned,midpoint,number,ovary,papillose,plant,prickle,pseudostipule,puberulent,ray,seed,shape,size,texture,thicknes,type,variation,width
21	wfo-0001025872	success	160	182	138	22	44	0.863	.1,.5,0.25-0.5,0.5,0.6-1,1,1-1.3,1-1.5,1-2,1.2-1.5,1.2-1.6,1.7-3,10-25-flowered,2-2.5,2-5,2/3,3.5-4,4-4.5,4.5-13,6-10,6-8,acute,along,anther,anthesi,apart,apex,apically,auriculate,bark,base,becoming,beginning,beneath,berry,blade,branched,bright,broadly,brownish,calyx,capitate,cm,coriaceous,corolla,crinkled,cup-shaped,dark,decurrent,deeply,deflexed,dense,densely,dia,dry,elliptic,exserted,filament,flattened,flattened-reniform,fleshy,flower,free,fruiting,glabrous,glandular-resinous,globose,green,greenish-tan,incrassate,irregularly,later,lateral,leaf,live,lobe,lobed,long,main,margin,material,midrib,minutely,mm,narrowly,occasionally,often,older,onto,opposite,ovary,pair,paler,papillae,papillose,pedicel,petiole,pitted,planar,plant,pore,poricidal,portion,prominent,pubescent,red-papillose,revolute,rounded,rounded-triangular,scar,several,shaped,shrub,somewhat,soon,spaced,specimen,stem,stigma,straight,style,surface,tall,tapering,tear-drop,terminal,thick,thickened,time,tip,tube,vein,visible,way,white,woody,x,young	0.5-1,ba,crowded,eaf,edicel,eed,grayish-brow,inflorescenc,junction,lon,lower,nflorescence,papillo,plurifoliat,ruit,simple,trichome,tub,ud,uniseriate,unit,ympodial	appearance,arrangement,border,branch,bud,characteristic,colour,corrugation,diameter,distal,drying,exertion,form,fruit,giving,glabrousnes,grayish-brown,growth,height,history,inflorescence,interjected,leaflet,length,life,lobing,midpoint,new,null,number,peduncle,per,prickle,primary,pseudostipule,ray,seed,shape,size,texture,thicknes,type,variation,width
22	wfo-0001025893	success	157	158	111	46	47	0.707	.25,.5,0.5-1.5,0.8-1,1-1.2,1-4,1.5-1.7,1.5-2,11-20,2-2.5,2-3,3-5,5-6,6-10,accrescent,along,anther,apex,attenuate,bank,bark,base,bearing,beneath,berry,bi-lobed,branched,broadly,brownish-green,calyx,capitate,cm,corolla,cup-shaped,decurrent,densely,dia,dry,early,ellipsoid,elliptic,even,exserted,faintly,filament,flower,fruit,fruiting,glabrate,glabrous,globose,golden-puberulent,gravelly,green,greyish,growing,impressed,internodal,lateral,leaf,lobe,lobed,long,long-acuminate,longitudinally,main,many,margin,minutely,mm,narrowly,nearly,obovate,occasionally,older,opposite,ovary,ovoid-reniform,pair,pale,pedicel,petiole,pitted,red-papillose,river,rocky,sandy,scar,shaped,shrub,slender,slightly,sometimes,specimen,stem,stigma,stream,style,surface,tall,tapering,tear-drop,time,tube,vein,white,winged,woody,x,yellowish,young	.4,1-1.5,1-2.5,anthesi,barely,beginning,blade,closely,deflexed,deltoid,difoliate,eaf,eed,erect,free,geminate,inflorescenc,lon,lower,material,middle,nflorescence,overlapping,papillo,papillose,planar,plurifoliat,pore,poricidal,portion,puberulent,reflexed,ruit,spaced,straight,striat,thickened,tip,trichome,ud,unicellular,unit,usually,visible,widest,ympodial	1.5,2,appearance,arrangement,border,branch,bud,characteristic,colour,corrugation,diameter,distal,drying,exertion,form,giving,glabrousnes,growth,height,history,inflorescence,interjected,leaflet,length,life,lobing,mentioned,midpoint,new,number,peduncle,per,plant,prickle,primary,pseudostipule,ray,seed,shape,size,striate,terminal,texture,thicknes,type,variation,width
23	wfo-0001025896	success	146	172	116	30	56	0.795	-3,-30,.5-2.5,0.5,0.5-2,1-1.5,1-3,1-6.5,1-8,1.5-2,10-15,2-14,2-2.5,2.5-14,2.5-5,4,4-12,4-23,4-5,4-6,5-15,6-10,6-13,7-,7743,abaxial,abaxially,acosta,acuminate,acute,adaxially,aggregate,also,angled,apex,base,blade,branched,brownish,calyx,cell,chartaceous,cm,connivent,constricted,cuneate,cylindrical,deltate,dendritically,densely,diameter,directed,eglandular,elliptic-ovate,entire,especially,flower,forked,fruit,glabrous,gland,globose,greenish,hair,inflated,like,lobe,long,margin,mm,moderately,near,nearly,obtuse,occasionally,often,orange,ovate,pale,pedicel,peduncle,petiole,pore,present,puberulent,pubescent,purple,radiu,red,ripe,rugose,short-stalked,shrub,simple,smooth,solÃ­,sparsely,stalked,stem,stigma,stone,style,subcordate,surface,time,tip,triangular-ovate,triangular-subulate,tube,unbranched,unit,vein,white,wide,x,yellow	1-25,1.5-9,10-25,5-7,absen,adaxiall,apart,articulated,axe,ba,distall,eaf,eed,lower,many-foliat,membranaceous,nflorescence,nther,orolla,perfect,pubescen,rachi,rotate-stellate,ruit,spaced,tal,tem,truncat,vary,ympodial	absent,anther,appearance,arrangement,bark,border,branch,bud,characteristic,colour,corolla,corrugation,distal,distally,drying,exertion,filament,form,fruiting,giving,glabrousnes,growth,height,history,inflorescence,interjected,lateral,leaf,leaflet,length,life,lobing,many-foliate,midpoint,new,null,number,ovary,per,plant,prickle,primary,pseudostipule,ray,seed,shape,size,sympodial,tall,terminal,texture,thicknes,truncate,type,variation,width
24	wfo-0001025902	success	211	213	172	39	41	0.815	.5,/2,0.1-0.5,0.5-2,0.5-2.5,1-1.2,1-1.5,1.2-1.5,1.5,1.5-2,1.5-3,1/3,11-15,1983,2-6,2.5-4,3-10,4,4-13,4-5,4-6,40,5-6,8-15,>,absent,accompanied,acute,adaxially,aid,along,always,anther,anthesi,apex,articulated,attenuate,axi,bark,base,becoming,beginning,berry,black,branch,branched,branching,broadly,c.,cabrera,calyx,cell,chartaceous,circular,clavate,cm,completely,conical,corolla,deltate,densely,diameter,dull,either,ellipsoid,entire,except,exfoliatin,exserted,fide,filament,flattened-reniform,fleshy,flower,free,fruiting,glabrous,globose,green,growth,inflorescence,lanceolate,lateral,leaf,leaf-opposed,leaving,length,linear,lobe,lobed,long,low,lower,margin,markedly,mature,minute,minutely,mm,new,obscured,occasionally,often,older,one,ovary,pair,pale,papillose,pedicel,peduncle,peg,per,petiole,pitted,plurifoliate,portion,primary,prominent,pubescent,revolute,ridged,rounded,scar,scattered,scrambling,semi-circular,shallow,simple,sleeve,slender,small,sometimes,somewhat,soon,spaced,sparsely,spreading,stem,stigma,strongly,style,surface,tangled,tapering,terminal,testal,time,tip,trichome,tube,twining,ultimate,uniseriate,unit,usually,vegetation,vein,vine,violet,water,way,weak,whitish,widely,wing,woody,x,yellow,yellowish,ympodial,Â½	.2,5-merou,8-10,8-9,abaxially,ag,alyx,apar,ark,berr,climbin,connivent,deciduou,eaf,eed,geminat,ilament,lengthening,less,loosely,midvei,nflorescence,orolla,papillat,pendant,perfect,pericarp,planar,pore,poricidal,rotate-stellate,ruit,semi-aquati,slit,tem,thin,ud,vary,weight	apart,appearance,arrangement,border,bud,characteristic,climbing,colour,corrugation,deciduous,distal,drying,exertion,form,fruit,geminate,giving,glabrousnes,height,history,interjected,leaflet,life,lobing,midpoint,null,number,papillate,plant,prickle,pseudostipule,ray,seed,semi-aquatic,shape,size,texture,thicknes,type,variation,width
25	wfo-0001025906	success	188	157	112	76	45	0.596	0-14,0.1-2,0.15-0.6,0.2-0.6,0.20-0.60,1-2,1.1-2,1.6-12.4,1.8-4.8,16-51,2-4.4,2-6,2.6-5.2,3-10,3-5,4-12,4-7,5-7,5.2-9,8-16,abaxially,acumen,acute,adaxially,anther,apex,apparently,axe,axillary,base,berry,blue,brownish,bud,cell,clavate,cm,condition,connivent,coriaceous,corolla,covering,cuneate,dark,decurrent,diameter,distal,drying,filament,flower,forked,fresh,fruit,generally,glabrous,globose,green,greenish,hair,half,herb,interjected,lanceolate,lateral,leaf,leaflet,light,lilac,linear,lobe,long,make,mm,mucilaginous,obtuse,odd-pinnate,ovoid,pedicel,peduncle,perfect,petiole,plant,plurifoliate,pubescent,purple,rachi,ripe,seed,sessile,shiny,short,size,slightly,stigma,stripe,style,sub-glabrous,subglabrous,subtending,terminal,testal,thick,tri-,tube,unwinged,usually,wall,wet,white,whitish,width,x	1-3,1-6,4-10,4-5,5-6,5-merou,8.5-12.5,adaxiall,ag,alyx,apart,articulated,blade,capitat,decreasing,decurrency,delimited,digestion,diminishing,dorsally,eaf,edge,eed,enzyme,erec,exceeding,falcate,first,flat,folded,geminat,glabrou,green-white,hair-like,hal,high,homostylous,honeycomb-shaped,lengthening,living,lower,next,nflorescence,orolla,pair,pentagonal,pore,poricidal,removed,rotate,ruit,second,seudostipule,slit,smaller,spaced,sparsely,specimen,stamen,straight,subequal,subglabrou,tall,tamen,tem,third,throughout,tip,toward,typically,unit,vary,well,wood,yellow,ympodial	'hair-like,appearance,arrangement,bark,border,branch,calyx,capitate,characteristic,colour,corrugation,erect,exertion,form,fruiting,geminate,giving,glabrousnes,growth,height,history,inflorescence,length,life,lobing,margin,mentioned,midpoint,new,number,ovary,per,prickle,primary,pseudostipule,ray,shape,stem,surface,texture,thicknes,type,variation,vein,woody
26	wfo-0001025907	success	148	166	121	27	45	0.818	-4,.05,.5,.5-1,0,0-60,0.8-1.8,1,1-1.2,1-2.3,1-3,1-5,1.5-2,1.5-2.2,10-15,12-45,2,2-3.5,2-8,2/3,3-,3-4,3/2,4-5,5-15,acuminate,acute,along,anther,anthesi,anticlinal,apex,attenuate,axil,axillary,base,beak,bearing,berry,brown,c,calyx,cm,conical,conspicuously,deciduous,densely,diameter,elliptic,filament,flattened,flower,free,fruit,fruiting,glabrous,globose,green,greenish,growth,highly,included,iquito,irregular,isolated,lamina,lobe,lobed,long,lower,margin,minutely,mm,near,nearly,new,obovate,open,ovary,ovoid-reniform,pair,papillate,papillose,pedicel,per,petiole,plant,population,portion,primary,projection,pubescent,red-papillate,reflexed,remaining,round,scar,scattered,seed,shrub,simple,single-stemmed,sinuous,size,slender,soon,sparsely,stigma,style,surface,thickening,time,tip,trichome,truncate,tube,uniseriate,vein,white-lenticellate,without,x	absent,anthesis5-7,appearing,breaking,cell,clavat,eaf,edicel,eed,epidermal,erec,lon,nflorescence,occasionally,poricidal,raised,rugose,ruit,tal,tem,tub,ud,unifoliat,unit,variable,white,ympodial	5-7,appearance,arrangement,bark,border,branch,bud,characteristic,clavate,colour,corolla,corrugation,distal,drying,exertion,form,giving,glabrousnes,height,history,inflorescence,interjected,lateral,leaf,leaflet,length,life,lobing,midpoint,null,number,peduncle,prickle,pseudostipule,ray,shape,stem,tall,terminal,texture,thicknes,type,unifoliate,variation,width
27	wfo-0001026203	success	197	166	122	75	44	0.619	0-39,0.06-0.86,0.3-11,0.3-6,0.38-11.3,0.4-3,0.5-2.3,0.5-3.2,0.7-2.6,1-13,1-2,1-9,1.1-7.9,1.2-5.5,2-10,2-4.9,2-43,2-5,2-8.5,2.2-13.3,3-10,3-11,3-5,3.2-22,3.2-23,7-47,abaxially,acumen,acuminate,acute,adaxially,anther,apex,asymmetric,attenuate,axillary,base,basiscopic,berry,blue,brownish,bud,cell,clavate,cm,condition,coriaceous,corolla,covering,dark,decurrent,deep,diameter,distal,drying,elliptic,erect,filament,flower,forked,fresh,fruit,generally,glabrescent,glabrous,globose,green,greenish,hair,half,herb,interjected,lanceolate,lateral,leaf,leaflet,light,lilac,linear,lobe,long,make,medium,mm,moniliform,mucilaginous,odd-pinnate,ovate,ovoid,pedicel,peduncle,petiole,plant,rachi,ripe,rounded,seed,sessile,short,side,size,slightly,sometimes,stigma,stripe,style,subtending,terminal,testal,thick,tissue,tube,tuber,typically,unwinged,usually,wall,wet,white,whitish,wide,x	0-7,1-4,1-5,5-merou,ag,along,alyx,apart,apparently,arranged,articulated,axe,bead,blade,capitat,connivent,decreasing,digestion,dorsally,eaf,edge,eed,enzyme,exceeding,flat,folded,geminat,glabrescen,glabrou,green-white,hair-like,hal,high,homostylous,honeycomb-shaped,lengthening,like,living,lower,middle,multiple,necklace,nflorescence,orbicular,orolla,pair,pentagonal,perfect,plurifoliate,pore,poricidal,removed,rosett,rotate,ruit,seudostipule,slit,spaced,specimen,stamen,stolon,straight,subequal,subglabrous,tall,tamen,tem,throughout,tip,toward,tri-,unit,vary,yellow,ympodial	'hair-like,appearance,arrangement,bark,border,branch,calyx,capitate,characteristic,colour,corrugation,exertion,form,fruiting,giving,glabrousnes,growth,height,history,inflorescence,length,life,lobing,margin,mentioned,midpoint,new,number,ovary,per,prickle,primary,pseudostipule,ray,rosette,shape,stem,surface,texture,thicknes,type,variation,vein,width
28	wfo-0001026208	success	214	218	178	36	40	0.832	-1/2,-10,-3,-5,/3,0,0-20,0-4,0-8,0.1,0.1-0.2,0.1-0.25,0.1-0.3,0.5-0.8,0.6-0.8,0.6-0.9,0.7-2,0.8-1.3,0.8-1.5,1-2,1-4,1-5,1.5,1.5-2.5,1.8-2.3,1.8-2.5,1/3,1/4-1/3,1/4-1/6,11-25,2,2-3,2.5-5,3-30,3-6,3.5-5,4-7,4-9,5,5-,5-17,6-22,6-8,abaxial,abaxially,acuminate,acute,adaxial,anther,apart,apex,apically,bark,base,becoming,berry,blade,bright,broad-deltate,brown,calyx,chartaceous,cm,conical,connivent,cuneate,curved,dark,deltate,densely,diameter,difoliate,discolorous,distance,drying,dull,elliptic,elongated,elongating,erect,evenly,extending,filament,flattened,flattened-reniform,fruit,fruiting,geminate,glabrescent,glabrous,gray-greenish,green,green-brown,infructescence,lateral,leaf,length,lobe,lobed,long,longer,lower,margin,mature,maturity,mauve,membranous,midpoint,midvein,mm,moderately,older,orange,orange-brown,ovate,pair,pale,pedicel,peduncle,pendulous,per,pericarp,petiole,poricidal,porrect,prickle,prickly,primary,pubescent,ray,recurved,red,rounded,sessile,shorter,shrub,side,slender,smooth,sometimes,somewhat,spaced,sparsely,spherical,spreading,stalk,stalked,stellate,stellate-pubescent,stem,stout,straight,straw-yellow,style,subentire,surface,tapering,terete,terminal,tertiary,time,tip,toward,trichome,tube,unarmed,unit,usually,variously,vein,venation,visible,way,white,wide,woody,yellow,young	.5,0-5,0.5-1.2,2-20,2-4,2.5-6,3-5,3/,5-22,5-merous,acut,alyx,apar,apparently,articulated,branched,eaf,eed,equal,flower,free,geminat,nflorescence,one,open,orolla,oung,perfec,portion,red-brow,ruit,scar,tamen,unarme,vary,ympodial	3/4,appearance,arrangement,border,branch,bud,characteristic,colour,corolla,corrugation,distal,exertion,form,giving,glabrousnes,growth,height,history,inflorescence,interjected,leaflet,life,lobing,new,null,number,ovary,plant,pseudostipule,red-brown,seed,shape,size,stigma,sympodial,texture,thicknes,type,variation,width
29	wfo-0001026215	success	150	175	127	23	48	0.847	-3,.05,.5,0,0.05,1,1-3,1.5,1.5-2,1.5-2.2,13-35,18-20,2,2-3,2-3.5,2-4,3/4,4-15,4-5,7-8,abaxially,abruptly,absent,acuminate,along,anther,anthesi,anticlinal,apex,axil,axillary,base,beak,berry,broadly,brown,calyx,cell,clavate,cm,completely,conical,conspicuously,continually,corolla,deltate,densely,diameter,elliptic,enlarged,entire,epidermal,erect,exserted,filament,flattened-round,flower,fruit,fruiting,glabrous,globose,green,greenish,herb,highly,horizontal,internode,irregular,kink,length,less,lobe,lobed,long,marked,markedly,minutely,mm,narrowing,nearly,occasionally,often,onto,ovary,ovoid-reniform,pair,papillae,papillate,pedicel,per,petiole,poricidal,portion,primary,projection,purple,raised,rounded,rugose,scar,seed,shrub,simple,single-stemmed,sinuous,small,stem,stigma,strongly,style,surface,thickening,time,tip,tube,unit,usually,vein,way,white,white-lenticellate,white-pubescent,wide,wing,winged,without,x	0.5-1,15-2,ape,bifi,eaf,edicel,eed,free,lower,nflorescence,noddin,nodding,papillat,red-papillose,reflexed,ruit,shortsympodial,ste,tal,tem,tub,ud,unifoliat	appearance,arrangement,bark,bifid,border,branch,bud,characteristic,colour,corrugation,distal,drying,exertion,form,giving,glabrousnes,growth,height,history,inflorescence,interjected,lateral,leaf,leaflet,life,lobing,margin,midpoint,new,null,number,peduncle,plant,prickle,pseudostipule,ray,shape,short,size,sympodial,tall,terminal,texture,thicknes,type,unifoliate,variation,width
30	wfo-0001026229	success	299	278	212	87	66	0.709	0.2â0.8,0.35,0.3â0.9,0.3â1.2,0.4,0.8â1.2,0.9,1,1-celled,1.2â4.8,1.4,1.7â11.8,1.8,13,1â4,2,2â3,2â3-celled,3,35,3â5,4â6,5,abaxial,abaxially,accrescent,acuminate,acute,adaxial,adaxially,almost,also,always,anther,apex,ark,associated,asymmetric,attenuate-caudate,base,beneath,berry,black,blade,branch,branching,broadly,broken,brown,calyx,camptodromous,capitate,celled,central,changing,clavate,cm,commonly,concentrated,cordate,corolla,covered,creating,cuneate,cylindrical,cyme,dark,deltoid,densely,developed,diameter,discolorous,diÂ­,drying,ellipsoidal,elliptic,elongated,entire,even,few-rayed,flattened,flower,found,free,frequently,fresh,fruit,fully,geminate,glabrescent,glabrous,gland,glandular,glandular-capitate,globose,golden,green,growth,hair,head,hirsute,hispid,hyaline,immature,included,inflorescence,insertion,internodal,involute,irregular,lamina,lanceolate,lateral,leaf,less,lobe,lobed,long,long-stalked,longer,margin,mature,membranaceous,midpoint,midvein,minute,mixed,mm,moderately,much,multangulate,multangulate-stellate,multiseriate,narrow-ovate,narrowly,near,nearly,new,oblong,often,old,older,one,orientation,other,ovate,ovate-elliptic,pale,papillose,pedicel,peduncle,per,petiole,pit,plurifoliate,poorly,porrect-stellate,portion,primary,pubescent,purple,rachi,rarely,ray,remnant,reniform,revolute,rounded,secondary,sessile,shin,shiny,short-,short-stalked,shorter,shrub,simple,size,slightly,small,smaller,solitary,sometimes,somewhat,spreading,stalk,stem,stigma,strongly,style,subopposite,subsessile,supported,surface,terminal,tree,trichome,trifoliate,tube,type,unbranched,unit,upper,usually,vein,vestiture,visible,weakly,white,whitish-green,wide,yellowish-white	0.1â1.47,0.8â2,0.9â4.3,1.3â1.5,1.3â1.7,1.7â2.3,1.8â5.5,1.9â2.5,1/3,1â1.4,1â2,2.3â3.4,2.8â4,2â4-celled,3â4,4.5â6.5,5-merou,5â9,6â15,6â7,6â8,8.6â12,8â10,9â31,adaxiall,ag,alyx,anthesi,articulated,axe,ba,barely,commentary,completely,connivent,develope,differing,directed,dried,eaf,eed,eglandular,faces,ilament,impressed,introrsely,larger,like,longitudinal,lower,mainly,material,maturit,midri,nflorescence,open,opening,orolla,oung,pair,paired,pedunculate,perfect,pink,point,pore,poricidal,purplish,ra,raised,ruit,see,slit,sparsely,spread,spreadin,stellate,surfac,three,tuft,ud,unequal,vary,venation,yellow,ympodial,Â¾	--,0.3,0.8,1.2,1.3,1.7,1.9,10,11.8,12,2.3,2.5,2.8,3-celled,3.4,3/4,31,4,4-celled,4.3,4.5,4.8,5.5,6,6.5,7,8,8.6,9,appearance,arrangement,bark,border,bud,characteristic,colour,corrugation,distal,exertion,filament,form,fruiting,giving,glabrousnes,height,history,interjected,leaflet,length,life,lobing,mentioned,midrib,number,ovary,plant,prickle,pseudostipule,seed,shape,sympodial,texture,thicknes,variation,width,young
31	wfo-0001026230	success	144	151	112	32	39	0.778	.25,.5,.8,0.3-1.5,0.5-3,0.75-1,0.9-2,1-1.4,1-1.5,1-4,1.1-1.8,1.8-2.3,1.9-4.1,12.6-20.8,2-4,2-5,3-4,4.6-9.3,5-10,5-20-flowered,acuminate,acute,anther,anthesi,apex,apiculate,area,back,bark,base,beneath,berry,broadly,bud,calyx,clavate,cm,cordate,corolla,deltoid,dia,distal,elliptic,erect,except,filament,free,fruit,fruiting,glabrous,globose,green,grey,immature,large,lateral,leaf,lobe,lobed,long,long-triangular,main,major,margin,middle,minor,minutely,mm,nearly,obtuse,older,opposite,orbicular,ovary,ovoid,pair,papillose,pedicel,petiole,pore,poricidal,portion,raised,reflexed,rounded,rusty-papillose,shaped,shrub,simple,slender,slightly,small,stem,stigma,straight,style,surface,tall,tapering,tear-drop,tip,tree,tube,umbonate,unknown,vein,white,widest,winged,woody,x,young	anisomorphic,anisophyllou,apart,appears,beginning,clu,completely,coroll,deflexed,difoliate,eaf,edicel,eed,enclosing,evenly,geminate,inflorescenc,lon,long-acuminate,lower,nflorescence,pointed,ruit,scar,sinus,spaced,strongly,thickened,ud,unit,white-lenticellat,ympodial	appearance,arrangement,border,characteristic,club,colour,corrugation,diameter,drying,exertion,form,giving,growth,history,inflorescence,interjected,leaflet,length,life,lobing,midpoint,null,number,peduncle,per,prickle,primary,pseudostipule,ray,seed,shape,size,terminal,texture,thicknes,type,variation,white-lenticellate,width
32	wfo-0001026233	success	165	166	114	51	52	0.691	-1,-1.9,-3.8,-5.5,-50,.25,0.3,0.5,0.7-,0.7-0.8,0.8-1.3,0.8-1.55,0.8-4,1,1-,1.1,1.2-2.7,1.5,1/2,2,2-,2.1,2.3-7,2.4-3.5,2.6,2/3,3.2-3.7,3.2-4.7,3.5-4.5,5-30,6,acute,annual,anther,antrorse,apex,ascending,basal,base,bearing,berry,broadly,calyx,capitate,cm,coat,conspicuous,cuneate-attenuate,densely,diameter,ellipsoidal,elliptic,entire,evident,few-,filament,fruiting,globose,hair,herb,herbaceous,hig,lamina,larger,leaf,less,lilac,lobe,lobed,long,longitudinally,margin,mm,moderately,multicellular,narrowly,non-glandular,obtuse,ovate,pale,papery-scarious,petiole,pinnatisect,portion,protuberance,pubescent,reticulate,ridged,rounded,scarcely,seed,shorter,simple,slender,slightly,small,sparsely,stigma,striate,style,subglobose,surface,tem,trans-ovoidal,trichome,tube,tuberculate,unequal,uniseriate,verrucose,wider,winged,x,yellow	-8.1,.75,4-,5-6.2,abundant,accrescent,ag,annular,articulated,campanulate,curved,cylindrical,difoliat,dimorphic,eaf,eed,embryo,glabrous,interlobular,investing,longitudinal,lower,membrane,minutely,near,occasionally,opening,orolla,other,outer,ovule,partially,pinnatipartite,pore,poricidal,present,pubescen,ree,ruit,seede,serrate,slit,smaller,strongly,styl,tip,unifoliate,unit,vary,venatio,ympodial	appearance,arrangement,bark,border,branch,bud,characteristic,colour,corolla,corrugation,distal,drying,exertion,form,free,fruit,giving,glabrousnes,growth,height,history,inflorescence,interjected,lateral,leaflet,length,life,lobing,mentioned,midpoint,new,number,ovary,pedicel,peduncle,per,plant,prickle,primary,pseudostipule,ray,shape,size,stem,terminal,texture,thicknes,type,variation,vein,venation,width
33	wfo-0001026241	exception_thrown	220	0	0	220	0	0.0		.2,.3,.5,0.1â0.15,0.2â,0.3â,0.3â0.4,0.3â0.6,0.3â1,0.5,0.5â0.7,0.5â0.8,0.5â1,0.7â1.1,1-,1-celled,1.2â1.5,1.2â2,1.5â1.7,1.5â2.5,1.5â3.5,1.9â2.1,1/3â1/2,10-20,109,1â,1â1.1,1â1.4,1â1.5,1â2,2-flowered,2.5â3,2â2.1,2â3,3,3-,30â50,3â3.1,4-,4.5â5,5,5-celled,5-merous,6,abaxially,adaxially,always,anther,anthesi,apex,apical,appearing,appears,articulated,attenuate,ba,basal,base,basiscopically,beak,berry,black,branching,brittle,broader,brown,calyx,campanulate,capitate,cell,center,cm,conical,connecting,cordate,corolla,covered,cup,curved,curving,darker,decurrent,deflexe,dehiscing,deltate,densely,denser,depressed-globose,dia,difoliate,discrete,dry,drying,dwarf,eaf,eglandular,elliptic,enclosed,entire,equal,erect,erose,et,extended,filament,flower,foliat,foliose,free,fruit,fruiting,galiano,geminate,glabrous,gland,glandular,glandular-pubescent,globose,herb,inflorescence,internodal,intially,irregularly,larger,lateral,leaf,leaflet,like,lobe,lobed,lon,long,longitudinal,main,margin,midvein,mixture,mm,much,near,nflorescence,oblique,one,onto,open,orangish,outline,ovary,ovate,ovoid,papillat,papillate,pedicel,peduncle,per,perennial,perfect,pericarp,petiole,pinnatifid,pitted,pore,portion,prolonged,pubescen,pubescent,pulp,rachi,remain,reniform,robust,ruit,seed,shallowly,shiny,simple,sinuate,slightly,slit,small,smaller,sometimes,somewhat,spatulate,stamen,stellate,stem,stigma,stout,strongly,style,subshrub,succulent,sulcate,surface,taproot,terminal,ternate,testa,thick,thickened,tip,tissue,triangular,trichome,truncate,tube,tuberculate,ud,uniseriate,unit,usually,vein,way,white,wide,wing,woody,x,ympodial	
34	wfo-0001026242	success	210	176	133	77	43	0.633	-0.9,/4,0,0.05-0.2,0.1,0.3-0.5,0.35-,0.4-0.55,0.4-2,0.5,0.55-0.9,1.2-2,1/2,10-,2-2.5,2-5,2.5-2.8,2.5-4.5,3-6.5,30-80,4-10,4.5-5.5,5-,5-18,6.5-8,7-17,8-20,almost,ame,anther,apart,apex,bark,base,berry,blade,bright,c.,calyx,cm,concolorous,connivent,curved,densely,diameter,difoliate,drying,dull,elongating,erect,evenly,filament,filiform,flattened,flattened-reniform,fruit,fruiting,glabrescent,glabrous,glandular,green,hair,infructescence,largely,lateral,leaf,length,lobe,lobed,long,longer,margin,mature,maturity,membranous,midpoint,minute,mm,multangulate,narrow-deltate,occasionally,older,orange-brown,pale,pale-brown,pedicel,peduncle,per,petiole,poricidal,porrect,prickle,prickly,primary,ray,red,red-brown,reflexed,sessile,shorter,shrub,simple,smooth,sometimes,spaced,sparsely,spherical,spreading,stalk,stalked,stellate,stellate-pubescent,stem,straight,style,subentire,surface,tapering,terete,time,tip,trichome,tube,unarmed,unit,upper,variously,vein,way,wide,woody,yellow,young	-1.5,-2,-5,-6,0-2,0.4-0.5,0.5-0.7,0.5-1,0.7,0.7-1.3,1-1.5,1-2.5,1-3,1.5-3,1.5-4,1/5-1/3,1/6-1/4,10-20,4-13,4-5-merous,5-7,abaxial,abaxially,acut,acute,alyx,apar,apically,apparently,articulated,branched,broad-deltate,cuneate,deltate,distance,eaf,eed,elliptic,equal,extending,eye,flower,free,geminat,glabrou,green-gra,irregularly,lower,midvein,moderately,naked,nflorescence,obtuse,one,open,orolla,oung,pair,perfec,pericarp,portion,prickl,recurved,rounded,ruit,scar,shorte,side,tamen,tertiary,unarme,vary,venation,visible,weakly,white,ympodial	appearance,arrangement,border,branch,bud,characteristic,colour,corolla,corrugation,deltoid,distal,exertion,form,geminate,giving,glabrousnes,green-gray,growth,height,history,inflorescence,interjected,leaflet,life,lobing,minutely,new,null,number,ovary,plant,pseudostipule,seed,shape,size,stigma,sympodial,terminal,texture,thicknes,type,variation,width
35	wfo-0001026259	success	233	208	170	63	38	0.73	.1,.7,.8,0.1â0.2,0.3â1.2,0.4â0.6,0.7â0.9,0404,1.0â1.2,1.0â3.3,1.2â8.4,1.4â4.0,1.5,11â22,12â24,1m,1â2-celled,1â3-celled,2-ridged,2/3,2â17,2â3-celled,3.0â3.4,35â45,4â5,5â14,5â7-celled,6,7â10,8â11,?,abaxial,acuminate,acute,adaxial,adaxially,affected,anther,anthesi,apex,appressed,arising,base,becoming,berry,branch,branching,broadly,brown,calyx,cell,central,close,cm,coloured,concave-reniform,conical-ellipsoid,corolla,cylindrical,decurrent,dehiscing,deltate,densely,diameter,ellipsoid,end,entire,especially,et,exerted,filament,fleshy,flower,free,fruit,fruiting,glabrous,globose,gradually,green,green-orange,halfway,herb,individual,inflorescence,internodal,knapp,larger,lateral,leaf,length,less,like,lilac,lobe,lobed,long,margin,membranous,minutely,mm,much,narrower,narrowly,nearly,node,occasionally,often,once-branched,one,outline,ovary,ovate-lanceolate,pair,papillate,pathogen,pedicel,peduncle,pentagonal,per,petiole,plant,portion,primary,pubescent,purple,purple-black,purple-coloured,rarely,recurving,reduced,ripe,rounded,shrub,similar,simple,slightly,somewhat,sparsely,splitting,spreading,star,stem,stigma,stout,straight,strongly,style,surface,tall,tapering,testal,tinged,together,toward,translucent,trichome,tube,turning,two,uniseriate,vein,white,wide,winged,woody,yellow,yellow-green,young,â15	0.2â0.4,0.5,0.5â0.6,0â2,1,1-celled,1.5â2.0,1â2,5-merous,abaxially,age,apar,beyond,branched,cone,congested,cream-coloured,difoliate,drop,eaf,eed,elongating,geminat,growt,hilum,leave,lengthening,live,lon,longer,lower,lowermost,near,nflorescence,pale,perfect,pericarp,pore,poricidal,positioned,rachi,reflexed,relatively,remaining,ruit,scar,shiny,short,shorter,slit,smooth,sometimes,spaced,stellate,stone,sub-laterally,tem,thick,tightly,tip,ud,unit,ympodial	.5â0.6,appearance,arrangement,bark,border,bud,characteristic,colour,corrugation,distal,drying,exertion,form,giving,glabrousnes,growth,height,history,interjected,leaflet,life,lobing,midpoint,new,null,number,prickle,pseudostipule,ray,seed,shape,size,terminal,texture,thicknes,type,variation,width
36	wfo-0001026267	success	162	179	134	28	45	0.827	.25,.5,0.1-1,0.5-1,0.6-1.7,0.7-1.1,1-1.2,1-1.5,1-2.6,1-4,1.5-2,1.5-2.3,2.5-3,20-30-flowered,3-15,3-6.1,3.2-8.6,4-8,5-7,8-10,8.5-15,acuminate,acute,anther,apex,attenuate,axil,bark,base,beginning,beneath,berry,blackish,body,bright,broadly,calyx,closely,cm,corolla,crateriform,cuneate,decurrent,deflexed,depressed,dia,difoliate,distally,distinct,drying,except,exerted,filament,flattened-reniform,free,fruiting,glabrous,globose,green,greenish-white,greyish-green,hard,incrassate,larger,lateral,leaf,lobe,long,main,major,margin,maturity,middle,minor,minutely,mm,narrowly,occasionally,older,opposite,ovary,ovate,overlapping,pair,pale,papillose,pedicel,petiole,pitted,pitting,pore,poricidal,portion,pubescent,quickly,raised,remaining,ripening,rough,scar,scattered,shaped,shrub,size,slender,slightly,small,softening,soon,spaced,stem,stigma,straight,style,surface,tan,tapering,tear-drop,tip,tree,triangular,trichome,tube,tuft,uniseriate,unit,vein,widest,wing,winged,woody,x,yellow-green,young	anthesi,ba,densely,differing,eaf,edicel,eed,geminat,inflorescenc,lavender,lobed,lon,longinflorescence,lower,nearly,often,one,papillo,reflexed,ruit,scarious,simple,sparsely,tall,tinge,ud,white,ympodial	appearance,arrangement,border,branch,bud,characteristic,colour,corrugation,diameter,distal,exertion,form,fruit,geminate,giving,glabrousnes,growth,height,history,inflorescence,interjected,leaflet,length,life,lobing,midpoint,new,null,number,peduncle,per,plant,prickle,primary,pseudostipule,ray,seed,shape,sympodial,terminal,texture,thicknes,type,variation,width
37	wfo-0001026279	success	248	194	155	93	39	0.625	-2.9,-34.3,-4,-5.9,/14-1/8,0.2-0.4,0.25-0.4,0.8-2.3,0.9-1.8,1-10,1-3.5,1.1-1.6,1.1-1.9,1.5-1.8,1.9-3,1.9-3.2,1/2,11.5-19.7,14-27,2/3,3-4,3.1-4.2,3.4-5.2,3.5-7.8,3.8-5.1,5-200,5-8,8,8-11,9-22,abaxially,acuminate,adaxially,anther,anthesi,apart,apex,appressed,articulated,attenuate,axe,base,berry,black,blade,blunt-tipped,branch,branched,brown,bud,calyx,capitate,chartaceous,closely,cm,conical,corolla,cuneate,dark,deltoid,dendritic-echinoid,diameter,drying,echinoid,elliptic,elongated,entire,exerted,expanded,few-rayed,filament,fleshy,flower,fruit,fruiting,glabrescent,glabrous,globose,granular,grayish,grayish-green,green,hair,immature,lanceolate,lateral,lavender,leaf,length,lilac,lobe,lobed,long,main,many,margin,mature,midrib,minute,mixed,mm,multangulate,narrowly,oblong,obovate,occasionally,orbicular,overlapping,pale,pedicel,peduncle,petiole,porrect-stellate,pseudo-terminal,pubescence,rachi,reticulate-punctate,rounded,scabridulous,scabrous,scattered,sessile,short,short-decurrent,short-stalked,shrub,side,simple,slightly,slowly,spaced,stem,stigma,style,subcampanulate,suborbicular,sulcate,surface,tall,time,tomentose,tomentose-pubescent,tree,tube,unarmed,unwinged,vein,way,white,whitish,wide,x,yellowish,yellowish-tan,young	-11.4,0.9-1,1-1.4,1.5-3,1.7-2.3,2.4-3.2,2.5-3.2,2.6-4.8,3.1-3.6,4-7.5,8.5-10.5,accrescent,acute,adaxiall,ag,apparently,appearing,ark,around,axillary,ba,completely,covering,cylindrical,dendritic-echinoi,dense,directed,distally,due,eaf,earl,echinoi,edge,eed,enveloping,equal,evident,farinose,free,glabrescen,half,inserted,lengthening,long-stalked,longer,longitudinal,longitudinall,lower,m.,multangulate-pubescent,multiseriate,nflorescence,occasional,often,older,open,orolla,ovate-lanceolate,partly,perfect,plant,plurifoliate,pore,poricidal,present,prominent,ruit,secondary,semi-ovate,short-,slit,somewhat,splitting,stalk,stamen,stellate,subcoriaceous,subsessile,suture,tamen,tertiary,thickened,thin,thin-stalked,tip,ud,unarme,unit,upper,usually,vary,yellow,ympodial	appearance,arrangement,bark,border,characteristic,colour,corrugation,distal,exertion,form,giving,glabrousnes,growth,history,inflorescence,interjected,leaflet,life,lobing,longitudinally,mentioned,midpoint,new,number,ovary,per,prickle,primary,pseudostipule,ray,seed,shape,size,terminal,texture,thicknes,type,variation,width
38	wfo-0001026299	success	239	214	178	61	36	0.745	--,-1,-10,-2.5,-3.5,-5,0-8,0.1-0.2,0.1-0.4,0.15-0.2,0.2-0.25,0.25-0.5,0.4-0.5,0.4-2,0.5,0.5-0.6,0.5-0.7,0.5-1,0.5-2.5,0.6-2,0.7-3.5,0.8-1,0.9-1,1,1-1.4,1-celled,1.1-1.7,1.2-1.6,1.2-5,1.5-,1.5-2.3,1.8-2,2-6,2-foliate,2-locular,2.2-3.2,2.5,2.5-7,25,3-,3.5-10,5-15,5-20,6-20,7-12,acute,almost,anther,anthesi,apex,appearance,approximately,basal,base,basiscopically,beneath,bract,bracteate,broadly,brown,calyx,capitate,cell,change,chota,cm,conical,corolla,could,crenate-serrate,dark,decurrent,densely,diameter,distal,ebracteate,elliptic,entire,erect,exserted,filament,flower,fruit,fruiting,give,glabrous,glandular,globose,green,hair-like,half,head,herb,imparipinnate,inflorescence,interjected,intermixed,internode,interrupted,investing,irregularly,jequetepeque,lanceolate,larger,lateral,leaf,leaflet,like,lobe,lobed,long,long-acuminate,longer,loosely,maraÃ±Ã³n,margin,maturity,minute,minutely,mixture,mm,multicellular,narrowly,nearly,node,oblique,obovate,often,outgrowth,ovary,pale,patent,pedicel,peduncle,perennial,petiole,population,primary,prostrate,pseudostipule,pubescent,purple,rachi,regularly,short,silky,simple,size,sparse,spreading,stem,stigma,straight,stripe,style,surface,tall,terminal,testa,thick,trichome,truncate,tube,unicellular,uniseriate,unit,usually,valley,variously,vein,velvety,wall,way,white,wide,winged,woody,yellow	-0.8,.5,0.1-0.25,0.1-0.5,0.2-1,0.3-0.4,0.8-0.9,2-4,5,abaxially,absent,abundant,acroscopically,adaxially,along,angled,apical,appendage,articulated,axi,berr,column,crenat,developed,diamete,eaf,edicel,eed,eglandular,gree,hal,lacking,less,lon,lower,middle,nflorescence,occasionally,pair,pentagonal,petiolule,present,pubescence,reflexed,rest,ruit,scarcely,scattered,secondary,sessile,sparsely,staminal,sterile,stout,tem,tertiary,tip,toward,ud,weak-walled,ympodial	arrangement,bark,berry,border,branch,bud,characteristic,colour,corrugation,drying,exertion,form,giving,glabrousnes,growth,height,history,length,life,lobing,mentioned,midpoint,new,number,per,plant,prickle,ray,seed,shape,sympodial,texture,thicknes,type,variation,width
39	wfo-0001026305	exception_thrown	135	0	0	135	0	0.0		.25,/4,0.2-1,0.25-0.5,0.5-2,0.6-1,0.7-1,1-1.5,1.3-1.5,2-2.5,2-6-flowered,2.5-3,3-8.5,4-4.5,5-7,6-9,7-16,7-9,abaxial,abaxially,acute,adaxially,along,anther,anthesi,apex,apical,area,attenuate,ba,bark,base,beige-tan,berry,calyx,closely,cm,congested,conical,corolla,dark,deflexed,deltate,dendritic,densely,dia,difoliate,drying,eaf,edicel,eed,elliptic,exserted,filament,free,fruiting,geminat,glabrate,glabrous,globose,green,greenish-white,interlocking,knob-like,lamina,lateral,leaf,leaf-opposed,like,lobe,lobed,lon,long,lower,main,margin,middle,midrib,minute,minutely,mm,nflorescence,occasionally,older,ovary,overlappin,ovoid-reniform,pair,pale,papillose,pedicel,petiole,pitted,planar,pore,poricidal,portion,projection,pubescent,reddish-brow,rounded,ruit,scar,scattered,shaped,shining,shrub,simple,slender,spaced,sparsely,stem,stigma,strongly,styl,style,surface,tall,tan,tear-drop,tip,trichome,tub,tube,ud,unifoliate,unit,vein,visible,way,widest,woody,x,ympodial,young	
40	wfo-0001026307	success	193	199	156	37	43	0.808	.0â1.2,.3,.5,.5â4.0,.6,.8,0.2â1.5,0.4,0.5â0.7,0.5â5.0,0.8â2,0.8â5,1.0â1.2,1.0â1.5,1.0â2.0,1.0â2.4,1.0â2.5,1â3-celled,1â6-celled,2.0,2.0â3.5,2.6â13,2/3,3.0â4.0,3.5â7.0,35â45,3â8,3â8-celled,4â5.7,5â7,8â12,9,abaxial,acute,acute-acuminate,adaxial,age,anther,anthesi,apex,appressed,articulated,base,becoming,berry,black,broadly,calyx,cell,central,clavate,cm,corolla,cuneate,cylindrical,decurrent,densely,diameter,difoliate,ellipsoid,end,entire,exerted,eye,facing,filament,flattened-reniform,flower,fruit,fruiting,glabrous,glandular,globose,gradually,green,growth,herb,internodal,lateral,length,lengthening,like,lobe,lobed,long,longer,lower,margin,middle,minutely,mm,narrowing,new,one,outline,ovary,ovate,pair,paler,pedicel,peduncle,pentagonal,per,petiole,pore,poricidal,primary,pubescent,purple,purple-yellow,reflexed,restricted,ripe,scar,shallow,shallowly,shape,shorter,shrub,side,simple,slightly,slit,spaced,sparsely,spreading,stem,stigma,straight,strongly,style,surface,testal,three,tinged,tip,toward,translucent,triangular,trichome,tube,turning,two,undulate,unequal,unevenly,uniseriate,upper,variable,vein,vigorous,weak-stemmed,white,wide,yellow,yellow-green	0.2â0.5,0.5â0.6,0.6,0.8â0.9,2.0â3.0,5-merous,abaxially,adaxially,angled,apar,beyond,cone,eaf,eed,free,geminat,hilum,later,membranous,narrower,nflorescence,papillat,perfect,portion,positioned,recurved,reflexe,ruit,ste,stellate,stone,sub-laterally,tal,tem,ud,unit,ympodial	angulated,apart,appearance,arrangement,bark,border,branch,bud,characteristic,colour,corrugation,distal,drying,exertion,form,geminate,giving,glabrousnes,height,history,inflorescence,interjected,leaf,leaflet,life,lobing,midpoint,null,number,papillate,plant,prickle,pseudostipule,ray,seed,size,tall,terminal,texture,thicknes,type,variation,width
41	wfo-0001026317	success	169	184	143	26	41	0.846	.5,/4,0.25-1,0.3-1.2,0.5,0.5-0.6,0.5-0.8,0.5-1,0.6-,0.7-0.9,0.8-1,1-1.2,1-1.5,1-5.7,10-12,2-,2-2.5,2-4,2.5-10,3-3.5,3-foliate,3.5-15,4-5,50-200,6-8,6x,?,abaxially,absent,acuminate,acute,adaxially,age,anther,anthesi,apex,apically,approximately,attenuate,bark,base,berry,branched,bright,brown,calyx,capitate,clonal,cm,conical,corolla,correlated,dark,deltate,dendritic,dense,densely,diameter,drying,elliptic,entire,erect,essentially,exerted,extremely,filament,flattened,flower,free,fruiting,glabrous,globose,growth,inflorescence,internodal,lamina,lengthening,less,like,lobe,many,margin,maturity,minutely,mm,narrowly,new,nodding,occasionally,often,orange,ovary,pair,pale,papillate,pedicel,peduncle,per,pericarp,petiole,pitted,planar,plant,pore,poricidal,portion,primary,pubescence,pubescent,pulp,red,reflexed,reniform,shiny,shrub,simple,slightly,slit,sparsely,stem,sticky,stigma,straight,style,surface,swollen,terminal,thin,time,tip,toward,triangular,trichome,tube,uniseriate,unit,variable,vein,way,white,woody,x,yellowish	3,apart,closely,distally,eaf,eed,em,erec,found,geminat,halfwa,lobed,longer,lower,nflorescence,packed,papillat,perfect,plane,population,pubescen,rachi,ruit,scar,ud,ympodial	2,appearance,arrangement,border,branch,bud,characteristic,colour,corrugation,distal,exertion,form,fruit,geminate,giving,glabrousnes,halfway,height,history,interjected,lateral,leaf,leaflet,length,life,lobing,midpoint,null,number,prickle,pseudostipule,ray,seed,shape,size,sympodial,texture,thicknes,type,variation,width
42	wfo-0001026335	exception_thrown	157	0	0	157	0	0.0		.5,.5-3.5,0.1-0.3,0.25-0.5,0.5-1,0.6-1,0.8-1.3,1,1-1.5,1-2,1-3,1-4,1.5-2,1.5-4,10-20,10-30,2,2-3,2-4,2-7.5,3-18,3-5,4-5,5-,5-15,5-7,7-8,abaxially,accrescent,acuminate,acute,adaxiall,adaxially,ag,anther,apart,apex,apparently,articulated,axe,ba,base,blade,branched,calyx,capitat,chartaceous,cm,connivent,covering,cuneate,curved,cylindrical,deltate,dense,densely,diameter,directed,distally,eaf,eed,elliptic,elliptic-ovate,entire,equal,erect,especially,filament,flattened,flower,forked,frui,fruit,fruiting,geminate,glabrescent,glabrous,glandula,glandular,globose,green,hair,held,lanceolate,large,leaf,leaf-opposed,like,lobe,long,longitudinal,lower,many-foliate,margin,midpoint,mm,moderately,much,multangulate,nflorescence,oblong,often,opening,orolla,paired,pedicel,peduncle,perfect,petiole,pore,probably,pubescence,pubescent,rachi,ray,reticulate,ripe,rounded,ruit,scattered,sessile,shrub,simple,slightly,slit,smaller,sometimes,spaced,ste,stellate,stellate-pubescent,stem,stigma,straight,style,subtending,surface,tal,tamen,tem,time,tip,toward,tube,unit,unripe,uprigh,usually,vary,vein,white,whitish,wide,x,yellow,yellowish,ympodial	
43	wfo-0001026343	success	221	189	152	69	37	0.688	-1.5,-15,-3.5,-7,.5,0-2,0-4,0-40,0.05-0.2,0.05-0.5,0.15,0.2,0.2-0.3,0.2-0.7,0.5,1-2,1.3-1.7,1.5-2,1.5-2.5,1.8-2.2,1.8-3,1/3,1/4-2/3,1/5,2-4,2-5,2-6,2.2-3.2,2.5-8,3-4,3-5,5-10,5.5-9,6-9,7-8,abaxial,abaxially,acute,adaxial,anther,apex,apically,bark,base,berry,blade,broadly,calyx,chartaceous,cm,concolorous,connivent,cream,cuneate,curved,dark,deltate,densely,diameter,distal,distance,drying,dull,elliptic,erect,extending,faint,filament,flattened,flattened-reniform,flower,fruit,fruiting,glabrescent,glabrous,green,green-brown,infructescence,lateral,leaf,length,less,lobe,lobed,lobing,long,long-styled,longer,lower,margin,marking,maturity,midpoint,midvein,mm,moderately,multangulate,narrow-deltate,obtuse,orange,orange-brown,ovate,pair,pale,pedicel,peduncle,per,pericarp,petiole,plant,poricidal,porrect,prickle,prickly,primary,ray,reddish,reduced,rounded,sessile,shrub,side,small,smooth,sometimes,sparsely,spherical,spreading,stalk,stalked,stellate-pubescent,stem,stout,style,surface,tapering,terete,tertiary,time,tip,tree,trichome,tube,upper,variously,vein,venation,visible,weakly,wide,yellow,young	-1,-4,/2,/5,0,0-10,0-5,0.1-0.2,0.3,0.45-1,0.5-1.5,0.8-1.5,1-3,1-4,1/,10-30,2-3,2-3.2,2-8,3.5-4.5,5-merous,7-12,7-14,7-9,acuminat,alyx,andromonoecious,apar,apart,apparently,articulated,branched,brow,eed,elongating,equal,free,hermaphrodite,heterostylous,lon,lowermost,mature,mauve,nflorescence,older,one,open,orolla,oung,pendulous,plurifoliat,portion,prickl,purple,reflexed,ruit,scar,secondary,short-styled,spaced,staminat,stellate,tamen,unarmed,unit,vary,way,woody,ympodial	appearance,arrangement,border,branch,brown,bud,characteristic,colour,corolla,corrugation,exertion,form,giving,glabrousnes,growth,height,history,inflorescence,interjected,leaflet,life,new,null,number,ovary,plurifoliate,pseudostipule,seed,shape,size,stigma,terminal,texture,thicknes,type,variation,width
44	wfo-0001026352	success	209	206	169	40	37	0.809	.3,.5,0.5,0.5-0.8,0.5-1,0.5-1.5,0.5-3,0.6-,0.7-2,0.9-1,1-,1-1.5,1-10,1-2-celled,1.2-1.7,1.5,1.5-4.6,10+,12-60,2,2-3-celled,3-15,3.5-9,4-4.5,5-6,7-9,<,?,acuminate,acute,almost,angle,anther,anthesi,antrorsely,apart,apex,apparently,appearance,arising,articulated,articulation,axi,bark,basal,base,bending,berry,blue,branch,branching,broadly,brown,calyx,capitate-truncate,cell,cm,conical,cordate,corolla,curved,deciduous,deltate,densely,denser,diameter,discolorous,ellipsoid,entire,evenly,eventually,expanded,exserted,few-celled,filament,flattened,flower,fruiting,giving,glabrous,globose,green,greenish,growth,herbarium,immature,impressed,inflorescence,irregularly,junction,lamina,large,largest,leafy,leaving,length,like,lobe,lobed,long,lower,many,margin,mature,minutely,mm,narrowly,near,nearly,new,older,outline,ovate,pair,pale,pedicel,peduncle,peg,per,petiole,pink,point,primary,principal,pubescent,rachi,reniform,rest,revolute,right,scar,seen,shallowly,shoot,short,simple,sleeve,small,spaced,sparser,specimen,spreading,stem,stigma,straw-colored,strongly,style,surface,terminal,third,time,trichome,truncate,tube,tuberculate,uniseriate,unit,unspecified,upper,vein,vine,violet,weak,white,wide,widest,woody,yellowish,ympodial	1.5-2,5-merou,6-7,abaxially,adaxiall,ag,alyx,chartaceous,eaf,eed,free,half,heigh,ilament,inflorescenc,leave,lengthening,membranous,nflorescence,orolla,papillate,papillo,perfect,pericarp,plurifoliat,pore,poricidal,portion,reflexed,ruit,shiny,slit,spreadin,stellate,tem,thin,tip,tub,ud,vary	arrangement,border,bud,characteristic,colour,corrugation,distal,drying,exertion,form,fruit,glabrousnes,height,history,interjected,lateral,leaf,leaflet,life,lobing,midpoint,number,ovary,papillose,plant,plurifoliate,prickle,pseudostipule,ray,seed,shape,size,texture,thicknes,type,variation,width
45	wfo-0001026352	success	214	189	154	60	35	0.72	.3,.5,0.5,0.5-0.8,0.5-1,0.5-1.5,0.5-3,0.6-,0.7-2,0.9-1,1-,1-1.5,1-2-celled,1.2-1.7,1.5,1.5-2,1.5-4.6,10+,12-60,2,2-3-celled,3-15,3.5-9,4-4.5,5-6,6-7,7-9,<,?,acuminate,acute,anther,anthesi,antrorsely,apex,apparently,appearance,arising,basal,base,berry,blue,branch,branching,broadly,brown,calyx,capitate-truncate,cell,cm,conical,connivent,cordate,corolla,curved,deciduous,deltate,densely,denser,diameter,discolorous,ellipsoid,entire,evenly,eventually,expanded,exserted,few-celled,filament,flattened-reniform,flower,form,free,fruiting,giving,glabrous,globose,green,greenish,growth,herbarium,immature,impressed,inflorescence,lamina,large,largest,leaf,leafy,length,like,lobe,lobed,long,lower,many,margin,mature,minutely,mm,narrowly,nearly,new,outline,ovate,pair,pale,pedicel,peduncle,per,pericarp,petiole,pink,portion,primary,principal,pubescent,reflexed,rest,revolute,seen,shallowly,shiny,shoot,short,simple,sparser,specimen,spreading,stem,stigma,straw-colored,strongly,style,surface,terminal,thin,third,time,trichome,truncate,tube,tuberculate,uniseriate,unspecified,vein,vine,violet,weak,white,widest,woody,x,yellowish	1-10,5-merou,abaxially,adaxially,ag,almost,alyx,angle,apart,ark,articulated,articulation,axi,bending,chartaceous,eaf,eed,geminat,half,heigh,ilament,inflorescenc,irregularly,junction,leaving,lengthening,membranous,near,nflorescence,older,orolla,papillate,papillo,peg,perfect,plurifoliate,point,pore,poricidal,rachi,right,ruit,scar,sleeve,slit,small,spaced,speciman,spreadin,stellate,tem,tip,tub,twining,ud,unit,upper,vary,yellow,ympodial	arrangement,bark,border,bud,characteristic,colour,corrugation,distal,drying,exertion,fruit,glabrousnes,height,history,interjected,lateral,leaflet,life,lobing,midpoint,number,ovary,papillose,plant,prickle,pseudostipule,ray,seed,shape,size,texture,thicknes,type,variation,width
46	wfo-0001026379	success	219	220	177	42	43	0.808	-4.5,0.2-0.38,0.2-0.4,0.7-1,0.8-1.2,0.9-1.2,1-1.7,1-10,1-2,1-3.7,1.3-2.1,1.5-2.3,1.7-4.9,1.8-2.6,1.8-3.2,1.8-5,1.9-3.4,1/2,13,2-7,2.4-5.1,2.6-3.7,2.9-4,2/3,3-11,3/4,4-5,4.1-7,5.3-10.2,50-450,6-10.6,8-15,8-29,8.3-10,9-14,abaxially,accrescent,acute,adaxially,along,anther,anthesi,apart,apex,articulated,attenuate,axillary,bark,basal,base,berry,blade,blunt-tipped,branch,branched,brown,calyx,chartaceous,closely,cm,completely,conical,corolla,covering,cylindrical,dark,dendritic-echinoid,densely,diameter,distal,dried,echinoid,echinoid-pubescent,ellipsoid,entire,enveloping,evident,few-rayed,filament,finely,fleshy,flower,fruit,fruiting,glabrous,globose,granular,gray-brown,grayish,growth,hair,included,inserted,lacking,lateral,leaf,length,line,lobe,lobed,long,long-attenuate,main,many,margin,mature,midrib,minute,minutely,mm,mostly,multangulate,multangulate-pubescent,nearly,oblong,obovate,obtuse,often,older,ovate,ovate-lanceolate,pale,partly,pedicel,peduncle,persistently,petiole,pitted,plant,plurifoliate,porrect-stellate,present,recent,reniform,rich,scabrous,scattered,semi-ovate,sessile,short-stalked,shrub,side,simple,size,small,sometimes,somewhat,spaced,sparse,stellate,stellate-,stellate-pubescent,stellate-tomentose,stelliform,stem,stigma,style,suture,terete,time,tomentose-pubescent,translucent,tree,tube,uneven,unit,upper,usually,vein,velutinous-pubescent,vestigial,violet,way,whitish,whitish-brown,x,young	0.7-2.5,2-2.8,8-13,adaxiall,ag,apparently,around,ba,capitat,directed,distally,eaf,echinoi,edge,eed,farinose,free,hig,large,lengthening,lower,m.,multangulat,nflorescence,orolla,perfect,pore,poricidal,pubescen,rachi,rather,ruit,runk,slit,tamen,testa,thin,tip,ud,vary,yellow,ympodial	appearance,arrangement,border,bud,capitate,characteristic,colour,corrugation,drying,exertion,form,giving,glabrousnes,height,high,history,inflorescence,interjected,leaflet,life,lobing,mentioned,midpoint,new,number,ovary,per,prickle,primary,pseudostipule,pubescent,ray,seed,shape,surface,sympodial,terminal,texture,thicknes,trunk,type,variation,width
47	wfo-0001026400	success	187	166	118	69	48	0.631	0.2-0.8,0.4-1,0.5-1,0.5-1.2,1-10,1-2,1.3-2.6,1.7-2.2,10-28,12-27,2.4-5.9,3.4-4.8,3.5-5.9,30-55,4-7,5-7,6.5-20,9-13,abaxially,acumen,acuminate,acute,adaxially,anther,apex,apparently,asymmetric,attenuate,axillary,base,basiscopic,berry,blue,brownish,bud,cell,clavate,cm,condition,connivent,corolla,covering,dark,decurrent,deep,diameter,distal,drying,elliptic,filament,finely,flower,forked,fresh,fruit,generally,glabrescent,glabrous,globose,green,greenish,hair,half,herb,interjected,lanceolate,lateral,leaf,leaflet,light,lilac,linear,lobe,long,make,mm,moderately,mucilaginous,odd-pinnate,orbicular,ovate,ovoid,pedicel,peduncle,pentagonal,perfect,petiole,plant,puberulent,pubescent,purple,ripe,rounded,seed,semi-stellate,sessile,short,side,simple,size,slightly,stigma,stripe,style,subtending,terminal,testal,thick,tip,tissue,tube,unwinged,usually,wall,wet,white,whitish,x	0.7-1.1,10-18,13-30,2-6,2-8,3-6,5-merou,6-13,6-15,8-12,adaxiall,ag,alyx,apart,articulated,axe,blade,capitat,coriaceous,decreasing,digestion,dorsally,eaf,edge,eed,enzyme,erec,exceeding,flat,folded,geminat,glabrou,gree,green-white,hair-like,hal,high,homostylous,honeycomb-shaped,lengthening,living,lower,nflorescence,orolla,pair,petiolulate,plurifoliate,pore,poricidal,removed,ruit,seudostipule,slit,spaced,specimen,stamen,straight,subequal,tall,tamen,tem,throughout,toward,tri-,typically,unit,vary,yellow,ympodial	'hair-like,0.5-2.6,2-5,2-5.9,appearance,arrangement,bark,border,branch,calyx,capitate,characteristic,colour,corrugation,erect,exertion,form,fruiting,geminate,giving,glabrousnes,growth,height,history,inflorescence,length,life,lobing,margin,mentioned,midpoint,new,number,ovary,per,prickle,primary,pseudostipule,ray,shape,stem,surface,texture,thicknes,type,variation,vein,width
48	wfo-0001026406	success	219	200	164	55	36	0.749	.2,.5,0,0-30,0-5,0.3-0.7,0.4-0.9,0.5-1.5,0.5-2.5,00-200,1,1-2,1.3-1.5,1.5-2,1.5-5,1.8-2.4,1/3,1/4,1/4-1/2,1/4-1/3,12-19,2-2.7,2-3,2-6,2.5-8,2.9-3.2,3-10.5,3-4,3.2-3.8,30-60,5,5-25,5-50,5-6,5-7,5-8,6-12,6-15,6.5-7,7-10,7-9,9-15,abaxial,acute,adaxial,ame,anther,apart,apex,apically,apparently,bark,base,berry,blade,branched,broad-deltate,c.,calyx,cm,conical,connivent,cordate,cream,curved,dark,deltate,densely,diameter,dirty-whitish,distal,distance,drying,equal,erect,extending,filament,flattened,flattened-reniform,flower,foliaceous,free,fruit,fruiting,fully,gently,green,herb,infructescence,lateral,leaf,least,length,lobe,lobed,long,long-styled,longer,lower,margin,marking,maturity,mauve,midpoint,midvein,mm,moderately,oblong,obtuse,older,one,open,opening,orange-brown,ovate,pair,pale,pedicel,peduncle,pendent,per,petiole,plant,poricidal,porrect,portion,prickle,prickly,primary,purple,ray,red-brown,rounded,short-styled,shrub,side,spaced,spherical,spreading,stalk,stalked,stellate-pubescent,stem,stout,straight,style,surface,tapering,terete,terminal,time,tip,trichome,tube,upper,variously,vein,velvety,way,white,wide,woody,yellow,young	-1,0-3,0.3,0.3-0.5,0.4-0.8,0.5,0.8,1/,10-30,20-60,5-merous,7-8,abaxially,adaxially,alyx,andromonoecious,apar,articulated,chartaceous,discolorous,eaf,eed,elongated,elongating,glabrous,hermaphrodite,heterostylous,lon,lowermost,mature,nflorescence,orolla,oung,pendulous,pericarp,plurifoliat,prickl,reflexed,ruit,scar,sessile,smooth,sometimes,sparsely,staminat,stellate,tamen,tertiary,unit,vary,venation,visible,weakly,yellow-brow,ympodial	appearance,arrangement,border,branch,bud,characteristic,colour,corolla,corrugation,exertion,form,giving,glabrousnes,growth,height,history,inflorescence,interjected,leaflet,life,lobing,mentioned,new,number,ovary,pseudostipule,seed,shape,size,stigma,texture,thicknes,type,variation,width,yellow-brown
49	wfo-0001026407	success	221	195	152	69	43	0.688	+,-11,-6,.5,/3,0.5,0.5-0.6,0.5-2,0.9-3,1,1-1.2,1.2-1.5,1.3,1.5-1.7,1.5-2,1.5-7,2-2.5,2.5-3,20-30,20-40,3.5,4-5,5,5-10,7-10,7-8,acute,along,anther,anthesi,apex,appearing,area,around,basal,base,becoming,beneath,berry,black,blunt,branch,branched,broadly,brown,brownish,calyx,capitate,cell,cm,congested,conical,connivent,corolla,deep,deltate,dendritic,dense,densely,diameter,discolorous,ellipsoid,elliptic,entire,erect,evenly,exserted,filament,flattened-reniform,flower,free,fruiting,glabrous,globose,golden,golden-pubescent,growth,inflorescence,internodal,lamina,lateral,lax,leafy,like,lobe,lobed,long,loosely,lower,many,margin,markedly,midvein,minutely,mm,narrowly,near,new,numerous,oblique,occasionally,often,older,open,outline,pair,pale,papillate,pedicel,peduncle,pentagonal,per,persistent,petiole,pitted,plurifoliate,portion,primary,pubescence,pubescent,purple,purplish,reddish,revolute,ripe,shiny,short,shrub,simple,sparsely,stem,stiff,stigma,stout,strongly,style,surface,terminal,time,trichome,truncate,tube,undulate,unit,upper,vein,vine,violet,way,woody,x,yellow	0.5-1,1-10,3.5-5.5,5-7,5-merou,abaxially,adaxially,ag,aid,always,alyx,apart,ark,articulated,axi,berr,chartaceous,clear,climbin,denser,eaf,eed,fleshy,geminat,glabrescen,glabrou,ilament,interpetalar,irregularly,leaving,lengthening,membranous,mixture,nflorescence,obscured,orolla,paler,papillat,pedice,peg,perfect,pericarp,planar,pore,poricidal,pubescenc,ruit,scar,sinus,sleeve,slightly,slit,small,spaced,sparser,spreading,stellate,tangled,tem,testal,thin,tip,transition,twining,ud,usually,vary,weak,ympodial	.5-3,appearance,arrangement,bark,border,bud,characteristic,colour,corrugation,distal,drying,exertion,form,fruit,geminate,giving,glabrescent,glabrousnes,height,history,interjected,leaf,leaflet,length,life,lobing,mentioned,midpoint,number,ovary,plant,prickle,pseudostipule,ray,seed,shape,size,sympodial,texture,thicknes,type,variation,width
50	wfo-0001026424	success	138	171	113	25	58	0.819	-25,-3.5,-4,0.75-1.5,1-,1-1.5,1.5-2,10,10-15,12-60,15,15-30,2,3-4,637/1,8-,acuman,acumen,acuminate,acute,age,angular,apex,aspect,axil,base,becoming,blunt,bluntly,blush-violet,broad,broadly,calyx,campanulate,cell,clonal,close,cm,common,conspicuous,corolla,cuneate,cyme,downard,ellipsoid,elliptic,erect,exceeding,except,exerted,facetted,facing,floral,flower,fork,forked,general,glabrous,glandular,growing,hair,interacuminal,lacking,lanceolate,lanceolate-elliptic,larger,lasting,lavender,leaf,line,lobe,lobed,long,minute,mm,oblique,obovate,often,part,pedicel,pedicellate,peduncle,petiole,point,rachi,raised,rarely,rh,rounded,scorpioid,second,several,shallowly,short,shrub,simple,slightly,soft-wooded,soon,stem,stone,straggly,time,tip,tissue,toward,triangular,usually,violet,woody,x,year,young	1,1-10,1-2,3-11,anthesi,ba,cut,dia,distinct,eaf,gree,lon,lower,midvein,nflorescence,pinnatisect,plurifoliat,rotate-stellate,sinus,tub,ud,unit,unwinged,within,ympodial	1-4,anther,appearance,arrangement,bark,border,branch,bud,characteristic,colour,corrugation,diameter,distal,drying,exertion,filament,form,fruit,fruiting,giving,glabrousnes,green,growth,height,history,inflorescence,interjected,lateral,leaflet,length,life,lobing,margin,mentioned,midpoint,new,number,ovary,per,plant,prickle,primary,pseudostipule,ray,seed,shape,size,stigma,style,surface,terminal,texture,thicknes,tube,type,variation,vein,width
51	wfo-0001026440	success	181	188	142	39	46	0.785	1-5,1.1-1.4,1.1-1.5,1.3-1.7,1.5-2.1,1.8-4.5,1.9-3.7,1/2-2/3,14-30,2-2.8,2.9-4.4,3-5,3-7,3-8,3.9-6.5,3/4,4-12,5-7,7-14,9,abaxially,accrescent,acute,adaxially,along,always,anther,anthesi,apex,appressed,articulated,axillary,bark,basal,base,berry,blunt-tipped,bract-like,branch,branched,broadly,brown,calyx,chartaceous,closely,cm,conical,corolla,dendritic-echinoid,dense,developed,diameter,dichotomy,distal,echinoid,elliptic,entire,filament,first,fleshy,flower,fruiting,globose,granular,green,greenish-yellow,hair,high,included,leaf,length,lobe,lobed,long,long-attenuate,many,margin,minutely,mm,mostly,multangulate,multangulate-pubescent,nearly,oblong,obovate,obovoid-oblong,obscure,obtuse,often,older,openly,ovate,pair,pale,pedicel,peduncle,petiole,pitted,plurifoliate,porrect-stellate,rather,reniform,ripe,scabrous,semi-ovate,sessile,short-acuminate,short-stalked,shrub,simple,size,small,sometimes,somewhat,spaced,sparse,stellate,stellate-pubescent,stem,stigma,style,suture,terete,testa,thin,time,tomentose,tomentose-pubescent,tomentum,translucent,tree,truncate,tube,turning,uneven,unit,usually,way,white,x,yellow,young	0-15,1/2,2-4,adaxiall,ag,apparently,ba,blade,branche,capitat,directed,distally,eaf,echinoi,eed,free,inserted,large,lengthening,lower,m.,minute,multangulat,nflorescence,orolla,perfect,persistently,pore,poricidal,pubescen,ruit,runk,slit,tamen,thick,tip,ud,vary,ympodial	appearance,arrangement,border,bud,capitate,characteristic,colour,corrugation,drying,exertion,form,fruit,giving,glabrousnes,growth,height,history,inflorescence,interjected,lateral,leaflet,life,lobing,midpoint,new,null,number,ovary,per,plant,prickle,primary,pseudostipule,ray,seed,shape,surface,sympodial,terminal,texture,thicknes,trunk,type,variation,vein,width
52	wfo-0001026441	success	197	161	117	80	44	0.594	0-2,0.3-0.7,0.4-3,0.5-1.5,0.8,1-1.5,1-10,1-2,1.5-2.5,10,10-14,15-20,2-2.5,2-5.5,2-8,4-6,4-8,4-8.5,4.5-6.5,5,5-10.5,6-15,7-20,7-8,9-14,abaxially,acumen,acuminate,adaxially,anther,apart,apex,articulated,attenuate,axillary,base,berry,blade,brownish,bud,cell,cm,condition,conical,connivent,corolla,covering,diameter,distal,drying,elliptic-lanceolate,filament,flower,forked,fresh,fruit,generally,glabrous,green,greenish,half,herb,interjected,lanceolate,lateral,leaf,leaflet,light,lobe,long,make,margin,middle,minute,mm,mottled,mucilaginous,narrow,obtuse,odd-pinnate,orbicular,ovate,ovoid,pale,pedicel,peduncle,petiole,petiolule,plant,pubescent,purple,ripe,rounded,seed,semierect,short,size,slightly,sparsely,stem,stigma,straight,style,subsessile,subtending,terminal,testal,thick,tube,usually,violet,wall,wet,whitish,wide,wing,x	.5,1.5-2,3-5,5-merou,absent,ag,alyx,apparently,axe,capitat,chartaceous,ciliate,decreasing,digestion,dorsally,eaf,edge,eed,end,enzyme,equal,erec,especially,exceeding,flat,folded,fourt,geminat,glabrou,gradually,green-white,hair,hair-like,homostylous,honeycomb-shaped,internal,larger,lengthening,like,living,lower,minutely,nflorescence,one,orolla,pair,perfect,placed,plurifoliate,pore,poricidal,puberulent,removed,rotate,ruit,secondary,seudostipule,slit,spaced,specimen,stamen,star,ste,stolo,subequal,symmetrical,tall,tamen,tem,throughout,tip,toward,tri-,tuber,typically,unit,vary,white,yellow,ympodial	'hair-like,1,appearance,arrangement,bark,border,branch,calyx,capitate,characteristic,colour,corrugation,erect,exertion,form,fourth,fruiting,giving,glabrousnes,growth,height,history,inflorescence,length,life,lobing,mentioned,midpoint,new,number,ovary,per,prickle,primary,pseudostipule,ray,shape,surface,texture,thicknes,type,variation,vein,width
53	wfo-0001026460	success	131	147	99	32	48	0.756	.1,.5,0.5-1.5,1-1.5,1.5-2,10-15,13.5-21,2-2.5,2.5-3,4.5-5,5,6-7,6-9,7-9,8-10,abaxially,acute-acuminate,adaxially,anther,anthesi,apex,base,becoming,berry,branched,brown,calyx,capitate,cm,completely,conical,corolla,dark,deltate,dia,distal,drying,elliptic,erect,filament,filiform,floccose,flower,free,fruiting,glabrous,globose,green,greenish,inflorescence,leaf,like,lobe,lobed,long,long-exserted,membraneous,middle,minutely,mm,nearly,older,opposite,ovary,ovoid-reniform,pair,pale,papillose,pedicel,pitted,pore,poricidal,portion,puberulent,reddish,reflexed,shaped,shrub,simple,slightly,soon,stem,stigma,style,subshrub,surface,tall,tapering,tear-drop,tiny,tip,trichome,tube,vein,white,widest,x,yellow,young	1/2,513,acut,axi,closely,deflexed,do,eaf,edicel,eed,fide,frui,inflorescenc,internodal,less,lower,major,nflorescence,often,papillo,reddish-brow,ruit,santo,scar,somewhat,spaced,tub,ud,unifoliat,unit,woody,ympodial	acute,appearance,arrangement,bark,border,branch,bud,characteristic,colour,corrugation,diameter,exertion,form,fruit,giving,glabrousnes,growth,height,history,interjected,lateral,leaflet,length,life,lobing,margin,midpoint,new,null,number,peduncle,per,petiole,plant,prickle,primary,pseudostipule,ray,reddish-brown,seed,shape,size,terminal,texture,thicknes,type,variation,width
54	wfo-0001026489	exception_thrown	153	0	0	153	0	0.0		.3,0.05-0.1,0.25-0.5,0.5,0.5-0.75,0.5-1,0.5-2,0.6-1.4,0.8-1.2,0.8-1.3,0.8-3.7,1-1.5,1.3-3,1.5-5,2-3,2-4,2-5,2-8-flowered,2.5-13,2.5-4,2/3,5-6,8-13,acute,along,anther,anthesi,apex,appearing,area,axil,ba,bark,base,beneath,berry,branched,broadly,brown,calyx,closely,cm,corolla,cup-shaped,dark,deflexed,deltoid,densely,dia,differing,difoliate,dry,eaf,edicel,eed,elliptic,erect,exserted,extending,filament,flattened,flattened-reniform,fleshy,free,fruiting,geminat,glabrous,globose,gra,green,incrassate,lamina,later,lateral,leaf,lobe,lobed,lon,long,lower,main,major,margin,middle,minor,minutely,mm,nflorescence,occasionally,often,older,one,opposite,ovary,overlappin,pair,paler,papillo,papillose,parallel,pedicel,perpendicular,petiole,pitted,planar,pore,poricidal,portion,prominent,pubescent,red-papillose,rhachi,ruit,scar,shaped,shiny,shrub,simple,size,slender,somewhat,soon,spaced,specimen,stem,stigma,straight,strongly,style,surface,tall,tapering,tear-drop,terminal,thickened,tip,trichome,tub,tube,ud,uniseriate,unit,usually,vein,way,white,whitish,widened,widest,woody,x,ympodial,young	
55	wfo-0001026490	success	272	223	163	109	60	0.599	.5,0.1â0.2,0.1â2.5,0.2â1.5,0.3â3.5,0.5â1,0.5â1.5,0.5â8,0.7â3,0.8â1.5,0.8â12,1.2â8,1.5â2,1.5â3.5,1.5â5,10â20,1â1.2,1â2.5,1â3,2.5â3.5,2â2.5,3,3â4.5,3â5,3â5-pinnate,4â5,5â7,7-pinnate,7â15,abaxially,absent,acuminate,acute,adaxially,along,anther,apex,apical,around,axillary,base,blade,branched,brown,calyx,climbing,cm,commonly,connivent,cordate,corolla,covered,crisped,cylindrical,darker,densely,diameter,distal,eglandular,ellipsoidal,entire,exceeding,extra-axillary,filament,flattened,flower,free,fruit,fruiting,fused,glabrous,green,ground,immature,incurved,inflorescence,interjected,irregularly,lateral,leaf,leaflet,length,lenticular,light,lobe,long,lower,main,margin,mature,medium,middle,midvein,mm,moderately,mottled,multicellular,nearly,node,oblong,obtuse,obtusely,orange,papillose,pedicel,peduncle,per,petiole,plurifoliate,pointed,pseudostipule,pubescence,pubescent,punctate,resulting,revolute,rooting,rounded,sand,seed,shape,shoot,short,simple,size,slender,slightly,smooth,sometimes,somewhat,sparsely,spur,stamen,stem,stigma,striping,style,surface,tawny,teardrop-shaped,terminal,tip,trailing,transparent,trichome,truncate,tube,unbranched,undulate,unit,vegetation,vine,violet,white,wide,wing,woody,yellow,Â½,Ã,â4,â4.5,â9.5	0.2â1,0.4â0.8,0.5â3.5,1.5,1.8â2.2,1.9,1â15,1â8,2,2â4,2â6,2â8,3â4.2,3â8,4.6,4â4.5,5-merous,6,7,=,[,],accrescent,ag,alyx,anthesi,apart,apicall,apparently,articulated,axe,ba,becoming,bract,bracteate,broadly,capitat,cauline,chartaceous,ciliate,completely,contiguously,decreasing,directed,distally,eaf,eed,elliptic,equal,expanded,flat,geminat,lacking,large,latrorse-introrse,lobed,longitudinal,lowermost,lunate,markedly,match,mean,mean=,minute,near,nflorescence,obliqu,oblique,obliquely,oblon,occasionally,one,opening,orolla,ovate,ovate-lanceolate,pair,part,pentagonal,perfec,perfect,petiolule,pore,present,pubescen,pur,rachi,radial,reflexed,reniform,ruit,seudostipule,shorter,similar,slit,smaller,spaced,striation,strongly,tamen,tem,thickened,toward,trichomessympodial,typically,vary,yellowish-tan,youn,â8	0.1-0.2,0.1-2.5,0.2-1,0.2-1.5,0.3-3.5,0.4-0.8,0.5-1,0.5-1.5,0.7-3,1-1.2,1-3,1.2-8,1.5-2,1.5-3.5,10-20,2-2.5,2-4,3-4.2,3-4.5,4-4.5,5-7,7-15,appearance,arrangement,bark,border,branch,bud,capitate,characteristic,colour,corrugation,drying,exertion,form,geminate,giving,glabrousnes,growth,height,history,life,lobing,mentioned,midpoint,new,number,ovary,plant,prickle,primary,ray,sympodial,texture,thicknes,type,variation,vein,width,young
56	wfo-0001026491	success	165	156	106	59	50	0.642	.5,1,1-2,1.5-2,1.5-2.5,1.5-3.5,1.7,10-50,2-3,2-4,2-celled,2.5-3.5,3,3-pinnate,5-6,5-8,6-8,7-8,abaxially,absent,acuminate,acute,adaxially,anther,apex,appressed,articulated,averaging,axe,base,bayonet,berry,branched,broadly,cellular-papillose,cm,crinkly,cuneate,deep,deltoid,densely,diameter,elliptic-lanceolate,entire,filament,flower,globose,greatly,green,growing,hair,highly,inflorescence,interjected,lanceolate,lateral,leaf,leaflet,less,light,lobe,long,margin,middle,minutely,mm,oblong-elliptic,obtuse,often,ovate,ovate-elliptic,ovoid,pale,pedicel,peduncle,petiole,pilose,porrect-incurved,pubescent,purple,rarely,reduced,rounded,scandent,shortly,shrub,similar,simple,slender,spotted,stigma,straight,strigose,strong,subacute,suborbicular-ovate,surface,tawny,terminal,tip,tube,uniseriate,upright,white,whitish,x	1977,5-merou,abaxiall,alyx,anderson,apparently,ba,bent,blade,bract,branching,capitat,cellular-pilose,central,connivent,conspicuously,deciduous,directed,distall,eaf,eed,equal,first,geminat,glistening,homostylous,lower,lunulat,mean,near,nflorescence,orolla,perfect,plurifoliate,point,pore,poricidal,present,rachi,readily,rotate-pentagonal,rotate-substellate,row,ruit,seudostipule,sharp,small,strigo,strongly,tal,tamen,tem,tightly,tyle,unit,usually,ventral,yellow,ympodial	appearance,arrangement,bark,border,branch,bud,calyx,capitate,characteristic,colour,corolla,corrugation,distal,distally,drying,exertion,form,fruit,fruiting,giving,glabrousnes,growth,height,history,length,life,lobing,mentioned,midpoint,new,number,ovary,per,plant,prickle,primary,pseudostipule,ray,seed,shape,size,stem,style,tall,texture,thicknes,type,variation,vein,width
57	wfo-0001026501	exception_thrown	195	0	0	195	0	0.0		-1.7,-3,.1,.35,.5,.6,.7,/3,0,0-1,0-2,0.05-0.3,0.1,0.2-1.8,0.27-0.7,0.5,0.5-0.6,0.5-0.9,0.5-1,0.6-1,0.6-1.1,0.6-2,0.9-2.2,1,1-2,1-2.5,1.8-2.2,1/2-2/3,1/4,1/6-1/2,2-10,2.5-4,2.8-3,3-4,3-5,3-9,3.5-4,4-5,4-7,5-merous,6-9,7-9,?,abaxially,acicular,acute,almost,alyx,anther,apar,apart,apex,apically,apparently,articulated,bark,base,becoming,berry,blade,borne,branched,brown,brown-green,calyx,chartaceous,cm,color,concolorous,cuneate,curved,deltate,densely,diameter,discolorous,drying,dull,eaf,eed,elliptic,elongated,elongating,entire,equal,erect,eye,filament,filiform,filiform-acuminat,flattened,flattened-reniform,flower,free,fruit,fruiting,glabrou,glabrous,gray,green,infructescence,known,leaf,length,light,lobe,lobed,long,longer,lower,margin,mature,mauve,midpoint,mm,moderately,naked,nflorescence,often,older,one,open,orange-brown,orbicular,orolla,oung,ovate,pair,pale,pedicel,peduncle,pendulous,per,perfec,pericarp,petiole,plurifoliat,poricidal,porrect,portion,prickl,prickle,prickly,primary,ray,reddish,rounded,ruit,scandent,scar,sessile,shoot,short,shorter,shrub,simple,slender,small,smooth,sometimes,somewhat,spaced,sparsely,spherical,spreading,stalk,stalked,stellate,stellate-pubescent,stem,straight,style,subsessile,surface,tamen,tapering,terete,terminal,time,tip,trichome,tube,unarme,unarmed,unit,upper,variously,vary,vein,visible,way,white,wide,yellow,yellow-green,ympodial	
58	wfo-0001026513	success	138	145	99	39	46	0.717	.25,.75,/3,0.8-2,1-1.5,1-3,2-2.2,2-5,3-5,3-6-flowered,4-5,6-8,7-9,8-16,acute,anther,anthesi,apex,area,bark,base,berry,broadly,calyx,cm,completely,corolla,darkish,decurrent,delicate,deltoid,dia,differentiated,dry,elliptic,exserted,filament,flower,free,fruit,fruiting,glabrous,globose,green,immature,known,lanceolate,lateral,leaf,live,lobe,long,long-styled,longer,main,mature,middle,minute,mm,much,older,opposite,ovary,pair,pale,papillose,pedicel,petiole,plant,pore,poricidal,portion,raised,reflexed,shaped,shiny,short-styled,shrub,simple,slender,small,soon,stem,stigma,style,surface,tall,tear-drop,tip,treelet,tube,undersurface,vein,way,white,wide,widest,x,young	.1,.3,apiculate,ba,caly,closely,deflexed,eaf,edicel,eed,erect,except,gre,hirsute,leave,less,lobed,lower,minutely,nflorescence,obscure,overlappin,prominent,rest,ruit,scar,somewhat,spaced,specimen,straight,styl,trichome,ud,unifoliat,uniseriate,unit,venation,woody,ympodial	appearance,arrangement,border,branch,bud,characteristic,colour,corrugation,diameter,distal,drying,exertion,form,giving,glabrousnes,grey,growth,height,history,inflorescence,interjected,leaflet,length,life,lobing,margin,mentioned,midpoint,new,number,peduncle,per,prickle,primary,pseudostipule,ray,seed,shape,size,terminal,texture,thicknes,type,variation,width,ye
59	wfo-0001026529	success	219	206	164	55	42	0.749	0-25,0.3-1,0.5-4.5,1,1-10,1-2,1-3,1-4.5,1.1-2.5,1.5-2.5,1.5-4,10,10-28,11-14,12-22,120-210,2,2-7.5,20-60,3-12,3-5,3-6,3-9.5,4-8,5-15,5-17,5-9,50-70,6-20,600-950,abaxially,acumen,acuminate,acute,adaxially,anther,apart,apex,apparently,articulated,attenuate,axe,axillary,base,berry,blue,broadly,brownish,bud,cell,chartaceous,clavate,cm,condition,connivent,cordate,corolla,covering,creamy,dark,deep,densely,diameter,digestion,distal,dot,drying,elliptic,enzyme,except,faintly,filament,flower,forked,fresh,fruit,generally,glabrous,gland,glandular,globose,greatly,green,greenish,hair,half,head,herb,honeycomb-shaped,interjected,lanceolate,lateral,leaflet,length,light,like,lilac,lobe,long,longer,make,margin,medium,membranous,mm,moderately,mucilaginous,narrowly,non-glandular,oblique,odd-pinnate,often,orbicular,ovate,ovoid,pair,pedicel,peduncle,perfect,petiole,petiolulate,petiolule,plant,proximal,pubescent,pure,rarely,reduced,removed,ripe,rounded,scattered,seed,sessile,shape,short,size,slightly,spaced,stem,stigma,style,subequal,subsessile,subtending,terminal,testal,tetralobulate,thick,tip,trichome,tube,typically,unwinged,usually,varying,wall,wet,white,whitish,wide,wing,x,yellowish	2-5,5-merou,?,ag,along,alyx,blade,capitat,ciliate,dorsally,eaf,edge,eed,erec,especially,exceeding,flat,folded,geminat,glabrou,gree,green-white,hair-like,hal,homostylous,lengthening,living,lower,lunate,midrib,minutely,nflorescence,orolla,pentagonal,plurifoliate,pore,poricidal,puberulent,ruit,seudostipule,slit,specimen,stamen,ste,straight,substellate,tall,tamen,tem,throughout,tri-,unit,vary,yellow,ympodial	'hair-like,appearance,arrangement,bark,border,branch,calyx,capitate,characteristic,colour,corrugation,erect,exertion,form,fruiting,giving,glabrousnes,growth,height,history,inflorescence,leaf,life,lobing,mentioned,midpoint,new,number,ovary,per,prickle,primary,pseudostipule,ray,surface,texture,thicknes,type,variation,vein,width,Âµm
60	wfo-0001026534	exception_thrown	150	0	0	150	0	0.0		-1.5,0.5-1,1-2,1-2.5,1-3,1.5-6,1.5-9,10-15,10-20,10-50,15-50,2-2.5,2-3,2-7,2-8,2.5-15,2.5-4,3-,3-10,3-25,3-4,3-5,3.5-4,4-10,4-foliat,4.5-5,5-6,6-35,7-12,7-40,abaxially,absent,acuminate,acute,adaxially,aggregate,apart,ape,apex,apiculate,articulated,auriculate,axe,basal,base,beyond,blade,branched,bright,calyx,cell,chartaceous,cm,connective,connivent,cordate,cylindrical,darker,deltate,densely,diameter,directed,distally,eaf,eed,eglandular,ellipsoidal,entire,equal,exserted,flattened,fleshy,flower,fruit,glabrous,glandular,hair,lanceolate,leaving,lemon-yello,lobe,lon,long,longitudinal,lower,m.,margin,mm,moderately,narrowly,nflorescence,nther,obtuse,often,orange,orolla,ovate,ovoid,pale,pedicel,pedicellar,peduncle,perfect,petiole,pinkish,pore,presen,puberulen,puberulent,pubescent,purple,rachi,radiu,red,remnant,ruit,shorter,simple,slightly,small,spaced,sparsely,stamen,stellate,stigma,stone,stripe,style,subcoriaceous,tal,tem,thecae,time,tip,tomento,tree,triangular,truncat,truncate,tube,ud,unbranched,unit,vary,vein,white,wide,x,yellow,ympodial	
61	wfo-0001026535	success	248	206	180	68	26	0.726	.2,.5,.8,0.1-0.2,0.15,0.2,0.2-0.3,0.5-1,0.7-1.5,1,1-2,1-3,1.2-2,1.3,1.5-2,1.5-3,1/2-2/3,1/3,2-3,2-5,2.5,3,3-4.5,3-5,4-15,5-10,5-7,5Â°,7-8,abaxial,absent,acute,age,almost,along,alternate,anther,anthesi,apex,apically,apparently,bark,base,becoming,berry,black,brachyblast,branch,branched,branching,broadly,brown,calyx,chartaceous,clavate,clustered,cm,concolorous,condensed,conical,corolla,cuneate,cupular,curved,dark,deeply,deltoid,dendritic,dendritic-pubescent,dense,developed,diameter,dilated,discolorous,distributed,divided,domatia,dry,drying,elliptic,elongated,entire,evenly,except,eye,filament,fine,flexuous,flower,forming,free,fruit,fruiting,glabrous,green-brown,known,leaf,length,liana,like,linear,lobe,lobed,long,loop,lower,main,margin,membranous,midvein,minutely,mm,naked,network,number,oblong,obovate,obscure,older,orange-brown,ovate,ovoid,pair,partly,pedicel,peduncle,pericarp,petiole,plant,pointed,portion,primary,prominent,pubescent,rachi,rarely,ray,reaching,ridged,rounded,short,shrub,side,simple,sinus,slender,smooth,sparsely,spreading,stem,stigma,style,surface,tearing,terete,terminal,tertiary,thin,tissue,trichome,truncate,tube,two,unarmed,uneven,unevenly,unit,unlignified,vein,venation,violet,visible,weakly,white,wide,widely,x,yellowish,young,youngest	.1,.4,0-0.5,0.2-1.5,1-5,3.5-4,abaxially,accrescent,adaxially,alyx,apar,area,around,articulated,clearly,cup,delineate,delineated,detaching,developing,dorsal,eaf,eed,ellipsoi,equal,fertilisation,flat,frui,increasing,inside,leave,lengthening,lon,loose,m.,marginal,minute,mostly,much,nflorescence,nther,orolla,outside,papillo,pendulous,perfec,plurifoliat,pore,poricidal,protruding,raised,ruit,scar,secondary,see,slightly,smaller,soon,spaced,stump,tip,toward,translucent,tufted,ud,vary,wider,ympodial	arrangement,bud,characteristic,colour,corrugation,ellipsoid,exertion,form,glabrousnes,growth,history,inflorescence,life,lobing,new,ovary,papillose,per,plurifoliate,seed,seen,shape,size,sympodial,texture,type
62	wfo-0001026604	success	192	171	135	57	36	0.703	.4,.75,0,0.1,0.8-0.9,1-1.2,1.1-1.3,1.2-1.7,1.5-2,1.5-9,10-30,2-2.3,2-2.5,2.3-3.5,3-3.5,3-5,3.5-4,4-4.5,4.5-7,5,5-7,50-100,<,absent,acuminate,aid,along,anther,apex,articulation,atop,bark,base,berry,branching,brown,c.,calyx,capitate,cell,climbing,cm,comical,conical,cordate,corolla,dark,diameter,distal,drying,ellipsoid,entire,exserted,filament,flattened,flexuous,flower,free,fruit,fruiting,glabrous,globose,growth,inflated,later,leaf-opposed,liana,lobe,lobed,margin,mere,midrib,minute,minutely,mm,narrowly,new,oblique,older,outline,ovary,ovate,overall,ovoid,pair,pale,papillose,part,pedicel,peduncle,per,petiole,pitted,poricidal,portion,primary,pubescent,purple,receptacle-like,red,reddish,reniform,rim,ripe,shape,shrub,simple,sinuate,slender,somewhat,stem,stigma,stout,strongly,structure,style,support,surface,terminal,testal,time,tip,trichome,truncate,tube,twisting,undulation,uniseriate,upper,vein,vining,violet,way,woody,x	.5,0.4-0.6,0.8-1,?,age,always,anthesi,apart,appearing,articulated,basal,brow,clearly,cucullate,cupped,deflexed,densely,differentiated,distinct,due,eaf,eed,elongate,expanding,leaving,lengthening,lower,nflorescence,nodding,occasionally,papillo,particularly,peg,perfect,pericarp,planar,plurifoliat,poin,point,pore,quarter,ruit,scar,series,shiny,slightly,slit,spaced,stellate,swolle,thin,tub,ud,unit,widely,ympodial,Â½	appearance,arrangement,border,branch,bud,characteristic,colour,corrugation,exertion,form,giving,glabrousnes,height,history,inflorescence,interjected,lateral,leaf,leaflet,length,life,lobing,mentioned,midpoint,number,plant,prickle,pseudostipule,ray,seed,size,texture,thicknes,type,variation,width
63	wfo-0001026607	success	204	184	143	61	41	0.701	0-3,0.1-0.3,0.3-1.8,0.5-5.8,0.8-3.4,0.8-4.5,0.8-5,1-2,1-3.8,1-5,1.5-4,10-30,2-10,2-2.5,2-3,2.4-5.8,2.5-3.8,2.7-19,3-8,4-10,4-6,5,5.8-19.8,6-10,abaxially,absent,acumen,acute,adaxially,anther,apex,apparently,articulated,attenuate,axe,axillary,base,basiscopic,berry,blade,brownish,bud,cell,chartaceous,ciliate,clavate,clearly,cm,coarse,condition,connivent,corolla,covering,decurrent,deep,diameter,distal,dot,drying,elliptic,especially,exceeding,filament,finely,flower,forked,forming,fresh,fruit,generally,glabrous,globose,green,greenish,hair,hair-like,half,herb,high,interjected,lanceolate,lateral,leaf,leaflet,like,lobe,long,make,margin,marked,medium,membranous,minute,mm,moderately,mucilaginous,obtuse,odd-pinnate,often,orbicular,ovate,ovoid,pedicel,peduncle,perfect,petiole,petiolulate,plant,puberulent,pubescent,rarely,ripe,rosette,rounded,scattered,seed,sessile,short,side,simple,size,sometimes,specimen,stamen,stem,stigma,straight,style,subtending,terminal,testal,thick,tube,typically,unwinged,usually,violet,wall,wet,white,whitish,without,x	0-4,1-10,1-8,5-merou,ag,along,alyx,apart,capitat,decreasing,digestion,dorsally,eaf,edge,eed,enzyme,flat,folded,geminat,glabrou,greatly,gree,green-white,hal,homostylous,honeycomb,larger,lengthening,living,lower,midrib,minutely,much,nflorescence,orolla,pair,pentagonal,plurifoliate,pore,poricidal,present,rachi,removed,ruit,semierec,seudostipule,shaped,slit,spaced,ste,tall,tamen,tem,throughout,tip,toward,tri-,unit,vary,yellow,ympodial	appearance,arrangement,bark,border,branch,calyx,capitate,characteristic,colour,corrugation,exertion,form,fruiting,giving,glabrousnes,growth,height,history,inflorescence,length,life,lobing,mentioned,midpoint,new,number,ovary,per,prickle,primary,pseudostipule,ray,semierect,shape,surface,texture,thicknes,type,variation,vein,width
64	wfo-0001026613	success	159	142	99	60	43	0.623	0.5-1,0.6,1-10,1-2,1.5-4,2-7.5,2.3-8,2.5-2.8,3-10,3-5,4-5,4.5-8.5,5,5-6,5-7,6-12,6-8,6.2-9.5,8-18,8.5-10,8.5-9,abaxially,absent,acumen,acuminate,adaxially,anther,apart,apex,articulated,attenuate,axillary,base,berry,bud,chartaceous,ciliate,cm,conical,connivent,cordate,corolla,densely,diameter,distal,especially,filament,flower,forked,fruit,generally,green,hair,half,herb,immature,interjected,lanceolate,lateral,leaf,leaflet,like,lobe,long,m-1.2,margin,mature,membranous,middle,minute,mm,mottled,odd-pinnate,ovate,pedicel,peduncle,petiole,petiolule,plant,proximal,pubescent,purple,semierect,size,spaced,sparsely,stem,stigma,style,subtending,symmetrical,tall,terminal,tip,tube,unknown,unwinged,usually,x	11-19.5,5-merou,5.5-7,9.5-13.5,ag,along,alyx,apparently,axe,blade,borne,capitat,decreasing,dorsally,eaf,edge,eed,end,erec,flat,folded,geminat,glabrous,greatly,hal,homostylous,larger,lengthening,lower,midrib,minutely,nflorescence,orolla,pair,perfect,plurifoliate,pore,poricidal,puberulent,pubescen,rotate-pentagonal,ruit,secondary,seudostipule,singly,slit,ste,stolo,subequal,tamen,tem,toward,tri-,tuber,typically,unit,unknow,vary,yellow,ympodial	appearance,arrangement,bark,border,branch,calyx,capitate,characteristic,colour,corrugation,drying,erect,exertion,form,fruiting,giving,glabrousnes,growth,height,history,inflorescence,length,life,lobing,midpoint,new,null,number,ovary,per,prickle,primary,pseudostipule,ray,seed,shape,surface,texture,thicknes,type,variation,vein,width
65	wfo-0001026614	success	200	201	172	28	29	0.86	.8,0.2,0.2â0.3,0.4-0.7,0.5,0.5â2,1.3-1.8,1.5â2,11-15,15â30,1â2,1â3,1â5,2.2,2.2-5.5,2.5,2.5â3,20â25,2â4,2â6.5,3-foliate,3.2-5.2,4-7,4.5â11,4.5â5.5,5,5.3-8.2,50,6.4-8.4,6â8,7.2-9.8,8â10,9â16,>,abaxially,absent,across,acuminate,acute,adaxially,anther,apart,apex,armed,articulated,base,berry,black,blade,blunt-tipped,broad-based,brown,calyx,campanulate,chartaceous,clavate,closely,cm,commonly,concentrated,cylindrical,dark,densely,denser,developed,diameter,directed,distally,dried,entire,erect,especially,evenly,expanded,filament,flattened-reniform,fleshy,flower,foveolate,fruit,fruiting,geminate,glabrescent,glabrous,gland-tipped,globose,golden,hair,homostylous,internode,interpetalar,irregularly,lanceolate-attenuate,lateral,leaf,less,linear,lobe,lobed,long,margin,midpoint,midvein,minute,minutely,mm,mottled,nearly,oblique,obtuse,often,orange,orange-red,ovate,ovate-lanceolate,ovoid,pair,pedicel,peduncle,per,petiole,pore,prickle,pubescence,pubescent,rachi,rarely,ray,reflexed,repand,ripe,rotate-pentagonal,rounded,scattered,sessile,shallowly,shrub,side,similar,simple,slightly,smaller,sometimes,somewhat,soon,spaced,sparsely,spreading,stellae,stellate,stellate-pubescent,stem,stigma,style,surface,tall,tapering,time,tissue,tube,unarmed,usually,vein,weakly,well,white,wide,x,yellow,yellowish,young,â5	1-,2â4-branched,3â10,5-merou,adaxiall,alyx,apparently,axe,ba,capitat,eaf,eed,extra-axillary,globo,lon,lower,nflorescence,orolla,perfect,ruit,shin,tamen,tem,tissu,ud,unarme,vary,ympodia	5-merous,arrangement,bark,branch,bud,capitate,characteristic,colour,corolla,corrugation,drying,form,glabrousnes,growth,height,history,inflorescence,length,life,new,ovary,plant,primary,seed,shape,shiny,size,stamen,texture
66	wfo-0001026642	success	193	164	99	94	65	0.513	0.1,0.4,0.4â2.2,0.5,0.5â,0.5â3.5,1.0,1.2â6.2,1.6â8.0,12â30,1â3,4â7,50â100,6,<,abaxial,abaxially,adaxially,along,annual,anther,anthesi,apart,apex,appressed,articulated,axillary,base,bipinnate,black,blade,blue,borne,branched,brown,calyx,clavate,cm,dark,decumbent,densely,denser,diameter,elliptic,erect,filament,flattened,flower,fruit,glabrous,globose,green-purple,hair,herb,indumentum,lavender,leaf,length,lilac,lobe,long,mm,moderately,multicellular,number,oblong,obtuse,ovate,pale,pedicel,peduncle,perennial,perfect,petiole,pinnate,pitted,primary,pubescent,shallowly,shoot,simple,sometimes,spaced,sparsely,stigma,style,subglabrous,surface,time,tube,unicellular,uniseriate,vein,violet,white,woody,x,â4.5,â6	.05,.1,.8,0.1â0.3,0.2,0.25,0.5â0.7,0.5â1.7,0.5â2.0,0.6,0.6â1.0,0.75â1.0,0.75â2.0,0.7â1.6,0.8â1.2,1.0â2.0,1.2â1.7,1.2â2.0,1.2â3.5,1.9â3.0,1â10,2.0â4.0,2.5â3.5,2.5â4.0,2.8â3.0,3.0â5.1,3â5,4.0â6.0,5,5.0â7.0,acute,adaxiall,ag,axe,ba,cell,chartaceous,circular,connivent,cylindrical,decreasing,divided,eaf,eed,either,equal,fleshy,geminat,glabrescen,gland,glandular,half,lon,longitudinal,lower,m.,narrow,nflorescence,occasionally,often,opening,orolla,pair,pentagonal,pinnae,pore,poricidal,present,probably,rapidly,rounded,ruit,secondary,sessile,side,slit,stone,straight,tal,tamen,tem,tip,unifoliate,unit,usually,vary,wide,wing,yellow,ympodial,â1.2,â11.0,â2.0,â7	--,0.3,0.75,0.8,1,1.2,1.7,10,2.0,2.8,3.0,3.5,4,4.0,5.0,6.0,7,7.0,appearance,arrangement,bark,border,branch,bud,characteristic,colour,corolla,corrugation,distal,drying,exertion,form,fruiting,giving,glabrescent,glabrousnes,growth,height,history,inflorescence,interjected,lateral,leaflet,life,lobing,margin,mentioned,midpoint,new,ovary,per,plant,prickle,pseudostipule,ray,seed,shape,size,stem,terminal,texture,thicknes,type,variation,width
67	wfo-0001026651	success	222	197	155	67	42	0.698	-celled,0.2â1.3,0.35â2.6,0.9â3,1,1.8,1â2,2.2â10,2.8,2â11.5,2â13,2â3,2â4,2â4.5,2â8,3,3-plurifoliate,3â5,3â7,4,4â6,4â7.8,6â10,6â14,abaxially,absent,acuminate,acute,adaxially,anther,antrorse,apex,appressed,asymmetric,attenuate,base,beneath,berry,beyond,branch,broadly,brochidodromous,brown,brownish-green,calyx,capitate,ciliate,circular,cm,cylindrical,cyme,dark,decumbent,densely,diameter,drying,dull,elliptic,entire,equal,erect,exfoliating,exserted,eye,filament,flattened,flexuous,flower,fruit,geminate,glabrescent,glabrous,globose,green,hair,herb,hilum,hollow,impressed,lanceolate,lateral,leaf,length,light,like,lobe,long,major,margin,matte,midrib,minor,mm,moderate,mostly,much-branched,naked,narrowly-elliptic,new,normally,oblong-ellipsoid,obtuse,older,one,ovate-lanceolate,ovate-reniform,pedicel,peduncle,pedunculate,per,petiole,plant,prominent,pubescence,pubescent,region,revolute,ripe,rounded,secondary,seed,shape,shiny,shrub,similar,simple,size,slightly,small,sometimes,stamen,stem,stigma,style,sub-opposite,surface,tall,terminal,translucent,trichome,turning,unbranched,undulate,uniseriate,unit,upper,usually,vein,venation,visible,white,wide,woody,young,Ã	2â3.3,5-merou,8,accrescent,adaxiall,along,alyx,anisophyllous,antror,antrorsely,apar,arcuate,ark,articulated,axi,capitat,cell,chartaceous,connivent,cordate,decurrent,differing,directed,discolorous,eaf,eed,emarginate,frui,geniculate,glabrou,glandular,growt,head,highly,introrsely,less,longitudinal,lower,lying,markedly,membranaceous,moderately,multicellular,nflorescence,onto,opening,orolla,ovate-deltate,parallel,perfect,pore,poricidal,reduce,ruit,single-celled,slit,smaller,spaced,stalk,stellate,straight,subapical,tamen,tem,vary,yellow,ympodial	--,2,3.3,4.5,appearance,arrangement,bark,border,bud,characteristic,colour,corolla,corrugation,distal,exertion,form,fruiting,giving,glabrousnes,growth,height,history,inflorescence,interjected,leaflet,life,lobing,mentioned,midpoint,number,ovary,prickle,primary,pseudostipule,ray,sympodial,texture,thicknes,tube,type,variation,width
68	wfo-0001026656	success	211	170	124	87	46	0.588	0-4,0.3-4.2,0.4-6.5,0.7-10.5,0.9-13,1,1-1.8,1-10,1-2,1-3.8,1-4,1.1-8.1,1.5-7,10,2-6,2.5-17,20-60,4-10,4-13,4-8,5-18,5-35,5.5-27,9-11,abaxially,acumen,acuminate,acute,anther,apex,attenuate,base,blue,borne,broadly,brownish,bud,capitate,cell,chartaceous,cm,condition,corolla,covering,cuneate,dark,densely,diameter,distal,dot,drying,elliptic,especially,filament,flower,forked,fresh,fruit,generally,glabrous,glaucous,globose,green,green-white,greenish,greenish-yellow,hair,half,herb,interjected,lanceolate,lateral,leaflet,light,like,lobe,long,make,margin,membranous,mm,moderately,mottled,mucilaginous,narrowly,non-glandular,oblique,odd-pinnate,often,ovate,ovoid,pedicel,peduncle,petiole,plant,pubescent,purple,rachi,scattered,seed,short,sometimes,star,stem,stigma,style,subglabrous,subtending,symmetrical,terminal,testal,thick,throughout,tinged,truncate,tube,unwinged,violet,wall,wet,white,whitish,wide,wing	0.3-3,1-5,2-8,5,5-merou,absent,adaxially,ag,along,alyx,apart,articulated,bearing,blade,ciliate,clavat,connate,connivent,curved,decurrent,digestion,dorsally,eaf,edge,eed,end,enzyme,erec,exceeding,flat,folded,geminat,greatly,hair-like,homostylous,honeycomb-shaped,larger,lengthening,living,lower,lunate,middl,midvein,minutely,nflorescence,occasionally,orolla,pair,pentagonal,petiolulate,petiolule,plurifoliate,pore,poricidal,puberulent,pubescen,ranging,removed,rotate-pentagonal,ruit,scale-like,seudostipule,singly,slightly,slit,somewhat,spaced,specimen,stamen,ste,stolo,straight,subequal,tall,tamen,tem,tertiary,therefore,tip,tri-,tuber,typically,unit,vary,without,yellow,ympodial	'hair-like,0.3-5,appearance,arrangement,bark,border,branch,calyx,characteristic,clavate,colour,corrugation,erect,exertion,form,fruiting,giving,glabrousnes,growth,height,history,inflorescence,leaf,length,life,lobing,mentioned,midpoint,new,number,ovary,per,present,prickle,primary,pseudostipule,ray,shape,size,surface,texture,thicknes,type,variation,vein,width
69	wfo-0001026663	success	251	240	197	54	43	0.785	-2.9,-9.7,.5-2.5,/25-1/15,/3,0-160,0.2-0.6,0.3-0.8,1,1-2.5,1-3.2,1-5,1.1,1.1-2.1,1.2-2,1.4-2.6,1.4-3.1,1.6-2.3,1.9-2.6,1/2,1/3,1/4-1/2,10-26,12-14,2-12,2.1-2.6,2.5-3.7,2.8-5.3,2.9-5,2/3,24-45,3-5,3.5-5,3.8-5.7,31,4.7-25.9,5-8,5.5-,5.5-8.8,7.5-9,abaxially,accrescent,acuminate,acute,adaxially,along,angled,anther,anthesi,apart,apex,articulated,attenuate,axe,axillary,bark,base,becoming,berry,blade,blunt-tipped,branch,branched,broadly,brown,bud,calyx,chartaceous,closely,cm,completely,conical,constricted,corolla,covering,dark,densely,diameter,distributed,drying,echinoid,echinoid-pubescent,elongated,entire,enveloping,especially,evident,exserted,filament,fleshy,flower,fruit,fruiting,glabrescen,glabrescent,glabrous,globose,granular,granular-tomentose,green,greenish-brown,grooved,hair,immature,inserted,lanceolate,lateral,leaf,length,less,light,line,lobe,lobed,long,long-stalked,longitudinally,lower,main,many,margin,midrib,minute,mm,multangulate,multangulate-pubescent,nearly,obtuse,occuring,older,openly,ovate,ovate-lanceolate,pale,pedicel,peduncle,persistent,petiole,plurifoliate,porrect-stellate,present,pseudo-terminal,pubescence,pubescent,rather,ray,rich,robust,scabrous,sessile,short,short-stalked,shrub,side,simple,slightly,small,sometimes,soon,spaced,sparsely,stalk,stalked,stem,stigma,strongly,style,subcampanulate,subcoriaceous,subglabrous,subglobose,suture,tall,terete,thick,thin,time,tip,tomentose,tomentose-pubescent,tomentum,touching,tree,tube,unarmed,unit,upper,usually,vein,violet,way,white,whitish,wide,x,yellow,young	-15,-8,0.4-2.2,0.9-1.5,10.3-13.2,4.5-5.7,8-17,adaxiall,ag,apparently,appressed,around,ascending,capitat,cylindrical,directed,distally,eaf,echinoi,edge,eed,farinose,flared,free,lengthening,lined,long-stalke,longer,longitudinal,m.,matur,midvein,nflorescence,occasional,opening,orolla,ovate-lanceolat,perfect,pore,poricidal,rachi,ridged,ruit,runk,slit,somewhat,stamen,stellate,tamen,tangled,ud,unarme,vary,ympodial	appearance,arrangement,border,capitate,characteristic,colour,corrugation,distal,exertion,form,giving,glabrousnes,growth,height,history,inflorescence,interjected,leaflet,life,lobing,mature,midpoint,new,null,number,ovary,per,plant,prickle,primary,pseudostipule,seed,shape,size,surface,sympodial,terminal,texture,thicknes,trunk,type,variation,width
70	wfo-0001026686	success	196	150	107	89	43	0.546	.4,0.6-0.9,1,1-2,1-2.5,1.2-3.4,1.5-7,1.7-2.5,10-28,2-10,2-9,2.4-3.6,2.5-8,3-4,3.7-8,4-6,5,5-16.5,5-8,6.5-12.7,7-9,8-10,8-14,8-27,abaxially,acuminate,adaxially,anther,apex,apparently,axe,axillary,base,berry,blade,brownish,bud,cell,cm,condition,conical,corolla,covering,densely,diameter,distal,drying,elliptic-lanceolate,filament,flower,forked,fresh,fruit,generally,green,greenish,half,herb,interjected,lanceolate,lateral,leaf,leaflet,light,lobe,long,make,margin,minute,mm,mottled,mucilaginous,odd-pinnate,orbicular,ovate,ovoid,pedicel,peduncle,perfect,petiole,petiolule,plant,pubescent,purple,purple-violet,ripe,seed,semierect,size,sparsely,stigma,straight,style,subsessile,subtending,symmetrical,terminal,testal,thick,tube,usually,wall,wet,whitish,wide,wing,x	0.2-0.5,1-10,1.2-3.6,3-5,5-merou,absent,acumen,ag,along,alyx,apart,articulated,borne,capitat,chartaceous,ciliate,connivent,decreasing,digestion,dorsally,eaf,edge,eed,end,enzyme,equal,erec,especially,exceeding,flat,folded,geminat,glabrou,glabrous,gradually,green-white,hair,hair-like,homostylous,honeycomb-shaped,larger,lengthening,like,living,lower,middle,midrib,minutely,nflorescence,obtuse,often,orolla,pair,plurifoliate,pore,poricidal,puberulent,pubescen,removed,rotate-stellate,round,ruit,secondary,seudostipule,singly,slightly,slit,spaced,specimen,stamen,star,ste,stolo,stripe,subequal,tall,tamen,tem,throughout,tip,toward,tri-,tuber,typically,unit,vary,white,yellow,ympodial	'hair-like,appearance,arrangement,bark,border,branch,calyx,capitate,characteristic,colour,corrugation,erect,exertion,form,fruiting,giving,glabrousnes,growth,height,history,inflorescence,length,life,lobing,mentioned,midpoint,new,number,ovary,per,prickle,primary,pseudostipule,ray,shape,stem,surface,texture,thicknes,type,variation,vein,width
71	wfo-0001026696	success	139	162	108	31	54	0.777	0.3-4.5,0.8-7,0.9-7.2,1,1-1.3,1-4,1.3-2.1,1.5-3,2-17,2-3,3-17,3-3.5,3-6,3-6-foliat,3-8.5,4-16,5-35,9,abaxially,acumen,acute,adaxially,apex,apiculate,articulate,base,branched,broadly,calyx,cell,cm,connate,corolla,covering,cuneate,cyme,decurrent,densely,diameter,dichasial,dichasially,distal,dorsally,ebracteate,edge,entire,exceeding,filament,flat,flower,folded,forked,generally,globose,green,green-white,hair-like,half,herbaceous,lanceolate,lateral,light,linear,living,lobe,long,make,margin,mm,monochasial,mucilaginous,oblong,obtuse,odd-pinnate,often,ovate,ovoid,pedicel,peduncle,perennial,perfect,petiole,plant,proximal,pubescent,rounded,seed,seudostipule,simple,sinuate,specimen,stamen,stellate,stigma,straight,style,testal,thick,throughout,tuber-bearing,typically,unit,wall,white-cream,wide,without,yellow,Â¼	apical,apically,dehiscent,digestion,eaf,eed,emoval,enzyme,globo,honeycomb,introrse,light-yello,lon,lower,lunat,maturing,nflorescence,nther,orolla,pattern,plan,poricidally,reveal,ruit,short,slit,tal,tem,throughou,vary,ympodial	anther,appearance,arrangement,bark,border,branch,bud,characteristic,colour,corrugation,drying,exertion,form,fruit,fruiting,giving,glabrousnes,growth,height,history,inflorescence,interjected,leaf,leaflet,length,life,light-yellow,lobing,lunate,midpoint,new,null,number,ovary,per,prickle,primary,pseudostipule,ray,shape,size,stem,surface,sympodial,tall,terminal,texture,thicknes,tube,type,variation,vein,wet,width
72	wfo-0001026706	success	232	249	204	28	45	0.879	-3.1,-4.4,-5.5,-6.1,.5,/14-1/6,0-240,0.2-0.3,0.2-0.5,0.6-2.2,0.8-1.2,0.8-1.5,0.8-2.8,0.9-1.9,0.9-2,1-2.2,1-5,1.1-4,1.5-3,1/2-2/3,10-15,12,14-32,2.2-3.3,2.3-3.8,2.5-3,2.7-4,2.9-6,2/3-3/4,3-4.6,3.1-3.8,3.6-5.7,4,4.2-12,4.5-5.5,5-6.5,5.3-6.4,6-10,6.1-,7-16,9.8-15.4,abaxially,accrescent,acute,adaxially,anther,anthesi,apart,apex,appearing,around,articulated,attenuate,axe,axillary,bark,base,becoming,berry,blade,blunt-tipped,branch,branched,brown,bud,calyx,chartaceous,closely,cm,completely,coriaceous,corolla,covering,crisped,cuneate,cylindrical,dark,dendritic-echinoid,dendritic-multangulate,densely,diameter,directed,distally,edge,entire,enveloping,exserted,farinose,filament,fleshy,flower,fourth,free,fruit,fruiting,glabrate,glabrous,globose,golden,grayish,green,hair,herbarium,indument,inserted,lacking,lanceolate,lateral,leaf,length,lengthening,lobe,lobed,long,long-stalked,longitudinal,lower,main,many,margin,matted,midrib,minute,mixed,mm,multangulate,nearly,oblong,obtuse,occasionally,often,older,ovate,ovate-elliptic,ovate-lanceolate,pale,pedicel,peduncle,persistent,petiole,plurifoliate,pore,poricidal,porrect-stellate,pseudo-terminal,pubescence,pubescent,rachi,rather,reddish,reticulate-punctate,semi-ovate,sessile,short-,short-stalked,shrub,side,simple,slightly,slit,small,softly,somewhat,soon,spaced,sparsely,specimen,splitting,stalked,stamen,stellate,stem,stigma,strongly,style,subcampanulate,subconical,subglobose,suborbicular,sulcate,surface,tall,time,tip,tomentose-pubescent,touching,translucent,tree,tube,unarmed,unevenly,unit,upper,vein,velutinous,wavy,way,white,whitish,wide,x,yellow,yellowish-tan,young	6-8,8-14,adaxiall,ag,apparently,ba,capitat,eaf,eed,furfuraceou,lackin,m.,multangulat,nflorescence,obscured,orolla,perfect,ruit,runk,suture,tamen,thin-walled,tomentu,transparent,ud,unarme,vary,ympodial	age,appearance,arrangement,border,capitate,characteristic,colour,corrugation,distal,drying,exertion,form,furfuraceous,giving,glabrousnes,growth,height,history,inflorescence,interjected,leaflet,life,lobing,midpoint,new,null,number,ovary,per,plant,prickle,primary,pseudostipule,ray,seed,shape,size,sympodial,terminal,texture,thicknes,trunk,type,variation,width
73	wfo-0001026707	success	196	151	108	88	43	0.551	-1/3,.5,.8,/3,0-20,0.05,0.5-1,0.6-0.7,0.7-1.4,1-5,1.5-1.8,1.6-2,1/3,1/3-1/2,1/8-1/4,11-16,2-2.3,2.5-4,3-4,4,5-25,5-merous,8-15,acute,anther,apart,apex,apparently,articulated,attenuate,bark,base,berry,blade,calyx,cm,connivent,curved,decurrent,diameter,drying,entire,equal,erect,eye,filament,flattened-reniform,flower,free,fruit,fruiting,fused,gently,glabrous,lateral,leaf,length,less,lobe,lobed,long,margin,mauve,midpoint,mm,moderately,naked,orange-brown,pedicel,peduncle,per,petiole,poricidal,porrect-lepidote,portion,prickle,prickly,ray,rounded,scar,sessile,shorter,shrub,small,spaced,spherical,stalked,stellate,stellate-pubescent,stem,stout,style,surface,tapering,terete,terminal,tip,tree,trichome,tube,unarmed,upper,variously,venation,visible,way,white,wide	-3,-5,0,0.05-0.15,0.1-0.2,0.3-0.8,0.5-3,0.6-0.8,0.7-1,0.7-1.5,1-1.7,1-3,1/3-3/4,1/4-1/3,2-10,2-6,2.5-3,2.5-6,3-4.5,3-7,3-8,5-10,5-7,5-8,?,abaxially,alyx,apar,apically,branche,branched,broad-deltate,broadly,chartaceous,clustered,color,concolorous,cuspidat,densely,discolorous,eaf,eed,elongating,foliaceous,glabrescent,glabrou,gray,green,inflated,infructescence,juvenil,known,longer,lower,mature,narrow-deltate,narrow-oblong,nflorescence,obtuse,older,one,open,orolla,oung,perfec,pericarp,plurifoliat,porrect,pubescent,red-brown,reflexed,ruit,simple,slender,smooth,sometimes,sparsely,spreading,stalk,straight,tamen,time,unit,vary,weakly,yellow-green,ympodial,Â¼	appearance,arrangement,border,branch,bud,characteristic,colour,corolla,corrugation,distal,exertion,form,giving,glabrousnes,growth,height,history,inflorescence,interjected,juvenile,leaflet,life,lobing,new,null,number,ovary,perfect,plant,primary,pseudostipule,seed,shape,size,stamen,stigma,texture,thicknes,type,variation,vein,width,young
74	wfo-0001026711	success	210	204	175	35	29	0.833	-15,-2,-5,-6,.2,0,0-0.2,0-25,0-6,0.1,0.15,0.2-0.3,0.3-1,0.5-1.5,0.7-,0.7-0.9,0.7-1.4,0.75-1,0.8,0.8-2.2,0.9-1.1,0.9-1.5,1-,1-2,1-30,1.5-,1.5-2.2,1.7-4,1/2-2/3,1/3,1/4,1/4-1/3,2-2.2,2-2.5,2-3.5,2-4,2-6,2.1-2.5,3-4,3-4.5,3-5,3-7,4-8,4.5-7,5-merous,7-8,abaxially,acicular,ame,anther,apart,apex,apically,apparently,articulated,bark,base,berry,blade,branched,c.,calyx,cell,cm,concolorous,cuneate,curved,deltate,densely,diameter,difoliate,discolorous,distance,drying,dull,elliptic,elongating,erect,evenly,extending,faint,filament,flattened-reniform,flower,fruit,fruiting,glabrous,green,infructescence,lateral,leaf,length,less,lobe,lobed,long,longer,lower,margin,mature,maturity,mauve,midpoint,midvein,mm,moderately,narrow-deltate,occasionally,older,one,open,orange,orange-brown,outline,pair,pale,pedicel,peduncle,per,pericarp,perpendicular,petiole,pit,porrect,prickle,prickly,primary,purple,raised,ray,red,reflexed,rounded,scar,sessile,shallowly,shorter,shrub,side,slender,small,smooth,sometimes,somewhat,spaced,spherical,spreading,stalk,stalked,stellate,stellate-pubescent,stem,straight,style,surface,terete,terminal,tertiary,thick-chartaceous,time,trichome,tube,unarmed,uniform,variously,vein,venation,visible,way,weakly,wide,woody,yellow,yellow-green,young	-7,.5,.8,0-4,1/,3.5-5.2,acuminat,acute,alyx,apar,brow,connivent,eaf,eed,equal,free,geminat,nflorescence,obtuse,orolla,oung,pendulous,perfec,poricidal,portion,prickl,reduced,ruit,tamen,tapering,tip,unit,upper,vary,ympodial	acuminate,arrangement,branch,brown,bud,characteristic,colour,corolla,corrugation,exertion,form,geminate,glabrousnes,growth,height,history,inflorescence,life,lobing,new,ovary,perfect,plant,seed,shape,size,stigma,texture,type
75	wfo-0001026717	success	207	167	124	83	43	0.599	0.3-5,0.6-1.5,0.8,1-10,1-2,1-2.5,1-3,1.3-2.5,1.4-2.2,1.8-3,13-28,14-22,15-34,2.5-4.5,2.5-5.5,3-4,3-6,3.3-11,4-6,4-8,4-9,5,5-11,5-13.5,5-6,5.3-9,7-11,abaxially,acumen,acuminate,adaxially,anther,apex,apparently,attenuate,axe,axillary,base,berry,brownish,bud,cell,ciliate,cm,condition,conical,connivent,corolla,covering,dark,darker,decurrent,diameter,distal,drying,elliptic,especially,filament,flower,forked,fresh,fruit,generally,glabrous,green,greenish,half,herb,interjected,lanceolate,lateral,leaf,leaflet,light,lobe,long,make,margin,medium,middle,minute,mm,mottled,mucilaginous,narrow,odd-pinnate,often,orbicular,ovate,ovoid,pedicel,peduncle,perfect,petiole,petiolule,plant,pubescent,purple,ripe,seed,semierect,sessile,size,sparsely,stigma,straight,stripe,style,subsessile,subtending,symmetrical,terminal,testal,thick,tip,tube,usually,violet,wall,wet,whitish,wide,wing,x	0.3-0.6,0.3-2.5,2.2-5,3-5,5-merou,ag,along,alyx,apart,articulated,blade,borne,capitat,chartaceous,decreasing,digestion,dorsally,eaf,edge,eed,end,enzyme,equal,erec,exceeding,flat,folded,geminat,glabrou,gradually,green-white,hair,hair-like,homostylous,honeycomb-shaped,larger,lengthening,like,living,lower,membranous,midrib,minutely,nflorescence,obtuse,one-quarte,orolla,pair,pentagonal,plurifoliate,pore,poricidal,present,puberulent,pubescen,removed,rotate,round,ruit,secondary,seudostipule,singly,slightly,slit,spaced,specimen,stamen,ste,stolo,subequal,subglabrous,tall,tamen,tem,throughout,toward,tri-,tuber,typically,unit,vary,yellow,ympodial	'hair-like,appearance,arrangement,bark,border,branch,calyx,capitate,characteristic,colour,corrugation,erect,exertion,form,fruiting,giving,glabrousnes,growth,height,history,inflorescence,length,life,lobing,mentioned,midpoint,new,number,ovary,per,prickle,primary,pseudostipule,ray,shape,stem,surface,texture,thicknes,type,variation,vein,width
76	wfo-0001026725	success	166	198	152	14	46	0.916	.3,.5,/4,0.2,0.7-1.2,1-1.2,1-1.5,1-4.5,1-5,1.2-1.7,1.5,1.5-2,1.6-2,1/2,2,2.2-4,3.5-4,3.6-7.7,5-20-flowered,5-5.5,5-6,8-18.6,8-9,accrescent,acute,anther,anthesi,apart,apex,attenuate,axil,bark,base,becoming,beneath,berry,black,bluish,broadly,brownish-papillose,calyx,capitate,character,cm,corolla,cup-shaped,dark,deflexed,dia,differing,difoliate,dry,drying,ellipsoid,elliptic,evenly,extremely,filament,flattened-reniform,free,fruit,fruiting,geographically,glabrous,glandular-papillose,globose,green,greenish-white,incrassate,interpetalar,large,lateral,leaf,less,lobe,lobed,long,main,major,margin,material,middle,minor,minutely,mm,occasionally,often,older,one,onto,open,opposite,ovary,ovate,ovoid,pair,pale,paler,papillose,pedicel,petiole,pitted,planar,pore,poricidal,portion,prominent,proximal,pubescent,reddish-brown,reflexed,rounded,scar,scarious,shaped,short,shrub,simple,sinus,size,slender,slightly,spaced,split,stem,stigma,straight,stretching,style,subshrub,surface,tall,tan,tapering,tear-drop,tip,triangular,trichome,tube,tuft,uniseriate,unit,upper,varying,vein,way,white,widest,winged,woody,x,young	crackin,eaf,edicel,eed,geminat,inflorescenc,lon,lower,margine,nflorescence,papillo,ruit,ud,ympodial	appearance,arrangement,border,branch,bud,characteristic,colour,corrugation,cracking,diameter,distal,exertion,form,geminate,giving,glabrousnes,growth,height,history,inflorescence,interjected,leaflet,length,life,lobing,margined,mentioned,midpoint,new,number,peduncle,per,plant,prickle,primary,pseudostipule,ray,seed,shape,sympodial,terminal,texture,thicknes,type,variation,width
77	wfo-0001026733	success	188	153	99	89	54	0.527	-13,-4,-7,0.3-0.5,0.3-2,0.5-2,1-1.5,1-2,1-3,1-7,1.5-14,10-20,15-,2-2.5,2.5-7.5,20-50,25-40,3-15,3-3.5,3-7,4,4-23,4-5,5-8,abaxially,acuminate,acute,acute-acuminate,adaxially,apex,basal,base,blade,calyx,chartaceous,cm,color,connivent,cordate,curled,deltate,dense,densely,diameter,eglandular-pubescent,ellipsoidal,elliptic-ovate,entire,flattened,flower,forked,fruit,fusiform,glabrate,glabrous,gland-tipped,glandular-,green,greyish,hair,hirsute,immature,lanceolate,lobe,long,longitudinal,margin,mm,moderately,oblique,ovate,ovoid,pedicel,peduncle,petiole,pilose,pubescent-pilose,ripe,shining,simple,small,sometimes,stigma,stripe,style,submarginally,time,tree,truncate,tube,unbranched,unknown,vein,villous,white,white-puberulent,wide,x,yellowish	-1,-11,-14,-15,-2,-8,.5-3,0.5,0.5-1,0.5-4,1,1.5-2,1.5-2.5,2-3,2-4,2-6,3-4-foliat,4.5-5,7-10,8-12,aggregate,apart,ape,articulated,axe,beyond,capitat,cell,ciliat,connective,cylindrical,dia,directed,distally,eaf,eed,eglandular-pilose,eglandular-villous,equal,especially,exceeding,exserted,glandula,glandular-puberulent,glandular-tomentose,leaving,linear-triangular,lon,lower,membranaceous,midrib,narrowly,near,nflorescence,nther,orolla,ovum,pedicellar,perfect,pore,present,pubescent,pubescent-pilo,rachi,radiu,remnant,round,ruit,shorter,slightly,smooth,spaced,sparsely,stamen,stellate,stone,swelling,tal,tem,thecae,toward,triangular,ud,unit,unknow,usually,vary,yellow,ympodial	anther,appearance,arrangement,bark,border,branch,bud,capitate,characteristic,colour,corolla,corrugation,distal,drying,exertion,filament,form,fruiting,giving,glabrousnes,growth,height,history,inflorescence,interjected,lateral,leaf,leaflet,length,life,lobing,mentioned,midpoint,new,number,ovary,per,plant,prickle,primary,pseudostipule,ray,seed,shape,size,stem,surface,tall,terminal,texture,thicknes,type,variation,width
78	wfo-0001026734	success	266	232	187	79	45	0.703	0.5,0.6,0.7â0.9,0.7â1,0.8â1,1,1.6â2.5,1.8â2.2,1.8â3,1/4,1â1.2,1â3,2.2â7,2.3â5,2.5â3,2â2.4,2â3,3,3.2â3.8,3â4,3â8,5â9,8,abaxial,absent,accrescent,acuminate,acute,adaxially,anther,anthesi,apex,apical,ark,asymmetric,axi,barely,base,becoming,beneat,berry,blade,branch,branched,bright,broadly,brown,calyx,camptodromous,celled,central,chartaceous,clavate,closely,cm,congested,connivent,corolla,covered,covering,cuneate,cylindrical,cyme,dark,dense,densely,denser,diameter,differing,discolorous,downward,drying,due,elliptic,emergent,entire,flattened,flower,foliate,free,fruit,geminate,glabrescen,glabrous,glandular,globose,gray,green,growth,hair,held,immature,initially,internodal,irregular,lamina,lanceolate,lateral,leaf,length,less,lobe,lobed,long,long-attenuate,margin,mature,maturity,membranaceous,midpoint,mm,moderately,much,narrow,near,new,normally,oblong,obovate,observed,obtuse,old,older,one,other,ovary,ovate,paired,pale,papillose,pedicel,peduncle,petiole,pit,plane,porrect,porrect-stellate,portion,pubescence,pubescent,purple,rachi,rarely,ray,reaching,reniform,rounded,scandent,sessile,shape,shiny,short-stalked,shorter,shrub,simple,size,slightly,smaller,sometimes,spaced,sparsely,spread,spreading,stellate,stem,stigma,style,subopposite,subsessile,surface,terminal,trichome,tube,unbranched,unequal,uniseriate,unit,vein,venation,vestiture,visible,white,whole,wide,yellow,yellowish,Â¾	0.1,0.2,0.3,1.6â2,3â4-celled,4â6,4â7,4â8,4â9,5-merou,abaxially,adaxial,adaxiall,ag,also,always,alyx,apice,archin,articulated,associated,beneath,caly,capitate,commonly,directed,distally,dried,eaf,eed,eglandular,erect,f.,fewer,flat,forked,found,frequently,glabrescent,ilament,introrsely,j,large,longer,longitudinal,lower,lying,material,maturit,midri,minute,mostly,multiseriate,nflorescence,often,one-celled,opening,orolla,oung,pair,perfect,pointing,pore,poricidal,purplish,raised,rayed,ruit,secondary,slit,sparse,stalk,still,surfac,tuft,ud,upward,vary,ympodial	--,1.6,2,2.4,2.5,appearance,arching,arrangement,bark,border,bud,characteristic,colour,corrugation,distal,exertion,filament,form,fruiting,giving,glabrousnes,height,history,inflorescence,interjected,larger,leaflet,life,lobing,mentioned,midrib,number,per,plant,prickle,primary,pseudostipule,seed,sympodial,texture,thicknes,type,variation,width,young
79	wfo-0001026740	success	171	168	115	56	53	0.673	-2,0-10,0.5-1,1-10,1-2,1-5,10-20,10-30,2-3,2-4,2.5-27,2.5-4.5,2.5-6,20-50,3-15,3-3.5,3.5-40,4-5,4.5-10,5-40,5-8,6-10,abaxially,acuminate,acute,acute-acuminate,adaxially,also,apart,apex,apiculate,articulated,axe,basal,base,beyond,branched,calyx,cm,connivent,cordate,corky,curled,cylindrical,darker,deltate,densely,diameter,eglandular,ellipsoidal,elliptic,entire,especially,exserted,flattened,flower,fruit,glabrous,glandular-puberulent,greenish,hair,immature,lanceolate,leaving,lobe,long,margin,mature,mm,moderately,narrowly,near,nearly,oblong,obtuse,often,ovate,ovoid,pedicel,pedicellar,peduncle,perfect,petiole,pilose,present,puberulent,purple,remnant,reticulate,scar,sessile,simple,small,sometimes,spaced,sparsely,stamen,stigma,stripe,style,time,tomentose,tree,triangular,truncate,tube,unbranched,vein,villous,white-puberulent,whitish,wide,woody,x,yellow	-17,1-12,1-3,1-4,2.5-3,3-5,3-foliat,8-19,absen,absent,aggregate,ape,blade,browni,cell,ciliate,connective,directed,distally,eaf,eed,equal,exceeding,fleshy,glabrate,lon,lower,nflorescence,nther,orange,orolla,pilo,pore,pubescent,rachi,radiu,rarely,ruit,shorter,slightly,stellate,stone,subcoriaceous,swelling,tal,tems,thecae,toward,truncat,ud,unit,unlobed,vary,violet,ympodial,young	anther,appearance,arrangement,bark,border,branch,bud,characteristic,colour,corolla,corrugation,distal,drying,exertion,filament,form,fruiting,giving,glabrousnes,growth,height,history,inflorescence,interjected,lateral,leaf,leaflet,length,life,lobing,midpoint,new,null,number,ovary,per,plant,prickle,primary,pseudostipule,ray,seed,shape,size,stem,surface,tall,terminal,texture,thicknes,type,variation,width
80	wfo-0001026752	success	169	173	116	53	57	0.686	-25,-3,-4,-50,0-,1,1-1.5,1-12,1-2,1-3,1-5,1-6,1.5-2,1.5-2.5,10-20,15-35,2,2-2.5,2-4,2.5-20,2.5-5,20-30,3,3-18,3-4,3.5-4,4-45,4-5,7-15,abaxially,abruptly,acute,adaxially,also,apart,apex,apiculate,axe,basal,base,beyond,black,blade,branched,calyx,cm,connivent,cordate,cuneate,cylindrical,darker,deltate,densely,diameter,dilated,distally,ellipsoidal,elliptic-oblong,elliptic-ovate,entire,exserted,finely,flattened,fleshy,flower,forked,fruit,glabrous,globose,green,greenish-brown,hair,immature,lanceolate,lobe,long,margin,mm,moderately,narrowly,nearly,obtuse,ovoid,papillose,pedicel,peduncle,perfect,petiole,pilose,possibly,pubescent,pubescent-pilose,purplish,rarely,ripe,short-acuminate,simple,slightly,small,stamen,stigma,stripe,style,time,tree,triangular,truncate,tube,unbranched,vein,violet,white,whitish,wide,x,yellow	1.5-12,2-3,3-5,3-foliat,8-16,absent,aggregate,ape,articulated,campanulate,capitat,cell,chartaceous,connective,coriaceous,directed,eaf,eed,equal,exceeding,laterally,leaving,less,lon,lower,near,nflorescence,nther,orolla,pedicellar,pilo,pore,presence,present,rachi,radiu,rather,remnant,ruit,somewhat,spaced,stellate,stone,tal,tem,thecae,tomento,ud,unit,unknow,vary,yello,ympodial	.5-4,3-foliate,anther,appearance,arrangement,bark,border,branch,bud,capitate,characteristic,colour,corolla,corrugation,distal,drying,exertion,filament,form,fruiting,giving,glabrousnes,growth,height,history,inflorescence,interjected,lateral,leaf,leaflet,length,life,lobing,midpoint,new,null,number,ovary,per,plant,prickle,primary,pseudostipule,ray,seed,shape,size,stem,surface,tall,terminal,texture,thicknes,tomentose,type,variation,width
81	wfo-0001026754	success	176	164	121	55	43	0.688	-6+,0.5,0.5-1,0.9-1.1,1,1-,1.5-3,1/2,10,2,2-2.5,2.5-3.5,2/3,3-4-celled,30+,5,5-lobed,5.5-9,7-9,acute,adaxially,along,anther,anthesi,apex,apparently,asymmetric,axi,basal,base,berry,branched,broadly,calyx,clavate,cm,complete,conical,corolla,deeply,dendritic,densely,diameter,distal,divided,ellipsoid,elliptic,entire,especially,exerted,extending,filament,flower,glabrous,globose,growth,half,halfway,inflorescence,irregularly,lamina,later,lateral,leaf,like,lobe,lobed,long,lower,many,margin,mature,membranous,minute,minutely,mixture,mm,mostly,narrowly,new,oblique,outline,pair,pedicel,peduncle,petiole,pinnate,primary,puberulent,pubescent,scandent,seen,simple,slender,sometimes,sparsely,splitting,spreading,stem,stigma,style,surface,tangled,terminal,time,transparent,trichome,truncate,tube,twining,uniseriate,upper,vein,vine,way,weak,white,within,woody,x,yellowish	.5,198.,2-3,2-4,4-5,5-merou,9,9-11,abaxially,ag,alyx,apar,ark,articulated,brow,cabrera,connivent,cucullat,denser,eaf,ed,fide,free,ilament,leaving,lengthening,loosely,midvein,nflorescence,older,orolla,papillo,peg,perfect,planar,plurifoliat,pore,poricidal,portion,ruit,scar,sleeve,slit,small,spaced,stellate-rotate,tem,tip,tub,twinin,ud,unit,vary,yellow,ympodial	appearance,arrangement,bark,border,branch,brown,bud,characteristic,colour,corrugation,drying,exertion,form,fruit,fruiting,giving,glabrousnes,height,history,interjected,leaflet,length,life,lobing,mentioned,midpoint,null,number,ovary,papillose,per,plant,prickle,pseudostipule,ray,seed,shape,size,texture,thicknes,type,variation,width
82	wfo-0001026756	success	147	161	114	33	47	0.776	.25,.5,0-7-1.2,0.5-1,0.5-3,1-1.5,1-2,1.5-1.7,1.5-10,1.5-2,1.5-3,1.8-3,3-4,3.5-8.5,5-10,5-10-flowered,5-5.5,6-10,6-16,abaxially,acute,adaxially,along,anther,anthesi,apex,apiculate,attenuate,bark,base,berry,bilobed,broadly,brown,calyx,cm,conical,corolla,corresponding,dark,deflexed,deltate,dendritic,densely,denser,dia,difoliate,distal,elliptic,erect,exserted,filament,fleshy,fruiting,glabrescent,glabrous,globose,green,lateral,lax,leaf,like,lobe,lobed,long,main,middle,minutely,mm,nearly,occasionally,opposite,ovary,ovate,ovoid-reniform,pair,pale,pedicel,perhaps,petiole,pinkish-white,pitted,planar,pore,poricidal,pubescence,pubescent,rest,shape,shaped,shrub,simple,somewhat,soon,sparsely,stem,stigma,strongly,style,surface,tall,tear-drop,thick,tip,tree,trichome,tube,unifoliate,vein,white,wide,widest,woody,young	0.25-0.5,abaxial,ba,closely,differing,eaf,edicel,eed,free,geminat,grayish-brow,hard,inflorescenc,irregular,lamina,lower,major,minor,nflorescence,older,overlappin,papillo,pericarp,portion,present,ruit,scar,spaced,tub,ud,uniseriate,unit,ympodial	appearance,arrangement,border,branch,bud,characteristic,colour,corrugation,diameter,drying,exertion,form,fruit,geminate,giving,glabrousnes,grayish-brown,growth,height,history,inflorescence,interjected,leaflet,length,life,lobing,margin,midpoint,new,number,papillose,peduncle,per,plant,prickle,primary,pseudostipule,ray,seed,size,specified,terminal,texture,thicknes,type,variation,width
83	wfo-0001026777	exception_thrown	168	0	0	168	0	0.0		.25,.5,/3,0.25-0.5,0.5-1,0.5-1.5,0.5-5,0.9-3,1-1.3,1-1.5,1-10,1-2,1-4,1.2-1.8,1.5-3,1.5-5,2-4,2-4.5,2-5,3-3.5,4-8,5-14,5-50-flowered,5-7,acuminate,acute,anther,anthesi,apart,apex,apiculate,axil,ba,base,beginning,beneath,berry,blue,body,branching,brown,calyx,campanulate,capitate,cell,cm,corolla,cup,decurrent,deflexed,dense,dia,differing,difoliate,distal,eaf,edicel,eed,elliptic,end,exserted,fide,filament,filiform,flattened,flattened-reniform,flexuous,free,fruiting,geminat,glabrate,glabrous,globose,green,greyi,growth,hyaline,incrassate,inflorescenc,irregularly,lateral,leaf,like,lobe,lobed,lon,long,lower,main,major,margin,matted,middle,minor,minutely,mm,narrowly,near,nearly,new,nflorescence,occasionally,often,older,one,onto,opposite,outline,ovary,overtopping,pair,papillo,papillose,pedicel,petiole,pitted,planar,pore,poricidal,portion,prominent,pubescent,quadrate-deltoid,quite,rest,ruit,russet,scar,seed,shaped,shiny,shrub,sinuate,size,slightly,smooth,somewhat,soon,spaced,sparsely,stem,stigma,straight,style,surface,tall,tapering,tear-drop,testa,thread-like,tip,trichome,tube,tuft,ud,uniseriate,unit,vein,vellozo,wall,way,white,widest,woody,x,yellowish,ympodial,young	
84	wfo-0001026819	success	218	174	129	89	45	0.592	0-27,0.3-4.7,0.5-1.5,1-2,1-2.3,1.2-36,1.5-10,1.5-12,1.5-3.0,1.5-3.3,1.6-3.5,10-26,2-5,2.5-5,3-120,3-18,3-20,3-35,3-38,4,4-10,4-7,5-30,6-11,abaxially,acumen,acuminate,acute,anther,apex,ascending,attenuate,base,blue,borne,broadly,brownish,bud,capitate,cell,chartaceous,cm,condition,connate,connivent,corolla,covering,cuneate,dark,densely,diameter,distal,dot,drying,elliptic,especially,filament,flower,forked,fresh,fruit,generally,glaucous,globose,green,greenish,greenish-yellow,hair,half,herb,interjected,lanceolate,lateral,leaflet,light,like,lobe,long,make,margin,membranous,mm,moderately,mottled,mucilaginous,narrowly,non-glandular,oblique,odd-pinnate,ovate,ovoid,pedicel,peduncle,petiole,plant,plurifoliate,pubescent,purple,rachi,scattered,seed,short,slightly,sometimes,star,stem,stigma,stripe,style,subglabrous,subrosette,subtending,symmetrical,tall,terminal,testal,thick,tinged,tri-,truncate,tube,unwinged,violet,wall,wet,white,whitish,wide,wing	1-10,1-5,1.5-3.5,10,2-6,5-merou,7,absent,adaxially,ag,along,alyx,apart,articulated,bearing,blade,ciliate,clavat,curved,decurrent,digestion,dorsally,eaf,edge,eed,end,enzyme,erec,exceeding,flat,folded,geminat,glabrou,glabrous,greatly,green-white,hair-like,homostylous,honeycomb-shaped,larger,lengthening,living,lower,lunate,middle,midvein,minutely,nflorescence,often,orolla,pair,pedice,pentagonal,petiolule,pore,poricidal,puberulent,ranging,removed,rotate-pentagonal,ruit,scale-like,seudostipule,singly,slit,somewhat,spaced,specimen,stamen,ste,stolo,straight,subequal,suborbicular,tamen,tem,tertiary,therefore,throughout,tip,tuber,typically,unit,usually,vary,within,without,yellow,ympodial	'hair-like,appearance,arrangement,bark,border,branch,calyx,characteristic,clavate,colour,corrugation,erect,exertion,form,fruiting,geminate,giving,glabrousnes,growth,height,history,inflorescence,leaf,length,life,lobing,mentioned,midpoint,new,number,ovary,per,prickle,primary,pseudostipule,ray,shape,size,surface,texture,thicknes,type,variation,vein,width
85	wfo-0001026821	success	204	183	134	70	49	0.657	.2,/3,0-20,0.2-1.5,0.3-1.2,0.3-2.5,0.4-1.5,0.5-1.2,0.5-3.5,0.7-1.8,0.8-1,1-1.5,1-2,1-20,1-3,1-5,1.2-1.5,1.5-2.5,10-15,2-15,2-3.5,2-6,2-celled,2.5-18,3-11,3-18,3-6,3-7,3-branched,3-celled,4-4.5,5-12,5-20,5-34,acuminate,angular,anther,apart,apex,apically,apiculate,appressed,articulated,axe,base,bayonet,berry,blade,broadly,brown,cm,cordate,dark,deltate,diameter,distal,due,ellipsoidal,elliptic,exceeding,filament,flattened,flower,forked,frequent,fruit,fused,gglobose,glabrous,gland-tipped,green,hair,herb,incurved,interjected,lanceolate,lateral,leaf-opposed,leaflet,length,light,lobe,long,long-attenuate,many,margin,mature,membranous,minutely,mm,narrowly,oblique,oblong,obtuse,occasional,odd-pinnate,one-celled,pale,pedicel,peduncle,per,perfect,petiole,petiolule,pilose,plurifoliate,puberulent,pubescent,rarely,remnant,rounded,scandent,short,slender,slightly,small,somewhat,sparsely,stamen,stigma,stripe,style,subglabrous,surface,terminal,thickening,tri-,tube,unbranched,unit,wall,white,winged,x	17,1977,5-10,5-merou,abaxially,acut,adaxial,adaxially,ag,alyx,anderson,apical,auriculate,ba,basal,bract,cell,chartaceous,ciliat,cuneate,directed,distally,eaf,eed,equal,especially,geminat,glabrou,greatly,homostylous,interstaminal,large,longitudinal,lower,lowermost,mean,membrane,minute,moderately,much,nflorescence,obliquely,occasionally,opening,orolla,pair,paired,pore,present,pseudostipular,pubescen,rachi,reduced,reniform,ruit,seudostipule,slit,smaller,spaced,stellate,substellate,subtended,tamen,tem,time,truncat,vary,wide,yellow,ympodial	appearance,arrangement,bark,border,branch,bud,calyx,characteristic,colour,corolla,corrugation,drying,exertion,form,fruiting,geminate,giving,glabrousnes,growth,height,history,inflorescence,leaf,life,lobing,mentioned,midpoint,new,number,ovary,plant,prickle,primary,pseudostipule,ray,seed,shape,size,stem,sympodial,texture,thicknes,truncate,type,variation,vein,width,â,â
86	wfo-0001026827	success	143	145	106	37	39	0.741	/3,0.2-0.5,0.4-0.6,0.5-2,0.6-1,1-,1-1.1,1-1.5,1-2,1-2.1,1.3-1.6,1.5-2,2-2.2,2-2.5,2-4,3-9,5-6,7-9,acute,age,and/or,anther,anthesi,apex,appearing,arachnoid,attenuate,bark,base,branch,branched,broadly,calyx,clavate,cm,conical,corolla,deltate,dendritic,densely,diameter,drying,ellipsoid,erect,exerted,filament,flower,glabrescent,glabrous,growth,inflorescence,internodal,irregularly,known,lamina,lanceolate,leaf,lengthening,less,like,lobe,margin,minutely,mm,narrowly,new,nodding,oblanceolate,ovary,pair,paler,papillate,pedicel,peduncle,petiole,pore,poricidal,primary,pubescent,reddish,revolute,shrub,simple,slender,slit,small,soon,sparsely,stem,stigma,stout,strongly,style,surface,terminal,third,tip,trichome,tube,uniseriate,upper,vein,way,white,widest,x	.5,?,abaxially,adaxiall,apart,crowded,deciduou,dense,distally,dry,eaf,especially,fleshy,free,know,lobed,lower,near,nflorescence,ot,papillat,perfect,planar,plane,plurifoliat,portion,rachi,scar,sinus,straight,surfac,thick,thickened,tub,ud,unit,ympodial	adaxially,appearance,arrangement,border,bud,characteristic,colour,corrugation,deciduous,distal,exertion,form,fruit,fruiting,giving,glabrousnes,height,history,interjected,lateral,leaflet,length,life,lobing,midpoint,number,per,plant,prickle,pseudostipule,ray,seed,shape,size,texture,thicknes,type,variation,width
87	wfo-0001026830	success	198	194	148	50	46	0.747	0-10,0.3-1.3,0.4-1,0.5-1.0,0.9-1.9,1-10,1-11,1-2,1.1-2.7,1.4-4,1.5-4,10-57,2-4,2.5-4.4,2.5-5,2.7-8,3.5-8.5,4-10,4-14.5,4-7,4.4-14.5,4.5-17.5,5-11,6-13,7-18,abaxially,acumen,acuminate,acute,adaxially,along,anther,apart,apex,apparently,arranged,articulated,asymmetric,attenuate,axe,axillary,base,basiscopic,bead,berry,blade,brown,brownish,bud,cell,ciliate,clavate,cm,condition,connivent,corolla,covering,decreasing,deep,diameter,distal,drying,elliptic,filament,finely,flower,forked,fresh,fruit,generally,glabrescent,glabrous,globose,green,greenish,hair,half,herb,high,interjected,lanceolate,lateral,leaf,leaflet,light,like,linear,lobe,long,make,margin,medium,mm,moderately,moniliform,mucilaginous,multiple,necklace,odd-pinnate,orbicular,ovate,ovoid,pair,pedicel,peduncle,perfect,petiole,petiolulate,plant,plurifoliate,puberulent,pubescent,purple,ripe,rounded,seed,sessile,short,side,simple,size,spaced,stigma,stolon,stripe,style,subequal,subglabrous,subtending,terminal,testal,thick,tissue,toward,tri-,tube,tuber,typically,unit,unwinged,usually,wall,wet,white,whitish,x,yellow,yellowish	0.5-1.2,2-6,5-merou,adaxiall,ag,alyx,capitat,coriaceous,digestion,dorsally,eaf,edge,eed,enzyme,erec,exceeding,flat,folded,geminat,glabrou,green-white,hair-like,hal,homostylous,honeycomb,lengthening,living,lower,nflorescence,orolla,pentagonal,pore,poricidal,removed,rotate,ruit,seudostipule,shaped,slit,specimen,stamen,straight,subglabrou,tall,tamen,tem,throughout,tip,vary,ympodial	'hair-like,appearance,arrangement,bark,border,branch,calyx,capitate,characteristic,colour,corrugation,erect,exertion,form,fruiting,geminate,giving,glabrousnes,growth,height,history,inflorescence,length,life,lobing,mentioned,midpoint,new,null,number,ovary,per,prickle,primary,pseudostipule,ray,shape,stem,surface,sympodial,texture,thicknes,type,variation,vein,width
88	wfo-0001026831	success	207	203	162	45	41	0.783	-0.25,-5,-6.5,-9,.5,/4,0-10,0-20,0-3,0-6,0.1,0.1-0.2,0.1-0.25,0.2-0.4,0.2-1,0.3-0.6,0.3-0.65,0.5-1.2,0.6,0.6-2,0.65-1,0.7-1.1,0.7-2,1-10,1-2,1-2.2,1-2.5,1-3,1-4,1-6,1.5-2.5,1/3,1/3-2/3,2-2.5,2-4,2.3-2.9,2.5-4.5,3-5,3-6,7-10,7-8,acute,anther,apart,apex,apically,apparently,articulated,attenuate,bark,base,berry,branched,bright,broad-deltate,calyx,cell,cm,connivent,cream,curved,dark,deltate,densely,diameter,difoliate,distance,drying,dull,elliptic,elongating,equal,erect,extending,filament,flattened-reniform,flower,free,fruit,fruiting,glabrescent,glabrous,gray-brown,green,lateral,leaf,length,less,lobe,lobed,long,lower,margin,marking,mature,maturity,mauve,midpoint,midvein,mm,moderately,multangulate,narrow-cuneate,oblong,occasionally,older,one,open,orange,orange-brown,outline,pair,pale,pedicel,peduncle,per,petiole,poricidal,porrect,portion,prickle,prickly,primary,raised,ray,red-brown,reduced,rounded,scandent,scar,sessile,shiny,shrub,side,slender,smooth,sometimes,spaced,sparsely,spherical,stalk,stellate-pubescent,stem,style,subsessile,surface,tapering,terete,time,tip,trichome,tube,upper,usually,vein,way,white,white-gray,wide,yellow,yellow-green,young	0.15-0.25,1.2-2,1/3-1/,1/5-1/4,2-3,3.5-10,5-merous,abaxially,alyx,apar,blade,brow,caudat,chartaceous,concolorous,eaf,eed,eye,fully,geminat,herbaceous,infructescence,longer,membranous,naked,nflorescence,opening,orolla,oung,ovate,pendulous,perfec,pericarp,prickl,ruit,shorter,spreading,stellate,tamen,tertiary,unit,vary,venation,visible,ympodial	1/3-1/2,appearance,arrangement,border,branch,brown,bud,caudate,characteristic,colour,corolla,corrugation,distal,exertion,form,giving,glabrousnes,growth,height,history,inflorescence,interjected,leaflet,life,lobing,mentioned,new,number,ovary,plant,pseudostipule,seed,shape,size,stigma,terminal,texture,thicknes,type,variation,width
89	wfo-0001026841	exception_thrown	139	0	0	139	0	0.0		.25,.5,/4,0.05,0.25-0.3,0.25-0.5,0.5-0.75,0.5-1,0.5-2,0.6-1,0.75-1,0.8-1,0.8-3,1.5,1.5-2,2-2.5,3-6.5,3.5-5,4-8,5-8-flowered,6-8,7-9,9.2-18,acute,along,anther,anthesi,apart,apex,arch,axi,ba,bark,base,beneath,berry,bi-lobed,broadly,calyx,clavate,cm,conical,coroll,corolla,curly-tipped,decurrent,deflexed,deltoid,dia,eaf,edicel,eed,ellipsoid,elliptic,exsertion,filament,filiform,free,fruiting,glabrate,glabrous,globose,green,greyish-gree,hyaline,immature,inflorescence,joined,known,later,lateral,leaf,like,lobe,lobed,lon,long,lower,main,margin,middle,minutely,mm,nflorescence,older,opposite,ovary,pair,paler,papillo,papillose,pedicel,petiole,pore,poricidal,portion,prominent,pubescent,raised,reddish,reflexed,rest,ruit,scar,series,shaped,shining,shrub,simple,slender,slightly,spaced,sparsely,stem,stigma,straight,style,tall,tapering,tear-drop,terminal,thickened,tip,trichome,tube,ud,unevenly,unifoliat,uniseriate,unit,vein,way,white,widest,winged,woody,x,ympodial,young	
90	wfo-0001026849	success	180	164	118	62	46	0.656	0-10,0.5-1,1,1-1.5,1-2,1-6,1.5-2.5,1.75-2,100-130,11,2,2-3,38/2,5-10,637/2,7-8,80-,acute,adult,anther,apex,appearing,aspect,aster,axil,base,berry,brown,calyx,capitate,cm,colour,conical,corolla,cut,cyme,developed,discoidal,distinctly,ellipsoid,emarginate,entire,erect,exceeding,except,exerted,expanded,filament,flowered,fork,fruiting,general,glabrous,glandular,globose,green,grey-brown,growth,hair,half,inflorescence,interacuminal,lavender,leaf,leave,less,linear-lanceolate,lobe,long,long-cuneate,margin,maturity,mid-vein,minute,minutely,mm,oblong,oblong-lanceolate,ovary,pale,pedicel,peduncle,petal,petiole,pruinose,purple,rarely,reticulate,rh,rounded,sea,seed,shallow,short-lived,shrub,simple,sinus,slightly,soft-wooded,sometimes,somewhat,soon,stem,stigma,stout,style,surface,thus,tip,tissue,tube,unarmed,undulate,violet,way,well,x,young	-50,30-,40,5,adherent,amongst,australian,cell,composed,conspicuous,curved,deflexed,dia,distinct,eed,enlarge,facetted,filled,flesh,floral,flower,free,globular,granule,greater,gree,large,lengthening,little,lon,loosely,lower,mature,native,nflorescence,occasionally,often,pal,pedicellate,plurifoliat,pore,poricidal,preparation,relatively,reproducing,rhachi,rotate,ruit,ruiting,shed,slende,slit,solanum,solitary,stone,stony,tub,ud,unit,uvenile,vegetatively,ympodial	appearance,arrangement,bark,border,branch,bud,characteristic,corrugation,diameter,distal,drying,enlarged,exertion,form,fruit,giving,glabrousnes,height,history,interjected,juvenile,lateral,leaflet,length,life,lobing,mentioned,midpoint,new,number,per,plant,prickle,primary,pseudostipule,ray,shape,size,slender,terminal,texture,thicknes,type,variation,vein,width
91	wfo-0001026858	success	153	172	119	34	53	0.778	-30,0.5,0.8,0.8-1,1-10,1-11.5,1-4,1-5,1.3-1.5,1.5-4,2-2.5,2-3,2-4,2.5-3,3-,3-4,4-24,4.5-10.5,5-15,6-10,6-18,6-7,abaxially,acumen,acute,adaxially,apex,apical,apically,articulate,base,branched,calyx,cell,cm,connate,cordate,corolla,covering,cuneate,cyme,dehiscent,diameter,dichasial,dichasially,distal,dorsally,ebracteate,edge,exceeding,filament,flat,flower,folded,forked,generally,glabrescent,glabrous,globose,green,green-white,hair-like,half,herbaceous,interjected,introrse,lateral,leaf,leaflet,light,lobe,long,make,maturing,minute,mm,monochasial,mucilaginous,mucronate,oblique,oblong,obtuse,odd-pinnate,often,ovate,ovate-lanceolate,ovoid,pedicel,peduncle,perennial,perfect,petiole,plant,poricidally,proximal,rounded,seed,shiny,short,size,slightly,slit,stamen,stellate,stigma,straight,style,testal,thick,throughout,triangular,tuber-bearing,typically,unit,wall,wide,without,yellow,Â¼	-4,0-.,1-,3-6-foliat,abruptly,digestion,diminishing,eaf,eed,emoval,enzyme,globo,honeycomb,living,lon,lower,lunat,nflorescence,nther,orolla,pair,pattern,plan,reveal,ruit,seudostipule,specimen,tal,tem,throughou,toward,vary,white-crea,ympodial	0-2,3-6-foliate,anther,appearance,arrangement,bark,border,branch,bud,characteristic,colour,corrugation,drying,exertion,form,fruit,fruiting,giving,glabrousnes,growth,height,history,inflorescence,length,life,lobing,lunate,margin,mentioned,midpoint,new,number,ovary,per,prickle,primary,pseudostipule,ray,shape,stem,surface,sympodial,tall,terminal,texture,thicknes,tube,type,variation,vein,wet,white-cream,width
92	wfo-0001026895	success	166	163	120	46	43	0.723	0-0.5,0.5-1,0.5-1.2,0.5-1.5,0.5-2,0.8-1,1-1.5,1-5,1.4-2.1,1.5-2,2-2.3,2-2.5,2-3,2.5-3.2,2/3,3-12,4.5-5,5-6,abaxial,acute,adaxial,anther,apex,apical,apically,appearing,attenuate,bark,base,berry,borne,broadly,brown,calyx,capitate,cm,conical,corolla,dark,deflexed,deltoid,dendritic,dia,difoliate,drying,ellipsoid,elliptic,elongate,filament,filiform,flattened,fruiting,glabrate,glabrous,globose,green,incrassate,internodal,lamina,lateral,leaf,lobe,lobed,long-exserted,main,margin,minutely,mm,mustard,narrowly,obovate,often,ovary,pair,pale,pedicel,petiole,pitted,pointed,pore,poricidal,projection,pubescent,reddish,reniform,scattered,shape,shaped,shoot,short,shrub,shrublet,side,simple,size,small,soon,sparsely,stem,stigma,style,surface,swollen,swollen-based,tall,tan,tear-drop,tip,toothed,trichome,tube,type,uniseriate,vein,way,white,woody,x,yellow,young	.5,5-8-flowered,along,anthesi,ba,broad,campanulate,closely,contracted,denser,differing,eaf,edicel,eed,erect,free,geminat,hard,like,lon,long,lower,major,middle,minor,minute,nflorescence,older,overlappin,papillo,pericarp,portion,present,reddish-brow,ruit,scar,somewhat,spaced,thin,tub,tuft,ud,unit,usually,widest,ympodial	appearance,arrangement,border,branch,bud,characteristic,colour,corrugation,diameter,distal,exertion,form,fruit,giving,glabrousnes,growth,height,history,inflorescence,interjected,leaflet,length,life,lobing,midpoint,new,null,number,papillose,peduncle,per,plant,prickle,primary,pseudostipule,ray,reddish-brown,seed,terminal,texture,thicknes,variation,width
93	wfo-0001026905	success	204	197	155	49	42	0.76	-10,-2,-2/3,-4,0,0-2,0.1,0.15,0.2-0.3,0.2-0.5,0.3-0.4,0.4-1,0.5-0.7,0.5-1.5,0.6-0.7,0.75-1.1,0.9-1.3,1,1-2,1-20,1-3.7,1-4,1-6,1/2-3/4,1/3,1/4,1/5-1/3,2-3,3-5,3-8,5-6,5-merous,6-8,7-8,abaxially,acute,ame,anther,apart,apex,apically,apparently,articulated,attenuate,bark,base,berry,blade,branched,c.,calyx,chartaceous,cm,cream,curved,dark,deltate,densely,diameter,difoliate,discolorous,distance,drying,dull,erect,extending,eye,filament,flower,fruit,fruiting,gray-green,green,inflorescence,infructescence,lateral,leaf,length,lobe,lobed,long,longer,lower,margin,marking,mauve,midpoint,midvein,mm,moderately,naked,oblong,older,one,open,orange-brown,ovate,pair,pale,pedicel,peduncle,per,pericarp,petiole,poricidal,porrect,prickle,prickly,primary,ray,reduced,rounded,sessile,shallowly,shorter,shrub,side,slender,smooth,sometimes,somewhat,spaced,sparsely,spherical,spreading,stalk,stalked,stellate,stellate-pubescent,stem,straight,style,subentire,surface,terete,tertiary,time,tip,trichome,tube,unarmed,unit,upper,usually,variously,vein,venation,visible,way,weakly,white,wide,yellow,yellow-green,young	-1.5,-3,.2,.5,0-20,0-25,0.4,0.4-0.9,0.7-1.4,1-2.5,1.9-2.5,2.5-2.9,2.5-3.5,2/3-3/,acuminat,alyx,apar,brow,cell,connivent,eaf,eed,elongating,equal,flattened-reniform,free,geminat,glabrous,mature,maturity,orange,orolla,oung,outline,pendulous,perfec,pit,portion,prickl,raised,red,ruit,scar,small,tamen,tapering,vary,woody,ympodial	2/3-3/4,acuminate,appearance,arrangement,border,branch,brown,bud,characteristic,colour,corolla,corrugation,distal,exertion,form,geminate,giving,glabrousnes,growth,height,history,interjected,leaflet,life,lobing,new,number,ovary,perfect,plant,pseudostipule,seed,shape,size,stigma,sympodial,terminal,texture,thicknes,type,variation,width
94	wfo-0001026923	exception_thrown	177	0	0	177	0	0.0		-5,.1-0.3,.5,0-5,0.25-0.5,0.5,0.5-1,0.6-0.8,0.8-1,1,1-1.5,1-3,1-4,1-7,1.5-2,1.5-4,10,2,2-2.5,2-3,2-6,20-50,3-4,3-5,4-18,4-5-,5-10,5-15,5-6,5-9,abaxially,absent,accrescent,acuminate,acute,adaxiall,adaxially,ag,anther,apart,apex,apparently,articulated,axe,ba,base,black,blade,branched,brown,calyx,capitat,center,chartaceous,cm,connivent,covering,cuneate,curved,cylindrical,deltate,densely,denser,diameter,directed,distally,eaf,eed,eglandular,elliptic,elliptic-ovate,entire,equal,erect,filament,flattened,flower,forked,frui,fruit,fruiting,fused,geminate,glabrescent,glabrous,gland-tippe,glandular,globose,green,hair,held,intermediate,lanceolate,large,lateral,leaf,leaf-opposed,light,like,lobe,long,longitudinal,lower,many-foliate,margin,midpoint,midvein,mm,moderately,much,multangulate,nearly,nflorescence,oblong,opening,orange,orolla,paired,pedicel,peduncle,peltate,perfect,petiole,pore,possibly,pubescence,pubescent,purple,rachi,ray,red,relatively,ripening,rounded,rugulose,ruit,scale,sessile,short,shrub,simple,slightly,slit,small,smaller,sometimes,somewhat,spaced,sparsely,ste,stellate,stem,stigma,straight,strongly,style,subtending,surface,tal,tamen,tem,time,tip,tree,trichome,tube,unit,uprigh,usually,vary,white,whitish,wide,x,yellow,yellowish,ympodial	
95	wfo-0001026925	success	215	204	168	47	36	0.781	-2,.5,/6,0,0-20,0-5,0.1,0.1-0.3,0.2,0.5-1.5,0.5-4,0.7-1.8,0.9-1.8,00-200,1-1.4,1-25,1-3.5,1-4,1.5-2,1.5-4.5,1.8-2,1.8-2.5,1/3,1/3-1/2,1/4-2/3,2-4,2-5,2.4-2.6,2.4-3,2.5-6,3-20,3-7,4-10,4-14,4-5,4-7,5-6,5-8,5.5-10,6-10,6-17,6-8,7-12,acute,ame,anther,apart,apex,apically,apparently,articulated,attenuate,bark,base,berry,branched,brow,c.,calyx,chartaceous,cm,concolorous,connivent,cream,curved,dark,deltate,diameter,distal,distance,drying,elliptic,elongating,erect,extending,filament,flattened,flattened-reniform,flower,fruit,fruiting,gently,glabrescent,glabrous,green,green-brown,hair,lateral,leaf,length,lobe,lobed,lobing,long,long-styled,lower,margin,marking,mature,maturity,mauve,membranous,midpoint,midvein,minute,mm,moderately,narrow-deltate,oblong,older,one,open,orange-brown,ovate,pair,pale,pedicel,peduncle,pendent,per,petiole,plant,poricidal,porrect,prickle,prickly,primary,rarely,ray,red-brown,reduced,reflexed,rounded,scar,secondary,sessile,short-styled,shrub,side,simple,sometimes,spaced,sparsely,spherical,stalk,stalked,stellate-pubescent,stem,straight,style,surface,tapering,terete,terminal,time,tip,translucent,trichome,tube,unarmed,upper,vein,way,white,wide,yellow,yellow-orange,young	0-10,0-7,0.1-0.2,1-1.3,1-3,1.5-2.5,1/6-1/3,2/,5-merous,abaxially,acuminat,alyx,andromonoecious,apar,blade,broad-deltate,eaf,eed,equal,free,hermaphrodite,heterostylous,infructescence,longer,lowermost,nflorescence,orolla,oung,pendulous,pericarp,plurifoliat,portion,prickl,ruit,smooth,spreading,staminat,stellate,stout,tamen,tertiary,unit,vary,venation,visible,woody,ympodial	2/3,acuminate,appearance,arrangement,border,branch,brown,bud,characteristic,colour,corolla,corrugation,exertion,giving,glabrousnes,growth,height,history,inflorescence,interjected,leaflet,life,new,null,number,ovary,pseudostipule,seed,shape,size,stigma,texture,thicknes,type,variation,width
96	wfo-0001026946	success	205	177	133	72	44	0.649	0-20,0.5-2,0.9-3.5,0.9-4.3,1-10,1-2,1-4,1.5-2,1.6-3.7,10-39,12-23,2,2-15,2.5-10.5,2.7-9,3-20,3-5,3-6,3.5-10,4.1-9.4,5-7,6-24,8-15,8-25,abaxially,acumen,acuminate,acute,adaxially,anther,apex,apparently,attenuate,axe,axillary,base,berry,blade,borne,broadly,brownish,bud,cell,clavate,cm,condition,connivent,corolla,covering,creamy,densely,diameter,distal,dot,drying,elliptic,end,exceeding,filament,flower,forked,fresh,fruit,generally,glabrous,globose,green,greenish,hair,half,herb,interjected,lanceolate,lateral,leaflet,like,lobe,long,make,margin,mm,mottled,mucilaginous,narrowly,oblique,odd-pinnate,often,orbicular,ovate,ovoid,pedicel,peduncle,perfect,petiole,petiolulate,plant,pubescent,pure,purple,ripe,rounded,scattered,seed,sessile,short,short-pubescent,singly,size,slightly,stamen,stem,stigma,straight,streak,style,subtending,terminal,testal,thick,truncate,tube,tuber,typically,unwinged,usually,wall,wet,white,whitish,wing,x,yellow,yellow-white	0-5,1,2-5,4-7,5-merou,ag,along,alyx,apart,articulation,capitat,chartaceous,ciliate,deeply,digestion,dorsally,eaf,edge,eed,enzyme,erec,especially,except,extremely,flat,folded,geminat,glabrou,greatly,green-white,hair-like,homostylous,honeycomb-shaped,lengthening,living,lower,membranous,midrib,minutely,nflorescence,orolla,pair,pentagonal,petiolule,plurifoliate,pore,poricidal,proximal,puberulent,pubescen,reduced,removed,ruit,seudostipule,slit,spaced,specimen,ste,stellate,stolo,subequal,tall,tamen,tem,thir,throughout,tip,tri-,unit,variable,vary,ympodial	'hair-like,appearance,arrangement,bark,border,branch,calyx,capitate,characteristic,colour,corrugation,erect,exertion,form,fruiting,giving,glabrousnes,growth,height,history,inflorescence,leaf,length,life,lobing,mentioned,midpoint,new,number,ovary,per,prickle,primary,pseudostipule,ray,shape,stolon,surface,texture,thicknes,type,variation,vein,width
97	wfo-0001026962	exception_thrown	205	0	0	205	0	0.0		.05,.5,0,0.3-0.7,0.5,0.5-0.8,0.5-1,0.5-1.5,0.8-1,1,1-1.2,1-1.5,1-2,1-3,1-4.5,1-6,1.5-17,1.5-2,1.5-3,1.5-5,10-12,10-20,15-22,2-2.5,2-5,2-6,2/3-3/4,3-3.5,3-6,4-5,6-7,9-12,9-17,abaxially,abrupt,abruptly,accrescent,acute,adaxially,ag,alyx,anther,anthesi,apex,apparently,appearing,arising,articulated,axe,bark,base,basebud,becoming,beneath,blade,brittle,broadly,bud,calyx,capitat,cell,chartaceous,closely,cm,composed,connivent,constricted,corolla,cucullat,cylindrical,darker,deflexed,deltate,densely,denser,diameter,differing,difoliate,dimorphic,dry,eaf,eed,elliptic,elongate,entire,evenly,except,exerted,filament,flattened-reniform,flower,free,fruit,fruiting,geminat,glabrate,glabrou,glabrous,globose,green,ilament,incrassate,inflorescence,internodal,later,lateral,leaf,like,lobe,lobed,long,longitudinal,main,major,margin,material,minor,minutely,mm,narrowly,nflorescence,obconic,oblong,obovoid,occasionally,often,older,one,opening,opposite,orolla,oung,outline,ovate-lanceolate,overlapping,packed,pair,pale,papillose,paten,pedicel,peduncle,pendent,perfect,petiole,pitted,pore,portion,prominent,pubescen,pubescent,purplish,rachi,raised,reflexed,remaining,rest,rounded,rounder,ruit,sagittate,shaped,shrub,simple,size,slender,slightly,slit,small,sometimes,somewhat,soon,stellate,stem,stigma,straight,style,surface,tal,tapering,tear-drop,tinged,tip,tooth,tree,triangular,trichome,trunk,tube,unarmed,unbranched,unifoliate,uniseriate,unit,vary,vein,way,whit,white,woody,x,yellow,yellowish,ympodial,young	
98	wfo-0001026964	success	128	138	93	35	45	0.727	.2,.5,0,0.5,0.5-1,1-1.2,1-2.5,10,10-30,2-2.5,2-4,3-5,3.5-7,4.5-8.5,7-8,?,acuminate,acute,along,anther,anthesi,apex,attenuate,axillary,base,beak,bearing,berry,calyx,cm,conical,conspicuously,corolla,diameter,distinct,elliptic,exserted,filament,filiform,fleshy,flower,fruiting,glabrous,globose,green,greenish,herb,horizontal,known,lateral,leaflet,lenticellate,line,lobe,lobed,long,margin,minutely,mm,nearly,obovate,one,open,ovary,pair,pedicel,petiole,pinnate,poricidal,primary,pubescent,purple,reflexed,scar,shape,side,simple,size,slender,small,sparsely,stigma,style,surface,terminal,time,tip,trichome,tube,uniseriate,vein,x,yellow	basal,capitat,differentiated,eaf,edicel,equal,erec,free,glabrou,immature,lightly,long-attenuate,lower,nflorescence,noddin,often,onto,ot,papillate,petiolule,portion,purpli,rachi,rugose,ruit,smooth,somewhat,tal,tem,tub,ud,unifoliat,unit,winged,ympodial	appearance,arrangement,bark,border,branch,bud,capitate,characteristic,colour,corrugation,distal,drying,exertion,form,fruit,giving,glabrousnes,growth,height,history,inflorescence,interjected,leaf,length,life,lobing,mentioned,midpoint,new,nodding,number,peduncle,per,plant,prickle,pseudostipule,purplish,ray,seed,stem,texture,thicknes,type,variation,width
99	wfo-0001026981	success	252	217	181	71	36	0.718	-0.8,-14,-2.5,-35,-8,.2,0.05-0.1,0.1-0.2,0.2,0.2-0.4,0.3-0.5,0.3.6,0.4-0.5,0.45-1.3,0.5,0.5-0.3,0.5-30,0.6-1.4,0.6-2,0.8-1.2,0.9-1.5,1,1-2,1-2-cellular,1-3,1-3-celled,1-3.3,1-4,1.5-2.0,1.5-5,1.5-8.5,1.8-2.8,11,2-3-branched,2-locular,3-foliate,3.5-14,4,4-8,6-10,7.5,<,abaxially,absent,academy,accrescent,acute,adpressed,amongst,anther,anthesi,apex,appearance,appressed,asymmetric,axi,base,bay,beak,becoming,bract,bracteole-like,brown,calyx,capitate,cell,citrus-like,cm,coastal,composed,conical,cordate,corolla,dark,deltate,densely,diameter,distal,ebracteate,entire,erect,exserted,filament,flower,fruit,fruiting,giving,glabrescent,glandular,globose,green,hair-like,halfway,head,herb,imparipinnate,initially,interjected,internode,interrupted,irregularly,later,lateral,leaf,leaflet,like,lime,linear,lobe,lobed,long,margin,maturity,minutely,mm,multicellular,narrowly,obovate,orange,orbicular,outgrowth,ovary,ovate,pale,patent,pedicel,peduncle,per,perennial,petiole,petiolule,plant,population,present,primary,procumbent,pronounced,pseudostipule,pubescence,pubescent,robust,rounded,sessile,several,shaggy,short,shorter,silky,simple,slender,sometimes,sparsely,stem,stigma,strong,style,surface,tangled,terminal,testa,thick,tightly,transparent,trichome,tube,type,uni-,unicellular,uniseriate,unit,upto,usually,variously,velvety,viny,wall,wide,winged,yellow,â,â	-0.4,-2,-4,.2-0.2,0-5,0.1-0.3,0.15-0.2,0.2-2,0.25-0.4,0.4-0.7,0.4-2,0.7-0.8,0.8-6,0.9-1.4,1/3,196.,2-3,4-celled,absen,abundant,adaxially,along,angled,apical,appendage,articulated,articulation,basiscopically,column,cone,d,eaf,edicel,eed,gree,half,included,jointles,larger,less,lon,lower,mainly,mixed,much,nflorescence,occasionally,pair,pentagonal,proximal,rachi,reflexed,rick,ruit,scen,secondary,see,shaped,smaller,sparser,specimen,spreadin,staminal,sterile,straight,tem,tertiary,tub,villous,without,ympodial	arrangement,bark,border,branch,bud,characteristic,colour,corrugation,drying,exertion,form,glabrousnes,growth,height,history,inflorescence,length,life,lobing,mentioned,midpoint,new,number,prickle,ray,scent,seed,shape,size,spreading,sympodial,texture,thicknes,variation,vein,width
100	wfo-0001026992	success	243	199	160	83	39	0.658	-2.5,0.2-0.5,0.25-0.45,0.5-1.2,0.6-1.5,00-170,1-4,1.2-1.4,1.2-1.7,1.4-1.6,1.4-1.9,1.5-3.4,1.7-1.9,1.7-2.4,1.7-4.3,10-12,12-33,2-10,2.8-4.7,3-4,3.3-5.5,5-15,5.3-12.1,6-10,8,8-14,abaxially,abruptly,acuminate,acute,adaxially,along,angled,anther,anthesi,apart,apex,apparently,approximately,articulated,attenuate,axe,bark,base,berry,blunt-tipped,branch,branched,broadly,brown,calyx,cm,corolla,crown,cylindrical,deltoid,diameter,drying,echinoid,elliptic,entire,equal,exserted,filament,flat-topped,fleshy,flower,forming,fruit,fruiting,glabrous,globose,granular-tomentose,greenish,grooved,hair,immature,lance-ovate,lanceolate,lateral,leaf,length,lobe,long,long-stalked,longitudinally,lower,main,many,margin,maturity,midrib,mm,moderately,multangulate,oblong,obtuse,occasional,older,orange-tan,ovate,overlapping,pedicel,peduncle,perfect,petiole,plant,porrect-stellate,pubescent,rachi,rather,reniform,reticulate-punctate,ripe,scabridulous-,sessile,short,short-,short-stalked,shorter,shrub,side,simple,size,small,sometimes,spaced,sparingly,spreading,stalked,stamen,stellate,stem,stigma,stout-stalked,style,subcampanulate,subglobose,surface,terete,terminal,thin-textured,time,tomentose,tree,tube,unarmed,usually,vein,velutinous,violet,weakly,white,whitish,wide,x,yellow,yellowish,young,Â½	/7,0.8-3.4,1.3-2.6,1.3-4.3,1/2,2-5.6,2.3-3.3,2.6-4.6,2.8-4.6,3.3-5.6,4-8,5-merou,8-11,abaxial,accrescent,adaxiall,ag,alyx,appressed,around,axillary,ba,blade,capitat,chartaceous,completely,coriaceous,covering,dark,densely,directed,distally,eaf,echinoi,edge,eed,enveloping,evident,farinose,free,geminate,glabrescen,high,homostylous,inserted,lacking,lengthening,less,line,lobed,longitudinal,m.,mature,minute,mostly,nearly,nflorescence,occasionally,often,orolla,ovate-lanceolate,plurifoliate,pore,poricidal,pubescence,rare,ruit,runk,semi-ovate,slit,somewhat,split,suture,tamen,tan,tip,ud,unarme,unequal,unit,vary,way,ympodial	appearance,arrangement,border,bud,capitate,characteristic,colour,corrugation,distal,exertion,form,giving,glabrousnes,growth,height,history,inflorescence,interjected,leaflet,life,lobing,midpoint,new,number,ovary,per,prickle,primary,pseudostipule,ray,seed,shape,texture,thicknes,trunk,type,unspecified,variation,width
101	wfo-0001026994	success	266	239	203	63	36	0.763	-10,-20,-30,-foliate,.2,0.05-0.1,0.1-0.2,0.1-0.3,0.15-0.2,0.2-0.5,0.4-1.2,0.5,0.5-0.6,0.5-0.7,0.5-0.8,0.5-0.9,0.5-1.2,0.5-1.3,0.5-2,0.7-2.5,1,1-1.4,1-1.5,1-1.6,1-2,1.2-1.6,1.2-3.5,1.4-2.1,10-20,12-,2,2-,2-2.6,2-4,2-5-locular,2.2-3.2,2.5-6.5,20-50,3,3-branched,4,4-15,4-celled,5,5-,6-20,7-13,8,8-12,abundant,acuminate,acute,additional,adpressed,amongst,anther,anthesi,apex,apically,appearance,basal,basally,base,basiscopically,becoming,bent,berry,bifurcate,bifurcation,bract,bracteate,branched,bright,broader,broadly,brown,calyx,capitate,cell,celled,cm,conical,corolla,crenate,crowded,dark,darker,decumbent,decurrent,deeply,densely,developed,diameter,distal,ebracteate,eglandular,elliptic,erect,especially,exserted,filament,flower,fruit,fruiting,giving,glandular,globose,grayish,green,greenish,hair-like,half,halfway,head,herb,imparipinnate,inflorescence,interjected,internode,interrupted,investing,irregularly,lamina,lanceolate,lateral,leaf,leaflet,less,like,lobe,lobed,locule,long,loosely,margin,medial,midvein,mm,moderately,much,narrowing,narrowly,nearly,node,oblique,obovate,occasionally,often,outgrowth,ovary,pair,pedicel,peduncle,perennial,petiole,primary,pseudostipule,pubescent,purple,rachi,rarely,regularly,ripe,robust,sessile,set,shaggy,short,silky,simple,sinus,size,slightly,sometimes,sparsely,spreading,stem,stigma,straight,stripe,style,surface,tall,terminal,testa,thick,tip,trichome,tube,unicellular,uniseriate,unit,usually,velvety,wall,weak-walled,well,white,wide,winged,woody,yellow,young	-0.7,.5,0.05-0.2,0.1,0.2-0.4,0.25,0.3-0.4,0.4-0.5,0.9-1.2,0.9-1.3,1-1.2,5-7,abaxially,absent,acroscopically,along,also,andscattered,apical,appendage,articulate,articulation,beneath,column,crenat,decreasing,eaf,edicel,eed,essentially,fewer,glabrous,gree,habitat,hal,large,larger,largest,leave,lon,lower,markedly,minutely,narrower,nflorescence,paler,papillate,petiolule,present,puberulent,reflexed,rocky,rotate-stellate,secondary,specimen,spreadin,staminal,sterile,tem,tertiary,toward,ud,ympodial	arrangement,bark,border,branch,bud,characteristic,colour,corrugation,drying,exertion,form,glabrousnes,growth,height,history,length,life,lobing,midpoint,new,null,number,per,plant,prickle,ray,scattered,seed,shape,sympodial,texture,thicknes,type,variation,vein,width
102	wfo-0001026996	success	188	176	130	58	46	0.691	0-6,0.6-1,0.9-2.7,1-2,1-3,1-5,1.2-1.8,1.3-7.7,1.8-4.4,14-33,15-28,2-3,3-10,3-5,3-7,3.3-6,3.8-14.1,4-4.4,4-8,5-8,6-8,6.9-10.9,8.7-18.6,abaxially,acumen,acuminate,acute,adaxially,along,anther,apart,apex,arranged,asymmetric,attenuate,axillary,base,basiscopic,bead,berry,blue,brownish,bud,cell,clavate,cm,condition,connivent,coriaceous,corolla,covering,dark,deep,diameter,distal,drying,elliptic,exceeding,filament,flower,forked,fresh,fruit,generally,glabrous,globose,green,greenish,half,herb,interjected,lanceolate,lateral,leaf,leaflet,like,lilac,linear,lobe,long,make,medium,mm,moniliform,mottled,mucilaginous,multiple,necklace,odd-pinnate,orbicular,ovate,ovoid,pedicel,peduncle,petiole,petiolulate,plant,plurifoliate,purple,ripe,rounded,seed,sessile,side,size,sometimes,stamen,stigma,stolon,straight,stripe,style,subtending,symmetric,terminal,testal,thick,tissue,tri-,tube,tuber,typically,unit,unwinged,usually,wall,wet,white,whitish,x	1-4,4.5-10.5,5-merou,abaxiall,ag,alyx,apparently,articulated,axe,blade,capitat,considerably,decreasing,digestion,dorsally,eaf,edge,eed,enzyme,erec,flat,folded,geminat,glabrou,green-white,hair-like,homostylous,honeycomb-shaped,larger,lengthening,living,lower,middl,nflorescence,orolla,pair,pentagonal,perfect,pore,poricidal,removed,rotate,ruit,seudostipule,slightly,slit,spaced,specimen,subglabrou,tall,tamen,tem,throughout,tip,toward,vary,yellow,ympodial	'hair-like,appearance,arrangement,bark,border,branch,calyx,capitate,characteristic,colour,corrugation,erect,exertion,form,fruiting,geminate,giving,glabrousnes,growth,height,history,inflorescence,length,life,lobing,margin,midpoint,new,null,number,ovary,per,prickle,primary,pseudostipule,ray,shape,stem,surface,sympodial,texture,thicknes,type,variation,vein,width
103	wfo-0001027010	success	198	184	138	60	46	0.697	0-2,0-2.5,0.4-5.1,0.5-1.5,1-10,1-2,1-7,1.2-1.7,1.2-1.9,1.4-6.9,10-60,14-46,2-9.4,2.1-15.3,2.1-4.3,2.2-12.9,3-10,3-5,3-6,3-8,3.5-13.6,4-12,4-8,4.4-29,4.9-31,5-13,5-14,abaxially,acumen,acuminate,acute,adaxially,along,anther,apart,apex,apparently,arranged,articulated,asymmetric,attenuate,axe,axillary,base,basiscopic,bead,brownish,bud,cell,clavate,cm,coloration,condition,connivent,coriaceous,corolla,covering,deep,diameter,distal,drying,elliptic,filament,flower,forked,fresh,fruit,generally,glabrescent,glabrous,green,greenish,hair,half,herb,high,interjected,lanceolate,lateral,leaf,leaflet,light,like,lobe,long,make,mm,moniliform,mucilaginous,multiple,narrow,necklace,odd-pinnate,orbicular,ovate,ovoid,pedicel,peduncle,perfect,petiole,petiolulate,plant,plurifoliate,purple,ripe,rounded,scabrous,seed,sessile,short,side,size,sometimes,spaced,spot,stigma,stolon,stripe,style,subtending,terminal,testal,thick,tissue,tri-,tube,tuber,typically,unit,usually,wall,wet,white,whitish,wide,wing,winged,x	0-3,1-4,2-6,5-merou,adaxiall,ag,alyx,blade,capitat,decreasing,digestion,dorsally,eaf,edge,eed,enzyme,erec,exceeding,flat,folded,geminat,glabrescen,glabrou,green-white,hair-like,hal,homostylous,honeycomb-shaped,larger,lengthening,living,lower,nflorescence,occasionally,orolla,pair,pentagonal,pore,poricidal,present,removed,rotate,ruit,scabrou,seudostipule,slightly,slit,specimen,stamen,straight,subequal,tall,tamen,tem,throughout,tip,toward,vary,yellow,ympodial	'hair-like,appearance,arrangement,bark,border,branch,calyx,capitate,characteristic,colour,corrugation,erect,exertion,form,fruiting,geminate,giving,glabrousnes,growth,height,history,inflorescence,length,life,lobing,margin,midpoint,new,null,number,ovary,per,prickle,primary,pseudostipule,ray,shape,stem,surface,sympodial,texture,thicknes,type,variation,vein,width
104	wfo-0001027019	success	142	158	110	32	48	0.775	.5,/4,0-0.5,0.5-1,1-1.5,1-2,1.5-2,1.5-3,10,10-40-flowered,12-30,2-3,2-5,2-8,4-5,4-8.5,7-14,abaxially,abruptly,acute,adaxially,along,anther,apex,apparent,attenuate,bark,base,berry,branched,bright,calyx,capitate,cm,corolla,cyathiform,deltoid,densely,dia,difoliate,distal,ellipsoid,elliptic,even,exserted,filament,flattened,free,fruiting,glabrate,glabrous,globose,golden,green,inflorescence,later,leaf,like,live,lobe,lobed,long,major,midrib,minor,minutely,mm,narrowed,obovate,older,opposite,ovary,ovoid-reniform,pale,papillose,pedicel,petiole,pitted,plant,pore,poricidal,portion,pubescent,shaped,shrub,small,somewhat,sparsely,stem,stigma,straight,strongly,style,surface,tall,tan,tear-drop,third,tip,tree,trichome,tube,unit,way,white,widest,wing,winged,x,young	1/2,abaxial,anthesi,ba,constriction,deflexed,eaf,edicel,eed,erect,fleshy,geminat,inflorescenc,largely,lon,lower,nflorescence,onto,overlapping,papillo,planar,reddish-brow,rest,ruit,scar,spaced,tapering,tub,ud,waxy,woody,ympodial	appearance,arrangement,border,branch,bud,characteristic,colour,corrugation,diameter,drying,exertion,form,fruit,geminate,giving,glabrousnes,growth,height,history,interjected,lateral,leaflet,length,life,lobing,margin,midpoint,new,null,number,peduncle,per,prickle,primary,pseudostipule,ray,reddish-brown,seed,shape,size,sympodial,terminal,texture,thicknes,type,variation,vein,width
105	wfo-0001027030	success	234	233	198	36	35	0.846	-11,-15,.2,.5,0-4,0.05-0.1,0.1-0.7,0.1-0.9,0.15-0.2,0.2,0.2-0.3,0.2-1,0.3-,0.3-0.7,0.4-0.5,0.4-1.5,0.5,0.5-,0.5-0.7,0.5-1,0.6-0.7,0.6-0.8,0.6-1.8,0.7-1,0.8-0.9,0.8-1,1,1-,1-1.3,1-3,1-3.4,1.2-1.6,1.5-,1.6-2,2-,2-3,2-4,2-4.8,2-6,2-7,2-foliate,2-locular,2.2-3.2,3-4-celled,3-8,3-9,4-celled,5-12,8-celled,abaxial,abaxially,absent,abundant,acuminate,acute,adaxially,adpressed,anther,anthesi,apex,appearance,axi,basal,base,basiscopically,beneath,berry,bract,branched,bright,brown,calyx,capitate,cell,cm,conical,corolla,crenate,crenation,dark,darker,decurrent,deeper,deeply,densely,denser,diameter,distal,due,eglandular,elliptic,entire,evenly,exserted,extremely,filament,flower,fruit,fruiting,giving,gland,glandular,globose,grayish,green,hair-like,half,halfway,herb,imparipinnate,inflorescence,interjected,internode,interrupted,interspersed,investing,lamina,lanceolate,larger,lateral,leaflet,less,like,lobe,long,longer,loosely,margin,minutely,mm,multicellular,narrowly,near,node,oblique,obovate,occasionally,often,outgrowth,ovary,pair,pale,paler,papillate,pedicel,peduncle,perennial,petiole,petiolule,primary,pseudostipule,pubescence,pubescent,robust,secondary,sessile,silky,similar,simple,size,slender,small,smaller,soft,sometimes,somewhat,sparsely,spread,spreading,stem,stigma,stripe,style,surface,tall,terminal,tertiary,testa,thick,tiny,trailing,trichome,truncate,tube,unicellular,uniseriate,unit,usually,vein,velvety,wall,weak,white,wide,winged,woody,yellow,young	0.3-0.5,0.4-0.8,0.5-0.8,0.9-1.1,1-1.2,angled,apical,appendage,articulated,articulation,beyond,column,crenat,diamete,eaf,edicel,eed,gree,growt,hal,irregularly,lon,lower,nflorescence,present,reflexed,rotate-stellate,ruit,slightly,spreadin,staminal,sterile,straight,tem,ud,ympodial	arrangement,bark,border,branch,bud,characteristic,colour,corrugation,drying,exertion,form,glabrousnes,growth,height,history,leaf,length,life,lobing,mentioned,midpoint,new,number,per,plant,prickle,ray,seed,shape,sympodial,texture,thicknes,type,variation,width
106	wfo-0001027035	success	199	184	138	61	46	0.693	0-36,0.1-0.9,0.3-2.3,0.4-12.8,0.5-3.4,0.5-5,0.5-7,0.8-4.2,0.9-3.1,1-2,1-3,1-3.4,1-8,1.5-5.9,1.7-8,1.8-5.2,10-80,2-38,2-7,2.8-10.3,3-10,3-5,4-18,4-18.5,4.9-23.5,abaxially,acumen,acuminate,acute,adaxially,anther,apart,apex,apparently,articulated,asymmetric,attenuate,axe,axillary,base,basiscopic,blade,blue,brownish,bud,cell,clavate,cm,coloration,completely,condition,connivent,corolla,covering,deep,diameter,distal,drying,elliptic,filament,flower,forked,fresh,fruit,generally,glabrescent,glabrous,globose,green,greenish,hair,half,herb,high,interjected,lanceolate,lateral,leaf,leaflet,lengthening,light,lilac,lobe,long,make,medium,mm,mucilaginous,odd-pinnate,ovate,ovoid,pair,pedicel,peduncle,perfect,petiole,petiolulate,plant,plurifoliate,pore,poricidal,present,purple,ripe,rounded,seed,sessile,shape,short,side,size,slit,sometimes,spaced,stigma,stripe,style,subglabrous,subtending,terminal,testal,thick,throughout,tip,tissue,tri-,tube,unit,unwinged,usually,variable,wall,wet,white,whitish,wide,x,yellow	0-7,0.8-3,5-merou,adaxiall,ag,along,alyx,arranged,bead,capitat,decreasing,digestion,dorsally,eaf,edge,eed,enzyme,erec,exceeding,flat,folded,geminat,glabrescen,glabrou,green-white,hair-like,hal,homostylous,honeycomb,larger,like,living,lower,moniliform,multiple,necklace,nflorescence,orbicular,orolla,pentagonal,removed,rotate,ruit,second,seudostipule,shaped,slightly,smaller,specimen,stamen,stolon,straight,subequal,tall,tamen,tem,toward,tuber,typically,vary,ympodial	'hair-like,age,appearance,arrangement,bark,border,branch,calyx,capitate,characteristic,colour,corrugation,erect,exertion,form,fruiting,geminate,giving,glabrousnes,growth,height,history,inflorescence,length,life,lobing,margin,mentioned,midpoint,new,number,ovary,per,prickle,primary,pseudostipule,ray,stem,surface,sympodial,texture,thicknes,type,variation,vein,width
107	wfo-0001027050	success	244	223	185	59	38	0.758	-12,-9,.5,/3,0-0.2,0.1-3,0.3-1.5,0.5-3,0.8,0.9-2.1,1-1.5,1-2,1.5-2,1.5-6,10-13.5,12-15,15-50+,2-2.5,2-3,2-4,2-5,2-8,2.5-3,3-5,4-20,5,5-10,5-6,5-7,5-9,6-8,8-26,abaxial,absent,abundant,acuminate,acute,adaxial,adult,anther,apex,articulated,axe,bark,basal,base,berry,branch,branched,broad,broad-based,broadly,brown,calyx,capitate,closely,cm,coarsely,conical,connivent,cordate,cuneate,curved,densely,diameter,difoliate,directed,distal,distally,drying,eglandular,elliptic,entire,erect,except,ferruginous,filament,flattened,flattened-reniform,flower,fruit,fruiting,glabrous,glandular-puberulent,green,growth,hair,half,inflorescence,lanceolate,lateral,leaf,leaf-opposed,least,length,less,like,lobe,lobed,long,long-styled,longer,margin,markedly,mature,mid-way,midpoint,midrib,minute,minutely,mm,moderately,multiseriate,narrowly,near,numerous,oblique,obtuse,occasionally,often,older,ovate,ovate-lanceolate,pale,pedicel,peduncle,per,petiole,plant,pore,poricidal,porrect,present,prickle,prickly,pubescent,ray,rest,ripe,rounded,scar,scattered,secondary,several,shallowly,short-stalked,shrub,side,slightly,small,somewhat,spaced,sparsely,spherical,stalk,stellate,stellate-pubescent,stem,stigma,straight,style,surface,tall,terete,thicker,time,tip,toothed,touching,tree,triangular,trichome,truncate,tube,unarmed,unbranched,usually,way,white,whitish,wide,woody,yellow,yellowish-green,younger	.2,0-3,0.1-0.3,0.2-0.5,0.2-1,1,4-8,5-merous,50,7-30+,abaxially,absen,adaxiall,alyx,andromonoeciou,apar,arme,blade,brow,chartaceous,deeply,distall,eaf,eed,equal,erec,free,geminat,heterostylous,infructescence,inside,interpetalar,juicy,juvenile,larger,lower,midvein,moist,mucilaginous,nflorescence,orolla,oung,papillat,pericarp,portion,pricklier,ruit,sessile,shiny,short-styled,shorter,stalked,tamen,tissue,unit,vary,weakly,ympodial,young	apart,appearance,armed,arrangement,border,bud,characteristic,colour,corolla,corrugation,exertion,form,geminate,giving,glabrousnes,height,history,interjected,leaflet,life,lobing,new,null,number,ovary,papillate,primary,pseudostipule,seed,shape,size,terminal,texture,thicknes,type,variation,vein,width
108	wfo-0001027050	success	234	230	189	45	41	0.808	.2,0-0.2,0-0.5,0-1,0-3,0.1-3,0.2-0.6,0.2-1,0.3-0.6,0.4-1,0.5-1,0.5-3,0.8,1-1.5,1-2,1-5,1.5-2,1.5-6,10-13.5,10-30,11-21,12-15,15-50+,16-40,2-10,2-2.5,2-3,2-4,2-5,2-6,2-8,2-foliate,2.5-3,23-40+,3-15,3-5,4-19,4-40,4-8,5,5-10,5-6,5-7,5-9,6-8,8-26,8-40+,abaxially,absent,abundant,across,acuminate,acute,adaxially,adult,andromonoecious,anther,apart,apex,armed,articulated,axe,ba,base,blade,branche,branched,broad-based,broadly,brown,calyx,chartaceous,cm,coarsely,connivent,contiguous,cordate,cuneate,curved,cylindrical,deeply,densely,diameter,distally,distributed,drying,eglandular,elliptic,entire,erect,except,extra-axillary,ferruginous,filament,flattened,flower,forked,fruit,fruiting,geminat,glabrous,glandular-puberulent,globose,green,growth,hair,half,inflorescence,juvenile,lanceolate,lateral,leaf,leaf-opposed,length,less,like,lobe,lobed,long,longer,margin,markedly,mature,midpoint,midvein,minutely,mm,moderately,multiseriate,narrowly,nearly,oblique,obtuse,ovate,ovate-lanceolate,pair,pale,pedicel,peduncle,per,petiole,pinnatifid,pitted,plant,porrect,present,prickle,rachi,ray,rounded,scattered,sessile,shallowly,shorter,shrub,side,simple,small,somewhat,spaced,sparsely,stalk,stellae,stellate-pubescent,stem,stigma,straight,style,surface,thicker,throughout,time,toothed,tree,triangular,truncate,tube,unarmed,unbranched,unit,upper,usually,weakly,white,whitish,wide,x,yellow,younger	0.5-0.8,14-20,2-3-locular,5-merous,7-30+,absen,accrescent,adaxiall,anvil-shape,capitat,cross-section,directed,distall,eaf,eed,exocarp,functional,held,interpetalar,juicy,lower,mesocarp,minute,moist,mucilaginous,nflorescence,often,orolla,placenta,pore,ruit,slightly,stalked,stellate,tal,tamen,tem,thick,tip,tissue,unarme,upright,vary,yellowish-green,ympodial	3-locular,appearance,arrangement,bark,border,branch,bud,capitate,characteristic,colour,corolla,corrugation,distal,exertion,form,giving,glabrousnes,height,history,interjected,leaflet,life,lobing,new,null,number,ovary,primary,pseudostipule,seed,shape,size,sympodial,tall,terminal,texture,thicknes,type,variation,vein,width
109	wfo-0001027091	success	142	179	118	24	61	0.831	.3,0.7,0.8,1-1.6,1.1-1.6,1.8-2.6,1/2-2/3,2.3-2.9,2.5-3.5,3-8,3-9,30-60,4-10,5-11,8.5-11.5,9-13,accrescent,across,acute-tipped,along,annual,anther,anthesi,arcuate,armed,base,beneath,berry,blade,blue,branched,bristly,broadly,brown,calyx,campanulate,capitate-glandular,cauline,cm,dark,deltoid,densely,developing,dia,difoliate,divided,dm,dry,enveloped,extended,few-rayed,fully,glabrous,gland,glandular,green,hair,herb,high,internodal,invested,lenticular,linear-lanceolate,lobe,long,longer,low,main,maturity,mm,mostly,narrowly,near,obtuse,occasionally,oriented,ovate,pedicel,per,petiole,pinnatifid,pinnatisect,prickly,radially,reticulately,ridge,rounded,scattered,sessile,short-stipitate,simple,sometimes,somewhat,sparsely,spherical,splitting,spreadingly,stellae,stem,strait,surface,tapering,taprooted,terete,tightly,tube,twice,undulate,uniseriate,unit,usually,variously,vein,vestiture,violet,wholly,wrinkled,younger	6-10,6-10-flowere,alyx,eaf,eed,geminat,lon,nflorescence,orolla,ruit,short,slende,ste,stellate-pentagonal,suffused,tamen,terminally,tigma,tub,tyle,unexpande,vary,yello,ympodial	6-10-flowered,apex,appearance,arrangement,bark,border,branch,bud,characteristic,colour,corolla,corrugation,diameter,distal,drying,exertion,filament,form,fruit,fruiting,geminate,giving,glabrousnes,growth,height,history,inflorescence,interjected,lateral,leaf,leaflet,length,life,lobing,margin,midpoint,new,null,number,ovary,peduncle,plant,prickle,primary,pseudostipule,ray,seed,shape,size,slender,stamen,stigma,style,sympodial,terminal,texture,thicknes,type,unexpanded,variation,width
110	wfo-0001027102	exception_thrown	167	0	0	167	0	0.0		.5,.5-6,0.2-2,0.5,0.5-1,0.5-2,0.5-3,1-1.5,1-2,1-2.5,1-3,1-4,1-6,1.5-2,10-20,15,15-35,2-2.5,2-3,3,3-12,3-4,3-5,4-5,4-7,5-12,<,abaxially,absen,absent,accrescent,acuman,acuminate,acute,adaxial,adaxiall,adaxially,ag,aggregate,almost,alyx,anther,apart,apex,appearance,articulated,axe,ba,base,blade,broad,broadly,calyx,cell,channe,chartaceous,ciliate,cm,congested,connivent,corky,cuneate,curved,cylindrical,deltate,densely,diameter,differing,difoliate,dimorphic,directed,distally,eaf,eed,elliptic,entire,few-,filament,flattened,flower,forked,free,fruit,fruiting,geminat,giving,glabrous,globose,hair,ilament,lanceolate,leaf,leaf-opposed,lobe,long,long-tapered,longitudinal,m.,major,margin,minor,mm,moderately,multiseriate,narrowly,nflorescence,oblong,obtuse,often,one,opening,orange,orolla,ovate,pedicel,peduncle,per,perfect,petiole,pore,portion,pubescent,rachi,rarely,ripe,roughened,rugulose,ruit,short,shrub,simple,size,slender,slit,small,somewhat,spaced,sparsely,stellate,stem,stigma,stone,straight,style,subcoriaceous,surface,tal,tem,time,tip,tomentose,triangular,truncat,truncate,tube,unarme,unbranched,unit,usually,vary,white,wide,x,yellow,yellow-brown,ympodial,young	
111	wfo-0001027104	success	141	174	119	22	55	0.844	0.15-0.35,0.5-0.8,1-1.5,1-3,1-4,1.2-6,1.5-2.3,1.5-4.2,10-15,2-3,2-6,2.2-5,3-5.5,4-15,5-15,6-7.5,abaxially,acumen,acuminate,acute,adaxially,apex,apical,apically,articulate,attenuate,base,branched,calyx,cell,cm,condition,connate,cordate,corolla,covering,cyme,dehiscent,diameter,dichasial,dichasially,digestion,distal,dorsally,ebracteate,edge,emoval,enzyme,epiphytic-like,exceeding,filament,finely,flat,flower,folded,forked,generally,globose,green,green-white,growing,hair-like,half,herbaceous,honeycomb,introrse,lateral,linear,lobe,long,make,maturing,mm,monochasial,mos,mucilaginous,mucronate,narrowly,odd-pinnate,often,ovate,ovoid,pattern,pedicel,peduncle,perennial,perfect,petiole,plant,poricidally,proximal,pubescent,rarely,reveal,seed,short,simple,slit,stamen,stigma,straight,style,tall,terrestrial,testal,thick,throughout,tone,truncate,tuber-bearing,typically,unit,wall,white,wide,without,yellow,yellow-green,Â¼	3-6-foliat,eaf,eed,epiphyti,globo,living,lon,lower,nflorescence,nther,orolla,ovat,plan,ruit,seudostipule,specimen,stellate,tem,throughou,vary,viole,ympodial	3-6-foliate,anther,appearance,arrangement,bark,border,branch,bud,characteristic,colour,corrugation,drying,epiphytic,exertion,form,fruit,fruiting,giving,glabrousnes,growth,height,history,inflorescence,interjected,leaf,leaflet,length,life,lobing,margin,mentioned,midpoint,na,new,number,ovary,per,prickle,primary,pseudostipule,ray,shape,size,stem,surface,sympodial,terminal,texture,thicknes,tube,type,variation,vein,violet,width
112	wfo-0001027114	success	154	157	119	35	38	0.773	-17,-2,-30,.5,0.5-1,1-1.1,1-1.2,1-1.5,1-2,1.5-1.7,1.5-2,1/2,13-21,2-2.5,2-3,20-40,3-4,3-7,5,6-8,6-9,7-10,7-9,abaxially,acute,adaxially,along,alternating,anther,anthesi,apex,appearing,bark,base,berry,branched,bushy,calyx,capitate,closely,cm,conical,corolla,dark,deltate,dendritic,densely,dia,drying,elliptic,exserted,filament,flattened-reniform,flowered,free,fruiting,glabrous,globose,green,halfway,inflorescence,investing,lamina,lateral,leaf,like,lobe,lobed,long,main,major,many,margin,minor,minutely,mm,occasionally,opening,opposite,ovary,pair,pedicel,petiole,pitted,planar,pore,poricidal,portion,projection,pubescent,reddish,reddish-brown,rest,scattered,shoot-terminal,shrub,simple,size,slit,soft,stem,stigma,style,surface,tall,tapering,thickened,time,tip,triangular,trichome,tube,uniseriate,vein,way,white,wide,yellowish,young	abaxial,apar,axillary,ba,commonly,differing,difoliate,due,eaf,edicel,eed,erect,geminate,glabrou,growt,inflorescenc,lon,lower,minute,nflorescence,older,papillo,plurifoliate,rapid,ruit,scar,several,shoot,spaced,tub,ud,unevenly,unit,woody,ympodial	appearance,arrangement,border,bud,characteristic,colour,corrugation,diameter,distal,exertion,form,fruit,giving,growth,history,interjected,leaflet,length,life,lobing,midpoint,null,number,papillose,peduncle,per,prickle,primary,pseudostipule,ray,seed,shape,terminal,texture,thicknes,type,variation,width
113	wfo-0001027117	success	235	206	166	69	40	0.706	-1.5,-11,-12,-2.8,-3/4,.5,/3,0-15,0-25,0-40,0-5,0.1,0.1-0.7,0.15-0.35,0.5,0.5-1.5,0.6-0.9,0.7-0.9,0.7-1.3,0.7-1.5,0.8-,1-2,1-4,1-6,1.2,1.5-,1.5-2.3,1.5-6.5,1.7-2.5,1.8-2.5,1/3,1/4,10-20,2-3,2-6,2-8,2.3-2.8,3-15,3-6,4-6.5,4-8,4.5-6.5,5-11,5-14,7-,8,acicular,acute,almost,ame,anther,apart,apex,apically,apparently,attenuate,bark,base,berry,beyond,black,branched,brown,c.,calyx,cell,cm,cordate,dark,densely,diameter,distance,drying,erect,evenly,extending,fifth,filament,fine,flattened-reniform,flower,four,free,fruit,fruiting,glabrescent,glabrous,gra,green,herb,infructescence,lateral,leaf,length,less,lobe,lobed,long,lower,margin,mature,maturity,mauve,membranous,midpoint,midvein,mm,moderately,narrow-deltate,narrow-elliptic,narrow-lanceolate,oblong,obovate,older,one,open,outline,ovate,pair,pale,pedicel,peduncle,per,perpendicular,petiole,pit,porrect,portion,prickle,prickly,primary,raised,ray,red-brown,reduced,rounded,sessile,shallowly,side,small,smooth,sometimes,spaced,sparsely,spherical,stalk,stalked,stellate-pubescent,stem,straight,style,surface,tapering,terete,time,translucent,trichome,tube,unequal,variously,vein,way,wide,yellow,yellow-green,young	0-10,0-20,0.1-,0.15-0.25,0.2,0.2-0.45,1/,1/8-1/2,25-100,3-10,4-7,4.5-8,5-merous,6-10,6-9,abaxially,accrescent,alyx,apar,articulated,blade,brittle,chartaceous,concolorous,connivent,curved,deltate,discolorous,eaf,eed,elongating,enclosing,gently,herbarium,irregularly,lon,long-acuminat,longer,nflorescence,orolla,oung,pendulous,perfec,pericarp,plurifoliat,poricidal,prickl,reflexed,ruit,scar,shiny,shorter,specimen,spreading,staman,stellate,tamen,tearing,tertiary,tip,tissue,unit,upper,vary,venation,visible,weakly,woody,ympodial	appearance,arrangement,border,branch,bud,characteristic,colour,corolla,corrugation,distal,exertion,form,giving,glabrousnes,gray,growth,height,history,inflorescence,interjected,leaflet,life,lobing,long-acuminate,mentioned,new,number,ovary,plant,pseudostipule,seed,shape,size,stigma,terminal,texture,thicknes,type,variation,width
114	wfo-0001027123	success	181	180	137	44	43	0.757	-10,-20,.3,0.3-1.6cm,0.5,0.7-3.5,0.8-1.3,1,1-1.2,1-1.5,1.5-2,2-2.2,2-2.5,2-2.6,2-3,2-5.5,2-lobed,2.5-10.4,2.5-4,2.5-6,3-15,3-4,4-5,4-6,5-10,5-6,acute,adaxially,along,anther,apex,appearing,attenuate,axe,bark,base,branched,bright,brown,calyx,cell,clavate,cm,commonly,completely,conical,constricted,coriaceous,corolla,cup-shaped,dark,darker,diameter,drying,edge,elliptic,erect,exerted,filament,flattened,flower,free,fruiting,glabrous,glandular,globose,green,inflorescence,lamina,lax,leaf,less,lobe,lobed,long,loose,loosely,lower,margin,mauve-purple,minutely,mm,narrowly,older,outline,ovary,pair,papillae,papillate,pedicel,peduncle,perhaps,petiole,pitted,plurifoliate,portion,primary,prominent,pubescent,reddish,reniform,revolute,scar,scattered,shining,shiny,simple,sinuate,sometimes,soon,sparsely,stellate,stem,stigma,stoutish,strongly,style,subshrub,surface,terminal,testal,thick,time,trailing,trichome,tube,turned,unit,usually,vein,violet,warty,way,white,x,young,Â¾	.5,0.5-0.8,0.9-1.3,abaxial,adaxial,anthesi,axi,broadly,campanulate,deltate,dendritic,densely,denser,eaf,eed,enlarged,fide,inserted,lewi,like,lon,midvein,minute,monopodia,nflorescence,nodding,perfect,petal,planar,scatted,shin,shinin,short,sleeve,slightly,spaced,straight,tip,tub,ud,upper,widely,wood,ympodial	appearance,arrangement,border,branch,bud,characteristic,colour,corrugation,distal,exertion,form,fruit,giving,glabrousnes,growth,height,history,interjected,lateral,leaflet,length,life,lobing,midpoint,monopodial,new,null,number,per,plant,prickle,pseudostipule,ray,seed,shape,size,sympodial,texture,thicknes,type,variation,width,woody
115	wfo-0001027146	success	213	189	148	65	41	0.695	0-11,0.3-2.2,0.5-3.2,0.7-2.4,0.8,0.8-3.1,0.8-5.8,1-10,1-2,1-2.5,1-9.5,1.9-10,10,13-36,2-12.2,2-13,2-4.2,3.3-6.1,3.5-22,4-11,4-12.5,4-38,4-8,6,6-10,6-17.5,6.5-52,abaxially,acumen,acuminate,adaxially,along,anther,apart,apex,apparently,arranged,asymmetrical,attenuate,axe,axillary,base,basiscopic,bead,berry,blade,brownish,bud,cell,ciliate,clavate,cm,coarsely,commonly,condition,conical,corolla,covering,dark,darker,deep,diameter,distal,drying,elliptic,especially,filament,finely,flower,forked,fresh,fruit,generally,glabrous,green,greenish,hair,half,herb,interjected,lanceolate,lateral,leaf,leaflet,like,lobe,long,make,margin,medium,minute,mm,moniliform,mottled,mucilaginous,multiple,necklace,odd-pinnate,orbicular,ovate,ovoid,pedicel,peduncle,perfect,petiole,petiolule,plant,puberulent,pubescent,purple,ray,ripe,seed,semierect,sessile,side,simple,size,sometimes,stem,stigma,stolon,style,subglabrous,subsessile,subtending,symmetrical,tall,terminal,testal,thick,throughout,tinged,tip,tissue,tube,tuber,typically,unwinged,usually,violet,wall,wet,white,whitish,wide,wing,x	0.6-3.3,2-5,5-merou,ag,alyx,articulated,capitat,chartaceous,connivent,decreasing,digestion,dorsally,eaf,edge,eed,enzyme,erec,exceeding,flat,folded,fourt,fourth,geminat,glabrou,gradually,green-white,hair-like,homostylous,honeycomb-shaped,lengthening,living,lower,membranous,midrib,minutely,nflorescence,orolla,pair,pentagonal,plurifoliate,pore,poricidal,proximal,rarely,removed,rotate,ruit,secondary,seudostipule,slit,spaced,specimen,stamen,ste,straight,subequal,subglabrou,tamen,tem,toward,tri-,unit,vary,yellow,ympodial	'hair-like,appearance,arrangement,bark,border,branch,calyx,capitate,characteristic,colour,corrugation,erect,exertion,form,fruiting,giving,glabrousnes,growth,height,history,inflorescence,length,life,lobing,mentioned,midpoint,new,number,ovary,per,prickle,primary,pseudostipule,shape,surface,texture,thicknes,type,variation,vein,width
116	wfo-0001027157	success	207	189	144	63	45	0.696	0-3,0.15-0.3,0.7-2,0.9-2.8,1,1-10,1-2,1-3,1-3.8,1-6,1.5-6.5,10-30,2,2-15,2-2.5,2-3,2.3-4,2.5-3,3-12,3-7,3.3-7.8,3.8-8.3,4-5,6.5-14.5,9-12,abaxially,absent,acumen,acuminate,acute,adaxially,anther,apart,apex,apparently,articulated,attenuate,axe,axillary,base,berry,blade,broadly,brownish,bud,cell,chartaceous,ciliate,clavate,cm,condition,conical,connivent,cordate,corolla,covering,decurrent,deeply,densely,diameter,distal,drying,elliptic,end,especially,filament,flower,forked,fresh,fruit,generally,glabrous,green,greenish,hair,half,herb,interjected,lanceolate,lateral,leaf,leaflet,like,lobe,long,low-growing,make,margin,membranous,mm,mucilaginous,narrowly,oblique,obtuse,odd-pinnate,one,orbicular,ovate,ovoid,pedicel,peduncle,perfect,petiole,petiolule,placed,plant,plurifoliate,puberulent,pubescent,rarely,ripe,rounded,seed,semi-rosette,shady,situation,size,slightly,sometimes,stellate,stem,stigma,style,subsessile,subtending,sunny,terminal,testal,thick,tinged,tip,tri-,tube,tuber,typically,unwinged,usually,violet,wall,wet,white,whitish,wide,x	2-5,5-merou,ag,along,alyx,among,capitat,cuneate,decreasing,digestion,dorsally,eaf,edge,eed,enzyme,erec,exceeding,flat,folded,geminat,glabrou,grassland,greatly,green-white,hair-like,homostylous,honeycomb-shaped,lengthening,living,lower,markedly,middl,midrib,minutely,nflorescence,orolla,pair,petiolulate,pore,poricidal,removed,ruit,sessile,seudostipule,short,slit,spaced,specimen,stamen,ste,stolo,straight,tall,tamen,tem,throughout,toward,unequal,unit,vary,woodland,yellow,ympodial	'hair-like,appearance,arrangement,bark,border,branch,calyx,capitate,characteristic,colour,corrugation,erect,exertion,form,fruiting,geminate,giving,glabrousnes,growth,height,history,inflorescence,length,life,lobing,mentioned,middle,midpoint,new,number,ovary,per,prickle,primary,pseudostipule,ray,shape,stolon,surface,texture,thicknes,type,variation,vein,width
117	wfo-0001027184	success	219	168	117	102	51	0.534	.3,.5,.7,0.2-0.4,0.4-2,0.8,1.5-5,19,2,3-4-,4,5,abaxially,absent,acute,adaxially,along,anther,apart,apex,axi,axillary,base,blade,blue,borne,bract-like,branch,brown,calyx,cm,connivent,covered,cylindrical,densely,diameter,epidermal,extension,filament,flattened,fleshy,flower,free,fruit,fruiting,glabrescent,glabrous,globose,hairlike,half,herbaceous,imparipinnate,lanceolate,lateral,leaf,leaflet,leafy,least,light,lobe,long,lower,margin,membranous,meter,midrib,mm,oblong,obtuse,older,orange,pedicel,peduncle,per,petiole,pilose,plurifoliate,portion,prominently,pseudostipule,pubescent,raised,red,reticulate,revolute,ripe,several,shape,shoot,short,size,slightly,small,soft-woody,somewhat,spaced,sparsely,stellate,stem,stigma,straight,style,sulcate,surface,terminal,tertiary,truncate,tube,unbranched,unequal,unit,vein,vine,wall,white,x,young	.8,0-,0-0.2,0.4â0.9,0.5-2,0.8â1.6,0â3,1-2,1.5,1.8â3.5,13â18,1â2,1â2.5,1â4,2.8â4.1,2â4-celled,3-foliolate,3.5â8,3â,3â4-celled,4â12,5-7,7,9,accrescent,adaxiall,adventitious,ag,always,alyx,appressed,articulated,axe,ba,basal,broad,broadly,cell,chartaceous,clavat,cluster,cordat,directed,eaf,eed,elliptic,entire,especially,fasciculate,foliaceous,geminat,generally,glabrou,grading,hair,ilament,introrsely,larger,largest,less,like,longitudinal,m.,minutely,mostly,much,narrowly,nearly,nflorescence,node,often,opening,opposite,orolla,ovate,ower,petiolule,pore,prominent,puberulent,rachi,rarely,root,ruit,scarcely,secondary,simple,slit,subopposite,tightly,tip,tree,trunk,unarme,uniform,usually,vary,visible,weak,yellow,ympodial,â9	0-3,0.8-1.6,1-2.5,1-4,1.8-3.5,13-18,2.8-4.1,3.5-8,4-12,appearance,arrangement,bark,border,bud,characteristic,clavate,colour,corolla,corrugation,distal,drying,exertion,form,geminate,giving,glabrousnes,growth,height,history,inflorescence,interjected,length,life,lobing,midpoint,new,number,ovary,plant,prickle,primary,ray,seed,sympodial,texture,thicknes,type,unarmed,unspecified,variation,width
118	wfo-0001027186	success	168	180	143	25	37	0.851	-6,.4,.5,0.5-1,1-1.5,1-2.5,1.4-1.6,1.5,1.5-2,1.5-2.5,1.6-5,15,2-6,2-lobed,2.5-3,3-4,3.5-4,30-40,4-15,4-9,5-10,6-7,9-10,?,abaxial,abaxially,acute,adaxially,age,always,anther,apex,attenuate,axil,bark,base,berry,branch,branched,broadly,brown,calyx,clavate,cm,conical,corolla,dark,dbh,deltate,denditic,dendritic,densely,denser,diameter,dry,ellipsoid,elliptic,enlarging,entire,exerted,filament,filiform,flower,free,fruit,fruiting,glabrescent,glabrous,globose,golden,green,growth,immature,keeled,lamina,lengthening,less,like,lobe,longer,loose,margin,maturity,midrib,minutely,mm,much,narrowly,new,occasionally,ovary,ovoid,pair,pale,papillate,pedicel,peduncle,pendent,pericarp,petiole,pitted,pointed,pore,poridical,portion,primary,pubescent,reddish,reniform,rough,scattered,seed,shiny,short,simple,slightly,slit,small,soon,sparsely,spreading,stalk,stem,stigma,straight,strongly,style,surface,terminal,time,tip,tree,treelet,trichome,tube,uniseriate,variably,vein,way,white,woody,x,yellow	anthesi,apart,apparently,deflexed,eaf,incrassat,irregularly,lobed,lower,m.,nflorescence,papillat,perfect,planar,plane,plurifoliat,pubescen,rachi,ruit,scar,spaced,tub,ud,unit,ympodial	appearance,arrangement,border,bud,characteristic,colour,corrugation,distal,drying,exertion,form,giving,glabrousnes,history,incrassate,inflorescence,interjected,lateral,leaf,leaflet,length,life,lobing,midpoint,null,number,per,prickle,pseudostipule,ray,shape,size,texture,thicknes,type,variation,width
119	wfo-0001027198	success	191	184	138	53	46	0.723	.4,.5,0.05-1.0,0.5-1,0.7-1,0.8-1,1-1.5,1-10,1.5-10,10-11,11-20,2-5.5,3/4,4-9,5-120-flowered,5-6,7.5-9,acuminate,acute,anther,anthesi,apex,attenuate,axil,base,beneath,berry,bushy,calyx,channeled,clavate,cm,complex,corolla,cyathiform,decurrent,deltoid,dendritic,densely,dia,differing,difoliate,elliptic,entire,exserted,extremely,eye,female,filament,flower,free,fruiting,furcate,glabrate,glabrous,globose,golden,green,impressed,inflorescence,invisible,large,lateral,leaf,lobe,lobed,long,main,major,male,many,margin,medium,middle,minor,minute,minutely,mm,naked,nearly,obovate,often,older,opposite,ovary,ovoid,pale,paler,papillose,pedicel,petiole,pitted,plant,pore,poricidal,portion,puberulent,pubescent,rounded,set,shaped,shining,short,shrub,simple,size,slender,slightly,small,soon,speciman,stem,stigma,straight,style,styled,surface,tall,tannish-yellow,tear-drop,testae,thin,time,tip,tree,trichome,tube,two,type,uniseriate,unit,vein,way,white,widest,x,yellowish,young	0.5-0.75,1-5,1.5-2,abruptly,always,apart,ba,beginning,broadening,caly,closely,constriction,corky,corresponding,dry,eaf,edge,edicel,eed,erect,evenly,found,geminat,inflorescenc,like,live,lon,lower,meet,nflorescence,overlapping,ovoid-reniform,papillo,pendan,planar,pubescence,rather,reddi,reflexed,rest,ruit,scar,sessile,spaced,specimen,strong,thickened,top,ud,undersurface,usually,woody,ympodial	appearance,arrangement,bark,border,branch,bud,characteristic,colour,corrugation,diameter,distal,drying,exertion,form,fruit,geminate,giving,glabrousnes,growth,height,history,interjected,leaflet,length,life,lobing,mentioned,midpoint,new,number,oid-reniform,peduncle,per,prickle,primary,pseudostipule,ray,reddish,seed,shape,sympodial,terminal,texture,thicknes,variation,width
120	wfo-0001027200	exception_thrown	139	0	0	139	0	0.0		0.05-0.25,0.25-0.5,0.5-0.75,0.5-1,0.6-1,0.7-2.5,1-1.4,1-1.5,1.2-1.5,1.5-2,1.5-5,1.6-6,2-3,2.5-3,3-3.5,3.5-6,6-8,8-15,9-11,across,acute,anther,anthesi,apex,aspec,ba,bark,base,beneath,berry,branch,branche,broadly,brown,calyx,capitate,cm,conical,converging,corolla,dark,decurrent,deeply,deflexed,deltoid,densely,dia,differing,eaf,eed,elliptic,except,filament,flattened,free,fruiting,geminate,giving,glabrous,globose,golden,green,grey-brown,horizontally,impressed,inflorescence,lateral,leaf,lightly,like,lobe,lobed,lon,long,lower,main,major,margin,middle,minor,minute,minutely,mm,near,nearly,node,non-reproductive,occasionally,older,onto,ovary,ovoid-reniform,papillo,papillose,pedicel,petiole,pitted,planar,pore,poricidal,portion,prominent,puberulent,reflexed,rest,ruit,shaped,shrub,size,slightly,small,sparse,sparsely,spreading,stem,stigma,straight,style,surface,tall,tear-drop,tip,tree,trichome,tube,unicellular,unifoliate,uniseriate,unit,vein,white,widened,widest,winged,woody,x,yellowish,ympodial,young	
121	wfo-0001027213	success	231	216	174	57	42	0.753	-19,-230,-3.3,-4.5,/10,0-160,0-2.5,0.2-0.4,0.2-0.5,0.7-2.3,1-2,1-5,1.1-1.7,1.2-1.6,1.2-1.7,1.2-2.5,1.3-2.2,1.7-3.6,1.7-3.9,1.8-3.2,1/2-2/3,10-24,12.3-16.3,2-5,2.9-3.8,2.9-4.8,2/3,3.5-8,4-9.5,4.2-5.9,5-8,5.7-6.2,9-13,abaxially,acuminate,acute,adaxially,along,anther,anthesi,apart,apex,apparently,around,articulated,attenuate,axe,basal,base,blade,blunt-tipped,branch,branched,broadly,brown,calyx,cm,conical,corolla,cuneate,cylindrical,dark,decurrent,deltoid,diameter,directed,distally,drying,early,edge,elliptic,entire,eventually,exserted,farinose,filament,flower,free,fruit,fruiting,glabrescent,glabrous,globose,granular,grayish-brown,green,hair,high,immature,inserted,lanceolate,lateral,leaf,length,lengthening,lobe,lobed,long,long-stalked,longitudinal,main,many,margin,midrib,mixed,mm,moderately,mostly,multangulate,nearly,oblanceolate,obovate,often,orbicular,ovate,ovate-lanceolate,pale,pedicel,peduncle,perfect,petiole,pore,poricidal,porrect-stellate,pseudo-terminal,pubescent,rachi,relatively,reniform,reticulate-punctate,scabrous,sessile,short,short-attenuate,short-stalked,shrub,side,simple,slit,sometimes,somewhat,spaced,sparsely,stamen,stem,stigma,style,subcampanulate,surface,terete,thick-stalked,time,tip,tomentose,tomentose-pubescent,touching,tree,tube,unarmed,unwinged,vein,vestigial-rayed,violet,way,white,whitish,whitish-green,wide,x,yellow,yellow-green,yellow-tan,yellowish,young	0.8-1.8,1.8-2.8,2.4-4.7,2.5-5.1,3.5-5,5-7.5,5-merou,8-24,8.2-10.5,accrescent,ag,alyx,ark,axillary,ba,capitat,cell,completely,covering,eaf,eed,enveloping,epidermal,few-rayed,glabrescen,group,homostylous,lackin,long-,lower,m.,multangulat,nflorescence,obscured,obtuse,older,orolla,partly,plurifoliate,porrect-stellat,prominent,pubescence,rather,ruit,short-,stellate,suture,tamen,thick,thin-stalked,ti,tomentu,ud,unarme,unit,vary,ympodial	age,appearance,arrangement,bark,border,bud,capitate,characteristic,colour,corrugation,distal,exertion,form,giving,glabrousnes,growth,history,inflorescence,interjected,leaflet,life,lobing,midpoint,new,null,number,ovary,per,prickle,primary,pseudostipule,ray,seed,shape,short-to,size,terminal,texture,thicknes,type,variation,width
122	wfo-0001027214	success	181	167	126	55	41	0.696	-20,-38,..,.5,0,0-16,0.5-0.8,0.5-1,0.7-2.5,0.8-1,1-1.5,1-2.8,1.2-3,1.5,1.5-1.8,10-,10-13,12-17,15-25,2,2-9,3-6,6-,6-12,7-12,abaxially,absent,adaxially,along,anther,anthesi,anticlinal,apex,apical,base,berry,broadly,calyx,climbing,cm,conical,conspicuously,corolla,deltate,densely,diameter,drying,elliptic,erect,exserted,extending,filament,finely,flattened-round,flower,free,fruit,fruiting,glabrous,globose,green,greenish,grown,height,herb,inflorescence,irregular,lamina,lateral,leaflet,length,less,like,lobe,lobed,long,long-acuminate,long-conical,margin,midrib,minutely,mm,nearly,nodding,oblique,obovate,occasionally,once-branched,open,ovary,pedicel,per,petiole,pinnate,pointed,poricidal,portion,projection,pubescent,rachi,reflexed,rest,scar,scattered,scrambling,seed,sharply,simple,sinuous,somewhat,stigma,style,surface,terminal,thickening,time,tip,triangular,trichome,truncate,tube,vein,white,white-lenticellate,without,x	-9,.25,0.25,0.3-1.5,0.3-1.7,0.7-2,1.5-6,3-,4-5,5-6,8-9,acuminate,acute,basal,capitat,cell,composed,decurrent,dr.,eaf,edicel,eed,epidermal,groove,horizontal,inflorescenc,lanceolate,lon,lower,markedly,narrowly,nflorescence,noddin,often,onto,opposite,pair,paired,papilla,papillate,perfectly,petiolule,rugose,rugosity,ruit,smaller,tem,tub,ud,unevenly,unifoliat,uniseriate,unit,whitish,ympodial	appearance,arrangement,bark,border,branch,bud,capitate,characteristic,colour,corrugation,distal,dry,exertion,form,giving,glabrousnes,growth,history,interjected,leaf,life,lobing,mentioned,midpoint,new,number,peduncle,plant,prickle,primary,pseudostipule,ray,shape,size,stem,texture,thicknes,type,unifoliate,variation,width
123	wfo-0001027219	success	143	158	115	28	43	0.804	.5,/4,0.3,0.4-0.6,0.5,0.5-0.8,1-15,1-2,1-3,1.5-2,1.5-2.5,2,2-2.5,2-3,2-3.5,2-4,3-5,3-6,6-8,7-8,absent,acuminate,acute,age,anther,anthesi,apex,axillary,bark,base,berry,bright,broadly,brown,c.,calyx,capitate,cm,completely,conical,corolla,cup-shaped,deltate,densely,diameter,drying,edge,elliptic,entire,erect,filament,flower,fruiting,glabrescent,glabrous,globose,green,greyish,growth,hard,known,leaf-opposed,lengthening,less,lobe,long-conical,long-styled,margin,maturity,minutely,mm,new,ovary,pair,pale,pedicel,peduncle,pericarp,petiole,pointed,pore,poricidal,primary,pubescent,purple,sharply,shoot,short,short-styled,shrub,simple,slightly,slit,sometimes,soon,stem,stigma,stout,style,surface,terminal,thickened,tip,trichome,tube,tuft,uniseriate,vein,violet,way,white,woody,x,yellowish,â1/3	1,berr,closely,eaf,eed,exerte,exfoliatin,free,glabrou,heterostylous,lobed,lower,nflorescence,overlappin,papillo,papillose-pubescent,pendent,planar,plurifoliat,portion,ruit,scar,somewhat,spaced,ud,unit,weight,ympodial	appearance,arrangement,border,branch,bud,characteristic,colour,corrugation,distal,exerted,exertion,exfoliating,form,fruit,giving,glabrousnes,height,history,inflorescence,interjected,lateral,leaf,leaflet,length,life,lobing,mentioned,midpoint,number,papillose,per,plant,prickle,pseudostipule,ray,seed,shape,size,texture,thicknes,type,variation,width
124	wfo-0001027223	success	189	172	128	61	44	0.677	.5,0.19-0.75,0.3-1.2,1-2,1-3,1.3-2,1.5-3.5,1.8-3.5,16-41,2-7,3-10,3-11,3-5,3-5.2,3.5-4,3.5-6,3.5-7,3.7-9.3,4-6,5-10,5-21,5-8,5.9-12.2,9-15,9-22,9-35,abaxially,acumen,acuminate,adaxially,anther,apart,apex,articulated,asymmetric,attenuate,axillary,base,basiscopic,berry,blade,brownish,bud,cell,clavate,cm,condition,conical,connivent,corolla,covering,deep,densely,diameter,distal,dot,drying,elliptic,end,exceeding,filament,flower,forked,fresh,fruit,generally,green,greenish,hair,hair-like,half,herb,hyaline,interjected,lanceolate,lateral,leaf,leaflet,light,lobe,long,make,middle,mm,mucilaginous,odd-pinnate,one,orbicular,ovate,ovoid,pedicel,peduncle,petiole,petiolulate,placed,plant,pubescent,purple,ripe,rounded,seed,sessile,shortly,side,size,sometimes,spaced,stamen,stigma,straight,stripe,style,subtending,terminal,testal,thick,tissue,tube,tuber,typically,unwinged,usually,wall,wet,white,whitish,wide,x	2-4,5-merou,adaxiall,ag,alyx,apparently,axe,capitat,decreasing,digestion,dorsally,eaf,edge,eed,enzyme,erec,flat,folded,geminat,glabrou,glabrous,green-white,hal,homostylous,honeycomb-shaped,larger,lengthening,like,living,lower,nflorescence,orolla,pair,pentagonal,perfect,plurifoliate,pore,poricidal,present,removed,rotate,ruit,seudostipule,short,slightly,slit,specimen,ste,stolo,subequal,tall,tamen,tem,throughout,tip,toward,tri-,unit,vary,yellow,ympodial	appearance,arrangement,bark,border,branch,calyx,capitate,characteristic,colour,corrugation,erect,exertion,form,fruiting,giving,glabrousnes,growth,height,history,inflorescence,length,life,lobing,margin,mentioned,midpoint,new,number,ovary,per,prickle,primary,pseudostipule,ray,shape,stem,stolon,surface,texture,thicknes,type,variation,vein,width
125	wfo-0001027237	success	122	147	97	25	50	0.795	.5,/4,0.5-1,1-1.2,1.5-2.5,2-3,3-3.5,3-4,30-100-flowered,5,6-11,6-8,8,anther,anthesi,apiculate,appearing,bark,base,berry,black,branched,broadly,brown,calyx,clavate,cm,completely,corolla,cup-shaped,dark,deltoid,dia,difoliate,drying,ellipsoid,erect,exsertion,filament,flattened,free,fruiting,geminate,glabrous,globose,green,greenish-white,inflorescence,internodal,later,leaf,lobe,lobed,long,many,margin,minutely,mm,occasionally,older,ovary,paler,papillose,pedicel,pitted,plurifoliat,pore,poricidal,portion,regularly,reniform,shaped,shining,shrub,slender,small,stem,stigma,straight,style,surface,tall,tapering,tear-drop,terminal,time,tip,tree,tube,unit,usually,way,white,woody,x,x.,young	1.5-2,apart,apiculae,ba,blac,branc,cucullate,deflexed,edicel,eed,greyi,lower,nflorescence,papillate,papillo,part,reflexed,regulary,ruit,scar,spaced,ud,upper,widely,ympodial	apex,appearance,arrangement,border,branch,bud,characteristic,colour,corrugation,diameter,distal,exertion,form,fruit,giving,glabrousnes,greyish,growth,height,history,interjected,lateral,leaflet,length,life,lobing,midpoint,na,new,nternodal,number,peduncle,per,petiole,plant,plurifoliate,prickle,primary,pseudostipule,ray,seed,shape,size,sympodial,texture,thicknes,type,variation,vein,width
126	wfo-0001027238	success	204	180	136	68	44	0.667	-25,.3,.5,0-1,0-1.5,0.3-0.5,0.3-0.8,0.3-1,0.3-5,0.5-1,0.5-16,0.5-2,1-1.5,1-2,1.5-3,1.5-4,10,15-30,2-4,3-4,3-5,3-6,4-10,4-5,4-8,5-15,6-15,6-8,abaxially,acuminate,acute,adaxially,anther,apex,articulated,base,berry,black,blade,branch,brown,calyx,cm,connivent,contiguous,covering,cuneate,cylindrical,dark,deltate,densely,diameter,differentiated,elliptic,elliptic-ovate,entire,extra-axillary,filament,flattened,fleshy,flower,fruit,fruiting,glabrous,globose,green,greenish,hair,interpetalar,lavender,leaf,light,lighter,like,lobe,long,major,margin,midpoint,minor,minutely,mm,multangulate,narrowly,near,nearly,new,oblique,oblong,obtuse,often,outline,pale,pedicel,peduncle,petiole,pitted,porrect-stellate,pubescent,purple,ray,reniform,ripe,rounded,scandent,sessile,shiny,shrub,side,simple,small,sometimes,sparsely,sprawling,stellate-pubescent,stem,stigma,straight,strongly,style,subtending,surface,tip,tissue,tree,triangular,tube,unbranched,unequal,vein,white,whitish,without,x,yellow,yellowish	-5,0-0.7,1.5-7,2-3,4-,4-16,5-7,5-merou,accrescent,adaxiall,ag,alyx,apparently,axe,ba,capitat,chartaceous,directed,discolorous,distally,eaf,eed,equal,foliaceous,fork,free,frui,geminate,glabrescent,gland,gland-tipped,growt,homostylous,introrsely,juic,large,longitudinal,lower,membranaceous,mixed,nflorescence,one,opening,orolla,paired,part,perfect,pericarp,plurifoliate,pore,rachi,ruit,short-stalked,similar,slit,somewhat,sparse,ste,stellate,tamen,tem,time,toward,unarme,unit,vary,wide,ympodial	appearance,arrangement,bark,border,bud,capitate,characteristic,colour,corolla,corrugation,distal,drying,exertion,form,giving,glabrousnes,growth,height,history,inflorescence,interjected,lateral,leaflet,length,life,lobing,null,number,ovary,per,plant,prickle,primary,pseudostipule,seed,shape,size,terminal,texture,thicknes,type,unarmed,variation,width
127	wfo-0001027244	success	294	263	231	63	32	0.786	-12,-2,-3.2,0-,0.05,0.07-0.15,0.1-,0.1-0.5,0.1-0.6,0.15-0.2,0.2,0.2-,0.2-1,0.25-0.4,0.3-0.5,0.3-0.6,0.4-,0.4-1,0.45-0.6,0.5,0.5-0.8,0.5-1,0.7-1.5,0.7-2,0.7-3,0.9-1.3,0.9-1.7,1,1-2-celled,1-3.5,1-celled,1.1-1.3,1.2-1.6,1.5-2,1.5-2.1,1.5-2.4,1.5-6.5,1.7-3.0,1/2,2-,2-4,2-locular,2.1-8,3.5-13,3/4,4-12,4-celled,5-,5-10,5-9-celled,7-12,8-16,8-celled,abaxially,abundance,abundant,acuminate,acute,adaxially,adpressed,alfway,along,also,always,angled,anther,anthesi,apex,apical,appearance,appendage,articulated,articulation,axi,base,berry,bifurcate,bract,bracteate,branched,broadly,brown,c.,cage,calyx,capitate,cell,cm,common,conical,cordate,corolla,crenate,curved,dark,decumbent,decurrent,deltate,densely,density,dentate,diameter,distal,eglandular,either,elliptic,elliptical,erect,exserted,extremely,filament,flower,flushed,forming,fruit,fruiting,general,giving,glabrous,gland,glandular,globose,green,greenish,hair-like,half,halfway,head,herb,hyaline,imparipinnate,inflorescence,interjected,interrupted,investing,irregularly,lamina,lanceolate,larger,largest,lateral,leaflet,length,like,lobe,lobed,lobing,long,longer,margin,middle,midvein,minute,mixed,mixture,mm,multicellular,narrowly,oblique,obovate,occasionally,often,onto,orbicular,outgrowth,ovary,papillate-pubescent,patent,pedicel,peduncle,perennial,petiole,population,present,primary,pseudostipule,pubescent,purple,rachi,reflexed,ripe,rounded,shaggy,shorter,silky,simple,sinus,size,slender,small,sometimes,somewhat,sparsely,sparser,spreading,stem,sterile,stigma,stout,straight,stripe,strongly,style,surface,tall,terminal,testa,thick,tiny,tip,tipped,toward,trichome,truncate,tube,two,undulate,unicellular,uniseriate,united,upper,usually,variable,variety,vein,velvety,wall,white,wide,winged,woody	-1.2,.5,0.02-,0.04-,0.05-1,0.1-0.3,0.3,0.3-0.4,0.3-0.8,0.4-0.6,0.6-0.9,0.6-09,0.7-1,0.8-1.2,1-2.5,2-4-celled,2-9,2-foliate,3-5,absent,acroscopically,amongst,apparently,arequipa,around,articulatio,basal,berr,column,deciduous,deeper,dense,developed,diamete,eaf,edicel,eed,glabrescent,gree,internode,leave,lon,lower,near,node,pair,petiolule,rest,rotate-stellate,ruit,scattered,secondary,sessile,short,sparse,staminal,tem,tertiary,ud,unit,vivid,yellow,ympodial	arrangement,bark,border,branch,bud,characteristic,colour,corrugation,drying,exertion,form,glabrousnes,growth,height,history,leaf,life,midpoint,new,null,number,per,plant,prickle,ray,seed,shape,texture,thicknes,type,variation,width
128	wfo-0001027248	exception_thrown	158	0	0	158	0	0.0		.5,0,0.5-1,0.5-2.5,0.7-1.2,1-1.5,1-2,1-3,1-5,2-2.5,2-4.5,3-4,3-7,3-7-flowered,3.5-4,4-8,5-5.5,6-13,6.5-8,7-9,abaxial,abaxially,acute,adaxially,along,anther,anthesi,ape,apex,appearing,arachnoid,arachnoid-pubescen,arachnoid-pubescent,area,bark,base,beige,beneath,berry,broadened,broadly,brown,brownish,brownish-gra,calyx,closely,cm,conical,corolla,dark,deflexed,deltate,densely,denser,dia,differing,difoliate,dirty,eaf,edicel,eed,ellipsoid,elliptic,erect,exserted,felty,filament,fleshy,free,fruit,fruiting,geminate,glabrescent,glabrous,globose,grayish-green,green,impressed,lamina,later,lateral,leaf,lightly,lobe,lobed,long,lower,main,major,margin,merely,minor,minutely,mm,nearly,nflorescence,node,occasionally,older,opposite,ovary,overlappin,ovoid-reniform,pair,pale,papillo,papillose,patch,pedicel,per,petiole,pitted,planar,pore,poricidal,portion,present,pubescence,pubescent,ruit,scar,scattered,shaped,shoot,shrub,simple,size,small,somewhat,soon,spaced,sparsely,specimen,stem,stigma,strongly,style,surface,tall,tear-drop,thick,tip,top,tree,trichome,tub,tube,ud,unifoliate,unit,vein,white,wid,wide,winged,woody,ympodial,young	
129	wfo-0001027258	exception_thrown	178	0	0	178	0	0.0		.25,.5,/4,0.25-0.5,0.5-1,0.6-2,0.9-1.3,1-1.5,1-2.3,1-4,1.2-2,1.5-1.6,2-2.5,2.5-8,3-4,3-6,3.5-4,4-5,4.5-5,5-10-flowered,6-8,7-13,7-9,abaxially,abruptly,acuminate,acute,adaxially,age,along,anther,anthesi,apar,apex,apical,apiculae,attenuate,axil,ba,bark,base,beneath,berry,broadly,calyx,capitate,cm,corolla,crystal,darker,decurrent,deflexed,deltate,dense,densely,deposit,dia,differing,difoliate,dissecting,drying,eaf,edicel,eed,ellipsoid,elliptic,enlarge,entire,evenly,exserted,extending,fide,filament,flattened-reniform,fragrant,free,fruit,fruiting,geminat,glabrou,glabrous,globose,green,greenish-yellow,incrassate,internodal,lamina,large,lateral,leaf,length,lengthening,lenticel,lobe,lobed,long,lower,main,major,margin,microscope,middle,minor,minute,minutely,mm,nee,nflorescence,occasionally,often,older,onto,opposite,ovary,ovate,pair,pale,papillo,papillose,pedicel,petiole,pitted,planar,pore,poricidal,portion,projection,prominent,pubescent,red-papillose,reddish,ruit,sand,scar,scattered,shrub,simple,size,slender,slightly,slit,small,spaced,sparsely,speck,stem,stigma,straight,strongly,style,surface,sweetly,swollen,tall,tiny,tip,treelet,trichome,tub,tube,tuft,ud,uniseriate,unit,urceolate,vein,visible,way,white,widening,widest,winged,woody,x,yellowish,yellowish-tan,ympodial,young	
130	wfo-0001027260	success	176	165	111	65	54	0.631	-2,-60,0.25-1,0.5-3,0.5-6.5,0.8-2,1-,1-2,1-3,1-4,1-6,1.5-13,1.5-2,10-25,15-30,2-,2-10,2-18,2-2.5,2.5-14,2.5-3.5,3-,3-11,3-4.5,3-6,3.5-25,4-25,4-32,4-6,5-,5-40,6-20,abaxially,acuminate,acute-,adaxially,age,also,apex,basal,base,berry,beyond,blade,branched,clavate,cm,connivent,cordate,cylindrical,darker,densely,diameter,eglandular,ellipsoidal,elliptic,elliptic-ovate,entire,exserted,fading,flattened,flower,fruit,glabrate,glabrous,globose,greenish,hair,lanceolate,lavender,lobe,long,longitudinal,margin,mm,moderately,obtuse,often,ovate,pedicel,peduncle,petiole,pilose,pink,puberulent,pubescent,pubescent-pilose,purple,radiu,shrub,simple,small,sparsely,stamen,stigma,stripe,style,time,tree,triangular,truncate,tube,unbranched,usually,vein,white,wide,x,yellow,yellow-green,yellowish	-17,-7,0.5-1,0.75-1,1-7,3-10,4-5-foliat,4.5-14,5-25,5-merous,absent,acute,aggregate,alyx,apart,ape,articulated,axe,cell,chartaceous,connective,diamete,directed,distally,eaf,eed,equal,exceeding,leaving,lon,lower,membranaceous,narrowly,nearly,nflorescence,nther,orolla,pedicellar,perfec,perfect,pilo,pore,presen,puberulent-pubescen,puberulent-pubescent,rachi,remnant,ruit,shorter,slightly,spaced,stellate,stone,strongly,subcoriaceous,tal,tapered,tem,thecae,tomento,ud,unit,vary,yellow-orang,ympodial	anther,appearance,arrangement,bark,border,branch,bud,calyx,characteristic,colour,corolla,corrugation,distal,drying,exertion,filament,form,fruiting,giving,glabrousnes,growth,height,history,inflorescence,interjected,lateral,leaf,leaflet,length,life,lobing,mentioned,midpoint,new,number,ovary,per,plant,prickle,primary,pseudostipule,ray,seed,shape,size,stem,surface,tall,terminal,texture,thicknes,type,variation,width
131	wfo-0001027265	success	159	144	94	65	50	0.591	.2,.3,0.1â2,0.2-0.4,0.5-1,1-2.5,1.2-2,1.2â1.4,1.5-2.5,1.5â1.8,1.5â4,2,2-3,2/3,20-30,2â2.5,2â3,3-lobed,30â50,4.5â8,4â6,4â7-branched,abaxially,acute,adaxially,anther,apex,apparently,axe,base,berry,calyx,ciliate,cm,cylindrical,diameter,entire,erect,extra-axillary,filament,flattened-reniform,flower,fruit,fruiting,glabrous,globose,hair,herb,leaf-opposed,light,lobe,long,long-attenuate,low,lower,margin,minutely,mm,near,nearly,node,numerous,oblong,obtuse,orange,ovate-lanceolate,pedicel,peduncle,petiole,pitted,puberulent,pubescent,purple,rarely,recurved,red,ripe,rooting,seed,simple,slightly,sometimes,sparsely,stigma,style,surface,tall,triangular,tube,weak,white,winged,x,yellow	-2.5,.5,0.5,0.5â0.6,1-1.3,1-3,1.2-1.3,1.5â2,2-,2-4,3-,4-5,5-merou,58409,accrescent,adaxiall,alyx,apart,articulated,ba,blade,broad,capitat,chartaceous,connivent,covering,croat,dehiscent,eaf,eed,foliate,frui,geminat,granule,hermaphroditic,juic,larger,lon,longitudinall,mesocarp,nflorescence,orolla,paired,partially,pore,present,prominent,rachi,rotate-stellate,ruit,scarcely,sclerotic,somewhat,spaced,subcoriaceous,tamen,tem,time,tip,unit,usually,vary,white-puberulent,wide,ympodial	1.5-1.8,appearance,arrangement,bark,border,branch,bud,capitate,characteristic,colour,corolla,corrugation,distal,drying,exertion,form,giving,glabrousnes,growth,height,history,inflorescence,interjected,lateral,leaf,leaflet,length,life,lobing,mentioned,midpoint,new,number,ovary,per,plant,prickle,primary,pseudostipule,ray,shape,size,stem,terminal,texture,thicknes,type,variation,vein,width
132	wfo-0001027265	success	156	145	93	63	52	0.596	.2,.3,.5,0.1â2,0.2-0.4,0.5-1,0.5â0.6,1-2.5,1.2-2,1.2â1.4,1.5-2.5,1.5â1.8,1.5â4,2,2-3,2/3,20-30,2â2.5,2â3,3-lobed,30â50,4.5â8,4â6,4â7-branched,abaxially,acute,adaxially,anther,apex,apparently,axe,base,calyx,ciliate,cm,cylindrical,diameter,entire,erect,extra-axillary,filament,flattened-reniform,flower,fruit,fruiting,glabrous,globose,hair,herb,leaf-opposed,light,lobe,long,long-attenuate,low,lower,margin,minutely,mm,near,nearly,node,numerous,oblong,obtuse,orange,ovate-lanceolate,pedicel,peduncle,petiole,pitted,puberulent,pubescent,rarely,recurved,red,ripe,rooting,seed,simple,slightly,sometimes,sparsely,stigma,style,surface,tall,triangular,tube,weak,winged,x,yellow	-2.5,0.5,1-1.3,1-3,1.2-1.3,1.5â2,2-,2-4,3-,4-5,5-merou,58409,accrescent,adaxiall,alyx,apart,articulated,ba,blade,broad,capitat,chartaceous,connivent,covering,croat,dehiscent,eaf,eed,foliate,frui,geminat,granule,hermaphroditic,juic,larger,lon,longitudinall,mesocarp,nflorescence,orolla,paired,partially,pore,prominent,purple,rachi,rotate-stellate,ruit,scarcely,sclerotic,somewhat,spaced,subcoriaceous,tamen,tem,time,tip,unit,vary,white,white-puberulent,wide,ympodial	1.2-1.4,1.5-1.8,4-6,appearance,arrangement,bark,border,branch,bud,capitate,characteristic,colour,corolla,corrugation,distal,drying,exertion,form,giving,glabrousnes,growth,height,history,inflorescence,interjected,lateral,leaf,leaflet,length,life,lobing,mentioned,midpoint,new,number,ovary,per,plant,prickle,primary,pseudostipule,ray,shape,size,stem,terminal,texture,thicknes,type,variation,vein,width
133	wfo-0001027284	success	172	167	116	56	51	0.674	.3,0.1â0.5,0.2â,0.7â0.9,0.7â1,1.2â1.5,1.5â2,1.5â2.5,1.5â8,1.8â2,1â1.5,2.5â3,2.5â3.5,2â2.2,3.5â14,3â4,4,4â12,4â6,5â7,5â8,9â18,acuminate,acute,adaxially,anther,anthesi,apex,axillary,base,berry,branch,branched,brownish,calyx,climbing,cm,cordate,cylindrical,deflected,deltoid,densely,diameter,elliptic,entire,extra-axillary,filament,flattened,flattened-reniform,fleshy,flower,fruit,fruiting,glabrous,globose,green,herbaceous,inflorescence,leafy,lobe,long,margin,maturity,minutely,mm,nearly,oblique,one,orangish,ovate,ovoid,pair,pale,pedicel,peduncle,petiole,pink,pinnate,planar,pointed,pubescent,rarely,reticulate-rugulose,rounded,sand-punctate,scandent,secondary,shortly,shrub,side,simple,size,slightly,sometimes,somewhat,soon,sparsely,spreading,stem-terminal,stigma,style,surface,tan,thickly,tip,tree,truncate,tube,unbranched,understory,vein,vine,weakly,white,woody,x	0.1â2,1.5â5.5,1â2,1â3,2â16,5-merous,abaxially,accrescent,alyx,axe,blade,c.,capitat,ciliat,conspicuous,contiguousl,distally,eaf,eed,enlarged,fine,glabrescen,glabrou,gradually,immature,lower,m.,midvein,near,nflorescence,nternode,orolla,pendulou,perfec,plurifoliate,prominent,pubescence,rachi,reduced,ruit,sand-punctat,scar,seen,spaced,stellate,tamen,tem,thickened,time,toward,unifoliat,unit,vary,venation,wide,ympodial	1.8-2,2-2.2,3-4,appearance,arrangement,bark,border,bud,capitate,characteristic,colour,corolla,corrugation,distal,drying,exertion,form,giving,glabrescent,glabrousnes,growth,height,history,interjected,lateral,leaf,leaflet,length,life,lobing,mentioned,midpoint,new,number,ovary,pendulous,per,plant,prickle,primary,pseudostipule,ray,seed,shape,stem,terminal,texture,thicknes,type,variation,width
134	wfo-0001027302	success	188	188	144	44	44	0.766	.5,0.4-5,0.5,0.5-1,0.8-1,1,1-1.5,1-2,1-3,1.2-1.6,1.5-2,10,2-3,2-6,2.2,2.7-7.5,3.5-5,3/4,6-12,7,7/8,abaxially,acuminate,acute,adaxial,age,along,anther,anthesi,apex,apical,bark,basal,base,becoming,berry,blade,branching,bright,brownish-yellow,calyx,capitate,clavate,cm,cordate,corolla,crispate,cultivation,decurrent,deflexed,dendritic,densely,denser,diameter,elliptic,entire,especially,exserted,filament,fine,flattened,free,fruiting,glabrous,globose,growth,inserted,later,lateral,lax,leaf,length,lenticular,less,like,lobe,lobed,long,main,margin,minutely,mm,monochasial,narrowly,nodding,occasionally,older,ovary,ovate,pair,pale,pedicle,per,pericarp,petiole,pitted,planar,plant,plurifoliate,pore,poridical,portion,prominent,puberulent,pubescent,red,reddish-brown,reflexed,scar,scrambling,secondary,shrub,simple,sleeve,slit-like,small,somewhat,sparsely,stem,stigma,strongly,style,surface,tall,tapering,terminal,thin,tiny,tip,tree,trichome,truncate,tube,undulate,unit,usually,vein,violet,way,wide,winged,woody,x,young	0.6-1,1-1.3,1.2-2.5,10-20,2,5-7,abaxial,adaxially,appearing,ba,broader,conical,deltoid,dichasia,discussion,eaf,edicel,eed,ew,flat-topped,flower,growing,juvenile,larger,lon,long-triangular,lower,m.,nflorescence,otherwise,overtopping,papillo,pyramidal,ruit,scattered,see,shade,shin,shoot,stamen,time,tub,ud,ympodial	appearance,arrangement,border,branch,bud,characteristic,colour,corrugation,dichasial,distal,drying,exertion,form,fruit,giving,glabrousnes,height,history,inflorescence,interjected,leaflet,life,lobing,midpoint,new,null,number,papillose,pedicel,peduncle,prickle,primary,pseudostipule,ray,seed,shape,shiny,size,sympodial,texture,thicknes,type,variation,width
135	wfo-0001027310	success	215	245	207	8	38	0.963	-2.2,-20,.8,/3,0,0-20,0-5,0.05,0.05-0.15,0.1,0.1-0.2,0.15-0.3,0.6-1,0.7-2,0.9-0.17,1-1.2,1-1.7,1-6,1.1-1.5,1.5-2.2,1.5-5,1/10-1/6,1/3-1/2,1/3-3/4,11-16,2-10,2-3.1,2-4,2-5,2.2-2.5,2.8-3,2/3,20-60,22-30,3-15,4-10,4-9,4.5-5.5,4.5-7,5-10,5-20,5-7,5-merous,6-8,7-10,8-10,9-13,abaxial,abaxially,acut,acute,adaxial,alyx,andromonoecious,anther,apar,apart,apex,apically,apparently,articulated,bark,base,berry,blade,branched,branching,broadly,calyx,chartaceous,cm,connivent,cuneate,curved,dark,deltate,densely,diameter,discolorous,distal,drying,elongating,entire,equal,erect,evenly,faint,filament,flattened,flattened-reniform,flower,foliaceous,free,fruit,fruiting,fused,gently,glabrescent,glabrou,glabrous,glaucous,gray,green,green-brown,hair,hermaphrodite,heterostylous,inflated,infructescence,lanceolate,lateral,leaf,length,less,lobe,lobed,long,long-styled,longer,lower,lowermost,margin,mature,maturity,mauve,midpoint,minutely,mm,moderately,older,one,open,orange-brown,pair,pale,pedicel,peduncle,pendulous,per,pericarp,petiole,pitted,plant,plurifoliat,poricidal,porrect,porrect-lepidote,portion,prickle,prickly,primary,pubescent,purple,ray,red,reddi,reflexed,rounded,scar,secondary,sessile,shallowly,short-styled,shorter,shrub,simple,smooth,sometimes,spaced,sparse,sparsely,spherical,spreading,stalk,stalked,staminat,stellate,stellate-pubescent,stem,stout,straight,strongly,style,surface,tapering,terete,terminal,tertiary,time,tip,toward,tree,trichome,truncate,tube,unarme,unarmed,unit,vary,vein,venation,visible,way,wide,woody,yellow,young	eaf,eed,nflorescence,orolla,oung,ruit,tamen,ympodial	appearance,arrangement,border,branch,bud,characteristic,colour,corolla,corrugation,exertion,form,giving,glabrousnes,growth,height,history,inflorescence,interjected,leaflet,life,lobing,new,null,number,ovary,pitte,pseudostipule,seed,shape,size,stamen,stigma,sympodial,texture,thicknes,type,variation,width
136	wfo-0001027317	exception_thrown	144	0	0	144	0	0.0		.25,.5,0.1-0.2,0.3-1,0.4-1.5,0.5-1,0.5-3,0.8-3.5,1,1-1.5,1-2,1-5,1.4-1.6,1.5-2,2-3-flowered,2-9,3-3.5,4.5-5,7-9,?,abaxial,acuminate,acute,adaxially,along,anther,anthesi,apex,apical,apically,arch,ba,bark,base,beneath,berry,bilobed,broadly,calyx,closely,cm,conical,corolla,cucullate,deciduous,deflexed,deltoid,densely,dia,differing,difoliate,drying,eaf,edicel,eed,ellipsoid,elliptic,elongated,erect,expanded,filament,filiform,free,fruit,fruiting,geminat,glabrous,globose,golden,green,greyish-whit,immature,inflorescenc,joined,known,lateral,leaf,like,lobe,lobed,lon,long,long-exserted,lower,main,major,margin,mature,minor,minute,minutely,mm,nearly,nflorescence,offset,older,opposite,ovary,overlappin,pair,pale,papillo,papillose,pedicel,petiole,pointed,pore,poricidal,portion,projection,prominent,pubescent,reflexed,rest,ruit,scar,series,shaped,shrub,simple,size,slightly,soon,spaced,sparsely,stem,stigma,strongly,style,surface,tall,tear-drop,tip,trichome,tub,tube,ud,uniseriate,vein,white,woody,x,ympodia,young	
137	wfo-0001027323	success	175	176	132	43	44	0.754	/3,0.5-1,1-1.5,1-2,1.2-1.5,10-15,14-21,2-3,2-6,2.5-3,20-45,3-5,5-20-flowered,5-7,6-11,7-9,acute,along,anther,apex,apparent,appearing,area,asymmetric,attenuate,bark,base,berry,broadened,bud,calyx,campanulate,character,closed,cm,corolla,decurrent,densely,dia,difoliate,dried,elliptic,elongate,exserted,filament,fleshy,flopping,flower,fruit,fruiting,furcate,glabrate,glabrous,globose,grey,growing,held,higher,hooded,immature,lateral,leaf,like,live,lobe,lobed,long,long-triangular-deltoid,main,major,margin,matte,mature,measured,middle,minor,minutely,mm,occasionally,older,one,onto,opposite,ovary,ovoid,ovoid-reniform,pair,papillae,papillose,partially,pedicel,persistent,petiole,pinkish-grey,pitted,plant,pore,poricidal,prominent,proximal,red-papillose,reddish-grey,rest,seen,shaped,size,slightly,small,soon,specimen,stem,stigma,style,surface,tan,tear-drop,tiny,tip,treelet,trunk,tube,two,unit,upper,vein,visible,way,white,widest,winged,x,young	.75,adaxial,anthesi,arising,ba,closely,cork,deflexed,differing,dry,eaf,edicel,eed,entire,erect,erose,five-pointed,free,geminat,hood,interpetalar,lon,lower,nflorescence,overlapping,papillo,planar,portion,rather,ridge,ruit,scar,secondary,sinus,smoot,spaced,straight,tall,thickened,thin,ud,woody,ympodial	appearance,arrangement,border,branch,characteristic,colour,corrugation,diameter,distal,drying,exertion,form,geminate,giving,glabrousnes,growth,height,history,inflorescence,interjected,leaflet,length,life,lobing,mentioned,midpoint,new,number,peduncle,per,prickle,primary,pseudostipule,ray,seed,shape,smooth,sympodial,terminal,texture,thicknes,type,variation,width
138	wfo-0001027340	success	189	173	130	59	43	0.688	0.5-0.9,1-10,1-2,1.5-2.7,10-16,16-22,2-3,2-3.5,2-4,2.5-4.5,2.7-4.5,3.5-5,3.5-9,4-6,4-7.5,5-11,5-6,6-8.5,7-18,7-8,8-14,8-9.5,abaxially,abruptly,absent,acumen,acuminate,adaxially,anther,apart,apex,apparently,articulated,articulation,auriculate,axe,axillary,base,berry,blade,brownish,bud,cell,ciliate,cm,condition,connivent,cordate,corolla,covering,dark,developing,diameter,distal,distinct,drying,elliptic,especially,filament,flower,forked,fresh,fruit,generally,globose,green,greenish,hair,half,herb,high,indistinct,interjected,lanceolate,lateral,leaflet,like,lilac-purple,lobe,long,make,margin,minute,mm,mucilaginous,narrow,narrowed,odd-pinnate,ovate,ovoid,papillose,pedicel,peduncle,perfect,petiole,petiolulate,plant,pointed,pubescent,purple,ripe,rounded,seed,semi-rosette,sessile,short,shortly,size,slightly,spaced,sparsely,splotched,stem,stigma,style,subtending,terminal,testal,thick,tinged,tip,truncate,tube,usually,wall,wet,whitish,wing,x,young	1-3,3-4,5-merou,ag,along,alyx,capitat,chartaceous,decreasing,digestion,dorsally,eaf,edge,eed,enzyme,exceeding,flat,folded,geminat,glabrou,glabrous,green-white,hair-like,hal,homostylous,honeycomb-shaped,lengthening,living,lower,membranous,midrib,minutely,nflorescence,orolla,pair,plurifoliate,pore,poricidal,puberulent,purpl,removed,rotate,ruit,semi-erec,seudostipule,slit,specimen,stamen,ste,straight,tall,tamen,tem,throughout,tri-,unit,vary,yellow,ympodial	'hair-like,appearance,arrangement,bark,border,branch,calyx,capitate,characteristic,colour,corrugation,exertion,form,fruiting,giving,glabrousnes,growth,height,history,inflorescence,leaf,length,life,lobing,mentioned,midpoint,new,number,ovary,per,prickle,primary,pseudostipule,ray,semi-erect,shape,surface,texture,thicknes,type,variation,vein,width
139	wfo-0001027354	success	166	174	135	31	39	0.813	0,0.5,0.5-2,0.7-1.3,1,1-1.2,1-1.5,1-7,1.5-1.8,1.7-5,10,10-20,2.5-3.5,3-4,3.4-4,3/4,4-10,5-7,6.5-13,8-12,abaxial,absent,acute,adaxial,age,along,anther,anthesi,apex,apical,appearing,bark,basal,base,becoming,berry,bi-lobed,branch,branching,calyx,cm,conical,corolla,covered,dark,deltoid,dendritic,densely,denser,diameter,drying,elliptic,entire,erect,exserted,filament,flattened,flower,fork,fruit,fruiting,glabrate,glabrous,globose,golden,growth,later,lateral,leaf,length,lenticular,less,like,lobe,long,loose,loosely,minutely,mm,monochasial,narrowly,near,nodding,occasionally,older,ovary,pair,pedicel,per,pericarp,petiole,pitted,planar,plurifoliate,pore,poricidal,pubescent,purplish-black,pyramidal,raised,reddish-brown,scar,secondary,shrub,slightly,slit-like,small,somewhat,sparsely,stem,stigma,strongly,style,surface,tall,tapering,terminal,thin,time,tip,tree,tree-like,trichome,tube,type,unit,vein,violet,way,white,wide,winged,woody,x,young	.5,1.5-2,abaxially,ba,belo,blade,dichasia,eaf,edicel,eed,ew,free,inserted,lobed,lower,m.,mostly,nflorescence,papillo,portion,pubescen,ruit,side,simple,sleeve,stamen,thecalyx,tiny,tub,ud,ympodial	3,appearance,arrangement,border,bud,characteristic,colour,corrugation,dichasial,distal,exertion,form,giving,glabrousnes,history,inflorescence,interjected,leaflet,life,lobing,margin,mentioned,midpoint,new,number,papillose,peduncle,prickle,primary,pseudostipule,ray,seed,shape,size,sympodial,texture,thicknes,variation,width
140	wfo-0001027359	success	224	193	152	72	41	0.679	-2,-20,.1,.5,0,0-3,0-9,0.1-0.2,0.1-1.5,0.3-1.2,0.5-2,0.6-0.8,1-1.2,1-2,1-3,1-5,1.2-1.5,1.2-2,1.5-2.5,1.8-3.2,1/5-1/4,2-3,2-4,2.5-3.5,2.5-5.5,3-10,4-,4-5,5-6.5,5-merous,6-8,acute,anther,apart,apex,apparently,articulated,bark,base,berry,blade,branched,calyx,cell,chartaceous,cm,concolorous,cuneate,curved,dark,densely,diameter,difoliate,distinctive,drying,dull,elongate,entire,equal,erect,eye,filament,flattened-reniform,flower,fruit,fruiting,glabrescent,glabrous,gray,lateral,leaf,length,like,lobe,lobed,long,longer,margin,membranous,midpoint,minutely,mm,moderately,naked,obtuse,occasional,often,one,open,orange-brown,outline,ovate,ovoid,pair,pedicel,peduncle,per,petiole,pit,poricidal,porrect,prickle,prickly,primary,purple,rachi,raised,rarely,ray,reticulate,scandent,scar,shallowly,shorter,shrub,slender,small,smooth,sometimes,spaced,sparsely,spherical,spreading,stalk,stalked,stellate,stellate-pubescent,stem,stump,style,surface,tapering,terete,terminal,tertiary,time,tinge,tip,trichome,tube,unarmed,undulate,unit,usually,variously,vein,venation,visible,white,wide,yellow,young	-0.25,-3,-4,-7,-9,.2,/3,/4,0-2,0-5,0.1,0.3-0.5,0.5,0.5-1,0.6-1,1-4,1.5-2,2-10,5-,7-8,abaxially,acut,alyx,apar,apically,ba,bright,brow,coroll,cream,deltate,eaf,eed,elongating,filiform,flattened,free,geminat,green,herbaceous,infructescence,less,lower,marking,mature,maturity,narrow-deltate,narrow-ovate,near,nflorescence,older,orolla,oung,pale,perfec,pericarp,portion,red,reflexed,ruit,sessile,simple,slightly,tamen,ud,unarme,vary,way,weakly,woody,yellow-brown,ympodial	appearance,arrangement,border,branch,brown,bud,characteristic,colour,corolla,corrugation,distal,exertion,form,geminate,giving,glabrousnes,growth,height,history,inflorescence,interjected,leaflet,life,lobing,new,number,ovary,perfect,plant,pseudostipule,seed,shape,size,stamen,stigma,sympodial,texture,thicknes,type,variation,width
141	wfo-0001027366	success	136	148	103	33	45	0.757	/2,/4,0.25-0.5,0.5-1,0.7-1,1-1.5,1-2,1-3,1.5-2,11-21,2-2.5,3-10-flowered,3-9,4-4.5,4-5,5-7,6-19,abaxially,acute,adaxially,anther,anthesi,apex,axe,bark,base,berry,bright,broadly,brown,calyx,capitate,cm,conical,conspicuously,corolla,dark,deflexed,dia,drying,elliptic,except,exserted,filament,fruiting,glabrous,globose,golden,green,greenish-white,internodal,lateral,leaf,less,lobe,long,main,margin,middle,minutely,mm,older,opposite,orbicular,ovary,ovoid,ovoid-reniform,pair,pale,papillose,parallel,pedicel,petiole,pitted,planar,pointed,pore,poridical,reddish,rounded,secondary,shaped,shining,shrub,simple,sometimes,somewhat,stem,stigma,style,surface,tall,tear-drop,tip,trichome,tube,unit,vein,venation,way,wide,widest,young	.5,603,ape,ba,closely,deltate,eaf,edicel,eed,erect,et,fide,free,lamina,lobed,lon,long-triangular,lower,nflorescence,overlappin,packed,papillo,portion,ramo,ruit,scar,straight,tub,ud,unifoliat,woody,yellowish-gre,ympodial	appearance,arrangement,border,branch,bud,characteristic,colour,corrugation,diameter,distal,exertion,form,fruit,giving,glabrousnes,growth,history,inflorescence,interjected,leaflet,length,life,lobing,midpoint,new,null,number,peduncle,per,prickle,primary,pseudostipule,ray,seed,shape,size,sympodial,terminal,texture,thicknes,type,unifoliate,variation,width,yellowish-grey
142	wfo-0001027368	success	145	161	107	38	54	0.738	-10,-15,-2,-20,-5,.5,0.3-2.5,0.5-3.5,0.5-5,1-15-flower,1-2,1-6,1.5-2,2,2-2.5,2-3,2-4,2-9,3-12.5,4-6,5-10,5-15,5-6,abaxially,acuminate,acute,adaxially,aggregate,apart,apex,base,blade,branched,calyx,cell,chartaceous,cm,color,connivent,cuneate,cylindrical,darker,decurrent,dendritically,densely,denser,diameter,directed,distally,ellipsiodal,elliptic,elliptic-ovate,entire,forked,glabrous,globose,hair,lanceolate,lenticular,lighter,lobe,long,long-stalked,margin,mm,moderately,narrowly,nearly,oblong,obtuse,occasionally,often,otherwise,ovoid-fusiform,pedicel,peduncle,petiole,pore,puberulent,pubescent,purple,radiu,ray,shrub,simple,small,sparsely,star,stigma,stone,style,subcoriaceous,subhastate,terminal,three,time,triangular,truncate,tube,unbranched,unknown,usually,vein,white,wide,x,yellow	0.8-2,1.5-2.5,3,4-many-foliat,8-13,abruptly,absen,adaxiall,also,articulated,axe,ba,contiguous,deltate,eaf,eed,except,gland,lower,midvein,narrowed,nflorescence,nther,orolla,pubescen,rachi,ruit,sometimes,spaced,stalked,stellate,subcapitat,tal,tem,tip,unit,vary,ympodial	absent,anther,appearance,arrangement,bark,border,branch,bud,characteristic,colour,corolla,corrugation,distal,drying,exertion,filament,form,fruit,fruiting,giving,glabrousnes,growth,height,history,inflorescence,interjected,lateral,leaf,leaflet,length,life,lobing,midpoint,new,null,number,ovary,per,plant,prickle,primary,pseudostipule,seed,shape,size,stem,subcapitate,surface,tall,texture,thicknes,type,variation,width
143	wfo-0001027369	exception_thrown	191	0	0	191	0	0.0		-1,-10,-11,-2,.1,.4,.5,.7,/4,0,0-1,0-15,0-3,0-5,0-6,0.05-0.15,0.1,0.1-0.2,0.1-0.3,0.2-0.5,0.25-0.4,0.3-1.5,0.5,0.5-0.8,0.5-1.5,0.6-0.8,1-,1-2,1-2.5,1-3,1-4,1.2-2.5,1.2-3,1.5-2,1/3,2-3,2-4,2-5,3,3-10,3-4,4-5,4-8,5,5-merous,7-15,abaxially,acut,almost,alyx,ame,anther,apar,apart,apex,apically,apparently,articulated,bark,base,berry,blade,branched,broad-deltate,c.,calyx,cm,color,concolorous,cordate,curved,deltate,densely,diameter,difoliate,distance,drying,eaf,eed,elongating,equal,erect,extending,eye,filament,filiform,flower,free,fruit,fruiting,geminat,glabrou,glabrous,glaucous,gra,green,hair,herbaceous,infructescence,know,known,lanceolate,lateral,leaf,length,less,lobe,lobed,lon,long,lower,margin,mature,mauve,membranous,midpoint,midvein,mm,moderately,multangulate,naked,narrowly,nflorescence,older,one,open,orbicular,orolla,oung,pale,pedicel,peduncle,pendulous,per,perfec,pericarp,perpendicular,petiole,poricidal,porrect,portion,prickl,prickle,prickly,ray,reflexed,reniform,rounded,ruit,scandent,scar,sessile,shrub,side,simple,slender,slightly,smooth,spaced,sparsely,spherical,spreading,stalk,stalked,stellate,stellate-pubescent,stem,straight,strongly,style,surface,tamen,tapering,terete,terminal,time,tip,trichome,tube,unarmed,unequal,unit,vary,venation,visible,way,wide,wider,winged,yellow,ympodial	
144	wfo-0001027378	success	149	172	101	48	71	0.678	.2,0.5â1,1.5â8,3â5,5-8,abaxially,acuminate,acute,adaxial,adaxially,anther,apex,axe,base,berry,blade,blue,broadly,calyx,chartaceous,clavate,cm,color,cordate,cylindrical,deeply,deltoid,densely,diameter,eaf,extra-axillary,filament,flattened,fleshy,flower,fruit,fruiting,glabrous,hair,hair-tipped,half,herbaceous,lanceolate,leaf,light,like,lobe,long,longer,lower,margin,markedly,minutely,mm,moderately,narrowly,obscure,often,ovate,ovoid,palmate,papillose,pedicel,peduncle,petiole,plurifoliat,pointed,primary,pubescent,rachi,revolute,rounded,sand-punctate,scattered,short,side,simple,slender,slightly,small,somewhat,spaced,sparsely,stem,stigma,style,terrestrial,tip,tooth,trichome,tube,unbranched,unit,unknown,vein,venation,vine,white,wide,widely,x	0.7â1,0.8â2.5,1.2â1.5,1.2â1.8,1.5â1.8,15â35,1â1.5,1â3,2.3â5,2.5â7,2â11,2â2.2,2â2.5,3â4.5,3â6,4â6,4â9,5-merous,5â10,5â13,5â7,6â10,6â7,alyx,apar,apicall,c.,capitat,ciliate,climbin,eed,glabrou,lon,m.,membranous,nflorescence,nternode,orolla,pentagonal,perfec,rotate-stellate,ruit,sand-punctat,tamen,tem,unknow,vary,ympodial	0.7-1,0.8-2.5,1-1.5,1-3,1.2-1.5,1.2-1.8,1.5-1.8,1.5-8,15-35,2-11,2-2.2,2-2.5,2.5-7,3-4.5,3-5,3-6,4-6,5-10,5-13,5-7,apart,appearance,arrangement,bark,border,branch,bud,capitate,characteristic,climbing,colour,corolla,corrugation,distal,drying,exertion,form,giving,glabrousnes,growth,height,history,inflorescence,interjected,internode,lateral,leaflet,length,life,lobing,midpoint,new,null,number,ovary,per,plant,prickle,pseudostipule,ray,seed,shape,size,surface,sympodial,terminal,texture,thicknes,type,variation,width
145	wfo-0001027378	success	141	156	106	35	50	0.752	.2,0.7-1,0.8-2.5,1-1.5,1-3,1.2-1.5,1.5-1.8,1.5-8,15-35,2-11,2-2.2,2-4,2.3-5,2.5-7,3-4.5,3-5,3-6,4-6,5-13,5-8,6-7,abaxially,acuminate,acute,adaxially,anther,apart,apex,apparently,articulated,axe,basally,base,blade,blue,broadly,calyx,chartaceous,clavate,climbing,cm,connivent,cordate,cylindrical,deeply,deltoid,diameter,extra-axillary,filament,fleshy,flower,fruit,fruiting,glabrous,hair,hair-tipped,herb,lanceolate,leaf,light,lobe,long,longer,margin,minutely,mm,moderately,multicellular,narrowly,node,oblong,obscure,often,ovate,pedicel,peduncle,petiole,plurifoliate,pubescent,rachi,revolute,rooting,rounded,simple,slender,slightly,small,somewhat,spaced,sparsely,stigma,style,terrestrial,tip,tooth,trailing,tube,unbranched,unit,unknown,vein,weakly,white,wide,widely,x	4-9,5-merou,6-10,ag,alyx,apicall,ba,capitat,ciliate,densely,directed,distally,eaf,eed,equal,geminat,large,longitudinal,lower,nflorescence,opening,orolla,perfect,pore,pubescen,rotate-pentagonal,scattered,short,slit,tamen,tem,unknow,vary,yellow,ympodial	appearance,arrangement,bark,border,branch,bud,capitate,characteristic,colour,corolla,corrugation,distal,drying,exertion,form,geminate,giving,glabrousnes,growth,height,history,inflorescence,interjected,lateral,leaflet,length,life,lobing,midpoint,new,number,ovary,per,plant,prickle,primary,pseudostipule,ray,seed,shape,size,stem,surface,sympodial,terminal,texture,thicknes,type,variation,width
146	wfo-0001027384	exception_thrown	155	0	0	155	0	0.0		.25,.5,.75,/3,0.4-1.1,0.5-1,0.9-1,1-1.3,1-1.5,1-3,1-4,1.5-2,2.5-6.5,3-3.5,3-4,3/4,4-7,5-15-flowered,5-5.5,7-14,7.5-8,abov,acute,anothe,anther,anthesi,apart,apex,ba,bark,base,beginning,beneath,berry,breaking,broadly,brown,bud,calyx,capitate,clavate,closely,cm,corolla,cuneate,deep,dia,difoliate,distal,drying,eaf,edicel,eed,ellipsoid,equal,erect,filament,flattened-reniform,free,fruiting,geminate,glabrous,globose,green,hard,herbarium,incrassate,inflorescenc,later,lateral,leaf,lobe,lobed,long,long-exserted,lower,main,margin,member,middle,minutely,mm,mustard,narrowly,nflorescence,obovate,occasionally,older,opposite,ovary,overlapping,pair,pale,paler,papillo,papillose,pedicel,peeling,petiole,pitted,planar,pore,poricidal,portion,prominent,pseudo-terminal,rarely,reddish-purple,rounded,ruit,scar,section,shaped,shining,shrub,simple,siz,slender,small,spaced,specimen,stem,stigma,straight,style,subcoriaceous-fleshy,sulcate,surface,tall,tapering,tear-drop,thick,tip,transverse,tree,triangular,trichome,tub,tube,tuft,ud,uniseriate,unit,vein,way,white,widely,widest,without,woody,x,yellow,yellowish,ympodial,young	
147	wfo-0001027389	exception_thrown	154	0	0	154	0	0.0		.1,.25,.5,0.25-0.3,0.25-0.5,0.5-0.75,0.5-1.5,0.6-1,1,1-1.5,1-2,1.8-1.9,11-14,2-2.5,3-3.5,3-4.5,4-5-flowered,5-7,7-8,acuminate,acute,along,anther,anthesi,apart,apex,ba,bark,base,beneath,berry,broadening,broadly,brown,bud,calyx,cm,conical,corolla,dark,decurrent,deflexed,deltoid,dia,dry,eaf,edicel,eed,ellipsoid,elliptic,erect,evenly,except,expanded,exserted,filament,filiform,foetid,foliage,free,fruiting,geminate,glabrous,globose,green,hispidulous,inflorescence,lateral,leaf,like,lobe,lobed,lon,long,lower,main,making,margin,material,middle,minutely,mm,nearly,nflorescence,node,non-reproductive,obovoi,occasionally,often,older,one,opposite,ovary,ovate,ovoid-reniform,pair,paler,papillo,papillose,pedicel,petiole,pitted,pore,poricidal,portion,prominent,prominently,proximal,puberulent,raise,raised,reddish-golden,reflexed,rest,ruit,scar,shaped,shin,shrub,side,simple,slender,slight,slightly,soon,spaced,sparsely,stem,stigma,straight,style,surface,tall,tapering,tear-drop,thread-like,tip,top,trichome,truncate,tube,ud,unifoliat,uniseriate,unit,vein,white,widest,winged,woody,x,yellowish,ympodial,young	
148	wfo-0001027395	success	153	168	124	29	44	0.81	.25,.5,0.25-0.5,0.6-1.1,1-1.5,1-2,1-5,1.1-1.5,1.5-1.9,1.6-2.9,10-20-flowered,12.5-17.3,2-3,2.2-7,3.5-4,5-6.5,8,acute,anther,anthesi,apex,apically,apiculate,attenuate,bark,base,becoming,beneath,berry,black,calyx,capitate,cm,conical,constricted,corolla,decurrent,deflexed,deltoid,densely,depressed,dia,difoliate,drying,enlarging,exfoliating,exserted,filament,fleshy,free,fruit,fruiting,glabrous,globose,green,immature,known,large,lateral,leaf,lobe,lobed,long,main,major,margin,midrib,minor,minutely,mm,narrowly,nearly,obovate,occasionally,older,once-furcate,opposite,ovary,ovoid,papillose,partially,pedicel,petiole,piece,planar,pointed,pore,poricidal,portion,primary,pubescent,raised,restricted,robust,rusty-papillate,secondary,shaped,shining,shiny,shrub,simple,size,small,somewhat,stem,stigma,straight,style,tall,tear-drop,thickened,tip,transverse,trichome,tube,uniseriate,unit,vein,white,within,without,woody,x,young	0.75-1,1.5-2.5,11-15,4-6,beginning,caly,closely,cucullate,differing,eaf,edicel,eed,erect,geminat,imperceptibly,inflorescenc,lon,lower,nflorescence,overlapping,pair,papillo,ruit,scar,spaced,tapering,thick,ud,ympodial	appearance,arrangement,border,branch,bud,characteristic,colour,corrugation,diameter,distal,exertion,form,geminate,giving,glabrousnes,growth,height,history,inflorescence,interjected,leaflet,length,life,lobing,mentioned,midpoint,new,number,peduncle,per,plant,prickle,pseudostipule,ray,seed,shape,surface,sympodial,terminal,texture,thicknes,type,variation,width
149	wfo-0001027396	success	244	254	215	29	39	0.881	-2,-5,-6,/3,0-100,0-3,0-30,0-4,0.1-0.5,0.1-1,0.4-0.7,0.5-1,0.5-1.5,0.5-2,0.5-2.5,0.7-2.5,0.8,0.8-1.3,1,1-4,1.2-2,1.5-3,1.5-3.5,1.8-3,1/2-2/3,1/3,1/4-1/3,1/6,10-15,10-25,10-30,10-35,15-40,2-3,2-3.5,2-7,2.5-4,2.8-4.5,3-,3-9,3.5-6,4,4-5,4-6,4-7,5-10,5-20,5-30,5-50,5-8,5-merous,5.5-7.5,6-20,6.5-7.5,7-15,8-20,abaxial,abaxially,acute,almost,ame,andromonoecious,anther,apart,apex,apically,apparently,articulated,attenuate,bark,base,berry,black,blade,broad,broad-deltate,brown,bulbous,c.,calyx,chartaceous,cm,concolorous,connivent,cream,cuneate,curved,dark,decurrent,densely,diameter,difoliate,discolorous,distal,distance,drying,elliptic,elongate,elongating,equal,erect,extending,filament,flattened,flattened-reniform,flower,free,fruit,fruiting,fully,glabrescent,glabrous,glandular,gray-brow,green,hair,herb,hermaphrodite,heterostylous,infructescence,lateral,leaf,length,less,lignified,lobe,lobed,lobing,long,long-styled,longer,lowermost,margin,marking,mature,maturity,mauve,midpoint,midvein,mm,moderately,near,obtuse,often,older,one,open,opening,orange,pair,pale,pedicel,peduncle,pendulous,per,pericarp,perpendicular,petiole,plant,poricidal,porrect,portion,prickle,prickly,primary,pubescent,purple,ray,red-brown,reflexed,rotate,sessile,short-styled,shrub,side,simple,smooth,sometimes,somewhat,spaced,sparsely,spherical,spreading,stalk,stalked,stellate-pubescent,stem,stout,straight,style,surface,tapering,tearing,terete,tertiary,time,tip,trichome,tube,unbranched,unit,upper,usually,variously,vein,venation,visible,way,white,wide,woody,yellow,yellow-green,yellowish,young	0-5,12-25,20-100,7-10,adaxial,alyx,apar,ba,deltate,eaf,eed,extensive,fewer,geminat,lon,long-acuminat,lower,nflorescence,orolla,oung,prickl,ruit,scar,secondary,staminat,tamen,unarmed,vary,ympodial	appearance,arrangement,border,branch,bud,characteristic,colour,corolla,corrugation,exertion,form,geminate,giving,glabrousnes,gray-brown,growth,height,history,inflorescence,interjected,leaflet,life,new,null,number,ovary,pseudostipule,seed,shape,size,staminate,stigma,sympodial,terminal,texture,thicknes,type,variation,width
150	wfo-0001027449	exception_thrown	160	0	0	160	0	0.0		.4,.5,.75,/3,0.5-1,0.5-1.5,0.8-1.5,0.9-1.1,1.2-1.5,1.4-1.5,1.5-2.5,10-15-flowered,2-3,2-4,3,3-3.5,3-7,4-6,5-6,8-15,acuminate,acute,anther,anthesi,apex,appearing,area,arising,around,axil,bark,base,becoming,beginning,beneath,berry,brown,bud,calyx,closely,cm,corolla,cup,dark,deciduous,deflexed,dense,densely,density,dia,differing,difoliate,dry,eaf,edicel,eed,ellipsoid,elliptic,erect,exserted,extreme,filament,forming,free,frui,fruit,fruiting,geminat,glabrate,glabrous,globose,green,inflorescenc,inflorescence,lamina,later,lateral,leaf,like,lobe,lobed,lon,long,long-acuminate,long-triangular,lower,main,major,material,minor,minutely,mm,narrowly,nflorescence,obconic,oblique,often,older,one,opposite,orangish,ovary,overlapping,ovoid-reniform,packed,pair,pale,papillose,pedicel,persistent,petiole,pitted,pointed,pore,poricidal,portion,prominent,pubescent,raised,red-papillose,reddish-brow,reflexed,rest,ruit,scar,shaped,shrub,simple,size,slender,small,soon,sparse,sparsely,stem,stigma,straight,styl,style,surface,tall,tapering,tear-drop,tip,tree,trichome,trunk,tube,tuft,ud,uniseriate,unit,varying,vein,way,white,woody,x,ympodial,young	
151	wfo-0001027452	success	152	166	117	35	49	0.77	.5,0.5-1,0.5-1.5,0.5-2,0.5-2.5,1,1-2,1-3,1-4.5,1-5,1.5,1.5-3,10-20,2-6,3-6,3-9,4,4-6,5-12,5-20,abaxially,absent,acute,adaxially,along,anther,apex,axe,base,berry,beyond,blade,branched,brown,calyx,cell,celled,center,ciliate,cm,connected,cordate,decurrent,densely,denser,diameter,dm,drying,elliptic,elliptic-ovoid,entire,equal,exserted,filament,flat,flower,fruit,glabrous,globose,hair,herb,immature,large,linear-lanceolate,lobe,long,lying,margin,maturing,mm,moderately,nearly,new,notched,oblong,obtuse,often,one-,outer,parallel,pedicel,peduncle,per,perpendicular,petiole,placenta,pubescent,rachi,raised,ridge,rounded,running,seed,semitransparent,short,significantly,single,slightly,smaller,smoother,sometimes,sparsely,stamen,stigma,straight,style,swollen,triangular,tube,two-celled,unbranched,vein,wall,white,woody,x,yellow	2-4,2-foliate,abundant,adaxiall,chartaceous,dehiscing,eaf,eed,emarginat,explosively,frui,geminat,growt,held,interpetalar,lower,maturit,membranaceous,mesocarp,nfloresence,orolla,pressure,pubescen,rotate,ruit,tal,tamen,tem,tissue,unit,usually,vary,watery,wid,ympodial	appearance,arrangement,bark,border,branch,bud,characteristic,colour,corolla,corrugation,distal,emarginate,exertion,form,fruiting,giving,glabrousnes,growth,height,history,inflorescence,interjected,lateral,leaf,leaflet,length,life,lobing,mentioned,midpoint,number,ovary,plant,prickle,primary,pseudostipule,ray,shape,size,stem,surface,tall,terminal,texture,thicknes,type,variation,wide,width
152	wfo-0001027471	success	165	183	143	22	40	0.867	.5,/4,0.1-0.2,0.2-0.4,0.2-0.5,0.4-1,0.5,0.5-0.6,0.5-0.7,0.5-1.5,0.7-0.9,0.9-1,1-1.2,1-1.5,1-1.6,1.4-3,1.5-2,2-2.5,2-3,2-lobed,3-4,3-7,4-5,6-7,abaxially,acute,adaxially,age,along,anther,anthesi,apex,appressed,ascending,bark,base,berry,bifid,branched,calyx,closely,cm,conical,corolla,deltate,dendritic,densely,diameter,differing,difoliate,distant,drying,elliptic,entire,erect,especially,filament,flattened,flower,free,fruiting,furcate-dendritic,geminate,glabrous,globose,growth,herb,included,inflorescence,internodal,lamina,leaf,leaf-opposed,lengthening,less,like,lobe,lobed,long-triangular,major,margin,maturity,midvein,minor,minutely,mixture,mm,new,nodding,node,occasionally,open-conical,orbicular,ovary,ovate,pair,pale,pedicel,peduncle,petal,petiole,pitted,planar,pore,poridical,portion,primary,pubescent,red-orange,reflexed,reniform,scattered,shape,shrub,similar,simple,size,slender,slightly,slit,small,somewhat,sparsely,stem,stigma,straight,style,subshrub,surface,tan,thickened,tip,trichome,tube,uniseriate,unit,usually,vein,way,white,woody,x,yellowish	brittle,c.,desnsely,eaf,eed,erec,lower,nflorescence,overlapping,papillat,perfect,pericarp,plane,pubscent,rachi,ruit,scar,spaced,thin,trifoliat,ud,ympodial	appearance,arrangement,border,branch,bud,characteristic,colour,corrugation,distal,exertion,form,fruit,giving,glabrousnes,height,history,interjected,lateral,leaflet,length,life,lobing,midpoint,null,number,papillate,per,plant,prickle,pseudostipule,ray,seed,sympodial,terminal,texture,thicknes,trifoliate,type,variation,width
153	wfo-0001027473	success	138	152	107	31	45	0.775	.25,/2,0.25-0.5,0.5-1,0.8-1,1-1.5,1-2,1.3-2,1.5-2,1.8-2,1/3,2-2.5,2.5-3,3.5-5,4.5-13,5,6-9,8.5-37,?,abaxially,acute,anther,anthesi,apex,apparently,bark,base,berry,brown,calyx,clavate,cm,conical,corolla,deccurent,decurrent,deep,dendritic,densely,dia,drying,empty,erect,filament,flattened-reniform,fruiting,giving,glabrous,globose,green,incrassate,later,lateral,leaf,like,lobe,lobed,long,long-triangular,lower,main,margin,middle,minute,minutely,mm,near,obovate,occasionally,ovary,pair,pale,pedicel,petiole,pitted,planar,pointed,pubescent,rootstock,rusty,sac,sessile,shape,shrub,somewhat,sparsely,stem,sterile,stigma,strongly,style,subshrub,surface,tall,thick,trichome,tube,vein,way,white,wide,widest,wing,winged,woody,yellowish,young	absen,adaxially,along,ape,deflexed,denser,di-,differing,eaf,eed,free,geminat,less,major,minor,older,overall,papillo,pore,poricidal,portion,pubesent,ruit,shaped,tear-drop,tip,trifoliate,unit,usually,yellowish-brow,ympodial	absent,appearance,arrangement,border,branch,bud,characteristic,colour,corrugation,diameter,distal,exertion,form,fruit,glabrousnes,growth,height,history,inflorescence,interjected,leaflet,length,life,lobing,mentioned,midpoint,new,number,papillose,peduncle,per,plant,prickle,primary,pseudostipule,ray,seed,size,terminal,texture,thicknes,type,variation,width,yellowish-brown
154	wfo-0001027483	success	164	184	132	32	52	0.805	0.2-1.9,0.6,1,1-2.5,1-4,1-5,1.2-2.5,1.5-10,1.5-2.6,1.5-3,2,2-3,2-4,2-4.5,3-15,3-6,3.5-20,4.5-8,5-10,5-6,abaxially,acumen,acute,adaxially,apex,apical,apically,articulate,basal,base,branched,calyx,cell,cm,coarsely,connate,corolla,covering,cuneate,cyme,dehiscent,diameter,dichasial,dichasially,digestion,distal,dorsally,dot,ebracteate,edge,elliptical,emoval,enzyme,exceeding,filament,finely,flat,flower,folded,forked,generally,globose,green,green-white,hair-like,half,herbaceous,honeycomb,interjected,interpetiolar,introrse,lateral,leaf,leaflet,light,lighter,lobe,long,make,maturing,medium,minute,mm,monochasial,mucilaginous,obtuse,odd-pinnate,often,ovate,ovoid,pattern,pedicel,peduncle,perennial,perfect,petiole,plant,poricidally,proximal,pubescent,purple,ray,reveal,rosette,rounded,seed,short,size,slit,smooth,sometimes,stamen,stigma,straight,style,tall,terminal,testal,thick,throughout,tuber-bearing,typically,uniform,unit,varying,violet,violet-purple,wall,white,wide,yellow,Â¼	0-1.,1-2,3-6-foliat,decurrent,diminishing,eaf,eed,erec,globo,gradually,living,lon,lower,lunat,nflorescence,nther,orolla,pair,petiolule,plan,rachi,rotate,ruit,sessile,seudostipule,specimen,subsessile,tem,tissu,toward,vary,ympodial	0-10,3-6-foliate,anther,appearance,arrangement,ba,bark,border,branch,bud,characteristic,colour,corrugation,description,drying,erect,exertion,form,fruit,fruiting,giving,glabrousnes,growth,height,history,inflorescence,length,life,lobing,lunate,margin,mentioned,midpoint,new,number,ovary,per,prickle,primary,pseudostipule,shape,stem,surface,sympodial,texture,thicknes,tissue,tube,type,variation,vein,width
155	wfo-0001027506	success	215	211	176	39	35	0.819	-0.35,-1,-20,-7,-7.5,.2,.5,/2,/6,0,0-10,0-6,0-60,0.1-,0.1-0.3,0.2,0.2-0.3,0.25,0.5-1.5,0.5-6,0.7-1.3,0.8-1.5,1-2,1-3,1.2-1.5,1.5-2.2,1.8,1/3,10-40,2-3.2,2.2-3.5,2.5-5,2.5-8,3-10,3-5,3-6,3.5-5,5-10,5-7,6-13,6.5-10,7-8,8-10,9-13,acuminate,acute,ame,anther,apart,apex,apically,apparently,bark,base,becoming,berry,blade,branched,brow,brown,c.,calyx,cell,cm,concolorous,connivent,cordate,cream,cuneate,curved,dark,densely,diameter,distal,dry,drying,elongating,entire,equal,erect,filament,fine,flattened,flattened-reniform,flower,free,fruit,fruiting,glabrescent,glabrous,green,hard,infructescence,lateral,leaf,length,lobe,lobed,long,long-styled,longer,lower,margin,marking,mature,maturity,mauve,midpoint,mm,moderately,multangulate,narrow-deltate,occasionally,older,one,open,orange,orange-brown,outline,ovate,pair,pale,pedicel,peduncle,pendulous,per,petiole,pit,plant,poricidal,porrect,portion,prickle,prickly,primary,purple,raised,ray,reddish,reflexed,shrub,simple,small,smooth,sometimes,spaced,spherical,spreading,stalk,stalked,stellate-pubescent,stem,stout,style,subentire,surface,tapering,terete,terminal,time,tip,tree,trichome,truncate,tube,twice,unarmed,upper,variously,vein,way,wide,woody,yellow,yellow-green,young	-3,0-2,1-4,1/6-1/4,5-merous,7-9,abaxially,acuminat,alyx,andromonoecious,apar,articulated,chartaceous,eaf,eed,hermaphrodite,heterostylous,lengt,lowermost,nflorescence,orolla,oung,pericarp,plurifoliat,prickl,reduced,ruit,scar,sessile,short-styled,staminat,stellate,tamen,tertiary,unit,vary,venation,visible,ympodial	appearance,arrangement,border,branch,bud,characteristic,colour,corolla,corrugation,exertion,form,giving,glabrousnes,growth,height,history,inflorescence,interjected,leaflet,life,lobing,mentioned,new,number,ovary,pseudostipule,seed,shape,size,stigma,texture,thicknes,type,variation,width
156	wfo-0001027548	exception_thrown	216	0	0	216	0	0.0		-11.5,.3,0.2,0.3-1.2,0.5,0.5-2,1,1-1.5,1-10,1-2.5,1-3.5,1.2,1.5,1.5-2,1.5-2.5,10-12,10-50,3-7,4-6,4-8,4.5,5-merou,6-9,7-10,8-9,abaxiall,acuminate,acute,adaxially,ag,almost,along,also,although,alyx,anther,anthesi,apart,apex,apical,apparently,appearing,area,ark,articulated,articulation,attenuate,axi,basal,base,beneath,bent,berry,black,branch,branched,branching,brown,bu,c.,calyx,capitate,cell,cm,conical,connivent,corolla,dark,darker,deflexe,deltate,dendritic,densely,denser,depressed-elliptic,diameter,drying,dull,eaf,early,eed,ellipsoid,elliptic,elongate,em,entire,exserted,extending,filament,flattened-reniform,flexuous,flower,free,fruiting,geminat,glabrescen,glabrous,glandular,globose,green,growth,half,herbarium,ilament,immature,inflorescence,irregularly,lamina,leaf,leaving,lengthening,less,like,lilac,lobe,lobed,lon,long,long-styled,loose,loosely,lower,many,margin,matte,membranous,minute,minutely,mixed,mm,narrowly,near,new,nflorescence,occasionally,older,orolla,outline,pair,pale,papillae,papillate,papillo,pedicel,peduncle,per,perfect,pericarp,petiole,pitted,planar,plurifoliate,point,pore,poricidal,portion,primary,prominent,puberulent,pubescent,rachi,rectangular,reddish,revolute,ripe,ruit,scar,scattered,simple,size,slender,slit,small,sometimes,somewhat,spaced,sparse,sparsely,specimen,spreading,stellate,stem,stigma,strongly,style,surface,swollen,tapering,terminal,testal,thickened,thin,time,tinged,tiny,tip,transparent,trichome,tube,twinin,type,ud,uniseriate,unit,upper,usually,vary,vein,vine,warty,way,white,woody,x,yellow,ympodial	
157	wfo-0001027581	success	200	193	148	52	45	0.74	0.2â0.3,0.3,0.3â1,0.5â1,0.5â1.5,1,1.2â1.5,1.3â1.5,1.5,1.5â2,1.5â3,100+,10â16,12,12â30,15â20,1â1.5,1â3-rayed,2.5â3,200,3.5â4.5,3â3.5,4.5â16,4â8,6â7,7â10,7â9,8,8â10,9â11,9â9.5,>,acute,along,anther,anthesi,apex,axe,base,beneath,berry,branched,branching,broadly,brown,bulbous,c.,calyx,clavate,clearly,cm,connivent,corolla,cup-shaped,dark,deltate,densely,diameter,discolorous,drying,echinoid,ellipsoidal,elliptic,entire,evenly,exserted,filament,flattened-reniform,flower,fruiting,glabrescent,glabrous,globose,golden,gradually,green,greyish,growth,inflorescence,lamina,largest,leaf,length,like,lobe,lobed,long,loosely,lower,many,margin,minute,minutely,mixed,mm,moderately,multangulate,multiseriate,narrowing,new,nodding,pair,part,pedicel,peduncle,per,petiole,pitted,plane,plurifoliate,porrect-stellate,primary,pubescent,purple,ray,reddish,ripe,scarcely,sessile,shrub,simple,size,small,smaller,sparsely,stalk,stellate,stem,stigma,stout,style,surface,tall,terminal,time,tree,trichome,tube,undersurface,upper,vein,visible,way,weak,wide,woody,yellow,yellowish	10,5-merou,abaxial,abaxially,adaxial,ag,alyx,apar,ark,articulated,brow,closely,dichasia,distally,eaf,eed,erec,free,ilament,lengthening,less,longest,midvei,near,nflorescence,older,orolla,papillo,perfect,pericarp,pore,poricidal,portion,reflexed,rhachi,ruit,scar,shiny,short-stalked,slit,spaced,spreading,tem,thin,tip,ud,unevenly,unit,vary,varying,whit,ympodial	--,1-1.5,1.5-2,2,3-3.5,4-8,appearance,arrangement,bark,border,branch,bud,characteristic,colour,corrugation,dichasial,distal,exertion,form,fruit,giving,glabrousnes,height,history,interjected,lateral,leaflet,life,lobing,midpoint,null,number,ovary,papillose,plant,prickle,pseudostipule,seed,shape,texture,thicknes,type,variation,white,width
158	wfo-0001027584	success	144	149	105	39	44	0.729	-16,-2,..,.5,0.5-1.5,0.9-1,0.9-2.5,1-1.2,1.2-1.4,1.5-2,1.6-1.9,10-15,11.5-45,2,2-10,2.5-3,3,3-.,4-6,4-7,4.5-20,7-10,abruptly,absent,acuminate,anther,anthesi,apex,attenuate,bark,base,becoming,beneath,branch,branched,broadly,calyx,cell,cm,conical,corolla,darker,deltate,diameter,ellipsoid,elliptic,filament,flattened,four,fruit,fruiting,glabrous,green,herb,irregular,lamina,lobe,lobed,long,margin,minutely,mm,nearly,outer,outline,ovary,ovate,pair,pale,papillate,pedicel,peduncle,per,petiole,pointed,present,primary,reddish,regularly,reniform,scattered,shrub,single-stemmed,sinuate,small,sparse,sparsely,stem,stigma,striate,stripe,style,suffruticose,surface,tan,thickening,time,trichome,tube,uniseriate,vein,wall,white,without,x	0.5-1,1.5-8,100,8-9,apical,beginning,brittle,brow,c.,capitat,cucullate,deflexe,densely,dry,eaf,edicel,eed,erec,flower,lower,markedly,narrowly,nflorescence,open,pericarp,planar,plurifoliat,ruit,scar,single,smooth,testal,thin,tip,triangular,tuft,ud,unit,ympdoial	3-5,appearance,arrangement,border,brown,bud,capitate,characteristic,colour,corrugation,distal,drying,exertion,form,giving,glabrousnes,growth,height,history,inflorescence,interjected,lateral,leaf,leaflet,length,life,lobing,mentioned,midpoint,new,number,plant,prickle,pseudostipule,ray,seed,shape,size,terminal,texture,thicknes,type,variation,width
159	wfo-0001027600	exception_thrown	185	0	0	185	0	0.0		-10,-3,0.5-1,0.5-1.5,1,1-14,1-2,1-4,1-5,1.5-2,1.5-2.5,1/2-3/4,10-,10-20,15-25,2-11,2-18,2-3,2-3.5,2-4,2-4.5,2-5,2-6,2.5-21,2.5-6,20-30,3-15,3-5,3-5-lobed,3-6,4-6,4-foliat,5-13,8-17,abaxially,abruptly,absen,absent,acuminate,acute,adaxial,adaxially,adpressed,aggregate,along,apart,ape,apex,apical,apiculate,articulated,axe,basal,base,beyond,blade,brow,calyx,campanulate,cell,channe,cm,collection,concave,connective,cordate,coriaceous,cream,cuneate,deltate,densely,diameter,dilated,directed,distally,divided,eaf,eed,ellipsoidal,elliptic,entire,especially,exceeding,except,exserted,fading,flattened,fleshy,flower,forked,fruit,glabrescent,glabrous,gland,glandular-puberulent,greenish-white,laterally,leaf,leaving,lobe,lobed,lon,long,lower,main,margin,mature,midrib,minutely,mm,moderately,narrowed,nflorescence,nther,obconical,oblong,obtuse,occasionally,older,orange,orolla,ovate,ovoid,papillose,pedicel,pedicellar,peduncle,perfect,petiole,pilo,pilose,pinnately,pore,puberulen,puberulence,puberulent,pubescent,purple,purplish,rachi,radiu,rarely,remnant,rounded,ruit,shorter,simple,sinus,slightly,small,somewhat,spaced,sparsely,stamen,stigma,stone,strongly,style,subcoriaceous,surface,tal,tem,thecae,time,tip,tomento,tree,triangular,truncate,tube,two,ud,unbranched,unit,unlobed,vary,vein,white,wide,x,yellow,yellow-green,yellowish,ympodial,young	
160	wfo-0001027607	success	167	192	148	19	44	0.886	.1,.25,.5,0.25-0.5,0.5,0.5-1,0.8-1,1,1-4,1.2-1.5,1.5-3,2-2.5,2-3,2-4,2.5-3,3-3.5,3/4,4-10-flowered,5-10,5-7,8-9,acuminate,acute,age,anther,anthesi,apex,arching,area,aspect,bark,basal,base,becoming,berry,branch,branche,brown,calyx,cm,corky,corolla,curling,dark,decurrent,deltoid,densely,dia,dry,ellipsoid,elliptic,elongate,erect,evenly,except,exserted,f,filament,filiform,flattened,free,fruiting,geminate,gently,giving,glabrate,glabrous,globose,golden,green,lateral,leaf,lenticellat,less,like,lobe,lobed,long,lower,main,material,midrib,minute,minutely,mm,narrow,narrowly,non-reproductive,obovoid,occasionally,older,opposite,ovary,ovoid-reniform,pagoda-like,pair,papillose,pedicel,petiole,pitted,plant,pore,poricidal,portion,present,prominent,pubescent,raised,rarely,reddish-brown,reflexed,scar,shaped,short,shrub,simple,slender,slight,small,soon,spaced,stem,stigma,strongly,style,surface,tall,tan,tapering,tear-drop,tip,treelet,trichome,tube,unifoliate,uniseriate,unit,vein,way,white,widened,widening,winged,x,yellowish,ympodial,young,zig-zag	apar,ba,deflexed,eaf,edicel,eed,lamina,lon,m.,middle,nflorescence,ruit,slightly,straight,styl,tub,ud,widest,woody	apart,appearance,arrangement,border,bud,characteristic,colour,corrugation,diameter,distal,drying,exertion,form,fruit,glabrousnes,growth,height,history,inflorescence,interjected,leaflet,length,life,lobing,margin,midpoint,new,null,number,peduncle,per,prickle,primary,pseudostipule,ray,seed,shape,size,terminal,texture,thicknes,type,variation,width
161	wfo-0001027618	success	202	203	153	49	50	0.757	-10,-pubescent,0-10,0.5-1,1,1-,1-1.5,1-13,1-14,1-23,1-3,1-5,1-9,1.4-4,1.5-3,1.5-7,11-22,15-35,2-11,2-11.5,2-27,2-5,2-8.5,2-9,2.5-6,3-18,3-30,3-5,3-7,3.5-6,4,4-8,5-30,5-7.5,6-25,6-40,8-16,8-35,abaxially,acute,adaxially,aggregate,also,apart,apex,articulated,axe,base,blade,branched,bud,capitate,cell,chartaceous,cm,compound,connective,cordate,cuneate,cylindrical,darker,deltate,densely,dia,diameter,dilated,directed,distally,ellipsoidal,elliptic,elliptic-ovate,entire,exceeding,fleshy,flower,fruit,fusiform,glabrous,globose,greenish,lateral,laterally,leaf,leaflet,leaving,length,less,lobe,long,longitudinal,margin,membranaceous,mesocarp,minutely,mm,moderately,near,oblong,obovate,obtuse,often,orange,ovate,papillose,pedicel,pedicellar,peduncle,per,perfect,petiole,petiolule,pilose,pinnately,pore,puberulent,puberulent-pubescent,pubescent,pubescent-pilose,purple,rachi,radiu,ratio,remnant,reticulate,ripe,shorter,shrub,simple,slightly,small,sometimes,spaced,sparsely,stigma,stone,stripe,style,sympodial,terminal,thecae,tomentose,tree,triangular,truncate,tube,unbranched,unit,white,wide,width,without,x,yellow	0.5,0.5-6,1.5-13,1.5-8.5,11-16,11-pinnate,12-27,15-30,2-12,3-7-pinnate,5-18,5-20,5-merous,5.5-12,7-25,acuminat,acut,alyx,ape,ascending,basal,beyond,campanulate,diamete,eaf,eed,exserted,lon,lower,nflorescence,nther,obtu,orolla,perfec,pilo,presen,puberulent-pilo,ranch,rown,ruit,runk,shallowly,somewhat,spreading,stamen,tal,uni,urceolate,vary	acuminate,anther,appearance,arrangement,bark,border,branch,calyx,characteristic,colour,corolla,corrugation,distal,drying,exertion,filament,form,fruiting,giving,glabrousnes,growth,height,history,inflorescence,interjected,life,lobing,midpoint,new,null,number,ovary,plant,present,prickle,primary,pseudostipule,puberulent-pilose,ray,seed,shape,size,stem,surface,tall,texture,thicknes,type,variation,vein
162	wfo-0001027622	success	203	186	141	62	45	0.695	.5,0-14,0-16,0.3-10,1,1-10,1-2,1.5-3.5,1.5-4.2,1.6-4.5,12-23,2-25,2-6,2.5-3.5,3-4,3-4.5,3.5-11,4-5,4-9.5,5-11,6-17,6-7,8-16,8-20,abaxially,acumen,acuminate,acute,adaxially,anther,apart,apex,apparently,articulated,axe,axillary,base,berry,blade,blue,blue-purple,borne,broadly,brownish,bud,cell,ciliate,clavate,cm,condition,connivent,corolla,covering,diameter,distal,drying,elliptical,end,erect,especially,exceeding,filament,flower,forked,fresh,fruit,generally,glabrescent,glabrous,globose,green,greenish,hair,hair-like,half,herb,interjected,lanceolate,lateral,leaflet,light,like,lobe,long,make,margin,middle,mm,mottled,mucilaginous,narrowly,oblique,odd-pinnate,ovate,ovate-lanceolate,ovoid,pale,pedicel,peduncle,perfect,petal,petiole,plant,plurifoliate,pubescent,purple,rounded,seed,shortly,singly,size,slightly,spaced,stamen,star,stem,stigma,straight,striped,style,subglabrous,subtending,tall,terminal,testal,thick,tip,tri-,truncate,tube,tuber,typically,unwinged,usually,wall,wet,whitish,wide,wing,x,yellow	1/,2-3,3-16,5-merou,ag,along,alyx,capitat,chartaceous,decumben,different,digestion,dorsally,eaf,edge,eed,elliptic,enzyme,except,flat,folded,geminat,glabrou,greatly,green-white,homostylous,honeycomb-shaped,lengthening,living,lower,membranous,midrib,minutely,nflorescence,often,orolla,pair,pentagonal,petiolule,population,pore,poricidal,proximal,puberulent,reduced,removed,ruit,seudostipule,slit,sometimes,specimen,ste,stellate,stolo,subequal,tamen,tem,throughout,unit,vary,varying,ympodial	1/3,appearance,arrangement,bark,border,branch,calyx,capitate,characteristic,colour,corrugation,decumbent,exertion,form,fruiting,geminate,giving,glabrousnes,growth,height,history,inflorescence,leaf,length,life,lobing,mentioned,midpoint,new,number,ovary,per,prickle,primary,pseudostipule,ray,shape,stolon,surface,texture,thicknes,type,variation,vein,width
163	wfo-0001027624	success	189	179	134	55	45	0.709	0-3,0-7,0.1-0.9,0.3-1,0.4-3,0.5-1.5,0.8-5.6,1-2,1-3,1.1-8.4,1.2-2.6,1.3-2.9,1.5-6.6,2-20,2-7,2.4-4.8,2.9-12,3-10,3-11,3-4,3-5,4-15.2,4-7,4-8,5-9,6-18.5,9-41,abaxially,acumen,acuminate,acute,adaxially,along,anther,apart,apex,apparently,arranged,articulated,axe,axillary,base,bead,berry,blade,brownish,bud,cell,clavate,cm,condition,connivent,corolla,covering,cuneate,decurrent,deep,densely,diameter,distal,drying,elliptic,entirely,erect,exceeding,filament,flower,forked,fresh,fruit,glabrous,globose,green,greenish,hair,half,herb,interjected,lanceolate,lateral,leaf,leaflet,light,like,lobe,long,make,mm,moniliform,mottled,mucilaginous,multiple,necklace,odd-pinnate,onto,orbicular,ovate,ovoid,pedicel,peduncle,perfect,petiole,plant,present,pubescent,purple,rachi,seed,sessile,short,size,slightly,sometimes,stamen,stigma,stolon,straight,style,subtending,terminal,testal,thick,tube,tuber,typically,unwinged,usually,wall,wet,white,whitish,wide,widely,x	1-5,2-5,5-merou,acuman,ag,alyx,capitat,considerably,decreasing,decumben,digestion,dorsally,eaf,edge,eed,enzyme,flat,folded,geminat,glabrou,green-white,hair-like,homostylous,honeycomb-shaped,larger,leave,lengthening,living,lower,middl,nflorescence,orolla,pair,pentagonal,plurifoliate,pore,poricidal,removed,rotate,ruit,seudostipule,slit,spaced,specimen,tall,tamen,tem,throughout,tip,toward,tri-,unit,vary,yellow,ympodial	'hair-like,appearance,arrangement,bark,border,branch,calyx,capitate,characteristic,colour,corrugation,decumbent,exertion,form,fruiting,giving,glabrousnes,growth,height,history,inflorescence,length,life,lobing,margin,mentioned,middle,midpoint,new,number,ovary,per,prickle,primary,pseudostipule,ray,shape,stem,surface,texture,thicknes,type,variation,vein,width
164	wfo-0001027626	success	152	170	118	34	52	0.776	.3,.5,0.1â0.2,0.2â0.6,0.5-1,0.5â1,0.7â1,0.7â2.8,1,1.3â4.5,1.5â2,13â14,14â116,2â3,2â5,3â4,3â4.5,3â55,4.4â11,4â6,5â6,8,9â18,abaxially,acuminate,acute,adaxially,along,anther,apex,arrangement,axe,base,berry,blade,broadly,calyx,chartaceous,clavate,climbing,cm,color,cordate,coriaceous,densely,diameter,distant,distichous,distinct,elliptical,entire,extra-axillary,filament,fleshy,flower,frequently,fruit,fruiting,glabrous,greenish-white,immature,lamina,lanceolate,leaf-opposed,liana,line,lobe,long,margin,maturity,membranous,midvein,minutely,mm,moderately,nearly,oblique,ovate,pair,pedicel,peduncle,petiole,pinnate,pointed,possibly,pubescent,reflexed,rounded,sand-punctate,scandent,scar,secondary,seen,shortly,shrub,side,simple,slender,somewhat,sparsely,spindle-shaped,stigma,style,terminal,time,tip,trichome,truncate,tube,two,unbranched,unit,unknown,vein,white,wide,wiry-woody,x	1.5â8,2â49,3â5,5-merous,accrescen,alyx,apar,c.,capitat,center,ciliat,eaf,eed,glabrou,lower,m.,mor,nflorescence,nternode,orolla,perfec,petal,plurifoliat,rachi,ruit,sand-punctat,spaced,ste,stellate,tamen,tem,vary,venation,ympodial	accrescent,appearance,bark,border,branch,bud,capitate,characteristic,colour,corolla,corrugation,distal,drying,exertion,form,giving,glabrousnes,growth,height,history,inflorescence,interjected,internode,lateral,leaf,leaflet,length,life,lobing,mentioned,midpoint,new,number,ovary,per,plant,plurifoliate,prickle,primary,pseudostipule,ray,seed,shape,size,stem,surface,sympodial,texture,thicknes,type,variation,width
165	wfo-0001027630	success	149	178	131	18	47	0.879	.1,.2,.5,0.05-0.1,0.5-1,0.5-1.2,0.5-2,1-1.5,1-5,1.4-1.7,1.5-2,2-3,2-6-flowered,3/4,4-6,5.5-11.2,6-10,8-9,acute,also,anther,anthesi,apart,apex,arising,bark,base,beginning,berry,blunt,branchlet,broadly,calyx,ciliate,climbing,cm,corolla,de,decurrent,deltoid,densely,dia,distinguishable,erose,except,extreme,filament,free,fruit,fruiting,glabrate,glabrous,globose,golden,green,hirsute,indistinct,internodal,irregularly,knob-like,known,lanceolate,lateral,leaf,linear,lobe,lobed,long,long-acuminate,main,margin,middle,midrib,minutely,mm,near,novo,occasionally,older,opposite,ovary,pair,paler,papillose,partially,pedicel,petiole,pore,poricidal,portion,prominent,proximal,puberulent,pubescent,raised,reflexed,rest,rounded,scar,shaped,shrub,simple,slender,spaced,sparsely,stem,stigma,straight,strongly,style,swollen,tapering,tear-drop,terminal,thickened,tip,trichome,tube,ultimate,uniseriate,unit,vein,way,white,wide,widest,wing,winged,x,yellowish,young	deflexed,eaf,edicel,eed,elongat,globo,immature,inflorescenc,lon,lower,nflorescence,ruit,seen,tall,ti,ud,unifoliat,ympodial	appearance,arrangement,border,branch,bud,characteristic,colour,corrugation,diameter,distal,drying,elongate,exertion,form,giving,glabrousnes,growth,height,history,inflorescence,interjected,leaflet,length,life,lobing,mentioned,midpoint,new,number,peduncle,per,plant,prickle,primary,pseudostipule,ray,seed,shape,size,surface,sympodial,texture,thicknes,type,unifoliate,variation,width
166	wfo-0001027661	success	222	223	200	22	23	0.901	+,-10,0.5,0.5-,0.5-2,0.6-1.1,0.6-1.5,1-,1-1.5,1-5,1-7,1.2-6,1.3,1.5,1.5-2,2,2.5-3,2.5-7,30,4-15,4-8-celled,4.5-6,40,5-9,6-12,6-8,6-9,8-10,<,>,abaxially,acuminate,acute,along,anther,anthesi,apart,apex,articulate,axi,basal,base,berry,branch,branched,bright,broadly,calyx,capitate,cell,cm,column,commonly,conical,connivent,cordate,corolla,creeping,deeply,dendritic,densely,denser,density,diameter,ellipsoid,elliptic,entire,even,extremely,filament,flattened,flower,free,fruiting,fused,glabrous,globose,green,grey,ground,growth,herbaceous,hue,irregularly,lamina,lateral,leaf,leaf-opposed,leaving,lengthening,like,lobe,lobed,long,long-exserted,lower,many,margin,markedly,membraneous,minute,minutely,mixture,mm,moderately,narrowing,near,new,occasionally,often,older,open,outline,ovate,pair,pale,papillate,pedicel,peduncle,peg,pentagonal,per,perfect,pericarp,petiole,pinnatifid,pitted,pointed,pore,poricidal,portion,primary,prominent,pubescence,pubescent,purple,purplish,rachi,rarely,red,reflexed,reniform,ripe,scar,shape,shiny,short,simple,single,sinus,size,sleeve,slender,slit,small,spaced,sparsely,spot,spreading,stellate,stem,stigma,strongly,style,surface,swollen,tan,tangled,terminal,ternately,testa,thin,tightly,time,tip,trailing,triangular,trichome,truncate,tube,turbinate,two,type,underground,unieriate,uniseriate,unit,upper,usually,variable,vein,vine,violet,way,white,wide,woody,yellow,yellowish,Â¾	5-merou,adaxiall,ag,alyx,ark,eaf,eed,gre,ilament,nflorescence,orolla,papillat,papillo,plurifoliat,pubescen,ruit,spreadin,tem,ud,vary,ympodial,zig-za	5-merous,adaxially,age,arrangement,bark,bud,characteristic,colour,form,fruit,glabrousnes,height,history,inflorescence,life,ovary,papillose,plant,plurifoliate,seed,sympodial,texture,zig-zag
167	wfo-0001027714	success	251	238	197	54	41	0.785	+,.5,/3,0,0.4,0.5,0.5-0.7,1,1-,1-1.5,1-1.6,1-2,1.5-2,1.5-2.5,1.5-3,1.5-5,14-16,2-,2-2.5,2-8,2.5-,2.5-4,4-10,4-5,5,5-6,6-7,7-20,80,<,abaxially,acuminate,acute,adaxial,adaxially,aid,almost,along,angle,anther,anthesi,apex,appearance,around,articulated,axi,basal,base,berry,branched,bright,brown,calyx,capitate,cell,channelled,cm,confined,conical,connected,cordate,corky,corolla,creating,deep,deflexed,dendritic,densely,denser,diameter,drying,ellipsoid,elliptic,elongate,entire,especially,exserted,fide,filament,flattened,fleshy,flower,free,fruit,fruiting,furcate,giving,glabrate,glabrous,globose,groove,growth,hairy,immature,individual,inflated,inflorescence,juicy,lamina,large,lateral,leaf,leaving,like,lobe,lobed,long,longer,lower,many,margin,marginal,mature,mere,minute,minutely,mm,nee,new,nodding,obovate,occasionally,often,older,outline,ovary,pair,pale,papillate,pedicel,peduncle,peg,per,petal,petiole,petiolule,pinnatifid,pitted,portion,primary,prominent,pubescence,pubescent,purple,reaching,rectangular,red,reddish,reniform,rim,ripe,seed,shiny,similar,simple,sleeve,slender,slightly,small,somewhat,sparsely,stem,stigma,strongly,style,surface,tangled,terminal,testa,testal,thick,third,time,tiny,tip,tooth,trichome,truncate,tube,twining,uniformly,uniseriate,unit,upper,usually,vein,vine,violet,wall,way,weak,widest,wing,woody,x,yellowish,younger	0.6-0.7,0.9-1.5,2373.,3-3.5,4.5-5,5-10,5-merou,abaxial,age,alyx,apar,apice,ark,canop,climbin,connivent,cucullate,cupped,eaf,eed,enlarged,glabrou,hanging,ilament,irregularly,lengthening,lon,loosely,mpodial,nflorescence,orolla,otherwise,papillo,perfect,pericarp,plat,plurifoliat,pore,poricidal,ruit,scar,showy,slit,spaced,spreading,stellate-rotate,tem,thecae,thickened,thin,ud,visible,weight,yellow	23735,arrangement,bark,border,branch,bud,canopy,characteristic,climbing,colour,corrugation,description,distal,exertion,form,glabrousnes,height,history,interjected,leaflet,length,life,lobing,mentioned,midpoint,number,papillose,plant,plate,plurifoliate,prickle,pseudostipule,ray,shape,size,sympodial,texture,thicknes,type,variation,width
168	wfo-0001027720	success	184	170	125	59	45	0.679	.25-0.3,0,0-15,0.25-0.35,0.3-5,0.4-0.8,0.5-0.8,0.8-1,1-1.5,1-2,1-3.5,1-locular,1.5-2,13-35,15-25,2-3,2-4,2-7,2-branched,3-13,4-5.5,4-7,4.3-15,6,7-8,7-9,8-11,8-16,abaxially,absent,acute,adaxially,anther,apex,axe,base,berry,brown,calyx,chartaceous,cm,confined,connivent,cuneate,cylindrical,deltate,diameter,distally,eglandular,elliptic,entire,erect,extra-axillary,filament,finger,flattened,flower,fruit,fruiting,glabrous,gland-tipped,globose,green,hair,half,incomplete,inflorescence,juicy,lanceolate,lateral,leaf,length,less,lilac,lobe,long,loosely,margin,markedly,mature,mesocarp,midpoint,midrib,mm,narrowly,notched,oblique,ovate,pale,part,pedicel,peduncle,per,perennial,perfect,petiole,porrect,present,prickle,pubescent,ray,red,rhizomatous,septum,sessile,short,shrub,simple,slightly,sparsely,stellae,stellate,stigma,straight,style,subreniform,surface,thicker,time,toward,triangular,tube,unarmed,x,yellow	%,0.15-0.25,0.4-0.7,0.5-1,0.6-1.2,13-23,2-foliate,2.8-3.1,23-35,4-,4.3-7.5,5-merous,7-10,9-15,absen,adaxiall,adult,alyx,apparently,articulated,ba,blade,capitat,densely,directed,distall,eaf,eed,geminat,hig,homostylous,intepetalar,juvenile,lamina,lower,mid-point,minute,nflorescence,orolla,perfec,pore,rachi,ruit,scarce,stellate-pubescent,succulen,tamen,tem,thick,tissue,unarme,unit,upper,vary,white,wide,without,yellowi,ympodial	appearance,arrangement,bark,border,branch,bud,capitate,characteristic,colour,corolla,corrugation,distal,drying,exertion,form,giving,glabrousnes,growth,height,high,history,interjected,leaflet,life,lobing,new,null,number,ovary,plant,primary,pseudostipule,seed,shape,size,stem,succulent,terminal,texture,thicknes,type,variation,vein,width,yellowish
169	wfo-0001027720	success	272	290	214	58	76	0.787	.0,.04,.2,.3,.5,.9,0,0.8â2.0,0.9,1.5â3.3,1.5â9.0,1/2,1/3,10.0,12â16,13.0,19.7â30.0,2.0,2.5,2â3,3.2,3.6,3.9,4.0â12.6,4.0â18.0,6â8,8.0,9.5â16.0,abaxially,acuminate,acute,adaxially,adnate,aequilateral,anther,anthesi,apex,apical,apiculate,apparently,appearing,armed,articulated,attachment,attenuate,axe,base,becoming,berry,blade,branch,broad,broad-based,bud,calyx,cancellate,channel,channeled,cm,concave,congested,conical,connivent,corolla,cream,crisped,curved,deciduous,dehiscence,densely,dentate,developed,diameter,difoliate,distally,dorsally,dry,either,elliptic,emerging,endocarp,entire,erect,especially,exocarp,extra-axillary,fertile,filament,filiform,flattened-irregular,flattened-orbicular,flattened-reniform,flower,free,fruit,glabrous,glandular,globose,glossy,gradually,growth,hair,heavily,hooked,inclined,increasing,internode,interpetalar,intersepalar,juvenile,large,lateral,lavender,leaf,least,line,lobe,long,longer,major,margin,mature,midpoint,midrib,midvein,minor,minute,mm,moderately,narrowly,nearly,notched,oblique,oblong,occasionally,often,orange,ovate,part,pedicel,peduncle,per,petiole,point,poorly,pore,porrect,porrect-stellate,portion,potentially,presumably,prickle,proximal,pubescent,ray,red,reflexed,rigid,row,scattered,sessile,short,shorter,shrub,side,simple,sinus,slightly,small,soon,sparsely,splitting,spread,stamen,stellae,stellate,stellate-pubescent,stem,stigma,straight,style,subacute,subcoriaceous,surface,suture,tall,thin,time,tip,tissue,toward,translucent,tree,triangular,truncate,tube,twice-branched,two,unarmed,upper,vein,violet,wavy,way,white,wide,yellow,yellow-ferruginous,yellow-tan,young,youngest,Â±equal,Ã,â4	0.1â0.6,0.2â0.4,0.3â0.4,0.7â0.9,0.7â1.1,0.7â1.2,0.8â1.3,0.8â1.9,1.4â1.9,1.5â1.7,1.5â2.0,1.5â2.5,1.7â1.8,1.7â2.0,1.7â2.5,1.8â2.0,1.9â2.2,1/3â1/2,10.8â18.2,2.5â2.8,2.5â2.9,3.7â5.7,4â5-merou,5.1â18.6,6.5â9.5,8.0â11.9,8.2â10.5,8.5â9.4,alyx,ba,bilobed,brochidodromous,capitate,colore,eaf,eed,geminat,homostylous,juic,lamina,like,lon,lower,m.,nflorescence,orolla,perforate,raised,rip,ruit,stellate-pubescen,tamen,tem,ud,vary,weakly,yellow-ferruginou,ympodia	--,0.1,0.2,0.3,0.4,0.6,0.7,0.8,1.1,1.2,1.3,1.4,1.5,1.7,1.8,1.9,10.5,10.8,11.9,18.2,18.6,2.2,2.8,2.9,3.7,40,5.1,5.7,6.5,8.2,8.5,9.4,9.5,appearance,arrangement,bark,border,characteristic,colored,colour,corrugation,distal,drying,exertion,form,fruiting,geminate,giving,glabrousnes,height,history,inflorescence,interjected,juicy,leaflet,length,life,lobing,new,number,ovary,perforated,plant,primary,pseudostipule,ripe,seed,shape,size,sympodia,terminal,texture,thicknes,type,variation,width
170	wfo-0001027757	success	186	181	106	80	75	0.57	0.2,0.3â2.0,0.5,0.6,0.7,1.2â4.0,12,1â3,2,2.5,2â,3â5,4â9,5,60â100,abaxially,accrescent,acute,adaxially,along,anther,anthesi,apex,axe,axillary,base,blue,borne,branching,brown,calyx,cell,clavate,cm,colour,cylindrical,dark,decurrent,deeply,densely,diameter,elliptic,equal,erect,filament,flattened,fleshy,flower,fruit,glabrous,globose,hair,irregularly,lanceolate,leaf,leafy,lilac,lobe,lobed,long,margin,mm,moderately,multicellular,narrowly,oblong,obtuse,occasionally,often,opposed,ovate,pair,pale,pedicel,peduncle,perennial,perfect,petiole,pitted,plurifoliate,primary,probably,pubescent,regularly,serrate,shoot,shrub,simple,sparsely,stigma,stone,straight,style,surface,toward,tube,unbranched,unicellular,uniseriate,unknown,violet,woody,x,yellow,â2.7,â5.5	0.2â0.3,0.6â1.0,0â1.4,1.0â1.1,1.0â2.5,1.5â1.6,1.5â2.5,1.6â2.4,1.9â2.7,1â1.5,1â11,1â2,2.5â4,2.5â5.5,2.5â7,2â10,3â12,5â,6â9,7â8,8â16,absen,adaxiall,ag,apart,apical,arising,articulated,ba,basal,blade,campanulate,chartaceous,concave,connivent,convex,directed,distally,eaf,eed,entire,erose,geminat,glabrescen,glabrou,lon,longitudinal,lower,m.,nflorescence,opening,orolla,pore,poricidal,rootstock,rotate,ruit,secondary,side,slit,smaller,sometimes,spaced,tall,tamen,tem,thic,thickened,time,tip,unit,vary,white,wide,ympodial,â19,â3.2,â4.0,â6,â9	'null,'null',--,0,0.3,1,1.0,1.1,1.4,1.5,1.6,10,11,16,19,2.4,3,3.2,4,5.5,6,7,8,9,absent,appearance,arrangement,bark,border,branch,bud,characteristic,corolla,corrugation,distal,drying,exertion,form,fruiting,geminate,giving,glabrescent,glabrousnes,growth,height,history,inflorescence,interjected,lateral,leaflet,length,life,lobing,mentioned,midpoint,new,number,ovary,per,plant,prickle,pseudostipule,ray,seed,shape,size,stem,terminal,texture,thicknes,type,using,variation,vein,width
171	wfo-0001027765	success	167	169	118	49	51	0.707	-44,0.8,1,1-10,1-11.5,1-2,1-4,1-5,1.5-6,10-13,2-2.5,2-3,2-4,2.5-4,2.5-4.2,20-30,3-12,3-20,5-6,7-20,abaxial,abaxially,acumen,acuminate,acute,apex,apiculate,articulate,base,branched,calyx,cell,cm,connate,cordate,corolla,covering,cuneate,cyme,diameter,dichasial,dichasially,distal,dorsally,ebracteate,edge,elliptic,elliptic-lanceolate,exceeding,filament,flat,flower,folded,forked,generally,glandular,globose,green,green-white,hair,half,herbaceous,interjected,lateral,leaf,leaflet,light,living,lobe,long,make,mm,monochasial,mucilaginous,oblique,obtuse,odd-pinnate,ovate,ovate-elliptic,ovate-lanceolate,ovoid,pedicel,peduncle,perennial,perfect,petiole,pilose,plant,proximal,rounded,seed,side,simple,size,slightly,specimen,stamen,stellate,stigma,straight,style,terminal,testal,thick,throughout,tip,tone,truncate,tuber-bearing,typically,unit,violet,wall,white,wide,without,yellow,Â¼	-30,-4,0-.,1-,3-,3-6-foliat,5,5-15,5-8,abruptly,apical,apically,dehiscent,digestion,diminishing,eaf,eed,emoval,enzyme,globo,hair-like,honeycomb,introrse,lon,lower,lunat,maturing,nflorescence,nther,often,orolla,pair,pattern,petiolate,petiolule,plan,poricidally,reveal,ruit,sessile,seudostipule,short,slit,tal,tem,throughou,toward,vary,ympodial	'hair-like,0-2,3-6-foliate,anther,appearance,arrangement,bark,border,branch,bud,characteristic,colour,corrugation,drying,exertion,form,fruit,fruiting,giving,glabrousnes,growth,height,history,inflorescence,length,life,lobing,lunate,margin,mentioned,midpoint,new,number,ovary,per,prickle,primary,pseudostipule,ray,shape,stem,surface,sympodial,texture,thicknes,tube,type,variation,vein,wet,width
172	wfo-0001027807	success	116	129	81	35	48	0.698	.5,0-0.2,0.2-0.3,0.2-0.9,0.3-0.4,0.9-1,0.9-2.5,1-1.5,15-30,2-5,2-6,3.5-9,acuminate,acute,apex,attenuate,bark,base,berry,brittle,brown,bud,closely,cm,decurrent,diameter,dry,drying,elliptic,flattened,flower,fruiting,glabrous,globose,gray,grayish,green,growth,internodal,known,lanceolate,leaf,leaf-opposed,margin,material,maturity,minutely,mm,narrowly,new,occasionally,older,pair,pale,papillae,papillate,parallel,pedicel,peduncle,petiole,pitted,primary,reddish,reniform,revolute,seemingly,shrub,simple,slender,slightly,small,spaced,sparsely,stem,surface,tree,vein,white,winged,x,yellowish	0.1-1,abaxially,adaxially,almost,barely,deflexe,deflexed,difoliate,eaf,eed,ellipti,geminat,know,midrib,nflorescence,ot,overlapping,paler,plane,prominent,rachi,reddi,reproductive,ruit,scar,shoot,somewhat,thickened,ud,unifoliate,unit,usually,visible,ympodial,young	anther,appearance,arrangement,border,branch,calyx,characteristic,colour,corolla,corrugation,distal,exertion,filament,form,fruit,giving,glabrousnes,height,history,inflorescence,interjected,lateral,leaflet,length,life,lobe,lobing,midpoint,null,number,ovary,per,plant,prickle,pseudostipule,ray,seed,shape,size,stigma,style,terminal,texture,thicknes,tube,type,variation,width
173	wfo-0001027816	success	187	165	126	61	39	0.674	.5,0.5-1,0.5-2,0.6-0.8,0.7-1,1-1.5,1-3,1-4,1.2-2,1.5-2,1.8-6,12-14,2-4,2/3,3-3.5,3.5-4,4-5,5-30,6-9,acuminate,acute,anther,anthesi,apex,attenuate,base,becoming,berry,bluish,branched,brown,calyx,capitate,cell,cm,conical,connivent,corolla,dark,dense,densely,diameter,drying,ellipsoid,entire,erect,exserted,filament,filiform,flattened,fleshy,flower,free,fruiting,glabrous,gland-tipped,glandular,globose,growth,half,inflorescence,lanceolate,lateral,leaf,less,like,linear,lobe,lobed,loosely,lower,margin,minute,minutely,mm,new,occasionally,often,orange,pair,patent,pedicel,peduncle,per,petiole,pitted,plant,portion,primary,pubescent,purple,rectangular,red,reddish,reniform,ripe,rounded,several,shrub,simple,slightly,small,sometimes,sparse,sparsely,square,stem,stigma,style,surface,terminal,testal,time,tip,triangular,trichome,tube,ultimate,uniformly,uniseriate,vein,viscous,way,x,yellowish,Â½	..,0.2,0.5,1,1-1,2-2.5,5-merou,<,ag,almost,along,alyx,apar,ark,articulated,axi,confined,cupped,eaf,eed,em,ilament,irregularly,leaving,lengthening,m.,markedly,nflorescence,nodding,older,orolla,papillo,peg,perfect,perhaps,pericarp,plurifoliat,pore,poricidal,prominen,pubescen,ruit,scar,shiny,sleeve,slit,somewhat,spaced,spreadin,spreading,stellate,thin,twinin,ud,unit,upper,usually,variable,vary,woody,ympodial	apart,appearance,arrangement,bark,border,branch,bud,characteristic,colour,corrugation,distal,exertion,form,fruit,giving,glabrousnes,height,history,interjected,leaflet,length,life,lobing,midpoint,null,number,ovary,papillose,prickle,pseudostipule,ray,seed,shape,size,texture,thicknes,type,variation,width
174	wfo-0001027819	exception_thrown	199	0	0	199	0	0.0		-100,0.5-1,1,1-,1-2,1-5,1.5-2,10-20,10-50,12-21,15-22,16-25,2,2-,2-15,2-3,20-25,20-35,20-40,22-35,25-35,3-40,3-5,3-5-lobed,4,4-10,4-15,4-25,4-5,5,5-6,5-merous,8-10,9-12,abaxially,acute,adaxially,aggregate,also,alyx,apart,ape,apex,apical,apiculat,articulated,axe,ba,basal,base,beyond,blade,branched,cell,ciliate,cm,color,concave,connective,cordate,cuneate,cylindrical,deeply,densely,denser,dia,diamete,diameter,dilated,directed,distally,divided,eaf,eed,eglandular,eglandular-pilose,ellipsoidal,elliptic,elliptic-ovate,entire,equal,especially,exceeding,except,exserted,fading,finely,fleshy,flower,forked,fruit,glabrous,globose,green,hair,halfway,leaf,leaving,length,lobe,lobed,lon,long,lower,main,margin,mesocarp,midrib,mm,moderately,narrow,narrowly,near,nflorescence,nther,oblique,oblong,obtu,obtuse,occasionally,often,orolla,ovate,pedicel,pedicellar,peduncle,per,perfec,perfect,petiole,pilose,pinnately,pore,present,probably,prominent,protuberance,puberulen,puberulence,puberulent,purple,purplish,rachi,radiu,ranch,rarely,ratio,remnant,ripe,rounded,rown,rugose,ruit,runk,shallowly,short-acuminat,shorter,simple,sinus,slightly,small,sometimes,spaced,sparsely,stamen,stellate,stigma,stone,strongly,style,subcoriaceous,swelling,sympodial,tal,thecae,toward,tree,triangular,truncate,tube,two,ud,umbrella-shaped,unbranched,uni,unit,unknown,unlobed,usually,vary,vein,villous,whitish,wide,width,without,x,yellow,young	
175	wfo-0001027834	success	236	218	173	63	45	0.733	-6.1,.5-3,0-110,0.2-0.3,0.2-0.4,0.2-0.6,0.4-1.1,0.5-2,0.9-1.8,1-1.6,1-1.9,1-10,1.1-1.6,1.1-1.8,1.4-2,1.6-2.7,1.8-4.9,1/2,10-25,2-3.8,2-8,2.2-4.3,2.3-3.4,2.4-6.2,2.7-7.3,2.9-4.2,25,3-15,3-4.3,4-5.2,4-6,4.8-6.9,5-20,5.1-8,6.9-18.1,9-13,abaxial,absent,accrescent,acuminate,acute,adaxial,adaxially,angled,anther,anthesi,apex,articulated,attenuate,axillary,bark,base,becoming,berry,blade,blunt-tipped,branch,branched,branching,brown,bud,calyx,closely,cm,completely,coriaceous,corolla,covering,crown,cylindrical,deltoid,dendritic-echinoid,diameter,drying,echinoid,ellipsoid,entire,enveloping,filament,finely,flat-topped,fleshy,flower,forming,fruit,fruiting,glabrescent,glabrous,globose,granular-tomentose,gray,grooved,hair,included,leaf,lenticular,lobe,lobed,long,longitudinally,many,margin,mm,mostly,multangulate,near,numerous,obovate,obtuse,older,orbicular,ovate,ovate-elliptic,ovate-lanceolate,pair,pedicel,peduncle,petiole,plurifoliate,porrect-stellate,primary,pseudo-terminal,pubescence,rachi,rarely,ray,reticulate-punctate,ripe,rounded,scabridulous,scar,semi-ovate,semi-spherical,sessile,short,short-stalked,shrub,simple,small,soft,sometimes,somewhat,spaced,sparsely,spreading,stalked,stellate-pubescent,stem,stigma,style,subcampanulate,surface,though,time,tree,trichome,tube,turbinoid,unit,usually,vein,velutinous-tomentose,way,white,whitish,whitish-tomentose,wide,x,yellow,yellowish,yellowish-tan,yellowish-tomentose,young	1-2.5,5-merous,9-11.9,abaxially,ag,alyx,apar,apical,around,ba,capitat,concentrated,connivent,dendritic-echinoi,densely,dichasia,directed,discolorous,distally,eaf,echinoi,edge,eed,enclosing,equal,erec,exserted,farinose,high,inserted,lengthening,less,light,long-stalked,longitudinal,lower,multangulat,nflorescence,obscured,orolla,perfec,persistent,pore,poricidal,pubescent,ruit,runk,slit,stamen,stellate,subcoriaceous,suture,tamen,tip,tomentose,tomentu,tomentum,toward,ud,unarme,vary,villous,ympodial	apart,appearance,arrangement,border,capitate,characteristic,colour,corrugation,dichasial,distal,exertion,form,giving,glabrousnes,growth,height,history,inflorescence,interjected,lateral,leaflet,length,life,lobing,mentioned,midpoint,new,number,ovary,per,plant,prickle,pseudostipule,seed,shape,size,sympodial,terminal,texture,thicknes,trunk,type,unarmed,variation,width
176	wfo-0001027843	success	154	170	126	28	44	0.818	.75,0.5-0.75,0.5-1,0.8-3.5,1-1.2,1-1.3,1-1.5,1.2-1.5,1.2-2.5,2-2.5,2-4,3-15-flowered,3-6,5-6,6-13,6-9,acute,along,anther,anthesi,apex,apiculate,bark,base,bearing,becoming,beneath,berry,broadly,calyx,clavate,cm,conical,corolla,curly,deltoid,densely,denser,dia,distally,ellipsoid,erose,exsertion,filament,flower,free,fruiting,glabrate,glabrous,globose,green,hairy,impressed,known,lamina,larger,later,lateral,leaf,like,lobe,lobed,long,long-acuminate,main,major,margin,middle,minor,minutely,mm,near,nearly,occasionally,older,one,opposite,orbicular,ovary,ovate,pair,papillose,pedicel,petiole,pleated,pore,poricidal,portion,prominent,proximal,pubescent,reflexed,rounded,shape,shaped,shrub,simple,sinus,size,slender,slightly,somewhat,sparser,stem,stiff,stigma,straight,strongly,style,surface,tall,tapering,tear-drop,time,tip,tipped,trichome,tube,two,uniseriate,vein,white,widest,winged,x,young	.5,/3,apart,ba,beginning,coroll,deflexed,differing,difoliate,eaf,edicel,eed,geminat,irregularly,lon,lower,nflorescence,papillo,reddish-gre,ruit,scar,spaced,sparsely,ud,unit,way,woody,ympodial	appearance,arrangement,border,branch,bud,characteristic,colour,corrugation,diameter,distal,drying,exertion,form,fruit,giving,glabrousnes,growth,height,history,inflorescence,interjected,leaflet,length,life,lobing,mentioned,midpoint,new,number,peduncle,per,plant,prickle,primary,pseudostipule,ray,reddish-grey,seed,terminal,texture,thicknes,type,variation,width
177	wfo-0001027847	success	219	195	155	64	40	0.708	-0.8,-2,-2.5,-3,-4,-6,/2,0,0-2,0-7,0.1-0.4,0.15-0.2,0.2,0.4-1,0.5,0.5-1,0.8-1.2,1-2.5,1.5-2,1.5-5,1.9-2.3,1/2,1/4,2-2.8,2-3,2-4,2-5,2.2-3,3-15,3-5,3-6,4-5-merous,5-25,6-11,6-8,acute,almost,ame,anther,apart,apex,apically,apparently,articulated,bark,base,berry,blade,broadly,c.,calyx,chartaceous,cm,cordate,curved,deltate,densely,diameter,dimorphic,discolorous,distance,drying,dull,edge,elliptic,equal,erect,extending,faint,filament,finely,flattened,flattened-reniform,flower,fruit,fruiting,geminate,glabrescent,glabrous,gray,increasing,lateral,leaf,length,lobe,lobed,long,longer,lower,margin,middle,midpoint,midvein,minor,mm,older,orange-brown,orbicular,ovate,pair,pedicel,peduncle,per,perpendicular,petiole,pit,pitted,porrect,prickle,prickly,primary,ray,red-brown,reddish,retrorse,rounded,scandent,scar,seed,sessile,shrub,side,simple,size,smooth,sometimes,spaced,sparsely,spherical,stalk,stalked,stellate-pubescent,stem,straight,strongly,style,surface,terete,terminal,tertiary,time,toward,trichome,tube,unit,upper,usually,variously,vein,venation,visible,weakly,wide,yellow,young	-5,.35,.7,/3,0.8,0.8-0.9,1,1-2,1.5-2.5,1/6-1/3,2.5-3.5,2/,3.5-6,5-6,5.5-8,7-10,abaxially,alyx,apar,branched,brow,connivent,eaf,eed,elongating,evenly,filiform,filiform-acuminat,free,green,infructescence,lon,mature,maturity,mauve,moderately,narrow-deltate,nflorescence,one,open,orange,orolla,oung,pendulous,perfec,pericarp,plurifoliat,poricidal,portion,prickl,purple,red,ruit,slender,spreading,stellate,tamen,tapering,tip,unarmed,vary,way,white,ympodial	appearance,arrangement,border,branch,brown,bud,characteristic,colour,corolla,corrugation,distal,exertion,form,giving,glabrousnes,growth,height,history,inflorescence,interjected,leaflet,life,lobing,new,null,number,ovary,perfect,plant,plurifoliate,pseudostipule,shape,stamen,stigma,sympodial,texture,thicknes,type,variation,width
178	wfo-0001027872	success	190	186	138	52	48	0.726	0.5,1,1-1.2,1-4,1-8,1.0-1.3,10,12-35,15,2,2-3,2.2-3.5,2.8,20,35,4-6,5-7,5-8,5-lobed,6-20,8-11,acumen,acuminate,acute,angular,apex,apiculate,articulate,b,basal,base,becoming,branched,ca,calyx,caudate,cell,celled,cm,commonly,connate,cordate,covering,cuneate,cyme,decreasing,deep,densely,diameter,dichasial,dichasially,distal,ebracteate,elliptic,erect,externally,filament,flower,forked,four-celled,generally,glabrescent,gland,glandular,glandular-pubescent,globose,gray-green,green,green-white,hair-like,half,herbaceous,homogeneously,interjected,lanceolate,lateral,leaflet,light,lobe,long,longer,make,middle,mm,moderately,monochasial,mottled,mucilaginous,narrowly,nearly,obliquely,oblong,odd-pinnate,ovate,ovoid,pair,pedicel,peduncle,perennial,petiolate,petiolule,plant,puberulent,pubescent,purple,rarely,reduced,rhizomatous,rhizome,rounded,seed,shape,short,single,size,slightly,sometimes,somewhat,stigma,style,subequal,terete,terminal,testal,thick,tinged,tip,trailing,type,typically,unbranched,uniformly,usually,wall,wide,wider,yellow,yellowish-green	1.5-4,3-6-foliat,5-10,abaxially,adaxially,apical,apically,ba,clasping,dehiscent,digestion,eaf,eed,emoval,enzyme,exceeding,globo,honeycomb,introrse,living,lon,lower,maturing,nflorescence,nther,often,orolla,pattern,pentagonal,perfect,petiolulate,poricidally,purpl,reveal,rotate,rotate-,ruit,semi-lunate,sessile,seudostipule,slit,specimen,stamen,ste,straight,symmetrically,tem,unit,vary,viole,wid,ympodial	anther,appearance,arrangement,bark,border,branch,bud,characteristic,colour,corolla,corrugation,drying,exertion,form,fruit,fruiting,giving,glabrousnes,growth,height,history,inflorescence,leaf,length,life,lobing,margin,midpoint,new,null,number,ovary,per,petiole,prickle,primary,pseudostipule,ray,stem,surface,texture,thicknes,tube,variation,vein,violet,wet,width
179	wfo-0001027880	success	185	185	137	48	48	0.741	-3.5,.25,0.3-3,0.5-1.5,0.5-5,0.6-1,0.6-1.5,0.8-1.5,1-14,1-15,1-2,1-3,1.5-2,1.5-3,10-15,2-3,2-80,3-4,4-10,4-6,5-11,8,abaxially,acuminate,acute,adaxially,along,anther,apart,apex,apiculate,articulated,axe,base,blade,branch,branching,calyx,clavate,cm,conical,contiguously,cordate,coriaceous,curled,densely,diameter,diminishing,discolorous,distichous,distinct,distinctly,entire,epiphytic,equal,extra-axillary,filament,flattened,flower,fruit,fruiting,glabrous,globose,green,greenish,growing,hair,increasing,inflorescence,internode,leaf,leaf-opposed,line,lobe,long,longer,margin,midvein,minutely,mm,multicellular,nearly,node,oblique,oblong,oblong-ovate,occasionally,often,ovate,ovoid,pair,papillose,pedicel,peduncle,petiole,pink,plurifoliate,point,pubescent,purple,rachi,red-brown,reddish,revolute,ripe,rooting,rounded,rugulose,scar,secondary,shrub,simple,size,slender,slightly,sometimes,somewhat,spaced,stigma,style,surface,tan,trailing,tree,truncate,trunk,tube,typically,unbranched,undulate,uniseriate,unit,usually,vein,vine,white,x	-3,1-2.5,2/,5-8,5-merou,absen,accrescen,ag,aggregate,alyx,apparently,ba,cell,chartaceous,ciliat,connivent,cylindrical,deltate,dense,directed,distally,eaf,eed,geminat,longitudinal,lower,nflorescence,opening,orolla,pale,perfect,pore,pubescen,ruit,slit,sparsely,ste,stellate,stone,tamen,tem,thickened,time,tip,vary,wide,yellow,ympodial	accrescent,appearance,arrangement,bark,border,bud,characteristic,colour,corolla,corrugation,distal,drying,exertion,form,geminate,giving,glabrousnes,growth,height,history,interjected,lateral,leaflet,length,life,lobing,midpoint,new,null,number,ovary,per,plant,prickle,primary,pseudostipule,ray,seed,shape,stamen,stem,sympodial,terminal,texture,thicknes,type,variation,width
180	wfo-0001027880	success	170	181	114	56	67	0.671	.25,0.2-0.5,0.3â3,0.5,0.5â5,2-80,2/3,abaxially,absent,acuminate,acute,adaxially,along,anther,apex,apiculate,arrangement,axe,base,berry,blade,bluish-purple,calyx,chartaceous,clavate,climbing,cm,conical,cordate,coriaceous,curled,cylindrical,densely,diameter,discolored,distichous,distinct,distinctly,entire,extra-axillary,filament,flattened,flower,fruit,fruiting,glabrous,globose,greenish,hair,lanceolate,leaf,leaf-opposed,line,lobe,long,longer,lower,margin,midvein,minutely,mm,mottled,nearly,oblique,oblong-ovate,occasionally,often,ovate,ovoid,pair,papillose,pedicel,peduncle,petiole,pink,pinnate,pubescent,red,reddish,reddish-brown,revolute,rounded,rugulose,sand-punctate,scar,secondary,shrubby,simple,slender,slightly,sometimes,somewhat,stigma,style,surface,tan,time,tree,trichome,truncate,trunk,tube,typically,unbranched,undulate,uniseriate,unit,vein,vine,white,wide,woody,x,â3.5	0.5â1.5,0.6â1,0.6â1.5,0.8â1.5,1.5â2,1.5â3,10â15,1â14,1â15,1â2,1â2.5,1â3,2â3,3â4,4â10,4â6,5-merous,5â11,5â8,8,accrescen,alyx,apar,c.,capitat,ciliat,contiguously,deltate,dense,eaf,eed,green,m.,membranous,nflorescence,nternode,orolla,pale,perfec,plurifoliat,rachi,rip,ruit,sand-punctat,spaced,sparsely,ste,stellate,tamen,tem,thickened,tip,vary,vegetatio,venation,ympodial	0.5-1.5,0.6-1,0.6-1.5,0.8-1.5,1-15,1-2,1-2.5,1-3,1.5-2,10-15,2-3,3-4,4-10,4-6,5-11,appearance,bark,border,branch,bud,capitate,characteristic,colour,corolla,corrugation,distal,drying,exertion,form,giving,glabrousnes,growth,height,history,inflorescence,interjected,internode,lateral,leaflet,length,life,lobing,mentioned,midpoint,new,number,ovary,per,plant,plurifoliate,prickle,primary,pseudostipule,ray,ripe,seed,shape,size,stem,sympodial,terminal,texture,thicknes,type,variation,vegetation,width
181	wfo-0001027881	success	215	197	134	81	63	0.623	-3,.3â0.5,1â2-celled,1â3,1â3-celled,1â4,20â40,5,8,abaxially,absent,acute,adaxially,almost,anther,apex,articulated,attenuate,axe,base,berry,blackish,blade,calyx,camptodromous,ciliate,cm,commonly,connected,connivent,contiguous,cordate,cordiform,cylindrical,decurrent,densely,denser,diameter,difoliate,drying,eglandular,emerging,entire,equal,erect,exceeding,extra-axillary,few-,fewer,filament,flattened,flower,forming,frequent,fruit,geminate,giving,glabrous,glandular,globose,greenish,groove,hair,half,herb,hollow,immature,impression,larger,lateral,leaf,less,light-brown,like,lobe,long,longer,many-branched,margin,maturity,mixed,mm,moderately,much,multicelled,netlike,one,other,ovate-elliptic,pair,parallel,pedicel,peduncle,per,petiole,placenta,primary,projection,prominent,pubescence,pubescent,rachi,raised,reniform,secondary,seed,sessile,short,side,similar,simple,size,slightly,small,smaller,solitary,sparsely,stamen,stem,stigma,style,subopposite,surface,translucent,triangular,tube,unbranched,unit,vein,visible,white,winged,woody,Ã	0.5â2.2,0.8â1.5,1-celled,1.3â2,1.8â2.9,10â25,1â2,1â2.5,1â2.6,2.5â3.6,2â4,2â6,2â7,4â6,4â9.5,5-merous,6â10,7â14,7â9,abundant,accrescent,acuminate,adaxiall,alyx,appressed,asymmetric,ba,barely,bulge,capitat,case,central,chartaceous,closely,curved,dehiscing,directed,dorsally,eaf,ed,emarginate,exclusively,explosively,eye,held,interpetalar,introrsely,longitudinal,lower,mainly,maturit,membranaceous,mesocarp,multicellular,naked,near,nflorescence,normally,opening,orolla,part,perfec,pore,pressure,rotate,ruit,slit,sometimes,stalk,staman,subapically,tal,tamen,tem,tissue,two,vary,venation,watery,yellow,ympodial	--,0.5,0.8,1,1.3,1.5,1.8,10,14,2,2.2,2.5,2.6,2.9,25,3,3.6,4,6,7,9,appearance,arrangement,bark,border,branch,bud,capitate,characteristic,colour,corolla,corrugation,distal,exertion,form,fruiting,glabrousnes,growth,height,history,inflorescence,interjected,leaflet,length,life,lobing,midpoint,new,null,number,ovary,plant,prickle,pseudostipule,ray,shape,sympodial,terminal,texture,thicknes,type,variation,width
182	wfo-0001027882	success	184	186	146	38	40	0.793	.25,0.1,0.5-1,1,1-1.5,1-5,1.5-,1.5-2,1.5-2.2,1.5-6,1.6-2.2,10-25,10-40,2-3,2-lobed,2.1-2.6,2.5-3,3-4,3.2-6,3.5-4,3.5-5,4-5,6-9,7-,9-13,abaxially,absent,acuminate,adaxially,age,along,anther,anthesi,apex,apparently,appearing,attenuate,axil,bark,base,berry,branch,branched,branching,broadly,brown,c.,calyx,clavate,cm,completely,conical,corolla,cucullate,dark,deltate,densely,diameter,dry,drying,elliptic,entire,erect,exerted,filament,flattened,flower,fork,free,fruiting,fusiform,glabrous,globose,green,growth,hairy,hollow,hooked,inflorescence,junction,lamina,leaf-opposed,lengthening,less,lobe,lobed,margin,maturity,midrib,minutely,mm,new,occasionally,ovary,ovoid,pair,pale,papillate,paulo,pedicel,peduncle,petiole,pitted,planar,pointed,population,pore,poricidal,portion,primary,rarely,reddish,reniform,shattering,shiny,shrub,simple,slender,slit,small,sometimes,sparse,sparsely,specimen,stem,stigma,stout,straight,strongly,structurally,style,surface,sÃ£o,time,tip,tree,trichome,tube,uniseriate,usually,vein,way,white,x,yellow,yellowish	.5,06a,2-6,apart,caly,dense,difoliate,eaf,eed,et,fide,geminat,glabrou,irregularly,kallunki,lower,markedly,nflorescence,nodding,papillat,penden,perfect,plane,pulp,rachi,red-papillat,ruit,scar,spaced,sticky,sweet-scented,swollen,thickened,tuft,ud,unit,woody,ympodial	appearance,arrangement,border,bud,characteristic,colour,corrugation,distal,exertion,form,fruit,giving,glabrousnes,height,history,interjected,lateral,leaf,leaflet,length,life,lobing,mentioned,midpoint,number,per,plant,prickle,pseudostipule,ray,red-papillate,seed,shape,size,terminal,texture,thicknes,type,variation,width
183	wfo-0001027889	success	151	146	89	62	57	0.589	-2.5,-pubescent,.5-2,0.5-1,0.5-11,0.7-2,1-10,1-3,1-3.5,1.5,1.5-2,10-12,10-20,10-30,2-20,2-3,3-4,3-9,5-10,abaxially,acuminate,acute,acute-acuminate,adaxially,apart,apex,apiculate,basal,base,calyx,cm,connivent,cylindrical,darker,deltate,densely,diameter,dilated,distally,eglandular-puberulent,elliptic,entire,flower,fruit,glandular-,green,greenish,immature,length,light,lobe,long,longitudinal,margin,mm,moderately,ovate,ovoid,pedicel,peduncle,perfect,petiole,probably,puberulent,puberulent-pubescent,ripe,shrub,slightly,small,somewhat,sparsely,stigma,stripe,style,subcordate,time,tip,tree,triangular,truncate,tube,unbranched,unit,unknown,violet,white,wide,x,yellowish	.5,0,1,3-8,4-foliat,aggregate,ape,articulated,axe,beyond,blade,capitat,cell,chartaceous,color,connective,directed,eaf,eed,eglandular-pubescent,equal,exceeding,exserted,extending,finely,glabrous,introrse,laterally,leaving,lon,lower,narrow,nflorescence,nther,oblong,orolla,pedicellar,pore,presen,present,puberulen,puberulent-pubescen,rachi,radiu,remnant,ruit,simple,spaced,stamen,stellate,stone,subcoriaceous,swelling,tal,tem,thecae,tomento,tomentose,ud,vary,yello,ympodial	1-2.5,4-foliate,anther,appearance,arrangement,bark,border,branch,bud,capitate,characteristic,colour,corolla,corrugation,distal,drying,exertion,filament,form,fruiting,giving,glabrousnes,growth,height,history,inflorescence,interjected,lateral,leaf,leaflet,life,lobing,midpoint,new,null,number,ovary,per,plant,prickle,primary,pseudostipule,ray,seed,shape,size,stem,surface,sympodial,tall,terminal,texture,thicknes,type,variation,vein,width
184	wfo-0001027901	success	156	178	133	23	45	0.853	.25,.5,0.3-1.2,0.5-1,0.8-1,0.8-2,0.9-2.3,1-1.5,1-2,1-2.5,1.5-1.8,1.8-4.5,2.5-3,3-5,4-10-flowered,4-5,4.7-12,6-7,?,abaxially,acuminate,acute,adaxially,anther,anthesi,apex,area,attenuate,bark,base,beneath,berry,bright,broadened,brown,calyx,closely,cm,conical,corolla,curled,dark,deflexed,densely,dia,difoliate,dry,drying,ellipsoid,elliptic,exserted,filament,firm,fleshy,free,fresh,fruiting,glabrous,globose,green,imbedded,immature,inflorescence,keeled,later,lateral,leaf,like,lobe,lobed,long,main,major,material,matrix,middle,midrib,minutely,mm,nearly,older,opposite,orbicular,ovary,ovoid-reniform,pair,papillose,pedicel,petiole,pitted,planar,pore,poricidal,portion,prominently,pubescent,reddish,reflexed,ripe,rounded,scar,shape,shaped,shiny,shrub,simple,size,slender,spaced,sparsely,stem,stigma,straight,strongly,style,surface,swollen,tall,tear-drop,tip,translucent,triangular,trichome,tube,uniseriate,unit,vein,white,widest,woody,x,yellow,young	abaxial,ba,brow,differing,direction,eaf,edicel,eed,geminat,lon,lower,minor,nflorescence,oriented,overlappin,papillo,rest,ruit,single,tub,ud,usually,ympodial	appearance,arrangement,border,branch,bud,characteristic,colour,corrugation,diameter,distal,exertion,form,fruit,geminate,giving,glabrousnes,growth,height,history,interjected,leaflet,length,life,lobing,margin,midpoint,new,null,number,overlapping,peduncle,per,plant,prickle,primary,pseudostipule,ray,seed,sympodial,terminal,texture,thicknes,type,variation,width
185	wfo-0001027902	success	128	124	70	58	54	0.547	0.5-1,1-1.5,1-2,10-20,2-15,2-8,20-50,3-4,3-5,4-25,4-5,5-20,6-37,7-9,abaxially,acuminate,acute,adaxially,angled,apex,axe,base,branched,calyx,cm,cordate,deeply,densely,diameter,distally,eglandular,entire,flower,forked,fruit,glandular,globose,hair,inflated,like,lobe,margin,mm,moderately,narrowly,obtuse,ovate,pedicel,peduncle,petiole,puberulent,pubescent,purple,reticulate,ripe,shrub,small,sparsely,stigma,style,tip,tree,triangular,truncate,tube,unbranched,unknown,usually,whitish,x	-2.5,1-6,1.5-3,10-15,15-30,2,2-12,2-3,2-9,3-foliat,8-13,absen,adaxiall,aggregate,apart,articulated,blade,cell,chartaceous,color,connivent,cylindrical,directed,distall,eaf,eed,glabrous,leaving,lon,long,lower,nearly,nflorescence,nther,orolla,pedicellar,pore,pubescen,purplish,rachi,radiu,remnant,ruit,simple,spaced,ste,stellate,stone,subcoriaceous,tal,tem,time,truncat,unit,vary,wide,yellow,ympodial	2-2.5,anther,appearance,arrangement,bark,border,branch,bud,characteristic,colour,corolla,corrugation,distal,drying,exertion,filament,form,fruiting,giving,glabrousnes,growth,height,history,inflorescence,interjected,lateral,leaf,leaflet,length,life,lobing,mentioned,midpoint,new,number,ovary,per,plant,prickle,primary,pseudostipule,ray,seed,shape,size,stem,surface,terminal,texture,thicknes,type,variation,vein,width
186	wfo-0001027929	success	193	188	142	51	46	0.736	0.2-0.9,1,1-10,1-4,1-8,1.0-1.3,1.5-4,10,15,2,2-3,2.0-3.0,20,3.5-5,35,4-30,4-5,4-6,5-10,5-6,5-lobed,6-15,abaxially,acumen,acuminate,acute,adaxially,along,angular,apex,apiculate,basal,base,becoming,beyond,branched,calyx,caudate,cell,center,cm,coat,color,connate,cordate,corolla,covering,cuneate,cyme,dark,darker-violet-blue,decreasing,deep,diameter,dichasial,dichasially,distal,ebracteate,elliptic,embryo,erect,except,filament,flower,forked,formed,generally,glabrous,globose,green,green-white,hair,hair-like,half,herbaceous,interjected,lanceolate,lateral,leaflet,light,lobe,long,make,middle,mm,monochasial,mostly,mucilaginous,narrowly,nearly,obliquely,oblong,occasional,odd-pinnate,ovate,ovoid,pair,pedicel,peduncle,perennial,petiolate,petiolule,plant,puberulent,purple,radiating,rarely,reduced,rhizomatous,rhizome,rounded,seed,shape,size,slightly,sometimes,somewhat,spot,star,stigma,style,subequal,symmetrically,terete,terminal,testal,thick,tinged,tip,trailing,unbranched,usually,vein,violet,violet-blue,visible,wall,white,wide,wider,without,yellow	3-6-foliat,apical,apically,articulate,ba,cente,clasping,dehiscent,digestion,eaf,eed,emoval,enzyme,exceeding,globo,honeycomb,included,introrse,living,lon,lower,maturing,nflorescence,nther,often,orolla,pattern,pentagonal,perfect,petiolulate,poricidally,purpl,reveal,rotate,rotate-,ruit,semi-lunate,sessile,seudostipule,short,slit,specimen,stamen,ste,straight,tem,typically,unit,vary,wid,ympodial	anther,appearance,arrangement,bark,border,branch,bud,characteristic,colour,corrugation,drying,exertion,form,fruit,fruiting,giving,glabrousnes,growth,height,history,inflorescence,leaf,length,life,lobing,margin,midpoint,new,null,number,ovary,per,petiole,prickle,primary,pseudostipule,ray,stem,surface,texture,thicknes,tube,type,variation,wet,width
187	wfo-0001027948	success	186	165	117	69	48	0.629	-15,-16,-6,.5,0-,0.5-2,0.8-,1-1.2,1-2,1.2-2.2,1.3-1.8,1.5-4.5,13,2-,2.2-,2.5-,3-8.2,3.2-5.2,3.7-4,5,5-,6-celled,7,7-15,7.5-10,abaxially,abundant,acuminate,adaxially,anther,antrorse,apex,attenuate,basal,base,berry,branch,calyx,cm,connectival,corolla,diameter,difoliate,directed,dorsally,edentate,ellipsoidal,elliptical,erect,filament,flexuous,fruiting,generally,glandular,globose,herb,herbaceous,hollow,ill-smelling,inconspicuous,lamina,leaf,length,light,lobe,long,long-stalked,longitudinally,margin,midvein,mm,narrowly,near,non-glandular,occasionally,ovate,ovoid,pair,papillate,patent,petiole,prolongation,pubescent,purple,reduced,ridged,scarce,secondary,seed,serrulate,simple,slightly,small,smooth,solitary,spur-like,stem,stigma,straight,striate,style,sub-opposite,sub-shrub,thickened,tip,tooth,trichome,tube,unequal,unit,upward,vein,violet,viscid-pubescent,x,Â¼,Â½	0.4,0.5-0.7,0.6,1.6,1/10,10-14,14,3.5,8-celled,accrescen,ag,aggregate,ape,articulate,ature,bicellular,c.,campanulate,cell,crushed,cuticle,dark,delicate,diamete,eaf,finely,fragrance,free,glabrous,head,hig,inserted,longer,longitudinal,lower,many-,narrow,odorles,opening,orolla,pericarp,pore,poricidal,portion,pubescence,ree,ruit,saddle-shape,scarcely,seeded,seen,separated,short-stalked,shorter,single-celled,sinus,slit,stalk,stone,striat,tem,thecae,time,triangular,twice,vary,ventrifixed,verrucate,ympodial	appearance,arrangement,bark,border,bud,characteristic,colour,corrugation,distal,drying,exertion,form,fruit,giving,glabrousnes,growth,height,history,inflorescence,interjected,lateral,leaflet,life,lobing,mentioned,midpoint,new,number,ovary,pedicel,peduncle,per,plant,prickle,primary,pseudostipule,ray,saddle-shaped,shape,size,surface,sympodial,terminal,texture,thicknes,type,variation,width
188	wfo-0001027961	success	177	179	135	42	44	0.763	.5,0.25-0.5,0.5-1,0.9-1,1,1-1.5,1-3,1-4,1-5,1-9,10-50,2-2.5,2.3-2.5,2.5-9,3-3.5,4.5-5,5-8,6-9,7-9,8-10,?,acute,adaxially,age,always,anther,anthesi,apex,asymmetric,axil,base,berry,branched,broadly,c.,calyx,clavate,cm,conical,connivent,cordate,corolla,curling,deltate,densely,diameter,distributed,early,ellipsoid,elliptic,entire,equalling,exserted,fading,filament,flower,free,fruiting,fusiform,glabrous,globose,green,growth,immature,inflorescence,lamina,lateral,lengthening,lobe,lobed,long,loosely,lower,many,margin,mature,maturity,midrib,minute,minutely,mm,new,obovate,observed,occasionally,often,older,one,other,pair,pedicel,peduncle,petiole,pinched,pinnatifid,planar,poricidal,portion,present,primary,probably,pubescent,purple,reddish,shiny,simple,slender,slightly,sparsely,spreading,stem,stigma,style,surface,terminal,time,tip,triangular,trichome,truncate,tube,tuft,twining,unequal,uniseriate,upper,vein,vine,violet,way,white,white-pubescent,woody,x,yellow	0.25,5-merou,<,abaxially,adaxiall,alyx,apar,ark,articulated,brow,clear,eaf,eed,geminat,ilament,irregularly,lon,membranous,nflorescence,orolla,papillo,pendan,perfect,pericarp,plurifoliate,pore,pubescen,rotate-stellate,ruit,scar,sleeve,slit,small,spaced,tem,thin,transition,twinin,ud,unit,vary,ympodial	appearance,arrangement,bark,border,branch,brown,bud,characteristic,colour,corrugation,distal,drying,exertion,form,fruit,giving,glabrousnes,height,history,interjected,leaf,leaflet,length,life,lobing,midpoint,number,ovary,papillose,pendant,per,plant,prickle,pseudostipule,ray,seed,shape,size,specified,texture,thicknes,type,variation,width
189	wfo-0001027966	success	207	186	143	64	43	0.691	0.4-0.5,0.7-3,0.8,0.8-2.5,1-1.8,1-10,1-2,1-4.2,1-5,1.2-4.5,1.3-2.2,1.5-5.2,10,10-30,2.2-2.9,2.5-10.5,2.8-9,3-4,3-5,3-7,4,40-80,5-10,5-6,5-9.5,5.5-14,6-11,abaxially,absent,acumen,acuminate,adaxially,along,anther,apart,apex,apparently,arranged,attenuate,axe,axillary,base,bead,berry,blue-violet,brownish,bud,cell,chartaceous,ciliate,cm,condition,conical,corolla,covering,densely,diameter,distal,drying,elliptic,especially,filament,flower,forked,fresh,fruit,generally,glabrous,green,greenish,hair,half,herb,interjected,lanceolate,lateral,leaf,leaflet,less,light,like,lobe,long,make,margin,medium,membranous,minute,mm,moniliform,mottled,mucilaginous,multiple,narrow,necklace,odd-pinnate,orbicular,ovate,ovoid,pale,pedicel,peduncle,perfect,petiole,plant,plurifoliate,pubescent,purple,rarely,ray,ripe,seed,semierect,sessile,shorter,size,slightly,somewhat,sparsely,stem,stigma,stolon,straight,subsessile,subtending,tall,terminal,testal,thick,tip,tri-,tube,tuber,typically,usually,violet,wall,wet,white,whitish,wide,wing,x	1-3,1.5-3,5-merou,ag,alyx,articulated,asymmetrical,basiscopic,blade,capitat,commonly,connivent,decreasing,digestion,dorsally,eaf,edge,eed,enzyme,erec,exceeding,flat,folded,geminat,glabrou,gradually,green-white,hair-like,homostylous,honeycomb-shaped,larger,lengthening,living,lower,middle,nflorescence,orolla,pair,pentagonal,petiolule,pore,poricidal,proximal,removed,rotate,ruit,secondary,seudostipule,side,slit,spaced,specimen,stamen,ste,subequal,symmetrical,tamen,tem,throughout,tissue,tyle,unit,yellow,ympodial	'hair-like,appearance,arrangement,bark,border,branch,calyx,capitate,characteristic,colour,corrugation,erect,exertion,form,fruiting,geminate,giving,glabrousnes,growth,height,history,inflorescence,length,life,lobing,mentioned,midpoint,new,number,ovary,per,prickle,primary,pseudostipule,shape,style,surface,texture,thicknes,type,variation,vein,width
190	wfo-0001028014	success	222	224	183	39	41	0.824	-0.5,-1,-1/2,-10,-15,-2.5,-3,-4,-5,-6,.5,/5,0,0.1-0.2,0.15,0.15-0.3,0.2,0.2-0.4,0.2-1,0.2-1.6,0.3-0.4,0.5,0.5-1,0.5-1.5,0.5-3,0.6-0.9,0.7-1,0.7-1.6,0.9-1.2,1-,1-10,1-2,1-3,1-4,1.3-2.4,1.5,1.5-2,1/4,1/4-2/3,2,2-20,2-3,2-4.5,2-6.5,3-10,4-10,4.5-7,5-merous,6-10,6-11,abaxially,ame,anther,apart,apex,apically,apparently,articulated,bark,base,berry,blade,branched,broad-deltate,brown,brown-green,c.,calyx,chartaceous,cm,concolorous,connivent,cordate,curved,deltate,densely,diameter,difoliate,discolorous,distance,drying,elongating,equal,erect,extending,eye,filament,flattened,flower,free,fruit,fruiting,glabrescent,glabrous,gland,globular,gray,gray-green,herbaceous,infructescence,lateral,leaf,length,lobe,lobed,long,longer,lower,margin,mature,maturity,mauve,membranous,midpoint,midvein,mm,moderately,naked,obtuse,occasionally,older,one,open,orange,ovate,pair,pale,pedicel,peduncle,per,pericarp,petiole,poricidal,porrect,portion,prickle,prickly,primary,purple,ray,red,reduced,reflexed,rounded,scandent,seed,sessile,shorter,shrub,side,simple,slender,smooth,sometimes,spaced,spherical,spreading,stalk,stalked,stellate,stellate-pubescent,stem,straight,strongly,style,surface,tapering,terete,terminal,tertiary,time,tip,trichome,tube,unit,vein,venation,visible,way,weakly,wide,yellow,yellow-green	0.25,0.5-2,1.8-3,2.5-4,acuminat,almost,alyx,apar,around,black,cell,decurrent,eaf,edge,eed,flattened-reniform,geminat,glabrou,lon,nflorescence,orange-gra,orolla,oung,outer,outline,pendulous,perfec,pit,prickl,raised,rough,ruit,scar,shiny,tamen,vary,visibly,winged,ympodial	appearance,arrangement,border,branch,bud,characteristic,colour,corolla,corrugation,distal,exertion,form,geminate,giving,glabrousnes,growth,height,history,inflorescence,interjected,leaflet,life,lobing,new,number,orange-gray,ovary,perfect,plant,pseudostipule,shape,size,stamen,stigma,sympodial,texture,thicknes,type,variation,width,young
191	wfo-0001028017	success	158	165	109	49	56	0.69	-2.5,0.3-1,1-3,1.5-2,10-22,13-40,15-35,15-50-flower,2,2-3,2-4,2.5-5,3,3-12,3-14,3-4,40-50,5-7,5-9,6-8,abaxially,acuminate,acute,adaxially,apart,apex,apiculate,articulated,axe,basal,base,beyond,blade,brown,calyx,clavate,cm,connivent,cuneate,cylindrical,densely,diameter,eglandular,eglandular-puberulent,eglandular-pubescent,ellipsoidal,elliptic,entire,exserted,flattened,fleshy,flower,forked,fruit,fusiform,glabrous,glandular,glandular-,glandular-puberulent,green,greenish,hair,immature,lanceolate,leaving,lobe,long,margin,mm,moderately,narrowly,near,oblique,obtuse,ovate,ovoid,pedicel,pedicellar,peduncle,perfect,petiole,pointed,pubescent,radiu,rarely,remnant,ripe,short-acuminate,simple,small,sometimes,sparsely,stamen,stigma,style,subcoriaceous,time,tip,tree,truncate,tube,unbranched,unit,vein,white,wide,without,x,yellow	1,1-10,1-2,3-foliat,5,6-7,9-11,absen,absent,aggregate,ape,cell,chartaceous,ciliat,connective,cream,directed,distally,eaf,eed,exceeding,introrse,lon,lower,nflorescence,nther,orolla,pore,puberulen,purple,purplish,rachi,ruit,shorter,slightly,spaced,stellate,stellate-campanulate,stone,tal,tan,tem,thecae,tomentose,triangular,truncat,ud,vary,ympodial	3-foliate,anther,appearance,arrangement,bark,border,branch,bud,characteristic,colour,corolla,corrugation,distal,drying,exertion,filament,form,fruiting,giving,glabrousnes,growth,height,history,inflorescence,interjected,lateral,leaf,leaflet,length,life,lobing,midpoint,new,null,number,ovary,per,plant,prickle,primary,pseudostipule,puberulent,ray,seed,shape,size,stem,surface,sympodial,tall,terminal,texture,thicknes,type,variation,width
192	wfo-0001028033	success	157	161	114	43	47	0.726	.6,1.4â1.8,1â4,1â5,2â3,3,3â11,3â4,3â5,4â12,4â5,50,5â7,6â12,acuminate,acute,along,anther,apex,ascending,attenuate,base,becoming,blade,branch,brochidodromous,brown,calyx,cell,chartaceous,ciliate,cm,connivent,cylindrical,cyme,darker,decurrent,deeply,densely,denser,diameter,discolorous,drying,elliptic,entire,equal,eye,few-branched,filament,flower,fruit,glabrescent,glabrous,green,greenish,growth,herb,high,hispid-pubescent,known,lateral,length,light,like,linear-lanceolate,lobe,lobed,long,margin,midrib,mm,naked,nearly,new,oblong,older,onto,order,ovate-lanceolate,pedicel,petiole,prominent,pubescence,pubescent,rhizomatous,secondary,sessile,shiny,shrub,simple,slightly,solitary,sparsely,spreading,stellate,stem,stigma,straight,style,surface,trichome,tube,unbranched,uniseriate,unknown,upright,vein,venation,visible,white,wide,woody,yellow,Ã	1.5,2â4,2âfoliate,5-merou,abaxially,adaxiall,adaxially,alyx,anthesi,ark,capitat,contiguou,cordate,directed,eaf,eed,emarginate,florescence,geminat,introrsely,know,longitudinal,lower,mainly,membranaceous,opening,orolla,perfect,pore,poricidal,prostrat,recurved,ruit,shin,shorter,slit,strongly,subapical,tamen,tem,unit,vary,ympodial	2-4,appearance,arrangement,bark,border,bud,capitate,characteristic,colour,contiguous,corolla,corrugation,distal,exertion,form,fruiting,giving,glabrousnes,height,history,inflorescence,interjected,leaf,leaflet,life,lobing,mentioned,midpoint,number,ovary,peduncle,per,plant,prickle,primary,prostrate,pseudostipule,ray,seed,shape,size,terminal,texture,thicknes,type,variation,width
193	wfo-0001028067	success	139	128	80	59	48	0.576	0.5-1.5,0.5-2,1-7,10-25,2,2-2.5,2-3,2.5-3,3-17,3-4,3-5,3-7,5-7,6-12,7-11-compound,7-20,7-9,8-13,abaxially,acuminate,acute,adaxially,along,apex,axe,base,calyx,cm,compound,connivent,cuneate,dark,diameter,elliptic-fusiform,elliptic-ovate,entire,especially,flattened,flower,fruit,glabrous,hair,lateral,leaf,leaflet,lobe,margin,midrib,mm,narrowly,nearly,obtuse,often,pedicel,peduncle,per,petiole,pink,pinnately,puberulent,purple,ripe,shrub,simple,sparsely,stigma,strongly,style,subcoriaceous,tip,tomentulose,triangular,triangular-deltate,truncate,tube,unbranched,unequal,usually,x,yellow	-30,0.5-1,1,1-10,1-11,1-2,1-3,1.5-2.5,4-foliat,6-18,adaxiall,aggregate,apart,articulated,basiscopically,blade,cell,chartaceous,color,cylindrical,decurrent,directed,distall,eaf,eed,glabrou,leaving,lon,long,lower,moderately,nflorescence,nther,orolla,pedicellar,pore,puberulen,rachi,radiu,rarely,remnant,ruit,several,slightly,smal,spaced,stellate,stone,tal,tem,time,truncat,unit,unknown,upper,vary,wide,ympodial,zigzag	anther,appearance,arrangement,bark,border,branch,bud,characteristic,colour,corolla,corrugation,distal,drying,exertion,filament,form,fruiting,giving,glabrousnes,growth,history,inflorescence,interjected,length,life,lobing,mentioned,midpoint,new,number,ovary,prickle,primary,pseudostipule,ray,seed,shape,size,stem,surface,tall,terminal,texture,thicknes,type,variation,vein,width
194	wfo-0001028069	success	253	232	199	54	33	0.787	-30,.1,.1-0.2,.2,.5,0.05-0.1,0.1-0.15,0.1-0.2,0.1-0.3,0.1-0.5,0.2-0.5,0.3,0.3-0.4,0.3-0.45,0.3-0.6,0.3-1,0.4,0.4-0.5,0.4-0.8,0.4-1,0.5-1.8,0.5-2,0.6-1.1,0.6-4,0.7-1,0.7-1.5,0.8-1.2,1-2-celled,1-2.7,1-3.5,1-4.5,1.4,1.5-2.0,1.6-3.2,10,10-12,10-30,12,2-17,2-3-branched,2-4,2-7,2-locular,3,3-,5-22,5-25,6-,abaxially,abundant,accrescent,acute,adjacent,adpressed,alternate,always,among,anther,anthesi,apex,appearance,appressed,basal,base,basioscopically,becoming,berry,bilaterally,bract,bracteole-like,bright,brown,calyx,cell,citru,cm,composed,conical,cordate,corolla,cuneate,decurrent,deep,deeply,dense,densely,diameter,due,ebracteate,erect,exserted,filament,flower,forming,fruit,fruiting,fusion,giving,gland,gland-tipped,glandular,globose,green,hair-like,half,halfway,herb,imparipinnate,initially,interjected,interrupted,larger,later,lateral,leaf,leaflet,length,like,lime,linear,lobe,lobed,long,longer,longest,margin,maturity,minute,mm,multicellular,narrowly,oblique,obovate,occasionally,often,one,orange,outgrowth,ovary,ovate,pair,pale,pedicel,peduncle,pentagonal,per,perennial,petiole,petiolule,plant,population,present,primary,procumbent,pseudostipule,pubescence,pubescent,quaternary,robust,rounded,scarcely,scent,secondary,sessile,several,shaggy,short,shorter,silky,simple,single-celled,size,slender,smaller,somewhat,stem,stigma,straight,strong,style,subopposite,surface,symmetric,terminal,tertiary,testa,thick,tightly,trichome,tube,unicellular,uniseriate,usually,varying,viny,wall,wide,winged,yellow	-0.4,-6,0.1-0.6,0.2-0.3,0.3-0.7,0.5,0.5-0.7,0.7-1.3,1.5-3.5,3-foliate,4-celled,<,absen,along,apical,appendage,articulated,axi,ba,column,cone-shaped,curving,eaf,edicel,eed,eglandular,glabrescent,gland-tippe,glandular-villous,gree,head,included,internode,less,lon,lower,middl,midvein,minutely,nflorescence,patent,rarely,reflexed,ruit,staminal,sterile,tangled,tem,toward,transparent,ud,unit,weak,ympodial	arrangement,bark,border,branch,bud,characteristic,colour,corrugation,distal,drying,exertion,form,glabrousnes,growth,height,history,inflorescence,life,lobing,midpoint,new,null,number,prickle,ray,seed,shape,texture,thicknes,type,variation,vein,width
195	wfo-0001028075	success	196	199	152	44	47	0.776	.5,1-10,1-2,1-2.7,1-3,1.5-2.5,1.5-7,1.6-2.7,10-35,2-4.5,2-6,2.5-10,3-11,3-23.5,4-12,4-7,5-12,5-14,5-17,5-7,5-8,5-9,7-13,7-30,8-12,abaxially,absent,acuman,acuminate,acute,adaxially,along,anther,apart,apex,apparently,articulated,axe,axillary,base,berry,blade,borne,broadly,brownish,bud,cell,chartaceous,ciliate,cm,condition,connivent,corolla,covering,cuneate,dark,decreasing,diameter,differentiated,distal,distally,distinctively,dot,drying,elliptic-lanceolate,end,exceeding,filament,flower,forked,fresh,fruit,generally,glabrescen,glabrescent,glabrous,globose,green,green-white,greenish,half,herb,interjected,lanceolate,larger,lateral,leaf,leaflet,light,ligulate,lobe,long,make,margin,membranous,midrib,mm,much,mucilaginous,narrow,oblique,obtuse,odd-pinnate,often,ovate,ovate-elliptic,ovoid,pair,pale,pedicel,peduncle,perfect,petiole,petiolule,plant,plurifoliate,purple,reflexed,rounded,scattered,seed,seudostipule,singly,size,slightly,sometimes,spaced,stamen,star,stigma,straight,style,subcordate,subtending,terminal,testal,thick,throughout,toward,tri-,tube,tuber,typically,unit,usually,wall,wet,white,whitish,wide,wing,x	2-3,5-merou,acumen,ag,alyx,capitat,digestion,dorsally,eaf,edge,eed,enzyme,erec,especially,flat,folded,geminat,hair-like,homostylous,honeycomb-shaped,lengthening,living,lower,middl,minutely,nflorescence,orolla,pentagonal,pore,poricidal,puberulent,removed,rotate,ruit,slit,specimen,stolo,tall,tamen,tem,tip,vary,yellow,ympodial	'hair-like,appearance,arrangement,bark,border,branch,calyx,capitate,characteristic,colour,corrugation,erect,exertion,form,fruiting,geminate,giving,glabrousnes,growth,height,history,inflorescence,length,life,lobing,mentioned,middle,midpoint,new,number,ovary,per,prickle,primary,pseudostipule,ray,shape,stem,stolon,surface,sympodial,texture,thicknes,type,variation,vein,width
196	wfo-0001028076	success	195	182	137	58	45	0.703	.5,0.4-0.5,0.5,1-1.3,1-10,1-2,1-3,1.2-2.2,1.8-2.2,110,12-22,13-14,2-12,2-3,2-5.4,2.2-2.6,2.2-3.7,2.5-4,2.6-3.8,4-5,4.5-7,5,5-20,5-6,5-6.5,7-8,abaxially,absent,acumen,acuminate,adaxially,anther,apart,apex,apparently,articulated,attenuate,axe,axillary,base,berry,blade,borne,brownish,bud,cell,cm,condition,conical,connivent,corolla,covering,decreasing,densely,diameter,distal,drying,elliptic,end,filament,flower,forked,fresh,fruit,generally,glabrous,gradually,green,greenish,hair,half,herb,interjected,lanceolate,larger,lateral,leaf,leaflet,less,light,like,lobe,long,make,margin,medium,minute,mm,mucilaginous,odd-pinnate,ovate,ovoid,pair,pedicel,peduncle,perfect,petiole,plant,plurifoliate,proximal,pubescent,purple,rarely,ray,ripe,seed,semierect,sessile,singly,size,slightly,stem,stigma,straight,style,subequal,subsessile,subtending,symmetrical,terminal,testal,thick,toward,tri-,tube,tuber,typically,unit,unwinged,usually,wall,wet,white,whitish,wide,wing,x	2.5-3,5-merou,?,ag,alyx,capitat,chartaceous,ciliate,digestion,dorsally,eaf,edge,eed,enzyme,erec,especially,exceeding,flat,folded,geminat,glabrou,green-white,hair-like,homostylous,honeycomb-shaped,lengthening,living,lower,membranous,nflorescence,obtuse,orolla,pentagonal,petiolule,pore,poricidal,pubescen,removed,rotate,round,ruit,secondary,seudostipule,slit,spaced,specimen,stamen,ste,stolo,tall,tamen,tem,thir,throughout,tip,vary,yellow,ympodial	'hair-like,appearance,arrangement,bark,border,branch,calyx,capitate,characteristic,colour,corrugation,erect,exertion,form,fruiting,geminate,giving,glabrousnes,growth,height,history,inflorescence,length,life,lobing,mentioned,midpoint,new,number,ovary,per,prickle,primary,pseudostipule,shape,stolon,surface,sympodial,texture,thicknes,third,type,variation,vein,width
197	wfo-0001028105	success	150	172	127	23	45	0.847	.1,.5,0.3-1.5,0.5,0.5-1,0.5-2,0.6-1,1-1.2,1-1.5,1-2.5,1.5,1.5-1.8,1.5-2,1.5-4.5,2,2-2.2,2-5,3-5-celled,3-6,3.5-4,5-7-flowered,6-7,9.5-15,abaxially,acuminate,adaxially,anther,anthesi,apex,apical,attenuate,axi,axil,bark,base,berry,bilobed,calyx,clavate,cm,conical,corolla,dark,deflexed,dense,dia,differing,difoliate,distinct,drying,ellipsoid,elliptic,erect,exserted,filament,filiform,flattened-reniform,free,fruiting,glabrous,glandular,globose,green,incrassate,lamina,lateral,leaf,lobe,lobed,long,main,major,margin,middle,minor,minutely,mm,nearly,occasionally,olive-green,opposite,ovary,pair,pale,papillose,pedicel,petiole,pitted,planar,pore,poricidal,portion,projection,pubescent,quadrate,reddish-brown,reflexed,scattered,shaped,shrub,simple,size,slightly,small,sparsely,spreading,stem,stigma,straight,strongly,style,surface,tall,tear-drop,tip,tree,trichome,tube,tuft,uniseriate,vein,white,widest,woody,x,yellowish,young	.4,acute,apar,ba,eaf,edicel,eed,evenly,geminat,greenish-yello,like,lon,lower,nflorescence,older,papillo,ruit,scar,spaced,tub,ud,unit,ympodial	apart,appearance,arrangement,border,branch,bud,characteristic,colour,corrugation,diameter,distal,exertion,form,fruit,giving,glabrousnes,greenish-yellow,growth,height,history,inflorescence,interjected,leaflet,length,life,lobing,midpoint,new,null,number,peduncle,per,plant,prickle,primary,pseudostipule,ray,seed,shape,terminal,texture,thicknes,type,variation,width
198	wfo-0001028109	success	205	229	187	18	42	0.912	-20,-4,-7,.5,/3,0.05-0.15,0.05-0.2,0.1,0.1-0.2,0.3,0.4-0.8,0.4-1.5,0.45-0.65,0.5-1.2,0.5-2.5,0.6-0.8,0.7,0.8-1.5,0.8-1.6,1.5-10,1.5-2.5,1.5-5.5,1/8-1/4,10-25,10-30,12-40,15-100,2-15,2-4,2.3-2.9,2.5-3,2.5-5,2/3-3/4,20-60,3-,3-7,3.5-6,3/4,30-150,4-13,4-5-merous,5-13,5-30,8-12,8-15,8-25,abaxial,abaxially,acuminate,acute,adaxial,almost,ame,anther,apart,apex,apically,apparently,articulated,bark,base,berry,blade,branching,bright,c.,calyx,chartaceous,cm,connivent,cuneate,curved,deltate,densely,diameter,dimorphic,discolorous,drying,dull,elliptic,elongating,entire,equal,erect,evenly,filament,flattened-reniform,flower,free,fruit,fruiting,fully,geminate,gently,glabrescent,glabrous,gray-green,green,green-brown,infructescence,lateral,leaf,length,light,lobe,lobed,long,long-styled,longer,lower,margin,mature,maturity,mauve,midpoint,minor,mm,moderately,multangulate,obtuse,occasionally,older,one,open,opening,orange-brown,pair,pedicel,peduncle,per,pericarp,perpendicular,petiole,poricidal,porrect,portion,prickle,prickly,primary,ray,recurved,red,red-brown,reflexed,scar,secondary,sessile,shrub,simple,slender,small,smooth,sometimes,spaced,spherical,spreading,stalk,stalked,stellate,stellate-pubescent,stem,straight,strongly,style,surface,tapering,terete,terminal,tertiary,time,tip,tree,trichome,tube,unarmed,unit,usually,vein,venation,visible,way,weakly,white,wide,woody,yellow,young	acut,alyx,apar,brow,eaf,eed,glabrou,nflorescence,orolla,oung,perfec,plurifoliat,prickl,ruit,tamen,unarme,vary,ympodial	appearance,arrangement,border,branch,brown,bud,characteristic,colour,corolla,corrugation,distal,exertion,form,giving,glabrousnes,growth,height,history,inflorescence,interjected,leaflet,life,lobing,new,null,number,ovary,perfect,plant,plurifoliate,pseudostipule,seed,shape,size,stamen,stigma,sympodial,texture,thicknes,type,variation,width
199	wfo-0001028115	success	165	182	128	37	54	0.776	-1.1,-5.2,.2,.6,0.42,0.8-,1-2.4,1-3,1.1-1.8,1.3-1.8,1.4-1.7,1.7-2.2,1.8-3.5,12-13.5,2-,2-3.2,2.5-,3-4.5,3-5,3-6.5,5-15,6-10,7-7.5,9-17,abaxially,abundant,accrescent,acute,adaxially,alternate,amply,anther,antrorse,apex,articulate,attenuate,basal,base,berry,blade,blue,calyx,capitate,cm,connectival,curved,diameter,dorsal,ellipsoidal,elliptical,entire,especially,evident,exceeding,filament,fruiting,glabrescent,glabrous,glandular,globose,growing,half,herb,herbaceous,inflated,length,light,linear,lobe,long,longer,longitudinally,margin,mixed,mm,moderately,much,narrowly,near,nerve,non-glandular,oblong,one,opposite,ovate,pair,pale,papery-scarious,petiole,pinnatifid,pinnatipartite,pinnatisect,prolongation,prostrate,pubescent,rarely,reticulate,ridged,scarce,seed,segment,similar,simple,slender,slightly,small,smooth,sometimes,stem,stigma,strongly,style,time,trans-ovoidal,triangular,trichome,tube,tuberculate,unequal,uniseriate,venation,violet,wide,wider,width,winged,x,yellow	-2.5,0.2-0.3,0.5,0.6-0.7,0.7-0.8,4.7-,5-8.5,acuminat,ag,annular,campanulate,coat,difoliat,eaf,eed,embryo,hig,longitudinal,lower,multi-seeded,opening,orolla,papillo,pore,poricidal,portion,ree,ruit,slit,styl,subsessil,tem,tip,unifoliate,unit,vary,ympodial	0.7-,0.8-0.85,acuminate,appearance,arrangement,bark,border,branch,bud,characteristic,colour,corolla,corrugation,distal,drying,exertion,form,fruit,giving,glabrousnes,growth,height,history,inflorescence,interjected,lateral,leaf,leaflet,life,lobing,midpoint,new,null,number,ovary,papillose,pedicel,peduncle,per,plant,prickle,primary,pseudostipule,ray,shape,size,subsessile,surface,terminal,texture,thicknes,type,variation,vein
200	wfo-0001028131	success	208	208	168	40	40	0.808	-1.2,.5,/5,0-0.6,0-2,0-3,0-30,0-4,0.05-0.2,0.1-0.15,0.1-0.3,0.2-1.5,0.3-0.7,0.4-0.8,0.5-1.1,0.7-1.1,0.8-1,0.8-1.1,1-10,1-3,1-5,1.5-3,1.5-5,1.8-2,1.8-2.2,1/5,2-2.8,2-4,2-5,2-6.5,2/3,3-6,4-6,5-6.5,5-8,6-7,abaxial,absent,adaxial,anther,apart,apex,apically,apparently,articulated,attenuate,bark,base,berry,blade,branched,broad-deltate,calyx,cell,chartaceous,cm,concolorous,connivent,cream,curved,dark,deltate,densely,diameter,distance,drying,dull,epidermi,equal,erect,extending,filament,filiform,flattened,flattened-reniform,flower,free,fruit,fruiting,glabrescent,glabrous,gland,green,herb,infructescence,lateral,leaf,length,like,lobe,lobed,long,longer,margin,marking,maturity,mauve,membranous,midpoint,midvein,mm,narrow-obovate,narrow-ovate,oblong,obtuse,often,older,one,open,orange,orange-brown,outline,pair,pale,pale-brown,pedicel,peduncle,pendulous,per,petiole,pit,poricidal,porrect,portion,prickle,prickly,primary,purple,raised,ray,red,reduced,rounded,sessile,shiny,shorter,side,simple,small,smooth,sometimes,spaced,sparsely,spherical,spreading,stellate-pubescent,stem,straight,strongly,style,sunk,surface,tapering,terete,time,tip,trichome,tube,unarmed,upper,vein,visible,way,wide,woody,yellow,yellow-green,young	.1,1-4,1/4-2/3,5-merous,7-8,abaxially,acuminat,alyx,apar,difoliate,eaf,eed,elongating,eye,geminat,lanceolate,lengt,lower,mature,moderately,naked,nflorescence,orolla,oung,pale-gra,perfec,pericarp,prickl,reflexed,ruit,scar,sessil,stellate,tamen,tertiary,unarme,unit,vary,venation,ympodial	acuminate,appearance,arrangement,border,branch,bud,characteristic,colour,corolla,corrugation,distal,exertion,form,giving,glabrousnes,growth,height,history,inflorescence,interjected,leaflet,life,lobing,mentioned,new,number,ovary,pale-gray,plant,pseudostipule,seed,shape,size,stigma,terminal,texture,thicknes,type,variation,width
201	wfo-0001028148	success	157	159	105	52	54	0.669	-6,.5-4,0.25-0.5,0.5-1.5,0.6-3.5,0.75-2,1-3.5,1.5,1.5-2.5,12-15,15,2-3,2.5-4,20-50,3.5-4,3.5-9,4-10,4.5-10,5,5-10,5-20,5-7,5-8,6-18,acute,angled,apex,apiculate,base,blade,blue-black,branched,broadly,calyx,central,cm,cylindrical,dark,decurrent,deltate,densely,diameter,distal,elliptic,entire,fleshy,flower,fresh,fruit,glabrous,glaucous,globose,hair,highly,less,light-colored,lobe,long,margin,material,mature,midrib,minute,mm,moderately,narrowly,obtuse,often,ovate,pedicel,peduncle,petiole,pink,puberulent-pubescent,purple,radiu,rarely,rhizomatous,ridge,ripe,scalloped,shrub,simple,slender,smooth,sometimes,star,stigma,style,succulent,surface,tapered,thickened,time,treelet,triangular,tube,unbranched,usually,violet,white,whitish,wide,x,young	1-15,10-30,2,2-7,abaxially,absen,adaxially,aggregate,apart,articulated,axe,ba,cell,chartaceous,connivent,directed,distall,eaf,eed,especially,except,lower,many-foliat,margi,nflorescence,nther,orange,orolla,part,perfect,plicae,plicate,pore,puberulence,puberulent,rachi,rotate-stellate,ruit,slightly,smoot,spaced,sparse,stone,tal,tem,tip,truncat,unit,vary,winge,yellow,ympodial	anther,appearance,arrangement,bark,border,branch,bud,characteristic,colour,corolla,corrugation,drying,exertion,filament,form,fruiting,giving,glabrousnes,growth,height,history,inflorescence,interjected,lateral,leaf,leaflet,length,life,lobing,many-foliate,mentioned,midpoint,new,number,ovary,per,plant,prickle,primary,pseudostipule,ray,seed,shape,size,stem,tall,terminal,texture,thicknes,truncate,type,variation,vein,width
202	wfo-0001028161	exception_thrown	124	0	0	124	0	0.0		.5,0.1-0.25,0.25-0.5,0.7-1.7,1-1.3,1-1.5,1-2,1-2.3,1.5-4.5,1/3,2-5-flowered,2-9,2.5-3,3-4,3-7,4-5,6-9,7.5-12,9-11,abaxially,acuminate,acute,adaxially,along,anthesi,apex,arising,attenuate,ba,bark,base,berry,branch,branched,brown,calyx,cell,closely,cm,congested,consisting,corolla,deflexed,dendritic,densely,denser,dia,differing,difoliate,distal,eaf,edicel,eed,elliptic,exserted,fruiting,geminat,glabrescen,globose,green,incrassate,inflorescenc,lanceolate,later,lateral,leaf,like,lon,long,main,major,margin,middle,minor,minutely,mm,narrowly,nflorescence,obovoid,often,older,opposite,orbicular,outline,overlappin,ovoid-reniform,pair,pale,pedicel,petiole,pitted,probably,pubescence,pubescent,reddish-brown,rest,rounded,ruit,scar,shape,short,shrub,simple,sinuate,size,somewhat,spaced,sparsely,stem,strongly,surface,tall,tan,tapering,thin,trichome,tub,ud,unit,vein,widest,x,ympodial,young	
203	wfo-0001028164	success	197	206	183	14	23	0.929	-1,-14,-6,-8,/4,0-20,0.05-0.2,0.05-1.5,0.1,0.3-0.8,0.4-0.8,0.5-0.8,0.5-1,0.7-1.1,0.8-1.5,0.9-1.6,1,1-1.5,1-4.5,1.5-2.5,1.8-2.5,1/3,1/6-1/4,12-20,2-2.5,2.5-4,2.5-4.5,2.8-4,3-17,3-7,3.6-4.8,4-13,4-5-merous,4-7,4-8,6-8,8-15,8-17,abaxial,abaxially,acuminate,acute,almost,alyx,ame,anther,apar,apex,apically,apparently,articulated,attenuate,bark,base,berry,blade,branched,bright,c.,calyx,cm,concolorous,connivent,curved,dark,deltate,densely,diameter,difoliate,drying,dull,elliptic,elongating,entire,equal,erect,evenly,eye,filament,filiform,flattened-reniform,flower,free,fruit,fruiting,glabrescent,glabrous,glandular,gray,green,hair,infructescence,lateral,leaf,length,less,lobe,lobed,long,long-acuminat,longer,lower,margin,mature,maturity,mauve,membranous,midpoint,midvein,minute,mm,moderately,multangulate,naked,narrow-deltate,obtuse,often,older,one,open,orange-brown,orolla,pair,pale,pedicel,peduncle,per,perfec,pericarp,petiole,poricidal,porrect,portion,primary,ray,recurved,red,red-brown,scar,sessile,shallowly,shorter,shrub,side,simple,smooth,sometimes,spaced,sparsely,spherical,spreading,stalk,stalked,stellate,stellate-pubescent,stem,straight,style,surface,tapering,terete,terminal,tertiary,time,tip,trichome,tube,unarmed,undulate,unit,upper,variously,vary,vein,venation,visible,way,white,wide,woody,yellow,yellow-green,young	eaf,eed,geminat,glabrescen,glabrou,nflorescence,oung,reflexe,ruit,shorte,tamen,unarme,yellow-gra,ympodial	arrangement,branch,characteristic,colour,corrugation,form,geminate,glabrousnes,growth,height,history,inflorescence,life,new,plant,reflexed,seed,shape,size,stamen,sympodial,texture,yellow-gray
204	wfo-0001028180	success	147	169	121	26	48	0.823	.05,.5,/2,0.7-1,1-1.2,1-1.5,1-1.8,1-3,1.5-5,15-28,2-2.2,2-3,2.5-3,20-30-flowered,3-10,3-4,4.5-5,5-6,5-8,7,8-10,abaxially,acute,adaxially,along,anther,anthesi,apex,attenuate,bark,base,beginning,berry,c.,calyx,capitate,closely,cm,conical,corolla,dark,deltate,dia,differing,difoliate,distinctly,drying,elliptic,elongate,erect,falcate,filament,fleshy,four-angled,free,fruiting,glabrous,globose,gold,golden,green,irregularly,larger,lateral,leaf,lobe,lobed,long,main,major,margin,midrib,minor,minutely,mm,nearly,obscure,older,onto,opposite,ovary,ovoid-reniform,pair,pale,papillose,pedicel,petiole,pinkish-white,pitted,planar,portion,puberulent,pubescent,scar,shaped,shiny,simple,size,small,somewhat,spaced,sparsely,stem,stigma,style,surface,tan,tear-drop,tip,tree,trichome,tube,underside,uniseriate,vein,way,white,winged,x,yellow-gray,young	ba,cucullate,darker,deflexed,densely,eaf,eed,geminat,glabrat,know,leathery,lon,lower,nflorescence,overlappin,pore,poricidal,ruit,straight,styl,tall,thick,ud,unit,woody,ympodial	3,appearance,arrangement,border,branch,bud,characteristic,colour,corrugation,diameter,distal,exertion,form,fruit,geminate,giving,glabrate,glabrousnes,growth,height,history,inflorescence,interjected,known,leaflet,length,life,lobing,midpoint,new,null,number,overlapping,peduncle,per,plant,prickle,primary,pseudostipule,ray,seed,shape,terminal,texture,thicknes,type,variation,width
205	wfo-0001028182	success	150	173	128	22	45	0.853	0-90,0.1-0.2,0.5-0.6,0.5-1,0.8-1,0.9-1,1-1.5,2,2-2.5,2-6.5,3,3-5,4-6,5-15-flowered,5-ribbed,6-9,anther,anthesi,apart,apex,apiculate,arching,axi,bark,base,bending,beneath,black,blade,branch,brown,calyx,capitate,ciliate,cm,conical,cordate,corolla,deflexed,deltoid,dia,dry,ellipsoid,evenly,except,extreme,filament,filiform,flower,free,glabrous,globose,hemiepiphyte,inflorescence,internodal,keeled,known,later,lateral,lax,leaf,like,lobe,lobed,long,long-acuminate,main,margin,material,midrib,minutely,mm,narrowly,nearly,obovoid,older,opposite,ovary,ovate,pair,papillose,pedicel,petiole,planar,pore,poricidal,portion,present,prominent,proximal,pubescent,purplish,reflexed,rib,rounded,scar,shaped,shiny,shrub,simple,slender,slightly,somewhat,spaced,sparsely,sparser,specimen,spindly,stem,stigma,still,strongly,style,surface,tear-drop,third,time,tip,trichome,truncate,tube,uniseriate,vein,white,widest,x,young,zig-zag	.5,0.5,along,apiculae,densely,eaf,edicel,eed,gre,know,less,lower,minute,nflorescence,papillo,ruit,sca,tapering,ud,unifoliat,unit,ympodial	appearance,arrangement,border,bud,characteristic,colour,corrugation,diameter,distal,drying,exertion,form,fruit,fruiting,giving,glabrousnes,grey,growth,height,history,interjected,leaflet,length,life,lobing,mentioned,midpoint,new,number,peduncle,per,plant,prickle,primary,pseudostipule,ray,seed,shape,size,terminal,texture,thicknes,type,variation,width
206	wfo-0001028183	success	237	225	181	56	44	0.764	-10,-5.3,.5-3,0.1,0.1-0.2,0.1-0.4,0.1-0.9,0.2-0.3,0.2-0.5,0.5,0.5-2.5,0.6,0.7-1.2,0.7-2,0.8-1.4,0.8-3.1,1.1-1.8,1.2-1.4,1.3-1.7,1.4-2.8,1.5-3.4,1.7-2.7,1.9-3.7,1/3-1/2,10-15,11-30,2-4.2,2-5,2.2-5.7,2.5-4.1,2.8-4.2,3.2-,3.5-6.6,4.5-9,4.6-6.4,5-8,5.2-6.2,50-400,6.6-20,7.5-23,9-13,abaxially,accrescent,acute,adaxially,along,anther,anthesi,apart,apex,articulated,attenuate,axi,axillary,bark,base,berry,blade,blunt-tipped,branch,branched,bud,calyx,capitate,cell,central,closely,cm,corolla,cuneate,cylindrical,deltoid,dendritic-multangulate,diameter,distantly,drying,dull,elliptic,elongated,entire,epidermal,especially,except,exserted,few-rayed,filament,flower,fruit,fruiting,glabrescent,glabrous,globose,granular-punctate,group,hair,half,high,lanceolate,lateral,leaf,lobe,lobed,long,long-decurrent,lower,main,many,margin,midrib,mm,multangulate,narrowly,nearly,oblong,obovoid,older,orangish-tan,pedicel,peduncle,petiole,plurifoliate,porrect-stellate,present,prominent,pseudoterminal,pubescence,pubescent,purple,rachi,relatively,reticulate-punctate,ripe,scabrous,sessile,short,short-,shrub,side,simple,small,somewhat,soon,spaced,sparingly,sparse,spherical,stage,stalk,stem,stigma,stipitate-glandular,stout,streak,strongly,style,sub-lenticular,subcampanulate,surface,tan,terete,thick,thin,thin-textured,time,tomentose,touching,translucent,tree,tube,unit,usually,vein,violet,way,white,whitish,wide,x,yellowish,yellowish-tomentose,young	0.2-0.4,1.3-1.4,1.6-2.3,2.6-4.4,5-8.5,8-9.1,abaxial,ag,alyx,apparently,around,brown,chartaceous,dark,directed,distally,eaf,earl,edge,eed,evident,farinose,free,glabrescen,inserted,lackin,lengthening,lon,longitudinal,m.,nflorescence,open,orolla,ovate-lanceolate,overlapping,perfec,pore,poricidal,porrect-stellat,rarely,reportedly,ruit,runk,slit,splitting,stamen,stellate,suture,tamen,tip,ud,unarme,upper,vary,yellow,ympodial	appearance,arrangement,border,characteristic,colour,corrugation,distal,exertion,form,giving,glabrousnes,growth,height,history,inflorescence,interjected,lacking,leaflet,length,life,lobing,mentioned,midpoint,new,number,ovary,per,plant,prickle,primary,pseudostipule,ray,seed,shape,size,sympodial,terminal,texture,thicknes,trunk,type,unarmed,variation,width
207	wfo-0001028227	success	236	237	193	43	44	0.818	-2/3,-6.2,.5-4,0-250,0.1,0.2,0.2-0.3,0.2-0.4,0.2-0.5,0.3,0.4,0.5,0.8-1.4,0.9,0.9-1.2,0.9-1.4,1,1-1.7,1-2.5,1-4.2,1.2-2,1.3-4,1.4,1.4-2.6,1.5-2.3,1.7-2.8,1.9,1.9-5.8,1/2,1/2-3/4,10,10-24,11-15,2-12,2-3.8,2.5-7.8,2.6-5.9,2.9-4.7,3-4.9,3.7-6.3,3.7-7,4-13,4.8-7.6,5-7.5,6-16,6.7-15,8.5-22,abaxial,abaxially,accrescent,acuminate,acute,adaxially,age,along,anther,anthesi,apex,appressed,around,attenuate,axillary,bark,base,becoming,berry,blade,blunt-tipped,branch,branched,brown,brownish,bud,c.,calyx,cm,corolla,cuneate,dark,decurrent,deltoid,dendritic-echinoid,diameter,directed,distally,drying,early,echinoid,edge,elliptic,elongate,ength,entire,exserted,farinose,filament,fleshy,flower,free,fruit,fruiting,glabrescent,glabrous,globose,granular-tomentose,gray,grayish,green,hair,inserted,lacking,lanceolate,lateral,leaf,lengthening,less,lobe,lobed,long,longitudinal,main,many,margin,midrib,midvein,mm,mostly,multangulate,oblong,oblong-lanceolate,obtuse,often,older,orangish-tan,orbicular,ovate-lanceolate,overlapping,pale,pedicel,peduncle,petiole,plurifoliate,pore,poricidal,porrect-stellate,present,prominent,pseudoterminal,pubescence,pubescent,quarter,relatively,reticulate-punctate,ripe,rounded,scabridulous,sessile,shrub,side,simple,slightly,slit,somewhat,sparsely,stalk,stem,stigma,stout,style,subcampanulate,sublenticular,subspherical,sulcate,surface,thick,thicker,thin,time,tip,tomentose,touching,tree,tube,unit,upper,vein,velutinous,way,wide,x,yellow,yellowish,young	0.7-2.1,0.8,1.1-3.1,1.9-4.2,8.1-18,ag,alyx,apart,apparently,articulated,blunt-tippe,closely,cylindrical,eaf,echinoi,eed,high,lon,lower,m.,nflorescence,obscured,occasionally,orolla,ovate-orbicula,perfec,purple,rachi,ruit,runk,spaced,stamen,stellate,suture,tamen,tomentu,ud,unarme,usually,vary,violet,well,ympodial	appearance,arrangement,border,characteristic,colour,corrugation,distal,exertion,form,giving,glabrousnes,growth,height,history,inflorescence,interjected,leaflet,length,life,lobing,midpoint,new,null,number,ovary,ovate-orbicular,per,plant,prickle,primary,pseudostipule,ray,seed,shape,size,sympodial,terminal,texture,thicknes,trunk,type,unarmed,variation,width
208	wfo-0001028228	exception_thrown	143	0	0	143	0	0.0		.5,0.1-1.7,0.75,1-1.5,1.1-1.2,1.1-2.5,1.2-1.8,1.5-2,1.8-3.4,10-30-flowered,2,2-5,2-8,2.1-4.2,2.8-6.5,3/4,6-7,6-8,7.5-12.5,abruptly,acute,age,anther,anthesi,apex,area,ba,bark,base,becoming,beginning,beneath,berry,brown,caly,calyx,campanulate,clavate,closely,cm,coriaceous,corolla,dark,deflexed,deltoid,dia,difoliate,distal,dry,eaf,edicel,eed,elliptic,erect,exserted,filament,fragrant,free,fruiting,geminat,glabrous,globose,green,greenish-yellow,impressed,inflorescenc,lateral,leaf,lobe,lobed,lon,long,lower,main,major,margin,material,middle,minor,minute,minutely,mm,narrowing,nflorescence,obovate,occasionally,older,opposite,ovary,overlapping,ovoid,ovoid-reniform,pair,pale,papillose,pedicel,petiole,planar,pore,poricidal,portion,prominent,reticulate,rounded,ruit,scar,shaped,shinin,shining,shrub,simple,slender,slightly,small,spaced,stem,stigma,straight,styl,style,surface,sweetly,tall,tapering,tear-drop,terminal,thick-margined,thickened,tip,tree,tube,ud,unit,usually,vein,way,weight,white,widest,woody,x,ympodial,young	
209	wfo-0001028263	success	156	160	110	46	50	0.705	0.25,1-2,1-3,1-4,11-13,11-23,14-44,2-3,2-4,2.6,3,3.4,3.5-4.2,4,5-7,5-7.5,6,6-8,8-14,9,abaxially,acumen,acuminate,acute,adaxially,apex,apical,apically,articulate,atenuate,base,branched,broadly,calyx,cell,cm,conical,connate,cordate,corolla,covering,cuneate,cyme,darker,deep,dehiscent,diameter,dichasial,dichasially,distal,ebracteate,elliptical,exceeding,filament,flower,forked,generally,green,green-white,half,herbaceous,interjected,introrse,lateral,leaf,leaflet,light,lobe,long,make,maturing,medium,mm,monochasial,mucilaginous,oblique,odd-pinnate,often,ovate,ovoid,pedicel,peduncle,perennial,perfect,petiole,plant,poricidally,proximal,puberulent,pubescent,seed,short,size,slit,stamen,stigma,straight,strigose,style,terminal,testal,thick,throughout,truncate,tuber-bearing,violet,wall,wide,yellow,Â¼	2,3-6-foliat,4-5,8-1.,abaxiall,digestion,diminishing,dorsally,eaf,edge,eed,emoval,enzyme,equal,first,flat,folded,globo,gradually,hair-like,honeycomb,living,lon,lower,lunat,nflorescence,nther,orolla,pair,pattern,plan,reveal,rotate,ruit,sessile,seudostipule,specimen,tal,tem,throughou,toward,two,typically,unit,vary,ympodial	'hair-like,8-19,anther,appearance,arrangement,bark,border,branch,bud,characteristic,colour,corrugation,drying,exertion,form,fruit,fruiting,giving,glabrousnes,globose,growth,height,history,inflorescence,length,life,lobing,lunate,margin,mentioned,midpoint,new,number,ovary,per,prickle,primary,pseudostipule,ray,shape,stem,surface,texture,thicknes,tube,type,variation,vein,wet,width
210	wfo-0001028280	success	87	116	63	24	53	0.724	.5,0.7-1,1-2,1-2-flowered,1.5-2.7,2-2.5,2-3,6-9,7-8,acuminate,apex,arching,attenuate,axil,bark,base,berry,branch,ciliate,cm,completely,dark,decurrent,dia,elliptic,flattened,fruiting,glabrous,globose,green,immature,known,lanceolate,lateral,leaf,long,main,margin,minutely,mm,narrowly,new,older,onto,opposite,pair,papillae,pedicel,petiole,present,rounded,shrub,simple,small,stem,surface,tall,tip,ultimate,vein,winged,x,young	almost,anthesi,ape,brow,closely,eaf,eed,know,lon,lower,middle,nflorescence,pendant,ruit,scar,sessil,somewhat,spaced,ud,unifoliat,unit,widest,woody,ympodial	anther,appearance,arrangement,border,brown,bud,calyx,characteristic,colour,corolla,corrugation,diameter,distal,drying,exertion,filament,form,fruit,giving,glabrousnes,growth,height,history,inflorescence,interjected,leaflet,length,life,lobe,lobing,mentioned,midpoint,number,ovary,peduncle,per,plant,prickle,primary,pseudostipule,ray,seed,shape,size,stigma,style,terminal,texture,thicknes,tube,type,variation,width
211	wfo-0001028281	success	267	242	210	57	32	0.787	+,-0.9,-1,-10,-20,-3,-36,-45,-5,-7,-8,.2,0.05-0.4,0.1-0.15,0.15-0.2,0.2-0.3,0.2-0.5,0.2-0.7,0.3-1,0.5-0.7,0.5-1,0.5-1.1,0.5-1.2,0.7-1.2,0.7-2.5,0.75-1,1,1-,1-1.5,1-3,1-5,1.0-1.6,1.1-1.4,1.1-2.4,1.5-2,1.5-6,1.7-2.5,10-18,10-30,2-13,2-4,2-4-celled,2-6.5,2-locular,2.1-3.0,2.5-,20-30,3-16,3-8.5,3-foliate,5-8-celled,6,6-15,7-30,abaxial,abaxially,acuminate,acute,adaxial,almost,alternate,anther,anthesi,apex,appearance,appressed,arising,base,basiscopically,bract,bracteate,branching,broadly,brown,calyx,capitate,cell,cm,composed,conical,corolla,covering,dark,darker,decreasing,decurrent,deep,densely,diameter,distal,doubly,dry,eglandular,either,elliptic,elongate,elongate-triangular,entire,exerted,extended,filament,flower,form,fragile,fruit,fruiting,generally,giving,glabrous,gland,glandular,globose,golden,green,hair-like,half,halfway,head,imparipinnate,inflorescence,interjected,internode,interrupted,large,largest,lateral,leaf,leaflet,less,like,lobe,long,longest,margin,material,medial,minute,mixture,mm,multi-celled,multi-cellular,multicellular,narrowly,oblique,obovate,occasionally,once-branched,opposite,other,outgrowth,ovary,ovate,pale,paler,patent,pedicel,peduncle,petiole,petiolule,point,primary,proximal,pseudostipule,pubescent,rachi,regularly,rest,rotate,serrate,sessile,set,shrub,silky,size,small,smaller,smooth,sometimes,sparsely,sparser,sprawling,stem,stiff,stigma,stripe,style,subopposite,surface,terminal,testa,thick,thin,three,tip,toward,transparent,trichome,tube,type,unicellular,uniseriate,unit,usually,vein,vine,wall,weak-walled,wide,winged,yellow	.4,.5,0.3-0.5,0.5-,0.5-0.6,0.7-,0.8-1,1.2-1.5,1.2-1.6,1.4-4,3-5,absent,apical,appendage,articulation,autogamous,axi,bent,berr,blade,column,developed,eaf,edicel,eed,enclosing,exserted,free,gree,hal,included,lon,lower,midvein,nflorescence,node,orbicular,pair,population,portion,present,primarily,probably,ruit,secondary,serrat,shorter,staminal,sterile,straight,strongly,tem,tertiary,ud,weak,well,ympodial	arrangement,bark,border,branch,bud,characteristic,colour,corrugation,drying,exertion,glabrousnes,growth,height,history,length,life,lobing,mentioned,midpoint,new,number,per,plant,prickle,ray,seed,shape,sympodial,texture,thicknes,variation,width
212	wfo-0001028317	success	204	210	169	35	41	0.828	-1.5,-5,/5,0,0-1,0.1,0.1-0.3,0.1-0.4,0.3-0.4,0.3-1,0.5-3.5,0.6-0.8,0.6-1.2,0.6-1.5,0.8-1.1,0.8-2.5,1-1.3,1-3,1-4,1.1-1.9,1.4-2,1/3-1/4,1/4-2/3,1/5,2-2.8,2-4,2-4.5,2.5-6.5,2.8-3.3,2/3,3-10,3-4,3-5,4-6,4-8,5-8,absent,acute,almost,anther,apart,apex,apically,apparently,articulated,bark,base,berry,blade,branched,bright,broad-deltate,brown,calyx,chartaceous,cm,concolorous,cream,cuneate,curved,dark,deltate,densely,diameter,difoliate,distance,drying,dull,elongating,erect,extending,filament,filiform,flattened-reniform,flower,free,fruit,fruiting,glabrous,gray,green,hair,herb,herbaceous,infructescence,lanceolate,lateral,leaf,length,lobe,lobed,long,longer,lower,margin,marking,mature,maturity,mauve,midpoint,midvein,minute,mm,moderately,obtuse,older,one,open,orange-brown,ovate,pair,pale,pedicel,peduncle,pendulous,per,petiole,poricidal,porrect,portion,prickle,prickly,primary,purple,ray,red,reduced,reflexed,rounded,scandent,sessile,shrub,side,simple,smooth,sometimes,spaced,sparsely,spherical,spreading,stalk,stalked,stellate-pubescent,stem,straight,style,subsessile,surface,tapering,terete,terminal,time,tip,toward,translucent,trichome,truncate,tube,unarmed,unit,upper,variously,vein,way,white,wide,yellow,yellow-green,young	0-5,0.1-0.25,1.8-2.5,1/,4-5-merous,6-10,abaxially,acuminat,alyx,apar,brow,eaf,eed,equal,eye,geminat,naked,nflorescence,oblong,orolla,oung,perfec,pericarp,prickl,ruit,scar,shorter,stellate,tamen,tertiary,unarme,vary,venation,visible,ympodial	1/2,acuminate,appearance,arrangement,border,branch,bud,characteristic,colour,corolla,corrugation,distal,exertion,form,geminate,giving,glabrousnes,growth,height,history,inflorescence,interjected,leaflet,life,lobing,new,null,number,ovary,plant,pseudostipule,seed,shape,size,stigma,sympodial,texture,thicknes,type,variation,width
213	wfo-0001028323	success	164	170	128	36	42	0.78	0.2-0.5,0.2-1,0.5,0.5-1,0.6-1,0.8,0.9-1.2,1,1-1.2,1-1.5,1.1-4.5,1.5,1.5-2.5,2-3,2-9,3,3-5,3.5-4,5-6,7.5-9,abaxially,absent,acute,along,anther,anthesi,apex,appressed,attenuate,bark,base,berry,blue-green,brown,c.,calyx,cell,cm,conical,corolla,cup-shaped,dark,deltate,dendritic,densely,diameter,drying,ellipsoid,elliptic,entire,erect,fading,filament,fleshy,free,fruiting,glabrescent,glabrous,globose,grey,growth,included,inflorescence,internodal,lanceolate,leaf-opposed,less,like,lobe,lobed,longer,main,margin,maturity,minute,minutely,mm,new,occasionally,ovary,ovate,ovoid,pair,pale,pedicel,peduncle,pericarp,petiole,pitted,planar,poricidal,portion,primary,proceed,pubescent,reddish,revolute,rounded,scattered,shiny,shoot,short,shrub,simple,soft,sometimes,somewhat,soon,sparsely,splitting,stem,stigma,straight,style,surface,testal,thin,tip,trichome,tube,uniseriate,unit,vein,violet,wall,way,white,x	-2,0.4-1.3,1-2,3-6,abscissio,apart,apparently,articulated,ba,capiatate,coriaceous,eaf,eed,flower,glabrescen,lengthening,lower,nflorescence,papillat,papillose,peg,perfect,plurifoliat,pore,remaining,ruit,scar,sinus,small,sparely,tearing,thick,tuft,ud,woody,ympodial	appearance,arrangement,border,bud,capitatate,characteristic,colour,corrugation,distal,exertion,form,fruit,giving,height,history,interjected,lateral,leaf,leaflet,length,life,lobing,midpoint,number,papillate,per,plant,plurifoliate,prickle,pseudostipule,ray,seed,shape,size,specified,sympodial,terminal,texture,thicknes,type,variation,width
214	wfo-0001028329	success	215	204	159	56	45	0.74	.5-3,.75-2,/10-3/10,0-100,0.2-0.3,0.8-1.1,0.8-1.4,0.9-1.3,1-6,1.0-1.4,1.3-1.8,1.5-2.3,10-34,12,2-3,2.75-4.5,3-14,3-8,3.75-7,3/4,4-15,5-10,6-8,6-9,abaxially,acuminate,acute,adaxially,angled,anther,apart,apex,articulated,asperous,axe,axillary,bark,base,becoming,berry,blade,blunt-tipped,branch,branched,brown,bud,calyx,chartaceous,cm,conical,continued,corolla,cylindrical,deltoid,dendritic-echinoid,diameter,dichotomously,distantly,distinct,due,echinoid,entire,filament,finely,fleshy,flower,fruit,glabrous,granular,granular-tomentose,gray,green,grooved,growth,hair,honeycombed,lateral,leaf,length,lobe,lobed,long,long-attenuate,longitudinally,main,margin,midvein,minutely,mm,moderately,mostly,multangulate,obelliptic,oblong,obovate,obtuse,occasional,older,orbicular,ovate,ovate-elliptic,pale,pedicel,peduncle,petiole,plurifoliate,porrect-stellate,present,pseudo-terminal,pubescent,rather,receptacle,reniform,reticulate-punctate,ripe,sessile,several,short-,short-stalked,shrub,side,simple,slightly,small,sometimes,spaced,sparse,sparsely,stalked,stellate,stellate-pubescent,stelliform,stem,stigma,style,subglobose,suborbicular,swollen,thickened,time,tomentose,touching,tree,tube,turning,unarmed,unit,usually,vein,velutinous,vestigial,way,white,whitish,wide,x,yellow,yellowish,young	.75-5.75,1.1-2.5,1.3-2,1.5-2.75,1.5-3.5,1.5-8,2-4,2.2-3.9,2.6-5,4-5,6-11,7-19,absen,ag,anthesi,apical-lateral,apparently,ba,closely,dehiscing,dendritic-echinoi,eaf,eed,free,glabrescen,high,inserted,introrse,large,lengthening,lower,multangulat,nflorescence,obscured,orolla,perfect,pore,rachi,relatively,ruit,runk,sessil,slit,stellat,stellate-rotate,subcapitat,suture,tamen,testa,thick,thin,tomentu,toward,unarme,vary,ympodial	absent,appearance,arrangement,border,characteristic,colour,corrugation,distal,drying,exertion,form,fruiting,giving,glabrousnes,height,history,inflorescence,interjected,leaflet,life,lobing,midpoint,new,null,number,ovary,per,plant,prickle,primary,pseudostipule,ray,seed,shape,size,subcapitate,surface,sympodial,terminal,texture,thicknes,trunk,type,variation,width
215	wfo-0001028337	success	195	214	177	18	37	0.908	-2,-2.5,-4,-6,.5,.8,/3,0,0.05-0.15,0.05-1,0.1-0.3,0.3-0.5,0.4-0.7,0.4-0.8,0.7-0.9,0.7-1,1,1-1.8,1-2,1-3,1.5-3,1.5-4,1.8-2,1/2,1/3-2/3,1/4-1/3,1/8-1/4,11-16,15-50,2-2.2,2-4,3-4,4-5,5-25,5-6,5-8,5-merous,6-7,8-10,8-14,abaxial,abaxially,adaxial,anther,apart,apex,apically,apparently,articulated,bark,base,berry,blade,branched,calyx,chartaceous,cm,color,conical,connivent,cuneate,curved,dark,deltate,densely,diameter,discolorous,drying,elongating,entire,equal,erect,evenly,eye,filament,flattened-reniform,flower,free,fruit,fruiting,fused,gently,glabrescent,glabrous,glaucous,gray,gray-brown,green,green-brown,hair,inflorescence,infructescence,juvenile,known,lateral,leaf,length,lobe,lobed,long,long-styled,longer,margin,marking,mature,mauve,midpoint,minutely,mm,moderately,naked,narrow-oblong,occasionally,older,one,open,orange-brown,pale,pedicel,peduncle,per,perfect,pericarp,petiole,pitted,poricidal,porrect,porrect-lepidote,portion,prickle,prickly,primary,ray,reddish,reflexed,rounded,scar,sessile,shallowly,shoot,short,short-styled,shorter,shrub,simple,slender,small,smooth,spaced,sparse,spherical,staminate,stellate,stellate-pubescent,stem,stout,straight,strongly,style,surface,tapering,terete,terminal,time,tip,toward,trichome,tube,unarmed,unit,usually,vein,visible,way,white,wide,young	acut,alyx,apar,ape,eaf,eed,glabrou,juvenil,lower,nflorescence,orolla,oung,plurifoliat,ruit,tamen,unarme,vary,ympodial	acute,arrangement,branch,bud,characteristic,colour,corolla,corrugation,distal,exertion,form,glabrousnes,growth,height,history,interjected,leaflet,life,lobing,new,null,number,ovary,plant,plurifoliate,pseudostipule,seed,shape,size,stamen,stigma,sympodial,texture,thicknes,type,variation,width
216	wfo-0001028339	exception_thrown	195	0	0	195	0	0.0		.5,0.05-0.1,0.8-1.2,1-1.2,1-1.5,1-2,1-5,1.1-1.4,1.2-1.5,1.5,1.5-2,1.7-3.2,10-30-flowered,10.2-18.5,2.5-5,3.4-5.5,3.5-4,43191,5-7,5-angled,5.8-7.9,7-11,8-10,8182,across,acuminate,acute,almost,anther,anthesi,apex,appearance,appearing,appressed,attenuate,bark,base,becoming,beneath,berry,blue,broadly,brown,bud,calyx,capitate,carinate,carpel,closely,cm,connate,corolla,covered,crystalline,cuneate,cup-shaped,dark,decurrent,deflexed,densely,dia,differing,difoliate,distinctly,dried,dry,eaf,edicel,eed,enclosed,epidermi,erect,evenly,exserted,fide,filament,filiform,first,flattened,floccose,flower,free,frui,fruiting,geminat,glabrate,glabrous,globose,grainy,greyish-brown,growth,irregular,large-celled,later,lateral,leaf,leave,like,little,lobe,lobed,lon,long,long-triangular,lower,main,major,margin,middle,minor,minutely,mm,mustard,nearly,nee,nflorescence,oblique,obscure,occasionally,older,one,opposite,ovary,ovate,overlappin,ovoid,ovoid-reniform,papery,papillate,papillose,pedicel,petiole,pitted,planar,pore,poricidal,portion,proximal,pulp,red-brown,reflexed,ruit,scar,schwarz,secondary,septum,shaped,shining,shrub,simple,size,slender,slightly,small,somewhat,spaced,sparsely,specimen,speckled,stem,stigma,straight,strong,strongly,style,surface,tall,tapering,tear-drop,texture,tightly,tip,tree,trichome,tub,tube,ud,uniseriate,unit,urceolate,vein,venation,white,white-lenticellat,white-papillo,white-speckled,wide,widest,winged,woody,x,yellow,yellowish,ympodial,young	
217	wfo-0001028351	exception_thrown	175	0	0	175	0	0.0		.2,.8,.8â1.0,0,0.1,0.2,0.5,0.6,0â,1.0â,1.0â1.6,1.0â2.0,1.0â2.5,1.4â1.5,1.5â4.0,1.6â,10,2,2.0â2.5,2.0â5.0,2.1â3.5,2/3,2â2.5,2â4,3,3.4â5.0,3â4,4,40,5,5.0,5.0â5.5,5.5â10.5,5â7,6.5â8.5,6â12,8â15,abaxially,absent,acute,adaxiall,adaxially,ag,along,annual,anther,anthesi,apart,apex,apical,articulated,axe,ba,basal,base,becoming,blade,blue,branching,brown,calyx,capitate,cell,chartaceous,clavate,cm,colour,connivent,convex,cylindrical,densely,diameter,directed,distally,eaf,eed,equal,erect,filament,flattened,fleshy,flower,fruit,geminat,glabrous,glandular,globose,green,hair,herb,indumentum,lamin,lanceolate,leaf,like,lobe,lobed,lon,long,longitudinal,lower,m.,margin,midvein,mm,moderately,multicellular,narrowly,nfloresence,number,oblong,obtuse,occasionally,opening,opposed,orolla,ovate,pair,pale,pedicel,peduncle,pentagonal,perennial,perfect,petiole,pitted,plurifoliate,pore,present,probably,pubescent,regularly,ruit,serrate,shallowly,shaped,shiny,side,simple,slender,slit,smaller,spaced,sparsely,stem,stigma,stone,straight,style,surface,tal,tamen,tardily,teardrop,tem,time,truncate,tube,unbranched,unicellular,uniseriate,unit,unknown,vary,velutinous,white,wide,wing,winged,woody,x,ympodial,young,â,â3.0	
218	wfo-0001028353	success	177	186	142	35	44	0.802	/3,0.2-0.4,0.5,0.5-,0.9-1.2,1,1-2,1-4,1.4-2,1.5-2,1.5-5,2,2-3,2-4,3,3-5,4-7,6-8,7,8-10,accrescent,acute,anther,anthesi,apart,apex,area,base,beneath,berry,bluntly,bright,calyx,capitate,cell,centre,ciliate,clasping,cm,coarsely,conical,cordate,corolla,cup-shaped,dark,decreasing,deep,deeply,densely,diameter,difoliate,dry,drying,ellipsoid,elliptic,emarginated,erect,exerted,filament,fleshy,flower,free,fruiting,glabrous,globose,green,greenish,growing,herb,heteromorphic,hollow,honey-comb,inserted,internodal,leaf,less,like,lobe,long,margin,material,midrib,minute,minutely,mm,nodding,often,open,outline,ovary,ovoid,pair,pale,papery,papillose,pedicel,peduncle,petiole,pitted,plant,plump,portion,primary,pubescent,purple,reddish,rhomboid,ripe,scar,scattered,sessile,shallow,short,simple,size,sleeve,slender,slightly,somewhat,sparsely,stem,stigma,straight,strongly,style,surface,tan,testal,tip,toothed,toward,trichome,truncate,tube,uniseriate,unit,vein,wall,way,wrinkled,x,yellow	.5,abaxially,age,along,becoming,campanulate,curved,decumben,distally,eaf,edicel,eed,fracturing,frui,geminat,gree,horn,horned,lengthening,lon,lower,m.,nflorescence,papillate,pericarp,point,pore,poricidal,principal,ruit,sessil,slit,thin,ud,ympodial	appearance,arrangement,bark,border,branch,bud,characteristic,colour,corrugation,decumbent,distal,exertion,form,fruit,geminate,giving,glabrousnes,growth,height,history,inflorescence,interjected,lateral,leaflet,length,life,lobing,midpoint,new,null,number,per,prickle,pseudostipule,ray,seed,shape,sympodial,terminal,texture,thicknes,type,variation,width
219	wfo-0001028390	success	147	166	108	39	58	0.735	-10,0,0.5,0.5-1,0.5-1.5,1,1-2.5,1-3,1-5,1.5-2,1.5-3.5,1.5-5.5,10-15,2,3-4,3-5,4-11,4-5,5-7,7-8,abaxially,acute,adaxially,angled,apart,apex,apiculate,articulated,axe,base,branched,calyx,cm,connivent,cuneate,curled,cylindrical,deltate,dendritically,dendritically-branched,dense,densely,diameter,directed,divided,eglandular,elliptic,entire,felty-pubescent,flower,forked,glabrous,gland,globose,hair,lanceolate,leaving,less,like,lobe,long,margin,midvein,mixed,mm,moderately,mostly,near,obtuse,occasionally,often,orange,ovate,pedicel,peduncle,peg,perfect,petiole,pore,pseudohair,pubescent,radiu,rarely,ripe,scar,short,shrub,simple,slightly,small,spaced,sparsely,stalked,stigma,style,subclavate,subcordate,tip,truncate,tube,unbranched,unequally,usually,violet,white,white-pubescent,x,yellow	.5-3.3,0.5-2.5,2.5,6-many-foliat,7,9,absen,adaxiall,aggregate,blade,cell,chartaceous,distall,eaf,eed,lon,lower,narrowly,nflorescence,nther,orolla,presen,puberulent,pubescen,rachi,ruit,ste,stellate,stone,subcapitat,subcoriaceous,tal,tem,time,triangular,unit,vary,wide,ympodial	anther,appearance,arrangement,bark,border,branch,bud,characteristic,colour,corolla,corrugation,distal,distally,drying,exertion,filament,form,fruit,fruiting,giving,glabrousnes,growth,height,history,inflorescence,interjected,lateral,leaf,leaflet,length,life,lobing,midpoint,new,null,number,ovary,per,plant,present,prickle,primary,pseudostipule,ray,seed,shape,size,stem,subcapitate,surface,tall,terminal,texture,thicknes,type,variation,vein,width
220	wfo-0001028405	success	149	159	109	40	50	0.732	0.4-0.5,0.5-3,1-4,1-9,1.3-8,1.5-6.5,10-11,2,2-2.5,2-3,2-4,3-4,3.5-10,3.5-6.5,4-11.5,4-6,6-7,7-14.5,8-15,9-15,abaxially,acumen,acute,adaxially,apex,apical,apically,apiculate,articulate,attenuate,base,branched,calyx,cell,cm,conical,connate,corolla,covering,cyme,decurrent,dehiscent,diameter,dichasial,dichasially,distal,dorsally,ebracteate,edge,elliptic,elliptic-lanceolate,exceeding,filament,flat,folded,forked,green,green-white,herbaceous,interjected,introrse,lanceolate,lateral,leaf,leaflet,lobe,long,make,maturing,mm,monochasial,mucilaginous,oblique,oblong,odd-pinnate,often,ovate-elliptic,ovoid,pedicel,peduncle,perennial,petiole,plant,poricidally,proximal,puberulent,rachi,seed,short,short-acuminate,short-petiolate,size,slit,stamen,stellate,stigma,straight,style,subsessile,terminal,testal,thick,throughout,tuber-bearing,wall,wide,without,yellow,Â¼	3-20,3-6-foliat,absen,digestion,diminishing,eaf,eed,emoval,enzyme,flower,generally,globo,gradually,hair-like,half,honeycomb,living,lon,lower,lunat,nflorescence,nther,orolla,pair,pattern,perfect,plan,reveal,ruit,seudostipule,specimen,tal,tem,throughou,toward,typically,unit,vary,whit,ympodial	'hair-like,absent,anther,appearance,arrangement,bark,border,branch,bud,characteristic,colour,corrugation,drying,exertion,form,fruit,fruiting,giving,glabrousnes,globose,growth,height,history,inflorescence,length,life,lobing,margin,mentioned,midpoint,new,number,ovary,per,prickle,primary,pseudostipule,ray,shape,stem,surface,texture,thicknes,tube,type,variation,vein,wet,white,width
221	wfo-0001028429	success	162	166	116	46	50	0.716	0.2-0.4,0.8-1.2,0.9-2.3,1-2.5,1-4,1.5-3,10-11,10-27,10.5-21,2-3,2-4,2-8,2.5-12,2.5-4,2.5-7.5,2.7-3.6,3-6,4-14,5-12,6-18,6-28,abaxially,acumen,acuminate,acute,adaxially,apex,apical,apically,base,branched,broadly,calyx,cell,cm,connate,cordate,corolla,covering,cuneate,cyme,darker,dehiscent,diameter,dichasial,dichasially,distal,ebracteate,elliptical,especially,exceeding,filament,flower,forked,generally,glabrescent,glabrous,globose,green,green-white,greenish,hair,half,herbaceous,interjected,introrse,lateral,leaf,leaflet,light,lobe,long,long-attenuate,make,maturing,medium,mm,monochasial,mucilaginous,narrowly,oblique,odd-pinnate,often,ovate,ovoid,pedicel,peduncle,perennial,perfect,petiole,plant,poricidally,scattered,seed,short,size,slightly,slit,spot,stamen,stigma,straight,style,terminal,testal,thick,throughout,tuber-bearing,typically,unit,vein,violet,wall,white,wide,yellow	1.5-4,2-1.,3-6-foliat,7-7,abaxiall,articulate,digestion,diminishing,dorsally,eaf,edge,eed,emoval,enzyme,flat,folded,globo,gradually,hair-like,honeycomb,living,lon,lower,lunat,nflorescence,nther,obovate,orolla,pair,pattern,pentagonal,petiolule,plan,proximal,reveal,rotate,ruit,seudostipule,specimen,tal,tem,throughou,toward,vary,ympodial,Â¼	'hair-like,2-19,3-6-foliate,anther,appearance,arrangement,bark,border,branch,bud,characteristic,colour,corrugation,drying,exertion,form,fruit,fruiting,giving,glabrousnes,growth,height,history,inflorescence,length,life,lobing,lunate,margin,mentioned,midpoint,new,number,ovary,per,prickle,primary,pseudostipule,ray,shape,stem,surface,sympodial,texture,thicknes,tube,type,variation,wet,width
222	wfo-0001028436	success	150	162	113	37	49	0.753	.5,0.2-0.4,0.5,0.5-1,0.8-1.5,1-2,1-2-celled,1-3,1.5,1.5-2.5,10-20,1st,2-3,2-4,2.5-3,2nd,4,5-10,5-12,5-8,7,8-12,abaxially,absent,acute,adaxially,anther,apex,apically,appearance,appearing,axe,base,berry,blade,brown,calyx,cell,center,chartaceous,ciliate,cm,connected,decurrent,deflated,dehiscent,diameter,dm,dried,due,edge,elliptic,entire,explosively,filament,fine,flower,fruit,fruiting,geniculate,glabrous,globose,hair,leaf,linear,linear-lancolate,lobe,long,margin,membranaceous,mm,moderately,much-branched,nearly,notch,oblong,often,older,parallel,pedicel,peduncle,per,petiole,placenta,pointing,presence,pubescent,rachi,radiating,raised,reaching,ridge,running,shallow,shrub,small,sparsely,stem,stigma,style,surface,swollen,taproot,tear,thick,triangular,tube,two-celled,unbranched,white,woody,wrinkled,x	1.5-2,5-15,abundant,adaxiall,along,beyond,cordat,difficult,eaf,eed,evaluat,exserted,flat,frui,glabrescen,interpetalar,lengt,like,lower,lying,nflorescence,orolla,oung,pubescen,rhizomatous,rotate,ruit,stamen,structure,tal,tamen,tissue,unifoliate,unit,vary,wid,ympodial	arrangement,bark,border,branch,bud,characteristic,colour,cordate,corolla,corrugation,distal,drying,exertion,form,giving,glabrescent,glabrousnes,growth,height,history,inflorescence,interjected,lateral,leaflet,length,life,lobing,mentioned,midpoint,new,number,ovary,plant,prickle,primary,pseudostipule,ray,seed,shape,size,terminal,texture,thicknes,type,variation,vein,wide,width,young
223	wfo-0001028465	success	159	197	145	14	52	0.912	0.75,1-2,1-4,1.2-2,1.5-2.9,10,10-24,11-23,2,2-3,2-4,2-6,2-9.3,2.4-2.8,2.5-4,3-4,3-5,3-8,3.8-7,4-8,4.5-5.5,5-7,7-15,8-10,9-19,abaxially,acumen,acuminate,acute,adaxially,apex,apical,apically,articulate,attenuate,base,branched,broadly,calyx,cell,cm,connate,corolla,covering,cuneate,cyme,decurrent,dehiscent,diameter,dichasial,dichasially,digestion,diminishing,distal,dorsally,ebracteate,edge,elliptical,emoval,enzyme,equal,exceeding,filament,first,flat,flower,folded,forked,generally,globose,gradually,green,green-white,hair-like,half,herbaceous,honeycomb,interjected,interpetalar,introrse,lateral,leaf,leaflet,living,lobe,lon,long,make,maturing,medium,mm,monochasial,mucilaginous,nther,oblique,odd-pinnate,often,orolla,ovoid,pair,pattern,pedicel,peduncle,perennial,perfect,petiole,petiolule,plant,poricidally,proximal,puberulent,pubescent,purple,rachi,rarely,reveal,rotate,seed,sessile,short,size,slit,specimen,spot,stamen,stigma,straight,strigose,style,terminal,testal,thick,throughout,tissu,toward,tuber-bearing,two,typically,unit,vary,wall,white,wide,yellow,Â¼	3-6-foliat,4-1.,eaf,eed,globo,lower,lunat,nflorescence,plan,ruit,seudostipule,tal,tem,ympodial	3-6-foliate,4-18,anther,appearance,arrangement,bark,border,branch,bud,characteristic,colour,corrugation,drying,exertion,form,fruit,fruiting,giving,glabrousnes,growth,height,history,inflorescence,length,life,lobing,lunate,margin,midpoint,new,null,number,ovary,per,prickle,primary,pseudostipule,ray,shape,stem,surface,sympodial,tall,texture,thicknes,tissue,tube,type,variation,vein,wet,width
224	wfo-0001028468	success	255	239	198	57	41	0.776	-1.3,-10,-3,-5.5,-7,.1-0.2,.1-0.3,.1-0.4,.2,.2-0.4,.3,.3-0.4,.5,.5-1.5,.6-1,/10-1/5,0.05,0.1,0.2-0.3,0.2-1.5,0.4-1,0.4-4,0.5-2,0.5-3,0.5-3.5,0.5-8,0.6-1.2,0.7-2.5,0.8-3.5,1.2-1.5,1.5-2.2,1.5-3.1,1.6,1/3-1/2,1/5-1/2,16,2,2-9,2.2-3,2.5-4,2.8-4.1,2/3-3/4,20,3-4,4-6,4-9,5-9,6-9,accrescent,acute,anther,apart,apex,appressed,armed,articulated,attenuate,axe,base,becoming,berry,beyond,blade,blue,broad-based,broadly,brown,bud,calyx,campanulate,cauline,clavate,cm,compressed,corolla,dark,densely,diameter,distal,distally,distantly,dry,ellipsoid,equal,exserted,extra-axillary,filament,flattened,flower,foveate,fruit,fruiting,glabrescent,glabrous,gradually,gray,green,greenish,hair,increasing,inserted,interpetalar,lateral,laterally,length,light,lobe,lobed,long,longer,lower,main,margin,midpoint,midvein,minutely,mixed,mm,moderately,mostly,multangulate,narrowly,oblique,oblong-conical,oblong-lanceolate,obtuse,older,orange,ovate,overlapping,ovoid,pair,pale,pedicel,peduncle,per,petiole,porrect-stellate,prickle,proximal,pubescence,purple,rachi,ray,recurved,reduced,relatively,reticulate,rhombic,sessile,shallowly,short,short-,short-stalked,shrub,side,simple,slightly,somewhat,spaced,sparsely,specimen,stalk,stamen,stellate-pubescent,stelliform,stem,stigma,straight,style,subacuminate,subcapitate,subcuneate,subelliptic,subglobose,sublenticular,subreniform,subshrub,surface,terete,testa,thick,thick-stalked,thicknes,time,tissue,touching,triangular,tube,unarmed,unbranched,upper,vein,way,wide,x,yellowish,young	-4,.5-1.6,/4-1/3,0.2-0.6,0.5-3.3,0.6-2,1,1.3-2,5-21,6-10,abaxially,acuminate,adaxially,along,ark,bu,c.,central,chartaceous,commonly,compresse,connivent,d.,decreasing,density,directed,eaf,eed,geminat,half,introrsel,lamin,m.,multangulat,nflorescence,occasionally,orangish,orolla,papillo,perfect,pore,pubescent,rotate-stellate,ruit,similar,similarly,subchartaceous,subsessile,tal,tamen,toward,unifoliate,unit,usually,vary,yellow,ympodial	-21,appearance,arrangement,bark,border,branch,characteristic,colour,corrugation,dm,drying,exertion,form,giving,glabrousnes,growth,height,history,inflorescence,interjected,leaf,leaflet,life,lobing,new,null,number,ovary,papillose,plant,primary,pseudostipule,seed,shape,size,tall,terminal,texture,type,variation,width
225	wfo-0001028470	success	185	163	118	67	45	0.638	0-18,0.25-0.75,0.9-2.2,0.9-2.3,1-12.3,1-2,1-3,1.5-2.8,1.6-3.2,11.8-21,12-44,2-10,2-7,2-8,2.1-3.9,3-10,3.2-5.5,3.5-16,3.5-7,4-7,5.5-11.6,6-33,abaxially,acumen,acute,adaxially,anther,apex,apparently,asymmetric,attenuate,axe,axillary,base,basiscopic,berry,brownish,bud,cell,chartaceous,clavate,cm,condition,connivent,corolla,covering,dark,deep,diameter,distal,dot,drying,elliptic,filament,flower,forked,fresh,fruit,generally,glabrescent,glabrous,green,greenish,hair,half,herb,interjected,lanceolate,lateral,leaf,leaflet,light,lobe,long,make,medium,mm,mottled,mucilaginous,odd-pinnate,orbicular,ovate,ovoid,pedicel,peduncle,perfect,petiole,petiolulate,plant,pubescent,purple,ripe,rounded,scarce,seed,sessile,short,side,size,sometimes,stigma,style,subtending,terminal,testal,thick,tissue,tube,typically,unwinged,usually,wall,wet,white,whitish,wide,wing,x	2-5,3-5,4-6,5-merou,adaxiall,ag,alyx,apart,articulated,blade,capitat,decreasing,digestion,dorsally,eaf,edge,eed,end,enzyme,erec,exceeding,flat,folded,geminat,glabrou,green-white,hair-like,hal,high,homostylous,honeycomb-shaped,lengthening,living,lower,nflorescence,one,orolla,pair,pentagonal,placed,plurifoliate,pore,poricidal,removed,ruit,seudostipule,slit,spaced,specimen,stamen,stolo,straight,subequal,subglabrou,substellate,tall,tamen,tem,throughout,tip,toward,tri-,tuber,unit,vary,yellow,ympodial	'hair-like,appearance,arrangement,bark,border,branch,calyx,capitate,characteristic,colour,corrugation,erect,exertion,form,fruiting,giving,glabrousnes,growth,height,history,inflorescence,length,life,lobing,margin,mentioned,midpoint,new,number,ovary,per,prickle,primary,pseudostipule,ray,shape,stem,subglabrous,surface,texture,thicknes,type,variation,vein,width
226	wfo-0001028476	success	246	225	188	58	37	0.764	-16,-20,-6,-8,.05-0.1,0-,0.1-0.15,0.1-0.4,0.15-0.2,0.2-0.3,0.2-0.5,0.2-0.6,0.25-0.5,0.3-0.4,0.3-0.7,0.3-1.2,0.4-0.5,0.4-0.6,0.4-1.5,0.5,0.5-0.6,0.7-2.5,0.8-1.2,0.8-1.6,1,1-1.2,1-1.4,1-1.5,1-2,1-2-celled,1-4,1-6,1-celled,1.1-1.5,1.1-1.6,1.2-2.5,1.8-2.5,12-30,2-6,2-foliate,2-locular,2.4-3,3-12,3-foliate,3.5-13,4-celled,5-15,6-,7-10,8-30,abaxially,absent,abundant,acuminate,acute,age,almost,along,anther,anthesi,apex,appearance,basal,base,basiscopically,bifurcate,bifurcation,bract,bracteate,branched,bright,brown,calyx,capitate,cell,cm,conical,corolla,curved,dark,deeply,diameter,distal,ebracteate,elliptic,elongate,entire,especially,exserted,filament,first,flower,fortaleza,fruit,fruiting,give,glabrescent,glandular,globose,green,hair-like,half,head,herb,hyaline,imparipinnate,inflorescence,interjected,internode,interrupted,irregularly,lanceolate,largest,lateral,leaf,leaflet,less,like,lobe,lobed,long,margin,maturity,midvein,minute,minutely,mixed,mm,narrowly,node,numerous,oblique,obovate,occasionally,often,outgrowth,ovary,pale,pedicel,peduncle,perennial,petiole,population,present,primary,prominent,pseudostipule,puberulent,pubescent,purple,rarely,reflexed,regularly,rounded,rÃ­o,scattered,silky,simple,sinus,sparsely,sprawling,spreading,stem,stiff,stigma,straight,stripe,style,surface,tall,terminal,testa,thick,tip,trichome,truncate,tube,unicellular,uniformly,uniseriate,unit,usually,vein,wall,wide,winged,woody,yellow	-1,.5,0-0.5,0.15-0.4,0.25-0.4,0.3-0.5,0.5-1.7,2,3-7,acroscopically,also,alternate,ape,apical,appendage,articulated,axi,becoming,column,decurrent,diamete,eaf,edicel,eed,gradually,gree,hal,incurved,lon,lower,main,nflorescence,pair,petiolule,pubescence,rachi,recurve,rest,ruit,secondary,sessile,set,short,slightly,smaller,staminal,stellate,sterile,subopposite,tem,tertiary,toward,ud,unpaired,weak-walled,white,wid,ympodial	arrangement,bark,border,branch,bud,characteristic,colour,corrugation,drying,exertion,form,giving,glabrousnes,growth,height,history,length,life,lobing,mentioned,midpoint,new,number,per,plant,prickle,ray,recurved,seed,shape,size,sympodial,texture,thicknes,type,variation,width
227	wfo-0001028481	success	194	170	130	64	40	0.67	.1,.3,.5,0-2,0.5-1,0.6-1,0Â°,1-1.4,1-2,1-4,1.5,1.8-2.5,2.5-3,3,3-4,3-6,5.5-7.5,8,absent,acuminate,age,almost,along,anther,apex,apically,articulated,attenuate,bark,base,branch,branched,brown,canaliculate,chartaceous,clavate,clearly,cm,colour,conical,corolla,cuneate,cupular,delineated,dendritic,dendritic-pubescent,diameter,dilated,discolorous,distributed,dry,drying,elliptic,entire,equal,evenly,except,eye,faint,filament,flaking,flexuous,flower,free,glabrous,green,known,lamina,leaf,length,lengthening,less,liana,like,linear,lobe,lobed,long,longitudinally,main,margin,midvein,mm,naked,oblique,oblong,occasional,often,orange-brown,ovate,pair,pedicel,peduncle,petiole,pore,poricidal,portion,primary,pubescent,rachi,ray,reddish,ribbed,ridged,shortly,shrub,side,simple,size,slender,smoothly,sparsely,spreading,stem,stigma,style,surface,terminal,thickly,tip,trichome,tube,unarmed,unknown,vein,visible,white,x,yellowish,young	0.1-0.2,0.15,1-3,1.5-2,1/2-2/3,2-3,3-3.5,3-4.5,abaxially,acute,adaxially,alyx,anthesi,apar,apparently,close,deeply,deltoid,density,different,divided,domatia,dorsifixed,eaf,eed,ellipsoi,erect,extending,extent,flat,increasing,know,lon,long-acuminate,longer,lower,m.,mostly,narrowly,nflorescence,nther,orolla,perfec,plurifoliat,protruding,raised,ruit,scar,see,sinus,small,smoot,stump,tearing,tertiary,together,toward,ud,uneven,unit,vary,venation,wide,ympodial	appearance,arrangement,border,bud,calyx,characteristic,corrugation,distal,ellipsoid,exertion,form,fruit,fruiting,giving,glabrousnes,growth,history,inflorescence,interjected,lateral,leaflet,life,lobing,midpoint,new,none,null,number,ovary,per,prickle,pseudostipule,seed,shape,smooth,texture,thicknes,type,variation,width
228	wfo-0001028482	success	224	203	164	60	39	0.732	.1,/3,0,0.2,0.5-1,0.5-5,00,1-11,1-2,1-4,1.1-5,1.2-1.6,1.5-2,1.5-3,10,2-3,2-celled,3-12,3-4,4-5,5-25,6-50,7-14,acuminate,acute,adaxially,age,alternate,angled,anther,apex,ascending,asymmetric,bark,base,becoming,berry,bifurcate,bilobed,branched,bright,broadly,brochiodromous,brownish,bud,calyx,campanulate,capitate,channeled,cm,coriaceous,corky,corolla,corrugated,creamy,cymose,deciduous,deflexed,deltate,diameter,diffusely,distally,dry,drying,ellipsoid,elliptic,emarginate,enlarged,entire,exerted,exfoliating,expanding,filament,flattened-reniform,fleshy,flower,free,fresh,fruit,fruiting,glabrous,glandular,globose,golden,green,growth,halfway,hard,impressed,internodal,investing,keeled,leaf-opposed,lengthening,less,lobe,lobed,long,margin,material,maturity,midrib,minutely,mm,new,obovate,occasionally,olive,ovary,pair,pale,pedicel,peduncle,per,pericarp,petiole,pitted,pore,poricidal,portion,primary,pubescent,reddish,revolute,scandent,shaped,shiny,short,simple,size,slightly,slit,small,somewhat,soon,stem,stigma,style,subglobose,subpyramidal,surface,tan,tear-drop,tightly,tip,transparent,transversely,tree,trichome,truncate,tube,twice,usually,vegetative,vein,venation,way,white,woody,x,yellow,yellowish,young,Âµm	.5,0.5,0.7-1.1,1-1.5,abaxially,anthesi,apiculae,basal,berr,bifid,chartaceous,circinate,closely,constriction,cucullate,curved,densely,difoliate,discolorous,distinct,eaf,eed,embryo,geminat,glabrou,grayish,heterostylous,incrassate,individual,irregular,lower,markedly,materia,midvein,minute,nflorescence,nodding,overlappin,papillat,pentamerous,petal,row,ruit,scar,sometimes,spaced,sparsely,stout,straight,subcoriaceous,tiny,tub,tuberculate,tuft,two,ud,unifoliate,uniseriate,unit,ympodial	.7-1.1,appearance,arrangement,border,branch,characteristic,colour,corrugation,distal,exertion,form,giving,glabrousnes,height,history,inflorescence,interjected,lateral,leaf,leaflet,length,life,lobing,mentioned,midpoint,number,papillate,plant,prickle,pseudostipule,ray,seed,shape,terminal,texture,thicknes,type,variation,width
229	wfo-0001028487	success	195	185	140	55	45	0.718	0-9,0.3-0.7,0.4-1.5,0.9-3,1-2,1-3,1-3.2,1.1-1.5,1.4-1.7,1.7-7,10-4.3,10-41,15-28,2-4,2-4.8,2-6,2.5-3.5,3-10,3-19,3-5,3.4-7.8,4-7,4.6-13.6,5-6,7.8-16.4,abaxially,acumen,acuminate,acute,adaxially,along,anther,apart,apex,apparently,arranged,asymmetric,attenuate,axe,axillary,base,basiscopic,bead,berry,brownish,bud,cell,central,clavate,cm,condition,connivent,coriaceous,corolla,covering,dark,deep,diameter,distal,drying,elliptic,filament,flower,forked,fresh,fruit,generally,glabrescent,glabrous,green,greenish,hair,hair-like,half,herb,interjected,lanceolate,lateral,leaf,leaflet,light,like,lobe,long,make,medium,mm,moniliform,mucilaginous,multiple,narrow,necklace,odd-pinnate,orbicular,ovate,ovoid,pedicel,peduncle,pentagonal,perfect,petiole,petiolulate,plant,plurifoliate,purple,ripe,rounded,scabrous,scarce,seed,sessile,short,side,size,sometimes,spaced,star,stigma,stolon,style,substellate,subtending,terminal,testal,thick,tissue,tri-,tube,tuber,typically,unit,unwinged,usually,wall,wet,white,whitish,wide,wing,x	3-4,5-merou,adaxiall,ag,alyx,articulated,blade,capitat,considerably,decreasing,digestion,dorsally,eaf,edge,eed,enzyme,erec,exceeding,flat,folded,geminat,glabrou,green-white,hal,high,homostylous,honeycomb-shaped,lengthening,living,lower,nflorescence,orolla,pair,pore,poricidal,removed,ruit,second,seudostipule,slit,smaller,specimen,stamen,straight,subequal,subglabrou,tall,tamen,tem,throughout,tip,toward,vary,yellow,ympodial	appearance,arrangement,bark,border,branch,calyx,capitate,characteristic,colour,corrugation,erect,exertion,form,fruiting,geminate,giving,glabrousnes,growth,height,history,inflorescence,length,life,lobing,margin,mentioned,midpoint,new,number,ovary,per,prickle,primary,pseudostipule,ray,shape,stem,surface,sympodial,texture,thicknes,type,variation,vein,width
230	wfo-0001028489	success	224	239	197	27	42	0.879	-0.6,-10,-2.5,-4,-5,-6,/4,0-10,0-15,0-20,0-3,0-50,0.1,0.1-0.6,0.2,0.2-,0.2-0.4,0.2-0.5,0.2-0.6,0.2-0.7,0.3-0.5,0.3-1,0.3-1.2,0.4-0.8,0.5-0.8,0.5-1,0.5-1.1,0.5-1.5,0.6-1.2,0.7-3,1-3,1-4,1-6,1-7,1.5-3,1.5-4,1.8-2.2,1.8-4,1.8-5.5,1/3,1/3-1/2,1/4-1/2,2-3,2-4,2-6,2.1-3,3-7,3.5-6,4-10,4-13,4-8,5-25,5-8,7.5,acicular,acute,anther,apart,apex,apically,apparently,articulated,bark,base,berry,beyond,blade,branched,broad-deltate,calyx,cell,chartaceous,cm,concolorous,connivent,cordate,cream,cuneate,curved,dark,deltate,diameter,difoliate,distance,drying,dull,elliptic,elongating,erect,extending,eye,filament,flattened-reniform,flower,free,fruit,fruiting,glabrous,gray,green,hair,herbaceous,infructescence,lateral,leaf,length,less,lobe,lobed,long,longer,margin,marking,mature,maturity,mauve,membranous,midpoint,midvein,minute,mm,moderately,naked,occasionally,often,older,one,open,orange,orange-brown,orange-green,outline,ovate,pair,pale,pedicel,peduncle,pendulous,per,pericarp,perpendicular,petiole,poricidal,porrect,portion,prickle,prickly,primary,protruding,purple,raised,ray,red-brown,rounded,scar,sessile,shiny,shrub,side,simple,slender,smooth,sometimes,spaced,sparsely,spherical,spreading,stalk,stellate,stellate-pubescent,stem,straight,style,subsessile,surface,tapering,terete,time,tip,toward,trichome,truncate,tube,unarmed,unit,upper,vein,visible,way,weakly,white,wide,woody,yellow,yellow-green,yellow-orange,young	0.3-0.7,5-merous,abaxially,alyx,apar,ba,caudat,densely,eaf,eed,equal,geminat,lon,lower,nflorescence,obtuse,orolla,oung,perfec,ruit,tamen,tertiary,unarme,vary,venation,white-gra,ympodial	appearance,arrangement,border,branch,bud,caudate,characteristic,colour,corolla,corrugation,distal,exertion,form,geminate,giving,glabrousnes,growth,height,history,inflorescence,interjected,leaflet,life,lobing,new,null,number,ovary,plant,pseudostipule,seed,shape,size,stigma,sympodial,terminal,texture,thicknes,type,variation,white-gray,width
231	wfo-0001028492	success	130	159	101	29	58	0.777	0.5-1,1-2.5,1-4,1-5,1.5-3,1.5-6,1.75-3.5,15-20,2-2.5,2-3,2-4,2-5,2.5-9,3,3-6,4,5-15,5-25-flower,5-8,6-11,6-12,abaxially,acute,adaxially,aggregate,angled,apart,apex,apiculate,articulated,axi,base,blade,calyx,cell,chartaceous,cm,colored,connivent,containing,crystal,cylindrical,dark,deltate,diameter,elliptic-ovate,entire,except,forked,fruit,glabrous,globose,hair,herb,irregularly,leaving,lobe,long,margin,mm,narrowly,obtuse,pedicel,peduncle,petiole,pubescent,punctate,purple,radiu,rarely,reticulate,ripe,rounded,sand-punctate,scar,shrub,simple,somewhat,spaced,sparse,splitting,stigma,stone,style,subcordate,subcoriaceous,succulent,time,tip,triangular,triangular-ovate,tube,unbranched,unevenly,veiny,white,white-punctate,whitish,wide,x,x1-3	-5-foliat,0.2-2,1.5-2.5,8-15,absen,axe,ciliolate,color,directed,distall,eaf,eed,glabrou,lower,nflorescence,nther,orolla,pore,rachi,ruit,san,stellate,tal,tem,truncat,unit,unknown,vary,ympodial	absent,anther,appearance,arrangement,bark,border,branch,bud,characteristic,colour,corolla,corrugation,description,distal,drying,exertion,filament,form,fruiting,giving,glabrousnes,growth,height,history,inflorescence,interjected,lateral,leaf,leaflet,length,life,lobing,mentioned,midpoint,new,number,ovary,per,plant,prickle,primary,pseudostipule,ray,sand,seed,shape,size,stem,surface,tall,terminal,texture,thicknes,truncate,type,variation,vein,width
232	wfo-0001028501	success	195	187	142	53	45	0.728	0-3.2,0-4,0.3-0.7,0.3-3.3,0.6-5.8,0.8-1.6,0.8-1.7,1,1-2,1-8,1.8-10.7,13-41,2-4,2.8-18,2.8-4.9,3-10,3-5,3-7,3.1-10.4,3.1-12,4-8,4.8-18,6.6-21.1,8-10,8-34,abaxially,acumen,acuminate,acute,adaxially,along,anther,apart,apex,apparently,arranged,articulated,axe,axillary,base,bead,berry,blade,broadly,brownish,bud,cell,clavate,cm,condition,connivent,coriaceous,corolla,covering,dark,decurrent,diameter,distal,drying,elliptic,filament,flower,forked,fresh,fruit,generally,glabrescent,glabrous,green,greenish,hair,hair-like,half,herb,high,interjected,lanceolate,lateral,leaf,leaflet,light,like,linear,lobe,long,make,medium,mm,moniliform,mottled,mucilaginous,multiple,narrow,narrowly,necklace,odd-pinnate,onto,orbicular,ovate,ovoid,pedicel,peduncle,perfect,petiole,plant,plurifoliate,present,purple,pyriform,rachi,ripe,scarce,seed,sessile,short,simple,size,sometimes,spaced,spot,stigma,stolon,straight,style,subtending,terminal,testal,thick,tri-,tube,tuber,typically,unit,unwinged,usually,wall,wet,white,whitish,wide,wing,x	0-3,1-3,2-5,5-merou,adaxiall,ag,alyx,attenuate,capitat,considerably,decreasing,digestion,dorsally,eaf,edge,eed,enzyme,erec,exceeding,flat,folded,geminat,glabrou,green-white,hal,homostylous,honeycomb-shaped,larger,lengthening,living,lower,nflorescence,orolla,pair,pore,poricidal,removed,rotate,ruit,seudostipule,slit,specimen,stamen,subglabrou,tall,tamen,tem,throughout,tip,toward,vary,yellow,ympodial	appearance,arrangement,bark,border,branch,calyx,capitate,characteristic,colour,corrugation,erect,exertion,form,fruiting,geminate,giving,glabrousnes,growth,height,history,inflorescence,length,life,lobing,margin,midpoint,new,null,number,ovary,per,prickle,primary,pseudostipule,ray,shape,stem,surface,sympodial,texture,thicknes,type,variation,vein,width
233	wfo-0001028502	exception_thrown	158	0	0	158	0	0.0		.5,/2,0.5-1,1-2,1.5-2,1.5-2.5,1.5-3,1.5-6,1.6-2.4,2-2.5,2-4,2-5,2-7,2-8,3.5-15,3.5-4,5-15,5-6,6-8,?,abaxial,abaxially,acute,adaxially,age,along,anther,anthesi,apar,apex,ba,bark,base,beige,blade,body,branch,branched,brown,calyx,campanulate,cazalet,christmas-tree-like,clavate,closely,cm,cone,congested,constricted,corolla,dark,deltate,dendritic,densely,denser,dia,eaf,edicel,eed,elliptic,erect,exserted,fawn,fide,filament,flat,flattened-reniform,fleshy,flower,free,fruiting,glabrat,glabrous,globose,heteromorphic,impressed,included,incrassate,inflorescenc,inflorescence,later,lateral,leaf,lengthening,light,like,lobe,lobed,lon,long,long-styled,lower,main,margin,matted,middle,minutely,mm,narrower,nflorescence,obovate,often,older,ovary,packed,pair,papillo,papillose,pedicel,petiole,pitted,planar,plurifoliat,pore,poricidal,portion,prominent,pubescent,reddish-brown,rest,ruit,scar,scattered,seed,shining,short-styled,shrub,slit,small,spaced,stem,stigma,structure,style,surface,tall,terminal,thick,time,tip,tree,tree-like,trichome,tub,tube,ud,unclear,unevenly,vein,warty,way,white,wide,widest,within,woody,ympodia,young	
234	wfo-0001028505	success	168	194	154	14	40	0.917	.01,.1,.3,.5,/3,0.25-0.5,0.8-1,0.8-1.5,1,1-3,1.2-2.5,1/3,10-14-flowered,10-15,2,2.5-4.5,3-5,3.5-5,7-8,acuminate,acute,anther,anthesi,apex,aspect,barely,bark,basal,base,beneath,berry,black,blade,body,branch,bright,broadly,bud,calyx,characteristic,cm,conical,corolla,darker,deciduous,decurrent,deflexed,delicate,deltoid,dia,differentiated,differing,difoliate,distance,distinct,dried,dry,drying,elliptic,erect,expanded,exserted,exsertion,f,filament,flattened,free,fruiting,gently,glabrous,globose,greatly,green,grey,incrassate,lateral,leaf,live,lobe,lobed,long,main,major,margin,material,member,minor,minute,minutely,mm,narrowly,obovoid,obvious,older,opposite,ovary,ovate,overlapping,ovoid-reniform,pair,pale,papillose,pedicel,petiole,pitted,plant,pore,poricidal,portion,prominent,proximal,pubescent,purple,reflexed,rounded,scar,seed,shape,shaped,short,shrub,simple,size,slightly,somewhat,soon,specimen,stem,stigma,straight,strongly,style,surface,tall,tan,tapering,tear-drop,tip,touching,trichome,truncate,tube,unicellular,uniseriate,unit,usually,vein,way,white,widest,woody,x,yellowish,young	ba,eaf,edicel,eed,geminat,lon,lower,m.,materia,nflorescence,ruit,ud,whit,ympodial	appearance,arrangement,border,colour,corrugation,diameter,distal,exertion,flower,form,fruit,geminate,giving,glabrousnes,growth,height,history,inflorescence,interjected,leaflet,length,life,lobing,midpoint,new,null,number,peduncle,per,prickle,primary,pseudostipule,ray,sympodial,terminal,texture,thicknes,type,variation,width
235	wfo-0001028524	success	236	252	210	26	42	0.89	-2.7,-3,.5-1,/10-3/10,0-150,0.3,0.3-0.8,0.5-3.5,0.6-1.4,1-5,1.1-1.2,1.2-1.3,1.5-1.6,1.5-3,1.8-2.5,1/3-2/3,10-20,11,2-3.8,2-6,2.5-3.4,2.5-3.8,2.5-4,2.8-3.5,3-10,3-15,3-4.3,3.3-4,3.4-3.6,4-6,4-8,4.3-6,6-7,6-9,7-10,7-11,8-13,9-14,abaxially,accrescent,acuminate,acute,adaxially,along,anther,anthesi,apart,apex,apical-lateral,articulated,ascending,axe,axillary,bark,base,becoming,berry,blade,blunt-tipped,branch,branched,brown,bud,calyx,chartaceous,closely,cm,conical,continued,corolla,cream,dark,dehiscing,deltoid,densely,diameter,distal,dm,due,echinoid,elliptic,entire,exserted,extend,ferrugineous,few-,few-rayed,filament,first,fleshy,flower,free,fruit,fruiting,glabrescent,glabrous,granular-tomentose,gray,green,greenish,growth,hair,half,high,honeycombed,indument,inserted,interpetalar,introrse,lacking,lanceolate,large,late,later,lateral,leaf,length,lobe,lobed,long,longitudinal,main,many-rayed,margin,matted,midvein,mixed,mm,multangulate,nearly,oblong,obtuse,often,older,orbicular,ovate,ovate-lanceolate,overlapping,pale,partly,pedicel,peduncle,persistent,petiole,plurifoliate,pore,porrect-stellate,present,probably,prominent,pseudo-terminal,pubescent,rachi,rather,ray,relatively,reniform,reticulate-punctate,ripe,rounded,scabridulous,sessile,short,short-stalked,side,simple,slightly,slit,small,somewhat,spaced,sparingly,sparsely,stalked,stellate,stelliform,stem,stigma,stout-stalked,strongly,style,subcoriaceous,subglobose,suborbicular,sulcate,terete,thick,thick-stalked,thin,thin-stalked,time,tissue,tomentose,touching,translucent,tree,tube,unarmed,unit,usually,vein,velutinous,warty,way,wide,x,yellow,yellowish,yellowish-green,young	ag,apparently,ba,capitat,eaf,echinoi,eed,glabrescen,lanceolat,lower,m.,midvei,nflorescence,obscured,orolla,perfect,ruit,runk,stamen,suture,tamen,testa,tomentu,unarme,vary,ympodial	age,appearance,arrangement,border,capitate,characteristic,colour,corrugation,drying,exertion,form,giving,glabrousnes,height,history,inflorescence,interjected,leaflet,life,lobing,midpoint,new,null,number,ovary,per,plant,prickle,primary,pseudostipule,seed,shape,size,surface,sympodial,terminal,texture,thicknes,trunk,type,variation,width
236	wfo-0001028525	success	257	199	162	95	37	0.63	.25,0.2-0.3,0.5,0.5-1.5,0.5-2.5,0Â°,1-2,1-2.5,1.1-1.7,1.2-1.6,1.5,1.5-3,10,10-13,2,2-2.5,2.5-5,3,3-5,3-7,4,4-15,4-5,4-7,6,7,7-13,acuminate,acute,almost,anther,apart,apex,apically,attenuate,bark,base,becoming,berry,black,brachyblast,branch,branched,branching,broadly,brown,calyx,capitate,clavate,clustered,cm,conical,cordate,corolla,curved,dark,deltoid,dendritic,dendritic-pubescent,density,developed,diameter,dilated,drying,elongated,entire,erect,eye,filament,flattened,flexuous,flower,form,forming,free,frequently,fruit,fruiting,glabrescent,glabrous,green-brown,grey,increasing,known,lamina,lateral,laterally,leaf,less,liana,light,like,linear,lobe,lobed,long,longitudinally,loop,lumpy,main,margin,mature,mauve,midvein,mm,multicellular-dendritic,naked,narrowly,obconical,oblong,obscuring,orange-brown,ovate,ovoid,pair,partly,pedicel,peduncle,petiole,portion,primary,pubescent,pyriform,rachi,ray,red-brown,ridged,rounded,scattered,shrub,side,simple,size,slender,smaller,smooth,sometimes,somewhat,sparsely,spheroidal,spreading,stem,stigma,style,surface,terete,terminal,thick,tip,toward,trichome,truncate,tube,unarmed,vein,visible,weakly,well-developed,whitish,wide,x,young	.4,0.2-0.6,1-1.5,1-4,1/3-3/4,1mm,2-3,7.5,accrescent,age,along,alternate,alyx,anthesi,apar,apice,apparently,around,articulated,axil,centre,chartaceous,clearly,clum,cup,deeply,delineated,densely,detaching,developing,discolorous,divided,domatia-like,dorsal,dorsifixed,eaf,eed,ellipsoi,equal,fertilisation,fewer,fine,flat,flexible,formed,frui,inside,leave,lengthening,longer,loose,lower,m.,membranous,minute,much,nflorescence,nther,often,one,orolla,outside,overlapping,pendulous,perfec,pericarp,plurifoliat,pore,poricidal,prominent,protruding,puberulous,ruit,scar,sessile,sinus,slightly,small,smoot,soon,stripe,structure,stump,tangling,tearing,tertiary,thin,ud,uneven,unit,vary,venation,white,wider,ympodial	appearance,arrangement,border,bud,characteristic,colour,corrugation,distal,ellipsoid,exertion,giving,glabrousnes,growth,height,history,inflorescence,interjected,leaflet,length,life,lobing,mentioned,midpoint,new,number,ovary,per,plant,prickle,pseudostipule,seed,shape,texture,thicknes,type,variation,width
237	wfo-0001028528	exception_thrown	155	0	0	155	0	0.0		.5,0.9-1.2,1-2,1.1-1.2,1.5,1.8-2,2-3,2-4,2.5-3,3.5-4,3.5-6,3/4,4-5,4-6,6-10,6-7,8-9,?,abaxial,absent,acuminate,acute,adaxial,adaxially,age,along,anther,anthesi,apex,apical,attenuate,ba,bark,basal,base,becoming,berry,bi-lobed,blackish,branch,branching,calyx,cm,conical,coriaceous,corolla,decurrent,dendritic,densely,denser,diameter,dichasia,eaf,edicel,eed,elliptic,erect,ew,except,exserted,filament,flattened,flower,fork,free,fruiting,glabrat,glabrous,glandular,globose,growth,immature,impressed,inserted,later,leaf,leave,like,lobe,lobed,long,lower,m.,margin,midvein,minute,minutely,mm,mucronate,narrowly,nflorescence,nodding,obovate,occasionally,older,outline,ovary,pair,papillo,pedicel,per,pericarp,petal,petiole,pitted,planar,plurifoliate,pore,poricidal,portion,prominent,pubescent,pyramidal,reddish-brown,revolute,round,ruit,scar,secondary,shiny,short,shrub,sleeve,slit-like,somewhat,sparsely,stamen,ste,stem,stigma,strongly,style,surface,tall,tapering,terminal,thin,time,tip,triangular,trichome,tub,tube,ud,unit,vein,violet,way,white,wide,winged,woody,x,ympodial,young	
238	wfo-0001028529	success	164	181	135	29	46	0.823	.2,0.1,0.5,0.5-2,0.8-1.3,0.8-3,0.8-3.2,1,1-1.2,1-1.5,1.5,2.5-3,2/3,3-40-flowered,3-5,5-6,6-9,7-8,8-14,acuminate,anther,anthesi,apex,apiculate,attenuate,bark,base,beneath,berry,bluish,brown,bud,calyx,capitate,cast,cm,corolla,course,dark,decurrent,deltoid,dia,distal,elliptic,erect,evenly,exfoliating,exserted,filament,free,fruiting,furcate,glabrous,globose,green,growing,hyaline,immature,internodal,lanceolate,lateral,leaf,less,linear,lobe,lobed,long,main,major,metallic,middle,minor,minutely,mm,much,narrowly,nearly,oblanceolate,occasionally,older,one,opposite,ovary,ovoid-reniform,pair,paler,papillose,pedicel,petiole,pitted,planar,pore,poricidal,portion,present,prominent,range,reflexed,river,scar,shape,shaped,short,shrub,simple,size,slender,slightly,small,smooth,somewhat,soon,spaced,species,stem,stigma,straight,style,subshrub,surface,tapering,tear-drop,tip,tube,umbonate,variable,vein,way,white,widest,winged,woody,x,yellowish,young	across,acute,age,apart,becoming,beginning,close,cork,deflexe,eaf,edicel,eed,ellipsoi,flower,heterostylous,hrub,indistinct,inflorescenc,lenticellat,lon,lower,minute,nflorescence,papillae,papillo,ruit,scattered,tall,ud	.5,appearance,arrangement,border,branch,characteristic,colour,corrugation,deflexed,diameter,drying,ellipsoid,exertion,form,fruit,giving,glabrousnes,growth,height,history,inflorescence,interjected,leaflet,length,lenticellate,life,lobing,margin,midpoint,new,null,number,peduncle,per,plant,prickle,primary,pseudostipule,ray,seed,terminal,texture,thicknes,type,variation,width
239	wfo-0001028532	success	186	166	121	65	45	0.651	0-19,0.2-1,1-1.6,1-1.7,1-2,1-3,1-5,1.3-8.7,1.4-1.6,15-36,17-42,2-3,2-8,2.2-4.2,3-10,3-7,3.3-4.4,3.9-5,4-7,5-9,6.5-9.2,7.5-15.2,abaxially,acumen,acuminate,acute,adaxially,along,anther,apex,apparently,arranged,asymmetric,attenuate,axe,axillary,base,basiscopic,bead,berry,brownish,bud,cell,clavate,cm,condition,corolla,covering,dark,deep,diameter,distal,drying,filament,flower,forked,fresh,fruit,generally,glabrous,globose,green,greenish,half,herb,interjected,lanceolate,lateral,leaf,leaflet,like,linear,lobe,long,make,medium,mm,moniliform,mottled,mucilaginous,multiple,necklace,odd-pinnate,ovate,ovate-lanceolate,ovoid,pedicel,peduncle,perfect,petiole,petiolulate,plant,plurifoliate,purple,ripe,rounded,seed,side,size,sometimes,spot,stigma,stolon,style,subtending,symmetric,terminal,testal,thick,tissue,tri-,tube,tuber,typically,unwinged,usually,wall,wet,white,whitish,x	2-6,3-5,5-merou,5.5-15,abaxiall,ag,alyx,apart,articulated,blade,capitat,chartaceous,connivent,decreasing,digestion,dorsally,eaf,edge,eed,enzyme,erec,exceeding,flat,folded,geminat,glabrou,green-white,hair-like,homostylous,honeycomb-shaped,larger,lengthening,living,lower,middl,nflorescence,orbicular,orolla,pair,pentagonal,pore,poricidal,removed,rotate,ruit,second,sessile,seudostipule,slightly,slit,spaced,specimen,stamen,straight,subequal,tall,tamen,tem,throughout,tip,toward,unit,vary,yellow,ympodial	'hair-like,appearance,arrangement,bark,border,branch,calyx,capitate,characteristic,colour,corrugation,erect,exertion,form,fruiting,geminate,giving,glabrousnes,growth,height,history,inflorescence,length,life,lobing,margin,midpoint,new,number,ovary,per,prickle,primary,pseudostipule,ray,shape,stem,surface,texture,thicknes,type,unspecified,variation,vein,width
240	wfo-0001028547	success	224	233	193	31	40	0.862	-1/2,-13,-3,-6,.2,.5,.7,.8,/2,/5,0,0-1,0-10,0-15,0-2,0-30,0-5,0.1-0.2,0.15,0.2-0.35,0.3-0.4,0.5-,0.8-1,1-2,1-2.5,1-4,1-5,1.2-1.4,1.5-2.5,1.7-2,1/3,1/5-1/4,10-12,2-1.5,2-2.5,2-4,2-6,2.5-2.8,2.8-3.2,3-5,3.5-4.5,4-5,4-6,6-8,7-10,7-9,abaxial,absent,acute,adaxial,anther,apart,apex,apically,apparently,appearing,articulated,bark,base,berry,blade,branched,branching,bright,bulbous,calyx,cell,chartaceous,cm,conical,connivent,cream,cuneate,curved,dark,deltate,densely,diameter,discolorous,distance,drying,dull,elongate,elongating,entire,equal,erect,extending,faint,filament,flattened,flattened-reniform,flower,free,fruit,fruiting,gently,glabrescent,glabrous,green,inflorescence,infructescence,lateral,leaf,length,lobe,lobed,long,long-acuminate,long-styled,longer,margin,marking,mature,maturity,mauve,midpoint,midvein,mm,moderately,narrow-deltate,often,older,one,open,orange,orange-brown,outline,ovate,pair,pale,pedicel,peduncle,pendulous,per,pericarp,petiole,pit,poricidal,porrect,portion,prickle,prickly,primary,purple,raised,ray,red,reddish,reflexed,rounded,scandent,sessile,shallowly,shrub,side,simple,slender,small,smooth,sometimes,somewhat,spaced,spherical,stalk,stalked,stellate,stellate-pubescent,stem,straight,style,subsessile,surface,tapering,terete,terminal,tertiary,time,tip,trichome,truncate,tube,unit,vein,venation,villous,way,wide,woody,yellow,yellow-green,yellow-orange,young	0.05-0.15,0.7-1,5-merous,abaxially,alyx,apar,ape,eaf,eed,glabrou,gray-brow,lon,lower,nflorescence,oblong,occasionally,orolla,oung,perfect,plurifoliat,prickl,ruit,scar,short-styled,spreading,staminate,tamen,thin-acuminat,usually,vary,ympodial	appearance,arrangement,border,branch,bud,characteristic,colour,corolla,corrugation,distal,exertion,form,giving,glabrousnes,gray-brown,growth,height,history,interjected,leaflet,life,lobing,new,null,number,ovary,plant,plurifoliate,pseudostipule,seed,shape,size,stigma,sympodial,texture,thicknes,thin-acuminate,type,variation,width
241	wfo-0001028587	success	178	183	142	36	41	0.798	.4,.5,.75,0,0.3,0.3-1,0.5,0.5-1,0.8-1.6,0.8-1.8,0.8-2.9,1-1.3,1-1.5,1-2,1-4,1.3-5.1,1/4,2-5,2.1-6.9,2.5,3-8,6-8,6.5-17.7,8-10,8-10-flowered,abruptly,across,acuminate,acute,anther,anthesi,apex,bark,base,becoming,berry,brown,calyx,cm,corolla,cracking,deflexed,degree,densely,dia,difoliate,distal,drying,ellipsoid,erect,filament,flower,free,fruit,fruiting,geminate,glabrous,globose,green,greenish-white,impressed,lamina,lateral,layer,leaf,length,like,lobe,lobed,long,long-styled,lower,main,major,middle,minor,minute,minutely,mm,narrowing,nearly,obe,obovate,obovoid,occasionally,often,older,opposite,outer,ovary,ovate,ovoid-reniform,pair,paler,papillose,pedicel,peeling,per,persistent,petiole,pitted,portion,puberulent,pubescence,pubesent,reflexed,scattered,seed,short,shrub,simple,slender,sparsely,stem,stiff,stigma,straight,straw-colored,style,subumbellate,surface,tall,terminal,thickened,tip,triangular,trichome,tube,type,umbonate,unicellular,uniseriate,unit,upper,usually,variable,vein,white,widest,woody,x,young	0.7-1.2,accrescent,baseflower,ca,chartaceou,closely,coat,cup,different,eaf,edicel,eed,forming,geminat,keeled,lon,midrib,nflorescence,open,overlappin,papillo,pore,poricidal,pubescent,ruit,scar,slightly,slit-like,spaced,thin,transversel,two,ud,upon,wide,ympodial	appearance,arrangement,border,branch,bud,characteristic,chartaceous,colour,corrugation,diameter,exertion,form,giving,glabrousnes,growth,height,history,inflorescence,interjected,leaflet,life,lobing,margin,midpoint,new,null,number,peduncle,plant,prickle,primary,pseudostipule,ray,shape,size,sympodial,texture,thicknes,transversely,variation,width
242	wfo-0001028594	success	142	166	119	23	47	0.838	.5,0-100,0.3-1.0,0.8-1.8,1-1.2,1-1.3,1-1.5,1-2,1-3,1.5-9,12,12-14,2,3-4,3-6,3-9,5-6,6-20,6-7,abaxially,acuminate,acute,adaxially,along,anther,anthesi,apex,axil,axillary,base,bearing,becoming,berry,black,bottle-shaped,calyx,cell,climbing,cm,conical,corolla,densely,denser,diameter,drying,ellipsoid,elliptic,epidermal,especially,exserted,filament,flattened-reniform,flower,forest,fruit,fruiting,glabrous,globose,green,hair-like,herb,immature,inflorescence,lax,leaf,length,like,lobe,long,margin,maturity,minute,minutely,mm,obtuse,often,open,orange-brown,ovary,ovate,pair,pedicel,pendent,per,petiole,planar,primary,projection,pubescent,purple,quit,rectangular,reddish,reflexed,regular,rest,rounded,scar,side,simple,slightly,soft,somewhat,sparsely,spreading,stigma,strait,strongly,style,surface,time,trailing,trichome,tube,uniseriate,unit,vein,violet,x	capitat,eaf,edicel,eed,floo,free,glabrat,inflorescenc,lon,lower,nflorescence,noddin,papillate,portion,ruit,scattered,smooth,tem,tip,tub,ud,unifoliat,ympodial	appearance,arrangement,bark,border,branch,bud,capitate,characteristic,colour,corrugation,distal,exertion,floor,form,giving,glabrate,glabrousnes,growth,height,history,interjected,lateral,leaflet,life,lobing,mentioned,midpoint,new,nodding,number,peduncle,plant,prickle,pseudostipule,ray,seed,shape,size,stem,sympodial,terminal,texture,thicknes,type,unifoliate,variation,width
243	wfo-0001028660	success	204	166	120	84	46	0.588	0.2-1.1,0.3-1.1,0.5-2.8,0.5-5.5,0.7-4.2,0.8-1,0.9-2.5,1-10,1-2,1.5-2.8,1.5-4,1.5-7.6,2-11,2-6,2-9,3-30,3-7,3-9,3.8-13,4-6,5-8,6,7-10,abaxially,absent,acute,adaxially,anther,apex,articulated,axillary,base,berry,blue,broadly,brownish,bud,cell,ciliate,clavate,cm,condition,connivent,corolla,covering,decumbent,decurrent,densely,diameter,distal,dot,drying,elliptic,entirely,filament,flower,forked,fresh,fruit,generally,glabrous,globose,green,greenish,hair,half,herb,interjected,lanceolate,lateral,leaflet,like,linear,lobe,long,make,margin,mm,mucilaginous,narrowly,oblique,obtuse,odd-pinnate,often,ovoid,pedicel,peduncle,pentagonal,petiole,plant,plurifoliate,pubescent,purple,ripe,rotate,scabrous,scattered,seed,short,size,sparsely,stem,stigma,style,substellate,subtending,terminal,testal,thick,tinged,tri-,tube,unit,unwinged,usually,wall,wet,white,whitish,x	0-5,0.1-0.3,2-5,20,3-5,5-merou,acumen,ag,along,alyx,apart,apparently,attenuate,axe,blade,borne,capitat,chartaceous,digestion,dorsally,eaf,edge,eed,end,enzyme,erec,especially,exceeding,except,flat,folded,geminat,glabrou,greatly,green-white,hair-like,homostylous,honeycomb-shaped,lengthening,less,living,lower,membranous,middl,midrib,minutely,nflorescence,orbicular,orolla,ovate,pair,perfect,petiolulate,petiolule,pore,poricidal,proximal,puberulent,rarely,reduced,removed,ruit,sessile,seudostipule,singly,slit,spaced,specimen,stamen,ste,stolo,straight,subequal,sunny,tall,tamen,tem,throughout,tip,tuber,typically,vary,yellow,ympodial	'hair-like,appearance,arrangement,bark,border,branch,calyx,capitate,characteristic,colour,corrugation,erect,exertion,form,fruiting,geminate,giving,glabrousnes,growth,height,history,inflorescence,leaf,length,life,lobing,mentioned,middle,midpoint,new,number,ovary,per,prickle,primary,pseudostipule,ray,shape,surface,sympodial,texture,thicknes,type,variation,vein,width
244	wfo-0001028667	success	129	144	98	31	46	0.76	-2.6,0.4-0.7,0.7-4,1-1.5,1-2-1.5,1-4.5,1-6,1.3-2,3,3-11,5-20,8-10,acute,aid,anthesi,apex,appearing,around,axillary,base,berry,branch,branched,calyx,cell,climbing,clustered,cm,completely,conical,coriaceous,corolla,creamy,curling,deciduous,diameter,discolorous,dry,ellipsoid,elliptic,entire,exfoliating,exserted,flattened,flower,fragrant,fruiting,glabrous,growth,inflorescence,leaf,like,lobe,long,margin,midrib,minutely,mm,narrowly,new,occasionally,older,outer,pale,pedicel,peduncle,per,petiole,pitted,primary,reniform,revolute,shiny,shoot,short,simple,slender,slightly,soon,stem,straw-colored,strongly,support,surface,terminal,tip,triangular,tube,twice,twining,vein,vine,visible,white,woody,wrinkling,x,yellow	.5,5,5-merou,alyx,apar,ark,articulated,climbin,eaf,eed,exfoliatin,fide,irregularly,lower,mentz,nflorescence,orolla,other,papilla,papillat,pendan,perfect,plurifoliat,scar,sleeve,small,spaced,tem,ud,unit,ympodial	anther,appearance,arrangement,bark,border,bud,characteristic,colour,corrugation,description,distal,drying,exertion,filament,form,fruit,giving,glabrousnes,height,history,interjected,lateral,leaflet,length,life,lobing,mentioned,midpoint,number,ovary,papillae,pendant,plant,prickle,pseudostipule,ray,seed,shape,size,stigma,style,texture,thicknes,type,variation,width
245	wfo-0001028688	success	137	169	117	20	52	0.854	.5,0.4-1,0.5,0.5-0.75,0.5-1,0.5-1.5,0.9-1,1-1.5,1-1.8,1-3,1-5,1.1-1.2,1.4-2.8,2-3,2.2-4.8,5-11,5-6,acuminate,acute,along,anther,anthesi,apex,area,bark,base,beneath,bi-cellular,branch,calyx,clavate,cm,corolla,curl-tipped,deciduous,decreasing,deltoid,densely,densest,dia,differing,elliptic,exserted,filament,free,furcate,glabrous,globose,golden,interpetalar,irregularly,known,lanceolate,leaf,like,lobe,lobed,long,major,markedly,membraneous,middle,minor,minutely,mm,near,nearly,occasionally,often,older,opposite,ovary,overtopping,paler,papillose,pedicel,petiole,pilose,planar,pore,poricidal,portion,proximal,pubescent,reddish-brown,scar,shaped,shiny,shoot,shrub,sinus,size,slender,slightly,soon,spaced,sparsely,stem,stigma,straight,style,tall,tapering,tear-drop,terminal,thickened,thin,tip,trichome,tube,uniseriate,vein,white,wide,widest,x,young	across,apar,deflexed,difoliate,eaf,edicel,eed,exfoliatin,geminat,know,lon,lower,nflorescence,ruit,styl,tub,ud,unit,usually,ympodial	apart,appearance,arrangement,border,bud,characteristic,colour,corrugation,diameter,distal,drying,exertion,exfoliating,form,fruit,fruiting,given,giving,glabrousnes,growth,height,history,inflorescence,interjected,lateral,leaflet,length,life,lobing,margin,mentioned,midpoint,new,null,number,peduncle,per,plant,prickle,primary,pseudostipule,ray,seed,shape,specific,surface,texture,thicknes,type,value,variation,width
246	wfo-0001028698	success	166	184	132	34	52	0.795	0.3-0.75,1-2,1-4,1-9.8,1.8-5,1.9-4,13-25,2-10,2-3,2-4,3-17,3-5,3.5,4-14,5-15,5-6,5-8,6,6-13,6-27,8-10,9-35,abaxially,acumen,acuminate,acute,adaxially,apex,apical,apically,articulate,base,branched,broadly,calyx,cell,cm,commonly,conical,connate,corolla,covering,cyme,dark,darker,decurrent,dehiscent,diameter,dichasial,dichasially,distal,dorsally,dot,ebracteate,edge,ellipsoid,elliptical,exceeding,filament,flat,flower,folded,forked,generally,green,green-white,half,herbaceous,interjected,introrse,lateral,leaf,leaflet,light,living,lobe,long,long-attenuate,make,maturing,medium,minute,mm,monochasial,mucilaginous,oblique,odd-pinnate,often,ovate,ovoid,pedicel,peduncle,pentagonal,perennial,perfect,petiole,petiolule,plant,poricidally,proximal,puberulent,pubescent,rachi,raised,rarely,rotate,seed,sessile,short,size,slit,smooth,specimen,stamen,stigma,straight,strigose,style,terminal,testal,thick,throughout,tuber-bearing,typically,unit,usually,violet,wall,white,wide,yellow,Â¼	0-1.,3-6-foliat,abaxiall,cuneate,digestion,diminishing,eaf,eed,emoval,enzyme,equal,first,globo,gradually,hair-like,honeycomb,lon,lower,lunat,nflorescence,nther,orolla,pair,pattern,plan,reveal,ruit,seudostipule,tal,tem,toward,two,vary,ympodial	'hair-like,0-10,3-6-foliate,anther,appearance,arrangement,bark,border,branch,bud,characteristic,colour,corrugation,drying,exertion,form,fruit,fruiting,giving,glabrousnes,globose,growth,height,history,inflorescence,length,life,lobing,lunate,margin,mentioned,midpoint,new,number,ovary,per,prickle,primary,pseudostipule,ray,shape,stem,surface,sympodial,texture,thicknes,tube,type,variation,vein,wet,width
247	wfo-0001028716	success	145	172	122	23	50	0.841	.2,.5,0.5,0.6-1.9,0.75,1-2,1.9-5.5,10-40-flowered,11-16.4,2-4,2.2-7.9,2.5-8,3.6-8.8,5-6,7-8,8-9,9-10,acuminate,anther,anthesi,apex,appearing,asymmetric,bark,base,becoming,beneath,bi-cellular,branched,brown,calyx,cm,corolla,cuneate,dark,decurrent,deflexed,dia,difoliate,ellipsoid,elliptic,except,fertilization,fifth,filament,filiform,free,fruit,geminate,glabrous,glandular,hirsute,intermediate,known,lateral,leaf,lengthening,less,like,lobe,lobed,long,long-triangular,main,major,markedly,middle,minor,minutely,mm,much,nearly,node,often,older,opposite,orbicular,ovary,ovate,pair,papillose,pedicel,petiole,pointed,pore,poricidal,portion,prominent,proximal,puberulent,pubescent,raised,reflexed,remaining,rounded,shape,shaped,shrub,simple,size,slightly,sparsely,stem,straight,strongly,style,tall,tear-drop,tip,triangular,trichome,truncate,tube,two,uniseriate,unit,vein,white,widening,widest,x,young	across,anisophyllou,apart,ba,beginning,differing,eaf,edicel,eed,evenly,inflorescenc,know,lenticellat,lon,lower,nflorescence,one,ruit,scar,spaced,stigm,ud,ympodial	anisophyllous,appearance,arrangement,border,branch,bud,characteristic,colour,corrugation,described,diameter,distal,drying,exertion,form,fruiting,giving,glabrousnes,growth,height,history,inflorescence,interjected,leaflet,length,lenticellate,life,lobing,margin,midpoint,new,null,number,peduncle,per,plant,prickle,primary,pseudostipule,ray,seed,stigma,surface,sympodial,terminal,texture,thicknes,type,variation,width
248	wfo-0001028723	success	211	238	192	19	46	0.91	-1.5,.3,.5,0-0.5,0.2,0.8-1,0.8-2,0Â°,1,1-1.5,1-1.8,1-2.2,1-2.5,1/3-1/2,1/5-1/3,10-15,10-16,2-2.5,2-2.7,2-4,2.5,3-4,3.5-4,4,4-5,5,5-6,5-7,abaxial,abaxially,acute,adaxially,age,almost,alternate,alyx,another,anther,anthesi,apar,apex,apically,apparently,articulated,bark,base,becoming,brachyblast,branch,branched,branching,broadly,brown,calyx,capitate,clearly,cm,common,concolorous,conical,corolla,curved,dark,decurrent,delineated,deltoid,dendritic,densely,density,developed,diameter,dilated,divided,domatia,dorsifixed,drying,elliptic,entire,equal,except,faint,filament,fine,flat,flexuous,flower,formed,free,frequent,glabrous,gradual,green,increasing,inner,junction,known,leaf,length,lengthening,less,liana,like,lobe,lobed,long,long-attenuate,main,margin,membranous,middle,midvein,minutely,mm,mostly,much,multiply,naked,narrowly,obconical,oblong,obovate,obtuse,occasional,one,orange-brown,outer,ovate,overlapping,pair,pale,pedicel,peduncle,perfec,petiole,poorly,pore,poricidal,portion,primary,prominent,protruding,pubescent,rachi,raised,ray,region,regular,ridged,scar,separated,shrub,side,simple,sinus,slender,small,smaller,smooth,sparsely,spreading,stem,stigma,stump,style,surface,surrounding,tearing,terminal,tertiary,tip,toward,transition,trichome,tube,tuft,ud,unarmed,uneven,unevenly,unit,vein,venation,visible,white,wide,widely,wrinkled,x,yellow,ympodial,young,youngest	apice,clustered,eaf,eed,ellipsoi,ey,know,longitudinally,lower,m.,nflorescence,nther,orolla,papillo,plurifoliat,ruit,short,tissu,vary	appearance,arrangement,border,bud,characteristic,colour,corrugation,distal,ellipsoid,exertion,eye,form,fruit,fruiting,giving,glabrousnes,growth,height,history,inflorescence,interjected,lateral,leaflet,life,lightly,lobing,midpoint,new,null,number,ovary,papillose,per,plant,plurifoliate,prickle,pseudostipule,seed,shape,size,texture,thicknes,tissue,type,variation,width
249	wfo-0001028736	success	180	188	142	38	46	0.789	0.2-0.4,0.5,0.5-1,0.5-1.5,0.5-1mm,0.5-2,1,1-1.5,1-2,1-3,1.5,1.5-3,10-15,2-4,2-5,2-7,3-5,3-6,3-8,3.5-5,4-12,4-6,40-70,5-10,5-15,6-13x3-8,6-8,abaxially,absent,acute,adaxially,anther,apar,apex,apparently,armed,attenuate,axe,base,berry,beyond,blade,brown,calyx,cm,connivent,contiguous,created,cylindrical,dark,decurrent,densely,diameter,difoliate,either,exserted,extra-axillary,filament,filiform,flower,fruit,fruiting,geminate,glabrous,glandular,globose,green,hair,immature,leaf,length,light,like,lobe,lobed,long,lower,major,many,mature,midpoint,midvein,mm,moderately,mottled,multicellular,multiseriate,narrowly,nearly,netlike,obtuse,occasionally,onto,orange,pair,pedicel,peduncle,per,perfect,petiole,pit,porrect-stellate,prickle,pubescent,rachi,raised,ray,recurved,red,reniform,rhombic,ridge,roselike,shrub,side,simple,small,spaced,sparsely,stalk,stamen,stellate,stem,stigma,style,surface,tapering,thin-skinned,triangular,tube,unarmed,unbranched,unicellular,uniseriate,unit,unlobed,vein,white,wide,x,yellow,yellow-white	1/6,4-9,5-merou,accrescent,adaxiall,alyx,apical,chartaceous,cordate,cut,directed,discolorous,eaf,eed,flattened,frui,glabrou,gree,introsel,less,m.,midrib,nflorescence,occasional,orolla,pore,purple,ruit,scanden,sinus,slightly,ste,tamen,tem,unequa,vary,way,ympodial	5-merous,appearance,arrangement,bark,border,branch,bud,characteristic,colour,corolla,corrugation,distal,drying,exertion,form,giving,glabrousnes,growth,height,history,inflorescence,interjected,lateral,leaflet,life,lobing,margin,mentioned,new,number,ovary,plant,primary,pseudostipule,scandent,seed,shape,size,sympodial,terminal,texture,thicknes,type,unequal,variation,width
250	wfo-0001028737	success	151	167	114	37	53	0.755	0.2-0.5,0.7-2,1,1-2.5,1-4,1-6,1.5-3.5,10,12-14,16-30,2-3,2-5,2.8-3.5,3-5,4-10,4-6.5,4-9,5-6,6,7-15,abaxially,acumen,acuminate,acute,adaxially,apex,apical,apically,apiculate,articulate,base,branched,calyx,caudate,cell,cm,connate,corolla,covering,cyme,decurrent,dehiscent,diameter,dichasial,dichasially,distal,dorsally,ebracteate,edge,elliptic-lanceolate,exceeding,filament,flat,flower,folded,forked,generally,glabrescent,glandular,globose,green,green-white,half,herbaceous,interjected,introrse,lanceolate,lateral,leaf,leaflet,lobe,long,make,maturing,mm,monochasial,mucilaginous,oblique,oblong,odd-pinnate,often,ovoid,pedicel,peduncle,perennial,perfect,petiole,plant,poricidally,proximal,rachi,seed,sessile,short,size,slit,stamen,stellate,stigma,straight,strongly,style,terminal,testal,thick,throughout,tuber-bearing,typically,unit,wall,wide,without,yellow,Â¼	3-4,3-6-foliat,absen,attenuate,digestion,diminishing,eaf,eed,emoval,enzyme,globo,gradually,hair-like,honeycomb,larger,living,lon,lower,nflorescence,nther,orolla,pair,pattern,pinnatifi,plan,reveal,ruit,second,seudostipule,specimen,tal,tem,throughou,toward,vary,whit,ympodial	'hair-like,3-6-foliate,absent,anther,appearance,arrangement,bark,border,branch,bud,characteristic,colour,corrugation,drying,exertion,form,fruit,fruiting,giving,glabrousnes,growth,height,history,inflorescence,length,life,lobing,margin,mentioned,midpoint,new,number,ovary,per,pinnatifid,prickle,primary,pseudostipule,ray,shape,stem,surface,sympodial,tall,texture,thicknes,tube,type,variation,vein,wet,white,width
251	wfo-0001028777	success	205	197	157	48	40	0.766	-10,-2.5,-3,-4,.5,.8,.9,0-2,0-30,0.1-0.2,0.2,0.4-0.8,0.5-1.3,0.6-1,0.7-1.2,0.7-1.3,0.8-1,0.8-2.2,1-2,1-2.5,1-3,1.5,1.5-3,1.5-4,1.8-2.5,1/4,2-,2.5,2.5-3,2.5-5,3,3.5-5,3/4-4/5,4.5-8,7-11,8-15,acute,anther,apex,apically,attenuate,bark,base,berry,blade,branched,briefly,calyx,chartaceous,cm,concolorous,connivent,curved,dark,deltate,diameter,discolorous,drying,elongating,entire,equal,erect,filament,flattened-reniform,flower,free,fruit,fruiting,glabrescent,glabrous,green,green-brown,inflorescence,infructescence,leaf,length,less,lobe,lobed,long,long-styled,longer,margin,marking,mature,maturity,mauve,midpoint,minute,mm,moderately,multangulate,obovate,older,one,open,orange,orange-brown,ovate,pair,pale,pedicel,peduncle,per,pericarp,petiole,poricidal,portion,present,primary,ray,recurved,red-brown,reflexed,retuse,rounded,sessile,shoot,short,shorter,shrub,simple,small,smooth,sometimes,somewhat,soon,sparsely,spherical,stalk,stalked,stellate-pubescent,stem,stout,strongly,style,surface,tapering,terete,terminal,time,tip,tree,trichome,truncate,tube,unarmed,variously,vein,way,white,whole,wide,wider,woody,yellow-green,young	-12,0.1-0.3,1,1/4-1/2,4-5-merous,6-10,8,abaxially,acuminat,alyx,ame,apar,ape,articulated,c.,deciduou,eaf,eed,faint,glabrescen,lengt,lower,narrow-deltate,nflorescence,occasionally,orolla,oung,perfect,plurifoliat,porrect,reflexe,ruit,scar,short-styled,shorte,spaced,spreading,staminate,stellate,tamen,tertiary,unarme,unit,usually,vary,venation,visible,ympodial	acuminate,appearance,arrangement,border,branch,bud,characteristic,colour,corolla,corrugation,deciduous,distal,exertion,form,giving,glabrousnes,growth,height,history,interjected,lateral,leaflet,life,lobing,mentioned,new,number,ovary,plant,prickle,pseudostipule,seed,shape,size,stigma,texture,thicknes,type,variation,width
252	wfo-0001028791	success	257	257	219	38	38	0.852	+,-0.6,-1.5,-9,.5,0-6,0.05,0.05-0.2,0.2-0.3,0.2-0.4,0.2-0.8,0.25-0.3,0.3-0.4,0.3-0.5,0.4-0.5,0.4-0.6,0.4-0.65,0.45-0.55,0.5,0.6-0.8,0.8-1,0.8-1.3,1-1.5,1-2,1-2-celled,1-3,1-3-celled,1.5-,1.5-2,1.6-4.5,1.7-2.1,1.8-3.3,10,100,2-3,2-3.5,2-7,2-7-celled,2-locular,2.5-4.5,2.8-3.0,20-to,3-,4-11.5,4-15,4-5+,4-celled,5-,5-10,5-15,5-22,5-plurifoliate,50-80,8-10-celled,9-30,9-35,abaxially,absent,abundant,acuminate,acute,adaxially,addition,along,anther,anthesi,apex,apical,appearance,appendage,articulated,articulation,basal,base,basiscopically,beneath,border,branched,breaking,broadly,brown,bullate,calyx,capitate,cell,clambering,cm,conical,corolla,dark,darker,deciduous,deltate,densely,densest,developed,diameter,dichotomously,ebracteate,eglandular,elliptic,elongating,enlarged,entire,exserted,extended,filament,flower,fruit,fruiting,give,glabrescent,glabrous,glandular,globose,green,grow,growing,hair-like,half,halfway,head,imparipinnate,interjected,internode,interrupted,lamina,large,lateral,leaf,leaflet,leaving,less,liana,like,lobe,long,many,margin,middle,minutely,mixture,mm,much,multicellular,near,oblique,obovate,occasionally,often,outgrowth,ovary,pale,paler,pedicel,peduncle,per,petiole,petiolule,plant,poorly,present,primary,protuberance,pseudostipule,pubescence,pubescent,rachi,rough,round,sandpapery,scandent,seed,sessile,short,shorter,silky,simple,slightly,small,sometimes,somewhat,sparse,sparsely,spreading,stellate,stem,sterile,stiff,stigma,straight,style,surface,terminal,testa,thick,thickened,time,tip,touch,transparent,trichome,truncate,tube,unicellular,uniseriate,unit,upper,usually,vegetation,vein,vine,wall,white,wide,winged,woody,yellow,â1-2-celled	0.3-0.6,0.3-0.8,0.4-1.1,0.6-0.9,0.7-1.5,1-celled,3-4,absen,ag,berr,colo.,column,consistently,eaf,edicel,eed,even,free,gree,lon,lower,midvein,nflorescence,pair,papillate,reflexed,rest,ruit,secondary,single,smaller,stamen,staminal,tal,tem,tertiary,ud,ympodial	age,arrangement,bark,berry,branch,bud,characteristic,color,colour,corrugation,distal,drying,exertion,form,giving,glabrousnes,growth,height,history,inflorescence,length,life,lobing,mentioned,midpoint,new,number,prickle,ray,shape,size,sympodial,tall,texture,thicknes,type,variation,width
253	wfo-0001028798	success	214	197	154	60	43	0.72	.5-5,0-1,0-60,0.2-0.4,0.9-1.2,1-4.5,1-6,1.1-2,1.5-1.8,1/2-2/3,1/20,10,15-19,2-3,2-6,2-7,2/3,3-4,3-5,3.3-5.6,5-8,5.25-7.5,6-10,6-8,7-8,8-18,abaxially,acuminate,acute,adaxially,anther,anthesi,apart,apex,articulated,attenuate,axe,axillary,base,becoming,berry,blade,blunt-tipped,boat-shaped,branch,branched,bud,calyx,chartaceous,cm,conical,continued,corolla,curved,decurrent,densely,diameter,distal,dm,downward,due,echinoid,entire,exserted,filament,fleshy,flower,fruit,fruiting,glabrous,granular,granular-tomentose,green,greenish,growth,hair,included,inserted,lacking,lanceolate,large,lateral,leaf,length,less,lined,lobe,lobed,long,main,margin,midvein,mixed,mm,multangulate,nearly,oblanceolate,oblong,obovate,orbicular,ovate-lanceolate,overlapping,pale,pedicel,peduncle,persistently,petiole,plurifoliate,porrect-stellate,present,probably,pseudo-terminal,quite,rachi,rather,ray,ripe,rough,rough-granular,sessile,short,short-stalked,shrub,side,simple,slightly,small,spaced,sparingly,stalked,stellate-pubescent,stem,stigma,strongly,style,subcampanulate,subcoriaceous,subglobose,sulcate,thick,time,tip,tomentose,toward,tube,unarmed,unit,vein,velutinous,way,wide,x,yellow,yellowish	0.5-2,1-3,2-3.75,2.4-4.4,2.5-3.5,2.6-4,3.8-4.2,4-5.4,8.5-13,accrescent,ag,apical-lateral,apparently,ba,capitat,cylindrical,dehiscing,eaf,echinoi,eed,extend,free,hal,high,introrse,irregularly,longitudinal,lower,m.,many,minutely,multangulat,nflorescence,oblanceolat,obscured,obtuse,often,orolla,oung,perfect,persistent,pore,prominent,pubescent,rotate-stellate,ruit,semi-ovate,slit,somewhat,splitting,stamen,suture,tamen,tomentu,tomentum,translucent,unarme,unknow,vary,ympodial	appearance,arrangement,bark,border,capitate,characteristic,colour,corrugation,drying,exertion,form,giving,glabrousnes,height,history,inflorescence,interjected,leaflet,life,lobing,midpoint,new,null,number,ovary,per,plant,prickle,primary,pseudostipule,seed,shape,size,surface,sympodial,terminal,texture,thicknes,type,unknown,variation,width,young
254	wfo-0001028815	success	196	171	128	68	43	0.653	0.4-0.8,0.5-1,1-10,1-2,1-3.5,1-4,1-5,10-15,14-28,2-4,2-4.5,2.5-6.5,22-35,3-4,3-5,3-7,4-10,5-6,6-10,6-8,7-16,abaxially,acumen,acute,adaxially,anther,apart,apex,apparently,axe,axillary,base,basiscopic,berry,blade,broadly,brownish,bud,cell,chartaceous,cm,condition,corolla,covering,cuneate,dark,decurrent,developing,diameter,distal,drying,elliptic,elliptic-lanceolate,filament,flower,forked,fresh,fruit,generally,globose,green,greenish,hair,half,herb,interjected,lanceolate,lateral,leaflet,like,lilac-purple,lobe,long,make,margin,medium,membranous,mm,mucilaginous,narrowly,obtuse,odd-pinnate,onto,ovate,ovoid,papillose,pedicel,peduncle,perfect,petiole,petiolulate,plant,pointed,pubescent,purple,rachi,red-purple,ripe,rounded,rugose,seed,semi-rosette,sessile,short,side,size,slightly,sparsely,splotched,stem,stigma,style,subtending,terminal,terminated,testal,thick,tinged,triangular-lanceolate,tube,unwinged,usually,wall,wet,whitish,winged,x,young	2-9,5-7,5-merou,ag,along,alyx,articulated,articulation,auriculate,capitat,ciliate,connivent,decreasing,digestion,distinct,dorsally,eaf,edge,eed,enzyme,especially,exceeding,flat,folded,geminat,glabrou,glabrous,green-white,hair-like,hal,high,homostylous,honeycomb-shaped,indistinct,lengthening,living,lower,midrib,minutely,nflorescence,orolla,pair,plurifoliate,pore,poricidal,puberulent,purpl,removed,rotate,ruit,semi-erec,seudostipule,slit,spaced,specimen,stamen,ste,straight,tall,tamen,tem,throughout,tip,tri-,unit,vary,yellow,ympodial	'hair-like,appearance,arrangement,bark,border,branch,calyx,capitate,characteristic,colour,corrugation,exertion,form,fruiting,giving,glabrousnes,growth,height,history,inflorescence,leaf,length,life,lobing,mentioned,midpoint,new,number,ovary,per,prickle,primary,pseudostipule,ray,semi-erect,shape,surface,texture,thicknes,type,variation,vein,width
255	wfo-0001028876	success	127	142	94	33	48	0.74	.5,/4,0.4-1,0.5-2,1-2,1.5-2,1.5-3,2-2.3,3-5,3-8,4-5,4-8,5-6,abaxially,acute,adaxially,along,anther,apex,attenuate,bark,base,brown,calyx,capitate,cm,conical,corolla,dark,dendritic,densely,difoliate,drying,ellipsoid,elliptic,filament,flower,free,glabrous,golden,included,internodal,known,lamina,lateral,leaf,like,lobe,lobed,long,long-triangular,main,middle,midrib,minutely,mm,occasionally,older,opposite,ovary,pair,papillose,pedicel,petiole,portion,pubescent,reddish,rest,rounded,sagittate,shining,shrub,simple,slender,small,sparsely,speciman,stem,stigma,style,subshrub,surface,tall,trichome,tube,type,uniseriate,unit,vein,way,white,widest,x,young	abaxial,anthesi,branched,closely,dia,eaf,edicel,eed,geminat,glabrat,hroughout,inflorescenc,know,leave,lower,nflorescence,nodding,overlappin,papillae,papillo,planar,pore,poricidal,ruti,scar,shaped,spaced,straight,tear-drop,tip,tub,ud,ympodial	appearance,arrangement,border,branch,bud,characteristic,colour,corrugation,diameter,distal,exertion,form,fruit,fruiting,geminate,giving,glabrate,glabrousnes,growth,height,history,inflorescence,interjected,leaflet,length,life,lobing,margin,mentioned,midpoint,new,number,peduncle,per,plant,prickle,primary,pseudostipule,ray,seed,shape,size,sympodial,terminal,texture,thicknes,variation,width
256	wfo-0001028883	success	207	183	136	71	47	0.657	0.5â2,0.6,1,1.5â7,1â2,1â6,2,2â3,2â5,3â5,4,4â6,5,50,6,6â10,6â12,acute,almost,anther,antrorse,antrorsely,apex,arched,articulated,ascending,attenuate,axi,base,becoming,berry,branch,brochidodromous,calyx,capitate,cell,chartaceous,ciliate,cm,completely,concolorous,connivent,coriaceous,curved,cyme,dark,decurrent,deltate,diameter,drying,dull,elliptic,entire,erect,exfoliating,filament,flattened,flower,fruit,geminate,glabrescent,glabrous,globose,green,greenish,growth,herb,hilum,hollow,lateral,leaf,length,like,lobe,long,lying,margin,mm,moderately,narrowly,new,normally,notably,oblong,often,older,onto,ovate-lanceolate,parallel,pedicel,peduncle,per,petiole,plurifoliate,primarily,pubescence,pubescent,rarely,region,reniform,ripe,seed,sessile,shiny,shrub,similar,simple,single,size,slightly,small,sometimes,spaced,sparse,sparsely,spreading,stem,stigma,style,subopposite,subsessile,surface,swollen,tall,trichome,unbranched,undulate,uniseriate,unit,vein,venation,white,whitish,wide,woody,Ã	0.3â0.6,0.4â1.2,5-merou,abaxially,absent,accrescent,acuminate,adaxiall,adaxially,along,alyx,apar,ark,blade,brow,capitat,circular,common,cylindrical,densely,differing,directed,eaf,eed,elliptic-ovate,emarginate,equal,eye,frui,geniculat,glabrou,glandular,head,impressed,introrsely,less,light,longitudinal,lower,membranaceous,midrib,minor,multicellular,naked,nflorescence,obtuse,opening,orolla,pendan,perfect,pore,poricidal,present,prominent,rachi,rounded,ruit,secondary,shap,single-celled,slit,stalk,stellate,straight,subapical,tamen,tem,vary,visible,yellow,ympodial	--,12,3,apart,appearance,arrangement,bark,border,brown,bud,characteristic,colour,corolla,corrugation,distal,exertion,form,fruiting,geniculate,giving,glabrousnes,height,history,inflorescence,interjected,leaflet,life,lobing,mentioned,midpoint,number,ovary,pendant,plant,prickle,primary,pseudostipule,ray,shape,sympodial,terminal,texture,thicknes,tube,type,variation,width
257	wfo-0001028885	success	214	188	151	63	37	0.706	-1,.5,0.3-0.5,0.5-1,0.7-2,1-1.2,1-1.5,1-2,1-3,1.5-1.7,1.5-3.5,10-20,2,2-,2.3-2.5,2.5-3.5,2/3,3-5,3.5-4.5,3.5-8.5,4-5,7-8,7-9,9-11,9-12,?,acute,adaxially,along,anther,anthesi,apex,apiculate,attenuate,basal,base,berry,black,blackish,branch,branched,broadly,brown,calyx,capitate,cm,connivent,corolla,cup-shaped,dark,decurrent,deltate,densely,diameter,distal,dried,drying,ellipsoid,elliptic,entire,erect,exserted,extending,filament,fleshy,flower,fruiting,furcate,glabrescent,glabrous,globose,golden,gradually,groove,growth,height,immature,inflorescence,known,lamina,lanceolate,lateral,leaf,like,live,lobe,lobed,long,loosely,lower,margin,material,midvein,minute,minutely,mm,mostly,multicellular,narrowing,narrowly,new,nodding,occasionally,often,older,pair,part,pedicel,peduncle,petiole,pigmentation,plant,portion,primary,pubescent,purple,quarter,recorded,reddish,retaining,revolute,rhachi,ripe,scandent,scattered,shiny,shrub,simple,slender,slightly,sometimes,sparsely,stem,stigma,strongly,style,surface,terminal,third,time,tip,trichome,tube,uniseriate,vein,vine,way,wide,winged,woody,Â¾	0.5-5,2-2.5,5-merou,abaxial,adaxial,ag,alyx,apart,apparently,archin,ark,articulated,cell,collapsing,dark-pigmented,dendriti,eaf,eed,free,glabrou,glandular,groupe,ilament,inserted,irregularly,leaving,lengthening,less,nflorescence,noddin,orolla,papillo,peg,perfect,pericarp,plurifoliat,pore,poricidal,ruit,scar,shin,short,sleeve,slit,small,smaller,spaced,spheroidal,spreading,stellate,tangled,tem,thin,twinin,ud,unit,upper,usually,vary,wall,weak,weak-walled,ympodial	appearance,arching,arrangement,bark,border,bud,characteristic,colour,corrugation,dendritic,exertion,form,fruit,giving,glabrousnes,history,interjected,leaflet,length,life,lobing,midpoint,number,ovary,papillose,per,prickle,pseudostipule,ray,seed,shape,size,texture,thicknes,type,variation,width
258	wfo-0001028888	success	207	171	128	79	43	0.618	0-3.5,0-5,0-7,0.15-0.5,1,1-1.5,1-10,1-2,1-3,1.5-4,10-25,12.5-25,2-6,2.3-5,2.3-7,2.5-3.3,3-4,3.6-12.5,3.8-8.3,4-25,4-7,5-10,5-7,6-11,8-11,8-13.5,abaxially,acumen,acuminate,acute,adaxially,anther,apex,apiculate,apparently,axe,axillary,base,berry,broadly,brownish,bud,cell,center,central,clavate,cm,condition,connivent,corolla,covered,covering,cuneate,diameter,distal,dot,drying,elliptic,filament,flower,forked,fresh,fruit,generally,glabrous,glaucous,globose,green,greenish,hair,half,herb,interjected,lanceolate,lateral,leaflet,less,like,lobe,long,make,margin,midrib,mm,mottled,mucilaginous,odd-pinnate,often,orbicular,ovate,ovoid,pedicel,peduncle,perfect,petiole,petiolulate,petiolule,plant,pubescent,purple,ripe,scattered,seed,sessile,short,size,slightly,sparsely,stem,stigma,streak,style,subglabrous,subtending,terminal,testal,thick,truncate,tube,unwinged,usually,violet,wall,wet,white,whitish,wing,x	2-5,3-5,5-merou,ag,along,alyx,apart,articulated,blade,capitat,chartaceous,ciliate,digestion,dorsally,eaf,edge,eed,end,enzyme,erec,especially,exceeding,except,flat,folded,geminat,glabrou,greatly,green-white,hair-like,hal,homostylous,honeycomb-shaped,lengthening,living,low,lower,membranous,middle,minutely,nflorescence,oblique,one,orolla,pair,pentagonal,placed,plurifoliate,pore,poricidal,proximal,puberulent,reduced,removed,rounded,ruit,seudostipule,slit,sometimes,spaced,specimen,stamen,ste,stolo,straight,subequal,substellate,tall,tamen,tem,throughout,tip,tri-,tuber,typically,unit,vary,yellow,ympodial	'hair-like,appearance,arrangement,bark,border,branch,calyx,capitate,characteristic,colour,corrugation,erect,exertion,form,fruiting,giving,glabrousnes,growth,height,history,inflorescence,leaf,length,life,lobing,mentioned,midpoint,new,number,ovary,per,prickle,primary,pseudostipule,ray,shape,surface,texture,thicknes,type,variation,vein,width
259	wfo-0001028920	exception_thrown	152	0	0	152	0	0.0		.25,.5,0.2-1,0.5-1,0.8-1.1,1-1.2,1-1.5,1-2.4,1-3,1.5-2,2-2.5,2-7,3-15-flowered,3-3.5,3-4,5-9,6-15,6-6.5,abaxially,acuminate,acute,adaxially,anther,anthesi,apex,arachnoid,arachnoid-pubescent,area,attenuate,axil,ba,bark,base,berry,broadly,brown,brownish,calyx,closely,cm,congested,conical,corolla,cucullate,dark,decurrent,deflexed,deltate,dendritic,dense,densely,dia,differing,difoliate,eaf,edicel,eed,ellipsoid,elliptic,erect,exserted,felty,filament,fleshy,flower,free,fruiting,geminat,glabrate,glabrous,globose,gray-brow,green,later,lateral,leaf,lightly,lobe,lobed,lon,long,long-styled,lower,main,major,middle,minor,minutely,mm,nearly,nflorescence,obovate,obovoid,occasionally,older,opposite,ovary,overlappin,ovoid-reniform,pair,papillose,pedicel,petiole,pitted,planar,pore,poricidal,portion,present,pubescence,pubescent,ruit,scar,shape,shaped,short-styled,shrub,simple,size,small,somewhat,soon,spaced,sparsely,stem,stigma,strongly,styl,style,surface,tall,tapering,tear-drop,thick,tip,tree,trichome,tub,tube,tuft,ud,unifoliate,uniseriate,unit,vein,white,widest,winged,woody,x,ympodial,young	
260	wfo-0001028929	success	210	221	179	31	42	0.852	-2,-2/3,.5,.7,.9,/5,0,0-1,0-10,0-20,0-3,0.1,0.2-0.3,0.2-0.4,0.2-0.8,0.3-0.6,0.4-0.8,0.5-1.5,0.5-2,0.7-1,0.7-2,0.8-1,1,1-1.1,1-3,1.5-2.4,1/2,1/4-1/3,2-3,2-4,2-6,2.2-2.3,2.5-4,2.7-3,2/3-3/4,3-20,3-4,4-6,5-25,5-6,5-7.5,6-8,7-9,8-10,abaxial,acicular,adaxial,anther,apart,apex,apically,apparently,articulated,bark,base,berry,blade,branched,calyx,cell,chartaceous,cm,concolorous,connivent,cuneate,curved,densely,diameter,difoliate,discolorous,distance,drying,dull,elliptic,elongating,equal,erect,extending,filament,flattened-reniform,flower,foliaceous,free,fruit,fruiting,gently,glabrescent,glabrous,hair,inflorescence,infructescence,lateral,leaf,length,lobe,lobed,long,long-styled,longer,margin,mature,maturity,midpoint,midvein,minute,minutely,mm,narrow-deltate,narrow-ovate,oblong,obovate,obtuse,older,one,open,orange-brown,outline,pair,pale,patch,pedicel,peduncle,pendulous,per,pericarp,perpendicular,petiole,pit,poricidal,porrect,portion,prickle,prickly,primary,raised,ray,red,red-brown,red-green,reticulate,rounded,sessile,shrub,side,simple,slender,small,smooth,sometimes,spaced,spherical,spreading,stalk,stalked,stellate,stellate-pubescent,stem,straight,style,surface,tapering,terete,tertiary,time,tip,trichome,tube,unarmed,unit,variously,vein,venation,visible,way,white,wide,woody,yellow,yellow-green	0.15-0.3,2-9,5-merous,abaxially,acute,alyx,apar,ape,eaf,eed,geminat,glabrou,gra,lon,lower,nflorescence,obtu,occasionally,orolla,oung,perfect,prickl,ruit,scar,short-styled,staminate,subsessile,tamen,usually,vary,ympodial	appearance,arrangement,border,branch,bud,characteristic,colour,corolla,corrugation,distal,exertion,form,geminate,giving,glabrousnes,gray,growth,height,history,interjected,leaflet,life,lobing,new,null,number,ovary,plant,pseudostipule,seed,shape,size,stamen,stigma,sympodial,terminal,texture,thicknes,type,variation,width,young
261	wfo-0001028963	success	197	200	157	40	43	0.797	.5,/2,0-0.4,0-2,0.1,0.1-0.25,0.3-0.6,0.3-0.7,0.3-1,0.3-1.5,0.45-0.6,0.6-0.9,0.6-1,0.8-1.8,0.9-1.5,1.5-2,1/4-1/3,1/5,2-2.3,2-3,2-4,2-5,2-9,2.4-2.8,3-4.5,3.5-4.2,4-10,4-8,5-25,6-10,acute,anther,apex,apically,apparently,articulated,attenuate,bark,base,becoming,berry,blade,bright,broad-deltate,brown,calyx,cell,chartaceous,cm,concolorous,connivent,curved,densely,diameter,difoliate,discolorous,drying,dull,elongating,entire,equal,erect,evenly,eye,filament,flattened-reniform,flower,free,fruiting,glabrescent,gray-green,green,herb,herbaceous,inflorescence,infructescence,lanceolate,lateral,leaf,length,light,lobe,lobed,long,long-styled,longer,lower,margin,mature,maturity,mauve,midpoint,mm,moderately,naked,narrow-cuneate,narrow-elliptic,narrowly,obtuse,older,one,open,orange,outline,pair,pale,pedicel,peduncle,pendulous,per,pericarp,petiole,pit,poricidal,porrect,portion,primary,purple,raised,ray,red,sessile,shorter,shrub,simple,slender,slightly,small,smooth,spherical,stalk,stalked,stellate-pubescent,stem,straight,style,surface,tapering,terete,terminal,time,tip,trichome,tube,unarmed,unbranched,unit,upper,variously,vein,visible,way,wide,winged,woody,yellow-orange,young	0.1-0.2,0.15-0.3,1-4,1/,1/6,5-merous,7-8,abaxially,alyx,apar,ape,cuspidat,deltate,eaf,eed,frui,geminat,glabrous,gra,less,nflorescence,occasionally,orolla,oung,perfect,ruit,scar,short-styled,spaced,spreading,staminate,stellate,subsessile,tamen,tertiary,unarme,usually,vary,venation,ympodial	1/2,appearance,arrangement,border,branch,bud,characteristic,colour,corolla,corrugation,cuspidate,distal,exertion,form,fruit,geminate,giving,glabrousnes,gray,growth,height,history,interjected,leaflet,life,lobing,new,null,number,ovary,plant,prickle,pseudostipule,seed,shape,size,stigma,sympodial,texture,thicknes,type,variation,width
262	wfo-0001028971	success	225	205	165	60	40	0.733	-0.8,-1.4,.1-0.2,0.1-0.4,0.1-0.5,0.2-0.5,0.25-0.6,0.25-1.25,0.4-1.5,0.8-2.5,1-2,1.5-2.2,1.75-2.5,1/5-1/2,10-15,15-30,2-5,2.2-3.5,2.5-3.5,2.5-5,20-35,3-14,3-5,3-6,4-9,5-10,5-8,6-16,6-8.5,abaxially,acute,acute-,adaxially,also,anther,apart,apex,appearance,ascending,attenuate,axe,base,bearing,becoming,blade,branched,broad-based,broadly,calyx,campanulate,cauline,cm,coarsely,compressed,connivent,cylindrical,deltoid,dentate,diameter,distal,elongate-deltoid,entire,erect,essentially,farinaceous,felty-pubescent,female-sterile,filament,flower,form,frequently,fruit,glabrous,globose,grading,growt,hair,inflorescence,interlobal,invested,largest,later,lateral,laterally,leaf,least,length,lenticular,lignescent,like,linear-lanceolate,lobe,lon,long,longer,longest,manifestly,margin,midpoint,minutely,mixture,mm,much,multiseriate,narrowly,numerous,obtuse,often,one,orange,other,outline,ovate,ovate-apiculate,pedicel,peduncle,per,perennial,petiole,pitted,prickle,prickly,pubescent,ray,reduced,reniform-ovate,ripe,round-tipped,scattered,sericeous,sessile,short,short-stalked,shorter,sinus,smaller,sometimes,spaced,sparse,spreadingly,stalk,stellae,stellate,stellate-pubescent,stem,stigma,stipitate,style,surface,tan,termination,time,tooth-like,trichome,truncate,tube,unbranched,usually,variable,variously,vein,well-developed,white,wide,x	0.3-0.6,0.4-0.9,05-2.5,1-5,1.5-4,2-foliate,2.5-4.5,4-5,5-15,6-9,7-16,adaxiall,along,appearing,armed,articulated,ba,capitat,close,delicate,densely,directed,distall,eaf,eed,elongate,extra-axillary,felty,geminat,inserted,lanceolate,lower,major,maturit,midrib,minute,nflorescence,occasionally,orolla,ovate-lanceolate,pair,persistent,pore,principal,rachi,ruit,side,similar,simple,spreading-hirsute,ste,tal,tamen,tem,thin-textured,underdeveloped,unit,vary,yellow,ympodial	0.5-2.5,arrangement,bark,border,branch,bud,capitate,characteristic,colour,corolla,corrugation,drying,exertion,fruiting,giving,glabrousnes,growth,height,history,interjected,leaflet,life,lobing,new,null,number,ovary,plant,primary,pseudostipule,seed,shape,size,tall,terminal,texture,thicknes,type,variation,width
263	wfo-0001028975	success	163	182	138	25	44	0.847	.5,0.1-1,0.5-1,1,1-3,1-5,1.2-1.5,1.5-1.8,2.2-6,3-10-flowered,3-3.5,3-6.5,5.5-10,6-6.5,7.5-15,8-9,?,acuminate,acute,along,anther,apart,apex,appearing,area,bark,base,beneath,berry,broad,brown,calyx,closely,cm,conical,conically,corky,corolla,cup-shaped,dark,decurrent,deflexed,densely,denser,dia,differing,difoliate,elliptic,epidermi,equal,erect,exserted,extension,filament,free,fruit,fruiting,glabrous,globose,golden,green,immature,large-celled,late,lateral,leaf,length,like,lobe,lobed,long,main,mainly,major,margin,member,mere,middle,minor,minutely,mm,narrowly,nearly,obscured,occasionally,older,once-furcate,one,opposite,ovary,ovoid-reniform,pair,pedicel,petiole,pitted,pore,poricidal,portion,prominent,pubescent,raised,remaining,rib,scar,shaped,shiny,shrub,simple,size,slender,slightly,small,somewhat,spaced,sparsely,stem,stigma,straight,style,surface,tall,tapering,tear-drop,tip,tree,triangular,trichome,tube,uniseriate,upper,varying,vein,white,wide,widest,woody,x,young	.2,1.5-2,5-ribbed,anthesi,eaf,edicel,eed,entire,geminat,hyaline,lon,lower,nflorescence,papillo,pubescenc,reddi,reflexed,ruit,short,sinus,strongly,tub,ud,unit,ympodial	appearance,arrangement,border,branch,bud,characteristic,colour,corrugation,diameter,distal,drying,exertion,form,geminate,giving,glabrousnes,growth,history,inflorescence,interjected,leaflet,life,lobing,midpoint,new,null,number,papillose,peduncle,per,prickle,primary,pseudostipule,pubescence,ray,reddish,seed,shape,terminal,texture,thicknes,type,variation,width
264	wfo-0001028980	success	168	178	135	33	43	0.804	.1,.5,.75,0.5-1.5,1-1.2,1.2-1.8,1.2-3,1.5-1.8,1.5-2,1.5-6,2.5,2.5-5,3-4,3/4,4-5,5-6,5-8,6,6-8,7-12,acuminate,acute,anther,anthesi,apex,axil,bark,basal,base,beneath,berry,black,broadly,calyx,capitate,clearly,cm,coarsely,conical,corolla,cucullate,deflexed,deltoid,densely,dia,differentiated,differing,difoliate,drying,elliptic,exserted,extending,f,filament,flattened-reniform,fleshy,free,fruiting,furcate,glabrate,glabrous,glandular,globose,green,impressed,lamina,lateral,leaf,lobe,lobed,long,main,major,margin,middle,minor,minutely,mm,older,one,opposite,ovary,ovate,ovoid,pair,paler,pedicel,peduncle,petiole,pit,pitted,pore,poricidal,portion,prominent,pubescent,reddish,reflexed,seed,shaped,sharply,shining,shrub,simple,size,slightly,small,soon,sparsely,speciman,stem,stigma,strongly,style,surface,tall,tapering,tear-drop,thick,tip,tree,trichome,tube,type,uniseriate,unit,usually,vein,way,white,widest,woody,x,yellowish,young	/3,20-25-flowered,along,apart,beginning,corky,dry,eaf,edicel,eed,expanded,frui,geminat,incrassate,inflorescenc,lenticellat,like,lon,lower,m.,material,member,nflorescence,occasionally,pale,papillose,planar,ruit,scar,scarious,ti,ud,ympodial	appearance,arrangement,border,branch,bud,characteristic,colour,corrugation,diameter,distal,exertion,form,fruit,geminate,giving,glabrousnes,growth,height,history,inflorescence,interjected,leaflet,length,lenticellate,life,lobing,midpoint,new,null,number,per,plant,prickle,primary,pseudostipule,ray,shape,sympodial,terminal,texture,thicknes,variation,width
265	wfo-0001028984	success	180	162	107	73	55	0.594	-14,-2,-3,-65,-9,0.5-,1,1-1.7,1-2,1-6,1-9,1.2-4,1.5,10-20,15-35,2,2-,2-16,2-2.5,2-3,20-40,3-10,3-28,4-5,4-6,4-6.3,4-7,abaxially,acuminate,acute,adaxially,adpressed,age,almost,also,apart,apex,apical,basal,base,broadly,calyx,cm,color,concave,cordate,densely,diameter,dilated,distally,eglandular,ellipsoid-fusiform,entire,especially,flower,forked,fruit,glabrous,gland,glandular-puberulent,globose,greenish,hair,lanceolate,lobe,long,margin,minutely,mm,moderately,obconical,obtuse,often,ovate,ovoid,pale,papillose,pedicel,peduncle,perfect,petiole,pilose,puberulent,pubescent-pilose,purple,rarely,ripe,shrub,simple,small,sparsely,stigma,strongly,style,tip,tomentose,toward,tree,triangular,truncate,tube,turning,two,unbranched,unknown,x,yellow	-2.5,-6,1-,1-2.5,12-20,2-4,3-26,3-6,4-30,4-foliat,5,5-10,7-14,8-15,abruptly,absen,aggregate,ape,articulated,axe,blade,broad,campanulate,cell,chartaceous,connective,directed,eaf,eed,equalling,exceeding,fleshy,laterally,leaving,lon,longer,lower,narrowed,near,nflorescence,nther,orolla,pedicellar,pilo,pore,possibly,presence,present,puberulent-pubescent,pubescent-pilo,rachi,radiu,remnant,ruit,shorter,slightly,spaced,stamen,stone,subcoriaceous,swelling,tal,tem,thecae,time,tomento,ud,unit,unknow,vary,violet,wide,ympodial	4-foliate,anther,appearance,arrangement,bark,border,branch,bud,characteristic,colour,corolla,corrugation,distal,drying,exertion,filament,form,fruiting,giving,glabrousnes,growth,height,history,inflorescence,interjected,lateral,leaf,leaflet,length,life,lobing,midpoint,new,null,number,ovary,per,plant,prickle,primary,pseudostipule,ray,seed,shape,size,stem,surface,tall,terminal,texture,thicknes,type,variation,vein,width
266	wfo-0001028997	success	136	149	105	31	44	0.772	.5,0.5-0.7,0.8-1.1,1-1.2,1-1.5,2-2.5,2-3.5,20-50-flowered,3-4,3.3.5,4-10,4-4.5,4-angled,5-6,6-10,6-7,abaxially,acute,adaxially,anther,apex,appearing,area,attenuate,bark,base,berry,branched,broadened,calyx,cm,conical,corolla,dia,difoliate,dry,drying,elliptic,elliptic-obovate,erect,exserted,filament,filiform,flattened-reniform,free,fruiting,glabrous,globose,golden,green,height,incrassate,later,lateral,leaf,lobe,lobed,long,main,many,margin,matte,merely,middle,minutely,mm,mustard,nearly,older,opposite,ovary,pair,pale,papillose,pedicel,pericarp,petiole,pitted,pore,poricidal,portion,revolute,shaped,shiny,shrub,stem,stigma,strongly,style,surface,tan,tear-drop,terminal,thick,time,tip,trifoliate,tube,unknown,vein,white,widest,x,yellow,young	0.5-1,0.5-1.5,anthesi,apar,ba,coriaceous,cucullate,deflexed,eaf,edicel,eed,fragrant,geminat,glabrou,greenish-brow,lon,lower,nflorescence,partially,quadrate,ruit,scar,spaced,specimen,styl,thickened,tub,ud,unevenly,woody,ympodia	appearance,arrangement,border,branch,bud,characteristic,colour,corrugation,diameter,distal,exertion,form,fruit,geminate,giving,glabrousnes,greenish-brown,growth,history,inflorescence,interjected,leaflet,length,life,lobing,midpoint,new,null,number,peduncle,per,prickle,primary,pseudostipule,ray,seed,shape,size,sympodia,texture,thicknes,type,variation,width
267	wfo-0001029003	success	207	175	132	75	43	0.638	0-6,0.4-3,0.5,1,1-10,1-2,1-3,1.2-1.9,1.2-2.5,1.5-2.3,11-32,12.2-30,13-36,2-6,2.5-10,2.5-7.5,3,3-20,3.5-7.5,4-8,5,5-10.5,5-12.5,7-15.5,7-9,9-14,abaxially,acumen,acuminate,adaxially,anther,apex,apparently,attenuate,axe,axillary,base,berry,blue-violet,brownish,bud,cell,cm,condition,conical,connivent,corolla,covering,diameter,distal,drying,elliptic,elongated,filament,flower,forked,fresh,fruit,generally,glabrous,green,greenish,hair,hair-like,half,herb,highly,interjected,lanceolate,lateral,leaf,leaflet,light,like,lobe,long,make,margin,medium,minute,mm,mottled,mucilaginous,obtuse,odd-pinnate,orbicular,ovate,ovoid,pale,pedicel,peduncle,perfect,petiole,petiolule,pigmentation,plant,plurifoliate,prostrate,pubescent,purple,ray,ripe,rounded,seed,sessile,size,sometimes,sparsely,stem,stigma,straight,style,subcapitate,subglabrous,subtending,symmetrical,tall,terminal,testal,thick,tri-,tube,unit,usually,violet,wall,wet,white,whitish,wide,wing,x	0.3-0.5,1-2.5,1-5,3-5,5-merou,absent,ag,alyx,apart,articulated,blade,capitat,chartaceous,ciliate,decreasing,digestion,dorsally,eaf,edge,eed,end,enzyme,equal,erec,especially,exceeding,flat,folded,fourth,geminat,glabrou,gradually,green-white,hal,homostylous,honeycomb-shaped,larger,lengthening,living,lower,membranous,middle,nflorescence,one,orolla,pair,pentagonal,placed,pore,poricidal,proximal,rarely,removed,rotate,ruit,secondary,seudostipule,slightly,slit,spaced,specimen,stamen,ste,stolo,subequal,tamen,tem,throughout,tip,toward,tuber,typically,vary,yellow,ympodial	appearance,arrangement,bark,border,branch,calyx,capitate,characteristic,colour,corrugation,erect,exertion,form,fruiting,geminate,giving,glabrousnes,growth,height,history,inflorescence,length,life,lobing,mentioned,midpoint,new,null,number,ovary,per,prickle,primary,pseudostipule,shape,surface,sympodial,texture,thicknes,type,variation,vein,width
268	wfo-0001029006	success	217	200	159	58	41	0.733	-+,.5,0.2,0.4-2.5,0.5,0.5-2,0.5-4,1,1-1.5,1-4,1-5,1.2-1.5,1.8-2.2,1/3,10,10-20,2-3,2.5,3.5-4,4-6,5,5-6,50,7-8,7-9,<,>,acuminate,acute,adaxial,along,anther,anthesi,apex,area,asymmetrical,axil,basal,base,berry,beyond,bilobed,black,blackish,branched,bright,broadest,c.,calyx,cell,cm,conical,connivent,corolla,deeply,deltate,dense,diameter,drying,ellipsoid,elliptic,elongate,entire,exserted,extending,filament,filiform,flattened,flower,fruiting,glabrous,globose,green,groove,growing,growth,inflated,inflorescence,intramarginal,irregular,keeled,lamina,later,lateral,lobe,lobed,long,loosely,lower,many,margin,midrib,minute,minutely,mm,narrowly,nearly,new,oblique,obvious,occasionally,often,pair,pale,papillate,part,pedicel,peduncle,pentagonal,per,petiole,pinnatifid,pitted,primary,puberulent,pubescent,purple,purplish,reaching,reddish,reniform,ripe,sagittate,simple,size,sometimes,somewhat,sparsely,stem,stigma,strong,strongly,style,surface,tan,terminal,testal,time,tip,trichome,truncate,tube,tuft,twining,uniseriate,upper,usually,variously,vein,vine,violet,way,white,widest,within,woody,x,young,zig-zag	2-6,5-merou,abaxially,adaxiall,ag,age,alyx,apar,ark,articulated,axi,chartaceous,clavat,depending,eaf,eed,free,ilament,irregularly,leaving,lengthening,markedly,membranous,nflorescence,nodding,older,one,orolla,peg,pendan,perfect,pericarp,planar,plurifoliat,pore,poricidal,portion,puberulen,rotate-stellate,ruit,scar,shiny,sleeve,slit,small,smaller,spaced,spreading,sunligh,tem,thin,tiny,twinin,ud,unit,variable,vary,ympodial	appearance,arrangement,bark,border,branch,bud,characteristic,clavate,colour,corrugation,distal,exertion,form,fruit,giving,glabrousnes,height,history,interjected,leaf,leaflet,length,life,lobing,mentioned,midpoint,number,ovary,plant,plurifoliate,prickle,pseudostipule,ray,seed,shape,sunlight,texture,thicknes,type,variation,width
269	wfo-0001029031	success	213	217	173	40	44	0.812	-11.4,-12.3,-3.6,-8,.1-0.3,.5-1.2,0-5,0.1-0.5,0.5,0.5-1.5,0.6-1.2,0.7-1.1,1-1.5,1-2.5,1-2.6,1-3,1-5,1-9.4,1.3-3.3,1.5-2.8,1.5-3.5,1.8-2.7,1.8-4,1/3,10,13.5,2-10.7,2-3,2-3.3,2-5,2.5-5.5,2.5-5.6,20-150,3-10,4-5-,5-17,6-12,6-21,abaxially,absent,acuminate,acute,adaxially,angle,anther,apart,apex,apparently,articulated,axe,base,becoming,berry,black,blade,bluish,branched,brown,calyx,capitate,center,chartaceous,cm,connivent,corolla,covering,cuneate,curved,cylindrical,deltate,densely,denser,diameter,eglandular,elliptic,elliptic-ovate,entire,erect,filament,flattened,fleshy,flower,forked,fruit,fruiting,fused,geminate,glabrescent,glabrous,globose,green,hair,held,immature,impressed,inserted,lanceolate,lateral,leaf,leaf-opposed,least,length,light,like,lobe,long,major,many-foliate,margin,midpoint,midvein,mm,nearly,oblong,obtuse,occasionally,outline,paired,pedicel,peduncle,peltate,peltate-stellate,perfect,petiole,porrect-stellate,possibly,prominent,pseudoterminal,pubescence,pubescent,rarely,ray,reniform,ripening,rounded,rugulose,sessile,short,short-stalked,shrub,side,silvery,simple,small,smaller,sometimes,spaced,sparsely,stellate-pubescent,stem,stigma,straight,strongly,style,suborbicular,subtending,surface,tall,time,tip,tree,trichome,tube,unbranched,unit,usually,vein,white,whitish,wide,x,yellow,yellowish	0.5-4,1-2,4-7.5,accrescent,adaxiall,ag,apexacute,around,ba,bilobe,directed,distally,eaf,edge,eed,eglandula,equal,farinose,frui,large,longitudinal,lower,nflorescence,opening,orange,orolla,pore,pubescen,rachi,ruit,slightly,slit,somewhat,ste,stellate,tamen,tem,unarme,vary,ympodial	appearance,arrangement,bark,bilobed,border,branch,bud,characteristic,colour,corrugation,distal,drying,exertion,form,giving,glabrousnes,growth,height,history,inflorescence,interjected,leaflet,life,lobing,new,null,number,ovary,per,plant,prickle,primary,pseudostipule,seed,shape,size,sympodial,terminal,texture,thicknes,type,unarmed,variation,width
270	wfo-0001029048	success	162	178	133	29	45	0.821	.01,.2,.5,/3,0.5,0.5-1.7,0.8-1,1,1-2,1-8,1.5-2,11,14,2,25,26,3-4,3.5-4,4-6,5-8,8-10,9-15,acuminate,angle,another,anther,anthesi,apex,apparent,arching,attenuate,basal,base,bearing,beneath,berry,bicellular,branch,bright,broadly,calyx,cm,conical,corolla,decurrent,dia,elliptic,elongated,expanded,f,filament,filiform,flower,free,fruiting,glabrate,glabrous,globose,golden,greatly,green,greenish-white,greenish-yellow,hanging,hispidulous,incrassate,lateral,leaf,less,like,live,lobe,lobed,long,main,margin,matte,midrib,minute,minutely,mm,much,obtuse,older,one,opposite,ovary,ovoid-reniform,pair,pale,papillose,parallel,pedicel,petiole,pitted,planar,pore,poricidal,portion,puberulent,right,ripe,scar,shaped,sharply,shrub,slender,slightly,small-capitate,somewhat,specimen,stem,stigma,straight,style,surface,tall,tan,tapering,tear-drop,thread-like,time,tip,translucent,trichome,tube,uni-,vein,way,winged,x,young,zig-zag	0.5-1,3-7,apar,becoming,blade,eaf,edicel,eed,except,geminate,greenish-yello,lower,middle,nflorescence,node,non-reproductive,obovoid,papillo,reflexed,rounded,ruit,spaced,ud,unevenly,unifoliate,unit,widely,widest,ympodial	appearance,arrangement,bark,border,bud,characteristic,colour,corrugation,diameter,distal,drying,exertion,form,fruit,giving,glabrousnes,growth,height,history,inflorescence,interjected,leaflet,length,life,lobing,midpoint,new,null,number,peduncle,per,plant,prickle,primary,pseudostipule,ray,seed,shape,size,terminal,texture,thicknes,type,variation,width
271	wfo-0001029055	success	169	207	156	13	51	0.923	0.4-1.5,1-2.6,1-4,1-5,1.6-3.5,1.7-2.2,1.8-3.5,14-50,2-3,2-4,2.2-3,2.5-8,3,3-10,3-6,3-6-foliat,4-10,4-6,4-7,5-24,5.5-9,6-14,8-9,9-22,abaxially,acumen,acuminate,acute,adaxially,apex,apical,apically,articulate,attenuate,base,branched,calyx,cell,cm,connate,cordate,corolla,covered,covering,cuneate,cyme,dark,decurrent,dehiscent,densely,diameter,dichasial,dichasially,digestion,diminishing,distal,dorsally,ebracteate,edge,elliptcal,elliptical,emoval,enzyme,exceeding,filament,first,flat,flower,folded,forked,generally,gland,green,green-white,hair,hair-like,half,herbaceous,honeycomb,interjected,introrse,lateral,leaf,leaflet,living,lobe,lon,long,long-attenuate,longer,longitudional,lower,make,maturing,mm,monochasial,mucilaginous,near,oblique,odd-pinnate,often,orolla,outline,ovate,ovoid,pair,pattern,pedicel,peduncle,pentagonal,perennial,perfect,petiole,pilose,plant,poricidally,proximal,pubescent,purple,rarely,reveal,rotate,second,seed,sessile,seudostipule,short,short-petiolate,short-stalked,size,slit,sometimes,specimen,spreading,stamen,stigma,straight,stripe,style,terminal,testal,thick,throughout,time,toward,triangular,tuber-bearing,type,typically,unit,vary,wall,wide,widest,yellow,Â¼	2-1.,eaf,eed,globo,lunat,nflorescence,nther,plan,ruit,tal,tem,whit,ympodial	2-11,anther,appearance,arrangement,bark,border,branch,bud,characteristic,colour,corrugation,drying,exertion,form,fruit,fruiting,giving,glabrousnes,globose,growth,height,history,inflorescence,length,life,lobing,lunate,margin,midpoint,new,null,number,ovary,per,prickle,primary,pseudostipule,ray,shape,stem,surface,sympodial,tall,texture,thicknes,tube,variation,vein,wet,white,width
272	wfo-0001029059	success	199	209	168	31	41	0.844	.5,0.1-0.5,0.1-1,0.2,0.2-0.5,0.5,0.5-1,1-1.2,1-1.5,1-3,1-4,1-6,1.2-3,1.3-1.7,1.5-2,1.5-2.8,10-19,2.5,3-3.5,3-6.5,3.5-6,3.5-8,4-10.5,5,5-15-flowered,6-10,7-9,acute,along,anther,anthesi,apex,apiculae,apiculate,arising,bark,base,beneath,berry,bout,branched,bud,calyx,clavate,cm,connivent,cordate,corolla,covered,cuneate,deep,deltoid,dense,densely,dia,differing,dirty,ellipsoid,elliptic,expanded,exserted,extending,extremely,filament,flattened-reniform,foetid,free,fruiting,glabrate,glabrous,globose,greatly,hispidulous,impressed,incrassate,inflorescence,interpetalar,lamina,lateral,leaf,lobe,lobed,long,main,major,margin,membranous,middle,minor,minute,minutely,mm,narrowly,nearly,oblique,occasionally,often,older,one,opposite,orange,orangish-yellow,orbiculate,ovary,pair,pale,paler,papillose,partially,pedicel,petiole,pitted,planar,pointed,pore,poricidal,portion,prominent,pubescence,pubescent,purplish,rest,ripe,rounded,shallowly,shape,shaped,shrub,simple,sinus,size,slender,small,somewhat,soon,sparse,specimen,stem,stigma,straight,style,surface,tall,tapering,tear-drop,terminal,thickened,tightly,tinge,tip,tree,triangular,trichome,tube,underside,unicellular,uniseriate,variable,vein,waxy,white,wide,widest,x,yellowish,yellowish-green,yellowish-tan,young	anisophyllou,apar,ape,closely,coiba,de,deflexed,difoliate,eaf,edicel,eed,geminate,isla,lon,longest,lower,member,nflorescence,panama,papillo,population,reddish-gre,ruit,scar,spaced,ti,ud,unit,usually,woody,ympodial	appearance,arrangement,border,branch,characteristic,colour,corrugation,diameter,distal,drying,exertion,form,fruit,giving,glabrousnes,growth,height,history,interjected,leaflet,length,life,lobing,midpoint,new,null,number,peduncle,per,plant,prickle,primary,pseudostipule,ray,reddish-grey,seed,texture,thicknes,type,variation,width
273	wfo-0001029072	success	235	186	148	87	38	0.63	-1/2,-2.5,.5,0-2,0-20,0.1-0.4,0.4-0.9,0.5-2,0.5-3,0.8,0.8-1.5,00-200,1-1.2,1-25,1-3,1.5-2.6,1.5-3.2,1/3,1/4-1/2,1/4-1/3,2-5,2-7,2.2-2.5,2.2-3.2,2.5-3.5,2.5-3.8,2.5-4.5,20-50,3-20,3-5,3-50,3-8,3.5-6,4.2-6.5,4.5-9,5-10,5-7,7-15,8-20,8-27,acute,ame,angled,anther,apart,apex,apically,apparently,bark,base,berry,branched,broadly,c.,calyx,cm,conical,connivent,cordate,cuneate,curved,deltate,densely,diameter,dirty,distal,distance,drying,dull,erect,extending,filament,flattened,flattened-reniform,flower,fruit,fruiting,gently,green-brown,herb,lateral,leaf,least,length,lobe,lobed,long,long-styled,longitudinal,lower,margin,mauve,midpoint,midvein,mm,moderately,multangulate,narrow-deltate,older,one,open,orange-brown,ovate,pair,pale,pedicel,peduncle,pendent,per,petiole,plant,poricidal,porrect,prickle,prickly,primary,raised,ray,ridge,rounded,short-styled,shrub,side,sometimes,spaced,spherical,stalk,stalked,stellate-pubescent,stem,stout,straight,style,surface,tapering,terminal,time,tip,trichome,tube,upper,variously,vein,way,white,wide,yellow,young	-15,/6,0,0-4,0-8,0.2-0.3,0.2-0.4,0.3,0.7,1,1-1.5,1.5-2.5,12-19,2-10,2-8,3-10,3/,4-,4-10,5-50,5-9,5-merous,7-10,abaxial,abaxially,adaxial,adaxially,alyx,andromonoecious,apar,articulated,blade,bright,broad-deltate,chartaceous,clearly,cream,dark,discolorous,eaf,eed,elongated,elongating,equal,free,glabrous,gra,green,hermaphrodite,heterostylous,infructescence,longer,lowermost,marking,mature,maturity,nflorescence,obtu,orolla,oung,pendulous,pericarp,plurifoliat,portion,prickl,reflexed,ruit,scar,sessile,simple,smooth,sparsely,spreading,staminat,stellate,strongly,tamen,tertiary,unarmed,unit,vary,venation,visible,weakly,whitish,woody,ympodial	3/4,appearance,arrangement,border,branch,bud,characteristic,colour,corolla,corrugation,exertion,form,giving,glabrousnes,gray,growth,height,history,inflorescence,interjected,leaflet,life,lobing,mentioned,new,number,obtuse,ovary,pseudostipule,seed,shape,size,stigma,texture,thicknes,type,variation,width
274	wfo-0001029073	exception_thrown	211	0	0	211	0	0.0		.5,.7,0.3-1,0.5,0.5-1,0.6-0.7,0.6-2,1-1.2,1-1.5,1-2.5,1-3,1.1-1.5,1.2-1.6,1.5-2,10-15,10-16,2,2-3,2-4,2/3,3.5-9,4-5,4-6,5-6,5-8,5-merous,6-9,7-10,8-14,abaxially,acuminate,acute,adaxially,along,another,anther,anthesi,apart,apex,armed,articulated,away,awn-like,ba,bark,basal,base,beneath,berry,broad-based,brown,calyx,cell,chartaceous,cm,conical,corolla,cream,curved,dark,darker,dense,densely,diameter,difoliate,dimorphic,discolorous,drying,eaf,eed,elliptic,enlarged,entire,equal,erect,except,exserted,filament,flattened,flower,four,free,frui,fruiting,geminat,glabrous,globose,golden,gre,growth,hooked,inflorescence,internodal,interpetalar,lamina,lanceolate,leaf,length,lengthening,like,linear,lobe,lobed,long,long-styled,lower,margin,maturity,midpoint,midvein,minutely,mixture,mm,multangulate,narrowly,new,nflorescence,nodding,oblique,occasionally,older,one,opposite,orange,pair,pale,paler,papillose,pedicel,peduncle,per,perfect,pericarp,petiole,planar,plurifoliate,pore,poricidal,porrect,portion,prickle,prickly,primary,pubescence,pubescent,purple,ray,rectangular,reniform,reticulate,ruit,scar,sessile,shallowly,shiny,short,short-stalked,shorter,shrub,simple,sinuate,slightly,slit,sometimes,somewhat,spaced,sparsely,splitting,stellate,stem,stigma,straight,strongly,style,styled,surface,tan,tapering,testal,thin,three,ti,tip,tissue,triangular,trichome,truncate,tube,two,ud,unarmed,underside,unequal,unequally,unisexual,unit,upper,upward,vein,visible,wall,way,whitish,wide,woody,x,yellow,yellowish,ympodial,zygomorphic,Â½	
275	wfo-0001029074	success	174	177	136	38	41	0.782	.1,.5,0,0.2-1,0.3-0.8,0.5-1,0.5-1.2,0.7-0.8,1,1-,1-1.2,1-1.5,1-2,1.4-1.8,1.5-2,1.5-4,11,2-2.3,2-4,2-5,2-7,3-6,3.5-5,5-6,5-7,abaxially,absent,acute,adaxially,along,anther,anthesi,apart,apex,appearing,articulation,bark,base,berry,black,broadly,calyx,capitate,cm,conical,corolla,cuneate,densely,diameter,ellipsoid,entire,exerted,filament,flattened,flower,free,fruiting,glabrous,globose,green,grey,growth,herb,immature,internodal,lacking,leaf,less,lignescent,like,lobe,lobed,longest,margin,midpoint,midvein,minutely,mixture,mm,new,often,opposite,ovary,ovate,pair,pale,pedicel,peduncle,per,petiole,pitted,poricidal,portion,primary,pubescent,purplish,ray,reflexed,reniform,ripening,rounded,sagittate,scar,scattered,sessile,simple,small,somewhat,sparsely,stalk,stalked,stellate,stellate-pubescent,stem,stigma,strongly,style,subshrub,surface,swollen,tip,triangular,trichome,truncate,tube,underside,uniformly,uniseriate,usually,vein,way,white,x,yellow,yellowish,Â¾	0.3-0.4,0.7-0.95,3-,age,almost,apparently,basa,deflexed,denser,eaf,eed,expanding,frui,glabrescen,lengthening,lower,markedly,nflorescence,obscuring,older,papillat,perfect,pericarp,petal,planar,plurifoliat,pore,prominent,pulp,ruit,slit,thin,tub,ud,unit,watery,woody,ympodial	appearance,arrangement,basal,border,branch,bud,characteristic,colour,corrugation,distal,drying,exertion,form,fruit,giving,glabrescent,glabrousnes,height,history,inflorescence,interjected,lateral,leaflet,length,life,lobing,mentioned,number,papillate,plant,prickle,pseudostipule,seed,shape,size,terminal,texture,thicknes,type,variation,width
276	wfo-0001029075	success	217	187	144	73	43	0.664	.3,.5,0-8,0.8-1.2,0.8-1.5,1-10,1-2,1-2.5,10-20,2-5,2.5-3,2.7-4.2,30-60,4-10,4-14,4-5,4-7,4.5-6.5,5-10,5-8.5,6-12,7-17,8-9,abaxially,abruptly,acumen,adaxially,anther,apart,apex,apparently,articulated,attenuate-acuminate,atypically,axe,axillary,base,berry,blade,broadly,brown,brownish,bud,canescent,cell,ciliate,cm,condition,corolla,covering,cuneate,dark,densely,diameter,distal,dot,drying,elliptic-lanceolate,erect,especially,etota,filament,flecked,flower,forked,fresh,fruit,generally,glabrescent,glabrous,glandular-pilose,glandular-puberulent,gray-green,green,greenish,hair,half,herb,interjected,lanceolate,lateral,leaf,leaflet,light,like,lobe,long,long-spatulate,make,margin,mm,mucilaginous,narrowed,narrowly,odd-pinnate,orbicular,ovate,ovoid,pedicel,peduncle,pentagonal,perfect,petal,petiole,petiolulate,plant,pointed,pubescent,purple,rounded,sec,seed,sessile,short,size,slightly,small,sometimes,stem,stigma,style,subobtuse,subquadrate,substellate,subtending,terminal,testal,thick,tip,tube,unwinged,upper,usually,wall,wet,white,whitish,whitish-gray,wide,woody,x,yellow,yellow-green,yellowish-white	0-3,0.5-0.8,1-3,2-4,5-8,5-merou,7-9,ag,along,alyx,clavifor,connivent,decreasing,decurrent,digestion,dorsally,eaf,edge,eed,end,enzyme,erect-ascendin,exceeding,flat,folded,geminat,glabrou,gradually,greatly,green-white,hair-like,homostylous,honeycomb-shaped,larger,lengthening,living,lower,middl,midrib,minutely,nflorescence,orne,orolla,pair,petiolule,plurifoliate,pore,poricidal,puberulent,rachi,removed,ruit,seudostipule,singly,slit,spaced,specimen,stamen,ste,stolo,straight,subequal,tall,tamen,tem,throughout,toward,tri-,tuber,typically,unit,vary,ympodial	'hair-like,appearance,arrangement,bark,border,branch,calyx,characteristic,claviform,colour,corrugation,erect-ascending,exertion,form,fruiting,giving,glabrousnes,growth,height,history,inflorescence,length,life,lobing,mentioned,middle,midpoint,new,number,ovary,per,prickle,primary,pseudostipule,ray,shape,surface,texture,thicknes,type,variation,vein,width
277	wfo-0001029084	success	192	166	123	69	43	0.641	.5,0.8-2,0.8-2.1,1-10,1-2,1-3,1.1-2.2,1.5-2.5,10-50,2-3.5,2-5,3-6,3.5-7.5,3.5-8,4-17,4-7,4.5-10,5,5-7,6-13,7-9,8-23,abaxially,absent,acumen,acuminate,adaxially,anther,apart,apex,apparently,articulated,axe,axillary,base,berry,brownish,bud,cell,ciliate,cm,condition,conical,connivent,corolla,covering,darker,diameter,distal,drying,especially,exceeding,filament,flower,forked,fresh,fruit,generally,glabrous,green,greenish,half,herb,interjected,interpetalar,lanceolate,lateral,leaf,leaflet,light,lilac,lobe,long,make,margin,middle,minute,mm,moniliform,mottled,mucilaginous,narrow,odd-pinnate,ovate-lanceolate,ovoid,pedicel,peduncle,perfect,petiole,petiolule,pilose,plant,proximal,pubescent,purple,ray,ripe,seed,size,sparsely,stamen,stigma,style,subglabrous,subsessile,subtending,symmetrical,terminal,testal,thick,tip,tissue,tube,tuber,typically,unwinged,usually,wall,wet,whitish,wide,wing,x	1-4,2-4,4.5-6.5,5-merou,ag,along,alyx,arranged,bead,blade,capitat,chartaceous,decreasing,digestion,dorsally,eaf,edge,eed,enzyme,flat,folded,geminat,glabrou,gradually,green-white,hair-like,homostylous,honeycomb-shaped,larger,lengthening,like,living,lon,lower,midrib,minutely,multiple,necklace,nflorescence,obtuse,orolla,pair,plurifoliate,pore,poricidal,puberulent,removed,rotate,ruit,secondary,semierec,seudostipule,slit,spaced,specimen,stolon,subequal,subglabrou,tall,tamen,tem,thir,throughout,toward,tri-,unit,vary,yellow,ympodial	'hair-like,appearance,arrangement,bark,border,branch,calyx,capitate,characteristic,colour,corrugation,exertion,form,fruiting,giving,glabrousnes,growth,height,history,inflorescence,length,life,lobing,mentioned,midpoint,new,number,ovary,per,prickle,primary,pseudostipule,semierect,shape,stem,surface,texture,thicknes,third,type,variation,vein,width
278	wfo-0001029088	success	149	149	93	56	56	0.624	.2,.3,0.6â3.2,1.3â4.5,1.5â2,15â25,1â1.5,1â1.6,1â3,2.5â4.2,25â30,2â2.5,2â3,3.5â7,3.5â8,3â16,4â8,5,5-merous,acuminate,anther,apex,axe,base,berry,blade,bronze-brown,calyx,capitate,climbing,cm,cordate,diameter,emarginate,entire,extra-axillary,filament,flattened,flower,fruit,fruiting,glabrous,greenish-brown,half,herbaceous,immature,leaf,lenticular,light,lobe,long,lower,margin,mature,minutely,mm,moderately,near,obtuse,ovoid-rhomboid,palmate,papillose,pedicel,peduncle,petiole,primary,purplish,reddish-brown,revolute,rounded,rugose,sand-punctate,shortly,simple,slender,slightly,somewhat,sparsely,stigma,style,surface,terrestrial,tip,truncate,tube,unbranched,unit,vein,vine,white,wider,x,â7	0.1,0.9â1.5,1.5â3,1â1.2,2-lobe,2.5â20,5â8,6-10,<,abaxially,accrescent,acute,adaxially,alyx,apar,apicall,c.,ciliate,cylindrical,densely,eaf,eed,flavor,fleshy,fragrant,glabrou,groun,hair,heavy,juicy,lanceolate,m.,membranous,narrowly,nflorescence,nternode,orolla,perfec,plurifoliat,pubescent,rachi,ruit,scent,spaced,stellate,stout,straight,strongly,swee,sweet,tamen,tem,truncate-acuminat,vary,venation,ympodial	1-1.2,1.5-2,2-2.5,2-lobed,appearance,arrangement,bark,border,branch,bud,characteristic,colour,corolla,corrugation,distal,drying,exertion,form,giving,glabrousnes,ground,growth,height,history,inflorescence,interjected,lateral,leaflet,length,life,lobing,mentioned,midpoint,new,number,ovary,per,perfect,plant,plurifoliate,prickle,pseudostipule,ray,seed,shape,size,sparse,stem,sympodial,terminal,texture,thicknes,truncate-acuminate,type,variation,width
279	wfo-0001029089	success	177	175	136	41	39	0.768	.75,/4,0.1-0.25,0.5-0.6,0.5-1,0.8-1,0.8-1.2,1,1-1.5,1.5-2,1.5-6,10-25,2.5-3.5,4.5-5,5-10,5-20-flowered,5-6,5-9,6-7,8-9,acute,along,anther,apex,apiculate,axil,bark,base,beneath,berry,bilobed,branched,bud,calyx,campanulate,caniculate,cm,completely,corolla,covered,covering,cracking,dark,decurrent,densely,dia,differing,drying,either,elliptic,enclosed,entire,expand,exserted,filament,flattened-reniform,fruiting,furcate,glabrous,globose,golden,green,impressed,incrassate,lamina,later,lateral,leaf,like,lobe,lobed,long,main,major,margin,middle,minor,minutely,mm,obovoid,occasionally,older,one,opposite,ovary,pair,part,pedicel,peeling,persistent,petiole,pinkish,pitted,pore,poricidal,primary,prominent,pubescent,purplish,reddish-grey,resinous,rounded,rounded-deltoid,secretion,shaped,shiny,shrub,simple,size,slightly,small,smooth,somewhat,stem,stigma,still,style,surface,tall,tan,tapering,tear-drop,tip,tree,trichome,tube,underside,uniseriate,usually,varnished,vein,way,white,widest,x,young	.5,1/2,abrupt,anthesi,apart,ba,beginning,closely,deflexed,difoliate,eaf,edicel,eed,erect,free,geminat,glabrou,inflorescenc,lon,lower,material,member,nflorescence,otherwise,overlapping,papillo,papillose,planar,portion,resinou,ruit,scar,spaced,straight,tub,ud,unit,varnish,widening,woody,ympodial	appearance,arrangement,border,characteristic,colour,corrugation,diameter,distal,exerted,exertion,form,fruit,giving,glabrousnes,growth,history,inflorescence,interjected,leaflet,length,life,lobing,midpoint,new,null,number,peduncle,per,prickle,pseudostipule,ray,seed,shape,terminal,texture,thicknes,type,variation,width
280	wfo-0001029091	success	212	223	173	39	50	0.816	-1,-15,-4,-4.5,0.3-,0.5-0.8,0.5-1,1,1-2,1.5-,1.5-2,10,10-20,10-toothed,15-40,170-210,2-12,2-2.5,2-3,2.5-,3,3-,3-11-lobed,3-4,4,46/1,5-7,635/1,7-8,acuminate,acute,age,anther,apex,appearing,articulation,aspect,axil,base,becoming,berry,blunt,bluntly,broadly,brownish,buff,calyx,campanulate,capitate,clonal,close,cm,colour,common,corolla,cuneate,cut,cyme,dark,deeply,develop,dia,discoidal,downward,effect,ellipsoid,elliptic,emarginated,erect,exerted,filament,flattened,floral,flower,flushed,fork,forked,fresh,fruiting,general,giving,glandular,globose,globular,grey,growing,hair,half,intense,irregular,irregularly,juvenile,lacking,larger,lasting,later,lateral,lavender,leaf,light,line,linear,linear-lanceolate,lobe,long,long-triangular,lower,may,mid-vein,mineral,minutely,mm,narrowly,oblong,obovate,obscure,occasionally,ochre-yellow,ovate,overlain,ovoid,pale,pattern,pedicel,pedicellate,peduncle,petiolate,petiole,point,pubescent,rachi,raised,reddish-purple,relatively,reticulate-concentric,rh,ridge,ridged,rounded,scarcely,separate,several,shortly,shrub,sigmoid,simple,sinus,slender,slightly,soft-wooded,soon,sparsely,speckled,stem,stigma,straggly,style,subulate,surface,swollen,tip,toward,transverse,triangular,unit,upper,usually,violet,violet-purple,winged,woody,x,year	1-10,20-30,5,aromatic,articulated,ba,cell,conspicuous,developed,eed,exceeding,gree,interacuminal,lavende,lengthening,nflorescence,ower,pentagonal,petiol,plurifoliat,pore,poricidal,readily,ripe,ruit,shallowly,shed,slit,soft,stellate-rotate,stone,succulent,tall,tissue,tub,ud,well,without,ympodial	appearance,arrangement,bark,border,branch,bud,characteristic,corrugation,diameter,distal,drying,exertion,form,fruit,glabrousnes,green,growth,height,history,inflorescence,interjected,leaflet,length,life,lobing,margin,mentioned,midpoint,new,number,ovary,per,plant,plurifoliate,prickle,primary,pseudostipule,ray,seed,shape,size,sympodial,terminal,texture,thicknes,tube,type,variation,vein,width
281	wfo-0001029101	success	233	242	221	12	21	0.948	-15,-3,.5,/3,/4,0-100,0-2,0-20,0-5,0-8,0.1,0.1-0.4,0.1-0.5,0.1-0.7,0.1-1,0.2,0.4-1.5,0.5-1,0.7-,0.8-3.5,00-200,1,1-1.5,1-3,1-4,1-8,1.3-2,1.3-2.6,1.4-2.2,1.5-2,1.5-2.5,1.7,1.8-3,1/5-1/4,10-14,10-20,2-,2-20,2-6,2.5-3.5,2.5-6,2.8-3.3,2/3-3/4,3-,3-10,3-4,3-7,30-100,4-12,4-7,5-,5-20,5-6,5-7,5-8,5-9,5-merous,5.5-8,6-8,7-13,8-15,abaxial,abaxially,acute,adaxial,almost,always,andromonoecious,anther,apar,apart,apex,apically,apparently,articulated,bark,base,berry,blade,branched,broad-deltate,brown-green,calyx,cell,chartaceous,cm,concolorous,connivent,cream,cuneate,dark,darker,deltate,diameter,discolorous,distal,distance,drying,dull,elliptic,elongating,equal,erect,extending,filament,flattened,flattened-reniform,flower,free,fruit,fruiting,glabrescent,glabrous,green,green-brow,hermaphrodite,heterostylous,infructescence,lateral,leaf,lengt,length,like,lobe,lobed,lon,long,long-styled,longer,lowermost,margin,marking,mature,maturity,mauve,midpoint,midvein,mm,moderately,multangulate,narrow-deltate,oblong,obovate,obtuse,often,older,one,open,orange-brown,outline,ovate,pair,pale,pedicel,peduncle,pendulous,per,pericarp,petiole,pit,plant,plurifoliat,poricidal,porrect,portion,present,prickle,prickly,primary,raised,rarely,ray,reduced,reflexed,rounde,rounded,scar,secondary,sessile,short-styled,shrub,side,simple,small,smooth,sometimes,spaced,sparsely,spherical,spreading,stalk,stalked,staminat,stellate,stellate-pubescent,stem,straight,style,suborbicular,surface,tapering,terete,tertiary,thick,time,tip,trichome,tube,unit,variously,vein,venation,visible,way,well-developed,wide,woody,yellow,yellow-green,yellow-orange,young	alyx,eaf,eed,lower,nflorescence,orolla,oung,prickl,ruit,tamen,vary,ympodial	arrangement,branch,characteristic,colour,corolla,corrugation,form,glabrousnes,growth,height,history,inflorescence,life,new,ovary,seed,shape,size,stamen,sympodial,texture
282	wfo-0001029106	success	200	196	157	43	39	0.785	-6,.1,.5,/3,0,0-0.3,0-10,0-20,0-5,0.1,0.2-0.4,0.2-1,0.25-0.7,0.5-0.8,0.5-0.9,0.5-1,0.5-2.5,0.9-1.2,1-1.6,1-2,1-5,1.5-2,1.5-3.5,1/4,2-3.5,2-4,2-5.5,2-8,2.2-3,3-25,3-3.5,3-4,4-6,4-8,5-14,6-8,acute,ame,anther,apart,apex,apically,apparently,bark,base,berry,branched,c.,calyx,cell,cm,concolorous,cuneate,curved,deltate,densely,diameter,discolorous,distance,drying,elliptic,equal,erect,extending,filament,flattened,flattened-reniform,flower,free,fruit,fruiting,gently,glabrescent,glabrous,infructescence,lateral,leaf,length,light,lobe,lobed,long,lower,margin,maturity,mauve,membranous,midpoint,midvein,mm,obtuse,older,one,open,orange,orange-brown,orbicular,outline,ovate,pair,pale,pedicel,peduncle,pendulous,per,petiole,pit,poricidal,porrect,portion,prickle,prickly,primary,raised,ray,red,reflexed,rounded,scandent,sessile,shallow,shiny,shorter,shrub,side,size,slender,small,smooth,sometimes,spaced,sparsely,spherical,spreading,stalk,stalked,stellate-pubescent,stem,straight,style,subentire,surface,tapering,terete,time,tip,trichome,tube,variously,vein,way,weakly,white,wide,woody,yellow-orange,yellowish-green	0-2,0-6,0.5,1.5-1.8,1/5-1/4,2-6,2/,5-8,5-merous,abaxially,acuminat,alyx,apar,appearing,articulated,blade,eaf,eed,elongating,eye,lon,longer,mature,naked,nflorescence,orange-brow,orolla,oung,perfec,pericarp,plurifoliat,prickl,scar,simple,stellate,tamen,tertiary,uit,unit,vary,venation,visible,ympodial	2/3,acuminate,appearance,arrangement,border,branch,bud,characteristic,colour,corolla,corrugation,distal,exertion,form,giving,glabrousnes,growth,height,history,inflorescence,interjected,leaflet,life,lobing,new,null,number,ovary,plant,pseudostipule,seed,shape,stigma,terminal,texture,thicknes,type,variation,width
283	wfo-0001029112	success	190	185	140	50	45	0.737	0.5,0.9-1.7,1-10,1-2,1-3,1-4,1.4-2.5,1.5-1.8,1.5-2,10-17,10-21,2-3.5,2.5-4.5,2.6-3,2.7-3.5,2.7-4.2,2.7-5.7,20,3-5,3-6,3-7,3.5-4.5,3.5-7,5,5-8,6.5-5.5,9.5-13,abaxially,acumen,acuminate,adaxially,along,anther,apart,apex,apparently,arranged,articulated,axe,axillary,base,bead,berry,blade,brownish,bud,cell,chartaceous,cm,condition,conical,connivent,corolla,covering,decreasing,densely,diameter,distal,drying,elliptic-lanceolate,equal,filament,flower,forked,fresh,fruit,generally,gradually,green,greenish,half,herb,interjected,lanceolate,larger,lateral,leaf,leaflet,light,like,lobe,long,make,margin,middle,minute,mm,moniliform,mottled,mucilaginous,multiple,narrow,necklace,obtuse,odd-pinnate,ovate,ovoid,pair,pale,pedicel,peduncle,perfect,petiole,petiolule,plant,plurifoliate,present,pubescent,purple,ray,ripe,secondary,seed,size,slightly,stigma,stolon,style,subequal,subtending,symmetrical,tall,terminal,testal,thick,toward,tri-,tube,tuber,typically,unit,usually,violet,wall,wet,whitish,wide,wing,x,yellow	0-2,3-4,5-merou,ag,alyx,capitat,ciliate,digestion,dorsally,eaf,edge,eed,enzyme,especially,exceeding,flat,folded,geminat,glabrou,glabrous,green-white,hair,hair-like,homostylous,honeycomb-shaped,lengthening,living,lower,nflorescence,orolla,pore,poricidal,pubescen,removed,rotate,ruit,semierec,seudostipule,slit,spaced,specimen,stamen,ste,tamen,tem,thir,throughout,tip,vary,ympodial	'hair-like,appearance,arrangement,bark,border,branch,calyx,capitate,characteristic,colour,corrugation,exertion,form,fruiting,geminate,giving,glabrousnes,growth,height,history,inflorescence,length,life,lobing,mentioned,midpoint,new,number,ovary,per,prickle,primary,pseudostipule,semierect,shape,stem,surface,sympodial,texture,thicknes,third,type,variation,vein,width
284	wfo-0001029120	success	168	154	110	58	44	0.655	.5,.75,0.1-0.5,0.5-1.5,0.7-1,1-1.5,1.1-1.5,1.1-2,2.5-3.5,2.6-7,3-3.5,5-10-flowered,5-8,6-8,6.5-16.5,8511,abrupt,acuminate,acute,anther,anthesi,apex,bark,basal,base,black,bud,calyx,cm,corolla,dark,decurrent,deflexed,densely,dia,drying,f,fide,filament,fleshy,free,glabrous,globose,golden,greenish-brown,hirsute,internodal,lanceolate,large,lateral,leaf,lehmann,like,lobe,lobed,long,long-triangular,main,margin,minutely,mm,narrow,narrower,narrowly,nearly,occasionally,often,opposite,ovary,ovate,pair,pale,paler,pedicel,peduncle,petiole,point,pore,poricidal,portion,pubescent,raised,shaped,shrub,simple,slender,slightly,speckle,stem,stigma,style,surface,tall,tapering,tear-drop,terminal,thickened,tip,trichome,tube,unbranched,uniseriate,vein,white,wide,widening,widest,x,yellow-green,young	.05,/2,apart,beginning,beneath,bullate,cell,difoliate,dry,eaf,edicel,eed,epidermi,erose,especially,evenly,geminat,inflorescenc,infloresence,know,known,larger,later,lon,lower,middle,midrib,minor,nflorescence,older,outer,papillose,peduncl,petaloid,present,prominently,proximal,reproductive,rest,ruit,scar,scattered,spaced,sparsely,specimen,straight,sympodial,tub,ud,unifoliate,unit,upper,urceolate,venation,way,white-papillo,yellow,ympodial	appearance,arrangement,border,branch,characteristic,colour,corrugation,diameter,distal,erosely,exertion,form,fruit,fruiting,giving,glabrousnes,growth,height,history,inflorescence,interjected,leaflet,length,life,lobing,mentioned,midpoint,new,number,per,plant,prickle,primary,pseudostipule,ray,seed,shape,size,texture,thicknes,type,variation,white-papillose,width
285	wfo-0001029121	success	161	160	107	54	53	0.665	0,0.2-2,1-4,1-5,1.1-3.9,1.2-2.5,1.2-3.3,15-30,2-10,2-13,2-3,2-3-celled,3.6-9,3.8-11,4-10,4-5.5,4.5-10.0,5-8,8-16,abaxially,acumen,acuminate,acute,adaxially,apex,articulate,attenuate,base,blue,branched,calyx,cell,cm,commonly,conical,connate,corolla,covering,cuneate,cyme,deep,diameter,dichasial,dichasially,distal,ebracteate,elliptical,exceeding,filament,flower,forked,generally,glabrous,green,green-white,hair,hair-like,half,herbaceous,interjected,lateral,leaf,leaflet,lobe,long,make,medium,mm,monochasial,mucilaginous,narrowly,oblique,obtuse,odd-pinnate,ovate,ovoid,pedicel,peduncle,perennial,perfect,petiole,plant,proximal,purple,rarely,rounded,scattered,seed,short,short-attenuate,size,stamen,stigma,straight,style,terminal,testal,thick,throughout,tip,tuber-bearing,typically,unit,wall,wide,yellow,Â¼	-6,0-2,10,2-,3-5,3-6-foliat,5-20,9-33,abaxiall,apical,apically,dehiscent,digestion,diminishing,dorsally,eaf,edge,eed,emoval,enzyme,flat,folded,globo,gradually,honeycomb,introrse,living,lon,lower,lunat,maturing,nflorescence,nther,often,orolla,pair,pattern,petiolule,plan,poricidally,reveal,rotate,ruit,sessile,seudostipule,slit,specimen,subequal,tal,tem,throughou,toward,vary,ympodial	3-6-foliate,3.6-10.0,6,anther,appearance,arrangement,bark,border,branch,bud,characteristic,colour,corrugation,drying,exertion,form,fruit,fruiting,giving,glabrousnes,globose,growth,height,history,inflorescence,length,life,lobing,lunate,margin,mentioned,midpoint,new,number,ovary,per,prickle,primary,pseudostipule,ray,shape,stem,surface,sympodial,tall,texture,thicknes,tube,type,variation,vein,wet,width
286	wfo-0001029125	success	197	186	133	64	53	0.675	.1,.2,.4,.6,0.5,0.5â0.6,0.5â1.0,0.9,1.0â1.5,1.0â4.0,1.5â3.0,1.7-,1â2-celled,2.5â12.0,2/3,20â100,3â5,6,abaxial,acuminate,acute,adaxial,along,anther,anthesi,apex,apparently,appressed,arising,attenuate,base,berry,beyond,black,brownish,calyx,cell,central,cm,concave-reniform,cone,conical,corolla,cuneate,delicate,deltate,densely,diameter,difoliate,ellipsoid,end,entire,especially,exerted,filament,flower,fruit,fruiting,glabrous,globose,green,herb,internodal,lateral,leaf,like,lobe,lobed,long,lower,margin,maturity,minutely,mm,narrower,nearly,oblique,occasionally,often,one,orange,outline,ovary,ovate-lanceolate,pair,papillate,pedicel,peduncle,pentagonal,per,petiole,place,plant,primary,pubescent,purple,purple-tinged,purplish,reflexed,ridged,ripe,seed,simple,slightly,small,sparsely,spreading,star,stem,stigma,stone,straight,strongly,style,subshrub,surface,terete,tip,toward,traingular,trichome,tube,turning,unequal,uniseriate,vein,white,whitewith,wide,woody,yellow,young,Â¼	.0â3.5,.1â1.4,.5â2.0,0.8â0.9,1,1.0â1.2,1.5â2.0,1.8â3.5,2â3-celled,2â4,3.0â3.4,3.5â4,35â45,3â5-celled,4â8,5-merous,5â6,6â7,abaxially,adaxially,age,apar,articulated,ba,branching,closely,eaf,eed,free,geminat,growt,hilum,later,lengthening,live,lon,maximum,nflorescence,pale,perfect,pore,poricidal,portion,positioned,reflexe,ruit,scar,scattered,shiny,shorter,single,slit,spaced,stellate,stemmed,sub-lateral,tall,tem,testal,tinged,ud,unit,usually,ympodial	.1-1.4,0.5-1.0,0.8-0.9,1.0-1.2,1.8-3.5,2-3-celled,2-4,3.0-3.4,3.5-4,35-45,4-8,5-6,6-7,appearance,arrangement,bark,border,branch,bud,characteristic,colour,corrugation,distal,drying,exertion,form,geminate,giving,glabrousnes,growth,height,history,inflorescence,interjected,leaflet,length,life,lobing,midpoint,new,null,number,prickle,pseudostipule,ray,shape,size,terminal,texture,thicknes,type,variation,width
287	wfo-0001029150	success	177	177	128	49	49	0.723	.5,0.3,0.3â0.5,0.5â1.1,0.8-1,0.8â1,0.8â1.5,0.8â3.5,1.2â1.5,1.5,1.5â2,15,1â1.5,1â11,1â5,2.5â3,2.5â5,2.5â8,2â2.5,2â3,3â10,3â4,3â50,6,7â8,8-shaped,9â12,accrescent,acute,adaxially,anther,apex,apically,apiculate,attenuate,axe,base,berry,branched,calyx,canopy,ciliate,climbing,cm,color,conical,cros,cylindrical,delicate,diameter,dried,ellipsoidal,elliptical,enlarged,entire,except,extra-axillary,filament,flattened,fleshy,flower,flush,fruit,fruiting,glabrous,inconspicuous,lanceolate,larger,leaf,light,lobe,long,margin,minutely,mm,moderately,nearly,oblique,older,opposed,ovate,pair,pale,pedicel,peduncle,petiole,pinkish-white,pinnate,pubescent,rarely,rounded,rounded-deltoid,rugose,sand-punctate,scar,secondary,section,shortly,simple,slender,slightly,somewhat,sparsely,specimen,stem,stigma,strong,style,surface,tan,teardrop-shaped,thick,time,tip,tree,trichome,truncate,tube,understory,unit,vegetation,vein,vine,white,wide,wiry,woody,x	0.3-0.5,1.5â2.2,1â2,1â6,2â10,3-5,5-merous,abaxially,across,adaxiall,alyx,apar,apicall,blade,c.,capitat,distant,eaf,eed,glabrou,lamina,living,lon,lower,m.,material,membranaceous,midvein,mor,nflorescence,nternode,orolla,perfec,plurifoliat,pointed,rachi,reaching,ruit,side,small,spaced,stellate,tamen,tem,thickened,translucent,vary,venation,ympodial	appearance,arrangement,bark,border,branch,bud,capitate,characteristic,colour,corolla,corrugation,distal,drying,exertion,form,giving,glabrousnes,growth,height,history,inflorescence,interjected,lateral,leaflet,length,life,lobing,mentioned,midpoint,new,number,ovary,per,plant,plurifoliate,prickle,primary,pseudostipule,ray,seed,shape,size,sympodial,terminal,texture,thicknes,type,variation,width
288	wfo-0001029152	success	197	195	160	37	35	0.812	.1,.5,0.25-0.5,0.5-1,0.75-1,0.8-1,0.9-1.3,1,1-1.5,1-2,1-3,1-4,1.1-1.3,1.5-1.7,1.5-2,2-2.5,2-3,2-4,2-5,2.5-3,3-5,3-8-flowered,4-6,6-8,8.5-16,acuminate,acute,anther,anthesi,apex,appressed,area,attenuate,bark,base,beginning,beneath,berry,blade,branch,broadened,broadly,brown,bud,calyx,closely,cm,conical,corky,corolla,cuneate,dark,deciduous,decurrent,deep,deflexed,deltoid,densely,dia,differing,distal,dry,elliptic,erect,exsertion,filament,flattened,flower,free,fruit,fruiting,giving,glabrous,globose,green,greyish-red,held,inflorescence,keeled,large-lenticellate,lateral,leaf,lightly,lobe,lobed,long,long-styled,main,major,margin,material,middle,minor,minutely,mm,nearly,obovate,often,older,one,opposite,ovary,overlapping,ovoid-reniform,pair,pale,papillose,pedicel,per,petiole,pitted,planar,plane,plant,pore,poricidal,portion,prominent,prominently,red-floccose,reddish,reddish-floccose,reflexed,scar,shape,shaped,shiny,short-styled,shrub,simple,single,size,slender,slightly,small,soon,spaced,stem,stigma,straight,style,surface,tall,tapering,tear-drop,terminal,third,tip,tree,trichome,tube,usually,vein,weak,white,widest,winged,woody,x,young	61-25,appearanc,appearing,ba,citronella,completely,difoliate,eaf,edicel,eed,ellipsoi,enclosing,et,fide,floccose,fragrance,geminat,hyaline,inflorescenc,late,live,lon,longer,lower,midrib,nflorescence,quite,red,reminiscent,rounded,ruit,somewhat,styl,tillett,ud,unit,ympodial	appearance,arrangement,border,characteristic,colour,corrugation,diameter,drying,ellipsoid,exertion,form,glabrousnes,growth,height,history,interjected,leaflet,length,life,lobing,midpoint,new,null,number,peduncle,prickle,primary,pseudostipule,ray,seed,texture,thicknes,type,variation,width
289	wfo-0001029156	success	65	113	59	6	54	0.908	-3,0.5,1,1.5-2,10-12,2,4-6,6,6-8,<,almost,apex,apparently,bark,berry,cell,center,cm,completely,deeply,diameter,epiphytic,exfoliating,flattened,fruiting,glabrous,golden,growth,lateral,liana,long,margin,markedly,minute,minutely,mm,multiseriate,new,occasionally,pale,pedicel,per,pitted,rectangular,reniform,rib-like,seed,shiny,sinuate,stem,surface,tan,testal,thickening,trichome,vine,wall,wide,woody	eed,fide,nee,noddin,older,shreddy	8-12,anther,appearance,arrangement,base,border,branch,bud,calyx,characteristic,colour,corolla,corrugation,distal,drying,exertion,filament,form,fruit,giving,glabrousnes,height,history,inflorescence,interjected,leaf,leaflet,length,life,lobe,lobing,mentioned,midpoint,number,ovary,peduncle,petiole,plant,prickle,primary,pseudostipule,ray,shape,size,stigma,style,terminal,texture,thicknes,tube,type,variation,vein,width
290	wfo-0001029156	success	65	110	53	12	57	0.815	0.5,1,1.5-2,10-12,2,4-6,6-8,<,almost,apex,apparently,berry,center,cm,completely,deeply,diameter,epiphytic,exfoliating,flattened,fruiting,glabrous,golden,growth,lateral,liana,margin,markedly,minute,minutely,mm,multiseriate,new,occasionally,pale,pedicel,per,pitted,rectangular,reniform,rib-like,seed,shiny,sinuate,stem,surface,tan,thickening,trichome,vine,wall,woody,x	-3,ark,cell,eed,em,fide,lon,nee,noddin,older,shreddy,testal	2-3,6,anther,appearance,arrangement,bark,base,border,branch,bud,calyx,characteristic,colour,corolla,corrugation,distal,drying,exertion,filament,form,fruit,giving,glabrousnes,height,history,inflorescence,interjected,leaf,leaflet,length,life,lobe,lobing,long,mentioned,midpoint,number,ovary,peduncle,petiole,plant,prickle,primary,pseudostipule,ray,shape,size,stigma,style,terminal,texture,thicknes,tube,type,variation,vein,width
291	wfo-0001029163	success	149	176	123	26	53	0.826	-25,-4,-9,0.3-2.5,0.5-1,1,1-2,1.5-3,10-,2,2-3,2-6,2-7,2.5-3,20-30,3-14,3-4,3-5,4-20,4-5-foliat,4.5-23,5-12,5-8,7-9,9-15,abaxial,abaxially,acuminate,acute,adaxially,aggregate,apart,apex,articulated,axe,band,base,blade,calyx,cell,chartaceous,cm,color,connivent,cuneate,cylindrical,decurrent,deltate,densely,denser,diameter,directed,distally,eglandular,elliptic,elliptic-ovate,entire,flower,free,fruit,glabrous,glandular,globose,hair,herb,lanceolate,leaving,lenticular,like,lobe,long,margin,mm,moderately,narrowed,narrowly,nearly,obtuse,papillose,pedicel,pedicellar,peduncle,perennial,petiole,pore,projection,pseudohair,puberulent,puberulent-pubescent,pubescence,purple,remnant,ripe,roughened,scale-like,shrub,simple,slightly,small,sometimes,spaced,sparsely,stalked,stem,stigma,stone,style,subapical,surface,time,tip,triangular,tube,unbranched,unit,unknown,vein,white,whitish,wide,x,yellow,ympodial	1.5-2,1.5-2.5,13-18,2-18,4-6,absen,adaxiall,distall,eaf,eed,lon,lower,nflorescence,nther,orolla,puberulent-pubescen,rachi,radiu,ruit,stellate,subcoriaceous,tal,tem,thickened,truncat,vary	absent,anther,appearance,arrangement,bark,border,branch,bud,characteristic,colour,corolla,corrugation,distal,drying,exertion,filament,form,fruiting,giving,glabrousnes,growth,height,history,inflorescence,interjected,lateral,leaf,leaflet,length,life,lobing,mentioned,midpoint,new,number,ovary,per,plant,prickle,primary,pseudostipule,ray,seed,shape,size,tall,terminal,texture,thicknes,truncate,type,variation,width
292	wfo-0001029171	success	137	148	93	44	55	0.679	-,-15,0.5,1-3,1-4.5,1.5-2,1.5-7.5,10-25,10-35,2-3,3-4,3.5-18,3.5-6.5,4-10,4-5,5-6,5-8,6-,7-9,abaxially,abruptly,acuminate,acute,adaxially,aggregate,also,angled,apex,base,blade,branched,calyx,cell,chartaceous,cm,cuneate,cylindrical,decurrent,deltate,dendritically,densely,diameter,eglandular,elliptic,entire,flower,forked,fruit,glabrous,gland,glandular,globose,hair,lanceolate,like,lobe,long,margin,mm,moderately,narrowed,obtuse,often,orange,ovate-elliptic,pedicel,peduncle,petiole,pubescent,purple,radiu,rarely,red,ripe,rugose,shoot,short-stalked,shrub,simple,slightly,smooth,sometimes,stigma,stone,style,time,tip,tube,unbranched,unit,white,wide,x	-10,1-5,11-20,8-17,absen,and/or,apart,articulated,axe,ba,connivent,dense,directed,distall,eaf,eed,except,glandula,lower,many-foliat,midrib,narrowly,near,nearly,nflorescence,nther,orolla,perfect,pore,puberulent,rachi,ruit,spaced,sparsely,ste,stellate,tal,tem,triangular,truncat,usually,vary,yellow,ympodial	absent,anther,appearance,arrangement,border,branch,bud,characteristic,colour,corolla,corrugation,distal,drying,exertion,filament,form,fruiting,giving,glabrousnes,growth,history,inflorescence,interjected,lateral,leaf,leaflet,length,life,lobing,many-foliate,mentioned,midpoint,new,number,ovary,per,prickle,primary,pseudostipule,ray,seed,shape,size,stem,surface,sympodial,tall,terminal,texture,thicknes,truncate,type,variation,vein,width
293	wfo-0001029215	success	49	100	42	7	58	0.857	-1.8-2.3,.2,0.3-0.5,0.5-0.7,0.5-2.5,1,2.3-2.9,appearance,border,brown,calyx,cell,cm,coarse,diameter,entire,fide,fruit,hair-like,herb,lateral,lobe,long,mm,narrowly,obovate,outgrowth,pubescent,round,shrub,silky,small,smelling,strong,surface,testa,wall,weigend,wide,winged,woody,xyledecor	eed,elongating,give,markedly,spreadin,tall,thick	anther,apex,arrangement,bark,base,branch,bud,characteristic,colour,corolla,corrugation,distal,drying,exertion,filament,form,fruiting,giving,glabrousnes,growth,height,history,inflorescence,interjected,leaf,leaflet,length,life,lobing,margin,midpoint,new,number,ovary,pedicel,peduncle,per,petiole,plant,prickle,primary,pseudostipule,ray,seed,shape,size,specified,stem,stigma,style,terminal,texture,thicknes,tube,type,variation,vein,width
294	wfo-0001029216	success	243	232	197	46	35	0.811	+,-0.5,-10,-5,.5,.8-1,0.1-0.3,0.1-0.6,0.1-0.8,0.2-0.25,0.2-0.3,0.3-0.4,0.4-0.5,0.5,0.5-0.8,0.6-1,0.8-2.5,1-1.2,1-2,1-3,1-4,1.2-6,1.5-2.3,1.5-2.5,1.5-3,10,10-,10-14,2,2-4.5,2-locular,2.5-3.3,20-35,3,3-,3-4,3-5,3-7,4,5,5-15-flower,6-10,7-10,<,absent,acute,adpressed,allogamous,always,and/or,annual,anther,anthesi,apex,apical,appearance,appendage,attenuate,base,basiscopically,becoming,biennial,branch,bright,brown,calyx,capitate,cell,cm,column,composed,cone,conical,cordate,corolla,crenate,cultivar,decurrent,deep,deeply,dentate,diameter,distal,elliptic,entire,erect,exserted,extending,facultatively,fasciated,filament,fruit,fruiting,giving,glabrescent,gland-tipped,glandular,globose,green,hair-like,half,halfway,herb,imparipinnate,included,inflorescence,initially,interjected,interrupted,lanceolate,later,lateral,leaflet,length,less,like,linear,lobe,lobulate,long,longer,mainly,margin,maturity,minute,minutely,mixture,mm,multicellular,multilocular,narrowly,near,numerous,oblique,obovate,often,one,orange,outgrowth,ovary,ovate,pair,pale,particularly,pedicel,peduncle,perennial,petiole,petiolule,plant,population,present,primary,procumbent,pseudostipule,pubescent,rarely,red,shaggy,shape,shaped,silky,simple,sometimes,somewhat,sparse,sparsely,spreading,staminal,stem,sterile,stigma,straight,strong,strongly,style,surface,tangled,terminal,testa,thick,tip,total,toward,trichome,truncate,tube,unicellular,uniseriate,usually,varying,villous,viny,wall,wide,winged,yellow	0.1-0.5,0.2-0.4,0.2-0.8,0.3-0.5,0.3-2,0.4,0.5-1.5,0.5-2,0.6-0.8,1-6,1/,3-foliate,absen,accrescent,acroscopically,angeld,articulated,articulation,axi,basal,cente,eaf,edicel,eed,fruited,gree,internode,large,larger,lon,lower,nflorescence,pentagonal,reflexe,ruit,scen,secondary,sessile,short,tem,tertiary,thickening,ud,unit,variety,ympodial	arrangement,bark,border,bud,center,characteristic,colour,corrugation,drying,exertion,form,glabrousnes,growth,height,history,leaf,life,lobing,midpoint,new,null,number,per,prickle,ray,reflexed,scent,seed,size,texture,thicknes,type,variation,vein,width
295	wfo-0001029226	success	206	224	180	26	44	0.874	-7,-9,.5,.75,0-1,0.5,0.5-5,1-1.5,1-2,1-3,1-celled,10-40+,2,2-3,2-6,2-9,2.5-10,3-3.5,3-6,30,4,4-6,5-7,7-11,8-13,>,acuminate,acute,anther,anthesi,apart,apex,apparently,articulated,basal,base,berry,black,blue,branched,breaking,bright,calyx,capitate,cell,cm,completely,congested,conical,connivent,cordate,corolla,dark,decurrent,deltate,densely,diameter,distall,divided,dry,ellipsoid,elongate,enation,entire,exserted,filament,flattened,flexuous,flower,fruiting,glabrescent,glabrous,gland,glandular,globose,green,growth,hairy,herbaceous,irregularly,juice,lateral,lavender,leaf,lengthening,like,lobe,lobed,long,longer,loosely,lyrate,many,margin,material,mature,membranous,mere,minute,minutely,mm,new,occasionally,often,one,open,overtopping,pair,pale,papillate,pedicel,peduncle,per,petiole,pinnate,pinnatifid,pitted,pore,poricidal,primary,pubescent,red,reflexed,remainin,reniform,rim,ripe,sagittate,scar,scarlet,seed,shiny,short-glandular,shorter,shrub,simple,sleeve,slender,slit,small,sometimes,spaced,sparsely,spot,sprawling,spreading,staining,stem,stigma,strongly,style,surface,tan,tangled,terminal,testal,thin,third,time,tip,translucent,trichome,truncate,tube,uniformly,uniseriate,unit,usually,vein,vine,wall,way,weak,white,wide,widest,winged,woody,yellowish,Â¾	5-merou,ag,alyx,ark,ba,eaf,eed,free,ilament,lower,nflorescence,older,orolla,papillat,papillo,perfect,plurifoliat,portion,ruit,spreadin,stellate,tem,twinin,ud,vary,ympodial	age,appearance,arrangement,bark,border,branch,bud,characteristic,colour,corrugation,distal,drying,exertion,form,fruit,giving,glabrousnes,height,history,inflorescence,interjected,leaflet,length,life,lobing,midpoint,number,ovary,papillose,plant,plurifoliate,prickle,pseudostipule,ray,shape,size,specified,sympodial,texture,thicknes,twining,type,variation,width
296	wfo-0001029236	success	159	178	135	24	43	0.849	.5,0.2-0.7,0.2-1,0.45-0.5,0.5,0.5-1.5,0.9-2.3,1-1.5,1-2,1.4-1.7,1/2,2-4,2-5,3,6-9,absent,age,anther,anthesi,apex,apical,apically,appearing,axi,bark,basal,base,becoming,berry,branch,branching,branchlet,broadly,calyx,cm,compact,completely,conical,coriaceous,corolla,cupulate,decurrent,deflexed,deltate,dendritic,densely,diameter,dichasial,elliptic,erect,except,exserted,filament,flattened,fleshy,flower,free,fruit,fruiting,glabrous,globose,grey-brown,growth,later,lateral,leaf,lenticular,less,lobe,lobed,long,many,margin,middle,minutely,mm,narrowly,near,nodding,obscure,obscurely,occasionally,older,ovary,overtopping,pale,pedicel,per,pericarp,persistent,petiole,pitted,plurifoliate,pointed,pore,poricidal,portion,prominent,pubescent,purplish,purplish-black,reddish-brown,revolute,scar,scattered,shiny,shoot,short,shrub,sleeve,slightly,slit-like,sparsely,stem,stigma,strongly,style,surface,tall,tapering,terminal,thin,time,tip,trichome,tube,unit,usually,violet,way,wide,winged,woody,x,young	abaxially,adaxial,apparently,ba,bi-lobe,eaf,edicel,eed,ew,inserted,lower,m.,midvein,nflorescence,packe,ruit,secondary,simple,stamen,trongly,tub,ud,venation,ympodial	appearance,arrangement,bi-lobed,border,bud,characteristic,colour,corrugation,distal,drying,exertion,form,giving,glabrousnes,height,history,inflorescence,interjected,leaflet,length,life,lobing,midpoint,new,null,number,packed,peduncle,plant,prickle,primary,pseudostipule,ray,seed,shape,size,sympodial,texture,thicknes,type,variation,vein,width
297	wfo-0001029246	success	209	190	150	59	40	0.718	-1.5,-4,/5,0-5,0.1-0.4,0.15-0.3,0.2-1.5,0.3-0.8,0.5,0.7-1.3,0.7-2,0.8-1.1,0.8-3,0.9-1.3,1-1.5,1-1.8,1-10,1-3,1-4,1.2-2,1.5-2.3,1.5-2.5,1.5-6,1.7-6,1/3,2,2-3,2-5,2.5-3.2,2.8-4,2/3,3-20,3-5,3.5-5,5-20,6-8,7-12,8-16,abaxial,acuminate,acute,adaxial,anther,apart,apex,apically,apparently,articulated,bark,base,berry,broad-deltate,c.,calyx,cm,concolorous,connivent,cuneate,deltate,densely,diameter,discolorous,distance,drying,dull,elliptic,entire,erect,extending,filament,flattened,flattened-reniform,flower,free,fruit,fruiting,glabrescent,glabrous,infructescence,lateral,leaf,length,less,lobe,lobed,long,lower,margin,mature,maturity,mauve,midpoint,midvein,mm,moderately,narrow-deltate,oblong,obtuse,older,one,open,orange-brown,orange-red,pair,pale,pedicel,peduncle,per,petiole,poricidal,porrect,portion,prickle,prickly,primary,procumbent,pubescent,purple,ray,recurved,rounded,scar,sessile,shrub,side,sometimes,spaced,sparsely,spherical,stellate-pubescent,stem,straight,style,surface,tapering,terete,time,tip,trichome,tube,unarmed,unbranched,upper,vein,way,white,wide,yellow,yellow-orange,Â¼	-1,0,0-15,0.1-0.3,0.3-0.5,0.5-1.5,0.7-1.5,1-5,1-8,1.8-3,1/10-1/5,2-3.5,2/3-3/,4-6,5-,5-merous,6-10,abaxially,acuminat,almost,alyx,apar,blade,chartaceous,curved,eaf,eed,elongating,equal,eye,lon,longer,naked,narrow-ovate,nflorescence,orange-brow,orolla,oung,pendulous,perfec,pericarp,plurifoliat,prickl,ruit,simple,smooth,spreading,stellate,stout,strongly,tamen,tertiary,unit,usually,vary,venation,visible,woody,ympodial	2/3-3/4,appearance,arrangement,border,branch,bud,characteristic,colour,corolla,corrugation,distal,exertion,form,giving,glabrousnes,growth,height,history,inflorescence,interjected,leaflet,life,lobing,mentioned,new,number,ovary,plant,plurifoliate,pseudostipule,seed,shape,size,stigma,terminal,texture,thicknes,type,variation,width
298	wfo-0001029286	success	224	192	147	77	45	0.656	.4,0.15-0.4,0.4-1.2,0.6-1.2,0Â°,1-1.5,1-2,1.5-2,1.5-4,1/8,15-50,2-3,2.5-3,3-4,4-5,4-6,4.5,4.5-7,5,5-6,6-8,6-9,7-10,abaxial,abscising,acute,age,almost,anther,anthesi,apart,apex,apically,apiculate,around,articulation,attenuate,bark,base,branch,branched,branching,broadly,brown,canaliculate,capitate,chartaceous,clearly,clustered,cm,concolorous,conical,corolla,crenulate,curved,delineated,dendritic,density,diameter,dilated,distributed,drying,entire,equal,except,faint,fertilization,filament,flexuous,flower,free,glabrescent,glabrous,green,grey,increasing,inside,isolated,known,leaf,length,lengthening,less,liana,light,lilac,lobe,lobed,long,main,margin,mauve,membranous,midvein,minutely,mm,much,narrowly,obconical,oblong,obovate,occasional,outside,ovate,pair,pedicel,peduncle,petiole,pore,poricidal,portion,primary,prominent,protruding,rachi,scar,shallowly,side,simple,slender,smaller,smooth,sometimes,soon,sparsely,spreading,stem,stigma,stump,style,surface,terete,terminal,thick,thickened,time,tip,toward,trichome,tube,tuft,unarmed,vein,widely,x,yellowish,young	.5,0-0.5,0.1,0.8,1.5-8,abaxially,adaxially,along,altered,alyx,another,apar,apice,apparently,arising,articulated,axil,becoming,closer,concave,cuspidate,deltoid,domatia,eaf,eed,extending,flat,formed,forming,fresh,globo,hair,inflorescenc,junction,know,lamina,lower,m.,margi,mas,meeting,middle,multicellular,nflorescence,nther,often,one,orolla,papillo,perfec,plurifoliat,raised,rarely,regular,rounded,ruit,separated,somewhat,specimen,stretchy,tangled,tearing,tertiary,textur,thinner,tissue,together,translucent,translucent-violet,ud,uneven,unit,vary,venation,visible,wide,ympodial	appearance,arrangement,border,bud,calyx,characteristic,colour,corrugation,distal,exertion,form,fruit,fruiting,giving,glabrousnes,globose,growth,height,history,inflorescence,interjected,lateral,leaflet,life,lobing,mentioned,midpoint,new,null,number,ovary,papillose,per,plant,prickle,pseudostipule,ray,seed,shape,size,texture,thicknes,type,variation,width
299	wfo-0001029310	success	216	244	205	11	39	0.949	-16,-25,.1,.5,.6,/4,/6,0-20,0-5,0.1-0.2,0.2-0.3,0.2-0.8,0.5,0.5-3,0.6-1.1,00,1,1-1.5,1-2,1-4,1.2-1.5,1.8-3,1/,10,10-13,10-15,10-20,15-20,2-3.5,2-4,2.5-6,2/3-3/4,20-40,20-60,200-500,3-4,3-5,3.5,4-10,4-8,45-60,5,5-10,5-12,5-20,5-30,5-6,5-7,5-8,5-merous,6-8,7-12,7-13,8,abaxially,accrescent,acute,ame,andromonoecious,anther,apar,apart,apex,apically,apparently,articulated,bark,base,berry,beyond,blade,branched,brown,c.,calyx,cm,concolorous,conical,connivent,cordate,dark,deltate,diameter,difoliate,distal,distance,drying,dull,elliptic,elongating,enclosing,equal,erect,extending,filament,filifor,flattened-reniform,flower,free,fruit,fruiting,geminat,gently,glabrescent,glabrous,gray,hair,herb,hermaphrodite,heterostylous,inflated,infructescence,lateral,leaf,length,lobe,lobed,lobing,lon,long,long-styled,longer,lower,lowermost,margin,mature,maturity,mauve,membranous,midpoint,midvein,minute,mm,moderately,narrow-deltate,older,one,open,orange-green,ornately,pair,pedicel,peduncle,pendent,pendulous,per,pericarp,perpendicular,petiole,pinnatifid,plant,poricidal,porrect,portion,prickle,prickly,primary,ray,recurved,red-brow,retrorse,scar,secondary,sessile,short-styled,shorter,shrub,side,simple,smooth,sometimes,spaced,sparsely,spherical,spreading,stalk,stalked,staminat,stellate,stellate-pubescent,stem,stout,straight,strongly,style,surface,tapering,terete,tertiary,time,tip,tissue,toward,trichome,truncate,tube,unit,variously,vein,venation,visible,way,wide,woody,yellow	alyx,eaf,eed,nflorescence,orolla,oung,prickl,ruit,tamen,vary,ympodial	appearance,arrangement,border,branch,bud,characteristic,colour,corolla,corrugation,exertion,form,giving,glabrousnes,growth,height,history,inflorescence,interjected,leaflet,life,new,null,number,ovary,pseudostipule,seed,shape,size,stamen,stigma,sympodial,terminal,texture,thicknes,type,variation,width,yello,young
300	wfo-0001029317	success	151	163	118	33	45	0.781	.5,0.25,0.5,0.5-0.75,0.5-1,0.8-1,1,1-1.5,1.5-3.5,10-16,10-30-flowered,2-3,2.5-5,6-8,6.5-11,7-8,8-9,acuminate,along,anther,anthesi,apex,area,attenuate,barely,base,beneath,broadly,bud,ca,calyx,channeled,cm,corolla,cup-like,deflexed,deltoid,densely,denser,dia,differing,difoliate,dry,epidermi,erect,exserted,extreme,filament,free,fruiting,geminate,glabrate,glabrous,globose,grayish,immature,inflorescence,known,lateral,leaf,like,lobe,lobed,long,major,margin,middle,minor,minutely,mm,narrowly,nearly,often,older,opposite,ovary,ovate,ovoid,papillose,pedicel,petiole,poricidal,portion,probably,prominent,proximal,pubescent,rachi,raised,reflexed,remaining,rounded,shrub,simple,size,slender,soft,soon,sparsely,specimen,stem,stigma,straight,style,tall,tapering,tip,trichome,tube,uniseriate,unit,vein,visible,white,widest,x,yellowish,young	11-14,apar,brow,closely,deciduou,eaf,edicel,eed,ellipsoi,frui,lon,lower,main,nflorescence,occasionally,one,otherwise,overlapping,pair,paler,pore,rest,ruit,scar,shaped,slightly,spaced,styl,tear-drop,thickened,tuft,ud,ympodial	appearance,arrangement,border,branch,brown,characteristic,colour,corrugation,deciduous,diameter,distal,drying,ellipsoid,exertion,form,fruit,giving,glabrousnes,growth,history,interjected,leaflet,length,life,lobing,mentioned,midpoint,new,number,peduncle,per,prickle,primary,pseudostipule,ray,seed,shape,surface,sympodial,terminal,texture,thicknes,type,variation,width
301	wfo-0001029332	success	197	194	154	43	40	0.782	.5,/3,0,0-0.5,0-100,0-2,0-20,0-5,0.1,0.1-0.2,0.15-0.2,0.5-1,0.8-1,1-1.5,1-2,1-3,1-4,1.3-1.5,1.5-2,1/2,1/3,1/4,10-30,2,2-2.5,2-4,2.5-3.5,2.8-3.7,2/3-3/4,3-4,3-6,3.5-5,4-10,4-15,5-6,5-8,6-8,8.5-9.5,abaxial,adaxial,anther,apart,apex,apically,apparently,bark,base,berry,broad-deltate,calyx,chartaceous,cm,concolorous,conical,connivent,cordate,curved,densely,diameter,difoliate,distal,distance,drying,elongating,equal,erect,extending,filament,flattened,flattened-reniform,flower,free,fruit,fruiting,glabrescent,gland,globular,lateral,leaf,length,less,lobe,lobed,long,long-styled,lower,margin,mature,maturity,mauve,midpoint,midvein,mm,moderately,narrow-deltate,often,older,one,open,orange-brown,ovate,pair,pale,pedicel,peduncle,per,petiole,plant,poricidal,porrect,portion,prickle,prickly,primary,pubescent,ray,reduced,rounded,scandent,sessile,shorter,shrub,side,simple,slender,spaced,spherical,spreading,stalk,stalked,stellate,stellate-pubescent,stem,style,subsessile,surface,tapering,terete,terminal,time,tip,trichome,tube,unbranched,unit,upper,variously,vein,way,weakly,wide,yellow,yellow-green,yellow-orange	-5,0-4,0.15-0.25,1/4-1/3,2/,5-merous,abaxially,alyx,andromonoecious,apar,articulated,becoming,blade,eaf,eed,geminat,glabrous,grayi,herbaceous,hermaphrodite,heterostylous,infructescence,long-acuminat,longer,lowermost,nflorescence,orolla,oung,pendulous,pericarp,prickl,ruit,scar,short-styled,smooth,staminat,tamen,tertiary,vary,venation,visible,woody,ympodial	2/3,appearance,arrangement,border,branch,bud,characteristic,colour,corolla,corrugation,exertion,form,geminate,giving,glabrousnes,grayish,growth,height,history,inflorescence,interjected,leaflet,life,lobing,long-acuminate,mentioned,new,number,ovary,pseudostipule,seed,shape,size,stigma,sympodial,texture,type,variation,width,young
302	wfo-0001029333	success	155	181	136	19	45	0.877	.25,.5,/4,0.5-1,0.7-1,1-1.2,1-1.5,1-15,1-2,1-3,1-7,1.5-2,1.5-2.5,1.5-3,10-15-flowered,100,17-26,2-2.5,3-7,3-7.5,5-6,8-15,9-13,abaxially,acuminate,acute,adaxially,along,anther,anthesi,apex,auriculate,bark,base,beige,beneath,berry,broadly,calyx,clavate,cm,conical,contracted,corolla,deflexed,dendritic,densely,denser,dia,differing,difoliate,dry,elliptic-obovate,erect,exserted,filament,flattened-reniform,flower,free,fresh,fruiting,geminate,glabrous,globose,golden,green,incrassate,lateral,leaf,like,lobe,lobed,long,long-styled,main,major,margin,minor,minutely,mm,obovate,occasionally,older,opposite,orbicular,ovary,pair,pale,paler,pedicel,petiole,pitted,planar,pore,poricidal,portion,present,pubescence,pubescent,reddish-brown,rest,rounded,scar,sessile,shape,shaped,shining,short-styled,shrub,simple,size,slender,small,somewhat,sparsely,stem,stigma,strongly,style,surface,tall,tear-drop,time,tip,tree,triangular,trichome,truncate,tube,type,unit,vein,way,wide,woody,young	0.5,abaxial,anisophyllou,ba,dendritic-pubescent,eaf,edicel,eed,heteromorphic,inflorescenc,lon,lower,nflorescence,overlappin,papillo,ruit,spaced,ud,ympodial	anisophyllous,appearance,arrangement,border,branch,bud,characteristic,colour,corrugation,diameter,distal,drying,exertion,form,fruit,giving,glabrousnes,growth,height,history,inflorescence,interjected,leaflet,length,life,lobing,mentioned,midpoint,new,number,papillose,peduncle,per,plant,prickle,primary,pseudostipule,ray,seed,sympodial,terminal,texture,thicknes,variation,width
303	wfo-0001029334	success	211	185	140	71	45	0.664	0-4,0.15-0.3,1,1-10,1-2,1-3,1-6,1.3-4.5,1.5-3.9,1.5-6,1.8-2.9,2-2.5,2-4,2-5,2-8,2.5-3,3-7,3.2-5.8,3.3-6.5,4-5.5,4-8.5,5-10,7.5-15.5,8-30,9-12,abaxially,absent,acumen,acute,adaxially,almost,anther,apart,apex,apparently,articulated,attenuate,axe,axillary,base,berry,blade,borne,broadly,brownish,bud,cell,ciliate,clavate,cm,condition,connivent,cordate,corolla,covering,cuneate,densely,diameter,distal,drying,elliptic,end,erect,especially,exceeding,filament,flower,forked,fresh,fruit,generally,glabrous,globose,green,greenish,hair,half,herb,interjected,lanceolate,lateral,leaflet,like,lobe,long,make,margin,mm,mucilaginous,narrowly,oblique,obtuse,odd-pinnate,orbicular,ovate,ovoid,pedicel,peduncle,perfect,petiole,petiolulate,plant,puberulent,pubescent,pure,rarely,ripe,rounded,seed,semi-rosette,sessile,shady,short,singly,situation,size,stamen,stem,stigma,straight,style,subtending,sunny,terminal,testal,thick,tinged,tip,tube,tuber,typically,unwinged,usually,violet,wall,wet,white,whitish,wide,x	.2,2,3-5,5-merou,ag,along,alyx,among,capitat,chartaceous,decreasing,decurrent,digestion,dorsally,eaf,edge,eed,enzyme,except,flat,folded,geminat,glabrou,gradually,grassland,greatly,green-white,hair-like,homostylous,honeycomb-shaped,lengthening,living,low-growin,lower,membranous,middl,midrib,minutely,nflorescence,often,orolla,pair,petiolule,plurifoliate,pore,poricidal,proximal,reduced,removed,ruit,seudostipule,slightly,slit,spaced,specimen,ste,stellate,stolo,subequal,subsessile,tall,tamen,tem,throughout,toward,tri-,unit,vary,woodland,yellow,ympodial	'hair-like,appearance,arrangement,bark,border,branch,calyx,capitate,characteristic,colour,corrugation,exertion,form,fruiting,giving,glabrousnes,growth,height,history,inflorescence,leaf,length,life,lobing,low-growing,mentioned,middle,midpoint,new,number,ovary,per,prickle,primary,pseudostipule,ray,shape,stolon,surface,texture,thicknes,type,variation,vein,width
304	wfo-0001029344	success	147	167	115	32	52	0.782	.5,0.4-1,0.5-1,0.5-1.5,0.5-3,1,1-2,1-3,1-5,1-6,1.5,1.5-3,1.5-4,10-20,10-35,2-3,2-7,3-10,4-6,5-12,5-15,abaxially,absent,acute,adaxially,along,anther,apex,axe,base,berry,beyond,blade,brown,calyx,center,ciliate,cm,connected,cordate,decurrent,densely,denser,diameter,difoliate,dm,drying,edge,elliptic,elliptic-ovoid,entire,equal,exserted,filament,fine,flat,flower,fruit,glabrous,globose,hair,herb,immature,lacking,linear-lanceolate,lobe,long,lying,margin,maturing,mm,moderately,nearly,notch,oblong,obtuse,obvious,often,one-,parallel,pedicel,peduncle,per,petiole,placenta,pubescent,rachi,radiating,raised,rhizomatous,ridge,rounded,running,semitransparent,shallow,short,slightly,sometimes,sparsely,stamen,stigma,straight,style,surface,swollen,triangular,tube,two-celled,unbranched,unit,vein,white,woody,x,yellow	2-3-celled,2-4,abundant,adaxiall,chartaceous,dehiscing,eaf,eed,emarginat,explosively,frui,geminat,held,interpetalar,lower,maturit,membranaceous,mesocarp,nflorescence,orolla,pressure,pubescen,rotate,ruit,tal,tamen,tem,tissue,vary,watery,wid,ympodial	appearance,arrangement,bark,border,branch,bud,characteristic,colour,corolla,corrugation,distal,emarginate,exertion,form,fruiting,geminate,giving,glabrousnes,growth,height,history,inflorescence,interjected,lateral,leaf,leaflet,length,life,lobing,mentioned,midpoint,new,null,number,ovary,plant,prickle,primary,pseudostipule,ray,seed,shape,size,stem,sympodial,terminal,texture,thicknes,type,variation,wide,width
305	wfo-0001029363	success	152	140	99	53	41	0.651	.75,/4,0-0.1,0.1-0.5,0.2-1.1,0.5-1,1,1-1.2,1.5-1.7,1.5-3.5,2-6,3-7,4-11,5-7-flowered,6-7,6-8,acuminate,acute,anther,anthesi,apex,axil,bark,base,becoming,beneath,berry,bi-lobed,bud,calyx,capitate,cm,corolla,cup-shaped,deep,densely,dia,drying,elliptic,except,filament,free,fruit,fruiting,glabrous,globose,green,greyish,immature,known,larger,lateral,leaf,lobe,lobed,long,main,margin,maroon,mature,middle,minutely,mm,much,narrowly,obtuse,older,opposite,ovary,pale,pedicel,petiole,portion,pubescent,shiny,shrub,simple,slender,small,sparsely,stem,stigma,style,surface,tall,tapering,terminal,tree,trichome,tube,tuft,uniseriate,vein,way,white,white-papillose,wide,widest,young	.25,0.5,7-10,ba,beginning,closely,coroll,deflexed,deltoid,eaf,edge,edicel,eed,erect,exsertion,inflorescenc,internodal,lamina,later,lon,lower,meeting,minute,near,nflorescence,occasionally,often,overlapping,pair,paler,papillo,papillose,pore,poricidal,prominent,reflexed,ruit,scar,slit-like,somewhat,spaced,sparse,straight,thickened,tip,ud,unifoliat,unit,upon,usually,woody,yellowish,ympodial	appearance,arrangement,border,branch,characteristic,colour,corrugation,diameter,distal,exertion,form,giving,glabrousnes,growth,height,history,inflorescence,interjected,leaflet,length,life,lobing,mentioned,midpoint,new,number,peduncle,per,plant,prickle,primary,pseudostipule,ray,seed,shape,size,texture,thicknes,type,variation,width
306	wfo-0001029364	success	153	151	100	53	51	0.654	-2,-6,.5,0.2-0.5,1,1-,1-3,1-5,1.5-2,10-27,2,2-,2-6,3-4,4-12,4-9,5-,5-11,5-9,6-8,7-9,8-15,?,acuminate,anther,apart,apex,around,articulated,base,blue,calyx,center,chartaceous,cm,color,connivent,corolla,cream,cuneate,cylindrical,deep,diameter,distally,elliptic,entire,extra-axillary,fide,filament,finger,flower,free,fruit,glabrous,gland-tipped,globose,green,greenish,hair,herb,immature,inserted,lobe,margin,minutely,mm,narrowly,nearly,obtuse,ovate,part,pedicel,peduncle,petiole,puberulent,radiu,ripe,rusby,sagittate,shallow,shorter,shrub,side,simple,spaced,sparsely,spot,stigma,strongly,style,tapered,tightly,triangular,tube,unbranched,unknown,vein,white,wide,x	-3,1-4,191.,2-foliat,8-10,abaxially,according,acute,adaxially,aggregate,axe,ba,bitter,blade,cell,curled,darker,directed,distall,eaf,ed,glandular-puberulen,long,lower,major,membranaceous,mesocarp,moderately,nflorescence,orolla,perfect,pore,presence,present,puberulen,pubescent,rachi,ruit,short-tomentose,small,stellate,stone,tal,tamen,tem,thecae,time,tomento,truncat,unit,vary,yellow,ympodial	appearance,arrangement,bark,border,branch,bud,characteristic,colour,corrugation,distal,drying,exertion,form,fruiting,giving,glabrousnes,growth,height,history,inflorescence,interjected,lateral,leaf,leaflet,length,life,lobing,midpoint,new,null,number,ovary,per,plant,prickle,primary,pseudostipule,ray,seed,shape,size,stem,surface,tall,terminal,texture,thicknes,truncate,type,variation,width
307	wfo-0001029368	success	139	159	114	25	45	0.82	.2,.25,.5,0,0.5-2,0.9-1,1.5-1.6,1.5-2,1.5-3,1.5-4,11-13,16-25,2-5,2.5-4,5-6,?,abaxially,acuminate,acute,adaxially,along,anther,anthesi,apex,bark,base,bearing,berry,bitter,borne,broadly,calyx,capitate,closely,cm,coarse,conical,corolla,crumpled,densely,dia,distal,elliptic,erect,exserted,few-branched,fide,filament,flower,free,fruit,fruiting,glabrous,globose,golden,green,half,herb,inflorescence,internodal,known,lanceolate,lateral,leaf,like,lobe,long,main,margin,midrib,minute,minutely,mm,non-flower,obtuse,older,one,opposite,ovary,pair,papillose,parallel,pedicel,petiole,pore,poricidal,portion,puberulent,reflexed,rest,scar,shaped,shrub,simple,somewhat,spaced,stem,stigma,straight,strongly,style,tall,tear-drop,tip,trichome,tube,uniseriate,upper,vein,white,winged,woody,x,young	apparently,breaking,brow,cup,deflexed,eaf,edicel,eed,flattened,indistinct,inflorescenc,lamina,leaving,lower,margi,middle,nflorescence,overlappin,papillo,ruit,ud,unifoliat,unit,widest,ympodial	appearance,arrangement,border,branch,brown,bud,characteristic,colour,corrugation,diameter,drying,exertion,form,giving,glabrousnes,growth,height,history,interjected,leaflet,length,life,lobing,mentioned,midpoint,new,number,overlapping,peduncle,per,plant,prickle,primary,pseudostipule,ray,seed,shape,size,surface,terminal,texture,thicknes,type,variation,width
308	wfo-0001029370	success	224	186	146	78	40	0.652	-20,.1,.5,/4,0-10,0-3,0-35,0.2,0.3,0.5-2.2,1-2,1-3,1-4,1.5-6,1.8-2.5,1/4-1/3,10-17,10-40,10-50,12-17,3-4,4-7,4-9,5-10,5-12,5-merous,7-11,7-13,8-14,8-23,abaxial,abaxially,adaxial,almost,ame,andromonoecious,anther,apart,apex,apically,articulated,bark,basal,base,blade,broad-deltate,c.,calyx,chartaceous,clearly,cm,conical,cordate,curved,densely,diameter,discolorous,distal,distance,drying,erect,extending,fewer,filament,flattened,flower,fruit,fruiting,fully,glabrescent,greenish,herb,hermaphrodite,heterostylous,lateral,leaf,length,lobe,lobed,long,long-styled,longer,lowermost,margin,mauve,midpoint,midvein,mixture,mm,moderately,multangulate,obtuse,older,opening,orange,ovate,overlapping,pair,pale,pedicel,peduncle,per,perpendicular,petiole,plant,porrect,prickle,prickly,primary,ray,red-brown,rotate,rounded,scar,short-styled,shrub,side,simple,slightly,sometimes,spaced,spreading,stalk,stalked,stellate-pubescent,stem,straight,strongly,style,surface,terete,tertiary,time,trichome,tube,unarmed,unit,variously,vein,venation,visible,way,white,whitish,wide,young	-32,.3,0-100,0.1,0.1-0.15,0.5-1,1,1.8-2.8,1/3-1/2,15-30,2-10,2-20,2-3,2-6,2.5-3.5,3.5-4,3.5-8,3/,4-6,5.5-7,6-15,8-20,acut,alyx,apar,apparently,berry,branched,connivent,cream,dark,eaf,eed,elongate,elongating,equal,fine,flattened-reniform,free,gently,glabrous,green,infructescence,lower,marking,mature,maturity,nflorescence,often,one,open,orange-brown,ornate,orolla,oung,pattern,pendulous,pericarp,plurifoliat,poricidal,portion,prickl,reticulate,ruit,sessile,shiny,smooth,spherical,staminat,stout,tamen,tapering,tip,vary,white-gra,woody,yellow,ympodial	acute,appearance,arrangement,border,branch,bud,characteristic,colour,corolla,corrugation,exertion,form,giving,glabrousnes,growth,height,history,inflorescence,interjected,leaflet,life,lobing,new,number,ovary,plurifoliate,pseudostipule,seed,shape,size,staminate,stigma,sympodial,terminal,texture,thicknes,type,variation,white-gray,width
309	wfo-0001029373	success	199	182	133	66	49	0.668	.0â1.2,.3,.5,0.4â1.6,0.5â1.2,0.6â0.7,1.0â1.6,1.2â1.5,1.4â3.5,1.5â2.5,1.5â2.7,2-celled,20â30,2â4-celled,3â5,4â6,5,6.8,abaxial,acuminate,acute,adaxial,anther,anthesi,apex,appressed,arising,articulated,bark,basal,base,bayonet,berry,broadly,bud,calyx,capped,cell,clavate,cm,conical,corolla,curved,deltate,densely,developing,diameter,distal,ellipsoid,elongate,enclosing,entire,exerted,filament,finger,flattened-reniform,flower,free,fruit,fruiting,glabrous,glandular-tipped,globose,green,grey-brown,growth,hair,half,halfway,herb,individual,internodal,lateral,leaf,less,like,lobe,lobed,long,margin,minute,minutely,mm,moderately,mouth,new,node,obtuse,older,ovary,ovate-lanceolate,pair,papillate,pedicel,peduncle,per,petiole,pitted,plant,plurifoliate,portion,primary,pubescent,root,rounded,scar,shape,short,simple,slightly,spaced,spreading,stem,stigma,still,straight,style,surface,tall,terete,thicker-walled,tip,trailing,trichome,tube,uniseriate,unit,upper,vein,white,wide,woody,yellowish	.2,.5â2.0,0.3â0.5,0.5â1.8,1.0â1.2,1.3â2.2,1.5â2.0,1.8â2.0,1.8â2.3,180Â°,2.0â2.5,2.7â3.0,3,3.5â4.0,30â40,4â5,5-merous,5â6,8â9,abaxially,accrescent,adaxially,age,apar,appearanc,beyond,cone,eaf,eed,enclosed,fully,geminat,hilum,immature,laterally,lengthening,live,lon,lower,mature,mesocarp,middle,nflorescence,outline,pentagonal,perfect,pore,poricidal,positioned,reflexed,resembling,ruit,seen,seudostipule,shallowly,slit,smoot,stellate,tem,testal,tub,ud,yellow,yellow-green,ympodial,â5	-5,0.3-1.8,1.0-1.2,1.2-1.5,1.8-2.3,2.7-3.0,3.5-4.0,30-40,4-5,5-6,8-9,apart,appearance,arrangement,border,branch,characteristic,colour,corrugation,drying,exertion,form,geminate,giving,glabrousnes,height,history,inflorescence,interjected,leaflet,length,life,lobing,midpoint,null,number,prickle,pseudostipule,ray,seed,size,smooth,sympodial,terminal,texture,thicknes,type,variation,width
310	wfo-0001029402	success	113	134	78	35	56	0.69	0.5-1,0.5-2,1-2.5,15-30,2,2-10,2-3,3-4,3-5,4-6,4-8,5-25,6-16,7-11,7-8,7-9,8-15,abaxially,acute,adaxially,apart,apex,articulated,axe,base,blade,branched,calyx,ciliolate,cm,connivent,cylindrical,diameter,elliptic,fleshy,flower,forked,free,glabrou,glabrous,hair,inrolled,lanceolate,leaving,lobe,long,margin,mm,moderately,narrowly,nearly,often,pedicel,peduncle,petiole,pubescent,rachi,radiu,scar,shrub,simple,somewhat,spaced,sparsely,stigma,style,surface,tapered,thickened,time,triangular,tube,unit,unknown,violet,wide,x,ympodial	11-17,3-6,4-7,abaxial,acuminate,band,chartaceous,color,deltate,denser,directed,distall,eaf,eed,glabrate,lower,many-foliat,narrowed,nflorescence,nther,orolla,papillose,pore,pubescence,rachise,roughened,ruit,scale-like,stellate,tal,tem,tip,truncat,unknow,vary	anther,appearance,arrangement,bark,border,branch,bud,characteristic,colour,corolla,corrugation,distal,drying,exertion,filament,form,fruit,fruiting,giving,glabrousnes,growth,height,history,inflorescence,interjected,lateral,leaf,leaflet,length,life,lobing,many-foliate,midpoint,new,number,ovary,per,plant,prickle,primary,provided,pseudostipule,ray,seed,shape,size,stem,tall,terminal,texture,thicknes,truncate,type,variation,vein,width
311	wfo-0001029404	exception_thrown	154	0	0	154	0	0.0		-1.5,-10,-3,-5,0-60-flower,0.5-1,1,1-4,1.5-2,15-25,2,2-3,2-4,2-5,2-8,2.5-22,2.5-3,20-35,3-4,3-5,3-8.5,4-foliat,5-10,5-20,5-24,5-6,6-8,6-9,6.5-34,8-12,abaxially,absent,acuminate,acute,adaxially,aggregate,anther,apart,ape,apex,apiculate,articulated,auriculate,axe,basal,base,beyond,blade,branched,calyx,cell,center,chartaceous,cm,connective,connivent,cordate,cream,cylindrical,dark,darker,deltate,densely,diameter,directed,distally,eaf,eed,eglandular,ellipsoidal,entire,exserted,flattened,fleshy,flower,fruit,glabrous,glandular,glandular-puberulen,green,hair,lanceolate,leaving,lemon,less,light,lobe,lon,long,longitudinal,lower,margin,mm,moderately,mottling,narrowly,nflorescence,nther,obtuse,orang,orange,orolla,ovate,ovoid,pedicel,pedicellar,peduncle,perfect,petiole,pink,pore,presen,puberulent,pubescent,purple,rachi,radiu,remnant,ripe,ruit,shorter,shrub,simple,slightly,small,somewhat,spaced,sparsely,star,stellate,stigma,stone,style,subcoriaceous,tal,tem,thecae,time,tomento,toward,tree,triangular,truncat,tube,ud,unbranched,unit,vary,vein,white,wide,x,yellow,ympodial	
312	wfo-0001029406	success	136	158	112	24	46	0.824	.5,0.3-1,0.5-1,0.6-1,0.7-1.5,1-1.5,1-10,1-2,1.5-2.2,1.5-2.5,1.5-5,2,2-11,2-3,2.5-3.5,28,3-9,30,4-18,4-6,abaxially,acute,adaxially,along,anther,apex,arachnoid,arachnoid-pubescent,bark,base,berry,broadly,brown,brownish,calyx,clavate,cm,conical,corolla,dark,deciduous,deltate,densely,dia,difoliate,dry,elliptic,felt-like,filament,free,fruiting,glabrous,globose,grayish-brown,grayish-green,green,greenish-white,impressed,large,lateral,leaf,lenticel,lilac,lobe,lobed,long,major,margin,matted,maturity,minor,minutely,mm,nearly,often,older,ovary,ovoid,ovoid-reniform,pale,papillose,pedicel,petiole,pitted,pointed,population,pore,poricidal,portion,pubescent,shaped,shrub,size,slightly,small,soon,stem,stigma,style,surface,tall,tear-drop,tinge,tip,tree,trichome,tube,unit,vein,white,wide,young	7-12,anthesi,ba,bullate,conspicuously,deflexed,differing,eaf,eed,geminat,lon,lower,main,middle,occasionally,pair,papillo,planar,ruit,shiny,waxy,widest,woody,ympodial	appearance,arrangement,border,branch,bud,characteristic,colour,corrugation,diameter,distal,drying,exertion,form,fruit,geminate,giving,glabrousnes,growth,height,history,inflorescence,interjected,leaflet,length,life,lobing,midpoint,new,null,number,peduncle,per,plant,prickle,primary,pseudostipule,ray,seed,shape,sympodial,terminal,texture,thicknes,type,variation,width
313	wfo-0001029407	exception_thrown	208	0	0	208	0	0.0		-10,-2,-25,-4,-6,-7,.5,/3,0,0-15,0-2,0-4,0-5,0.1-0.2,0.1-0.25,0.15-0.4,0.2-0.3,0.4-0.7,0.4-1,0.5-0.7,0.5-1.5,0.5-2,0.6,0.6-0.9,0.7-1.2,1,1-1.4,1-2,1-3,1-4,1-4.5,1.5,1.8-2.5,1/3,1/3-1/2,1/5,1/8-1/5,2-3,2-4,2-5,2.5-3,3-4,3-6,3.5-4.5,4-15,4-9,4.5-6,5-7,5-merous,6-13,6-20,7-8,abaxial,abaxially,acut,acute,adaxial,almost,alyx,anther,apar,apart,apex,apically,apparently,articulated,bark,base,berry,blade,bright-red,brow,calyx,chartaceous,cm,connivent,cuneate,curved,dark,deltate,densely,diameter,difoliate,discolorous,drying,dull,eaf,eed,elliptic,elongating,entire,equal,erect,evenly,filament,flattened,flattened-reniform,flower,free,fruit,fruiting,geminat,geminate,glabrescent,glabrous,gray-greenish,green,green-brown,infructescence,lateral,leaf,lengt,length,lobe,lobed,long,longer,lower,margin,mature,maturity,mauve,midpoint,mm,moderately,nflorescence,obtuse,occasionally,older,one,open,orange,orange-brown,orolla,oung,ovate,pair,pale,pedicel,peduncle,pendulous,per,perfec,pericarp,petiole,poricidal,porrect,portion,prickl,prickle,prickly,primary,pubescent,rarely,ray,recurved,reflexed,rounded,ruit,scar,sessile,shorter,shrub,side,simple,slender,smooth,sometimes,spaced,sparsely,spherical,spreading,stalk,stalked,stellate,stellate-pubescent,stem,stout,straight,straw-yellow,strongly,style,surface,tamen,tapering,terete,tertiary,thick,time,tip,trichome,tube,unbranched,unit,upper,vary,vein,venation,visible,way,weakly,white,wide,woody,yellow,yellow-green,ympodial,young	
314	wfo-0001029408	success	244	238	197	47	41	0.807	-10.5,-4.5,.2-3.5,/10,0,0-100,0.2-0.3,0.3-5,0.9-1.3,0.9-1.6,1-8,1.1-1.5,1.4-1.9,1.5-3,1.6-2.8,1.7-2.4,1.8-3.5,1/2,1/2-3/4,1/4,11-31,2-12,2-3.5,2-4,2-5,2.2-3.7,2/3,3-5,3.5-5,4-14,4-20,4-7.5,5-24,5-6,5-6.5,5-8,7-12,abaxially,accrescent,acute,adaxially,anther,anthesi,apart,apex,articulated,axe,axillary,barely,bark,base,becoming,berry,blade,blunt-tipped,branch,branched,broadly,brown,bud,calyx,clavate,cm,conical,continued,corolla,cuneate,dark,decurrent,deltoid,dendritic-echinoi,dendritic-multangulate,densely,develope,diameter,distal,due,echinoid,elliptic,entire,exserted,faintly,few-rayed,filament,fleshy,flower,fruit,fruiting,glabrous,globose,gray,green,growth,hair,high,honeycombed,indument,interpetalar,lacking,lanate,lanceolate,lateral,leaf,length,lilac,lobe,lobed,long,long-,long-attenuate,long-stalked,m.,main,margin,midvein,mixed,mm,moderately,mostly,multangulate,nearly,oblong,obtuse,often,older,orbicular,ovate,ovate-lanceolate,overlapping,pale,part,partly,pedicel,peduncle,perfect,persistent,petiole,plurifoliate,porrect-stellate,present,pseudo-terminal,pubescent,purplish,rarely,rather,ray,relatively,reniform,reticulate-punctate,ribbed,ripe,sessile,short-,short-attenuate,short-stalked,shrub,side,simple,slightly,small,sometimes,spaced,stamen,stelliform,stem,stigma,style,subcampanulate,suborbicular,subovate,terete,thick,thick-stalked,thick-textured,thin-stalked,time,tissue,tomentose,top,touching,tree,tube,turbinate,unarmed,unit,usually,vein,velutinous,way,well,white,whitish,wide,x,yellow,yellowish,young	-1.5,0.5-2.5,0.7-1.2,2.5-7,5-merou,acuminate,adaxiall,ag,alyx,apical-lateral,ba,capitat,chartaceous,dehiscing,directed,distall,eaf,echinoi,eed,extend,free,homostylous,inserted,introrse,large,longitudinal,lower,many,near,nflorescence,obscured,orolla,pore,rachi,rotate-stellate,ruit,runk,slit,suture,tamen,testa,tomentu,tomentum,toward,unarme,vary,ympodial	appearance,arrangement,border,capitate,characteristic,colour,corrugation,drying,exertion,form,giving,glabrousnes,height,history,inflorescence,interjected,leaflet,life,lobing,mentioned,midpoint,new,number,ovary,per,plant,prickle,primary,pseudostipule,seed,shape,size,surface,sympodial,terminal,texture,thicknes,trunk,type,variation,width
315	wfo-0001029417	success	213	183	142	71	41	0.667	.5,0-7,0.2-0.6,0.4-8,0.7-3,1,1-10,1-2,1-8,1.3-8,1.5-1.8,1.5-10,1.5-8,12,2-4,2.5-10,2.8-3.5,3-14,3-5,4-7,5-15,6-11,8-15,8-9,abaxially,acumen,acuminate,acute,adaxially,anther,apart,apex,apiculate,apparently,attenuate,axe,axillary,base,basiscopic,berry,blade,blue,broadly,brownish,bud,cell,central,clavate,cm,coarsely,condition,connivent,corolla,covering,dark,decurrent,deep,diameter,distal,dot,drying,erect,filament,flower,forked,fresh,fruit,generally,glabrous,globose,green,greenish,hair,hair-like,half,herb,interjected,lanceolate,lateral,leaflet,like,linear,lobe,long,make,margin,medium,minute,mm,moderately,mucilaginous,narrowly,non-glandular,odd-pinnate,often,orbicular,ovate,ovoid,pedicel,peduncle,perfect,petiole,petiolulate,pilose,plant,pubescent,purple,rarely,ripe,rounded,scattered,seed,sessile,short,short-petiolulate,side,size,slightly,sometimes,star,stem,stigma,style,subtending,terminal,testal,thick,tinged,trichome,tube,typically,unwinged,usually,violet,wall,wet,white,whitish,wide,widely,wing,x	1-1.5,1-4,5-merou,ag,along,alyx,articulated,borne,capitat,chartaceous,ciliate,decreasing,digestion,dorsally,eaf,edge,eed,end,enzyme,erec,especially,exceeding,flat,folded,geminat,glabrou,greatly,green-white,hal,homostylous,honeycomb-shaped,lengthening,living,lower,lunate,membranous,midrib,minutely,nflorescence,orolla,pair,pentagonal,plurifoliate,pore,poricidal,puberulent,rapidly,removed,rotate,ruit,seudostipule,singly,slit,spaced,specimen,stamen,ste,stolo,straight,subequal,tall,tamen,tem,throughout,tip,tri-,tuber,unit,vary,yellow,ympodial	appearance,arrangement,bark,border,branch,calyx,capitate,characteristic,colour,corrugation,exertion,form,fruiting,giving,glabrousnes,growth,height,history,inflorescence,leaf,length,life,lobing,mentioned,midpoint,new,number,ovary,per,prickle,primary,pseudostipule,ray,shape,surface,texture,thicknes,type,variation,vein,width
316	wfo-0001029461	success	217	237	193	24	44	0.889	-1.5,-14,-2,-3,-3.2,-3/4,-4,-4.5,-5,.5,0,0.1,0.1-0.25,0.15-0.25,0.6-1,0.7-1,0.8,0.8-1.5,1-,1-1.6,1-2,1-3,1-4,1-6,1.2-1.7,1.2-1.8,1.3-2.2,1.5-,1.5-2,1/3,1/3-2/3,1/4,1/4-1/2,2-2.4,2-2.8,2-3,2-4,3-20,3-6,4-10,4-6.5,4-7,4.5-7,4.7-7.2,5-10,5-25,5-merous,7-10,7-12,8-9,abaxially,almost,ame,andromonoecious,anther,apart,apex,apically,attenuate,bark,base,becoming,berry,black,blade,breaking,brittle,broad-deltate,brown,c.,calyx,cell,chartaceous,cm,concolorous,cuneate,curved,dark,densely,diameter,discolorous,distal,distance,drying,dull,elliptic,elongating,erect,evenly,extending,fifth,filament,fine,flattened,flattened-reniform,flower,four,free,fruit,fruiting,glabrescent,glabrous,green,hermaphrodite,heterostylous,infructescence,leaf,length,lobe,lobed,long,long-styled,longer,lowermost,margin,mature,maturity,mauve,midpoint,midvein,mm,moderately,oblong,obovate,obtuse,older,orange,outline,ovate,pair,pedicel,pendulous,per,pericarp,petiole,pit,plant,poricidal,porrect,portion,prickle,prickly,primary,raised,ray,reddish,reduced,reflexed,rounded,sessile,shallow,shiny,short-styled,shorter,shrub,side,simple,slender,slightly,small,smooth,sometimes,spaced,sparsely,spherical,spreading,stalk,stalked,staman,stellate-pubescent,stem,straight,strongly,style,subentire,surface,terete,time,tip,trichome,tube,unarmed,unequal,unit,upper,variously,vein,way,weakly,wide,woody,yellow,young	2.5-3,acuminat,alyx,eaf,eed,faint,gra,lengt,lower,orolla,oung,plurifoliat,prickl,ruit,staminat,stellate,tamen,tertiary,unarme,vary,venation,visible,ympodial,zygomorphic	.5-3,acuminate,appearance,arrangement,border,branch,bud,characteristic,colour,corolla,corrugation,exertion,form,giving,glabrousnes,gray,growth,height,history,inflorescence,interjected,lateral,leaflet,life,lobing,new,null,number,ovary,peduncle,plurifoliate,pseudostipule,seed,shape,size,staminate,stigma,sympodial,terminal,texture,thicknes,type,variation,width
317	wfo-0001029462	success	166	189	134	32	55	0.807	-2,-30,-4,0.5-1,0.5-2,1,1-,1-2,1-3,1-6,1.5,1.5-2,1.5-3,1.5-7,10-,15-25,2-3,2-6.5,2.5-3.5,2.5-5.5,20-35,3-18,3-4,3-5,3-6,3-7,4-15,4-20,5-30,6-9,7-19,7-8,8-9,abaxially,abruptly,absent,acuminate,acute,adaxially,apart,apex,articulated,axe,basal,base,beyond,blade,broad,calyx,chartaceous,ciliate,cm,connective,connivent,constricted,cuneate,curled,cylindrical,dark,densely,dentate,diameter,directed,eglandular,ellipsoidal,elliptic,entire,equal,exceeding,exserted,flattened,flower,fruit,glabrous,green,hair,lanceolate,laterally,leaving,light,lobe,long,longitudinal,margin,membranaceous,minutely,mm,moderately,narrowly,near,obtuse,occasionally,often,ovate,ovoid,pedicel,pedicellar,peduncle,perfect,petiole,pore,puberulent,pubescent,pubescent-pilose,purplish,radiu,remnant,reticulate,rounded,shorter,simple,slightly,small,somewhat,spaced,sparsely,stamen,stigma,stripe,style,thecae,time,tip,tomentose,tree,triangular,truncate,tube,unbranched,white,wide,without,x,yellow	-5,10-22,3,3-27,4-foliat,aggregate,ape,campanulate,cell,eaf,eed,lon,lower,m.,nflorescence,nther,orolla,oval,pubescent-pilo,purpl,rachi,ruit,smooth,stellate-,stone,tal,tem,truncat,ud,unit,vary,ympodial	anther,appearance,arrangement,bark,border,branch,bud,characteristic,colour,corolla,corrugation,distal,drying,exertion,filament,form,fruiting,giving,glabrousnes,growth,height,history,inflorescence,interjected,lateral,leaf,leaflet,length,life,lobing,midpoint,new,null,number,ovary,per,plant,prickle,primary,pseudostipule,purple,ray,seed,shape,size,stem,surface,tall,terminal,texture,thicknes,type,variation,vein,width
318	wfo-0001029464	success	235	221	183	52	38	0.779	-3,-30,-5,.9,0,0-80,0.2,0.2-0.5,0.3-0.7,0.5,0.5-2,0.8-2,00-200,1,1-10,1-3,1-8,1.2-3,1.5-2,1/4,1/4-1/2,1/4-1/3,10-23,10-40,10-50,12-50,2,2-3,2-3.5,2-4,2.2-2.5,2.4-4,2.5-5,2.5-8,2.9-3.2,3-20,3-7,3.5-5,4-7,5-17,5.5-6,5.5-7.5,6-15,7-10,8-15,9-15,abaxial,acicular,acute,adaxial,ame,annual,anther,apart,apex,apically,apparently,around,articulated,bark,base,berry,black,branched,broad,brown,c.,calyx,cm,cordate,cultivar,cup-shaped,curved,dark,deltate,diameter,difoliate,distal,distance,drying,ellipsoid,elongated,erect,extending,filament,flattened-reniform,flower,fruit,fruiting,glabrescent,glabrous,glaucous,globular,green,green-brown,hair,herb,infructescence,lateral,leaf,length,less,lobe,lobed,long,long-styled,longer,lower,margin,maroon,mature,maturity,mauve,midpoint,midvein,minute,mm,moderately,mottled,narrow-deltate,oblong,obtuse,occasionally,often,older,one,open,orange-brown,ovate,ovoid,pair,pedicel,peduncle,pendent,pendulous,per,petiole,pink,plant,poricidal,porrect,prickle,prickly,primary,purple,ray,red-brown,rounded,sessile,short-styled,side,simple,sometimes,spaced,stalk,stalked,stellate-pubescent,stem,straight,striped,style,surface,tapering,terete,terminal,time,tip,translucent,trichome,tube,unarmed,upper,usually,variously,vein,visible,way,white,wide,woody,yellow-green,yellow-orange,young	-2/3,0-2,0.2-0.7,0.3-1,1/,10-15,3-5,4-8,4-8-merous,5-8,8-13,abaxially,alyx,andromonoecious,apar,blade,broad-deltate,brow,chartaceous,connivent,discolorous,eaf,eed,elongating,equal,free,fully,geminat,hermaphrodite,heterostylous,long-acuminat,lowermost,nflorescence,opening,orolla,oung,pericarp,portion,prickl,ruit,scar,smooth,sparsely,spreading,staminat,stellate,tamen,tertiary,unit,vary,venation,ympodial	1/2,appearance,arrangement,border,branch,bud,characteristic,colour,corolla,corrugation,exertion,form,geminate,giving,glabrousnes,growth,height,history,inflorescence,interjected,leaflet,life,lobing,long-acuminate,new,null,number,ovary,pseudostipule,seed,shape,size,stigma,texture,thicknes,type,variation,width
319	wfo-0001029546	success	203	182	137	66	45	0.675	0.3-1,1-2,1-3.2,1-4.5,1-5,1.5-2,1.5-6.2,1.6-6.5,2-9,2.2-2.8,3.5-5,4-10,4.5-12.5,4.5-7,5,5-10,5-18,5-8,6.3-19.5,7-10,8,8-17,8-19.5,abaxially,absent,acumen,acuminate,acute,adaxially,anther,apex,apiculate,apparently,attenuate,axe,axillary,base,berry,blade,blue,broadly,brownish,bud,cell,clavate,cm,condition,cordate,corolla,covered,covering,curved,decurrent,densely,diameter,distal,dot,drying,elliptic,elliptical,erect,filament,flower,forked,frequently,fresh,fruit,generally,glabrous,glandular,globose,green,greenish,hair,half,herb,interjected,lanceolate,lateral,leaf,leaflet,like,lobe,long,longer,make,mm,mucilaginous,nearly,non-glandular,oblique,odd-pinnate,often,orbicular,ovate,ovoid,pedicel,peduncle,perfect,petiole,petiolule,plant,pubescent,purple,rarely,regular,ripe,seed,sessile,short,simple,size,slightly,soft,sometimes,stem,stigma,straight,style,subtending,tall,terminal,testal,thick,tinged,trichome,tube,typically,unwinged,usually,wall,wet,white,whitish,wide,wing,x	0-2,1-10,2-4,3-8,5-merou,adaxiall,ag,alyx,apart,articulated,capitat,chartaceous,connivent,decreasing,decumben,digestion,dorsally,eaf,edge,eed,enzyme,exceeding,flat,folded,geminat,glabrou,greatly,green-white,hair-like,homostylous,honeycomb-shaped,lengthening,living,lower,lunate,membranous,middl,minutely,mottle,nflorescence,pair,pentagonal,plurifoliate,pore,poricidal,rachi,removed,rotate-pentagonal,ruit,seudostipule,slit,spaced,specimen,stamen,ste,subequal,tamen,tem,throughout,tip,tri-,truncate,unit,vary,yellow,ympodial	'hair-like,appearance,arrangement,bark,border,branch,calyx,capitate,characteristic,colour,corrugation,decumbent,exertion,form,fruiting,giving,glabrousnes,growth,height,history,inflorescence,length,life,lobing,margin,midpoint,mottled,new,null,number,ovary,per,present,prickle,primary,pseudostipule,ray,shape,surface,texture,thicknes,type,variation,vein,width
320	wfo-0001029552	success	161	165	127	34	38	0.789	.25,.5,0.1-0.5,0.6-1,1-1.3,1-1.5,1-2,1-3,1-5,10-20,12,2-2.5,2.5-3,5-10-flowered,5.5-8,6-9,abaxially,abruptly,acuminate,acute,adaxially,along,anther,anthesi,apex,area,bark,base,berry,branched,broadened,broadly,calyx,clavate,cm,conical,contracted,corolla,decurrent,deflexed,deltate,dendritic,densely,dia,drying,elliptic,erect,exserted,filament,flattened-reniform,flower,free,fruiting,glabrous,globose,green,heteromorphic,incrassate,inflorescence,later,lateral,leaf,like,lobe,lobed,long,long-styled,main,major,margin,middle,minute,minutely,mm,nearly,occasionally,older,onto,opposite,ovary,pair,pale,paler,pedicel,persistent,petiole,pitted,planar,pore,poricidal,portion,present,pubescent,reflexed,shape,shaped,shining,short-styled,shrub,simple,size,slender,slightly,small,somewhat,sparsely,stem,stigma,strongly,style,surface,swollen,tall,tan,tear-drop,tip,tree,tree-like,trichome,tube,vein,white,wide,widest,x,yellowish,young	0.5,1.5-2,1.5-6.5,2-9,abaxial,closely,denser,differing,difoliate,eaf,edicel,eed,geminat,greyish-brow,inflorescenc,lamina,lon,lower,minor,nflorescence,orbicular,overlappin,papillo,rest,rounded,ruit,scar,scattered,spaced,tub,ud,unit,woody,ympodial	appearance,arrangement,border,bud,characteristic,colour,corrugation,diameter,distal,exertion,form,fruit,giving,greyish-brown,growth,history,interjected,leaflet,length,life,lobing,midpoint,null,number,papillose,peduncle,per,prickle,primary,pseudostipule,ray,seed,terminal,texture,thicknes,type,variation,width
321	wfo-0001029584	success	180	177	132	48	45	0.733	0-30,1,1-2,1-6,1.5-6.5,16.2-33,2-3,2-4,2.4-6.3,3-10,3-7,4-14,4-15,4-5,4.5-11.5,5.3-13.3,6-7,6.1-9.4,7-14,8-15,9.7-23.4,9.8-17,abaxially,acumen,acuminate,acute,adaxially,anther,apex,apparently,asymmetric,attenuate,axe,axillary,base,basiscopic,borne,brownish,bud,cell,clavate,cm,condition,coriaceous,corolla,covering,dark,dense,densely,diameter,digestion,distal,drying,elliptic,end,enzyme,filament,finer,flower,forked,fresh,fruit,geminat,generally,glabrescent,green,green-white,greenish,hair,half,herb,honeycomb-shaped,interjected,larger,lateral,leaf,leaflet,light,linear,lobe,long,make,margin,mm,mucilaginous,oblong-lanceolate,odd-pinnate,orbicular,ovate,ovoid,pair,pedicel,peduncle,perfect,petiole,petiolulate,plant,plurifoliate,present,pubescent,purple,removed,seed,sessile,short,side,simple,singly,size,stigma,stolo,style,subtending,tall,terminal,testal,thick,throughout,tissue,tri-,tube,tuber,typically,unit,unwinged,usually,wall,wet,white,whitish,x,ympodial	1-3,3-5,5-merou,ag,alyx,apart,articulated,blade,capitat,connivent,considerably,decreasing,dorsally,eaf,edge,eed,erry,flat,folded,glabrous,hair-like,hal,homostylous,lengthening,living,lower,middle,nflorescence,orolla,pentagonal,pore,poricidal,proximal,second,semi-erec,seudostipule,slit,spaced,specimen,straight,substellate,tamen,tem,tip,toward,unknow,vary,yellow	'hair-like,appearance,arrangement,bark,berry,border,branch,calyx,capitate,characteristic,colour,corrugation,exertion,form,fruiting,giving,glabrousnes,growth,height,history,inflorescence,length,life,lobing,midpoint,new,null,number,ovary,per,prickle,primary,pseudostipule,ray,semi-erect,shape,stem,surface,texture,thicknes,type,unknown,variation,vein,width
322	wfo-0001029593	success	181	193	148	33	45	0.818	-10,0.05,0.5-1,0.5-5,0.8-1,0.8-1.2,1,1-1.2,1-1.5,1-2,1-8,1.6-2.3,10-50,100,2,2-14,2-5,2.3,2.3-3.0,3-4,3.5-8,35-60,4-6,5-10,5-15,7-25,7.5-15,9-15,abaxially,abruptly,acuminate,acute,adaxially,age,always,anther,anthesi,anticlinal,apex,apically,arising,attenuate,axil,axillary,base,basiscopically,bearing,berry,broadly,brown,calyx,capitate,cell,cm,colony,conical,deltate,densely,diameter,dry,drying,elliptic,enlarged,epidermal,exserted,extremely,filament,filiform,flower,fruit,fruiting,glabrescent,glabrous,globose,green,growing,half,hollow,irregular,lamina,large,lateral,leaf,leaflet,lobe,long,lower,markedly,minutely,mm,narrowing,oblique,obovate,occasionally,often,once-branched,open,opposite,ovary,ovoid-reniform,pair,papillose,pedicel,per,perfectly,petiole,pinnate,place,plant,pointed,poricidal,primary,projection,pubescence,pubescent,purple,rarely,rest,scar,seed,shape,shrub,simple,single-stemmed,sinuous,slightly,small,somewhat,sparsely,stigma,style,surface,tall,terminal,thickening,tip,trichome,tube,uniseriate,unit,usually,variable,vein,white,white-lenticellate,without,woody,x	2-3,basal,cateniform,clavat,cone,decurrent,eaf,edicel,eed,entire,free,included,much,nflorescence,noddin,onto,petiolule,portion,pubescen,rachi,reflecting,ruit,short-styled,similar,smaller,smooth,tem,tub,ud,unifoliat,wider,winged,ympodial	8,appearance,arrangement,bark,border,branch,bud,cateniforme,characteristic,clavate,colour,corolla,corrugation,distal,exertion,form,giving,glabrousnes,growth,height,history,inflorescence,interjected,length,life,lobing,margin,midpoint,new,nodding,null,number,peduncle,prickle,pseudostipule,ray,size,stem,sympodial,texture,thicknes,type,unifoliate,variation,width
323	wfo-0001029601	success	187	176	130	57	46	0.695	0-37,0.2-0.8,0.5-5.8,1-2,1-3,1-4,1-53,1.1-2.7,1.2-2.3,1.7-6.5,2,2-12,2-9,2.2-4.5,2.3-5.9,2.8-10.5,3-10,3-5,3-7,4-13.5,5-41,6-10,6.6-22,6.8-14.5,abaxially,acumen,acuminate,acute,adaxially,anther,apex,apparently,asymmetric,attenuate,axe,axillary,base,basiscopic,berry,borne,brownish,bud,cell,clavate,cm,condition,connivent,coriaceous,corolla,covering,dark,diameter,digestion,distal,dot,drying,elliptic,end,enzyme,filament,flower,forked,fresh,fruit,generally,glabrescent,glabrous,globose,green,green-white,greenish,hair,half,herb,honeycomb-shaped,interjected,lanceolate,lateral,leaf,leaflet,light,linear,lobe,long,make,mm,mucilaginous,narrow,odd-pinnate,orbicular,ovate,ovoid,pedicel,peduncle,perfect,petiole,petiolulate,plant,plurifoliate,puberulent,removed,ripe,rounded,seed,sessile,short,side,singly,size,small,stigma,style,subtending,terminal,testal,thick,throughout,tissue,tri-,tube,tuber,typically,unwinged,usually,wall,wet,white,whitish,wing,x	0.5-8,2-3,2-7,5-merou,abaxiall,ag,alyx,apart,articulated,blade,capitat,decreasing,dorsally,eaf,edge,eed,erec,exceeding,flat,folded,geminat,glabrou,hair-like,homostylous,larger,lengthening,living,lower,middl,middle,nflorescence,orolla,pair,pentagonal,pore,poricidal,rotate,ruit,seudostipule,slightly,slit,spaced,specimen,stamen,stolo,straight,subequal,subglabrou,tall,tamen,tem,tip,toward,unit,vary,yellow,ympodial	'hair-like,appearance,arrangement,bark,border,branch,calyx,capitate,characteristic,colour,corrugation,erect,exertion,form,fruiting,geminate,giving,glabrousnes,growth,height,history,inflorescence,length,life,lobing,margin,mentioned,midpoint,new,number,ovary,per,prickle,primary,pseudostipule,ray,shape,stem,stolon,surface,texture,thicknes,type,variation,vein,width
324	wfo-0001029621	exception_thrown	165	0	0	165	0	0.0		.1,0.5-0.75,0.5-1,0.5-1.2,0.5-1.5,0.7-1.1,0.8-1,0.8-4.5,1-1.5,1-2,1.5-2,1.5-2.5,1.5-5,1/3,2.5-3,2/3,3-3.5,3.5-4.5,5-20-flowered,6-20,6-8,7-9,accrescent,acute,along,anther,anthesi,apar,apex,appearing,appressed,area,attenuate,bark,base,becoming,beneath,berry,borne,branched,brown,calyx,caudate,cluster,cm,completely,constricted,corolla,course,cup-shaped,dark,decurrent,deltoid,densely,dia,distal,dry,eaf,edicel,eed,ellipsoid,elongate,enclosed,erect,exsertio,filament,fleshy,free,fruit,fruiting,geminate,glabrate,glabrous,globose,green,irregularly,lanceolate,late,later,lateral,leaf,like,live,lobe,lobed,lon,long,lower,main,many,margin,material,merely,middle,minutely,mm,nflorescence,oblanceolate,occasionally,often,older,onto,ovary,ovoid-reniform,pair,pale,papillate,papillo,papillose,pedicel,pitted,planar,plant,plurifoliat,pore,poricidal,portion,prominent,puberulent,quite,rarely,reddish,reddish-gre,ripe,river,ruit,scar,sessile,shaped,shiny,shrub,small,somewhat,spaced,ste,stem,stigma,straight,style,surface,tall,tan,tapering,tear-drop,terminal,thick,time,tip,trichome,tube,ud,uniseriate,unit,vein,way,white,whorl-like,widened,widest,woody,x,yellow,yellowish,ympodial,young	
325	wfo-0001029622	success	182	180	136	46	44	0.747	.1,.2,.5,/3,0.5-0.7,0.5-1,0.6-0.9,0.8-1,1-1.2,1-1.5,1-2.7,1-4,1.5,2-11,2-4,2-5,2.5-3,3-4,3-5,30-35,4-6.5,40,5-6,7-11,abaxially,absent,accrescent,acute,adaxially,anther,anthesi,apex,apparently,appearing,attenuate,axil,bark,base,beneath,blade,brown,bud,calyx,chartaceous,cm,connivent,consisting,corolla,cylindrical,deciduous,diameter,difoliate,dimorphic,elliptic,elongate,entire,filament,flower,free,fruit,fruiting,geminate,glabrous,globose,green,immature,included,inflorescence,internodal,jointed,known,lateral,leaf,lobe,long,long-acuminate,long-triangular,main,major,margin,mature,measured,midrib,minor,mm,narrowly,obconic,oblong,occasionally,often,older,onto,opposite,ovate,pair,pedicel,peduncle,pendent,petiole,portion,present,rachi,raised,reddish,remaining,rounded,sagittate,scar,second,shiny,shrub,simple,single,size,slender,slightly,somewhat,stem,stigma,straight,style,tapering,thus,tip,trichome,tube,tuft,uniseriate,unit,vein,way,white,within,x,yellow,young	0.3,0.5,45-50,ag,alyx,arising,axe,capitat,deflexed,differing,eaf,eed,except,glabrou,ilament,interlaced,lamina,less,lobed,longitudinal,m.,minute,minutely,nflorescence,one,opening,orolla,oung,ovate-lanceolate,papillose,pore,probably,reflexed,ruit,shaped,slende,slit,stellate,tal,tear-drop,thin,ud,unarme,unifoliat,vary,ympodial	appearance,arrangement,border,branch,capitate,characteristic,colour,corrugation,distal,drying,exertion,form,giving,glabrousnes,growth,history,interjected,leaflet,length,life,lobing,midpoint,new,null,number,ovary,per,prickle,primary,pseudostipule,ray,seed,shape,surface,sympodial,tall,terminal,texture,thicknes,type,unarmed,unifoliate,variation,width
326	wfo-0001029625	success	168	172	128	40	44	0.762	-15,..,.1-0.2,.5,0.5-1.3,0.5-2mm,0.8-1.4,0.8-1.8,1-1.5,1-2,1-3,1.2-1.6,2,2.5-.,3,3-,3-3,3-3.5,4-10,4-4,4-5-celled,4-7-celled,4-9,5,5-10,5-6,5-8,6-9,8-13,9-25,along,anther,anthesi,bark,base,beneath,branch,branched,calyx,cell,cm,conical,corolla,cucullate,darker,deltate,densely,denser,diameter,elliptic,filament,flattened,four,fruit,fruiting,glabrescent,glabrous,gland,gland-tipped,globose,green,greenish,growth,herb,hyaline,inflorescence,lamina,later,lighter,like,lobe,lobed,long,margin,markedly,middle,mixed,mm,narrowly,nearly,new,occasionally,outer,outline,ovary,ovate-reniform,pair,pale,papillate,pedicel,peduncle,per,planar,point,pointed,primary,pubescent,purplish,rarely,reddish,regularly,scattered,shrub,single,single-stemmed,sinuate,small,sparsely,stem,stigma,striate,stripe,strongly,style,surface,tan,time,tinged,tip,triangular,trichome,tube,uniseriate,vein,wall,white,x,young	0.5-1,0.5-2,100,abaxial,apical,branc,brittle,brow,capitat,cel,deflexe,deflexed,distinct,dry,eaf,edicel,eed,erect,flower,frui,glandular,lower,midline,minute,nflorescence,open,pericarp,plurifoliat,ruit,scar,slightly,smooth,testa,thin,tuft,ud,unit,weight,without,ympodial	2.5-3,4-4.5,apex,appearance,arrangement,border,brown,bud,capitate,characteristic,colour,corrugation,distal,drying,exertion,form,giving,glabrousnes,height,history,interjected,lateral,leaf,leaflet,length,life,lobing,mentioned,midpoint,number,petiole,plant,prickle,pseudostipule,ray,seed,shape,size,terminal,texture,thicknes,type,variation,width
327	wfo-0001029645	success	160	161	109	51	52	0.681	-1,.5-1,0.2-0.5,0.3-0.5,0.5-7,1,1-1.5,1-2,1.3-7,1.5,1.5-2,2-4,2.5-17,2.5-4,3-15,3-7,3.5-4,337,4-8,5,5-8,6-12,7-12,750,?,abundantly,acuminate,acute,along,anther,apex,base,blue,brown,calyx,chartaceous,cm,corolla,cuneate,cylindrical,decurrent,deltate,diameter,distally,entire,et,except,extra-axillary,fide,filament,finger,flattened,flower,fruit,glabrous,gland-tipped,globose,green,greenish,hair,herb,immature,kayap,line,lobe,long,major,margin,membranaceous,minutely,mm,moderately,nearly,obtuse,ovate,ovate-elliptic,pedicel,peduncle,perfect,petiole,puberulent,purple,radiu,rarely,red,rugose-verrucate,sagittate,sand-punctate,short,short-tomentose,side,smith,sparsely,stigma,strongly,style,subcordate,tapered,time,triangular,truncate,tube,unbranched,unit,vein,white,wide,x,Â±	0.5-2.5,1-4,2-3-foliat,3-10,4-5,abaxially,adaxially,aggregate,apart,around,articulated,axe,ba,blade,cell,connivent,directed,distall,eaf,eed,free,glabrou,inserted,knapp,lower,mesocarp,nflorescence,orolla,part,pore,puberulen,rachi,rotate-stellate,ruit,shorter,shru,simple,small,spaced,stone,tal,tamen,tem,thecae,tightly,tomento,truncat,vary,veiny,yellow,ympodial	2-3-foliate,appearance,arrangement,bark,border,branch,bud,characteristic,colour,corrugation,distal,drying,exertion,form,fruiting,giving,glabrousnes,growth,height,history,inflorescence,interjected,lateral,leaf,leaflet,length,life,lobing,mentioned,midpoint,new,number,ovary,per,plant,prickle,primary,pseudostipule,ray,seed,shape,shrub,size,stem,surface,sympodial,terminal,texture,thicknes,type,variation,width
328	wfo-0001029646	success	141	155	106	35	49	0.752	0.1-0.6,0.5,0.5-0.8,0.7-2.2,1-4,1.5-2,1.5-4.9,10-15,2-3,3-14,4-5.5,5-15,6-8,7-15,abaxially,acumen,acuminate,acute,adaxially,apex,apical,apically,articulate,attenuate,base,branched,calyx,cell,cm,corolla,covering,cyme,dehiscent,diameter,dichasial,dichasially,distal,dorsally,ebracteate,edge,elliptic,equaling,filament,finely,flat,flower,folded,forked,free,generally,globose,green,green-white,hair-like,half,herbaceous,introrse,lateral,leaf,linear,living,lobe,long,make,maturing,mm,monochasial,mucilaginous,mucronate,narrowly,often,ovate,ovoid,pedicel,peduncle,perennial,perfect,petiole,plant,poricidally,proximal,pubescent,seed,short,simple,slit,specimen,stamen,stellate,stigma,straight,style,testal,thick,throughout,tone,tuber-bearing,typically,unit,wall,white,wide,without,yellow,yellow-green,Â¼	3-6-foliat,commonly,digestion,eaf,eed,emoval,enzyme,epiphytic,globo,ground,growing,honeycomb,lon,lower,mos,mould,nflorescence,nther,oak,orolla,ovat,pattern,pine,plan,rarely,reveal,ruit,seudostipule,tall,tem,throughou,tree,vary,viole,ympodial	3-6-foliate,anther,appearance,arrangement,border,bud,characteristic,colour,corrugation,drying,exertion,form,fruit,fruiting,giving,growth,height,history,inflorescence,interjected,leaflet,length,life,lobing,margin,mentioned,midpoint,number,ovary,per,prickle,primary,pseudostipule,ray,shape,size,stem,surface,sympodial,terminal,texture,thicknes,tube,type,variation,vein,violet,wet,width
329	wfo-0001029652	success	160	185	141	19	44	0.881	.25,.3,.5,0.5-1,0.5-4,0.75-1,0.8-1,1,1-2,1-3,1.5-2,2,2-2.5,2-4,2.5-3,25,3.5-4,3/4,4-4.5,6-15,7-9,abaxially,adaxially,along,anther,anthesi,apex,apical,arch,arching,attenuate,bark,base,bearing,berry,broadly,calyx,cm,cone,conical,corolla,curling,deciduous,deflexed,deltate,denser,dia,difoliate,drying,elliptic-ovate,evenly,exserted,filament,filiform,flower,free,fruiting,glabrous,globose,golden,golden-red,green,greenish-white,hard,hispid,included,joining,lamina,lateral,leaf,like,lobe,lobed,long,long-acuminate,long-styled,main,major,margin,maturity,middle,midrib,minor,minute,minutely,mm,narrowly,near,occasionally,older,opposite,ovary,ovoid-reniform,pair,pale,papillose,pedicel,pericarp,petiole,pitted,pore,poricidal,portion,projection,pubescent,reddish-brown,scar,series,shaped,short-styled,shrub,simple,size,slender,slightly,soon,spaced,sparsely,stem,stigma,style,surface,swollen,tall,tan,tear-drop,thickened,time,tip,trichome,tube,undulate,uniseriate,unit,vein,way,white,widest,within,x,young	apar,ape,ba,differing,eaf,edicel,eed,geminat,heteromorphic,lon,lower,nflorescence,papillo,reflexed,ruit,slende,tub,ud,ympodial	apart,appearance,arrangement,border,branch,bud,characteristic,colour,corrugation,diameter,distal,exertion,form,fruit,geminate,giving,glabrousnes,growth,history,inflorescence,interjected,leaflet,length,life,lobing,midpoint,new,null,number,peduncle,per,prickle,primary,pseudostipule,ray,seed,shape,sympodial,terminal,texture,thicknes,type,variation,width
330	wfo-0001029673	success	159	181	139	20	42	0.874	.5,0.5-1,0.7-1.1,0.75-1,0.8-1,1-10,1-2,1-5,1.2-3.5,1.5-1.8,1.5-2,10-20,2-2.5,2-3,2-4,2.5,3-5,3/4,4-6,5-25,5.5-15,abaxial,absent,accrescent,acuminate,acute,adaxial,age,along,anther,anthesi,apex,apical,appearing,bark,basal,base,becoming,berry,black,blade,branch,branching,broadly,calyx,clavate,cm,conical,corolla,decurrent,deep,deltoid,dendritic,densely,denser,diameter,dichasia,eaf,elliptic,ew,exserted,filament,flower,fork,free,fruit,fruiting,glabrous,globose,greyish,greyish-yello,greyish-yellow,growth,individual,lamina,later,lateral,leaf,length,lenticular,like,lobe,long,longer,minutely,mm,monochasial,narrowly,occasionally,older,ovary,overtopping,pair,pedicel,pericarp,petiole,pitted,planar,plurifoliate,pore,poricidal,portion,prominent,pubescent,purple,pyramidal,reddish-brown,reflexed,scar,secondary,shoot,shrub,slightly,slit-like,small,somewhat,sparsely,stem,stigma,strongly,style,surface,tall,tapering,terminal,thin,time,tip,tree,triangular,trichome,tube,unit,vein,violet,wide,winged,x,young	abaxially,adaxially,deflexed,edicel,eed,inserted,lon,lower,m.,nflorescence,nodding,papillo,petal,ruit,sleeve,stamen,tub,ud,woody,ympodial	appearance,arrangement,border,bud,characteristic,colour,corrugation,distal,drying,exertion,form,giving,glabrousnes,height,history,inflorescence,interjected,leaflet,life,lobing,margin,mentioned,midpoint,new,number,papillose,peduncle,per,plant,prickle,primary,pseudostipule,ray,seed,shape,size,sympodial,texture,thicknes,type,variation,width
331	wfo-0001029680	success	212	159	85	127	74	0.401	.0,0.1,1.0,1.5,10,12,5,50,abaxially,acute,adaxially,annual,anther,anthesi,apex,axillary,base,becoming,bipinnate,blade,blue,borne,branched,brown,calyx,clavate,cm,decurrent,diameter,divided,erect,filament,fleshy,flower,fruit,glabrous,globose,green,herb,indistinct,leaf,length,light,lobe,margin,mm,moderately,oblong,obovate,obtuse,ovate,pair,pale,pedicel,peduncle,petiole,pinnae,pinnate,pitted,primary,prostrate,pubescent,purple,rarely,red,ripe,shallowly,shoot,size,sometimes,sparsely,stem,stigma,style,surface,terminal,time,tripinnate,tube,turning,violet,white,winged,woody,x	0.4,0.5â1.5,0.6,0.6â1.2,0.6â2.0,0.9â1.0,1,1.0â1.1,1.0â1.5,1.0â1.8,1.1â1.2,1.4â2.5,1.4â7.5,1.6â2.7,1.7â7,1.8â3.8,11â16,11â25,1â2,1â3,1â6,1â8,2.2â4.2,2â20,3.0â4.2,3.3â5.5,3â22,3â6,4.0â16,4.0â6.5,4.5â20,4.5â7.0,4â10,4â30,5.5â8.5,5â11,7â10,8â32,absen,adaxiall,ag,along,apart,appressed,arequipa,arranged,articulated,asymmetrically,axe,ba,beyond,cell,connivent,cylindrical,decreasing,densely,difoliate,eaf,eed,entire,equal,extending,flange,flattened,forming,geminat,hair,irregularly,lon,long,longitudinal,lower,m.,midrib,multicellular,narrow,nflorescence,node,occasionally,often,opening,orolla,parallel,pendant,pentagonal,perfect,plurifoliate,pore,poricidal,rapidly,rotate,ruit,running,secondary,shaped,side,simple,spaced,specimen,split,stone,straight,subglabrous,tacna,tal,tamen,tear-drop,tem,tertiary,tip,unicellular,uniseriate,unit,usually,vary,wide,wing,winge,yellow,ympodial,â10,â12.5,â19,â3,â3.2,â46,â48	--,1-2,1.1,1.2,1.4,1.7,1.8,11,12.5,16,19,2.2,22,25,3,3.0,30,32,4,4.0,4.2,4.5,46,48,6,6.5,7,7.0,7.5,8,appearance,arrangement,bark,border,branch,bud,characteristic,colour,corolla,corrugation,distal,drying,exertion,form,fruiting,giving,glabrousnes,growth,height,history,inflorescence,interjected,lateral,leaflet,life,lobing,mentioned,midpoint,new,number,ovary,per,plant,prickle,pseudostipule,ray,seed,shape,texture,thicknes,type,variation,vein,width
332	wfo-0001029704	success	146	162	114	32	48	0.781	-17,-3,0-1.5,0.5,1,1.5,1.5-2.5,1.5-3,10-14,1000-1200,15-25,2-2.5,2-3,2-5,3-4-celled,3-5,4,5,7-,7-10,9-20,acuman,acuminate,acute,along,also,anther,apex,aspect,base,berry,blue,branch,broadly,brown,c.,calyx,cm,composed,conical,corolla,cuneate,dark,deeply,dia,diam,ellipsoid,erect,especially,exerted,extra-axillary,few-flowered,filament,flower,fork,fruiting,glabrous,globose,gradually,green,halfway,lanceolate,leaf,lengthening,less,lobe,lobed,long,minute,minutely,mm,mottled,obovate,obovoid,occasionally,one,ovary,pedicel,peduncle,petiole,pinnatisect,pore,poricidal,pubescent,purple,record,reddish,reticulate,rounded,shoot,short,shrub,simple,single,slit,sombre,sprawling,stigma,stout,striped,style,subdiscoidal,surface,swollen,tip,trichome,tube,twig,variable,variously,vein,white,x,young	.5,1-2,1-4,140-185,4-7,anthesi,apparently,axi,cell,cunate,cut,deflexed,eaf,eed,enlarged,flowering,lower,midrib,moderately,nflorescence,plurifoliat,ruit,sinus,stellate,stone,straight,subglobo,tub,ud,unit,within,ympodial	appearance,arrangement,bark,border,bud,characteristic,colour,corrugation,diameter,distal,drying,exertion,form,fruit,giving,glabrousnes,growth,height,history,inflorescence,interjected,lateral,leaflet,length,life,lobing,margin,mentioned,midpoint,new,number,per,plant,prickle,primary,pseudostipule,ray,seed,shape,size,stem,subglobose,terminal,texture,thicknes,type,variation,width
333	wfo-0001029727	success	260	231	194	66	37	0.746	-1/3,-10,-3,.5,/3,0-15,0-2,0-4,0-40,0-8,0.1-5,0.15-0.2,0.15-0.3,0.2,0.2-0.5,0.3,0.4,0.4-1,0.5,0.5-1.2,0.5-3,0.7-0.9,0.7-1,1,1-1.2,1-4,1.5-2.5,1.5-5.5,1.6-3,1/2-2/3,1/3-1/2,1/4,1/8-1/5,2.5,3-11,3-6,3-7,4-7,4-merous,4.5-,5-8,5.5-7,6-11,abaxial,abaxially,acicular,acuminate,acute,adaxial,along,alternate,ame,anther,anthesi,apart,apex,apically,apparently,articulated,bark,base,blade,bristle,brown,c.,calyx,chartaceous,climber,cm,colourles,connivent,cordate,corolla,covered,cupular,curved,darker,deltate,deltoid,densely,developing,diameter,different,discolorous,divided,drying,equal,erect,except,extending,ferrugineous,filament,filiform,fissure,flower,free,glabrous,inside,lateral,leaf,length,less,like,lobe,lobed,long,longer,margin,mature,midpoint,midvein,minutely,mixture,mm,moderately,obconical,occasional,older,one,outside,ovate,pair,papillose,pedicel,peduncle,per,perfect,petiole,poricidal,porrect,portion,prickle,prickly,primary,pubescent,raised,rarely,ray,red-brown,reddish,reduced,regular,rounded,scandent,scar,seed,series,sessile,shallowly,shape,short,shrub,simple,sinus,size,smooth,sometimes,spaced,stalk,stalked,stellate,stellate-pubescent,stem,stigma,straight,strongly,style,subentire,surface,tapering,tearing,terete,terminal,tertiary,time,tip,translucent,transverse,trichome,tube,unarmed,uneven,unit,upper,variable,variously,vein,venation,violet,visible,wide,x,yellowish,young	0-20,0-30,0-5,0.2-2.5,1-,1-2,1.2-2,1.5-2.3,1.5-3,2-5,2.5-3.2,2.5-5.5,2.8-4,3/,4-merou,4.5,5-12,5-9,7-10,age,almost,alyx,apar,berry,branched,clavate,dimorphic,eaf,edge,eed,elongating,filiform-acuminat,finely,flattened-reniform,geminate,increasing,lengthening,lon,lower,m.,mauve,middle,minor,narrow-deltate,nflorescence,nther,oblong,open,orange-brown,orolla,oung,papillo,perfec,pit,pitted,plurifoliat,pore,prickl,protruding,red-brow,spreading,tamen,toward,vary,way,ympodial	0.2-0.3,appearance,arrangement,border,branch,bud,characteristic,colour,corrugation,distal,exertion,form,fruit,fruiting,giving,glabrousnes,growth,height,history,inflorescence,interjected,leaflet,life,lobing,new,number,ovary,plant,plurifoliate,pseudostipule,stamen,sympodial,texture,thicknes,type,variation,width
334	wfo-0001029731	success	246	204	163	83	41	0.663	.5,.6,1-2,1-2.5,1.5,1.5-2.5,10-20,1994,2,2-3,2-6,2.5,2.5-4.5,3,3-4,31,4,4-5,4-9,6,6-7,7-11,8-9,abaxially,accrescent,acquiring,acuminate,acute,adaxially,almost,along,anther,apex,apically,arcy,bark,basally,base,beak,becoming,berry,black,branch,branched,branching,brown,bumpy,calyx,clavate,cm,concolorous,conical,connate,coriaceous,corolla,crinkled,cuneate,deltoid,diameter,dilated,distributed,dorsifixed,dry,drying,dull,elliptic,enlarge,entire,epiphyte,erect,evenly,exserted,faint,filament,filiform,fine,finely,flaring,flattened,fleshy,flower,fruit,fruiting,glabrous,ground,hair,lamina,lateral,leaf,liana,like,linear,lobe,lobed,long,long-ellipsoid,longitudinal,longitudinally,main,margin,mature,maturity,mauve,midvein,mm,narrowly,obconical,oblong,obovate,often,orange-brown,pair,pedicel,peduncle,pendulous,pericarp,petiole,primary,pyriform,raised,rakotozafy,rarely,reflexed,reported,revolute,ribbed,ridge,ridged,rounded,several,shallowly,simple,slender,sometimes,sparsely,stem,stigma,straight,stretched,style,succulent,sunk,surface,terminal,thick,toward,tube,usually,vein,venation,visible,white,wide,widely,wing,winged,woody,wrinkling,x,yellow,yellow-green,young,â	0.05,0.1-0.8,0.25-0.3,1,1-1.5,1.5-3,1/3,3-10,age,alyx,anthesi,apar,apparently,articulated,basal,boundary,broadly,clearly,darker,delimited,delineated,dense,development,different,domatia,dorsal,eaf,early,elongating,equal,even,free,iscoid,large,later,lengthening,less,lon,lower,much,nflorescence,nther,obtuse,occasionally,orolla,papillae,papillose,part,perfec,persisting,plurifoliat,pore,poricidal,portion,prominent,protruding,rachi,ruit,scar,see,shorter,sinus,slightly,small,smaller,smoot,stump,tearing,thickened,thinner,though,time,tip,trichome,tub,tuft,ud,unit,vary,ventral,visibl,well-developed,ympodial	appearance,arrangement,border,bud,characteristic,colour,corrugation,discoid,distal,exertion,form,giving,glabrousnes,growth,height,history,inflorescence,interjected,leaflet,length,life,lobing,midpoint,new,null,number,ovary,per,plant,prickle,pseudostipule,ray,seed,shape,size,smooth,texture,thicknes,type,variation,width
335	wfo-0001029741	success	137	141	103	34	38	0.752	.4,.5,0.5-1.5,0.8-3.5,0.9-1.2,1-1.5,1-3.5,1.1-1.3,1.5,1.5-4,1.5-6,10-50-flowered,2-2.5,2.2-9,2.5-7.8,3,9.5-22.5,?,accrescent,acute,age,anther,anthesi,apex,apiculate,attenuate,base,becoming,berry,black,ca,calyx,capitate,cm,completely,corolla,dark,deltoid,dia,dry,drying,early,elliptic,exserted,filament,free,fruit,fruiting,furcate,glabrous,globose,green,growth,immature,inflorescence,known,lateral,leaf,lenticellate,lighter,lobe,lobed,long,major,minor,minutely,mm,nearly,new,opposite,ovary,ovate,papillose,pedicel,petiole,planar,pore,poricidal,portion,prominent,raised,reddish-brown,shaped,shrub,size,slender,slightly,stem,stigma,straight,style,tall,tapering,tear-drop,tip,tree,tube,variable,vein,weak,white,woody,x	branched,caly,closely,deflexed,differing,difoliate,divisio,eaf,edicel,eed,erect,flower,geminat,glabrou,lon,lower,main,middle,nflorescence,overlapping,pair,papillo,produced,proximal,quite,ruit,scar,spaced,ud,unit,usually,widest,wood,ympodial	appearance,arrangement,border,bud,characteristic,colour,corrugation,diameter,distal,exertion,form,giving,glabrousnes,history,interjected,leaflet,length,life,lobing,margin,midpoint,null,number,peduncle,per,prickle,primary,pseudostipule,ray,seed,shape,surface,terminal,texture,thicknes,type,variation,width
336	wfo-0001029744	exception_thrown	113	0	0	113	0	0.0		0.3-0.6,0.5-1,1,1.5,1.5-3.2,2,2-4,5-8,50,7-15,8-10-flowered,8-11,abaxially,acute,adaxially,along,apart,apex,bark,base,beginning,blunt,branch,brow,calyx,cm,deltate,dendritic,densely,denser,difoliate,distinct,eaf,eed,elliptic,entire,examined,extreme,fide,flattened,flexuous,form,fruit,geminate,glabrescent,glabrous,golden,incrassate,inflorescenc,lamina,lanceolate,leaf,leave,lobe,long-acuminate,looping,lower,major,margin,marginal,mature,minor,minutely,mm,narrowly,nflorescence,node,non-reproductive,oblanceolate,oblique,occasionally,older,opposite,ovoid-reniform,pair,pale,pedicel,petiole,pitted,primary,pubescence,pubescent,revolute,scar,see,shape,shrub,similar,simple,single-celled,slightly,small,smaller,smith,sometimes,somewhat,spaced,stem,surface,thee,thin,tip,trichome,ud,unicellular,unifoliate,uniseriate,unit,vein,white,x,ympodial,young	
337	wfo-0001029746	success	179	204	161	18	43	0.899	.5,0.3-2,0.5-1,0.7-1,1,1-1.3,1-1.5,1.2-1.5,1.5,2,2-4,2-7,2-8,3,3-4,3-4-pluri-foliate,3-4.5,3-6,4-9,6,6-7,8-10,8-11,abaxially,acuminate,acute,adaxially,age,anther,anthesi,apart,apex,base,bearing,becoming,berry,blackish,broadly,brown,calyx,capitate,cell,centre,ciliate,cm,color,conical,cordate,corolla,crenate,crowded,cup-shaped,curved,dark,darker,densely,diameter,ellipsoid,elliptic,entire,erect,exerted,filament,flattened,fleshy,flower,flush,free,fruit,fruiting,glabrous,gland-tipped,glandular,globose,greenish,growing,herb,heteromorphic,hollow,horn,inflorescence,internodal,irregularly,lamina,leaf,lengthening,less,lobe,long,longer,longest,lower,margin,markedly,mature,mid-length,minutely,mixed,mm,narrowly,near,nodding,occasionally,orange,ovary,ovate,ovoid,pair,pale,papillose,pedicel,peduncle,petiole,pitted,pore,poricidal,portion,primary,principal,pubescent,purple,rachi,red,reddish,reflexed,scar,shallowly,shortest,simple,single,slender,slightly,slit,somewhat,spaced,sparse,sparsely,stem,stigma,straight,strongly,style,subshrub,surface,testal,third,tip,triangular,trichome,tube,uniseriate,unit,upper,upward,vein,wall,widely,widest,woody,x,â3	2-2.5,c.,eaf,edicel,eed,enlarged,lon,maturit,nflorescence,papillo,pericarp,plan,pubescen,ruit,spreading,thin,ud,ympodial	appearance,arrangement,bark,border,branch,bud,characteristic,colour,corrugation,distal,drying,exertion,form,giving,glabrousnes,growth,height,history,interjected,lateral,leaflet,length,life,lobing,mentioned,midpoint,new,number,per,plant,prickle,pseudostipule,ray,seed,shape,size,sympodial,terminal,texture,thicknes,type,variation,width
338	wfo-0001029769	success	142	146	103	39	43	0.725	.25,.5,1-1.2,1-3,1.5-2,1.5-2.5,2.5-3,2.5-8,3.5-4,4,5-8,7-8,8-9,8.5-17,abaxially,acuminate,acute,adaxially,along,anther,apex,bark,base,berry,branch,brochidodromu,brown,calyx,capitate,cm,conical,corolla,curl-tipped,cyathiform,dark,deltoid,densely,dia,elliptic,exserted,filament,filiform,free,fresh,fruiting,glabrous,globose,golden,green,hen,horizontally,internodal,lateral,leaf,lobe,lobed,long,main,margin,midrib,minutely,mm,nearly,older,onto,opposite,ovary,ovoid-reniform,pair,papillose,pedicel,petiole,pitted,pore,poricidal,portion,puberulent,pubescent,ried,scattered,shaped,shrub,simple,smooth,somewhat,sparsely,stem,stigma,style,surface,swollen,tall,tear-drop,tip,trichome,tube,uniseriate,vein,white,wide,winged,x,young	0.5-1.5,30-60-flowered,4-5,6-17,anthesi,apar,ape,archin,ba,bearing,cerro,deflexed,eaf,edicel,eed,flower,inglÃ©,less,like,lon,lower,nflorescence,papillo,reflexed,ruit,scar,spaced,straight,three,time,tub,two,ud,unevenly,unifoliat,unit,widely,woody,ympodial	appearance,arching,arrangement,border,bud,characteristic,colour,corrugation,diameter,distal,drying,exertion,form,fruit,giving,glabrousnes,growth,history,inflorescence,interjected,leaflet,length,life,lobing,mentioned,midpoint,new,number,peduncle,per,prickle,primary,pseudostipule,ray,seed,shape,size,terminal,texture,thicknes,type,variation,width
339	wfo-0001029780	success	204	189	144	60	45	0.706	1-1.2,1-10,1-2,1.4-1.9,1.5-2,11-24,120-210,15-22,15-45,2-2.5,2-2.8,2-3.5,2-5.5,2.4-4.2,20-60,3-6,3.5-7.3,4-6,4.5-6,5-7,5.5-13,50-70,600-950,8-12,abaxially,absent,acumen,acute,adaxially,anther,apart,apex,apparently,articulated,attenuate,axe,axillary,base,berry,blade,borne,brownish,bud,cell,ciliate,cm,condition,connivent,cordate,corolla,covering,cuneate,dark,decumbent,densely,diameter,distal,drying,end,especially,except,filament,flower,forked,fresh,fruit,generally,glabrous,gland,glandular,globose,greatly,green,greenish,hair,half,head,herb,high,interjected,invested,lanceolate,lateral,leaflet,length,like,lobe,long,longer,make,margin,minute,mm,mucilaginous,non-glandular,obtuse,odd-pinnate,often,ovate,ovoid,pair,pale,pedicel,peduncle,perfect,petiole,pinkish,plant,plurifoliate,proximal,pubescent,reduced,ripe,seed,short,singly,size,spaced,stem,stigma,streak,stripe,style,subequal,subtending,terminal,testal,tetralobulate,thick,tip,tri-,trichome,truncate,tube,tuber,typically,unwinged,usually,wall,wet,white,whitish,x,yellow	2-12,3,5-merou,5.5,?,ag,along,alyx,capitat,chartaceous,digestion,dorsally,eaf,edge,eed,enzyme,erec,exceeding,flat,folded,geminat,glabrou,green-white,hair-like,hal,homostylous,honeycomb-shaped,lengthening,living,lower,membranous,midrib,minutely,nflorescence,orbicular,orolla,petiolulate,petiolule,pore,poricidal,puberulent,rarely,removed,rotate,ruit,sessile,seudostipule,slit,specimen,stamen,ste,stolo,straight,tall,tamen,tem,throughout,unit,vary,ympodial	'hair-like,appearance,arrangement,bark,border,branch,calyx,capitate,characteristic,colour,corrugation,erect,exertion,form,fruiting,geminate,giving,glabrousnes,growth,height,history,inflorescence,leaf,life,lobing,mentioned,midpoint,new,number,ovary,per,prickle,primary,pseudostipule,ray,shape,stolon,surface,texture,thicknes,type,variation,vein,width,Âµm
340	wfo-0001029784	success	237	246	210	27	36	0.886	-12,-5,.1,.2,.5,0-4,0.1-0.15,0.1-0.5,0.2,0.2-,0.2-0.3,0.2-0.5,0.25-0.3,0.3-0.35,0.3-0.4,0.3-0.5,0.3-1,0.4-,0.4-0.45,0.4-0.5,0.4-0.6,0.5-,0.5-1.5,0.6-1,0.7-1.2,0.9-1.2,1,1-,1-1.1,1-1.2,1-1.5,1-2,1-2-celled,1-4,1.0-1.3,1.2-2.5,1.5-,1.7-2.6,1/3,2,2-,2-2.5,2-3-celled,2-4.5,2-foliate,2-locular,2.5-3.5,2/3,3-,3-5,5-10,5-14,5-8,abaxial,abaxially,absent,abundant,acuminate,acute,adaxially,adpressed,along,anther,anthesi,apex,appearance,arising,articulated,axi,basal,base,basicopically,beneath,berry,bract,broadly,brown,calyx,capitate,cell,cm,conical,corolla,crenate-serrate,crenation,dark,decurrent,deeper,densely,developed,diameter,distal,distributed,due,edicel,eglandular,elliptic,enclosing,entire,evenly,exserted,filament,flower,fruit,fruiting,giving,glabrescent,glandular,globose,golden,green,hair-like,hal,half,halfway,head,herb,imparipinnate,inflorescence,interjected,internode,interrupted,interspersed,irregularly,lamina,lanceolate,larger,lateral,leaflet,like,live,lobe,long,long-acuminate,loosely,margin,maturing,mm,mostly,multicellular,narrowly,node,northern,obovate,occasionally,often,orbicular,outgrowth,ovary,pale,paler,patent,pedicel,peduncle,pentagonal,perennial,petiole,petiolule,plant,population,present,primary,proximal,pseudostipule,pubescence,pubescent,reflexed,ripe,robust,scattered,secondary,sessile,silky,simple,soft,sometimes,somewhat,sparse,sparsely,stem,stigma,stout,stripe,strongly,style,surface,terminal,tertiary,testa,thick,trailing,trichome,truncate,tube,ud,undulate,unicellular,uniseriate,unit,unseriate,usually,vein,velvety,wall,white,wide,winged,woody,x,yellow	0.1-,0.5,2-4,angled,apical,appendage,articulation,column,eaf,eed,glabrous,gree,included,lon,lower,markedly,nflorescence,pair,rarely,ruit,smaller,spreadin,staminal,sterile,straight,tem,ympodial	arrangement,bark,border,branch,bud,characteristic,colour,corrugation,drying,exertion,form,glabrousnes,growth,height,history,leaf,length,life,lobing,mentioned,midpoint,new,number,per,prickle,ray,seed,shape,size,spreading,sympodial,texture,thicknes,type,variation,width
341	wfo-0001029785	success	223	192	149	74	43	0.668	0-2,0.1-0.5,0.3-2.2,0.4-4.9,0.8-1,1-1.2,1-10,1-2,1-5,1.2-3.2,1.5-3.6,1.8-3.5,1.8-7,10-26,2-4,3-6,3-8,3.5-5,4-10.5,5-9,6,8-11,abaxially,absent,acumen,acute,adaxially,along,anther,apart,apex,apparently,articulation,attenuate,axe,axillary,base,berry,borne,broadly,brownish,bud,cell,clavate,cm,commonly,condition,cordate,corolla,covering,cuneate,dark,darker,decumbent,denser,diameter,distal,drying,elliptic,end,especially,filament,flower,forked,fresh,fruit,generally,glabrous,globose,green,greenish,hair,half,herb,interjected,invested,lanceolate,lateral,leaf,leaflet,like,lobe,long,make,margin,medium,middle,minute,mm,mottled,mucilaginous,multiple-celled,non-glandular,oblique,obovate,obtuse,odd-pinnate,outer,ovate,ovoid,pale,pedicel,peduncle,perfect,petiole,plant,point,pubescent,purple,purple-tinged,quite,rarely,ripe,rounded,scale-like,seed,shallowly,short,singly,size,slightly,spaced,sparsely,stem,stigma,stripe,style,subglabrous,subtending,tall,terminal,testal,thick,truncate,tube,tuber,typically,unbranched,unwinged,usually,variable,vein,violet,wall,wet,white,whitish,wide,x	0-3,3-4,3.8-7.2,5-16,5-merou,ag,alyx,blade,capitat,chartaceous,connivent,decreasing,digestion,dorsally,eaf,edge,eed,enzyme,erec,exceeding,flat,folded,geminat,glabrou,greatly,green-white,hair-like,homostylous,honeycomb-shaped,larger,lengthening,living,lower,markedly,membranous,midrib,minutely,much,nflorescence,one-quarte,orbicular,orolla,pair,pentagonal,petiolulate,petiolule,plurifoliate,pore,poricidal,present,puberulent,removed,rotate,ruit,sessile,seudostipule,slit,sometimes,specimen,stamen,ste,stolo,straight,tamen,tem,throughout,tip,toward,tri-,unequal,unit,vary,yellow,ympodial	'hair-like,appearance,arrangement,bark,border,branch,calyx,capitate,characteristic,colour,corrugation,erect,exertion,form,fruiting,giving,glabrousnes,growth,height,history,inflorescence,length,life,lobing,midpoint,new,null,number,one-quarter,ovary,per,prickle,primary,pseudostipule,ray,shape,stolon,surface,texture,thicknes,type,variation,width
342	wfo-0001029789	success	167	149	104	63	45	0.623	0-2,0.2-0.5,0.5-2.8,0.8-3.5,1-10,1-2,1-3,1.7-8.5,1.8-6.5,12,2-25,2-3,2-6,2-6.5,2.7-4.7,3-8.5,4-10,5-7,6,6-7,7-16.6,7-21,8-9,abaxially,acumen,acuminate,acute,adaxially,anther,apart,apex,apparently,articulated,axillary,base,basiscopic,blade,blue,broadly,bud,clavate,cm,connivent,corolla,dark,decurrent,diameter,distal,filament,flower,forked,fruit,generally,glabrous,green,hair,half,herb,interjected,lanceolate,lateral,leaf,leaflet,light,lilac,linear,lobe,long,long-attenuate,minute,mm,mottled,narrowly,odd-pinnate,orbicular,ovary,ovate,pedicel,peduncle,perfect,petiole,petiolulate,plant,pubescent,rarely,sessile,short,side,simple,size,spaced,sparsely,star,stigma,style,subglabrous,subtending,terminal,tinged,tube,typically,usually,white,x	1.5-2,3-5,4-13,5-merou,adaxiall,ag,alyx,attenuate,axe,capitat,chartaceous,decreasing,dorsally,eaf,edge,eed,erec,exceeding,flat,folded,formed,geminat,greatly,hal,homostylous,lant,lengthening,like,lower,lunate,maturing,membranous,minutely,never,nflorescence,orolla,pair,pentagonal,plurifoliate,pore,poricidal,pubescen,purpl,rachi,rotate,seudostipule,slightly,slit,stamen,ste,sterile,straight,subequal,tall,tamen,tem,tip,toward,tri-,unit,vary,yellow,ympodial	appearance,arrangement,bark,border,branch,calyx,capitate,characteristic,colour,corrugation,drying,erect,exertion,form,fruiting,giving,glabrousnes,growth,height,history,inflorescence,length,life,lobing,margin,mentioned,midpoint,new,number,per,prickle,primary,pseudostipule,purple,ray,seed,shape,stem,surface,texture,thicknes,type,variation,vein,width
343	wfo-0001029810	exception_thrown	149	0	0	149	0	0.0		.25,.5,0.5-1,0.5-3,1-1.3,1-1.5,1-10,1-2,1-3,1.1-2.3,1.5-3,2-3,2-5,2.5-3,3-3.5,3-4,3-6,4-10,5-15-flowered,5-16,5-6,8-12,abaxially,acuminate,acute,adaxially,along,anther,anthesi,ape,apex,apically,arachnoid,attenuate,bark,base,berry,brown,calyx,capitate,closely,cm,compact,compressed,congested,conical,corolla,dark,deflexed,deltate,dendritic,densely,dia,differing,difoliate,drying,eaf,edicel,eed,ellipsoid,elliptic,exserted,filament,fleshy,free,fruiting,geminat,glabrou,glabrous,globose,green,inflorescence,internodal,large,later,lateral,leaf,lenticel,less,like,lobe,lobed,lon,long,lower,main,major,margin,middle,minor,minutely,mm,narrowly,nearly,nflorescence,occasionally,older,opposite,ovary,overlappin,ovoid-reniform,pale,papillo,papillose,pedicel,petiole,pitted,planar,pointed,pore,poricidal,portion,pubescent,reddish-brown,rest,ruit,scar,shaped,shining,shrub,simple,size,slender,small,spaced,sparsely,stem,stigma,style,surface,tall,tan,tapering,tear-drop,tip,tree,trichome,tub,tube,ud,unit,vein,white,wide,widest,woody,yellowish,ympodial,young	
344	wfo-0001029811	success	225	234	191	34	43	0.849	-3,.5,/3,0,0-30,0-35,0.1-0.3,0.1-0.4,0.2,0.2-0.6,0.3-1,0.3-1.5,0.5-2,0.8-1.5,1,1-1.5,1-2.5,1-3,1.3-1.7,1.5-2.5,1.5-6,1/2-2/3,1/3,1/3-2/3,10-22,15-23,15-50,2-2.5,2-5,2-5.5,2.5-3,2.8-3.2,20-100,3-5,3-5.5,3-7,3.5-4.5,4-8,4.5-5,5-11,5-17,5-40,5-9,6-12,7-9,8-12,8-18,abaxial,abaxially,acicular,adaxial,anther,apart,apex,apically,apparently,articulated,bark,base,berry,blade,broad-deltate,brown,calyx,cell,chartaceous,cm,connivent,cordate,cream,cuneate,dark,densely,diameter,discolorous,distal,distance,drying,elongate,equal,erect,extending,fewer,filament,flattened,flattened-reniform,flower,free,fruit,fruiting,glabrous,glandular,green,hair,herb,inflated,infructescence,lateral,leaf,length,less,lobe,lobed,lobing,long,long-styled,longer,lower,margin,marking,mature,maturity,mauve,midpoint,midvein,minute,mm,moderately,multangulate,narrow-deltate,obtuse,often,older,one,open,orange-brown,outline,ovate,pair,pale,pedicel,peduncle,pendulous,per,pericarp,perpendicular,petiole,pit,plant,poricidal,porrect,portion,prickle,prickly,primary,raised,ray,scandent,scar,secondary,sessile,short,short-styled,shorter,shrub,side,simple,slightly,small,smooth,sometimes,spaced,sparsely,spherical,spreading,stalk,stalked,stellate-pubescent,stem,stout,straight,style,surface,tapering,terete,time,tip,trichome,tube,unarmed,unbranched,unit,upper,usually,vein,way,wide,woody,yellow,yellow-green,young	-6,-merous,1/,13-20,5,7-18,alyx,andromonoecious,apar,eaf,eed,elongating,eye,faint,green-brow,hermaphrodite,heterostylous,long-acuminat,lowermost,naked,nflorescence,orolla,oung,plurifoliat,prickl,ruit,staminat,stellate,tamen,tertiary,vary,venation,visible,ympodial	0.1-0.6,1.5,1/2,appearance,arrangement,border,branch,bud,characteristic,colour,corolla,corrugation,elongated,exertion,form,giving,glabrousnes,green-brown,growth,height,history,inflorescence,interjected,leaflet,life,long-acuminate,new,null,number,ovary,plurifoliate,pseudostipule,seed,shape,size,stigma,sympodial,terminal,texture,thicknes,type,variation,width
345	wfo-0001029978	success	208	183	141	67	42	0.678	0.3-0.7,0.5-0.6,0.7-1.9,0.8,0.9-2.3,1-10,1-2,1.3-1.5,1.4-1.5,1.5-3.1,1.8-5,11-19,15-27,2-4,3-5,3-7,3.1-6.3,3.2-2.5,3.5-9.5,3.7-8.1,4-11,4-7,4.2-5.2,5,5-16.5,8-10,abaxially,acumen,acuminate,adaxially,along,anther,apart,apex,apparently,arranged,articulated,asymmetrical,attenuate,axe,axillary,base,basiscopic,bead,berry,blade,brownish,bud,cell,clavate,cm,coarsely,commonly,condition,conical,connivent,corolla,covering,dark,darker,diameter,distal,drying,elliptic,filament,finely,flower,forked,fresh,fruit,generally,glabrous,green,greenish,hair,half,herb,interjected,lanceolate,lateral,leaf,leaflet,less,light,like,lobe,long,make,margin,medium,middle,minute,mm,moniliform,mottled,mucilaginous,multiple,narrow,necklace,odd-pinnate,orbicular,ovate,ovoid,pedicel,peduncle,perfect,petiole,plant,pubescent,purple,ray,ripe,seed,semierect,sessile,side,simple,size,sparsely,stem,stigma,stolon,style,subsessile,subtending,symmetrical,tall,terminal,testal,thick,tissue,tube,tuber,typically,usually,wall,wet,whitish,wide,wing,x	0.3-0.4,5-merou,ag,alyx,capitat,chartaceous,ciliate,decreasing,digestion,dorsally,eaf,edge,eed,enzyme,erec,especially,exceeding,flat,folded,fourt,geminat,glabrou,gradually,green-white,hair-like,homostylous,honeycomb-shaped,larger,lengthening,living,lower,membranous,midrib,minutely,nflorescence,orolla,pair,pentagonal,petiolule,plurifoliate,pore,poricidal,puberulent,pubescen,removed,rotate,ruit,secondary,seudostipule,slightly,slit,spaced,specimen,stamen,ste,straight,subequal,tamen,tem,throughout,tip,toward,tri-,unit,vary,yellow,ympodial	'hair-like,appearance,arrangement,bark,border,branch,calyx,capitate,characteristic,colour,corrugation,erect,exertion,form,fourth,fruiting,giving,glabrousnes,growth,height,history,inflorescence,length,life,lobing,mentioned,midpoint,new,number,ovary,per,prickle,primary,pseudostipule,shape,surface,texture,thicknes,type,variation,vein,width
346	wfo-0001029980	exception_thrown	173	0	0	173	0	0.0		.1,.5,0.1-0.25,0.25-0.5,0.25-1,0.5-1,0.5-1.2,0.5-2.5,0.5-5,0.7-1.3,0.8-1.2,0.9-4.5,1-1.5,1-1.7,1.2-2.5,1.5-2,1.5-6,2-5,2-6,2/3,3-4,3-9,5-10,5-50-flowered,6.4-17,abaxially,acute,adaxially,anther,anthesi,apar,apex,appearing,appressed,axil,ba,bark,base,berry,black,bright,brown,bud,calyx,closely,cm,conical,corolla,curved,dark,decurrent,deflexed,deltoid,density,dia,differing,difoliate,dried,drying,eaf,edicel,eed,elevation,elliptic,especially,exserted,filament,five,flattened-reniform,free,fruiting,geminat,glabrous,globose,gray,greatly,green,greenish-white,high,impressed,incrassate,knob,lateral,leaf,live,lobe,lobed,lon,long,lower,main,major,margin,material,middle,minor,minutely,mm,near,nflorescence,node,often,older,one,onto,opposite,orbicular,ovary,ovate,overlapping,pair,pale,paler,papillose,pedicel,petiole,pitted,plant,pore,poricidal,portion,prominent,proximal,puberulent,race,reflexed,rounded,ruit,scar,shape,shaped,shiny,shrub,side,simple,size,slender,slightly,small-capitate,somewhat,soon,spaced,specimen,stem,stigma,straight,style,surface,tall,tan,tapering,tear-drop,tip,trichome,tube,tuft,ud,unicellular,uniseriate,unit,varying,vein,venezuelan,way,whit,white,widest,winged,woody,x,yellowish,ympodial,young	
347	wfo-0001029989	success	161	174	130	31	44	0.807	.2,.5,/2,0.25-0.5,0.5-1,0.5-1.5,1-1.5,1-2,1-2.5,1-4,1.3-2.3,1.5-2.5,10-14,2.5-3,3-5,3-8,3.5-8,4-4.5,5-10-flowered,5-6,7-20,abaxial,abaxially,acute,adaxially,anther,anthesi,apex,bark,base,berry,branch,branched,broadly,calyx,capitate,central,cm,collection,congested,conical,corolla,deflexed,deltoid,dendritic,dense,densely,described,dia,drying,due,elliptic,erect,exserted,filament,flattened,fleshy,free,fruiting,glabrous,globose,golden,gray,green,greenish-black,incrassate,inflorescence,internodal,lamina,lateral,leaf,lenticular,like,lobe,lobed,long,main,margin,middle,minutely,mm,nearly,nodding,occasionally,older,opposite,ovary,pair,pedicel,peruvian,petiole,pitted,planar,pore,poricidal,portion,probably,pubescence,pubescent,reddish,reddish-brown,rest,scattered,shaped,shining,short-style,shrub,simple,small,somewhat,stem,stigma,style,surface,tall,tear-drop,tip,tree,tree-like,trichome,tube,vein,way,white,wide,widest,woody,x,yellow,young	brownish-re,closely,difoliate,dimaeter,discussion,eaf,edicel,eed,geminat,heteromorphic,inflorescenc,lon,lower,nflorescence,northern,overlappin,papillo,peru,perÃº,petal,petaloid,population,ruit,scar,see,spaced,sparsely,ud,unifoliate,unit,ympodial	appearance,arrangement,border,brownish-red,bud,characteristic,colour,corrugation,diameter,distal,exertion,form,fruit,giving,glabrousnes,growth,height,history,interjected,leaflet,length,life,lobing,midpoint,new,null,number,papillose,peduncle,per,plant,prickle,primary,pseudostipule,ray,seed,shape,size,terminal,texture,thicknes,type,variation,width
348	wfo-0001030000	success	155	152	96	59	56	0.619	-50,-7,0.5-1,0.5-3,1-10,1-2,1.5-,1.5-2,10-,15-25,2-2.5,2-3,2-4,2.5-,2.5-3.5,25-30,3-16,3-4,3.5-5,30-50,4-4.5,4-5,7-15,abaxially,acute,adaxially,aggregate,also,apex,apiculate,base,calyx,cell,cm,connivent,cucullate,deltate,densely,dia,diameter,dilated,distally,eglandular,ellipsoidal,equal,flattened,flower,fruit,glabrous,globose,green,hair,immature,lobe,long,margin,mature,mm,moderately,narrowly,oblong,obtuse,occasionally,orange,ovoid,pedicel,peduncle,pilose,puberulent,pubescent,purplish,shorter,shrub,slightly,small,sparsely,spotted,stamen,stigma,stone,strongly,style,tinge,tip,tomentose,tree,triangular,truncate,tube,umbrella-shaped,unbranched,white,x,yellow,yellow-brown,yellowish	-4,-5,-pilose,0.5-,0.5-14,1,1-,10-20,2-5,2.5-3,3-,4,4-foliat,absent,apart,ape,articulated,axe,biglandula,chartaceous,ciliat,connective,conspicuous,coriaceous,creamy-whit,directed,eed,exceeding,laterally,leaving,lon,lower,nflorescence,nther,orolla,pedicellar,perfect,pore,produced,pubescen,rachi,radiu,rarely,remnant,ruit,scar,smal,spaced,stellate,subcoriaceous,swelling,tal,tem,thecae,ud,unit,vary,wide,ympodial	anther,appearance,arrangement,bark,biglandular,border,branch,bud,characteristic,ciliate,colour,corolla,corrugation,distal,drying,exertion,filament,form,fruiting,giving,glabrousnes,growth,height,history,inflorescence,interjected,lateral,leaf,leaflet,length,life,lobing,midpoint,new,null,number,ovary,per,petiole,plant,prickle,primary,pseudostipule,ray,seed,shape,size,stem,surface,tall,terminal,texture,type,variation,vein,width
349	wfo-0001030000	exception_thrown	178	0	0	178	0	0.0		-2,-4,-5,-50,-7,-pilose,0.5-,0.5-1,0.5-13,0.5-14,0.5-3,1,1-,1-1.5,1-10,1-2,1-5,1.5-,1.5-2,10-,10-20,15-25,2-,2-2.5,2-3,2-4,2-5,2.5-,2.5-3,2.5-3.5,25-30,3-,3-16,3-4,3.5-5,30-50,4,4-25,4-4.5,4-5,4-foliat,5-25,7-15,abaxially,absent,acuminate,acute,adaxially,aggregate,also,apart,ape,apex,apiculate,articulated,axe,basal,base,biglandula,blade,calyx,cell,chartaceous,ciliat,cm,connective,connivent,conspicuous,cordate,coriaceous,creamy-whit,cucullate,deltate,densely,dia,diameter,dilated,directed,distally,eaf,eed,eglandular,ellipsoidal,elliptic,entire,equal,exceeding,flattened,flower,fruit,glabrescent,glabrous,globose,green,hair,immature,laterally,leaving,lobe,lon,long,lower,margin,mature,mm,moderately,narrowly,nflorescence,nther,oblique,oblong,obtuse,occasionally,often,orange,orolla,ovate,ovoid,pedicel,pedicellar,peduncle,perfect,petiole,pilo,pilose,pore,produced,puberulent,pubescen,pubescent,purplish,rachi,radiu,rarely,remnant,ruit,scar,shorter,shrub,simple,slightly,smal,small,spaced,sparsely,spotted,stamen,stellate,stigma,stone,strongly,style,subcoriaceous,swelling,tal,tem,thecae,time,tinge,tip,tomentose,tree,triangular,truncate,tube,ud,umbrella-shaped,unbranched,unit,vary,vein,white,wide,x,yellow,yellow-brown,yellowish,ympodial	
350	wfo-0001030004	success	177	180	139	38	41	0.785	.3,0-0.5,0-1.5,0.2-1,0.3-1,0.8-1.1,1-2,1.2-2,1.5-2.5,15,15-20,2-20,20-200-flowered,3-3.5,3-4,3.5-5,4-15,5-25,9-30,abaxial,abaxially,across,acuminate,acute,adaxially,along,anther,anthesi,apex,axillary,bark,basal,base,berry,branched,branching,broadly,bushy,calyx,capitate,cm,collection,conical,corolla,crotaloid,decurrent,deltate,dendritic,dense,densely,denser,dia,distal,drying,elliptic,erect,exserted,filament,flattened-reniform,fruiting,giving,glabrous,globose,green,hard,incrassate,inflorescence,knob,large,later,lateral,leaf,like,lobe,lobed,long,loose,main,many,margin,minutely,mm,much,nearly,obovate,obovoid,occasionally,often,onto,ovary,pair,pale,papillate,pedicel,pericarp,petiole,planar,plant,plurifoliate,pore,poricidal,portion,prominent,pubescence,pubescent,seed,sessile,shaped,shrub,small,sparsely,stem,stigma,stout,strongly,style,surface,tall,tan,tear-drop,terminal,thick,thin,time,tip,translucent,tree,trichome,tube,variously,vein,white,wide,winged,woody,x,yellowish,yellowish-green,young	1-1.5,always,apar,appearanc,barely,blade,body,cone,diamete,eaf,edicel,eed,especially,flat,fleshy,free,greenish-yello,juvenile,lamina,lower,middle,nflorescence,older,papillo,pitted,possessing,rest,ruit,scar,simple,spaced,surpassing,tub,tuft,ud,unevenly,widest,ympodia	appearance,arrangement,border,branch,bud,characteristic,colour,corrugation,diameter,exertion,form,fruit,glabrousnes,greenish-yellow,growth,height,history,interjected,leaflet,length,life,lobing,mentioned,midpoint,new,number,papillose,peduncle,per,prickle,primary,pseudostipule,ray,shape,size,sympodia,texture,thicknes,type,variation,width
351	wfo-0001030007	exception_thrown	168	0	0	168	0	0.0		.05,.4,.5,0.1-0.5,0.2-1,0.5-1,0.8-1,1-1.5,1-15,1-2,1.5-5,1.6-2.2,15-20,2-4,2-7,3-5,3/4,4.5-5,6-10-flowered,7-10,7-9,abrupt,acuminate,acute,along,anther,anthesi,apart,apex,ba,bark,base,becoming,beneath,berry,branched,broadly,brown,bud,calyx,campanulate,clavate,closely,cm,cork,corolla,dark,decurrent,deltoid,densely,dia,difoliate,dry,edicel,eed,elliptic,erect,exserted,filament,flattened,fleshy,free,fruiting,geminateleaf,glabrate,glabrous,globose,golden,golden-pubescent,gre,green,hooded,impressed,incrassate,inflorescenc,lateral,leaf,like,live,lobe,lobed,lon,long,longer,lower,main,major,margin,material,middle,midrib,minor,minutely,mm,nflorescence,oblique,obovoid,occasionally,older,one,onto,opposite,outline,ovary,pair,pale,papillo,papillose,pedicel,petiole,pitted,planar,plant,pore,poricidal,portion,prominent,pubescent,raised,reniform,rest,rounded,ruit,scar,shaped,short,shorter,shrub,simple,slender,slightly,small,soft,soon,spaced,sparsely,specimen,stem,stigma,straight,style,surface,tall,tapering,tear-drop,thick,thickened,tip,tree,trichome,trunk,tub,tube,two,type,ud,uniseriate,unit,vein,way,white,widening,widest,winged,woody,x,ympodial,young	
352	wfo-0001030010	exception_thrown	156	0	0	156	0	0.0		.5,.75,/4,0.5-5,0.7-1,0.9-1.1,1-1.3,1-1.5,1-2,1.2-1.5,1.5-2,10-15,10-50-flowered,11-12,2-2.2,2-7,2.5,20-40,3-5,4-4.5,5-7,7-10,acuminate,acute,anther,anthesi,apex,appearing,area,attenuate,bark,basal,base,beneath,berry,brown,bud,calyx,closely,cm,corolla,cyathiform,dark,deciduous,decurrent,deflexed,deltate,dia,differing,difoliate,distal,dry,eaf,edicel,eed,ellipsoid,exserted,f,filament,fleshy,free,fruit,fruiting,furcate,geminat,glabrate,glabrous,globose,green,grey,hooded,lateral,leaf,lobe,lobed,lon,long,lower,m.,main,major,margin,materia,material,middle,midrib,minor,minute,minutely,mm,near,nearly,nflorescence,obovate,occasionally,often,older,one,opposite,orange,ovary,overlappin,ovoid-reniform,pair,papillose,pedicel,persistent,petiole,pitted,planar,pore,poricidal,portion,prominent,puberulent,rather,reddish,ruit,scar,shaped,shin,shrub,simple,size,slightly,small,smooth,soon,spaced,stem,stigma,straight,styl,style,surface,tall,tapering,tear-drop,tiny,tip,tree,trichome,trunk,tube,ud,uniseriate,unit,vein,way,white,widest,winged,woody,x,ympodial,young	
353	wfo-0001030023	success	171	178	123	48	55	0.719	-,0-100+,0.5-1,1,1-2,1-8,1.5-2,1.5-7,10-,10-25,12-18,2,2-3,2.5-3.5,20-30,3-4.5,3-5,30-50+,4,4-12,5,5-16,5-6,6-26,6-7,7-9,abaxially,acute,adaxially,aggregate,apex,apiculate,basal,base,beyond,blade,branched,calyx,cell,ciliate,cm,color,connivent,cordate,cuneate,cylindrical,deeply,densely,denser,diameter,dilated,distally,ellipsoidal,elliptic,entire,especially,except,exserted,finely,flattened,fleshy,flower,forked,fruit,glabrous,glandular-puberulent,globose,greenish-white,hair,highly,lanceolate,lobe,long,loosely,main,margin,mm,moderately,narrowly,oblique,oblong,obtuse,occasionally,often,ovate,pedicel,peduncle,peltiform,petiole,present,probably,puberulent,pubescence,pubescent,purplish-,radiu,ripe,short-acuminate,simple,small,somewhat,sparsely,stamen,stigma,stone,style,subcoriaceous,time,tip,tree,triangular,truncate,tube,unbranched,unit,unknown,usually,vein,villous,wide,x,yellowish,young	1-,11-40+,13-20,4-10,4-foliat,5-,apart,ape,articulated,axe,capitat,connective,directed,eaf,eed,exceeding,glandular-puberulen,leaving,lon,lower,membranaceous,narrow,near,nflorescence,nther,orolla,pedicellar,perfect,pore,presen,prominent,pubescen,pubescent-pilo,rachi,remnant,ruit,shorter,slightly,spaced,stellate,swelling,tal,tem,thecae,ud,unknow,vary,ympodial	4-foliate,anther,appearance,arrangement,bark,border,branch,bud,capitate,characteristic,colour,corolla,corrugation,distal,drying,exertion,filament,form,fruiting,giving,glabrousnes,growth,history,inflorescence,interjected,lateral,leaf,leaflet,length,life,lobing,mentioned,midpoint,new,number,ovary,per,prickle,primary,pseudostipule,pubescent-pilose,ray,seed,shape,size,stem,surface,sympodial,tall,terminal,texture,thicknes,type,variation,width
354	wfo-0001030032	success	250	259	221	29	38	0.884	+,.05,.5,0.1-0.4,0.1-0.5,0.2,0.2-0.3,0.2-0.5,0.25-0.4,0.5,0.5-0.6,0.5-0.7,0.5-1.5,0.5-2,0.6-1.1,0.7-0.8,0.8-1.0,1-1.3,1-1.5,1-2-celled,1-3,1-celled,1.5-2,1.5-2.5,11-20,13-35,2,2-10,2-3-locular,2-3.5,2-4,2-5,2-60,2-lobed,2.4-3.5,3,3-5,3.0-3.5,3.5-12,30,4-5,4-6-celled,4-celled,4.3-5.0,5-plurifoliate,6-11,60-80,7-16,7.5-10,8-10,8-10-celled,8-20,abaxially,absent,abundant,acuminate,acute,adaxial,adaxially,along,also,anther,anthesi,apex,apical,appearance,appendage,articulated,articulation,basal,basally,base,basiscopically,border,branched,breaking,bright,brown,calyx,capitate,cell,clambering,cm,completely,conical,corolla,dark,decurrent,deltate,densely,densest,diameter,dry,ebracteate,elliptic,entire,exserted,filament,flower,fruit,fruiting,give,glabrous,glandular,golden,green,greenish-brown,hair-like,halfway,head,herbarium,imparipinnate,interjected,internode,interrupted,irregularly,lamina,large,larger,lateral,leaf,leaflet,length,like,lobe,long,longest,many,margin,markedly,middle,mixed,mm,moderately,much,multicellular,oblanceolate,oblique,obovate,occasionally,often,older,onto,opposite,orbicular,outgrowth,ovary,pair,pale,paler,patent,pedicel,peduncle,petiole,petiolule,pithy,present,primary,pseudostipule,pubescence,pubescent,rachi,reflexed,rest,rough,round,secondary,seed,set,shorter,silky,simple,slightly,smaller,soft,sometimes,somewhat,sparsely,sparser,specimen,splitting,stamen,stem,sterile,stigma,straight,style,subopposite,surface,swollen,tall,tangled,terminal,tertiary,testa,thick,thickened,time,tiny,tip,touch,transparent,trichome,truncate,tube,unicellular,uniseriate,unit,usually,vein,venation,vine,wall,weaker-walled,white,wide,winged,woody,yellow,younger,Â½-3/4	0.4-1.5,0.5-1,0.8-1.1,bent,branche,column,conspicuou,desne,eaf,edicel,eed,free,gree,hea,leave,lower,midvein,nflorescence,node,rotate,rotate-stellate,ruit,spreading,staminal,tem,ud,vegetatio,well-developed,ympodial	arrangement,bark,branch,bud,characteristic,colour,conspicuous,corrugation,dense,distal,drying,exertion,form,giving,glabrousnes,growth,height,history,inflorescence,life,lobing,mentioned,midpoint,new,number,per,plant,prickle,ray,shape,size,sympodial,texture,thicknes,type,variation,vegetation,width
355	wfo-0001030048	success	156	159	113	43	46	0.724	.5,0.5-1.5,1-1.5,1-2,1.2-2,1.3-1.6,1.5-3.5,1.5-7,10-16,2-5,3-3.5,3-5,4-15,4-4.5,5-10-flowered,5-8,abaxially,acute,adaxially,anther,anthesi,apex,apically,arachnoid,bark,base,becoming,berry,bi-colored,bi-lobed,blue,broadly,brown,calyx,clavate,closely,cm,conical,corolla,decurrent,deltate,densely,dia,drying,ellipsoid,elliptic,exserted,felt-like,filament,free,fruiting,glabrate,glabrous,globose,golden,green,greyish,impressed,internodal,lateral,leaf,lightly,lobe,lobed,long,main,margin,matted,minutely,mm,nearly,older,onto,opposite,ovary,ovoid-reniform,pale,papillose,pedicel,petiole,pitted,planar,pointed,pore,poricidal,portion,prominent,pubescent,reddish-brown,scar,shaped,shrub,simple,small,somewhat,spaced,stem,stigma,strongly,style,surface,tan,tear-drop,thickened,tip,tree,trichome,tube,vein,white,wide,yellowish,young	2-3,5973,abaxial,along,ape,apparently,completely,covered,deflexed,difoliate,eaf,edicel,eed,fide,fleshy,four-angle,geminat,inflorescenc,lamina,like,lon,lower,middle,nflorescence,occasionally,overlappin,pair,papillo,rather,rest,ruit,shiny,solomon,sparsely,tall,thick,trifoliate,tub,ud,unit,widest,woody,ympodial	appearance,arrangement,border,branch,bud,characteristic,colour,corrugation,diameter,distal,exertion,form,four-angled,fruit,giving,glabrousnes,growth,height,history,inflorescence,interjected,leaflet,length,life,lobing,midpoint,new,number,overlapping,peduncle,per,plant,prickle,primary,pseudostipule,ray,seed,shape,size,specified,terminal,texture,thicknes,type,variation,width
356	wfo-0001030053	success	141	144	96	45	48	0.681	0.5,0.5-1,1-1.3,1-13,1.3-3.5,1.5-5.5,1.8-2,10-20,100,2.5-3,3.5-4,4-,7-11,7-9,<,abruptly,acuminate,acute,anthesi,apex,apical,apiculae,base,berry,branch,branched,brown,calyx,cell,cm,completely,corolla,cyathiform,decurrent,diameter,elliptic,entire,exserted,far,filiform,flattened,flower,fruiting,glabrous,greenish,growth,hyaline,inflorescence,irregularly,lobe,lobed,long,many,margin,minutely,mm,new,nipple,older,pair,pale,pedicel,peduncle,pendant,per,petiole,pitted,primary,rectangular,reniform,revolute,rim,shallowly,shining,shiny,simple,slightly,spreading,stem,surface,terminal,testal,time,tiny,truncate,tube,turbinate,twining,unit,usually,vein,vine,white,woody,x,yellowish	2-2.5,5,5-merou,abscission,aiding,alyx,apart,ark,around,articulated,bfeore,climbin,coriaceous,eaf,eed,fide,fine,fragrant,frui,leaving,lower,mentz,near,nflorescence,orolla,papilla,papillo,parallel,peg,perfect,plurifoliat,scar,secondary,shin,sleeve,small,spaced,spreadin,strongly,support,tem,tip,ud,venation,ympodial	anther,appearance,arrangement,bark,border,bud,characteristic,colour,corrugation,distal,drying,exertion,filament,form,fruit,giving,glabrousnes,height,history,interjected,lateral,leaf,leaflet,length,life,lobing,measured,mentioned,midpoint,number,ovary,papillose,plant,plurifoliate,prickle,pseudostipule,ray,seed,shape,size,stigma,style,sympodial,texture,thicknes,type,variation,width
357	wfo-0001030057	success	141	157	105	36	52	0.745	-2,1-10,2-3-celled,2-4,2-4.5,2-6,2.1-4.1,20-30,20-80,3.5-8,4-10,4.3-8.2,5.5-12,7-14,8,8-19,abaxially,absent,acuminate,acute,adaxially,apart,apex,apparently,articulated,axe,axillary,base,berry,blade,broadly,brownish,bud,cell,cm,condition,cordate,covering,cuneate,diameter,digestion,distal,drying,elliptic,enzyme,flower,forked,fresh,fruit,generally,globose,green,green-white,greenish,hair,half,herb,high,honeycomb-shaped,interjected,lateral,leaf,leaflet,like,long,make,mm,mottled,mucilaginous,narrow,odd-pinnate,ovate,ovoid,pedicel,peduncle,perfect,petiole,plant,plurifoliate,pubescent,purple,removed,seed,short,size,sometimes,spaced,stem,subglabrous,suborbicular,subtending,terminal,testal,thick,throughout,tri-,truncate,unit,unwinged,usually,wall,wet,whitish,wing,x	1-2,3-5,borne,chartaceous,decreasing,eaf,eed,end,erec,extremely,geminat,glabrou,greatly,hair-like,larger,living,lunate,membranous,nflorescence,pair,petiolule,ruit,scale-like,seudostipule,singly,small,specimen,ste,stolo,tall,tem,thir,toward,tuber,typically,ympodial	'hair-like,anther,appearance,arrangement,bark,border,branch,calyx,characteristic,colour,corolla,corrugation,erect,exertion,filament,form,fruiting,geminate,giving,glabrousnes,growth,height,history,inflorescence,length,life,lobe,lobing,margin,midpoint,new,null,number,ovary,per,prickle,primary,pseudostipule,ray,shape,stigma,style,surface,sympodial,texture,thicknes,third,tube,type,variation,vein,width
358	wfo-0001030057	success	197	171	128	69	43	0.65	-10,-2,.5-3.5,1-10,1-2,2-3-celled,2-4,2-4.5,2-6,2.1-4.1,20-30,20-80,3-5,3.5-8,4-10,4.3-8.2,5-10,5-6,5.5-12,7-14,8,8-19,abaxially,absent,acuminate,acute,adaxially,anther,apart,apex,articulated,axillary,base,berry,broadly,brownish,bud,cell,ciliate,cm,condition,connivent,cordate,corolla,covering,cuneate,diameter,distal,drying,elliptic,especially,extremely,filament,flower,forked,fresh,fruit,generally,glabrous,globose,green,greenish,greenish-yellow,hair,hair-like,half,herb,high,interjected,lanceolate,lateral,leaf,leaflet,like,linear,lobe,long,lunate,make,margin,middle,mm,mottled,mucilaginous,narrow,odd-pinnate,ovate,ovate-lanceolate,ovoid,pedicel,peduncle,petal,petiole,plant,plurifoliate,pubescent,purple,scale-like,seed,short,size,small,sometimes,spaced,star,stem,stigma,striped,style,subglabrous,suborbicular,subtending,terminal,testal,thick,tip,tri-,truncate,tube,unit,unwinged,usually,wall,wet,white,whitish,wing,x	2-3,2-5,5-merou,acumen,ag,along,alyx,apparently,axe,blade,borne,chartaceous,decreasing,digestion,dorsally,eaf,edge,eed,end,enzyme,erec,exceeding,flat,folded,geminat,glabrou,globo,greatly,green-white,homostylous,honeycomb-shaped,larger,lengthening,living,lower,membranous,midrib,minutely,nflorescence,orolla,pair,pentagonal,perfect,petiolule,pore,poricidal,puberulent,removed,rotate,ruit,seudostipule,singly,slit,specimen,stamen,ste,stolo,straight,tall,tamen,tem,thir,throughout,toward,tuber,typically,vary,yellow,ympodial	appearance,arrangement,bark,border,branch,calyx,characteristic,colour,corrugation,erect,exertion,form,fruiting,geminate,giving,glabrousnes,growth,height,history,inflorescence,length,life,lobing,mentioned,midpoint,new,number,ovary,per,prickle,primary,pseudostipule,ray,shape,surface,sympodial,texture,thicknes,third,type,variation,vein,width
359	wfo-0001030080	success	186	175	130	56	45	0.699	0.3-7,0.4-1.5,0.5-4,1-2,1-3,1.5-2,1.5-2.5,1.8-4.5,2-3,2-4,2.1-7.1,3-10,3-5,3.3-7.7,4-12,4-7,5-13.5,5-7,5.5-9.9,6.5-18.6,8-16,8-23,9.9-33,abaxially,absent,acumen,acuminate,adaxially,along,anther,apex,apparently,arranged,axe,axillary,base,bead,berry,blade,brownish,bud,cell,clavate,cm,condition,coriaceous,corolla,covering,cuneate,dark,decurrent,diameter,distal,dot,drying,elliptic,exceeding,filament,flower,forked,fresh,fruit,generally,glabrescent,glabrous,green,greenish,hair,half,herb,interjected,lanceolate,lateral,leaf,leaflet,light,like,linear,lobe,long,make,medium,mm,moniliform,mottled,mucilaginous,multiple,necklace,odd-pinnate,onto,ovate,ovoid,pedicel,peduncle,perfect,petiole,plant,plurifoliate,purple,pyriform,rachi,seed,size,sometimes,stamen,stellate,stigma,stolon,straight,style,subtending,terminal,testal,thick,throughout,tiny,tri-,tube,tuber,typically,unit,unknown,usually,wall,wet,white,whitish,width,winged,x	1999,5-merou,abaxiall,ag,alyx,apart,articulated,capitat,ccording,connivent,decreasing,digestion,dorsally,eaf,edge,eed,enzyme,erec,flat,folded,geminat,glabrou,green-white,hair-like,hal,high,homostylous,honeycomb-shaped,inconspicuous,larger,lengthening,living,lower,nflorescence,ochoa,orolla,pair,pore,poricidal,removed,second,seudostipule,slightly,slit,spaced,specimen,strongly,subequal,tall,tamen,tem,tip,toward,vary,yellow,ympodial	'hair-like,appearance,arrangement,bark,border,branch,calyx,capitate,characteristic,colour,corrugation,erect,exertion,form,fruiting,geminate,giving,glabrousnes,growth,height,history,inflorescence,length,life,lobing,margin,mentioned,midpoint,new,number,ovary,per,prickle,primary,pseudostipule,ray,shape,stem,surface,sympodial,texture,thicknes,type,variation,vein
360	wfo-0001030081	success	157	172	123	34	49	0.783	.5,0.25-0.5,0.5-1,0.5-1.5,0.5-2.5,1,1-2,1-2-celled,1-3,1-4,1-5,1.5,1.5-3,1.5-7,10-20,10-35,1st,2-7,2nd,3-10,3-6,4-6,5-12,5-15,abaxially,absent,acute,adaxially,along,anther,apex,apically,axe,base,berry,beyond,blade,brown,calyx,cell,center,ciliate,cm,connected,cordate,decurrent,densely,denser,diameter,dm,drying,edge,elliptic,elliptic-ovoid,entire,equal,exserted,few-branched,filament,fine,flat,flower,fruit,geniculate,glabrous,globose,hair,herb,immature,linear-lanceolate,lobe,long,longer,lying,margin,maturing,mm,moderately,nearly,notch,oblong,obtuse,often,one,other,parallel,pedicel,peduncle,per,petiole,placenta,pointing,pubescent,rachi,radiating,raised,rarely,ridge,rounded,running,semitransparent,shallow,short,single-,slightly,small,sometimes,sparsely,stamen,stigma,straight,style,surface,swollen,triangular,tube,two-celled,unbranched,vein,white,woody,x,yellow	2-4,2-foliate,abundant,adaxiall,chartaceous,dehiscing,eaf,eed,emarginat,explosively,frui,geminat,held,interpetalar,lower,maturit,membranaceous,mesocarp,nfloresence,orolla,pressure,pubescen,rotate,ruit,tal,tamen,tem,tissue,unit,usually,vary,watery,wid,ympodial	appearance,arrangement,bark,border,branch,bud,characteristic,colour,corolla,corrugation,distal,emarginate,exertion,form,fruiting,giving,glabrousnes,growth,height,history,inflorescence,interjected,lateral,leaf,leaflet,length,life,lobing,mentioned,midpoint,new,number,ovary,plant,prickle,primary,pseudostipule,ray,seed,shape,size,stem,terminal,texture,thicknes,type,variation,wide,width
361	wfo-0001030083	success	146	168	121	25	47	0.829	.75,0.1,0.5-2,0.8-1,0.8-3,1-1.5,1-2,1.5-3,10-30,2,2-3,2-5-flowered,3-4,3/4,4-15,4-6,9-11,accrescent,acute,anther,apex,bark,base,beginning,berry,broadly,calyx,closely,cm,corolla,cup-shaped,deciduous,decurrent,deeply,deflexed,dia,dry,drying,elliptic,elongate,exserted,fleshy,flower,fruit,fruiting,glabrous,globose,green,greenish-white,hyaline,internodal,lateral,leaf,lobe,lobed,long,long-acuminate,long-styled,main,membranous,minutely,mm,narrowly,near,onto,opposite,ovary,ovate,overlapping,ovoid-reniform,pair,pale,paler,papillae,papillose,pedicel,petiole,pitted,pore,poricidal,prominent,raised,red-papillose,reddish-gold,scar,shallowly,shaped,short-styled,shrub,simple,single-stemmed,slender,slightly,small-capitate,somewhat,soon,spaced,specimen,stem,stigma,strongly,style,surface,tall,tan,tapering,tear-drop,terminal,thickened,thin,tip,translucent,tube,unit,vein,way,white,winged,woody,x,young	.5,0.25-0.5,0.5-1,anthesi,dar,deltoid,eaf,edicel,eed,greyish-re,inflorescenc,lon,lower,middle,nflorescence,older,proximal,reflexed,ruit,straight,tub,ud,unifoliat,widest,ympodial	appearance,arrangement,border,branch,bud,characteristic,colour,corrugation,diameter,distal,exertion,filament,form,giving,glabrousnes,greyish-red,growth,height,history,inflorescence,interjected,leaflet,length,life,lobing,margin,mentioned,midpoint,new,number,peduncle,per,plant,prickle,primary,pseudostipule,ray,seed,shape,size,sympodial,texture,thicknes,type,unifoliate,variation,width
362	wfo-0001030093	success	181	192	147	34	45	0.812	.5,0,0.1-0.3,0.2,0.2-0.5,0.2-1,0.5-1.1,0.6-1.5,0.75-1,1-1.5,1-12,1-5,1.3-4.5,2-2.5,2.5-11,3-4,3.5-12,5-50-flowered,5-8,7-30,7-9,8-9,acuminate,acute,anther,anthesi,apex,attenuate,bark,base,becoming,beneath,berry,branched,brownish-tan,calyx,campanulate,case,clavate,cm,commonly,continues,corolla,cuneate,deltoid,densely,dia,difoliate,ellipsoid,elliptic,erect,especially,except,expanded,exserted,filament,flower,forest,free,fruiting,furcate,glabrous,globose,golden,green,greenish-white,growth,hirsutulous,hyaline,impressed,inundated,lateral,leaf,like,lobe,lobed,long,long-styled,main,major,many,margin,middle,minor,minutely,mm,narrowly,nearly,new,obovate,occasionally,often,older,open,opposite,ovary,ovoid-reniform,pair,pale,paler,pedicel,petiole,pitted,plant,population,pore,poricidal,portion,puberulent,pubescent,quite,reflexed,remaining,shaped,shiny,shoot,short-styled,shrub,simple,size,slightly,small,soon,southern,stem,stigma,straight,style,surface,tall,tear-drop,terminal,thickened,time,tiny,tip,tree,trichome,tube,uniseriate,vein,white,widest,woody,x,yellowish,young	.2,4-6,apar,closely,collection,deflexed,differing,eaf,edicel,eed,evenly,geminat,greyish-brow,guyanese,lon,lower,member,nflorescence,one,onto,orbicular,papillo,persisting,present,ruit,scar,slender,spaced,tapering,tub,ud,underside,unit,ympodial	2.5,3,appearance,arrangement,border,branch,bud,characteristic,colour,corrugation,diameter,distal,drying,exertion,form,fruit,geminate,giving,glabrousnes,greyish-brown,height,history,inflorescence,interjected,leaflet,length,life,lobing,midpoint,null,number,papillose,peduncle,per,prickle,primary,pseudostipule,ray,seed,shape,texture,thicknes,type,variation,width
363	wfo-0001030145	exception_thrown	153	0	0	153	0	0.0		-2,-3,0.2-2,0.3-,0.5,0.5-1,0.5-4,1,1-1.5,1-2,1-2.5,1-3,1-5,1.5,1.5-2,1.5-4.5,1.5-7,10-12,2-3,2-4,2.5-6.5,3,3-10,3-4,3-5,4-5,4-8,4-foliat,6-40,8-11,abaxially,absent,acute,adaxially,adpressed,aggregate,also,apart,ape,apex,articulated,axe,basal,base,beyond,blade,calyx,campanulate,cell,chartaceous,cm,color,compound,connective,cuneate,cylindrical,deltate,densely,diameter,directed,distally,dunal,eaf,eed,ellipsoidal,elliptic,elliptic-ovate,entire,exceeding,exserted,fide,fleshy,flower,forked,fruit,glabrous,glandular,globose,hair,herb,lanceolate,larger,lateral,leaf,leaflet,leaving,less,lobe,lon,long,lower,margin,mm,moderately,narrowly,near,nflorescence,nther,obtuse,orolla,ovate-elliptic,pedicel,pedicellar,peduncle,petiole,pilose,pore,presen,puberulen,puberulent,rachi,radiu,reddish,remnant,ripe,ruit,shorter,shrub,simple,sinuate,slender,slightly,somewhat,spaced,sparsely,stamen,stigma,stone,style,subcordate,subcoriaceous,tal,tem,terminal,ternately,thecae,time,tomento,toward,triangular,truncat,truncate,tube,ud,unbranched,unit,unknown,vary,violet,wide,x,yellow,ympodial	
364	wfo-0001030146	success	210	203	163	47	40	0.776	.1,.2,.5,0.2â0.4,0.5,0.5â1,0.6â0.7,0.6â2,0.9â1,1.2â1.5,1.5â2,16â20,1â1.1,1â1.5,2.5â9,20,20â30,2â5,3â4,3â6,40â50,4â30,5â8,6.5â16,60+,8â15,9â9.5,>,absent,acuminate,acute,almost,along,anther,anthesi,apex,articulated,axe,base,beneath,berry,branched,branching,bright,brown,brownish,c.,calyx,capitate,cell,center,closely,cm,connivent,coriaceous,corolla,covered,cup-shaped,dark,deeply,deltate,dense,densely,diameter,discolorous,drying,echinoid,edge,ellipsoidal,elliptic,elongate,entire,exserted,filament,flattened-reniform,flower,fresh,fruiting,fused,glabrous,globose,golden,gradually,green,growth,halfway,impressed,inflorescence,layer,leaf,length,less,like,lobe,long,loosely,lower,many,margin,midpoint,minutely,mm,multangulate,narrowing,narrowly,new,nodding,olive,pair,pale,papillose,part,pedicel,peduncle,peltate,per,persistent,petiole,pitted,plant,plurifoliate,primary,projection,pubescence,pubescent,ray,reddish,regularly,revolute,ripe,scar,sessile,shiny,short-stalked,simple,small,spaced,stem,stigma,stout,strongly,style,subtended,surface,tan,tangled,terminal,testal,time,tiny,tree,treelet,trichome,tube,undersurface,unit,upper,vein,way,white,wide,woody,â18	4â4.5,5-merou,6â7,abaxial,abaxially,adaxial,ag,alyx,apar,appearing,ark,beig,dichasia,eaf,eed,erec,free,ilament,lamina,lengthening,lobed,nflorescence,older,orolla,perfect,pericarp,pore,poricidal,portion,reflexed,rhachi,ruit,scurfy,slit,sparsely,stellate,tall,tem,thin,tip,ud,unevenly,vary,varying,visible,yellow,ympodial	apart,appearance,arrangement,bark,beige,border,branch,bud,characteristic,colour,corrugation,dichasial,distal,erect,exertion,form,fruit,giving,glabrousnes,height,history,interjected,lateral,leaflet,life,lobing,mentioned,number,ovary,prickle,pseudostipule,seed,shape,size,sympodial,texture,thicknes,type,variation,width
365	wfo-0001030147	success	158	148	99	59	49	0.627	0.5-2,1-4,1-5,1.0-2.0,1.0-2.2,10-19,14-35,15-30,2,2-10,2-10.5,2-13,2-3,2-5,2.5-7.5,4-5.5,4.2-7.5,4.5-10,5-8,abaxially,acumen,acuminate,acute,adaxially,apex,articulate,base,blue,branched,calyx,cell,cm,conical,connate,corolla,covering,cuneate,cyme,deep,diameter,dichasial,dichasially,distal,dorsally,ebracteate,edge,elliptical,exceeding,filament,finely,flat,folded,forked,green,green-white,herbaceous,interjected,lateral,leaf,leaflet,lobe,long,long-attenuate,make,medium,mm,monochasial,mucilaginous,narrowly,oblique,obtuse,odd-pinnate,ovate,ovoid,pedicel,peduncle,perennial,petiole,plant,proximal,pubescent,purple,rounded,seed,size,stamen,stigma,straight,style,terminal,testal,thick,throughout,tip,tuber-bearing,wall,wide,yellow,Â¼	-8,0-5,3-,3-6-foliat,4-3.,5-7,8-38,abaxiall,apical,apically,attenuate,dehiscent,digestion,diminishing,eaf,eed,emoval,enzyme,flower,generally,globo,gradually,hair-like,half,honeycomb,introrse,living,lon,lower,lunat,maturing,nflorescence,nther,often,orolla,pair,pattern,perfect,petiolule,plan,poricidally,reveal,rotate,ruit,sessile,seudostipule,short,slit,specimen,subequal,subsessile,tal,tem,throughou,toward,typically,unit,vary,ympodial	'hair-like,4-31,anther,appearance,arrangement,bark,border,branch,bud,characteristic,colour,corrugation,drying,exertion,form,fruit,fruiting,giving,glabrousnes,globose,growth,height,history,inflorescence,length,life,lobing,margin,mentioned,midpoint,new,number,ovary,per,prickle,primary,pseudostipule,ray,shape,stem,surface,texture,thicknes,tube,type,variation,vein,wet,width
366	wfo-0001030151	exception_thrown	175	0	0	175	0	0.0		-3,-50,0.2-0.5,0.3-0.5,0.5,0.5-1,1,1-1.5,1-17,1-2,1-3,1-5,1.5-2,1.5-2.5,10-20,10-25,15-35,2-11,2-25,2-3,2-6,2-7-compound,20-30,3-14,3-5,3.5-32,4-5,4-foliat,5-6,6-9,?,abaxially,absent,abundantly,acuminate,acute,adaxial,adaxially,aggregate,apart,ape,apex,apiculate,around,articulated,axe,basal,base,beyond,blade,blotch,calyx,cell,channe,chartaceous,ciliat,cm,compound,connate,connective,cordate,cuneate,cylindrical,decurrent,deltate,diameter,directed,distally,eaf,eed,eglandular,elliptic,entire,exceeding,except,exserted,flower,fruit,glabrate,glabrous,glandular,glandular-puberulent,globose,hair,lanceolate,leaf,leaflet,leaving,less,lilac-tinged,line,lobe,lon,long,longitudinal,lower,margin,membranaceous,mm,narrowly,near,nflorescence,nther,oblique,oblong,obovate,obtuse,often,orolla,pedicel,pedicellar,peduncle,perfect,petiole,pinnately,pore,presence,probably,puberulent,purplish,pyriform,rachi,radiu,remnant,ring,ripe,ruit,sand-punctat,sand-punctate,scattered,shallowly,short,shorter,simple,slender,slightly,small,sometimes,somewhat,spaced,sparsely,stalked,stamen,stellate,stigma,stone,stripe,style,surface,tal,tem,thecae,time,tip,toward,tree,triangular,truncat,truncate,tube,ud,unbranched,unit,unknow,vary,vein,veiny,white,white-puberulent,whitish,wide,x,yellow,yellow-green,ympodial	
367	wfo-0001030153	success	147	167	126	21	41	0.857	/3,0.2-1,0.8-0.9,0.8-1.3,1-1.2,1-1.5,1-10,1-2,1-2.5,1.3-1.5,1.3-1.9,1.5-2,2-8,2-lobed,2.5-4,3-4,3-5,3-50,3.5-10.5,5-6,6-8,abaxially,absent,acuminate,acute,adaxially,age,anther,anthesi,apart,apex,apiculate,apparently,attenuate,axil,bark,base,berry,branched,brittle,broadly,calyx,campanulate,clavate,cm,conical,corolla,dark,deltate,densely,diameter,distinct,domatia,dot,dry,ellipsoid,elliptic,enlarged,entire,erect,exerted,filament,flower,fruiting,glabrous,globose,green,growth,impressed,internodal,irregularly,known,lanceolate,lengthening,lobe,lobed,margin,markedly,membranous,minutely,mm,narrowly,new,occasionally,older,ovary,pair,paler,papillate,pedicel,peduncle,petiole,pit-like,plane,pore,poricidal,primary,rachi,resinous,revolute,ripe,simple,slightly,slit,small,spaced,specimen,stem,stigma,straight,strongly,style,surface,terminal,thin,time,tip,tree,treelet,tube,vein,way,white,x,yellowish,young	.1,.2,ape,caly,eaf,free,glabrou,less,lower,nflorescence,nodding,ot,papillat,perfect,plurifoliat,portion,ruit,scar,ud,unit,ympodial	appearance,arrangement,border,branch,bud,characteristic,colour,corrugation,distal,drying,exertion,form,fruit,giving,glabrousnes,height,history,inflorescence,interjected,lateral,leaf,leaflet,length,life,lobing,midpoint,null,number,per,plant,prickle,pseudostipule,ray,seed,shape,size,texture,thicknes,type,variation,width
368	wfo-0001030167	success	141	157	86	55	71	0.61	.8,.9,0.6,abaxially,acuminate,adaxially,along,anther,apex,axe,base,berry,blade,branch,c.,calyx,chartaceous,ciliate,climbing,cm,densely,diameter,entire,extra-axillary,fertile,filament,flattened,flower,fruit,fruiting,gap,glabrous,green,herbaceous,lanceolate,less,lobe,long,margin,maturity,membranaceous,minutely,mm,moderately,near,obtuse,ovate,ovoid,pair,pedicel,peduncle,penden,petal,petiole,pinnate,plurifoliat,pointed,reflexed,rounded,sand-punctate,scar,secondary,simple,slender,somewhat,sparsely,stigma,style,subequal,symmetrical,thinly,time,tip,tube,unbranched,unit,unknown,vegetation,vein,venation,vine,weakly,white,wide,x,ympodial	0.1â0.2,0.5â0.6,0.5â0.7,0.6â0.8,0.7â1.2,0.8â1,1.2â2.5,1.5â2,1.5â7,12,14â19,15â20,17â58,1â1.2,1â1.5,2â3,2â4.5,4.5â8,4â10,4â4.5,4â5,4â7,5-merous,8â10,accrescent,acute,alyx,apar,apically,ciliat,clavate,contiguously,eaf,eed,enlarged,glabrou,immature,lower,m.,membranous,nearly,nflorescence,nternode,orolla,perfec,rachi,ruit,seen,slightly,spaced,stellate,tamen,tem,truncat,vary	0.1-0.2,0.7-1.2,0.8-1,1-1.2,1-1.5,1.2-2.5,1.5-2,1.5-7,14-19,15-20,17-58,2-3,2-4.5,4-10,4-4.5,4-5,4-7,4.5-8,8-10,appearance,arrangement,bark,border,bud,characteristic,colour,corolla,corrugation,distal,drying,exertion,form,giving,glabrousnes,growth,height,history,inflorescence,interjected,internode,lateral,leaf,leaflet,length,life,lobing,mentioned,midpoint,new,number,ovary,pendent,per,plant,prickle,primary,pseudostipule,ray,seed,shape,size,stamen,stem,surface,terminal,texture,thicknes,truncate,type,variation,width
369	wfo-0001030176	success	171	176	127	44	49	0.743	-1.4,.2,.7,.75-1.5,0.5,0.5-2,0.6-0.9,0.7-1.4,0.7â0.8,1,1-2,1.2,1.2-2.5,1.5-2,1.5-2.5,1.6,1/3,1/6,2-foliate,2.25-3.25,2.5,2.5â7.5,2.5â9,2â3,3-5,3-lobed,4-9,6-8,6â8,abaxially,accrescent,acute,adaxially,angulate,anther,apex,attenuate,basal,base,berry,bi-lobed,bilobed,blade,branch,broadly,calyx,ciliate,cm,connivent,contact,covering,cylindrical,decumbent,depressed-globose,diameter,downward,especially,extra-axillary,few-branched,filament,flattened-reniform,flower,forming,fruit,fruiting,glabrous,hair,herb,hold,lanceolate-oblong,lateral,light,line,lobe,lon,long,lower,major,margin,mesocarp,midrib,mm,near,nearly,node,numerous,oblong,often,ovate,pale,patch,pedicel,peduncle,petiole,plant,prostrate,pubescent,rarely,recurved,ripe,rooting,round,simple,slightly,soil,sometimes,somewhat,sparsely,stigma,style,terminal,time,tip,triangular,tube,unbranched,unit,vein,violet,white,wide,winged,x,yellow,yellow-orange,ympodial,young	-4.25,-6.25,0.4-1.5,1-5,2-3,3.75-5,5-merou,adaxiall,alyx,apart,apparently,articulated,asymmetrically,axe,ba,broad,capitat,chartaceous,dehiscent,eaf,eed,erec,geminat,hermaphroditic,interlobal,juic,lance-ovate,longitudinall,minutely,nflorescence,orolla,partially,perfect,pore,rachi,recurve,rotate-stellate,ruit,sinus,spaced,tamen,tem,vary,white-puberulent	appearance,arrangement,bark,border,bud,capitate,characteristic,colour,corolla,corrugation,distal,drying,erect,exertion,form,geminate,giving,glabrousnes,growth,height,history,inflorescence,interjected,juicy,leaf,leaflet,length,life,lobing,mentioned,midpoint,new,number,ovary,per,prickle,primary,pseudostipule,ray,seed,shape,size,stem,surface,texture,thicknes,type,variation,width
370	wfo-0001030180	success	135	158	112	23	46	0.83	.1,.5,.75,0.05-1,0.5-1,0.8-2,0.9-1.8,1-1.5,1.1-1.2,3-4,3-8,4.5-5,6,8-10,8.5-23,?,abruptly,accrescent,anther,anthesi,apex,apiculate,appearing,attenuate,bark,base,becoming,berry,calyx,clavate,cm,corolla,dark,decurrent,deltoid,dia,ellipsoid,erect,exserted,filament,free,fruit,fruiting,furcate,glabrate,glabrous,globose,green,height,immature,interpetalar,known,lateral,leaf,linear,lobe,lobed,long,long-acuminate,main,middle,minute,minutely,mm,narrowing,nearly,occasionally,older,opposite,ovary,papillate,papillose,pedicel,petiole,planar,pore,poricidal,portion,prominent,proximal,puberulent,rounded,shaped,shrub,sinus,slender,slightly,soon,sparsely,stem,stigma,straight,style,surface,tear-drop,terminal,thin,tip,trichome,tube,uniseriate,unit,unknown,vein,white,widely,widest,winged,woody,x,yellowish,young	10-30-flowered,apart,clu,deflexe,eaf,edicel,eed,inflorescenc,lenticellat,lon,lower,nflorescence,overlapping,pair,peduncl,plurifoliat,raised,ruit,scar,spaced,ud,unevenly,ympodial	appearance,arrangement,border,branch,bud,characteristic,club,colour,corrugation,deflexed,diameter,distal,drying,exertion,form,giving,glabrousnes,growth,history,inflorescence,interjected,leaflet,length,lenticellate,life,lobing,margin,midpoint,new,number,peduncle,per,plurifoliate,prickle,primary,pseudostipule,ray,seed,shape,size,sympodial,texture,thicknes,type,variation,width
371	wfo-0001030189	success	188	183	142	46	41	0.755	-4,.2,/3,0-1,0-15,0-30,0.1-0.2,0.5-1.6,0.9-1.1,1,1-1.5,1-2,1-4-cellular,1.1-2.7,1.3-4.2,1.5-2,1.5-4.5,1.5-5,1/3,2,2-3,2-5.5,2.5-4,3-4,3.2-4.5,4-13,4-5.5,5-,5-10,5-6,6-12,8-10,8-18,anther,apex,apically,apparently,appressed,articulated,bark,base,berry,branched,calyx,chartaceous,cm,concolorous,connivent,cordate,densely,diameter,drying,dull,elliptic,elongating,entire,erect,evenly,faint,filament,flattened-reniform,flower,foliaceous,fruit,fruiting,glabrescent,glabrous,gland-tipped,gray,green,infructescence,lateral,leaf,length,lobe,lobed,long,longer,lower,margin,mature,maturity,mauve,midpoint,mm,moderately,oblong,obtuse,often,older,one,open,orange,ovate,pair,pedicel,peduncle,per,petiole,poricidal,porrect,primary,purple,ray,recurved,red,rounded,scandent,sessile,shorter,shrub,simple,smooth,sometimes,sparsely,spherical,spreading,stalk,stalked,stellate-pubescent,stem,strongly,style,surface,tapering,terete,terminal,time,tip,trichome,tube,unarmed,upper,variously,vein,visible,way,wide,woody,yellow,yellow-green,young	-1/2,0.1,0.2-0.3,0.2-0.5,1-3-cellular,1-4-cellula,1/,1/6-1/3,5-merous,6-10,8,abaxially,acut,alyx,apar,blade,curved,deltate,eaf,eed,equal,free,frui,glabrescen,nflorescence,orolla,oung,perfec,pericarp,plurifoliat,portion,red-brow,reflexed,ruit,scar,slender,somewhat,spaced,stellate,tamen,tertiary,unarme,unit,vary,venation,ympodial	1/4,acute,appearance,arrangement,border,branch,bud,characteristic,colour,corolla,corrugation,distal,exertion,form,giving,glabrousnes,growth,height,history,inflorescence,interjected,leaflet,life,lobing,new,null,number,ovary,plant,prickle,pseudostipule,red-brown,seed,shape,size,stigma,texture,thicknes,type,variation,width
372	wfo-0001030219	success	191	200	149	42	51	0.78	0.1â0.3,0.2â2.3,0.5,0.5â,0.7â1.1,0.8â3.0,0â,1.0â2.0,1.0â2.2,1.3â2.9,1.4â2.8,1.5,1.6â,10,15,2.0â2.5,2.0â3.2,2.0â5.5,2.4â6.0,2â,2â3,2â4.5,3,4.5â5.5,4.8â11.5,4â5,4â7,5â,5â8,60,6â10,6â8,7â11,8â18,9â10,abaxially,acute,adaxially,adnate,along,anisophyllous,anther,anthesi,apart,apex,apical,apparently,appearing,arising,arranged,articulated,axe,basal,base,black,blade,blue,bractâlike,branched,brown,calyx,chartaceous,cm,concave,connivent,convex,cylindrical,decreasing,decurrent,deeply,densely,diameter,difoliate,elliptic,equal,erect,filament,flattened,flower,fruit,glabrescent,glabrous,globose,green,hair,incised,indistinct,internode,lanceolate,leaf,lilac,lobe,long,margin,marking,mm,moderately,multicellular,number,oblong,olive,opposed,oppositely,ovate,pair,pale,paler,pedicel,peduncle,pentagonal,perennial,perfect,petiole,pitted,procumbent,pubescent,purple,regularly,rounded,serrate,sessile,shallowly,shrub,side,simple,size,smaller,spaced,sparsely,stigma,straight,strongly,style,surface,time,tube,two,unicellular,uniseriate,unit,velutinous,wide,wing,winged,woody,x,â3.0,â7.0,â9.5	0.4â1.0,1.0â1.2,1.0â1.5,1â2.5,2â2.5,5,6â,9â12,abaxiall,acut,adaxiall,ag,ba,cell,clavat,diamete,directed,distally,eaf,eed,geminat,longitudinal,lower,nflorescence,opening,orolla,pore,present,rapidly,redâpurple,ruit,sid,split,stone,stripe,tal,tamen,tem,vary,white,yellow,ympodial	6â12,appearance,arrangement,bark,border,branch,bud,characteristic,clavate,colour,corolla,corrugation,distal,drying,exertion,form,fruiting,geminate,giving,glabrousnes,growth,height,history,inflorescence,interjected,lateral,leaflet,length,life,lobing,midpoint,new,null,ovary,per,plant,prickle,primary,pseudostipule,ray,seed,shape,stem,sympodial,terminal,texture,thicknes,type,variation,vein,width
373	wfo-0001030225	success	155	146	91	64	55	0.587	-1.5,-30,-45,.5-2.5,0,1,1-4,1-6,10-15,10-30,2,2-18,2-3,2-6,3-11-compound,3-20,3-4,3-5,4-5,8-15,abaxially,acuminate,acute,adaxially,apart,apex,apical,axe,basal,base,bilobed,blade,calyx,cm,compound,conivent,cordate,cuneate,deltate,densely,diameter,elliptic-ovate,entire,expanded,fleshy,flower,forked,fruit,glabrate,glabrous,gland,globose,leaf,leaflet,lobe,long,margin,mm,moderately,narrowly,oblong,obtuse,pedicel,peduncle,perfect,petiole,pinnately,possibly,puberulent,purple,shallowly,shrub,simple,small,somewhat,sparsely,stalked,stigma,style,succulent,time,tip,tree,triangular,truncate,tube,two,unbranched,unit,wide,x	-11,-4,-7,.5,0-20,0-5,1.5,1.5-2.5,2-2.5,3-foliat,absent,ape,apically,articulated,ature,beyond,campanulate,color,connective,coriaceous,cylindrical,dilated,directed,distally,eaf,eed,equal,especially,exceeding,exserted,immature,laterally,leaving,less,lower,minutely,nflorescence,nther,one,orolla,papillose,pore,prominent,puberulen,rachi,radiu,scar,see,seen,slightly,spaced,stamen,stellate,strongly,tal,tem,thecae,tomento,toward,ud,unknow,unknown,vary,ympodial	-5,3-foliate,anther,appearance,arrangement,bark,border,branch,bud,characteristic,colour,corolla,corrugation,distal,drying,exertion,filament,form,fruiting,giving,glabrousnes,growth,height,history,inflorescence,interjected,lateral,length,life,lobing,mentioned,midpoint,new,number,ovary,per,plant,prickle,primary,pseudostipule,ray,seed,shape,size,stem,surface,sympodial,tall,terminal,texture,thicknes,type,variation,vein,width
374	wfo-0001030250	success	169	162	125	44	37	0.74	.5,/4,0-seeded,0.5-1,1-1.5,1-3,1.1-1.2,1.1-3.5,1.25-1.5,1.4-1.5,1.7-7,1.9-2.6,11.2-22,11.3,2-2.5,2.1-6,2.5-3.25,25,3-5,3.4-6.6,3.5-4,4-7,5-50-flowered,5-6,6-8,anther,apex,appearing,arching,attenuate,bark,base,beneath,berry,broadly,brown,bullate,calyx,capitate,cm,conical,corolla,cuneate,cup-shaped,curved,dark,decurrent,dia,dry,elliptic-ovate,exerted,filament,free,fruiting,glabrous,globose,green,greenish-white,greenish-yellow,horizontally,inflorescence,lateral,leaf,lobe,lobed,long,long-acuminate,main,major,maturity,middle,minor,minutely,mm,node,opposite,ovary,ovoid-reniform,pair,pale,paler,papillose,pedicel,pendulous,petiole,pit,pitted,pore,poricidal,portion,prominent,proximal,raised,sea-green,seed,shallow,shape,shaped,shrub,simple,size,slender,slightly,smooth,soon,specimen,spreading,stem,stigma,straight,style,surface,tall,tan,tear-drop,tip,translucent-green,tube,vein,way,white-lenticellate,wide,widest,winged,x	across,anthesi,apart,beginning,carinate-hooded,consisting,deflexed,differing,difoliate,eaf,edicel,eed,elliptic,five,fresh,geminat,glabrou,inflorescenc,irregularly,lon,lower,n,nflorescence,occasionally,older,one,orbicular,orbiculate,papillo,projection,reflexed,rim,ruit,scar,spaced,tapering,translucent,two,ud,unit,usually,white-lenticellat,woody,ympodial	appearance,arrangement,border,bud,characteristic,colour,corrugation,diameter,distal,drying,exertion,form,fruit,giving,growth,history,interjected,leaflet,length,life,lobing,margin,midpoint,null,number,peduncle,per,prickle,primary,pseudostipule,ray,terminal,texture,thicknes,type,variation,width
375	wfo-0001030271	success	195	188	143	52	45	0.733	0-2,0.15-0.75,0.5-1.2,0.7-9.5,0.9-2.5,0.9-3.6,1-2,1-2.5,1-3,1-4,1-6,1-7,1.4-2.1,1.9-6.6,15-61,2-2.7,2-4,2-6,2.4-5.6,3-10,3-5,3.4-7.5,4-22,4-7,5-8,5.6-12.3,6-15,abaxially,acumen,acute,adaxially,along,anther,apart,apex,apparently,arranged,articulated,asymmetric,attenuate,axe,axillary,base,basiscopic,bead,berry,blue,brownish,bud,cell,clavate,cm,coloration,completely,condition,coriaceous,corolla,covering,dark,deep,diameter,distal,drying,elliptic,erect,exceeding,filament,flower,forked,fresh,fruit,generally,glabrous,green,greenish,half,herb,interjected,lanceolate,lateral,leaf,leaflet,light,like,lilac,linear,lobe,long,make,medium,mm,moniliform,mottled,mucilaginous,multiple,necklace,odd-pinnate,orbicular,ovate,ovoid,pedicel,peduncle,perfect,petiole,petiolulate,plant,plurifoliate,purple,ripe,rosette,rounded,seed,sessile,side,size,slightly,sometimes,spaced,spot,stamen,stigma,stolon,straight,style,subtending,symmetric,terminal,testal,thick,tissue,tri-,tube,tuber,typically,unwinged,usually,vein,wall,wet,white,whitish,wide,x	2-3,5-merou,adaxiall,ag,alyx,blade,capitat,connivent,considerably,decreasing,digestion,dorsally,eaf,edge,eed,enzyme,flat,folded,geminat,glabrou,green-white,habi,hair-like,homostylous,honeycomb-shaped,larger,lengthening,living,lower,middl,nflorescence,orolla,pair,pentagonal,pore,poricidal,removed,rotate,ruit,seudostipule,slit,specimen,tall,tamen,tem,throughout,tip,toward,unit,vary,yellow,ympodial	'hair-like,appearance,arrangement,bark,border,branch,calyx,capitate,characteristic,colour,corrugation,exertion,form,fruiting,geminate,giving,glabrousnes,growth,habit,height,history,inflorescence,length,life,lobing,margin,mentioned,middle,midpoint,new,number,ovary,per,prickle,primary,pseudostipule,ray,shape,stem,surface,texture,thicknes,type,variation,width
376	wfo-0001030272	success	179	183	143	36	40	0.799	-6,.3,.5,/4,0-20,0.05-0.1,0.05-1.5,0.5-1,0.5-1.5,0.5-2,0.6-0.9,0.65-1,0.7-2.5,0.8-1.5,1,1-1.5,1-2.8,1.2-1.8,1.5-2.5,1.5-3,1/3,10-20,2-2.5,2-6.5,2.5-3,2.5-3.5,2.8-3.5,3-8,3.5-5,4-15,4-6,4-8,5-7,abaxially,acute,almost,anther,apex,apically,apparently,bark,base,berry,blade,bright,calyx,cm,concolorous,connivent,deltate,densely,diameter,difoliate,drying,elliptic,entire,erect,evenly,filament,flattened-reniform,flower,free,fruit,fruiting,glabrescent,glabrous,gland,glandular,green,hair,infructescence,lateral,leaf,length,less,lobe,lobed,long,long-attenuate,longer,margin,maturity,mauve,membranous,midpoint,minute,mm,moderately,multangulate,narrow-deltate,near,obtuse,older,one,open,orange-brown,pair,pedicel,peduncle,per,pericarp,petiole,poricidal,porrect,portion,primary,ray,red,red-brown,reduced,rounded,sessile,shallowly,shrub,simple,slender,smooth,sometimes,sparsely,spherical,spreading,stellate-pubescent,stem,straight,style,surface,tapering,terete,terminal,time,tip,trichome,tube,unarmed,unbranched,undulate,unit,upper,vein,way,wide,woody,young	1/3-2/3,4-10,5-merous,acut,alyx,ame,apar,articulated,ba,c.,eaf,eed,elongating,equal,geminat,glabrescen,gra,lower,mature,nflorescence,orolla,oung,perfec,reflexe,ruit,scar,shorte,spaced,stellate,tamen,tertiary,unarme,vary,venation,visible,ympodial	appearance,arrangement,border,branch,bud,characteristic,colour,corolla,corrugation,distal,exertion,geminate,giving,glabrousnes,gray,growth,height,history,inflorescence,interjected,leaflet,life,lobing,new,number,ovary,plant,prickle,pseudostipule,seed,shape,size,stigma,sympodial,texture,thicknes,type,unspecified,variation,width
377	wfo-0001030287	success	150	154	101	49	53	0.673	-11,-40,.5-2.5,0-15,0.5-1,1-2,1-2.5,1-3,1-4,1-5.5,1.5-10,1.5-2.5,2,2-,2-10,2-12,2-5,2.5-4,3,3-9,4-5,4.5-6,5-10,abaxially,acute,adaxially,apex,axe,base,basiscopically,blade,bluish,branched,calyx,cm,color,compound,connivent,cylindrical,decurrent,deltate,dendritic,dendritically,densely,diameter,eglandular,ellipsoidal,elliptic-ovate,entire,flattened,flower,forked,glabrous,gland,glandular,hair,herb,lanceolate,lateral,leaf,leaflet,lilac,lobe,long,long-stalked,margin,mm,moderately,narrowly,oblong,obtuse,often,ovoid,pedicel,peduncle,petiole,pinnately,puberulent,pubescent,purple,radiu,rugulose,scattered,shrub,simple,sparser,stalked,stigma,strongly,style,subcordate,time,tip,triangular,truncate,tube,unbranched,unknown,upper,wide,x	-foliat,-many,1,1-10,1-15,1966,4-6,8-13,?,adaxiall,aggregate,apart,articulated,cell,chartaceous,dendritic-pubescen,directed,distall,down,eaf,eed,fide,leaving,lon,lower,membranaceous,nflorescence,nther,orolla,pedicellar,pore,presen,rachi,ruit,scar,slightly,smith,spaced,sparsely,stellate,stone,subcapitat,subcoriaceous,tal,tem,unit,vary,yellow,ympodial	anther,appearance,arrangement,bark,border,branch,bud,characteristic,colour,corolla,corrugation,dendritic-pubescent,distal,drying,exertion,filament,form,fruit,fruiting,giving,glabrousnes,growth,height,history,inflorescence,interjected,length,life,lobing,mentioned,midpoint,number,ovary,per,plant,prickle,primary,pseudostipule,ray,seed,shape,size,stem,subcapitate,surface,tall,terminal,texture,thicknes,type,variation,vein,width
378	wfo-0001030300	success	235	199	163	72	36	0.694	-1,-7,.5,0.1,0.1-0.15,0.2,0.2-0.5,0.4-0.5,0.4-4.5,0.5,0.5-0.6,0.5-1,0.5-4,0.5-5,0.6-0.8,0.7-1.2,0.8-1,0.8-3,0.8-4,0.9-1,1,1-1.3,1-2,1-2-celled,1-4,1-6,1.2-,1.4-2.4,1.5-,1.5-2.5,2-2.1,2-2.5,2-foliate,2-locular,2.2-7.5,3.5-13,3/4,4-11,6-15,6-8-celled,9-12,absent,acute,almost,anther,anthesi,apex,appearance,basal,base,bifid,bracteate,brittle,broadly,brown,calyx,capitate,cell,cm,cordate,corolla,crenate,curved,densely,diameter,distal,ellipsoidal,elliptical,elongate,entire,exserted,filament,finely,flower,fruit,fruiting,give,glandular,globose,golden,green,hair-like,halfway,head,herb,imparipinnate,inflorescence,interjected,internode,interrupted,irregularly,lamina,large,larger,lateral,leaflet,less,like,lobe,long,longer,margin,markedly,mm,multicellular,narrowly,node,oblique,obovate,occasionally,once-branched,orbicular,outgrowth,ovary,pale,pedicel,peduncle,pentagonal,perennial,petal,petiole,plant,present,primary,pseudostipule,pubescence,pubescent,rounded,silky,simple,slightly,sparsely,spathulate,spreading,stem,stigma,strongly,style,surface,tall,terminal,testa,thick,triangular,trichome,tube,two,underlying,uniseriate,unit,upper,usually,vein,velvety,wall,wide,wider,winged,woody,yellow,yellowish,yellowish-green,zygomorphic	-0.9,0.15-1,0.2-1.5,0.4-1.5,0.6-0.7,0.7-0.8,0.7-1.5,1-celled,2-3,2-4,4-celled,abaxially,abundant,adaxial,adaxially,although,always,apical,appendage,articulated,articulation,ba,bent,beyond,bract,coherent,column,crenat,deltate,developed,diamete,eaf,edicel,eed,eglandular,even,face,frequently,glabrous,glutinous-viscose,gree,introrse,leave,lon,midvein,minute,moderately,nflorescence,pair,papillae,partially,petiolule,pith,population,pore,reflexed,rest,ruit,secondary,spreadin,staminal,sterile,straight,tem,tertiary,tip,ud,unicellular,united,weak,well,ympodial	arrangement,bark,border,branch,bud,characteristic,colour,corrugation,drying,exertion,form,giving,glabrousnes,growth,height,history,leaf,length,life,lobing,mentioned,midpoint,new,number,per,prickle,ray,seed,shape,size,sympodial,texture,thicknes,type,variation,width
379	wfo-0001030311	success	182	180	100	82	80	0.549	.2,.5,5-pinnate,abaxially,accrescent,acuminate,acute,adaxial,adaxially,anther,apex,apical,appearance,axe,base,berry,blade,brown,calyx,chartaceous,clavate,cm,cordate,cuneate,deltoid,densely,diameter,distal,elliptical,entire,especially,extra-axillary,fallen,filament,flattened,flower,fruit,fruiting,giving,glabrous,granular,green,groove,ground,half,herbaceous,lanceolate,lateral,leaflet,lenticular,lobe,log,long,lower,margin,membranaceous,mm,oblique,obovate,obtuse,orangish,ovoid-rhomboid,pair,papillose,pedicel,peduncle,petiole,petiolule,proximal,pubescent,purplish,rachi,rhomboid,rounded,sand-punctate,shortly,side,slender,slightly,spaced,sparsely,stem,stigma,style,surface,tan,terrestrial,thick,thickened,tip,trailing,trichome,tube,unbranched,unit,upper,vein,vine,white,x	.5â1.8,0.1,0.1â0.2,0.3â1.5,0.4â2,0.5â0.8,0.5â1,0.5â2,0.5â2.5,0.6â1,0.6â2.4,0.8â1.2,0.8â4,0.8â4.5,1.2â7,1.5â2,1.5â3,1.5â5.5,1.5â6,1.5â8,1.8â2,15â22,1â1.2,1â1.5,1â2,1â2.5,1â3,2.2â2.5,2.2â3,2.5â9,2â10,2â2.5,2â6,3â5,3â7,5â10,<,along,alyx,apar,basal,c.,capitat,ciliat,ciliate,color,dense,eaf,eed,falcate,glabrou,groov,hair,like,lon,m.,membranous,midvein,minutely,nflorescence,nternode,occasionally,orolla,petiolulate,plurifoliat,present,pubescence,ruit,scattered,sessile,short,smaller,stellate,strongly,tamen,tem,thinner,vary,wide,wide-diameter,widely,ympodial	.5-1.8,0.4-2,0.5-0.8,0.5-1,0.5-2,0.6-1,0.6-2.4,0.8-1.2,0.8-4,0.8-4.5,1-1.2,1-1.5,1-2,1-2.5,1-3,1.2-7,1.5-2,1.5-3,1.5-5.5,1.5-6,1.5-8,1.8-2,15-22,2-10,2-2.5,2-6,2.2-2.5,2.2-3,2.5-9,3-5,3-7,5-10,apart,arrangement,bark,border,branch,bud,capitate,characteristic,colour,corolla,corrugation,drying,exertion,form,glabrousnes,growth,height,history,inflorescence,interjected,internode,leaf,length,life,lobing,mentioned,midpoint,new,number,ovary,per,plant,plurifoliate,prickle,primary,pseudostipule,ray,seed,shape,size,stamen,sympodial,terminal,texture,thicknes,type,variation,width
380	wfo-0001030311	success	203	182	136	67	46	0.67	.2,.5,.5-1.8,0.1,0.4-2,0.5-0.8,0.5-1,0.6-1,0.6-2.4,0.8-1.2,0.8-4,0.8-4.5,1-1.2,1-1.5,1-2.5,1-3,1.2-7,1.5-2,1.5-3,1.5-5.5,1.5-8,1.8-2,15-22,2-2.5,2-6,2.2-2.5,2.2-3,3-5,3-7,5-10,5-pinnate,<,abaxially,absent,accrescent,acuminate,acute,adaxial,adaxially,aggregate,anther,apex,appearance,axe,basally,base,blade,brown,cell,chartaceous,ciliate,clavate,cm,cordate,deltoid,dense,densely,diameter,distal,entire,especially,fallen,filament,flattened,flower,fruit,giving,glabrous,granular,green,groove,ground,hair,half,herb,interjected,lateral,leaflet,lenticular,like,lobe,log,long,lower,margin,membranaceous,midvein,minutely,mm,node,oblique,oblong,obtuse,occasionally,orangish,ovoid-rhomboid,papillose,pedicel,peduncle,petiole,plurifoliate,present,proximal,pubescent,purplish,rachi,rooting,rounded,scattered,short,side,simple,sinple,slender,slightly,sparsely,stem,stigma,stone,style,surface,tan,thick,thickened,thinner,tip,trailing,tube,unbranched,uniseriate,unit,vein,white,wide,widely,x	0-2.5,0.5-2,1.5-6,2-10,2224,5-merou,8031,[,],absen,ag,along,alyx,apart,apical,apparently,articulated,ba,basal,capitat,ciliat,color,connivent,cuneate,dig,directed,distally,eaf,eed,elliptical,equal,falcate,formation,g,geminat,gh,groov,large,lon,longitudinal,m.,nflorescence,obovate,opening,orolla,pair,perfect,petiolulate,petiolule,pittier,pore,rhomboid,ruit,sessile,shortly,slit,smaller,spaced,stellate,strongly,tamayo,tamen,tem,upper,vary,yellow,ympodial	arrangement,bark,border,branch,bud,calyx,capitate,characteristic,colour,corolla,corrugation,drying,exertion,form,fruiting,geminate,glabrousnes,growth,height,history,inflorescence,leaf,length,life,lobing,midpoint,new,null,number,ovary,per,plant,prickle,primary,pseudostipule,ray,seed,shape,size,sympodial,terminal,texture,thicknes,type,variation,width
381	wfo-0001030335	exception_thrown	153	0	0	153	0	0.0		.1,.25,.5,.75,0-5,0.05-0.2,0.1-0.5,0.25-0.5,0.5-1,0.7-1,1-1.5,1-2,1-3-flowered,1.1-1.4,1.1.5,2-2.2,2-2.5,2-4.5,2-5,2.5-3,3/4,5-6,5-7,7-13,acuminate,acute,along,anther,anthesi,apex,aspec,ba,bark,base,beneath,berry,bi-lobed,branch,bud,calyx,cm,conical,corolla,dark,deciduous,decurrent,deflexed,deltoid,densely,dia,dry,eaf,edicel,eed,elliptic,erect,except,expanded,exserted,filament,filiform,flattened,free,fruiting,geminate,gently,giving,glabrous,globose,green,greyish-red,horizontally,lamina,lateral,leaf,lenticellate,lightly,like,lobe,lobed,lon,long,lower,main,material,middle,minute,minutely,mm,narrowly,nflorescence,obovoid,occasionally,often,older,onto,opposite,ovary,ovoid-reniform,pair,pale,papillo,papillose,pedicel,petiole,pitted,pore,poricidal,portion,prominent,puberulen,puberulent,pubescent,raised,reflexed,ripe,ruit,shaped,shrub,simple,slightly,soon,sparsely,spreading,stem,stigma,straight,strongly,style,surface,tall,tan,tapering,tear-drop,tip,trichome,tube,ud,underside,unifoliat,uniseriate,unit,vein,way,white,widest,winged,woody,x,yellow,yellowish-green,ympodial,young	
382	wfo-0001030336	success	266	256	219	47	37	0.823	-1.5,-10,-19,-2,.5,0-,0.1-0.5,0.1-0.7,0.1-1,0.15-0.2,0.15-0.9,0.2,0.2-0.25,0.2-1,0.2-1.5,0.3-1.1,0.5,0.5-0.7,0.6-1.5,1,1-1.4,1-1.5,1-3,1-celled,1.0-1.4,1.5-,1.5-2,1.5-3.5,1.5-5,1.6-7,1.7-2.3,1.8-3.0,1/4-1/3,10,2-9,2-foliate,2/3,3-5,4,4-,4-10,4-celled,6,8-16,8-20,8-celled,absent,acute,adpressed,almost,amongst,anther,anthesi,apex,appearance,appearing,articulated,basal,base,basiscopically,bent,berry,bifurcate,bluntly,bract,bracteate,branch,bright,brown,calyx,capitate,cell,cm,coat,conical,cordate,corolla,crenate,curved,dark,darker,decurrent,deeply,densely,diameter,distal,divided,edicel,eglandular,elliptic,elongate,entire,erect,essentially,exserted,extremely,filament,first,flower,flushed,fruit,fruiting,giving,glandular,globose,grayish,green,greenish,hair-like,half,halfway,head,herb,imparipinnate,inflorescence,interjected,internode,interrupted,investing,lanceolate,large,larger,largest,lateral,leaf,leaflet,leave,less,like,lobe,lobed,long,longer,loosely,lower,margin,markedly,maturity,mere,midvein,minute,minutely,mixed,mm,narrowing,narrowly,node,oblique,obovate,occasionally,often,once-branched,orbicular,outgrowth,ovary,pale,pedicel,peduncle,perennial,petiole,petiolule,population,present,primary,proximal,pseudostipule,puberulent,pubescent,purple,rachi,rest,rounded,scattered,secondary,sessile,shaggy,shorter,shrub,silky,simple,sinus,slightly,small,sometimes,sparse,spreading,stem,stigma,stripe,strongly,style,surface,surrounding,tall,ten,terminal,tertiary,testa,thick,tip,trichome,truncate,tube,two,unicellular,uniformly,uniseriate,unit,upper,usually,velvety,wall,way,white,wide,winged,woody,yellow,young	0.1-0.3,0.2-0.8,0.3-0.4,0.5-1,0.5-1.5,0.6-0.8,0.8-0.9,0.8-1.2,0.8-1.3,0.8-3,2-4,2-locular,apical,appendage,articulation,clavat,column,completely,developed,diamete,eaf,eed,entir,glandula,lon,middl,mostly,nflorescence,pair,papillate,part,range,reflexed,rotate,ruit,soft,southern,spreadin,staminal,stellate,sterile,straight,tem,ud,united,weak-walled,ympodial	arrangement,bark,border,bud,characteristic,clavate,colour,corrugation,drying,exertion,form,glabrousnes,growth,height,history,length,life,lobing,mentioned,middle,midpoint,new,number,per,plant,prickle,ray,seed,shape,size,sympodial,texture,thicknes,type,variation,vein,width
383	wfo-0001030342	success	155	154	84	71	70	0.542	.2,.5,1.5,3-pinnate,acuminate,acute,adaxially,anther,apex,apical,apiculate,base,berry,blade,broadly,brown,calyx,chartaceous,cm,cordate,cuneate,cylindrical,deltoid,dense,diameter,elliptical,entire,extra-axillary,filament,flattened,flower,fruit,fruiting,glabrous,greenish,herbaceous,lanceolate,lateral,leaf,leaflet,lenticular,light,lobe,long,margin,membranous,mm,mottled,oblique,obtuse,often,ovoid-rhomboid,pedicel,peduncle,petiole,pointed,proximal,pubescent,rarely,rhomboid,rounded,sand-punctate,scattered,side,slender,smooth,sparsely,stem,stigma,style,surface,tip,trichome,truncate,tube,unbranched,undulate,vein,vine,white,wide-diameter,widely,x,yellowish	0.1â0.2,0.3â1.2,0.5â1,0.5â3,0.5â5,0.8â1.5,0.8â4,1-5,1-6.5,1.2â3,1.5â13,1.5â2,1.5â5,1.5â7.5,10â25,1â1.2,1â1.5,1â2.5,1â3,1â5.5,1â6,1â7,2â,2â2.5,2â4,3,3â12,4â5,4â8,5-merous,6â7,abaxially,abundant,accrescent,along,alyx,apar,axe,c.,capitat,ciliat,eaf,eed,glabrou,like,lon,lower,m.,minutely,nflorescence,nternode,orolla,perfec,petiolule,plurifoliat,pubescen,rachi,revolute,ruit,slightly,spaced,stellate,tamen,tem,terrestria,truncate-acuminat,unit,vary,wide,ympodial,â7	-3,-7,0.5-5,0.8-1.5,0.8-4,1-1.2,1-1.5,1-2.5,1-5.5,1-6,1-7,1.2-3,1.5-13,1.5-2,1.5-5,1.5-7.5,10-25,2-,2-2.5,2-4,3-12,4-5,6-7,appearance,arrangement,bark,border,branch,bud,capitate,characteristic,colour,corolla,corrugation,distal,drying,exertion,form,giving,glabrousnes,growth,height,history,inflorescence,interjected,length,life,lobing,mentioned,midpoint,new,number,ovary,per,plant,prickle,primary,pseudostipule,ray,seed,shape,size,terminal,terrestrial,texture,thicknes,truncate-acuminate,type,variation,width
384	wfo-0001030342	success	153	186	134	19	52	0.876	-7,.2,.5,0.5-1,0.5-3,0.5-5,0.8-4,1-1.2,1-1.5,1-3,1-5,1-5.5,1-6,1-6.5,1-7,1.2-3,1.5-13,1.5-2,1.5-5,1.5-7.5,10-25,2-,2-2.5,2-3,3,3-12,3-pinnate,4-5,4-8,6-7,abaxially,absent,abundant,accrescent,acuminate,acute,adaxially,along,anther,apart,apex,apical,apiculate,apparently,articulated,axe,basally,base,blade,broadly,brown,calyx,chartaceous,cm,connivent,cordate,cuneate,cylindrical,deltoid,diameter,directed,distally,elliptical,entire,equal,extra-axillary,filament,flower,fruit,fruiting,glabrous,hair,herb,interjected,lanceolate,lateral,leaf,leaflet,lenticular,light,lobe,long,longitudinal,margin,membraceous,minutely,mm,node,oblique,oblong,obtuse,opening,pedicel,peduncle,petiole,petiolule,plurifoliate,pore,proximal,pubescent,rachi,rarely,revolute,rhomboid,rooting,rounded,sagittate,scattered,side,simple,slender,slightly,slit,smooth,spaced,stellate,stigma,style,surface,terrestrial,tip,trailing,truncate,tube,unbranched,undulate,uniseriate,unit,vein,white,wide,widely,x,yellow	5-merou,ag,alyx,ba,capitat,ciliat,eaf,eed,geminat,lower,nflorescence,orolla,perfect,pubescen,tamen,tem,truncate-acuminat,vary,ympodial	age,appearance,arrangement,bark,border,branch,bud,capitate,characteristic,ciliate,colour,corolla,corrugation,distal,drying,exertion,form,geminate,giving,glabrousnes,growth,height,history,inflorescence,length,life,lobing,midpoint,new,null,number,ovary,per,plant,prickle,primary,pseudostipule,ray,seed,shape,size,specified,stamen,stem,sympodial,terminal,texture,thicknes,truncate-acuminate,type,variation,width
385	wfo-0001030353	success	227	227	188	39	39	0.828	-0.2,-1.5,-2,-3,-5,-6,-merous,.1,.2,.5,.7,0,0-15,0-2,0.1-0.2,0.1-0.3,0.15-0.3,0.5,0.5-0.9,0.8,1,1-2,1-3,1-6,1-7,1.8-2.2,1/2-2/3,1/3,1/5,1/6,10-15,11-16,2-7,2.5-4,2.8-3.7,20-200,3-4,3-5.5,3.5-4,4-5,5,6,6-15,6-8,7-10,8-15,abaxial,abaxially,acute,adaxial,almost,andromonoecious,anther,apart,apex,apically,apparently,bark,base,berry,blade,c.,calyx,chartaceous,cm,conical,connivent,cuneate,curved,deltate,densely,development,diameter,discolorous,distal,distance,drying,ellipsoid,elliptic,equal,erect,evenly,extending,filament,flattened,flower,free,fruit,fruiting,glabrescent,glabrous,green,half,hermaphrodite,heterostylous,infructescence,lateral,leaf,length,less,lobe,lobed,long,long-styled,longer,lower,lowermost,margin,maturity,mauve,midpoint,midvein,mm,moderately,multangulate,narrow-deltate,older,one,open,orange-brown,patch,pedicel,peduncle,per,pericarp,petiole,plant,pointed,poricidal,porrect,portion,prickle,prickly,primary,ray,red-brown,reddish-green,reflexed,retaining,rounded,scar,sessile,shape,short-styled,shorter,shrub,side,simple,small,smooth,sometimes,somewhat,spaced,sparsely,spreading,stalk,stalked,stellate,stellate-pubescent,stem,stout,straight,strongly,style,subentire,surface,tapering,terete,terminal,throughout,time,tip,tree,trichome,tube,unarmed,unbranched,unit,upper,vein,warty,way,weakly,white-gray,wide,wo,yellow,young	-1/2,0-6,0.8-1.2,1.2-1.8,1.8-3,1/,1/6-1/4,2-10,4-,4-4.5,5-6,alyx,apar,apiculat,articulated,broad-deltate,brown,eaf,eed,elongating,flattened-reniform,mature,nflorescence,orolla,oung,pair,pendulous,plurifoliat,ruit,staminat,tamen,tertiary,unarme,vary,venation,visible,whit,woody,ympodial	apiculate,appearance,arrangement,border,branch,bud,characteristic,colour,corolla,corrugation,exertion,form,giving,glabrousnes,growth,height,history,inflorescence,interjected,leaflet,life,lobing,new,number,ovary,plurifoliate,pseudostipule,seed,size,stamen,staminate,stigma,sympodial,texture,thicknes,type,variation,white,width
386	wfo-0001030407	success	182	149	107	75	42	0.588	.2,.5,0.7-3.2,1-10,1-2,1-3,1-4,1.5-5,12-14,12-15,2-5,2-6.7,2-7,3-10.5,3-6.5,3-9,3.5-9.5,30-60,4-5,5,6-7,6.5-18.5,7-8,abaxially,absent,acumen,acuminate,adaxially,anther,apex,apparently,axe,axillary,base,berry,brownish,bud,cell,cm,condition,conical,connivent,corolla,covering,densely,diameter,distal,drying,elliptic-lanceolate,filament,flower,forked,fresh,fruit,generally,glabrous,green,greenish,half,herb,interjected,lanceolate,lateral,leaf,leaflet,light,lobe,long,make,margin,minute,mm,mottled,mucilaginous,odd-pinnate,ovate,ovoid,pedicel,peduncle,perfect,petiole,petiolule,plant,pubescent,purple,ray,ripe,seed,size,stigma,style,subsessile,subtending,symmetrical,terminal,testal,thick,tube,unwinged,usually,wall,wet,white,whitish,wide,x,yellow	2-2.5,3-4,5-merou,ag,alyx,apart,articulated,blade,capitat,chartaceous,ciliate,decreasing,digestion,dorsally,eaf,edge,eed,end,enzyme,especially,exceeding,flat,folded,geminat,glabrou,gradually,green-white,hair,hair-like,homostylous,honeycomb-shaped,larger,lengthening,like,living,lower,middle,nflorescence,obtuse,one,orolla,pair,pentagonal,placed,plurifoliate,pore,poricidal,proximal,pubescen,removed,round,ruit,secondary,semierec,seudostipule,slit,spaced,specimen,stamen,ste,stolo,subequal,tall,tamen,tem,thir,throughout,tip,toward,tri-,tuber,typically,unit,vary,ympodial	'hair-like,appearance,arrangement,bark,border,branch,calyx,capitate,characteristic,colour,corrugation,exertion,form,fruiting,giving,glabrousnes,growth,height,history,inflorescence,length,life,lobing,mentioned,midpoint,new,number,ovary,per,prickle,primary,pseudostipule,semierect,shape,stem,surface,texture,thicknes,type,variation,vein,width
387	wfo-0001030420	success	170	156	104	66	52	0.612	-2,-20,-30,-35,-pubescent,0.5-,0.5-1,0.5-4,0.5-8,1,1-1.5,1-2,1-3,1-4,1-7.5,1.5-5,1/2,10-,10-25,15-25,2-,2-14.5,2-3,2-5,2-9,3-7,3-lobed,4-7,5-,5-15,5-6,7-19,7/8,abaxially,acuminate,acute,adaxially,also,apex,basal,base,calyx,chartaceous,cm,connivent,cordate,cylindrical,deltate,densely,diameter,divided,eglandular,ellipsoidal,elliptic-ovate,elongated,entire,flower,forked,fruit,glabrate,glabrous,glandular-,glandular-puberulent,lanceolate,leaf,lobe,lobed,long,margin,midrib,mm,moderately,narrowly,obtuse,often,ovate,pedicel,peduncle,perfect,petiole,pinnately,puberulent,pubescent,pubescent-pilose,purple,radiu,rarely,shrub,simple,small,sparsely,stigma,style,subcoriaceous,tip,tree,triangular,truncate,tube,unbranched,unknown,unlobed,vein,x	-4,-9,1-,1-6,1.5-3,2-6,4-foliat,6-7,7-22,absent,aggregate,apart,ape,articulated,axe,beyond,blade,cell,color,connective,dark,directed,distally,eaf,eed,eglandular-pilo,eglandular-puberulent,equal,exserted,hair,leaving,lon,lower,nearly,nflorescence,nther,orolla,pedicellar,pilose,pore,presen,puberulent-pubescent,pubescent-pilo,rachi,remnant,ripe,ruit,shorter,sinus,spaced,stamen,stellate,stone,tal,tem,thecae,time,tomento,truncat,ud,unit,vary,wide,yello,yellow,ympodial	anther,appearance,arrangement,bark,border,branch,bud,characteristic,colour,corolla,corrugation,distal,drying,eglandular-pilose,exertion,filament,form,fruiting,giving,glabrousnes,growth,height,history,inflorescence,interjected,lateral,leaflet,length,life,lobing,midpoint,new,number,ovary,per,plant,prickle,primary,pseudostipule,ray,seed,shape,size,stem,surface,tall,terminal,texture,thicknes,type,variation,width
388	wfo-0001030426	success	158	171	120	38	51	0.759	-30,0.3-7,0.3-8,0.4-0.7,1-4,1-4.2,1.5-3,1.7-3.2,10,15-25,2,2-3,2.5-4,2.5-6,3-12,3-4,3-6,4-10,4-6.5,6-11.5,6-8,9,abaxially,acumen,acute,adaxially,apex,apical,apically,apiculate,articulate,base,branched,calyx,caudate,cell,cm,connate,corolla,covering,cyme,dehiscent,diameter,dichasial,dichasially,distal,dorsally,ebracteate,edge,elliptic-lanceolate,exceeding,filament,flat,flower,folded,forked,generally,glandular,globose,green,green-white,half,heart-shaped,herbaceous,interjected,introrse,lanceolate,lateral,leaf,leaflet,linear,living,lobe,long,make,maturing,mm,monochasial,mucilaginous,oblique,oblong,obtuse,odd-pinnate,often,ovoid,pedicel,peduncle,perennial,perfect,petiole,pilose,plant,poricidally,proximal,rounded,seed,short,size,slit,specimen,spot,stamen,stellate,stigma,straight,stripe,style,terminal,testal,thick,throughout,tuber-bearing,typically,unit,wall,white,wide,without,yellow,Â¼	1.5-6.5,3-6-foliat,absen,decurrent,digestion,diminishing,eaf,eed,emoval,enzyme,globo,gradually,hair-like,honeycomb,larger,linear-lanceolate,linear-oblong,lon,lower,nflorescence,nther,orolla,pair,pattern,pinnatifi,plan,rachi,reveal,ruit,second,sessile,seudostipule,tal,tem,toward,vary,whit,ympodial	'hair-like,3-6-foliate,absent,anther,appearance,arrangement,bark,border,branch,bud,characteristic,colour,corrugation,drying,exertion,form,fruit,fruiting,giving,glabrousnes,growth,height,history,inflorescence,length,life,lobing,margin,mentioned,midpoint,new,number,ovary,per,pinnatifid,prickle,primary,pseudostipule,ray,shape,stem,surface,sympodial,texture,thicknes,tube,type,variation,vein,wet,width
389	wfo-0001030430	success	171	159	87	84	72	0.509	.2,0.25,0.5,30â200,abaxially,acute,adaxially,anther,anthesi,apart,apex,articulated,axillary,base,blade,blue,borne,branched,brittle,brown,bud,calyx,capitate,chartaceous,clavate,cm,cylindrical,decurrent,densely,dentate,diameter,elliptic,equal,erect,few-seeded,filament,flattened,flower,fruit,glabrous,globose,green,hair,indumentum,leaf,lobe,lobed,long,margin,mm,moderately,multicellular,oblong,occasionally,ovate,pair,pale,pedicel,peduncle,perennial,perfect,petiole,pitted,pubescent,purple,regularly,rounded,serrate,shallowly,shoot,shrub,simple,spaced,stigma,straight,style,subglabrous,surface,terminal,time,tube,unifoliate,uniseriate,violet,white,woody,x	.5,0.3,0.4,0.5â12,0.6,0.6â0.8,0.6â1.0,0.8â3.0,0.8â5.6,0.9â1.0,0â20,1.0â1.2,1.0â1.5,1.0â2.0,1.2â2.0,1.3â8.0,1.4â1.5,1.5â1.7,1.6â1.8,1.8â5.0,12â20,12â30,1â3,1â9,2.0â3.0,2.0â4.2,2â3,3.0â4.5,3â17,3â24,3â4,3â5,3â8,5,5.5â12,5â10,5â6,6â10,abundant,adaxiall,ag,apical,appressed,axe,ba,basal,cell,connivent,convex,diamete,eaf,eed,especially,fleshy,geminat,lon,longitudinal,lower,m.,nflorescence,opening,orolla,pentagonal,pore,poricidal,present,ruit,shaped,side,slit,stone,tal,tamen,tear-drop,tem,tip,toward,unit,vary,wide,yellow,ympodial,â2.7,â40	--,0-20,0.5-12,0.6-1.0,0.8-5.6,1.0-1.2,1.0-2.0,1.3-8.0,1.4-1.5,1.5-1.7,1.6-1.8,12-20,12-30,2-3,2.0-3.0,2.0-4.2,3-17,3-4,3-5,3-8,3.0-4.5,40,5-10,5-6,appearance,arrangement,bark,border,branch,characteristic,colour,corolla,corrugation,distal,drying,exertion,form,fruiting,geminate,giving,glabrousnes,growth,height,history,inflorescence,interjected,lateral,leaflet,length,life,lobing,midpoint,new,null,number,ovary,per,plant,prickle,primary,pseudostipule,ray,seed,shape,size,stem,texture,thicknes,type,variation,vein,width
390	wfo-0001030441	success	178	161	117	61	44	0.657	.5,0.5,0.5-0.75,0.5-3,1,1-1.4,1-2-celled,1.2-1.4,2,2-10,2-5.5,2.5,3-4,30,4-5,5-14,5-7,5-7.5,6-11,<,>,acuminate,acute,along,anther,anthesi,apex,attenuate,base,berry,branched,bright,c.,calyx,capitate,cell,cm,corolla,decurrent,deltate,diameter,ellipsoid,elliptic,entire,exerted,eye,filament,flattened,fruiting,glabrous,glandular,globose,green,growth,impressed,lateral,lobe,long,lower,making,many,margin,membranous,midvein,minutely,mm,narrowly,new,occasionally,onto,open,pair,pale,pedicel,peduncle,per,petiole,plant,primary,pubescent,red,reniform,ridged,ripe,scandent,shrub,shrubby,simple,slightly,small,somewhat,spot,stem,stigma,strongly,style,surface,terminal,thin,time,trailing,triangular,trichome,tube,undulate,uniseriate,upper,usually,vein,vine,violet,wall,way,white,wide,woody,yellow	+,0.5-1,1-1.5,1.5-2,10-40,2-3,5-6,5-merou,ag,alyx,apart,ark,articulated,brow,closely,distall,eaf,eed,flexuous,flower,free,glabrou,glandula,hair,ilament,irregularly,juicy,leaving,lengthening,lobed,lon,markedly,nflorescence,older,orolla,otherwise,papillat,papillose,peg,perfect,pericarp,plurifoliat,pore,poricidal,portion,reflexed,ruit,scar,shiny,short,slit,spaced,spreadin,spreading,stellate,tem,tip,ud,unit,vary,ympodial	'hair,appearance,arrangement,bark,border,branch,brown,bud,characteristic,colour,corrugation,distal,drying,exertion,flexible,form,fruit,giving,glabrousnes,height,history,inflorescence,interjected,leaf,leaflet,length,life,lobing,mentioned,midpoint,number,ovary,papillate,prickle,pseudostipule,ray,seed,shape,size,texture,thicknes,type,variation,width
391	wfo-0001030444	success	196	182	139	57	43	0.709	0-24,0.15-0.8,0.8-2,1,1-10,1-2,1-4,1.1-2.7,1.2-1.8,11-45,2-6,2-8,2.3-3.6,2.4-3.8,3-10,3-5,3.7-6.8,4-17,4-39,4-7,5.3-9,6.1-12.8,9.4-20.1,abaxially,acumen,acuminate,acute,adaxially,along,anther,apart,apex,apparently,arranged,asymmetric,attenuate,axe,axillary,base,basiscopic,bead,berry,blade,blue,brownish,bud,cell,ciliate,clavate,cm,condition,connivent,coriaceous,corolla,covering,dark,deep,diameter,distal,dot,drying,elliptic,exceeding,filament,flower,forked,fresh,fruit,generally,glabrous,green,greenish,half,herb,interjected,lanceolate,lateral,leaf,leaflet,light,like,lilac,linear,lobe,long,make,margin,medium,mm,moniliform,mucilaginous,multiple,narrow,necklace,odd-pinnate,orbicular,ovate,ovoid,pedicel,peduncle,perfect,petiole,petiolulate,plant,purple,ripe,rough,rounded,seed,sessile,shortly,side,size,sometimes,spaced,stamen,stigma,stolon,straight,style,subtending,symmetric,terminal,testal,thick,tissue,touch,tube,tuber,typically,unwinged,usually,wall,wet,white,whitish,wide,wing,x	1-5,2-3,5-merou,7.1-17.5,abaxiall,ag,alyx,articulated,capitat,decreasing,digestion,dorsally,eaf,edge,eed,enzyme,erec,flat,folded,geminat,general,glabrou,green-white,hair-like,hal,high,homostylous,honeycomb-shaped,larger,lengthening,living,lower,nflorescence,orolla,pair,pentagonal,plurifoliate,pore,poricidal,removed,rotate,ruit,seudostipule,slit,specimen,subequal,tall,tamen,tem,throughout,tip,toward,tri-,unit,vary,yellow,ympodial	'hair-like,appearance,arrangement,bark,border,branch,calyx,capitate,characteristic,colour,corrugation,erect,exertion,form,fruiting,giving,glabrousnes,growth,height,history,inflorescence,length,life,lobing,mentioned,midpoint,new,number,ovary,per,prickle,primary,pseudostipule,ray,shape,stem,surface,texture,thicknes,type,variation,vein,width
392	wfo-0001030445	success	226	223	181	45	42	0.801	.5,/5-2/3,0.1-0.7,0.2,0.2-0.4,0.2-0.5,0.2-0.7,0.3,0.4,0.5,0.6-2.2,0.6-3.5,0.7,0.8,1,1-1.3,1-7,1.1-4.3,1.3,1.3-1.8,1.3-2,1.6-2,1.7-2.4,1.8-3.5,10-14,10-16,14,15-35,2.1-5.2,2.2-2.9,2.2-3.5,2.4-4.7,3-5.4,3.1-5,3.4-5.6,3.5-4.2,4.1-8.7,4.2-10,5-125,5-merou,5.2-7.1,5.9-15,5.9-8.3,6.1-9.1,7.5-16,8.1-10,8.2-18,abaxially,accrescent,acuminate,acute,adaxially,along,anther,apart,apex,articulated,axillary,bark,base,berry,black,blade,blunt-tipped,branch,branched,brownish-yellow,bud,bulbous-based,calyx,capitate,cm,concentrated,corolla,cylindrical,decurrent,deltoid-reniform,diameter,drying,earl,elliptic,elliptical,elongated,entire,erect,exserted,ferruginous,ferruginous-granular,ferruginous-tomentose,filament,flower,fruit,fruiting,glabrate,glabrous,globose,green,greyish-tan,hair,homostylous,intermediate,lateral,leaf,lobe,lobed,long,lower,main,many,margin,midrib,midvein,mm,mostly,multangulate,oblong,oblong-lanceolate,obovate,obtuse,older,open,orangish-tan,orbicular,orolla,ovate,ovate-lanceolate,pedicel,peduncle,petiole,porrect-stellate,pseudoterminal,pubescence,pubescent,rachi,ray,relatively,reniform,reticulate-punctate,rounded,semi-spherical,sessile,shrub,side,simple,slightly,small,somewhat,soon,spaced,sparse,sparsely,splitting,stalk,stamen,stellate,stem,stigma,stout,style,subcampanulate,sulcate,surface,thick,thick-textured,thicknes,thin,thin-,time,tomentose,tomentum,tree,tube,vein,vestigial-rayed,way,white,wide,x,yellowish,yellowish-tan,young	.1,1.5-2.1,abaxial,ag,alyx,appressed,around,blunt-tippe,brown,directed,distally,eaf,edge,eed,free,geminate,glabrescen,high,inserted,lackin,lengthening,lon,longitudinal,m.,multangulat,nflorescence,obscured,orange,plurifoliate,pore,poricidal,porrect-stellat,resorption,ruit,runk,slit,suture,tamen,tip,tissue,unarme,unit,vary,yellow,ympodial	appearance,arrangement,border,characteristic,colour,corrugation,distal,exertion,form,giving,glabrescent,glabrousnes,growth,height,history,inflorescence,interjected,lacking,leaflet,length,life,lobing,midpoint,new,null,number,ovary,per,plant,prickle,primary,pseudostipule,seed,shape,size,terminal,texture,trunk,type,unarmed,variation,width
393	wfo-0001030447	success	276	265	223	53	42	0.808	.2,.3,.5,/5,0,0.15-0.3,0.2,0.2-0.4,0.4-0.7,0.4-0.9,0.5,0.5-0.65,0.5-10,0.5-3,0.7-1,0.8-1.7,0.8-3.5,1,1-1.5,1-10,1-2,1-2.5,1-3,1-5,1.5,1.5-2.5,1.5-7,1.8-2.5,1/3,1/3-1/2,1/3-2/3,2-4,2.2-2.8,2.5-10,2.5-6.5,3-4.5,3-5,30-45Â°,4-8,5-15,6,6-10,6-16,6-7,6-8,6.5-9,7-8,8,abaxially,acute,adaxially,age,always,anther,apart,apex,apically,apparently,articulated,axe,bark,base,berry,beyond,blade,broad-deltate,calyx,cell,characteristically,chartaceous,clavate,cm,corolla,cuneate,cupular,curved,deltate,development,diameter,difoliate,discolorous,distance,divided,drying,equal,erect,exserted,extending,filament,filiform,fine,finely,finger-hair,flat,flattened,flattened-reniform,flower,free,fruit,fruiting,gently,glabrescent,glabrous,globose,infructescence,irregular,lateral,leaf,length,lengthening,less,lobe,lobed,long,long-styled,longer,longitudinal,lower,margin,maturity,midpoint,midvein,minute,mm,moderately,narrow-deltate,obconical,oblique,oblong,obtuse,often,older,one,open,orange,orange-brown,orange-red,outline,ovate,pair,pale,pedicel,peduncle,per,petiole,pit,point,pore,poricidal,porrect,portion,prickle,primary,pronounced,prostrate,pubescent,purple,rachi,raised,ray,red-brown,reduced,rest,ridge,ridged,rounded,scar,sessile,shallow,shallowly,short-styled,shorter,shortly,shrub,side,simple,sinus,slender,slit,small,smooth,sometimes,somewhat,spaced,sparsely,spherical,spreading,stalk,stalked,stellate-pubescent,stem,stigma,straight,straw-yellow,stump,style,surface,tapering,terete,terminal,thick,throughout,time,tip,translucent,trichome,tube,unarmed,unbranched,unequal,unit,usually,vein,venation,visible,weakly,white,wide,widest,x,yellow,yellow-orange,Ã	0.1,0.1-0.3,1-6,1/4-1/3,3,5,5-merou,6-9,accrescent,alyx,apar,apical,armed,branche,c.,covering,dark,densely,eaf,eed,elongating,geminat,herbaceous,irregula,long-ovoi,mature,mostly,nflorescence,opening,orange-translucent,orolla,oung,papillo,pendulous,perfect,pericarp,persisting,ri,ruit,shiny,sparse,stellate,stout,subsessile,tamen,tertiary,thin,toward,ud,variously,vary,woody,ympodial	appearance,arrangement,border,branch,branched,bud,characteristic,colour,corrugation,distal,exertion,form,geminate,giving,glabrousnes,growth,height,history,inflorescence,interjected,leaflet,life,lobing,long-ovoid,mentioned,new,number,ovary,papillose,plant,pseudostipule,rim,seed,shape,size,sympodial,texture,thicknes,type,variation,width,young
394	wfo-0001030453	success	127	161	112	15	49	0.882	.25,.5,/4,0.25-0.5,0.8-1.5,1-1.3,1-1.5,1.5-1.6,1.5-2.5,3-3.5,4-5,9-12,9-14,abaxially,acuminate,acute,adaxially,along,anther,anthesi,apex,arachnoid,arachnoid-pubescent,attenuate,axi,bark,base,broadly,calyx,clavate,closely,cm,corolla,cup-shaped,dark,deflexed,delicate,deltate,dendritic,densely,dia,divided,ellipsoid,elliptic,especially,exserted,filament,fine,flat,floccose,free,glabrate,glabrous,known,later,lateral,leaf,less,lobe,long,main,margin,middle,midrib,minute,minutely,mm,narrowly,near,nearly,occasionally,older,opposite,ovary,pair,papillose,pedicel,petiole,planar,pore,poricidal,portion,pubescent,reddish,rounded,scar,shaped,shiny,shrub,simple,slender,soon,spaced,sparsely,stem,stigma,straight,strongly,style,surface,tall,tear-drop,tip,trichome,tube,unit,vein,way,white,wide,widest,young	eaf,edicel,eed,know,lon,lower,nflorescence,overlappin,papillat,reddish-brow,ruit,tub,ud,unifoliat,ympodial	appearance,arrangement,border,branch,bud,characteristic,colour,corrugation,diameter,distal,drying,exertion,form,fruit,fruiting,giving,glabrousnes,growth,history,inflorescence,interjected,leaflet,length,life,lobing,midpoint,new,null,number,overlapping,papillate,peduncle,per,prickle,primary,pseudostipule,ray,reddish-brown,seed,shape,size,sympodial,terminal,texture,thicknes,type,unifoliate,variation,width
395	wfo-0001030486	success	141	157	111	30	46	0.787	.5,0.8-2.2,1-1.5,1-5,1.1-1.4,1.7-2,10-12,10-14.5,2-3,2-5.5,3-3.5,3-5,3/4,4-4.5,4-6.5,4.5-5,5-8-flowered,6-7,abaxially,acute,adaxially,anther,anthesi,apex,bark,base,beneath,berry,brown,calyx,clavate,cm,completely,conical,corolla,dark,deflexed,deltate,dia,difoliate,distal,dry,drying,ellipsoid,elliptic,erect,exserted,filament,fleshy,free,fresh,fruiting,glabrous,globose,green,internodal,later,lateral,leaf,lobe,lobed,long,main,major,margin,material,middle,minor,minutely,mm,older,opposite,ovary,ovoid-reniform,pair,pale,papillose,pedicel,petiole,pitted,pore,poricidal,portion,reddish,shaped,shrub,simple,size,slightly,small,stem,stigma,stout,style,surface,tall,tan,tear-drop,tip,treelet,tube,unit,usually,vein,way,white,widest,woody,x,yellow-green,young	1.5-2,1/2,1/4,ba,basal,closely,clustered,differing,eaf,edicel,eed,f,geminat,inflorescenc,lon,lower,m.,nflorescence,overlapping,papillo,planar,ruit,scar,shin,spaced,tapering,thickened,tub,ud,ympodial	appearance,arrangement,border,branch,bud,characteristic,colour,corrugation,diameter,exertion,form,fruit,geminate,giving,glabrousnes,growth,height,history,inflorescence,interjected,leaflet,length,life,lobing,midpoint,new,null,number,peduncle,per,plant,prickle,primary,pseudostipule,ray,seed,shape,shiny,specified,sympodial,terminal,texture,thicknes,type,variation,width
396	wfo-0001030489	success	196	201	159	37	42	0.811	-6.5,.5-2.8,.5-3,.75-5.25,0.25-0.4,0.5-3,0.6-0.9,0.9-1.1,1-1.3,1-3,1-3.75,1.1-1.3,1.2-1.5,1.2-1.6,1.6-2.1,1.7-2,1.75-2,1.9-2.6,1/3-1/2,1/5-1/2,100,12-24,2.1-2.9,3-6,3-8,4-8,5,5-6,6-8,7-15,abaxially,abruptly,acuminate,acute,adaxially,anther,anthesi,apart,apex,appressed,appressed-pubescent,articulated,attenuate,axe,bark,base,becoming,berry,blade,blunt-tipped,branch,branched,broadly,brown,bud,calyx,chartaceous,cinereous,closely,cm,conical,continued,corolla,cylindrical,deltoid,densely,diameter,dichotomously,due,echinoid,elliptic,elongate,entire,filament,fleshy,flower,fruit,glabrate,glabrous,globose,greenish,growth,hair,high,honeycombed,lateral,leaf,length,lobe,lobed,long,long-acuminate,long-exserted,main,margin,midvein,minute,minutely,mm,mostly,multangulate,narrowly,oblong,obtuse,older,ovate,ovate-lanceolate,pale,pedicel,peduncle,petiole,porrect-stellate,probably,pseudo-terminal,puberulent,pubescent,pulverulent,rachi,reniform,reticulate-punctate,ripe,sessile,several,short,short-stalked,shrub,side,simple,slender,small,smooth,somewhat,spaced,sparingly,sparse,stellate-pubescent,stem,stigma,style,subcampanulate,subglobose,suborbicular,terete,thick,time,tomentose,toward,tree,tube,unarmed,usually,vein,way,white,wide,x,yellow,yellowish,young	0.75-0.9,4.5-9,absen,adaxiall,ag,apical-lateral,apparently,axillary,ba,dehiscing,eaf,echinoi,eed,free,inserted,introrse,large,longitudinal,lower,nflorescence,orolla,perfect,plurifoliate,pore,pulverulen,ruit,runk,slit,stellate-rotate,subcapitat,tamen,testa,turn,unarme,unit,vary,ympodial	appearance,arrangement,border,characteristic,colour,corrugation,distal,drying,exertion,form,fruiting,giving,glabrousnes,height,history,inflorescence,interjected,leaflet,life,lobing,midpoint,new,null,number,ovary,per,plant,prickle,primary,pseudostipule,ray,seed,shape,size,subcapitate,surface,terminal,texture,thicknes,type,variation,width
397	wfo-0001030509	success	220	212	173	47	39	0.786	-10,-2,-6,/3,0,0-0.3,0-100,0-5,0.1-0.2,0.2,0.3-2.5,0.5-1.5,0.6-1,0.8-1.2,0.8-4,1,1-1.5,1-2,1-3,1-4,1.3-2,1.5-2,1.7-2,1/4,2-2.5,2-3,2-4.2,2-4.5,2-6,2.8-3,2/3-3/4,3-10,3-4,4.5-10,4.5-12,4.5-8,7-15,7-9,8-16,anther,apart,apex,apically,apparently,articulated,bark,base,berry,blade,broad-deltate,calyx,chartaceous,cm,connivent,cordate,cream,cuneate,curved,dark,densely,diameter,difoliate,discolorous,distal,distance,drying,elongating,entire,erect,extending,filament,flattened-reniform,flower,free,fruit,fruiting,glabrescent,glabrous,gland,globular,gray,green,half,herb,inflated,infructescence,lateral,leaf,length,lobe,lobed,long,long-styled,longer,lower,margin,marking,mature,maturity,mauve,midpoint,midvein,mm,moderately,narrow-deltate,narrow-oblong,obtuse,occasional,occasionally,often,older,one,open,orange,orange-brown,ovate,pair,pale,pedicel,peduncle,per,pericarp,perpendicular,petiole,plant,poricidal,porrect,portion,prickle,prickly,primary,purple,ray,reduced,rounded,shorter,shrub,side,simple,slender,smooth,sometimes,spaced,sparsely,spherical,spreading,stalk,stalked,stellate,stellate-pubescent,stem,straight,style,surface,tapering,terete,terminal,time,tip,trichome,tube,unarmed,unbranched,unit,upper,variously,vein,way,weakly,wide,yellow,yellow-green,young	0-15,0-3,0.1,0.1-0.25,0.1-0.3,1-6,1/,1/3-2/3,5-10,5-merous,abaxially,alyx,andromonoecious,apar,apical,becoming,brow,eaf,eed,equal,eye,geminat,herbaceous,hermaphrodite,heterostylous,long-acuminat,lowermost,naked,nflorescence,orolla,oung,pendulous,ruit,scar,short-styled,shorte,staminat,subsessile,tamen,tertiary,unarme,usually,vary,venation,visible,woody,ympodial	appearance,arrangement,border,branch,brown,bud,characteristic,colour,corolla,corrugation,exertion,form,geminate,giving,glabrousnes,growth,height,history,inflorescence,interjected,leaflet,life,lobing,long-acuminate,new,null,number,ovary,pseudostipule,seed,shape,size,stigma,sympodial,texture,thicknes,type,variation,width
398	wfo-0001030516	success	172	192	143	29	49	0.831	0.4-1.5,1-2.5,1-4,1-7,1.1-3.5,1.1-4.1,1.5-2,1.8-2.4,2-12,2-3,2-4,3-6,3-6-foliat,3-8,3-9.8,4-22,4-4,4-6,4-7,4.2-10.7,6-15,8-9,9-22,9-32,abaxially,acumen,acuminate,acute,adaxially,apex,apical,apically,articulate,base,branched,calyx,cell,cm,connate,cordate,corolla,covered,covering,cuneate,cyme,darker,decurrent,dehiscent,densely,diameter,dichasial,dichasially,diminished,distal,dorsally,ebracteate,edge,elliptical,exceeding,filament,first,flat,flower,folded,forked,generally,gland,globose,gradually,green,green-white,hair,hair-like,half,herbaceous,interjected,introrse,lateral,leaf,leaflet,light,lobe,long,long-attenuate,longer,make,maturing,mm,monochasial,mucilaginous,oblique,odd-pinnate,often,outline,ovate,ovoid,pair,pedicel,peduncle,pentagonal,perennial,perfect,petiole,pilose,plant,poricidally,proximal,puberulent,pubescent,rarely,rotate,second,seed,sessile,seudostipule,short,short-petiolate,short-stalked,size,slightly,slit,sometimes,spreading,stamen,stigma,straight,stripe,style,terminal,testal,thick,throughout,toward,triangular,tuber-bearing,type,typically,unit,wall,wide,yellow,Â¼,â	1.7,2-2.,digestion,eaf,eed,emoval,enzyme,globo,honeycomb,less,living,lon,lower,lunat,nflorescence,nther,orolla,pattern,plan,reveal,ruit,specimen,tal,tem,time,triangulat,vary,whit,ympodial	2-21,anther,appearance,arrangement,border,branch,bud,characteristic,colour,corrugation,drying,exertion,form,fruit,fruiting,giving,glabrousnes,growth,height,history,inflorescence,length,life,lobing,lunate,margin,midpoint,new,null,number,ovary,per,prickle,primary,pseudostipule,ray,shape,stem,surface,sympodial,tall,texture,thicknes,tube,variation,vein,wet,white,width
399	wfo-0001030551	exception_thrown	167	0	0	167	0	0.0		-12,-30,-5,0-2,0.5-1,0.6-1.5,1,1-,1-10,1-2,1-2.5,1-3.5,1-4,1-5,1.5-,1.5-2.5,10-20,10-40,13.,2,2-3,2-6,2.5-4,2.5-5,20-25,3-,3-12,3-5,3-8,4-,4-5,4-7,4-foliat,5-17,5-6,9-20,abaxially,abruptly,absent,acuminate,acute,adaxially,adpressed,aggregate,also,apart,ape,apex,articulated,axe,basal,base,beyond,bilobe,blade,blue,broad,calyx,campanulate,cell,chartaceous,clavate,cm,color,concave,connective,cordate,densely,dia,diameter,dilated,directed,distally,eaf,ed,ellipsoidal,entire,equal,et,exceeding,exserted,fading,fleshy,flower,fruit,glabrous,glandular-puberulent,globose,hair,lanceolate,laterally,leaving,lobe,lon,long,lower,margin,martinelli,mm,moderately,narrow,narrowed,narrowly,nflorescence,nther,oblong-fusiform,obtuse,often,orolla,ovate,ovate-elliptic,ovoid,papillose,pedicel,pedicellar,peduncle,perfect,petiole,pilose,pore,puberulen,puberulent,puberulent-pubescent,pubescent-pilo,pubescent-pilose,rachi,radiu,remnant,ripe,round,ruit,seen,shorter,shrub,simple,slightly,small,spaced,sparsely,stamen,stellate,stigma,stone,style,subcoriaceous,tal,tem,thecae,time,tip,tomento,triangular,triangular-elliptic,truncate,tube,ud,unbranched,unit,unknow,unknown,vary,violet,wide,widening,x,yellowish,ympodial	
400	wfo-0001030570	success	173	172	117	56	55	0.676	-1,.3-0.5,0-,0.3-0.5,1-,1-1.5,1-3,1-4,1-5,1-8,1.5,1.5-2.5,1/2,10-17,10-25,15-35,2-3,2-4,2-5,2-7-lobed,2-8,2.5-22,20-30,3-10,3-5,3-6,3.5-5,4-25,4-5,4-7,4/5,5-,abaxially,acuminate,acute,adaxially,apart,apex,apiculate,basal,base,beyond,calyx,cm,color,connivent,cordate,cylindrical,diameter,dilated,distally,divided,eglandular,ellipsoidal,elliptic-oblong,entire,exserted,flattened,flower,forked,fruit,glabrous,glandular-puberulent,globose,green,hair,lanceolate,leaf,lobe,lobed,long,margin,midrib,mm,narrowly,obtuse,occasionally,often,ovate,ovoid,pedicel,peduncle,petiole,pilose,pinnately,pubescent,purplish,rarely,ripe,rounded,rugose,simple,slightly,small,sometimes,sparsely,stamen,stigma,style,subcoriaceous,submarginally,time,tip,tree,triangular,truncate,tube,unbranched,unequal,unit,unknown,unlobed,vein,white,wide,x,yellow	0.5-,0.5-1,1,1-2,15-20,2-2.5,2-7,4-foliat,8-,absent,aggregate,ape,articulated,axe,blade,campanulate,cell,connective,directed,eaf,eed,exceeding,fleshy,glabrat,leaving,lon,lower,near,nflorescence,nther,orolla,pedicellar,perfect,pilo,pore,presen,punctate,purpl,rachi,radiu,remnant,ruit,shorter,sinus,somewhat,spaced,stellate,stone,tal,tem,thecae,tomento,truncat,ud,vary,ympodial	4-foliate,anther,appearance,arrangement,bark,border,branch,bud,characteristic,colour,corolla,corrugation,distal,drying,exertion,filament,form,fruiting,giving,glabrousnes,growth,height,history,inflorescence,interjected,lateral,leaflet,length,life,lobing,midpoint,new,null,number,ovary,per,plant,prickle,primary,provided,pseudostipule,ray,seed,shape,size,stem,surface,sympodial,tall,terminal,texture,thicknes,type,variation,width
401	wfo-0001030581	success	187	198	159	28	39	0.85	.5,0.2â0.8,0.4â1.6,0.5,0.5â0.7,0.5â2.5,0.6â0.7,0.7â0.8,0.9â1,1,1-4-celled,1.2â1.5,1.8â8,1â2,1â2-celled,1â2.5,1â4-celled,2,20â50,2â3-celled,35â45,3â4,3â5,4.5â12,4â7,4â9,5â6,5â8,9,abaxial,acute,adaxial,adaxially,aggregate,along,angle,angled,anther,anthesi,apex,appressed,articulated,basal,base,becoming,berry,beyond,black,bright,calyx,capitate,cell,central,clustered,cm,cone,conical,corolla,decurrent,densely,denser,diameter,difoliate,drop,ellipsoid,elliptic,entire,exserted,filament,flattened-reniform,flower,free,fruit,fruiting,glabrous,globose,green,growth,halfway,herb,individual,inflorescence,intermodal,lacking,lateral,leaf,less,like,live,lobe,lobed,long,margin,markedly,maturity,minutely,mm,narrowly,near,new,occasionally,often,once-branched,outline,ovary,ovate,pair,papillate,pedicel,peduncle,pentagonal,per,petiole,pitted,plant,portion,primary,pubescent,purplish,reflexed,remaining,ridge,ripe,rounded,shallow,shiny,simple,slightly,somewhat,sparsely,spreading,stem,stigma,stone,straight,style,surface,tall,tangled,terete,testal,third,translucent,trichome,tube,turning,uniseriate,unit,upper,usually,vein,white,wide,winged,woody,yellow,yellowish,â15,â5	.3,0.4â0.6,5-merous,abaxially,apar,branched,eaf,eed,florescence,geminat,later,leave,lon,lower,minute,perfect,rachi,reflexe,ruit,scar,shorter,spaced,sprawlin,stellate,strongly,tem,ud,ympodial	appearance,arrangement,border,branch,bud,characteristic,colour,corrugation,distal,drying,exertion,form,geminate,giving,glabrousnes,height,history,interjected,leaflet,length,life,lobing,midpoint,null,number,prickle,pseudostipule,ray,seed,shape,size,sprawling,sympodial,terminal,texture,thicknes,type,variation,width
402	wfo-0001030583	success	166	174	132	34	42	0.795	.2,.5,0.1-0.5,0.2-1,0.3-1,0.4-2.7,0.5-1,0.7-4.5,0.8-1,0.9-3.5,1,1-1.5,1-8,1/2,2.5,2.5-3,2.5-9,3-4,3/4,4-6,5-6,5-7,abaxially,acute,adaxially,along,anther,anthesi,apex,bark,base,berry,calyx,cell,closely,cm,conical,corky,corolla,crisped,cultivar,cultivated,deep,deflexed,dendritic,densely,dia,dry,ellipsoid,elliptic,erect,filament,flattened-reniform,flower,form,fruit,fruiting,glabrous,globose,golden,green,immature,included,incrassate,irregular,lateral,leaf,like,lobe,lobed,long,long-rectangular,long-triangular,main,major,margin,midvein,minor,minutely,mm,narrowly,occasionally,often,older,opposite,orange-red,outline,ovary,overlapping,pair,pale,papillose,pedicel,petiole,pitted,planar,plant,pore,poricidal,prostrate,pubescent,ripe,rounded,scar,shaped,shrub,simple,size,small,small-capitate,soon,spaced,spathulate,stem,stigma,stout,style,surface,tall,tan,tear-drop,testal,tip,trichome,tube,uniseriate,vein,way,white,x,yellow,young	1-2,1.5-4,6-7,abaxial,ba,brow,dark,differing,difoliate,eaf,edicel,eed,enlarged,especially,free,frui,geminat,leave,live,lon,lower,nflorescence,papery,papillo,pericarp,portion,rest,ruit,specimen,thin,ud,unit,woody,ympodial	appearance,arrangement,border,branch,brown,bud,characteristic,colour,corrugation,diameter,distal,drying,exertion,giving,glabrousnes,growth,height,history,inflorescence,interjected,leaflet,length,life,lobing,midpoint,new,null,number,peduncle,per,prickle,primary,pseudostipule,ray,seed,shape,terminal,texture,thicknes,type,variation,width
403	wfo-0001030605	exception_thrown	144	0	0	144	0	0.0		.4,.5,0.1,0.3-0.5,1,1-4,1.5-2,1.5-5.5,1.7,1/3-1/2,12-19-flowered,2,2-3,2.5,5-12.5,7,abaxially,acute,adaxially,almost,along,anther,anthesi,apart,ape,apex,apical,area,attenuate,base,beginning,beneath,berry,branch,branched,brown,calyx,cinereous,cm,commonly,conical,coriaceous,corolla,covered,cylindrical,dark,deflexed,dendritic-echinoid,densely,dia,difoliate,dry,drying,eaf,edicel,eed,ellipsoid,entire,exerted,filament,free,fruiting,geminat,glabrate,glabrous,globose,gold,green,growth,inflorescenc,inflorescence,internodal,leaf,less,light,lobe,lobed,long,lower,margin,material,midrib,minutely,mm,nearly,new,nflorescence,obovate,obtuse,occasionally,olive,opposite,otherwise,ovary,ovate,overlapping,ovoid-reniform,papillate,papillosefruit,pedicel,peduncle,petiole,pitted,pore,poricidal,portion,pubescent,rarely,reflexed,revolute,rounded,scar,scattered,shaped,shiny,shrub,simple,slender,slightly,smooth,somewhat,soon,sparesly,sparsely,stigma,style,surface,tear-drop,thickened,tinged,tip,trichome,tub,tube,ud,unifoliate,unit,vein,way,white,woody,x,yellow,ympodial	
404	wfo-0001030624	success	170	182	139	31	43	0.818	.25,.5,0.5,0.5-1,0.5-1.5,0.9-1,1-3,1.2-1.8,1.2-2,1.5-2,2,2-10,2-3,2.5-5.5,25-40-flowered,3,3-3.5,3.5-4,4.5-8,6-13,7-9,acute,anther,anthesi,apart,apex,apiculate,attenuate,axil,bark,base,beginning,berry,branch,calyx,clavate,cm,corolla,decurrent,deflexed,dia,dimorphic,distal,ellipsoid,elliptic,end,erect,except,expanded,exserted,extreme,falcate,filament,flattened-reniform,free,fruiting,furcate,glabrate,glabrous,glandular,globose,green,hyaline,incrassate,large,later,lateral,leaf,lobe,lobed,long,longitudinally,main,major,margin,middle,midrib,minor,minutely,mm,narrowly,near,nearly,occasionally,older,one,opposite,ovary,pair,pale,papillose,pedicel,petiole,pitted,portion,prominent,puberulent,raised,remaining,scar,shining,short,shrub,simple,size,slender,slightly,small,somewhat,soon,spaced,square,stem,stigma,straight,style,surface,tall,tapering,three,tip,tree,trichome,trunk,tube,tuft,two,unevenly,uniseriate,vein,white,widest,woody,x,yellow,yellowish,yellowish-green,yellowish-grey,young	appearing,ba,caly,cell,differing,difoliate,dry,eaf,edicel,eed,geminat,greyish,inflorescenc,like,lon,lower,material,nflorescence,outer,planar,pore,poricidal,round,rugo,ruit,thickened,ti,ud,unit,wall,ympodial	appearance,arrangement,border,bud,characteristic,colour,corrugation,diameter,drying,exertion,form,fruit,giving,glabrousnes,growth,height,history,inflorescence,interjected,leaflet,length,life,lobing,midpoint,new,null,number,peduncle,per,plant,prickle,primary,pseudostipule,ray,rugose,seed,shape,terminal,texture,thicknes,type,variation,width
405	wfo-0001030638	success	177	169	128	49	41	0.723	0.1,0.5,0.5-0.7,0.5-1,0.5-1.5,0.5-2,0.7-1.5,1-1.2,1-1.5,1-2,1.4-1.7,1.5-2,1.6-2.2,2-3,2-5,2-7-flowered,3-10,3-13,4-6,8,8-11,8-9,acute,along,anther,anthesi,apex,apically,axi,bark,base,beneath,berry,branched,broadly,bud,calyx,cm,corolla,cucullate,cup-shaped,deltoid,densely,dia,difoliate,elliptic,exfoliating,filament,flattened,fruit,fruiting,geminate,glabrate,glabrous,glandular,globose,green,impressed,inflorescence,known,later,lateral,leaf,less,like,lobe,lobed,long,main,margin,middle,minutely,mm,nearly,obovate,occasionally,often,older,open,opposite,ovary,pair,pale,paler,papillae,papillose,pedicel,persistent,petiole,planar,pore,poricidal,red,red-glandular,reddish,roundish,rugose,seed,shape,shaped,shrub,simple,size,soon,stem,stigma,style,surface,tall,tapering,tear-drop,terminal,thick,thickened,thickening,tip,transversely,tree,trichome,tube,uniseriate,unit,usually,vein,white,widest,x,young	2.5-4,appear,appearing,axil,ba,beginning,blade,closely,conspicuously,corky,deflexed,differing,dry,eaf,eed,entire,erect,extending,fleshy,free,geminat,gre,irregular,lamina,large,lon,lower,major,material,minor,near,nflorescence,one,overlapping,ovoi,papillo,portion,present,prominent,rather,rest,ruit,scar,spaced,speciman,straight,wall,woody,ympodial	appearance,arrangement,border,branch,characteristic,colour,corrugation,diameter,distal,drying,exertion,form,giving,glabrousnes,grey,growth,height,history,interjected,leaflet,length,life,lobing,midpoint,na,new,number,ovoid,peduncle,per,plant,prickle,primary,pseudostipule,ray,sympodial,texture,thicknes,type,variation,width
406	wfo-0001030661	success	183	174	135	48	39	0.738	-24,.2,.5,0,0.5-0.6,0.5-0.75,0.5-2,0.7-0.8,1-,1-1.2,1-1.3,1-1.4,1-1.5,1.2-7,1.5-2,1.5-7,12-16,2-,2-2.5,3-20,3-3.5,4-15,5-5.5,50-100+,acute,along,anther,anthesi,apex,attenuate,base,berry,branched,brown,calyx,capitate,cell,cm,conical,connivent,corolla,deltate,densely,denser,diameter,drying,ellipsoid,elliptic,entire,erect,exserted,extending,filament,flattened,flower,fruiting,glabrescent,glabrous,globose,growth,inflorescence,insertion,lamina,lateral,leaf,lobe,lobed,long,loosely,lower,many,margin,mature,midrib,minute,minutely,mm,narrowly,near,new,occasionally,older,onto,pair,pale,pedicel,peduncle,per,pericarp,petiole,pitted,point,primary,pubescent,rectangular,red,reddish,reniform,scattered,shiny,shrub,simple,slender,slightly,small,sparsely,stem,stigma,strongly,style,surface,tangled,terminal,testal,thin,time,tinged,tip,tree,trichome,tube,uniseriate,upper,usually,vein,violet,way,white,winged,woody,x,yellow,yellowish,Â½,Â¾	1-.,3-4,4-6,5-10,5-merou,ag,alyx,ark,articulated,branch,brow,clustered,dar,eaf,eed,em,erec,free,glabrou,group,ilament,lengthening,lon,membranous,never,nflorescence,nodding,orolla,otherwise,papillo,perfect,planar,platform,plurifoliat,pore,poricidal,portion,ruit,scar,sleeve,slit,spreading,stellate,twinin,ud,unit,vary,ympodial	1-5,appearance,arrangement,bark,border,bud,characteristic,colour,corrugation,dark,distal,exertion,form,fruit,giving,height,history,interjected,leaflet,length,life,lobing,mentioned,midpoint,number,ovary,papillose,plant,prickle,pseudostipule,ray,seed,shape,size,texture,thicknes,type,variation,width
407	wfo-0001030676	success	220	202	157	63	45	0.714	-2.5,-3.9,-8.5,0-100,0.4,1,1-1.2,1-3,1.1-1.4,1.2-1.3,1.3-1.5,1.7-2,1/4,14-17,16,19-35,2.1-2.6,2.2-5.7,3-3.5,3-6,4-6,4-6.5,7-8,7-9,8-10,8-12,abaxially,abruptly,acute,adaxially,angled,anther,anthesi,apart,apex,appearing,appressed-tomentose,articulated,axillary,bark,base,becoming,berry,blade,blunt-tipped,branch,branched,brown,bud,calyx,chartaceous,closely,cm,conical,continued,corolla,crown,cylindrical,deltoid,densely,diameter,dichotomously,due,echinoid,elongate,entire,exserted,filament,finely,flat-topped,fleshy,flower,forming,fruit,glabrous,globose,granular-tomentose,green,greenish,grooved,growth,hair,honeycombed,horizontal,lamina,lateral,leaf,length,lobe,lobed,long,longitudinally,main,margin,midvein,minutely,mm,moderately,mostly,multangulate,oblique,oblong,oblong-elliptic,obtuse,often,older,openly,ovate-lanceolate,parallel,pedicel,peduncle,petiole,plurifoliate,probably,pseudo-terminal,pulverulent,ray,reniform,reticulate-punctate,ripe,scabrous,sessile,short-attenuate,short-stalked,shrub,side,simple,small,somewhat,spaced,spreading,stellate-pubescent,stem,stigma,strongly,style,subcampanulate,subglobose,suborbicular,tending,terete,time,tomentose,tree,tube,unit,usually,vein,velutinous,way,white,whitish,wide,x,yellow,yellowish,young	-1.6,/10-1/5,0.6-1.2,1.1-1.9,11-14,2.1-2.3,2.4-3.1,2.5-5.5,2.75-3.25,3-5,7-10,along,apical-lateral,apparently,ba,dehiscing,eaf,echinoi,eed,except,free,glabrescen,glabrescent,high,initially,inserted,introrse,lackin,large,lengthen,lined,longitudinal,lower,midvei,minute,nearly,nflorescence,occasional,opening,orolla,ovate,perfect,pore,pubescent,rachi,rather,ridged,ruit,runk,scattered,slit,sparsely,stellate,subcapitat,tamen,testa,thick,thin,tip,tuft,unarme,vary,ympodial	appearance,arrangement,border,characteristic,colour,corrugation,distal,drying,exertion,form,fruiting,giving,glabrousnes,height,history,inflorescence,interjected,lacking,leaflet,life,lobing,midpoint,new,null,number,ovary,per,plant,prickle,primary,pseudostipule,seed,shape,size,subcapitate,surface,sympodial,terminal,texture,thicknes,trunk,type,unarmed,variation,width
408	wfo-0001030686	success	182	184	144	38	40	0.791	.2,.5,0.5-1,1-1.1,1-1.2,1-1.5,1-2,1.2-1.5,1.5-2,1.5-4.5,1.6-3,15,2-2.5,2-3,2-6.5,2.5-4,2.5-8,3-3.5,5-12,5-25,5-30,5-6,8-9,abruptly,acuminate,acute,age,anther,anthesi,apart,apex,bark,basal,base,beneath,berry,bifid,black,branched,brown,c.,calyx,centre,cm,conical,corolla,cup-shaped,dark,darker,deeply,densely,denser,diameter,different,difoliate,discolorous,drying,elliptic,entire,erect,exerted,filament,flattened,flower,form,free,fruit,fruiting,globose,golden,half,height,heteromorphic,internodal,lamina,leaf,leaf-opposed,lengthening,lepidote,less,lilac,lobe,lobed,long,margin,maturity,midrib,minutely,mm,oblique,older,orange,ovary,overlapping,pair,pale,paler,papillose,pedicel,peduncle,petiole,pitted,planar,plant,pore,poricidal,portion,primary,pubescent,purple,rachi,scarious,seed,shallow,shallowly,shiny,short,simple,slightly,slit,somewhat,spaced,sparsely,spreading,stem,stigma,strongly,style,surface,time,tip,tissue,tree,trichome,tube,uniformly,unit,usually,vein,visible,way,woody,x,yellow	.5-1,1972,?,abaxially,aborted,adam,adaxially,breast,brittle,bu,closely,dry,eaf,edicel,eed,empty,fide,fragrant,geminat,glabrescen,glabrous,lower,many,midvein,nflorescence,noddin,papillae,pericarp,pubescen,ruit,scar,space,stellate,styl,thin,ud,ympodial,â	appearance,arrangement,border,branch,bud,characteristic,colour,corrugation,distal,exertion,geminate,giving,glabrescent,glabrousnes,growth,history,inflorescence,interjected,lateral,leaflet,length,life,lobing,mentioned,midpoint,new,number,per,prickle,pseudostipule,ray,shape,size,sympodial,terminal,texture,thicknes,type,variation,width
409	wfo-0001030709	success	217	225	186	31	39	0.857	-2,-5,-9,0,0-20,0-30,0.1-0.2,0.15-0.5,0.2-0.5,0.3-1.5,0.4,0.7-1,0.8-4,0.9-1.5,1-1.2,1-1.6,1-4.5,1-6,1.3-1.4,1.4-2,1.6-2.1,1.9-2.8,1/2-2/3,1/3-1/2,1/4,10-14,2-4,2-5,2-6,2.3-3,2/3-3/4,3-,5-10,5-20,5-6,5-7,5-9,6-10,6-21,6-7,6-8,7-8,7-9,8-11,8-15,abaxially,acuminate,acute,almost,ame,anther,apart,apex,apically,apparently,articulated,bark,base,berry,blade,branched,bright,broad-deltate,c.,calyx,chartaceous,cm,conical,connivent,cordate,cuspidate,deltate,diameter,discolorous,distance,drying,dull,edge,elliptic,elongating,equal,erect,extending,filament,finely,flattened-reniform,flower,free,fruit,fruiting,glabrescent,glabrous,increasing,inflorescence,infructescence,lanceolate,lateral,leaf,length,lobe,lobed,lobing,long,longer,margin,mature,maturity,mauve,middle,midpoint,midvein,mm,moderately,narrow-deltate,often,older,one,open,orange-brown,pair,pedicel,peduncle,pendulous,per,pericarp,perpendicular,petiole,pit,pitted,poricidal,porrect,portion,prickle,prickly,primary,purple,ray,red-green,red-orange,reflexed,retrorse,rounded,scar,secondary,seed,shorter,shrub,side,simple,size,slender,smooth,sometimes,spaced,sparsely,spherical,spreading,stalk,stalked,stellate,stellate-pubescent,stem,straight,style,surface,tapering,terete,terminal,time,tip,toward,trichome,truncate,tube,unarmed,unit,upper,variously,vein,venation,way,weakly,wide,woody,yellow,yellow-green	0-,1/4-1/3,10-50,2-8,4-5-merous,adaxially,alyx,apar,ape,brow,eaf,eed,lengt,lon,long-acuminat,lower,nflorescence,occasionally,orolla,oung,perfect,plurifoliat,prickl,ruit,short-styled,tamen,tertiary,usually,vary,visible,ympodial	appearance,arrangement,border,branch,brown,bud,characteristic,colour,corolla,corrugation,distal,exertion,form,giving,glabrousnes,growth,height,history,interjected,leaflet,life,long-acuminate,new,null,number,ovary,plant,plurifoliate,pseudostipule,shape,stamen,stigma,sympodial,texture,thicknes,type,variation,width,young
410	wfo-0001030714	success	178	195	149	29	46	0.837	-3,.2,.5,/3,0.1-0.3,0.5,0.5-0.8,0.5-1.9,0.7-0.8,1-1.2,1-1.3,1-1.5,1-2.5,1.2-1.5,1.2-4,1.4-3.5,1/3,2-2.5,2-2.6,20,3-3.5,3-7,5-100,5-6,7-17,>,acuminate,acute,adaxially,age,along,anther,anthesi,apex,articulating,bark,basal,base,becoming,beneath,berry,blue,blue-black,branching,calyx,clavate,cm,conical,cordate,corolla,cup,dark,denser,diameter,ellipsoid,elliptic,entire,especially,except,exserted,filament,flattened,flower,free,fruit,glabrous,globose,grading,gradually,greyish,growth,herbaceous,joined,leaving,lengthening,liana,like,lobe,lobed,long,many,margin,membranous,midrib,minute,minutely,mm,narrow,narrowly,new,nodding,node,ob-ellipsoid,ob-elliptic,oblique,older,ovary,overall,pair,pale,paler,papillate,pedicel,peduncle,peg,per,petiole,pitted,pore,poricidal,portion,primary,prominent,pubescent,quadrate,reniform,ripe,scar,shape,simple,slightly,slit,spaced,sparsely,stellate,stem,stigma,strongly,style,submarginal,surface,tapering,terminal,thickened,time,tip,trichome,truncate,tube,uniseriate,unit,vein,vine,violet,way,widely,woody,x,yellow	0.3-0.4,0.8-1,1.5-2,abaxial,abaxially,aid,apar,campanulate,climbin,densely,eaf,eed,fide,gree,howard,leaf-opposed,lower,nflorescence,occasionally,papillat,pedice,perfect,planar,plurifoliat,ruit,tub,twining,ud,ympodial	2,2.5,apart,appearance,arrangement,border,branch,bud,characteristic,colour,corrugation,distal,drying,exertion,form,fruiting,giving,glabrousnes,green,height,history,inflorescence,interjected,lateral,leaf,leaflet,length,life,lobing,mentioned,midpoint,null,number,plant,plurifoliate,prickle,pseudostipule,ray,seed,size,sympodial,texture,thicknes,type,variation,width
411	wfo-0001030733	success	130	152	105	25	47	0.808	.5,/4,0.5-1,1-1.2,1-1.5,1-2,1.5-5,1.7-2.7,2-2.5,3-4,3-5,4-15,4.5-5,5-8-flowered,6-7,6-9,?,abaxially,acuminate,acute,adaxially,along,anther,anthesi,apex,bark,base,berry,bi-lobed,broadly,brown,calyx,capitate,cm,conical,corolla,dark,decurrent,deltate,densely,denser,dia,ellipsoid,elliptic,elongate,erect,exserted,filament,free,fruiting,glabrous,globose,green,lamina,later,lateral,leaf,like,lobe,lobed,long,main,margin,middle,minutely,mm,moderately,narrowly,onto,opposite,ovary,ovoid-reniform,pair,pedicel,petiole,planar,pore,poricidal,portion,pubescent,rounded,shaped,shrub,simple,smooth,somewhat,stem,stigma,strongly,style,surface,tall,tear-drop,tip,treelet,trichome,tube,uniseriate,vein,way,white,widest,woody,x,young	ape,clearly,closely,coriaceous,eaf,eed,embryo,grayish-brow,lon,lower,nflorescence,older,overlappin,papillo,ruit,scar,spaced,sparsely,testa,thick,ud,unifoliat,unit,visible,ympodial	appearance,arrangement,border,branch,bud,characteristic,colour,corrugation,diameter,distal,drying,exertion,form,fruit,giving,glabrousnes,grayish-brown,growth,height,history,inflorescence,interjected,leaflet,length,life,lobing,midpoint,new,null,number,papillose,peduncle,per,plant,prickle,primary,pseudostipule,ray,seed,shape,size,terminal,texture,thicknes,type,variation,width
412	wfo-0001030772	success	155	167	128	27	39	0.826	-2,.2,.25,.5,0.2-0.8,0.25-0.5,0.5-1,0.75-1,0.9-1,0.9-3.1,1-2,1-2.5,1.2-5,1.4-1.6,1.5-2,2-7,3-3.5,3-5,4.2-6.5,5-10-flowered,5-6,8-10,9-15,acuminate,anther,anthesi,apex,attenuate,bark,base,becoming,beginning,beneath,berry,branch,bud,calyx,capitate,closely,cm,corolla,dark,deflexed,dia,ellipsoid,elliptic,erect,extreme,filament,free,fruit,fruiting,gently,glabrous,globose,green,grey,impressed,large,later,lateral,leaf,lenticellate,lobe,lobed,long,long-acuminate,long-triangular,main,major,margin,methyl,minor,minutely,mm,nearly,node,occasionally,older,opposite,ovary,overlapping,ovoid-reniform,pair,pale,paler,papillose,pedicel,per,petiole,pitted,pore,poricidal,portion,prominent,ripe,salicylate,scar,shape,shaped,shining,shrub,simple,size,slender,slightly,smelling,soon,spaced,stem,stigma,straight,strongly,style,surface,swollen,tall,tan,tapering,tear-drop,tip,tube,vein,white,wintergreen,woody,x,young	.05,acute,archin,ba,differing,difoliate,eaf,edicel,eed,geminat,inflorescenc,lon,lower,middle,nflorescence,one,papillo,reflexed,rounded,ruit,trichome,ud,uniseriate,unit,usually,widest,ympodial	3,appearance,arching,arrangement,border,characteristic,colour,corrugation,diameter,distal,drying,exertion,form,giving,glabrousnes,growth,history,inflorescence,interjected,leaflet,length,life,lobing,midpoint,new,null,number,peduncle,prickle,primary,pseudostipule,ray,seed,terminal,texture,thicknes,type,variation,width
413	wfo-0001030781	success	213	198	154	59	44	0.723	0-5,0.2-4,0.5-6,0.5-8,1-1.5,1-10,1-12,1-2,1-4,1-8,1.5-12,1.5-2,1.5-9,1.6-2.2,10-40,15-35,2-20,2.5-14,2.5-3.5,3-4,4-15,5-6,5-7,5-8,6-7,7.5-9,abaxially,abruptly,acumen,adaxially,anther,apart,apex,apiculate,apparently,articulated,axe,axillary,base,berry,blade,borne,broadly,brown,brownish,bud,cell,chartaceous,ciliate,cm,condition,corolla,covering,cuneate,dark,decurrent,deep,densely,diameter,distal,dot,drying,elliptic,end,erect,especially,filament,finely,flower,forked,fresh,fruit,generally,glabrous,glandular,globose,gray-green,green,greenish,hair,half,herb,high,interjected,lanceolate,lateral,leaf,leaflet,light,like,lobe,long,make,margin,membranous,mm,mucilaginous,narrowed,obovate,odd-pinnate,orbicular,ovate,ovate-lanceolate,ovoid,papillose,pedicel,peduncle,perfect,petiole,petiolulate,pilose,plant,plurifoliate,pointed,pubescent,purple,rachi,rarely,rounded,scattered,seed,sessile,short,simple,singly,size,slightly,small,sometimes,somewhat,spaced,sparsely,stem,stigma,style,subovoid,subtending,terminal,testal,thick,tip,tri-,tube,tuber,typically,unwinged,usually,violet,wall,wet,white,whitish,wide,x	2-3,3-6,5-merou,ag,along,alyx,caly,capitat,connivent,decreasing,digestion,dorsally,eaf,edge,eed,enzyme,exceeding,flat,folded,geminat,glabrou,gradually,green-white,hair-like,homostylous,honeycomb-shaped,larger,lengthening,living,low-growin,lower,midrib,minutely,nflorescence,orolla,pair,pentagonal,pore,poricidal,puberulent,removed,rotate-pentagonal,ruit,seudostipule,slit,specimen,stamen,ste,stolo,straight,tall,tamen,tem,throughout,toward,unit,vary,yellow,ympodial	'hair-like,appearance,arrangement,bark,border,branch,calyx,capitate,characteristic,colour,corrugation,exertion,form,fruiting,geminate,giving,glabrousnes,growth,height,history,inflorescence,length,life,lobing,low-growing,mentioned,midpoint,new,number,ovary,per,prickle,primary,pseudostipule,ray,shape,stolon,surface,texture,thicknes,type,variation,vein,width
414	wfo-0001030782	success	198	180	133	65	47	0.672	0-1,0-7,0.4-1.5,1-2,1-3,1.2-3.9,1.3-1.6,1.5-2,1.5-7.5,1.6-4.6,12-30,13-22,15,2,2.2-4,2.4-11.5,3-10,4-11.6,4-6,5-20,6-8,7-15.6,abaxially,acumen,acuminate,acute,adaxially,along,anther,apex,apparently,arranged,asymmetric,attenuate,axe,axillary,base,basiscopic,bead,berry,broadly,brownish,bud,cell,clavate,cm,condition,coriaceous,corolla,covering,cuneate,dark,deep,diameter,distal,drying,elliptic,filament,flower,forked,fresh,fruit,generally,glabrescent,glabrous,globose,green,greenish,hair,half,herb,inconspicuous,interjected,lanceolate,lateral,leaf,leaflet,light,like,lilac,lobe,long,make,medium,mm,moniliform,mottled,mucilaginous,multiple,necklace,odd-pinnate,orbicular,ovate,ovoid,pedicel,peduncle,perfect,petiole,petiolulate,plant,plurifoliate,purple,ripe,rounded,scarce,seed,sessile,short,side,size,sometimes,stigma,stolon,style,subtending,terminal,testal,thick,tissue,totally,tri-,tube,tuber,typically,unit,usually,wall,wet,white,whitish,wide,winged,x	1-5,1-6,11-47,2-3,3-5,4.6-26,5-merou,abaxiall,ag,alyx,apart,articulated,blade,capitat,connivent,decreasing,digestion,dorsally,eaf,edge,eed,enzyme,exceeding,flat,folded,geminat,glabrou,green-white,hair-like,hal,high,homostylous,honeycomb-shaped,lengthening,living,lower,nflorescence,orolla,pair,pentagonal,pore,poricidal,prominently,rachi,removed,rotate,ruit,second,seudostipule,slit,smaller,spaced,specimen,stamen,straight,subequal,tal,tamen,tem,throughout,tip,toward,vary,yellow,ympodial	'hair-like,appearance,arrangement,bark,border,branch,calyx,capitate,characteristic,colour,corrugation,description,exertion,form,fruiting,geminate,giving,glabrousnes,growth,height,history,inflorescence,length,life,lobing,margin,mentioned,midpoint,new,number,ovary,per,prickle,primary,pseudostipule,ray,shape,stem,surface,sympodial,tall,texture,thicknes,type,variation,vein,width
415	wfo-0001030802	success	171	181	138	33	43	0.807	.3,.5,.5mm,0,0.5-0.75,0.5-1,0.5-1.5,0.7-1cm,0.75-1,0.9-1,1,1-1.1,1-1.2,1-1.5,2-2.5,2-3,2-5,2.5-3,3-3.5x,3-4,3-6,4-5mm,4-6,5-10-flowered,abrupt,acuminate,acute,anther,anthesi,apex,appearing,bark,basal,base,becoming,beneath,berry,brown,bud,calyx,cm,cordate,corolla,deeply,deflexed,densely,dia,difoliate,dry,ellipsoid,exerted,exudate,filament,filiform,flattened-reniform,free,fruit,fruiting,glabrous,gland,glandular,globose,halfway,hanging,heart-shaped,incrassate,internodal,invest,lamina,later,lateral,leaf,length,live,lobe,lobed,long,long-triangular,main,margin,markedly,material,minutely,mm,obconic,older,ovary,ovoid,pair,pale,palmate,papillate,pedicel,per,persistently,petiole,pitted,plant,pore,poricidal,portion,prominent,pubescent,raised,red,reddish,shaped,shrub,simple,single-celled,slender,somewhat,soon,specimen,stem,stigma,straight,strongly,style,subshrub,surface,tapering,tear-drop,tip,tipped,trichome,tube,unifoliate,uniseriate,unit,variable,vein,white,woody,x,yellow,yellowish,young	0.25-0.4,abaxially,adaxially,along,beginning,campanulate,cucullate,denser,eaf,edicel,eed,evenly,except,geminat,glandurla,inflorescenc,irregularly,line,lower,m.,midvein,near,nflorescence,papillose,pubescen,ruit,scar,spaced,stigm,trichoem,ud,widely,ympodial	3-3.5,appearance,arrangement,border,branch,characteristic,colour,corrugation,diameter,distal,drying,exertion,form,geminate,giving,glabrousnes,growth,height,history,inflorescence,interjected,leaflet,life,lobing,midpoint,new,null,number,peduncle,prickle,primary,pseudostipule,ray,seed,shape,size,sympodial,terminal,texture,thicknes,type,variation,width
416	wfo-0001030809	success	154	182	135	19	47	0.877	.5,0.2,0.5-1,1-1.25,1-1.5,1.2-1.4,1.4-1.5,1.5-2.4,1.5-3.5,2-2.5,2.3-5.5,20-60-flowered,4.5-5,5-8,6-8,8,9.9-12,acute,along,also,anther,anthesi,apex,appearing,bark,base,beneath,berry,branched,broadly,calyx,campanulate,clavate,cm,corolla,curl-tipped,curved,deciduous,deflexed,deltoid,dense,densely,dia,difoliate,distally,ellipsoid,elliptic,especially,evenly,exserted,falcate,filament,free,fruit,fruiting,glabrous,globose,golden,green,hair,hidden,interpetalar,known,large,lateral,leaf,like,lobe,lobed,long,long-papillose,main,major,markedly,mature,membranous,middle,midrib,minor,minutely,mm,nearly,older,one,opposite,ovary,ovate,overtopping,pedicel,petiole,planar,pore,poricidal,portion,present,pubescent,round,scattered,several,shining,shoot,simple,sinus,size,slender,slightly,small,soon,spaced,stem,stigma,straight,style,tall,tapering,terminal,three,time,tip,tomentose,tree,triangular,trichome,tube,two,underside,unequal,uniseriate,vein,white,wide,widest,x,yellow-brown,young	across,apar,caly,dark-papillo,eaf,edicel,eed,erect,geminat,leave,lon,lower,nflorescence,ruit,scar,shinin,ud,unit,ympodial	apart,appearance,arrangement,border,branch,bud,characteristic,colour,corrugation,dark-papillose,diameter,distal,drying,exertion,form,geminate,giving,glabrousnes,growth,height,history,inflorescence,interjected,leaflet,length,life,lobing,margin,midpoint,new,null,number,peduncle,per,plant,prickle,primary,pseudostipule,ray,seed,shape,surface,texture,thicknes,type,variation,width
417	wfo-0001030810	exception_thrown	191	0	0	191	0	0.0		0.2,0.2â0.3,0.3,0.4,0.5â,0.5â0.8,0.6â1.0,0.7â1.4,0.8â5.5,0.95â2.0,0â,1,1.0â1.5,1.0â2.0,1.0â3.0,1.1â2.0,1.1â2.2,1.2â1.5,1.5â1.9,1â2,1â3,1â5,2.9â4.5,20â100,2â3,2â4,3.0â5.0,3.3â5.5,3.3â8.5,3.5â4.6,3â19,4â14,4â5,4â7,5,5â15,5â30,5â32,6â10,6â22,7â10,7â11,8â10,abaxially,absen,accrescent,acute,adaxiall,adaxially,ag,along,anther,anthesi,apart,apex,articulated,axe,axillary,ba,base,bipinnate,blade,blue,borne,branched,brown,calyx,cell,chartaceous,clavate,cm,colour,connivent,cylindrical,dark,decreasing,densely,denser,diameter,divided,eaf,eed,elliptic,elliptical,equal,erect,especially,filament,flattened,fleshy,flower,fruit,geminat,glabrous,globose,green,greyish,hair,half,hig,indumentum,irregular,leaf,leafy,lobe,lon,long,longitudinal,lower,m.,margin,midrib,midvein,mm,moderately,multicellular,narrow,nflorescence,oblong,obtu,occasionally,older,opening,opposed,orolla,oung,pair,pale,pedicel,peduncle,pentagonal,perfect,petiole,pinnae,pinnate,pitted,plurifoliate,pore,poricidal,primary,pubescent,rarely,reflexed,rounded,ruit,secondary,shallowly,shaped,shiny,shoot,shrub,side,simple,size,slit,sometimes,spaced,sparsely,stem,stigma,stone,straight,style,subglabrous,surface,tamen,tardily,tear-drop,time,tip,tomentose,tube,unicellular,uniseriate,unit,unknown,vary,violet,white,wide,wing,woody,x,yellow,ympodial,â2.5,â3,â3.4,â4.5,â5.0,â8	
418	wfo-0001030822	exception_thrown	146	0	0	146	0	0.0		.2,0-0.5,0.1-0.2,0.4,0.4-1,0.5-1.5,0.8-1,0.9-1,1-1.2,1-1.5,1.5-2,11-15.5,2-2.5,2-3.8,2-5,3-3.5,3-5,3.5-7,5-6,5-7,8-9,abaxially,acute,adaxially,anther,anthesi,apex,attenuate,ba,base,beneath,berry,broadly,calyx,clavate,closely,clustered,cm,completely,corolla,cucullat,cucullate,cup,decurrent,deflexed,deltate,dia,differing,difoliate,eaf,edicel,eed,elliptic-obovate,erect,exserted,filament,filiform,flattened-reniform,fleshy,flower,free,fruiting,geminat,glabrous,globose,green,incrassate,inflorescenc,inflorescence,internodal,later,lateral,leaf,lobe,lobed,lon,long,long-ellipsoid,lower,main,major,margin,middle,minor,minute,minutely,mm,near,nearly,nflorescence,occasionally,older,onto,open,opposite,ovary,pair,pale,papillo,papillose,pedicel,perhaps,petiole,pitted,planar,pore,poricidal,portion,present,red-papillose,revolute,ruit,scar,shaped,shiny,shrub,simple,size,slightly,somewhat,spaced,sparsely,stem,stigma,strongly,style,surface,tall,tan,tapering,tear-drop,tip,tube,ud,unit,usually,vein,white,widest,winged,woody,x,yellowish,yellowish-brown,ympodial,young	
419	wfo-0001030871	success	248	240	201	47	39	0.81	.2-3,.8-3.5,/30-1/5,0-120,0.2-0.4,0.3-4,0.4-1.8,0.6-1.5,0.7-1.3,0.7-2.5,1-1.3,1-18,1.3-2,1.3-3,1.4-2.7,1.5-3,1.5-6,1.8-2.6,1.8-3.5,1/2,1/2-3/4,1/4,1/4-1/3,11,2-3,2-8,2.8-4.5,3-32,3-4.4,3-5,3-6,3.5-14,30,4.5-6.5,4.8-9.5,5-33,5-7,6-40,9-13,abaxially,abruptly,acuminate,acute,adaxial,adaxially,along,anther,anthesi,apart,apex,appressed,appressed-tomentose,articulated,attenuate,axe,axillary,bark,base,becoming,berry,blade,blunt-tipped,branch,branched,brown,bud,calyx,campanulate,chartaceous,closely,cm,conical,continued,corolla,dark,decurrent,deltoid,dendritic-echinoid,dendritic-multangulate,densely,diameter,distal,due,early,echinoid,elliptic,elongate,entire,equal,erect,evident,exserted,filament,fleshy,flower,fruit,fruiting,glabrescent,glabrous,granular-tomentose,grayish,green,greenish,growth,hair,honeycombed,lateral,leaf,length,lobe,lobed,long,long-,long-stalked,longer,main,margin,midvein,minute,mixed,mm,mostly,multangulate,narrowly,nearly,nodding,oblong,obtuse,occasionally,often,older,open,orbicular,ovate,ovate-lanceolate,overlapping,pale,partly,pedicel,peduncle,petiole,plurifoliate,porrect-stellate,present,probably,prominent,pubescent,purple,rachi,rather,ray,reflexed,relatively,reniform,reticulate-punctate,ripe,scabridulous,sessile,short,short-,short-stalked,shrub,side,simple,small,sometimes,soon,spaced,sparingly,splitting,stamen,stem,stigma,strongly,style,subglobose,suborbicular,sulcate,suture,terete,terminal,thick,thick-stalked,thin-stalked,time,tomentose,tree,tube,unarmed,unit,usually,vein,velutinous,violet,way,white,wide,x,yellow,yellowish,young	.9-1.2,7-12,accrescent,ag,apical-lateral,apparently,ba,capitat,dehiscing,dendritic-echinoi,directed,eaf,earl,echinoi,eed,extend,free,glabrescen,held,high,inserted,introrse,large,longitudinal,lower,m.,multangulat,nflorescence,orbicula,orolla,perfect,plait,pore,rotate-stellate,ruit,runk,slit,somewhat,sparsely,stellate-tomentose,striate,tamen,testa,toward,unarme,vary,ympodial	appearance,arrangement,border,capitate,characteristic,colour,corrugation,drying,exertion,form,giving,glabrousnes,height,history,inflorescence,interjected,leaflet,life,lobing,midpoint,new,number,ovary,per,plant,prickle,primary,pseudostipule,seed,shape,size,surface,sympodial,texture,thicknes,trunk,type,variation,width
420	wfo-0001030872	success	166	153	106	60	47	0.639	.5,0.5,0.8-1,0.8-2,1-1.2,1-1.5,1-2,1.2-1.5,1.2-3,1.5-2,1.5-5,12-18,2-5,3-7,4-6,4-6-flowered,5-6,5.5-7,6-12.5,acuminate,acute,anther,apex,area,bark,base,berry,black,broadly,brown,calyx,closed,cm,completely,consisting,corky,corolla,crateriform,dark,darker,deltoid,dry,ellipsoid-ovoid,elliptic,exserted,filament,fleshy,fruiting,glabrate,glabrous,globose,green,hooded,known,large,leaf,lenticel,less,lobe,lobed,long,major,margin,minor,minutely,mm,nearly,nerve,oblique,older,one,opposite,ovary,ovate,pair,papillose,pedicel,petiole,pore,poricidal,primary,prominent,puberulent,raised,red-glandular-puberulent,reddish-glandular,rest,shaped,shining,simple,size,small,soon,specimen,stem,stigma,strongly,style,tear-drop,tip,tree,treelet,tube,white,x,young	0.5-1,adaxial,age,along,anthesi,appearing,beginning,caly,center,closely,cucullate,deflexed,densely,dia,difoliate,eaf,edicel,eed,erect,free,full,geminat,incurved,inflorescenc,lenticellate,like,live,lon,lower,material,middle,nflorescence,overlapping,pale,paler,petal,planar,portion,proximal,rather,reddish-glandular-puberulent,relative,ridge,rounded,ruit,scar,shorter,side,slightly,spaced,straight,styl,tall,tapering,thickened,ud,unit,widest,woody,ympodial	appearance,arrangement,border,branch,bud,characteristic,colour,corrugation,diam,diameter,distal,drying,exertion,form,fruit,giving,glabrousnes,growth,height,history,inflorescence,interjected,lateral,leaflet,length,life,lobing,mentioned,midpoint,new,number,peduncle,per,plant,prickle,pseudostipule,ray,seed,shape,surface,terminal,texture,thicknes,type,variation,vein,width
421	wfo-0001030882	success	144	146	103	41	43	0.715	.1,.5,0.5-0.75,0.5-1,0.5-1.1,0.8-1.1,0.8-2.4,0.9-1.1,1-1.3,1-1.5,1-4,1.6-2,2,2-5.4,2-6,2.2-4.6,3-3.5,3/4,6.5-15.6,acuminate,anther,anthesi,apex,attenuate,bark,base,beneath,berry,calyx,capitate,cm,conical,corolla,crenulate,dia,elliptic,exserted,extreme,filament,free,fruit,fruiting,glabrous,globose,green,lateral,leaf,lightly,lobe,lobed,long,major,margin,minor,minutely,mm,narrowly,nearly,occasionally,older,opposite,ovary,ovoid,ovoid-reniform,pale,paler,papillose,pedicel,petiole,pitted,portion,prominent,raised,ruguse,shrub,simple,size,slender,slightly,small,soon,stem,stigma,straight,style,surface,tall,tan,tapering,terminal,thick,thickened,tip,transversely,tree,truncate,tube,vein,way,white,x,yellowish,young	0.75-1,8-12,?,accrescent,beginning,closely,deflexed,deltoid,differing,difoliate,eaf,edicel,eed,erect,geminat,inflorescenc,lon,lower,main,middle,nflorescence,one,overlapping,pair,papillo,peelin,planar,pore,poricidal,ruit,scar,shaped,short,spaced,tear-drop,tub,ud,unit,widest,woody,ympodial	appearance,arrangement,border,branch,bud,characteristic,colour,corrugation,diameter,distal,drying,exertion,form,giving,glabrousnes,growth,height,history,inflorescence,interjected,leaflet,length,life,lobing,midpoint,new,null,number,peduncle,peeling,per,plant,prickle,primary,pseudostipule,ray,seed,shape,texture,thicknes,type,variation,width
422	wfo-0001030883	success	179	189	145	34	44	0.81	-3,.05,.1,.5,0.5-3,0.5-5,1-1.1,1-1.2,1-1.3,1-1.5,1-4,1.5-2,1.5-3.5,10-18,18-44.5,2-5,20-50-flowered,3-3.5,3-4,3/4,5-6,9.5-27.5,accrescent,acuminate,acute,anther,anthesi,apex,arching,bark,base,becoming,berry,brown,calyx,cell,clavate,cm,collapsed,corolla,dark,deflexed,dia,difoliate,dry,elliptic,epidermal,filament,finely,fleshy,free,fruit,fruiting,furcate,geminate,glabrous,glandular,globose,green,hard,hollow,imbedded,inflorescence,laminar,large,later,lateral,leaf,less,like,live,lobe,lobed,long,long-acuminate,main,malodorous,massive,material,midrib,minute,minutely,mm,narrowly,oblique,occasionally,older,opposite,ovary,ovate,ovoid-reniform,pair,pale,papillate,papillose,pedicel,perpendicular,petaloid,petiole,pitted,placenta,plant,pore,poricidal,portion,present,puberulent,quite,reflexed,reticulate,russet,seed,shaped,shrub,size,slender,slightly,sometimes,soon,stem,stigma,stout,straight,strongly,style,surface,tall,tan,tapering,tear-drop,thick,time,tip,triangular,trichome,tube,uniseriate,upper,vein,wall,way,white,woody,x,young	across,apart,appearing,approximatately,branched,bu,collection,differing,eaf,edicel,eed,erect,evenly,geminat,lenticellat,little,living,lon,lower,markedly,middle,nflorescence,papillo,proximal,pulp,rather,ruit,scar,spaced,two,ud,unit,widest,ympodial	.5-2,appearance,approximately,arrangement,border,branch,bud,characteristic,colour,corrugation,diameter,distal,drying,exertion,form,giving,glabrousnes,growth,height,history,interjected,leaflet,length,lenticellate,life,lobing,margin,mentioned,midpoint,new,number,peduncle,per,prickle,primary,pseudostipule,ray,shape,terminal,texture,thicknes,type,variation,width
423	wfo-0001030884	success	218	220	183	35	37	0.839	.2,.5,.7,0.3,0.3-0.5,0.4-3,0.5,0.5-1.2,0.8-1,0.9-5,1,1-1.2,1-1.5,1-3,1.5,1.5-2,1.5-2.5,10,100,2,2-5,4-13,4-5,4.5-5,5,5-30,5-6,5.5-7,6-25,6-8,7-8,9-11,>,abaxial,abruptly,acute,adaxial,along,also,anther,anthesi,apex,articulated,bark,basal,base,berry,blade,broad-based,brown,c.,calyx,capitate,cm,conical,curved,dark,decurrent,densely,di-,diameter,directed,discolorous,distal,elliptic,equal,extend,extending,filament,flower,flowering,fruiting,geminate,glabrous,glandular,gray-tinged,green,greenish,growth,half,herbaceous,inflorescence,lateral,leaf,length,like,lobe,lobed,long,long-stalked,long-styled,long-triangular,magnification,margin,mature,midpoint,midrib,minute,minutely,mixture,mm,moderately,new,node,occasionally,older,onto,open,ovary,ovoid-reniform,pair,pale,pedicel,peduncle,per,petiole,plant,pore,poricidal,porrect,present,prickle,prickly,primary,pubescent,ray,red,reddish,reflexed,regularly,rest,sagittate,scar,scattered,sessile,shallowly,short,short-stalked,short-styled,shrub,similar,simple,size,slender,spaced,sparsely,spherical,spreading,stellate,stem,stiff,stigma,still,strongly,style,surface,tall,tannish,tapering,time,tip,treelet,trichome,trifoliate,tube,unarmed,unicellular,uniseriate,unit,upward,usually,varying,vein,visible,way,white,wide,wing,winged,without,woody,yellow,young	5-merous,6-10,abaxially,adaxiall,alyx,andromonoeciou,apar,arme,connivent,differing,eaf,eed,free,gree,heterostylous,infructescence,leafy,lower,nflorescence,one,orolla,oung,outlin,papillat,portion,principal,reflexe,ruit,shap,stellate-pubescent,tamen,uniformly,vary,weakly,ympodial	apart,appearance,armed,arrangement,border,branch,bud,characteristic,colour,corolla,corrugation,drying,exertion,form,fruit,giving,glabrousnes,height,history,interjected,leaflet,life,lobing,mentioned,number,outline,papillate,pseudostipule,seed,shape,sympodial,terminal,texture,thicknes,type,variation,width
424	wfo-0001030899	success	146	161	107	39	54	0.733	-45,.5-2,0.3-0.5,0.5-1,1,1-1.5,1-2,1-3,1-6,10-20,2,2-3,2-3.5,2.5-3.5,20-25,3-12,3-4,3-5,3.5-4,4-5,5-10,5-6.5,6.5-31,7-27,abaxially,acuminate,acute,adaxially,aggregate,apart,apex,articulated,axe,basal,base,beyond,blade,bronze,calyx,cell,chartaceous,cm,connivent,cordate,coriaceous,deeply,densely,desc,diameter,dilated,distally,ellipsoidal,end,entire,ex,exserted,flattened,flower,fruit,glabrous,glandular-puberulent,globose,green,inside,leaving,less,lobe,long,margin,mm,mucronate,obconical,oblong,obtuse,outside,ovate,ovoid,pedicel,pedicellar,peduncle,perfect,petiole,puberulent,pubescent,purple,rachi,radiu,remnant,shrub,simple,spaced,splotch,stamen,stigma,stone,stripe,strongly,style,thecae,time,triangular,tube,unbranched,vein,wide,x,yellow	0.5,1.5-2,10-13,3-foliate,8-11,?,absent,ape,connective,directed,eaf,eed,exceeding,extrorse,light,lon,lower,narrowly,nflorescence,nther,orang,orolla,peltifor,pore,presen,puberulen,ruit,shorter,slightly,stellate,tal,tem,tomento,ud,unit,upward,vary,white,ympodial	anther,appearance,arrangement,bark,border,branch,bud,characteristic,colour,corolla,corrugation,distal,drying,exertion,filament,form,fruiting,giving,glabrousnes,growth,height,history,inflorescence,interjected,lateral,leaf,leaflet,length,life,lobing,mentioned,midpoint,new,number,ovary,peltiform,per,plant,present,prickle,primary,pseudostipule,ray,seed,shape,size,stem,surface,terminal,texture,thicknes,type,variation,width
425	wfo-0001030902	exception_thrown	159	0	0	159	0	0.0		-2,-20,-5,0-15,0.6-1.5,1-2,1-6,1.5-,1.5-13,1.5-2,1.5-2.5,10-15,15-50,2,2-3,2-5,2.5,2.5-4,3-13,3-20,3-4,3.5-4,30-50,4,4-22,4-6,4-7,4-foliat,5-7,5-9,6-24,8-14,abaxially,absent,acuminate,acute,adaxially,aggregate,along,angled,apart,ape,apex,apically,apiculate,articulated,axe,basal,base,beyond,blade,branched,brow,brown-pilose,calyx,cell,cm,connective,connivent,cordate,cylindrical,dark,deltate,densely,diameter,dilated,directed,distally,eaf,eed,eglandular,ellipsoidal,entire,equalling,exceeding,except,exserted,flattened,fleshy,flower,forked,fruit,glabrat,glabrescent,glabrous,glandular,glandular-puberulen,globose,hair,laterally,leaving,lobe,lon,long,lower,margin,mature,mm,narrowly,nflorescence,nther,oblong,obtuse,occasionally,orange,orolla,ovate,pedicel,pedicellar,peduncle,perfect,petiole,pinkish,pore,presen,present,puberulence,purple,purplish,rachi,radiu,rarely,reddish,remnant,ruit,shorter,simple,slightly,small,somewhat,spaced,sparse,sparsely,stamen,stellate,stigma,stone,style,subcapitat,subcoriaceous,tal,tem,thecae,time,tip,tomento,tree,triangular,truncate,tube,ud,unbranched,unit,vary,vein,wide,x,yellow,ympodial	
426	wfo-0001030914	exception_thrown	186	0	0	186	0	0.0		.1,.5,/4,0-0.25,0.1-0.5,0.5-1,0.7-1,0.8-1,0.8-1.3,1-1.5,1-2,1.2-1.5,1.5-2,1.5-3,1.5-8,2-10,2-2.5,2.5-11,2.5-3,3-4,3.5-17,5-17,5-25-flowered,7-10,7-8,9-35,acute,along,anther,anthesi,apex,attenuate,bark,base,beneath,berry,blade,bud,calyx,campanulate,capitate,closely,cm,constriction,corolla,dark,decurrent,deflexed,deltoid,densely,dia,differing,difoliate,distal,dry,eaf,edicel,eed,ellipsoid,elliptic,equal,erect,even,evenly,exserted,filament,flower,free,fruiting,furcate,geminat,glabrate,glabrous,globose,golden,green,greyish-brow,individual,inflorescence,later,lateral,leaf,lemon-yellow,length,like,live,lobe,lobed,lon,long,long-styled,lower,main,major,many,margin,middle,minor,minutely,mm,narowly,nflorescence,obovate,occasionally,often,older,one,onto,opposite,otherwise,ovary,overlappin,ovoid-reniform,pair,pale,papillo,papillose,pedicel,petiole,pitted,planar,plant,pore,poricidal,portion,prominent,puberulent,pubescent,quite,raised,reddish-brown,rest,ripe,rounded,ruit,scar,shape,shaped,short-styled,shrub,simple,size,slender,slightly,small,sometimes,soon,spaced,sparsely,specimen,stem,stigma,straight,style,surface,tall,tan,tapering,tear-drop,thick,third,ti,time,tip,tree,trichome,trunk,tub,tube,ud,uniseriate,unit,usually,variable,vein,way,weight,white,widest,winged,within,woody,x,yellow,ympodial,young	
427	wfo-0001030918	success	230	234	196	34	38	0.852	-12,-2.3,-3.2,-4,-4.5,-40,-5,-6,-9,.5,.7,0-10,0-25,0-6,0.1,0.2-0.4,0.25-0.45,0.3-1.5,0.5-0.7,0.5-2,0.5-2.5,0.6,0.6-2.5,0.7-1.2,0.7-1.7,1,1-1.5,1-1.8,1-2,1.5-2,1.5-2.5,1.5-5.5,1/2-2/3,1/2-3/4,1/3,1/3-,1/3-1/2,2-10,2-2.5,2-25,2-3,2-4,2-7,2-8,2.8-3,3-15,3-4,3-6.5,3-7,3.5-6,4-7,5-8,5.5-7,6-8,7-10,abaxial,acicular,acute,adaxial,ame,anther,apart,apex,apically,apparently,articulated,bark,base,berry,blade,branched,c.,calyx,cell,chartaceous,cm,connivent,cuneate,curved,dark,deltate,densely,diameter,difoliate,discolorous,distance,drying,dull,elliptic,elongated,elongating,erect,evenly,extending,filament,flattened,flattened-reniform,flower,free,fruit,fruiting,glabrescent,glabrous,green,green-brown,lateral,leaf,length,lobe,lobed,lobing,long,longer,lower,margin,mature,maturity,mauve,midpoint,midvein,mixture,mm,moderately,narrow-deltate,oblong,obtuse,occasionally,older,one,open,orange,orange-brown,outline,pair,pale,pedicel,peduncle,per,perpendicular,petiole,pit,poricidal,porrect,portion,prickle,prickly,primary,pubescent,purple,raised,ray,red,red-brown,reduced,reflexed,scandent,scar,secondary,seed,sessile,shrub,side,simple,slender,small,smooth,sometimes,somewhat,spaced,sparsely,spherical,spreading,stalk,stalked,stellate,stellate-pubescent,stem,straight,strongly,style,surface,tapering,terete,terminal,time,tip,trichome,tube,upper,usually,vein,way,weakly,wide,yellow,young	0-20,0-4,0.1-0.25,1-4,1/4-1/3,2/,5-7,5-merous,abaxially,alyx,apar,brow,caudat,eaf,equal,faint,geminat,infructescence,nflorescence,orolla,oung,pendulous,perfec,pericarp,prickl,ruit,tamen,tertiary,unit,vary,venation,visible,woody,ympodial	2/3,appearance,arrangement,border,branch,brown,bud,caudate,characteristic,colour,corolla,corrugation,distal,exertion,form,giving,glabrousnes,growth,height,history,inflorescence,interjected,leaflet,life,mentioned,new,number,ovary,plant,pseudostipule,shape,size,stigma,texture,thicknes,type,variation,width
428	wfo-0001030943	success	167	165	121	46	44	0.725	.5,0,0.5-1,0.5-3,1-1.2,1-1.5,1.1,1.5-2,1.8-2.2,1/2,10-25,12-15,2-6,3,3-4,3/4,4-4.5,4-5,7-13.5,7-8,8-10,abaxial,absent,acuminate,acute,adaxial,anther,apex,apical,bark,basal,base,becoming,berry,bi-lobed,black,branch,branching,calyx,cm,conical,corolla,decurrent,dendritic,densely,diameter,drying,echinoid,elliptic,elongate,exserted,fide,filament,flattened,flower,fruiting,glabrous,globose,golden,golden-yellow,growth,im,large,lateral,leaf,lenticular,lobe,lobed,long,minute,minutely,mm,narrowly,often,older,outline,ovary,overtopping,pair,pale,pearce,pedicel,per,petiole,pitted,plurifoliate,pubescent,purplish-black,raised,reddish-brown,scar,secondary,shoot,shrub,small,somewhat,sparsely,stem,stigma,strongly,style,surface,tall,tapering,terminal,time,tree,tree-like,triangular,trichome,tube,unit,vein,violet,way,wide,woody,x,yellow,yellowish-white,young	4-6,abaxially,adaxially,age,along,anthesi,belo,cupulate,dark,deflexed,denser,eaf,edicel,eed,erect,ew,free,glabrat,horizontal,inserted,lon,lower,m.,main,monochasia,nflorescence,nodding,papillo,pericarp,planar,pore,poricidal,portion,ruit,scattered,showy,sleeve,slightly,slit-like,stamen,thin,tip,tub,ud,upper,ympodial	appearance,arrangement,border,bud,characteristic,colour,corrugation,distal,exertion,form,fruit,giving,glabrate,glabrousnes,height,history,inflorescence,interjected,leaflet,length,life,lobing,margin,midpoint,monochasial,new,null,number,papillose,peduncle,plant,prickle,primary,pseudostipule,ray,seed,shape,size,sympodial,texture,thicknes,type,variation,width
429	wfo-0001030959	success	164	166	119	45	47	0.726	.05,.2,.8,/5,0.5-1.5,0.7-1.2,1-2,1-7,1.2-1.8,1.5-3.5,10-15,2-4,2.5-4,2.5-4.5,2.5-5,4-6,5-6,5-9,6-8,9-12,almost,ame,anther,apart,apex,apically,apparently,armed,bark,base,blade,branched,brown,brown-green,c.,cm,color,concolorous,connivent,cuneate,curved,deltate,densely,diameter,difoliate,distributed,drying,elliptic,equal,erect,evenly,filament,flower,free,fresh,gently,glabrescent,glabrous,glandular,hair,inflorescence,known,lateral,leaf,length,like,lobe,lobed,long,long-acuminate,longer,margin,membranous,midpoint,minute,mm,numerous,older,one,open,pair,part,pedicel,peduncle,perpendicular,petiole,poricidal,porrect,portion,present,prickle,prickly,primary,ray,sessile,shrub,simple,slender,spaced,stem,straight,straw,style,subentire,surface,tapering,terete,time,tip,toward,trichome,tube,unit,vein,way,whole,wide,yellow,youngest	0.5,1-10,1.5-2,1/5-1/10,4-8,5-merous,abaxially,alyx,apar,articulated,eaf,eed,geminat,glabrou,green-brow,know,less,long-acuminat,lower,narrow-deltate,nflorescence,orolla,oung,perfec,prickl,prominent,ruit,scar,scrambling,secondary,several,short,side,sparsely,spreading,stellate,stellate-pubescent,tamen,tertiary,unarmed,usually,vary,venation,visible,ympodial	1,appearance,arrangement,border,branch,bud,calyx,characteristic,colour,corolla,corrugation,distal,exertion,form,fruit,fruiting,geminate,giving,glabrousnes,green-brown,growth,height,history,interjected,leaflet,life,lobing,mentioned,new,number,ovary,per,plant,pseudostipule,scrambled,seed,shape,size,stigma,sympodial,terminal,texture,thicknes,type,variation,width,young
430	wfo-0001030982	success	215	217	179	36	38	0.833	-2-2.5,.1,.5,0.05,0.05-0.5,0.1,0.2-3,0.3-2,0.5,0.5-0.9,0.5-1,0.5-3,1,1-1.5,1-8,1.5,1.5-2,1.5-3,2/3,3-21,3-8,4-12,4-5,6-8,abaxially,acuminate,acute,adaxially,angular,anisophyllous,anther,anthesi,apex,appressed,base,beneath,berry,broadly,brown,brownish,bud,caducous,calyx,capitate,central,channelled,ciliate,closely,cm,conic,conical,corolla,cream,cuneate,curved,dark,deflexed,deltate,diameter,differing,difoliate,distally,dry,drying,ellipsoid,elliptic,enlarged,entire,exerted,external,filament,flattened-reniform,flower,foliage,form,free,fresh,fruit,fruiting,geminate,glabrescent,glabrous,glandular-papillose,globose,golden-green,green,greenish,growth,hilum,impressed,inconspicuously,internal,larger,later,leaf,less,like,live,lobe,lobed,long,major,margin,material,maturity,minor,minutely,mm,mostly,near,new,oblique,obovate,occasionally,olive,one,opposite,ovary,ovate,packed,pair,pale,papillae,papillate,papillose,pedicel,peduncle,petiole,pitted,plant,poricidal,portion,primary,prominent,prominently,puberulent,pubescent,reddish,reflexed,rest,revolute,rhizomatous,sagittate,scar,seed,separated,sigmoidally,simple,sinuate,situated,size,slightly,somewhat,sparsely,stem,stigma,straight,stripe,strongly,style,subshrub,surface,testa,tightly,time,tip,transverse,trichome,tube,uniseriate,unit,vein,veined,way,weakly,white,x,yellowish,young	.2,0.1-0.15,age,ape,ba,chartaceous,cucullate,distall,distichou,eaf,edicel,eed,extension,fleshy,glandular,isostylous,lengthening,lower,materia,midvein,nflorescence,often,overlappin,papillat,planar,pore,projection,ruit,shoot,slit,stamen,tetramerous,tub,ud,vegetative,ympodial	appearance,arrangement,bark,border,branch,characteristic,colour,corrugation,distal,distichous,exertion,giving,glabrousnes,height,history,inflorescence,interjected,lateral,leaflet,length,life,lobing,mentioned,midpoint,number,overlapping,per,prickle,pseudostipule,ray,shape,sympodial,terminal,texture,thicknes,type,variation,width
431	wfo-0001030989	success	177	146	105	72	41	0.593	.5,0.5-1,1-1.5,1-10,1-2,12-15,15-27.5,2-3.5,3-20,3-4,3-5.5,3-7.5,4-5,4-7,4-8,5,5.5-7.9,6-13,6-6.5,9-10,abaxially,acuminate,adaxially,anther,apart,apex,apparently,axe,axillary,base,berry,brownish,bud,cell,cm,condition,conical,connivent,corolla,covering,densely,diameter,distal,drying,filament,flower,forked,fresh,fruit,generally,green,greenish,half,herb,interjected,lanceolate,lateral,leaf,leaflet,light,lobe,long,make,margin,minute,mm,mucilaginous,odd-pinnate,orbicular,ovate,ovate-lanceolate,ovoid,pale,pedicel,peduncle,perfect,petiole,petiolule,plant,pubescent,ray,ripe,seed,semierect,size,sparsely,stem,stigma,style,subsessile,subtending,terminal,testal,thick,triangular,tube,unwinged,usually,violet,wall,wet,whitish,wide,x,yellow	5-merou,ag,alyx,articulated,blade,capitat,chartaceous,ciliate,decreasing,digestion,dorsally,eaf,edge,eed,end,enzyme,erec,especially,flat,folded,geminat,glabrou,glabrous,gradually,green-white,hair,hair-like,homostylous,honeycomb-shaped,larger,lengthening,like,living,lower,nflorescence,obtuse,occurring,orolla,pair,plurifoliate,pore,poricidal,present,proximal,pubescen,removed,rotate,ruit,secondary,seudostipule,singly,slit,spaced,specimen,ste,stolo,subequal,symmetrical,tall,tamen,tem,thir,throughout,tip,toward,tri-,tuber,typically,unit,vary,wider,ympodial	'hair-like,appearance,arrangement,bark,border,branch,calyx,capitate,characteristic,colour,corrugation,erect,exertion,form,fruiting,giving,glabrousnes,growth,height,history,inflorescence,length,life,lobing,mentioned,midpoint,new,number,ovary,per,prickle,primary,pseudostipule,shape,surface,texture,thicknes,type,variation,vein,width
432	wfo-0001030991	success	204	209	167	37	42	0.819	.5,0,0.2,0.2-0.7,0.3-0.4,0.5,0.5-0.7,0.5-1,0.5-1.5,0.5-3.5,0.6-0.8,0.7-1.2,1-1.5,1-1.6,1-2.2,1-2.5,1-7,1.5,10-20,2.5-10,2.5-3,2/3,3-,3-5-lobed,4-10,5-5.5,9-11,<,absent,acuminate,acute,adaxially,along,angled,anther,anthesi,apex,apparently,appressed,arising,articulated,ascending,attenuate,basal,base,berry,brown,bulbous,calyx,capitate,cell,cm,color,conical,connivent,corolla,densely,diameter,different,distally,drying,ellipsoid,ellipsoidal,elliptic,elongate,enlarged,entire,exerted,eye,filament,filiform,flattened,flower,free,fruiting,furcate,fusiform,glabrous,globose,grey,growth,herb,incised,inflorescence,lanceolate,lateral,leaf,leaf-opposed,lengthening,less,like,lobe,lobed,long-triangular,loosely,lower,margin,midrib,minutely,mm,narrowly,nearly,new,nodding,occasionally,often,outline,pair,part,particularly,pedicel,peduncle,pendant,per,petiole,pinnatifid,pitted,pointing,pore,poricidal,portion,primary,pseudoumbel,pubescent,rectangular,red,reflexed,reniform,rest,ripe,scattered,shallowly,short,shrub,simple,sleeve,slightly,slit,small,somewhat,sparsely,spreading,stem,stigma,strongly,style,suffrutescent,surface,tangled,terminal,testal,tip,trichome,tube,uniformly,uniseriate,variably,vein,violet,weak,weight,white,winged,woody,x,yellowish,young	0.1,2-plurifoliat,5-merou,abaxially,adaxiall,ag,alyx,ark,eaf,eed,frui,glabrescen,ilament,leave,minute,nflorescence,older,orolla,packed,papillo,perfect,pericarp,platfor,rootstoc,ruit,scar,shiny,stellate,tem,thin,tightly,twinin,ud,unit,upper,vary,ympodial	age,appearance,arrangement,bark,border,branch,bud,characteristic,colour,corrugation,distal,exertion,form,fruit,giving,glabrousnes,height,history,interjected,leaflet,length,life,lobing,mentioned,midpoint,number,ovary,papillose,plant,prickle,pseudostipule,ray,rootstock,seed,shape,size,texture,thicknes,twining,type,variation,width
433	wfo-0001031005	success	231	218	181	50	37	0.784	.5,/3-1/2,0-0.5,0.1,0.3-0.5,0.5-1.5,0.8,0.9,1,1-1.5,1-2,1-2.5,1-3,1.5-2.5,1.5-4,10,2-3.2,2.3-3,2.5,2.5-4,3-10,3-4,3-6.5,4-6,5,5-7,5-8,5Â°,6-12,accrescent,acuminate,acute,almost,along,anther,anthesi,apex,apically,articulated,attenuate,bark,base,berry,black,blue,brachyblast,branch,branched,branching,brown,calyx,capitate,chartaceous,clustered,cm,concolorous,conical,corolla,cupular,curved,dark,deeply,deltoid,dendritic,dendritic-pubescent,denser,detaching,developing,diameter,dilated,discolorous,divided,drying,elliptic,elongated,entire,evenly,extending,eye,fertilisation,filament,flattened,flexuous,flower,form,forming,free,fruit,fruiting,glabrous,greenish,immature,increasing,inside,known,lateral,leaf,leave,length,liana,like,linear,lobe,lobed,long,longitudinally,loop,main,margin,membranous,midvein,minute,mm,naked,oblong,obovate,obscure,occasional,occasionally,often,older,orange-brown,outside,ovate,ovoid,pair,pedicel,peduncle,pendulous,pericarp,petiole,pointed,portion,primary,prominent,pubescent,purple,rachi,ray,ridged,scar,secondary,seed,short,side,simple,slender,smooth,sometimes,somewhat,soon,sparsely,spread,spreading,stem,stigma,strongly,stump,style,surface,tearing,terete,terminal,thick-chartaceous,thin,tip,toward,trichome,tube,unarmed,uneven,usually,vein,venation,visible,weakly,well-developed,white,wide,x,young	.4,abaxial,abaxially,adaxially,age,alyx,apar,apparently,clearly,clum,common,datum,delineated,density,domatia,eaf,ellipsoi,equal,fine,flat,junction,lengthening,lower,m.,much,network,nflorescence,nther,onl,orolla,ou,perfec,plurifoliat,pore,poricidal,protruding,raised,region,rest,ruit,smaller,smoot,standing,surrounding,tangling,tertiary,ud,unit,vary,ympodial	apart,appearance,arrangement,border,bud,characteristic,colour,corrugation,distal,ellipsoid,exertion,giving,glabrousnes,growth,height,history,inflorescence,interjected,leaflet,life,lobing,midpoint,new,null,number,ovary,per,plant,prickle,pseudostipule,shape,size,texture,thicknes,type,variation,width
434	wfo-0001031007	success	207	192	154	53	38	0.744	.5,0.2,0.5-1,0.75-1.5,1,1-1.2,1-1.5,1-3.5,1.2-1.5,1.3-,1.5-2,1.6-2,1.9-3,1/3,11-14,15,2.5-,2.5-5,3-4,4-6,4.5-5,5,5-12,5.5-6,50-100,6,7-10,<,abruptly,acute,alfway,almost,along,anther,anthesi,apex,articulated,base,becoming,beginning,berry,bifid,black,branched,broad,broadly,brown,c.,calyx,capitate,chartaceous,cm,completely,connivent,corolla,cuneate,cup-shaped,dark,deltate,dendritic,diameter,dilated,drying,dull,ellipsoid,elliptic,entire,exserted,extending,filament,flattened-reniform,fleshy,flower,fruit,fruiting,glabrous,globose,growth,herbarium,impressed,inflorescence,intramarginal,irregularly,lamina,lax,leaving,lilac,lobe,lobed,long,looping,loose,loosely,lower,many,margin,markedly,matte,minutely,mm,multi-celled,narrowing,narrowly,near,new,occasionally,often,older,outline,papillate,pedicel,peduncle,peg,per,petiole,pitted,poricidal,primary,prominent,pubescent,rat,reddish,revolute,sagittate,shiny,shrub,simple,sleeve,slender,sparsely,specimen,splitting,spreading,stem,stigma,stout,strongly,style,surface,tangled,terminal,time,tip,trichome,tube,twining,upper,usually,vein,vine,way,woody,x,yellow	0.5,0.5-10,4-7,5-merou,8-10,abaxiall,ag,alyx,apar,apparently,ark,branching,campanulate,cell,clustered,densely,eaf,eed,free,geminat,glabrescen,glabrou,ilament,junction,lengthening,m.,midvein,nflorescence,nodding,orolla,pale,papillat,perfect,pericarp,planar,plurifoliate,pore,portion,round-rectangular,ruit,scar,slightly,slit,spaced,stellate,stellate-pentagonal,testal,thin,tiny,ud,unit,vary,ympodial	?,appearance,arrangement,bark,border,bud,characteristic,colour,corrugation,distal,exertion,form,giving,glabrescent,history,interjected,lateral,leaf,leaflet,length,life,lobing,midpoint,null,number,ovary,paler,prickle,pseudostipule,ray,seed,shape,size,texture,thicknes,type,variation,width
435	wfo-0001031007	success	206	176	135	71	41	0.655	0.2,0.75-1.5,1,1-1.5,1-3.5,1.2-1.5,1.3-,1.6-2,1.9-3,1/3,11-14,15,2.5-,2.5-5,3-4,4-6,4-7,4.5-5,5,5-12,5.5-6,50-100,6,7-10,8-10,<,abruptly,acute,alfway,along,anther,anthesi,apex,bark,base,becoming,beginning,berry,bifid,black,branched,broad,broadly,brown,c.,calyx,capitate,cell,cm,corolla,cuneate,cup-shaped,deltate,dendritic,diameter,drying,ellipsoid,elliptic,entire,exserted,extending,filament,flattened,flower,free,fruit,fruiting,glabrous,globose,growth,impressed,inflorescence,intramarginal,irregularly,lamina,lax,lilac,lobe,lobed,long,looping,loose,lower,many,margin,minutely,mm,narrowing,narrowly,near,new,occasionally,outline,papillate,pedicel,peduncle,per,petiole,pitted,poricidal,portion,primary,prominent,pubescent,reddish,reniform,revolute,round-rectangular,sagittate,shiny,shrub,simple,slender,sparsely,splitting,stem,stigma,strongly,style,surface,tall,tangled,terminal,testal,time,tip,trichome,tube,upper,usually,vein,vine,way,wide,woody	.5,0.5,0.5-1,0.5-10,1-1.2,1.5-2,5-merou,abaxially,adaxial,ag,almost,alyx,apar,apparently,articulated,branching,campanulate,chartaceous,clustered,completely,dark,densely,dilated,dull,eaf,eed,fleshy,glabrescen,glabrou,herbarium,ilament,junction,leaving,lengthening,m.,markedly,matte,midvein,multi-celled,nflorescence,nodding,often,older,orolla,pale,papillat,peg,perfect,pericarp,planar,plurifoliat,pore,rat,ruit,scar,sleeve,slightly,slit,spaced,specimen,spreading,stellate,stellate-rotate,stout,thin,tiny,twinin,ud,unit,vary,ympodial	appearance,arrangement,border,branch,bud,characteristic,colour,corrugation,distal,exertion,form,giving,glabrescent,glabrousnes,height,history,interjected,lateral,leaf,leaflet,length,life,lobing,mentioned,midpoint,number,ovary,paler,plant,plurifoliate,prickle,pseudostipule,ray,seed,shape,size,texture,thicknes,type,variation,width
436	wfo-0001031036	success	150	166	122	28	44	0.813	.2,.25,.5,0.5-1,0.8-1,0.8-1.2,1-1.3,1-2.5,1.2-1.5,1.5-3,10-20-flowered,12-15,2-2.5,2.2-3.7,3-4,3-5,3.5-5.5,4.5-6.5,5-6,7-8,abaxially,acuminate,acute,adaxially,along,angle,anther,apex,axil,base,becoming,berry,bi-lobed,broadly,brown,calyx,cm,conical,corolla,crisped,dark,decurrent,dia,difoliate,dry,drying,ellipsoid,elliptic,enlarged,erect,exserted,filament,filiform,flattened-reniform,fleshy,free,fresh,fruiting,glabrous,globose,green,greenish-white,knob-like,lateral,leaf,lobe,lobed,long,main,major,margin,material,middle,minor,minutely,mm,nearly,oblique,older,onto,opposite,ovary,pair,papillose,pedicel,perhaps,petiole,pitted,pointed,portion,rounded,sagittate,shiny,short,shrub,simple,sinus,size,slightly,soon,spathulate,stem,stigma,strongly,style,surface,tall,tapering,thickened,tip,trichome,tube,uniseriate,unit,usually,vein,white,widest,winged,x,yellowish,young	anthesi,arising,ba,closely,deflexed,differing,eaf,edicel,eed,geminat,lamina,lon,lower,nflorescence,overlappin,papillo,planar,pore,poricidal,ruit,scar,shaped,spaced,tear-drop,tub,ud,woody,ympodial	appearance,arrangement,border,branch,bud,characteristic,colour,corrugation,diameter,distal,exertion,form,fruit,geminate,giving,glabrousnes,growth,history,inflorescence,interjected,leaflet,length,life,lobing,midpoint,new,null,number,peduncle,per,prickle,primary,pseudostipule,ray,seed,shape,specified,sympodial,terminal,texture,thicknes,type,variation,width
437	wfo-0001031064	success	179	180	136	43	44	0.76	.0-2.5,.5,.5-1,0,0-15,0.5-0.7,0.5-0.8,1,1-1.2,1-2,1-3,1.2,1.7-4.2,10-12,10-12.5,10-17,2,2.5-3,3,3-5.5,3-7,3.5-4,4-5-celled,5-10.5,5-6,6-16,7-16,8-10-celled,abaxially,acuminate,adaxially,along,anther,anthesi,anticlinal,apex,arising,attenuate,axil,basal,base,bearing,berry,bright,calyx,cm,completely,conical,conspicuous,corolla,dark,deltate,densely,denser,diameter,distal,elongate,exserted,filament,fleshy,flower,fruit,fruiting,glabrous,globose,green,half,highly,inflorescence,irregular,irregularly,lateral,leaf,leaflet,lenticel,like,lobe,lobed,long,lower,margin,minute,minutely,mm,near,nearly,node,obovate,occasionally,open,ovary,ovate,ovoid-reniform,pedicel,per,petiole,pinnate,planar,projection,prominent,pubescent,purple,rachi,scar,scattered,short-pubescent,shrub,simple,single,sinuous,sinus,slender,somewhat,sparsely,splitting,stem,stigma,strongly,style,surface,swollen,terminal,thickening,time,translucent,trichome,tube,uniseriate,unit,usually,vein,wand-like,white,winged,without,x	.05,0.5,1.5-2,acroscopic,blade,broader,cell,clavat,commentary,dr.,eaf,edicel,eed,epidermal,erec,free,lamina,leave,lightly,lon,lost,narrower,nflorescence,nodding,often,pair,papillate,petiolule,poricidal,portion,pubescen,rugose,ruit,see,side,smaller,tal,tem,tip,tub,ud,unifoliat,ympodial	appearance,arrangement,bark,border,branch,bud,characteristic,clavate,colour,corrugation,dry,drying,exertion,form,giving,glabrousnes,growth,height,history,interjected,length,life,lobing,mentioned,midpoint,new,number,peduncle,plant,prickle,primary,pseudostipule,ray,seed,shape,size,sympodial,tall,texture,thicknes,type,unifoliate,variation,width
438	wfo-0001031071	success	186	171	126	60	45	0.677	0-10,0.2-0.8,0.4-2,1-1.5,1-2,1-3,1.5-2.2,2-8,2.1-3,2.4-3.4,3-10,3-5,3-6,3.8-5.4,4-25,4-6,5-9.4,5.7-8.8,6-8,7-16.5,7-8,8-28,abaxially,acumen,acute,adaxially,along,anther,apart,apex,apparently,arranged,asymmetric,axe,axillary,base,basiscopic,bead,berry,blue,brownish,bud,cell,clavate,cm,color,condition,connivent,corolla,covering,dark,deep,diameter,distal,drying,elliptic,filament,flower,forked,fresh,fruit,generally,glabrous,globose,green,greenish,half,herb,interjected,lanceolate,lateral,leaf,leaflet,like,lilac,lobe,long,make,medium,mm,moniliform,mottled,mucilaginous,multiple,narrowly,necklace,odd-pinnate,orbicular,ovate,ovoid,pedicel,peduncle,perfect,petiole,petiolulate,plant,plurifoliate,purple,ripe,round,seed,sessile,short,side,size,spot,star,stigma,stolon,style,subtending,terminal,testal,thick,tissue,tri-,tube,tuber,typically,usually,wall,wet,white,whitish,winged,x	1-7,2-3,2-5,5-merou,abaxiall,ag,alyx,articulated,attenuate,blade,capitat,coriaceous,decreasing,digestion,dorsally,eaf,edge,eed,enzyme,erec,exceeding,flat,folded,geminat,glabrou,green-white,hair-like,homostylous,honeycomb-shaped,lengthening,living,lower,middl,nflorescence,orolla,pair,pentagonal,pore,poricidal,removed,rotate,ruit,seudostipule,slightly,slit,spaced,specimen,stamen,straight,subequal,tall,tamen,tem,throughout,tip,toward,unit,vary,yellow,ympodial	'hair-like,appearance,arrangement,bark,border,branch,calyx,capitate,characteristic,colour,corrugation,erect,exertion,form,fruiting,geminate,giving,glabrousnes,growth,height,history,inflorescence,length,life,lobing,margin,midpoint,new,null,number,ovary,per,prickle,primary,pseudostipule,ray,shape,stem,surface,texture,thicknes,type,variation,vein,width
439	wfo-0001031097	success	174	184	133	41	51	0.764	0.45,0.5,1,1-3,1-4,1-4.5,1.6-5.5,1.8-2.5,1.8-2.6,13-30,2-3,2-3.3,2-4,3-5,3.5-6,3.7-8.4,4-6,4-7,5-11,5-12,5-9,8-11,9-21,abaxial,abaxially,acumen,acuminate,acute,adaxially,along,apex,apical,apically,articulate,base,branched,calyx,cell,cm,connate,corolla,covering,cuneate,cyme,darker,deep,dehiscent,diameter,dichasial,dichasially,distal,dorsally,dotted,ebracteate,edge,elliptical,exceeding,filament,flat,flower,folded,forked,generally,green,green-white,half,herbaceous,interjected,interpetalar,introrse,lateral,leaf,leaflet,light,lighter,lobe,long,make,margin,maturing,medium,mm,monochasial,mottled,mucilaginous,narrow,noticeably,oblique,obovate,odd-pinnate,often,ovate,ovoid,pattern,pedicel,peduncle,pentagonal,perennial,perfect,petal,petiole,plant,poricidally,proximal,puberulent,pubescent,purple,rarely,rotate,seed,short,side,size,slit,sometimes,stamen,stigma,straight,strigose,style,terminal,testal,thick,throughout,tuber-bearing,typically,violet,violet-blue,wall,wide,without,yellow,Â¼	1.5,3-6-foliat,decurrent,digestion,diminishing,eaf,eed,emoval,enzyme,frequently,globo,gree,hair-like,highly,honeycomb,living,lon,lower,lunat,nflorescence,nther,orolla,pair,petiolulate,petiolule,plan,rachi,rapidly,reveal,ruit,sessile,seudostipule,specimen,tal,tem,tissu,toward,unit,vary,vbase,ympodial	'hair-like,2,anther,appearance,arrangement,bark,border,branch,bud,characteristic,colour,corrugation,drying,exertion,form,fruit,fruiting,giving,glabrousnes,globose,growth,height,history,inflorescence,length,life,lobing,lunate,midpoint,new,null,number,ovary,per,prickle,primary,pseudostipule,ray,shape,stem,surface,tall,texture,thicknes,tissue,tube,type,variation,vein,wet,width
440	wfo-0001031101	success	197	181	158	39	23	0.802	-1,-20,-30,-5,-8,/2,/2-equal,0.05-0.2,0.1-0.2,0.1-0.3,0.3-0.5,0.5-0.8,0.5-3,0.6-0.8,0.7-0.8,0.8-,1-2,1-2.3,1.3-2,1.3-2.5,1.4-1.7,1/3-1/2,1/4-1/2,10-30,2-2.8,2-4,2.5-3.5,2.5-3.8,3-10,3-15,3-8,3.5-4.5,4-7,4.5-9,5-20,5-6,6-10,abaxial,abaxially,acuminate,adaxial,almost,ame,anther,apex,apical,apically,articulated,bark,base,berry,blade,branched,bright,c.,calyx,cm,concolorous,connivent,deltate,diameter,difoliate,drying,dull,elongating,entire,equal,erect,evenly,filament,filiform,flattened-reniform,flower,free,fruiting,glabrescent,glabrous,glandular,green,green-brown,hair,herbaceous,infructescence,leaf,length,lobe,lobed,long,long-acute,margin,mature,maturity,mauve,membranous,midpoint,minute,mm,moderately,multangulate,narrow-deltate,near,obtuse,often,one,open,orange-brown,orange-red,pair,pale,pedicel,peduncle,pendulous,per,pericarp,petiole,poricidal,porrect,portion,primary,ray,red,resembling,rounded,scandent,sessile,shrub,simple,smooth,sparsely,spherical,spreading,stalk,stalked,stellate,stellate-pubescent,stem,straight,style,surface,tapering,terete,tertiary,time,tip,trichome,tube,umbel,unarmed,variously,vein,venation,visible,way,white,wide,yellow,yellow-green,young	-16,1-,1-3,1.5-3,2-5,2-6,2.5-,4-10,4-5-merous,8-15,alyx,apar,apparently,ba,eaf,eed,frui,geminat,lateral,long-acuminat,longer,lower,nflorescence,older,orolla,oung,ovate,perfec,red-brow,ruit,scar,spaced,stellate-pubescen,tamen,terminal,unarme,unit,vary,ympodial	arrangement,branch,characteristic,colour,corolla,form,fruit,geminate,glabrousnes,growth,height,history,life,long-acuminate,new,ovary,plant,red-brown,seed,shape,size,stamen,texture
441	wfo-0001031114	success	208	226	178	30	48	0.856	.1,.2,.5,0-0.3,0.3-0.5,0.5,0.5-1,0.7-1.5,0.8-1.2,1-1.5,1-10,1-2,1-4.5,1-7,1-8,1.5-2.5,1.5-4,10-15,2-17,2-3,2-4,2-7,2.5-3,2/3,25-50,3-10,3-4,3-5,3-7,4-10,4-8,4.5-6,5-10,5-8,7-15,abaxially,accrescent,acuminate,acute,adaxially,anther,apart,apex,apparently,articulated,axe,base,becoming,berry,blade,branched,brown,calyx,chartaceous,cm,connivent,covering,cylindrical,dark,deltate,densely,diameter,differentiated,directed,discolorous,distal,distally,dried,echinoid,elliptic-ovate,entire,erect,especially,filament,first,flattened,fleshy,flower,fruit,fruiting,geminate,glabrous,globose,green,hair,highly,impressed,interpetalar,introrsely,lacking,large,leaf,leaf-opposed,light,like,lobe,long,long-stalked,longitudinal,major,margin,midpoint,minor,mm,multangulate,nearly,nodding,oblong,obtuse,often,one,opening,outline,ovate,paired,pedicel,peduncle,perfect,pericarp,petiole,plurifoliate,pore,porrect,prominent,pubescent,purple,rachi,ray,reniform,ripe,rounded,rugulose,sessile,short,short-,short-stalked,shrub,simple,slightly,slit,small,somewhat,spaced,sparsely,stalk,stellate,stellate-pubescent,stem,stigma,straight,strongly,style,subcoriaceous,subcucullate,subcuneate,subtending,surface,tall,thickened,thin,time,tip,tissue,toward,tree,triangular,truncate,tube,vein,white,white-pubescent,white-stellate,whitish,wide,without,x,yellow,yellowish	4-5,5-merou,6-7,absen,adaxiall,ag,alyx,ba,capitat,eaf,eed,equal,free,frui,homostylous,juic,lower,membanaceous,nflorescence,orolla,part,ruit,side,ste,tamen,tem,unarme,unit,vary,ympodial	absent,age,appearance,arrangement,bark,border,branch,bud,capitate,characteristic,colour,corolla,corrugation,drying,exertion,form,giving,glabrousnes,growth,height,history,inflorescence,interjected,juicy,lateral,leaflet,length,life,lobing,new,null,number,ovary,per,plant,prickle,primary,pseudostipule,seed,shape,size,terminal,texture,thicknes,type,unarmed,variation,width
442	wfo-0001031116	success	191	179	138	53	41	0.723	-10,.2,.8,/4,0,0.05-0.15,0.1,0.3-0.5,0.4-0.7,0.7-0.9,0.7-1,1,1-5,1/6-1/4,10-14,15-25,2-5,30-100,30-50,4-10,4-7,5-15,8-11,9-13,abaxial,acuminate,adaxial,anther,apart,apex,apparently,articulated,bark,base,berry,blade,branching,bristle,calyx,caudate,clearly,cm,collapsed,densely,diameter,dirty-white,discolorous,drying,elliptic,elongated,elongating,erect,evenly,filament,flexuous,flower,fragile,fruit,fruiting,glabrescent,glabrous,glaucous-green,green,hair,infructescence,lateral,leaf,length,less,lobe,long,longer,margin,mature,maturity,membranous,midpoint,minute,mm,moderately,multangulate,obovate,obtuse,often,older,one,open,orange-red,pair,pedicel,peduncle,per,pericarp,perpendicular,petiole,primary,ray,recurved,red-brown,reflexed,rounded,secondary,sessile,sharply,shortly,shrub,simple,single,small,smooth,soft,spaced,sparsely,spherical,stalk,stalked,stellate,stellate-pubescent,stem,straight,style,subentire,surface,terete,tertiary,time,tree,trichome,tube,unarmed,unit,vein,venation,visible,weakly,wide,woody,young	.5,1/2,1/3-2/,2.7-3.2,3.5-4,5,5-merous,abaxially,almost,alyx,ame,apar,apically,arachnoid,attenuate,broad-deltate,brow,c.,connivent,dull,eaf,eed,epidermi,equal,flat,flattened-reniform,free,lobed,lower,mauve,narrow-deltate,nflorescence,obtu,orange-brown,orolla,oung,perfec,plurifoliat,poricidal,portion,ruit,scar,slender,sometimes,tamen,tapering,tip,unarme,upper,vary,way,yellow,ympodial	appearance,arrangement,border,branch,brown,bud,characteristic,colour,corolla,corrugation,distal,exertion,form,giving,glabrousnes,growth,height,history,inflorescence,interjected,leaflet,life,lobing,new,number,ovary,plant,plurifoliate,prickle,pseudostipule,seed,shape,size,stigma,sympodial,terminal,texture,thicknes,type,variation,width
443	wfo-0001031128	success	213	217	177	36	40	0.831	-10,-100,-6.5,/4,0,0-30,0.05-0.2,0.2,0.2-0.4,0.3-0.8,0.5-0.7,0.5-1.5,0.5-5,0.6-1,0.8-1.7,1,1-,1-1.6,1.2-2,1.5-3,1.5-3.5,1/6-1/3,10-35,2-5,2-9.5,2.5-10,2.5-3.5,20-50,20-60,3-4,3.5-4.5,4-5-merous,4-7,5-15,5-19,5-30,8-12,8-23,abaxially,acute,almost,anther,apart,apex,apically,apparently,articulated,bark,base,berry,blade,branched,branching,bristle,brown,calyx,cm,concolorous,connivent,cuneate,deltate,densely,diameter,drying,elliptic,elongated,elongating,entire,erect,evenly,filament,filiform,flexuous,flower,fruit,fruiting,glabrescent,glabrous,gland,glandular,green,hair,inflorescence,infructescence,lateral,leaf,length,less,lobe,lobed,long,long-acuminate,longer,lower,margin,mature,maturity,mauve,membranous,midpoint,minute,mm,moderately,multangualte,multangulate,narrow-deltate,near,occasionally,often,older,one,open,pair,pale,pedicel,peduncle,per,perfect,pericarp,perpendicular,petiole,poricidal,primary,purple-black,ray,recurved,red,red-brown,reduced,reflexed,secondary,sessile,shallowly,short-attenuate,short-styled,shrub,simple,single,smooth,soft,spaced,spherical,spreading,stalk,stalked,staminate,stellate,stellate-pubescent,stem,straight,style,surface,tapering,terete,terminal,tertiary,time,tip,trichome,tube,unarmed,undulate,unit,usually,variously,vein,venation,visible,way,weakly,white,whitish,wide,woody,yellow-brown,yellow-green,young	-4.5,0.05-0.25,0.5-0.8,1/,10-20,2.3-,5-,abaxial,alyx,apar,ape,dull,eaf,eed,equal,eye,flattened-reniform,free,gra,lon,long-acuminat,naked,nflorescence,orange-brown,orolla,oung,plurifoliat,portion,ruit,scar,side,tamen,unarme,vary,yellow,ympodial	1/3,appearance,arrangement,border,branch,bud,characteristic,colour,corolla,corrugation,distal,exertion,form,giving,glabrousnes,gray,growth,height,history,interjected,leaflet,life,lobing,new,number,ovary,plant,plurifoliate,prickle,pseudostipule,seed,shape,size,stigma,sympodial,texture,thicknes,type,variation,width
444	wfo-0001031135	success	189	165	113	76	52	0.598	0-2,0.7-2,1-1.5,1-10,1-2.5,1-3,1.5-2,1.5-3,10-20,2,2-,2-2.5,2-23,2-3,2-3.5,2-4,2-5,2.5-28,3-4,3-5,3.5-12,4-5,5-11,5-30,5-9-pinnate,abaxially,acuminate,acute,adaxially,adpressed,also,apex,axe,basal,base,calyx,cm,compound,cordate,cuneate,cylindrical,darker,deltate,densely,diameter,dilated,distally,ellipsoidal,entire,fading,flattened,flower,frequently,fruit,fusiform,green,hair,interstitial,irregularly,lateral,leaf,leaflet,light,lobe,lobed,long,longitudinal,margin,mm,moderately,obconical,oblong,obtuse,occasionally,often,ovoid,pedicel,peduncle,peltiform,perfect,petiole,pilose,pink,pinnately,pinnatifid,puberulent,pubescent,purple,radiu,ripe,shrub,simple,small,smaller,sparsely,stigma,stripe,strongly,style,time,tip,tree,triangular,truncate,tube,unbranched,unlobed,white,whitish,wide,x,yellow-green,yellowish	-7,0.5-2,1-,1-4,1.5-9,3-10,4-foliat,7-15,absent,aggregate,along,apart,ape,articulated,basiscopically,beyond,biglandula,blade,broad,campanulate,cell,chartaceous,color,connective,coriaceous,decurrent,deflexed,directed,eaf,eed,eglandular-pubescent,ellipsoida,elliptic,equal,especially,exceeding,exserted,glabrous,glandular-,laterally,leaving,lon,lower,midrib,narrowed,nflorescence,nther,oblique,orolla,ovate,papillose,pedicellar,pilo,pore,present,rachi,remnant,ruit,shorter,slightly,spaced,stamen,stone,subcoriaceous,tal,tem,thecae,tomento,toward,ud,unit,unknow,upper,vary,violet,ympodial	anther,appearance,arrangement,bark,biglandular,border,branch,bud,characteristic,colour,corolla,corrugation,distal,drying,exertion,filament,form,fruiting,giving,glabrousnes,growth,height,history,inflorescence,interjected,length,life,lobing,mentioned,midpoint,new,number,ovary,per,plant,prickle,primary,pseudostipule,ray,seed,shape,size,stem,surface,tall,terminal,texture,thicknes,type,variation,vein,width
445	wfo-0001031144	success	231	191	152	79	39	0.658	-11,-13,.2,.5,0.2,0.8-1.4,1-,1-1.5,1-4,1.1-2.5,100,2,2-,2-3,2-9,2.5-3,2/3,25,3-7,3.5-10,4,4-20,4-4.5,4-6,5,6,7-10,<,acuminate,acute,adaxially,anther,anthesi,apex,apiculae,asymmetric,basal,base,basiscopically,berry,branch,bright,broadly,brown,calyx,capitate,cm,commonly,cordate,corolla,diameter,divaricate,drying,ellipsoid,elliptic,entire,exserted,extending,filament,flattened,flattened-reniform,flower,form,fruiting,glabrous,globose,groove,growth,inflated,inflorescence,lamina,later,lateral,leaf,leaflet,less,like,lobe,lobed,long,longer,lower,many,margin,membranous,mere,minute,minutely,mm,near,new,number,oblique,occasionally,often,older,open,outline,pair,pale,pedicel,peduncle,per,petiole,pinnately,pinnatifid,pitted,plurifoliate,primary,pubescent,red,reddish,rim,ripe,seed,shiny,simple,slightly,smaller,sometimes,sparsely,stem,stigma,strongly,style,surface,tan,terete,terminal,third,tiny,triangular,trichome,truncate,tube,tuft,twining,two,uniseriate,unit,upper,usually,vein,vine,violet,way,white,widest,woody,x,yellowish,Â½	0.5,2-6,3-4.5,5-9,5-merou,ag,alyx,apart,apicula,appearing,ark,around,articulated,away,axi,blac,branche,brow,cell,closer,connivent,corresponding,cupped,curved,densely,eaf,eed,elongate,elongating,four,free,geminat,ilament,irregularly,larger,leaving,lengthening,longest,loosely,markedly,nflorescence,one,orolla,papillo,peg,pendant,pentagonal,perfect,pericarp,pore,poricidal,portion,progress,quite,ruit,scar,sleeve,slit,small,spaced,spreading,stellate-rotate,tangle,tem,testal,thin,tip,together,twinin,ud,unequal,variable,vary,wall,weight,wing,wood,yellow,ympodial	13,appearance,arrangement,bark,black,border,bud,characteristic,colour,corrugation,distal,exertion,fruit,geminate,giving,glabrousnes,height,history,interjected,length,life,lobing,mentioned,midpoint,ovary,papillose,plant,prickle,pseudostipule,ray,shape,size,sympodial,tall,texture,thicknes,type,variation,width
446	wfo-0001031152	success	232	194	155	77	39	0.668	-1.5,-10,-5.5,.4,/100-1/16,0-100,0.2-0.3,0.2-1.5,0.3-3,1-1.5,1-3,1-6,1.1-2.2,1.4-2.6,1/2-3/4,11,13-27,2-5,2.5-7.5,2.7-3.7,4-19,4-6,4-8,8-20,9-13,abaxially,acuminate,acute,adaxially,anther,anthesi,apart,apex,articulated,attenuate,axe,basal,base,becoming,berry,blade,blister,blunt-tipped,branch,branched,brown,bud,bullate,calyx,closely,cm,conical,continued,corolla,decurrent,deltoid,densely,diameter,due,entire,exserted,few-rayed,filament,fleshy,flower,fruit,fruiting,glabrous,globose,granular-tomentose,green,greenish,growth,hair,honeycombed,lanceolate,lateral,lavender,leaf,length,lilac,lobe,long,long-,main,margin,midvein,mixed,mm,mostly,multangulate,narrowly,nearly,oblanceolate,oblong,obtuse,occasionally,one,openly,orbicular,ovate,pale,partly,pedicel,peduncle,persistently,petiole,pitted,porrect-stellate,probably,pubescent,rather,ray,reddish,reddish-brown,reniform,reticulate-punctate,ripe,scabrous,sessile,short-,shrub,side,simple,slightly,soon,spaced,sparingly,sparsely,stelliform,stem,stigma,stout-stalked,strongly,style,suborbicular,surface,swelling,terete,terminal,thick,thick-stalked,thin-,time,touching,tree,tube,unarmed,variously,vein,violet,wide,x,yellow,yellowish	0.3-1.3,1.1-3,1.2-1.8,1.3-4,1.5-3,1.5-3.5,1/2-2/3,2.7-4.5,2.7-6,2.8-4,3.7-7,4-7,5-6,6.5-10,accrescent,ag,along,apical-lateral,apparently,axillary,ba,capitat,chartaceous,dehiscing,directed,eaf,earl,eed,evident,extend,free,glabrescen,high,inserted,introrse,lackin,large,less,lobed,longer,longitudinal,lower,m.,moderately,multangulat,nflorescence,open,orolla,perfect,plurifoliate,pore,rachi,relatively,rotate-stellate,ruit,runk,short-stalked,slit,somewhat,splitting,stamen,stellate-pubescent,stipitate-glandular,suture,tamen,testa,thin,thin-stalked,tomentose,toward,unarme,unit,usually,vary,way,ympodial,young	appearance,arrangement,bark,border,capitate,characteristic,colour,corrugation,distal,drying,exertion,form,giving,glabrousnes,height,history,inflorescence,interjected,leaflet,life,lobing,midpoint,new,null,number,ovary,per,plant,prickle,primary,pseudostipule,seed,shape,size,texture,thicknes,type,variation,width
447	wfo-0001031202	exception_thrown	198	0	0	198	0	0.0		.1,.5,0-0.5,0-1,0.1-0.3,0.5,0.5-1,0.6-1.1,0.8-1,1-1.5,1-1.7,1-5,1.5-2,1.5-2.5,1.5-9,15-40,2-3,2-8,2.5-13,2.5-3.5,2.5-4,2/3,20-100-flowered,3.5-4,6-25,9-11,9-20,abrupt,accrescent,acute,along,anther,anthesi,apart,apex,apiculate,axi,bark,base,beneath,berry,broadly,bud,calyx,capitate,cm,completely,complex,condition,cordate,corky,corolla,cup-shaped,decurrent,deflexed,deltoid,densely,dia,differing,difoliate,distal,dry,due,eaf,edicel,eed,enclosed,erect,exserted,extremely,filament,fleshy,flower,free,frui,fruit,fruiting,furcate,geminat,glabrate,glabrous,globose,golden,green,greenish-white,greyi,hard,inflorescence,irregularly,large,later,lateral,leaf,like,live,lobe,lobed,lon,long,long-ellipsoid,long-styled,longer,lower,main,major,many,margin,material,middle,minor,minute,minutely,mm,narrowing,nflorescence,obovate,occasional,occasionally,often,older,one,opposite,orbicular,ovary,overtopping,ovoid-reniform,pair,pale,paler,papillo,papillose,pedicel,petiole,pitted,planar,plant,pore,poricidal,portion,prominent,puberulent,pubescent,quite,raised,reddish-brown,rounded,ruit,scar,scattered,sessile,shape,shaped,shoot,short-styled,shrub,size,slender,slightly,small,spaced,sparsely,specimen,stem,stigma,straight,style,surface,tall,tan,tapering,tear-drop,terminal,thick,thickened,thicker,third,time,tip,tree,trichome,tub,tube,ud,uniseriate,unit,usually,variable,vein,way,weight,white,whitish,widest,winged,woody,x,ympodial,young	
448	wfo-0001031207	success	219	232	190	29	42	0.868	-0.4,-1/2,-11,-4,-5,-7,-8,/5,0,0-0.5,0-10,0-20,0.1-0.2,0.1-0.3,0.1-0.5,0.2,0.2-0.3,0.25-0.5,0.3-0.5,0.5-1,0.6-0.9,0.6-1.2,0.7-2,0.8,0.85-1.4,0.9-1.6,1,1-3,1-4,1-5,1.4-2,1.5-5,1/3,1/3-equal,1/4-1/3,2-3,2-4,2.1-2.3,2.5-,2.8-3,3-5,3.5-7,5-8,6-8,6.5-8,9,acute,ame,anther,apart,apex,apically,apparently,articulated,bark,base,berry,blade,branched,bristle,bristly,broad-deltate,c.,calyx,cell,chartaceous,cm,concolorous,cordate,curved,dark,densely,diameter,difoliate,discolorous,distance,drying,dull,elongated,equal,erect,evenly,extending,filament,filiform,flattened-reniform,flower,free,fruit,fruiting,gently,glabrescent,glabrous,gray,green,herb,herbaceous,infructescence,lanceolate,lateral,leaf,length,less,like,lobe,lobed,long,longer,lower,margin,mature,maturity,mauve,midpoint,midvein,mm,moderately,multangulate,narrow-deltate,oblong,obtuse,occasionally,older,one,open,orange-brown,outline,ovate,pair,pale,pedicel,peduncle,pendulous,per,perpendicular,persistent,petiole,pit,poricidal,porrect,portion,prickle,prickly,primary,raised,ray,red,reflexed,rounded,scandent,shorter,shrub,side,simple,small,smooth,sometimes,spaced,spherical,spreading,stalk,stalked,stellate-pubescent,stem,straight,style,subentire,surface,tapering,terete,terminal,time,tip,toward,trichome,tube,unarmed,unit,upper,usually,variously,vein,visible,way,weakly,white,wide,yellow,yellow-green,young	.1,1/,5-merous,abaxially,acuminat,alyx,apar,brow,eaf,eed,elongating,eye,geminat,naked,nflorescence,orolla,oung,perfec,pericarp,prickl,ruit,scar,sessile,stellate,tamen,tertiary,vary,venation,ympodial	1/4,acuminate,appearance,arrangement,border,branch,brown,bud,characteristic,colour,corolla,corrugation,distal,exertion,form,geminate,giving,glabrousnes,growth,height,history,inflorescence,interjected,leaflet,life,lobing,new,null,number,ovary,plant,pseudostipule,seed,shape,size,stigma,sympodial,texture,thicknes,type,variation,width
449	wfo-0001031218	success	154	173	114	40	59	0.74	0.5,0.5-1,1-2,1-3,1-4,15-25,2-2.5,2-22,2-3,2.5-3,3,3-5,4-28,4-5,4-7,4-8,40,40-100+,5-37,5.5-7,6-10,6-7,6-9,8-17,8-20,abaxially,acuminate,acute,adaxially,aggregate,apex,apiculate,axe,basal,base,beyond,branched,calyx,cell,cm,connivent,cordate,cylindrical,dark,densely,diameter,directed,distally,eglandular,ellipsoidal,entire,especially,exserted,flattened,flower,fruit,glabrous,glandular,glandular-puberulent,globose,greenish-purple,hair,introrse,lanceolate,lavender,less,lobe,long,margin,minutely,mm,moderately,mottled,narrowly,oblique,obtuse,orange,ovate,ovate-elliptic,ovoid,pedicel,peduncle,perfect,petiole,pore,present,puberulent,pubescent,purple,radiu,ripe,shorter,simple,slightly,small,sometimes,sparsely,stamen,stigma,stone,style,subcoriaceous,succulent,time,tip,toward,tree,triangular,tube,unit,violet,wide,x,yellow	-5,10-19,3-14,4-foliat,5-7,apart,ape,articulated,blade,connective,coriaceous,eaf,eed,eglandular-pilose,equal,exceeding,glabrou,leaving,lon,lower,nflorescence,nther,orolla,papillo,pedicellar,presen,purpl,rachi,remnant,ruit,spaced,stellate,tal,tem,thecae,tomento,truncat,ud,vary,ympodial	4-foliate,anther,appearance,arrangement,bark,border,branch,bud,characteristic,colour,corolla,corrugation,distal,drying,exertion,filament,form,fruiting,giving,glabrousnes,growth,height,history,inflorescence,interjected,lateral,leaf,leaflet,length,life,lobing,midpoint,new,null,number,ovary,papillose,per,plant,prickle,primary,pseudostipule,ray,seed,shape,size,stem,surface,sympodial,tall,terminal,texture,thicknes,tomentose,truncate,type,variation,vein,width
450	wfo-0001031225	exception_thrown	163	0	0	163	0	0.0		.25,.5,/3,0.1-0.75,0.2,0.2-0.75,0.5,0.5-1,0.7-6,0.75-1,0.8-1,1-1.5,1-1.7,1-3,1-5,1.5-5,2,2.5-3,3-9,3/4,5-50-flowered,5-6,6-8,7-9,9-16,acute,along,anther,anthesi,apart,apex,bark,base,beginning,berry,broadly,bud,calyx,characteristic,closely,cm,conspicuous,corolla,cup-shaped,darker,decurrent,deltoid,dia,differentiated,differing,difoliate,dry,eaf,edicel,eed,ellipsoid,elliptic,erect,exserted,filament,flattene,fragrant,free,fruiting,furcate,geminat,glabrate,glabrous,globose,green,greyish-brow,growth,inflorescenc,inflorescence,lateral,leaf,less,like,live,lobe,lobed,lon,long,lower,main,major,margin,middle,minor,minute,minutely,mm,much,narrowly,nflorescence,often,older,one,opposite,outline,ovary,ovate,ovoid-reniform,pair,pale,papillo,papillose,pedicel,petiole,pitted,plant,pore,poricidal,portion,prominent,proximal,pubescent,raised,red-papillose,reflexed,rest,rhomboidal,rounded,ruit,scar,shape,shaped,shrub,size,slender,slightly,small,soon,spaced,specimen,stem,stigma,straight,strongly,style,surface,sweetly,swelling,tall,tan,tapering,tear-drop,tip,tree,trichome,tube,ud,unevenly,uniseriate,unit,vein,way,white,widest,woody,x,ympodial,young	
451	wfo-0001031231	success	175	170	120	55	50	0.686	-2,0.5-1.5,1-1.5,1-2,1-4,1.5-2,13,2-3,2-4,2.5-3,25-35,37/2,37/3,4-8,5-7,8-10,absent,acuminate,acute,almost,anther,apex,aromatic,aspect,axillary,base,becoming,berry,bluntly,branch,branched,brown,calyx,campanula,campanulate,clonal,cluster,cm,colour,corolla,dark,declinate,discoidal,ellipsoid,elliptic,entire,equal,erect,except,exerted,filament,flower,fork,general,glabrous,globose,green,greyish,habit,hair,juvenile,lanceolate,lasting,leaf,len,less,lobe,long,marbled,margin,mature,mauve,minute,mm,oblong,occasionally,often,ovary,pedicel,pedicellate,peduncle,petal,pinnatisect,plant,purple,rarely,rh,ripe,ripening,rounded,rugose-ruminate,seed,sessile,several,shallow,short,shrub,simple,sinus,slightly,small,soft,sometimes,stigma,stout,style,succulent,surface,tinged,tip,toward,translucent,triangular,unit,variable,vigorous,violet,wooded,x,year	.5,1-3,3-4,80-110,acumen,adherent,along,anthesi,axi,basal,beyond,blunt,cell,developed,dia,eaf,eed,exceeding,expanded,facetted,fleshy,flowering,folded,glandular,gree,herbarium,interacuminal,lengthening,lon,loosely,lower,midrib,nflorescence,pedice,pentagonal,plurifoliat,pore,poricidal,projecting,readily,recurve,rotate,ruit,shed,slit,specimen,stone,stonrgly,tissue,tub,ud,usually,well,without,ympodial	appearance,arrangement,bark,border,bud,characteristic,corrugation,diameter,distal,drying,exertion,form,fruit,fruiting,giving,glabrousnes,growth,height,history,inflorescence,interjected,lateral,leaflet,length,life,lobing,midpoint,na,new,number,per,petiole,plurifoliate,prickle,primary,pseudostipule,ray,shape,size,stem,strongly,sympodial,terminal,texture,thicknes,tube,type,variation,vein,width
452	wfo-0001031252	success	170	175	129	41	46	0.759	0.2-1.5,0.3-1.1,0.4-3,1-2,1-3,1.3-1.9,1.75-5.2,12-20,16-33,2-3,2.5-7,2.8-3.6,3-10,3-5,3-6,5-17,5-8,5-9,5.5-6.5,7-18,abaxially,absent,acumen,acute,adaxially,along,anther,apart,apex,apparently,arranged,attenuate,axillary,base,bead,berry,blade,brownish,bud,cell,clavate,cm,condition,connivent,coriaceous,corolla,covering,cuneate,dark,deep,diameter,digestion,distal,drying,elliptic,entire,enzyme,exceeding,filament,flower,forked,fresh,fruit,generally,glabrous,globose,green,green-white,greenish,hair-like,half,herb,honeycomb-shaped,interjected,lanceolate,lateral,leaflet,light,like,linear,lobe,long,make,margin,medium,mm,moniliform,mottled,mucilaginous,multiple,necklace,ovate,ovoid,pedicel,peduncle,perfect,petiole,plant,plurifoliate,purple,removed,ripe,rounded,seed,simple,sometimes,stamen,stigma,stolon,straight,stripe,style,subtending,terminal,testal,thick,throughout,tri-,tube,tuber,typically,unit,unwinged,usually,wall,wet,white,whitish,x	5-merou,adaxiall,ag,alyx,articulated,axe,capitat,ciliate,dorsally,eaf,edge,eed,erec,flat,folded,geminat,glabrou,hal,high,homostylous,lengthening,living,lower,nflorescence,orolla,pore,poricidal,rotate,ruit,serrate,seudostipule,slit,spaced,specimen,tall,tamen,tem,tip,vary,yellow,ympodial	appearance,arrangement,bark,border,branch,calyx,capitate,characteristic,colour,corrugation,erect,exertion,form,fruiting,geminate,giving,glabrousnes,growth,height,history,inflorescence,leaf,length,life,lobing,mentioned,midpoint,new,number,ovary,per,prickle,primary,pseudostipule,ray,shape,size,stem,surface,sympodial,texture,thicknes,type,variation,vein,width
453	wfo-0001031257	success	206	231	180	26	51	0.874	-12,-22.5,-5,-6,0,0.4,0.5,0.5-0.8,0.7-1,0.75-2.5,1-1.2,1-1.3,1.1-1.2,1.5,1.5-1.7,1.5-2,1/10,10-16,11.5-15,2-,2-4.5,3,3.5-,3.5-5.7,4-10,4-4.5,4.5-,5,5-8.5,6-12,6-celled,7-,7.5-9,8,abaxially,abundant,acuminate,adaxially,aggregate,anther,anthesi,antrorse,apex,ascending,attenuate,basal,base,berry,blue-violet,branch,broad,bud,calyx,campanulate,cell,cm,coarsely,coat,connectival,corolla,cotyledon,cuneate,curved,dark,deep,densely,dentate,diameter,difoliate,directed,dorsally,edentate,ellipsoidal,embryo,endosperm,epidermal,erect,filament,finely,flexuous,foliage,free,fruiting,glabrous,glandular,globose,hair-like,half,herb,herbaceous,high,hollow,honey-combed,inconspicuous,inserted,lamina,lateral,leaf,length,light,like,little,lobe,long,long-stalked,longer,longitudinal,longitudinally,lower,many-seeded,margin,midvein,mm,narrowly,non-glandular,odorles,opening,outward,ovate,pair,papillate,patent,pericarp,petiole,pore,poricidal,portion,prolongation,pubescent,purple,rarely,reduced,rest,ridged,ring,robust,scarce,secondary,seed,serrate,short-stalked,shorter,shrub,simple,sinus,slightly,slit,small,solitary,somewhat,spur-like,stem,stigma,stone,strand,striate,style,subglobose,thecae,thickened,thickening,time,tip,tooth,trans-ovoidal,triangular,trichome,tube,unequal,unit,upward,vein,ventrifixed,verrucate,viscid,wall,white,within,x,yellow	5-,8-celled,accrescen,ag,bicellular,cuticle,diamete,eaf,eed,elliptical,geminat,head,lon,orolla,ree,ruit,saddle-shape,scarcely,separated,single-celled,smooth,stalk,tem,vary,viscid-pubescen,ympodial	accrescent,age,appearance,arrangement,bark,border,characteristic,colour,corrugation,distal,drying,exertion,flower,form,fruit,geminate,giving,glabrousnes,growth,height,history,inflorescence,interjected,leaflet,life,lobing,midpoint,new,null,number,ovary,pedicel,peduncle,per,plant,prickle,primary,pseudostipule,ray,saddle-shaped,shape,size,surface,sympodial,terminal,texture,thicknes,type,variation,viscid-pubescent,width
454	wfo-0001031270	success	234	200	166	68	34	0.709	+,.5,0.4-1.5,0.5-1,1,1-1.2,1-4,1.2-1.6,1.5,1.5-2,1/3,10,10-12,100,2-2.5,2-20,2-3,2-4,2-7,2.5-3,3-10,3-20,4-5,5,5-15,5-6,6-17,6-50,9-10,>,acute,along,anther,anthesi,apex,associated,bark,base,berry,bipinnatifid,blade,bright,brown,c.,calyx,capitate,cell,celled,clavate,cm,conical,curved,deeply,densely,depressed-spherical,diameter,directed,distal,elliptic,entire,erect,few-rayed,filament,flower,free,fruiting,glabrous,gland,glandular,glandular-pubescent,green,growth,herb,inflorescence,infructescence,lateral,leaf,leaf-opposed,length,like,live,lobe,lobed,long,long-styled,margin,membranous,midpoint,midvein,minute,minutely,mixture,mm,multiseriate,new,obovate,outline,ovoid,pair,pale,pedicel,peduncle,per,petiole,pinnatifid,pitted,plant,pore,poricidal,prickle,prickly,primary,pubescent,ray,red,reddish,reniform,rest,ripe,rounded,scattered,sessile,shallowly,short-stalked,short-styled,shrub,simple,single,sinuate,size,slender,slightly,small,sparsely,spherical,spreading,stalk,stellate,stem,stigma,straight,straw-colored,style,surface,tan,tapering,terete,testal,tip,tissue,trichome,truncate,tube,uniseriate,upward,varying,vein,way,white,wice,wide,wing,woody,yellow,yellowish,Â½	1-3,3-5,5-10,5-merous,7-12,8,abaxial,abaxially,accrescent,adaxial,adaxiall,alyx,apart,arme,articulated,basal,beginning,brow,colored,connivent,consistently,differentiated,difoliate,eed,ellipti,equal,frui,geminat,heavily,heterostylous,investing,later,leafy,lon,longer,loosely,lower,multangulate,narrowly,nflorescence,occasionally,often,older,orolla,oung,papillo,pericarp,portion,rachi,reflexed,ruit,scar,secondary,shallow,shining,staminat,strongly,tall,tamen,thin,thus,tightly,unit,usually,vary,well,wid,ympodial	appearance,arrangement,border,branch,bud,characteristic,colour,corolla,corrugation,drying,exertion,form,fruit,giving,glabrousnes,height,history,interjected,leaflet,life,lobing,null,number,ovary,papillose,pseudostipule,seed,shape,terminal,texture,thicknes,type,variation,width
455	wfo-0001031283	success	52	104	45	7	59	0.865	-0.25,0.1-0.15,0.4-0.5,0.5-0.7,0.7,2.2-2.8,30-40,acute,apex,appearance,base,brown,calyx,cell,cm,diameter,elongating,erect,fide,fruit,hair-like,lateral,lobe,long,markedly,mm,moore,narrowly,outgrowth,pale,pleasant,pubescent,shrub,silky,small,smelling,somewhat,sprawling,surface,tall,testa,wall,wide,winged,woody	.7-2.3,eed,give,lo,obovate,spreadin,thick	1.7-2.3,anther,arrangement,bark,border,branch,bud,characteristic,colour,corolla,corrugation,distal,drying,exertion,filament,form,fruiting,giving,glabrousnes,growth,height,history,inflorescence,interjected,leaf,leaflet,length,life,lobing,margin,mentioned,midpoint,new,number,ovary,pedicel,peduncle,per,petiole,plant,prickle,primary,pseudostipule,ray,seed,shape,size,spreading,stem,stigma,style,terminal,texture,thicknes,tube,type,variation,vein,width
456	wfo-0001031287	success	147	169	123	24	46	0.837	.5,0.5-1.5,0.9-1,1,1-1.2,1-1.3,1-1.5,1-5,1.5-2,1.5-5.5,2-2.5,3-4,3-5,4-5,4-6,4.5-5,5-14,6-10-flowered,6-7,abaxially,acute,adaxially,anther,anthesi,apex,attenuate,axil,bark,base,bearing,berry,bi-lobed,branch,calyx,cm,conical,corolla,dark,deflexed,deltate,dendritic,densely,dia,difoliate,divergently,ellipsoid,elliptic,elongate,erect,exserted,filament,fleshy,free,fruiting,glabrous,globose,green,greenish-white,internodal,knob,later,lateral,leaf,lobe,lobed,long,main,margin,membranous,middle,minutely,mm,nearly,older,onto,ovary,ovoid-reniform,pair,pale,papillose,pedicel,petiole,pitted,planar,plurifoliate,pointed,pore,poricidal,portion,pubescent,red-papillose,reflexed,rounded,shaped,shoot,short,shrub,simple,sinus,small,somewhat,spaced,stem,stigma,strongly,style,surface,tan,tear-drop,thick,thin,tip,trichome,tube,tuft,unevenly,vein,white,widest,winged,woody,x,young	apar,ape,connective,coriaceous,eaf,edicel,eed,enlarged,frui,geminate,lamina,lon,lower,many,nflorescence,occasionally,papillo,reddish-brow,ruit,scar,tub,ud,unit,ympodial	apart,appearance,arrangement,border,bud,characteristic,colour,corrugation,diameter,distal,drying,exertion,form,fruit,giving,glabrousnes,growth,height,history,inflorescence,interjected,leaflet,length,life,lobing,midpoint,new,null,number,peduncle,per,plant,prickle,primary,pseudostipule,ray,reddish-brown,seed,shape,size,terminal,texture,thicknes,type,variation,width
457	wfo-0001031300	exception_thrown	219	0	0	219	0	0.0		-2.2,-4,-5,-6,.5,/4,0-15,0-20,0-3,0-8,0.1,0.1-0.5,0.1-0.6,0.15-0.7,0.2-0.4,0.2-0.5,0.2-0.7,0.2-1,0.3,0.3-0.6,0.3-1.3,0.5-0.9,0.5-1.5,0.5-18,0.5-2,0.6-0.8,0.6-1,0.6-1.2,0.7-0.9,0.7-1.2,0.8-1.5,1-2,1-4,1-5,1.2-1.7,1.3-2,1.5-3.5,1/2-3/4,1/3-1/2,1/6-1/4,10-30,2-,2-3,2-4,2-5.5,2-6,2.2-2.3,2.2-2.7,2.5-3.2,3-,3-4,4,4.5-6,5-15,5-merous,6-8,abaxially,absent,acute,also,alyx,anther,apar,apart,apex,apically,apparently,articulated,attenuate,ba,bark,base,berry,blade,branched,brow,brown-green,bulbous,calyx,caudat,cell,chartaceous,cm,concolorous,connivent,creeping,curved,deltate,densely,diameter,difoliate,distance,drying,dull,eaf,eed,elongating,equal,erect,extending,eye,filament,filiform,flattened,flattened-reniform,flower,free,fruit,fruiting,geminat,geniculate,glabrescent,glabrous,gray-green,hair,herbaceous,highly,infructescence,lateral,leaf,length,lobe,lobed,lon,long,longer,lower,margin,mature,maturity,membranous,midpoint,midvein,minute,mm,moderately,naked,near,nflorescence,oblanceolate,oblong,obtuse,older,one,open,orange,orange-brown,orange-green,orolla,oung,outline,pair,pale,pedicel,peduncle,pendulous,per,perfec,pericarp,petiole,pit,poricidal,porrect,portion,prickl,prickle,prickly,primary,pubescent,raised,rarely,ray,red,reduced,rounded,ruit,scar,sessile,shrub,side,simple,small,smooth,spaced,sparsely,spherical,spreading,stalk,stalked,stellate,stellate-pubescent,stem,style,surface,tamen,tapering,terete,tertiary,thin,time,tip,trichome,tube,uniradiate,unit,vary,vein,venation,visible,way,weakly,white,wide,wider,winged,yellow,yellow-green,yellow-orange,ympodial	
458	wfo-0001031310	success	203	166	124	79	42	0.611	.5,0-3,0.5-3,1-10,1-2,1-3,1-5.5,1-6,1.5-4,15-40,2-3,2.5-5.5,2.5-8.5,3-10,4-10,4-12,4.5-4.8,5-6,5-7,5.5-21,6-7,abaxially,absent,acumen,acuminate,adaxially,anther,apart,apex,apparently,articulated,axe,axillary,base,berry,blue,blue-purple,brown,brownish,bud,cell,ciliate,cm,condition,connivent,conspicuously,corolla,covering,decurrent,diameter,distal,drying,filament,flower,forked,fresh,fruit,generally,globose,green,greenish,hair,half,herb,high,interjected,lanceolate,lateral,leaf,leaflet,less,light,like,lobe,long,make,margin,mm,mottled,mucilaginous,multicellular,obtuse,odd-pinnate,ovate,ovate-elliptic,ovate-lanceolate,ovoid,pale,pedicel,peduncle,perfect,petiole,pilose,plant,pubescent,purple,rachi,rosette-forming,seed,shortly,simple,size,slightly,sometimes,somewhat,spaced,sparsely,stem,stigma,streak,style,subrosette-forming,subtending,terminal,testal,thick,tube,unwinged,usually,wall,wet,white,whitish,x	0-4,5-merou,ag,along,alyx,attenuate,blade,borne,broadly,caly,chartaceous,cuneate,decreasing,digestion,dorsally,eaf,edge,eed,elliptic,end,enzyme,erect-decumben,especially,exceeding,extremely,flat,folded,geminat,glabrou,glabrous,gradually,green-white,hair-like,homostylous,honeycomb-shaped,larger,lengthening,living,lower,membranous,midrib,minutely,narrowly,nflorescence,orolla,pair,petiolule,plurifoliate,pointed,pore,poricidal,puberulent,removed,rotate,ruit,seudostipule,singly,slit,small,specimen,stamen,ste,stolo,straight,subellipsoi,tall,tamen,tem,throughout,tip,tissue,toward,tri-,tuber,typically,unit,vary,yellow,ympodial	'hair-like,appearance,arrangement,bark,border,branch,calyx,characteristic,colour,corrugation,erect-decumbent,exertion,form,fruiting,giving,glabrousnes,growth,height,history,inflorescence,length,life,lobing,mentioned,midpoint,new,number,ovary,per,prickle,primary,pseudostipule,ray,shape,subellipsoid,surface,texture,thicknes,type,variation,vein,width
459	wfo-0001031316	success	207	219	178	29	41	0.86	-2,.1,/3,0.05-0.1,0.05-0.15,0.1-0.2,0.3-1,0.4-0.6,0.4-0.8,0.5-2,0.6-1,0.8-1.2,0.8-1.8,0.9-1.3,1-5,1.2-2.1,1.3-3.5,1.5-2,1.5-3.5,1.5-5,1/3-2/3,2-20,2-3,2-4,2.5-8,3-10,3-8,3.5-3.8,3.8-5,4,4-7,4-9,5-10,5-15,5-6,5-8,6-20,8-11,8-12,8-25,abaxial,abaxially,acuminate,acute,adaxial,almost,ame,anther,apex,apically,apparently,articulated,bark,base,becoming,berry,blue-mauve,branched,bright,broad,c.,calyx,cm,colored,concolorous,connivent,contrast,cream,curved,dark,densely,diameter,difoliate,discolorous,drying,dull,elongating,entire,erect,eye,fifth,filament,flattened-reniform,flower,four,free,fruit,fruiting,geminat,glabrescent,glabrous,gray,green,hair,held,herbaceous,infructescence,inward,lateral,leaf,length,lobe,lobed,long,lowermost,margin,marking,mature,maturity,membranous,midpoint,minute,mm,moderately,multangulate,naked,narrow-deltate,obtuse,older,one,open,orange,orange-brown,ovate,pair,pale,pedicel,peduncle,pendulous,per,pericarp,petiole,poricidal,porrect,portion,primary,purple,ray,red-brow,red-brown,reflexed,sessile,shrub,simple,slender,smooth,sometimes,sparsely,spherical,spreading,stalk,stalked,stellate-pubescent,stem,strongly,style,surface,tapering,terete,terminal,time,tip,trichome,tube,unarmed,unequal,unit,variously,vein,visible,way,white,white-green,whitish,wide,yellow,yellow-green,young	1.5-,1/3-1/2,5-merous,alyx,apar,blade,eaf,eed,foliaceou,glabrou,long-acuminat,longer,lower,nflorescence,orolla,oung,perfec,ruit,scar,spaced,stellate,stellate-pubescen,tamen,tertiary,unarme,usually,vary,venation,ympodial	appearance,arrangement,border,branch,bud,characteristic,colour,corolla,corrugation,distal,exertion,foliaceous,form,giving,glabrousnes,growth,height,history,inflorescence,interjected,leaflet,life,lobing,long-acuminate,mentioned,new,number,ovary,plant,prickle,pseudostipule,seed,shape,size,stigma,sympodial,texture,thicknes,type,variation,width
460	wfo-0001031333	success	194	186	137	57	49	0.706	+,.5,0.5,1-1.5,1-4,1-5,1.2-2,1.5,1.5-1.7,1.5-2,2,2-3,2.5-3,2.7-7,3-4,30-40,5-7,5-8,50,7-10,7-9,<,>,?,acuminate,acute,adaxially,adjacent,almost,anther,anthesi,apex,appearing,base,berry,bilobed,branched,broadly,brown,calyx,capitate,cell,cm,composed,conical,cupped,densely,denser,diameter,ellipsoidal,elliptic,entire,exserted,filament,flattened,flower,glabrescent,glabrous,globose,golden,green,greenish,growth,half,immature,inflorescence,lamina,less,like,lobe,long,lower,many,margin,membranous,mere,minute,minutely,mm,narrowly,near,new,nodding,occasionally,older,outline,ovate,pair,pale,pedicel,peduncle,per,petiole,pitted,planar,primary,pubescent,quadrate,reniform,rest,simple,sinus,slightly,somewhat,soon,sparsely,splitting,stem,stigma,striped,strongly,style,surface,tangled,terminal,thickened,time,trailing,triangular,trichome,truncate,tube,twining,undersurface,undulation,uniseriate,unit,upper,vein,venation,vine,white,whitish,woody,x,yellow,yellowish	0.1-0.5,1/2,3/4,5-merou,abaxially,adaxiall,ag,alyx,apart,ark,articulated,branche,clustered,collection,crea,eaf,eed,free,fruting,glabrescen,high,ilament,leaving,lengthening,lobed,m.,matte,nflorescence,orolla,papillat,peg,penden,pentagonal,perfect,pericarp,plurifoliat,pore,poricidal,portion,pubescent-papillate,rhachi,ruit,scar,slit,small,ste,stellate,tem,testal,thin,tip,ud,unequal,unevenly,vary,way,ympodial	alternate,appearance,arrangement,bark,border,branch,bud,certain,characteristic,colour,corolla,corrugation,cream,distal,drying,exertion,form,fruit,fruiting,giving,glabrousnes,height,history,interjected,lateral,leaf,leaflet,length,life,lobing,midpoint,null,number,ovary,papillate,plant,plurifoliate,prickle,pseudostipule,ray,seed,shape,size,sympodial,texture,thicknes,type,variation,width
461	wfo-0001031333	success	194	181	136	58	45	0.701	+,.5,0.5,1-1.5,1-4,1-5,1.5,1.5-1.7,1.5-2,1/2,2-3,2.5-3,2.7-7,3-4,3/4,30-40,5-7,5-8,50,7-10,7-9,<,>,?,acuminate,acute,adaxially,adjacent,almost,anther,apex,appearing,bark,base,berry,bilobed,branched,broadly,brown,calyx,capitate,cell,cm,composed,conical,corolla,cream,densely,denser,diameter,ellipsoid,elliptic,entire,exserted,filament,flattened,flower,fruiting,glabrescent,glabrous,globose,golden,green,greenish,growth,half,immature,inflorescence,lamina,less,like,lobe,lobed,long,lower,many,margin,mere,minute,minutely,mm,narrowly,near,new,occasionally,older,outline,ovate,pair,pale,pedicel,peduncle,per,petiole,pitted,primary,pubescent,quadrate,reniform,rest,simple,sinus,somewhat,soon,sparsely,splitting,stem,stigma,striped,strongly,style,surface,tangled,terminal,thickened,time,trailing,triangular,trichome,truncate,tube,undersurface,undulation,unevenly,uniseriate,unit,upper,vein,venation,vine,way,white,whitish,wide,woody,yellowish	0.1-0.5,1-5-2,2,3,5-merou,abaxially,adaxiall,ag,alyx,anthesi,apart,articulated,branche,clustered,cupped,eaf,eed,free,glabrescen,high,ilament,leaving,lengthening,m.,matte,membranous,nflorescence,nodding,orolla,papillat,peg,penden,perfect,pericarp,planar,plurifoliat,pore,poricidal,portion,pubescent-papillate,rhachi,rotate-stellate,ruit,scar,slightly,slit,small,spaced,stellate,testal,thin,tip,tub,twinin,ud,unequal,vary,ympodial	1-1.5-2,appearance,arrangement,border,branch,bud,characteristic,colour,corrugation,distal,drying,exertion,form,fruit,giving,glabrousnes,height,history,interjected,lateral,leaf,leaflet,length,life,lobing,midpoint,number,ovary,papillate,plant,plurifoliate,prickle,pseudostipule,ray,seed,shape,size,specified,sympodial,texture,thicknes,twining,type,variation,width
462	wfo-0001031359	exception_thrown	166	0	0	166	0	0.0		.02,.25,.5,/4,0.5-1,0.5-6,0.75-1,1-4,1.1-1.6,1.2-1.6,1.2-2.5,1.3-1.6,1.5-2,1.6-2.8,1.9-2.3,12-21,2.5-3,3-3.5,3.6-8.8,5-30-flowered,5-7,5-angled,5.3-7.5,6-7,acuminate,angle,anther,anthesi,apart,apex,apiculate,appearing,attenuate,axil,ba,bark,base,beginning,beneath,berry,bi-lobed,broadly,brown,calyx,cm,corolla,curled,dark,deflexed,dia,differing,difoliate,distal,dried,dull,eaf,edicel,eed,elliptic,evenly,extending,filament,flattened-reniform,free,fruiting,geminat,glabrous,globose,green,incrassate,inflorescenc,internodal,interpetalar,lamina,lateral,leaf,live,lobe,lobed,lon,long,lower,main,major,margin,membraneous,middle,minor,minutely,mm,narrowly,near,nearly,nflorescence,obovoid,occasionally,often,older,one,opposite,originating,outline,ovary,pair,paler,papillae,papillo,papillose,pedicel,petiole,pit,pitted,planar,plant,pore,poricidal,portion,reflexed,ridged,ripe,round,ruit,rusty,scar,shaped,shiny,shrub,simple,sinus,size,slender,slightly,somewhat,spaced,specimen,stem,stigma,straight,strongly,style,surface,tall,tan,tapering,tear-drop,tip,triangular,trichome,tub,tube,tuft,ud,undulate,uniseriate,unit,vein,way,white,white-lenticellat,widest,woody,x,yellow,yellow-orange,ympodial,young	
463	wfo-0001031362	success	138	168	123	15	45	0.891	.2,.3,.5,0.4-0.5,0.5-1,0.7-1,1-1.1,1-1.5,1-3,1-3-flowered,1-4,1.5-2,2-2.5,3-4,3-6,?,abaxially,acute,adaxially,along,anther,anthesi,apex,appearance,attenuate,bark,base,berry,branch,brown,bushy,calyx,cell,closely,cm,conical,corolla,dendritic,densely,denser,dia,ellipsoid,erect,exceeding,exserted,filament,flattened,flattened-reniform,free,fruiting,giving,glabrous,globose,golden,incrassate,internodal,lamina,lanceolate,lateral,leaf,like,lobe,lobed,long,long-triangular,main,margin,middle,minutely,mm,nearly,nodding,older,opposite,orange-red,outline,ovary,packed,pair,pale,papillose,pedicel,pericarp,petiole,pitted,planar,pore,poricidal,portion,pubescent,pubesent,rectangular,red,rest,rounded,scar,shaped,shiny,shrub,simple,slender,small-capitate,somewhat,spaced,sparsely,stem,stigma,straight,style,subshrub,surface,tan,tear-drop,thin,tip,trichome,tube,vein,white,widest,woody,x,young	eaf,edicel,eed,golden-brow,inflorescenc,lon,lower,nflorescence,overlappin,papillo,plurifoliat,ruit,ud,unit,ympodial	arrangement,border,bud,characteristic,colour,corrugation,diameter,distal,drying,exertion,flower,form,fruit,glabrousnes,golden-brown,growth,height,history,inflorescence,interjected,leaflet,length,life,lobing,mentioned,midpoint,new,number,overlapping,peduncle,per,plant,prickle,primary,pseudostipule,ray,seed,shape,size,terminal,texture,thicknes,type,variation,width
464	wfo-0001031400	success	161	194	142	19	52	0.882	-3,0.25-0.8,0.4-1.7,0.6-1.8,0.7-6,0.8-1.1,1,1-,1-4,1.2-2,1.5-5,10-11,2,2-3,2-5,2-9,4-,4-13,4-17,4-6.5,4-7,5-12.5,6-23,7-25,7-28,abaxial,abaxially,abruptly,acumen,acute,adaxially,apex,apical,apically,apiculate,articulate,base,branched,calyx,cell,cm,connate,corolla,covering,cuneate,cyme,dark,decurrent,deeply,dehiscent,diameter,dichasial,dichasially,digestion,diminishing,distal,dorsally,ebracteate,edge,enzyme,exceeding,filament,flat,flower,folded,forked,forming,generally,globose,green,green-white,hair-like,half,herbaceous,honeycomb,interjected,introrse,lateral,leaf,leaflet,linear,linear-lanceolate,living,lobe,long,make,maturing,mm,monochasial,mucilaginous,oblique,oblong,occasionally,odd-pinnate,often,ovoid,pair,pattern,pedicel,peduncle,perennial,perfect,petiole,plant,poricidally,proximal,puberulent,rachi,reveal,seed,sessile,short,side,size,slit,specimen,stamen,stellate,stigma,straight,stripe,structure,style,subglabrous,terminal,testal,thick,throughout,tip,tone,toward,trilobe,tuber-bearing,typically,unit,violet,wall,white,wide,without,yellow,Â¼	3-6-foliat,absen,eaf,eed,emoval,globo,lon,lower,lunat,nflorescence,nther,orolla,plan,ruit,seudostipule,tal,tem,vary,ympodial	3-6-foliate,absent,anther,appearance,arrangement,bark,border,branch,bud,characteristic,colour,corrugation,drying,exertion,form,fruit,fruiting,giving,glabrousnes,growth,height,history,inflorescence,length,life,lobing,lunate,margin,midpoint,new,null,number,ovary,per,prickle,primary,pseudostipule,ray,removal,shape,stem,surface,sympodial,tall,texture,thicknes,tube,type,variation,vein,wet,width
465	wfo-0001031401	exception_thrown	182	0	0	182	0	0.0		0.5,0.6-1.2,0.8-1.2,1,1-1.4,1-1.5,1-6,1.1-3,1.5-2,1/2,2-2.4,2-5,2.5-4,3,3.5-4,3/4,5,5-7,5-9,7-9,8-10,abaxial,abaxially,acute,adaxial,adaxially,age,along,anther,anthesi,apex,apical,appearing,attenuate,axi,bark,basal,base,becoming,berry,bi-lobed,black,blade,branch,branching,brown,calyx,clearly,cm,conical,corolla,dark,deciduous,deflexed,deltoid,dendritic,densely,denser,diameter,dichasial,differentiated,drying,eaf,ecuador,ecuadorian,edicel,eed,elliptic,ew,exserted,filament,finely,flattened,flower,fork,free,fruit,fruiting,glabrous,globose,golden,golden-yellow,growth,impressed,inserted,lateral,leaf,lenticular,less,lobe,lobed,long,long-triangular,lower,m.,matted,mesophyll,minutely,mm,monochasia,narrowly,near,new,nflorescence,noddin,nodding,node,occasionally,often,older,outline,ovary,overtopping,pair,papillo,pedicel,per,pericarp,petiole,pitted,planar,plurifoliate,pore,poricidal,portion,prominently,puberulent,pubescen,pubescent,purplish-black,pyramidal,raised,reddish-brown,rounded,roundish,ruit,scar,secondary,shiny,shoot,short,shrub,sleev,slit-like,small,sometimes,somewhat,sparsely,specimen,stamen,ste,stem,stigma,strongly,style,surface,tall,tapering,terminal,thin,time,tip,tree,tree-like,trichome,tub,tube,ud,unit,usually,vein,violet,visible,way,white,wide,winged,woody,x,yellow,ympodial,young	
466	wfo-0001031480	success	237	242	204	33	38	0.861	-0.25,-2,/3,0,0-0.5,0-1,0-2,0-30,0-5,0.1,0.1-0.3,0.1-0.4,0.15-0.3,0.4,0.5-2,0.6-0.8,0.7,0.8,0.8-1,1-1.3,1-1.5,1-3,1-4,1.5-2.2,1.7-2.2,1.8-3,1/3,1/4,1/6-1/5,2-,2-2.7,2-5,2-6,3,3-10,3-6,3-7,3.5-7,4-5,4-6,5-8,5-merous,6-13,6-30,6-8,7-8,8-12,abaxial,abaxially,acute,adaxial,andromonoecious,anther,apart,apex,apically,apparently,articulated,bark,base,berry,blade,branched,branching,bright,broad-deltate,calyx,cell,cm,cream,cuneate,curved,dark,densely,diameter,difoliate,discolorous,distal,distance,drying,dull,ellipsoid,elongate,elongating,entire,erect,extending,eye,faint,filament,flattened-reniform,flower,fruit,fruiting,glabrescent,glabrous,glandular,green,hair,hermaphrodite,heterostylous,infructescence,lateral,leaf,length,lobe,lobed,long,long-styled,longer,lowermost,margin,marking,mature,maturity,mauve,midpoint,midvein,minutely,mm,moderately,naked,near,obtuse,often,older,one,open,orange-brown,outline,ovate,pair,pale,pedicel,peduncle,pendulous,per,pericarp,persistent,petiole,pit,plant,poricidal,porrect,prickle,prickly,primary,purple,raised,ray,red,red-brown,red-green,red-yellow-green,reduced,reticulate,rounded,scandent,scar,sessile,shallowly,short-styled,shorter,shrub,side,simple,slender,small,smooth,somewhat,spaced,spherical,spreading,stalk,stalked,stellate,stellate-pubescent,stem,straight,style,surface,tapering,terete,terminal,tertiary,thick-chartaceous,time,tip,trichome,truncate,tube,unarmed,unit,upper,variously,vein,venation,visible,way,weakly,wide,woody,yellow,young	0.2-0.35,0.4-0.8,0.5-,1-2,1/2,2-3,acuminat,alyx,apar,ba,deltate,eaf,eed,equal,flattened,free,geminat,inconspicuous,lower,nflorescence,orolla,oung,portion,pubescent,red-brow,ruit,slightly,sparsely,staminat,tamen,unarme,vary,ympodial	0.2-0.3,appearance,arrangement,border,branch,bud,characteristic,colour,corolla,corrugation,exertion,form,geminate,giving,glabrousnes,growth,height,history,inflorescence,interjected,leaflet,life,lobing,new,null,number,ovary,pseudostipule,seed,shape,size,staminate,stigma,sympodial,texture,type,variation,width
467	wfo-0001031483	success	154	178	134	20	44	0.87	.5,/2,0,0.5,0.5-2,1,1-2,1.1-2.5,1.2-1.4,1.7-5.5,1/3,11-20.5,2-2.5,2-3,2.5-3.2,3-4,3-8-flowered,6-10,7-10,across,acuminate,acute,almost,anew,anther,anthesi,apart,apex,attenuate,base,bearing,beginning,beneath,berry,blade,ca,calyx,clavate,cm,continuous,corky,corolla,decurrent,deflexed,deltoid,dia,difoliate,distal,dry,end,evenly,exserted,filament,filiform,flower,free,fresh,fruiting,fusiform,glabrous,green,indistinct,internode,larger,lateral,leaf,lenticellate,less,linear,lobe,long,main,major,markedly,minor,mm,oblanceolate,oblong,obovate,obovoid,often,opposite,orbiculate,ovary,ovoid-reniform,pair,pale,paler,pedicel,per,petiole,planar,pointed,pore,poricidal,portion,prominent,quite,raised,scar,shape,shaped,short,short-triangular,shrub,simple,slender,slightly,somewhat,soon,spaced,stem,stigma,straight,strongly,style,subshrub,tall,tan,tapering,tear-drop,third,tip,tube,turbinate,variable,vein,way,white,widest,wing,winged,woody,x	ba,caly,cork,eaf,edicel,eed,geminat,indistinc,lea,lobed,lower,minutely,nflorescence,papillo,papillose,rounded,ruit,ud,unit,ympodial	appearance,arrangement,bark,border,branch,bud,characteristic,colour,corrugation,diameter,drying,exertion,form,fruit,geminate,giving,glabrousnes,growth,history,inflorescence,interjected,leaflet,length,life,lobing,margin,mentioned,midpoint,new,number,peduncle,prickle,primary,pseudostipule,ray,seed,size,surface,terminal,texture,thicknes,type,variation,width
468	wfo-0001031492	success	175	187	149	26	38	0.851	.5,/4,0.5,0.7-1.3,0.9-1.1,08,1-1.3,1-1.5,1.3-2,1.5-1.8,1.5-2.5,10-15,2-10,2-3,2-5,20,3-4,3-5,4-10,4-4.5,6-8,8-11,8-9,acuminate,acute,age,anther,anthesi,apex,apical,appearing,attenuate,axe,bark,basal,base,becoming,beneath,berry,bi-lobed,bitter,branching,calyx,cm,conical,corolla,dark,dbh,deciduous,decurrent,deltoid,densely,diameter,distinguishable,drying,dull,echinoid,elliptic,erect,exserted,filament,flattened,flower,free,fruit,fruiting,glabrous,globose,golden,grey,growth,inserted,juice,lamina,lateral,leaf,lenticular,lightly,lobe,long,medium,minutely,mm,narrowly,nodding,older,ovary,overtopping,pair,pedicel,per,pericarp,petiole,pitted,planar,plurifoliate,pore,poricidal,portion,prominent,pubescent,purplish-black,pyramidal,rather,reddish-brown,remaining,scar,scarcely,scattered,secondary,shiny,shoot,short,shrub,size,sleeve,slightly,slit-like,sometimes,somewhat,sparsely,stem,sticky,stigma,strongly,style,sunken,surface,tall,tapering,terminal,thin,time,tip,tree,tree-like,trichome,tube,undersurface,upper,upturned,vein,violet,way,wide,winged,x,young,younger	abaxially,absent,adaxially,ba,dendritic,denser,eaf,edicel,eed,ew,lobed,lower,m.,monochasia,nflorescence,occasionally,papillo,predominantly,ruit,stamen,ste,tub,ud,unit,woody,ympodial	3,appearance,arrangement,border,bud,characteristic,colour,corrugation,distal,exertion,form,giving,glabrousnes,history,inflorescence,interjected,leaflet,length,life,lobing,margin,midpoint,new,null,number,papillose,peduncle,prickle,primary,pseudostipule,ray,seed,shape,texture,thicknes,type,variation,width
469	wfo-0001031503	success	142	176	121	21	55	0.852	-10,-15,-25,-30,-6,-7,0.3-3,0.5-1,0.5-4,1-,1-2.5,1-3,1-5,1-7,1.5-2,1.5-3,1.5-7,1.7-3.5,2-3,2.5-10,3-15,3-4,3-5,3-6,5613,6-7,7-10,7-15,abaxially,abruptly,acuminate,acute,adaxially,aggregate,angled,apart,apex,articulated,axe,base,blade,branched,calyx,cell,chartaceous,cm,connivent,cuneate,curled,cylindrical,decurrent,deltate,densely,diameter,directed,distally,eglandular,elliptic,entire,except,fide,flower,forked,glabrous,gland,globose,hair,lanceolate,lobe,long,margin,mm,moderately,mostly,narrowed,narrowly,obtuse,occasionally,often,orange,ovate,pedicel,peduncle,perfect,petiole,pore,present,puberulent,pubescent,radiu,rarely,reddish,ripe,rounded,rugose-pubescent,shrub,simple,slightly,spaced,sparsely,stalked,stigma,stone,style,subclavate,time,tip,toward,triangular,truncate,tube,unbranched,unequal,uniseriate,usually,vein,venturi,white,wide,x,yellow	1.5-8,10-19,6-many-foliat,absen,ba,distall,eaf,eed,lower,nflorescence,nther,orolla,rachi,ruit,stellate,subcapitat,tal,tem,unit,vary,ympodial	absent,anther,appearance,arrangement,bark,border,branch,bud,characteristic,colour,corolla,corrugation,distal,drying,exertion,filament,form,fruit,fruiting,giving,glabrousnes,growth,height,history,inflorescence,interjected,lateral,leaf,leaflet,length,life,lobing,mentioned,midpoint,new,number,ovary,per,plant,prickle,primary,pseudostipule,ray,seed,shape,size,stem,subcapitate,surface,terminal,texture,thicknes,type,variation,width
470	wfo-0001031586	success	167	169	127	40	42	0.76	-2,.25,0.1-1,0.5-0.8,0.5-1,1,1-1.2,1-1.5,1-2,1.3-5,1.4-2.5,1.5-2,2,2-2.5,3-11,5-10,5-6,7-10-flowered,abrupt,absent,acute,anther,anthesi,apex,apparently,appearing,attenuate,bark,base,becoming,beneath,borne,branch,bright,broadly,bud,calyx,capitate,cm,completely,conical,corolla,cream-colored,deflexed,deltate,dia,difoliate,drying,ellipsoid,elliptic,exerted,filament,fleshy,free,geminate,glabrous,globose,green,greenish,inflorescence,known,later,lateral,leaf,lobe,lobed,long,main,major,margin,minutely,mm,nearly,new,older,olive,onto,open,opposite,ovary,overtopping,pair,pale,papillate,pedicel,petiole,pore,poricidal,portion,present,prominent,raised,ridged,rounded,shaped,shiny,shrub,simple,size,slender,small,sometimes,somewhat,soon,sparsely,stem,stigma,straight,style,surface,tall,tapering,tear-drop,thick,tip,trichome,truncate,trunk,tube,uniseriate,unit,vein,white,x,yellow,yellowish,young	apart,campanulate,closer,cucullate,differing,distance,eaf,edicel,eed,exfoliatin,flower,fresh,gree,inflorescenc,know,leave,lower,material,may,minor,mucro,near,nflorescence,notched,occasionally,one,paler,papillose,planar,remaining,ruit,scar,shap,shin,spaced,swollen,thickened,ud,widely,ympodial	appearance,arrangement,border,characteristic,colour,corrugation,diameter,distal,exertion,exfoliating,form,fruit,fruiting,giving,glabrousnes,growth,height,history,interjected,leaflet,length,life,lobing,mentioned,midpoint,number,peduncle,per,plant,prickle,primary,pseudostipule,ray,seed,shape,sympodial,terminal,texture,thicknes,type,variation,width
471	wfo-0001031587	success	142	170	122	20	48	0.859	.5,0.8-1,1-1.5,1.5-2,1.7-2,10-15,12-16,17-30,2-2.5,2-9-celled,2/3,3-4,5,6-7,6-8,7-9,abaxially,acute,adaxially,along,anther,anthesi,apart,apex,attenuate,axi,bark,base,bi-lobed,broadly,calyx,clavate,closely,cm,cone,conical,corolla,decurrent,deflexed,deltate,dendritic,densely,denser,dia,differing,drying,elliptic,elliptic-ovoid,erect,evenly,exserted,filament,fleshy,free,furcate,glabrous,globose,golden-red,included,inflorescence,irregular,known,lamina,later,lateral,leaf,like,lobe,lobed,long,main,major,middle,minor,minutely,mm,mostly,oblique,occasional,older,ovary,pair,pale,papillate,parallel,pedicel,perpendicular,petiole,pore,poricidal,portion,pubescent,rarely,reddish-grey,scar,shape,shaped,simple,size,soft,somewhat,spaced,stem,stigma,style,surface,tear-drop,thick,thickened,tip,tree,trichome,tube,uniseriate,vein,verrucose,way,white,widest,winged,x,young	2,eaf,edicel,eed,fide,know,loose,lower,lowered,ocasionally,overlappin,papillo,persisten,rect,rest,ruit,steinbach,tall,tub,ud	appearance,arrangement,border,branch,bud,characteristic,colour,corrugation,diameter,distal,exertion,flowered,form,fruit,fruiting,giving,glabrousnes,growth,height,history,interjected,leaflet,length,life,lobing,margin,midpoint,new,null,number,occasionally,overlapping,papillose,peduncle,per,persistent,plant,prickle,primary,pseudostipule,ray,seed,terminal,texture,thicknes,type,variation,width
472	wfo-0001031589	exception_thrown	222	0	0	222	0	0.0		-0.5,-15,-6,-6.5,.5,/6,0,0-1,0-10,0-3,0-30,0.1,0.1-0.5,0.15-0.3,0.2-0.4,0.2-0.5,0.2-3,0.4,0.5-1,0.55-0.7,0.6-1.2,0.7,0.8-2.3,0.9-1.3,0.9-1.6,1,1-1.8,1-5,1.2-1.5,1.5-5,1.7-2.5,1.8-2.9,1/3,1/3-1/2,1/3-1/4,10-30,2-,2-10,2-3.5,2.5-4.5,2.5-6,2.8-4,3-4,3-5,3/4,4-6.5,4/5,5-8,5-merous,6-8,8-14,8-30,abaxially,acute,alyx,ame,anther,apart,apex,apically,apparently,articulated,attenuate,bark,base,berry,blade,bright,broadly,brow,brown-green,c.,calyx,caudat,cell,chartaceous,cm,concolorous,connivent,cream,dark,deltate,densely,density,diameter,difoliate,discolorous,distance,drying,dull,eed,elliptic,elongating,equal,erect,extending,eye,filament,flattened-reniform,flower,free,fruit,fruiting,geminat,glabrescent,glabrous,gray-green,green,higher,infructescence,lateral,leaf,lengt,length,lobe,lobed,lon,long,long-obovate,longer,lower,margin,marking,mature,maturity,mauve,membranous,midpoint,midvein,mm,moderately,multangulate,naked,narrow,narrow-cuneate,nflorescence,oblong,obovate,occasionally,often,older,orange-brown,orange-green,orolla,oung,outline,pair,pale,part,pedicel,pendulous,per,perfec,pericarp,petiole,pit,plant,poricidal,porrect,portion,prickl,prickle,prickly,primary,raised,ray,reflexed,rounded,ruit,scandent,sessile,shiny,shorter,shrub,side,simple,small,smooth,solitary,sometimes,somewhat,spaced,sparsely,spherical,spreading,stalk,stalked,stellate,stellate-pubescent,stem,stout,straight,style,subentire,subsessile,surface,tamen,tapering,terete,tertiary,time,tip,trichome,tube,unit,upper,vary,vein,venation,visible,way,weakly,white,whole,wide,winged,woody,yellow,yellow-green,yellow-orange,ympodial,young	
473	wfo-0001031609	exception_thrown	154	0	0	154	0	0.0		.5,/4,0-30,0.4-3,0.5-1,0.5-3,1-10,1-6,1.3-3,1.5-2,1.5-3,10-25,2,2-,2-3,2.5-4,20-25,3-24,3-5,3-9-lobed,3-foliat,4,4-5,4-6,4.5-60,5-25,5/6,8-20,abaxially,absen,absent,acute,adaxially,aggregate,ape,apex,apiculate,around,articulated,axe,barely,base,beyond,bilobe,blade,branch,brow,brownish,calyx,campanulate,cell,cm,connective,connivent,conspicuous,contiguous,cuneate,dark,deltate,dia,diameter,dilated,directed,distally,divided,eaf,eed,ellipsoidal,elliptic,elliptic-ovate,emerging,entire,equal,exceeding,exserted,flattened,fleshy,flower,forked,fruit,glabrou,glabrous,globose,green,inflorescence,laterally,leaf,leaving,lobe,lobed,long,lower,margin,midrib,minutely,mm,nearly,nflorescence,nther,obconical,obovate,obtuse,occasionally,orange,orolla,papillose,pedicel,pedicellar,peduncle,petiole,pinnately,point,pore,puberulent,rachi,radiu,reticulate,ripe,rounded,ruit,scar,shallowly,shrub,simple,sinus,small,stamen,stellate,stigma,stone,strongly,style,succulen,succulent,tal,tem,thecae,time,tip,tomento,tree,triangular,truncate,tube,two,ud,unbranched,unit,unlobed,vary,wide,x,yellow,ympodial	
474	wfo-0001031615	success	154	156	115	39	41	0.747	.5,0,0.5,0.5-1,0.8-1,0.9-1.1,1-1.6,1.3-1.8,1.5,1.5-5,11-15.5,2-4.2,3.8-6.1,4-6.5,5-6,6-8,8-10,acuminate,acute,anther,anthesi,apex,attenuate,axil,bark,base,becoming,berry,bilobed,brown,calyx,capitate,cm,corolla,dark,decurrent,deep,deflexed,deltoid,dia,distal,elliptic,expanded,exserted,filament,flattened-reniform,free,fruit,fruiting,furcate,glabrous,glandular,globose,green,impressed,inflorescence,lateral,leaf,less,lobe,lobed,long,main,major,margin,middle,minor,minutely,mm,nearly,occasionally,older,opposite,ovary,pair,paler,pedicel,per,petiole,pitted,portion,prominent,reflexed,scarcely,shiny,shrub,simple,size,slender,slightly,small,somewhat,stem,stigma,straight,style,subumbellate,surface,tall,tapering,terminal,thickened,tree,trichome,tube,tuft,uniseriate,urceolate,vein,white,widest,winged,woody,x,young	2-3,5-20-flowered,arising,ba,caly,closely,dark-papillo,differing,difoliate,eaf,edicel,eed,geminat,incrassate,interpetalar,lamina,lon,lower,maroo,minute,nflorescence,one,overlappin,packed,papillae,papillose,pore,poricidal,ruit,scar,shaped,sinus,tear-drop,thin,tip,ud,unicellular,unit,ympodial	appearance,arrangement,border,branch,bud,characteristic,colour,corrugation,dark-papillose,diameter,drying,exertion,form,giving,glabrousnes,growth,height,history,interjected,leaflet,length,life,lobing,maroon,midpoint,new,null,number,peduncle,plant,prickle,primary,pseudostipule,ray,seed,shape,texture,thicknes,type,variation,width
475	wfo-0001031618	success	184	207	157	27	50	0.853	-2,0-3,0.5-1.5,1-1.5,1-7,1.5-2,10-18,10-lobed,13,2-2.5,2-3,3,3-4,3-8,4-5,5,5-12,90-110,acuman,acute,almost,also,anther,apex,appearance,appearing,aspect,axil,base,becoming,berry,beyond,blunt,branch,broadly,calyx,capitate,clonal,cluster,cm,conical,corolla,covering,cuneate,cut,cyme,darker,developed,discoidal,ellipsoid,elliptic,emarginate,enlarged,equal,erect,except,exerted,extending,filament,finely,fleshy,floral,flower,fork,forked,general,giving,glabrous,glandular,greatly,green,greyish,growing,habit,hair,half,interacuminal,lanceolate,lasting,lavender-purple,leaf,lengthening,less,lobe,lobed,long,loosely,lower,marbled,maturity,may,mid-vein,midrib,minute,mm,narrowly,oblong,obovoid,occasional,occur,ovary,ovate-lanceolate,ovoid,pale,pedicel,pedicellate,peduncle,petal,petiole,pinatisect,point,pore,poricidal,purple,rarely,reddish-brown,reticulate,rhachi,ripe,rounded,rugose,scorpioid,sessile,several,shallowly,shrub,simple,single,sinus,slit,soft-wooded,sometimes,somewhat,specimen,stem,stigma,stout,stripe,strongly,succulent,surface,tapering,terete,tinged,tip,tissue,triangular,unequal,unit,variable,vigorous,way,well,x,year,young,younger	1.5-3.5,40-60,anthesi,bluntly,c.,cell,column,dia,eaf,eed,facetted,frui,gree,lon,mauve,nflorescence,often,pal,plurifoliat,rotate,ruit,side,stone,styl,tub,ud,ympodial	arrangement,bark,border,bud,characteristic,colour,corrugation,diameter,distal,drying,exertion,form,fruit,fruiting,glabrousnes,growth,height,history,inflorescence,interjected,lateral,leaflet,length,life,lobing,margin,midpoint,new,null,number,per,plant,plurifoliate,prickle,primary,pseudostipule,ray,seed,shape,size,style,sympodial,terminal,texture,thicknes,tube,type,variation,vein,width
476	wfo-0001031646	success	171	151	107	64	44	0.626	-7,-pinnate,.2,0.2-0.8,0.5-2,0.8-1.5,1-1.8,1-10,1-6,1.2-2.5,1.5-3.5,1.5-4,15-25,18-38,2-2.5,2-3,2.5-10,20,4-18,4-20,4-5,4-8,5,5-6,5-7.5,7-8,8-15,abaxially,absent,acuminate,acute,adaxially,anther,apart,apex,apparently,basally,base,berry,blue,branched,brown,calyx,climbing,cm,covered,cuneate,densely,diameter,ellipsoidal,elliptic,elliptic-lanceolate,entire,filament,flattened,flower,fruit,fruiting,glabrous,glandular,globose,green,hair,high,highly,immature,interjected,lateral,leaf,leaflet,light,lobe,margin,mature,mm,multicellular,oblique,oblong,ovate-lanceolate,pedicel,peduncle,perfect,petiole,pubescence,pubescent,red,rounded,rugulose,scandent,shortly,shrub,simple,size,smooth,spreading,stem,stigma,stout,style,surface,tawny,tree,tube,uniseriate,vine,violet,x	.5,1962,2-10,3.5-4,4-foliate,5-7,5-merou,absen,accrescent,acut,aggregate,alyx,apical,articulated,axe,ba,blade,cell,chartaceous,ciliat,connivent,correll,cylindrical,darker,decreasing,directed,distall,eaf,eed,equal,fide,geminat,homostylous,hyaline,long,lower,maroon,nflorescence,obliquely,obtuse,orolla,ovate-lanceolat,part,petiolule,pore,present,pubescen,rachi,rotate-pentagonal,ruit,seudostipule,slightly,small,spaced,stone,tamen,tem,tip,toward,truncat,unit,vary,yellow,ympodial	appearance,arrangement,bark,border,branch,bud,characteristic,colour,corolla,corrugation,distal,drying,exertion,form,giving,glabrousnes,growth,height,history,inflorescence,length,life,lobing,mentioned,midpoint,new,number,ovary,per,plant,prickle,primary,pseudostipule,ray,seed,shape,terminal,texture,thicknes,truncate,type,variation,vein,width
477	wfo-0001031651	success	201	222	179	22	43	0.891	-2,-3,-3.5,.1,.6,.7,/5,0-20,0.1,0.1-0.15,0.1-0.2,0.1-0.25,0.15-0.2,0.2-0.5,0.3-0.5,0.3-0.8,0.3-1.5,0.6-1,0.6-1.3,0.7-1,1,1-1.7,1-2,1-4,1.2-2,1.2-3,1.3-1.6,1.5-2,1/5,1/6-1/4,2-10,2-3,2-3.5,3-5,4-5,4-6,4.5-7,abaxial,abaxially,absent,acute,adaxial,ame,anther,apart,apex,apically,apparently,articulated,bark,base,berry,blade,branched,brown,c.,calyx,cell,chartaceous,cm,concolorous,cordate,curved,dark,deltate,densely,diameter,difoliate,discolorous,drying,dull,elliptic,entire,equal,erect,eye,faint,filament,filiform,flattened-reniform,flower,free,fruit,fruiting,glabrescent,glabrous,gray,herb,herbaceous,infructescence,lanceolate,lateral,leaf,length,lobe,lobed,long,longer,lower,margin,maturity,midpoint,mm,naked,oblong,obtuse,older,one,open,orange-brown,outline,ovate,pair,pedicel,peduncle,pendulous,per,pericarp,persistent,petiole,pit,poricidal,porrect,portion,prickle,prickly,primary,purple,raised,ray,red,red-green,reflexed,rounded,scandent,scar,shorter,shrub,simple,small,smooth,sometimes,spaced,spherical,spreading,stalk,stalked,stellate,stellate-pubescent,stem,straight,style,subentire,subsessile,surface,tapering,terete,terminal,tertiary,thick,thick-stalked,time,tip,toward,trichome,tube,unarmed,unit,upper,variously,vein,venation,visible,way,weakly,white,wide,yellow,yellow-green	/3,2/3-3/,5-merous,acuminat,alyx,apar,eaf,eed,elongating,geminat,gra,mature,nflorescence,orolla,oung,perfec,prickl,ruit,tamen,unarme,vary,ympodial	2/3-3/4,acuminate,appearance,arrangement,border,branch,bud,characteristic,colour,corolla,corrugation,distal,exertion,form,geminate,giving,glabrousnes,growth,height,history,inflorescence,interjected,leaflet,life,lobing,new,null,number,ovary,plant,pseudostipule,seed,shape,size,stamen,stigma,sympodial,texture,thicknes,type,variation,width,young
478	wfo-0001031656	success	154	175	132	22	43	0.857	.5,/4,0.5,0.5-1,1-1.5,1-2,1-2.5,1.2-1.5,1.5-2,1.5-5,10-20,2.5-3.5,3-3.5,3-5,4-9,5-7,5-ribbed,6-8,acuminate,acute,also,anther,anthesi,apex,arising,bark,base,berry,bright,calyx,cm,corolla,dia,difoliate,directly,drying,ellipsoid,elliptic,erect,extremely,filament,fleshy,flower,free,fruit,fruiting,glabrous,globose,green,greyish,hooded,known,lateral,leaf,live,lobe,long,long-acuminate,lower,main,major,margin,matte,mature,middle,minor,minute,minutely,mm,node,oblique,often,older,opposite,ovary,ovate,pair,pale,paler,papillose,pedicel,persistent,petiole,planar,plant,pore,poricidal,portion,prominent,proximal,rather,red-papillose,reddish,reflexed,rib,ridged,rounded,sessile,shaped,shiny,shrub,size,slightly,somewhat,specimen,stem,stigma,straight,strongly,style,surface,swollen,tall,tear-drop,terminal,thick,thickened,tip,top,transversely,tube,unit,upper,vein,visible,way,white,wide,widest,woody,x,young	ba,capitate,closely,cork,densely,differing,eaf,edicel,eed,enclosing,geminat,lobed,lon,nflorescence,one,papillo,peelin,ruit,scar,spaced,ud,ympodial	appearance,arrangement,border,branch,bud,characteristic,colour,corrugation,diameter,distal,exertion,form,geminate,giving,glabrousnes,growth,height,history,inflorescence,interjected,leaflet,length,life,lobing,midpoint,new,null,number,peduncle,peeling,per,prickle,primary,pseudostipule,ray,seed,shape,sympodial,texture,thicknes,type,variation,width
479	wfo-0001031667	success	153	160	109	44	51	0.712	0.6-1,0.6-1.5,1-1.5,1-4,1.4-3,1.5-2,10-13,12-35,2-3,2-5,2-6,2.5-5,3-13,3-5,5-9,6-10,8-13,8-15,abaxially,acumen,acuminate,acute,adaxially,apex,apical,apically,apiculate,articulate,base,branched,calyx,caudate,cell,cm,connate,cordate,corolla,covering,cuneate,cyme,dark,dehiscent,diameter,dichasial,dichasially,distal,ebracteate,elliptic-lanceolate,exceeding,filament,forked,globose,green,green-white,half,herbaceous,interjected,introrse,irregularly,lanceolate,lateral,leaf,leaflet,lobe,lobed,long,make,maturing,mm,monochasial,mucilaginous,oblique,oblong,odd-pinnate,often,ovoid,pedicel,peduncle,perennial,petiolate,petiole,pilose,plant,poricidally,proximal,rounded,seed,sessile,short,size,slit,spot,stamen,stigma,straight,stripe,style,terminal,testal,thick,throughout,tuber-bearing,typically,unit,wall,white,wide,yellow,Â¼	3-6-foliat,3-8,4-1.,5-15,abruptly,digestion,diminishing,dorsally,eaf,edge,eed,emoval,enzyme,flat,flower,folded,generally,globo,hair-like,honeycomb,living,lon,lower,lunat,nflorescence,nther,orolla,pair,pattern,perfect,petiolule,plan,reveal,ruit,seudostipule,specimen,stellate,tal,tem,toward,vary,whit,without,ympodial	'hair-like,3-6-foliate,4-10,anther,appearance,arrangement,bark,border,branch,bud,characteristic,colour,corrugation,drying,exertion,form,fruit,fruiting,giving,glabrousnes,growth,height,history,inflorescence,length,life,lobing,lunate,margin,mentioned,midpoint,new,number,ovary,per,prickle,primary,pseudostipule,ray,shape,stem,surface,sympodial,texture,thicknes,tube,type,variation,vein,wet,width
480	wfo-0001031672	success	157	186	132	25	54	0.841	0,0-2,0.3-0.5,0.5,0.5-1,0.5-1.5,1,1-,1-1.5,1-2,1-5,1.5-2,1.5-2.5,1.5-3.5,1.5-5,10-20,15-20,15-50,2-12,2-28,3/4,4,4-34,4.5-5,4/5,5-6,6,9-lobed,abaxially,absent,acuminate,acute,adaxially,aggregate,apart,apex,apiculate,articulated,aublet,axe,basal,base,beyond,blade,calyx,cell,chartaceous,cm,connective,cordate,cylindrical,densely,diameter,directed,distally,divided,entire,exceeding,exserted,fide,flattened,fleshy,flower,fruit,glabrous,glandular-puberulent,globose,green,greenish-brown,hair,lanceolate,leaf,leaving,lobe,lobed,long,margin,mature,midrib,mm,moderately,narrowly,near,obtuse,occasionally,often,one,ovate,ovoid,pedicel,pedicellar,peduncle,perfect,petiole,pilose,pinnately,pore,present,puberulent,pubescent,purple,radiu,remant,represented,rounded,shorter,simple,sinus,slightly,small,spaced,sparsely,stamen,stigma,stone,style,subcoriaceous,thecae,time,tip,toward,tree,triangular,truncate,tube,unbranched,unlobed,white,whitish,wide,x,yellow	1-10,3-4-foliat,ape,ciliat,eaf,eed,lon,lower,membranaceous,nflorescence,nther,orolla,pilo,presen,rachi,ruit,stellate,tal,tem,truncat,ud,unit,vary,yello,ympodial	anther,appearance,arrangement,bark,border,branch,bud,characteristic,ciliate,colour,corolla,corrugation,distal,drying,exertion,filament,form,fruiting,giving,glabrousnes,growth,height,history,inflorescence,interjected,lateral,leaflet,length,life,lobing,midpoint,new,null,number,ovary,per,plant,prickle,primary,pseudostipule,ray,seed,shape,size,stem,surface,tall,terminal,texture,thicknes,type,variation,vein,width
481	wfo-0001031684	success	161	175	131	30	44	0.814	.5,.75,/4,0.1,0.4-1.5,0.5-0.7,0.5-0.8,0.5-1,0.7-1,0.75-1,1-1.2,1-5,10-100,2,2-9,3-3.5,3-30,4-17,5-7,acuminate,acute,along,anther,anthesi,apex,bark,base,bearing,beneath,berry,borne,branched,calyx,causing,clavate,cm,corolla,curly,decurrent,deflexed,densely,dia,drying,elliptic,elongated,expanded,exserted,extremely,filament,filiform,flower,free,fruiting,glabrous,globose,greatly,green,inflorescence,internodal,irregularly,lateral,leaf,less,like,lobe,lobed,long,long-triangular,main,major,middle,midrib,minutely,mm,obconic,occasionally,older,opposite,ovary,ovoid-reniform,pair,pale,papillose,pedicel,persistently,petiole,pitted,planar,pore,poricidal,portion,previously,pubescent,pulled,raised,reflexed,scar,shaped,short,shrub,single,size,slender,slightly,small,soon,sparsely,stem,stigma,straight,style,surface,tall,tan,tapering,tear-drop,time,tip,tipped,tree,trichome,tube,uniseriate,varying,vein,way,white,widest,winged,x,young	.25,apar,black,denser,differing,difoliate,eaf,edicel,eed,except,geminate,gre,lon,lower,minor,nflorescence,one,papillo,present,reflexe,rest,ruit,siz,spaced,ud,unevenly,unifoliate,unit,widely,ympodial	appearance,arrangement,border,branch,bud,characteristic,colour,corrugation,diameter,distal,exertion,form,fruit,giving,glabrousnes,grey,growth,height,history,interjected,leaflet,length,life,lobing,margin,mentioned,midpoint,new,number,peduncle,per,plant,prickle,primary,pseudostipule,ray,seed,shape,terminal,texture,thicknes,type,variation,width
482	wfo-0001031695	exception_thrown	185	0	0	185	0	0.0		0.5-1,0.5-2,1,1-2,1-3,1-9,1.5-2,1.5-8,1/2,1/3,10-,10-15,10-35,15-20,2-3,2-4,2-5,2.5-5,20-30,3-,3-10,3-17,3-19,3-7,30-40,4-10,4-5,4-6,4-foliat,5,5-20,5-7,6-10,6-20,6-8,7-,?,abaxially,abruptly,acuminate,acute,adaxially,aggregate,also,apart,ape,apex,apically,apiculate,articulated,axe,basal,base,beyond,blade,branched,broadened,calyx,campanulate,capitat,cell,chartaceous,cm,color,connective,connivent,cordate,cylindrical,d,dark,deep,densely,diameter,dilated,directed,divided,eaf,eed,eglandular,eglandular-pilose,ellipsoidal,entire,exceeding,exserted,flattened,fleshy,flower,fruit,glabrate,glabrescent,glabrous,glandular-puberulent,green,greenish,hair,hard,immature,lanceolate,lateral,laterally,lavender,leaf,leaving,lilac,lobe,lobed,lon,long,lower,margin,midrib,mm,moderately,mottled,narrowly,nflorescence,nther,oblique,oblong,obtuse,occasionally,often,orolla,ovate,ovoid,pedicel,pedicellar,peduncle,perfect,petiole,pilo,pilose,pilose-hirsut,pilose-hirsute,pore,presen,present,puberulent,puberulent-pubescent,pubescent,purple,purplish,rachi,radiu,remnant,ripe,rounded,ruit,shorter,shrub,simple,sinus,slight,slightly,small,sometimes,somewhat,spaced,sparsely,stamen,stigma,stone,stripe,style,subcoriaceous,swelling,tal,tem,thecae,time,tip,tomento,tree,triangular,tube,unbranched,unequal,unit,unknown,unlobed,vary,wide,x,yellow,ympodial	
483	wfo-0001031698	success	58	93	36	22	57	0.621	2-2.5,2.5,2.5-3,4-4.5,bark,base,branch,cm,decurrent,elliptic,flattened,fruiting,glabrous,green,leaf,margin,minutely,mm,otherwise,pale,papillae,pedicel,pitted,reddish-brown,reniform,repandly,rugose,shrub,stem,stout,strongly,surface,winged,x,yellowish,young	'',``,ape,deflexed,dia,difoliate,dull,eaf,eed,fide,geminat,incrassate,long,maguire,older,paler,persistin,tall,unit,wing,woody,ympodial	anther,apex,appearance,arrangement,border,bud,calyx,characteristic,colour,corolla,corrugation,diameter,distal,drying,exertion,filament,form,fruit,giving,glabrousnes,growth,height,history,inflorescence,interjected,lateral,leaflet,length,life,lobe,lobing,midpoint,new,null,number,ovary,peduncle,per,petiole,plant,prickle,primary,pseudostipule,ray,seed,shape,size,stigma,style,terminal,texture,thicknes,tube,type,variation,vein,width
484	wfo-0001031707	success	178	183	140	38	43	0.787	-3,.5,/4,1-1.2,1-1.3,1-1.5,1-3,1.2-1.8,1.2-2,1.5-1.7,1.5-2,1.5-6,1/3,16-20,2,2-10,2-3,2-4,2-6,24,4-5,4-6,5-10-celled,6-7,8-12,80-140,9-15,abaxially,absent,acute,adaxially,almost,along,anther,anthesi,apex,apical,apically,attenuate,axil,axillary,base,basiscopically,bearing,berry,brown,calyx,capitate,climbing,cm,conical,conspicuously,corolla,cucullate,dense,densely,diameter,distal,distinct,drying,elliptic,enlarged,erect,exserted,filament,flap-like,flat,flattened,fleshy,flower,free,fruiting,glabrous,globose,green,greenish,high,lanceolate,lateral,leaf,leaflet,less,like,lobe,long,margin,minutely,mm,narrowly,oblique,obovate,occasionally,open,ovary,pair,papillate,pedicel,per,petiole,pink,pinnate,planar,plant,pointed,poricidal,portion,primary,pubescent,quadrate,reddish,regular,rest,round,sagittate,scattered,simple,slightly,smooth,sparsely,stigma,stout,strongly,style,surface,terminal,ternate,thickening,time,tip,trichome,tube,type,uniseriate,vein,vine,way,white,white-lenticellate,woody,x	0.5-1,3,acuminate,basal,c.,cateniform,cell,clavat,eaf,edicel,eed,endrophilum,epidermal,four-lobed,horizonta,inflorescenc,lobed,lon,lower,narrower,nflorescence,penden,petiolule,quite,raised,ruit,scar,smaller,somewhat,spaced,tem,tub,ud,unifoliat,unit,usually,widely,ympodial	appearance,arrangement,bark,border,branch,bud,cateniforme,characteristic,clavate,colour,corrugation,exertion,form,fruit,giving,glabrousnes,growth,height,history,horizontal,inflorescence,interjected,length,life,lobing,midpoint,new,null,number,peduncle,pendent,prickle,pseudostipule,ray,seed,shape,size,stem,texture,thicknes,unifoliate,variation,width
485	wfo-0001031723	success	228	239	197	31	42	0.864	-1.5,-1/2,-15,-16,-2,-5,-6,-6.5,-merous,0,0.05-0.2,0.1-0.3,0.1-0.5,0.15,0.2-1,0.4,0.4-,0.4-0.9,0.4-1,0.55-0.9,0.6-1,0.7-1,0.8-1.5,1-,1-2.5,1-3,1-5,1.2-2,1.5-,1.5-10,1.5-2.5,1/3-1/2,1/4-1/3,1/6-,10-30,15-45,2-,2-3.5,2-5.5,2-7,2.5-4.5,2.5-5,2/3,2/3-3/4,3-10,3-15,4-,4-10,4-11,4-20,4-5,4-6,5-40,5-9,abaxial,acuminate,acute,adaxial,ame,anther,apart,apex,apparently,articulated,bark,base,berry,blade,branched,branching,brown,c.,calyx,chartaceous,cm,conical,connivent,cuneate,curved,dark,densely,diameter,discolorous,drying,dull,elongated,elongating,entire,equal,erect,evenly,filament,filiform,finely,flattened-reniform,flower,free,fruit,fruiting,gently,glabrescent,glabrous,gland,gland-tipped,glandular,gray,green,hair,herbaceous,inflated,infructescence,lateral,leaf,length,lobe,lobed,long,longer,lower,margin,marking,mature,maturity,mauve,midpoint,minute,mm,moderately,multangulate,narrow-deltate,near,obtuse,older,one,open,orange,orange-brown,ovate,pale,pedicel,peduncle,per,pericarp,perpendicular,petiole,poricidal,porrect,portion,prickle,prickly,primary,ray,recurved,red,reflexed,rounded,scar,secondary,sessile,shrub,simple,smooth,sometimes,spaced,spherical,spreading,stalk,stalked,stellate,stellate-pubescent,stem,straight,strongly,style,subentire,surface,tapering,terete,terminal,time,tip,trichome,tube,unarmed,unit,usually,variously,vein,way,weakly,white,whitish,wide,woody,yellow,yellow-green,young	-8,0.1-0.2,1-2,8-20,abaxially,acut,alyx,apar,apically,ba,brow,deltate,eaf,eed,eye,naked,nflorescence,orolla,oung,pair,perfec,plurifoliat,ruit,sparsely,tamen,tertiary,unarme,vary,venation,visible,ympodial	appearance,arrangement,border,branch,bud,characteristic,colour,corolla,corrugation,distal,ength,exertion,form,giving,glabrousnes,growth,height,history,inflorescence,interjected,leaflet,life,lobing,new,null,number,ovary,perfect,plant,plurifoliate,pseudostipule,seed,shape,size,stamen,stigma,sympodial,texture,thicknes,type,variation,width
486	wfo-0001031729	success	161	162	116	45	46	0.72	-0.5,-2,-45,..,0.5,0.5-1,0.6-,1-1.5,1-2,1-2.5,1.0-1.3,1.5,1.5-2,10-20,11-30,12-13,2-2.5,2-3,2.5-,2.5-5,3-4,3.5-4,4.1-16,5-,5-6,5-7,abruptly,acuminate,along,anther,anthesi,apex,apiculate-deltate,attenuate,base,beneath,branch,branched,calyx,cell,cm,conical,corolla,dark,darker,deltate,diameter,drying,elliptic,elongate,filament,flattened,fruit,fruiting,glabrous,globose,green,greenish,later,less,lobe,lobed,long,markedly,middle,minute,mm,mottling,nearly,obovate,occasionally,outer,outline,ovary,ovate-reniform,pair,pale,papillae,papillate,pedicel,peduncle,per,petiole,pink,planar,point,pointed,primary,purplish,quadrate,reddish,regularly,scattered,short,shrub,single,single-stemmed,sinuate,small,somewhat,stem,stigma,striate,stripe,surface,tan,time,trichome,tube,usually,vein,wall,wand-like,white,x,young	0.5-4,3-celled,50,8-9,apicula,branc,brittle,brow,c.,cucullate,curve,dry,eaf,edicel,eed,erec,flattened-capitat,flower,glandular,gradually,lower,membranous,minutely,narrowly,never,nflorescence,noddin,open,papillose,pericarp,plurifoliat,ruit,scar,smooth,testa,thin,thing,tip,toward,triangular,tuft,ud,unit,widening,ympodial	appearance,arrangement,bark,border,brown,bud,characteristic,colour,corrugation,curved,distal,exertion,flattened-capitate,form,giving,glabrousnes,growth,height,history,inflorescence,interjected,lateral,leaf,leaflet,length,life,lobing,margin,mentioned,midpoint,new,number,plant,prickle,pseudostipule,ray,seed,shape,size,style,terminal,texture,thicknes,type,variation,width
487	wfo-0001031738	success	231	259	219	12	40	0.948	-15,-5,-6,-merous,.5,0,0-2,0-3,0.1-0.25,0.2-0.3,0.25-0.8,0.3-1,0.7-1,0.7-1.1,0.9-2.1,1-1.5,1-1.8,1-3,1-4,1.4-1.7,1.5-,1.5-4,1/2-2/3,1/3,1/3-2/3,1/4-1/3,1/6-1/4,10-15,15-40,2-,2-4,2.3-3,20-200,3-4,3-6,3-7,3.5-3.8,3.5-4.5,4,4-10,4-5,4-6,4-8,5,5-8,6-15,7-12,7-12.5,8-10,8-18,abaxial,abaxially,acuminat,acute,adaxial,adaxially,almost,always,alyx,andromonoecious,anther,apart,apex,apically,apparently,articulated,auriculate,bark,base,berry,blade,branched,calyx,cell,chartaceous,cm,connivent,cordate,curved,dark,deltate,densely,diameter,discolorous,distal,distance,drying,dull,elongating,equal,erect,evenly,extending,filament,flattened,flattened-reniform,flower,free,frequently,fruit,fruiting,glabrescent,glabrous,gray,green,held,hermaphrodite,heterostylous,infructescence,inside,lateral,leaf,length,lobe,lobed,lobing,long,long-styled,longer,lower,lowermost,margin,mature,maturity,midpoint,midvein,mm,multangulate,narrow-deltate,oblong,obovate,often,older,one,open,orange,orange-brown,orolla,outline,ovate,pair,pale,pedicel,peduncle,per,pericarp,petiole,pit,plant,poorly,poricidal,porrect,portion,prickle,prickly,primary,prominent,pubescent,raised,ray,reflexed,resin,rounded,scar,secondary,sessile,short-styled,shorter,shrub,side,simple,small,smooth,sometimes,spaced,sparsely,spherical,spreading,stalk,stalked,staminat,stellate,stellate-pubescent,stem,sticky,stout,straight,strongly,style,surface,tapering,terete,terminal,tertiary,time,tip,tree,trichome,truncate,tube,unarmed,unit,upper,usually,variously,vary,vein,venation,visible,way,weakly,white,wide,woody,yellow,yellow-green,yellow-orange,yellowish,young	1/,apar,eaf,eed,nflorescence,oung,plurifoliat,prickl,ruit,tamen,white-brow,ympodial	1/4,acuminate,appearance,arrangement,border,branch,bud,characteristic,colour,corolla,corrugation,exertion,form,giving,glabrousnes,growth,height,history,inflorescence,interjected,leaflet,life,new,null,number,ovary,plurifoliate,pseudostipule,seed,shape,size,stamen,stigma,sympodial,texture,thicknes,type,variation,white-brown,width
488	wfo-0001031752	success	172	192	135	37	57	0.785	-10,-100,-3,-47,-6,0.5-1,0.5-1.5,1,1-,1-1.5,1-2,1-3,1-4,1.5-2,1.5-2.5,1.5-3,1.5-3.5,15-25,15-40,2-2.5,2-3,2-5,20-35,3-11.5,3-4,3-7,3.5-15,3.5-5,5-23,5-6,5-8,abaxially,acuminate,acute,adaxially,aggregate,apart,apex,apiculate,articulated,basal,base,beyond,blade,calyx,cell,chartaceous,cm,connective,connivent,cuneate,cylindrical,darker,deltate,densely,diameter,directed,distally,ellipsoidal,elliptic,entire,equal,exceeding,exserted,flattened,fleshy,flower,fruit,fusiform,glabrate,glabrescent,glabrous,gland,glandular-puberulent,green,immature,lanceolate,leaving,less,light,linear,lobe,long,margin,mm,moderately,near,nearly,oblong,obtuse,often,older,ovate,ovoid,pedicel,pedicellar,peduncle,petiole,pore,present,puberulent,pubescent,purplish,radiu,remnant,ripe,rounded,rugose,shrub,simple,slightly,small,spaced,sparsely,stalked,stamen,stigma,stone,stripe,style,subcordate,subcoriaceous,swelling,thecae,time,tip,tree,truncate,tube,unbranched,unit,wide,x,yellow,young	-44,-pubescent,1.5-10.5,3-4-foliat,8-15,9-16,ape,axe,ciliat,ciliate,eaf,eed,glandular-puberulen,lon,lower,membranaceous,narrowly,nflorescence,nther,olde,orolla,perfect,pink,presen,purpl,rachi,ruit,stellate,tal,tem,tomentose,triangular,truncat,ud,vary,white,ympodial	3-4-foliate,anther,appearance,arrangement,bark,border,branch,bud,characteristic,colour,corolla,corrugation,distal,drying,exertion,filament,form,fruiting,giving,glabrousnes,growth,height,history,inflorescence,interjected,lateral,leaf,leaflet,length,life,lobing,midpoint,new,null,number,ovary,per,plant,prickle,primary,pseudostipule,purple,ray,seed,shape,size,stem,surface,sympodial,tall,terminal,texture,thicknes,type,variation,vein,width
489	wfo-0001031756	success	186	147	108	78	39	0.581	-5,.5,.8,0,0-2,0-5,0.02-0.2,0.1,0.4-1.6,0.5-1,0.6-1.2,0.6-1.6,0.8-1,1-2,1-3,1-4,1.5-2,1.5-3.5,1.8-2.5,1/3,3-5,4-5,5-merous,7-10,anther,apart,apex,articulated,bark,base,berry,blade,branched,calyx,cm,color,cordate,curved,densely,diameter,drying,entire,equal,erect,evenly,eye,filament,finely,flattened-reniform,flower,fruit,fruiting,glabrous,green,herbaceous,known,leaf,lobe,long,margin,mature,midpoint,mm,naked,one,open,orange-brown,pair,pedicel,peduncle,pendulous,per,pericarp,petiole,pitted,porrect,prickle,prickly,primary,ray,rounded,scandent,shoot,short,shrub,slender,smooth,spaced,sparsely,spherical,stalk,stalked,stellate-pubescent,stem,style,surface,terete,terminal,time,trichome,truncate,tube,unarmed,variously,vein,visible,wide,young	-1,.1,/2,0.15-0.25,0.2,0.5-1.3,0.7-1.7,00,1-1.8,1/2,10,2-6,3-15,3-7,4.5,6-9,9-14,abaxially,accrescent,acut,alyx,apar,apically,apparently,broad-deltate,chartaceous,concolorous,conical,connivent,deltate,eaf,eed,elongating,enclosing,free,fully,glabrescent,glabrou,gray,inflated,infructescence,invested,lobed,longer,lower,mauve,moderately,nflorescence,older,orolla,oung,ovate,pale,perfec,perpendicular,plurifoliat,poricidal,portion,prickl,red-brown,ruit,scar,sessile,shorter,simple,small,spreading,stellate,straight,tamen,tapering,tip,unit,vary,way,white,yellow-green,ympodial	appearance,arrangement,border,branch,bud,characteristic,colour,corolla,corrugation,distal,exertion,form,giving,glabrousnes,growth,height,history,inflorescence,interjected,lateral,leaflet,length,life,lobing,new,number,ovary,plant,pseudostipule,seed,shape,size,stamen,stigma,texture,thicknes,type,variation,width
490	wfo-0001031786	success	209	197	158	51	39	0.756	.4,.5,/2,/3,0-20,0-5,0.1,0.1-0.4,0.2-2.5,0.25-0.5,0.5-1.5,0.7-1,0.7-1.6,0.7-4,0.8-1.2,1,1-2,1-3,1-4,1-6,1.2-1.6,1.5-1.9,1.5-2.5,2-13,2-3,2-7,2-8,2.5-3.5,3-4,4-5,6-8,acute,almost,anther,apart,apex,apically,apparently,bark,base,becoming,berry,blade,branched,calyx,cell,chartaceous,cm,concolorous,connivent,cuneate,curved,dark,deep,deltate,diameter,distance,drying,elliptic,equal,erect,evenly,extending,filament,filiform,flattened,flattened-reniform,flower,free,fruit,fruiting,glabrescent,glabrous,gray,green,herb,inconspicuous,infructescence,lateral,leaf,length,lobe,lobed,long,longer,margin,maturity,mauve,membranous,midpoint,midvein,minute,mm,obtuse,older,one,open,orange,orange-brown,outline,ovate,pair,pale,pedicel,peduncle,per,petiole,pit,poricidal,porrect,portion,prickle,prickly,primary,raised,ray,red,red-brown,reflexed,rounded,scandent,sessile,shiny,shorter,shrub,side,simple,slightly,small,smooth,sometimes,spaced,sparsely,spherical,spreading,stalk,stalked,stellate-pubescent,stem,stigma,straight,style,surface,tapering,terete,time,tip,trichome,truncate,tube,variously,vein,way,weakly,white,wide,yellow-orange,young	-5,0,0-2,0-3,0.2-0.3,0.8,1/3-1/2,3-5.5,5-7,5-merous,8-12,abaxially,acut,alyx,ame,apar,articulated,c.,clavat,densely,eaf,eed,elongating,eye,gray-brow,herbaceous,lon,lower,mature,naked,nflorescence,orolla,oung,pendulous,perfec,pericarp,plurifoliat,prickl,ruit,scar,stellate,tamen,tertiary,thick,unarmed,unit,vary,venation,visible,woody,ympodial	appearance,arrangement,border,branch,bud,characteristic,clavate,colour,corolla,corrugation,distal,exertion,form,giving,glabrousnes,gray-brown,growth,height,history,inflorescence,interjected,leaflet,life,lobing,mentioned,new,number,ovary,plant,pseudostipule,seed,shape,size,terminal,texture,thicknes,type,variation,width
491	wfo-0001031793	exception_thrown	188	0	0	188	0	0.0		-4,.5,0,1,1-1.5,1-2,1-3,1-8,1.5-2,1.5-4,1/3,1/4,1/5,10-15,13-20,15-20,2-3,2-5,20,26,3-4,3-8,3/4,4,40,5-merous,7,8-11,absent,abundant,accrescent,acumen,acuminate,acute,adult,aging,almost,alyx,anther,apex,apparently,armed,articulated,aspect,axe,ba,base,berry,bilobe,black,blade,branche,branched,broad,broadly,brown,brownish,calyx,capitate,central,chartaceous,cm,cuneate,cut,densely,diameter,difoliate,distal,eaf,eed,elliptic,elongatin,erec,erect,evident,extra-axillary,extreme,ferrugineous,filament,flattened,flower,forked,fruit,fruiting,geminat,general,glandular,globose,hair,homostylou,inflorescence,interpetalar,larger,leaf,linear,lobe,lobing,lon,long,lower,main,many,margin,maturing,midpoint,midrib,minutely,mm,mostly,mucilaginous,nflorescence,oblique,oblong-lanceolate,obtuse,often,older,orange-yellow,orbicular-ovate,orolla,ovate,pedicel,peduncle,per,perfect,petiole,pore,porocidal,porrect,prickle,principal,pubescent,rachi,reddish,reduced,reticulation,rounded,ruit,rusty,scarcely,scattered,sessile,shallow,shrub,side,similar,simple,single,sinus,size,small,smaller,sparsely,stellate,stellate-pubescen,stellate-pubescent,stem,stigma,stipitate,stout,style,surface,tall,tamen,tem,testa,thickened,tip,tissue,tree,triangular,triangular-acuminat,trichome,tube,unarmed,unbranched,unit,upward,usually,uvenile,vary,way,well-developed,white,woody,x,yellow,yellow-brown,ympodial	
492	wfo-0001031829	success	138	163	118	20	45	0.855	.25,.5,0.5-2.1,0.7-1,1,1-2,1.3-1.5,1.5-2,1.5-2.5,1.5-3.5,1.5-4.5,2-4,3-5-flowered,3/4,4-4.5,4-8.5,7-10,abaxially,absent,acute,adaxial,adaxially,along,anther,anthesi,apex,apiculae,bae,bark,base,berry,branched,broadly,calyx,capitate,cm,conical,corolla,crystalline,densely,denser,dia,differing,difoliate,drying,elliptic,epidermi,exserted,filament,free,fruiting,glabrous,globose,green,greenish-brown,growth,immature,inflorescence,known,large-celled,lateral,leaf,leathery,like,lobe,lobed,long,main,major,margin,minor,minute,minutely,mm,occasionally,often,opposite,ovary,packed,pair,papillose,pedicel,petiole,planar,pore,poricidal,portion,pubescent,quadrate,revolute,scar,shaped,shrub,simple,size,soft,somewhat,sparsely,stem,stigma,style,surface,tall,tapering,tear-drop,thick,tip,trichome,tube,uniseriate,unit,vein,waxy,way,white,x,yellowish,young	ape,deflexed,eaf,edicel,eed,erect,geminat,glabrat,lon,lower,nflorescence,older,overlappin,papillo,ruit,tub,tuft,ud,woody,ympodial	appearance,arrangement,border,branch,bud,characteristic,colour,corrugation,diameter,distal,exertion,form,fruit,geminate,giving,glabrate,glabrousnes,height,history,interjected,leaflet,length,life,lobing,midpoint,new,null,number,overlapping,peduncle,per,plant,prickle,primary,pseudostipule,ray,seed,shape,sympodial,terminal,texture,thicknes,type,variation,width
493	wfo-0001031832	success	232	202	163	69	39	0.703	-8,/50-1/10,0-150,0.1-0.3,0.2-0.6,0.2-1.5,0.3-0.8,0.3-3,0.7-1.6,0.7-2,0.8-1.2,1-12,1.2-1.6,1.2-2,14,2-3.6,2-4,2-6,3-6.5,3-7,4-20,5-21,7-10,8-25,9,abaxially,acuminate,adaxially,anther,anthesi,apart,apex,articulated,attenuate,axe,bark,basal,base,becoming,berry,blade,blister,blunt-tipped,branch,branched,brown,brownish,bud,bullate,calyx,closely,cm,conical,connate,continued,corolla,dark,decurrent,deltoid,diameter,due,entire,exserted,ferrugineous,few-rayed,filament,fleshy,flower,forming,fruit,fruiting,glabrescent,glabrous,globose,granular-tomentose,green,greenish,growth,hair,half,high,honeycombed,indument,lanceolate,lateral,leaf,length,lobe,long,long-,main,margin,midvein,mixed,mm,mostly,multangulate,nearly,oblanceolate,oblong,obovoid,obtuse,occasionally,older,orbicular,ovate,pale,partly,pedicel,peduncle,persistent,petiole,pitted,porrect-stellate,probably,pubescence,pubescent,rachi,ray,relatively,reniform,reticulate-punctate,ripe,rough,scabrous,sessile,short-,short-stalked,shrub,side,simple,smooth,somewhat,soon,spaced,sparingly,sparse,stamen,stem,stigma,style,subcampanulate,suborbicular,surface,swelling,terete,terminal,thick,thick-stalked,time,tree,tube,unarmed,usually,vein,violet,weakly,white,wide,x,yellow,yellowish,young	.5-1,0.7-1.5,1.1-2.4,1.2-2.5,1.3-4.2,1.5-4,1.7-4,1.8-4,1/2-3/4,2.5-6.5,2.8-4.8,3.5-7,4-7,5.5-10,accrescent,acute,ag,apical-lateral,apice,apparently,axillary,ba,capitat,chartaceous,dehiscing,directed,eaf,eed,evident,extend,free,glabrescen,inserted,introrse,lackin,large,line,lobed,longer,longitudinal,lower,m.,minute,nflorescence,orolla,perfect,plurifoliate,pore,porrect-stellat,rather,rotate-stellate,ruit,runk,slit,sometimes,splitting,stellate-pubescent,stipitate-glandular,suture,tamen,testa,toward,translucent,unarme,unit,vary,way,whitish,ympodial	appearance,arrangement,border,capitate,characteristic,colour,corrugation,distal,drying,exertion,form,giving,glabrousnes,height,history,inflorescence,interjected,leaflet,life,lobing,mentioned,midpoint,new,number,ovary,per,plant,prickle,primary,pseudostipule,seed,shape,size,texture,thicknes,trunk,type,variation,width
494	wfo-0001031834	success	150	169	120	30	49	0.8	.5,0.5,0.5-1,0.5-3,0.5-3.5,0.6-1.4,0.8-1,0.8-1.3,0.9-1.4,1,1.5,1.5-4,1.6-2,1.9-6.5,2.9-7,2/3,6-7,6.5-14,accrescent,acuminate,acute,anther,anthesi,apex,apiculate,attenuate,base,berry,bi-cellular,borne,calyx,campanulate,cm,corolla,covered,deciduous,decurrent,deltoid,depression,difoliate,few-flowered,filament,flattened-reniform,free,fruit,fruiting,glabrous,globose,green,greenish-yellow,hook,hooked,lamina,larger,leaf,less,lobe,lobed,long,lower,major,margin,markedly,middle,minor,minute,minutely,mm,mound-like,multicellular,often,opposite,ovary,ovate,pale,papillose,pedicel,persistent,petiole,pitted,planar,pore,poricidal,portion,proximal,pubescent,scabrous,shaped,short,shrub,simple,slender,slightly,small,sparsely,stem,stigma,straight,style,surface,tall,tan,tapering,tear-drop,tip,trichome,tube,tufted,uni-,uniseriate,unit,upper,usually,vein,way,white,widest,x,yellow,young	across,apar,apically,appear,deciduou,deflexed,dia,eaf,edicel,eed,expanded,eye,geminat,glabrou,incrassate,leaving,like,lon,naked,nflorescence,papillo,ruit,scar,soon,spaced,speck,ud,unevenly,woody,ympodial	appearance,arrangement,bark,border,branch,bud,characteristic,colour,corrugation,diam,diameter,distal,drying,exertion,form,geminate,giving,glabrousnes,growth,height,history,inflorescence,interjected,lateral,leaflet,length,life,lobing,mentioned,midpoint,new,number,peduncle,per,plant,prickle,primary,pseudostipule,ray,seed,shape,size,sympodial,terminal,texture,thicknes,type,variation,width
495	wfo-0001031842	success	161	186	139	22	47	0.863	.1,.4,.5,.75,0.1-0.5,0.5-2,0.6-1,0.7-1,1,1-1.5,1-1.8,1.5-2,10-12,10-20,10-30-flowered,2-10,2-3,2.5-3,2.5-6,3-8,3/4,4.5-6,7-9,9-15,acute,anther,anthesi,apart,apex,attenuate,axil,bark,base,bearing,beginning,beneath,berry,bi-lobed,brown,calyx,capitate,cm,corolla,cup-shaped,cusp,dark,decurrent,deeply,deflexed,densely,dia,difoliate,dry,ellipsoid,elliptic,exsertion,filament,flattened-reniform,free,fruiting,glabrous,globose,green,incrassate,irregularly,later,lateral,leaf,leaf-opposed,lobe,lobed,long,main,margin,middle,minutely,mm,near,new,often,older,onto,opposite,ovary,overtopping,pair,pale,paler,papillose,pedicel,petiole,pitted,pore,poricidal,portion,prominent,pubescent,quadrate,reddish,reddish-resinous,reflexed,shaped,shiny,shoot,shrub,simple,size,slender,somewhat,soon,spaced,sparsely,specimen,stem,stigma,straight,strongly,style,surface,tall,tapering,tear-drop,terminal,time,tip,tree,trichome,tube,tuft,uniseriate,unit,vein,way,white,widest,woody,x,yellowish,young	0.5-1,1-3.5,ba,differing,eaf,edicel,eed,exserte,geminat,inflorescenc,lon,lower,major,minor,nflorescence,one,papillo,ruit,scar,ud,yellowish-whit,ympodial	2,appearance,arrangement,border,branch,bud,characteristic,colour,corrugation,diameter,distal,drying,exertion,exserted,form,fruit,geminate,giving,glabrousnes,growth,height,history,inflorescence,interjected,leaflet,length,life,lobing,midpoint,null,number,peduncle,per,plant,prickle,primary,pseudostipule,ray,seed,shape,sympodial,texture,thicknes,type,variation,width,yellowish-white
496	wfo-0001031843	success	245	256	212	33	44	0.865	.2,.3,.5,.6,0-4,0.2-2,0.4-0.5,0.5-1,0.5-1.5,0.6-1.2,0.7-1.2,0.7-2,1-7,1.2-2,1.2-2.2,1.5,1.5-2,1.8-2.5,1mm,2-3,2-4,2.5,3-4,3-7,4-12,45-60Â°,5-10,5-12,6-9,accrescent,acuminate,age,almost,along,always,anther,apex,apically,appressed,around,articulated,attenuate,bark,basal,base,becoming,berry,black,branch,branched,branching,broadly,brown,calyx,canaliculate,capitate,caudate,clearly,cm,collapsing,completely,conical,corolla,cupular,curved,cuspidate,dark,deeply,delineated,deltoid,dendritic,density,detaching,diameter,dilated,discoid,discolorous,distributed,domatia,drying,dull,entire,equal,erect,even,evenly,eye,fertilisation,filament,finely,flexuous,flower,forming,free,fruiting,glabrous,green,hand,honeycomb,inner,largely,leaf,leave,len,length,lengthening,liana,lignified,like,lobe,lobed,long,longitudinally,loop,looping,lower,main,margin,midvein,mm,much,multiseriate,naked,network,never,oblique,oblong,obovate,obscure,older,opening,orange,orange-brown,orange-yellow,outline,ovate,pair,part,partly,pattern,pedicel,peduncle,pendulous,pericarp,petiole,pit,pitted,pore,poricidal,portion,present,primary,pronounced,protruding,pubescent,rachi,rarely,red,reddish,reveal,ribbed,ridged,rounded,scar,seed,shallowly,shiny,shortly,shrub,side,simple,sinus,slender,slightly,small,smaller,smooth,sometimes,soon,sparsely,spheroidal,spreading,stem,stigma,straight,strongly,stump,style,surface,tearing,terminal,tertiary,thick-chartaceous,thickened,thin,tip,trichome,tube,tuft,twice,unarmed,variable,vein,venation,violet,visible,weakly,wide,wider,without,x,young	0.8-2,1-2,1/6-1/4,abaxially,adaxially,alyx,anthesi,apar,apice,apparently,eaf,eed,ellipsoi,fine,flat,m.,nflorescence,nther,orolla,papillo,perfec,plurifoliat,prominent,raised,recurve,ruit,see,surfac,ud,unit,vary,white,ympodial	apart,appearance,arrangement,border,bud,characteristic,colour,corrugation,distal,ellipsoid,exertion,form,fruit,giving,glabrousnes,growth,height,history,inflorescence,interjected,lateral,leaflet,life,lobing,midpoint,new,null,number,ovary,papillose,per,plant,prickle,pseudostipule,ray,recurved,seen,shape,size,texture,thicknes,type,variation,width
497	wfo-0001031852	success	155	154	103	52	51	0.665	0.1-1,0.5-1.3,0.5-3,1-4,1-4.2,1-9,1.3-2.5,1.4-3,1.5-3,12-35,2-3,2-5.5,2.6-9.5,3-4,3-9,3.5-10,4-10,4-6,5-15,7-,9-11,abaxially,acumen,acuminate,acute,adaxially,apex,apiculate,articulate,attenuate,base,branched,calyx,cell,cm,conical,connate,corolla,covering,cyme,diameter,dichasial,dichasially,distal,dorsally,ebracteate,edge,elliptic,elliptic-lanceolate,exceeding,filament,flat,flower,folded,forked,generally,green,green-white,half,herbaceous,interjected,lanceolate,lateral,leaf,leaflet,light,lobe,long,make,mm,monochasial,mucilaginous,oblique,oblong,odd-pinnate,ovate-elliptic,ovoid,pedicel,peduncle,perennial,perfect,petiole,plant,proximal,pubescent,seed,size,stamen,stellate,stigma,straight,style,terminal,testal,thick,throughout,tuber-bearing,wall,white,wide,without,yellow,Â¼	-8,1-,3-6-foliat,4-,4-5,abruptly,absen,apical,apically,decurrent,dehiscent,digestion,diminishing,eaf,eed,emoval,enzyme,globo,hair-like,honeycomb,introrse,living,lon,lower,lunat,maturing,nflorescence,nther,often,orolla,pair,pattern,plan,poricidally,rachi,reveal,ruit,sessile,seudostipule,short,shortly,slit,specimen,tal,tem,throughou,toward,typically,unit,vary,white-crea,ympodial	'hair-like,absent,anther,appearance,arrangement,bark,border,branch,bud,characteristic,colour,corrugation,drying,exertion,form,fruit,fruiting,giving,glabrousnes,globose,growth,height,history,inflorescence,length,life,lobing,lunate,margin,mentioned,midpoint,new,number,ovary,per,prickle,primary,pseudostipule,ray,shape,stem,surface,texture,thicknes,tube,type,variation,vein,wet,white-cream,width
498	wfo-0001031864	success	140	150	100	40	50	0.714	.2,.25,.5,0.2-0.5,0.4-3,0.5-13.5,0.6-3.5,0.6-4,0.7-0.8,0.8-1,1-1.2,1-1.8,1-2,1-5,1-6.5,1.2-1.5,1.5,1.5-10,1.5-2.5,15-60,2,2-3,2.5-6,3-3.5,3-pinnate,abaxially,acuminate,acute,adaxially,anther,apex,apical,apiculate,base,berry,blade,calyx,ciliate,clavate,cm,color,cuneate,deltoid,dense,diameter,entire,extra-axillary,filament,fine,flattened,flower,fruit,fruiting,glabrous,hair,herbaceous,lateral,leaflet,lenticular,like,lobe,long,margin,middle,minutely,mm,moderately,oblique,ovoid-deltoid,papillose,pedicel,peduncle,petiole,pointed,pubescence,pubescent,rounded,sand-punctate,scattered,short,slender,sparsely,stem,stigma,style,surface,tip,trichome,truncate,tube,typical,unbranched,unit,unknown,vein,vine,violet,wide-diameter,widely,x	0.5-4,1-3,5-15,5-9,5-merous,7.5-8,accrescent,alyx,apar,axe,c.,capitat,chartaceous,densely,eaf,eed,emarginate,fleshy,glabrou,lon,lower,m.,near,nflorescence,nternode,orolla,perfec,petiolule,plurifoliat,pubescenc,rachi,rotate,ruit,slightly,spaced,tamen,tem,terrestria,vary,ympodial	appearance,arrangement,bark,border,branch,bud,capitate,characteristic,colour,corolla,corrugation,distal,drying,exertion,form,giving,glabrousnes,growth,height,history,inflorescence,interjected,internode,leaf,length,life,lobing,mentioned,midpoint,new,number,ovary,per,plant,plurifoliate,prickle,primary,pseudostipule,ray,seed,shape,size,sympodial,terminal,terrestrial,texture,thicknes,type,variation,width
499	wfo-0001031864	success	148	166	116	32	50	0.784	.2,.25,.5,0.4-3,0.5-13.5,0.5-4,0.6-3.5,0.6-4,1-1.2,1-1.8,1-2,1-3,1-5,1-6.5,1.2-1.5,1.5,1.5-2.5,15-60,2,2-3,2.5-6,3-3.5,3-5-celled,3-pinnate,5-15,7.5-8,abaxially,absent,accrescent,acuminate,acute,adaxially,anther,apart,apex,apical,apiculate,apparently,articulated,axe,basally,base,blade,blue-purple,calyx,center,ciliate,clavate,cm,connivent,cordate,cuneate,deltoid,dense,densely,diameter,entire,extra-axillary,filament,fine,fleshy,flower,fruit,fruiting,geminat,glabrous,hair,herb,interjected,lateral,leaflet,lenticular,lobe,long,margin,minutely,mm,node,oblique,oblong,papillose,pedicel,peduncle,plurifoliate,pubescence,pubescent,rachi,rooting,rotate,rounded,scattered,short,simple,slender,slightly,somewhat,spaced,sparsely,stigma,style,surface,terrestrial,thick,tip,trailing,truncate,tube,unbranched,uniseriate,unit,unknown,weakly,widely,wiry,woody,x	5-9,5-merou,ag,alyx,ba,capitat,color,directed,distally,eaf,eed,emarginate,equal,etiole,large,longitudinal,lower,m.,near,nflorescence,opening,orolla,perfect,petiolule,pore,pubescenc,slit,tamen,tem,vary,yellow,ympodial	achi,appearance,arrangement,bark,border,branch,bud,capitate,characteristic,colour,corolla,corrugation,distal,drying,exertion,form,giving,glabrousnes,growth,height,history,inflorescence,leaf,length,life,lobing,mentioned,midpoint,new,number,ovary,per,petiole,plant,prickle,primary,pseudostipule,ray,seed,shape,size,stem,sympodial,terminal,texture,thicknes,type,variation,vein,width
500	wfo-0001031871	success	185	166	121	64	45	0.654	0.4-2,0.6-1.2,1-2,1.4-2.1,1.5-11,1.5-2,1.5-2.1,1.6-2.7,14-22,2-4,2.9-6,3-10,3-4,3-5,3.5-4,33-40,36-44,4-6,4-7,5.4-12.3,6-12,6-7,6.5-20.5,7-9,7.5-23,abaxially,acumen,acute,adaxially,anther,apart,apex,apparently,asymmetric,attenuate,axillary,base,basiscopic,berry,blade,brownish,bud,cell,clavate,cm,condition,connivent,corolla,covering,dark,deep,diameter,distal,dot,drying,elliptic,filament,flower,forked,fresh,fruit,generally,glabrous,globose,green,greenish,hair,half,herb,interjected,lanceolate,lateral,leaflet,linear,lobe,long,make,medium,mm,mottled,mucilaginous,narrowly,odd-pinnate,orbicular,ovate,ovoid,pedicel,peduncle,perfect,petiole,petiolulate,plant,pubescent,purple,ripe,rounded,seed,sessile,short,side,size,sometimes,stigma,style,subglabrous,subtending,symmetric,terminal,testal,thick,tiny,tissue,tube,usually,wall,wet,white,whitish,wide,winged,x	2-3,5-merou,adaxiall,ag,alyx,articulated,axe,capitat,chartaceous,digestion,dorsally,eaf,edge,eed,end,enzyme,erec,exceeding,flat,folded,geminat,glabrou,green-white,hair-like,hal,high,homostylous,honeycomb-shaped,lengthening,living,lower,nflorescence,one,orolla,pair,placed,plurifoliate,pore,poricidal,removed,rotate,round,ruit,seudostipule,slit,spaced,specimen,stamen,stolo,straight,subequal,subglabrou,tall,tamen,tem,throughout,tip,tri-,tuber,typically,unit,vary,yellow,ympodial	'hair-like,appearance,arrangement,bark,border,branch,calyx,capitate,characteristic,colour,corrugation,erect,exertion,form,fruiting,giving,glabrousnes,growth,height,history,inflorescence,leaf,length,life,lobing,margin,mentioned,midpoint,new,number,ovary,per,prickle,primary,pseudostipule,ray,shape,stem,surface,texture,thicknes,type,variation,vein,width
501	wfo-0001031876	exception_thrown	140	0	0	140	0	0.0		.1,.5,0-flowered,0.5,0.8-1,1,1-1.5,1-1.6,1-4,1.5-2.2,27-35,3,5,9-15,?,across,acute,anther,anthesi,apex,apiculate,arc,arising,ba,bark,base,bearing,beneath,berry,bright,calyx,closely,cm,convergence,corky,corolla,cup-like,decurrent,dia,differing,eaf,edicel,eed,elliptic,erect,family,filament,flower,free,fruiting,glabrou,glabrous,globose,granular,green,greenish-yellow,immature,irregularity,known,lateral,leaf,lenticellat,less,lightly,lobe,lobed,long,long-acuminate,lower,main,major,margin,melastomataceae,member,middle,minute,minutely,mm,nearly,nflorescence,oblanceolate,oblique,often,opposite,otherwise,ovary,overlappin,pair,papillose,parallel,pedicel,perpendicular,persistent,petiole,point,pore,poricidal,portion,present,primary,prominent,raised,recurved,reflexed,resemble,ruit,running,scar,secondary,shaped,shrub,simple,slender,slightly,spaced,stem,stigma,straight,styl,style,tall,tapering,tear-drop,time,tip,tube,ud,unifoliat,unit,vein,venation,white,wide,widest,winged,woody,x,yellow,ympodial,young	
502	wfo-0001031877	success	216	190	148	68	42	0.685	+,.5,0.3-,0.3-1,0.3-1.2,0.5,0.6-1.2,1,1-1.5,1-3,1-3.5,1.1-,1.5,1.5-1.9,1.8-5,2,2-,2.5,3-5,3-6,3.5-4,6-10,6-8,abruptly,acuminate,acute,adaxially,angled,anther,anthesi,apex,ascending,basal,basally,base,berry,bright,brown,calyx,capitate,clavate,cm,conical,connivent,corolla,deltate,densely,diameter,distal,dried,ellipsoid,ellipsoidal,enlarged,entire,erect,exserted,eye,filament,flattened,fleshy,flower,fruit,fruiting,furcate,glabrous,globose,green,greenish,growth,hastate,impressed,lamina,later,lateral,like,line,linear,lobe,lobed,long,long-acuminate,loosely,lower,margin,material,minute,minutely,mm,nearly,new,occasionally,often,outline,pair,pale,parallel,part,pedicel,peduncle,per,petiole,pitted,plant,plump,pointing,primary,pubescence,pubescent,purple,red,reddish,reniform,rest,ripe,rounded,scrambler,seed,semi-woody,shiny,simple,slender,slightly,sometimes,somewhat,sparsely,stem,stigma,strongly,style,surface,terminal,tinged,tip,triangular,trichome,truncate,tube,uniformly,uniseriate,upper,usually,vein,vine,visible,weak,white,woody,x	.3,0.2,0.5-1,0.8-0.9,1-4,1.5-2,5-merou,abaxially,adaxiall,ag,along,alyx,apar,apparently,ark,articulated,cell,deep,deflexed,eaf,eed,especially,exposed,free,ilament,internal,irregularly,lengthening,mature,midvein,nflorescence,older,orolla,papillate,papillo,perfect,pericarp,plurifoliat,pore,poricidal,portion,prominently,purplish,rectangular,reflexed,ruit,scar,short,shorte,silky,sinuate,sleeve,slit,spaced,spreadin,stellate,subshru,tem,testal,thin,twinin,ud,unit,vary,wall,yello,ympodial,young	appearance,arrangement,bark,border,branch,bud,characteristic,colour,corrugation,drying,exertion,form,giving,glabrousnes,height,history,inflorescence,interjected,leaf,leaflet,length,life,lobing,midpoint,na,number,ovary,papillose,plurifoliate,prickle,pseudostipule,ray,shape,shorter,size,subshrub,texture,thicknes,type,variation,width,yellow
503	wfo-0001031880	success	180	200	156	24	44	0.867	.5,0.5-2,0.7-0.8,1,1-1.3,1-1.5,1-2,1.5,2,2-3,2-4,2-9,2.5-8,3-3.5,3-4-pluri-foliate,3-foliate,3-lobed,4,4-8,5,5-6,6-9,7-9,acuminate,acute,age,anther,anthesi,apex,basal,base,bearing,becoming,berry,broadly,brown,calyx,capitate,cell,ciliate,cm,color,conical,cordate,corolla,crenate,crowded,cup-shaped,curved,dark,densely,diameter,ellipsoid,elliptic,enlarged,entire,erect,exerted,filament,flattened,fleshy,flower,free,fruit,fruiting,glabrous,gland,gland-tipped,glandular,globose,green,growing,herb,heteromorphic,hollow,horn,inflorescence,internodal,irregularly,lamina,leaf,lengthening,less,lobe,long,longest,lower,margin,markedly,mature,mid-length,middle,minutely,mm,narrowly,near,nodding,orange,ovary,ovate,ovoid,pair,pale,papillose,pedicel,peduncle,pericarp,petiole,pitted,pore,poricidal,portion,primary,pubescent,purple,red,reddish,reflexed,shallowly,shortest,simple,single,slender,slightly,slit,sometimes,sparse,spreading,stem,stigma,straight,strongly,style,subshrub,surface,terminal,testal,thin,tip,toothed,triangular,trichome,truncate,tube,uniseriate,unit,unlobed,upper,upward,vein,wall,widest,woody,x,yellow,â5	0.5-1,abaxially,adaxially,apart,c.,eaf,edicel,eed,flush,lon,maturit,nflorescence,papillo,plan,pubescen,rachi,ruit,scar,spaced,sparsely,ud,unicellula,widely,ympodial	appearance,arrangement,bark,border,branch,bud,characteristic,colour,corrugation,distal,drying,exertion,form,giving,glabrousnes,growth,height,history,interjected,lateral,leaflet,length,life,lobing,maturity,midpoint,new,null,number,per,plant,prickle,pseudostipule,ray,seed,shape,size,sympodial,texture,thicknes,type,unicellular,variation,width
504	wfo-0001031881	success	168	168	132	36	36	0.786	.5,0.1-0.5,0.2,0.4-1,0.5-0.7,0.5-1,1-1.3,1-1.5,1-7,1.2-6,1.5-2.5,1/3,10-12,10-30,2,2-9,3-19,3.5-4,3/4,5-6,7-14,absent,acute,along,anther,anthesi,apex,attenuate,axil,bark,base,beneath,branch,branched,broadly,brown,bud,calyx,campanulate,capitate,cm,constriction,corolla,dark,decurrent,deflexed,deltoid,densely,dia,distal,dry,drying,either,ellipsoid,elliptic,erect,exserted,filament,free,fruit,fruiting,glabrous,globose,golden,golden-pubescent,green,incrassate,inflorescence,lateral,leaf,lightly,like,lobe,lobed,long,main,major,margin,material,middle,midrib,minor,minute,minutely,mm,obovate,opposite,ovary,ovoid-reniform,pair,papillose,pedicel,petiole,pitted,pore,poricidal,portion,puberulent,pubescent,rest,rounded,shape,shaped,shrub,simple,size,slender,small,somewhat,soon,sparsely,stem,stigma,strong,style,surface,tall,tapering,tear-drop,tip,tree,trichome,tube,uniseriate,usually,vein,way,white,widest,winged,x,young	0.2-0.6,apar,apparent,ba,differing,difoliate,eaf,edicel,eed,evenly,fleshy,geminat,golden-puberulent,greyish-brow,inflorescenc,junction,lon,lower,maturity,nflorescence,occasionally,older,one,orbicular,papillo,planar,puberulen,ruit,scar,slightly,spaced,straight,ud,unit,woody,ympodial	appearance,arrangement,border,characteristic,colour,corrugation,diameter,exertion,form,giving,glabrousnes,greyish-brown,growth,history,interjected,leaflet,length,life,lobing,midpoint,new,null,number,peduncle,per,prickle,primary,pseudostipule,ray,seed,terminal,texture,thicknes,type,variation,width
505	wfo-0001031886	success	169	179	136	33	43	0.805	-1.2,-25,-4,-9,.5,0,0.5-1,1-1.5,1-4,1.2-2.5,1.5-2,10-40,2,2-2.5,2-3,2-4,2-5,2.0-2.5,20-30,3-6,3.0,4,4-15,5-10,5-6,5-ridged,6-20,9-10,abaxially,absent,acuminate,adaxially,along,anther,anthesi,anticlinal,apex,arising,attenuate,axil,axillary,base,bearing,berry,bright,broadly,brown,bud,calyx,capitate,cell,cm,commonly,completely,conical,corolla,diameter,distinctly,dry,earl,elliptic,epidermal,exserted,filament,fleshy,flower,free,fruit,fruiting,glabrous,green,greenish,half,irregular,lateral,leaflet,lobe,lobed,long,lower,margin,minutely,mm,near,nearly,node,occasionally,ovary,ovoid-reniform,pair,papillae,papillate,papillose,pedicel,per,petiole,pinnate,poricidal,portion,primary,projection,purple,rachi,reddish,reflexed,ripe,scar,scattered,seed,shape,shrub,simple,single,sinuous,smelling,somewhat,sparse,specimen,stigma,strongly,style,surface,terminal,thickening,time,tip,triangular,trichome,tube,uniseriate,vein,white,wintergreen,without,woody,x	0.1,6-8,abruptly,basal,beak,clavat,deltate,eaf,edicel,eed,either,em,equal,erec,lanceolate,le,narrowed,nflorescence,noddin,oblique,open-conical,petiolule,raised,rugose,ruit,similar,smaller,tub,ud,unifoliat,unit,usually,ympodial	1,appearance,arrangement,bark,border,branch,characteristic,clavate,colour,corrugation,deltoid,distal,drying,exertion,form,giving,glabrousnes,growth,height,history,inflorescence,interjected,leaf,length,life,lobing,mentioned,midpoint,new,number,peduncle,plant,prickle,pseudostipule,ray,size,stem,texture,thicknes,type,unifoliate,variation,width
506	wfo-0001031895	exception_thrown	160	0	0	160	0	0.0		-1.5,0.5,0.5-1,0.5-2,1-1.5,1.5-2,1.5-3,1.5-6,2-2.5,2.5-3,3-10,3-4,3-8,3.5-6,4,4-5,4.5-16.5,5,5-6,5-8,6-7,6-9,acute,age,anther,anthesi,apex,apparently,articulating,attenuate,bark,base,beneath,berry,blac,bluish,broadly,calyx,campanulate,capitate,cell,cm,completely,conical,corolla,cup-shaped,dark,deltate,densely,diameter,drying,eaf,eed,ellipsoid,elliptic,emarginated,enlarging,entire,erec,erect,exerted,exfoliating,expand,filament,fleshy,flower,fragrant,free,fruiting,glabrou,glabrous,globose,green,growth,immature,inflorescenc,intensely,irregular,leaf-opposed,leafy,leaving,lengthening,less,lobe,lobed,lower,margin,matte,minutely,mm,new,nflorescence,occasionally,older,once-branched,ovary,overlapping,ovoid,pair,pale,papillat,papillate,part,patch,pedicel,peduncle,peeling,peg,perfect,pericarp,petiole,pitted,planar,plurifoliat,pore,poricidal,portion,primary,reddish,reniform,revolute,ruit,scar,shiny,shoot,short,shrub,simple,sinuate,slender,slightly,slit,small,somewhat,stem,stigma,stout,straight,strongly,style,surface,tan,terminal,testal,thick,thin,tip,tree,tub,tube,ud,unit,vein,violet,way,white,woody,x,ympodial,Â¼-1/2	
507	wfo-0001031897	success	264	214	175	89	39	0.663	.1,.5,.8,0-1,0.1-0.5,0.15,0.5-1,0.5-3,0.6,0Â°,1-2,1.1,1.3-2,1.5-8,1.7-3,13,2-4,4-5,5-6,6-9,abaxial,abaxially,absent,acute,adaxial,adaxially,almost,along,anther,apex,apically,appearing,appendage,arising,aristate,articulated,attenuate,axillary,bark,base,bendy,berry,black,brachyblast,branch,branched,brown,calyx,chartaceous,clavate,clustered,cm,concolorous,condensed,conical,coriaceous,corolla,cuneate,curved,dense,densely,developed,developing,diameter,dilated,distributed,divided,dry,drying,dull,elliptic,entire,epiphyte,equal,erect,even,evenly,except,extending,eye,faint,filament,filiform,fine,flower,free,fruit,fruiting,glabrous,green,grey,hair,known,lamina,lanceolate,larger,lateral,leaf,least,light,linear,lobe,lobed,long,longitudinal,longitudinally,main,margin,mauve,midvein,mm,multicellular,naked,obconical,oblong,obtuse,occasionally,one,orange-brown,ovate,ovoid,pair,partly,pedicel,peduncle,pericarp,petiole,plant,pointed,poricidal,portion,primary,pubescent,raised,rarely,reddish,revolute,ribbed,ridge,ridged,scar,seen,shoot,short,shrub,simple,slender,slightly,smooth,sometimes,sparse,sparsely,stem,stigma,style,subulate,sunk,surface,terete,terminal,thick,thin,tip,trichome,tube,unarmed,usually,vein,venation,visible,white,winged,wrinkle,x,young	0.2-0.4,0.4-1.1,0.8-1.5,1,1-1.5,1-2.5,1.5,2/3,462.,8,accrescent,age,alyx,anthesi,apar,apparently,boiteau,cell,clearly,connate,covering,dark,datum,dehiscing,delineated,dendritic,development,domatia,dorsal,dorsifixed,eaf,earliest,ed,enlarged,foliaceous,immature,indistinc,inner,inside,lengthening,like,looped,lower,m.,margi,membranous,minute,minutely,multiseriate,never,nflorescence,nther,oblon,occasional,orange,orolla,outside,overlapping,papillose,part,pendulous,perfec,persisting,plurifoliat,pore,prominent,pronounced,protruding,reach,ruit,secondary,see,side,sinus,smaller,smoot,stump,tearing,tertiary,toward,ud,unbranched,unicellular,unit,vary,weakly,well-developed,wide,ympodial	appearance,arrangement,border,bud,characteristic,colour,corrugation,distal,exertion,form,giving,glabrousnes,growth,height,history,indistinct,inflorescence,interjected,leaflet,length,life,lobing,midpoint,new,number,ovary,per,prickle,pseudostipule,ray,seed,shape,size,specified,texture,thicknes,type,variation,width
508	wfo-0001032157	success	136	145	104	32	41	0.765	.5,.75,0.25,0.5-1,0.6-1,0.75-1,1-3,1.9-2.2,2-3,2-5,2.2,3-6,5-15-flowered,5-8,5-9,7-9,9-17,acute,anther,anthesi,apex,bark,base,becoming,beneath,berry,bi-lobed,calyx,cm,completely,corolla,crystalline,decurrent,deflexed,deltoid,dia,differing,dry,elliptic,exserted,filament,free,fruiting,glabrous,globose,golden,green,incrassate,lateral,leaf,less,live,lobe,lobed,long,main,major,margin,minor,minutely,mm,nearly,obscure,opposite,ovary,ovoid-reniform,pair,paler,papillose,pedicel,persistent,petiole,pitted,plant,pore,poricidal,portion,raised,reddish,reflexed,rounded,shaped,shrub,simple,size,slender,slightly,soon,stem,stigma,straight,style,surface,tall,tapering,tear-drop,tip,tube,vein,white,woody,x,yellowish,young	apart,beginning,caly,difoliate,eaf,edicel,eed,evenly,frui,geminat,glabrou,inflorescenc,living,lon,longitudinal,lower,middle,nflorescence,older,one,papillo,peeling,ruit,scar,shiny,spaced,strip,translucen,ud,unit,widest,ympodial	appearance,arrangement,border,bud,characteristic,colour,corrugation,diameter,distal,drying,exertion,form,fruit,giving,glabrousnes,growth,history,inflorescence,interjected,leaflet,length,life,lobing,midpoint,new,null,number,peduncle,per,prickle,primary,pseudostipule,ray,seed,shape,terminal,texture,thicknes,type,variation,width
509	wfo-0001032161	success	146	149	108	38	41	0.74	.5,0.4-1.2,0.5-1,0.7-4,0.8-1,1-1.5,1-11,1-3,1.2-1.3,1.4-2,2-7,2-8-flowered,2.5-3,3.5-4,?,acute,adaxially,anther,anthesi,apex,area,bark,base,berry,branched,calyx,cm,conical,coriaceous,corolla,dark,delicate,deltate,dendritic,densely,dia,drying,ellipsoid,elliptic,exserted,filament,filiform,fruiting,giving,glabrous,globose,golden,green,inflorescence,internodal,later,leaf,like,lobe,lobed,long,margin,merely,middle,minute,minutely,mm,mustard,nearly,obovate,occasionally,opposite,ovary,ovoid-reniform,pale,papillose,pedicel,pericarp,persistent,petiole,pitted,pore,poricidal,pubescent,quadrate,reflexed,revolute,shaped,shiny,shrub,simple,sparsely,stem,stigma,strongly,style,sulcate,surface,tall,tan,tear-drop,thin,tip,trichome,tube,uniseriate,usually,vein,white,widest,x,yellow,young	0.75-1,abaxially,adaxiall,apical,ba,beneath,brownish-blac,closely,color,deflexed,difoliate,eaf,edicel,eed,free,hanging,lamina,lower,many,nflorescence,older,overlappin,plant,plurifoliate,portion,projection,rest,ruit,scar,shoot,short,spaced,styl,tub,ud,unit,yellowish,ympodial	appearance,arrangement,border,brownish-black,bud,characteristic,colour,corrugation,diameter,distal,exertion,form,fruit,glabrousnes,growth,history,interjected,lateral,leaflet,length,life,lobing,midpoint,new,null,number,peduncle,per,prickle,primary,pseudostipule,ray,seed,shape,size,terminal,texture,thicknes,type,variation,width
510	wfo-0001032165	success	197	199	159	38	40	0.807	.25,.5,0.1,0.1-0.3,0.25-0.5,1-1.2,1-1.5,1-2,1.5-4,10-25,2-2.5,2.5-3.5,3-4,3-6,3.5-8.5,4-6,5-15,5-30-flowered,5-6,5-7,5-9.5,8-9,abaxial,acute,adaxial,along,anther,anthesi,apex,appearing,bark,base,beneath,berry,broadly,brown,bud,calyx,capitate,center,cm,continued,corolla,cucullate,cup-shaped,dark,deciduous,decurrent,densely,denser,dia,differing,distal,dry,due,dull,ellipsoid,elliptic,end,erect,expansion,exserted,exsertion,filament,free,fruiting,glabrous,globose,golden,golden-puberulent,golden-pubescent,green,greyish-brown,inflorescence,later,lateral,leaf,less,like,live,lobe,lobed,long,main,major,margin,medial,middle,midrib,minor,minute,minutely,mm,near,nearly,node,obovate,occasionally,older,once-furcate,onto,opposite,orbicular,ovary,ovoid-reniform,pair,paler,papillose,pedicel,petiole,pitted,planar,plant,pore,poricidal,portion,presence,prominent,purplish,rather,ridge,ripe,shape,simple,single,size,slender,slightly,slow,small,specimen,stem,stigma,stout,straight,stripe,strongly,style,surface,swollen,tapering,tear-drop,terminal,thickened,time,tinged,tip,tree,trichome,tube,uniseriate,vein,white,widest,winged,woody,x,yellowish,young	0.3-1,0.75-1,apparent,ba,beginning,closely,deltoid,difoliate,eaf,edged,edicel,eed,entire,even,geminat,immature,inflorescenc,lon,lower,markedly,nflorescence,one,overlapping,pale,papillo,puberulent,rest,rounded,ruit,scar,shaepd,smoot,spaced,tall,tub,ud,unit,ympodial	appearance,arrangement,border,branch,characteristic,colour,corrugation,diameter,drying,exertion,form,fruit,giving,glabrousnes,growth,height,history,interjected,leaflet,length,life,lobing,midpoint,new,number,peduncle,per,prickle,primary,pseudostipule,ray,seed,shaped,smooth,specified,texture,thicknes,type,variation,width
511	wfo-0001032167	success	163	174	127	36	47	0.779	.5,0.5-1,0.5-1.5,0.5-2.5,0.75-3,1,1-2,1-2-celled,1-2.5,1-3,1-5,1-7,1.5,10-20,10-35,12-20,2-4,2-7,3-6,3-7,4-6,5-15,7-10,abaxially,absent,acute,adaxially,anther,apex,appressed,axe,base,berry,brown,calyx,cell,ciliate,closely,cm,connected,cordate,curved,decurrent,dehiscing,dense,densely,diameter,dm,drying,elliptic,elliptic-ovoid,entire,explosively,few-,filament,flattened,flower,forming,fruit,geniculate,glabrous,globose,growth,hair,held,herb,immature,larger,linear-lanceolate,lobe,long,longer,lowermost,many-branched,margin,maturing,mesocarp,mm,moderately,near,nearly,netlike,new,notch,oblong,obtuse,often,one-celled,pedicel,peduncle,per,petiole,placenta,pressure,projection,pubescent,purple,rachi,raised,rounded,seed,semitransparent,shorter,slightly,small,smaller,sometimes,sparsely,staman,stamen,stigma,straight,style,surface,triangular,tube,twisted,two-celled,unbranched,upper,vein,wall,watery,white,woody,x,yellow	2-foliate,4-10,abundant,adaxiall,along,blade,chartaceous,common,denser,eaf,eed,emarginat,flat,frui,geminat,growt,interpetalar,lower,lying,maturit,membranaceous,nfloresence,older,orolla,pubescen,rotate,ruit,tal,tamen,tem,tissue,unit,usually,vary,wid,ympodial	appearance,arrangement,bark,border,branch,bud,characteristic,colour,corolla,corrugation,distal,emarginate,exertion,form,fruiting,giving,glabrousnes,height,history,inflorescence,interjected,lateral,leaf,leaflet,length,life,lobing,maturity,midpoint,null,number,ovary,plant,prickle,primary,pseudostipule,ray,shape,size,stem,terminal,texture,thicknes,type,variation,wide,width
512	wfo-0001032176	success	177	188	145	32	43	0.819	.5,0,0.42,0.5,0.5-0.7,0.5-0.75,0.5-1,0.8-1,0.8-6,1-1.2,1-10,1.5-1.6,1.5-2.5,1.5-6,1/2,100,2-3,2.5-10,3-15,3-3.5,3-4,5-6-celled,6,6-10,7,adaxially,along,anther,anthesi,apart,apex,apical,arising,attaining,attenuate,axil,axillary,base,beak,becoming,berry,branched,calyx,cell,cm,conical,containing,corolla,creeping,cucullate,densely,denser,diameter,drying,ellipsoid,elliptic,epidermal,equal,especially,exserted,filament,filiform,flower,free,fruiting,glabrous,globose,green,greenish,grey-brown,greyish,herb,lateral,leaf,leaflet,lengthening,like,lobe,lobed,long,long-papillose,lower,margin,minute,minutely,mm,nearly,nodding,obovate,obtuse,occasionally,onto,open,ovary,ovoid-reniform,pair,pale,pedicel,per,petiole,pinnate,pore,poricidal,portion,projection,pubescent,quadrate,rachi,reflexed,rest,rounded,scar,seed,separate,simple,single,sinuous,size,slightly,slit,somewhat,soon,spaced,sparsely,stem,stigma,strait,strongly,style,terminal,thickening,time,tip,trichome,truncate,tube,ultimate,unevenly,uniseriate,vein,wall,white,winged,without,x	3-7,adhering,basal,capitat,cateniform,copiously,eaf,edicel,eed,fallen,hangin,inflorescenc,lengt,log,nflorescence,node,often,papillose,petiolule,rooting,ruit,smaller,tem,tightly,tree,trunk,tub,ud,unifoliat,unit,whit,ympodial	appearance,arrangement,bark,border,branch,bud,capitate,cateniforme,characteristic,colour,corrugation,distal,exertion,form,fruit,giving,glabrousnes,growth,hanging,height,history,inflorescence,interjected,length,life,lobing,midpoint,new,null,number,peduncle,plant,prickle,primary,pseudostipule,ray,shape,surface,texture,thicknes,type,variation,width
513	wfo-0001032187	success	139	155	87	52	68	0.626	-11,-2.1,-4.2,-5,-9,0.5,100,22,9,acuminate,acute,angular,anther,apex,appressed,base,berry,branch,brown,brownish,changing,cm,consisting,corolla,cyme,dark,dull,eglandular,elliptic,entire,equal,erect,filament,flowered,forked,glabrescent,globose,green,hair,herb,hooked,leaf,light,lobe,long,many,margin,marked,mature,mm,numerous,obovate,occasionally,ovate,pedicel,peduncle,pentagonal,per,petiole,plant,predominantly,protruding,purple,rarely,ridge,running,simple,small,sometimes,sparse,spreading,stage,stem,straight,style,sub-glabrous,texture,tinged,tooth,truncate,well,widest,wing,yellow,yellowish,Â±,Ã	-4,0.1â1.4,0.5-,0.5â1,0.6â1.3,1.1â3.2,1.3â1.8,1.6â2.1,1.8â2,1.8â2.8,1â1.7,24.6â26.3,2â9,3.1â3.5,3â3.2,3â4,5-merous,5â7,7â11,adherent,alyx,ape,aromatic,blade,broadly,di-foliate,dia,eaf,eed,fully,geminat,granule,hite,hydrated,lower,nflorescence,penden,perfec,persistent,petiolate,pollen,presen,ruit,sclerotic,short,soft,stellate,triangular,unit,ympodial,Â±1,Âµm	-1.1-3.2,0.1-1.4,0.5-1,0.6-1.3,1-1.7,1.3-1.8,1.6-2.1,1.8-2,1.8-2.8,2-9,3-4,3.1-3.5,5-7,7-11,appearance,arrangement,bark,border,bud,calyx,characteristic,colour,corrugation,diameter,difoliate,distal,drying,exertion,form,fruit,fruiting,geminate,giving,glabrousnes,growth,height,history,inflorescence,interjected,lateral,leaflet,length,life,lobing,mentioned,midpoint,new,null,number,ovary,pendent,prickle,primary,pseudostipule,ray,seed,shape,size,stigma,surface,terminal,thicknes,tube,type,variation,vein,white,width
514	wfo-0001032206	success	216	231	160	56	71	0.741	-0.8,-2,-20,.2,.5,0,0.2,0.2â0.5,1,1.5â2,1/3,1/6,1â2,1â3,3â4,4â6,5â15,5â20,6â8,8â20,abaxially,acute,adaxially,anther,apar,apart,apex,apically,apparently,approximately,armed,articulated,bark,base,berry,blade,bluntly,branched,broad-deltate,brow,calyx,chartaceous,clearly,cm,concolorous,cream,cuneate,curved,dark,deltate,diameter,discolorous,distal,distance,drying,eaf,elliptic,equal,erect,extending,filament,flattened,flattened-reniform,flower,foliaceous,free,fruit,fruiting,gently,glabrescent,glabrous,green,green-brown,infructescence,lateral,leaf,length,lobe,lobed,lobing,long,long-styled,longer,margin,marking,maturity,mauve,midpoint,midvein,mm,moderately,obtuse,often,older,one,open,orange-brown,ovate,pair,pale,pedicel,peduncle,pendent,pendulous,per,pericarp,petiole,plant,plurifoliat,poricidal,porrect,portion,prickle,primary,purple,rarely,ray,scar,secondary,sessile,short-styled,shrub,side,slender,smooth,sometimes,spaced,spherical,spreading,stalk,stalked,stellate,stellate-pubescent,stem,stout,straight,style,surface,tapering,tertiary,time,tip,toward,trichome,truncate,tube,unarmed,unit,usually,variously,vein,venation,visible,weakly,white,wide,woody,yellow,yellow-orange,young	-5,..,0.2â0.4,0.5â1,0.8â1.2,00â200,0â20,0â30,0â5,1.1â1.2,1.2â2.2,1.5â2.5,1/4â1/2,1/4â1/3,10â80,11â22,1â2.3,1â4,2.5â3.3,2.7â3.5,2â2.5,2â3,2â8,3.5â9,30â80,4.5â5.8,5-merous,5â6,5â8,5â9,6â10,6â15,7â10,accrescent,alyx,andromonoecious,connivent,covering,eed,functionally,hermaphroditic,heterostylous,lengt,lowermost,mal,mature,nflorescence,orolla,ower,reflexed,sparsely,tamen,uit,ung,vary,ympodial	--,0.5â1.5,0.8,00,1.1,1.2,1.5,1/2,1/4,10,11,15,2,2.2,2.3,2.5,2.7,20,200,22,3,3.3,3.5,30,4,4.5,5,5.8,6,7,8,80,9,appearance,arrangement,border,branch,brown,bud,characteristic,colour,corolla,corrugation,description,exertion,form,giving,glabrousnes,growth,height,history,inflorescence,interjected,leaflet,life,mentioned,new,number,ovary,pseudostipule,seed,shape,size,stigma,sympodial,terminal,texture,thicknes,type,variation,width
515	wfo-0001032209	success	257	232	196	61	36	0.763	-11,-20,-30+,.5,0.5,0.5-1,1,1-1.5,1-2,1-2-celled,1-6,1.5,1.5-,1.5-2,1.5-2.5,1.5-6,10-13,100,12-16,2,2-3,2-3-lobed,2-5,2.5-,2/3,20-30,3-7,3-9,4,4-20,5-8,6-15,6-8,absent,acute,adaxial,along,anther,anthesi,apex,apiculae,apparently,appearing,arching,articulated,axi,basal,base,berry,bilobed,blue,branch,branched,broadly,brown,calyx,canopy,capitate,cell,chartaceous,climbing,cm,colour,conical,conspicuously,cordate,coriaceous,corolla,dark,deltate,dendritic,densely,diameter,distally,early,ecuador,ellipsoid,elliptic,enlarged,entire,equal,especially,evenly,exerted,filament,finely,flattened-reniform,flower,fruiting,giving,glabrous,globose,groove,growth,hairy,hastate,hollow,inflorescence,lamina,large,lateral,leaf,leaving,length,like,lobe,lobed,long,longer,longest,lower,margin,markedly,mean,mere,metallic,middle,midrib,minute,minutely,mixture,mm,narrowly,near,nearly,new,nipple,occasionally,often,older,one,ovate,pair,papillae,papillate,pedicel,peduncle,peg,pentagonal,per,petiole,pinnately,pinnatifid,planar,pointed,primary,puberulent,pubescence,pubescent,purple,red,reddish,rest,rim,ripe,sagittate,several,shiny,simple,sleeve,small,sometimes,somewhat,sparser,spreading,stem,stigma,stout,style,surface,tapering,terminal,testa,testal,third,time,tiny,trichome,truncate,tube,twining,unequal,uniseriate,upper,usually,variable,vein,vine,violet,w,wall,white,widest,within,woody,x	0.3,5-merou,ag,alyx,apart,ark,berr,bu,cast,connivent,cucullat,deeply,denser,distinct,dried,eaf,eed,erect,fleshy,flowering,free,geminat,glabrescen,hanging,held,ilament,keeled,leathery,lengthening,less,material,midvein,nflorescence,orolla,papillat,part,particularly,perfect,pericarp,plurifoliate,pore,poricidal,portion,probably,rhachi,ruit,scar,slit,spaced,stellate,tem,thin,tightly,tip,twinin,ud,unit,vary,weight,yellow,ympodial	appearance,arrangement,bark,border,bud,characteristic,corrugation,distal,drying,exertion,form,fruit,glabrescent,glabrousnes,height,history,interjected,leaflet,life,lobing,midpoint,number,ovary,plant,prickle,provided,pseudostipule,ray,seed,shape,size,texture,thicknes,type,variation,width
516	wfo-0001032232	success	137	155	114	23	41	0.832	.5,0.1,0.25,0.5,0.5-1,0.6-3,0.8-1,1-3,1.8-2,18.8-27.5,2,2-2.6,20-100-flowered,3/4,4.8-7.3,5-6,?,abruptly,age,anther,anthesi,apex,attenuate,bark,base,becoming,berry,calyx,clavate,cm,corolla,cup-shaped,dark-papillose,decurrent,deflexed,dia,distally,elliptic,erect,erose,filament,filiform,flower,free,fruiting,glabrous,globose,green,greenish-brown,immature,irregular,lateral,leaf,lenticellate,less,light,lightly,lobe,lobed,long,long-acuminate,margin,middle,midrib,minutely,mm,narrowly,node,occasionally,onto,opposite,ovary,ovoid-reniform,pale,paler,papillose,pedicel,petiole,pitted,pore,poricidal,portion,prominent,raised,reflexed,revolute,rounded,shaped,short-styled,shrub,simple,slightly,somewhat,sparsely,stem,stigma,straight,style,subshrub,surface,tall,tear-drop,tip,translucent,tube,umbonate,undulate,vein,way,wide,widening,widest,winged,woody	ba,closely,eaf,edicel,eed,evenly,exfoliatin,lower,main,minute,nflorescence,overlappin,packed,pair,papillo,ruit,scar,ti,tub,ud,unifoliat,unit,ympodial	appearance,arrangement,border,bud,characteristic,colour,corrugation,diameter,distal,drying,exertion,exfoliating,form,fruit,giving,growth,history,inflorescence,interjected,leaflet,length,life,lobing,midpoint,null,number,peduncle,per,prickle,primary,pseudostipule,ray,seed,shape,size,terminal,texture,thicknes,type,variation,width
517	wfo-0001032233	success	160	157	102	58	55	0.637	0-2,0.3-2,1-1.5,1-2,1.5-2.5,10-15,157,2-15,2-3,2-4,2-5.5,2-6,2.5-4,20-100+,25-40,3-4,3-5,3.5-4,4-18,4-5,4-7,5-16,5-6,6-25,8-12,abaxially,acuminate,acute,adaxially,almost,apex,basal,base,beyond,branched,calyx,cm,connivent,convex,cordate,cylindrical,dark,densely,diameter,dilated,distally,ellipsoidal,entire,especially,exserted,flattened,fleischmann,fleshy,flower,fruit,glabrate,glabrescent,glabrous,glandular-puberulent,globose,green,lobe,long,longitudinal,margin,mm,moderately,narrowly,oblong,obtuse,orange,ovate,ovoid,pedicel,peduncle,perfect,petiole,puberulent,pubescent,purple,radiu,shallowly,small,sparsely,stamen,stigma,stripe,style,subpeltiform,time,tip,toward,tree,triangular,truncate,tube,unbranched,vein,wide,x,yellow,yellow-green	1-3,3-15,3-4.5,4-foliat,absen,absent,adaxial,aggregate,apart,ape,articulated,axe,bent,biglandula,blade,brow,cell,chartaceous,connective,coriaceous,directed,eaf,eed,equal,exceeding,laterally,leaving,lon,lower,nflorescence,nther,orolla,pedicellar,pore,present,projection,puberulen,rachise,remnant,ruit,shorter,simple,slightly,somewhat,spaced,stellate,stone,subcoriaceous,tal,tem,thecae,tomento,ud,unit,vary,white,yellow-orange,ympodial	anther,appearance,arrangement,bark,biglandular,border,branch,bud,characteristic,colour,corolla,corrugation,distal,drying,exertion,filament,form,fruiting,giving,glabrousnes,growth,height,history,inflorescence,interjected,lateral,leaf,leaflet,length,life,lobing,mentioned,midpoint,new,number,ovary,per,plant,prickle,primary,pseudostipule,ray,seed,shape,size,stem,surface,tall,terminal,texture,thicknes,tomentose,type,variation,width
518	wfo-0001032259	success	202	211	171	31	40	0.847	-4,.5,/3,/4,0,0-10,0-20,0-4,0.1-0.2,0.15-0.3,0.45-0.6,0.5-0.8,0.5-1.5,0.7-1.1,0.8-1.3,0.9-1.2,1-1.8,1-2,1-2.5,1.5-4.5,1/2,1/3,1/4-1/3,10-30,15-40,2-2.5,2-5,2.2-3,20-60,3-4,4,4-5,4-6,5,5-30,5.5-8,7-16,7-8,9-22,abaxial,acute,adaxial,almost,anther,apart,apex,apically,apparently,bark,base,becoming,berry,blade,branched,broad-deltate,brown,brownish,calyx,chartaceous,cm,conical,connivent,cordate,cuneate,dark,deltate,densely,diameter,difoliate,discolorous,distance,drying,dull,elongating,equal,erect,evenly,extending,filament,flattened,flattened-reniform,flower,free,fruit,fruiting,fully,geminate,glabrescent,glabrous,gland,green,hair,infructescence,lateral,leaf,length,lobe,lobed,long,longer,lower,margin,mature,maturity,mauve,midpoint,midvein,minute,mm,older,one,open,opening,orange,orange-brown,ovate,pair,pedicel,peduncle,pendulous,per,pericarp,petiole,poricidal,porrect,portion,prickle,prickly,primary,pubescent,ray,recurved,red,reduced,rounded,sessile,shrub,side,simple,slender,smooth,sometimes,spaced,sparsely,spherical,spreading,stellate,stellate-pubescent,stem,straight,strongly,style,surface,tapering,terete,terminal,time,tip,toward,trichome,tube,unarmed,unit,vein,way,white,wide,woody,yellow,yellow-green,young	0-2,0-5,0.1-0.3,1/6-1/5,2-4,3/,4-9,5-merous,abaxially,acut,alyx,apar,articulated,eaf,eed,green-brow,moderately,nflorescence,orolla,oung,perfec,prickl,ruit,scar,shorter,tamen,tertiary,vary,venation,visible,ympodial	3/4,appearance,arrangement,border,branch,bud,characteristic,colour,corolla,corrugation,distal,exertion,form,giving,glabrousnes,green-brown,growth,height,history,inflorescence,interjected,leaflet,life,lobing,new,null,number,ovary,plant,pseudostipule,seed,shape,size,stigma,sympodial,texture,thicknes,type,variation,width
519	wfo-0001032260	exception_thrown	216	0	0	216	0	0.0		-0.5,-1.5,-10,-3,-8,.1,/5,0-,0-0.5,0-10,0-20,0-5,0-8,0.1,0.1-0.3,0.1-0.4,0.15-0.3,0.2,0.2-0.5,0.4,0.5-0.8,0.5-2,0.5-5,0.6-0.8,0.7,0.7-1.5,0.8-1.1,1-1.7,1-3,1-5,1-6,1.2-1.7,1.5-4,1/2,1/3,1/3-1/2,1/3-1/5,10-30,2,2-20,2-4,2-5,2.5,2.5-3,2.5-3.5,3-10,3-5,3-8,3-9,4-,5-,5-20,5-merous,6-10,6-8,7-15,abaxial,abaxially,acuminat,acuminate,acute,adaxial,alyx,anther,apar,apart,apex,apically,apparently,articulated,bark,base,berry,blade,branched,broad-deltate,calyx,cell,chartaceous,cm,connivent,cuneate,curved,deltate,densely,diameter,difoliate,discolorous,distance,drying,dull,eaf,eed,elliptic,elongating,equal,erect,extending,eye,filament,flattened,flattened-reniform,flower,free,fruit,fruiting,geminat,glabrescent,glabrou,glabrous,gland,glaucous,globular,gray-brow,green-brown,infructescence,lateral,leaf,length,lobe,lobed,lon,long,long-styled,longer,lower,margin,mature,maturity,mauve,midpoint,midvein,mm,moderately,naked,narrow-ovate,nflorescence,older,one,open,orange-brown,orolla,oung,outline,ovate,pair,pale,pedicel,peduncle,pendulous,per,perfec,pericarp,petiole,pit,poricidal,porrect,portion,prickl,prickle,prickly,primary,pubescent,purple,raised,ray,red,reduced,reflexed,rounded,ruit,scandent,scar,sessile,shallowly,shorter,shrub,side,simple,slender,small,smooth,spaced,sparsely,spherical,spreading,stalk,stalked,stellate,stellate-pubescent,stem,strongly,style,subentire,surface,tamen,tapering,terete,terminal,tertiary,time,tip,trichome,tube,unit,variously,vary,vein,venation,visible,way,wide,woody,yellow,yellow-green,ympodial	
520	wfo-0001032264	success	183	201	157	26	44	0.858	.2,.5,0.25-0.5,0.25-0.75,0.5-1,0.6-2.2,0.8-10,0.8-4,1-1.5,1.2-2,1.5-1.8,1.8-3,10-22,2-50-flowered,2-6,3,3-15,3-9,4.5-5,5-9,6-17,acuminate,acute,along,anther,anthesi,apex,apiculate,appearing,bark,base,berry,branched,broadly,bud,bullate,calyx,cell,cell-layer,cm,corolla,cup-like,curling,deciduous,densely,dia,difoliate,dry,elliptic,epidermal,exserted,filament,flattened-reniform,flower,free,fruiting,glabrous,globose,gnarled,green,habitat,hair,inflorescence,lamina,large,larger,lateral,layer,leaf,like,live,lobe,lobed,long,main,major,margin,material,middle,minor,minute,minutely,mm,multiseriate,narrowly,nearly,occasionally,older,one,opposite,ovary,ovoid,pair,pale,papillose,parallel,pedicel,peeling,petiole,pitted,planar,plant,pointed,pore,poricidal,portion,primarily,prominent,pubescent,quite,raised,red-papillose,reddish,reddish-tan,revolute,rounded-deltoid,scattered,several,shaped,sheet,sheltered,short,shrub,simple,size,slender,small-capitate,small-celled,somewhat,soon,sparsely,stem,stigma,style,surface,tall,tapering,tear-drop,thick,time,tip,transversely,tree,trichome,trunk,tube,uniseriate,unit,vein,weak,white,whitish,wide,widest,x,yellowish-brown,young	apar,ba,closely,deflexed,differing,eaf,edicel,eed,fleshy,geminat,greyi,incrassate,lon,lower,nflorescence,often,overlapping,papillo,ruit,scar,spaced,straight,ud,upper,woody,ympodial	appearance,arrangement,border,branch,characteristic,colour,corrugation,diameter,distal,drying,exertion,form,fruit,geminate,giving,glabrousnes,greyish,growth,height,history,interjected,leaflet,length,life,lobing,midpoint,new,null,number,peduncle,per,prickle,primary,pseudostipule,ray,seed,shape,sympodial,terminal,texture,thicknes,type,variation,width
521	wfo-0001032274	success	192	176	138	54	38	0.719	0,0.15-0.2,0.5,0.5-0.7,0.5-1,0.5-1.5,0.7-1.8,0.9-1,1-1.2,1-1.5,1-3,1.5-2,2,2-3.5,2-7,3-10,3-4,3-5,3-6,3/4,5-7,<,acuminate,acute,anther,anthesi,apex,apiculate,appearance,arching,axillary,basal,base,berry,branch,brown,calyx,capitate,cell,clustered,cm,conical,connivent,corolla,deltate,dendritic,densely,diameter,distal,ellipsoid,elliptic,entire,exserted,filament,filiform,flattened-reniform,flower,free,fruiting,glabrous,globose,green,grey,growth,highly,inflorescence,lanceolate,lax,leaf,less,lobe,lobed,long,loosely,margin,minute,minutely,mm,new,obtusely,occasionally,often,once-branched,one,pair,pale,pedicel,peduncle,per,petiole,pitted,portion,primary,puberulent,pubescent,purple,quadrate,red,reddish,reflexed,ridge,ridged,ripe,rounded,shape,shiny,shoot,short,shrub,simple,size,sometimes,sparsely,square,stem,stigma,strongly,style,surface,terminal,testal,tinged,tip,trichome,truncate,tube,two,uniseriate,usually,variable,vein,violet,visible,way,white,woody,x,yellow	.5,5-merou,ag,alyx,apparently,ark,articulated,ba,borne,eaf,eed,fleshy,geminat,glabrou,group,ilament,irregular,lengthening,like,lower,markedly,membranous,nflorescence,nodding,non-reproductive,older,orolla,papillo,peg,pendan,perfect,pericarp,platfor,platform,plurifoliate,pore,poricidal,reproductive,ruit,scar,sleeve,slit,small,somewhat,stellate,suckering,tem,thin,twinin,ud,unit,upper,vary,ympodial	arrangement,bark,border,bud,characteristic,colour,corrugation,drying,exertion,form,fruit,giving,glabrousnes,height,history,interjected,lateral,leaflet,length,life,lobing,mentioned,midpoint,number,ovary,paler,papillose,pendant,plant,prickle,pseudostipule,ray,seed,texture,thicknes,type,variation,width
522	wfo-0001032276	success	152	157	111	41	46	0.73	-,.25,0.3-1,0.5-0.75,0.5-1,0.8-1,1,1-1.5,1-2,1.8-2,2-2.5,2.5-4,3-3.5,3-6-flowered,5-7,7-8,9-18,acute,along,anther,anthesi,apex,attenuate,bark,base,beneath,broadly,brown,calyx,cm,converging,corolla,cup-shaped,curly-tipped,dark,decurrent,densely,dia,dry,ellipsoid,elliptic,exserted,filament,filiform,fruiting,glabrous,globose,green,lamina,later,lateral,leaf,lobe,lobed,long,long-pubescent,main,margin,material,minute,minutely,mm,narrowly,nearly,obovoid,occasionally,older,onto,opposite,ovary,ovoid-reniform,pair,pale,pedicel,perhaps,petiole,pitted,plant,pore,poricidal,prominent,pubescent,raised,reflexed,remaining,shaped,short,shrub,simple,slender,soon,sparsely,stem,stigma,straw-colored,strongly,style,surface,tall,tapering,tear-drop,tip,trichome,tube,uniseriate,vein,white,winged,x,yellow,young	.5,0.25-1.5,apart,ba,blade,capitat,deflexed,deltoid,eaf,edicel,eed,evenly,except,free,geminate,greyish-gree,like,lower,middle,nflorescence,node,non-reproductive,papillose,portion,raise,rest,ruit,scar,slightly,somewhat,spaced,straight,triangular,tub,ud,unifoliate,unit,widely,widest,woody,ympodial	appearance,arrangement,border,branch,bud,capitate,characteristic,colour,corrugation,diameter,distal,drying,exertion,form,fruit,giving,glabrousnes,greyish-green,growth,height,history,inflorescence,interjected,leaflet,length,life,lobing,mentioned,midpoint,new,number,peduncle,per,prickle,primary,pseudostipule,ray,seed,shape,size,terminal,texture,thicknes,type,variation,width
523	wfo-0001032277	exception_thrown	163	0	0	163	0	0.0		.5,0.1-0.5,0.2-0.6,0.75-1,0.8-3,1-1.1,1-1.2,1-1.5,1-2,1-5,1.5-1.8,1/2,10-14,2-2.5,2-4,2-6-flowered,3-3.5,3-9,5-6,8-9,acute,along,anther,anthesi,apex,apiculate,appear,appearing,area,auriculate,ba,bark,base,beneath,berry,blade,blunt,branched,bright,calyx,closely,cm,coriaceous,corolla,cup-shaped,deltoid,densely,dia,drooping,dry,eaf,edicel,eed,ellipsoid,elliptic,erect,exserted,filament,flattened-reniform,free,fruit,fruiting,geminat,glabrous,globose,gre,green,immature,impressed,incrassate,indentation,inflorescence,internodal,lateral,lax,leaf,like,lobe,lobed,long,lower,main,margin,mature,middle,minutely,mm,nflorescence,number,obscured,occasionally,older,opposite,ovary,overlapping,pair,pale,paler,papillae,papillose,partially,pedicel,petiole,pitted,pore,poricidal,portion,prominent,puberulent,pubescenc,pubescent,raised,reddish,remaining,rest,revolute,ripe,round,rounded,ruit,scar,shrub,simple,slende,slender,small,spaced,sparsely,specimen,spicy-fragrant,stem,stigma,straight,strict,strongly,styl,style,surface,tall,tapering,tip,translucent,trichome,truncate,trunk,tub,tube,two,ud,uniseriate,unit,varying,vein,virgately,way,white,widest,woody,x,yellow,yellowish-tan,ympodial,young	
524	wfo-0001032304	success	249	195	158	91	37	0.635	-3,.9-1.4,0-120,0.2-0.3,0.5-4.5,1.1-2,1.2-2.3,1.3-2.1,1.6-1.9,10,18,2-5,2.5-19.5,2/3-3/4,3-10,3-15,3-20,3-6,3.2-3.8,4-7.5,7-27,9-13,abaxially,acuminate,acute,adaxially,along,anther,anthesi,apex,ascending,axe,bark,base,becoming,berry,blackish,blunt-tipped,branch,branched,broadly,brown,brownish,bud,calyx,campanulate,chartaceous,cm,conical,continued,corolla,dark,deltoid,dendritic-echinoid,densely,diameter,distal,due,echinoid,elliptic,entire,especially,exserted,few-,filament,fleshy,flower,fruit,fruiting,glabrescent,glabrous,granular-tomentose,green,greenish,growth,hair,high,honeycombed,lateral,leaf,least,length,lobe,long,long-,long-attenuate,long-stalked,main,many-rayed,margin,midvein,mixed,mm,mostly,multangulate,oblong,obtuse,occasionally,older,orbicular,ovate,overlapping,pale,partly,pedicel,peduncle,petiole,plant,porrect-stellate,probably,pseudo-terminal,pubescent,rather,ray,relatively,reniform,reticulate-punctate,ripe,scabridulous,seed,sessile,short,short-,shrub,side,simple,small,sparingly,spreading,stem,stigma,strongly,style,subglobose,suborbicular,terete,thick-stalked,thin,thin-,thin-stalked,time,tomentose,touching,tree,tube,unarmed,usually,vein,velutinous,violet,way,white,whitish,wide,x,yellow,yellowish,young	.6-1.2,/20,0.3-1.5,0.5-3,0.9-1.3,1,1-3.5,1.2-3,1.5-3.2,1.8-4,1/2,1/3-1/2,1/5,1/8,2-4,2-4.2,21,3-4.5,3.2-5.5,44,5-6,5.5-9,7.5-12,accrescent,ag,apart,apical-lateral,apparently,appressed-tomentose,articulated,axillary,ba,blade,capitat,closely,decurrent,dehiscing,dendritic,dendritic-echinoi,directed,eaf,echinoi,extend,few-rayed,free,glabrescen,inserted,introrse,juvenile,large,lobed,longitudinal,lower,m.,many,multangulat,nflorescence,obscured,often,opaque,orolla,ovat,ovate-lanceolate,perfect,plurifoliate,pore,present,rachi,rarely,rotate-stellate,ruit,runk,short-stalked,slit,somewhat,spaced,stamen,stellate-tomentose,sulcate,suture,tamen,testa,thick,tomentu,toward,triangular-ovate,unarme,unit,vary,within,ympodial	appearance,arrangement,border,capitate,characteristic,colour,corrugation,drying,exertion,form,giving,glabrousnes,height,history,inflorescence,interjected,leaflet,life,lobing,mentioned,midpoint,new,number,ovary,per,prickle,primary,pseudostipule,shape,size,surface,terminal,texture,thicknes,type,variation,width
525	wfo-0001032307	exception_thrown	153	0	0	153	0	0.0		.5,/3,0.2-0.5,0.4-1.3,1-1.5,1-2,1.5-2,1.5-5,10-20,2-5,2.5-12,2.5-3,2.5-3.5,3.5-4,30,4-8,5-12,5-25-flowered,7-18,?,abaxial,acute,adaxial,along,anther,anthesi,apar,apex,bark,base,berry,blade,body,branch,branched,brow,calyx,campanulate,capitate,christmas-tree-like,cm,congested,corolla,dark,deltate,dendritic,densely,dia,eaf,edicel,eed,either,ellipsoid,elliptic,elongate,erect,exserted,filament,flat,flattened-reniform,fleshy,free,fruiting,glabrate,glabrous,globose,green,growth,immature,incrassate,inflorescenc,inflorescence,later,lateral,leaf,like,lobe,lobed,lon,long,loose,lower,main,many,margin,middle,minute,minutely,mm,new,nflorescence,older,ovary,pair,pale,papillae,papillo,pedicel,petal,petiole,pitted,planar,plant,plurifoliat,pore,poricidal,portion,prominent,pubescent,reddish,reddish-brown,rest,ruit,scar,shaped,shrub,small,spaced,sparsely,stem,stigma,stout,strongly,style,surface,tall,tan,tear-drop,terminal,thick,thickened,time,tip,tree,tree-like,trichome,truncate,tub,tube,type,ud,unevenly,upper,variable,vein,way,white,wide,widest,within,woody,ympodia,young	
526	wfo-0001032308	success	190	179	137	53	42	0.721	0.2-2.1,0.3-5,0.7-1,0.7-1.2,1-10,1-2,1.5-2.5,1.8-2.5,1.9-3,12-16,2,2-3,2-4,2-6,3-10,3-6,3.8-5,4-7,4-8,4.8-7.7,5-7,6,6-11,8-9,abaxially,absent,acumen,acute,adaxially,anther,apart,apex,apparently,articulated,axe,axillary,base,berry,broadly,brownish,bud,cell,chartaceous,ciliate,clavate,cm,condition,cordate,corolla,covering,deep,diameter,distal,dot,drying,elliptic,especially,exceeding,filament,flower,forked,fresh,fruit,generally,glabrous,globose,green,greenish,hair,hair-like,half,interjected,invested,irregular,lanceolate,lateral,leaflet,leave,like,lobe,long,make,margin,medium,membranous,minute,mm,mucilaginous,narrowly,nflorescence,non-glandular,obtuse,odd-pinnate,often,ovate,ovoid,pedicel,peduncle,perfect,petiole,petiolule,plant,plurifoliate,pubescent,pure,ripe,rounded,scattered,seed,sessile,shape,short,slightly,spaced,stamen,stem,stigma,straight,style,subtending,sympodial,terminal,testal,thick,tip,tri-,trichome,tube,typically,unit,usually,wall,wet,white,whitish,wide,x	0-3,5-merou,ag,along,alyx,blade,capitat,connivent,cuneate,digestion,dorsally,eaf,edge,eed,enzyme,flat,folded,geminat,glabrou,greatly,green-white,hal,homostylous,honeycomb-shaped,larger,lengthening,living,lobed,lower,midrib,minutely,much,orbicular,orolla,pair,pentagonal,petiolulate,pore,poricidal,puberulent,removed,ruit,seudostipule,slit,specimen,ste,substellate,tamen,throughout,truncate,vary,varying,yellow	appearance,arrangement,bark,border,branch,calyx,capitate,characteristic,colour,corrugation,exertion,form,fruiting,geminate,giving,glabrousnes,growth,height,history,inflorescence,leaf,length,life,lobing,mentioned,midpoint,new,number,ovary,per,prickle,primary,pseudostipule,ray,size,surface,texture,thicknes,type,variation,vein,width
527	wfo-0001032335	success	215	217	172	43	45	0.8	.2,.5,0,0.2â0.3,0.4,0.5â1,0.9â1,1.5â2,100,100+,12â15,15,16,1â1.2,1â1.5,1â3,2.5â3,2â10,2â2.5,2â5,4â14,4â5,4â6-rayed,5â6,6â19,6â6.5,7â10,>,abaxial,abaxially,acuminate,acute,adaxial,along,anther,anthesi,apex,appearing,articulated,attenuate,axe,base,beneath,berry,branched,branching,bright,c.,calyx,capitate,cell,chartaceous,cm,connivent,corolla,covered,cup-shaped,deltate,densely,diameter,discolorous,drying,ellipsoidal,elliptic,elongate,entire,equal,evenly,exserted,filament,flattened-reniform,flower,free,fruiting,glabrous,globose,gold,golden-yellow,gradually,growth,impressed,inflorescence,length,lengthening,like,lobe,lobed,long,loosely,lower,many,margin,markedly,membranous,midpoint,minute,minutely,mm,moderately,multangulate,narrowing,narrowly,new,nodding,older,onto,orange,pair,pale,pedicel,peduncle,peltate,per,perfect,pericarp,persistent,petiole,pitted,plane,plurifoliate,pore,poricidal,porrect,porrect-stellate,portion,primary,pubescence,pubescent,ray,reddish,reflexed,ripe,scurfy,sessile,shiny,short-stalked,shrub,silvery,simple,slightly,slit,small,somewhat,sparsely,square,stellate,stem,stigma,stout,strongly,style,surface,terminal,testal,thin,time,tip,tree,trichome,tube,unevenly,unit,upper,varying,vein,way,white,wide,woody,yellow,â4,âstellate	'',0.05,0.2,0.5,10â12,3361,5-merou,ag,alyx,apar,ark,boh,center,closely,dichasia,eaf,eed,erec,fide,fused,golden-brow,half,ilament,lamina,less,near,nflorescence,orolla,papillo,part,regularly,ruit,scar,short,sometimes,spaced,stub,tal,tem,ud,vary,visible,ympodial	5-merous,age,appearance,arrangement,bark,border,branch,bud,characteristic,colour,corrugation,dichasial,distal,erect,exertion,form,fruit,giving,glabrousnes,golden-brown,height,history,interjected,lateral,leaf,leaflet,life,lobing,null,number,ovary,papillose,plant,prickle,pseudostipule,seed,shape,size,sympodial,tall,texture,thicknes,type,variation,width
528	wfo-0001032337	success	225	177	135	90	42	0.6	0.4-1.5,0.5-3.5,1-10,1-2,1.2-2.8,1.4-2,1.5,1.6-4,2-14,2-3.5,2-7,2.3-11.5,2.3-4.8,3-8,3.6-5,4-17,4-6,4-9,4.5-14.5,5-11,8-10,8-17,9-21,9-29,abaxially,acumen,acuminate,acute,adaxially,anther,apart,apex,apiculate,attenuate,axillary,base,basiscopic,berry,blade,brownish,bud,canescent,cell,ciliate,clavate,cm,condition,corolla,covering,cuneate,darker,decurrent,deep,densely,diameter,distal,dot,drying,especially,filament,flower,forked,fresh,fruit,generally,glabrous,globose,green,greenish,hair,hair-like,half,herb,interjected,lanceolate,lateral,leaf,leaflet,light,like,lobe,long,make,margin,mm,mottled,mucilaginous,oblique,obtuse,odd-pinnate,often,ovoid,pedicel,peduncle,petiole,plant,plurifoliate,pubescent,purple,rarely,ray,ripe,rounded,scattered,seed,short,side,size,sometimes,sparsely,stem,stigma,style,subglabrous,subtending,terminal,testal,thick,tip,tissue,tri-,tube,typically,unit,unwinged,usually,violet,violet-purple,wall,wet,white,whitish,wide,wing,x	0,1,1-4,10,2,2-4,2-4.5,3-4,5-merou,ag,along,alyx,apparently,articulated,axe,borne,broadly,capitat,chartaceous,connivent,cordate,digestion,dorsally,eaf,edge,eed,elliptic,end,enzyme,erec,exceeding,except,flat,folded,frequently,geminat,glabrou,greatly,green-white,homostylous,honeycomb-shaped,lengthening,living,lower,membranous,middl,midrib,minutely,nflorescence,orbicular,orolla,ovate,pair,paired,pentagonal,perfect,petiolulate,petiolule,pore,poricidal,proximal,puberulent,reduced,removed,rotate,ruit,sessile,seudostipule,singly,slightly,slit,small,spaced,specimen,stamen,ste,stolo,straight,subequal,subsessile,tall,tamen,tem,tertiary,throughout,tuber,unpaired,vary,yellow,ympodial	appearance,arrangement,bark,border,branch,calyx,capitate,characteristic,colour,corrugation,erect,exertion,form,fruiting,geminate,giving,glabrousnes,growth,height,history,inflorescence,length,life,lobing,mentioned,midpoint,new,number,ovary,per,prickle,primary,pseudostipule,shape,surface,sympodial,texture,thicknes,type,variation,vein,width
529	wfo-0001032344	success	157	164	117	40	47	0.745	0.2-0.5,1-1.3,1-3,1-4,1.5-4.5,1.5-6,1.6-2.4,10-29,2-2.8,2-3,2.2-4,3-5,3-7,3-8.5,3-9,3.5-6.5,4-11,4-8,5-10,6-15,9.5-21,abaxially,absent,acumen,acuminate,acute,adaxially,apex,apical,apically,articulate,base,bluish,branched,broadly,calyx,cell,cm,connate,corolla,covering,cuneate,cyme,dark,dehiscent,diameter,dichasial,dichasially,distal,dorsally,dot,ebracteate,edge,elliptical,exceeding,filament,flower,forked,generally,globose,green,green-white,hair-like,half,herbaceous,inrolled,interjected,introrse,lateral,leaf,leaflet,lobe,long,long-attenuate,make,maturing,medium,mm,monochasial,mucilaginous,oblique,odd-pinnate,often,ovate,ovoid,pedicel,peduncle,perennial,perfect,petiole,plant,poricidally,proximal,puberulent,pubescent,purple,scarce,seed,short,size,slit,smooth,stamen,stigma,straight,style,terminal,testal,thick,throughout,tuber-bearing,violet,wall,white,wide,yellow,Â¼	2.8,3-6-foliat,abruptly,belo,decurrent,digestion,diminishing,eaf,eed,emoval,enzyme,globo,honeycomb,layeral,living,lon,lower,lunat,nflorescence,nther,orolla,pair,pattern,petiolule,plan,reveal,rotate,rotate-pentagonal,ruit,sessile,seudostipule,sometimes,specimen,tal,tem,toward,typically,unit,vary,ympodial	7,anther,appearance,arrangement,bark,border,branch,bud,characteristic,colour,corrugation,drying,exertion,form,fruit,fruiting,giving,glabrousnes,growth,height,history,inflorescence,length,life,lobing,margin,mentioned,midpoint,new,number,ovary,per,prickle,primary,pseudostipule,ray,shape,stem,surface,texture,thicknes,tube,type,variation,vein,wet,width
530	wfo-0001032354	success	171	169	120	51	49	0.702	0,0-5,0.3,0.8-1.2,1-10,1-2,10-lobed,2,2-2.5,2.5-3,25,250-400,29,3-4,38/2,5-10,acute,anther,apex,aster,axillary,base,becoming,berry,bilobed,branch,branched,broadly,brown,calyx,campanulate,capitate,cm,coarsely,colour,corolla,creating,cuneate,decurrent,deep,dia,discoidal,distal,effect,ellipsoid,except,exerted,filament,fleshy,fork,glabrous,glandular,globose,green,greenish-ivory,greyish,hair,halfway,lasting,leaf,lengthening,lobe,lobed,maturity,minute,minutely,mm,narrow,obovate,obovoid,occasionally,ovary,ovoid,pale,pedicel,peduncle,pinnatisect,pore,poricidal,puberulent,rh,rounded,rugose-reticulate,secondary,seedling,several,shape,shoot,shrub,simple,sinus,size,slightly,slit,small,soft,somewhat,sparse,spreading,stem,stigma,straight,strongly,style,surface,tall,tip,trichome,uniseriate,unit,variable,vein,violet,wide,wing,wooded,woody,x,year,young	0.5-1,0.8-1,1-3,1-5,4-6,40-75,5-15,acuminate,almost,angular,anthesi,aspect,axi,c.,cell,cut,deeply,eaf,eed,facetted,flower,general,gre,gree,lanceolat,large,linear,lower,midrib,nflorescence,oval,ovate,pair,pebble-shaped,pedicellate,plurifoliat,pubescent,rather,rotate,ruit,single,smaller,smel,stellate,stone,tub,ud,unpleasant,usually,within,ympodial	15,appearance,arrangement,bark,border,bud,characteristic,corrugation,diameter,drying,exertion,form,fruit,fruiting,giving,glabrousnes,grey,growth,height,history,inflorescence,interjected,lateral,leaflet,length,life,lobing,margin,mentioned,midpoint,new,number,per,petiole,plant,plurifoliate,prickle,primary,pseudostipule,ray,seed,sympodial,terminal,texture,thicknes,tube,type,variation,width
531	wfo-0001032358	success	216	191	156	60	35	0.722	.1,.2,.3,.4,.5,/2,0,0.2-4,0.5-3,0.7-1,1-2,1.3-1.7,1.5-2,1/4-1/2,12-20,13-20,15-40,2-3,2-4,2-5,2.2-7.5,3-10,3-4,3.5-13,4-4.5,4-7,4-8,4.5-5,abaxially,acute,adaxially,anther,anthesi,apex,appearing,armed,bark,basal,base,based,berry,branched,broad,brown,calyx,capitate,center,cm,cordate,corolla,cupuliform,curved,densely,diameter,difoliate,dorsal,drying,entire,equal,erect,expanding,exserted,filament,flattened,flower,fruit,fruiting,furcate,geminate,glabrescent,glabrous,globose,green,growth,heteromorphic,inflorescence,internodal,irregular,irregularly,lamina,leaf,like,lobe,lobed,long,longer,lower,lowermost,margin,markedly,midpoint,midrib,minutely,mm,new,occasionally,often,orangish,ovate,ovoid,pair,pale,paler,papillate,part,pedicel,peduncle,per,persistent,petiole,pitted,planar,porrect,present,prickle,prickly,primary,pubescent,purple,ray,red,reniform,rhachi,ripening,sessile,short,short-stalked,shrub,simple,sinuate,slightly,somewhat,spaced,sparsely,spreading,staman,stellate,stem,stigma,strongly,style,surface,tan,three,time,trichome,tube,tuberculate,two,type,unit,vein,way,whitish,x,yellowish	0.6-0.8,0.6-1,1-1.6,1.5-2.5,2,2-10,4-merous,abscissio,along,another,apart,away,bulbous,cell,eaf,eed,free,frui,glabrescen,interpetalar,left,lengthening,linear,margined,maturity,membranous,midvein,nflorescence,nodding,older,one,papillat,peg,perfect,pericarp,pore,poricidal,portion,rotate-stellate,ruffly,ruit,scar,shiny,sinus,slit,small,sometimes,space,thick,thin,tip,tub,ud,unevenly,unisexual,upper,usually,widely,ympodial,zygomorphic	appearance,arrangement,border,branch,bud,characteristic,colour,corrugation,distal,exertion,form,giving,glabrousnes,height,history,interjected,lateral,leaflet,length,life,lobing,null,number,ovary,plant,pseudostipule,seed,shape,size,sympodial,terminal,texture,thicknes,variation,width
532	wfo-0001032367	success	231	191	149	82	42	0.645	.2,.4,0-0.3,0.4â0.5,0.4â0.6,0.4â1,0.5â2,0.6â0.8,0.7-1.1,0.8,0.8â2,1-2.1,1.2,100-300,1â1.5,1â1.8,2,2-3-celled,2.2â2.5,2.2â2.8,2.5â3,3-5,3-celled,3â5,3â6,5.5â6.9,6-8,6.8â8.2,7â10,8,abaxially,accrescent,acute,adaxially,also,anther,apex,axi,base,berry,blade,branch,broad-based,calyx,capitate,cm,congested,conical,copious,cordate,cream,dark,densely,diameter,erect,filament,flattened-reniform,flower,free,fruiting,glabrous,gland-tipped,glandular-puberulent,globose,green,greenish,hair,herbarium,hyaline,immature,inflorescence,lanceolate,largest,lateral,leaf,length,light,lobe,lobed,long,longer,many,margin,maturity,midpoint,minute,minutely,mixed,mixture,mm,moderately,mottled,narrowly,nearly,obtuse,often,ovary,ovate,pair,pale,pedicel,peduncle,per,petiole,prickle,prickly,puberulent,pubescence,pubescent,ray,recurved,red-brown,scattered,sessile,shallow,shrub,similar,simple,size,somewhat,sparsely,specimen,spreading,stellate,stem,stigma,straight,style,suborbicular,surface,tapering,terete,tightly,tip,triangular,trichome,truncate,tube,unarmed,unbranched,uniformly,uniseriate,usually,variable,vein,white,wide,yellow,â15	-3,0.2â0.35,0.4-0.5,0.5â0.8,0.6,1-2,2-4,2â2.5,3.2â4,3â10,4,4â6.5,5-merous,5â18,abaxial,acicular,adaxial,adaxiall,alyx,anthesi,arme,around,ba,connivent,curved,deciduous,difoliate,directed,distall,eaf,eed,enlarged,entire,equal,expand,fertile,geminat,geminate,grading,heterostylous,infructescence,layer,least,long-styled,lower,lowermost,major,membranous,mesocarp,nflorescence,one,orolla,oung,papillat,pore,poricidal,portion,rarely,rest,ruit,scarcely,secondary,short-styled,shorter,slender,small,smaller,spongy,spreadin,staminat,ste,tall,tamen,thick,time,tooth,twice,unit,vary,whitish,ympodial,â5	2-2.5,3.2-4,4-6.5,appearance,armed,arrangement,bark,border,bud,characteristic,colour,corolla,corrugation,distal,drying,exertion,form,fruit,giving,glabrousnes,growth,height,history,interjected,leaflet,life,lobing,mentioned,new,number,papillate,plant,primary,pseudostipule,seed,shape,terminal,texture,thicknes,type,variation,width
533	wfo-0001032407	success	216	191	150	66	41	0.694	0-4,0.3-0.6,0.4-4,0.5-3,0.8,0.8-0.3,1-10,1-2,1-2.4,1.2-7,1.4-2.7,1.5-2.2,10-19.5,10-27,12,2-10.5,2.5-10.5,2.5-9,3-15,3.1-13.5,30,38,4-11,4-48,4-7,5,5-23,5-30,6,7-9,8-10,abaxially,acumen,acuminate,adaxially,anther,apart,apex,apparently,articulated,asymmetrical,attenuate,axe,axillary,base,basiscopic,berry,brownish,bud,cell,ciliate,clavate,cm,coarsely,commonly,condition,conical,connivent,corolla,covering,dark,densely,diameter,distal,drying,elliptic,elongated,especially,filament,finely,flower,forked,fresh,fruit,generally,glabrous,green,greenish,hair,hair-like,half,herb,interjected,lanceolate,lateral,leaf,leaflet,less,light,like,lobe,long,make,margin,medium,middle,minute,mm,mottled,mucilaginous,narrow,obtuse,odd-pinnate,orbicular,ovate,ovoid,pedicel,peduncle,perfect,petiole,petiolule,plant,proximal,puberulent,pubescent,purple,rarely,ray,ripe,round,seed,semierect,sessile,side,simple,size,spaced,sparsely,stem,stigma,style,subtending,symmetrical,tall,terminal,testal,thick,tip,tissue,tube,unwinged,usually,wall,wet,white,whitish,wide,wing,x,yellow	0.3-8,1-5,2-4,5-merou,absent,ag,along,alyx,arranged,bead,blade,capitat,chartaceous,decreasing,digestion,eaf,edge,eed,enzyme,erec,exceeding,folded,geminat,glabrou,gradually,green-white,homostylous,honeycomb-shaped,larger,lengthening,living,lower,membranous,minutely,moniliform,multiple,necklace,nflorescence,orolla,pair,pentagonal,plurifoliate,pore,poricidal,pubescen,removed,rotate,ruit,secondary,seudostipule,slit,specimen,stamen,ste,stolon,straight,subequal,tamen,tem,throughout,tri-,tuber,typically,unit,vary,ympodial	appearance,arrangement,bark,border,branch,calyx,capitate,characteristic,colour,corrugation,erect,exertion,form,fruiting,giving,glabrousnes,growth,height,history,inflorescence,length,life,lobing,mentioned,midpoint,new,number,ovary,per,prickle,primary,pseudostipule,shape,surface,texture,thicknes,type,variation,vein,width,Â¼
534	wfo-0001032465	success	233	225	184	49	41	0.79	+,-10,-11,-14,-9,.2,.5,0,0.2,0.5-,0.5-2,1-,1-1.5,1-1.7,1-celled,1.2-1.5,1.5,1.5-1.8,1.5-2,1.5-5,1/3,2,2-2.5,2.5-5.5,25,3-3.5,3-4,3-5,3-8,4,5,5-7,5-8,9,acuminate,acute,angled,anther,anthesi,apex,appearing,basal,base,berry,black,branched,brown,calyx,capitate,cell,ciliate,clasping,cm,commonly,conical,connivent,cordate,coriaceous,corolla,deep,deeper,deeply,deltate,densely,diameter,distal,drying,edge,ellipsoid,elliptic,elongate,entire,erect,filament,filiform,flattened,flower,fringe,fruiting,glabrous,gland,glandular,glandular-tipped,globose,green,greenish,growing,growth,half,included,inflorescence,irregular,irregularly,larger,later,lateral,leaf,length,like,lobe,lobed,long,loosely,lower,margin,mature,membranous,minute,minutely,mm,narrowly,new,occasionally,often,outline,ovate,pair,paired,pedicel,peduncle,pentagonal,per,petiole,pinnate,pinnatifid,planar,poricidal,primary,puberulent,pubescent,purplish,reddish,reniform,reticulate,revolute,ripe,seed,shallow,shape,similar,simple,sinus,size,somewhat,sparsely,splitting,stem,stigma,strongly,style,subshrub,surface,terminal,testal,thicker,time,tiny,tip,toward,transparent,trichome,truncate,tube,tuft,twining,unicellular,uniseriate,unit,upper,usually,variously,varying,vein,vine,violet,wall,way,white,widest,woody,x,yellowish,young,Â½	3-9,5-merou,abaxial,ag,alyx,apar,apically,ark,articulated,axi,de,decreasing,eaf,eed,exserte,free,glabrescen,ilament,janeiro,leaving,lengthening,nflorescence,nodding,older,orolla,papillate,papillo,peg,pendan,perfect,pericarp,plurifoliat,pore,portion,rio,ruit,scar,scattered,shiny,sleeve,slit,spaced,stellate-rotate,tem,thin,twinin,ud,vary,ympodial	-3.5,appearance,arrangement,bark,border,branch,bud,characteristic,colour,corrugation,description,exertion,exserted,form,fruit,giving,glabrescent,glabrousnes,height,herb,history,interjected,leaflet,life,lobing,mentioned,midpoint,number,ovary,papillose,plant,plurifoliate,prickle,pseudostipule,ray,sympodial,texture,thicknes,type,variation,width
535	wfo-0001032494	success	163	187	147	16	40	0.902	.1,.4,.5,0.75-1,0.8-1,0.9-1.2,1-1.5,1.1-1.2,1.45-1.5,1.5,1.5-8,1.6-2,1.8-4.5,16.5-20.5,2.3-2.5,2.5,2.5-8,3-4,3.4-14.5,3/4,4-8,5-40,5-6.4,8-11,accrescent,acuminate,anther,anthesi,apart,apex,appearing,attenuate,axil,bark,base,beginning,beneath,berry,brown,bullate,calyx,clavate,cm,corolla,decurrent,deflexed,dia,differing,dry,equal,evenly,except,expanded,exserted,filament,flattened-reniform,flowered,free,fruit,fruiting,furcate,geminate,glabrous,globose,greenish-yellow,incrassate,lateral,lax,leaf,light,lobe,lobed,long,lower,main,major,margin,material,middle,minor,minutely,mm,narrowly,nearly,node,occasionally,opposite,orange,ovary,ovate,ovoid,pair,pale,papillae,papillose,pedicel,petiole,pitted,planar,pore,poricidal,portion,prominent,proximal,pubescent,quite,raised,revolute,ridge,scar,shaped,shrub,simple,size,slender,slightly,small,somewhat,spaced,stem,stigma,straight,style,surface,tall,tan,tapering,tear-drop,tip,tree,triangular,trichome,tube,two-winged,uniseriate,upper,vein,venation,way,white,whitish-green,widest,winged,woody,x,yellow,zig-zag	0.6-1,ba,difoliate,eaf,edicel,eed,geminat,inflorescenc,lenticellat,lon,nflorescence,papillo,ruit,ud,unit,ympodial	appearance,arrangement,border,bud,characteristic,colour,corrugation,diameter,distal,drying,exertion,flower,form,giving,growth,history,inflorescence,interjected,leaflet,length,lenticellate,life,lobing,midpoint,null,number,peduncle,per,prickle,primary,pseudostipule,ray,seed,shape,terminal,texture,thicknes,type,variation,width
536	wfo-0001032507	success	206	205	156	50	49	0.757	.2,.5,/4,0.25,0.3,0.5,0.7-1.2,0.8,1,1.2-1.7,1.3,1.5â2,1.5â7,10â20,15â20,1â10,2,2.5â6,20â30,2â9,3â7,4â10,5â10,5â8,6,8â15,abaxial,abaxially,absent,acuminate,acute,adaxially,adjacent,anther,anthesi,apex,apiculate,armed,articulated,base,becoming,berry,blade,blue,branched,broadly,brown,bud,calyx,campanulate,cell,chartaceous,cm,collection,compound,confluent,connivent,corolla,curved,deltate,diameter,distinct,either,ellipsoid,elliptic,elongating,entire,equal,exserted,fertile,filament,flattened-reniform,flower,flowering,fruiting,glabrous,globose,green,hair,herbaceous,herbarium,highly,individual,internode,larger,lateral,leaflet,light,lobe,long,longer,major,margin,material,minutely,mm,narrowly,nearly,oblong,occasionally,often,one,ovate,pedicel,peduncle,pentagonal,perennial,petiole,pinnate,pinnately,pinnatifid,pistillate,pitted,plant,present,prickle,puberulent,pulp,purple,quadrate,rarely,reddish,rounded,shape,side,simple,single,slender,slightly,spreading,staminate,stem,stigma,stout,straight,strongly,style,surface,terminal,testal,time,tip,tube,unbranched,unit,usually,variable,variously,vein,vine,way,white,wide,widest,woody,Ã	1â1.5,2.5â4,3â5,5â20,abundant,adaxiall,ag,alyx,cream,deep,distally,dr.,eaf,eed,fifth,four,interpetalar,lengthening,lobed,lower,midrib,nflorescence,observe,orolla,pale,papery,pericarp,plurifoliat,pore,poricidal,purplish,rachi,ranging,recurve,regularly,rotate-pentagonal,rugose,ruit,sinus,slit,sometimes,tamen,tear,tissue,unequal,unlobed,vary,wood,yellowish,ympodial	--,10,3,4,5,appearance,arrangement,bark,border,branch,characteristic,colour,corrugation,distal,drying,exertion,form,fruit,giving,glabrousnes,growth,height,history,inflorescence,interjected,leaf,length,life,lobing,mentioned,midpoint,new,number,observed,ovary,per,plurifoliate,primary,pseudostipule,ray,recurved,seed,size,sympodial,texture,thicknes,type,variation,width
537	wfo-0001032523	success	200	195	156	44	39	0.78	-2,-5,.2,.5,/4,0-0.15,0.1-0.2,0.2,0.3-0.5,0.4-1,0.4-1.5,0.6-0.7,0.6-0.8,1-1.5,1-2,1-3,1-8,1.3-1.6,1.5-3,1/3-1/2,10-50,15-30,2-2.4,2-2.5,2-4,2-5.5,2.5-6,2.7-3,3-15,3-4,3.5-4,4-7,5-12,5-20,6-10,6-8,abaxial,acuminate,acute,adaxial,anther,apart,apex,apically,apparently,articulated,bark,base,berry,blade,branching,calyx,cm,conical,connivent,cuneate,curved,deltate,diameter,discolorous,drying,dull,elliptic,entire,equal,erect,evenly,filament,filiform,flattened-reniform,flower,free,fruit,fruiting,gently,glabrescent,glabrous,green,hair,inflated,lateral,leaf,length,lobe,lobed,long,longer,margin,mature,maturity,mauve,membranous,midpoint,minute,mm,moderately,multangulate,older,one,open,orange,orange-brown,ovate,pair,pale,pedicel,peduncle,per,perpendicular,petiole,poricidal,porrect,portion,prickle,prickly,primary,ray,recurved,red,red-brown,reflexed,scandent,scar,secondary,sessile,shrub,simple,smooth,sometimes,spaced,sparsely,spherical,stalk,stalked,stellate-pubescent,stem,straight,strongly,style,subentire,surface,tapering,terete,terminal,time,tip,trichome,tube,unarmed,variously,vein,way,weakly,wide,yellow,young	0-10,0-12,0-15,0-3,0.2-0.4,0.5-1,1/4-1/3,2,4-5-merous,6-20,abaxially,acuminat,alyx,ame,apar,brow,c.,eaf,eed,elongating,glabrou,herbaceous,infructescence,lon,lower,narrow-deltate,nflorescence,orolla,oung,perfec,pericarp,plurifoliat,ruit,spreading,stellate,tamen,tertiary,unarme,unit,vary,venation,visible,woody,ympodial	appearance,arrangement,border,branch,brown,bud,characteristic,colour,corolla,corrugation,distal,exertion,form,giving,glabrousnes,growth,height,history,inflorescence,interjected,leaflet,life,lobing,mentioned,new,number,ovary,plant,plurifoliate,pseudostipule,seed,shape,size,stigma,texture,thicknes,type,variation,width
538	wfo-0001032524	success	205	181	138	67	43	0.673	1-10,1-2,1-2.5,1.5-2,1.5-4,10-35,12-13,120-210,14-50,2-3,2-5,2.5-8,25-90,3-4,3-5,3-8.5,3.5-4.5,4-5,4.5-8,5-6,50-70,6-13,6-16.5,7-35,7-8,abaxially,acumen,acute,adaxially,along,anther,apart,apex,apparently,arranged,articulated,ascending,attenuate,axe,axillary,base,bead,berry,blade,brownish,bud,cell,clavate,cm,condition,connivent,corolla,covering,cuneate,densely,diameter,different,distal,drying,elliptic,filament,flower,forked,fresh,fruit,generally,glabrous,globose,grayish-green,green,greenish,hair,half,head,herb,interjected,lanceolate,lateral,leaflet,length,light,like,lilac,lobe,long,make,margin,middle,mm,moniliform,mucilaginous,multicellular,multiple,narrowly,necklace,non-glandular,obtuse,odd-pinnate,often,ovate,ovoid,pedicel,peduncle,perfect,petiole,petiolulate,plant,pubescent,purple,ripe,rounded,seed,sessile,short,silky,silvery-white,size,spaced,stem,stigma,stolon,style,subtending,terminal,testal,tetralobulate,thick,trichome,tube,tuber,typically,unwinged,usually,violet,wall,wet,whitish,x	4,4.5-5,5-9,5-merou,?,ag,alyx,capitat,chartaceous,ciliate,digestion,dorsally,eaf,edge,eed,enzyme,erec,especially,exceeding,except,flat,folded,geminat,glabrou,greatly,green-white,hair-like,hal,homostylous,honeycomb-shaped,lengthening,living,lower,membranous,midrib,minutely,nflorescence,orolla,pair,pentagonal,petiolule,plurifoliate,pore,poricidal,proximal,puberulent,reduced,removed,rotate,ruit,seudostipule,slit,specimen,stamen,ste,straight,subequal,tall,tamen,tem,throughout,tip,tri-,unit,vary,yellow,ympodial	'hair-like,appearance,arrangement,bark,border,branch,calyx,capitate,characteristic,colour,corrugation,erect,exertion,form,fruiting,giving,glabrousnes,growth,height,history,inflorescence,leaf,life,lobing,mentioned,midpoint,new,number,ovary,per,prickle,primary,pseudostipule,ray,shape,surface,texture,thicknes,type,variation,vein,width,Âµm
539	wfo-0001032532	success	161	161	111	50	50	0.689	0.3-2.5,1-1.5,1-4,1.5-2.6,1.5-3.2,1.5-4.3,15-30,2,2-10,2-13,2-3,2.8-3.6,2.8-9.5,3-10,3.4-12.2,3.7-10,4-5.5,4.5,6,abaxially,acumen,acuminate,acute,adaxially,apex,apical,apically,articulate,base,branched,calyx,cell,cm,conical,connate,corolla,covering,cuneate,cyme,deep,dehiscent,diameter,dichasial,dichasially,distal,dorsally,ebracteate,edge,elliptical,exceeding,filament,finely,flat,folded,forked,green,green-white,herbaceous,interjected,introrse,lateral,leaf,leaflet,light,lobe,long,long-attenuate,make,maturing,medium,mm,monochasial,mucilaginous,narrowly,oblique,obtuse,odd-pinnate,often,ovate,ovoid,pedicel,peduncle,perennial,petiole,petiolule,plant,poricidally,proximal,pubescent,purple,rounded,seed,sessile,short,size,slit,stamen,stigma,straight,style,subsessile,terminal,testal,thick,throughout,tip,tuber-bearing,wall,wide,yellow,Â¼	0-.,13-52,2-,3-5,3-6-foliat,6-22,8-38,abaxiall,absent,attenuate,coarsel,digestion,diminishing,eaf,eed,emoval,enzyme,flower,generally,globo,gradually,hair-like,half,honeycomb,living,lon,lower,lunat,minute,nflorescence,nther,orolla,pair,pattern,perfect,plan,reveal,rotate,ruit,seudostipule,specimen,subequal,tal,tem,throughou,toward,typically,unit,vary,ympodial	'hair-like,0-2,anther,appearance,arrangement,bark,border,branch,bud,characteristic,coarsely,colour,corrugation,drying,exertion,form,fruit,fruiting,giving,glabrousnes,globose,growth,height,history,inflorescence,length,life,lobing,margin,mentioned,midpoint,new,number,ovary,per,prickle,primary,pseudostipule,ray,shape,stem,surface,texture,thicknes,tube,type,variation,vein,wet,width
540	wfo-0001032536	success	254	232	198	56	34	0.78	-3,/3,0.5,1,1-2,1-2.5,1.3-2.2,1.5,10,10-20,10-30,10-50,100,14-16,2-3,2.5-3,20-22,20-25,20-50,3,3-3.5,4-6,4-8,4-9,5,5-6,5-8,5.5-8,7-10,<,>,abaxial,abruptly,acute,adaxial,adaxially,age,almost,angle,anther,anthesi,apex,appressed,armed,axi,bark,basal-most,base,berry,blade,bright,bristle,bristly,broad-based,broadly,brown,calyx,capitate,caudate,clavate,clearly,cm,conical,curved,dark,dbh,deeply,deltate,densely,denser,depressed,diameter,difoliate,directed,diverging,elliptic,enlarged,entire,equal,evenly,fading,filament,flattened,flower,fruit,fruiting,geminate,glabrescent,glabrous,glandular,glandular-puberulent,globose,grayish,growth,halfway,inflorescence,infructesecnce,juvenile,lamina,lateral,leaf,leaf-opposed,length,like,lobe,lobed,long,long-stalked,long-styled,margin,mature,maturity,midpoint,midrib,minute,minutely,mixed,mixture,mm,multangulate,multiseriate,narrowing,narrowly,near,new,number,oblique,occasionally,odor,older,olive-green,once-branched,open,ovary,papillae,papillate,part,pedicel,peduncle,per,petiole,plant,pore,poricidal,porrect,potato,prickle,prickly,primary,prominent,protuberance,pubescent,purple,rarely,ray,reddish,reniform,reproductive,short-,simple,slender,slightly,small,smooth,soft,sparsely,spreading,stalk,stellate,stem,stigma,style,surface,tall,tapering,terete,terminal,time,tip,tree,triangular,trichome,truncate,trunk,tube,unarmed,unit,upward,urceolate,usually,vein,visible,way,white,wide,wood,yellow-green,younger	13-24,3-6,5-merous,abaxially,adaxiall,along,alyx,apar,around,articulated,berr,caudat,cell,chartaceous,coriaceous,cu,eaf,eed,free,hanging,heterostylous,inflorescenc,interpetalar,irregularly,leaving,lower,membranous,midvein,nflorescence,occurring,orolla,oung,papillat,pentagonal,pericarp,portion,prickl,rough,ruit,scar,scattered,shallowly,short-styled,somewhat,spaced,staminate,stellate-pubescent,strongly,tamen,thick,tissue,unequal,vary,woody,yellowish,ympodial	appearance,arrangement,border,branch,bud,characteristic,colour,corolla,corrugation,cut,distal,drying,exertion,form,giving,glabrousnes,height,history,interjected,leaflet,life,lobing,null,pseudostipule,seed,shape,size,sympodial,texture,thicknes,type,variation,width,young
541	wfo-0001032542	exception_thrown	161	0	0	161	0	0.0		.25,.25-0.5,.5,.5-1,/4,0.5-1,0.7-1,1-1.3,1-1.5,1-2,1-5,1.5-3.5,10-15-flowered,10-28,2-3,2-3.5,2.5-5,3-4,3-5,4-7,4-9.5,4.5-5,5-8,abaxial,abaxially,acuminate,acute,adaxially,along,anther,anthesi,apex,apical,attenuate,axi,ba,bark,basal,base,beginning,berry,bluish-green,bright,brown,calyx,capitate,closely,cm,compact,conical,corolla,dark,deflexed,deltate,dendritic,densely,di,dia,differing,difoliate,distal,dry,eaf,edicel,eed,either,elliptic,elliptic-obovate,erect,exserted,filament,flattened-reniform,free,fruiting,geminat,glabrous,globose,golden,green,growth,incrassate,inflorescenc,inflorescence,lamina,later,lateral,leaf,less,like,lobe,lobed,lon,long,loose,lower,main,major,margin,minor,minute,minutely,mm,narrowly,near,new,nflorescence,older,opposite,ovary,overlapping,pair,papillo,pedicel,persisten,petiole,pitted,planar,pore,poricidal,portion,pubescent,reddish-brown,rounded,ruit,scar,shape,shaped,shining,shrub,simple,size,slender,slightly,small,somewhat,spaced,sparsely,stem,stigma,strongly,style,surface,swollen,tear-drop,tip,treelet,triangular,trichome,tub,tube,ud,unit,vein,way,wide,woody,x,yellow-green,yellowish,ympodial,young	
542	wfo-0001032564	success	160	178	133	27	45	0.831	.05-0.1,.1,.5,0.25-0.5,0.3-1,0.75-1,1-1.2,1-1.3,1-1.5,1-2,1.3-2.5,1.5,2-2.5,4-5,4-6-flowered,5.5-9,6-7,8-9,along,anther,apart,apex,arched,bark,base,becoming,beneath,berry,branch,broadly,brown,bud,calyx,clavate,cm,conical,converging,corolla,dark,deflexed,deltoid,densely,dia,dry,elliptic,expanded,exserted,extreme,filiform,flattened,flower,fresh,fruiting,giving,glabrate,glabrous,globose,golden,green,greenish-white,greyish-red,halfway,lamina,later,lateral,leaf,like,lobe,lobed,long,long-acuminate,main,margin,material,member,minute,minutely,mm,narrowly,nearly,often,older,one,open,opposite,ovary,ovate,ovoid-reniform,pair,papillose,pedicel,petiole,pitted,planar,point,pore,poricidal,projection,prominent,puberulent,raised,ripe,rounded,scar,shaped,shiny,shrub,simple,slightly,small,soon,stem,stigma,straight,style,surface,tall,tan,tapering,tear-drop,thread-like,time,tiny,tip,trichome,truncate,tube,uniseriate,vein,winged,x,yellowish-green,young	.05,anthesi,apar,aspec,ba,eaf,edicel,eed,except,geminate,lower,middle,nflorescence,node,non-reproductive,obovoi,papillo,proximal,reflexed,ruit,strongly,ud,unifoliate,unit,widest,woody,ympodial	appearance,arrangement,aspect,border,characteristic,colour,corrugation,diameter,distal,drying,exertion,filament,form,fruit,glabrousnes,growth,height,history,inflorescence,interjected,leaflet,length,life,lobing,midpoint,new,null,number,obovoid,peduncle,per,plant,prickle,primary,pseudostipule,ray,seed,shape,size,terminal,texture,thicknes,type,variation,width
543	wfo-0001032569	exception_thrown	164	0	0	164	0	0.0		.5,/3,0.5-10,0.8-1,1-1.2,1-1.5,1-2,1-4,1.2-5,1.5,1.5-2,1.7-2,2-3,2-4,4-18,4-8,5-6,5-60-flowered,7-27,7-9,abaxially,acute,adaxially,along,anther,anthesi,apex,apparently,appearing,axi,bark,base,bearing,berry,bilobed,branched,broadly,brown,bullate,calyx,cell,closely,cm,conical,corolla,corrugated,dark,decurrent,deflexed,dendritic,dense,densely,denser,dia,differing,difoliate,dry,drying,eaf,edicel,eed,ellipsoid,elliptic,erect,exserted,filament,flattened,fleshy,free,fruiting,geminate,glabrous,globose,golden,gra,green,incrassate,inflorescence,irregularly,later,lateral,lea,leaf,like,lobe,lobed,lon,long,los,lower,main,major,margin,matted,mature,middle,minor,minutely,mm,moderately,nflorescence,obscured,occasionally,onto,open,opposite,otherwise,ovary,ovate,pair,paler,papillo,papillose,pedicel,pericar,petiole,pitted,planar,pore,poricidal,portion,present,pubecsence,pubescent,reniform,rich,ruit,scar,shaped,shrub,simple,size,somewhat,spaced,sparsely,splitting,stem,stigma,stone,strongly,style,surface,tall,tear-drop,thick,time,tip,triangular,trichome,tub,tube,tuft,ud,unifoliate,unit,vein,waxy,way,white,widest,woody,x,ympodial,young	
544	wfo-0001032576	success	229	228	191	38	37	0.834	-10,-12,-2,-2/3,/4,/5,0,0-1.5,0-5,0.1,0.1-0.15,0.1-0.2,0.3-0.5,0.3-0.7,0.5-1,0.5-1.5,0.5-2,0.5-4,0.8-1.2,0.8-1.4,0.8-2,1-3,1-4,1.2-1.8,1.5-2,1.5-2.3,1.5-7.5,1.8-2.5,1/2,1/3,2-10,2-3,2-4,2-5,2.5-3,2.5-4,3-14,4,4-,4-6,4-6.5,5-30,6-8,7-8,acute,anther,apart,apex,apically,apparently,ascendant,bark,base,berry,blade,branched,bright,brown,brown-green,calyx,cell,chartaceous,cm,concolorous,conical,cuneate,curved,deltate,densely,diameter,difoliate,distance,drying,dull,ellipsoid,elongating,entire,erect,evenly,extending,filament,flattened,flattened-reniform,flower,free,fruit,fruiting,glabrescent,glabrous,gland,glandular,globular,gray,green,hair,herb,infructescence,lanceolate,lateral,leaf,length,lobe,lobed,long,longer,margin,mature,maturity,membranous,midpoint,midvein,minutely,mm,moderately,narrow-deltate,narrow-ovate,near,obovate,obtuse,often,older,one,open,orange-brown,outline,ovate,pair,pale,pedicel,peduncle,per,petiole,pit,poricidal,porrect,portion,prickle,prickly,primary,purple,raised,ray,red,red-green,reduced,reflexed,reticulate,rounded,scandent,sessile,shiny,short,shrub,side,simple,slender,slightly,small,smooth,sometimes,spaced,sparsely,spherical,spreading,stalk,stalked,stellate,stellate-pubescent,stem,straight,style,surface,tapering,terminal,time,tip,trichome,tube,unarmed,unit,upper,usually,variously,vein,way,white,wide,yellow,yellow-green,yellow-orange,young	0-3,0-30,0.1-0.25,1/3-1/6,4-5-merous,abaxially,acuminat,alyx,apar,articulated,ba,branching,brow,eaf,eed,equal,eye,faint,geminat,herbaceous,lower,naked,nflorescence,orolla,oung,perfec,pericarp,prickl,ruit,scar,shorter,tamen,tertiary,vary,venation,visible,woody,ympodial	acuminate,arrangement,branch,bud,characteristic,colour,corolla,corrugation,distal,exertion,form,geminate,glabrousnes,growth,height,history,inflorescence,interjected,leaflet,life,lobing,new,number,ovary,plant,pseudostipule,seed,shape,size,specified,stigma,sympodial,texture,thicknes,type,variation,width
545	wfo-0001032595	success	200	171	122	78	49	0.61	-25,-pilose,0-,0.5-1,0.5-3.5,1-2,1-2.5,1-3,1.5-2,1.5-2.5,1.5-5,15-25,15-40,2-3,2-4,2.3-24,25-40,3-10,3-12,3-4,3-4-foliate,3-5,4-25,4-5,4-7,5-6,abaxially,acuminate,acute,adaxially,along,also,anther,apex,apical,apiculate,axe,basal,base,branch,branched,calyx,cm,connivent,cordate,cream,deeply,deltate,dense,densely,diameter,eglandular,ellipsoidal,entire,filament,finely,flattened,flower,fork,forked,fruit,fruiting,geminate,glabrous,gland,glandular,hair,lanceolate,leaf-opposed,lobe,long,loosely,major,margin,mature,mm,moderately,oblique,often,ovate,ovoid,pale,pedicel,peduncle,per,perfect,petiole,pilose,prominent,pseudohair,puberulent,pubescent,purplish,rarely,reniform,rugulose,shallow,shrub,side,simple,single,small,sparsely,spreading,stigma,style,tall,thecae,time,tip,tree,truncate,trunk,tube,two,unbranched,unit,vein,white,wide,x,yellow	-20,1,1-6,1-6.5,1.5-4.5,12-16,5-merou,6-7,9-14,accrescen,aggregate,alyx,apart,ape,articulated,blade,brownish,brownish-purple,cell,ciliat,connective,coriaceous,crow,cucullate,denser,dilated,directed,distally,dull,eaf,eed,equal,exceeding,free,fusiform,greenish,homostylous,larg,leaving,lon,longitudinal,lower,m.,midrib,narrowly,near,nflorescence,opening,orolla,part,pedicellar,pilo,pore,produced,purple,rachi,remnant,ruit,shorter,slightly,slit,spaced,stamen,stellate,stone,strongly,subcoriaceous,swelling,tamen,tem,tomentose,toward,triangular,ud,umbrella-shaped,vary,violet,ympodial	appearance,arrangement,bark,border,bud,characteristic,colour,corolla,corrugation,crown,distal,drying,exertion,form,giving,glabrousnes,growth,height,history,inflorescence,interjected,lateral,leaf,leaflet,length,life,lobing,mentioned,midpoint,new,number,ovary,plant,prickle,primary,pseudostipule,ray,seed,shape,size,stem,surface,sympodial,terminal,texture,thicknes,type,variation,width
