	coreid	status	nwords_original	nwords_result	nwords_recovered	nwords_omitted	nwords_created	prop_recovered	common_words	original_only	result_only
0	wfo-0001025652	success	156	113	86	70	27	0.551	.3,.5,1-1.5,1.5-2,15-17,2-3,2-6,3-3.5,3-5,4,4-6,4-7,abruptly,acute,anther,apex,base,blade,calyx,cm,corolla,decurrent,densely,difoliate,dry,elliptic,filament,fleshy,flower,free,fruit,furcate,glabrous,green,growing,growth,irregular,lateral,leaf,lobe,long,main,major,margin,minor,minute,minutely,mm,narrowing,occasionally,onto,opposite,ovary,ovoid-reniform,pair,pale,paler,papillae,papillose,parallel,pedicel,petiole,pinkish-grey,pitted,plant,portion,red-papillose,shape,shiny,shrub,simple,small,specimen,stem,strongly,style,surface,tan,tapering,thick,tree,tube,vein,white,winged,x	0.5-1,1,10-20,15-19,2-5,20-50,3-5-flowered,9-11,acuminate,anthesi,appearing,bark,bilobed,broad,campanulate,closed,closely,completely,connate,dia,differing,eaf,edicel,eed,emerge,envelope,geminat,glabrate,greyi,greyish,like,live,lobed,lon,lower,matte,middle,nearly,new,nflorescence,older,one,overlappin,ovoid,papillo,planar,pore,poricidal,rather,ry,scar,shaped,size,soon,spaced,stigma,straight,tall,tear,tear-drop,thicker,tightly,tip,ud,unit,wider,widest,wing,ympodial,young	abaxial,adaxial,arrangement,branching,characteristic,colour,diameter,form,geminate,height,history,inflorescence,length,life,midvein,null,peduncle,primary,pseudostipule,rachi,seed,staman,tertiary,texture,true,unarmed,venation
1	wfo-0001025657	success	239	160	135	104	25	0.565	0.1-0.4,0.2-0.4,0.5-2.5,1-1.1,1-1.3,1-1.6,1-3,1.2-1.5,1.3-2,1.5-1.8,12x,2-10,2-3.5,2.2-5.5,2.5-9.3,2.7-4.3,25-60,3-6,4-4.4,5-14,5-16,6-8,7-9.5,8-10.5,8.3-12,abaxially,acute,adaxially,also,anther,apart,apex,articulated,ascending,axe,base,berry,bluish,branched,brown,calyx,central,closely,cm,conical,cordate,corolla,dark,deltoid,dendritic-multangulate,densely,diameter,dried,entire,expanded,filament,fleshy,flower,fruit,glabrous,glandular,granular,green,hair,half,lanate-pubescent,lanceolate,leaf,length,light,lobe,long,lower,magnification,margin,midrib,minutely,mixed,mm,multangulate,narrowly,obtuse,orbicular,ovate,pale,part,partly,pedicel,peduncle,persistent,petiole,plurifoliate,porrect-stellate,pseudo-terminal,pubescent,rachi,ray,reportedly,reticulate-punctate,ripe,semi-ovate,sessile,short,short-stalked,shrub,side,simple,slightly,soft,spaced,stellate-pubescent,stem,stipitate-glandular,stipitate-multangulate,style,subcoriaceous,suborbicular,surface,tan,thick-stalked,thin-stalked,tomentose,tomentose-pubescent,tomentum,transparent,tree,two-third,unarmed,upper,vein,velutinous-pubescent,white,x,yellow,yellowish	-2,/3,1.7-1.9,2/3,3-4,3-4.8,3.2-6,4-4.5,4-7,6-12,6.5-10,7-27,7-9,accrescent,ag,anthesi,apparently,appearing,ark,around,axillary,ba,blade,blunt-tipped,branch,broadly,bud,capitat,chartaceous,cylindrical,dendritic-multangulat,dense,directed,distally,due,eaf,earl,edge,eed,elliptic,especially,evident,exerted,exserted,farinose,few-rayed,free,fruiting,glandula,inserted,lateral,lengthening,lobed,long-stalked,longitudinal,m.,main,nearly,nflorescence,oblong,occasional,often,older,open,orolla,ovat,ovate-lanceolate,overlapping,parted,perfect,persistently,pore,poricidal,present,pubescence,ruit,scented,short-,slit,somewhat,splitting,stamen,stellate,stigma,strongly,subcampanulate,suture,tall,tamen,terete,thickened,time,tip,tube,ud,unarme,unit,usually,vary,way,weakly,wide,ympodial,young	abaxial,adaxial,arrangement,branching,characteristic,colour,form,growth,height,history,inflorescence,life,midvein,ovary,plant,primary,pseudostipule,seed,shape,staman,tertiary,texture,true,unspecified,venation
2	wfo-0001025669	success	216	137	105	111	32	0.486	.5,0-7,0.1-0.3,0.8-2.4,1,1-10,1-2,1-4,1.3-4.2,1.4-2.5,1.6-4.4,13-35,2-3,2-4,2.2-6,2.2-6.5,2.4-7,3-5,3-7,4-6,9-24.5,abaxially,absent,acuminate,acute,adaxially,anther,apart,apex,articulation,base,berry,blade,blue,brownish,cell,cm,condition,corolla,covering,cuneate,diameter,distal,drying,filament,flower,fresh,fruit,glabrous,globose,green,green-white,greenish,hair,herb,interjected,lateral,leaflet,like,lobe,long,make,margin,minute,mm,moderately,monochasium,mottled,mucilaginous,multicellular,oblique,obtuse,odd-pinnate,ovoid,pair,pedicel,peduncle,petiole,plant,pubescent,purple,rarely,ripe,scale-like,seed,short,slightly,sometimes,spaced,stem,streaked,style,subglabrous,terminal,testal,thick,throughout,tinged,typically,unbranched,wall,wet,white,whitish,x	'',0-1,0-5,1-2.2,1-3,2,5-merou,``,absen,acumen,ag,along,alyx,apparently,axe,broadly,capitat,chartaceous,ciliate,clavate,clearly,connivent,contracted,decurrent,digestion,discussion,distinct,dorsally,eaf,edge,eed,elliptic,end,enzyme,erec,especially,exceeding,except,extra,flat,flowered,folded,forming,geminat,glabrou,greatly,hair-like,half,highly,homostylous,honeycomb-shaped,lanceolate,larger,lengthening,living,lower,membranous,midrib,minutely,near,nflorescence,obovate,often,one,orbicular,orolla,ovate,perfect,petiolulate,petiolule,placed,plurifoliate,pore,poricidal,proximal,puberulent,reduced,removed,rosette,rotate,rounded,ruit,see,sessile,seudostipule,single,size,slit,species,specimen,stamen,ste,stigma,stolo,straight,subequal,tall,tamen,tem,tip,tri-,truncate,tube,tuber,unequal,unit,unwinged,vary,wide,yellow,ympodial	'extra,'hair-like,abaxial,adaxial,arrangement,branching,calyx,characteristic,colour,form,growth,height,history,inflorescence,leaf,length,life,mentioned,midvein,ovary,primary,pseudostipule,rachi,shape,staman,surface,tertiary,texture,true,unarmed,vein,venation
3	wfo-0001025697	success	181	117	84	97	33	0.464	-9,0.15-0.75,1-1.7,1-2,1.5-1.8,1.7-8.6,2-6,25-35,3-10,3-4,3-6,abaxially,acumen,acuminate,acute,adaxially,anther,apex,articulated,asymmetric,attenuate,base,basiscopic,berry,blue,brownish,cell,cm,condition,corolla,covering,dark,deep,diameter,distal,drying,elliptic,filament,fresh,fruit,glabrescent,glabrous,globose,green,greenish,hair,half,herb,high,lanceolate,lateral,leaf,light,lilac,linear,lobe,long,make,medium,mm,mucilaginous,odd-pinnate,ovate,ovoid,pedicel,peduncle,petiole,plant,purple,rachi,ripe,rounded,seed,sessile,short,side,stripe,style,testal,thick,tissue,wall,wet,whitish	0-14,0.6-3.5,0.8-2,1-3,10-26,2-10.5,2-2.6,2-4,3-5,3.3-11,4-7.5,5-merou,5.5-11.5,6.5-13.5,adaxiall,ag,alyx,apart,apparently,axe,axillary,blade,bud,capitat,clavate,connivent,coriaceous,decreasing,decurrent,digestion,dorsally,eaf,edge,eed,enzyme,erec,exceeding,flat,flower,folded,forked,geminat,generally,glabrou,green-white,hair-like,hal,homostylous,honeycomb-shaped,interjected,leaflet,lengthening,living,lower,nflorescence,orbicular,orolla,pair,pentagonal,perfect,petiolulate,plurifoliate,pore,poricidal,removed,rotate,ruit,seudostipule,size,slightly,slit,spaced,specimen,stamen,stigma,straight,subequal,subglabrou,subtending,tall,tamen,tem,terminal,throughout,tip,toward,tri-,tube,typically,unit,unwinged,usually,vary,wood,x,yellow,ympodial	'hair-like,abaxial,adaxial,arrangement,branching,calyx,characteristic,colour,form,growth,height,history,inflorescence,length,life,margin,midvein,null,ovary,primary,pseudostipule,shape,staman,stem,subglabrous,surface,tertiary,texture,true,unarmed,vein,venation,woody
4	wfo-0001025699	success	181	150	122	59	28	0.674	.2,.5,1,1-1.5,1-2.5,1-3,1.5,1.5-2,10,15-20,2,2-2.5,2-6,2cm,3-15,3-3.5,3-8,4-5,5-8,5-winged,8-9,abaxially,absent,acute,almost,anther,anthesi,apex,appearing,attenuate,base,becoming,berry,branching,brown,calyx,capitate,cm,completely,conical,conspicuously,continuing,corolla,crystal,dark,darker,densely,diameter,difoliate,dry,drying,ellipsoid,elliptic,entire,erect,filament,flower,fruiting,glabrous,globose,green,grey-brown,growth,immature,inclusion,inflorescence,lanceolate,leaf,leaf-opposed,lobe,margin,markedly,midrib,minutely,mm,narrowly,nodding,older,one,onto,ovary,oxalate,pair,pale,pedicel,peduncle,per,petiole,plurifoliate,primary,red,reddish,reniform,reticulate-pitted,rounded,sand,shoot,short,simple,small,somewhat,stem,stigma,straight,strongly,style,surface,time,tip,tree,triangular,unit,vein,white,white-spotted,wide,wing,winged,woody,x,yellow,young	0.5,1-2,1/3,3-5.5,499,5.5-14,adaxially,age,apart,apparently,articulating,bark,c.,campanulate,corrugate,cup-shaped,deltate,dorsal,eaf,eed,exerted,face,fide,free,glabrou,included,inflorescenc,irregularly,leafy,leaving,lengthening,less,lobed,lower,new,nflorescence,papillat,papillose,peg,penden,perfect,pore,poricidal,portion,rounded-sagittate,ruit,scar,slightly,slit,spaced,stearn,tangled,thickened,trichome,tube,ud,way,ympodial,Â½	3,abaxial,adaxial,arrangement,characteristic,colour,corrugated,form,fruit,height,history,length,life,midvein,null,papillate,pendent,plant,pseudostipule,rachi,seed,shape,staman,sympodial,tertiary,texture,unarmed,venation
5	wfo-0001025700	success	189	141	105	84	36	0.556	0.30-2.0,0.5-2,0.8-2.6,1.5-2,10-40,10.5-12,15-40,2-12,2-7,2.5-4,3-8,5-15,5-20,5.3-17.5,5.5-8,abaxially,acumen,acuminate,acute,adaxially,anther,apex,apiculate,apparently,articulated,asymmetric,attenuate,axe,axillary,basal,base,basiscopic,berry,brownish,bud,cell,cm,condition,corolla,covering,diameter,distal,dot,drying,elliptic,filament,flower,forked,fresh,fruit,generally,glabrescent,glabrous,globose,green,green-white,greenish,hair,half,herb,high,lateral,leaf,light,lilac,linear,lobe,long,make,medium,mm,mucilaginous,odd-pinnate,ovate,ovoid,pedicel,peduncle,perfect,petiole,petiolulate,plant,plurifoliate,purple,ripe,rounded,seed,short,side,sometimes,straight,style,subtending,terminal,testal,thick,throughout,tissue,tri-,typically,unit,usually,wall,wet,white,whitish	0-16,0.7-2.7,0.8-4,1-2,1-3,1.1-2.3,3-4,3.5-10.5,3.7-8.6,4-5,5-merou,5.5-18,9-31,acuman,ag,alyx,blade,capitat,chartaceous,clavate,connivent,considerably,decrease,decreasing,digestion,dorsally,eaf,edge,eed,enzyme,erec,exceeding,except,flat,folded,geminat,glabrou,hair-like,hal,homostylous,honeycomb-shaped,interjected,lanceolate,larger,leaflet,lengthening,living,lower,narrowly,nflorescence,orbicular,orolla,pair,par,pentagonal,pore,poricidal,proximal,removed,rotate-pentagonal,ruit,sessile,seudostipule,size,slightly,slit,specimen,stamen,stigma,subequal,subglabrou,tall,tamen,tem,tip,toward,tube,unwinged,vary,whose,winged,x,yellow,ympodial	'hair-like,abaxial,adaxial,arrangement,branching,calyx,characteristic,colour,form,geminate,growth,height,history,inflorescence,length,life,margin,midvein,null,ovary,part,primary,pseudostipule,rachi,shape,staman,stem,subglabrous,surface,sympodial,tertiary,texture,true,unarmed,vein,venation
6	wfo-0001025704	success	248	197	176	72	21	0.71	-3,-5,/6,0-100,0-2,0-3.5,0.1,0.15-0.8,0.3-0.8,0.5-1.5,0.7-1,1,1-3.5,1-4,1-6,1.2-3,1.5-3.2,1.5-4.5,1/4-3/4,1/5,2-10,2-3,2-4.5,2-7,2.7-4,3-15,3-5,3-6,4-12,4-5,4.5-6.5,8-12,abaxial,acute,adaxial,age,almost,anther,apart,apex,apically,apiculate,apparently,articulated,auriculate,axe,base,berry,blade,branched,broad-deltate,calyx,cell,cm,connivent,cordate,deltate,densely,development,diameter,distal,distance,ellipsoid,elliptic,end,equal,erect,evenly,extending,filament,flattened-reniform,flower,free,fruit,glabrescent,green,green-yellow,infructescence,irregular,lateral,leaf,length,lobe,lobed,lobing,long,long-styled,margin,maturity,mauve,midpoint,midvein,mm,multangulate,near,obtuse,often,one,open,orange-brown,outline,ovate,pair,pale,pedicel,peduncle,per,pericarp,petiole,pit,plant,poricidal,porrect,portion,prickle,prickly,primary,raised,rarely,ray,recurved,red-green,retaining,round,rounded,scar,secondary,sessile,shape,short-styled,shrub,side,slender,small,smooth,sometimes,somewhat,spaced,sparsely,spherical,stalk,stalked,stellate-pubescent,stem,stout,straight,style,surface,tapering,terete,terminal,tertiary,throughout,time,tip,tree,trichome,truncate,tube,unarmed,unbranched,unit,upper,vein,venation,visible,warty,white,white-gray,wide,widening,yellow,yellow-green,yellowish,young,Ã	-10,-2,0,0-5,0.1-0.3,0.1-0.5,1.5-2,1.8-3.5,1/2-4/5,2,2-5,2.5-4.5,3-10,5-20,5-merous,6-12,6-15,8-15,8-17,abaxially,alyx,andromonoecious,apar,ba,bark,brow,chartaceous,covering,curved,discolorous,drying,eaf,eed,elongating,flattened,fruiting,glabrous,gray,half,hermaphrodite,heterostylous,less,longer,lower,lowermost,mature,moderately,nflorescence,occasionally,older,orange,orolla,oung,pendulous,plurifoliat,prickl,prominent,red-brown,reflexed,ruit,shorter,spreading,staminat,stellate,stellate-pubescen,strongly,tamen,variously,vary,way,woody,ympodial	arrangement,branching,characteristic,colour,corolla,description,form,growth,height,history,inflorescence,life,mentioned,ovary,plurifoliate,pseudostipule,rachi,seed,staman,sympodial,texture
7	wfo-0001025729	success	177	139	107	70	32	0.605	-20,.5,0.25-0.5,0.7-1.2,1-1.5,1-5,1.1-1.5,1.2-1.8,1.5-2,1.75,2,20,4-5,5-50-flowered,6-8,7-8,abaxial,abaxially,abrupt,acute,adaxially,anther,apex,apiculate,axil,basal,base,berry,black,calyx,cm,corolla,covering,deltoid,densely,dia,diam,difoliate,dirty,drying,elliptic,f,filament,flattened-reniform,fleshy,free,furcate,glabrous,globose,green,greenish-yellow,greyish-brown,incrassate,lamina,lateral,leaf,like,live,lobe,long,main,major,margin,minor,minute,minutely,mm,oblique,occasionally,opposite,ovary,pair,pale,papillose,pedicel,petiole,pit,pitted,plant,portion,prominent,pubescent,raised,ripening,rounded,shiny,simple,sparsely,stem,style,surface,tall,tapering,tip,tree,treelet,trichome,tube,tuft,uniseriate,unit,usually,vein,white,widening,x,yellow	/4,2-3.5,3-6,4-8,9-17,along,anthesi,apar,apical,appearing,bark,blackish,branched,bright,bristly,bud,covered,cyathiform,dark,deflexed,denser,differing,eaf,edicel,eed,enclosed,expanded,fruiting,geminat,gently,glabrou,growing,lat,lobed,lon,lower,m.,mainly,member,middle,nflorescence,often,older,one,overlapping,overtopping,papillo,partially,pore,poricidal,quite,reflexed,ruit,scar,shaped,short,size,stigma,stout,straight,tear-drop,terminal,touching,tub,ud,way,widest,woody,ympodial,young	..,3.5,adaxial,arrangement,branching,characteristic,colour,diameter,form,fruit,geminate,growth,height,history,inflorescence,length,life,midvein,null,peduncle,primary,pseudostipule,rachi,seed,shape,staman,sympodial,tertiary,texture,true,unarmed,venation
8	wfo-0001025749	success	217	137	113	104	24	0.521	.5,0-10,0-3,0-6,0.2-1.5,0.3-1.5,0.5-0.8,0.5-0.9,0.8-0.9,1-10,1-13,1-2,1-3,1-6,1-9,1.5,1.5-2,1.5-2.5,2-2.5,2.5-6,3-5,5-20,abaxial,acute,adaxial,anther,apex,apparently,base,berry,branched,calyx,cm,cuneate,dark,densely,diameter,difoliate,dull,erect,filament,filiform,flattened-reniform,flower,fruit,glabrous,green-brown,indistinct,infructescence,lateral,leaf,length,lobe,lobed,long,long-ovate,lower,magnification,margin,maturity,mauve,midvein,mm,moderately,narrow-deltate,orange-brown,orange-red,orbicular,ovate,pair,pale,pedicel,peduncle,per,petiole,porrect,prickle,prickly,primary,procumbent,purple,rarely,recurved,red-brown,rounded,sessile,shrub,side,sometimes,sparsely,spherical,stalked,stellate,stellate-pubescent,stem,straight,straw-yellow,style,surface,terete,tertiary,toward,trichome,usually,vein,venation,visible,white,wide,without,yellow,yellow-green,yellow-orange	-1,-12,/5,0-5,0-8,0.1,0.1-0.2,0.1-0.3,0.1-0.4,0.2,0.4-0.7,0.5,0.5-1.3,0.5-3,0.6-4.5,1,1-8.5,1/4-1/3,1/5-1/2,2-10,2/3,3-20,4-8,5-,5-10,5-merous,6-8,abaxially,acuminat,adaxially,adnate,almost,alyx,apar,apart,apically,articulated,bark,blade,broad-deltate,chartaceous,concolorous,curved,discolorous,distance,drying,eaf,eed,elongating,equal,extending,flattened,free,fruiting,geminat,gently,glabrescent,gray,herbaceous,light,lon,longer,markedly,mature,midpoint,narrow-ovate,nflorescence,oblong,obtuse,occasionally,older,one,open,orange-brow,orolla,oung,pendulous,perfec,pericarp,poricidal,portion,prickl,ray,reduced,ruit,scar,shorter,smooth,spaced,spreading,stalk,strongly,tamen,tapering,time,tip,tube,unit,variously,vary,way,yellowish,ympodial,Â½-2/	+,arrangement,branching,characteristic,colour,corolla,form,geminate,growth,height,history,inflorescence,life,null,ovary,plant,pseudostipule,rachi,seed,shape,staman,texture,unarmed,Â½-2/3
9	wfo-0001025754	success	164	170	138	26	32	0.841	-celled,.5,0.1-0.2,0.5-1,0.5-1.5,1,1-2,1-3,1.5,1.5-3,10-20,10-35,2-5-celled,2-7,3-10,3-5,3-6,4,4-6,5-12,5-15,abaxially,absent,abundant,acuminate,acute,adaxially,along,anther,apex,asymmetrical,axe,barely,base,berry,beyond,blade,branch,brown,calyx,center,chartaceous,ciliate,cm,connected,cordate,cordiform,decumbent,decurrent,dehiscing,densely,denser,diameter,dm,dried,drying,edge,eglandular,entire,equal,erect,explosively,exserted,filament,fine,flat,flower,fruit,glabrous,glandular,globose,hair,held,herb,immature,interpetalar,leaf,leaving,like,linear-lanceolate,lobe,long,lying,main,margin,material,maturing,membranaceous,mesocarp,mixed,mm,moderately,much-branched,nearly,notch,often,palmately,parallel,pedicel,peduncle,per,petiole,placenta,pressure,probably,pubescent,rachi,radiating,raised,ridge,rotate,running,semitransparent,shallow,short,slightly,small,solitary,sometimes,sparsely,stamen,stem,straight,style,surface,swollen,tissue,truncate,tube,unbranched,upright,vein,visible,watery,white,woody,x,yellow	1-3.5,1.5-4,2-4,2-foliate,adaxiall,eaf,eed,emarginat,geminat,lower,maturit,nfloresence,oblong,orolla,penden,pubescen,ruit,stigma,tal,tamen,tem,triangular,unit,vary,wid,ympodial	2.5,abaxial,adaxial,arrangement,branching,characteristic,colour,corolla,form,geminate,growth,height,history,inflorescence,length,life,maturity,midvein,null,ovary,pendent,plant,primary,pseudostipule,seed,shape,staman,tall,tertiary,texture,unarmed,venation
10	wfo-0001025760	success	210	145	124	86	21	0.59	-10,-12,-5,-6,0-0.5,0-100,0.1,0.15-0.3,0.3-1,0.45-0.9,0.5-2,0.8-1.8,1-,1-1.8,1-2,1-4,1.5,1.5-2.5,1.5-5,1/4-1/3,1/5,2-2.5,2.1-3.5,2.3-4,2/3,3,3-6,3.5-9,abaxial,acute,adaxial,almost,annual,anther,apex,apically,apparently,articulated,bark,base,berry,black,blade,broad-deltate,calyx,cm,cream,cultivar,cuneate,curved,dark,diameter,dull,elliptic,erect,filament,flattened-reniform,flower,fruit,gently,glabrescent,glabrous,green,herb,lateral,leaf,length,lobe,lobed,long,margin,marking,maturity,midvein,mm,moderately,older,orange,orange-brown,ovate,pair,pale,pedicel,peduncle,per,perennial,petiole,porrect,primary,ray,red-brown,rounded,sessile,shape,shrub,side,sometimes,spherical,stalk,stalked,stellate-pubescent,stem,style,subentire,surface,terete,tertiary,thick-stalked,trichome,unarmed,unbranched,upper,usually,various,variously,vein,venation,visible,weakly,white,wide,yellow,yellow-green,young	-3,.5,/3,0.1-0.2,0.2-0.35,0.4-0.8,0.5-1.5,0.7-2.5,1,1.5-4.5,1/4,1/4-1/2,2-3,2.5-10,2.5-8,3.5-17,5-10-merous,5-18,8-10,abaxially,acut,alyx,apar,brow,chartaceous,concolorous,connivent,deltate,difoliate,discolorous,distance,drying,eaf,eed,elongating,equal,extending,free,fruiting,geminat,geminate,hair,infructescence,lengt,longer,lower,mature,membranous,midpoint,minute,nflorescence,often,one,open,orolla,oung,pendulous,perfec,pericarp,poricidal,portion,recurved,reflexe,ruit,scar,shorter,simple,slender,smooth,spaced,spreading,stellate,stellate-pubescen,stout,straight,tamen,tapering,time,tip,tube,unarme,unit,vary,way,woody,ympodial	arrangement,branching,brown,characteristic,colour,corolla,form,growth,height,history,inflorescence,life,mentioned,ovary,plant,pseudostipule,rachi,seed,staman,texture,true
11	wfo-0001025782	exception_thrown	200	0	0	200	0	0.0		-2,.5,0-10,0-5,0.1-0.15,0.1-0.2,0.1-0.25,0.3-1,0.4-0.6,0.5-1,0.55-0.75,0.9-1.3,1,1-1.7,1-2,1-2.5,1-4,1.2-6,1.3-1.6,1.5-3,1/4-1/2,1/4-1/3,1/6,10-13,2-10,2-2.5,2-3,2-5,2-7,2.5-3.5,2/3-3/4,20,3-4,3-5,4,4-4.5,4.5-9,5-20,5-6.5,5-8,5-merous,5.5-6,6-14,6-8,abaxial,abaxially,acuminat,acuminate,adaxial,also,alyx,andromonoecious,anther,apar,apart,apex,apically,apparently,articulated,bark,base,berry,blade,brown,calyx,chartaceous,climbing,cm,concolorous,conical,connivent,cuneate,curved,deltate,densely,diameter,difoliate,discolorous,distal,distance,drying,dull,eaf,eed,elliptic,elongated,elongating,equal,evenly,extending,filament,flattened,flattened-reniform,flower,free,fruit,fruiting,geminat,geminate,gently,glabrescent,glabrous,green,green-brown,hair,hermaphrodite,heterostylous,infructescence,lateral,leaf,lengt,length,less,lobe,lobed,long,long-styled,longer,lower,lowermost,margin,mature,maturity,membranous,midpoint,midvein,minute,mm,moderately,nflorescence,occasionally,older,one,open,orange-brown,orolla,oung,pair,pedicel,peduncle,pendulous,per,pericarp,petiole,plant,poricidal,porrect,portion,prickl,prickle,prickly,primary,ray,red-brow,reduced,ruit,scar,sessile,short-styled,shorter,shrub,side,simple,smooth,spaced,sparsely,spherical,spreading,staminat,stellate,stellate-pubescent,stem,stout,straight,style,surface,tamen,tapering,terete,tertiary,time,tip,toward,trichome,tube,unbranched,unit,vary,vein,venation,visible,way,weakly,white,wide,woody,yellow,yellow-green,ympodial,young	
12	wfo-0001025783	exception_thrown	179	0	0	179	0	0.0		.5,0.5,0.5-1,0.5-1.5,0.8-3.5,1-1.2,1-1.5,1-3,1.8-2,2,2-3+,2-5,2-6.5,3-4,5,5-merou,7-10,<,abaxiall,abaxially,acute,adaxiall,adaxially,along,alyx,anther,anthesi,apart,ape,apex,ark,articulated,axil,base,berry,branched,branching,brown,bud,c.,calyx,cell,cluster,cm,completely,confined,conical,coriaceous,corolla,dendritic,densely,diameter,eaf,eed,ellipsoid,elliptic,entire,erect,expanded,exposed,exserted,filiform,flattened,fleshy,flexuous,flower,free,fruiting,glabrou,glabrous,globose,green,greyish,groove,growth,hromosome,ilament,inserted,keeled,known,lateral,lax,less,lobe,lobed,long,long/tall,lower,margin,mature,midrib,midvein,minute,minutely,mm,mmm,narrowly,near,new,nflorescence,nodding,number,obscured,obtuse,occasionally,older,orolla,outlin,pair,pale,pedicel,peduncle,penden,pentagonal,perfect,pericarp,petiole,pitted,plurifoliat,point,portion,possibly,primary,pubescent,purple,reniform,revolute,ripe,ruit,sagittate,scar,scarious,see,shiny,shoot,short,shrub,simple,sleeve,slightly,sometimes,somewhat,spaced,sparse,sparsely,stellate,stem,stigma,strongly,style,surface,suture,terminal,testal,thin,time,transparent,triangular,trichome,truncate,tube,tuft,twinin,type,ud,uniseriate,unit,upper,vary,vein,vine,violet,way,weak,wide,within,woody,yellowish,ympodial	
13	wfo-0001025788	success	158	136	101	57	35	0.639	0-6,0.5-2,1-4,1-5,15-30,2-10,2-13,2-3,2-5,2.8-9.5,2m,4-5.5,4.5-12.5,5-8,8-38,abaxially,acumen,acuminate,acute,adaxially,apex,articulate,attenuate,base,blue,branched,calyx,cell,cm,conical,corolla,covering,cuneate,cyme,deep,diameter,dichasial,dichasially,digestion,distal,ebracteate,elliptical,emoval,enzyme,exceeding,filament,finely,flower,forked,generally,green,green-white,hair-like,half,herbaceous,honeycomb,lateral,leaf,leaflet,living,lobe,long,long-attenuate,make,medium,mm,monochasial,mucilaginous,narrowly,oblique,obtuse,odd-pinnate,ovate,ovoid,pattern,pedicel,peduncle,perennial,perfect,petiole,petiolule,plant,proximal,pubescent,purple,reveal,rounded,seed,specimen,stamen,stigma,straight,style,terminal,testal,thick,throughout,tip,tuber-bearing,wall,Â¼	-8,1.8-2.7,1.8-3.9,10-24,14-48,3-,3-6-foliat,4-3.,4.5-10.1,6-7,6.2-12.5,abaxiall,apical,apically,connate,dehiscent,diminishing,dorsally,eaf,edge,eed,flat,folded,globo,gradually,interjected,introrse,lon,lower,lunat,maturing,nflorescence,nther,often,orolla,pair,plan,poricidally,rotate,ruit,sessile,seudostipule,short,size,slit,subequal,subsessile,tal,tem,throughou,toward,typically,unit,vary,wide,yellow,ympodial	'hair-like,abaxial,adaxial,anther,arrangement,ba,branching,characteristic,colour,form,fruit,globose,growth,height,history,inflorescence,length,life,lunate,margin,mentioned,midvein,ovary,primary,pseudostipule,rachi,shape,staman,stem,surface,tertiary,texture,unarmed,vein,venation
14	wfo-0001025792	success	203	147	115	88	32	0.567	0.4-0.7,1-10,1-2,1-3,10-15,2-11,2-3,2.5-3.5,21-28,4-12,4-6,5,5-10,7.5-8,8-10,9-12,abaxially,acuminate,acute,adaxially,anther,apart,apex,apparently,articulated,articulation,auriculate,axe,axillary,base,berry,blue-mauve,blue-purple,brownish,bud,cell,cm,condition,corolla,covering,dark,densely,diameter,distal,distinct,distinctly,drying,elliptic,filament,flower,forked,fresh,fruit,generally,glabrous,globose,green,green-white,greenish,hair,hair-like,half,herb,high,indistinct,interjected,lanceolate,lateral,leaflet,like,lobe,long,make,margin,mauve,minute,mm,mucilaginous,narrowly,oblique,odd-pinnate,ovoid,papillose,pedicel,peduncle,perfect,petiole,plant,plurifoliate,proximal,pubescent,purple,rachi,ripe,rounded,seed,shortly,slightly,spaced,stem,streak,style,subtending,terminal,testal,thick,throughout,tinged,tri-,unit,usually,wall,wet,white,whitish	1-4,2-3.5,2.5-4,3-4,3-5,3.5-6,4.5-7,5-6,5-9,5-merou,7-10,acumen,ag,along,alyx,basiscopic,blade,broadly,capitat,chartaceous,ciliate,connivent,decurrent,developing,digestion,dorsally,eaf,edge,eed,enzyme,especially,exceeding,except,flat,folded,geminat,glabrou,greatly,hal,homostylous,honeycomb-shaped,lengthening,living,lower,membranous,midrib,minutely,mottle,narrow,nflorescence,often,onto,orolla,pair,petiolulate,pore,poricidal,puberulent,reduced,removed,rotate-pentagonal,ruit,semi-erec,semi-rosette,sessile,seudostipule,short,side,size,slit,specimen,stamen,ste,stigma,straight,sub-rosette,subequal,tall,tamen,tem,tip,tube,vary,wing,x,yellow,ympodial,young	abaxial,adaxial,arrangement,branching,calyx,characteristic,colour,form,geminate,growth,height,history,inflorescence,leaf,length,life,mentioned,midvein,mottled,ovary,primary,pseudostipule,shape,staman,surface,sympodial,tertiary,texture,true,unarmed,vein,venation
15	wfo-0001025804	success	155	150	117	38	33	0.755	.25,0.5-1,1-1.5,1-3,1.2-1.5,1.4-1.7,1.5-2,11-20,16-35,2-2.5,2.5-4,3-4.5,4-10,5,6-8,7-10,abaxially,acute,adaxially,anther,anthesi,apex,attenuate,bark,base,berry,bilobed,calyx,clavate,cm,conical,corolla,covered,cream,cucullate,dark,decurrent,deflexed,densely,dia,differing,difoliate,drying,ellipsoid,elliptic,erect,exserted,filament,flattened,fleshy,flower,free,fruiting,glabrous,glandular,globose,green,incrassate,internodal,later,lateral,leaf,light,lobe,lobed,long,main,major,margin,middle,minor,minute,minutely,mm,nearly,obovate,occasionally,older,onto,opposite,ovary,pair,paler,papillae,papillate,pedicel,pitted,plurifoliate,poricidal,portion,red,reddish-brown,regularly,reniform,scar,sessile,shrub,size,somewhat,spaced,stem,stigma,strongly,style,surface,thick,tip,tube,vein,white,whitish-green,widest,wing,winged,woody,x,young	.5,10-20,3.5-12,?,age,apar,ape,apiculate,ba,branched,c.,eaf,edicel,eed,geminat,lengthening,lower,many,mere,near,nflorescence,often,papillat,papillose,planar,pore,projection,red-papillose,reddish-brow,rim,ruit,slit,tall,time,tub,ud,unit,ympodial	abaxial,adaxial,apart,arrangement,branching,bud,characteristic,colour,diameter,form,fruit,geminate,growth,height,history,inflorescence,length,life,midvein,null,peduncle,petiole,plant,primary,pseudostipule,rachi,seed,shape,staman,tertiary,texture,unarmed,venation
16	wfo-0001025813	success	197	146	112	85	34	0.569	1-1.5,1-10,1-2,1-4,1.5-1.8,1.5-2,15-30,2-3,3-3.5,3-4,3-5,3-6,3-7,5-6,6-7,abaxially,acuminate,acute,adaxially,anther,apart,apex,apparently,articulated,axe,base,berry,blue,broadly,brownish,cell,cm,condition,contracted,corolla,covering,dark,decurrent,densely,diameter,distal,distinct,drying,elliptic,exceeding,filament,flower,fresh,fruit,glabrous,globose,green,green-white,greenish,hair,half,herb,highly,lanceolate,lateral,leaflet,light,like,lobe,long,longer,make,margin,mm,monochasium,mucilaginous,near,obtuse,odd-pinnate,often,ovoid,pedicel,peduncle,perfect,petiole,pilose,plant,plurifoliate,pubescent,rachi,rarely,seed,single-flowered,sometimes,spaced,species,stamen,stem,straight,strongly,style,suborbicular,terminal,testal,thick,throughout,tri-,typically,unforked,unit,unwinged,vein,violet,wall,wet,white,whitish	'',0-2,0.7-1.7,1.2-4.5,1.3-7,1.5-6.5,2-4,2-5,5-18.5,5-merou,``,absent,acumen,ag,along,alyx,blade,borne,chartaceous,ciliate,connivent,cuneate,decreasing,digestion,discussion,dorsally,eaf,edge,eed,end,enzyme,especially,extra,flat,folded,geminat,glabrou,hair-like,homostylous,honeycomb-shaped,interjected,larger,lengthening,living,lower,membranous,midrib,minute,minutely,nflorescence,orbicular,orolla,ovate,ovoi,pair,petiolulate,pore,poricidal,puberulent,removed,rosette-formin,rotate,ruit,see,sessile,seudostipule,short,singly,size,slit,specimen,ste,stigma,stolo,tamen,tem,thir,tip,toward,tube,tuber,vary,x,yellow,ympodial	'extra,'hair-like,abaxial,adaxial,arrangement,branching,calyx,characteristic,colour,form,geminate,growth,height,history,inflorescence,leaf,length,life,midvein,null,ovary,primary,pseudostipule,rosette-forming,shape,staman,surface,sympodial,tertiary,texture,third,true,unarmed,venation
17	wfo-0001025825	success	187	127	95	92	32	0.508	0.4-1,0.5-10.4,1-2,1-5.5,1.1-1.4,10-24,2-3.7,2-5,22-86,3-10,3-5,4-8,4-9,5-10,acuminate,acute,anther,apart,apex,apparently,articulated,asymmetric,attenuate,axe,axillary,back,base,basiscopic,berry,brownish,bud,cell,cm,condition,coriaceous,corolla,covering,dark,diameter,distal,drying,elliptic,filament,flower,forked,fresh,fruit,glabrescent,glabrous,green,green-white,greenish,hair,half,herb,high,lanceolate,lateral,leaf,light,lilac,lobe,long,make,medium,mm,mucilaginous,odd-pinnate,ovate,ovoid,pedicel,peduncle,perfect,petiole,plant,rachi,rounded,seed,shiny,short,side,spaced,streak,style,subtending,terminal,testal,thick,throughout,tissue,usually,wall,wet,white,whitish	0-0.21,0.4-3,0.5-0.8,0.7-2.2,0.9-2,0.9-4,1-3,10.5-26,14-85,3-8.5,3.7-6.5,5-7,5-merou,6-10,6.6-14,abaxially,acumen,adaxiall,adaxially,ag,alyx,blade,capitat,clavate,connivent,cuneate,decreasing,decurrent,digestion,dorsally,eaf,edge,eed,enzyme,erec,exceeding,flat,folded,geminat,generally,glabrou,hair-like,hal,homostylous,honeycomb-shaped,increasing,interjected,leaflet,lengthening,living,lower,middle,nflorescence,orbicular,orolla,pair,pentagonal,petiolulate,plurifoliate,pore,poricidal,removed,rotate-pentagonal,ruit,sessile,seudostipule,size,slightly,slit,smaller,specimen,stamen,stigma,straight,subequal,subglabrou,tall,tamen,tem,tip,toward,tri-,tube,unit,unwinged,vary,wide,wing,winged,x,yellow,ympodial	'hair-like,abaxial,adaxial,arrangement,branching,calyx,characteristic,colour,form,growth,height,history,inflorescence,length,life,margin,mentioned,midvein,ovary,primary,pseudostipule,shape,staman,stem,subglabrous,surface,tertiary,texture,true,unarmed,vein,venation
18	wfo-0001025838	success	217	151	126	91	25	0.581	-20,.5,0.5,0.5-1,0.7-2,1-1.2,1.5-2,1.5-2.5,1.5-3.5,1.5-5,1.8-2,10-15,10-60,2-2.5,2.5-3,20-40,4-15,4.5-5.5,6.5-7,acuminate,adaxial,adaxially,along,anther,apex,apiculate,appearing,articulated,attenuate,axil,base,berry,black,branched,brown,calyx,cell,cm,corolla,decurrent,dendritic,dense,densely,diameter,disintegrating,elliptic,entire,erect,extending,filament,flattened,fleshy,flower,fruit,glabrescent,glabrous,globose,greenish,growth,hairy,inflorescence,inserted,keeled,lamina,lanceolate,lateral,leaf,like,lobe,long,many,margin,membranous,midrib,minutely,mm,narrowly,never,nodding,occasionally,often,onto,pair,pale,pedicel,peduncle,per,petiole,pitted,primary,pubescent,purple,quadrate,reddish,reniform,revolute,ripe,seed,short,shrub,simple,sleeve,slender,slightly,small,sometimes,sparsely,square,stem,strongly,style,surface,terminal,testal,time,tinged,tip,tree,trichome,tuft,vein,wall,white,winged,x,yellow	1-1.5,1.2-5,1.5-1.7,2-5,2/3,3.5-,5,5-merou,6-15,abruptly,ag,alyx,anthesi,apart,archin,ark,basall,branch,broad,capitate,clavate,clustered,connivent,cucullate,cup-shaped,dark,denser,drying,eaf,eed,ellipsoidal,exserted,free,fruiting,ilament,insertion,irregularly,lengthening,less,lobed,loosely,lower,m.,minute,mostly,narrowing,new,nflorescence,older,orolla,ovoid,papillat,papillo,perfect,pericarp,platform,plurifoliat,point,pointed,pore,poricidal,portion,ruit,scar,shin,shiny,sinus,slit,spaced,spreading,stellate,stigma,tall,tem,thi,thin,tube,turbinate,twinin,ud,uniseriate,unit,upper,vary,way,weight,wing,woody,yellowish,ympodial,Â¾	abaxial,arching,arrangement,branching,characteristic,colour,form,height,history,length,life,mentioned,midvein,ovary,papillate,plant,pseudostipule,rachi,shape,staman,tertiary,texture,twining,unarmed,venation
19	wfo-0001025845	success	180	144	113	67	31	0.628	.5,0.3-0.5,0.4-1.5,0.5-11,0.5-2.5,1-1.8,1-2,1-4.5,1.5,1.5-2,1.5-2.5,1.5-7,2,2-3,2-5-lobed,2.5-4,3-13,3-6,4-5,4-6,5-6,6-6.5,6-9,7-10,abaxially,abundantly,acuminate,adaxial,adaxially,aggregate,along,anther,apart,apex,articulated,axe,base,branch,brown,calyx,cell,cm,compressed,corolla,cuneate,cylindrical,dark,decurrent,diameter,eglandular,ellipsoidal,entire,especially,extra-axillary,filament,flattened,flower,fork,fruit,glabrous,green,greenish,herb,laterally,leaf,light,lobe,lobed,located,longitudinal,major,margin,membranaceous,mesocarp,minutely,mm,obtuse,often,orange,ovoid,pedicel,peduncle,perfect,petiole,pinnately,puberulent,pubescent,purple,rachi,radiu,rarely,rugose-verrucate,sand-punctate,shrub,side,simple,spaced,sparsely,stone,stripe,style,subcordate,thick,truncate,unbranched,unit,unlobed,vein,veiny,white,wide,x,yellow	1,1.5-13,2-15,3,3-4,3-foliat,acute,apiculate,around,ascending,ba,blade,channe,chartaceous,connivent,deltate,diamete,directed,distall,distally,divided,eaf,eed,elliptic,free,glabrou,inserted,lateral,long,lower,midrib,narrowly,near,nearly,nflorescence,obovate,orolla,ovate,part,patch,pore,rotate-stellate,rounded,ruit,sagittate,shorter,sinus,small,stigma,strongly,tal,tamen,tapered,tem,terminal,thecae,tightly,time,tip,tomento,triangular,truncat,tube,vary,yellowish,ympodial,youn	3-foliate,abaxial,arrangement,branching,channel,characteristic,colour,form,growth,height,history,inflorescence,length,life,midvein,null,ovary,plant,primary,pseudostipule,seed,shape,staman,stem,surface,sympodial,tertiary,texture,true,unarmed,venation
20	wfo-0001025850	success	197	173	142	55	31	0.721	-5,-7,.5,.8,0.5,0.5-,0.5-1,0.5-3,0.6-1,1,1-1.5,1-3,1-celled,1.5,1.5-5,15-20,2,2-12,2-6.5,30,4-5,6-7,abaxial,acute,along,anther,anthesi,apex,apparently,articulated,axi,basal,base,berry,branched,broadly,brown,calyx,cell,cm,corolla,deciduous,deltate,denser,diameter,divaricate,divided,drying,elliptic,elongate,entire,filament,flattened,fleshy,flower,free,glabrous,gland,glandular,globose,green,growth,half,halfway,inflorescence,irregularly,lamina,later,lateral,lax,leaving,less,lobe,lobed,long,many,margin,membranous,midrib,minutely,mm,narrowly,new,nodding,node,occasionally,often,openly,orange,outline,pair,pale,pedicel,peduncle,peg,per,petiole,pinnatifid,pitted,plurifoliate,portion,primary,pubescent,reddish,reniform,rhomboid,ripe,rounded,scar,scattered,shallowly,shiny,shrub,simple,sinuate,sinus,sleeve,slender,slightly,small,soon,spaced,splitting,stem,style,surface,tan,terminal,testal,thin,time,tiny,tip,trichome,truncate,uniseriate,unit,vein,vine,white,woody,x	3-4,5-7,5-merou,ag,alyx,apar,ark,capitate,connivent,cupped,cyathiform,deflexed,densely,eaf,eed,ellipsoid,em,erect,exserted,extending,fruiting,geminat,glabrou,ilament,lengthening,loosely,lower,minute,nearly,nflorescence,older,orolla,papillate-puberulent,papillo,perfect,planar,pore,poricidal,puberulen,ruit,slit,sometimes,spreadin,spreading,stellate,stigma,strongly,surfac,tube,twinin,ud,vary,yellow,ympodial,young	.5-2,adaxial,apart,arrangement,branching,characteristic,colour,form,fruit,geminate,height,history,leaf,length,life,midvein,null,ovary,plant,pseudostipule,puberulent,rachi,seed,shape,staman,sympodial,tertiary,texture,twining,unarmed,venation
21	wfo-0001025872	success	160	143	112	48	31	0.7	.5,0.25-0.5,0.5-1,0.6-1,1-1.3,1-1.5,1-2,1.2-1.6,10-25-flowered,2-2.5,2-5,3.5-4,4-4.5,6-10,6-8,acute,along,anther,anthesi,apex,auriculate,bark,base,becoming,beneath,berry,branched,bright,brownish,calyx,capitate,cm,coriaceous,corolla,crinkled,crowded,dark,decurrent,deeply,deflexed,dense,densely,dia,dry,elliptic,filament,flattened-reniform,fleshy,flower,free,glabrous,glandular-resinous,globose,green,greenish-tan,incrassate,junction,later,lateral,leaf,live,lobe,long,main,margin,material,midrib,minutely,mm,narrowly,occasionally,often,older,onto,opposite,ovary,pair,paler,papillose,pedicel,petiole,pitted,plant,portion,prominent,pubescent,red-papillose,revolute,rounded,rounded-triangular,several,shrub,simple,somewhat,specimen,stem,stigma,style,surface,tall,terminal,thick,thickened,time,tube,uniseriate,unit,vein,visible,white,x,young	.1,0.5,1,1.2-1.5,1.7-3,2/3,4.5-13,apart,apically,ba,beginning,blade,broadly,cup-shaped,eaf,edicel,eed,exserted,flattened,fruiting,grayish-brow,inflorescenc,irregularly,lobed,lon,lower,nflorescence,papillae,papillo,planar,plurifoliat,pore,poricidal,ruit,scar,shaped,soon,spaced,straight,tapering,tear-drop,tip,trichome,tub,ud,way,woody,ympodial	abaxial,adaxial,arrangement,branching,characteristic,colour,diameter,form,fruit,grayish-brown,growth,height,history,inflorescence,length,life,mentioned,midvein,peduncle,plurifoliate,primary,pseudostipule,rachi,seed,shape,staman,sympodial,tertiary,texture,unarmed,venation
22	wfo-0001025893	success	157	130	100	57	30	0.637	.25,.4,.5,0.5-1.5,0.8-1,1-1.2,1-1.5,1-2.5,1-4,1.5-2,2-2.5,2-3,3-5,5-6,6-10,along,anther,anthesi,apex,attenuate,barely,base,bearing,beneath,berry,branched,broadly,brownish-green,calyx,cm,corolla,cup-shaped,decurrent,deflexed,deltoid,densely,dia,difoliate,dry,elliptic,filament,flower,free,fruit,geminate,glabrate,glabrous,globose,golden-puberulent,green,impressed,internodal,lateral,leaf,lobe,long,long-acuminate,main,many,margin,minutely,mm,narrowly,obovate,occasionally,older,opposite,ovary,ovoid-reniform,pair,pale,pedicel,petiole,pitted,portion,puberulent,red-papillose,scar,shrub,slender,sometimes,specimen,stem,style,surface,tapering,time,tip,trichome,tube,unicellular,unit,usually,vein,visible,white,winged,x,yellowish,young	1.5-1.7,11-20,accrescent,bank,bark,beginning,bi-lobed,blade,capitate,closely,eaf,early,eed,ellipsoid,erect,even,exserted,faintly,fruiting,gravelly,greyish,growing,inflorescenc,lobed,lon,longitudinally,lower,material,middle,nearly,nflorescence,overlapping,papillo,papillose,planar,plurifoliat,pore,poricidal,reflexed,river,rocky,ruit,sandy,shaped,slightly,spaced,stigma,straight,stream,striat,tall,tear-drop,thickened,ud,widest,woody,ympodial	abaxial,adaxial,arrangement,branching,characteristic,colour,diameter,form,growth,height,history,inflorescence,length,life,mentioned,midvein,peduncle,plant,plurifoliate,primary,pseudostipule,rachi,seed,shape,staman,sympodial,tertiary,texture,unarmed,venation
23	wfo-0001025896	success	146	139	106	40	33	0.726	-3,-30,.5-2.5,0.5,0.5-2,1-1.5,1-25,1-3,1-6.5,1-8,1.5-2,1.5-9,10-15,2-14,2-2.5,2.5-14,2.5-5,4,4-23,4-5,4-6,5-15,6-10,7-,7743,abaxial,acosta,acuminate,acute,adaxially,aggregate,also,angled,apart,apex,articulated,axe,base,blade,brownish,calyx,cell,chartaceous,cm,constricted,cuneate,cylindrical,deltate,densely,diameter,eglandular,elliptic-ovate,entire,flower,forked,fruit,glabrous,gland,globose,hair,inflated,like,lobe,long,margin,mm,moderately,nearly,obtuse,often,orange,ovate,pale,pedicel,peduncle,perfect,petiole,pubescent,purple,rachi,radiu,red,ripe,rugose,short-stalked,shrub,simple,smooth,solÃ­,spaced,stalked,stem,stone,style,subcordate,surface,time,tip,triangular-subulate,tube,unbranched,unit,vein,white,wide,x	10-25,4-12,5-7,6-13,abaxially,absen,adaxiall,ba,branched,connivent,dendritically,directed,distall,eaf,eed,especially,greenish,lower,many-foliat,membranaceous,near,nflorescence,nther,occasionally,orolla,pore,present,puberulent,pubescen,rotate-stellate,ruit,sparsely,stigma,tal,tem,triangular-ovate,truncat,vary,yellow,ympodial	absent,adaxial,anther,arrangement,branching,characteristic,colour,corolla,filament,form,growth,height,history,inflorescence,leaf,length,life,many-foliate,midvein,null,ovary,plant,primary,pseudostipule,seed,shape,staman,sympodial,tertiary,texture,true,unarmed,venation
24	wfo-0001025902	success	211	198	169	42	29	0.801	.5,0.1-0.5,0.5-2,0.5-2.5,1-1.2,1-1.5,1.2-1.5,1.5,1.5-2,1.5-3,1/3,11-15,1983,2-6,2.5-4,4,4-13,4-5,4-6,40,5-6,8-15,>,absent,accompanied,acute,adaxially,aid,along,always,anther,anthesi,apex,articulated,attenuate,axi,base,becoming,beginning,berry,black,branch,branched,branching,broadly,cabrera,calyx,cell,chartaceous,circular,clavate,cm,completely,conical,connivent,corolla,deltate,densely,diameter,dull,either,ellipsoid,entire,except,fide,filament,flattened-reniform,fleshy,flower,free,fruiting,glabrous,globose,green,growth,inflorescence,lanceolate,lateral,leaf,leaf-opposed,leaving,length,lengthening,less,linear,lobe,lobed,long,loosely,low,lower,margin,markedly,mature,minutely,mm,new,obscured,occasionally,often,one,ovary,pair,pale,papillose,pedicel,peduncle,peg,pendant,per,pericarp,petiole,pitted,plurifoliate,pore,poricidal,portion,primary,prominent,pubescent,revolute,ridged,rounded,scattered,scrambling,semi-circular,shallow,simple,sleeve,slender,slit,small,sometimes,somewhat,soon,sparsely,spreading,stem,stigma,strongly,style,surface,tangled,tapering,terminal,testal,thin,time,tip,trichome,twining,ultimate,uniseriate,unit,usually,vegetation,vein,vine,violet,water,weak,weight,whitish,wing,woody,x,yellow,yellowish,Â½	.2,/2,3-10,5-merou,8-10,8-9,abaxially,ag,alyx,apar,ark,bark,berr,c.,climbin,deciduou,eaf,eed,exfoliatin,exserted,geminat,ilament,midvei,minute,nflorescence,older,orolla,papillat,perfect,planar,rotate-stellate,ruit,scar,semi-aquati,spaced,tem,tube,ud,vary,way,widely,ympodial	abaxial,adaxial,age,arrangement,characteristic,climbing,colour,deciduous,form,fruit,geminate,height,history,life,midvein,null,papillate,plant,pseudostipule,rachi,seed,semi-aquatic,shape,staman,sympodial,tertiary,texture,unarmed,venation
25	wfo-0001025906	success	188	142	108	80	34	0.574	0.1-2,0.20-0.60,1-2,1-6,1.1-2,1.6-12.4,16-51,2-4.4,2-6,3-10,3-5,4-12,4-5,4-7,5-6,5-7,8.5-12.5,abaxially,acute,adaxially,anther,apart,apex,apparently,articulated,axe,axillary,base,berry,blue,brownish,bud,cell,cm,condition,coriaceous,corolla,covering,cuneate,dark,decurrent,diameter,distal,drying,exceeding,filament,flower,forked,fresh,fruit,generally,glabrous,globose,green,green-white,greenish,hair,half,herb,high,lanceolate,lateral,leaf,light,lilac,linear,lobe,long,make,mm,mucilaginous,obtuse,odd-pinnate,ovoid,pedicel,peduncle,perfect,petiole,plant,plurifoliate,pubescent,purple,rachi,ripe,seed,shiny,short,slightly,spaced,sparsely,stamen,straight,stripe,style,sub-glabrous,subglabrous,subtending,terminal,testal,thick,throughout,tri-,unit,usually,wall,wet,white,whitish	0-14,0.15-0.6,0.2-0.6,1-3,1.8-4.8,2.6-5.2,4-10,5-merou,5.2-9,8-16,acumen,adaxiall,ag,alyx,blade,capitat,clavate,connivent,decreasing,decurrency,delimited,digestion,diminishing,dorsally,eaf,edge,eed,enzyme,erec,falcate,first,flat,folded,geminat,glabrou,hair-like,hal,homostylous,honeycomb-shaped,interjected,leaflet,lengthening,living,lower,next,nflorescence,orolla,pair,pentagonal,pore,poricidal,removed,rotate,ruit,second,sessile,seudostipule,size,slit,smaller,specimen,stigma,subequal,subglabrou,tall,tamen,tem,third,tip,toward,tube,typically,unwinged,vary,well,width,wood,x,yellow,ympodial	'hair-like,abaxial,adaxial,arrangement,branching,calyx,characteristic,colour,form,geminate,growth,height,history,inflorescence,length,life,margin,midvein,null,ovary,primary,pseudostipule,shape,staman,stem,surface,sympodial,tertiary,texture,true,unarmed,vein,venation,woody
26	wfo-0001025907	exception_thrown	148	0	0	148	0	0.0		-4,.05,.5,.5-1,0,0-60,0.8-1.8,1,1-1.2,1-2.3,1-3,1-5,1.5-2,1.5-2.2,10-15,12-45,2,2-3.5,2-8,2/3,3-,3-4,3/2,4-5,5-15,absent,acuminate,acute,along,anther,anthesi,anthesis5-7,anticlinal,apex,appearing,attenuate,axil,axillary,base,beak,bearing,berry,breaking,brown,c,calyx,cell,clavat,cm,conical,conspicuously,deciduous,densely,diameter,eaf,edicel,eed,elliptic,epidermal,erec,filament,flattened,flower,free,fruit,fruiting,glabrous,globose,green,greenish,growth,highly,included,iquito,irregular,isolated,lamina,lobe,lobed,lon,long,lower,margin,minutely,mm,near,nearly,new,nflorescence,obovate,occasionally,open,ovary,ovoid-reniform,pair,papillate,papillose,pedicel,per,petiole,plant,population,poricidal,portion,primary,projection,pubescent,raised,red-papillate,reflexed,remaining,round,rugose,ruit,scar,scattered,seed,shrub,simple,single-stemmed,sinuous,size,slender,soon,sparsely,stigma,style,surface,tal,tem,thickening,time,tip,trichome,truncate,tub,tube,ud,unifoliat,uniseriate,unit,variable,vein,white,white-lenticellate,without,x,ympodial	
27	wfo-0001026203	success	197	117	85	112	32	0.431	0.06-0.86,0.3-11,0.38-11.3,0.4-3,0.5-2.3,1-13,1-2,1-9,2-10,2-4.9,3-10,3-11,7-47,abaxially,acuminate,acute,adaxially,anther,apex,asymmetric,attenuate,base,basiscopic,berry,blue,brownish,cell,cm,condition,coriaceous,corolla,covering,dark,deep,diameter,drying,elliptic,filament,fresh,fruit,glabrescent,glabrous,globose,green,green-white,greenish,hair,herb,lanceolate,lateral,leaf,light,lilac,lobe,long,make,medium,mm,mucilaginous,odd-pinnate,ovate,ovoid,pedicel,peduncle,petiole,plant,rachi,ripe,rounded,seed,sessile,short,side,sometimes,stripe,style,subglabrous,testal,thick,throughout,tissue,wall,wet,white,whitish	0-39,0-7,0.3-6,0.5-3.2,0.7-2.6,1-4,1-5,1.1-7.9,1.2-5.5,2-43,2-5,2-8.5,2.2-13.3,3-5,3.2-22,3.2-23,5-merou,acumen,ag,along,alyx,apart,apparently,arranged,articulated,axe,axillary,bead,blade,bud,capitat,clavate,connivent,decreasing,decurrent,digestion,distal,dorsally,eaf,edge,eed,enzyme,erect,exceeding,flat,flower,folded,forked,geminat,generally,glabrescen,glabrou,hair-like,hal,half,high,homostylous,honeycomb-shaped,interjected,leaflet,lengthening,like,linear,living,lower,middle,moniliform,multiple,necklace,nflorescence,orbicular,orolla,pair,pentagonal,perfect,plurifoliate,pore,poricidal,removed,rosett,rotate,ruit,seudostipule,size,slightly,slit,spaced,specimen,stamen,stigma,stolon,straight,subequal,subtending,tall,tamen,tem,terminal,tip,toward,tri-,tube,tuber,typically,unit,unwinged,usually,vary,wide,x,yellow,ympodial	'hair-like,abaxial,adaxial,arrangement,branching,calyx,characteristic,colour,description,form,growth,height,history,inflorescence,length,life,margin,mentioned,midvein,ovary,primary,pseudostipule,shape,staman,stem,surface,tertiary,texture,true,unarmed,vein,venation
28	wfo-0001026208	success	214	135	114	100	21	0.533	-3,0-4,0-5,0.5-1.2,0.6-0.8,0.6-0.9,0.7-2,0.8-1.5,1-2,1-5,1.8-2.3,1.8-2.5,2,2-20,2-4,2.5-6,3-5,3.5-5,4-7,5,5-22,abaxial,acuminate,acute,adaxial,anther,apex,apically,apparently,articulated,base,berry,branched,bright,calyx,cm,cuneate,dark,deltate,densely,diameter,difoliate,dull,elliptic,erect,evenly,filament,flattened-reniform,flower,fruit,geminate,glabrous,green,green-brown,lateral,leaf,length,lobe,lobed,long,lower,margin,maturity,mauve,midvein,mm,moderately,one,open,orange,orange-brown,ovate,pair,pale,pedicel,peduncle,petiole,porrect,prickle,prickly,primary,recurved,red,rounded,sessile,shrub,side,slender,sometimes,somewhat,sparsely,spherical,stalked,stellate,stellate-pubescent,stem,stout,straight,style,surface,terete,terminal,tertiary,time,toward,trichome,unarmed,vein,venation,visible,white,wide,yellow,young	-1/2,-10,-5,.5,/3,0,0-20,0-8,0.1,0.1-0.2,0.1-0.25,0.1-0.3,0.5-0.8,0.8-1.3,1-4,1.5,1.5-2.5,1/3,1/4-1/3,1/4-1/6,11-25,2-3,2.5-5,3-30,3-6,3/,4-9,5-,5-17,5-merous,6-22,6-8,abaxially,acut,alyx,apar,apart,bark,becoming,blade,broad-deltate,brown,chartaceous,conical,connivent,curved,discolorous,distance,drying,eaf,eed,elongated,elongating,equal,extending,flattened,free,fruiting,geminat,glabrescent,gray-greenish,infructescence,longer,mature,membranous,midpoint,nflorescence,older,orolla,oung,pendulous,per,perfec,pericarp,poricidal,portion,pubescent,ray,red-brow,ruit,scar,shorter,smooth,spaced,spreading,stalk,straw-yellow,subentire,tamen,tapering,tip,tube,unarme,unit,usually,variously,vary,way,woody,ympodial	3/4,arrangement,branching,characteristic,colour,corolla,form,growth,height,history,inflorescence,life,null,ovary,plant,pseudostipule,rachi,seed,shape,staman,texture
29	wfo-0001026215	success	150	133	104	46	29	0.693	-3,.05,.5,0,0.05,0.5-1,1,1-3,1.5,1.5-2,1.5-2.2,18-20,2,2-3,2-3.5,2-4,4-5,7-8,abruptly,acuminate,along,anther,anticlinal,apex,axil,axillary,base,beak,berry,broadly,brown,calyx,cell,cm,completely,conical,continually,corolla,deltate,densely,diameter,elliptic,entire,epidermal,filament,flattened-round,flower,fruit,glabrous,green,greenish,herb,highly,horizontal,irregular,kink,length,less,lobe,long,marked,minutely,mm,narrowing,nodding,occasionally,onto,ovary,ovoid-reniform,pair,papillae,papillate,pedicel,per,petiole,portion,primary,projection,purple,raised,red-papillose,rounded,rugose,scar,seed,shrub,simple,single-stemmed,sinuous,small,stem,strongly,style,surface,thickening,time,unit,vein,white,white-pubescent,wing,winged,without,x	13-35,15-2,3/4,4-15,abaxially,absent,anthesi,ape,bifi,clavate,conspicuously,eaf,edicel,eed,enlarged,erect,exserted,free,fruiting,globose,internode,lobed,lower,markedly,nearly,nflorescence,noddin,often,papillat,poricidal,reflexed,ruit,shortsympodial,ste,stigma,tal,tem,tip,tub,tube,ud,unifoliat,usually,way,white-lenticellate,wide	abaxial,adaxial,arrangement,branching,characteristic,colour,form,growth,height,history,inflorescence,leaf,life,margin,mentioned,midvein,peduncle,plant,pseudostipule,rachi,shape,staman,sympodial,tall,tertiary,texture,unarmed,unifoliate,venation
30	wfo-0001026229	success	299	271	215	84	56	0.719	0.35,0.3â0.9,0.4,0.8â1.2,0.9,1,1.2â4.8,1.4,1.7â11.8,1.8,13,1â4,2,2â3,3,35,3â5,5,abaxial,abaxially,accrescent,acuminate,acute,adaxial,adaxially,almost,also,always,anther,anthesi,apex,articulated,associated,asymmetric,attenuate-caudate,axe,barely,base,beneath,berry,black,blade,branch,branching,broadly,brown,calyx,camptodromous,capitate,celled,central,changing,clavate,cm,commonly,completely,concentrated,connivent,cordate,corolla,covered,cuneate,cylindrical,cyme,dark,deltoid,densely,developed,diameter,directed,discolorous,dried,drying,eglandular,ellipsoidal,elliptic,elongated,entire,faces,flattened,flower,found,free,frequently,fresh,fruit,geminate,glabrescent,glabrous,gland,glandular,glandular-capitate,globose,golden,green,growth,hair,head,hirsute,hispid,hyaline,immature,impressed,inflorescence,internodal,introrsely,involute,irregular,lamina,lateral,leaf,less,like,lobe,lobed,long,long-stalked,longer,longitudinal,margin,material,mature,membranaceous,midvein,minute,mixed,mm,moderately,much,multangulate,multangulate-stellate,multiseriate,narrowly,near,oblong,often,old,one,open,opening,orientation,other,ovate,ovate-elliptic,pair,pale,papillose,pedicel,peduncle,pedunculate,per,petiole,pink,pit,poorly,pore,poricidal,porrect-stellate,portion,primary,pubescent,purple,purplish,rachi,raised,ray,remnant,reniform,revolute,rounded,secondary,sessile,shiny,short-,short-stalked,shorter,shrub,simple,slightly,slit,small,smaller,sometimes,somewhat,sparsely,spread,spreading,stalk,stellate,stem,strongly,style,subopposite,subsessile,supported,surface,terminal,three,tree,trichome,trifoliate,tuft,type,unbranched,unequal,unit,upper,usually,vein,venation,visible,weakly,white,wide,yellow	0.1â1.47,0.2â0.8,0.3â1.2,0.8â2,0.9â4.3,1-celled,1.3â1.5,1.3â1.7,1.7â2.3,1.8â5.5,1.9â2.5,1/3,1â1.4,1â2,2.3â3.4,2.8â4,2â3-celled,2â4-celled,3â4,4.5â6.5,4â6,5-merou,5â9,6â15,6â7,6â8,8.6â12,8â10,9â31,adaxiall,ag,alyx,ark,ba,broken,commentary,creating,develope,differing,diÂ­,eaf,eed,even,few-rayed,fully,ilament,included,insertion,lanceolate,larger,lower,mainly,maturit,midpoint,midri,narrow-ovate,nearly,new,nflorescence,older,orolla,oung,paired,perfect,plurifoliate,point,ra,rarely,ruit,see,shin,size,solitary,spreadin,stigma,surfac,tube,ud,vary,vestiture,whitish-green,yellowish-white,ympodial,Â¾	--,0.1,0.3,0.8,1.2,1.3,1.47,1.5,1.7,1.9,10,12,15,2.3,2.5,2.8,3-celled,3.4,3/4,31,4,4-celled,4.3,4.5,5.5,6,6.5,7,8,8.6,9,age,arrangement,characteristic,colour,filament,form,height,history,length,life,maturity,midrib,null,ovary,plant,pseudostipule,seed,shape,staman,sympodial,tertiary,texture,true,unarmed,young
31	wfo-0001026230	success	144	126	97	47	29	0.674	.25,.5,.8,0.3-1.5,0.5-3,0.9-2,1-1.4,1-1.5,1-4,1.1-1.8,2-4,3-4,5-10,5-20-flowered,acuminate,acute,anther,anthesi,apex,apiculate,appears,back,base,beneath,berry,broadly,bud,calyx,clavate,cm,completely,cordate,corolla,deltoid,dia,distal,elliptic,enclosing,except,filament,free,fruit,glabrous,globose,green,grey,immature,large,lateral,leaf,lobe,lobed,long,long-acuminate,long-triangular,main,major,margin,minor,minutely,mm,nearly,obtuse,opposite,orbicular,ovary,pair,papillose,pedicel,petiole,pointed,portion,raised,reflexed,rounded,rusty-papillose,shrub,simple,sinus,slender,slightly,small,stem,style,surface,tapering,thickened,tip,tree,tube,umbonate,unknown,vein,white,winged,x,young	0.75-1,1.8-2.3,1.9-4.1,12.6-20.8,2-5,4.6-9.3,anisomorphic,anisophyllou,apart,area,bark,beginning,clu,coroll,deflexed,difoliate,eaf,edicel,eed,erect,evenly,fruiting,geminate,inflorescenc,lon,lower,middle,nflorescence,older,ovoid,pore,poricidal,ruit,scar,shaped,spaced,stigma,straight,strongly,tall,tear-drop,ud,unit,white-lenticellat,widest,woody,ympodial	abaxial,adaxial,arrangement,branching,characteristic,colour,diameter,form,growth,height,history,inflorescence,length,life,midvein,null,peduncle,plant,primary,pseudostipule,rachi,seed,shape,staman,tertiary,texture,unarmed,venation,white-lenticellate
32	wfo-0001026233	success	165	131	94	71	37	0.57	-1,-1.9,-3.8,-5.5,-50,-8.1,.25,.75,0.7-,0.7-0.8,0.8-1.3,0.8-1.55,0.8-4,1-,1.2-2.7,1.5,1/2,2,2-,2.1,2.3-7,2.4-3.5,2.6,2/3,3.5-4.5,4-,5-30,5-6.2,6,acute,annual,annular,anther,antrorse,apex,basal,base,bearing,berry,broadly,calyx,cm,coat,conspicuous,cuneate-attenuate,diameter,elliptic,embryo,entire,few-,filament,glabrous,globose,hair,herb,lamina,leaf,less,lilac,lobe,long,longitudinally,margin,mm,moderately,narrowly,non-glandular,obtuse,ovate,ovule,pale,petiole,pinnatisect,protuberance,pubescent,ridged,seed,shorter,simple,small,striate,style,subglobose,surface,trans-ovoidal,trichome,tube,tuberculate,unifoliate,uniseriate,unit,winged,x,yellow	0.3,0.5,1,1.1,3.2-3.7,3.2-4.7,abundant,accrescent,ag,articulated,ascending,campanulate,capitate,curved,cylindrical,densely,difoliat,dimorphic,eaf,eed,ellipsoidal,evident,fruiting,herbaceous,hig,interlobular,investing,larger,lobed,longitudinal,lower,membrane,minutely,multicellular,near,occasionally,opening,orolla,other,outer,papery-scarious,partially,pinnatipartite,pore,poricidal,portion,present,pubescen,ree,reticulate,rounded,ruit,scarcely,seede,serrate,slender,slightly,slit,smaller,sparsely,stigma,strongly,styl,tem,tip,unequal,vary,venatio,verrucose,wider,ympodial	abaxial,adaxial,arrangement,branching,characteristic,colour,corolla,dense,difoliate,form,fruit,growth,height,history,inflorescence,length,life,mentioned,midvein,ovary,pedicel,peduncle,plant,primary,pseudostipule,rachi,seeded,shape,sparse,staman,stem,sympodial,tertiary,texture,unarmed,vein,venation
33	wfo-0001026241	success	220	152	127	93	25	0.577	0.3â1,0.5,0.5â0.7,0.5â1,1-,1.5â1.7,1.9â2.1,1/3â1/2,10-20,109,1â1.1,1â1.4,1â1.5,1â2,2-flowered,2.5â3,2â2.1,2â3,30â50,3â3.1,4.5â5,5-celled,6,abaxially,adaxially,anther,anthesi,apex,appearing,appears,articulated,base,basiscopically,berry,black,branching,brittle,brown,calyx,cell,cm,conical,corolla,covered,curved,decurrent,densely,dia,dry,dwarf,eglandular,elliptic,entire,erect,erose,et,extended,filament,fruit,galiano,glabrous,glandular,glandular-pubescent,globose,herb,inflorescence,irregularly,leaf,like,lobe,lobed,long,margin,midvein,mixture,mm,near,oblique,orangish,outline,ovary,ovate,ovoid,papillate,pedicel,peduncle,per,perennial,petiole,pinnatifid,pitted,pubescent,pulp,rachi,remain,reniform,robust,seed,shallowly,shiny,simple,sinuate,slightly,somewhat,spatulate,stellate,stem,stout,strongly,style,subshrub,surface,taproot,ternate,testa,thickened,triangular,trichome,truncate,tuberculate,uniseriate,usually,vein,way,white,woody,x	.2,.3,.5,0.1â0.15,0.2â,0.3â,0.3â0.4,0.3â0.6,0.5â0.8,0.7â1.1,1-celled,1.2â1.5,1.2â2,1.5â2.5,1.5â3.5,1â,3,3-,4-,5,5-merous,always,apical,attenuate,ba,basal,beak,broader,campanulate,capitate,center,connecting,cordate,cup,curving,darker,deflexe,dehiscing,deltate,denser,depressed-globose,difoliate,discrete,drying,eaf,enclosed,equal,flower,foliat,foliose,free,fruiting,geminate,gland,internodal,intially,larger,lateral,leaflet,lon,longitudinal,main,much,nflorescence,one,onto,open,papillat,perfect,pericarp,pore,portion,prolonged,pubescen,ruit,slit,small,smaller,sometimes,stamen,stigma,succulent,sulcate,terminal,thick,tip,tissue,tube,ud,unit,wide,wing,ympodial	1â6,3-3.1,abaxial,adaxial,arrangement,characteristic,colour,diameter,form,growth,height,history,length,life,null,plant,primary,pseudostipule,shape,staman,tertiary,texture,true,unarmed,venation
34	wfo-0001026242	exception_thrown	210	0	0	210	0	0.0		-0.9,-1.5,-2,-5,-6,/4,0,0-2,0.05-0.2,0.1,0.3-0.5,0.35-,0.4-0.5,0.4-0.55,0.4-2,0.5,0.5-0.7,0.5-1,0.55-0.9,0.7,0.7-1.3,1-1.5,1-2.5,1-3,1.2-2,1.5-3,1.5-4,1/2,1/5-1/3,1/6-1/4,10-,10-20,2-2.5,2-5,2.5-2.8,2.5-4.5,3-6.5,30-80,4-10,4-13,4-5-merous,4.5-5.5,5-,5-18,5-7,6.5-8,7-17,8-20,abaxial,abaxially,acut,acute,almost,alyx,ame,anther,apar,apart,apex,apically,apparently,articulated,bark,base,berry,blade,branched,bright,broad-deltate,c.,calyx,cm,concolorous,connivent,cuneate,curved,deltate,densely,diameter,difoliate,distance,drying,dull,eaf,eed,elliptic,elongating,equal,erect,evenly,extending,eye,filament,filiform,flattened,flattened-reniform,flower,free,fruit,fruiting,geminat,glabrescent,glabrou,glabrous,glandular,green,green-gra,hair,infructescence,irregularly,largely,lateral,leaf,length,lobe,lobed,long,longer,lower,margin,mature,maturity,membranous,midpoint,midvein,minute,mm,moderately,multangulate,naked,narrow-deltate,nflorescence,obtuse,occasionally,older,one,open,orange-brown,orolla,oung,pair,pale,pale-brown,pedicel,peduncle,per,perfec,pericarp,petiole,poricidal,porrect,portion,prickl,prickle,prickly,primary,ray,recurved,red,red-brown,reflexed,rounded,ruit,scar,sessile,shorte,shorter,shrub,side,simple,smooth,sometimes,spaced,sparsely,spherical,spreading,stalk,stalked,stellate,stellate-pubescent,stem,straight,style,subentire,surface,tamen,tapering,terete,tertiary,time,tip,trichome,tube,unarme,unarmed,unit,upper,variously,vary,vein,venation,visible,way,weakly,white,wide,woody,yellow,ympodial,young	
35	wfo-0001026259	success	233	185	145	88	40	0.622	.1,.7,0404,1-celled,1.5,1m,2/3,6,?,abaxial,acuminate,acute,adaxial,affected,anther,anthesi,apex,appressed,arising,base,becoming,berry,branch,branched,branching,broadly,brown,calyx,cell,central,close,cm,coloured,concave-reniform,corolla,cylindrical,decurrent,dehiscing,deltate,densely,diameter,difoliate,drop,ellipsoid,end,entire,especially,et,filament,flower,fruit,fruiting,glabrous,gradually,green,green-orange,herb,hilum,individual,inflorescence,internodal,knapp,larger,lateral,leaf,length,less,like,lilac,lobe,long,margin,mm,much,narrower,narrowly,nearly,node,occasionally,often,once-branched,one,outline,ovary,ovate-lanceolate,pair,pathogen,pedicel,peduncle,pentagonal,per,pericarp,petiole,plant,positioned,primary,pubescent,purple,purple-black,purple-coloured,rachi,rarely,recurving,reflexed,relatively,remaining,ripe,rounded,shiny,shrub,similar,simple,smooth,sparsely,splitting,spreading,star,stem,stone,stout,straight,style,sub-laterally,surface,tall,tapering,testal,thick,tightly,tinged,together,toward,translucent,trichome,turning,two,uniseriate,vein,white,wide,winged,woody,yellow,yellow-green,young	.8,0.1â0.2,0.2â0.4,0.3â1.2,0.4â0.6,0.5,0.5â0.6,0.7â0.9,0â2,1,1.0â1.2,1.0â3.3,1.2â8.4,1.4â4.0,1.5â2.0,11â22,12â24,1â2,1â2-celled,1â3-celled,2-ridged,2â17,2â3-celled,3.0â3.4,35â45,4â5,5-merous,5â14,5â7-celled,7â10,8â11,abaxially,adaxially,age,apar,beyond,cone,congested,conical-ellipsoid,cream-coloured,eaf,eed,elongating,exerted,fleshy,free,geminat,globose,growt,halfway,leave,lengthening,live,lobed,lon,longer,lower,lowermost,membranous,minutely,near,nflorescence,pale,papillate,perfect,pore,poricidal,portion,reduced,ruit,scar,short,shorter,slightly,slit,sometimes,somewhat,spaced,stellate,stigma,strongly,tem,tip,tube,ud,unit,ympodial,â15	0.1-0.2,0.2-0.4,0.3-1.2,0.4-0.6,0.5-0.6,0.7-0.9,1-2-celled,1-3-celled,1.0-1.2,1.0-3.3,1.4-4.0,1.5-2.0,11-22,12-24,2-3-celled,2.8,3.0-3.4,35-45,5-14,7-10,8-11,arrangement,characteristic,colour,form,growth,height,history,life,midvein,null,pseudostipule,seed,shape,staman,tertiary,texture,true,unarmed,venation
36	wfo-0001026267	success	162	171	139	23	32	0.858	.25,.5,0.1-1,0.5-1,0.6-1.7,0.7-1.1,1-1.2,1-1.5,1-2.6,1.5-2,1.5-2.3,2.5-3,20-30-flowered,3-15,4-8,5-7,8-10,acuminate,acute,anther,anthesi,apex,attenuate,axil,bark,base,beginning,beneath,berry,blackish,body,bright,broadly,calyx,closely,cm,corolla,crateriform,cuneate,decurrent,deflexed,densely,depressed,dia,difoliate,distally,distinct,drying,except,filament,flattened-reniform,free,fruiting,glabrous,globose,green,greenish-white,greyish-green,hard,incrassate,larger,lateral,lavender,leaf,lobe,lobed,long,main,major,margin,maturity,middle,minor,minutely,mm,narrowly,nearly,occasionally,often,older,opposite,ovary,ovate,overlapping,pair,pale,papillose,pedicel,petiole,pitted,pitting,pore,poricidal,portion,pubescent,quickly,raised,reflexed,remaining,ripening,rough,scar,scarious,scattered,shaped,shrub,simple,slender,slightly,small,softening,spaced,sparsely,stem,stigma,straight,style,surface,tan,tapering,tear-drop,tinge,tip,tree,triangular,trichome,tube,tuft,uniseriate,unit,vein,white,widest,wing,winged,woody,x,yellow-green,young	1-4,3-6.1,3.2-8.6,8.5-15,ba,differing,eaf,edicel,eed,exerted,geminat,inflorescenc,lon,longinflorescence,lower,one,papillo,ruit,size,soon,tall,ud,ympodial	abaxial,adaxial,arrangement,branching,characteristic,colour,diam,diameter,form,fruit,geminate,growth,height,history,inflorescence,length,life,midvein,null,peduncle,plant,primary,pseudostipule,rachi,seed,shape,staman,sympodial,tertiary,texture,unarmed,venation
37	wfo-0001026279	success	248	165	142	106	23	0.573	-11.4,-2.9,-34.3,-5.9,/14-1/8,0.2-0.4,0.25-0.4,0.8-2.3,0.9-1.8,1-1.4,1-10,1-3.5,1.1-1.6,1.1-1.9,1.5-1.8,1.5-3,1.7-2.3,1.9-3.2,11.5-19.7,3-4,3.1-4.2,3.4-5.2,3.8-5.1,5-200,8,8-11,8.5-10.5,9-22,abaxially,acuminate,acute,adaxially,anther,apart,apex,articulated,attenuate,axe,base,berry,black,blade,branched,brown,calyx,chartaceous,closely,cm,conical,corolla,cuneate,cylindrical,dark,deltoid,dendritic-echinoid,diameter,drying,echinoid,elliptic,entire,expanded,filament,fleshy,flower,fruit,glabrescent,glabrous,globose,granular,grayish,grayish-green,green,hair,half,immature,lanceolate,lavender,leaf,length,lilac,lobe,long,long-stalked,many,margin,mature,midrib,mixed,mm,multangulate,multangulate-pubescent,narrowly,pale,partly,pedicel,peduncle,petiole,plant,porrect-stellate,prominent,pseudo-terminal,pubescence,rachi,reticulate-punctate,rounded,scabridulous,scabrous,scattered,semi-ovate,sessile,short,short-,short-stalked,shrub,side,simple,slightly,slowly,spaced,stalk,stem,style,subcoriaceous,suborbicular,subsessile,surface,tertiary,thin,thin-stalked,time,tomentose,tomentose-pubescent,tree,unarmed,unwinged,upper,vein,white,whitish,x,yellowish,yellowish-tan	-4,0.9-1,1.9-3,1/2,14-27,2.4-3.2,2.5-3.2,2.6-4.8,2/3,3.1-3.6,3.5-7.8,4-7.5,5-8,accrescent,adaxiall,ag,anthesi,apparently,appearing,appressed,ark,around,axillary,ba,blunt-tipped,branch,bud,capitate,completely,covering,dendritic-echinoi,dense,directed,distally,due,eaf,earl,echinoi,edge,eed,elongated,enveloping,equal,evident,exerted,farinose,few-rayed,free,fruiting,glabrescen,inserted,lateral,lengthening,lobed,longer,longitudinal,longitudinall,lower,m.,main,minute,multiseriate,nflorescence,oblong,obovate,occasional,occasionally,often,older,open,orbicular,orolla,ovate-lanceolate,overlapping,perfect,plurifoliate,pore,poricidal,present,ruit,secondary,short-decurrent,slit,somewhat,splitting,stamen,stellate,stigma,subcampanulate,sulcate,suture,tall,tamen,thickened,tip,tube,ud,unarme,unit,usually,vary,way,wide,yellow,ympodial,young	abaxial,adaxial,arrangement,branching,characteristic,colour,form,growth,height,history,inflorescence,life,midvein,ovary,primary,pseudostipule,seed,shape,staman,texture,true,unspecified,venation
38	wfo-0001026299	success	239	175	151	88	24	0.632	-1,-3.5,0.1-0.2,0.1-0.4,0.25-0.5,0.4-0.5,0.5,0.5-0.6,0.5-0.7,0.5-1,0.5-2.5,0.8-1,1,1-1.4,1-celled,1.1-1.7,1.2-1.6,1.5-,1.8-2,2-6,2-foliate,2-locular,2.2-3.2,3.5-10,5-20,6-20,7-12,abaxially,abundant,acute,adaxially,almost,along,anther,apex,appearance,articulated,basal,base,basiscopically,beneath,bract,bracteate,broadly,brown,calyx,cell,change,cm,corolla,could,crenate-serrate,dark,decurrent,densely,diameter,distal,ebracteate,elliptic,entire,erect,filament,flower,fruit,give,glabrous,glandular,globose,green,hair-like,half,head,herb,imparipinnate,inflorescence,intermixed,internode,interrupted,irregularly,jequetepeque,lacking,lanceolate,larger,lateral,leaf,less,like,lobe,lobed,long,longer,margin,maturity,middle,minute,minutely,mixture,mm,multicellular,narrowly,nearly,node,oblique,obovate,often,outgrowth,ovary,pale,patent,pedicel,peduncle,perennial,petiole,population,primary,prostrate,pseudostipule,pubescence,pubescent,purple,rachi,regularly,scattered,short,silky,simple,sparsely,spreading,stem,stout,stripe,style,surface,tall,tertiary,testa,thick,trichome,truncate,uniseriate,unit,variously,vein,velvety,wall,weak-walled,white,wide,winged,woody,yellow	--,-0.8,-10,-2.5,-5,.5,0-8,0.1-0.25,0.1-0.5,0.15-0.2,0.2-0.25,0.2-1,0.3-0.4,0.4-2,0.6-2,0.7-3.5,0.8-0.9,0.9-1,1.2-5,1.5-2.3,2-4,2.5,2.5-7,25,3-,5,5-15,absent,acroscopically,angled,anthesi,apical,appendage,approximately,axi,berr,capitate,chota,column,conical,crenat,developed,diamete,eaf,edicel,eed,eglandular,exserted,fruiting,gree,hal,interjected,investing,leaflet,lon,long-acuminate,loosely,lower,maraÃ±Ã³n,nflorescence,occasionally,pair,pentagonal,petiolule,present,reflexed,rest,ruit,scarcely,secondary,sessile,size,sparse,staminal,sterile,stigma,straight,tem,terminal,tip,toward,tube,ud,unicellular,usually,valley,way,ympodial	abaxial,adaxial,arrangement,branching,characteristic,colour,form,growth,height,history,length,life,mentioned,midvein,plant,see,seed,shape,staman,sympodial,texture,true,unarmed,venation
39	wfo-0001026305	success	135	119	87	48	32	0.644	.25,0.2-1,0.5-2,0.6-1,0.7-1,1-1.5,2-2.5,2-6-flowered,2.5-3,4-4.5,5-7,6-9,7-9,abaxial,abaxially,acute,adaxially,along,anther,anthesi,apex,apical,attenuate,base,beige-tan,berry,calyx,cm,congested,corolla,deflexed,deltate,dendritic,densely,dia,difoliate,elliptic,filament,free,glabrous,globose,green,greenish-white,knob-like,lateral,leaf,leaf-opposed,like,lobe,long,main,margin,middle,midrib,minutely,mm,occasionally,older,ovary,ovoid-reniform,pair,pale,pedicel,petiole,pitted,portion,projection,pubescent,rounded,scattered,shining,shrub,simple,slender,sparsely,stem,style,surface,tan,trichome,tube,unifoliate,unit,vein,widest,x,young	/4,0.25-0.5,1.3-1.5,3-8.5,7-16,area,ba,bark,closely,conical,dark,drying,eaf,edicel,eed,exserted,fruiting,geminat,glabrate,interlocking,lamina,lobed,lon,lower,minute,nflorescence,overlappin,papillose,planar,pore,poricidal,reddish-brow,ruit,scar,shaped,spaced,stigma,strongly,styl,tall,tear-drop,tip,tub,ud,visible,way,woody,ympodial	-,adaxial,arrangement,branching,characteristic,colour,diameter,form,fruit,geminate,growth,height,history,inflorescence,length,life,mentioned,midvein,peduncle,plant,primary,pseudostipule,rachi,reddish-brown,seed,shape,staman,sympodial,tertiary,texture,unarmed,venation
40	wfo-0001026307	success	193	154	130	63	24	0.674	.3,.6,.8,0.2â0.5,0.2â1.5,0.4,0.5â0.6,0.5â0.7,0.5â5.0,0.8â0.9,0.8â2,0.8â5,1.0â1.2,1.0â2.4,1â6-celled,2.0â3.5,2.6â13,2/3,3.0â4.0,3.5â7.0,35â45,3â8,3â8-celled,4â5.7,5â7,8â12,9,abaxial,acute,acute-acuminate,adaxial,anther,apex,articulated,base,becoming,berry,black,broadly,calyx,cell,central,cm,corolla,cuneate,decurrent,densely,diameter,difoliate,ellipsoid,end,entire,eye,filament,flattened-reniform,flower,fruit,glabrous,glandular,globose,gradually,green,growth,herb,hilum,internodal,lateral,length,like,lobe,lobed,long,longer,margin,middle,mm,narrower,narrowing,new,one,outline,ovary,ovate,pair,paler,pedicel,peduncle,pentagonal,per,petiole,positioned,primary,pubescent,purple,purple-yellow,restricted,ripe,shallow,shallowly,shape,shorter,shrub,simple,sparsely,spreading,stem,straight,style,sub-laterally,surface,testal,tinged,tip,toward,translucent,triangular,trichome,tube,turning,undulate,uniseriate,unit,variable,vein,vigorous,weak-stemmed,white,wide,yellow,yellow-green	.0â1.2,.5,.5â4.0,0.6,1.0â1.5,1.0â2.0,1.0â2.5,1â3-celled,2.0,2.0â3.0,5-merous,abaxially,adaxially,age,angled,anthesi,apar,appressed,beyond,clavate,cone,cylindrical,eaf,eed,exerted,facing,free,fruiting,geminat,later,lengthening,lower,membranous,minutely,nflorescence,papillat,perfect,pore,poricidal,portion,recurved,reflexe,reflexed,ruit,scar,side,slightly,slit,spaced,ste,stellate,stigma,stone,strongly,tal,tem,three,two,ud,unequal,unevenly,upper,ympodial	arrangement,branching,characteristic,colour,form,geminate,height,history,inflorescence,leaf,life,midvein,null,plant,pseudostipule,rachi,seed,staman,sympodial,tertiary,texture,true,unarmed,venation
41	wfo-0001026317	success	169	149	123	46	26	0.728	.5,0.25-1,0.3-1.2,0.5,0.5-0.6,0.5-1,0.6-,0.8-1,1-1.2,1-1.5,1-5.7,10-12,2-,2-2.5,2-4,2.5-10,3-3.5,3-foliate,3.5-15,4-5,50-200,6-8,6x,?,abaxially,absent,acuminate,acute,adaxially,anther,anthesi,apex,apically,attenuate,base,berry,branched,bright,brown,calyx,capitate,clonal,cm,conical,corolla,correlated,dark,dendritic,dense,densely,diameter,drying,elliptic,entire,essentially,extremely,filament,flattened,flower,found,free,glabrous,globose,growth,inflorescence,internodal,lamina,less,lobe,longer,many,margin,maturity,minutely,mm,narrowly,nodding,occasionally,often,orange,ovary,pair,pale,papillate,pedicel,peduncle,per,pericarp,petiole,pitted,plant,population,portion,primary,pubescence,pubescent,pulp,rachi,red,reniform,shiny,shrub,simple,sparsely,stem,sticky,stigma,straight,style,surface,terminal,thin,time,triangular,trichome,tube,uniseriate,unit,variable,vein,white,x,yellowish	/4,0.5-0.8,0.7-0.9,3,age,apart,approximately,bark,closely,deltate,distally,eaf,eed,em,erec,erect,exerted,fruiting,geminat,halfwa,lengthening,like,lobed,lower,new,nflorescence,packed,papillat,perfect,planar,plane,pore,poricidal,pubescen,reflexed,ruit,scar,slightly,slit,swollen,tip,toward,ud,way,woody,ympodial	2,abaxial,adaxial,arrangement,branching,characteristic,colour,form,fruit,geminate,height,history,leaf,length,life,midvein,null,pseudostipule,seed,shape,staman,sympodial,tertiary,texture,unarmed,venation
42	wfo-0001026335	success	157	133	102	55	31	0.65	.5,.5-3.5,0.25-0.5,0.5-1,0.6-1,1,1-1.5,1-2,1-4,1.5-2,10-20,10-30,2,2-3,2-4,2-7.5,3-18,4-5,5-,5-15,5-7,abaxially,acuminate,acute,adaxially,anther,apart,apex,articulated,base,blade,branched,calyx,chartaceous,cm,cuneate,curved,deltate,dense,densely,diameter,elliptic,elliptic-ovate,entire,equal,erect,filament,flattened,flower,forked,fruit,geminate,glabrescent,glabrous,glandular,globose,green,hair,leaf,leaf-opposed,like,lobe,long,many-foliate,margin,midpoint,mm,moderately,multangulate,pedicel,peduncle,petiole,probably,pubescence,pubescent,rachi,reticulate,ripe,rounded,scattered,sessile,shrub,simple,sometimes,spaced,stellate,stellate-pubescent,stem,straight,style,surface,time,tip,unit,unripe,usually,vein,white,whitish,wide,x,yellowish	0.1-0.3,0.8-1.3,1-3,1.5-4,3-5,7-8,accrescent,adaxiall,ag,apparently,axe,ba,capitat,connivent,covering,cylindrical,directed,distally,eaf,eed,especially,frui,fruiting,glandula,held,lanceolate,large,longitudinal,lower,much,nflorescence,oblong,often,opening,orolla,paired,perfect,pore,ray,ruit,slightly,slit,smaller,ste,stigma,subtending,tal,tamen,tem,toward,tube,uprigh,vary,yellow,ympodial	abaxial,adaxial,arrangement,branching,characteristic,colour,corolla,form,growth,height,history,inflorescence,length,life,mentioned,midvein,ovary,plant,primary,pseudostipule,seed,shape,staman,stamen,sympodial,tall,tertiary,texture,true,unarmed,venation
43	wfo-0001026343	success	221	160	137	84	23	0.62	-1.5,-3.5,-4,-7,.5,0-2,0-4,0-40,0-5,0.05-0.5,0.2-0.7,0.45-1,0.5-1.5,1-2,1-3,1.3-1.7,1.5-2.5,1.8-2.2,1.8-3,1/3,1/5,2-3,2-3.2,2-4,2-5,2-6,2-8,2.2-3.2,3-4,3-5,5.5-9,abaxial,acute,adaxial,anther,apex,apically,apparently,articulated,bark,base,berry,blade,branched,broadly,calyx,cm,connivent,cream,cuneate,curved,dark,deltate,densely,diameter,dull,equal,erect,faint,filament,flattened-reniform,flower,free,fruit,glabrescent,glabrous,green,infructescence,lateral,leaf,length,less,lobe,lobed,long,long-styled,lower,margin,marking,maturity,mauve,midvein,mm,moderately,older,one,open,orange-brown,ovate,pair,pale,pedicel,peduncle,per,pericarp,petiole,plant,poricidal,porrect,portion,prickle,prickly,primary,purple,reddish,rounded,sessile,shrub,side,small,smooth,sparsely,spherical,stalked,stellate-pubescent,stem,stout,style,surface,tapering,terete,tertiary,time,tip,tree,trichome,tube,unarmed,unit,upper,vein,venation,visible,weakly,wide,yellow,young	-1,-15,/2,/5,0,0-10,0.05-0.2,0.1-0.2,0.15,0.2,0.2-0.3,0.3,0.5,0.8-1.5,1-4,1.5-2,1/,1/4-2/3,10-30,2.5-8,3.5-4.5,5-10,5-merous,6-9,7-12,7-14,7-8,7-9,abaxially,acuminat,alyx,andromonoecious,apar,apart,brow,chartaceous,concolorous,distal,distance,drying,eed,elliptic,elongating,extending,flattened,fruiting,green-brown,hermaphrodite,heterostylous,lobing,lon,longer,lowermost,mature,midpoint,multangulate,narrow-deltate,nflorescence,obtuse,orange,orolla,oung,pendulous,plurifoliat,prickl,ray,reduced,reflexed,ruit,scar,secondary,short-styled,sometimes,spaced,spreading,stalk,staminat,stellate,tamen,variously,vary,way,woody,ympodial	acuminate,arrangement,branching,brown,characteristic,colour,corolla,form,growth,height,history,inflorescence,life,mentioned,ovary,plurifoliate,pseudostipule,rachi,seed,shape,staman,sympodial,texture
44	wfo-0001026352	success	209	155	131	78	24	0.627	.3,.5,0.5,0.5-0.8,0.5-1,0.5-3,0.7-2,1-2-celled,1.2-1.7,1.5,10+,12-60,2,2-3-celled,3-15,4-4.5,5-6,7-9,<,?,acuminate,acute,anther,anthesi,apex,apparently,appearance,arising,articulated,axi,basal,base,berry,blue,branch,branching,broadly,brown,calyx,cell,cm,cordate,corolla,deciduous,deltate,densely,denser,diameter,ellipsoid,entire,evenly,expanded,filament,flattened,flower,giving,glabrous,globose,green,greenish,growth,half,herbarium,immature,impressed,inflorescence,junction,lamina,largest,leafy,leaving,length,like,lobe,long,lower,many,margin,mature,minutely,mm,narrowly,near,outline,ovate,pair,pale,pedicel,peduncle,peg,per,pericarp,petiole,pink,primary,principal,pubescent,rachi,reniform,rest,revolute,seen,shallowly,shiny,shoot,short,simple,sleeve,small,sparser,specimen,spreading,stem,style,surface,terminal,thin,time,trichome,truncate,tuberculate,uniseriate,unspecified,vein,vine,violet,weak,white,wide,woody,yellowish	0.5-1.5,0.6-,0.9-1,1-,1-1.5,1-10,1.5-2,1.5-4.6,3.5-9,5-merou,6-7,abaxially,adaxiall,ag,almost,alyx,angle,antrorsely,apart,articulation,bark,bending,capitate-truncate,chartaceous,conical,curved,discolorous,eaf,eed,eventually,exserted,few-celled,free,fruiting,heigh,ilament,inflorescenc,irregularly,large,leave,lengthening,lobed,membranous,nearly,new,nflorescence,older,orolla,papillate,papillo,perfect,plurifoliat,point,pore,poricidal,portion,reflexed,right,ruit,scar,slit,spaced,spreadin,stellate,stigma,straw-colored,strongly,tem,third,tip,tub,tube,ud,unit,upper,vary,widest,ympodial	abaxial,adaxial,arrangement,characteristic,colour,form,fruit,height,history,leaf,life,midvein,ovary,plant,plurifoliate,pseudostipule,seed,shape,staman,tertiary,texture,true,unarmed,venation
45	wfo-0001026352	success	214	148	125	89	23	0.584	.3,.5,0.5,0.5-0.8,0.5-1,0.5-3,0.7-2,0.9-1,1-1.5,1-2-celled,1.2-1.7,1.5,10+,12-60,2,3-15,4-4.5,5-6,7-9,<,?,acuminate,acute,anther,anthesi,apex,apparently,articulated,axi,basal,base,berry,blue,branch,branching,broadly,brown,calyx,cm,cordate,corolla,deciduous,deltate,densely,diameter,ellipsoid,entire,evenly,filament,flattened-reniform,flower,form,free,fruiting,glabrous,globose,green,greenish,growth,half,immature,impressed,inflorescence,lamina,leaf,leafy,leaving,length,like,lobe,long,many,margin,mature,mm,narrowly,near,outline,ovate,pair,pedicel,peduncle,peg,per,pericarp,petiole,pink,plurifoliate,portion,primary,principal,pubescent,rachi,revolute,seen,shallowly,shiny,shoot,short,simple,sleeve,small,spreading,stem,style,surface,terminal,thin,third,time,trichome,truncate,tuberculate,twining,uniseriate,unspecified,vein,vine,violet,weak,white,widest,woody,x,yellowish	0.5-1.5,0.6-,1-,1-10,1.5-2,1.5-4.6,2-3-celled,3.5-9,5-merou,6-7,abaxially,adaxially,ag,almost,alyx,angle,antrorsely,apart,appearance,arising,ark,articulation,bending,capitate-truncate,cell,chartaceous,conical,connivent,curved,denser,discolorous,eaf,eed,eventually,expanded,exserted,few-celled,geminat,giving,heigh,herbarium,ilament,inflorescenc,irregularly,junction,large,largest,lengthening,lobed,lower,membranous,minutely,nearly,new,nflorescence,older,orolla,pale,papillate,papillo,perfect,point,pore,poricidal,reflexed,rest,right,ruit,scar,slit,spaced,sparser,speciman,specimen,spreadin,stellate,stigma,straw-colored,strongly,tem,tip,tub,tube,ud,unit,upper,vary,yellow,ympodial	'pale,abaxial,adaxial,arrangement,characteristic,colour,fruit,geminate,height,history,life,midvein,ovary,plant,pseudostipule,seed,shape,staman,tertiary,texture,true,unarmed,venation
46	wfo-0001026379	success	219	167	140	79	27	0.639	-4.5,0.2-0.38,0.2-0.4,0.7-1,0.7-2.5,0.8-1.2,0.9-1.2,1-1.7,1-10,1-2,1-3.7,1.3-2.1,1.5-2.3,1.7-4.9,1.8-2.6,1.9-3.4,1/2,13,2-7,2.6-3.7,2/3,3-11,4.1-7,5.3-10.2,50-450,8-13,8-15,8-29,8.3-10,9-14,abaxially,acute,adaxially,along,anther,apart,apex,articulated,attenuate,axillary,basal,base,berry,blade,branch,branched,brown,calyx,chartaceous,closely,cm,conical,corolla,dark,dendritic-echinoid,densely,diameter,dried,echinoid,entire,few-rayed,filament,finely,fleshy,flower,fruit,globose,granular,gray-brown,grayish,growth,hair,lacking,lateral,leaf,length,lobe,long-attenuate,main,many,margin,mature,midrib,minute,minutely,mm,mostly,multangulate,multangulate-pubescent,nearly,obovate,obtuse,often,ovate,pale,pedicel,peduncle,persistently,petiole,pitted,plant,plurifoliate,porrect-stellate,present,rachi,recent,reniform,rich,scabrous,semi-ovate,sessile,short-stalked,shrub,side,simple,small,sometimes,somewhat,spaced,sparse,stellate,stellate-,stellate-tomentose,stem,style,testa,time,tomentose-pubescent,translucent,tree,unit,upper,usually,vein,velutinous-pubescent,vestigial,violet,whitish,x,young	1.8-3.2,1.8-5,2-2.8,2.4-5.1,2.9-4,3/4,4-5,6-10.6,accrescent,adaxiall,ag,anthesi,apparently,around,ba,bark,blunt-tipped,capitat,completely,covering,cylindrical,directed,distal,distally,eaf,echinoi,echinoid-pubescent,edge,eed,ellipsoid,enveloping,evident,farinose,free,fruiting,glabrous,hig,included,inserted,large,lengthening,line,lobed,long,lower,m.,multangulat,nflorescence,oblong,older,orolla,ovate-lanceolate,partly,perfect,pore,poricidal,pubescen,rather,ruit,runk,scattered,size,slit,stellate-pubescent,stelliform,stigma,suture,tamen,terete,thin,tip,tube,ud,uneven,vary,way,whitish-brown,yellow,ympodial	abaxial,adaxial,arrangement,branching,characteristic,colour,form,height,history,inflorescence,life,midvein,null,ovary,primary,pseudostipule,pubescent,seed,shape,staman,surface,sympodial,tertiary,texture,trunk,unarmed,venation
47	wfo-0001026400	success	187	159	126	61	33	0.674	0.2-0.8,0.4-1,0.5-1,0.5-1.2,1-10,1-2,1.3-2.6,1.7-2.2,10-18,12-27,2-6,3-6,3.4-4.8,3.5-5.9,30-55,4-7,5-7,6-15,6.5-20,8-12,9-13,abaxially,acuminate,acute,adaxially,anther,apart,apex,apparently,articulated,asymmetric,attenuate,axe,axillary,base,basiscopic,berry,blue,brownish,bud,cell,cm,condition,corolla,covering,dark,deep,diameter,digestion,distal,drying,elliptic,enzyme,exceeding,filament,finely,flower,forked,fresh,fruit,generally,glabrescent,glabrous,globose,green,green-white,greenish,hair,hair-like,half,herb,high,honeycomb-shaped,lateral,leaf,leaflet,light,lilac,linear,lobe,long,make,mm,moderately,mucilaginous,odd-pinnate,ovate,ovoid,pedicel,peduncle,perfect,petiole,plant,plurifoliate,puberulent,pubescent,purple,removed,ripe,rounded,seed,sessile,short,side,simple,spaced,stamen,straight,stripe,style,subtending,terminal,testal,thick,throughout,tip,tissue,tri-,typically,unit,usually,wall,wet,white,whitish,x	0.7-1.1,10-28,13-30,2-8,2.4-5.9,5-merou,6-13,acumen,adaxiall,ag,alyx,blade,capitat,clavate,connivent,coriaceous,decreasing,decurrent,dorsally,eaf,edge,eed,erec,flat,folded,geminat,glabrou,gree,hal,homostylous,interjected,lanceolate,lengthening,living,lower,nflorescence,orbicular,orolla,pair,pentagonal,petiolulate,pore,poricidal,ruit,semi-stellate,seudostipule,size,slightly,slit,specimen,stigma,subequal,tall,tamen,tem,toward,tube,unwinged,vary,yellow,ympodial	abaxial,adaxial,arrangement,branching,calyx,characteristic,colour,form,geminate,growth,height,history,inflorescence,length,life,margin,midvein,null,ovary,primary,pseudostipule,rachi,shape,staman,stem,surface,sympodial,tertiary,texture,true,unarmed,vein,venation
48	wfo-0001026406	success	219	145	122	97	23	0.557	.5,0-3,0-30,0-5,0.4-0.9,0.5-1.5,00-200,1-2,1.3-1.5,1.8-2.4,1/3,1/4,12-19,2-2.7,2-3,2-6,2.5-8,2.9-3.2,3.2-3.8,30-60,5-25,5-6,5-8,6-15,6.5-7,7-10,abaxial,abaxially,acute,adaxial,adaxially,anther,apex,apparently,articulated,base,berry,branched,calyx,cm,cordate,cream,curved,dark,deltate,densely,diameter,dirty-whitish,erect,filament,flattened-reniform,flower,foliaceous,free,fruit,gently,glabrous,green,herb,lateral,leaf,length,lobe,lobed,long,long-styled,lower,margin,marking,maturity,mauve,midvein,mm,moderately,oblong,obtuse,one,open,orange-brown,ovate,pair,pale,pedicel,peduncle,pendent,per,petiole,plant,porrect,portion,prickle,prickly,primary,purple,red-brown,short-styled,shrub,smooth,sometimes,spherical,stalked,stellate-pubescent,stem,stout,straight,style,surface,terete,terminal,tertiary,time,trichome,tube,upper,vein,velvety,venation,visible,white,wide,yellow,young	-1,.2,0,0.3,0.3-0.5,0.3-0.7,0.4-0.8,0.5,0.5-2.5,0.8,1,1.5-2,1.5-5,1/,1/4-1/2,1/4-1/3,10-30,20-60,3-10.5,3-4,5,5-50,5-7,5-merous,6-12,7-8,7-9,9-15,alyx,ame,andromonoecious,apar,apart,apically,bark,blade,broad-deltate,c.,chartaceous,conical,connivent,discolorous,distal,distance,drying,eaf,eed,elongated,elongating,equal,extending,flattened,fruiting,fully,hermaphrodite,heterostylous,infructescence,least,lon,longer,lowermost,mature,midpoint,nflorescence,older,opening,orolla,oung,pendulous,pericarp,plurifoliat,poricidal,prickl,ray,reflexed,rounded,ruit,scar,sessile,side,spaced,sparsely,spreading,stalk,staminat,stellate,tamen,tapering,tip,unit,variously,vary,way,weakly,woody,yellow-brow,ympodial	3.5,7.2,arrangement,branching,characteristic,colour,corolla,form,growth,height,history,inflorescence,life,mentioned,ovary,plurifoliate,pseudostipule,rachi,seed,shape,staman,texture,unarmed
49	wfo-0001026407	success	221	183	155	66	28	0.701	+,-11,-6,.5,0.5,0.5-0.6,0.5-1,0.5-2,0.9-3,1,1-1.2,1.2-1.5,1.3,1.5-1.7,1.5-2,1.5-7,2-2.5,2.5-3,20-30,20-40,3.5,4-5,5,5-10,7-10,7-8,acute,aid,along,anther,anthesi,apex,appearing,area,around,articulated,axi,basal,base,becoming,beneath,berry,black,blunt,branch,branched,brown,brownish,calyx,cell,chartaceous,cm,congested,corolla,deep,deltate,dendritic,dense,densely,diameter,discolorous,elliptic,entire,erect,evenly,filament,flattened-reniform,fleshy,flower,free,fruiting,glabrous,globose,golden,golden-pubescent,growth,inflorescence,internodal,lamina,lateral,lax,leafy,leaving,like,lobe,long,lower,many,margin,markedly,membranous,midvein,minutely,mm,narrowly,near,oblique,occasionally,often,open,outline,pair,pale,paler,papillate,pedicel,peduncle,peg,pentagonal,per,pericarp,persistent,petiole,pitted,plurifoliate,portion,primary,pubescence,pubescent,purple,purplish,reddish,revolute,ripe,shiny,short,shrub,simple,sleeve,slightly,small,sparsely,sparser,spreading,stem,stiff,stout,style,surface,terminal,testal,thin,time,trichome,truncate,twining,undulate,upper,usually,vein,vine,violet,woody,x,yellow	/3,1-10,3.5-5.5,5-7,5-merou,abaxially,adaxially,ag,always,alyx,apart,ark,berr,broadly,capitate,clear,climbin,conical,connivent,denser,eaf,eed,ellipsoid,exserted,geminat,glabrescen,glabrou,ilament,interpetalar,irregularly,lengthening,lobed,loosely,mixture,new,nflorescence,numerous,obscured,older,orolla,papillat,pedice,perfect,planar,pore,poricidal,pubescenc,ruit,scar,sinus,slit,spaced,stellate,stigma,strongly,tangled,tem,tip,transition,tube,ud,unit,vary,way,weak,ympodial	abaxial,adaxial,arrangement,branching,characteristic,climbing,colour,form,fruit,geminate,glabrescent,height,history,leaf,length,life,null,ovary,plant,pseudostipule,rachi,seed,shape,staman,tertiary,texture,unarmed,venation
50	wfo-0001026424	success	138	154	117	21	37	0.848	-4,0.75-1.5,1-,1-1.5,1.5-2,10,12-60,15,2,3-4,637/1,acuman,acumen,acuminate,acute,age,angular,anthesi,apex,aspect,axil,base,becoming,blunt,bluntly,blush-violet,broad,broadly,calyx,campanulate,cell,clonal,close,cm,common,conspicuous,corolla,cuneate,cyme,dia,distinct,downard,ellipsoid,elliptic,erect,exceeding,except,exerted,facetted,facing,floral,flower,fork,forked,general,glabrous,glandular,growing,hair,interacuminal,lacking,lanceolate-elliptic,larger,lasting,lavender,leaf,line,lobe,lobed,lon,long,lower,midvein,minute,mm,oblique,obovate,often,pedicel,pedicellate,peduncle,petiole,pinnatisect,point,rachi,raised,rarely,rh,rotate-stellate,rounded,scorpioid,second,several,shallowly,short,shrub,simple,slightly,soft-wooded,soon,stem,stone,straggly,time,tip,tissue,toward,triangular,tub,ud,unit,unwinged,usually,violet,woody,year,young	-25,-3.5,1,1-10,1-2,10-15,15-30,3-11,8-,ba,cut,eaf,gree,lanceolate,nflorescence,part,plurifoliat,sinus,within,x,ympodial	1-4,abaxial,adaxial,anther,arrangement,branching,characteristic,colour,diameter,filament,form,fruit,green,growth,height,history,inflorescence,length,life,margin,mentioned,ovary,plant,plurifoliate,primary,pseudostipule,seed,shape,staman,style,surface,sympodial,tertiary,texture,unarmed,vein,venation
51	wfo-0001026440	success	181	148	117	64	31	0.646	0-15,1-5,1.1-1.4,1.1-1.5,1.5-2.1,1.9-3.7,14-30,2-2.8,2-4,2.9-4.4,3-5,3-7,3-8,3/4,4-12,5-7,7-14,9,abaxially,acute,adaxially,along,anther,apex,articulated,bark,basal,base,berry,blade,blunt-tipped,bract-like,branch,branched,broadly,brown,calyx,chartaceous,closely,cm,conical,corolla,dendritic-echinoid,diameter,dichotomy,echinoid,elliptic,entire,filament,first,fleshy,flower,globose,granular,green,hair,leaf,length,lobe,long,long-attenuate,many,margin,minutely,mm,multangulate,multangulate-pubescent,nearly,oblong,obovate,obtuse,often,older,openly,ovate,pair,pale,pedicel,peduncle,persistently,petiole,pitted,porrect-stellate,reniform,ripe,scabrous,semi-ovate,sessile,short-acuminate,short-stalked,shrub,simple,size,small,sometimes,somewhat,spaced,sparse,stellate,stellate-pubescent,stem,style,terete,testa,thick,time,tomentose,tomentose-pubescent,translucent,tree,turning,uneven,usually,white,x,yellow,young	1.3-1.7,1.8-4.5,1/2,1/2-2/3,3.9-6.5,accrescent,adaxiall,ag,always,anthesi,apparently,appressed,axillary,ba,branche,capitat,dense,developed,directed,distal,distally,eaf,echinoi,eed,free,fruiting,greenish-yellow,high,included,inserted,large,lengthening,lobed,lower,m.,minute,mostly,multangulat,nflorescence,obovoid-oblong,obscure,orolla,perfect,plurifoliate,pore,poricidal,pubescen,rather,ruit,runk,slit,stigma,suture,tamen,thin,tip,tomentum,truncate,tube,ud,unit,vary,way,ympodial	abaxial,adaxial,arrangement,branching,characteristic,colour,form,fruit,growth,height,history,inflorescence,life,midvein,null,ovary,plant,primary,pseudostipule,pubescent,rachi,seed,shape,staman,surface,tertiary,texture,trunk,unarmed,vein,venation
52	wfo-0001026441	success	197	144	113	84	31	0.574	0.3-0.7,0.5-1.5,0.8,1-1.5,1-10,1-2,1.5-2.5,10,10-14,15-20,2-2.5,2-5.5,2-8,4-6,4-8,4.5-6.5,5,5-10.5,6-15,7-8,9-14,abaxially,acuminate,adaxially,anther,apart,apex,apparently,articulated,attenuate,axe,axillary,base,berry,brownish,bud,cell,cm,condition,conical,corolla,covering,diameter,distal,drying,elliptic-lanceolate,filament,flower,forked,fresh,fruit,generally,glabrous,green,green-white,greenish,hair,hair-like,half,herb,lateral,leaf,leaflet,light,like,lobe,long,make,margin,middle,minute,mm,mottled,mucilaginous,narrow,odd-pinnate,ovate,ovoid,pale,pedicel,peduncle,perfect,petiole,petiolule,plant,plurifoliate,pubescent,purple,ripe,seed,short,slightly,spaced,sparsely,stem,straight,style,subtending,symmetrical,terminal,testal,thick,throughout,tri-,unit,usually,violet,wall,wet,whitish,wide,wing,x	.5,0-2,0.4-3,1.5-2,3-5,4-8.5,5-merou,7-20,absent,acumen,ag,alyx,blade,capitat,chartaceous,ciliate,connivent,decreasing,digestion,dorsally,eaf,edge,eed,end,enzyme,equal,erec,especially,exceeding,flat,folded,fourt,geminat,glabrou,gradually,homostylous,honeycomb-shaped,interjected,internal,lanceolate,larger,lengthening,living,lower,minutely,nflorescence,obtuse,one,orbicular,orolla,pair,placed,pore,poricidal,puberulent,removed,rotate,rounded,ruit,secondary,semierect,seudostipule,size,slit,specimen,stamen,star,ste,stigma,stolo,subequal,subsessile,tall,tamen,tem,tip,toward,tube,tuber,typically,vary,white,yellow,ympodial	abaxial,adaxial,arrangement,branching,calyx,characteristic,colour,form,fourth,geminate,growth,height,history,inflorescence,length,life,mentioned,midvein,ovary,primary,pseudostipule,rachi,shape,staman,surface,sympodial,tertiary,texture,unarmed,vein,venation
53	wfo-0001026460	success	131	113	79	52	34	0.603	.1,.5,0.5-1.5,1-1.5,1.5-2,10-15,2.5-3,4.5-5,5,513,6-7,7-9,8-10,abaxially,acute-acuminate,anther,anthesi,apex,base,berry,brown,calyx,cm,conical,corolla,dark,deltate,dia,do,drying,elliptic,erect,fide,filament,filiform,floccose,flower,free,glabrous,globose,green,greenish,inflorescence,internodal,leaf,less,lobe,long,membraneous,minutely,mm,often,opposite,ovary,ovoid-reniform,pair,pale,pedicel,pitted,portion,puberulent,reddish,reflexed,santo,shrub,simple,somewhat,stem,style,subshrub,surface,tapering,tip,trichome,tube,vein,white,x,yellow	1/2,13.5-21,2-2.5,6-9,acut,adaxially,axi,becoming,branched,capitate,closely,completely,deflexed,distal,eaf,edicel,eed,frui,fruiting,inflorescenc,like,lobed,long-exserted,lower,major,middle,nearly,nflorescence,older,papillo,papillose,pore,poricidal,reddish-brow,ruit,scar,shaped,slightly,soon,spaced,stigma,tall,tear-drop,tiny,tub,ud,unifoliat,unit,widest,woody,ympodial,young	abaxial,acute,adaxial,arrangement,branching,characteristic,colour,diameter,form,fruit,growth,height,history,length,life,margin,midvein,null,peduncle,petiole,plant,primary,pseudostipule,rachi,reddish-brown,seed,shape,staman,tertiary,texture,true,unarmed,unifoliate,venation
54	wfo-0001026489	success	153	124	91	62	33	0.595	0.05-0.1,0.25-0.5,0.5-1,0.5-2,0.8-1.2,0.8-1.3,1-1.5,1.5-5,2-3,2-4,2-5,2-8-flowered,2.5-4,2/3,5-6,8-13,acute,along,anther,apex,axil,base,beneath,berry,branched,broadly,brown,calyx,cm,corolla,cup-shaped,dark,deflexed,deltoid,dia,difoliate,elliptic,erect,filament,flattened-reniform,fleshy,free,glabrous,globose,green,lateral,leaf,lobe,lobed,long,main,major,margin,middle,minor,minutely,mm,occasionally,often,opposite,ovary,pair,papillose,parallel,pedicel,petiole,pitted,portion,prominent,pubescent,shiny,shrub,simple,slender,stem,strongly,style,surface,tapering,trichome,tube,uniseriate,unit,usually,vein,way,white,whitish,widest,woody,x	.3,0.5,0.5-0.75,0.6-1.4,0.8-3.7,1.3-3,2.5-13,anthesi,appearing,area,ba,bark,closely,densely,differing,dry,eaf,edicel,eed,exserted,extending,flattened,fruiting,geminat,gra,incrassate,lamina,later,lon,lower,nflorescence,older,one,overlappin,paler,papillo,perpendicular,planar,pore,poricidal,red-papillose,rhachi,ruit,scar,shaped,size,somewhat,soon,spaced,specimen,stigma,straight,tall,tear-drop,terminal,thickened,tip,tub,ud,widened,ympodial,young	abaxial,adaxial,arrangement,branching,characteristic,colour,diameter,form,fruit,geminate,gray,growth,height,history,inflorescence,length,life,midvein,null,peduncle,plant,primary,pseudostipule,rachi,seed,shape,staman,sympodial,tertiary,texture,true,unarmed,venation
55	wfo-0001026490	success	272	248	204	68	44	0.75	.5,0.1â2.5,0.2â1.5,0.3â3.5,0.4â0.8,0.5â1.5,0.5â8,0.7â3,0.8â12,1.2â8,1.5,1.5â3.5,1.9,1â3,1â8,2,3,3â5-pinnate,4.6,5-merous,6,7,7-pinnate,=,[,],abaxially,absent,accrescent,acuminate,acute,adaxially,along,alyx,anther,apart,apex,apical,apparently,around,articulated,axe,axillary,ba,base,blade,bract,bracteate,branched,brown,calyx,cauline,chartaceous,climbing,cm,commonly,completely,contiguously,cordate,corolla,covered,crisped,cylindrical,darker,decreasing,densely,diameter,distal,distally,eglandular,ellipsoidal,elliptic,entire,exceeding,expanded,extra-axillary,filament,flattened,flower,fruit,fruiting,glabrous,green,ground,immature,inflorescence,interjected,irregularly,lacking,lateral,leaf,leaflet,length,lenticular,light,lobe,lobed,long,lower,lowermost,lunate,main,margin,markedly,match,mature,mean,mean=,medium,middle,midvein,minute,mm,moderately,mottled,multicellular,near,nearly,nflorescence,oblique,obliquely,oblong,obtuse,obtusely,occasionally,orange,ovate,ovate-lanceolate,pair,papillose,part,pedicel,peduncle,per,perfec,perfect,petiole,petiolule,plurifoliate,pointed,pseudostipule,pubescence,pubescent,punctate,pur,rachi,radial,reniform,resulting,revolute,rounded,sand,seed,shape,shoot,short,similar,simple,size,slender,slightly,smaller,smooth,sometimes,somewhat,spaced,sparsely,spur,stamen,stem,striation,striping,strongly,style,surface,tawny,teardrop-shaped,terminal,thickened,tip,toward,trailing,transparent,trichome,truncate,tube,typically,unbranched,undulate,unit,vegetation,vine,violet,white,wide,wing,woody,yellow,yellowish-tan,Â½,Ã,â4,â4.5,â9.5	0.1â0.2,0.2â1,0.5â1,0.5â3.5,0.8â1.5,1.5â2,1.5â5,1.8â2.2,10â20,1â1.2,1â15,1â2.5,2.5â3.5,2â2.5,2â4,2â6,2â8,3â4.2,3â4.5,3â5,3â8,4â4.5,4â5,5â7,7â15,ag,anthesi,apicall,becoming,broadly,capitat,ciliate,connivent,directed,eaf,eed,equal,flat,free,fused,geminat,incurved,large,latrorse-introrse,longitudinal,node,obliqu,oblon,one,opening,orolla,pentagonal,pore,present,pubescen,reflexed,rooting,ruit,seudostipule,shorter,slit,stigma,tamen,tem,trichomessympodial,vary,youn,â8	--,0.1,0.2,0.5,0.8,1,1.2,1.8,10,15,2.2,2.5,20,3.5,4,4.2,4.5,5,5-pinnate,8,abaxial,adaxial,arrangement,branching,characteristic,colour,form,geminate,growth,height,history,life,null,ovary,plant,primary,staman,sympodial,tertiary,texture,unarmed,vein,venation,young
56	wfo-0001026491	success	165	138	102	63	36	0.618	.5,1,1-2,1.5-2,1.5-2.5,1.5-3.5,1.7,10-50,1977,2-4,2-celled,2.5-3.5,3,3-pinnate,5-6,5-8,6-8,abaxially,acuminate,acute,adaxially,anderson,anther,apex,appressed,articulated,averaging,axe,base,bayonet,berry,blade,bract,branched,branching,broadly,cellular-papillose,cm,conspicuously,crinkly,cuneate,deciduous,deep,deltoid,diameter,elliptic-lanceolate,entire,filament,first,flower,green,growing,hair,highly,inflorescence,lanceolate,leaf,leaflet,less,light,lobe,margin,mean,middle,minutely,mm,obtuse,often,ovate,ovate-elliptic,pale,pedicel,peduncle,perfect,petiole,point,porrect-incurved,pubescent,purple,rachi,rarely,readily,rounded,scandent,shortly,shrub,simple,slender,spotted,straight,strigose,subacute,suborbicular-ovate,surface,tawny,terminal,tip,uniseriate,upright,white,whitish,x	2-3,5-merou,7-8,abaxiall,absent,alyx,apparently,ba,bent,capitat,cellular-pilose,central,connivent,densely,directed,distall,eaf,eed,equal,geminat,glistening,globose,greatly,homostylous,interjected,lateral,long,lower,lunulat,near,nflorescence,oblong-elliptic,orolla,ovoid,pilose,plurifoliate,pore,poricidal,present,reduced,rotate-pentagonal,rotate-substellate,row,ruit,seudostipule,sharp,similar,small,stigma,strigo,strong,strongly,tal,tamen,tem,tightly,tube,tyle,unit,usually,ventral,yellow,ympodial	'',``,abaxial,adaxial,arrangement,calyx,characteristic,colour,corolla,distally,form,fruit,growth,height,history,length,life,lunulate,mentioned,midvein,ovary,plant,primary,pseudostipule,seed,shape,staman,stem,style,tall,tertiary,texture,unarmed,vein,venation,ye
57	wfo-0001026501	success	195	159	131	64	28	0.672	-1.7,.1,.5,.6,.7,0,0-1,0.05-0.3,0.1,0.27-0.7,0.5,0.5-0.6,0.5-0.9,0.5-1,0.6-1.1,0.6-2,0.9-2.2,1,1-2,1-2.5,1.8-2.2,1/4,1/6-1/2,2.5-4,2.8-3,3-4,3.5-4,6-9,7-9,?,abaxially,acute,almost,anther,apex,apically,articulated,base,berry,blade,branched,brown,brown-green,calyx,cm,color,cuneate,curved,deltate,densely,diameter,dull,elliptic,entire,equal,erect,eye,filament,filiform,flattened-reniform,flower,free,fruit,glabrous,gray,green,infructescence,known,leaf,length,lobe,long,longer,margin,mauve,midpoint,mm,moderately,naked,one,open,orange-brown,orbicular,ovate,pair,pale,pedicel,peduncle,per,pericarp,petiole,porrect,portion,prickly,primary,ray,reddish,rounded,scandent,sessile,shoot,short,shorter,shrub,simple,smooth,sparsely,spherical,stalk,stalked,stellate-pubescent,stem,straight,style,subsessile,surface,terete,terminal,time,tip,trichome,tube,unarmed,unit,upper,vein,visible,white,wide,yellow,yellow-green	-3,.35,/3,0-2,0.2-1.8,0.6-1,1/2-2/3,2-10,3-5,3-9,4-5,4-7,5-merous,acicular,alyx,apar,apart,apparently,bark,becoming,borne,chartaceous,concolorous,discolorous,drying,eaf,eed,elongated,elongating,filiform-acuminat,flattened,fruiting,glabrou,light,lobed,lower,mature,nflorescence,often,older,orolla,oung,pendulous,perfec,plurifoliat,poricidal,prickl,prickle,ruit,scar,slender,small,sometimes,somewhat,spaced,spreading,stellate,tamen,tapering,unarme,variously,vary,way,ympodial	abaxial,adaxial,arrangement,branching,characteristic,colour,corolla,filiform-acuminate,form,growth,height,history,inflorescence,life,midvein,null,ovary,plant,plurifoliate,pseudostipule,rachi,seed,shape,staman,sympodial,tertiary,texture,venation
58	wfo-0001026513	success	138	115	86	52	29	0.623	.25,.3,0.8-2,1-1.5,1-3,3-6-flowered,4-5,6-8,7-9,acute,anther,apex,apiculate,area,bark,base,berry,broadly,calyx,cm,corolla,darkish,decurrent,deflexed,delicate,deltoid,dia,dry,elliptic,except,filament,flower,free,fruit,glabrous,globose,green,immature,known,lanceolate,lateral,leaf,live,lobe,long,long-styled,longer,main,mature,minute,minutely,mm,obscure,older,opposite,ovary,pair,pale,papillose,pedicel,petiole,plant,portion,prominent,raised,rest,shiny,short-styled,shrub,simple,slender,small,somewhat,specimen,stem,stigma,style,surface,tip,treelet,tube,undersurface,vein,venation,white,young	.1,.75,/3,2-2.2,2-5,3-5,8-16,anthesi,ba,caly,closely,completely,differentiated,eaf,edicel,eed,erect,exserted,fruiting,gre,hirsute,leave,less,lobed,lower,middle,much,nflorescence,overlappin,pore,poricidal,reflexed,ruit,scar,shaped,soon,spaced,straight,styl,tall,tear-drop,trichome,ud,unifoliat,uniseriate,unit,way,wide,widest,woody,x,ympodial	-,abaxial,adaxial,arrangement,branching,characteristic,colour,diameter,form,grey,growth,height,history,inflorescence,length,life,margin,mentioned,midvein,peduncle,primary,pseudostipule,rachi,seed,shape,staman,tertiary,texture,unarmed
59	wfo-0001026529	success	219	181	150	69	31	0.685	0-25,0.3-1,0.5-4.5,1,1-10,1-2,1-3,1-4.5,1.1-2.5,1.5-2.5,1.5-4,10,11-14,12-22,2,2-7.5,3-12,3-5,3-6,3-9.5,4-8,5-15,5-17,5-9,abaxially,acumen,acuminate,acute,adaxially,anther,apart,apex,apparently,articulated,attenuate,axe,axillary,base,berry,blue,broadly,brownish,bud,cell,chartaceous,cm,condition,cordate,corolla,covering,creamy,dark,deep,densely,diameter,digestion,distal,dot,drying,elliptic,enzyme,except,faintly,filament,flower,forked,fresh,fruit,generally,glabrous,glandular,globose,greatly,green,green-white,greenish,hair,half,herb,honeycomb-shaped,interjected,lateral,leaflet,length,light,like,lilac,lobe,long,make,margin,medium,membranous,mm,moderately,mucilaginous,narrowly,non-glandular,oblique,odd-pinnate,often,orbicular,ovate,ovoid,pair,pedicel,peduncle,perfect,petiole,petiolulate,petiolule,plant,plurifoliate,proximal,pubescent,pure,rarely,reduced,removed,ripe,rounded,scattered,seed,sessile,shape,short,size,slightly,spaced,stem,style,subequal,subsessile,subtending,terminal,testal,thick,throughout,tri-,trichome,typically,unit,usually,varying,wall,wet,white,whitish,x,yellowish	10-28,120-210,2-5,20-60,5-merou,50-70,6-20,600-950,?,ag,along,alyx,blade,capitat,ciliate,clavate,connivent,dorsally,eaf,edge,eed,erec,especially,exceeding,flat,folded,geminat,glabrou,gland,gree,hair-like,hal,head,homostylous,lanceolate,lengthening,living,longer,lower,lunate,midrib,minutely,nflorescence,orolla,pentagonal,pore,poricidal,puberulent,ruit,seudostipule,slit,specimen,stamen,ste,stigma,straight,substellate,tall,tamen,tem,tetralobulate,tip,tube,unwinged,vary,wide,wing,yellow,ympodial	'hair-like,abaxial,adaxial,arrangement,branching,calyx,characteristic,colour,form,geminate,growth,height,history,inflorescence,leaf,life,mentioned,midvein,ovary,primary,pseudostipule,rachi,staman,surface,sympodial,tertiary,texture,true,unarmed,vein,venation
60	wfo-0001026534	exception_thrown	150	0	0	150	0	0.0		-1.5,0.5-1,1-2,1-2.5,1-3,1.5-6,1.5-9,10-15,10-20,10-50,15-50,2-2.5,2-3,2-7,2-8,2.5-15,2.5-4,3-,3-10,3-25,3-4,3-5,3.5-4,4-10,4-foliat,4.5-5,5-6,6-35,7-12,7-40,abaxially,absent,acuminate,acute,adaxially,aggregate,apart,ape,apex,apiculate,articulated,auriculate,axe,basal,base,beyond,blade,branched,bright,calyx,cell,chartaceous,cm,connective,connivent,cordate,cylindrical,darker,deltate,densely,diameter,directed,distally,eaf,eed,eglandular,ellipsoidal,entire,equal,exserted,flattened,fleshy,flower,fruit,glabrous,glandular,hair,lanceolate,leaving,lemon-yello,lobe,lon,long,longitudinal,lower,m.,margin,mm,moderately,narrowly,nflorescence,nther,obtuse,often,orange,orolla,ovate,ovoid,pale,pedicel,pedicellar,peduncle,perfect,petiole,pinkish,pore,presen,puberulen,puberulent,pubescent,purple,rachi,radiu,red,remnant,ruit,shorter,simple,slightly,small,spaced,sparsely,stamen,stellate,stigma,stone,stripe,style,subcoriaceous,tal,tem,thecae,time,tip,tomento,tree,triangular,truncat,truncate,tube,ud,unbranched,unit,vary,vein,white,wide,x,yellow,ympodial	
61	wfo-0001026535	success	248	182	165	83	17	0.665	.4,.5,.8,0-0.5,0.1-0.2,0.7-1.5,1,1-3,1.2-2,1.3,1.5-3,1/3,2-3,2-5,2.5,3,3-4.5,3-5,3.5-4,5-10,5-7,5Â°,7-8,abaxial,abaxially,absent,acute,adaxially,age,almost,along,anther,apex,apically,articulated,base,becoming,berry,black,brachyblast,branch,branched,branching,brown,calyx,chartaceous,clearly,clustered,cm,concolorous,condensed,conical,corolla,cuneate,curved,delineated,deltoid,dendritic,dendritic-pubescent,dense,detaching,developed,diameter,dilated,discolorous,distributed,dry,drying,elliptic,elongated,entire,equal,evenly,except,eye,fertilisation,filament,fine,flat,flower,forming,fruit,fruiting,glabrous,green-brown,known,leaf,leave,length,lengthening,liana,like,lobe,lobed,long,loop,lower,margin,membranous,midvein,mm,much,naked,network,obovate,older,orange-brown,ovate,ovoid,pair,partly,pedicel,peduncle,pendulous,pericarp,petiole,plant,pointed,pore,poricidal,primary,prominent,pubescent,rachi,raised,rarely,ray,ridged,rounded,short,shrub,side,simple,slender,smaller,smooth,soon,sparsely,spreading,stem,stigma,stump,style,surface,terminal,tertiary,thin,tip,tissue,trichome,truncate,two,unarmed,unevenly,unlignified,vein,venation,violet,visible,weakly,white,x,yellowish,young,youngest	.1,.2,0.15,0.2,0.2-0.3,0.2-1.5,0.5-1,1-2,1-5,1.5-2,1/2-2/3,4-15,accrescent,alternate,alyx,anthesi,apar,apparently,area,around,bark,broadly,clavate,cup,cupular,dark,deeply,delineate,developing,divided,domatia,dorsal,eaf,eed,ellipsoi,flexuous,free,frui,increasing,inside,linear,lon,loose,m.,main,marginal,minute,minutely,mostly,nflorescence,nther,number,oblong,obscure,orolla,outside,papillo,perfec,plurifoliat,portion,protruding,reaching,ruit,scar,secondary,see,sinus,slightly,spaced,tearing,terete,toward,translucent,tube,tufted,ud,uneven,unit,vary,wide,widely,wider,ympodial	adaxial,arrangement,characteristic,colour,form,growth,height,history,inflorescence,life,null,ovary,pseudostipule,seed,shape,staman,texture
62	wfo-0001026604	exception_thrown	192	0	0	192	0	0.0		.4,.5,.75,0,0.1,0.4-0.6,0.8-0.9,0.8-1,1-1.2,1.1-1.3,1.2-1.7,1.5-2,1.5-9,10-30,2-2.3,2-2.5,2.3-3.5,3-3.5,3-5,3.5-4,4-4.5,4.5-7,5,5-7,50-100,<,?,absent,acuminate,age,aid,along,always,anther,anthesi,apart,apex,appearing,articulated,articulation,atop,bark,basal,base,berry,branching,brow,brown,c.,calyx,capitate,cell,clearly,climbing,cm,comical,conical,cordate,corolla,cucullate,cupped,dark,deflexed,densely,diameter,differentiated,distal,distinct,drying,due,eaf,eed,ellipsoid,elongate,entire,expanding,exserted,filament,flattened,flexuous,flower,free,fruit,fruiting,glabrous,globose,growth,inflated,later,leaf-opposed,leaving,lengthening,liana,lobe,lobed,lower,margin,mere,midrib,minute,minutely,mm,narrowly,new,nflorescence,nodding,oblique,occasionally,older,outline,ovary,ovate,overall,ovoid,pair,pale,papillo,papillose,part,particularly,pedicel,peduncle,peg,per,perfect,pericarp,petiole,pitted,planar,plurifoliat,poin,point,pore,poricidal,portion,primary,pubescent,purple,quarter,receptacle-like,red,reddish,reniform,rim,ripe,ruit,scar,series,shape,shiny,shrub,simple,sinuate,slender,slightly,slit,somewhat,spaced,stellate,stem,stigma,stout,strongly,structure,style,support,surface,swolle,terminal,testal,thin,time,tip,trichome,truncate,tub,tube,twisting,ud,undulation,uniseriate,unit,upper,vein,vining,violet,way,widely,woody,x,ympodial,Â½	
63	wfo-0001026607	success	204	143	114	90	29	0.559	0.1-0.3,0.8-3.4,0.8-4.5,0.8-5,1-10,1-2,1-8,1.5-4,10-30,2-10,2-2.5,2.5-3.8,3-8,4-10,4-6,5,6-10,abaxially,absent,acute,adaxially,anther,apart,apex,apparently,articulated,attenuate,axe,axillary,base,basiscopic,berry,brownish,bud,cell,chartaceous,cm,coarse,condition,corolla,covering,decurrent,deep,diameter,distal,dot,drying,elliptic,filament,finely,flower,forked,forming,fresh,fruit,generally,glabrous,globose,green,green-white,greenish,hair,hair-like,half,herb,high,lateral,leaf,like,lobe,long,make,margin,medium,membranous,minute,mm,moderately,mucilaginous,obtuse,odd-pinnate,often,ovate,ovoid,pedicel,peduncle,perfect,petiole,plant,puberulent,pubescent,rachi,ripe,rosette,rounded,scattered,seed,sessile,side,simple,spaced,stem,style,subtending,terminal,testal,thick,throughout,usually,violet,wall,wet,white,whitish	0-3,0-4,0.3-1.8,0.5-5.8,1-3.8,1-5,2-3,2.4-5.8,2.7-19,5-merou,5.8-19.8,acumen,ag,along,alyx,blade,capitat,ciliate,clavate,clearly,connivent,decreasing,digestion,dorsally,eaf,edge,eed,enzyme,especially,exceeding,flat,folded,geminat,glabrou,greatly,gree,hal,homostylous,honeycomb,interjected,lanceolate,larger,leaflet,lengthening,living,lower,marked,midrib,minutely,much,nflorescence,orbicular,orolla,pair,pentagonal,petiolulate,plurifoliate,pore,poricidal,present,rarely,removed,ruit,semierec,seudostipule,shaped,short,size,slit,sometimes,specimen,stamen,ste,stigma,straight,tall,tamen,tem,tip,toward,tri-,tube,typically,unit,unwinged,vary,without,x,yellow,ympodial	abaxial,adaxial,arrangement,branching,calyx,characteristic,colour,form,growth,height,history,inflorescence,length,life,mentioned,midvein,ovary,primary,pseudostipule,semierect,shape,staman,surface,tertiary,texture,true,unarmed,vein,venation
64	wfo-0001026613	success	159	110	78	81	32	0.491	0.6,1-10,1-2,2.3-8,2.5-2.8,3-5,4-5,5,5-6,5-7,6-12,6-8,8-18,8.5-10,8.5-9,abaxially,acuminate,adaxially,anther,apart,apex,apparently,articulated,attenuate,axe,axillary,base,berry,bud,cm,conical,cordate,corolla,densely,diameter,distal,filament,flower,forked,fruit,generally,glabrous,green,hair,half,herb,immature,leaf,like,lobe,long,m-1.2,margin,mature,middle,minute,mm,mottled,odd-pinnate,pedicel,peduncle,perfect,petiole,plant,plurifoliate,proximal,pubescent,purple,spaced,sparsely,stem,style,subtending,terminal,tri-,unit,unknown,usually	0.5-1,1.5-4,11-19.5,2-7.5,3-10,4.5-8.5,5-merou,5.5-7,6.2-9.5,9.5-13.5,absent,acumen,ag,along,alyx,blade,borne,capitat,chartaceous,ciliate,connivent,decreasing,dorsally,eaf,edge,eed,end,erec,especially,flat,folded,geminat,greatly,hal,homostylous,interjected,lanceolate,larger,lateral,leaflet,lengthening,lower,membranous,midrib,minutely,nflorescence,orolla,ovate,pair,petiolule,pore,poricidal,puberulent,pubescen,rotate-pentagonal,ruit,secondary,semierect,seudostipule,singly,size,slit,ste,stigma,stolo,subequal,symmetrical,tall,tamen,tem,tip,toward,tube,tuber,typically,unknow,unwinged,vary,x,yellow,ympodial	abaxial,adaxial,arrangement,branching,calyx,characteristic,colour,form,geminate,growth,height,history,inflorescence,length,life,mentioned,midvein,ovary,primary,pseudostipule,rachi,seed,shape,staman,surface,sympodial,tertiary,texture,true,unarmed,vein,venation
65	wfo-0001026614	success	200	162	127	73	35	0.635	.8,0.2,0.4-0.7,0.5,1-,1.3-1.8,11-15,15â30,1â2,1â3,1â5,2.2,2.2-5.5,2.5,20â25,2â4-branched,3-foliate,3.2-5.2,3â10,4-7,5,50,9â16,>,abaxially,across,acuminate,acute,adaxially,anther,apart,apex,apparently,articulated,axe,base,berry,black,brown,calyx,clavate,closely,cm,commonly,concentrated,cylindrical,dark,densely,denser,diameter,dried,entire,erect,especially,expanded,extra-axillary,filament,flattened-reniform,flower,foveolate,fruit,geminate,glabrescent,glabrous,gland-tipped,globose,hair,irregularly,lanceolate-attenuate,lateral,leaf,less,lobe,lobed,margin,midvein,minute,minutely,mm,mottled,oblique,obtuse,often,orange,orange-red,ovate,ovate-lanceolate,pair,pedicel,peduncle,per,perfect,petiole,pubescence,pubescent,rachi,reflexed,repand,ripe,rounded,scattered,sessile,shallowly,shrub,side,similar,simple,slightly,smaller,sometimes,somewhat,soon,spaced,sparsely,stellae,stellate,stellate-pubescent,stem,style,surface,unarmed,usually,vein,white,x,yellow,yellowish	0.2â0.3,0.5â2,1.5â2,2.5â3,2â4,2â6.5,4.5â11,4.5â5.5,5-merou,5.3-8.2,6.4-8.4,6â8,7.2-9.8,8â10,absent,adaxiall,alyx,armed,ba,blade,blunt-tipped,broad-based,campanulate,capitat,chartaceous,developed,directed,distally,eaf,eed,evenly,fleshy,fruiting,globo,golden,homostylous,internode,interpetalar,linear,lon,long,lower,midpoint,nearly,nflorescence,orolla,ovoid,pore,prickle,rarely,ray,rotate-pentagonal,ruit,shin,spreading,stigma,tall,tamen,tapering,tem,time,tissu,tissue,tube,ud,unarme,vary,weakly,well,wide,ympodia,young,â5	1-2,1.5-2,2-4,2.5-3,4.5-5.5,8-10,abaxial,adaxial,arrangement,branching,characteristic,colour,corolla,explicitly,form,growth,height,history,inflorescence,length,life,mentioned,null,ovary,plant,primary,pseudostipule,seed,shape,shiny,staman,tertiary,texture,true,venation
66	wfo-0001026642	success	193	165	117	76	48	0.606	.05,.8,0.1,0.25,0.4,0.4â2.2,0.5,0.5â3.5,0.6,1.0,12â30,1â3,3.0â5.1,4â7,50â100,6,<,abaxial,abaxially,acute,adaxially,along,annual,anther,anthesi,apart,apex,appressed,articulated,axillary,base,bipinnate,black,blue,borne,branched,brown,calyx,cell,circular,cm,cylindrical,dark,decumbent,densely,denser,diameter,either,elliptic,erect,filament,flattened,flower,fruit,glabrous,gland,glandular,globose,green-purple,hair,half,herb,lavender,leaf,length,lilac,lobe,long,lower,mm,moderately,multicellular,narrow,number,obtuse,occasionally,ovate,pale,pedicel,peduncle,perennial,perfect,petiole,pinnae,pinnate,pitted,present,primary,pubescent,rounded,secondary,sessile,shallowly,shoot,side,simple,sometimes,spaced,sparsely,stone,straight,style,subglabrous,surface,time,unicellular,uniseriate,usually,vein,violet,white,wide,wing,x,â11.0,â4.5,â6	.1,0.1â0.3,0.2,0.5â,0.5â0.7,0.5â1.7,0.5â2.0,0.6â1.0,0.75â1.0,0.75â2.0,0.7â1.6,0.8â1.2,1.0â2.0,1.2â1.7,1.2â2.0,1.2â3.5,1.2â6.2,1.6â8.0,1.9â3.0,1â10,2.0â4.0,2.5â3.5,2.5â4.0,2.8â3.0,3â5,4.0â6.0,5,5.0â7.0,adaxiall,ag,axe,ba,blade,chartaceous,clavate,connivent,decreasing,divided,eaf,eed,equal,fleshy,geminat,glabrescen,indumentum,lon,longitudinal,m.,nflorescence,oblong,often,opening,orolla,pair,pentagonal,pore,poricidal,probably,rapidly,ruit,slit,stigma,tal,tamen,tem,tip,tube,unifoliate,unit,vary,woody,yellow,ympodial,â1.2,â2.0,â7	--,0.3,0.7,0.75,0.8,1,1.2,1.6,1.7,1.9,10,2.0,2.8,3.0,3.5,4.0,4.5,5.0,6.0,7.0,adaxial,arrangement,branching,characteristic,colour,corolla,form,glabrescent,growth,height,history,inflorescence,life,margin,mentioned,midvein,ovary,plant,pseudostipule,rachi,seed,shape,staman,stem,tertiary,texture,unarmed,venation
67	wfo-0001026651	success	222	194	166	56	28	0.748	-celled,0.9â3,1,1.8,1â2,2.2â10,2.8,2â11.5,2â13,2â3,2â4,2â4.5,2â8,3,3â7,4,4â6,4â7.8,6â10,6â14,8,abaxially,acuminate,acute,adaxially,along,anther,antror,antrorse,antrorsely,apex,appressed,arcuate,ark,articulated,asymmetric,attenuate,axi,base,beneath,berry,beyond,branch,brochidodromous,brown,brownish-green,calyx,capitate,cell,chartaceous,ciliate,cm,connivent,cyme,dark,decumbent,decurrent,densely,diameter,discolorous,drying,dull,entire,equal,erect,exfoliating,exserted,eye,filament,flattened,flexuous,flower,fruit,geniculate,glabrescent,glabrous,glandular,globose,green,growt,hair,head,herb,hilum,hollow,impressed,lanceolate,lateral,leaf,length,less,light,like,lobe,long,lying,major,margin,matte,midrib,mm,moderate,moderately,much-branched,multicellular,naked,narrowly-elliptic,new,normally,oblong-ellipsoid,older,one,onto,ovate-deltate,ovate-reniform,parallel,pedicel,peduncle,pedunculate,per,petiole,plant,prominent,pubescence,pubescent,region,revolute,ripe,rounded,secondary,seed,shape,shiny,shrub,similar,simple,single-celled,slightly,small,sometimes,spaced,stalk,stamen,stem,style,sub-opposite,surface,tall,terminal,translucent,trichome,turning,unbranched,undulate,uniseriate,upper,usually,vein,venation,visible,white,wide,woody,yellow,young,Ã	0.2â1.3,0.35â2.6,2â3.3,3-plurifoliate,3â5,5-merou,absent,accrescent,adaxiall,alyx,anisophyllous,apar,broadly,capitat,circular,cordate,cylindrical,differing,directed,eaf,eed,elliptic,emarginate,frui,geminate,glabrou,highly,introrsely,longitudinal,lower,markedly,membranaceous,minor,mostly,nflorescence,obtuse,opening,orolla,ovate-lanceolate,perfect,pore,poricidal,reduce,ruit,size,slit,smaller,stellate,stigma,straight,subapical,tamen,tem,unit,vary,ympodial	--,2,3.3,4.5,abaxial,adaxial,apart,arrangement,branching,characteristic,colour,corolla,form,growth,height,history,inflorescence,life,midvein,null,ovary,primary,pseudostipule,rachi,staman,tertiary,texture,unarmed
68	wfo-0001026656	exception_thrown	211	0	0	211	0	0.0		0-4,0.3-3,0.3-4.2,0.4-6.5,0.7-10.5,0.9-13,1,1-1.8,1-10,1-2,1-3.8,1-4,1-5,1.1-8.1,1.5-7,10,2-6,2-8,2.5-17,20-60,4-10,4-13,4-8,5,5-18,5-35,5-merou,5.5-27,9-11,abaxially,absent,acumen,acuminate,acute,adaxially,ag,along,alyx,anther,apart,apex,articulated,attenuate,base,bearing,blade,blue,borne,broadly,brownish,bud,capitate,cell,chartaceous,ciliate,clavat,cm,condition,connate,connivent,corolla,covering,cuneate,curved,dark,decurrent,densely,diameter,digestion,distal,dorsally,dot,drying,eaf,edge,eed,elliptic,end,enzyme,erec,especially,exceeding,filament,flat,flower,folded,forked,fresh,fruit,geminat,generally,glabrous,glaucous,globose,greatly,green,green-white,greenish,greenish-yellow,hair,hair-like,half,herb,homostylous,honeycomb-shaped,interjected,lanceolate,larger,lateral,leaflet,lengthening,light,like,living,lobe,long,lower,lunate,make,margin,membranous,middl,midvein,minutely,mm,moderately,mottled,mucilaginous,narrowly,nflorescence,non-glandular,oblique,occasionally,odd-pinnate,often,orolla,ovate,ovoid,pair,pedicel,peduncle,pentagonal,petiole,petiolulate,petiolule,plant,plurifoliate,pore,poricidal,puberulent,pubescen,pubescent,purple,rachi,ranging,removed,rotate-pentagonal,ruit,scale-like,scattered,seed,seudostipule,short,singly,slightly,slit,sometimes,somewhat,spaced,specimen,stamen,star,ste,stem,stigma,stolo,straight,style,subequal,subglabrous,subtending,symmetrical,tall,tamen,tem,terminal,tertiary,testal,therefore,thick,throughout,tinged,tip,tri-,truncate,tube,tuber,typically,unit,unwinged,vary,violet,wall,wet,white,whitish,wide,wing,without,yellow,ympodial	
69	wfo-0001026663	success	251	182	155	96	27	0.618	-15,-2.9,/25-1/15,/3,0-160,0.2-0.6,0.3-0.8,0.4-2.2,0.9-1.5,1,1-2.5,1-3.2,1-5,1.1,1.1-2.1,1.2-2,1.4-2.6,1.4-3.1,1.6-2.3,1/2,1/3,10.3-13.2,12-14,2-12,2.1-2.6,2.9-5,2/3,3.8-5.7,31,4.7-25.9,5.5-,7.5-9,8-17,abaxially,acuminate,acute,adaxially,along,anther,apart,apex,appressed,articulated,ascending,attenuate,axe,axillary,base,berry,blade,branched,broadly,brown,calyx,chartaceous,closely,cm,conical,constricted,corolla,dark,densely,diameter,distributed,drying,echinoid,echinoid-pubescent,entire,especially,filament,fleshy,flower,fruit,glabrescent,globose,granular,granular-tomentose,green,greenish-brown,hair,immature,lateral,leaf,length,less,lobe,long,long-stalked,lower,main,many,margin,midrib,midvein,mm,multangulate,multangulate-pubescent,nearly,obtuse,occuring,openly,ovate,pale,pedicel,peduncle,persistent,petiole,plurifoliate,porrect-stellate,present,pseudo-terminal,pubescent,rachi,ray,rich,robust,scabrous,sessile,short,short-stalked,shrub,side,simple,slightly,small,soon,spaced,sparsely,stalk,stalked,stem,stigma,style,subcoriaceous,subglabrous,subglobose,tangled,thick,time,tip,tomentose,tomentose-pubescent,tomentum,touching,tree,unarmed,unit,upper,usually,vein,violet,way,white,whitish,x	-8,-9.7,.5-2.5,1.9-2.6,1/4-1/2,10-26,2.5-3.7,2.8-5.3,24-45,3-5,3.5-5,4.5-5.7,5-8,5.5-8.8,accrescent,adaxiall,ag,angled,anthesi,apparently,around,bark,becoming,blunt-tipped,branch,bud,capitat,completely,covering,cylindrical,directed,distally,eaf,echinoi,edge,eed,elongated,enveloping,evident,exserted,farinose,flared,free,fruiting,glabrescen,glabrous,grooved,inserted,lanceolate,lengthening,light,line,lined,lobed,long-stalke,longer,longitudinal,longitudinally,m.,matur,minute,nflorescence,occasional,older,opening,orolla,ovate-lanceolat,ovate-lanceolate,perfect,pore,poricidal,pubescence,rather,ridged,ruit,runk,slit,sometimes,somewhat,stamen,stellate,strongly,subcampanulate,suture,tall,tamen,terete,thin,tube,ud,unarme,vary,wide,yellow,ympodial,young	abaxial,adaxial,arrangement,branching,characteristic,colour,form,growth,height,history,inflorescence,life,mature,null,ovary,plant,primary,pseudostipule,seed,shape,staman,surface,sympodial,tertiary,texture,trunk,venation
70	wfo-0001026686	success	196	129	97	99	32	0.495	0.2-0.5,0.6-0.9,1-10,1-2,1.5-7,1.7-2.5,10-28,2-9,2.4-3.6,3-4,4-6,5,5-8,6.5-12.7,7-9,8-10,8-14,abaxially,acumen,acuminate,adaxially,anther,apart,apex,apparently,articulated,axe,axillary,base,berry,brownish,bud,cell,cm,condition,conical,corolla,covering,densely,diameter,distal,drying,elliptic-lanceolate,filament,flower,forked,fresh,fruit,generally,glabrous,green,green-white,greenish,hair,half,herb,lanceolate,lateral,leaf,leaflet,light,like,lobe,long,make,margin,middle,minute,mm,mottled,mucilaginous,odd-pinnate,ovoid,pedicel,peduncle,perfect,petiole,petiolule,plant,pubescent,purple,purple-violet,ripe,seed,spaced,sparsely,style,subtending,symmetrical,terminal,testal,thick,throughout,usually,wall,wet,whitish	.4,1,1-2.5,1.2-3.4,1.2-3.6,2-10,2.5-8,3-5,3.7-8,5-16.5,5-merou,8-27,absent,ag,along,alyx,blade,borne,capitat,chartaceous,ciliate,connivent,decreasing,digestion,dorsally,eaf,edge,eed,end,enzyme,equal,erec,especially,exceeding,flat,folded,geminat,glabrou,gradually,hair-like,homostylous,honeycomb-shaped,interjected,larger,lengthening,living,lower,midrib,minutely,nflorescence,obtuse,often,orbicular,orolla,ovate,pair,plurifoliate,pore,poricidal,puberulent,pubescen,removed,rotate-stellate,round,ruit,secondary,semierect,seudostipule,singly,size,slightly,slit,specimen,stamen,star,ste,stigma,stolo,straight,stripe,subequal,subsessile,tall,tamen,tem,tip,toward,tri-,tube,tuber,typically,unit,vary,white,wide,wing,x,yellow,ympodial	'hair-like,abaxial,adaxial,arrangement,branching,calyx,characteristic,colour,form,growth,height,history,inflorescence,length,life,mentioned,midvein,ovary,primary,pseudostipule,rachi,shape,staman,stem,surface,tertiary,texture,true,unarmed,vein,venation,Â¼
71	wfo-0001026696	success	139	138	100	39	38	0.719	0.3-4.5,0.8-7,1,1-1.3,1-4,1.3-2.1,1.5-3,2-3,3-17,3-3.5,3-6,3-8.5,4-16,5-35,9,abaxially,acumen,acute,adaxially,apex,apiculate,articulate,base,branched,broadly,calyx,cell,cm,corolla,covering,cuneate,cyme,decurrent,densely,diameter,dichasial,dichasially,digestion,distal,ebracteate,emoval,entire,enzyme,exceeding,filament,flower,forked,generally,globose,green,green-white,hair-like,half,herbaceous,honeycomb,lanceolate,lateral,light,linear,living,lobe,long,make,margin,mm,monochasial,mucilaginous,oblong,obtuse,odd-pinnate,often,ovate,ovoid,pattern,pedicel,peduncle,perennial,perfect,petiole,plant,proximal,pubescent,reveal,rounded,seed,sinuate,specimen,stamen,stigma,straight,style,testal,thick,throughout,tuber-bearing,typically,unit,wall,white-cream,Â¼	0.9-7.2,2-17,3-6-foliat,apical,apically,connate,dehiscent,dorsally,eaf,edge,eed,flat,folded,globo,introrse,light-yello,lon,lower,lunat,maturing,nflorescence,nther,orolla,plan,poricidally,ruit,seudostipule,short,simple,slit,stellate,tal,tem,throughou,vary,wide,without,yellow,ympodial	'hair-like,3-6-foliate,abaxial,adaxial,anther,arrangement,ba,branching,characteristic,colour,form,fruit,growth,height,history,inflorescence,leaf,length,life,light-yellow,lunate,mentioned,midvein,ovary,primary,pseudostipule,rachi,shape,staman,stem,surface,sympodial,tall,tertiary,texture,unarmed,vein,venation
72	wfo-0001026706	success	232	166	140	92	26	0.603	-3.1,-4.4,-6.1,.5,/14-1/6,0-240,0.2-0.3,0.2-0.5,0.6-2.2,0.8-1.2,0.8-1.5,0.8-2.8,0.9-2,1-2.2,1-5,1.1-4,1.5-3,10-15,12,14-32,2.5-3,2/3-3/4,3-4.6,3.1-3.8,3.6-5.7,4,4.2-12,4.5-5.5,5.3-6.4,6.1-,7-16,8-14,9.8-15.4,abaxially,acute,adaxially,anther,apart,apex,appearing,articulated,attenuate,axe,axillary,bark,base,berry,blade,branched,brown,calyx,chartaceous,closely,cm,coriaceous,corolla,crisped,cuneate,cylindrical,dark,dendritic-multangulate,densely,diameter,entire,exserted,filament,fleshy,flower,fruit,glabrate,globose,green,hair,herbarium,lacking,lateral,leaf,length,lobe,long,lower,main,many,margin,midrib,mixed,mm,multangulate,obtuse,occasionally,older,ovate,ovate-elliptic,pale,pedicel,peduncle,petiole,plurifoliate,porrect-stellate,pseudo-terminal,pubescent,rachi,reticulate-punctate,semi-ovate,sessile,short-stalked,shrub,side,simple,slightly,small,softly,somewhat,spaced,sparsely,specimen,stalked,stamen,stem,style,subconical,subglobose,suborbicular,sulcate,surface,time,tomentose-pubescent,touching,translucent,tree,unarmed,unit,vein,velutinous,wavy,white,whitish,wide,x,yellowish-tan	-5.5,0.9-1.9,1/2-2/3,2.2-3.3,2.3-3.8,2.7-4,2.9-6,5-6.5,6-10,6-8,accrescent,adaxiall,ag,anthesi,apparently,around,ba,becoming,blunt-tipped,branch,bud,capitat,completely,covering,dendritic-echinoid,directed,distally,eaf,edge,eed,enveloping,farinose,fourth,free,fruiting,furfuraceou,glabrous,golden,grayish,indument,inserted,lackin,lanceolate,lengthening,lobed,long-stalked,longitudinal,m.,matted,minute,multangulat,nearly,nflorescence,oblong,obscured,often,orolla,ovate-lanceolate,perfect,persistent,pore,poricidal,pubescence,rather,reddish,ruit,runk,short-,slit,soon,splitting,stellate,stigma,strongly,subcampanulate,suture,tall,tamen,thin-walled,tip,tomentu,transparent,tube,ud,unarme,unevenly,upper,vary,way,yellow,ympodial,young	abaxial,adaxial,arrangement,branching,characteristic,colour,form,growth,height,history,inflorescence,life,midvein,ovary,plant,primary,pseudostipule,seed,shape,staman,sympodial,tertiary,texture,true,unspecified,venation
73	wfo-0001026707	success	196	134	102	94	32	0.52	-5,.5,.8,0,0.5-1,0.6-0.7,0.7-1,0.7-1.4,0.7-1.5,1-3,1.5-1.8,1.6-2,1/3,2-2.3,2-6,2.5-4,3-4,3-4.5,3-8,4,5-25,8-15,?,acute,anther,apex,apically,apparently,articulated,attenuate,base,berry,branched,broad-deltate,calyx,clustered,cm,color,decurrent,diameter,entire,erect,eye,filament,flattened-reniform,flower,free,fruit,glabrous,green,infructescence,known,lateral,leaf,length,lobe,long,lower,margin,mauve,mm,moderately,naked,narrow-oblong,obtuse,one,open,orange-brown,pedicel,peduncle,per,pericarp,petiole,portion,prickle,prickly,pubescent,rounded,shrub,small,smooth,sometimes,sparsely,spherical,stellate-pubescent,stem,style,surface,terete,terminal,time,tip,tree,unarmed,unit,upper,venation,visible,white,wide,yellow-green,Â¼	-1/3,-3,/3,0-20,0.05,0.05-0.15,0.1-0.2,0.3-0.8,0.5-3,0.6-0.8,1-1.7,1-5,1/3-1/2,1/3-3/4,1/4-1/3,1/8-1/4,11-16,2-10,2.5-3,2.5-6,3-7,5-10,5-7,5-8,5-merous,abaxially,alyx,apar,apart,bark,blade,branche,broadly,chartaceous,concolorous,connivent,curved,cuspidat,densely,discolorous,drying,eaf,eed,elongating,equal,foliaceous,fruiting,fused,gently,glabrescent,glabrou,gray,inflated,juvenil,less,lobed,longer,mature,midpoint,narrow-deltate,nflorescence,older,orolla,oung,perfec,plurifoliat,poricidal,porrect,porrect-lepidote,ray,red-brown,reflexed,ruit,scar,sessile,shorter,simple,slender,spaced,spreading,stalk,stalked,stellate,stout,straight,tamen,tapering,trichome,tube,variously,vary,way,weakly,ympodial	abaxial,adaxial,arrangement,branch,branching,characteristic,colour,corolla,cuspidate,form,growth,height,history,inflorescence,juvenile,life,midvein,null,ovary,plant,plurifoliate,primary,pseudostipule,rachi,seed,shape,staman,sympodial,tertiary,texture,vein,young
74	wfo-0001026711	success	210	140	117	93	23	0.557	-2,-7,.5,0,0-0.2,0-25,0-4,0-6,0.3-1,0.5-1.5,0.7-,0.7-1.4,0.75-1,0.9-1.1,1-2,1.5-2.2,1/3,1/4,2-2.2,2-3.5,2-6,2.1-2.5,3-4,3-4.5,3-7,3.5-5.2,4.5-7,acute,anther,apex,apically,apparently,articulated,base,berry,branched,calyx,cell,cm,cuneate,curved,densely,diameter,difoliate,distance,dull,elliptic,erect,evenly,extending,faint,filament,flattened-reniform,flower,fruit,glabrous,green,lateral,leaf,length,lobe,lobed,long,lower,margin,maturity,mauve,midvein,mm,narrow-deltate,obtuse,occasionally,one,open,orange,orange-brown,outline,pair,pedicel,peduncle,per,petiole,pit,prickle,prickly,primary,purple,raised,red,rounded,shallowly,shrub,side,slender,small,smooth,sometimes,spherical,stellate-pubescent,stem,style,surface,terete,terminal,tertiary,time,unarmed,uniform,upper,vein,venation,visible,weakly,wide,yellow,yellow-green,young	-15,-5,-6,.2,.8,0.1,0.15,0.2-0.3,0.7-0.9,0.8,0.8-2.2,0.9-1.5,1-,1-30,1.5-,1.7-4,1/,1/2-2/3,1/4-1/3,2-2.5,2-4,3-5,4-8,5-merous,7-8,abaxially,acicular,acuminat,alyx,ame,apar,apart,bark,blade,brow,c.,concolorous,connivent,deltate,discolorous,drying,eaf,eed,elongating,equal,free,fruiting,geminat,infructescence,less,longer,mature,midpoint,moderately,nflorescence,older,orolla,oung,pale,pendulous,perfec,pericarp,perpendicular,poricidal,porrect,portion,prickl,ray,reduced,reflexed,ruit,scar,sessile,shorter,somewhat,spaced,spreading,stalk,stalked,stellate,straight,tamen,tapering,thick-chartaceous,tip,trichome,tube,unit,variously,vary,way,woody,ympodial	abaxial,acuminate,adaxial,arrangement,branching,characteristic,colour,corolla,form,growth,height,history,inflorescence,life,null,ovary,plant,pseudostipule,rachi,seed,shape,staman,texture
75	wfo-0001026717	success	207	164	130	77	34	0.628	0.3-5,0.6-1.5,0.8,1-10,1-2,1-3,1.3-2.5,1.4-2.2,1.8-3,13-28,14-22,15-34,2.5-4.5,2.5-5.5,3-4,3-6,3.3-11,4-6,4-8,4-9,5,5-11,5-13.5,5-6,5.3-9,7-11,abaxially,acumen,acuminate,adaxially,anther,apart,apex,apparently,articulated,attenuate,axe,axillary,base,berry,blade,brownish,bud,cell,cm,condition,conical,corolla,covering,dark,darker,decurrent,diameter,digestion,distal,drying,elliptic,enzyme,filament,flower,forked,fresh,fruit,generally,glabrous,green,green-white,greenish,hair,half,herb,honeycomb-shaped,interjected,lanceolate,lateral,leaf,leaflet,light,like,lobe,long,make,margin,medium,middle,minute,mm,mottled,mucilaginous,narrow,odd-pinnate,often,orbicular,ovate,ovoid,pedicel,peduncle,perfect,petiole,petiolule,plant,plurifoliate,pubescent,purple,removed,ripe,seed,sessile,spaced,sparsely,straight,stripe,style,subglabrous,subsessile,subtending,symmetrical,terminal,testal,thick,throughout,tri-,unit,usually,violet,wall,wet,whitish,wing,x	0.3-0.6,0.3-2.5,1-2.5,2.2-5,3-5,5-merou,ag,along,alyx,borne,capitat,chartaceous,ciliate,connivent,decreasing,dorsally,eaf,edge,eed,end,equal,erec,especially,exceeding,flat,folded,geminat,glabrou,gradually,hair-like,homostylous,larger,lengthening,living,lower,membranous,midrib,minutely,nflorescence,obtuse,one-quarte,orolla,pair,pentagonal,pore,poricidal,present,puberulent,pubescen,rotate,round,ruit,secondary,semierect,seudostipule,singly,size,slightly,slit,specimen,stamen,ste,stigma,stolo,subequal,tall,tamen,tem,tip,toward,tube,tuber,typically,vary,wide,yellow,ympodial	'hair-like,abaxial,adaxial,arrangement,branching,calyx,characteristic,colour,description,form,geminate,growth,height,history,inflorescence,length,life,mentioned,midvein,one-quarter,ovary,primary,pseudostipule,rachi,shape,staman,stem,surface,sympodial,tertiary,texture,unarmed,vein,venation
76	wfo-0001026725	success	166	134	106	60	28	0.639	.3,.5,/4,0.2,0.7-1.2,1-1.2,1-1.5,1-4.5,1-5,1.5,1.5-2,1.6-2,1/2,2,3.5-4,5-20-flowered,5-6,8-9,acute,anther,apart,apex,axil,base,beneath,berry,broadly,calyx,capitate,character,cm,corolla,dark,dia,difoliate,dry,drying,elliptic,evenly,extremely,filament,flattened-reniform,free,fruit,geographically,glabrous,glandular-papillose,globose,green,greenish-white,incrassate,large,lateral,leaf,less,lobe,long,main,major,margin,material,minor,minutely,mm,occasionally,onto,opposite,ovary,ovate,pair,pale,papillose,pedicel,petiole,pitted,portion,pubescent,reddish-brown,rounded,scar,scarious,short,shrub,simple,slender,spaced,stem,straight,style,subshrub,surface,tan,tapering,tip,triangular,trichome,tube,tuft,uniseriate,upper,varying,vein,way,white,winged,x	1.2-1.7,2.2-4,3.6-7.7,5-5.5,8-18.6,accrescent,anthesi,attenuate,bark,becoming,black,bluish,brownish-papillose,crackin,cup-shaped,deflexed,differing,eaf,edicel,eed,ellipsoid,fruiting,geminat,inflorescenc,interpetalar,lobed,lon,lower,margine,middle,nflorescence,often,older,one,open,ovoid,paler,papillo,planar,pore,poricidal,prominent,proximal,reflexed,ruit,shaped,sinus,size,slightly,split,stigma,stretching,tall,tear-drop,ud,unit,widest,woody,ympodial,young	abaxial,adaxial,arrangement,branching,characteristic,colour,diameter,form,growth,height,history,inflorescence,length,life,midvein,null,peduncle,plant,primary,pseudostipule,rachi,seed,shape,staman,tertiary,texture,unarmed,venation
77	wfo-0001026733	exception_thrown	188	0	0	188	0	0.0		-1,-11,-13,-14,-15,-2,-4,-7,-8,.5-3,0.3-0.5,0.3-2,0.5,0.5-1,0.5-2,0.5-4,1,1-1.5,1-2,1-3,1-7,1.5-14,1.5-2,1.5-2.5,10-20,15-,2-2.5,2-3,2-4,2-6,2.5-7.5,20-50,25-40,3-15,3-3.5,3-4-foliat,3-7,4,4-23,4-5,4.5-5,5-8,7-10,8-12,abaxially,acuminate,acute,acute-acuminate,adaxially,aggregate,apart,ape,apex,articulated,axe,basal,base,beyond,blade,calyx,capitat,cell,chartaceous,ciliat,cm,color,connective,connivent,cordate,curled,cylindrical,deltate,dense,densely,dia,diameter,directed,distally,eaf,eed,eglandular-pilose,eglandular-pubescent,eglandular-villous,ellipsoidal,elliptic-ovate,entire,equal,especially,exceeding,exserted,flattened,flower,forked,fruit,fusiform,glabrate,glabrous,gland-tipped,glandula,glandular-,glandular-puberulent,glandular-tomentose,green,greyish,hair,hirsute,immature,lanceolate,leaving,linear-triangular,lobe,lon,long,longitudinal,lower,margin,membranaceous,midrib,mm,moderately,narrowly,near,nflorescence,nther,oblique,orolla,ovate,ovoid,ovum,pedicel,pedicellar,peduncle,perfect,petiole,pilose,pore,present,pubescent,pubescent-pilo,pubescent-pilose,rachi,radiu,remnant,ripe,round,ruit,shining,shorter,simple,slightly,small,smooth,sometimes,spaced,sparsely,stamen,stellate,stigma,stone,stripe,style,submarginally,swelling,tal,tem,thecae,time,toward,tree,triangular,truncate,tube,ud,unbranched,unit,unknow,unknown,usually,vary,vein,villous,white,white-puberulent,wide,x,yellow,yellowish,ympodial	
78	wfo-0001026734	success	266	237	211	55	26	0.793	0.1,0.2,0.3,0.5,0.6,0.7â0.9,0.7â1,0.8â1,1,1.6â2,1.6â2.5,1.8â3,1/4,1â1.2,1â3,2.2â7,2.3â5,2.5â3,2â2.4,2â3,3,3â4-celled,3â8,4â6,4â7,4â8,4â9,5â9,8,abaxial,abaxially,absent,accrescent,acuminate,acute,adaxial,adaxially,also,always,anther,apex,apical,articulated,associated,asymmetric,axi,barely,base,becoming,beneath,berry,blade,branch,branched,bright,broadly,brown,calyx,camptodromous,capitate,central,clavate,closely,cm,commonly,congested,corolla,covered,covering,cuneate,cylindrical,cyme,dark,dense,densely,denser,diameter,differing,distally,downward,dried,drying,due,eglandular,elliptic,entire,f.,fewer,flattened,flower,foliate,found,free,frequently,fruit,geminate,glabrescent,glabrous,glandular,globose,gray,green,growth,hair,held,immature,initially,internodal,irregular,j,lamina,lanceolate,lateral,leaf,length,less,lobe,long,long-attenuate,longer,margin,material,mature,maturity,midpoint,minute,mm,moderately,much,multiseriate,narrow,near,new,normally,oblong,obovate,observed,obtuse,often,old,older,one,other,ovary,ovate,pair,paired,pale,papillose,pedicel,peduncle,petiole,pit,plane,porrect,porrect-stellate,portion,pubescence,pubescent,purple,purplish,rachi,raised,rarely,ray,rayed,reaching,reniform,rounded,scandent,secondary,sessile,shape,shiny,short-stalked,shorter,shrub,simple,size,slightly,smaller,sometimes,spaced,sparse,sparsely,spread,stalk,stellate,stem,stigma,still,style,subopposite,subsessile,surface,terminal,trichome,tube,tuft,unbranched,unequal,uniseriate,unit,vein,venation,vestiture,visible,white,whole,wide,yellowish	1.8â2.2,3.2â3.8,3â4,5-merou,adaxiall,ag,alyx,anthesi,apice,archin,ark,beneat,caly,celled,chartaceous,connivent,directed,discolorous,eaf,eed,emergent,erect,flat,forked,glabrescen,ilament,introrsely,large,lobed,longitudinal,lower,lying,maturit,membranaceous,midri,mostly,nflorescence,one-celled,opening,orolla,oung,perfect,pointing,pore,poricidal,ruit,slit,spreading,surfac,ud,upward,vary,yellow,ympodial,Â¾	arching,arrangement,bark,branching,characteristic,colour,filament,form,height,history,inflorescence,larger,life,midrib,midvein,null,plant,primary,pseudostipule,seed,staman,sympodial,tertiary,texture,unarmed,young
79	wfo-0001026740	success	171	158	124	47	34	0.725	-2,0-10,0.5-1,1-10,1-12,1-2,1-3,1-5,10-20,10-30,2-3,2-4,2.5-27,2.5-3,2.5-4.5,2.5-6,20-50,3-15,3-3.5,3-5,3.5-40,4-5,4.5-10,5-40,5-8,6-10,abaxially,absent,acuminate,acute,adaxially,aggregate,also,apart,apex,apiculate,articulated,axe,basal,base,beyond,blade,branched,calyx,cell,cm,cordate,corky,curled,cylindrical,darker,deltate,densely,diameter,eglandular,ellipsoidal,elliptic,entire,especially,exserted,flattened,fleshy,flower,fruit,glabrate,glabrous,glandular-puberulent,greenish,hair,immature,leaving,lobe,long,margin,mature,mm,moderately,near,nearly,oblong,obtuse,often,ovate,pedicel,pedicellar,peduncle,perfect,petiole,pilose,present,puberulent,purple,rachi,radiu,remnant,reticulate,scar,sessile,simple,small,sometimes,spaced,sparsely,stamen,stone,stripe,style,subcoriaceous,time,tomentose,tree,truncate,unbranched,unit,unlobed,vein,villous,white-puberulent,whitish,wide,woody,x,yellow,young	-17,1-4,3-foliat,8-19,absen,acute-acuminate,ape,browni,ciliate,connective,connivent,directed,distally,eaf,eed,equal,exceeding,lanceolate,lon,lower,narrowly,nflorescence,nther,orange,orolla,ovoid,pilo,pore,pubescent,rarely,ruit,shorter,slightly,stellate,stigma,swelling,tal,tems,thecae,toward,triangular,truncat,tube,ud,vary,violet,ympodial	3-foliate,abaxial,adaxial,anther,arrangement,branching,characteristic,colour,corolla,filament,form,growth,height,history,inflorescence,leaf,length,life,mentioned,midvein,ovary,plant,primary,pseudostipule,seed,shape,staman,stem,surface,sympodial,tertiary,texture,unarmed,venation
80	wfo-0001026752	exception_thrown	169	0	0	169	0	0.0		-25,-3,-4,-50,0-,1,1-1.5,1-12,1-2,1-3,1-5,1-6,1.5-12,1.5-2,1.5-2.5,10-20,15-35,2,2-2.5,2-3,2-4,2.5-20,2.5-5,20-30,3,3-18,3-4,3-5,3-foliat,3.5-4,4-45,4-5,7-15,8-16,abaxially,abruptly,absent,acute,adaxially,aggregate,also,apart,ape,apex,apiculate,articulated,axe,basal,base,beyond,black,blade,branched,calyx,campanulate,capitat,cell,chartaceous,cm,connective,connivent,cordate,coriaceous,cuneate,cylindrical,darker,deltate,densely,diameter,dilated,directed,distally,eaf,eed,ellipsoidal,elliptic-oblong,elliptic-ovate,entire,equal,exceeding,exserted,finely,flattened,fleshy,flower,forked,fruit,glabrous,globose,green,greenish-brown,hair,immature,lanceolate,laterally,leaving,less,lobe,lon,long,lower,margin,mm,moderately,narrowly,near,nearly,nflorescence,nther,obtuse,orolla,ovoid,papillose,pedicel,pedicellar,peduncle,perfect,petiole,pilo,pilose,pore,possibly,presence,present,pubescent,pubescent-pilose,purplish,rachi,radiu,rarely,rather,remnant,ripe,ruit,short-acuminate,simple,slightly,small,somewhat,spaced,stamen,stellate,stigma,stone,stripe,style,tal,tem,thecae,time,tomento,tree,triangular,truncate,tube,ud,unbranched,unit,unknow,vary,vein,violet,white,whitish,wide,x,yello,yellow,ympodial	
81	wfo-0001026754	success	176	162	131	45	31	0.744	-6+,.5,0.5,0.5-1,0.9-1.1,1,1-,1.5-3,10,2,2-2.5,2-3,2-4,2.5-3.5,3-4-celled,30+,5,5-lobed,5.5-9,7-9,9,acute,adaxially,along,anther,anthesi,apex,apparently,articulated,asymmetric,axi,basal,base,berry,branched,calyx,cm,complete,conical,connivent,corolla,deeply,dendritic,densely,denser,diameter,divided,ellipsoid,elliptic,entire,especially,extending,filament,flower,glabrous,globose,growth,half,inflorescence,irregularly,lamina,later,lateral,leaf,leaving,lengthening,like,lobe,lobed,long,loosely,lower,many,margin,mature,midvein,minutely,mixture,mm,mostly,narrowly,new,oblique,outline,pair,pedicel,peduncle,peg,petiole,pinnate,pore,poricidal,primary,puberulent,pubescent,scar,seen,simple,sleeve,slender,slit,small,sometimes,spaced,sparsely,splitting,spreading,stem,style,surface,tangled,terminal,time,tip,transparent,trichome,truncate,tube,twining,uniseriate,unit,upper,vein,vine,weak,white,within,woody,x,yellow,yellowish	1/2,198.,2/3,4-5,5-merou,9-11,abaxially,ag,alyx,apar,ark,broadly,brow,cabrera,clavate,cucullat,distal,eaf,ed,exerted,fide,free,halfway,ilament,membranous,minute,nflorescence,older,orolla,papillo,perfect,planar,plurifoliat,portion,ruit,scandent,stellate-rotate,stigma,tem,tub,twinin,ud,vary,way,ympodial	abaxial,adaxial,age,apart,arrangement,branching,brown,characteristic,colour,form,fruit,height,history,length,life,null,ovary,papillose,plant,plurifoliate,pseudostipule,rachi,seed,shape,staman,sympodial,tertiary,texture,true,unarmed,venation
82	wfo-0001026756	success	147	115	83	64	32	0.565	0-7-1.2,0.5-3,1-1.5,1.5-1.7,1.5-10,1.5-2,1.8-3,3-4,5-10,5-10-flowered,5-5.5,6-10,abaxial,abaxially,acute,adaxially,along,anther,apex,apiculate,attenuate,base,berry,brown,calyx,cm,corolla,corresponding,dark,deltate,dendritic,densely,denser,dia,difoliate,elliptic,erect,filament,glabrous,globose,green,hard,lateral,lax,leaf,like,lobe,long,main,minutely,mm,occasionally,opposite,ovary,ovate,ovoid-reniform,pair,pale,pedicel,pericarp,petiole,pinkish-white,pitted,pubescence,pubescent,rest,shape,shrub,simple,sparsely,stem,style,surface,thick,tree,trichome,unifoliate,uniseriate,unit,vein,white,wide,woody	.25,.5,0.25-0.5,0.5-1,1-2,1.5-3,3.5-8.5,6-16,anthesi,ba,bark,bilobed,broadly,closely,conical,deflexed,differing,distal,eaf,edicel,eed,exserted,fleshy,free,fruiting,geminat,glabrescent,grayish-brow,inflorescenc,irregular,lamina,lobed,lower,major,middle,minor,nearly,nflorescence,older,overlappin,papillo,perhaps,planar,pore,poricidal,portion,present,ruit,scar,shaped,somewhat,soon,spaced,stigma,strongly,tall,tear-drop,tip,tub,tube,ud,widest,ympodial,young	adaxial,arrangement,branching,characteristic,colour,description,diameter,form,fruit,geminate,grayish-brown,growth,height,history,inflorescence,length,life,margin,mentioned,midvein,peduncle,plant,primary,pseudostipule,rachi,seed,staman,sympodial,tertiary,texture,unarmed,venation
83	wfo-0001026777	success	168	130	100	68	30	0.595	0.25-0.5,0.5-1,0.5-1.5,1-1.3,1-1.5,1-10,1-2,1-4,1.2-1.8,1.5-3,2-4,2-5,3-3.5,4-8,5-7,acuminate,acute,anther,apex,apiculate,base,beneath,berry,blue,body,branching,brown,calyx,capitate,cell,cm,corolla,decurrent,deflexed,difoliate,elliptic,fide,filament,filiform,flattened-reniform,flexuous,free,glabrate,glabrous,globose,green,growth,incrassate,irregularly,lateral,leaf,lobe,long,main,major,margin,minor,minutely,mm,narrowly,occasionally,onto,opposite,outline,ovary,pair,papillose,pedicel,petiole,pitted,portion,prominent,pubescent,quadrate-deltoid,russet,scar,seed,shiny,shrub,sinuate,slightly,smooth,spaced,sparsely,stem,straight,style,surface,testa,trichome,tube,tuft,uniseriate,unit,vein,vellozo,wall,white,x,yellowish	.25,.5,/3,0.5-5,0.9-3,1.5-5,2-4.5,5-14,5-50-flowered,anthesi,apart,axil,ba,beginning,campanulate,cup,dense,dia,differing,distal,eaf,edicel,eed,end,exserted,flattened,fruiting,geminat,greyi,hyaline,inflorescenc,like,lobed,lon,lower,matted,middle,near,nearly,new,nflorescence,often,older,one,overtopping,papillo,planar,pore,poricidal,quite,rest,ruit,shaped,size,somewhat,soon,stigma,tall,tapering,tear-drop,thread-like,tip,ud,way,widest,woody,ympodial,young	abaxial,adaxial,arrangement,characteristic,colour,diameter,form,fruit,geminate,greyish,height,history,inflorescence,length,life,midvein,null,peduncle,plant,primary,pseudostipule,rachi,shape,staman,sympodial,tertiary,texture,true,unarmed,venation
84	wfo-0001026819	success	218	145	114	104	31	0.523	0.5-1.5,1-2,1-2.3,1.5-10,1.5-12,1.5-3.3,1.6-3.5,10-26,2-5,2.5-5,3-120,3-18,3-20,4-10,4-7,5-30,6-11,abaxially,acumen,acuminate,acute,anther,apex,ascending,attenuate,base,blue,borne,broadly,brownish,bud,cell,cm,condition,corolla,covering,cuneate,dark,densely,diameter,distal,dot,drying,elliptic,especially,filament,flower,forked,fresh,fruit,generally,glabrous,glaucous,globose,green,green-white,greenish,greenish-yellow,hair,half,herb,lanceolate,lateral,light,like,lobe,long,make,margin,midvein,mm,moderately,mottled,mucilaginous,narrowly,non-glandular,oblique,odd-pinnate,often,ovate,ovoid,pedicel,peduncle,petiole,plant,pubescent,purple,rachi,scattered,seed,short,slightly,sometimes,star,stem,stripe,style,subglabrous,subrosette,subtending,symmetrical,terminal,tertiary,testal,thick,throughout,tinged,truncate,usually,violet,wall,wet,white,whitish	0-27,0.3-4.7,1-10,1-5,1.2-36,1.5-3.0,1.5-3.5,10,2-6,3-35,3-38,4,5-merou,7,absent,adaxially,ag,along,alyx,apart,articulated,bearing,blade,capitate,chartaceous,ciliate,clavat,connate,connivent,curved,decurrent,digestion,dorsally,eaf,edge,eed,end,enzyme,erec,exceeding,flat,folded,geminat,glabrou,greatly,hair-like,homostylous,honeycomb-shaped,interjected,larger,leaflet,lengthening,living,lower,lunate,membranous,middle,minutely,nflorescence,orolla,pair,pedice,pentagonal,petiolule,plurifoliate,pore,poricidal,puberulent,ranging,removed,rotate-pentagonal,ruit,scale-like,seudostipule,singly,slit,somewhat,spaced,specimen,stamen,ste,stigma,stolo,straight,subequal,suborbicular,tall,tamen,tem,therefore,tip,tri-,tube,tuber,typically,unit,unwinged,vary,wide,wing,within,without,yellow,ympodial	'hair-like,2,abaxial,adaxial,arrangement,branching,calyx,characteristic,colour,description,erect,form,growth,height,history,inflorescence,leaf,length,life,mentioned,ovary,primary,pseudostipule,shape,staman,surface,texture,true,unarmed,vein,venation
85	wfo-0001026821	success	204	141	107	97	34	0.525	0-20,0.3-2.5,0.4-1.5,0.5-1.2,0.7-1.8,1-1.5,1-2,1-5,1.5-2.5,10-15,2-3.5,2-celled,2.5-18,3-18,3-branched,3-celled,4-4.5,5-10,5-20,5-34,acuminate,adaxial,angular,anther,apex,apically,appressed,auriculate,base,berry,blade,broadly,brown,cm,cordate,dark,diameter,due,ellipsoidal,elliptic,exceeding,filament,flattened,flower,forked,fruit,gglobose,glabrous,gland-tipped,green,hair,herb,incurved,lanceolate,lateral,leaf-opposed,length,light,lobe,long,long-attenuate,many,margin,mature,membranous,mm,narrowly,oblique,obliquely,obtuse,occasional,odd-pinnate,one-celled,pale,pedicel,peduncle,per,petiole,pilose,plurifoliate,puberulent,pubescent,rachi,rarely,remnant,reniform,rounded,scandent,slender,slightly,somewhat,sparsely,stamen,stripe,style,subglabrous,surface,thickening,time,tri-,unbranched,unit,wall,white,wide,winged,x	.2,/3,0.2-1.5,0.3-1.2,0.5-3.5,0.8-1,1-20,1-3,1.2-1.5,17,1977,2-15,2-6,3-11,3-6,3-7,5-12,5-merou,abaxially,acut,adaxially,ag,alyx,anderson,apart,apical,apiculate,articulated,axe,ba,basal,bayonet,bract,cell,chartaceous,ciliat,cuneate,deltate,directed,distal,distally,eaf,eed,equal,especially,frequent,fused,geminat,glabrou,greatly,homostylous,interjected,interstaminal,large,leaflet,longitudinal,lower,lowermost,mean,membrane,minute,minutely,moderately,much,nflorescence,oblong,occasionally,opening,orolla,pair,paired,perfect,petiolule,pore,present,pseudostipular,pubescen,reduced,ruit,seudostipule,short,slit,small,smaller,spaced,stellate,stigma,substellate,subtended,tamen,tem,terminal,truncat,tube,vary,yellow,ympodial	'bayonet,5-15,abaxial,acute,arrangement,branching,calyx,characteristic,colour,corolla,form,geminate,growth,height,history,inflorescence,leaf,life,midvein,null,ovary,plant,primary,pseudostipule,seed,shape,staman,stem,sympodial,tertiary,texture,unarmed,vein,venation
86	wfo-0001026827	success	143	115	92	51	23	0.643	.5,0.2-0.5,0.4-0.6,0.5-2,0.6-1,1-,1-1.1,1-1.5,1-2.1,1.3-1.6,1.5-2,2-2.2,2-2.5,2-4,3-9,5-6,7-9,acute,anther,anthesi,apex,appearing,arachnoid,attenuate,base,branched,broadly,calyx,cm,conical,corolla,deltate,dendritic,densely,diameter,dry,drying,especially,filament,fleshy,flower,glabrescent,glabrous,growth,inflorescence,internodal,irregularly,known,lamina,lanceolate,leaf,less,like,lobe,margin,mm,narrowly,near,nodding,oblanceolate,ovary,pair,paler,pedicel,peduncle,petiole,primary,pubescent,rachi,reddish,revolute,shrub,simple,slender,small,sparsely,stem,stout,style,surface,terminal,thick,thickened,third,tip,trichome,uniseriate,upper,vein,white,widest,x	/3,1-2,?,abaxially,adaxiall,age,and/or,apart,bark,branch,clavate,crowded,deciduou,dense,distally,eaf,ellipsoid,erect,exerted,free,know,lengthening,lobed,lower,minutely,new,nflorescence,ot,papillat,papillate,perfect,planar,plane,plurifoliat,pore,poricidal,portion,scar,sinus,slit,soon,stigma,straight,strongly,surfac,tub,tube,ud,unit,way,ympodial	abaxial,adaxial,adaxially,arrangement,branching,characteristic,colour,form,fruit,height,history,length,life,midvein,plant,pseudostipule,seed,shape,staman,tertiary,texture,unarmed,venation
87	wfo-0001026830	success	198	133	102	96	31	0.515	0.3-1.3,0.4-1,0.5-1.0,0.9-1.9,1-10,1-11,1-2,1.5-4,10-57,2.5-5,4-10,4-7,5-11,6-13,abaxially,acuminate,acute,adaxially,anther,apart,apex,articulated,asymmetric,attenuate,base,basiscopic,berry,brown,brownish,cell,ciliate,cm,condition,corolla,covering,deep,diameter,digestion,distal,drying,elliptic,enzyme,filament,finely,fresh,fruit,glabrescent,glabrous,globose,green,green-white,greenish,hair,half,herb,high,honeycomb,lateral,leaf,light,linear,lobe,long,make,margin,medium,mm,moderately,mucilaginous,odd-pinnate,ovate,ovoid,pedicel,peduncle,petiole,plant,puberulent,pubescent,purple,removed,ripe,rounded,seed,sessile,shaped,short,side,simple,spaced,stripe,style,subglabrous,testal,thick,throughout,tissue,wall,wet,white,whitish,yellow,yellowish	0-10,0.5-1.2,1.1-2.7,1.4-4,2-4,2-6,2.5-4.4,2.7-8,3.5-8.5,4-14.5,4.4-14.5,4.5-17.5,5-merou,7-18,acumen,adaxiall,ag,along,alyx,apparently,arranged,axe,axillary,bead,blade,bud,capitat,clavate,connivent,coriaceous,decreasing,dorsally,eaf,edge,eed,erec,exceeding,flat,flower,folded,forked,geminat,generally,glabrou,hair-like,hal,homostylous,interjected,lanceolate,leaflet,lengthening,like,living,lower,moniliform,multiple,necklace,nflorescence,orbicular,orolla,pair,pentagonal,perfect,petiolulate,plurifoliate,pore,poricidal,rotate,ruit,seudostipule,size,slit,specimen,stamen,stigma,stolon,straight,subequal,subglabrou,subtending,tall,tamen,tem,terminal,tip,toward,tri-,tube,tuber,typically,unit,unwinged,usually,vary,x,ympodial	'hair-like,abaxial,adaxial,arrangement,branching,calyx,characteristic,colour,form,growth,height,history,inflorescence,length,life,midvein,null,ovary,primary,pseudostipule,rachi,shape,staman,stem,surface,tertiary,texture,true,unarmed,vein,venation
88	wfo-0001026831	success	207	192	165	42	27	0.797	-0.25,-5,-6.5,-9,.5,0-10,0-20,0-3,0-6,0.1,0.1-0.2,0.1-0.25,0.2-0.4,0.2-1,0.3-0.65,0.5-1.2,0.6,0.6-2,0.65-1,0.7-2,1-10,1-2,1-2.2,1-2.5,1-3,1-4,1.5-2.5,1/3,1/3-2/3,1/5-1/4,2-2.5,2-3,2-4,2.3-2.9,2.5-4.5,3-5,3-6,7-10,7-8,acute,anther,apart,apex,apically,apparently,articulated,attenuate,bark,base,berry,blade,branched,bright,broad-deltate,calyx,cell,cm,concolorous,connivent,cream,curved,dark,deltate,densely,diameter,difoliate,distance,drying,dull,elliptic,equal,erect,extending,eye,filament,flattened-reniform,flower,free,fruit,glabrescent,glabrous,gray-brown,green,infructescence,lateral,leaf,length,less,lobe,lobed,long,longer,lower,margin,marking,maturity,mauve,midpoint,midvein,mm,moderately,multangulate,naked,narrow-cuneate,oblong,occasionally,older,one,open,orange,orange-brown,outline,pair,pale,pedicel,peduncle,per,pericarp,petiole,poricidal,porrect,portion,prickle,prickly,primary,raised,ray,red-brown,reduced,rounded,scandent,sessile,shiny,shrub,side,slender,smooth,sometimes,spaced,sparsely,spherical,stalk,stellate-pubescent,stem,style,subsessile,surface,tapering,terete,tertiary,time,tip,trichome,tube,upper,usually,vein,venation,visible,white,white-gray,wide,yellow,yellow-green,young	/4,0.15-0.25,0.3-0.6,0.7-1.1,1-6,1.2-2,1/3-1/,3.5-10,5-merous,abaxially,alyx,apar,brow,caudat,chartaceous,eaf,eed,elongating,fruiting,fully,geminat,herbaceous,mature,membranous,nflorescence,opening,orolla,oung,ovate,pendulous,perfec,prickl,ruit,scar,shorter,spreading,stellate,tamen,unit,vary,way,ympodial	1/3-1/2,abaxial,adaxial,arrangement,branching,brown,caudate,characteristic,colour,corolla,form,geminate,growth,height,history,inflorescence,life,null,ovary,plant,pseudostipule,rachi,seed,shape,staman,texture,unarmed
89	wfo-0001026841	success	139	137	104	35	33	0.748	.25,.5,/4,0.25-0.3,0.25-0.5,0.5-0.75,0.5-1,0.6-1,0.75-1,0.8-1,0.8-3,1.5,1.5-2,2-2.5,3.5-5,4-8,5-8-flowered,6-8,7-9,acute,along,anther,anthesi,apex,arch,bark,base,beneath,berry,bi-lobed,broadly,calyx,clavate,cm,conical,corolla,curly-tipped,decurrent,deflexed,deltoid,dia,elliptic,filament,filiform,free,fruiting,glabrate,glabrous,globose,green,hyaline,immature,inflorescence,joined,known,lateral,leaf,like,lobe,lobed,long,main,margin,minutely,mm,older,opposite,ovary,pair,papillose,pedicel,petiole,portion,prominent,pubescent,raised,reddish,reflexed,rest,series,shining,shrub,simple,slender,slightly,sparsely,stem,stigma,straight,style,tall,tapering,tip,trichome,tube,uniseriate,unit,vein,way,white,winged,woody,x,young	0.05,0.5-2,3-6.5,9.2-18,apart,axi,ba,coroll,eaf,edicel,eed,ellipsoid,exsertion,greyish-gree,later,lon,lower,middle,nflorescence,paler,papillo,pore,poricidal,ruit,scar,shaped,spaced,tear-drop,terminal,thickened,ud,unevenly,unifoliat,widest,ympodial	-,abaxial,adaxial,arrangement,branching,characteristic,colour,diameter,form,fruit,greyish-green,growth,height,history,length,life,mentioned,midvein,peduncle,plant,primary,pseudostipule,rachi,seed,shape,staman,surface,sympodial,tertiary,texture,unarmed,unifoliate,venation
90	wfo-0001026849	success	180	197	169	11	28	0.939	-50,0-10,0.5-1,1,1-1.5,1-2,1-6,1.5-2.5,1.75-2,100-130,11,2,2-3,30-,38/2,40,5,5-10,637/2,7-8,80-,acute,adherent,adult,amongst,anther,apex,appearing,aspect,aster,australian,axil,base,berry,brown,calyx,capitate,cell,cm,colour,composed,conical,conspicuous,corolla,curved,cut,cyme,deflexed,developed,dia,discoidal,distinct,distinctly,ellipsoid,emarginate,enlarge,entire,erect,exceeding,except,exerted,expanded,facetted,filament,filled,flesh,floral,flower,flowered,fork,free,fruiting,general,glabrous,glandular,globose,globular,granule,greater,green,grey-brown,growth,hair,half,inflorescence,interacuminal,large,lavender,leaf,leave,lengthening,less,linear-lanceolate,little,lobe,long,long-cuneate,loosely,margin,mature,maturity,mid-vein,minute,minutely,mm,native,oblong,oblong-lanceolate,occasionally,often,ovary,pale,pedicel,pedicellate,peduncle,petal,petiole,pore,poricidal,preparation,pruinose,purple,rarely,relatively,reproducing,reticulate,rh,rhachi,rotate,rounded,ruiting,sea,seed,shallow,shed,short-lived,shrub,simple,sinus,slende,slightly,slit,soft-wooded,solanum,solitary,sometimes,somewhat,soon,stem,stigma,stone,stony,stout,style,surface,thus,tip,tissue,tube,ud,unarmed,undulate,unit,vegetatively,violet,way,well,x,young	eed,gree,lon,lower,nflorescence,pal,plurifoliat,ruit,tub,uvenile,ympodial	abaxial,adaxial,arrangement,branching,characteristic,diameter,enlarged,form,fruit,height,history,juvenile,length,life,midvein,null,plant,plurifoliate,primary,pseudostipule,rachi,shape,staman,sympodial,tertiary,texture,vein,venation
91	wfo-0001026858	success	153	127	89	64	38	0.582	0.8,0.8-1,1-11.5,1-4,1.3-1.5,1.5-4,2-2.5,2-3,2-4,2.5-3,3-4,4-24,6-10,6-18,6-7,abaxially,acute,adaxially,apex,articulate,base,branched,calyx,cell,cm,cordate,corolla,covering,cuneate,cyme,diameter,dichasial,dichasially,distal,ebracteate,exceeding,filament,flower,forked,generally,glabrescent,glabrous,globose,green,green-white,half,herbaceous,lateral,leaf,leaflet,light,lobe,long,make,mm,monochasial,mucilaginous,mucronate,oblique,oblong,obtuse,odd-pinnate,ovate,ovate-lanceolate,ovoid,pedicel,peduncle,perennial,perfect,petiole,plant,proximal,rounded,seed,shiny,slightly,stamen,stigma,straight,style,testal,thick,throughout,triangular,tuber-bearing,typically,unit,wall,Â¼	-30,-4,0-.,0.5,1-,1-10,1-5,3-,3-6-foliat,4.5-10.5,5-15,abruptly,acumen,apical,apically,connate,dehiscent,digestion,diminishing,dorsally,eaf,edge,eed,emoval,enzyme,flat,folded,globo,hair-like,honeycomb,interjected,introrse,living,lon,lower,lunat,maturing,minute,nflorescence,nther,often,orolla,pair,pattern,plan,poricidally,reveal,ruit,seudostipule,short,size,slit,specimen,stellate,tal,tem,throughou,toward,vary,white-crea,wide,without,yellow,ympodial	'hair-like,3-6-foliate,abaxial,adaxial,anther,arrangement,branching,characteristic,colour,form,fruit,growth,height,history,inflorescence,length,life,lunate,margin,mentioned,midvein,ovary,primary,pseudostipule,rachi,shape,staman,stem,surface,sympodial,tall,tertiary,texture,unarmed,vein,venation,wet,white-cream
92	wfo-0001026895	success	166	143	113	53	30	0.681	0-0.5,0.5-1,0.5-1.2,0.5-1.5,0.5-2,0.8-1,1-1.5,1.4-2.1,1.5-2,2-2.3,2-2.5,2-3,4.5-5,5-6,5-8-flowered,abaxial,acute,adaxial,along,anther,apex,apical,apically,appearing,attenuate,base,berry,borne,broadly,brown,calyx,cm,conical,contracted,corolla,dark,deflexed,deltoid,dendritic,denser,dia,difoliate,drying,elliptic,elongate,erect,filament,filiform,flattened,free,glabrous,globose,green,hard,incrassate,internodal,lamina,lateral,leaf,like,lobe,long,main,margin,minute,minutely,mm,mustard,narrowly,often,ovary,pair,pale,pedicel,pericarp,petiole,pitted,pointed,portion,projection,pubescent,reddish,reniform,scattered,shape,shoot,short,shrub,shrublet,side,simple,small,somewhat,sparsely,stem,style,surface,swollen,swollen-based,tan,toothed,trichome,tube,tuft,type,uniseriate,unit,usually,vein,white,woody,x,yellow	.5,1-5,2.5-3.2,2/3,3-12,anthesi,ba,bark,broad,campanulate,capitate,closely,differing,eaf,edicel,eed,ellipsoid,fruiting,geminat,glabrate,lobed,lon,long-exserted,lower,major,middle,minor,nflorescence,obovate,older,overlappin,papillo,pore,poricidal,present,reddish-brow,ruit,scar,shaped,size,soon,spaced,stigma,tall,tear-drop,thin,tip,tub,ud,way,widest,ympodial,young	arrangement,branching,characteristic,colour,diameter,form,fruit,geminate,growth,height,history,inflorescence,length,life,mentioned,midvein,peduncle,plant,primary,pseudostipule,rachi,reddish-brown,seed,staman,sympodial,tertiary,texture,true,unarmed,venation
93	wfo-0001026905	exception_thrown	204	0	0	204	0	0.0		-1.5,-10,-2,-2/3,-3,-4,.2,.5,0,0-2,0-20,0-25,0.1,0.15,0.2-0.3,0.2-0.5,0.3-0.4,0.4,0.4-0.9,0.4-1,0.5-0.7,0.5-1.5,0.6-0.7,0.7-1.4,0.75-1.1,0.9-1.3,1,1-2,1-2.5,1-20,1-3.7,1-4,1-6,1.9-2.5,1/2-3/4,1/3,1/4,1/5-1/3,2-3,2.5-2.9,2.5-3.5,2/3-3/,3-5,3-8,5-6,5-merous,6-8,7-8,abaxially,acuminat,acute,alyx,ame,anther,apar,apart,apex,apically,apparently,articulated,attenuate,bark,base,berry,blade,branched,brow,c.,calyx,cell,chartaceous,cm,connivent,cream,curved,dark,deltate,densely,diameter,difoliate,discolorous,distance,drying,dull,eaf,eed,elongating,equal,erect,extending,eye,filament,flattened-reniform,flower,free,fruit,fruiting,geminat,glabrous,gray-green,green,inflorescence,infructescence,lateral,leaf,length,lobe,lobed,long,longer,lower,margin,marking,mature,maturity,mauve,midpoint,midvein,mm,moderately,naked,oblong,older,one,open,orange,orange-brown,orolla,oung,outline,ovate,pair,pale,pedicel,peduncle,pendulous,per,perfec,pericarp,petiole,pit,poricidal,porrect,portion,prickl,prickle,prickly,primary,raised,ray,red,reduced,rounded,ruit,scar,sessile,shallowly,shorter,shrub,side,slender,small,smooth,sometimes,somewhat,spaced,sparsely,spherical,spreading,stalk,stalked,stellate,stellate-pubescent,stem,straight,style,subentire,surface,tamen,tapering,terete,tertiary,time,tip,trichome,tube,unarmed,unit,upper,usually,variously,vary,vein,venation,visible,way,weakly,white,wide,woody,yellow,yellow-green,ympodial,young	
94	wfo-0001026923	success	177	159	129	48	30	0.729	-5,.1-0.3,.5,0-5,0.25-0.5,0.5,0.5-1,0.6-0.8,0.8-1,1,1-1.5,1-7,1.5-4,10,2,2-2.5,2-3,2-6,20-50,3-5,4-18,4-5-,5-10,5-15,5-6,5-9,abaxially,absent,acuminate,acute,adaxially,anther,apart,apex,apparently,articulated,axe,base,black,blade,branched,brown,calyx,chartaceous,cm,cuneate,curved,cylindrical,deltate,densely,denser,diameter,eglandular,elliptic,elliptic-ovate,entire,erect,filament,flattened,flower,forked,fruit,geminate,glabrescent,glabrous,glandular,globose,green,hair,held,intermediate,lateral,leaf,leaf-opposed,light,like,lobe,long,many-foliate,margin,midpoint,midvein,mm,moderately,multangulate,nearly,pedicel,peduncle,peltate,perfect,petiole,possibly,pubescence,pubescent,purple,rachi,ray,red,relatively,ripening,rounded,rugulose,scale,sessile,short,shrub,simple,small,sometimes,spaced,sparsely,stellate,stem,straight,strongly,style,surface,time,tip,tree,trichome,unit,usually,white,whitish,wide,x,yellow,yellowish	1-3,1-4,1.5-2,3-4,accrescent,adaxiall,ag,ba,capitat,center,connivent,covering,directed,distally,eaf,eed,equal,frui,fruiting,fused,gland-tippe,lanceolate,large,longitudinal,lower,much,nflorescence,oblong,opening,orange,orolla,paired,pore,ruit,slightly,slit,smaller,somewhat,ste,stigma,subtending,tal,tamen,tem,tube,uprigh,vary,ympodial	abaxial,adaxial,arrangement,branching,characteristic,colour,corolla,form,growth,height,history,inflorescence,length,life,null,ovary,plant,primary,pseudostipule,seed,shape,staman,sympodial,tertiary,texture,true,unarmed,upright,vein,venation
95	wfo-0001026925	exception_thrown	215	0	0	215	0	0.0		-2,.5,/6,0,0-10,0-20,0-5,0-7,0.1,0.1-0.2,0.1-0.3,0.2,0.5-1.5,0.5-4,0.7-1.8,0.9-1.8,00-200,1-1.3,1-1.4,1-25,1-3,1-3.5,1-4,1.5-2,1.5-2.5,1.5-4.5,1.8-2,1.8-2.5,1/3,1/3-1/2,1/4-2/3,1/6-1/3,2-4,2-5,2.4-2.6,2.4-3,2.5-6,2/,3-20,3-7,4-10,4-14,4-5,4-7,5-6,5-8,5-merous,5.5-10,6-10,6-17,6-8,7-12,abaxially,acuminat,acute,alyx,ame,andromonoecious,anther,apar,apart,apex,apically,apparently,articulated,attenuate,bark,base,berry,blade,branched,broad-deltate,brow,c.,calyx,chartaceous,cm,concolorous,connivent,cream,curved,dark,deltate,diameter,distal,distance,drying,eaf,eed,elliptic,elongating,equal,erect,extending,filament,flattened,flattened-reniform,flower,free,fruit,fruiting,gently,glabrescent,glabrous,green,green-brown,hair,hermaphrodite,heterostylous,infructescence,lateral,leaf,length,lobe,lobed,lobing,long,long-styled,longer,lower,lowermost,margin,marking,mature,maturity,mauve,membranous,midpoint,midvein,minute,mm,moderately,narrow-deltate,nflorescence,oblong,older,one,open,orange-brown,orolla,oung,ovate,pair,pale,pedicel,peduncle,pendent,pendulous,per,pericarp,petiole,plant,plurifoliat,poricidal,porrect,portion,prickl,prickle,prickly,primary,rarely,ray,red-brown,reduced,reflexed,rounded,ruit,scar,secondary,sessile,short-styled,shrub,side,simple,smooth,sometimes,spaced,sparsely,spherical,spreading,stalk,stalked,staminat,stellate,stellate-pubescent,stem,stout,straight,style,surface,tamen,tapering,terete,terminal,tertiary,time,tip,translucent,trichome,tube,unarmed,unit,upper,vary,vein,venation,visible,way,white,wide,woody,yellow,yellow-orange,ympodial,young	
96	wfo-0001026946	success	205	112	81	124	31	0.395	0.5-2,1-2,1-4,1.5-2,1.6-3.7,12-23,2.5-10.5,3-20,3-5,3.5-10,5-7,8-15,abaxially,acuminate,acute,adaxially,anther,apex,attenuate,base,berry,broadly,brownish,cell,cm,condition,corolla,covering,creamy,densely,diameter,drying,elliptic,filament,fresh,fruit,glabrous,globose,green,greenish,hair,herb,lateral,like,lobe,long,make,margin,mm,mottled,mucilaginous,narrowly,oblique,odd-pinnate,ovate,ovoid,pedicel,peduncle,petiole,plant,pubescent,pure,purple,ripe,rounded,seed,short,short-pubescent,slightly,stem,streak,style,testal,thick,truncate,typically,wall,wet,white,whitish,yellow-white	0-20,0-5,0.9-3.5,0.9-4.3,1,1-10,10-39,2,2-15,2-5,2.7-9,3-6,4-7,4.1-9.4,5-merou,6-24,8-25,acumen,ag,along,alyx,apart,apparently,articulation,axe,axillary,blade,borne,bud,capitat,chartaceous,ciliate,clavate,connivent,deeply,digestion,distal,dorsally,dot,eaf,edge,eed,end,enzyme,erec,especially,exceeding,except,extremely,flat,flower,folded,forked,geminat,generally,glabrou,greatly,green-white,hair-like,half,homostylous,honeycomb-shaped,interjected,lanceolate,leaflet,lengthening,living,lower,membranous,midrib,minutely,nflorescence,often,orbicular,orolla,pair,pentagonal,perfect,petiolulate,petiolule,plurifoliate,pore,poricidal,proximal,puberulent,pubescen,reduced,removed,ruit,scattered,sessile,seudostipule,singly,size,slit,spaced,specimen,stamen,ste,stellate,stigma,stolo,straight,subequal,subtending,tall,tamen,tem,terminal,thir,throughout,tip,tri-,tube,tuber,unit,unwinged,usually,variable,vary,wing,x,yellow,ympodial	'hair-like,abaxial,adaxial,arrangement,branching,calyx,characteristic,colour,form,growth,height,history,inflorescence,leaf,length,life,midvein,null,ovary,primary,pseudostipule,rachi,shape,staman,surface,tertiary,texture,true,unarmed,vein,venation
97	wfo-0001026962	success	205	128	103	102	25	0.502	.05,.5,0,0.3-0.7,0.8-1,1,1-1.2,1-1.5,1-3,1-4.5,1.5-2,10-12,10-20,15-22,2-2.5,2-6,3-3.5,4-5,6-7,9-12,abaxially,acute,adaxially,anther,apex,apparently,articulated,base,beneath,broadly,calyx,closely,cm,corolla,cylindrical,darker,deflexed,deltate,densely,diameter,dry,elliptic,entire,evenly,filament,flattened-reniform,flower,fruit,glabrous,globose,green,incrassate,inflorescence,leaf,lobe,long,major,margin,material,minor,minutely,mm,narrowly,often,overlapping,packed,pair,pale,pedicel,peduncle,pendent,perfect,petiole,pitted,prominent,pubescent,purplish,rachi,raised,rounded,shrub,simple,small,sometimes,stem,straight,style,surface,tapering,tinged,tip,tree,triangular,trichome,unarmed,unbranched,uniseriate,vein,white,woody,x,yellow,yellowish	0.5,0.5-0.8,0.5-1,0.5-1.5,1-2,1-6,1.5-17,1.5-3,1.5-5,2-5,2/3-3/4,3-6,9-17,abrupt,abruptly,accrescent,ag,alyx,anthesi,appearing,arising,axe,bark,basebud,becoming,blade,brittle,bud,capitat,cell,chartaceous,composed,connivent,constricted,cucullat,denser,differing,difoliate,dimorphic,eaf,eed,elongate,except,exerted,free,fruiting,geminat,glabrate,glabrou,ilament,internodal,later,lateral,like,lobed,longitudinal,main,nflorescence,obconic,oblong,obovoid,occasionally,older,one,opening,opposite,orolla,oung,outline,ovate-lanceolate,papillose,paten,pore,portion,pubescen,reflexed,remaining,rest,rounder,ruit,sagittate,shaped,size,slender,slightly,slit,somewhat,soon,stellate,stigma,tal,tear-drop,tooth,trunk,tube,unifoliate,unit,vary,way,whit,ympodial,young	abaxial,adaxial,arrangement,branching,characteristic,colour,form,growth,height,history,length,life,midvein,null,ovary,plant,primary,pseudostipule,seed,shape,staman,tertiary,texture,true,venation
98	wfo-0001026964	success	128	107	76	52	31	0.594	.2,.5,0.5,0.5-1,10-30,2-2.5,3-5,7-8,acuminate,acute,along,anther,anthesi,apex,attenuate,axillary,base,bearing,berry,calyx,cm,conical,conspicuously,corolla,diameter,distinct,elliptic,filament,filiform,fleshy,flower,glabrous,green,greenish,herb,horizontal,known,lenticellate,lightly,line,lobe,long,margin,mm,obovate,one,open,ovary,pair,pedicel,petiole,petiolule,pinnate,primary,pubescent,purple,rachi,scar,shape,side,simple,slender,small,sparsely,style,surface,time,tip,trichome,tube,uniseriate,unit,vein,winged,x,yellow	0,1-1.2,1-2.5,10,2-4,3.5-7,4.5-8.5,?,basal,beak,capitat,differentiated,eaf,edicel,equal,erec,exserted,free,fruiting,glabrou,globose,immature,lateral,leaflet,lobed,long-attenuate,lower,minutely,nearly,nflorescence,noddin,often,onto,ot,papillate,poricidal,portion,purpli,reflexed,rugose,ruit,size,smooth,somewhat,stigma,tal,tem,terminal,tub,ud,unifoliat,ympodial	abaxial,adaxial,arrangement,branching,characteristic,colour,form,fruit,growth,height,history,inflorescence,leaf,length,life,mentioned,midvein,nodding,peduncle,plant,pseudostipule,purplish,seed,staman,stem,sympodial,tertiary,texture,unarmed,unifoliate,venation
99	wfo-0001026981	success	252	166	141	111	25	0.56	-0.8,-2.5,-35,.2,0.05-0.1,0.3-0.5,0.3.6,0.4-0.5,0.5-30,0.6-1.4,0.6-2,0.8-1.2,1-2,1-3.3,1.5-2.0,1.8-2.8,1/3,11,2-3-branched,2-locular,3-foliate,4,6-10,7.5,abaxially,absent,academy,acute,adaxially,adpressed,anther,apex,appearance,articulated,articulation,asymmetric,axi,base,bay,beak,becoming,bract,bracteole-like,brown,calyx,capitate,cell,cm,conical,cordate,corolla,dark,densely,diameter,distal,ebracteate,entire,erect,filament,flower,fruit,giving,glabrescent,glandular,green,hair-like,herb,imparipinnate,initially,interrupted,irregularly,jointles,later,lateral,leaf,leaflet,like,lime,linear,lobe,lobed,long,margin,maturity,minutely,mm,multicellular,narrowly,obovate,occasionally,orange,orbicular,outgrowth,ovary,ovate,pale,pedicel,peduncle,perennial,petiole,plant,present,primary,procumbent,pronounced,pseudostipule,pubescent,rachi,rick,robust,rounded,see,shaggy,short,silky,simple,slender,sometimes,sparsely,stem,style,surface,tertiary,testa,thick,trichome,uni-,uniseriate,unit,usually,variously,velvety,villous,viny,wall,wide,winged,without,yellow,â,â	-0.4,-14,-2,-4,-8,.2-0.2,0-5,0.1-0.2,0.1-0.3,0.15-0.2,0.2,0.2-0.4,0.2-2,0.25-0.4,0.4-0.7,0.4-2,0.45-1.3,0.5,0.5-0.3,0.7-0.8,0.8-6,0.9-1.4,0.9-1.5,1,1-2-cellular,1-3,1-3-celled,1-4,1.5-5,1.5-8.5,196.,2-3,3.5-14,4-8,4-celled,<,absen,abundant,accrescent,along,amongst,angled,anthesi,apical,appendage,appressed,basiscopically,citrus-like,coastal,column,composed,cone,d,deltate,eaf,edicel,eed,exserted,fruiting,globose,gree,half,halfway,head,included,interjected,internode,larger,less,lon,lower,mainly,mixed,much,nflorescence,pair,patent,pentagonal,per,petiolule,population,proximal,pubescence,reflexed,ruit,scen,secondary,sessile,several,shaped,shorter,smaller,sparser,specimen,spreadin,staminal,sterile,stigma,straight,strong,tangled,tem,terminal,tightly,transparent,tub,tube,type,unicellular,upto,ympodial	1967,abaxial,adaxial,arrangement,branching,characteristic,colour,form,growth,height,history,inflorescence,length,life,midvein,null,seed,shape,staman,sympodial,texture,true,unarmed,vein,venation
100	wfo-0001026992	success	243	175	150	93	25	0.617	-2.5,/7,0.2-0.5,0.25-0.45,0.6-1.5,00-170,1-4,1.2-1.4,1.2-1.7,1.3-2.6,1.3-4.3,1.4-1.6,1.4-1.9,1.5-3.4,1.7-2.4,1.7-4.3,10-12,12-33,2-10,2.8-4.7,3-4,3.3-5.6,5-15,5.3-12.1,6-10,8,8-11,8-14,abaxial,abaxially,abruptly,acuminate,acute,adaxially,along,anther,apart,apex,apparently,approximately,articulated,attenuate,axe,axillary,base,berry,blade,branched,broadly,brown,calyx,cm,corolla,cylindrical,deltoid,diameter,echinoid,elliptic,entire,equal,filament,fleshy,flower,fruit,geminate,glabrous,globose,granular-tomentose,greenish,hair,immature,lacking,lance-ovate,lateral,leaf,length,lobe,long,long-stalked,lower,main,many,margin,mature,maturity,midrib,mm,moderately,mostly,multangulate,obtuse,occasional,occasionally,often,orange-tan,ovate,overlapping,pedicel,peduncle,perfect,petiole,plant,plurifoliate,porrect-stellate,pubescent,rachi,rare,reniform,reticulate-punctate,ripe,scabridulous-,semi-ovate,sessile,short,short-,short-stalked,shorter,shrub,side,simple,size,small,sometimes,spaced,sparingly,stalked,stamen,stellate,stem,stout-stalked,style,surface,terminal,time,tomentose,tree,unarmed,unequal,unit,usually,vein,velutinous,violet,white,whitish,wide,x,yellow,yellowish,Â½	0.5-1.2,0.8-3.4,1.7-1.9,1/2,2-5.6,2.3-3.3,2.6-4.6,2.8-4.6,3.3-5.5,4-8,5-merou,accrescent,adaxiall,ag,alyx,angled,anthesi,appressed,around,ba,bark,blunt-tipped,branch,capitat,chartaceous,completely,coriaceous,covering,crown,dark,densely,directed,distally,drying,eaf,echinoi,edge,eed,enveloping,evident,exserted,farinose,flat-topped,forming,free,fruiting,glabrescen,grooved,high,homostylous,inserted,lanceolate,lengthening,less,line,lobed,longitudinal,longitudinally,m.,minute,nearly,nflorescence,oblong,older,orolla,ovate-lanceolate,pore,poricidal,pubescence,rather,ruit,runk,slit,somewhat,split,spreading,stigma,subcampanulate,subglobose,suture,tamen,tan,terete,thin-textured,tip,tube,ud,unarme,vary,way,weakly,ympodial,young	adaxial,arrangement,branching,characteristic,colour,form,glabrescent,growth,height,history,inflorescence,life,mentioned,midvein,ovary,primary,pseudostipule,seed,shape,staman,sympodial,tertiary,texture,true,venation
101	wfo-0001026994	success	266	149	126	140	23	0.474	-foliate,.2,0.1-0.2,0.5,0.5-0.6,0.5-0.7,0.5-0.8,0.5-0.9,0.5-2,1,1-1.4,1-1.5,1-1.6,1.2-1.6,2,2-2.6,2-5-locular,2.2-3.2,3,4,4-15,8-12,abaxially,absent,acuminate,acute,adpressed,anther,apex,appearance,articulate,basal,base,beneath,bifurcate,branched,bright,broadly,brown,calyx,cell,cm,corolla,crenate,dark,darker,decurrent,deeply,densely,diameter,distal,eglandular,elliptic,essentially,filament,fruit,giving,glabrous,globose,grayish,green,greenish,hair-like,half,herb,imparipinnate,inflorescence,interrupted,irregularly,lateral,leaf,leaflet,less,like,lobe,lobed,locule,long,margin,medial,midvein,minutely,mm,narrowly,nearly,obovate,outgrowth,ovary,paler,pedicel,peduncle,perennial,petiole,primary,pseudostipule,puberulent,pubescent,purple,rachi,rarely,regularly,ripe,robust,sessile,shaggy,silky,simple,sometimes,stem,stripe,style,surface,tall,tertiary,testa,thick,trichome,uniseriate,unit,usually,velvety,wall,white,wide,winged,yellow	-0.7,-10,-20,-30,.5,0.05-0.1,0.05-0.2,0.1,0.1-0.3,0.15-0.2,0.2-0.4,0.2-0.5,0.25,0.3-0.4,0.4-0.5,0.4-1.2,0.5-1.2,0.5-1.3,0.7-2.5,0.9-1.2,0.9-1.3,1-1.2,1-2,1.2-3.5,1.4-2.1,10-20,12-,2-,2-4,2.5-6.5,20-50,3-branched,4-celled,5,5-,5-7,6-20,7-13,8,abundant,acroscopically,additional,along,also,amongst,andscattered,anthesi,apical,apically,appendage,articulation,basally,basiscopically,becoming,bent,berry,bifurcation,bract,bracteate,broader,capitate,celled,column,conical,crenat,crowded,decreasing,decumbent,developed,eaf,ebracteate,edicel,eed,erect,especially,exserted,fewer,flower,fruiting,glandular,gree,habitat,hal,halfway,head,interjected,internode,investing,lamina,lanceolate,large,larger,largest,leave,lon,loosely,lower,markedly,moderately,much,narrower,narrowing,nflorescence,node,oblique,occasionally,often,pair,papillate,petiolule,present,reflexed,rocky,rotate-stellate,secondary,set,short,sinus,size,slightly,sparsely,specimen,spreadin,spreading,staminal,sterile,stigma,straight,tem,terminal,tip,toward,tube,ud,unicellular,weak-walled,well,woody,ympodial,young	abaxial,adaxial,arrangement,branching,characteristic,colour,description,form,growth,height,history,length,life,mentioned,plant,seed,shape,staman,sympodial,texture,unarmed,vein,venation
102	wfo-0001026996	success	188	159	123	65	36	0.654	0-6,0.6-1,0.9-2.7,1-2,1-5,1.2-1.8,1.3-7.7,1.8-4.4,14-33,15-28,2-3,3-10,3-5,3-7,3.3-6,3.8-14.1,4-4.4,4-8,4.5-10.5,5-8,6-8,6.9-10.9,8.7-18.6,abaxially,acumen,acuminate,acute,adaxially,anther,apart,apex,apparently,articulated,asymmetric,attenuate,axe,axillary,base,basiscopic,berry,blade,blue,brownish,bud,cell,cm,condition,coriaceous,corolla,covering,dark,deep,diameter,distal,drying,exceeding,filament,flower,forked,fresh,fruit,generally,glabrous,globose,green,green-white,greenish,half,herb,interjected,lanceolate,lateral,leaf,leaflet,lilac,linear,lobe,long,make,medium,mm,mottled,mucilaginous,odd-pinnate,orbicular,ovate,ovoid,pedicel,peduncle,perfect,petiole,petiolulate,plant,plurifoliate,purple,ripe,rounded,seed,sessile,side,slightly,sometimes,spaced,stamen,straight,stripe,style,subtending,symmetric,terminal,testal,thick,throughout,tissue,tri-,unit,unwinged,usually,wall,wet,white,whitish,x	1-3,1-4,5-merou,abaxiall,ag,along,alyx,arranged,bead,capitat,clavate,connivent,considerably,decreasing,digestion,dorsally,eaf,edge,eed,elliptic,enzyme,erec,flat,folded,geminat,glabrou,hair-like,homostylous,honeycomb-shaped,larger,lengthening,like,living,lower,middl,moniliform,multiple,necklace,nflorescence,orolla,pair,pentagonal,pore,poricidal,removed,rotate,ruit,seudostipule,size,slit,specimen,stigma,stolon,subglabrou,tall,tamen,tem,tip,toward,tube,tuber,typically,vary,yellow,ympodial	'hair-like,abaxial,adaxial,arrangement,branching,calyx,characteristic,colour,form,geminate,growth,height,history,inflorescence,length,life,margin,mentioned,middle,midvein,ovary,primary,pseudostipule,rachi,shape,staman,stem,subglabrous,surface,sympodial,tertiary,texture,true,unarmed,vein,venation
103	wfo-0001027010	success	198	114	82	116	32	0.414	0.4-5.1,0.5-1.5,1-10,1-2,1.2-1.9,14-46,2.1-4.3,2.2-12.9,3-10,3-8,4-8,5-13,5-14,acuminate,acute,anther,apex,asymmetric,attenuate,base,basiscopic,brownish,cell,cm,coloration,condition,coriaceous,corolla,covering,deep,diameter,drying,elliptic,filament,fresh,fruit,glabrescent,glabrous,green,green-white,greenish,hair,herb,lanceolate,lateral,leaf,light,lobe,long,make,mm,mucilaginous,odd-pinnate,ovate,ovoid,pedicel,peduncle,petiole,petiolulate,plant,purple,ripe,rounded,scabrous,seed,sessile,short,side,sometimes,spot,straight,stripe,style,testal,thick,throughout,tissue,usually,wall,wet,white,whitish	0-2,0-2.5,0-3,1-4,1-7,1.2-1.7,1.4-6.9,10-60,2-6,2-9.4,2.1-15.3,3-5,3-6,3.5-13.6,4-12,4.4-29,4.9-31,5-merou,abaxially,acumen,adaxiall,adaxially,ag,along,alyx,apart,apparently,arranged,articulated,axe,axillary,bead,blade,bud,capitat,clavate,connivent,decreasing,digestion,distal,dorsally,eaf,edge,eed,enzyme,erec,exceeding,flat,flower,folded,forked,geminat,generally,glabrescen,glabrou,hair-like,hal,half,high,homostylous,honeycomb-shaped,interjected,larger,leaflet,lengthening,like,living,lower,moniliform,multiple,narrow,necklace,nflorescence,occasionally,orbicular,orolla,pair,pentagonal,perfect,plurifoliate,pore,poricidal,present,removed,rotate,ruit,scabrou,seudostipule,size,slightly,slit,spaced,specimen,stamen,stigma,stolon,subequal,subtending,tall,tamen,tem,terminal,tip,toward,tri-,tube,tuber,typically,unit,vary,wide,wing,winged,x,yellow,ympodial	'hair-like,abaxial,adaxial,arrangement,branching,calyx,characteristic,colour,description,form,growth,height,history,inflorescence,length,life,margin,mentioned,midvein,ovary,primary,pseudostipule,rachi,shape,staman,stem,surface,tertiary,texture,unarmed,vein,venation
104	wfo-0001027019	success	142	136	105	37	31	0.739	.5,/4,0-0.5,0.5-1,1-1.5,1-2,1.5-2,1.5-3,10,10-40-flowered,2-3,2-8,4-5,abaxial,abaxially,abruptly,acute,adaxially,along,anther,anthesi,apex,apparent,attenuate,bark,base,berry,branched,bright,calyx,capitate,cm,corolla,cyathiform,deltoid,densely,dia,difoliate,distal,even,filament,flattened,fleshy,free,glabrate,glabrous,globose,golden,green,inflorescence,leaf,like,live,lobe,lobed,long,midrib,minutely,mm,narrowed,obovate,older,onto,opposite,ovary,ovoid-reniform,pale,papillose,pedicel,petiole,pitted,planar,plant,pore,poricidal,portion,pubescent,rest,shaped,shrub,small,somewhat,sparsely,stem,stigma,straight,strongly,style,surface,tan,tear-drop,third,tip,tree,trichome,tube,unit,waxy,way,white,widest,wing,winged,x,young	1/2,12-30,2-5,4-8.5,7-14,ba,constriction,deflexed,eaf,edicel,eed,ellipsoid,elliptic,erect,exserted,fruiting,geminat,inflorescenc,largely,later,lon,lower,major,minor,nflorescence,overlapping,papillo,reddish-brow,ruit,scar,spaced,tall,tapering,tub,ud,woody,ympodial	adaxial,arrangement,branching,characteristic,colour,diameter,form,fruit,geminate,growth,height,history,length,life,margin,midvein,null,peduncle,primary,pseudostipule,rachi,reddish-brown,seed,shape,staman,sympodial,tertiary,texture,unarmed,vein,venation
105	wfo-0001027030	success	234	226	202	32	24	0.863	-11,-15,.2,.5,0-4,0.1-0.7,0.1-0.9,0.2,0.2-0.3,0.2-1,0.3-,0.3-0.5,0.3-0.7,0.4-0.5,0.4-1.5,0.5,0.5-,0.5-0.7,0.5-1,0.6-0.7,0.6-0.8,0.6-1.8,0.7-1,0.8-0.9,0.8-1,1,1-,1-1.2,1-1.3,1-3,1-3.4,1.2-1.6,1.5-,1.6-2,2-,2-3,2-4,2-4.8,2-7,2-foliate,2-locular,2.2-3.2,3-4-celled,3-8,3-9,4-celled,8-celled,abaxial,abaxially,absent,abundant,acuminate,acute,adaxially,adpressed,angled,anther,anthesi,apex,appearance,articulated,articulation,axi,basal,base,basiscopically,beneath,berry,bract,branched,bright,brown,calyx,cell,cm,conical,corolla,crenate,crenation,dark,darker,decurrent,deeper,deeply,densely,denser,diameter,distal,due,edicel,eglandular,elliptic,entire,evenly,exserted,extremely,filament,flower,fruit,fruiting,giving,gland,glandular,globose,grayish,green,hair-like,hal,half,halfway,herb,imparipinnate,inflorescence,interjected,internode,interrupted,interspersed,investing,irregularly,lamina,lanceolate,larger,lateral,leaflet,less,like,lobe,long,longer,loosely,margin,minutely,mm,multicellular,narrowly,near,node,oblique,obovate,occasionally,often,outgrowth,ovary,pair,pale,paler,papillate,pedicel,peduncle,perennial,petiole,petiolule,primary,pseudostipule,pubescence,pubescent,robust,secondary,sessile,silky,similar,simple,size,slender,slightly,small,smaller,soft,sometimes,somewhat,sparsely,spread,spreading,stem,straight,stripe,style,surface,tall,terminal,tertiary,testa,thick,tiny,trailing,trichome,truncate,ud,unicellular,uniseriate,unit,usually,vein,velvety,wall,weak,white,wide,winged,woody,yellow,young	0.05-0.1,0.15-0.2,0.4-0.8,0.5-0.8,0.9-1.1,2-6,5-12,apical,appendage,beyond,capitate,column,crenat,diamete,eaf,eed,gree,growt,lon,lower,nflorescence,present,reflexed,rotate-stellate,ruit,spreadin,staminal,sterile,stigma,tem,tube,ympodial	adaxial,arrangement,branching,characteristic,colour,form,growth,height,history,leaf,length,life,midvein,null,plant,rachi,seed,shape,staman,sympodial,texture,true,unarmed,venation
106	wfo-0001027035	success	199	140	110	89	30	0.553	0-7,0.1-0.9,0.3-2.3,0.4-12.8,0.5-7,0.9-3.1,1-2,1-3.4,1-8,1.8-5.2,10-80,2-38,3-10,3-5,4-18,acuminate,acute,anther,apart,apex,apparently,articulated,asymmetric,attenuate,axe,axillary,base,basiscopic,blue,brownish,bud,cell,cm,coloration,completely,condition,corolla,covering,deep,diameter,distal,drying,elliptic,exceeding,filament,flower,forked,fresh,fruit,generally,glabrescent,glabrous,globose,green,green-white,greenish,hair,hair-like,half,herb,high,lanceolate,lateral,leaf,light,lilac,lobe,long,make,medium,mm,mucilaginous,odd-pinnate,ovate,ovoid,pedicel,peduncle,perfect,petiole,petiolulate,plant,present,purple,ripe,rounded,seed,sessile,shape,short,side,sometimes,spaced,stamen,straight,stripe,style,subglabrous,subtending,terminal,testal,thick,throughout,tissue,usually,variable,wall,wet,white,whitish,wide	0-36,0.5-3.4,0.5-5,0.8-3,0.8-4.2,1-3,1.5-5.9,1.7-8,2-7,2.8-10.3,4-18.5,4.9-23.5,5-merou,abaxially,acumen,adaxiall,adaxially,ag,along,alyx,arranged,bead,blade,capitat,clavate,connivent,decreasing,digestion,dorsally,eaf,edge,eed,enzyme,erec,flat,folded,geminat,glabrescen,glabrou,hal,homostylous,honeycomb,interjected,larger,leaflet,lengthening,like,living,lower,moniliform,multiple,necklace,nflorescence,orbicular,orolla,pair,pentagonal,plurifoliate,pore,poricidal,removed,rotate,ruit,second,seudostipule,shaped,size,slightly,slit,smaller,specimen,stigma,stolon,subequal,tall,tamen,tem,tip,toward,tri-,tube,tuber,typically,unit,unwinged,vary,x,yellow,ympodial	abaxial,adaxial,arrangement,branching,calyx,characteristic,colour,form,growth,height,history,inflorescence,length,life,margin,mentioned,midvein,ovary,primary,pseudostipule,rachi,staman,stem,surface,tertiary,texture,true,unarmed,vein,venation
107	wfo-0001027050	success	244	178	154	90	24	0.631	-12,-9,.2,0-3,0.2-0.5,0.3-1.5,0.5-3,0.8,1,1-1.5,1-2,1.5-2,1.5-6,10-13.5,15-50+,2-2.5,2-3,2-5,2-8,2.5-3,3-5,4-8,5-10,5-9,7-30+,abaxial,absent,acuminate,acute,adaxial,anther,apex,articulated,axe,basal,base,berry,branched,broad-based,broadly,brown,calyx,cm,coarsely,conical,cordate,cuneate,curved,densely,diameter,difoliate,distally,drying,eglandular,elliptic,entire,erect,except,ferruginous,filament,flattened-reniform,flower,fruit,glabrous,glandular-puberulent,green,growth,hair,inflorescence,infructescence,inside,lanceolate,lateral,leaf,leaf-opposed,least,length,like,lobe,lobed,long,long-styled,longer,margin,markedly,mid-way,midpoint,midrib,midvein,mm,moderately,moist,mucilaginous,narrowly,near,numerous,oblique,obtuse,occasionally,often,ovate,pale,pedicel,peduncle,per,pericarp,petiole,plant,porrect,present,prickle,pubescent,ray,rest,ripe,rounded,secondary,sessile,several,shallowly,shiny,short-stalked,shorter,shrub,side,small,sparsely,spherical,stalk,stalked,stellate,stellate-pubescent,stem,straight,style,surface,terete,thicker,time,tip,toothed,tree,triangular,trichome,truncate,unarmed,unbranched,unit,usually,white,whitish,wide,yellow,yellowish-green	.5,/3,0-0.2,0.1-0.3,0.1-3,0.2-1,0.9-2.1,12-15,2-4,4-20,5,5-6,5-7,5-merous,50,6-8,8-26,abaxially,absen,abundant,adaxiall,adult,alyx,andromonoeciou,apar,arme,bark,blade,branch,broad,brow,capitate,chartaceous,closely,connivent,deeply,directed,distal,distall,eaf,eed,equal,erec,flattened,free,fruiting,geminat,half,heterostylous,interpetalar,juicy,juvenile,larger,less,lower,mature,minute,minutely,multiseriate,nflorescence,older,orolla,oung,ovate-lanceolate,papillat,pore,poricidal,portion,pricklier,prickly,ruit,scar,scattered,short-styled,slightly,somewhat,spaced,stigma,tall,tamen,tissue,touching,tube,vary,way,weakly,woody,ympodial,young,younger	arrangement,branching,characteristic,colour,corolla,description,form,geminate,height,history,life,mentioned,ovary,primary,pseudostipule,rachi,seed,shape,staman,sympodial,tertiary,texture,vein,venation
108	wfo-0001027050	success	234	221	195	39	26	0.833	.2,0-0.2,0-0.5,0-1,0.1-3,0.2-0.6,0.2-1,0.3-0.6,0.4-1,0.5-0.8,0.5-1,0.5-3,0.8,1-1.5,1-2,1-5,1.5-2,1.5-6,10-13.5,11-21,14-20,15-50+,16-40,2-10,2-2.5,2-3,2-3-locular,2-4,2-5,2-8,2-foliate,2.5-3,23-40+,3-15,3-5,4-19,4-40,4-8,5,5-10,5-6,5-7,5-9,6-8,7-30+,8-26,8-40+,abaxially,absent,abundant,accrescent,across,acuminate,acute,adaxially,adult,andromonoecious,anther,apart,apex,armed,articulated,axe,base,blade,branched,broad-based,broadly,brown,calyx,chartaceous,cm,coarsely,contiguous,cordate,cross-section,cuneate,curved,deeply,densely,diameter,distally,distributed,drying,eglandular,elliptic,entire,erect,except,exocarp,extra-axillary,ferruginous,filament,flattened,flower,forked,fruit,fruiting,glabrous,glandular-puberulent,globose,green,growth,hair,half,held,inflorescence,juicy,juvenile,lanceolate,lateral,leaf,leaf-opposed,length,less,like,lobe,lobed,long,longer,margin,markedly,mature,mesocarp,midpoint,midvein,minutely,mm,moderately,moist,mucilaginous,multiseriate,narrowly,nearly,oblique,obtuse,often,ovate,pair,pale,pedicel,peduncle,per,petiole,pinnatifid,pitted,placenta,plant,porrect,present,prickle,rachi,ray,rounded,scattered,sessile,shallowly,shorter,shrub,side,simple,slightly,small,spaced,sparsely,stalk,stalked,stellae,stellate-pubescent,stem,straight,style,surface,thick,thicker,throughout,time,tip,toothed,tree,triangular,truncate,unarmed,unbranched,unit,upright,usually,weakly,white,whitish,wide,x,yellow,yellowish-green,younger	0-3,10-30,12-15,2-6,5-merous,absen,adaxiall,anvil-shape,ba,branche,capitat,connivent,cylindrical,directed,distall,eaf,eed,functional,geminat,interpetalar,lower,minute,nflorescence,orolla,ovate-lanceolate,pore,ruit,somewhat,stellate,stigma,tal,tamen,tem,tissue,tube,unarme,upper,vary,ympodial	abaxial,adaxial,anvil-shaped,arrangement,branch,branching,characteristic,colour,corolla,form,geminate,height,history,life,null,ovary,primary,pseudostipule,seed,shape,staman,sympodial,tertiary,texture,vein,venation
109	wfo-0001027091	success	142	143	103	39	40	0.725	0.8,1-1.6,1.1-1.6,1.8-2.6,1/2-2/3,2.3-2.9,2.5-3.5,3-8,3-9,30-60,5-11,6-10,8.5-11.5,9-13,accrescent,acute-tipped,along,annual,anther,anthesi,arcuate,armed,base,beneath,berry,blade,blue,branched,broadly,brown,calyx,campanulate,cm,dark,developing,dia,difoliate,divided,dm,dry,enveloped,extended,few-rayed,fully,glabrous,gland,glandular,green,hair,herb,internodal,invested,lenticular,linear-lanceolate,lobe,long,low,main,maturity,mm,near,obtuse,oriented,ovate,pedicel,per,petiole,pinnatifid,pinnatisect,prickly,radially,reticulately,ridge,rounded,scattered,sessile,short,short-stipitate,simple,sometimes,somewhat,spherical,splitting,spreadingly,stellae,stem,strait,suffused,surface,tapering,taprooted,terete,terminally,tightly,tube,twice,undulate,usually,variously,vein,violet,wholly,wrinkled	.3,0.7,4-10,6-10-flowere,across,alyx,bristly,capitate-glandular,cauline,deltoid,densely,eaf,eed,geminat,high,lon,longer,mostly,narrowly,nflorescence,occasionally,orolla,ruit,slende,sparsely,ste,stellate-pentagonal,tamen,tigma,tub,tyle,unexpande,uniseriate,unit,vary,vestiture,yello,ympodial,younger	6-10-flowered,abaxial,adaxial,apex,arrangement,branching,characteristic,colour,corolla,diameter,filament,form,fruit,geminate,growth,height,history,inflorescence,leaf,length,life,margin,mentioned,midvein,ovary,peduncle,plant,primary,pseudostipule,rachi,seed,shape,slender,staman,style,tertiary,texture,unarmed,venation,yellow
110	wfo-0001027102	exception_thrown	167	0	0	167	0	0.0		.5,.5-6,0.2-2,0.5,0.5-1,0.5-2,0.5-3,1-1.5,1-2,1-2.5,1-3,1-4,1-6,1.5-2,10-20,15,15-35,2-2.5,2-3,3,3-12,3-4,3-5,4-5,4-7,5-12,<,abaxially,absen,absent,accrescent,acuman,acuminate,acute,adaxial,adaxiall,adaxially,ag,aggregate,almost,alyx,anther,apart,apex,appearance,articulated,axe,ba,base,blade,broad,broadly,calyx,cell,channe,chartaceous,ciliate,cm,congested,connivent,corky,cuneate,curved,cylindrical,deltate,densely,diameter,differing,difoliate,dimorphic,directed,distally,eaf,eed,elliptic,entire,few-,filament,flattened,flower,forked,free,fruit,fruiting,geminat,giving,glabrous,globose,hair,ilament,lanceolate,leaf,leaf-opposed,lobe,long,long-tapered,longitudinal,m.,major,margin,minor,mm,moderately,multiseriate,narrowly,nflorescence,oblong,obtuse,often,one,opening,orange,orolla,ovate,pedicel,peduncle,per,perfect,petiole,pore,portion,pubescent,rachi,rarely,ripe,roughened,rugulose,ruit,short,shrub,simple,size,slender,slit,small,somewhat,spaced,sparsely,stellate,stem,stigma,stone,straight,style,subcoriaceous,surface,tal,tem,time,tip,tomentose,triangular,truncat,truncate,tube,unarme,unbranched,unit,usually,vary,white,wide,x,yellow,yellow-brown,ympodial,young	
111	wfo-0001027104	success	141	113	78	63	35	0.553	0.15-0.35,0.5-0.8,1-1.5,1-3,1-4,1.2-6,1.5-2.3,10-15,2-3,2.2-5,3-5.5,5-15,6-7.5,abaxially,acumen,acuminate,acute,adaxially,apex,articulate,attenuate,base,branched,calyx,cell,cm,cordate,corolla,covering,cyme,diameter,dichasial,dichasially,distal,ebracteate,exceeding,filament,finely,forked,globose,green,green-white,herbaceous,lateral,linear,lobe,long,make,mm,monochasial,mucilaginous,mucronate,narrowly,odd-pinnate,ovate,ovoid,pedicel,peduncle,perennial,petiole,plant,proximal,pubescent,seed,stamen,stigma,straight,style,testal,thick,throughout,tone,truncate,tuber-bearing,wall,white,yellow-green,Â¼	1.5-4.2,2-6,3-6-foliat,4-15,apical,apically,condition,connate,dehiscent,digestion,dorsally,eaf,edge,eed,emoval,enzyme,epiphyti,epiphytic-like,flat,flower,folded,generally,globo,growing,hair-like,half,honeycomb,introrse,living,lon,lower,maturing,mos,nflorescence,nther,often,orolla,ovat,pattern,perfect,plan,poricidally,rarely,reveal,ruit,seudostipule,short,simple,slit,specimen,stellate,tall,tem,terrestrial,throughou,typically,unit,vary,viole,wide,without,yellow,ympodial	'hair-like,abaxial,adaxial,anther,arrangement,branching,characteristic,colour,form,fruit,growth,height,history,inflorescence,leaf,length,life,margin,midvein,null,ovary,primary,pseudostipule,rachi,shape,staman,stem,surface,tertiary,texture,unarmed,vein,venation,violet,wet
112	wfo-0001027114	success	154	119	90	64	29	0.584	-2,.5,0.5-1,1-1.1,1-1.2,1-1.5,1-2,1.5-2,2-3,20-40,3-4,3-7,6-8,7-9,abaxial,abaxially,acute,adaxially,along,anther,apex,appearing,base,berry,branched,bushy,calyx,cm,corolla,dark,deltate,dendritic,densely,difoliate,drying,due,elliptic,filament,flattened-reniform,flowered,geminate,glabrous,globose,green,inflorescence,lamina,lateral,leaf,like,lobe,long,main,major,many,margin,minor,minutely,mm,occasionally,opposite,ovary,pair,pedicel,petiole,pitted,plurifoliate,pubescent,rapid,reddish,reddish-brown,rest,scar,scattered,shoot-terminal,shrub,simple,soft,spaced,stem,style,surface,thickened,time,trichome,unevenly,uniseriate,unit,vein,white,yellowish	-17,-30,1.5-1.7,1/2,13-21,2-2.5,5,6-9,7-10,alternating,anthesi,apar,axillary,ba,bark,capitate,closely,commonly,conical,dia,differing,eaf,edicel,eed,erect,exserted,free,fruiting,glabrou,growt,halfway,inflorescenc,investing,lobed,lon,lower,minute,nflorescence,older,opening,papillo,planar,pore,poricidal,portion,projection,ruit,several,shoot,size,slit,stigma,tall,tapering,tip,triangular,tub,tube,ud,way,wide,woody,ympodial,young	adaxial,apart,arrangement,branching,characteristic,colour,diameter,form,fruit,growth,height,history,length,life,mentioned,midvein,peduncle,plant,primary,pseudostipule,rachi,seed,shape,staman,sympodial,tertiary,texture,unarmed,venation
113	wfo-0001027117	exception_thrown	235	0	0	235	0	0.0		-1.5,-11,-12,-2.8,-3/4,.5,/3,0-10,0-15,0-20,0-25,0-40,0-5,0.1,0.1-,0.1-0.7,0.15-0.25,0.15-0.35,0.2,0.2-0.45,0.5,0.5-1.5,0.6-0.9,0.7-0.9,0.7-1.3,0.7-1.5,0.8-,1-2,1-4,1-6,1.2,1.5-,1.5-2.3,1.5-6.5,1.7-2.5,1.8-2.5,1/,1/3,1/4,1/8-1/2,10-20,2-3,2-6,2-8,2.3-2.8,25-100,3-10,3-15,3-6,4-6.5,4-7,4-8,4.5-6.5,4.5-8,5-11,5-14,5-merous,6-10,6-9,7-,8,abaxially,accrescent,acicular,acute,almost,alyx,ame,anther,apar,apart,apex,apically,apparently,articulated,attenuate,bark,base,berry,beyond,black,blade,branched,brittle,brown,c.,calyx,cell,chartaceous,cm,concolorous,connivent,cordate,curved,dark,deltate,densely,diameter,discolorous,distance,drying,eaf,eed,elongating,enclosing,erect,evenly,extending,fifth,filament,fine,flattened-reniform,flower,four,free,fruit,fruiting,gently,glabrescent,glabrous,gra,green,herb,herbarium,infructescence,irregularly,lateral,leaf,length,less,lobe,lobed,lon,long,long-acuminat,longer,lower,margin,mature,maturity,mauve,membranous,midpoint,midvein,mm,moderately,narrow-deltate,narrow-elliptic,narrow-lanceolate,nflorescence,oblong,obovate,older,one,open,orolla,oung,outline,ovate,pair,pale,pedicel,peduncle,pendulous,per,perfec,pericarp,perpendicular,petiole,pit,plurifoliat,poricidal,porrect,portion,prickl,prickle,prickly,primary,raised,ray,red-brown,reduced,reflexed,rounded,ruit,scar,sessile,shallowly,shiny,shorter,side,small,smooth,sometimes,spaced,sparsely,specimen,spherical,spreading,stalk,stalked,staman,stellate,stellate-pubescent,stem,straight,style,surface,tamen,tapering,tearing,terete,tertiary,time,tip,tissue,translucent,trichome,tube,unequal,unit,upper,variously,vary,vein,venation,visible,way,weakly,wide,woody,yellow,yellow-green,ympodial,young	
114	wfo-0001027123	success	181	147	123	58	24	0.68	-10,-20,.3,0.3-1.6cm,0.5,0.8-1.3,1,1-1.2,1-1.5,1.5-2,2-2.2,2-2.5,2-2.6,2-3,2-5.5,2.5-4,2.5-6,3-15,3-4,4-5,4-6,5-10,5-6,abaxial,acute,adaxial,adaxially,along,anther,apex,appearing,attenuate,axe,bark,base,branched,broadly,brown,calyx,cell,cm,commonly,conical,corolla,dark,darker,deltate,densely,diameter,drying,edge,elliptic,enlarged,erect,filament,flattened,flower,fruiting,glabrous,glandular,inflorescence,lamina,lax,leaf,less,lobe,long,loose,loosely,margin,mauve-purple,midvein,minute,minutely,mm,narrowly,nodding,older,outline,ovary,pair,papillae,papillate,pedicel,peduncle,perhaps,petiole,pitted,plurifoliate,primary,prominent,pubescent,reddish,reniform,revolute,scar,scattered,shining,shiny,simple,sinuate,sometimes,sparsely,stem,stoutish,strongly,style,subshrub,surface,terminal,testal,thick,time,trailing,trichome,tube,turned,usually,vein,violet,warty,white,x	.5,0.5-0.8,0.7-3.5,0.9-1.3,2-lobed,2.5-10.4,anthesi,axi,bright,campanulate,clavate,completely,constricted,coriaceous,cup-shaped,dendritic,denser,eaf,eed,exerted,fide,free,globose,green,inserted,lewi,like,lobed,lon,lower,monopodia,nflorescence,perfect,petal,planar,portion,scatted,shin,shinin,short,sleeve,slightly,soon,spaced,stellate,stigma,straight,tip,tub,ud,unit,upper,way,widely,wood,ympodial,young,Â¾	arrangement,branching,characteristic,colour,form,fruit,growth,height,history,length,life,monopodial,null,plant,pseudostipule,rachi,seed,shape,staman,tertiary,texture,unarmed,venation,woody
115	wfo-0001027146	success	213	114	85	128	29	0.399	0.3-2.2,1-2,1-2.5,1-9.5,10,13-36,2-13,2-4.2,3.3-6.1,4-11,4-12.5,4-8,6,6-10,abaxially,acuminate,adaxially,anther,apex,attenuate,base,berry,brownish,cell,cm,coarsely,condition,conical,corolla,covering,dark,deep,diameter,drying,elliptic,filament,finely,fresh,fruit,glabrous,green,green-white,greenish,hair,hair-like,herb,lateral,leaf,like,lobe,long,make,margin,medium,minute,mm,mottled,mucilaginous,odd-pinnate,ovate,ovoid,pedicel,peduncle,petiole,petiolule,plant,puberulent,pubescent,purple,ripe,seed,simple,stem,style,subglabrous,subsessile,testal,thick,throughout,tinged,violet,wall,wet,white,whitish	0-11,0.5-3.2,0.6-3.3,0.7-2.4,0.8,0.8-3.1,0.8-5.8,1-10,1.9-10,2-12.2,2-5,3.5-22,4-38,5-merou,6-17.5,6.5-52,acumen,ag,along,alyx,apart,apparently,arranged,articulated,asymmetrical,axe,axillary,basiscopic,bead,blade,bud,capitat,chartaceous,ciliate,clavate,commonly,connivent,darker,decreasing,digestion,distal,dorsally,eaf,edge,eed,enzyme,erec,especially,exceeding,flat,flower,folded,forked,fourt,fourth,geminat,generally,glabrou,gradually,half,homostylous,honeycomb-shaped,interjected,lanceolate,leaflet,lengthening,living,lower,membranous,midrib,minutely,moniliform,multiple,necklace,nflorescence,orbicular,orolla,pair,pentagonal,perfect,plurifoliate,pore,poricidal,proximal,rarely,ray,removed,rotate,ruit,secondary,semierect,sessile,seudostipule,side,size,slit,sometimes,spaced,specimen,stamen,ste,stigma,stolon,straight,subequal,subglabrou,subtending,symmetrical,tall,tamen,tem,terminal,tip,tissue,toward,tri-,tube,tuber,typically,unit,unwinged,usually,vary,wide,wing,x,yellow,ympodial	abaxial,adaxial,arrangement,branching,calyx,characteristic,colour,form,growth,height,history,inflorescence,length,life,mentioned,midvein,ovary,primary,pseudostipule,rachi,shape,staman,surface,tertiary,texture,true,unarmed,vein,venation
116	wfo-0001027157	success	207	155	122	85	33	0.589	0.15-0.3,0.7-2,0.9-2.8,1,1-10,1-2,1-3,1-3.8,1-6,1.5-6.5,10-30,2,2-15,2-3,2.5-3,3-12,3-7,3.3-7.8,4-5,6.5-14.5,9-12,abaxially,absent,acumen,acuminate,acute,adaxially,anther,apart,apex,apparently,articulated,attenuate,axe,axillary,base,berry,blade,brownish,bud,cell,cm,condition,conical,cordate,corolla,covering,decurrent,densely,diameter,distal,drying,filament,flower,forked,fresh,fruit,generally,glabrous,green,green-white,greenish,hair,half,herb,interjected,lateral,leaf,leaflet,like,lobe,long,low-growing,make,margin,mm,mucilaginous,oblique,obtuse,odd-pinnate,orbicular,ovate,ovoid,pedicel,peduncle,perfect,petiole,petiolule,plant,plurifoliate,puberulent,pubescent,rarely,ripe,rounded,seed,shady,situation,slightly,sometimes,spaced,stem,straight,style,subsessile,subtending,terminal,testal,thick,throughout,tinged,tri-,tube,typically,unit,usually,violet,wall,wet,white,whitish,x	0-3,2-2.5,2-5,2.3-4,3.8-8.3,5-merou,ag,along,alyx,among,broadly,capitat,chartaceous,ciliate,clavate,connivent,cuneate,decreasing,deeply,digestion,dorsally,eaf,edge,eed,elliptic,end,enzyme,erec,especially,exceeding,flat,folded,geminat,glabrou,grassland,greatly,hair-like,homostylous,honeycomb-shaped,lanceolate,lengthening,living,lower,markedly,membranous,middl,midrib,minutely,narrowly,nflorescence,one,orolla,pair,petiolulate,placed,pore,poricidal,removed,ruit,semi-rosette,sessile,seudostipule,short,size,slit,specimen,stamen,ste,stellate,stigma,stolo,sunny,tall,tamen,tem,tip,toward,tuber,unequal,unwinged,vary,wide,woodland,yellow,ympodial	'hair-like,abaxial,adaxial,arrangement,branching,calyx,characteristic,colour,form,geminate,growth,height,history,inflorescence,length,life,middle,midvein,null,ovary,primary,pseudostipule,rachi,shape,staman,surface,sympodial,tertiary,texture,true,unarmed,vein,venation
117	wfo-0001027184	success	219	170	137	82	33	0.626	.3,.5,.7,.8,0-0.2,0.2-0.4,0.4-2,0.8,13â18,19,1â2,1â4,2,2â4-celled,3-4-,3-foliolate,3â,4,5,5-7,7,abaxially,absent,acute,adaxially,along,anther,apart,apex,articulated,axe,axi,axillary,basal,base,blue,borne,bract-like,branch,brown,calyx,cell,cm,connivent,covered,cylindrical,densely,diameter,entire,epidermal,especially,extension,filament,flattened,flower,foliaceous,free,fruit,generally,glabrous,globose,grading,hair,hairlike,half,herbaceous,imparipinnate,lanceolate,largest,leaf,leaflet,leafy,least,light,like,lobe,long,lower,margin,meter,midrib,mm,mostly,much,nearly,oblong,obtuse,orange,pedicel,peduncle,per,petiole,pilose,plurifoliate,portion,prominent,prominently,pseudostipule,pubescent,rachi,raised,rarely,red,reticulate,revolute,ripe,scarcely,secondary,several,shape,shoot,short,simple,small,soft-woody,somewhat,spaced,sparsely,stem,straight,style,sulcate,surface,tertiary,truncate,tube,unbranched,unequal,unit,vein,vine,visible,wall,white,x,yellow,â9	0-,0.4â0.9,0.5-2,0.8â1.6,0â3,1-2,1.5,1.5-5,1.8â3.5,1â2.5,2.8â4.1,3.5â8,3â4-celled,4â12,9,accrescent,adaxiall,adventitious,ag,always,alyx,appressed,ba,blade,broad,broadly,chartaceous,clavat,cluster,cordat,directed,eaf,eed,elliptic,fasciculate,fleshy,fruiting,geminat,glabrescent,glabrou,ilament,introrsely,larger,lateral,less,longitudinal,m.,membranous,minutely,narrowly,nflorescence,node,often,older,opening,opposite,orolla,ovate,ower,petiolule,pore,puberulent,root,ruit,size,slightly,slit,stellate,stigma,subopposite,terminal,tightly,tip,tree,trunk,unarme,uniform,usually,vary,weak,ympodial,young	--,0,1-4,3,3.5-8,abaxial,adaxial,arrangement,branching,characteristic,colour,cordate,corolla,form,geminate,growth,height,history,inflorescence,length,life,midvein,null,ovary,plant,primary,seed,staman,sympodial,texture,true,unarmed,venation
118	wfo-0001027186	success	168	153	127	41	26	0.756	-6,.4,.5,0.5-1,1-1.5,1-2.5,1.4-1.6,1.5,1.5-2,1.5-2.5,1.6-5,15,2-6,3-4,3.5-4,30-40,4-15,4-9,5-10,6-7,9-10,?,abaxial,abaxially,acute,adaxially,always,anther,anthesi,apex,attenuate,axil,bark,base,berry,branch,branched,brown,calyx,cm,conical,corolla,dark,dbh,deflexed,deltate,dendritic,densely,denser,diameter,dry,elliptic,entire,filament,filiform,flower,free,fruit,glabrescent,glabrous,globose,golden,green,growth,immature,keeled,lamina,less,like,lobe,longer,loose,margin,maturity,midrib,minutely,mm,much,narrowly,new,occasionally,ovary,ovoid,pair,pale,pedicel,peduncle,pericarp,petiole,pitted,portion,primary,pubescent,rachi,reddish,reniform,scattered,seed,shiny,short,simple,slightly,small,soon,sparsely,spreading,stalk,stem,straight,style,surface,terminal,time,tip,tree,treelet,trichome,tube,uniseriate,unit,variably,vein,way,white,woody,x,yellow	2-lobed,2.5-3,age,apart,apparently,broadly,clavate,denditic,eaf,ellipsoid,enlarging,exerted,fruiting,incrassat,irregularly,lengthening,lobed,lower,m.,nflorescence,papillat,papillate,pendent,perfect,planar,plane,plurifoliat,pointed,pore,poridical,pubescen,rough,ruit,scar,slit,spaced,stigma,strongly,tub,ud,ympodial	2,adaxial,arrangement,branching,characteristic,colour,form,height,history,incrassate,inflorescence,leaf,length,life,midvein,null,plant,plurifoliate,pseudostipule,shape,staman,sympodial,tertiary,texture,unarmed,venation
119	wfo-0001027198	success	191	151	119	72	32	0.623	.4,.5,0.5-1,0.7-1,0.8-1,1-1.5,1-10,1.5-10,1.5-2,10-11,5-120-flowered,5-6,abruptly,acuminate,acute,anther,apex,attenuate,axil,base,beneath,berry,broadening,bushy,calyx,channeled,cm,complex,corolla,cyathiform,deltoid,dendritic,densely,dia,difoliate,elliptic,entire,erect,extremely,eye,female,filament,flower,free,furcate,glabrate,glabrous,globose,golden,green,impressed,inflorescence,invisible,large,lateral,leaf,like,lobe,long,main,major,male,many,margin,medium,middle,minor,minute,minutely,mm,naked,nearly,obovate,often,older,opposite,ovary,ovoid-reniform,pale,paler,pedicel,petiole,pitted,plant,portion,puberulent,pubescent,rounded,sessile,set,shining,short,shrub,simple,size,slender,slightly,small,speciman,stem,style,styled,surface,tannish-yellow,testae,thin,time,tree,trichome,tube,two,type,uniseriate,unit,vein,white,widest,x,young	0.05-1.0,0.5-0.75,1-5,11-20,2-5.5,3/4,4-9,7.5-9,always,anthesi,apart,ba,beginning,caly,clavate,closely,constriction,corky,corresponding,decurrent,differing,dry,eaf,edge,edicel,eed,evenly,exserted,found,fruiting,geminat,inflorescenc,live,lobed,lon,lower,meet,nflorescence,overlapping,ovoid,papillo,papillose,pendan,planar,pore,poricidal,pubescence,rather,reddi,reflexed,rest,ruit,scar,shaped,soon,spaced,specimen,stigma,straight,strong,tall,tear-drop,thickened,tip,top,ud,undersurface,usually,way,woody,yellowish,ympodial	-,abaxial,adaxial,arrangement,branching,characteristic,colour,diameter,form,fruit,geminate,growth,height,history,length,life,mentioned,midvein,peduncle,pendant,primary,pseudostipule,rachi,reddish,seed,shape,staman,sympodial,tertiary,texture,unarmed,venation
120	wfo-0001027200	success	139	116	87	52	29	0.626	0.05-0.25,0.25-0.5,0.5-1,0.6-1,1-1.4,1-1.5,1.2-1.5,1.5-2,1.5-5,2-3,2.5-3,3-3.5,6-8,9-11,acute,anther,apex,base,beneath,berry,brown,calyx,cm,converging,corolla,dark,decurrent,deeply,deltoid,densely,dia,elliptic,filament,free,geminate,glabrous,globose,golden,green,horizontally,impressed,inflorescence,lateral,leaf,like,lobe,long,main,major,margin,minor,minute,minutely,mm,near,node,non-reproductive,onto,ovary,ovoid-reniform,papillose,pedicel,petiole,pitted,portion,prominent,puberulent,rest,shrub,slightly,small,sparsely,spreading,stem,style,surface,tip,tree,trichome,tube,unicellular,uniseriate,vein,white,x,yellowish,young	0.5-0.75,0.7-2.5,1.6-6,3.5-6,8-15,across,anthesi,aspec,ba,bark,branch,branche,broadly,capitate,conical,deflexed,differing,eaf,eed,except,flattened,fruiting,giving,grey-brown,lightly,lobed,lon,lower,middle,nearly,occasionally,older,papillo,planar,pore,poricidal,reflexed,ruit,shaped,size,sparse,stigma,straight,tall,tear-drop,unifoliate,unit,widened,widest,winged,woody,ympodial	abaxial,adaxial,arrangement,branching,characteristic,colour,diameter,form,fruit,growth,height,history,length,life,midvein,null,peduncle,plant,primary,pseudostipule,rachi,seed,shape,staman,tertiary,texture,true,unarmed,venation
121	wfo-0001027213	success	231	171	145	86	26	0.628	-19,-230,-3.3,-4.5,/10,0-160,0-2.5,0.2-0.4,0.2-0.5,0.7-2.3,0.8-1.8,1-2,1-5,1.1-1.7,1.2-1.6,1.2-2.5,1.3-2.2,1.7-3.9,1.8-3.2,1/2-2/3,10-24,12.3-16.3,2-5,2.9-3.8,2.9-4.8,2/3,3.5-8,4-9.5,4.2-5.9,5.7-6.2,8-24,8.2-10.5,9-13,abaxially,acuminate,acute,adaxially,along,anther,apart,apex,apparently,articulated,attenuate,axe,axillary,basal,base,blade,branch,branched,broadly,brown,calyx,cm,conical,corolla,cuneate,cylindrical,dark,decurrent,deltoid,diameter,elliptic,entire,exserted,filament,flower,fruit,glabrescent,glabrous,globose,granular,grayish-brown,green,hair,immature,leaf,length,lobe,long,long-,long-stalked,many,margin,midrib,mixed,mm,mostly,multangulate,nearly,oblanceolate,obtuse,often,older,pale,partly,pedicel,peduncle,perfect,petiole,plurifoliate,porrect-stellate,pseudo-terminal,pubescent,rachi,relatively,reniform,reticulate-punctate,scabrous,sessile,short,short-,short-attenuate,short-stalked,shrub,side,simple,spaced,sparsely,stamen,stem,style,surface,thick,thick-stalked,thin-stalked,time,tomentose,tomentose-pubescent,tree,unarmed,unwinged,vein,violet,way,white,whitish,whitish-green,wide,x,yellow-green,yellow-tan,yellowish,young	1.2-1.7,1.7-3.6,1.8-2.8,2.4-4.7,2.5-5.1,3.5-5,5-7.5,5-8,5-merou,accrescent,ag,alyx,anthesi,ark,around,ba,blunt-tipped,capitat,cell,completely,covering,directed,distally,drying,eaf,early,edge,eed,enveloping,epidermal,eventually,farinose,few-rayed,free,fruiting,glabrescen,group,high,homostylous,inserted,lackin,lanceolate,lateral,lengthening,lobed,longitudinal,lower,m.,main,moderately,multangulat,nflorescence,obovate,obscured,orbicular,orolla,ovate,ovate-lanceolate,pore,poricidal,porrect-stellat,prominent,pubescence,rather,ruit,slit,sometimes,somewhat,stellate,stigma,subcampanulate,suture,tamen,terete,ti,tip,tomentu,touching,tube,ud,unarme,unit,vary,vestigial-rayed,yellow,ympodial	abaxial,adaxial,arrangement,branching,characteristic,colour,form,growth,height,history,inflorescence,lacking,life,midvein,ovary,plant,primary,pseudostipule,seed,shape,staman,tertiary,texture,true,unspecified,venation
122	wfo-0001027214	success	181	139	110	71	29	0.608	-9,..,.25,.5,0,0-16,0.25,0.5-0.8,0.5-1,0.7-2.5,1-1.5,1.5,1.5-1.8,10-13,2,2-9,3-,3-6,4-5,5-6,abaxially,acuminate,adaxially,along,anther,anticlinal,apex,apical,base,berry,broadly,calyx,cell,climbing,cm,composed,conical,corolla,deltate,densely,diameter,drying,elliptic,epidermal,erect,extending,filament,finely,flattened-round,flower,fruit,glabrous,green,greenish,groove,grown,height,herb,inflorescence,irregular,lamina,leaflet,length,less,like,lobe,long,long-conical,margin,midrib,mm,nodding,oblique,occasionally,once-branched,open,ovary,pair,papillate,pedicel,per,petiole,pinnate,pointed,projection,pubescent,rachi,rest,scar,scattered,scrambling,seed,sharply,simple,sinuous,somewhat,style,surface,thickening,time,triangular,trichome,truncate,uniseriate,unit,vein,white,whitish,without,x	-20,-38,0.3-1.5,0.3-1.7,0.7-2,0.8-1,1-2.8,1.2-3,1.5-6,10-,12-17,15-25,6-,6-12,7-12,8-9,absent,acute,anthesi,basal,capitat,conspicuously,decurrent,dr.,eaf,edicel,eed,exserted,free,fruiting,globose,horizontal,inflorescenc,lanceolate,lateral,lobed,lon,long-acuminate,lower,markedly,minutely,narrowly,nearly,nflorescence,noddin,obovate,often,onto,opposite,paired,papilla,perfectly,petiolule,poricidal,portion,reflexed,rugose,rugosity,ruit,smaller,stigma,tem,terminal,tip,tub,tube,ud,unevenly,unifoliat,white-lenticellate,ympodial	2.0,abaxial,adaxial,arrangement,branching,characteristic,colour,form,growth,history,leaf,life,midvein,null,papillae,peduncle,plant,primary,pseudostipule,shape,staman,stem,sympodial,tertiary,texture,true,unarmed,unifoliate,venation
123	wfo-0001027219	success	143	133	104	39	29	0.727	.5,0.3,0.4-0.6,0.5,0.5-0.8,1-15,1-2,1-3,1.5-2,1.5-2.5,2,2-2.5,2-3,2-3.5,2-4,3-5,3-6,6-8,7-8,absent,acuminate,acute,anther,anthesi,apex,axillary,bark,base,berry,bright,broadly,brown,calyx,capitate,cm,conical,corolla,cup-shaped,deltate,densely,diameter,drying,elliptic,entire,erect,filament,flower,free,fruiting,glabrescent,glabrous,green,greyish,growth,hard,known,leaf-opposed,less,lobe,long-conical,long-styled,margin,maturity,minutely,mm,new,ovary,pair,pale,pedicel,peduncle,pendent,pericarp,petiole,pointed,portion,primary,pubescent,purple,sharply,shoot,short,short-styled,shrub,simple,sometimes,soon,stem,stigma,stout,style,surface,terminal,trichome,tube,tuft,uniseriate,vein,violet,weight,white,woody,x,yellowish	/4,1,age,berr,c.,closely,completely,eaf,edge,eed,exerte,exfoliatin,glabrou,globose,heterostylous,lengthening,lobed,lower,nflorescence,overlappin,papillo,papillose-pubescent,planar,plurifoliat,pore,poricidal,ruit,scar,slightly,slit,somewhat,spaced,thickened,tip,ud,unit,way,ympodial,â1/3	abaxial,adaxial,arrangement,branching,characteristic,colour,exfoliating,form,fruit,height,history,inflorescence,leaf,length,life,midvein,null,papillose,plant,plurifoliate,pseudostipule,rachi,seed,shape,staman,tertiary,texture,unarmed,venation
124	wfo-0001027223	success	189	127	95	94	32	0.503	0.19-0.75,0.3-1.2,1-2,1.8-3.5,16-41,3-10,3-11,3-5,3-5.2,3.5-4,3.7-9.3,4-6,5-8,abaxially,acuminate,adaxially,anther,apart,apex,articulated,asymmetric,attenuate,base,basiscopic,berry,brownish,cell,cm,condition,conical,corolla,covering,deep,densely,diameter,distal,dot,drying,elliptic,filament,forked,fresh,fruit,glabrous,green,green-white,greenish,hair,half,herb,hyaline,lanceolate,lateral,leaf,leaflet,light,like,lobe,long,make,middle,mm,mucilaginous,odd-pinnate,ovate,ovoid,pedicel,peduncle,petiole,petiolulate,plant,pubescent,purple,ripe,rounded,seed,sessile,short,shortly,side,sometimes,spaced,straight,stripe,style,terminal,testal,thick,throughout,tissue,usually,wall,wet,white,whitish	.5,1-3,1.3-2,1.5-3.5,2-4,2-7,3.5-6,3.5-7,5-10,5-21,5-merou,5.9-12.2,9-15,9-22,9-35,acumen,adaxiall,ag,alyx,apparently,axe,axillary,blade,bud,capitat,clavate,connivent,decreasing,digestion,dorsally,eaf,edge,eed,end,enzyme,erec,exceeding,flat,flower,folded,geminat,generally,glabrou,hair-like,hal,homostylous,honeycomb-shaped,interjected,larger,lengthening,living,lower,nflorescence,one,orbicular,orolla,pair,pentagonal,perfect,placed,plurifoliate,pore,poricidal,present,removed,rotate,ruit,seudostipule,size,slightly,slit,specimen,stamen,ste,stigma,stolo,subequal,subtending,tall,tamen,tem,tip,toward,tri-,tube,tuber,typically,unit,unwinged,vary,wide,x,yellow,ympodial	'hair-like,abaxial,adaxial,arrangement,branching,calyx,characteristic,colour,form,growth,height,history,inflorescence,length,life,margin,mentioned,midvein,ovary,primary,pseudostipule,rachi,shape,staman,stem,surface,tertiary,texture,true,unarmed,vein,venation
125	wfo-0001027237	success	122	128	92	30	36	0.754	.5,/4,0.5-1,1-1.2,1.5-2,1.5-2.5,2-3,3-3.5,3-4,30-100-flowered,6-11,6-8,8,anther,anthesi,apart,apiculae,apiculate,appearing,bark,base,berry,black,branched,broadly,brown,calyx,cm,completely,corolla,cup-shaped,dark,deflexed,deltoid,dia,difoliate,drying,filament,flattened,free,geminate,glabrous,globose,green,greenish-white,inflorescence,internodal,leaf,lobe,lobed,long,many,margin,minutely,mm,occasionally,older,ovary,paler,papillate,part,pedicel,pitted,portion,regularly,reniform,scar,shining,shrub,slender,small,spaced,stem,straight,style,surface,tall,tapering,terminal,time,tip,tree,tube,unit,upper,usually,way,white,widely,x,x.,young	5,ba,blac,branc,clavate,cucullate,edicel,eed,ellipsoid,erect,exsertion,fruiting,greyi,later,lower,nflorescence,papillo,papillose,plurifoliat,pore,poricidal,reflexed,regulary,ruit,shaped,stigma,tear-drop,ud,woody,ympodial	-,abaxial,adaxial,apex,arrangement,branch,branching,characteristic,colour,diameter,form,fruit,greyish,growth,height,history,length,life,mentioned,midvein,peduncle,petiole,plant,plurifoliate,primary,pseudostipule,rachi,seed,shape,staman,sympodial,tertiary,texture,unarmed,vein,venation
126	wfo-0001027238	success	204	152	122	82	30	0.598	-25,.3,.5,0-0.7,0-1,0-1.5,0.3-0.5,0.5-1,1-1.5,1.5-3,1.5-4,10,15-30,2-4,3-4,3-5,3-6,5-15,5-7,6-15,6-8,abaxially,acuminate,acute,adaxially,anther,apex,apparently,articulated,axe,base,berry,black,blade,brown,calyx,cm,contiguous,cuneate,cylindrical,dark,deltate,densely,diameter,elliptic,elliptic-ovate,entire,equal,extra-axillary,filament,flattened,fleshy,flower,foliaceous,free,fruit,glabrescent,glabrous,globose,green,greenish,hair,lavender,leaf,light,lighter,like,lobe,long,major,margin,minutely,mm,multangulate,near,nearly,oblique,obtuse,outline,pale,part,pedicel,peduncle,perfect,pericarp,petiole,pitted,porrect-stellate,pubescent,purple,rachi,reniform,ripe,rounded,scandent,sessile,shiny,shrub,side,similar,simple,small,sometimes,sparsely,sprawling,stellate-pubescent,stem,straight,strongly,style,surface,tip,tree,tube,unbranched,unequal,vein,white,whitish,x,yellow,yellowish	-5,0.3-0.8,0.3-1,0.3-5,0.5-16,0.5-2,1-2,1.5-7,2-3,4-,4-10,4-16,4-5,4-8,5-merou,accrescent,adaxiall,ag,alyx,ba,branch,capitat,chartaceous,connivent,covering,differentiated,directed,discolorous,distally,eaf,eed,fork,frui,fruiting,geminate,gland,gland-tipped,growt,homostylous,interpetalar,introrsely,juic,large,longitudinal,lower,membranaceous,midpoint,minor,mixed,narrowly,new,nflorescence,oblong,often,one,opening,orolla,paired,plurifoliate,pore,ray,ruit,short-stalked,slit,somewhat,sparse,ste,stellate,stigma,subtending,tamen,tem,time,tissue,toward,triangular,unarme,unit,vary,wide,without,ympodial	abaxial,adaxial,arrangement,branching,characteristic,colour,corolla,form,growth,height,history,inflorescence,juicy,length,life,midvein,null,ovary,plant,primary,pseudostipule,seed,shape,staman,stamen,tertiary,texture,true,unarmed,venation
127	wfo-0001027244	success	294	178	156	138	22	0.531	-12,-2,-3.2,0.2,0.2-1,0.3-0.6,0.4-1,0.45-0.6,0.5,0.5-0.8,0.7-1.5,0.9-1.3,1,1-celled,1.1-1.3,1.2-1.6,1.5-2,1.5-2.4,1.7-3.0,1/2,2-4-celled,2-9,2-foliate,2-locular,2.1-8,3/4,4-12,4-celled,5-,7-12,8-16,abundant,acuminate,acute,adpressed,alfway,along,also,anther,apex,appearance,articulated,articulation,base,bifurcate,bracteate,branched,broadly,brown,c.,calyx,cell,cm,cordate,corolla,crenate,dark,decumbent,decurrent,deltate,dense,densely,dentate,diameter,distal,eglandular,elliptic,erect,filament,flower,flushed,fruit,giving,glabrous,glandular,globose,green,greenish,hair-like,half,head,herb,imparipinnate,inflorescence,internode,interrupted,irregularly,lamina,lanceolate,lateral,leaflet,length,like,lobe,lobed,long,margin,middle,midvein,mixed,mixture,mm,narrowly,oblique,obovate,often,onto,orbicular,outgrowth,ovary,patent,pedicel,peduncle,perennial,petiole,present,primary,pseudostipule,pubescent,purple,rachi,ripe,rounded,shaggy,silky,simple,slender,sometimes,somewhat,sparse,sparsely,spreading,stem,stout,stripe,style,surface,tall,terminal,tertiary,testa,thick,trichome,truncate,uniseriate,unit,usually,vein,velvety,vivid,wall,white,wide,winged,woody,yellow	-1.2,.5,0-,0.02-,0.04-,0.05,0.05-1,0.07-0.15,0.1-,0.1-0.3,0.1-0.5,0.1-0.6,0.15-0.2,0.2-,0.25-0.4,0.3,0.3-0.4,0.3-0.5,0.3-0.8,0.4-,0.4-0.6,0.5-1,0.6-0.9,0.6-09,0.7-1,0.7-2,0.7-3,0.8-1.2,0.9-1.7,1-2-celled,1-2.5,1-3.5,1.5-2.1,1.5-6.5,2-,2-4,3-5,3.5-13,5-10,5-9-celled,8-celled,abaxially,absent,abundance,acroscopically,adaxially,always,amongst,angled,anthesi,apical,apparently,appendage,arequipa,around,articulatio,axi,basal,berr,berry,bract,cage,capitate,column,common,conical,curved,deciduous,deeper,density,developed,diamete,eaf,edicel,eed,either,elliptical,exserted,extremely,forming,fruiting,general,glabrescent,gland,gree,halfway,hyaline,interjected,investing,larger,largest,leave,lobing,lon,longer,lower,minute,multicellular,near,node,occasionally,pair,papillate-pubescent,petiolule,population,reflexed,rest,rotate-stellate,ruit,scattered,secondary,sessile,short,shorter,sinus,size,small,sparser,staminal,sterile,stigma,straight,strongly,tem,tiny,tip,tipped,toward,tube,two,ud,undulate,unicellular,united,upper,variable,variety,ympodial	abaxial,adaxial,arrangement,branching,characteristic,colour,description,form,growth,height,history,leaf,life,mentioned,plant,seed,shape,staman,sympodial,texture,unarmed,venation
128	wfo-0001027248	success	158	108	79	79	29	0.5	.5,0,0.5-1,0.5-2.5,0.7-1.2,1-1.5,1-2,1-3,1-5,3-4,3-7-flowered,3.5-4,5-5.5,6.5-8,7-9,abaxial,abaxially,acute,adaxially,along,anther,apex,arachnoid,arachnoid-pubescent,base,beneath,berry,broadly,brown,brownish,calyx,cm,corolla,dark,deltate,densely,denser,dirty,elliptic,felty,filament,fruit,glabrous,globose,green,impressed,lateral,leaf,lobe,long,main,margin,minutely,mm,opposite,ovary,ovoid-reniform,pair,pale,patch,pedicel,per,petiole,pitted,pubescence,pubescent,scattered,shrub,simple,small,sparsely,stem,style,surface,tree,trichome,vein,white,wide	2-2.5,2-4.5,3-7,4-8,6-13,anthesi,ape,appearing,arachnoid-pubescen,area,bark,beige,broadened,brownish-gra,closely,conical,deflexed,dia,differing,difoliate,eaf,edicel,eed,ellipsoid,erect,exserted,fleshy,free,fruiting,geminate,glabrescent,grayish-green,lamina,later,lightly,lobed,lower,major,merely,minor,nearly,nflorescence,node,occasionally,older,overlappin,papillo,papillose,planar,pore,poricidal,portion,present,ruit,scar,shaped,shoot,size,somewhat,soon,spaced,specimen,stigma,strongly,tall,tear-drop,thick,tip,top,tub,tube,ud,unifoliate,unit,wid,winged,woody,ympodial,young	adaxial,arrangement,branching,brownish-gray,characteristic,colour,diameter,form,growth,height,history,inflorescence,length,life,midvein,null,peduncle,plant,primary,pseudostipule,rachi,seed,shape,staman,tertiary,texture,true,unarmed,venation
129	wfo-0001027258	success	178	150	120	58	30	0.674	.25,.5,0.25-0.5,0.5-1,0.6-2,0.9-1.3,1-1.5,1-2.3,1.5-1.6,2-2.5,3-4,3.5-4,4-5,4.5-5,5-10-flowered,6-8,7-9,abaxially,abruptly,acuminate,acute,adaxially,along,anther,apex,apical,apiculae,attenuate,axil,bark,base,berry,calyx,cm,corolla,crystal,darker,decurrent,deltate,dense,densely,deposit,dia,difoliate,dissecting,drying,elliptic,entire,extending,filament,flattened-reniform,free,fruit,glabrous,globose,green,greenish-yellow,incrassate,internodal,lamina,large,lateral,leaf,length,lenticel,lobe,long,main,major,margin,microscope,minor,minutely,mm,occasionally,often,older,onto,opposite,ovary,ovate,pair,pale,pedicel,petiole,pitted,portion,projection,prominent,pubescent,reddish,sand,scattered,shrub,simple,slender,slightly,small,sparsely,speck,stem,style,surface,swollen,tiny,treelet,trichome,tube,tuft,uniseriate,unit,vein,visible,white,widening,winged,x,yellowish,yellowish-tan,young	/4,1-4,1.2-2,2.5-8,3-6,7-13,age,anthesi,apar,ba,beneath,broadly,capitate,deflexed,differing,eaf,edicel,eed,ellipsoid,enlarge,evenly,exserted,fide,fragrant,fruiting,geminat,glabrou,lengthening,lobed,lower,middle,minute,nee,nflorescence,papillo,papillose,planar,pore,poricidal,red-papillose,ruit,scar,size,slit,spaced,stigma,straight,strongly,sweetly,tall,tip,tub,ud,urceolate,way,widest,woody,ympodial	-,abaxial,adaxial,arrangement,branching,characteristic,colour,diameter,form,geminate,growth,height,history,inflorescence,life,mentioned,midvein,peduncle,plant,primary,pseudostipule,rachi,seed,shape,staman,sympodial,tertiary,texture,unarmed,venation
130	wfo-0001027260	success	176	158	121	55	37	0.688	-17,-2,-60,0.25-1,0.5-3,0.5-6.5,0.8-2,1-,1-2,1-3,1-4,1-6,1-7,1.5-13,1.5-2,10-25,15-30,2-,2-10,2-18,2-2.5,2.5-3.5,3-,3-10,3-11,3-4.5,3-6,3.5-25,4-32,4-6,4.5-14,5-,5-40,6-20,abaxially,acuminate,acute,acute-,adaxially,age,aggregate,also,apart,apex,articulated,axe,basal,base,berry,beyond,blade,branched,cell,chartaceous,cm,cordate,cylindrical,darker,densely,diameter,eglandular,ellipsoidal,elliptic,elliptic-ovate,entire,exserted,fading,flattened,flower,fruit,glabrate,glabrous,globose,greenish,hair,lanceolate,lavender,leaving,lobe,long,longitudinal,margin,mm,moderately,obtuse,often,ovate,pedicel,pedicellar,peduncle,perfect,petiole,pilose,pink,puberulent,puberulent-pubescent,pubescent,pubescent-pilose,purple,rachi,remnant,shrub,small,spaced,sparsely,stamen,stone,stripe,style,subcoriaceous,time,tree,unbranched,unit,usually,vein,white,wide,x,yellow-green,yellowish	-7,0.5-1,0.75-1,2.5-14,4-25,4-5-foliat,5-25,5-merous,absent,alyx,ape,clavate,connective,connivent,diamete,directed,distally,eaf,eed,equal,exceeding,lon,lower,membranaceous,narrowly,nearly,nflorescence,nther,orolla,perfec,pilo,pore,presen,puberulent-pubescen,radiu,ruit,shorter,simple,slightly,stellate,stigma,strongly,tal,tapered,tem,thecae,tomento,triangular,truncate,tube,ud,vary,yellow,yellow-orang,ympodial	4-5-foliate,abaxial,adaxial,anther,arrangement,branching,calyx,characteristic,colour,corolla,filament,form,growth,height,history,inflorescence,leaf,length,life,midvein,null,ovary,plant,present,primary,pseudostipule,seed,shape,staman,stem,surface,sympodial,tertiary,texture,true,unarmed,venation
131	wfo-0001027265	success	159	134	101	58	33	0.635	-2.5,.2,.3,.5,0.1â2,0.2-0.4,0.5-1,0.5â0.6,1-3,1.2-1.3,1.2-2,1.2â1.4,1.5â1.8,1.5â2,1.5â4,2,2-3,2/3,20-30,2â2.5,2â3,3-lobed,30â50,4-5,4.5â8,4â6,4â7-branched,abaxially,acute,adaxially,anther,apart,apex,articulated,axe,base,berry,blade,calyx,chartaceous,ciliate,cm,cylindrical,diameter,entire,erect,extra-axillary,filament,flattened-reniform,flower,fruit,glabrous,globose,hair,herb,leaf-opposed,light,lobe,long,long-attenuate,low,lower,margin,mesocarp,minutely,mm,near,nearly,numerous,obtuse,orange,ovate-lanceolate,pedicel,peduncle,petiole,pitted,puberulent,pubescent,purple,rachi,rarely,recurved,red,ripe,seed,simple,slightly,sometimes,spaced,sparsely,style,subcoriaceous,surface,time,triangular,weak,white,wide,winged,x,yellow	0.5,1-1.3,1-2.5,1.5-2.5,2-,2-4,3-,5-merou,58409,accrescent,adaxiall,alyx,apparently,ba,broad,capitat,connivent,covering,croat,dehiscent,eaf,eed,foliate,frui,fruiting,geminat,granule,hermaphroditic,juic,larger,lon,longitudinall,nflorescence,node,oblong,orolla,paired,partially,pore,present,prominent,rooting,rotate-stellate,ruit,scarcely,sclerotic,somewhat,stigma,tall,tamen,tem,tip,tube,unit,usually,vary,white-puberulent,ympodial	1.5-1.8,4-6,abaxial,adaxial,arrangement,branching,characteristic,colour,corolla,form,growth,height,history,inflorescence,juicy,leaf,length,life,mentioned,midvein,ovary,plant,primary,pseudostipule,shape,staman,stem,tertiary,texture,true,unarmed,vein,venation
132	wfo-0001027265	success	156	129	98	58	31	0.628	-2.5,.2,.3,.5,0.1â2,0.2-0.4,0.5,0.5-1,0.5â0.6,1-3,1.2-1.3,1.2-2,1.2â1.4,1.5â1.8,1.5â2,1.5â4,2,2-3,2/3,20-30,2â2.5,2â3,3-lobed,30â50,4-5,4.5â8,4â6,4â7-branched,abaxially,acute,adaxially,anther,apart,apex,articulated,axe,base,blade,calyx,ciliate,cm,diameter,entire,erect,extra-axillary,filament,flattened-reniform,flower,fruit,glabrous,globose,hair,herb,leaf-opposed,light,lobe,long,long-attenuate,low,lower,margin,mesocarp,minutely,mm,near,nearly,numerous,obtuse,orange,ovate-lanceolate,pedicel,peduncle,petiole,pitted,puberulent,pubescent,purple,rachi,rarely,recurved,red,ripe,seed,simple,slightly,sometimes,spaced,sparsely,style,surface,time,triangular,weak,white,wide,winged,x,yellow	1-1.3,1-2.5,1.5-2.5,2-,2-4,3-,5-merou,58409,accrescent,adaxiall,alyx,apparently,ba,broad,capitat,chartaceous,connivent,covering,croat,cylindrical,dehiscent,eaf,eed,foliate,frui,fruiting,geminat,granule,hermaphroditic,juic,larger,lon,longitudinall,nflorescence,node,oblong,orolla,paired,partially,pore,prominent,rooting,rotate-stellate,ruit,scarcely,sclerotic,somewhat,stigma,subcoriaceous,tall,tamen,tem,tip,tube,unit,vary,white-puberulent,ympodial	abaxial,adaxial,arrangement,branching,characteristic,colour,corolla,form,growth,height,history,inflorescence,juicy,leaf,length,life,midvein,null,ovary,plant,primary,pseudostipule,shape,staman,stem,tertiary,texture,true,unarmed,vein,venation
133	wfo-0001027284	success	172	154	107	65	47	0.622	.3,0.2â,1.5â8,1â1.5,1â2,3.5â14,4,abaxially,acuminate,adaxially,anther,apex,axe,axillary,base,berry,blade,branch,branched,brownish,calyx,cm,conspicuous,cordate,cylindrical,deflected,deltoid,densely,diameter,elliptic,entire,extra-axillary,filament,fine,flattened,flattened-reniform,fleshy,flower,fruit,glabrous,globose,gradually,green,herbaceous,immature,inflorescence,leafy,lobe,long,margin,maturity,midvein,minutely,mm,nearly,oblique,one,orangish,ovate,ovoid,pair,pale,pedicel,peduncle,petiole,pointed,prominent,pubescence,pubescent,rachi,rarely,reduced,reticulate-rugulose,rounded,sand-punctate,scandent,scar,secondary,seen,shortly,shrub,side,simple,size,slightly,sometimes,somewhat,soon,sparsely,spreading,stem-terminal,style,surface,tan,thickly,time,toward,truncate,unbranched,vein,venation,vine,weakly,white,wide,woody,x	0.1â0.5,0.1â2,0.7â0.9,0.7â1,1.2â1.5,1.5â2,1.5â2.5,1.5â5.5,1.8â2,1â3,2.5â3,2.5â3.5,2â16,2â2.2,3â4,4â12,4â6,5-merous,5â7,5â8,9â18,accrescent,acute,alyx,anthesi,c.,capitat,ciliat,climbing,contiguousl,distally,eaf,eed,enlarged,fruiting,glabrescen,glabrou,lower,m.,near,nflorescence,nternode,orolla,pendulou,perfec,pink,pinnate,planar,plurifoliate,ruit,sand-punctat,spaced,stellate,stigma,tamen,tem,thickened,tip,tree,tube,understory,unifoliat,unit,vary,ympodial	0.1-0.5,0.1-2,0.7-0.9,0.7-1,1-1.5,1-3,1.2-1.5,1.5-2,1.5-2.5,1.8-2,2-16,2-2.2,2.5-3.5,3-4,4-12,4-6,5-7,5-8,9-18,abaxial,adaxial,arrangement,branching,characteristic,colour,corolla,form,glabrescent,growth,height,history,leaf,length,life,mentioned,ovary,pendulous,plant,primary,pseudostipule,seed,shape,staman,stem,tertiary,texture,unarmed
134	wfo-0001027302	success	188	144	118	70	26	0.628	.5,0.4-5,0.5-1,0.6-1,0.8-1,1,1-1.3,1-1.5,1-2,1.2-2.5,1.5-2,2,2-3,2-6,2.2,3.5-5,6-12,abaxial,abaxially,acuminate,acute,adaxial,adaxially,along,anther,anthesi,apex,apical,appearing,bark,basal,base,berry,blade,branching,bright,brownish-yellow,calyx,cm,cordate,corolla,crispate,cultivation,deltoid,dendritic,denser,diameter,elliptic,entire,especially,filament,flat-topped,flattened,glabrous,globose,growth,later,lateral,lax,leaf,length,lenticular,like,lobe,long,long-triangular,main,margin,minutely,mm,monochasial,narrowly,nodding,occasionally,older,ovary,ovate,overtopping,pair,pale,per,pericarp,petiole,pitted,plant,plurifoliate,puberulent,pubescent,pyramidal,red,reddish-brown,scattered,scrambling,secondary,shoot,shrub,simple,small,somewhat,sparsely,stem,style,surface,tall,tapering,terminal,thin,tree,trichome,truncate,undulate,unit,usually,vein,violet,wide,winged,x	0.5,1-3,1.2-1.6,10,10-20,2.7-7.5,3/4,5-7,7,7/8,age,ba,becoming,broader,capitate,clavate,conical,decurrent,deflexed,densely,dichasia,discussion,eaf,edicel,eed,ew,exserted,fine,flower,free,fruiting,growing,inserted,juvenile,larger,less,lobed,lon,lower,m.,nflorescence,otherwise,papillo,pedicle,planar,pore,poridical,portion,prominent,reflexed,ruit,scar,see,shade,shin,sleeve,slit-like,stamen,stigma,strongly,time,tiny,tip,tub,tube,ud,way,woody,ympodial,young	arrangement,characteristic,colour,dichasial,form,fruit,height,history,inflorescence,life,midvein,null,pedicel,peduncle,primary,pseudostipule,rachi,seed,shape,shiny,staman,sympodial,tertiary,texture,unarmed,venation
135	wfo-0001027310	exception_thrown	215	0	0	215	0	0.0		-2.2,-20,.8,/3,0,0-20,0-5,0.05,0.05-0.15,0.1,0.1-0.2,0.15-0.3,0.6-1,0.7-2,0.9-0.17,1-1.2,1-1.7,1-6,1.1-1.5,1.5-2.2,1.5-5,1/10-1/6,1/3-1/2,1/3-3/4,11-16,2-10,2-3.1,2-4,2-5,2.2-2.5,2.8-3,2/3,20-60,22-30,3-15,4-10,4-9,4.5-5.5,4.5-7,5-10,5-20,5-7,5-merous,6-8,7-10,8-10,9-13,abaxial,abaxially,acut,acute,adaxial,alyx,andromonoecious,anther,apar,apart,apex,apically,apparently,articulated,bark,base,berry,blade,branched,branching,broadly,calyx,chartaceous,cm,connivent,cuneate,curved,dark,deltate,densely,diameter,discolorous,distal,drying,eaf,eed,elongating,entire,equal,erect,evenly,faint,filament,flattened,flattened-reniform,flower,foliaceous,free,fruit,fruiting,fused,gently,glabrescent,glabrou,glabrous,glaucous,gray,green,green-brown,hair,hermaphrodite,heterostylous,inflated,infructescence,lanceolate,lateral,leaf,length,less,lobe,lobed,long,long-styled,longer,lower,lowermost,margin,mature,maturity,mauve,midpoint,minutely,mm,moderately,nflorescence,older,one,open,orange-brown,orolla,oung,pair,pale,pedicel,peduncle,pendulous,per,pericarp,petiole,pitted,plant,plurifoliat,poricidal,porrect,porrect-lepidote,portion,prickle,prickly,primary,pubescent,purple,ray,red,reddi,reflexed,rounded,ruit,scar,secondary,sessile,shallowly,short-styled,shorter,shrub,simple,smooth,sometimes,spaced,sparse,sparsely,spherical,spreading,stalk,stalked,staminat,stellate,stellate-pubescent,stem,stout,straight,strongly,style,surface,tamen,tapering,terete,terminal,tertiary,time,tip,toward,tree,trichome,truncate,tube,unarme,unarmed,unit,vary,vein,venation,visible,way,wide,woody,yellow,ympodial,young	
136	wfo-0001027317	success	144	121	89	55	32	0.618	.25,.5,0.3-1,0.4-1.5,0.5-1,1,1-1.5,1-2,1.4-1.6,2-3-flowered,3-3.5,4.5-5,7-9,?,abaxial,acuminate,acute,adaxially,along,anther,apex,apical,arch,base,beneath,berry,broadly,calyx,cm,conical,corolla,deflexed,deltoid,dia,difoliate,drying,elliptic,elongated,erect,filament,filiform,free,fruit,glabrous,globose,golden,green,immature,joined,known,lateral,leaf,like,lobe,long,long-exserted,main,major,margin,mature,minor,mm,offset,opposite,ovary,pair,pale,pedicel,petiole,portion,projection,prominent,pubescent,rest,series,shrub,simple,slightly,sparsely,stem,style,surface,tall,trichome,tube,uniseriate,vein,white,x	0.1-0.2,0.5-3,0.8-3.5,1-5,1.5-2,2-9,anthesi,apically,ba,bark,bilobed,closely,cucullate,deciduous,densely,differing,eaf,edicel,eed,ellipsoid,expanded,fruiting,geminat,greyish-whit,inflorescenc,lobed,lon,lower,minute,minutely,nearly,nflorescence,older,overlappin,papillo,papillose,pointed,pore,poricidal,reflexed,ruit,scar,shaped,size,soon,spaced,stigma,strongly,tear-drop,tip,tub,ud,woody,ympodia,young	adaxial,arrangement,branching,characteristic,colour,diameter,form,geminate,greyish-white,growth,height,history,inflorescence,length,life,mentioned,midvein,null,peduncle,plant,primary,pseudostipule,rachi,seed,shape,staman,sympodia,tertiary,texture,true,unarmed,venation
137	wfo-0001027323	exception_thrown	175	0	0	175	0	0.0		.75,/3,0.5-1,1-1.5,1-2,1.2-1.5,10-15,14-21,2-3,2-6,2.5-3,20-45,3-5,5-20-flowered,5-7,6-11,7-9,acute,adaxial,along,anther,anthesi,apex,apparent,appearing,area,arising,asymmetric,attenuate,ba,bark,base,berry,broadened,bud,calyx,campanulate,character,closed,closely,cm,cork,corolla,decurrent,deflexed,densely,dia,differing,difoliate,dried,dry,eaf,edicel,eed,elliptic,elongate,entire,erect,erose,exserted,filament,five-pointed,fleshy,flopping,flower,free,fruit,fruiting,furcate,geminat,glabrate,glabrous,globose,grey,growing,held,higher,hood,hooded,immature,interpetalar,lateral,leaf,like,live,lobe,lobed,lon,long,long-triangular-deltoid,lower,main,major,margin,matte,mature,measured,middle,minor,minutely,mm,nflorescence,occasionally,older,one,onto,opposite,ovary,overlapping,ovoid,ovoid-reniform,pair,papillae,papillo,papillose,partially,pedicel,persistent,petiole,pinkish-grey,pitted,planar,plant,pore,poricidal,portion,prominent,proximal,rather,red-papillose,reddish-grey,rest,ridge,ruit,scar,secondary,seen,shaped,sinus,size,slightly,small,smoot,soon,spaced,specimen,stem,stigma,straight,style,surface,tall,tan,tear-drop,thickened,thin,tiny,tip,treelet,trunk,tube,two,ud,unit,upper,vein,visible,way,white,widest,winged,woody,x,ympodial,young	
138	wfo-0001027340	success	189	141	108	81	33	0.571	0.5-0.9,1-10,1-2,10-16,16-22,2-3,2-4,3.5-5,4-7.5,5-11,5-6,6-8.5,7-8,8-14,8-9.5,abaxially,absent,acuminate,adaxially,anther,apart,apex,apparently,articulated,articulation,auriculate,axe,axillary,base,berry,brownish,bud,cell,cm,condition,cordate,corolla,covering,dark,diameter,distal,distinct,drying,elliptic,filament,flower,forked,fresh,fruit,generally,glabrous,globose,green,green-white,greenish,hair,half,herb,high,indistinct,lanceolate,lateral,leaflet,like,lilac-purple,lobe,long,make,margin,minute,mm,mucilaginous,odd-pinnate,ovate,ovoid,papillose,pedicel,peduncle,perfect,petiole,plant,plurifoliate,pubescent,purple,ripe,rounded,seed,shortly,slightly,spaced,sparsely,splotched,stem,style,subtending,terminal,testal,thick,throughout,tinged,tri-,truncate,unit,usually,wall,wet,whitish,x	1-3,1.5-2.7,2-3.5,2.5-4.5,2.7-4.5,3-4,3.5-9,4-6,5-merou,7-18,abruptly,acumen,ag,along,alyx,blade,capitat,chartaceous,ciliate,connivent,decreasing,developing,digestion,dorsally,eaf,edge,eed,enzyme,especially,exceeding,flat,folded,geminat,glabrou,hair-like,hal,homostylous,honeycomb-shaped,interjected,lengthening,living,lower,membranous,midrib,minutely,narrow,narrowed,nflorescence,orolla,pair,petiolulate,pointed,pore,poricidal,puberulent,purpl,removed,rotate,ruit,semi-erec,semi-rosette,sessile,seudostipule,short,size,slit,specimen,stamen,ste,stigma,straight,tall,tamen,tem,tip,tube,vary,wing,yellow,ympodial,young	'hair-like,abaxial,adaxial,arrangement,branching,calyx,characteristic,colour,form,geminate,growth,height,history,inflorescence,leaf,length,life,mentioned,midvein,ovary,primary,pseudostipule,rachi,shape,staman,surface,sympodial,tertiary,texture,true,unarmed,vein,venation
139	wfo-0001027354	success	166	171	144	22	27	0.867	.5,0,0.5,0.5-2,0.7-1.3,1,1-1.2,1-1.5,1-7,1.5-1.8,1.5-2,10,10-20,2.5-3.5,3-4,3.4-4,3/4,4-10,5-7,8-12,abaxial,abaxially,absent,acute,adaxial,age,along,anther,anthesi,apex,apical,appearing,bark,basal,base,becoming,berry,bi-lobed,blade,branch,branching,calyx,cm,conical,corolla,covered,dark,deltoid,dendritic,densely,denser,diameter,drying,elliptic,entire,erect,exserted,filament,flattened,flower,fork,free,fruit,fruiting,glabrate,glabrous,globose,golden,growth,inserted,later,lateral,leaf,length,lenticular,less,like,lobe,lobed,long,loose,loosely,minutely,mm,monochasial,mostly,narrowly,near,nodding,occasionally,older,ovary,pair,pedicel,per,pericarp,petiole,pitted,planar,plurifoliate,pore,poricidal,portion,pubescent,purplish-black,pyramidal,reddish-brown,secondary,shrub,side,simple,sleeve,slightly,slit-like,small,sparsely,stamen,stem,stigma,strongly,style,surface,tall,tapering,terminal,thecalyx,thin,time,tiny,tip,tree,tree-like,trichome,tube,unit,vein,violet,way,white,wide,winged,woody,x,young	1.7-5,6.5-13,ba,belo,dichasia,eaf,edicel,eed,ew,lower,m.,nflorescence,papillo,pubescen,raised,ruit,scar,somewhat,tub,type,ud,ympodial	arrangement,bud,characteristic,colour,dichasial,form,height,history,inflorescence,life,margin,midvein,null,papillose,peduncle,plant,primary,pseudostipule,rachi,seed,shape,staman,sympodial,tertiary,texture,unarmed,venation
140	wfo-0001027359	success	224	170	148	76	22	0.661	-0.25,-2,-20,-3,-7,.1,.5,0,0-2,0-3,0-9,0.1-0.2,0.1-1.5,0.3-1.2,0.5,0.5-2,0.6-1,1-1.2,1-2,1-3,1-4,1.2-1.5,1.8-3.2,1/5-1/4,2-4,2.5-3.5,3-10,4-,4-5,5-6.5,6-8,acute,anther,apex,apically,apparently,articulated,base,berry,branched,bright,calyx,cell,chartaceous,cm,concolorous,cream,cuneate,curved,dark,deltate,densely,diameter,difoliate,distinctive,drying,dull,elongate,entire,erect,eye,filament,filiform,flattened-reniform,flower,fruit,glabrescent,glabrous,green,infructescence,lateral,leaf,length,less,like,lobe,lobed,long,margin,marking,maturity,membranous,midpoint,minutely,mm,moderately,naked,near,obtuse,occasional,often,one,open,orange-brown,outline,ovate,pair,pale,pedicel,peduncle,per,petiole,pit,porrect,prickle,prickly,primary,purple,rachi,raised,rarely,ray,red,reticulate,scandent,shallowly,shorter,shrub,simple,slender,small,smooth,sometimes,sparsely,spherical,stalk,stalked,stellate,stellate-pubescent,stem,style,surface,terete,terminal,tertiary,time,tinge,trichome,unarmed,undulate,usually,vein,venation,visible,white,wide,yellow,young	-4,-9,.2,/3,/4,0-5,0.1,0.3-0.5,0.5-1,0.6-0.8,1-5,1.2-2,1.5-2,1.5-2.5,2-10,2-3,2.5-5.5,5-,5-merous,7-8,abaxially,acut,alyx,apar,apart,ba,bark,blade,brow,coroll,eaf,eed,elongating,equal,flattened,free,fruiting,geminat,gray,herbaceous,longer,lower,mature,narrow-deltate,narrow-ovate,nflorescence,older,orolla,oung,ovoid,perfec,pericarp,poricidal,portion,reflexed,ruit,scar,sessile,slightly,spaced,spreading,stump,tamen,tapering,tip,tube,ud,unarme,unit,variously,vary,way,weakly,woody,yellow-brown,ympodial	abaxial,adaxial,arrangement,branching,characteristic,colour,corolla,form,growth,height,history,inflorescence,life,midvein,null,ovary,plant,pseudostipule,seed,shape,staman,texture
141	wfo-0001027366	success	136	101	71	65	30	0.522	0.5-1,0.7-1,1-1.5,1-2,1-3,2-2.5,3-10-flowered,3-9,4-4.5,4-5,5-7,abaxially,acute,adaxially,anther,apex,axe,base,berry,bright,broadly,brown,calyx,cm,conspicuously,corolla,dark,deltate,drying,elliptic,except,filament,glabrous,globose,golden,green,greenish-white,internodal,lateral,leaf,lobe,long-triangular,main,margin,minutely,mm,opposite,orbicular,ovary,ovoid-reniform,pair,pale,papillose,parallel,pedicel,petiole,pitted,reddish,rounded,shining,shrub,simple,sometimes,somewhat,stem,style,surface,tip,trichome,vein,venation	.5,/2,/4,0.25-0.5,1.5-2,11-21,6-19,603,anthesi,ape,ba,bark,capitate,closely,conical,deflexed,dia,eaf,edicel,eed,erect,et,exserted,fide,free,fruiting,lamina,less,lobed,lon,long,lower,middle,nflorescence,older,overlappin,ovoid,packed,papillo,planar,pointed,pore,poridical,portion,ramo,ruit,scar,secondary,shaped,stigma,straight,tall,tear-drop,tub,tube,ud,unifoliat,unit,way,wide,widest,woody,yellowish-gre,ympodial,young	abaxial,adaxial,arrangement,branching,characteristic,colour,diameter,form,fruit,growth,height,history,inflorescence,length,life,midvein,null,peduncle,plant,primary,pseudostipule,rachi,seed,shape,staman,tertiary,texture,true,unarmed,yellowish-grey
142	wfo-0001027368	success	145	147	112	33	35	0.772	-10,-15,-2,-20,-5,.5,0.3-2.5,0.5-3.5,0.5-5,0.8-2,1-15-flower,1-2,1-6,1.5-2,1.5-2.5,2,2-2.5,2-9,3,3-12.5,4-6,5-15,5-6,abaxially,abruptly,acuminate,acute,adaxially,aggregate,also,apart,apex,articulated,axe,base,blade,branched,calyx,cell,chartaceous,cm,color,contiguous,cuneate,cylindrical,darker,decurrent,deltate,dendritically,densely,denser,diameter,distally,ellipsiodal,elliptic,elliptic-ovate,entire,forked,glabrous,gland,globose,hair,lanceolate,lenticular,lighter,lobe,long,long-stalked,margin,midvein,mm,moderately,narrowed,narrowly,nearly,obtuse,occasionally,often,otherwise,ovoid-fusiform,pedicel,peduncle,petiole,puberulent,pubescent,purple,rachi,radiu,ray,shrub,simple,small,sometimes,spaced,sparsely,stalked,star,stone,style,subcoriaceous,subhastate,terminal,three,time,tip,triangular,unbranched,unknown,vein,white,wide,x	2-3,2-4,4-many-foliat,5-10,8-13,absen,adaxiall,ba,connivent,directed,eaf,eed,except,lower,nflorescence,nther,oblong,orolla,pore,pubescen,ruit,stellate,stigma,subcapitat,tal,tem,truncate,tube,unit,usually,vary,yellow,ympodial	4-many-foliate,abaxial,absent,adaxial,anther,arrangement,branching,characteristic,colour,corolla,filament,form,fruit,growth,height,history,inflorescence,leaf,length,life,mentioned,ovary,plant,primary,pseudostipule,seed,shape,staman,stem,surface,tall,tertiary,texture,unarmed,venation
143	wfo-0001027369	success	191	169	143	48	26	0.749	-1,-10,-11,-2,.1,.5,.7,0,0-1,0-3,0-5,0.1,0.1-0.3,0.2-0.5,0.25-0.4,0.3-1.5,0.5,0.5-0.8,0.5-1.5,0.6-0.8,1-,1-2,1-2.5,1-3,1-4,1.2-2.5,1.2-3,1.5-2,1/3,2-4,2-5,3,3-4,4-8,5,7-15,almost,ame,anther,apart,apex,apically,apparently,articulated,base,berry,blade,branched,broad-deltate,c.,calyx,cm,color,concolorous,cordate,curved,densely,diameter,difoliate,distance,drying,equal,erect,extending,eye,filament,filiform,flower,free,fruit,glabrous,glaucous,green,hair,infructescence,known,lanceolate,lateral,leaf,length,less,lobe,lobed,long,margin,mauve,membranous,midpoint,midvein,mm,moderately,multangulate,naked,narrowly,one,open,orbicular,pale,pedicel,peduncle,per,pericarp,perpendicular,petiole,porrect,portion,prickle,prickly,ray,reflexed,reniform,rounded,scandent,sessile,shrub,side,simple,slender,slightly,smooth,spaced,sparsely,spherical,stalk,stalked,stellate-pubescent,stem,straight,strongly,style,surface,terete,terminal,time,trichome,tube,unarmed,venation,visible,wide,wider,winged,yellow	.4,/4,0-15,0-6,0.05-0.15,0.1-0.2,2-3,3-10,4-5,5-merous,abaxially,acut,alyx,apar,bark,deltate,eaf,eed,elongating,fruiting,geminat,glabrou,gra,herbaceous,know,lon,lower,mature,nflorescence,older,orolla,oung,pendulous,perfec,poricidal,prickl,ruit,scar,spreading,stellate,tamen,tapering,tip,unequal,unit,vary,way,ympodial	abaxial,acute,adaxial,arrangement,branching,characteristic,colour,corolla,form,growth,height,history,inflorescence,life,null,ovary,plant,primary,pseudostipule,rachi,seed,shape,staman,tertiary,texture,vein
144	wfo-0001027378	success	149	138	89	60	49	0.597	.2,0.5â1,5-8,5â10,abaxially,acuminate,acute,adaxial,adaxially,anther,apex,axe,base,berry,blade,blue,broadly,calyx,clavate,cm,color,cordate,cylindrical,deeply,densely,diameter,extra-axillary,filament,flattened,flower,fruit,glabrous,hair,hair-tipped,half,herbaceous,lanceolate,leaf,light,lobe,long,longer,lower,margin,markedly,minutely,mm,moderately,obscure,often,ovate,ovoid,palmate,papillose,pedicel,peduncle,petiole,pointed,primary,pubescent,rachi,revolute,rounded,sand-punctate,scattered,short,simple,slender,slightly,small,somewhat,spaced,sparsely,stem,style,terrestrial,tip,tooth,trichome,unbranched,unit,unknown,vein,venation,vine,white,wide,widely,x	0.7â1,0.8â2.5,1.2â1.5,1.2â1.8,1.5â1.8,1.5â8,15â35,1â1.5,1â3,2.3â5,2.5â7,2â11,2â2.2,2â2.5,3â4.5,3â5,3â6,4â6,4â9,5-merous,5â13,5â7,6â10,6â7,alyx,apar,apicall,c.,capitat,chartaceous,ciliate,climbin,deltoid,eaf,eed,fleshy,fruiting,glabrou,like,lon,m.,membranous,narrowly,nflorescence,nternode,orolla,pentagonal,perfec,plurifoliat,rotate-stellate,ruit,sand-punctat,side,stigma,tamen,tem,tube,unknow,vary,ympodial	0.7-1,0.8-2.5,1-3,1.2-1.5,1.2-1.8,1.5-1.8,1.5-8,15-35,2-11,2-2.2,2-2.5,2.5-7,3-4.5,3-5,3-6,4-6,5-13,5-7,6-10,abaxial,apart,arrangement,branching,characteristic,climbing,colour,corolla,form,growth,height,history,inflorescence,internode,length,life,midvein,ovary,plant,plurifoliate,pseudostipule,seed,shape,specified,staman,surface,sympodial,tertiary,texture,unarmed
145	wfo-0001027378	success	141	129	98	43	31	0.695	.2,0.7-1,0.8-2.5,1-1.5,1-3,1.2-1.5,1.5-1.8,1.5-8,15-35,2-11,2-2.2,2-4,2.5-7,3-4.5,3-5,3-6,4-6,5-13,5-8,6-10,abaxially,acuminate,acute,adaxially,anther,apart,apex,apparently,articulated,axe,base,blade,blue,broadly,calyx,clavate,climbing,cm,cordate,cylindrical,deeply,densely,diameter,extra-axillary,filament,flower,fruit,glabrous,hair,hair-tipped,herb,lanceolate,leaf,light,lobe,long,longer,margin,minutely,mm,moderately,multicellular,node,obscure,often,ovate,pedicel,peduncle,petiole,plurifoliate,pubescent,rachi,revolute,rooting,rounded,scattered,short,simple,slender,slightly,small,somewhat,spaced,sparsely,style,terrestrial,tip,tooth,trailing,tube,unbranched,unit,unknown,vein,white,wide,widely,x	2.3-5,4-9,5-merou,6-7,ag,alyx,apicall,ba,basally,capitat,chartaceous,ciliate,connivent,deltoid,directed,distally,eaf,eed,equal,fleshy,fruiting,geminat,large,longitudinal,lower,narrowly,nflorescence,oblong,opening,orolla,perfect,pore,pubescen,rotate-pentagonal,slit,stigma,tamen,tem,unknow,vary,weakly,yellow,ympodial	abaxial,adaxial,arrangement,branching,characteristic,colour,corolla,form,geminate,growth,height,history,inflorescence,length,life,midvein,null,ovary,plant,primary,pseudostipule,seed,shape,staman,stem,surface,sympodial,tertiary,texture,unarmed,venation
146	wfo-0001027384	success	155	136	106	49	30	0.684	.5,0.4-1.1,0.5-1,0.9-1,1-1.3,1-1.5,1-3,1-4,1.5-2,3-3.5,3-4,4-7,5-15-flowered,5-5.5,7.5-8,acute,anther,apex,base,beneath,berry,breaking,broadly,brown,calyx,capitate,clavate,cm,corolla,cuneate,deep,dia,difoliate,distal,drying,erect,filament,flattened-reniform,free,fruiting,geminate,glabrous,globose,green,hard,herbarium,incrassate,lateral,leaf,lobe,long,main,margin,middle,minutely,mm,mustard,narrowly,obovate,occasionally,opposite,ovary,pair,pale,paler,papillose,pedicel,peeling,petiole,pitted,portion,prominent,pseudo-terminal,rarely,reddish-purple,rounded,section,shining,shrub,simple,slender,small,specimen,stem,straight,style,sulcate,surface,tapering,tip,transverse,tree,triangular,trichome,tube,tuft,uniseriate,unit,vein,white,widest,without,woody,x,yellow,yellowish	.25,.75,/3,2.5-6.5,3/4,7-14,abov,anothe,anthesi,apart,ba,bark,beginning,bud,closely,eaf,edicel,eed,ellipsoid,equal,inflorescenc,later,lobed,long-exserted,lower,member,nflorescence,older,overlapping,papillo,planar,pore,poricidal,ruit,scar,shaped,siz,spaced,stigma,subcoriaceous-fleshy,tall,tear-drop,thick,tub,ud,way,widely,ympodial,young	abaxial,adaxial,arrangement,branching,characteristic,colour,diameter,form,fruit,growth,height,history,inflorescence,length,life,midvein,null,peduncle,plant,primary,pseudostipule,rachi,seed,shape,staman,sympodial,tertiary,texture,unarmed,venation
147	wfo-0001027389	success	154	103	71	83	32	0.461	.5,0.25-0.3,0.25-0.5,0.5-1.5,0.6-1,1,1-1.5,3-3.5,5-7,7-8,acuminate,acute,along,anther,apex,base,beneath,berry,brown,calyx,cm,corolla,dark,decurrent,deltoid,dry,elliptic,erect,filament,glabrous,globose,green,hispidulous,inflorescence,lateral,leaf,lobe,main,margin,material,minutely,mm,occasionally,opposite,ovary,ovate,ovoid-reniform,pair,papillose,pedicel,petiole,pitted,prominently,puberulent,raised,reddish-golden,shrub,simple,sparsely,stem,style,surface,thread-like,trichome,truncate,uniseriate,unit,vein,white,winged,x	.1,.25,0.5-0.75,1-2,1.8-1.9,11-14,2-2.5,3-4.5,4-5-flowered,anthesi,apart,ba,bark,broadening,broadly,bud,conical,deflexed,dia,eaf,edicel,eed,ellipsoid,evenly,except,expanded,exserted,filiform,foetid,foliage,free,fruiting,geminate,like,lobed,lon,long,lower,making,middle,nearly,nflorescence,node,non-reproductive,obovoi,often,older,one,paler,papillo,pore,poricidal,portion,prominent,proximal,raise,reflexed,rest,ruit,scar,shaped,shin,side,slender,slight,slightly,soon,spaced,stigma,straight,tall,tapering,tear-drop,tip,top,tube,ud,unifoliat,widest,woody,yellowish,ympodial,young	abaxial,adaxial,arrangement,branching,characteristic,colour,diameter,form,fruit,growth,height,history,length,life,midvein,null,peduncle,plant,primary,pseudostipule,rachi,seed,shape,shiny,staman,sympodial,tertiary,texture,true,unarmed,unifoliate,venation
148	wfo-0001027395	success	153	126	95	58	31	0.621	.25,.5,0.25-0.5,0.6-1.1,0.75-1,1-1.5,1-2,1-5,1.1-1.5,1.5-1.9,1.5-2.5,10-20-flowered,2-3,3.5-4,8,acute,anther,apex,apiculate,attenuate,base,becoming,beneath,berry,calyx,cm,corolla,decurrent,deflexed,deltoid,densely,depressed,dia,difoliate,enlarging,exfoliating,filament,fleshy,free,fruit,fruiting,glabrous,globose,green,immature,imperceptibly,known,leaf,lobe,long,major,margin,midrib,minor,minutely,mm,narrowly,obovate,occasionally,older,once-furcate,opposite,ovary,papillose,pedicel,petiole,piece,portion,primary,pubescent,raised,restricted,robust,secondary,shining,shrub,simple,small,somewhat,stem,straight,style,tapering,thickened,transverse,trichome,tube,uniseriate,unit,vein,white,within,without,woody,x	1.6-2.9,11-15,12.5-17.3,2.2-7,4-6,5-6.5,anthesi,apically,bark,beginning,black,caly,capitate,closely,conical,constricted,cucullate,differing,drying,eaf,edicel,eed,erect,exserted,geminat,inflorescenc,large,lateral,lobed,lon,lower,main,nearly,nflorescence,overlapping,ovoid,pair,papillo,partially,planar,pointed,pore,poricidal,ruit,rusty-papillate,scar,shaped,shiny,size,spaced,stigma,tall,tear-drop,thick,tip,ud,ympodial,young	abaxial,adaxial,arrangement,branching,characteristic,colour,diameter,form,geminate,growth,height,history,inflorescence,length,life,midvein,null,peduncle,plant,pseudostipule,rachi,seed,shape,staman,surface,sympodial,tertiary,texture,true,unarmed,venation
149	wfo-0001027396	exception_thrown	244	0	0	244	0	0.0		-2,-5,-6,/3,0-100,0-3,0-30,0-4,0-5,0.1-0.5,0.1-1,0.4-0.7,0.5-1,0.5-1.5,0.5-2,0.5-2.5,0.7-2.5,0.8,0.8-1.3,1,1-4,1.2-2,1.5-3,1.5-3.5,1.8-3,1/2-2/3,1/3,1/4-1/3,1/6,10-15,10-25,10-30,10-35,12-25,15-40,2-3,2-3.5,2-7,2.5-4,2.8-4.5,20-100,3-,3-9,3.5-6,4,4-5,4-6,4-7,5-10,5-20,5-30,5-50,5-8,5-merous,5.5-7.5,6-20,6.5-7.5,7-10,7-15,8-20,abaxial,abaxially,acute,adaxial,almost,alyx,ame,andromonoecious,anther,apar,apart,apex,apically,apparently,articulated,attenuate,ba,bark,base,berry,black,blade,broad,broad-deltate,brown,bulbous,c.,calyx,chartaceous,cm,concolorous,connivent,cream,cuneate,curved,dark,decurrent,deltate,densely,diameter,difoliate,discolorous,distal,distance,drying,eaf,eed,elliptic,elongate,elongating,equal,erect,extending,extensive,fewer,filament,flattened,flattened-reniform,flower,free,fruit,fruiting,fully,geminat,glabrescent,glabrous,glandular,gray-brow,green,hair,herb,hermaphrodite,heterostylous,infructescence,lateral,leaf,length,less,lignified,lobe,lobed,lobing,lon,long,long-acuminat,long-styled,longer,lower,lowermost,margin,marking,mature,maturity,mauve,midpoint,midvein,mm,moderately,near,nflorescence,obtuse,often,older,one,open,opening,orange,orolla,oung,pair,pale,pedicel,peduncle,pendulous,per,pericarp,perpendicular,petiole,plant,poricidal,porrect,portion,prickl,prickle,prickly,primary,pubescent,purple,ray,red-brown,reflexed,rotate,ruit,scar,secondary,sessile,short-styled,shrub,side,simple,smooth,sometimes,somewhat,spaced,sparsely,spherical,spreading,stalk,stalked,staminat,stellate-pubescent,stem,stout,straight,style,surface,tamen,tapering,tearing,terete,tertiary,time,tip,trichome,tube,unarmed,unbranched,unit,upper,usually,variously,vary,vein,venation,visible,way,white,wide,woody,yellow,yellow-green,yellowish,ympodial,young	
150	wfo-0001027449	success	160	137	106	54	31	0.662	.4,.5,.75,0.5-1,0.5-1.5,0.8-1.5,0.9-1.1,1.4-1.5,10-15-flowered,2-4,3,3-3.5,4-6,5-6,acuminate,acute,anther,anthesi,apex,area,axil,bark,base,beginning,beneath,berry,brown,calyx,closely,cm,corolla,dark,deflexed,dense,densely,density,dia,difoliate,dry,elliptic,extreme,filament,free,fruit,glabrate,glabrous,globose,green,inflorescence,lateral,leaf,like,lobe,long,long-triangular,main,major,material,minor,minutely,mm,narrowly,oblique,often,older,opposite,orangish,ovary,overlapping,ovoid-reniform,packed,pair,pale,papillose,pedicel,petiole,pitted,portion,prominent,pubescent,raised,red-papillose,rest,scar,shrub,simple,slender,small,sparse,sparsely,stem,style,surface,tapering,tip,tree,trichome,trunk,tube,tuft,uniseriate,unit,varying,vein,white,x	/3,1.2-1.5,1.5-2.5,2-3,3-7,8-15,appearing,arising,around,becoming,bud,cup,deciduous,differing,eaf,edicel,eed,ellipsoid,erect,exserted,forming,frui,fruiting,geminat,inflorescenc,lamina,later,lobed,lon,long-acuminate,lower,nflorescence,obconic,one,persistent,pointed,pore,poricidal,reddish-brow,reflexed,ruit,shaped,size,soon,stigma,straight,styl,tall,tear-drop,ud,way,woody,ympodial,young	abaxial,adaxial,arrangement,branching,characteristic,colour,diameter,form,geminate,growth,height,history,length,life,margin,midvein,null,peduncle,plant,primary,pseudostipule,rachi,reddish-brown,seed,shape,staman,sympodial,tertiary,texture,unarmed,venation
151	wfo-0001027452	success	152	130	99	53	31	0.651	.5,0.5-1,0.5-1.5,0.5-2,1,1-2,1-3,1-5,1.5,1.5-3,10-20,2-6,2-foliate,3-9,4,4-6,5-12,5-20,abaxially,absent,acute,adaxially,anther,apex,axe,base,berry,branched,brown,calyx,cell,celled,center,ciliate,cm,connected,decurrent,densely,diameter,dm,drying,elliptic,elliptic-ovoid,entire,filament,flower,fruit,glabrous,globose,hair,herb,immature,large,linear-lanceolate,lobe,margin,maturing,mm,moderately,nearly,notched,obtuse,often,one-,outer,parallel,pedicel,peduncle,per,perpendicular,petiole,placenta,pubescent,rachi,raised,ridge,rounded,running,seed,semitransparent,significantly,single,slightly,smaller,smoother,sometimes,sparsely,straight,style,swollen,two-celled,unbranched,usually,vein,wall,white,woody,x,yellow	0.5-2.5,1-4.5,2-4,3-6,abundant,adaxiall,along,beyond,blade,chartaceous,cordate,dehiscing,denser,eaf,eed,emarginat,equal,explosively,exserted,flat,frui,geminat,growt,held,interpetalar,long,lower,lying,maturit,membranaceous,mesocarp,new,nfloresence,oblong,orolla,pressure,pubescen,rotate,ruit,short,stamen,stigma,tal,tamen,tem,tissue,triangular,tube,unit,vary,watery,wid,ympodial	abaxial,adaxial,arrangement,branching,characteristic,colour,corolla,form,geminate,growth,height,history,inflorescence,leaf,length,life,mentioned,midvein,ovary,plant,primary,pseudostipule,shape,staman,stem,surface,tall,tertiary,texture,unarmed,venation
152	wfo-0001027471	success	165	142	118	47	24	0.715	.5,0.1-0.2,0.2-0.4,0.2-0.5,0.4-1,0.5,0.5-0.6,0.5-1.5,0.9-1,1-1.2,1-1.5,1-1.6,1.4-3,1.5-2,2-2.5,2-3,2-lobed,3-4,3-7,4-5,6-7,abaxially,acute,adaxially,anther,anthesi,apex,base,berry,bifid,branched,brittle,calyx,cm,conical,corolla,dendritic,densely,diameter,difoliate,distant,drying,elliptic,entire,erect,filament,flattened,flower,free,furcate-dendritic,geminate,glabrous,globose,growth,herb,inflorescence,internodal,lamina,leaf,leaf-opposed,less,like,lobe,long-triangular,major,margin,maturity,midvein,minor,minutely,mixture,mm,nodding,node,occasionally,open-conical,orbicular,ovary,ovate,pair,pale,pedicel,peduncle,pericarp,petiole,pitted,portion,primary,pubescent,rachi,red-orange,reniform,shape,shrub,similar,simple,slender,small,somewhat,sparsely,stem,stigma,straight,style,subshrub,surface,tan,thickened,thin,trichome,tube,uniseriate,unit,usually,vein,white,x,yellowish	/4,0.5-0.7,0.7-0.9,age,along,appressed,ascending,bark,c.,closely,deltate,desnsely,differing,eaf,eed,erec,especially,fruiting,included,lengthening,lobed,lower,new,nflorescence,overlapping,papillat,perfect,petal,planar,plane,pore,poridical,pubscent,reflexed,ruit,scar,scattered,size,slightly,slit,spaced,tip,trifoliat,ud,way,woody,ympodial	abaxial,adaxial,arrangement,branching,characteristic,colour,form,fruit,height,history,length,life,null,papillate,plant,pseudostipule,seed,staman,sympodial,tertiary,texture,trifoliate,unarmed,venation
153	wfo-0001027473	success	138	118	87	51	31	0.63	.25,0.25-0.5,0.5-1,0.8-1,1-1.5,1-2,1.3-2,1.5-2,2.5-3,3.5-5,5,6-9,?,abaxially,acute,adaxially,along,anther,apex,bark,base,berry,brown,calyx,cm,corolla,decurrent,deep,dendritic,densely,denser,di-,drying,filament,flattened-reniform,free,glabrous,globose,green,incrassate,later,lateral,leaf,like,lobe,long,long-triangular,main,margin,minute,minutely,mm,near,obovate,occasionally,older,ovary,pair,pale,pedicel,petiole,pitted,pointed,portion,pubescent,rusty,sessile,shape,shrub,somewhat,sparsely,stem,strongly,style,subshrub,surface,thick,trichome,trifoliate,tube,usually,vein,white,wing,winged,yellowish,young	/2,1.8-2,1/3,2-2.5,4.5-13,8.5-37,absen,anthesi,ape,apparently,clavate,conical,deccurent,deflexed,dia,differing,eaf,eed,empty,erect,fruiting,geminat,giving,less,lobed,lower,major,middle,minor,overall,papillo,planar,pore,poricidal,pubesent,rootstock,ruit,sac,shaped,sterile,stigma,tall,tear-drop,tip,unit,way,wide,widest,woody,yellowish-brow,ympodial	abaxial,absent,adaxial,arrangement,branching,characteristic,colour,diameter,form,fruit,geminate,growth,height,history,inflorescence,length,life,mentioned,midvein,peduncle,plant,primary,pseudostipule,rachi,seed,staman,tertiary,texture,unarmed,venation,yellowish-brown
154	wfo-0001027483	success	164	144	110	54	34	0.671	0.2-1.9,0.6,1,1-2.5,1-4,1-5,1.5-2.6,1.5-3,2,2-3,2-4.5,3-15,3-6,4.5-8,5-10,5-6,abaxially,acumen,acute,adaxially,apex,articulate,base,branched,calyx,cell,cm,coarsely,corolla,covering,cuneate,cyme,decurrent,diameter,dichasial,dichasially,digestion,distal,dot,ebracteate,elliptical,emoval,enzyme,exceeding,filament,finely,flower,forked,generally,globose,green,green-white,hair-like,half,herbaceous,honeycomb,interpetiolar,lateral,leaf,light,lighter,living,lobe,long,make,medium,minute,mm,monochasial,mucilaginous,obtuse,odd-pinnate,ovate,ovoid,pattern,pedicel,peduncle,perennial,perfect,petiole,petiolule,plant,proximal,pubescent,purple,rachi,ray,reveal,rounded,seed,smooth,sometimes,specimen,stamen,stigma,straight,style,subsessile,testal,thick,throughout,tuber-bearing,typically,uniform,unit,violet,violet-purple,wall,white,Â¼	0-1.,1-2,1.2-2.5,1.5-10,2-4,3-6-foliat,3.5-20,apical,apically,basal,connate,dehiscent,diminishing,dorsally,eaf,edge,eed,erec,flat,folded,globo,gradually,interjected,introrse,leaflet,lon,lower,lunat,maturing,nflorescence,nther,often,orolla,pair,plan,poricidally,rosette,rotate,ruit,sessile,seudostipule,short,size,slit,tall,tem,terminal,tissu,toward,vary,varying,wide,yellow,ympodial	3-6-foliate,abaxial,adaxial,anther,arrangement,branching,characteristic,colour,form,fruit,growth,height,history,inflorescence,length,life,lunate,margin,mentioned,midvein,ovary,primary,pseudostipule,shape,staman,stem,surface,sympodial,tertiary,texture,tissue,unarmed,vein,venation
155	wfo-0001027506	success	215	140	117	98	23	0.544	-1,.2,.5,0,0-10,0-2,0-60,0.5-1.5,0.5-6,0.7-1.3,1-2,1-3,1.2-1.5,1.8,1/3,1/6-1/4,2-3.2,2.2-3.5,3-10,3-5,3.5-5,5-7,6.5-10,acuminate,acute,anther,apex,apparently,articulated,base,becoming,berry,blade,branched,calyx,cell,cm,cordate,cream,cuneate,curved,dark,densely,diameter,dry,entire,erect,filament,fine,flattened-reniform,flower,fruit,glabrous,green,hard,infructescence,lateral,leaf,length,lobe,long,long-styled,margin,marking,maturity,mauve,mm,moderately,narrow-deltate,occasionally,one,open,orange-brown,outline,ovate,pair,pale,pedicel,peduncle,per,pericarp,petiole,pit,plant,prickle,prickly,primary,purple,raised,shrub,small,smooth,sometimes,spherical,stellate-pubescent,stem,stout,style,subentire,surface,terete,terminal,tertiary,time,tree,truncate,twice,unarmed,upper,vein,venation,visible,wide,woody,yellow,yellow-green,young	-0.35,-20,-3,-7,-7.5,/2,/6,0-6,0.1-,0.1-0.3,0.2,0.2-0.3,0.25,0.8-1.5,1-4,1.5-2.2,10-40,2.5-5,2.5-8,3-6,5-10,5-merous,6-13,7-8,7-9,8-10,9-13,abaxially,acuminat,alyx,ame,andromonoecious,apar,apart,apically,bark,brow,brown,c.,chartaceous,concolorous,connivent,distal,drying,eaf,eed,elongating,equal,flattened,free,fruiting,glabrescent,hermaphrodite,heterostylous,lengt,lobed,longer,lower,lowermost,mature,midpoint,multangulate,nflorescence,older,orange,orolla,oung,pendulous,plurifoliat,poricidal,porrect,portion,prickl,ray,reddish,reduced,reflexed,ruit,scar,sessile,short-styled,simple,spaced,spreading,stalk,stalked,staminat,stellate,tamen,tapering,tip,trichome,tube,unit,variously,vary,way,ympodial	abaxial,adaxial,arrangement,branching,characteristic,colour,corolla,form,growth,height,history,inflorescence,life,mentioned,midvein,ovary,plurifoliate,pseudostipule,rachi,seed,shape,staman,texture
156	wfo-0001027548	success	216	177	147	69	30	0.681	-11.5,.3,0.3-1.2,0.5,0.5-2,1,1-1.5,1-2.5,1-3.5,1.2,1.5,1.5-2.5,10-12,10-50,3-7,4-8,4.5,6-9,8-9,acuminate,acute,adaxially,almost,along,also,anther,anthesi,apex,appearing,area,articulated,attenuate,axi,basal,base,beneath,berry,black,branch,branched,branching,brown,calyx,cell,cm,conical,corolla,dark,darker,deltate,dendritic,densely,denser,depressed-elliptic,diameter,drying,dull,elliptic,elongate,entire,filament,flattened-reniform,flexuous,flower,glabrous,glandular,globose,green,growth,half,herbarium,immature,inflorescence,lamina,leaf,leaving,like,lilac,lobe,long,loose,loosely,lower,many,margin,matte,minutely,mixed,mm,narrowly,near,new,occasionally,outline,pair,papillae,pedicel,peduncle,per,pericarp,petiole,pitted,plurifoliate,primary,prominent,puberulent,pubescent,rachi,rectangular,reddish,revolute,ripe,scar,scattered,simple,size,slender,small,somewhat,sparse,sparsely,specimen,spreading,stem,style,surface,swollen,terminal,testal,thickened,thin,time,tinged,tiny,transparent,trichome,tube,uniseriate,unit,upper,usually,vein,vine,warty,white,woody,x	0.2,1-10,1.5-2,4-6,5-merou,7-10,abaxiall,ag,although,alyx,apart,apical,apparently,ark,articulation,bent,bu,c.,capitate,connivent,deflexe,eaf,early,eed,ellipsoid,em,exserted,extending,free,fruiting,geminat,glabrescen,ilament,irregularly,lengthening,less,lobed,lon,long-styled,membranous,minute,nflorescence,older,orolla,pale,papillate,papillo,perfect,planar,point,pore,poricidal,portion,ruit,slit,sometimes,spaced,stellate,stigma,strongly,tapering,tip,twinin,type,ud,vary,way,yellow,ympodial	2,5,8,abaxial,adaxial,arrangement,characteristic,colour,form,fruit,geminate,height,history,length,life,midvein,null,ovary,plant,pseudostipule,seed,shape,staman,sympodial,tertiary,texture,true,twining,unarmed,venation
157	wfo-0001027581	success	200	151	111	89	40	0.555	0.3,1,1.5,100+,200,>,abaxial,abaxially,acute,adaxial,along,anther,anthesi,apex,articulated,axe,base,beneath,berry,branched,branching,broadly,brown,calyx,cm,corolla,dark,deltate,densely,diameter,distally,drying,echinoid,elliptic,entire,evenly,filament,flattened-reniform,flower,glabrescent,globose,golden,green,greyish,growth,inflorescence,largest,leaf,length,like,lobe,long,longest,lower,many,margin,minutely,mixed,mm,moderately,multangulate,multiseriate,new,nodding,older,pair,part,pedicel,peduncle,per,pericarp,petiole,pitted,plane,porrect-stellate,primary,pubescent,purple,ray,reddish,rhachi,ripe,sessile,shiny,short-stalked,shrub,simple,size,small,smaller,sparsely,stalk,stellate,stem,stout,style,surface,terminal,thin,time,tree,trichome,undersurface,unevenly,upper,varying,vein,visible,weak,wide,yellowish	0.2â0.3,0.3â1,0.5â1,0.5â1.5,1.2â1.5,1.3â1.5,1.5â2,1.5â3,10,10â16,12,12â30,15â20,1â1.5,1â3-rayed,2.5â3,3.5â4.5,3â3.5,4.5â16,4â8,5-merou,6â7,7â10,7â9,8,8â10,9â11,9â9.5,ag,alyx,apar,ark,brow,bulbous,c.,clavate,clearly,closely,connivent,cup-shaped,dichasia,discolorous,eaf,eed,ellipsoidal,erec,exserted,free,fruiting,glabrous,gradually,ilament,lamina,lengthening,less,lobed,loosely,midvei,minute,narrowing,near,nflorescence,orolla,papillo,perfect,plurifoliate,pore,poricidal,portion,reflexed,ruit,scar,scarcely,slit,spaced,spreading,stigma,tall,tem,tip,tube,ud,unit,vary,way,whit,woody,yellow,ympodial	0.18,0.5-1,0.5-1.5,1-1.5,1-3-rayed,1.3-1.5,1.5-2,1.5-3,15-20,2.5-3,3-3.5,4-8,7-10,7-9,8-10,9-11,9-9.5,arrangement,characteristic,colour,form,fruit,height,history,life,midvein,null,ovary,plant,pseudostipule,rachi,seed,shape,staman,tertiary,texture,true,unarmed,venation,white
158	wfo-0001027584	success	144	138	108	36	30	0.75	-16,-2,..,0.5-1,0.5-1.5,0.9-1,0.9-2.5,1-1.2,1.5-2,1.5-8,1.6-1.9,10-15,100,2,2-10,2.5-3,3,3-.,4-6,4-7,7-10,abruptly,acuminate,anther,apex,apical,attenuate,base,beginning,beneath,branch,branched,brittle,broadly,calyx,cell,cm,conical,corolla,darker,deltate,densely,diameter,dry,ellipsoid,elliptic,filament,flattened,flower,four,fruit,glabrous,green,herb,irregular,lamina,lobe,long,margin,minutely,mm,open,outer,outline,ovary,ovate,pair,pale,papillate,pedicel,peduncle,per,pericarp,petiole,present,primary,reddish,regularly,reniform,scar,scattered,shrub,single,sinuate,small,smooth,sparse,sparsely,stem,stigma,striate,stripe,style,suffruticose,surface,tan,testal,thickening,thin,time,trichome,tuft,uniseriate,vein,wall,white,without,x	.5,1.2-1.4,11.5-45,4.5-20,8-9,absent,anthesi,bark,becoming,brow,c.,capitat,cucullate,deflexe,eaf,edicel,eed,erec,fruiting,lobed,lower,markedly,narrowly,nearly,nflorescence,planar,plurifoliat,pointed,ruit,single-stemmed,tip,triangular,tube,ud,unit,ympdoial	abaxial,adaxial,arrangement,branching,brown,capitate,characteristic,colour,deflexed,fork,form,growth,height,history,inflorescence,leaf,length,life,midvein,null,plant,pseudostipule,rachi,seed,shape,staman,tertiary,texture,unarmed,venation
159	wfo-0001027600	success	185	150	118	67	32	0.638	-10,0.5-1.5,1,1-14,1-2,1-4,1-5,1.5-2,10-,10-20,15-25,2-11,2-3,2-3.5,2-4,2-4.5,2-5,2-6,20-30,3-15,3-5,3-5-lobed,3-6,abaxially,absent,acuminate,acute,adaxial,adaxially,aggregate,along,apart,apex,articulated,axe,basal,base,beyond,calyx,cell,cm,collection,cordate,cuneate,deltate,densely,diameter,dilated,distally,ellipsoidal,entire,especially,except,exserted,fading,flattened,fleshy,flower,forked,fruit,glabrescent,glabrous,greenish-white,leaf,leaving,lobe,lobed,long,main,margin,mature,midrib,minutely,mm,moderately,obconical,obtuse,occasionally,older,orange,pedicel,pedicellar,peduncle,perfect,petiole,pilose,pinnately,puberulence,puberulent,pubescent,purple,rachi,radiu,rarely,remnant,rounded,simple,slightly,small,somewhat,spaced,sparsely,stamen,stone,strongly,style,surface,tip,tree,truncate,unbranched,unit,unlobed,vein,x,yellow,yellow-green,young	-3,0.5-1,1.5-2.5,1/2-3/4,2-18,2.5-21,2.5-6,4-6,4-foliat,5-13,8-17,abruptly,absen,adpressed,ape,apical,apiculate,blade,brow,campanulate,channe,concave,connective,coriaceous,cream,directed,divided,eaf,eed,elliptic,exceeding,gland,glandular-puberulent,laterally,lon,lower,narrowed,nflorescence,nther,oblong,orolla,ovate,ovoid,papillose,pilo,pore,puberulen,purplish,ruit,shorter,sinus,stigma,subcoriaceous,tal,tem,thecae,time,tomento,triangular,tube,two,ud,vary,white,wide,yellowish,ympodial	4-foliate,abaxial,anther,arrangement,branching,channel,characteristic,colour,corolla,filament,form,growth,height,history,inflorescence,length,life,mentioned,midvein,ovary,plant,primary,pseudostipule,seed,shape,staman,stem,sympodial,tertiary,texture,unarmed,venation
160	wfo-0001027607	success	167	126	97	70	29	0.581	.25,.5,0.25-0.5,0.5,0.5-1,0.8-1,1,1-4,2-2.5,2-3,2-4,2.5-3,3-3.5,3/4,4-10-flowered,5-7,8-9,acuminate,acute,anther,apex,arching,area,basal,base,berry,brown,calyx,cm,corolla,dark,decurrent,deltoid,dia,dry,elliptic,f,filament,filiform,flattened,free,gently,glabrate,glabrous,globose,green,lateral,leaf,less,like,lobe,lobed,long,main,material,minutely,mm,narrow,narrowly,occasionally,opposite,ovary,ovoid-reniform,pair,papillose,pedicel,petiole,pitted,plant,portion,prominent,pubescent,raised,reddish-brown,short,shrub,simple,slender,small,stem,style,surface,tall,tan,tapering,tip,treelet,trichome,tube,uniseriate,vein,way,white,widened,winged,x,yellowish	.1,1.2-1.5,1.5-3,5-10,age,anthesi,apar,aspect,ba,bark,becoming,branch,branche,corky,curling,deflexed,densely,eaf,edicel,eed,ellipsoid,elongate,erect,evenly,except,exserted,fruiting,geminate,giving,golden,lamina,lenticellat,lon,lower,m.,middle,midrib,minute,nflorescence,non-reproductive,obovoid,older,pagoda-like,pore,poricidal,present,rarely,reflexed,ruit,scar,shaped,slight,slightly,soon,spaced,stigma,straight,strongly,styl,tear-drop,tub,ud,unifoliate,unit,widening,widest,woody,ympodial,young,zig-zag	abaxial,adaxial,arrangement,branching,characteristic,colour,diameter,form,fruit,growth,height,history,inflorescence,length,life,margin,midvein,null,peduncle,primary,pseudostipule,rachi,seed,shape,staman,tertiary,texture,unarmed,venation
161	wfo-0001027618	success	202	136	103	99	33	0.51	-pubescent,1,1-,1-13,1-14,1-23,1-5,1-9,1.4-4,15-35,2-11,2-11.5,2-5,2-8.5,2.5-6,3-30,3-5,4,5-7.5,6-40,8-16,8-35,abaxially,acute,adaxially,aggregate,also,apart,apex,articulated,axe,base,branched,cell,cm,compound,cordate,cuneate,darker,deltate,densely,diameter,ellipsoidal,entire,flower,fruit,fusiform,glabrous,globose,greenish,leaf,leaving,length,less,lobe,long,longitudinal,margin,mesocarp,minutely,mm,moderately,near,obtuse,often,orange,pedicel,pedicellar,peduncle,per,perfect,petiole,pilose,pinnately,puberulent,puberulent-pubescent,pubescent,pubescent-pilose,purple,rachi,remnant,reticulate,ripe,shrub,simple,small,sometimes,spaced,sparsely,stone,stripe,style,sympodial,tree,triangular,truncate,unbranched,unit,white,wide,without,x,yellow	-10,0-10,0.5,0.5-1,0.5-6,1-1.5,1-3,1.5-13,1.5-3,1.5-7,1.5-8.5,11-16,11-22,11-pinnate,12-27,15-30,2-12,2-27,2-9,3-18,3-7,3-7-pinnate,3.5-6,4-8,5-18,5-20,5-30,5-merous,5.5-12,6-25,7-25,acuminat,acut,alyx,ape,ascending,basal,beyond,blade,bud,campanulate,capitate,chartaceous,connective,cylindrical,dia,diamete,dilated,directed,distally,eaf,eed,elliptic,elliptic-ovate,exceeding,exserted,fleshy,lateral,laterally,leaflet,lon,lower,membranaceous,nflorescence,nther,oblong,obovate,obtu,orolla,ovate,papillose,perfec,petiolule,pilo,pore,presen,puberulent-pilo,radiu,ranch,ratio,rown,ruit,runk,shallowly,shorter,slightly,somewhat,spreading,stamen,stigma,tal,terminal,thecae,tomentose,tube,uni,urceolate,vary,width	abaxial,acuminate,adaxial,anther,arrangement,branching,calyx,characteristic,colour,corolla,filament,form,growth,height,history,inflorescence,life,midvein,null,ovary,plant,primary,pseudostipule,seed,shape,staman,stem,surface,tertiary,texture,unarmed,vein,venation
162	wfo-0001027622	success	203	129	98	105	31	0.483	.5,0-14,0.3-10,1-10,1.5-3.5,2-25,2-6,2.5-3.5,3-4,3-4.5,3.5-11,6-7,abaxially,acuminate,acute,adaxially,anther,apart,apex,articulated,base,berry,blue,blue-purple,broadly,brownish,cell,cm,condition,corolla,covering,diameter,digestion,distal,drying,elliptic,elliptical,enzyme,filament,flower,fresh,fruit,glabrescent,glabrous,globose,green,green-white,greenish,hair,hair-like,herb,honeycomb-shaped,lateral,light,like,lobe,long,make,margin,middle,mm,mottled,mucilaginous,narrowly,oblique,odd-pinnate,ovate,ovate-lanceolate,ovoid,pale,pedicel,peduncle,petal,petiole,plant,pubescent,purple,removed,rounded,seed,shortly,slightly,spaced,star,stem,straight,striped,style,subglabrous,testal,thick,throughout,truncate,wall,wet,whitish,x,yellow	0-16,1,1-2,1.5-4.2,1.6-4.5,1/,12-23,2-3,3-16,4-5,4-9.5,5-11,5-merou,6-17,8-16,8-20,acumen,ag,along,alyx,apparently,axe,axillary,blade,borne,bud,capitat,chartaceous,ciliate,clavate,connivent,decumben,different,dorsally,eaf,edge,eed,end,erect,especially,exceeding,except,flat,folded,forked,geminat,generally,glabrou,greatly,half,homostylous,interjected,lanceolate,leaflet,lengthening,living,lower,membranous,midrib,minutely,nflorescence,often,orolla,pair,pentagonal,perfect,petiolule,plurifoliate,population,pore,poricidal,proximal,puberulent,reduced,ruit,seudostipule,singly,size,slit,sometimes,specimen,stamen,ste,stellate,stigma,stolo,subequal,subtending,tall,tamen,tem,terminal,tip,tri-,tube,tuber,typically,unit,unwinged,usually,vary,varying,wide,wing,ympodial	1/3,abaxial,adaxial,arrangement,branching,calyx,characteristic,colour,form,growth,height,history,inflorescence,leaf,length,life,mentioned,midvein,ovary,primary,pseudostipule,rachi,shape,staman,surface,tertiary,texture,true,unarmed,vein,venation
163	wfo-0001027624	exception_thrown	189	0	0	189	0	0.0		0-3,0-7,0.1-0.9,0.3-1,0.4-3,0.5-1.5,0.8-5.6,1-2,1-3,1-5,1.1-8.4,1.2-2.6,1.3-2.9,1.5-6.6,2-20,2-5,2-7,2.4-4.8,2.9-12,3-10,3-11,3-4,3-5,4-15.2,4-7,4-8,5-9,5-merou,6-18.5,9-41,abaxially,acuman,acumen,acuminate,acute,adaxially,ag,along,alyx,anther,apart,apex,apparently,arranged,articulated,axe,axillary,base,bead,berry,blade,brownish,bud,capitat,cell,clavate,cm,condition,connivent,considerably,corolla,covering,cuneate,decreasing,decumben,decurrent,deep,densely,diameter,digestion,distal,dorsally,drying,eaf,edge,eed,elliptic,entirely,enzyme,erect,exceeding,filament,flat,flower,folded,forked,fresh,fruit,geminat,glabrou,glabrous,globose,green,green-white,greenish,hair,hair-like,half,herb,homostylous,honeycomb-shaped,interjected,lanceolate,larger,lateral,leaf,leaflet,leave,lengthening,light,like,living,lobe,long,lower,make,middl,mm,moniliform,mottled,mucilaginous,multiple,necklace,nflorescence,odd-pinnate,onto,orbicular,orolla,ovate,ovoid,pair,pedicel,peduncle,pentagonal,perfect,petiole,plant,plurifoliate,pore,poricidal,present,pubescent,purple,rachi,removed,rotate,ruit,seed,sessile,seudostipule,short,size,slightly,slit,sometimes,spaced,specimen,stamen,stigma,stolon,straight,style,subtending,tall,tamen,tem,terminal,testal,thick,throughout,tip,toward,tri-,tube,tuber,typically,unit,unwinged,usually,vary,wall,wet,white,whitish,wide,widely,x,yellow,ympodial	
164	wfo-0001027626	success	152	122	94	58	28	0.618	.3,.5,0.1â0.2,0.2â0.6,0.5-1,0.5â1,0.7â1,1,1.5â2,13â14,14â116,2â3,2â49,2â5,3â4,3â5,3â55,4â6,5â6,8,9â18,abaxially,acuminate,adaxially,anther,apex,arrangement,axe,base,berry,broadly,calyx,clavate,cm,color,cordate,densely,diameter,distichous,elliptical,entire,extra-axillary,filament,flower,fruit,glabrous,greenish-white,immature,leaf-opposed,liana,lobe,long,margin,membranous,midvein,minutely,mm,moderately,nearly,oblique,ovate,pair,pedicel,peduncle,petiole,pinnate,pointed,possibly,pubescent,rachi,rounded,sand-punctate,scandent,scar,secondary,seen,shortly,shrub,slender,sparsely,spindle-shaped,style,terminal,time,tip,trichome,unbranched,unknown,vein,venation,white,wide,wiry-woody,x	0.7â2.8,1.3â4.5,1.5â8,3â4.5,4.4â11,5-merous,accrescen,acute,along,alyx,apar,blade,c.,capitat,center,chartaceous,ciliat,climbing,coriaceous,distant,distinct,eaf,eed,fleshy,frequently,fruiting,glabrou,lamina,lanceolate,line,lower,m.,maturity,mor,nflorescence,nternode,orolla,perfec,petal,plurifoliat,reflexed,ruit,sand-punctat,side,simple,somewhat,spaced,ste,stellate,stigma,tamen,tem,truncate,tube,two,unit,vary,ympodial	9-18,abaxial,adaxial,branching,characteristic,colour,corolla,form,growth,height,history,inflorescence,leaf,length,life,null,ovary,plant,primary,pseudostipule,seed,shape,staman,stem,surface,tertiary,texture,unarmed
165	wfo-0001027630	success	149	126	91	58	35	0.611	0.5-1,0.5-1.2,0.5-2,1-5,1.5-2,2-3,2-6-flowered,3/4,4-6,6-10,8-9,anther,anthesi,apart,apex,base,berry,blunt,broadly,calyx,ciliate,climbing,cm,corolla,decurrent,deflexed,deltoid,densely,except,extreme,filament,free,fruit,fruiting,glabrous,globose,golden,green,hirsute,immature,indistinct,internodal,irregularly,knob-like,known,lanceolate,lateral,leaf,linear,lobe,lobed,long,long-acuminate,main,margin,midrib,minutely,mm,near,occasionally,opposite,ovary,pair,papillose,pedicel,petiole,portion,pubescent,raised,reflexed,rounded,scar,seen,shrub,simple,slender,spaced,sparsely,stem,style,swollen,tapering,tip,trichome,tube,uniseriate,unit,vein,way,white,winged	.1,.2,.5,0.05-0.1,1-1.5,1.4-1.7,5.5-11.2,acute,also,arising,bark,beginning,branchlet,de,dia,distinguishable,eaf,edicel,eed,elongat,erose,glabrate,globo,inflorescenc,lon,lower,middle,nflorescence,novo,older,paler,partially,pore,poricidal,prominent,proximal,puberulent,rest,ruit,shaped,stigma,straight,strongly,tall,tear-drop,terminal,thickened,ti,ud,ultimate,unifoliat,wide,widest,wing,x,yellowish,ympodial,young	abaxial,adaxial,arrangement,branching,characteristic,colour,diameter,elongate,erosive,form,growth,height,history,including,inflorescence,length,life,midvein,null,peduncle,plant,primary,pseudostipule,rachi,seed,shape,staman,surface,sympodial,tertiary,texture,true,unarmed,unifoliate,venation
166	wfo-0001027661	success	222	172	146	76	26	0.658	+,0.5,0.5-,0.5-2,0.6-1.1,1-,1-1.5,1-7,1.5,1.5-2,2,30,4-15,4-8-celled,4.5-6,40,5-9,6-12,6-9,8-10,<,>,acuminate,acute,anther,anthesi,apex,articulate,axi,basal,base,berry,branch,branched,bright,broadly,calyx,cell,cm,commonly,cordate,corolla,dendritic,densely,denser,density,diameter,ellipsoid,elliptic,entire,extremely,filament,flattened,flower,glabrous,globose,green,ground,growth,herbaceous,hue,lamina,lateral,leaf,leaf-opposed,leaving,like,lobe,lobed,long,lower,many,margin,minutely,mixture,mm,moderately,narrowing,near,often,open,outline,ovate,pair,pale,papillate,pedicel,peduncle,peg,pentagonal,per,petiole,pinnatifid,pitted,pointed,primary,prominent,pubescence,pubescent,purple,purplish,rachi,rarely,red,reniform,ripe,shape,shiny,short,simple,sinus,sleeve,slender,small,sparsely,spot,spreading,stem,style,surface,swollen,tan,tangled,terminal,ternately,testa,time,trailing,triangular,trichome,truncate,two,type,unieriate,uniseriate,unit,upper,usually,variable,vein,vine,violet,white,wide,woody,yellow	-10,0.6-1.5,1-5,1.2-6,1.3,2.5-3,2.5-7,5-merou,6-8,abaxially,adaxiall,ag,along,alyx,apart,ark,capitate,column,conical,connivent,creeping,deeply,eaf,eed,even,free,fruiting,fused,gre,grey,ilament,irregularly,lengthening,long-exserted,markedly,membraneous,minute,new,nflorescence,occasionally,older,orolla,papillat,papillo,perfect,pericarp,plurifoliat,pore,poricidal,portion,pubescen,reflexed,ruit,scar,single,size,slit,spaced,spreadin,stellate,stigma,strongly,tem,thin,tightly,tip,tube,turbinate,ud,underground,vary,way,yellowish,ympodial,zig-za,Â¾	abaxial,adaxial,arrangement,branching,characteristic,colour,form,fruit,height,history,inflorescence,length,life,midvein,null,ovary,plant,plurifoliate,pseudostipule,seed,staman,sympodial,tertiary,texture,unarmed,venation
167	wfo-0001027714	success	251	191	169	82	22	0.673	+,.5,0,0.4,0.5,0.5-0.7,1,1-1.5,1-1.6,1-2,1.5-2,1.5-3,1.5-5,14-16,2-,2-2.5,2.5-4,3-3.5,4-5,4.5-5,5,5-6,6-7,7-20,80,<,abaxial,abaxially,acuminate,acute,adaxial,adaxially,aid,along,anther,anthesi,apex,appearance,around,articulated,axi,basal,base,berry,branched,bright,brown,calyx,cell,channelled,cm,confined,connected,cordate,corolla,creating,deep,deflexed,dendritic,densely,denser,diameter,elliptic,elongate,entire,especially,filament,flattened,flower,free,fruit,furcate,giving,glabrous,globose,groove,growth,hairy,immature,individual,inflorescence,juicy,lamina,lateral,leaf,leaving,like,lobe,long,longer,many,margin,marginal,mature,mere,minute,minutely,mm,nodding,obovate,occasionally,often,outline,ovary,pair,pale,papillate,pedicel,peduncle,peg,per,pericarp,petiole,petiolule,pinnatifid,pitted,portion,primary,prominent,pubescence,pubescent,purple,reaching,rectangular,red,reddish,reniform,rim,ripe,seed,shiny,similar,simple,sleeve,slender,small,somewhat,sparsely,stem,style,surface,tangled,terminal,testa,testal,thin,third,time,tiny,tip,tooth,trichome,truncate,tube,twining,uniformly,uniseriate,upper,usually,vein,vine,violet,wall,weak,widest,wing,woody,x,younger	/3,0.6-0.7,0.9-1.5,1-,1.5-2.5,2-8,2.5-,2373.,4-10,5-10,5-merou,age,almost,alyx,angle,apar,apice,ark,canop,capitate,climbin,conical,connivent,corky,cucullate,cupped,drying,eaf,eed,ellipsoid,enlarged,exserted,fide,fleshy,fruiting,glabrate,glabrou,hanging,ilament,inflated,irregularly,large,lengthening,lobed,lon,loosely,lower,mpodial,nee,new,nflorescence,older,orolla,otherwise,papillo,perfect,petal,plat,plurifoliat,pore,poricidal,ruit,scar,showy,slightly,slit,spaced,spreading,stellate-rotate,stigma,strongly,tem,thecae,thick,thickened,ud,unit,visible,way,weight,yellow,yellowish	arrangement,branching,canopy,characteristic,climbing,colour,form,height,history,length,life,mentioned,midvein,plant,pseudostipule,rachi,shape,staman,tertiary,texture,unarmed,venation
168	wfo-0001027720	success	184	185	154	30	31	0.837	%,.25-0.3,0,0-15,0.15-0.25,0.25-0.35,0.3-5,0.4-0.7,0.5-0.8,0.5-1,0.6-1.2,0.8-1,1-1.5,1-2,1-3.5,1-locular,1.5-2,13-23,13-35,15-25,2-3,2-4,2-7,2-branched,2-foliate,2.8-3.1,23-35,3-13,4-5.5,4-7,4.3-15,4.3-7.5,6,7-10,7-8,7-9,8-11,8-16,9-15,absent,acute,adaxially,adult,anther,apex,articulated,axe,base,berry,blade,brown,calyx,chartaceous,cm,confined,connivent,cuneate,cylindrical,deltate,densely,diameter,directed,distally,eglandular,elliptic,entire,erect,extra-axillary,filament,finger,flattened,flower,fruit,fruiting,glabrous,gland-tipped,globose,green,hair,half,incomplete,inflorescence,intepetalar,juicy,juvenile,lamina,lanceolate,lateral,leaf,length,less,lilac,lobe,long,loosely,margin,markedly,mature,mesocarp,midpoint,midrib,minute,mm,narrowly,notched,oblique,ovate,pale,part,pedicel,peduncle,per,perennial,perfect,petiole,pore,present,prickle,pubescent,rachi,ray,red,rhizomatous,scarce,septum,sessile,short,shrub,simple,slightly,sparsely,stellae,stellate,stellate-pubescent,stigma,straight,style,subreniform,surface,thick,thicker,time,tissue,toward,triangular,tube,unarmed,unit,upper,white,wide,without,x,yellow	0.4-0.8,4-,5-merous,abaxially,absen,adaxiall,alyx,apparently,ba,capitat,distall,eaf,eed,geminat,hig,homostylous,lower,mid-point,nflorescence,orolla,perfec,porrect,ruit,succulen,tamen,tem,unarme,vary,yellowi,ympodial	abaxial,adaxial,arrangement,branching,capitate,characteristic,colour,corolla,form,geminate,growth,height,history,life,midvein,null,ovary,plant,primary,pseudostipule,seed,shape,staman,stem,succulent,sympodial,tertiary,texture,vein,venation,yellowish
169	wfo-0001027720	success	272	225	168	104	57	0.618	.0,.04,.2,.3,.5,.9,0,0.9,1/3,13.0,2.0,2.5,3.2,3.6,3.9,8.0,abaxially,acuminate,acute,adaxially,aequilateral,anther,anthesi,apex,apparently,appearing,armed,articulated,attachment,attenuate,axe,base,berry,blade,branch,broad,broad-based,calyx,cancellate,channel,channeled,cm,concave,congested,conical,corolla,crisped,curved,deciduous,densely,dentate,diameter,difoliate,distally,dry,either,elliptic,endocarp,entire,erect,especially,exocarp,extra-axillary,fertile,filament,filiform,flattened-irregular,flattened-orbicular,flattened-reniform,flower,fruit,glabrous,glandular,globose,glossy,gradually,growth,hair,heavily,hooked,increasing,internode,juvenile,lamina,lateral,lavender,leaf,least,like,lobe,long,major,margin,mature,midpoint,midvein,minute,mm,moderately,narrowly,notched,oblique,occasionally,often,orange,ovate,part,pedicel,peduncle,per,petiole,point,porrect,porrect-stellate,portion,potentially,presumably,prickle,proximal,pubescent,raised,ray,red,reflexed,rigid,row,scattered,sessile,short,shorter,shrub,side,simple,slightly,small,soon,stellae,stellate,stem,straight,style,subacute,subcoriaceous,surface,thin,time,tip,toward,tree,triangular,truncate,twice-branched,two,unarmed,upper,vein,violet,wavy,white,wide,yellow,yellow-ferruginous,yellow-tan,young,youngest,Â±equal,Ã,â4	0.1â0.6,0.2â0.4,0.3â0.4,0.7â0.9,0.7â1.1,0.7â1.2,0.8â1.3,0.8â1.9,0.8â2.0,1.4â1.9,1.5â1.7,1.5â2.0,1.5â2.5,1.5â3.3,1.5â9.0,1.7â1.8,1.7â2.0,1.7â2.5,1.8â2.0,1.9â2.2,1/2,1/3â1/2,10.0,10.8â18.2,12â16,19.7â30.0,2.5â2.8,2.5â2.9,2â3,3.7â5.7,4.0â12.6,4.0â18.0,4â5-merou,5.1â18.6,6.5â9.5,6â8,8.0â11.9,8.2â10.5,8.5â9.4,9.5â16.0,adnate,alyx,apical,apiculate,ba,becoming,bilobed,brochidodromous,bud,capitate,colore,connivent,cream,dehiscence,developed,dorsally,eaf,eed,emerging,free,geminat,homostylous,inclined,interpetalar,intersepalar,juic,large,line,lon,longer,lower,m.,midrib,minor,nearly,nflorescence,oblong,orolla,perforate,poorly,pore,rip,ruit,sinus,sparsely,splitting,spread,stamen,stellate-pubescen,stellate-pubescent,stigma,suture,tall,tamen,tem,tissue,translucent,tube,ud,vary,way,weakly,yellow-ferruginou,ympodia	0.3-0.4,0.7-0.9,0.7-1.1,0.7-1.2,0.8-1.3,0.8-1.9,0.8-2.0,1.5-1.7,1.5-2.0,1.5-2.5,1.5-3.3,1.5-9.0,1.7-1.8,1.7-2.5,1.8-2.0,1.9-2.2,10.8-18.2,12-16,19.7-30.0,2-3,2.5-2.8,3.7-5.7,4.0-12.6,4.0-18.0,5.1-18.6,6-8,6.5-9.5,8.0-11.9,9.5-16.0,abaxial,adaxial,arrangement,branching,characteristic,colour,form,geminate,height,history,inflorescence,juicy,length,life,null,ovary,plant,primary,pseudostipule,rachi,ripe,seed,shape,staman,sympodia,tertiary,texture,venation
170	wfo-0001027757	success	186	152	100	86	52	0.538	0.2,0.3â2.0,0.5,1.2â4.0,12,2,2.5,2â,3â5,5,60â100,abaxially,acute,adaxially,along,anther,anthesi,apart,apex,articulated,axillary,base,blade,blue,borne,branching,brown,calyx,cell,cm,colour,cylindrical,dark,decurrent,deeply,densely,diameter,elliptic,equal,erect,filament,flattened,fleshy,flower,fruit,glabrous,globose,hair,irregularly,lanceolate,leaf,leafy,lilac,lobe,lobed,long,margin,mm,moderately,multicellular,narrowly,oblong,obtuse,occasionally,often,opposed,ovate,pair,pale,pedicel,peduncle,perennial,perfect,petiole,pitted,plurifoliate,primary,probably,pubescent,regularly,shoot,shrub,simple,spaced,sparsely,stone,straight,style,surface,toward,unbranched,unicellular,uniseriate,unit,unknown,violet,woody,x,â2.7,â5.5	0.2â0.3,0.6,0.6â1.0,0.7,0â1.4,1.0â1.1,1.0â2.5,1.5â1.6,1.5â2.5,1.6â2.4,1.9â2.7,1â1.5,1â11,1â2,1â3,2.5â4,2.5â5.5,2.5â7,2â10,3â12,4â9,5â,6â9,7â8,8â16,absen,accrescent,adaxiall,ag,apical,arising,axe,ba,basal,campanulate,chartaceous,clavate,concave,connivent,convex,directed,distally,eaf,eed,entire,erose,geminat,glabrescen,glabrou,lon,longitudinal,lower,m.,nflorescence,opening,orolla,pore,poricidal,rootstock,rotate,ruit,secondary,serrate,side,slit,smaller,sometimes,stigma,tall,tamen,tem,thic,thickened,time,tip,tube,vary,white,wide,yellow,ympodial,â19,â3.2,â4.0,â6,â9	--,0,0.3,1,1.0,1.1,1.4,1.5,1.6,10,11,16,19,3,3.2,4,5.5,6,7,8,9,abaxial,absent,adaxial,arrangement,characteristic,corolla,form,geminate,growth,height,history,inflorescence,length,life,mentioned,midvein,ovary,plant,pseudostipule,rachi,seed,shape,staman,stem,sympodial,tertiary,texture,true,unarmed,vein,venation
171	wfo-0001027765	success	167	136	100	67	36	0.599	-44,0.8,1,1-11.5,1-2,1-4,10-13,2-2.5,2-3,2-4,2.5-4,2.5-4.2,20-30,3-20,5,5-6,7-20,abaxial,acumen,acuminate,acute,apex,apiculate,articulate,base,branched,calyx,cell,cm,cordate,corolla,covering,cuneate,cyme,diameter,dichasial,dichasially,distal,ebracteate,elliptic,elliptic-lanceolate,exceeding,filament,flower,forked,generally,glandular,globose,green,green-white,hair,half,herbaceous,lateral,leaf,light,living,lobe,long,make,mm,monochasial,mucilaginous,oblique,obtuse,odd-pinnate,ovate,ovate-lanceolate,ovoid,pedicel,peduncle,perennial,perfect,petiole,petiolule,pilose,plant,proximal,rounded,seed,side,simple,specimen,stamen,stigma,straight,style,testal,thick,throughout,tip,tone,tuber-bearing,typically,unit,vary,violet,wall,white,Â¼	-30,-4,0-.,1-,1-10,1-5,1.5-6,3-,3-12,3-6-foliat,5-15,5-8,abaxially,abruptly,apical,apically,connate,dehiscent,digestion,diminishing,dorsally,eaf,edge,eed,emoval,enzyme,flat,folded,globo,hair-like,honeycomb,interjected,introrse,leaflet,lon,lower,lunat,maturing,nflorescence,nther,often,orolla,ovate-elliptic,pair,pattern,petiolate,plan,poricidally,reveal,ruit,sessile,seudostipule,short,size,slightly,slit,stellate,tal,tem,terminal,throughou,toward,truncate,wide,without,yellow,ympodial	'hair-like,3-6-foliate,adaxial,anther,arrangement,branching,characteristic,colour,form,fruit,growth,height,history,inflorescence,length,life,lunate,margin,mentioned,midvein,ovary,primary,pseudostipule,rachi,shape,staman,stem,surface,sympodial,tertiary,texture,true,unarmed,vein,venation,wet
172	wfo-0001027807	success	116	118	85	31	33	0.733	0-0.2,0.2-0.3,0.2-0.9,0.3-0.4,0.9-1,0.9-2.5,15-30,2-5,2-6,3.5-9,abaxially,acuminate,acute,adaxially,almost,apex,attenuate,barely,base,berry,brittle,brown,bud,closely,cm,decurrent,diameter,difoliate,dry,drying,elliptic,flattened,flower,glabrous,globose,grayish,green,growth,internodal,known,lanceolate,leaf,leaf-opposed,margin,material,maturity,midrib,minutely,mm,narrowly,occasionally,overlapping,pair,parallel,pedicel,peduncle,petiole,pitted,plane,primary,prominent,rachi,reddish,reniform,reproductive,revolute,scar,seemingly,shoot,shrub,simple,slightly,small,spaced,stem,surface,tree,unifoliate,unit,usually,vein,visible,winged,x,yellowish	.5,0.1-1,1-1.5,bark,deflexe,deflexed,eaf,eed,ellipti,fruiting,geminat,gray,know,new,nflorescence,older,ot,pale,paler,papillae,papillate,reddi,ruit,slender,somewhat,sparsely,thickened,ud,white,ympodial,young	abaxial,adaxial,anther,arrangement,branching,calyx,characteristic,colour,corolla,filament,form,fruit,geminate,height,history,inflorescence,length,life,lobe,midvein,null,ovary,plant,pseudostipule,seed,shape,staman,style,sympodial,tertiary,texture,unarmed,venation
173	wfo-0001027816	success	187	163	134	53	29	0.717	.5,0.5,0.5-1,0.5-2,0.6-0.8,0.7-1,1,1-1.5,1-3,1-4,1.5-2,1.8-6,12-14,2-4,3-3.5,3.5-4,4-5,5-30,6-9,<,acuminate,acute,almost,anther,apex,articulated,attenuate,axi,base,becoming,berry,bluish,branched,brown,calyx,cell,cm,confined,corolla,dark,dense,densely,diameter,drying,entire,erect,filament,filiform,flattened,fleshy,flower,free,glabrous,gland-tipped,glandular,globose,growth,half,inflorescence,irregularly,lanceolate,lateral,leaf,leaving,less,like,linear,lobe,lower,margin,minute,minutely,mm,new,occasionally,often,orange,pair,patent,pedicel,peduncle,peg,per,pericarp,petiole,pitted,plant,portion,primary,pubescent,purple,rectangular,red,reddish,reniform,ripe,rounded,scar,several,shiny,shrub,simple,sleeve,slightly,small,sometimes,somewhat,spaced,sparse,sparsely,spreading,square,stem,style,surface,terminal,testal,thin,time,tip,triangular,trichome,tube,ultimate,uniformly,uniseriate,unit,upper,usually,variable,vein,viscous,x,yellowish	..,0.2,1-1,1.2-2,2-2.5,2/3,5-merou,ag,along,alyx,anthesi,apar,ark,capitate,conical,connivent,cupped,eaf,eed,ellipsoid,em,exserted,fruiting,ilament,lengthening,lobed,loosely,m.,markedly,nflorescence,nodding,older,orolla,papillo,perfect,perhaps,plurifoliat,pore,poricidal,prominen,pubescen,ruit,slit,spreadin,stellate,stigma,twinin,ud,vary,way,woody,ympodial,Â½	abaxial,adaxial,apart,arrangement,branching,characteristic,colour,form,fruit,height,history,length,life,midvein,null,ovary,plurifoliate,pseudostipule,rachi,seed,shape,staman,sympodial,tertiary,texture,true,twining,unarmed,venation
174	wfo-0001027819	exception_thrown	199	0	0	199	0	0.0		-100,0.5-1,1,1-,1-2,1-5,1.5-2,10-20,10-50,12-21,15-22,16-25,2,2-,2-15,2-3,20-25,20-35,20-40,22-35,25-35,3-40,3-5,3-5-lobed,4,4-10,4-15,4-25,4-5,5,5-6,5-merous,8-10,9-12,abaxially,acute,adaxially,aggregate,also,alyx,apart,ape,apex,apical,apiculat,articulated,axe,ba,basal,base,beyond,blade,branched,cell,ciliate,cm,color,concave,connective,cordate,cuneate,cylindrical,deeply,densely,denser,dia,diamete,diameter,dilated,directed,distally,divided,eaf,eed,eglandular,eglandular-pilose,ellipsoidal,elliptic,elliptic-ovate,entire,equal,especially,exceeding,except,exserted,fading,finely,fleshy,flower,forked,fruit,glabrous,globose,green,hair,halfway,leaf,leaving,length,lobe,lobed,lon,long,lower,main,margin,mesocarp,midrib,mm,moderately,narrow,narrowly,near,nflorescence,nther,oblique,oblong,obtu,obtuse,occasionally,often,orolla,ovate,pedicel,pedicellar,peduncle,per,perfec,perfect,petiole,pilose,pinnately,pore,present,probably,prominent,protuberance,puberulen,puberulence,puberulent,purple,purplish,rachi,radiu,ranch,rarely,ratio,remnant,ripe,rounded,rown,rugose,ruit,runk,shallowly,short-acuminat,shorter,simple,sinus,slightly,small,sometimes,spaced,sparsely,stamen,stellate,stigma,stone,strongly,style,subcoriaceous,swelling,sympodial,tal,thecae,toward,tree,triangular,truncate,tube,two,ud,umbrella-shaped,unbranched,uni,unit,unknown,unlobed,usually,vary,vein,villous,whitish,wide,width,without,x,yellow,young	
175	wfo-0001027834	success	236	170	145	91	25	0.614	-6.1,.5-3,0-110,0.2-0.3,0.2-0.4,0.2-0.6,0.5-2,0.9-1.8,1-1.6,1-1.9,1-10,1.1-1.6,1.1-1.8,1.4-2,1.8-4.9,10-25,2-8,2.2-4.3,2.3-3.4,25,3-15,4-5.2,4.8-6.9,5-20,6.9-18.1,9-11.9,9-13,abaxial,abaxially,absent,acuminate,acute,adaxial,adaxially,angled,anther,apex,apical,articulated,attenuate,axillary,bark,base,berry,blade,branch,branched,branching,brown,bud,calyx,cm,connivent,coriaceous,corolla,cylindrical,deltoid,dendritic-echinoid,diameter,echinoid,entire,equal,exserted,filament,finely,fleshy,flower,fruit,glabrous,globose,granular-tomentose,gray,grooved,hair,leaf,lenticular,lobe,long,longitudinally,many,margin,mm,mostly,multangulate,numerous,obovate,obtuse,older,orbicular,ovate,ovate-elliptic,pair,pedicel,peduncle,persistent,petiole,plurifoliate,porrect-stellate,primary,pseudo-terminal,pubescence,rachi,rarely,ray,reticulate-punctate,ripe,rounded,scabridulous,semi-ovate,semi-spherical,sessile,short,short-stalked,shrub,simple,small,soft,sometimes,sparsely,stalked,stamen,stellate-pubescent,stem,style,surface,time,tomentose,tomentum,tree,trichome,unit,usually,vein,velutinous-tomentose,villous,white,whitish,whitish-tomentose,wide,x,yellow,yellowish,yellowish-tan,yellowish-tomentose,young	0.4-1.1,1-2.5,1.6-2.7,1/2,2-3.8,2.4-6.2,2.7-7.3,2.9-4.2,3-4.3,4-6,5-merous,5.1-8,accrescent,ag,alyx,anthesi,apar,around,ba,becoming,blunt-tipped,capitat,closely,completely,concentrated,covering,crown,dendritic-echinoi,densely,dichasia,directed,discolorous,distally,drying,eaf,echinoi,edge,eed,ellipsoid,enclosing,enveloping,erec,farinose,flat-topped,forming,fruiting,glabrescent,high,included,inserted,lengthening,less,light,lobed,long-stalked,longitudinal,lower,multangulat,near,nflorescence,obscured,orolla,ovate-lanceolate,perfec,pore,poricidal,pubescent,ruit,runk,scar,slit,somewhat,spaced,spreading,stellate,stigma,subcampanulate,subcoriaceous,suture,tamen,though,tip,tomentu,toward,tube,turbinoid,ud,unarme,vary,way,ympodial	arrangement,characteristic,colour,dichasial,form,growth,height,history,inflorescence,length,life,midvein,null,ovary,plant,pseudostipule,seed,shape,staman,sympodial,tertiary,texture,trunk,unarmed,venation
176	wfo-0001027843	success	154	153	122	32	31	0.792	.5,0.5-0.75,0.5-1,0.8-3.5,1-1.2,1-1.3,1-1.5,1.2-1.5,1.2-2.5,2-2.5,2-4,3-15-flowered,5-6,6-9,acute,along,anther,anthesi,apex,apiculate,base,bearing,becoming,beneath,berry,broadly,calyx,clavate,cm,conical,corolla,curly,deltoid,densely,denser,dia,differing,difoliate,distally,erose,filament,flower,free,glabrate,glabrous,globose,green,hairy,impressed,known,lamina,larger,lateral,leaf,like,lobe,lobed,long,long-acuminate,main,major,margin,middle,minor,minutely,mm,near,nearly,occasionally,older,one,opposite,orbicular,ovary,ovate,pair,papillose,pedicel,petiole,pleated,pore,poricidal,portion,prominent,proximal,pubescent,reflexed,rounded,shape,shaped,shrub,simple,sinus,size,slender,slightly,somewhat,sparsely,sparser,stem,stiff,stigma,straight,strongly,style,surface,tapering,tear-drop,time,tip,tipped,trichome,tube,two,uniseriate,unit,vein,white,widest,winged,x,young	.75,/3,3-6,6-13,apart,ba,bark,beginning,coroll,deflexed,eaf,edicel,eed,ellipsoid,exsertion,fruiting,geminat,irregularly,later,lon,lower,nflorescence,papillo,reddish-gre,ruit,scar,spaced,tall,ud,way,woody,ympodial	abaxial,adaxial,arrangement,branching,characteristic,colour,diameter,form,fruit,geminate,growth,height,history,inflorescence,length,life,mentioned,midvein,peduncle,plant,primary,pseudostipule,rachi,reddish-grey,seed,staman,sympodial,tertiary,texture,unarmed,venation
177	wfo-0001027847	success	219	173	148	71	25	0.676	-0.8,-3,-5,-6,.7,/2,/3,0-2,0-7,0.1-0.4,0.15-0.2,0.2,0.4-1,0.5,0.5-1,0.8,0.8-0.9,0.8-1.2,1-2,1.5-2,1.5-5,1/2,1/4,1/6-1/3,2-2.8,2-3,2-4,2-5,3-15,3-5,3-6,3.5-6,4-5-merous,6-11,6-8,7-10,abaxially,acute,ame,anther,apart,apex,apically,apparently,base,berry,blade,broadly,c.,calyx,chartaceous,cm,cordate,curved,deltate,densely,diameter,discolorous,distance,drying,elliptic,equal,erect,evenly,extending,faint,filament,filiform,flattened,flower,free,fruit,glabrous,gray,green,infructescence,leaf,length,lobe,lobed,long,longer,lower,margin,mauve,midpoint,midvein,mm,moderately,orbicular,ovate,pair,pedicel,peduncle,per,pericarp,perpendicular,petiole,porrect,portion,prickle,prickly,primary,purple,ray,red-brown,reddish,retrorse,rounded,scandent,scar,seed,sessile,shrub,side,simple,smooth,sometimes,spaced,sparsely,spherical,spreading,stalk,stalked,stellate,stellate-pubescent,stem,straight,strongly,style,surface,terete,tertiary,time,trichome,tube,unarmed,unit,upper,variously,vein,venation,visible,way,weakly,white,wide,young	-2,-2.5,-4,.35,0,1,1-2.5,1.5-2.5,1.9-2.3,2.2-3,2.5-3.5,2/,5-25,5-6,5.5-8,almost,alyx,apar,articulated,bark,branched,brow,connivent,dimorphic,dull,eaf,edge,eed,elongating,filiform-acuminat,finely,flattened-reniform,fruiting,geminate,glabrescent,increasing,lateral,lon,mature,maturity,middle,minor,narrow-deltate,nflorescence,older,one,open,orange,orange-brown,orolla,oung,pendulous,perfec,pit,pitted,plurifoliat,poricidal,prickl,red,ruit,size,slender,tamen,tapering,terminal,tip,toward,usually,vary,yellow,ympodial	2/3,abaxial,adaxial,arrangement,branching,characteristic,colour,corolla,form,growth,height,history,inflorescence,life,ovary,perfect,plant,plurifoliate,pseudostipule,rachi,shape,staman,stamen,sympodial,texture
178	wfo-0001027872	exception_thrown	190	0	0	190	0	0.0		0.5,1,1-1.2,1-4,1-8,1.0-1.3,1.5-4,10,12-35,15,2,2-3,2.2-3.5,2.8,20,3-6-foliat,35,4-6,5-10,5-7,5-8,5-lobed,6-20,8-11,abaxially,acumen,acuminate,acute,adaxially,angular,apex,apical,apically,apiculate,articulate,b,ba,basal,base,becoming,branched,ca,calyx,caudate,cell,celled,clasping,cm,commonly,connate,cordate,covering,cuneate,cyme,decreasing,deep,dehiscent,densely,diameter,dichasial,dichasially,digestion,distal,eaf,ebracteate,eed,elliptic,emoval,enzyme,erect,exceeding,externally,filament,flower,forked,four-celled,generally,glabrescent,gland,glandular,glandular-pubescent,globo,globose,gray-green,green,green-white,hair-like,half,herbaceous,homogeneously,honeycomb,interjected,introrse,lanceolate,lateral,leaflet,light,living,lobe,lon,long,longer,lower,make,maturing,middle,mm,moderately,monochasial,mottled,mucilaginous,narrowly,nearly,nflorescence,nther,obliquely,oblong,odd-pinnate,often,orolla,ovate,ovoid,pair,pattern,pedicel,peduncle,pentagonal,perennial,perfect,petiolate,petiolulate,petiolule,plant,poricidally,puberulent,pubescent,purpl,purple,rarely,reduced,reveal,rhizomatous,rhizome,rotate,rotate-,rounded,ruit,seed,semi-lunate,sessile,seudostipule,shape,short,single,size,slightly,slit,sometimes,somewhat,specimen,stamen,ste,stigma,straight,style,subequal,symmetrically,tem,terete,terminal,testal,thick,tinged,tip,trailing,type,typically,unbranched,uniformly,unit,usually,vary,viole,wall,wid,wide,wider,yellow,yellowish-green,ympodial	
179	wfo-0001027880	success	185	167	137	48	30	0.741	-3,.25,0.3-3,0.5-1.5,0.5-5,0.6-1,0.6-1.5,0.8-1.5,1-14,1-15,1-2,1-3,1.5-2,1.5-3,10-15,2-3,2-80,3-4,4-10,4-6,5-11,5-8,8,abaxially,acuminate,acute,adaxially,aggregate,along,anther,apart,apex,apiculate,articulated,base,blade,branching,calyx,cell,chartaceous,clavate,cm,conical,connivent,contiguously,cordate,coriaceous,curled,cylindrical,deltate,densely,diameter,discolorous,distichous,distinct,distinctly,entire,epiphytic,extra-axillary,filament,flattened,flower,fruit,fruiting,glabrous,globose,green,greenish,hair,inflorescence,leaf,leaf-opposed,line,lobe,long,longer,lower,margin,midvein,minutely,mm,multicellular,nearly,oblique,oblong,oblong-ovate,occasionally,often,ovate,ovoid,pair,pale,papillose,pedicel,peduncle,petiole,pink,plurifoliate,pubescent,purple,rachi,red-brown,reddish,revolute,ripe,rounded,rugulose,scar,secondary,shrub,simple,slender,slightly,sometimes,somewhat,spaced,stellate,stigma,stone,style,surface,tan,thickened,time,tip,trailing,truncate,typically,unbranched,undulate,uniseriate,vein,vine,white,wide,x,yellow	-3.5,1-2.5,2/,5-merou,absen,accrescen,ag,alyx,apparently,axe,ba,branch,ciliat,dense,diminishing,directed,distally,eaf,eed,equal,geminat,growing,increasing,internode,longitudinal,nflorescence,node,opening,orolla,perfect,point,pore,pubescen,rooting,ruit,size,slit,sparsely,ste,tamen,tem,tree,trunk,tube,unit,usually,vary,ympodial	2/3,abaxial,absent,accrescent,adaxial,arrangement,characteristic,ciliate,colour,corolla,form,geminate,growth,height,history,length,life,null,ovary,plant,primary,pseudostipule,seed,shape,staman,stem,tertiary,texture,unarmed,venation
180	wfo-0001027880	success	170	169	127	43	42	0.747	.25,0.2-0.5,0.5,0.5â1.5,0.6â1.5,10â15,1â14,1â15,2-80,2/3,3â4,4â10,8,abaxially,absent,acuminate,acute,adaxially,along,anther,apar,apex,apiculate,arrangement,axe,base,berry,blade,bluish-purple,c.,calyx,clavate,climbing,cm,contiguously,cordate,curled,cylindrical,deltate,dense,densely,diameter,discolored,distichous,distinct,distinctly,entire,extra-axillary,filament,flattened,flower,fruit,glabrous,globose,green,greenish,hair,leaf,leaf-opposed,line,lobe,long,longer,lower,margin,membranous,midvein,minutely,mm,mottled,nearly,nflorescence,nternode,oblique,oblong-ovate,occasionally,often,ovate,ovoid,pair,pale,papillose,pedicel,peduncle,petiole,pink,pinnate,pubescent,rachi,red,reddish,reddish-brown,revolute,rounded,rugulose,sand-punctate,scar,secondary,shrubby,simple,slender,slightly,sometimes,somewhat,spaced,sparsely,ste,style,surface,tan,thickened,tip,tree,trichome,truncate,trunk,typically,unbranched,undulate,uniseriate,vein,venation,vine,white,woody,x,â3.5	0.3â3,0.5â5,0.6â1,0.8â1.5,1.5â2,1.5â3,1â2,1â2.5,1â3,2â3,4â6,5-merous,5â11,5â8,accrescen,alyx,capitat,chartaceous,ciliat,conical,coriaceous,eaf,eed,fruiting,lanceolate,m.,orolla,perfec,plurifoliat,rip,ruit,sand-punctat,stellate,stigma,tamen,tem,time,tube,unit,vary,vegetatio,wide,ympodial	0.5-1.5,0.6-1,0.6-1.5,0.8-1.5,1-14,1-15,1-2,1.5-2,1.5-3,10-15,2-3,4-10,4-6,5-8,abaxial,adaxial,apart,branching,characteristic,colour,corolla,form,growth,height,history,inflorescence,length,life,null,ovary,plant,primary,pseudostipule,ripe,seed,shape,staman,stem,tertiary,texture,unarmed,vegetation
181	wfo-0001027881	success	215	177	153	62	24	0.712	-3,.3â0.5,0.5â2.2,0.8â1.5,1-celled,1.3â2,1.8â2.9,10â25,1â2,1â2-celled,1â2.5,1â2.6,1â3,1â3-celled,1â4,2.5â3.6,20â40,2â6,2â7,4â6,4â9.5,6â10,7â14,7â9,abaxially,absent,acuminate,acute,adaxially,almost,anther,apex,appressed,articulated,attenuate,axe,barely,base,berry,blackish,blade,calyx,camptodromous,ciliate,closely,cm,connected,contiguous,cordate,cordiform,curved,cylindrical,decurrent,dehiscing,densely,diameter,difoliate,drying,eglandular,emerging,entire,erect,exclusively,explosively,extra-axillary,eye,few-,fewer,filament,flattened,flower,forming,frequent,fruit,giving,glabrous,glandular,globose,greenish,groove,hair,held,herb,hollow,immature,impression,larger,lateral,leaf,less,light-brown,like,lobe,long,longer,many-branched,margin,maturity,mesocarp,mixed,mm,moderately,multicelled,multicellular,naked,near,netlike,normally,one,ovate-elliptic,pair,parallel,pedicel,peduncle,per,petiole,placenta,pressure,primary,projection,prominent,pubescence,pubescent,rachi,raised,reniform,secondary,seed,sessile,short,side,similar,slightly,small,sparsely,stalk,staman,stem,style,subopposite,surface,translucent,tube,two,unbranched,vein,venation,visible,watery,white,winged,woody,Ã	2â4,5,5-merous,8,abundant,accrescent,adaxiall,alyx,asymmetric,ba,bulge,capitat,case,central,chartaceous,commonly,connivent,denser,directed,dorsally,eaf,ed,emarginate,equal,exceeding,geminate,half,interpetalar,introrsely,longitudinal,lower,mainly,maturit,membranaceous,much,nflorescence,opening,orolla,other,part,perfec,pore,rotate,ruit,simple,size,slit,smaller,solitary,sometimes,stamen,stigma,subapically,tal,tamen,tem,tissue,triangular,unit,vary,yellow,ympodial	abaxial,adaxial,arrangement,branching,characteristic,colour,corolla,form,growth,height,history,inflorescence,length,life,midvein,null,ovary,plant,pseudostipule,shape,tall,tertiary,texture,unarmed
182	wfo-0001027882	success	184	136	111	73	25	0.603	0.1,0.5-1,1,1-1.5,1-5,1.5-,1.5-2,1.5-2.2,1.5-6,10-40,2-3,2.1-2.6,3-4,3.5-4,3.5-5,4-5,6-9,9-13,abaxially,absent,acuminate,adaxially,along,anther,anthesi,apex,appearing,attenuate,axil,base,berry,branched,branching,calyx,cm,completely,conical,corolla,dark,deltate,dense,diameter,difoliate,dry,drying,elliptic,entire,erect,filament,flattened,flower,glabrous,globose,green,growth,hairy,hollow,inflorescence,junction,lamina,less,lobe,margin,markedly,maturity,midrib,minutely,mm,nodding,ovary,ovoid,pair,pale,pedicel,peduncle,petiole,pitted,primary,pulp,rachi,rarely,reddish,reniform,shattering,shiny,shrub,simple,slender,small,sometimes,sparse,specimen,stem,sticky,stout,style,surface,swollen,thickened,time,tip,tree,trichome,tuft,uniseriate,usually,vein,white,x,yellow,yellowish	.25,.5,06a,1.6-2.2,10-25,2-6,2-lobed,2.5-3,3.2-6,7-,age,apart,apparently,bark,branch,broadly,brown,c.,caly,clavate,cucullate,densely,eaf,eed,et,exerted,fide,fork,free,fruiting,fusiform,geminat,glabrou,hooked,irregularly,kallunki,leaf-opposed,lengthening,lobed,lower,new,nflorescence,occasionally,papillat,papillate,paulo,penden,perfect,planar,plane,pointed,population,pore,poricidal,portion,red-papillat,ruit,scar,slit,spaced,sparsely,stigma,straight,strongly,structurally,sweet-scented,sÃ£o,tube,ud,unit,way,woody,ympodial	abaxial,adaxial,arrangement,characteristic,colour,form,fruit,geminate,height,history,leaf,length,life,midvein,null,plant,pseudostipule,seed,shape,staman,tertiary,texture,true,unarmed,venation
183	wfo-0001027889	success	151	141	105	46	36	0.695	-pubescent,.5-2,0,0.5-1,0.5-11,0.7-2,1,1-10,1-3,1-3.5,1.5,1.5-2,10-12,10-20,10-30,2-20,2-3,3-4,3-8,3-9,abaxially,acute,acute-acuminate,adaxially,aggregate,apart,apex,apiculate,articulated,axe,basal,base,beyond,blade,calyx,cell,chartaceous,cm,cylindrical,darker,deltate,densely,diameter,dilated,distally,eglandular-puberulent,eglandular-pubescent,elliptic,entire,exserted,finely,flower,fruit,glabrous,glandular-,green,greenish,immature,leaving,length,light,lobe,long,longitudinal,margin,mm,moderately,ovate,ovoid,pedicel,pedicellar,peduncle,perfect,petiole,present,probably,puberulent,puberulent-pubescent,rachi,radiu,remnant,ripe,shrub,simple,slightly,small,spaced,sparsely,stamen,stone,stripe,style,subcordate,time,tip,tree,truncate,unbranched,unit,unknown,violet,white,wide,x,yellowish	-2.5,.5,4-foliat,5-10,acuminate,ape,capitat,color,connective,connivent,directed,eaf,eed,equal,exceeding,extending,introrse,laterally,lon,lower,narrow,nflorescence,nther,oblong,orolla,pore,presen,puberulen,puberulent-pubescen,ruit,somewhat,stellate,stigma,subcoriaceous,swelling,tal,tem,thecae,tomento,tomentose,triangular,tube,ud,vary,yello,ympodial	1-2.5,4-foliate,abaxial,adaxial,anther,arrangement,branching,characteristic,colour,corolla,filament,form,growth,height,history,inflorescence,leaf,life,midvein,null,ovary,plant,primary,pseudostipule,seed,shape,staman,stem,surface,sympodial,tertiary,texture,true,unarmed,vein,venation
184	wfo-0001027901	success	156	135	105	51	30	0.673	.25,.5,0.3-1.2,0.8-1,1-1.5,1-2,1-2.5,2.5-3,3-5,4-10-flowered,4-5,6-7,?,abaxial,acuminate,acute,anther,anthesi,apex,attenuate,base,beneath,berry,bright,brown,calyx,closely,cm,corolla,dark,deflexed,dia,difoliate,direction,dry,drying,elliptic,filament,firm,fleshy,free,fresh,glabrous,globose,green,imbedded,immature,inflorescence,keeled,lateral,leaf,like,lobe,lobed,long,main,material,matrix,minutely,mm,nearly,opposite,orbicular,oriented,ovary,ovoid-reniform,pair,papillose,pedicel,petiole,pitted,planar,portion,prominently,pubescent,reddish,reflexed,ripe,rounded,scar,shape,shiny,shrub,simple,single,slender,spaced,sparsely,stem,straight,style,surface,swollen,tip,translucent,triangular,trichome,tube,uniseriate,usually,vein,white,x,yellow,young	0.5-1,0.8-2,0.9-2.3,1.5-1.8,1.8-4.5,4.7-12,abaxially,adaxially,area,ba,bark,broadened,brow,conical,curled,densely,differing,eaf,edicel,eed,ellipsoid,exserted,fruiting,geminat,later,lon,lower,major,middle,midrib,minor,nflorescence,older,overlappin,papillo,pore,poricidal,rest,ruit,shaped,size,stigma,strongly,tall,tear-drop,tub,ud,unit,widest,woody,ympodial	adaxial,arrangement,branching,characteristic,colour,diameter,form,fruit,geminate,growth,height,history,length,life,margin,midvein,null,overlapping,peduncle,plant,primary,pseudostipule,rachi,seed,staman,tertiary,texture,true,unarmed,venation
185	wfo-0001027902	success	128	122	86	42	36	0.672	-2.5,0.5-1,1-1.5,1-2,1-6,10-20,15-30,2,2-12,2-15,2-3,2-8,2-9,20-50,3-4,3-5,4-25,4-5,5-20,6-37,7-9,abaxially,acuminate,acute,adaxially,angled,apart,apex,articulated,axe,base,blade,branched,calyx,cm,color,cordate,deeply,densely,diameter,eglandular,entire,flower,forked,fruit,glandular,globose,hair,leaving,like,lobe,long,margin,mm,moderately,obtuse,ovate,pedicel,pedicellar,peduncle,petiole,puberulent,pubescent,purple,rachi,radiu,remnant,reticulate,ripe,shrub,simple,small,spaced,sparsely,style,time,tip,tree,truncate,unbranched,unit,unknown,usually,whitish,wide,x	1.5-3,10-15,3-foliat,8-13,absen,adaxiall,aggregate,cell,chartaceous,connivent,cylindrical,directed,distall,distally,eaf,eed,glabrous,inflated,lon,lower,narrowly,nearly,nflorescence,nther,orolla,pore,pubescen,purplish,ruit,ste,stellate,stigma,stone,subcoriaceous,tal,tem,triangular,truncat,tube,vary,yellow,ympodial	3-foliate,abaxial,adaxial,anther,arrangement,branching,characteristic,colour,corolla,filament,form,growth,height,history,inflorescence,leaf,length,life,midvein,null,ovary,plant,primary,pseudostipule,seed,shape,staman,stem,surface,sympodial,tertiary,texture,true,unarmed,vein,venation
186	wfo-0001027929	exception_thrown	193	0	0	193	0	0.0		0.2-0.9,1,1-10,1-4,1-8,1.0-1.3,1.5-4,10,15,2,2-3,2.0-3.0,20,3-6-foliat,3.5-5,35,4-30,4-5,4-6,5-10,5-6,5-lobed,6-15,abaxially,acumen,acuminate,acute,adaxially,along,angular,apex,apical,apically,apiculate,articulate,ba,basal,base,becoming,beyond,branched,calyx,caudate,cell,cente,center,clasping,cm,coat,color,connate,cordate,corolla,covering,cuneate,cyme,dark,darker-violet-blue,decreasing,deep,dehiscent,diameter,dichasial,dichasially,digestion,distal,eaf,ebracteate,eed,elliptic,embryo,emoval,enzyme,erect,exceeding,except,filament,flower,forked,formed,generally,glabrous,globo,globose,green,green-white,hair,hair-like,half,herbaceous,honeycomb,included,interjected,introrse,lanceolate,lateral,leaflet,light,living,lobe,lon,long,lower,make,maturing,middle,mm,monochasial,mostly,mucilaginous,narrowly,nearly,nflorescence,nther,obliquely,oblong,occasional,odd-pinnate,often,orolla,ovate,ovoid,pair,pattern,pedicel,peduncle,pentagonal,perennial,perfect,petiolate,petiolulate,petiolule,plant,poricidally,puberulent,purpl,purple,radiating,rarely,reduced,reveal,rhizomatous,rhizome,rotate,rotate-,rounded,ruit,seed,semi-lunate,sessile,seudostipule,shape,short,size,slightly,slit,sometimes,somewhat,specimen,spot,stamen,star,ste,stigma,straight,style,subequal,symmetrically,tem,terete,terminal,testal,thick,tinged,tip,trailing,typically,unbranched,unit,usually,vary,vein,violet,violet-blue,visible,wall,white,wid,wide,wider,without,yellow,ympodial	
187	wfo-0001027948	success	186	144	114	72	30	0.613	-15,-16,-6,.5,0-,0.5-0.7,0.5-2,0.8-,1-1.2,1.2-2.2,1.3-1.8,1.5-4.5,1.6,10-14,13,14,2.2-,2.5-,3-8.2,3.2-5.2,3.7-4,5-,7,7-15,7.5-10,abaxially,abundant,acuminate,adaxially,aggregate,anther,antrorse,apex,attenuate,basal,base,berry,calyx,cell,cm,corolla,diameter,difoliate,directed,edentate,elliptical,erect,filament,flexuous,free,generally,glabrous,glandular,globose,herb,herbaceous,hollow,inserted,lamina,leaf,length,light,lobe,long,longer,longitudinally,many-,margin,midvein,mm,narrowly,near,non-glandular,occasionally,ovate,ovoid,pair,patent,pericarp,petiole,portion,pubescent,purple,ridged,scarce,secondary,seed,seeded,seen,serrulate,short-stalked,shorter,simple,small,solitary,stem,stone,straight,striate,style,sub-opposite,sub-shrub,tooth,triangular,trichome,tube,unequal,unit,upward,vein,violet,x,Â¼,Â½	0.4,0.6,1-2,1/10,2-,3.5,5,6-celled,8-celled,accrescen,ag,ape,articulate,ature,bicellular,branch,c.,campanulate,connectival,crushed,cuticle,dark,delicate,diamete,dorsally,eaf,ellipsoidal,finely,fragrance,fruiting,head,hig,ill-smelling,inconspicuous,long-stalked,longitudinal,lower,narrow,odorles,opening,orolla,papillate,pore,poricidal,prolongation,pubescence,reduced,ree,ruit,saddle-shape,scarcely,separated,single-celled,sinus,slightly,slit,smooth,spur-like,stalk,stigma,striat,tem,thecae,thickened,time,tip,twice,vary,ventrifixed,verrucate,viscid-pubescent,ympodial	abaxial,adaxial,arrangement,branching,characteristic,colour,form,fruit,growth,height,history,inflorescence,life,null,ovary,pedicel,peduncle,plant,primary,pseudostipule,rachi,shape,staman,surface,sympodial,tertiary,texture,true,unarmed,venation
188	wfo-0001027961	success	177	146	117	60	29	0.661	.5,0.25-0.5,0.5-1,0.9-1,1,1-1.5,1-3,1-5,1-9,10-50,2-2.5,2.3-2.5,3-3.5,4.5-5,7-9,8-10,?,acute,adaxially,always,anther,anthesi,apex,ark,articulated,asymmetric,axil,base,berry,branched,broadly,brow,calyx,clear,cm,cordate,corolla,curling,deltate,densely,diameter,distributed,elliptic,entire,fading,filament,flower,fruiting,glabrous,globose,green,growth,immature,inflorescence,lamina,lateral,lobe,lobed,lon,long,lower,many,margin,mature,maturity,midrib,mm,new,obovate,observed,occasionally,often,older,pair,pedicel,peduncle,pericarp,petiole,pinched,pinnatifid,plurifoliate,present,primary,probably,pubescent,purple,reddish,shiny,simple,sleeve,slender,slightly,small,sparsely,spreading,stem,style,surface,terminal,thin,time,transition,triangular,trichome,truncate,tuft,twining,uniseriate,unit,upper,vein,vine,violet,white,white-pubescent,woody,x	0.25,1-4,2.5-9,5-8,5-merou,6-9,<,abaxially,adaxiall,age,alyx,apar,c.,clavate,conical,connivent,eaf,early,eed,ellipsoid,equalling,exserted,free,fusiform,geminat,ilament,irregularly,lengthening,loosely,membranous,minute,minutely,nflorescence,one,orolla,other,papillo,pendan,perfect,planar,pore,poricidal,portion,pubescen,rotate-stellate,ruit,scar,slit,spaced,stigma,tem,tip,tube,twinin,ud,unequal,vary,way,yellow,ympodial	abaxial,adaxial,arrangement,branching,characteristic,colour,form,fruit,geminate,height,history,leaf,length,life,midvein,null,ovary,pendant,plant,pseudostipule,rachi,seed,shape,staman,sympodial,tertiary,texture,unarmed,venation
189	wfo-0001027966	success	207	124	92	115	32	0.444	1-10,1-2,1-4.2,1-5,1.3-2.2,10,10-30,2.2-2.9,3-4,3-5,3-7,40-80,5-6,6-11,abaxially,acuminate,adaxially,anther,apart,apex,articulated,attenuate,base,berry,blue-violet,brownish,cell,cm,condition,conical,corolla,covering,densely,diameter,distal,drying,elliptic,filament,flower,fresh,fruit,glabrous,green,greenish,hair,herb,lateral,leaf,leaflet,light,like,lobe,long,make,margin,medium,middle,minute,mm,mottled,mucilaginous,odd-pinnate,ovate,ovoid,pale,pedicel,peduncle,petiole,plant,proximal,pubescent,purple,ray,ripe,seed,sessile,shorter,slightly,somewhat,spaced,sparsely,stem,straight,subsessile,terminal,testal,thick,violet,wall,wet,white,whitish	0.4-0.5,0.7-3,0.8,0.8-2.5,1-1.8,1-3,1.2-4.5,1.5-3,1.5-5.2,2.5-10.5,2.8-9,4,5-10,5-9.5,5-merou,5.5-14,absent,acumen,ag,along,alyx,apparently,arranged,asymmetrical,axe,axillary,basiscopic,bead,blade,bud,capitat,chartaceous,ciliate,commonly,connivent,decreasing,digestion,dorsally,eaf,edge,eed,enzyme,erec,especially,exceeding,flat,folded,forked,geminat,generally,glabrou,gradually,green-white,hair-like,half,homostylous,honeycomb-shaped,interjected,lanceolate,larger,lengthening,less,living,lower,membranous,moniliform,multiple,narrow,necklace,nflorescence,orbicular,orolla,pair,pentagonal,perfect,petiolule,plurifoliate,pore,poricidal,rarely,removed,rotate,ruit,secondary,semierect,seudostipule,side,size,slit,specimen,stamen,ste,stigma,stolon,subequal,subtending,symmetrical,tall,tamen,tem,throughout,tip,tissue,tri-,tube,tuber,tyle,typically,unit,usually,wide,wing,x,yellow,ympodial	'hair-like,abaxial,adaxial,arrangement,branching,calyx,characteristic,colour,form,growth,height,history,inflorescence,length,life,mentioned,midvein,ovary,primary,pseudostipule,rachi,shape,staman,style,surface,tertiary,texture,true,unarmed,vein,venation,Â¼
190	wfo-0001028014	success	222	133	108	114	25	0.486	-15,-2.5,-5,-6,0,0.2-1,0.2-1.6,0.25,0.5-1,0.5-2,0.6-0.9,0.7-1,0.9-1.2,1-,1-10,1-4,1.3-2.4,2-20,2-3,2-4.5,2.5-4,4.5-7,almost,anther,apex,apically,apparently,around,articulated,base,berry,black,branched,brown,brown-green,calyx,cell,cm,cordate,curved,decurrent,deltate,densely,diameter,difoliate,edge,erect,eye,filament,flattened-reniform,flower,fruit,glabrescent,glabrous,gray,gray-green,lateral,leaf,length,lobe,lobed,margin,maturity,mauve,midvein,mm,moderately,naked,obtuse,one,open,orange,outer,outline,ovate,pair,pedicel,peduncle,petiole,pit,prickle,primary,purple,raised,red,rough,rounded,scandent,seed,shiny,shrub,slender,sometimes,spherical,stellate-pubescent,stem,style,surface,terminal,tertiary,time,vein,venation,visible,visibly,weakly,winged,yellow-green	-0.5,-1,-1/2,-10,-3,-4,.5,/5,0.1-0.2,0.15,0.15-0.3,0.2,0.2-0.4,0.3-0.4,0.5,0.5-1.5,0.5-3,0.7-1.6,1-2,1-3,1.5,1.5-2,1.8-3,1/4,1/4-2/3,2,2-6.5,3-10,4-10,5-merous,6-10,6-11,abaxially,acuminat,alyx,ame,apar,apart,bark,blade,broad-deltate,c.,chartaceous,concolorous,connivent,discolorous,distance,drying,eaf,eed,elongating,equal,extending,flattened,free,fruiting,geminat,glabrou,gland,globular,herbaceous,infructescence,lon,long,longer,lower,mature,membranous,midpoint,nflorescence,occasionally,older,orange-gra,orolla,oung,pale,pendulous,per,perfec,pericarp,poricidal,porrect,portion,prickl,prickly,ray,reduced,reflexed,ruit,scar,sessile,shorter,side,simple,smooth,spaced,spreading,stalk,stalked,stellate,straight,strongly,tamen,tapering,terete,tip,trichome,tube,unit,vary,way,wide,yellow,ympodial	abaxial,acuminate,adaxial,arrangement,branching,characteristic,colour,corolla,form,geminate,growth,height,history,inflorescence,life,null,orange-gray,ovary,plant,pseudostipule,rachi,shape,staman,texture,unarmed
191	wfo-0001028017	success	158	137	104	54	33	0.658	-2.5,0.3-1,1-10,1-3,1.5-2,10-22,13-40,15-35,15-50-flower,2,2-3,2-4,2.5-5,3,3-12,3-14,3-4,40-50,5,5-7,5-9,6-8,abaxially,acute,adaxially,apart,apex,apiculate,articulated,axe,basal,base,beyond,blade,brown,calyx,cm,cuneate,cylindrical,densely,diameter,eglandular,eglandular-puberulent,eglandular-pubescent,ellipsoidal,elliptic,entire,exserted,flattened,fleshy,flower,forked,fruit,fusiform,glabrous,glandular,glandular-,glandular-puberulent,green,greenish,hair,immature,leaving,lobe,long,margin,mm,moderately,near,oblique,obtuse,ovate,pedicel,pedicellar,peduncle,perfect,petiole,pointed,pubescent,rachi,radiu,rarely,remnant,ripe,short-acuminate,simple,small,sometimes,spaced,sparsely,stamen,style,subcoriaceous,time,tip,tree,truncate,unbranched,vein,white,wide,without,x,yellow	1,1-2,3-foliat,6-7,9-11,absen,absent,acuminate,aggregate,ape,cell,chartaceous,ciliat,clavate,connective,connivent,cream,directed,distally,eaf,eed,exceeding,introrse,lanceolate,lon,lower,narrowly,nflorescence,nther,orolla,ovoid,pore,puberulen,purple,purplish,ruit,shorter,slightly,stellate,stellate-campanulate,stigma,stone,tal,tan,tem,thecae,tomentose,triangular,truncat,tube,ud,unit,vary,ympodial	abaxial,adaxial,anther,arrangement,branching,characteristic,colour,corolla,filament,form,growth,height,history,inflorescence,leaf,length,life,midvein,null,ovary,plant,primary,pseudostipule,puberulent,seed,shape,staman,stem,surface,tertiary,texture,unarmed,venation
192	wfo-0001028033	success	157	131	96	61	35	0.611	.6,1â4,3,4â12,50,6â12,abaxially,acuminate,acute,adaxially,along,anther,anthesi,apex,ark,attenuate,base,becoming,blade,brown,calyx,cell,ciliate,cm,cylindrical,cyme,darker,decurrent,densely,denser,diameter,drying,elliptic,entire,eye,few-branched,filament,flower,fruit,glabrescent,glabrous,green,greenish,growth,herb,hispid-pubescent,known,lateral,length,light,like,linear-lanceolate,lobe,long,margin,midrib,mm,naked,nearly,new,older,onto,order,pedicel,petiole,prominent,pubescence,pubescent,recurved,rhizomatous,secondary,sessile,shin,shiny,shrub,simple,slightly,solitary,sparsely,spreading,stem,stigma,straight,strongly,style,surface,trichome,unbranched,uniseriate,unknown,upright,vein,venation,visible,white,woody	1.4â1.8,1.5,1â5,2â3,2â4,2âfoliate,3â11,3â4,3â5,4â5,5-merou,5â7,adaxiall,alyx,ascending,branch,brochidodromous,capitat,chartaceous,connivent,contiguou,cordate,deeply,directed,discolorous,eaf,eed,emarginate,equal,florescence,geminat,high,introrsely,know,lobed,longitudinal,lower,mainly,membranaceous,oblong,opening,orolla,ovate-lanceolate,perfect,pore,poricidal,prostrat,ruit,shorter,slit,stellate,subapical,tamen,tem,tube,unit,vary,wide,yellow,ympodial,Ã	1.4-1.8,2-4,3-4,3-5,4-12,4-5,abaxial,adaxial,arrangement,branching,capitate,characteristic,colour,contiguous,corolla,form,height,history,inflorescence,leaf,life,midvein,null,ovary,peduncle,plant,primary,pseudostipule,rachi,seed,shape,staman,tertiary,texture,unarmed
193	wfo-0001028067	success	139	124	89	50	35	0.64	-30,0.5-1,0.5-1.5,0.5-2,1,1-10,1-11,1-2,1-3,1-7,1.5-2.5,10-25,2,2-2.5,2.5-3,3-5,3-7,5-7,6-12,6-18,7-11-compound,7-9,abaxially,acuminate,acute,adaxially,along,apart,apex,articulated,axe,base,calyx,chartaceous,cm,cuneate,cylindrical,dark,diameter,elliptic-fusiform,entire,especially,flattened,flower,fruit,glabrous,hair,leaf,leaving,lobe,long,margin,midrib,mm,moderately,nearly,obtuse,often,pedicel,pedicellar,peduncle,petiole,pink,pinnately,puberulent,purple,rachi,radiu,rarely,remnant,ripe,shrub,simple,slightly,spaced,sparsely,stellate,strongly,style,tip,tomentulose,triangular-deltate,truncate,unbranched,unequal,unit,x,yellow,zigzag	2-3,3-17,3-4,4-foliat,7-20,8-13,adaxiall,aggregate,basiscopically,blade,cell,color,compound,connivent,decurrent,directed,distall,eaf,eed,elliptic-ovate,glabrou,lateral,leaflet,lon,lower,narrowly,nflorescence,nther,orolla,per,pore,puberulen,ruit,several,smal,stigma,stone,subcoriaceous,tal,tem,time,triangular,truncat,tube,unknown,upper,usually,vary,wide,ympodial	4-foliate,abaxial,adaxial,anther,arrangement,branching,characteristic,colour,corolla,filament,form,growth,height,history,inflorescence,length,life,midvein,null,ovary,plant,primary,pseudostipule,seed,shape,staman,stem,surface,sympodial,tertiary,texture,true,unarmed,vein,venation
194	wfo-0001028069	success	253	220	194	59	26	0.767	-30,-6,.2,.5,0.05-0.1,0.1-0.2,0.1-0.3,0.1-0.5,0.1-0.6,0.2-0.3,0.2-0.5,0.3,0.3-0.45,0.3-0.6,0.3-1,0.4,0.4-0.5,0.4-0.8,0.4-1,0.5,0.5-0.7,0.5-1.8,0.5-2,0.6-1.1,0.6-4,0.7-1.5,0.8-1.2,1-2.7,1-3.5,1-4.5,1.4,1.5-2.0,1.5-3.5,1.6-3.2,10,10-12,10-30,12,2-3-branched,2-4,2-7,2-locular,3,3-,3-foliate,4-celled,5-22,6-,<,abaxially,abundant,accrescent,acute,adpressed,along,alternate,always,anther,apex,appearance,appressed,articulated,axi,basal,base,basioscopically,becoming,berry,bract,bracteole-like,bright,brown,calyx,cell,cm,composed,conical,cordate,corolla,cuneate,curving,decurrent,deep,deeply,densely,diameter,ebracteate,eglandular,erect,filament,flower,forming,fruit,fruiting,giving,glabrescent,glandular,glandular-villous,globose,green,hair-like,half,head,herb,imparipinnate,initially,interjected,internode,interrupted,larger,later,lateral,leaf,leaflet,length,like,lime,linear,lobe,lobed,long,longer,margin,maturity,midvein,minute,minutely,mm,narrowly,oblique,obovate,occasionally,often,orange,outgrowth,ovary,ovate,pair,pale,patent,pedicel,peduncle,per,perennial,petiole,petiolule,plant,population,present,primary,procumbent,pseudostipule,pubescence,pubescent,quaternary,robust,rounded,scarcely,secondary,sessile,several,shaggy,short,shorter,silky,simple,size,slender,smaller,stem,straight,style,subopposite,surface,tangled,terminal,tertiary,testa,thick,tightly,toward,transparent,trichome,unicellular,uniseriate,unit,usually,varying,viny,wall,weak,wide,winged,yellow	-0.4,.1,.1-0.2,0.1-0.15,0.3-0.4,0.3-0.7,0.7-1,0.7-1.3,1-2-celled,2-17,5-25,absen,adjacent,among,anthesi,apical,appendage,ba,bilaterally,citru,column,cone-shaped,dense,due,eaf,edicel,eed,exserted,fusion,gland,gland-tippe,gland-tipped,gree,halfway,included,less,lon,longest,lower,middl,multicellular,nflorescence,one,pentagonal,rarely,reflexed,ruit,scent,single-celled,somewhat,staminal,sterile,stigma,strong,symmetric,tem,tube,ud,ympodial	.1-0.2-0.2,abaxial,absent,adaxial,arrangement,branching,characteristic,colour,form,growth,height,history,inflorescence,life,middle,null,rachi,seed,shape,staman,sympodial,texture,true,unarmed,vein,venation
195	wfo-0001028075	success	196	109	77	119	32	0.393	1-10,1-2.7,1.5-2.5,1.6-2.7,10-35,2-6,4-7,5-7,5-8,5-9,7-13,7-30,8-12,acuminate,acute,anther,apart,apex,articulated,base,berry,broadly,brownish,cell,ciliate,cm,condition,corolla,covering,dark,diameter,distinctively,drying,elliptic-lanceolate,filament,fresh,fruit,glabrescent,glabrous,globose,green,greenish,herb,lateral,leaf,light,ligulate,lobe,long,make,margin,mm,mucilaginous,oblique,obtuse,odd-pinnate,ovate,ovate-elliptic,ovoid,pale,pedicel,peduncle,petiole,plant,reflexed,rounded,seed,slightly,spaced,style,subcordate,testal,thick,wall,wet,white,whitish	.5,1-2,1-3,1.5-7,2-3,2-4.5,2.5-10,3-11,3-23.5,4-12,5-12,5-14,5-17,5-merou,abaxially,absent,acuman,acumen,adaxially,ag,along,alyx,apparently,axe,axillary,blade,borne,bud,capitat,chartaceous,connivent,cuneate,decreasing,differentiated,digestion,distal,distally,dorsally,dot,eaf,edge,eed,end,enzyme,erec,especially,exceeding,flat,flower,folded,forked,geminat,generally,glabrescen,green-white,hair-like,half,homostylous,honeycomb-shaped,interjected,lanceolate,larger,leaflet,lengthening,living,lower,membranous,middl,midrib,minutely,much,narrow,nflorescence,often,orolla,pair,pentagonal,perfect,petiolule,plurifoliate,pore,poricidal,puberulent,purple,removed,rotate,ruit,scattered,seudostipule,singly,size,slit,sometimes,specimen,stamen,star,stigma,stolo,straight,subtending,tall,tamen,tem,terminal,throughout,tip,toward,tri-,tube,tuber,typically,unit,usually,vary,wide,wing,x,yellow,ympodial	'hair-like,abaxial,adaxial,arrangement,branching,calyx,characteristic,colour,form,growth,height,history,inflorescence,length,life,middle,midvein,null,ovary,primary,pseudostipule,rachi,shape,staman,stem,surface,tertiary,texture,true,unarmed,vein,venation
196	wfo-0001028076	exception_thrown	195	0	0	195	0	0.0		.5,0.4-0.5,0.5,1-1.3,1-10,1-2,1-3,1.2-2.2,1.8-2.2,110,12-22,13-14,2-12,2-3,2-5.4,2.2-2.6,2.2-3.7,2.5-3,2.5-4,2.6-3.8,4-5,4.5-7,5,5-20,5-6,5-6.5,5-merou,7-8,?,abaxially,absent,acumen,acuminate,adaxially,ag,alyx,anther,apart,apex,apparently,articulated,attenuate,axe,axillary,base,berry,blade,borne,brownish,bud,capitat,cell,chartaceous,ciliate,cm,condition,conical,connivent,corolla,covering,decreasing,densely,diameter,digestion,distal,dorsally,drying,eaf,edge,eed,elliptic,end,enzyme,erec,especially,exceeding,filament,flat,flower,folded,forked,fresh,fruit,geminat,generally,glabrou,glabrous,gradually,green,green-white,greenish,hair,hair-like,half,herb,homostylous,honeycomb-shaped,interjected,lanceolate,larger,lateral,leaf,leaflet,lengthening,less,light,like,living,lobe,long,lower,make,margin,medium,membranous,minute,mm,mucilaginous,nflorescence,obtuse,odd-pinnate,orolla,ovate,ovoid,pair,pedicel,peduncle,pentagonal,perfect,petiole,petiolule,plant,plurifoliate,pore,poricidal,proximal,pubescen,pubescent,purple,rarely,ray,removed,ripe,rotate,round,ruit,secondary,seed,semierect,sessile,seudostipule,singly,size,slightly,slit,spaced,specimen,stamen,ste,stem,stigma,stolo,straight,style,subequal,subsessile,subtending,symmetrical,tall,tamen,tem,terminal,testal,thick,thir,throughout,tip,toward,tri-,tube,tuber,typically,unit,unwinged,usually,vary,wall,wet,white,whitish,wide,wing,x,yellow,ympodial	
197	wfo-0001028105	success	150	118	87	63	31	0.58	.1,.5,0.3-1.5,0.5-1,0.5-2,0.6-1,1-1.2,1.5-1.8,1.5-2,2,2-2.2,2-5,3.5-4,5-7-flowered,6-7,abaxially,acuminate,adaxially,anther,apex,apical,attenuate,axil,base,berry,calyx,cm,corolla,dark,deflexed,dense,difoliate,distinct,drying,elliptic,erect,filament,filiform,flattened-reniform,free,glabrous,globose,green,incrassate,lamina,lateral,leaf,lobe,long,main,major,margin,minor,minutely,mm,occasionally,olive-green,opposite,ovary,pair,pale,pedicel,petiole,pitted,portion,projection,pubescent,quadrate,reddish-brown,scattered,shrub,simple,slightly,small,sparsely,stem,style,surface,tree,trichome,tube,tuft,uniseriate,vein,white,x,yellowish	.4,0.5,1-1.5,1-2.5,1.5,1.5-4.5,3-5-celled,3-6,9.5-15,acute,anthesi,apar,axi,ba,bark,bilobed,clavate,conical,dia,differing,eaf,edicel,eed,ellipsoid,evenly,exserted,fruiting,geminat,glandular,greenish-yello,like,lobed,lon,lower,middle,nearly,nflorescence,older,papillo,papillose,planar,pore,poricidal,reflexed,ruit,scar,shaped,size,spaced,spreading,stigma,straight,strongly,tall,tear-drop,tip,tub,ud,unit,widest,woody,ympodial,young	abaxial,adaxial,arrangement,branching,characteristic,colour,diameter,form,fruit,greenish-yellow,growth,height,history,inflorescence,length,life,midvein,null,peduncle,plant,primary,pseudostipule,rachi,seed,shape,staman,tertiary,texture,true,unarmed,venation
198	wfo-0001028109	success	205	139	117	88	22	0.571	-20,-4,-7,0.1-0.2,0.3,0.4-0.8,0.4-1.5,0.45-0.65,0.5-2.5,0.6-0.8,0.8-1.5,1.5-2.5,1.5-5.5,12-40,15-100,2-4,2.3-2.9,2.5-3,2.5-5,20-60,3-,4-13,5-13,5-30,8-12,8-25,abaxial,acuminate,acute,adaxial,anther,apex,apparently,articulated,base,berry,blade,branching,bright,calyx,cm,cuneate,curved,deltate,densely,diameter,dull,entire,erect,evenly,filament,flower,free,fruit,gently,glabrescent,glabrous,gray-green,green,green-brown,infructescence,lateral,leaf,length,light,lobe,long,long-styled,margin,maturity,mauve,mm,moderately,multangulate,orange-brown,pair,pedicel,peduncle,per,petiole,portion,prickly,primary,ray,recurved,red,red-brown,secondary,shrub,simple,slender,small,sometimes,spherical,stalk,stalked,stellate-pubescent,stem,straight,style,surface,terete,terminal,tertiary,tree,trichome,tube,unarmed,unit,vein,venation,visible,weakly,white,wide,yellow,young	.5,/3,0.05-0.15,0.05-0.2,0.1,0.5-1.2,0.7,0.8-1.6,1.5-10,1/8-1/4,10-25,10-30,2-15,2/3-3/4,3-7,3.5-6,3/4,30-150,4-5-merous,8-15,abaxially,acut,almost,alyx,ame,apar,apart,apically,bark,brow,c.,chartaceous,connivent,dimorphic,discolorous,drying,eaf,eed,elliptic,elongating,equal,flattened-reniform,fruiting,fully,geminate,glabrou,lobed,longer,lower,mature,midpoint,minor,nflorescence,obtuse,occasionally,older,one,open,opening,orolla,oung,perfec,pericarp,perpendicular,plurifoliat,poricidal,porrect,prickl,prickle,reflexed,ruit,scar,sessile,smooth,spaced,spreading,stellate,strongly,tamen,tapering,time,tip,unarme,usually,vary,way,woody,ympodial	arrangement,characteristic,colour,corolla,form,growth,height,history,inflorescence,life,mentioned,midvein,ovary,plant,plurifoliate,pseudostipule,rachi,seed,shape,staman,sympodial,texture
199	wfo-0001028115	success	165	139	104	61	35	0.63	-1.1,-2.5,-5.2,.6,0.42,0.6-0.7,1.1-1.8,1.4-1.7,1.7-2.2,1.8-3.5,2-3.2,2.5-,3-4.5,3-5,4.7-,5-15,5-8.5,6-10,9-17,abaxially,abundant,acute,adaxially,alternate,annular,anther,antrorse,apex,articulate,attenuate,basal,base,berry,blade,blue,calyx,cm,coat,curved,diameter,ellipsoidal,elliptical,embryo,entire,especially,filament,glabrescent,glabrous,glandular,globose,half,herb,herbaceous,length,light,linear,lobe,long,longitudinally,margin,mixed,mm,moderately,multi-seeded,narrowly,near,nerve,non-glandular,oblong,one,opposite,ovate,pair,pale,petiole,pinnatifid,pinnatipartite,pinnatisect,prostrate,pubescent,rarely,ridged,scarce,seed,segment,similar,simple,slender,slightly,small,stem,style,trans-ovoidal,triangular,trichome,tuberculate,unequal,uniseriate,venation,violet,wide,winged,x,yellow	.2,0.2-0.3,0.5,0.7-0.8,0.8-,1-2.4,1-3,1.3-1.8,12-13.5,2-,3-6.5,7-7.5,accrescent,acuminat,ag,amply,campanulate,capitate,connectival,difoliat,dorsal,eaf,eed,evident,exceeding,fruiting,growing,hig,inflated,longer,longitudinal,lower,much,opening,orolla,papery-scarious,papillo,pore,poricidal,portion,prolongation,ree,reticulate,ruit,slit,smooth,sometimes,stigma,strongly,styl,subsessil,tem,time,tip,tube,unifoliate,unit,vary,wider,width,ympodial	0.7-,0.8,abaxial,adaxial,arrangement,branching,characteristic,colour,corolla,form,fruit,growth,height,history,inflorescence,leaf,life,midvein,null,ovary,pedicel,peduncle,plant,primary,pseudostipule,rachi,shape,staman,subsessile,surface,tertiary,texture,true,unarmed,vein
200	wfo-0001028131	success	208	186	164	44	22	0.788	-1.2,.5,0-0.6,0-2,0-3,0-30,0-4,0.05-0.2,0.1-0.15,0.1-0.3,0.2-1.5,0.3-0.7,0.4-0.8,0.5-1.1,0.8-1,0.8-1.1,1-10,1-3,1-4,1-5,1.5-3,1.5-5,1.8-2.2,1/5,2-2.8,2-4,2-5,2-6.5,2/3,3-6,4-6,5-6.5,5-8,abaxial,absent,adaxial,anther,apart,apex,apically,apparently,articulated,attenuate,bark,base,berry,blade,branched,broad-deltate,calyx,cell,cm,connivent,cream,curved,dark,deltate,densely,diameter,difoliate,distance,dull,epidermi,equal,erect,extending,eye,filament,filiform,flattened,flattened-reniform,flower,free,fruit,glabrescent,glabrous,gland,green,herb,infructescence,lateral,leaf,length,like,lobe,lobed,long,longer,margin,marking,maturity,mauve,midpoint,midvein,mm,naked,narrow-obovate,narrow-ovate,oblong,obtuse,often,older,one,open,orange,orange-brown,outline,pair,pale,pale-brown,pedicel,peduncle,per,pericarp,petiole,pit,poricidal,porrect,portion,prickle,prickly,primary,purple,raised,ray,red,reduced,rounded,scar,sessile,shiny,shorter,side,simple,small,smooth,sometimes,spaced,sparsely,spherical,spreading,stellate-pubescent,stem,straight,strongly,style,sunk,surface,tapering,terete,tertiary,time,tip,trichome,tube,unarmed,upper,vein,venation,visible,wide,yellow,yellow-green,young	.1,/5,0.7-1.1,1.8-2,1/4-2/3,5-merous,6-7,7-8,abaxially,acuminat,alyx,apar,chartaceous,concolorous,drying,eaf,eed,elongating,fruiting,geminat,lanceolate,lengt,lower,mature,membranous,moderately,nflorescence,orolla,oung,pale-gra,pendulous,perfec,prickl,reflexed,ruit,sessil,stellate,tamen,unarme,unit,vary,way,woody,ympodial	acuminate,arrangement,branching,characteristic,colour,corolla,form,growth,height,history,inflorescence,life,null,ovary,pale-gray,plant,pseudostipule,rachi,seed,shape,staman,texture
201	wfo-0001028148	success	157	138	100	57	38	0.637	-6,0.25-0.5,0.5-1.5,0.75-2,1-15,1-3.5,1.5,1.5-2.5,10-30,12-15,2,2-3,2-7,2.5-4,20-50,3.5-4,3.5-9,5-20,5-7,abaxially,acute,adaxially,aggregate,angled,apart,apex,apiculate,articulated,axe,base,blue-black,branched,calyx,cell,central,cm,cylindrical,dark,decurrent,deltate,densely,diameter,elliptic,entire,except,flower,fresh,fruit,glabrous,glaucous,globose,hair,highly,less,light-colored,lobe,margin,material,mature,minute,mm,moderately,narrowly,obtuse,often,pedicel,peduncle,perfect,petiole,pink,puberulence,puberulent-pubescent,purple,rachi,radiu,rarely,rhizomatous,ridge,ripe,scalloped,shrub,slender,slightly,smooth,sometimes,spaced,sparse,star,stone,style,surface,tapered,treelet,unbranched,unit,violet,white,whitish,x,young	.5-4,0.6-3.5,15,4-10,4.5-10,5,5-10,5-8,6-18,absen,ba,blade,broadly,chartaceous,connivent,directed,distal,distall,eaf,eed,especially,fleshy,long,lower,many-foliat,margi,midrib,nflorescence,nther,orange,orolla,ovate,part,plicae,plicate,pore,puberulent,rotate-stellate,ruit,simple,smoot,stigma,succulent,tal,tem,thickened,time,tip,triangular,truncat,tube,usually,vary,wide,winge,yellow,ympodial	0.5-4,abaxial,absent,adaxial,anther,arrangement,branching,characteristic,colour,corolla,filament,form,growth,height,history,inflorescence,leaf,length,life,many-foliate,mentioned,midvein,ovary,plant,primary,pseudostipule,seed,shape,staman,stem,sympodial,tertiary,texture,true,unarmed,vein,venation,winged
202	wfo-0001028161	success	124	103	68	56	35	0.548	0.25-0.5,1-1.3,1-1.5,1-2,2-5-flowered,2-9,2.5-3,3-4,3-7,4-5,9-11,abaxially,acuminate,acute,adaxially,apex,attenuate,base,berry,branched,brown,calyx,cell,closely,cm,corolla,dendritic,densely,elliptic,globose,green,incrassate,lanceolate,lateral,leaf,like,long,main,major,margin,minor,minutely,mm,narrowly,opposite,outline,ovoid-reniform,pair,pale,pedicel,petiole,pitted,pubescent,reddish-brown,rest,shape,shrub,simple,sinuate,somewhat,sparsely,stem,surface,tapering,thin,trichome,vein,x	.5,0.1-0.25,0.7-1.7,1-2.3,1.5-4.5,1/3,6-9,7.5-12,along,anthesi,arising,ba,bark,branch,congested,consisting,deflexed,denser,dia,differing,difoliate,distal,eaf,edicel,eed,exserted,fruiting,geminat,glabrescen,inflorescenc,later,lon,middle,nflorescence,obovoid,often,older,orbicular,overlappin,probably,pubescence,rounded,ruit,scar,short,size,spaced,strongly,tall,tan,tub,ud,unit,widest,ympodial,young	abaxial,adaxial,anther,arrangement,branching,characteristic,colour,diameter,filament,form,fruit,growth,height,history,inflorescence,length,life,lobe,mentioned,midvein,null,ovary,peduncle,plant,primary,pseudostipule,rachi,seed,staman,style,tertiary,texture,true,unarmed,venation
203	wfo-0001028164	success	197	150	125	72	25	0.635	-1,-6,0-20,0.4-0.8,0.5-0.8,0.5-1,0.7-1.1,0.9-1.6,1-1.5,1-4.5,1.8-2.5,1/3,2.5-4,2.5-4.5,2.8-4,3-17,3.6-4.8,4-13,6-8,8-15,abaxial,acuminate,acute,almost,anther,apex,apically,apparently,articulated,attenuate,base,berry,branched,bright,calyx,cm,concolorous,curved,dark,deltate,densely,diameter,difoliate,drying,dull,elliptic,entire,erect,evenly,eye,filament,filiform,flattened-reniform,flower,fruit,glabrescent,glabrous,glandular,gray,green,hair,infructescence,lateral,leaf,length,lobe,long,margin,maturity,mauve,midvein,minute,mm,moderately,multangulate,naked,obtuse,often,one,open,orange-brown,pair,pale,pedicel,peduncle,per,pericarp,petiole,porrect,primary,recurved,red,red-brown,sessile,shallowly,shrub,side,smooth,sometimes,sparsely,spherical,stalked,stellate-pubescent,stem,straight,style,surface,terete,terminal,tertiary,time,tip,trichome,unarmed,undulate,upper,variously,vein,venation,visible,white,wide,yellow,yellow-green,young	-14,-8,/4,0.05-0.2,0.05-1.5,0.1,0.3-0.8,0.8-1.5,1,1.5-2.5,1/6-1/4,12-20,2-2.5,3-7,4-5-merous,4-7,4-8,8-17,abaxially,alyx,ame,apar,bark,blade,c.,connivent,eaf,eed,elongating,equal,free,fruiting,geminat,glabrescen,glabrou,less,lobed,long-acuminat,longer,lower,mature,membranous,midpoint,narrow-deltate,nflorescence,older,orolla,oung,perfec,poricidal,portion,ray,reflexe,ruit,scar,shorte,shorter,simple,spaced,spreading,stalk,stellate,tamen,tapering,tube,unarme,unit,vary,way,woody,yellow-gra,ympodial	adaxial,arrangement,branching,characteristic,colour,corolla,form,geminate,growth,height,history,inflorescence,life,long-acuminate,null,ovary,plant,pseudostipule,rachi,seed,shape,staman,texture,true,yellow-gray
204	wfo-0001028180	success	147	136	103	44	33	0.701	.05,.5,/2,0.7-1,1-1.2,1-1.5,1-1.8,1-3,2-3,2.5-3,20-30-flowered,3-4,4.5-5,5-6,7,8-10,abaxially,acute,adaxially,along,anther,apex,attenuate,bark,base,beginning,berry,calyx,closely,cm,conical,corolla,dark,darker,deltate,dia,differing,difoliate,distinctly,drying,elliptic,erect,filament,fleshy,four-angled,free,glabrous,globose,gold,golden,green,irregularly,lateral,leaf,lobe,long,main,major,margin,midrib,minor,minutely,mm,obscure,older,onto,opposite,ovary,ovoid-reniform,pair,pale,papillose,pedicel,petiole,pinkish-white,pitted,portion,puberulent,pubescent,scar,shiny,simple,size,somewhat,spaced,sparsely,stem,style,surface,tan,tip,tree,trichome,tube,uniseriate,unit,vein,way,white,winged,x,yellow-gray,young	1.5-5,15-28,2-2.2,3-10,5-8,anthesi,ba,c.,capitate,cucullate,deflexed,densely,eaf,eed,elongate,falcate,fruiting,geminat,glabrat,know,larger,leathery,lobed,lon,lower,nearly,nflorescence,overlappin,planar,pore,poricidal,ruit,shaped,small,stigma,straight,styl,tall,tear-drop,thick,ud,underside,woody,ympodial	abaxial,adaxial,arrangement,branching,characteristic,colour,diameter,form,fruit,geminate,glabrate,growth,height,history,inflorescence,length,life,mentioned,midvein,overlapping,peduncle,plant,primary,pseudostipule,rachi,seed,shape,staman,sympodial,tertiary,texture,unarmed,venation
205	wfo-0001028182	success	150	142	109	41	33	0.727	0.1-0.2,0.5,0.5-0.6,0.5-1,0.8-1,0.9-1,1-1.5,2,2-2.5,2-6.5,3,3-5,4-6,5-15-flowered,along,anther,anthesi,apex,apiculae,apiculate,arching,bark,base,beneath,branch,brown,calyx,capitate,ciliate,cm,conical,cordate,corolla,deflexed,deltoid,densely,dry,except,extreme,filament,filiform,flower,free,glabrous,hemiepiphyte,inflorescence,internodal,keeled,known,lateral,lax,leaf,less,like,lobe,lobed,long,long-acuminate,main,margin,midrib,minutely,mm,narrowly,nearly,older,opposite,ovary,ovate,pair,papillose,pedicel,petiole,planar,portion,present,prominent,pubescent,purplish,reflexed,rounded,scar,shiny,shrub,simple,slender,slightly,somewhat,sparsely,sparser,specimen,spindly,stem,stigma,still,style,surface,tapering,time,tip,trichome,truncate,tube,uniseriate,vein,white,x,young,zig-zag	.5,0-90,5-ribbed,6-9,apart,axi,bending,black,blade,dia,eaf,edicel,eed,ellipsoid,evenly,globose,gre,know,later,lower,material,minute,nflorescence,obovoid,papillo,pore,poricidal,proximal,rib,ruit,sca,shaped,spaced,strongly,tear-drop,third,ud,unifoliat,unit,widest,ympodial	abaxial,adaxial,arrangement,branching,characteristic,colour,diam,diameter,form,fruit,grey,growth,height,history,length,life,mentioned,midvein,null,peduncle,plant,primary,pseudostipule,rachi,seed,shape,staman,tertiary,texture,true,unarmed,unifoliate,venation
206	wfo-0001028183	success	237	185	157	80	28	0.662	-10,-5.3,.5-3,0.1,0.1-0.2,0.1-0.4,0.1-0.9,0.2-0.3,0.2-0.5,0.5,0.5-2.5,0.6,0.7-1.2,0.7-2,0.8-1.4,0.8-3.1,1.1-1.8,1.2-1.4,1.3-1.7,1.4-2.8,1.5-3.4,10-15,11-30,2-4.2,2-5,2.8-4.2,3.2-,3.5-6.6,4.5-9,4.6-6.4,5.2-6.2,50-400,6.6-20,7.5-23,8-9.1,9-13,abaxial,abaxially,acute,adaxially,along,anther,apex,attenuate,axillary,bark,base,berry,blade,branch,branched,calyx,cell,cm,corolla,cuneate,cylindrical,deltoid,dendritic-multangulate,diameter,distantly,dull,elliptic,entire,epidermal,except,exserted,few-rayed,filament,flower,fruit,glabrescent,glabrous,globose,granular-punctate,group,hair,half,lanceolate,lateral,leaf,lobe,long,long-decurrent,lower,main,many,margin,midrib,mm,multangulate,narrowly,nearly,older,orangish-tan,overlapping,pedicel,peduncle,petiole,plurifoliate,porrect-stellate,present,prominent,pseudoterminal,pubescence,pubescent,purple,rachi,rarely,relatively,reportedly,reticulate-punctate,ripe,scabrous,sessile,short-,shrub,side,simple,small,somewhat,soon,spaced,sparingly,sparse,spherical,stalk,stamen,stem,stipitate-glandular,stout,streak,style,sub-lenticular,surface,tan,terete,thick,thin,thin-textured,time,tomentose,touching,translucent,tree,unit,upper,usually,vein,violet,white,whitish,wide,x,yellowish,yellowish-tomentose,young	0.2-0.4,1.3-1.4,1.6-2.3,1.7-2.7,1.9-3.7,1/3-1/2,2.2-5.7,2.5-4.1,2.6-4.4,5-8,5-8.5,accrescent,ag,alyx,anthesi,apart,apparently,around,articulated,axi,blunt-tipped,brown,bud,capitate,central,chartaceous,closely,dark,directed,distally,drying,eaf,earl,edge,eed,elongated,especially,evident,farinose,free,fruiting,glabrescen,high,inserted,lackin,lengthening,lobed,lon,longitudinal,m.,nflorescence,oblong,obovoid,open,orolla,ovate-lanceolate,perfec,pore,poricidal,porrect-stellat,ruit,runk,short,slit,splitting,stage,stellate,stigma,strongly,subcampanulate,suture,tamen,tip,tube,ud,unarme,vary,way,yellow,ympodial	adaxial,arrangement,branching,characteristic,colour,form,growth,height,history,inflorescence,lacking,length,life,midvein,ovary,plant,primary,pseudostipule,seed,shape,staman,sympodial,tertiary,texture,trunk,unarmed,unspecified,venation
207	wfo-0001028227	success	236	177	150	86	27	0.636	-2/3,-6.2,.5-4,0-250,0.1,0.2,0.2-0.3,0.2-0.4,0.3,0.4,0.5,0.7-2.1,0.8-1.4,0.9,0.9-1.4,1-1.7,1-4.2,1.1-3.1,1.2-2,1.3-4,1.5-2.3,1.7-2.8,1.9,1/2,1/2-3/4,10,10-24,11-15,2-12,2.5-7.8,3-4.9,3.7-6.3,3.7-7,4.8-7.6,6-16,6.7-15,8.1-18,8.5-22,abaxial,abaxially,acuminate,acute,adaxially,age,anther,apart,apex,appressed,articulated,attenuate,axillary,base,becoming,berry,blade,branch,branched,brown,brownish,c.,calyx,closely,cm,corolla,cuneate,dark,decurrent,deltoid,dendritic-echinoid,diameter,echinoid,elliptic,entire,farinose,filament,fleshy,flower,fruit,glabrescent,globose,granular-tomentose,gray,grayish,green,hair,lacking,lanceolate,lateral,leaf,less,lobe,long,main,many,margin,midrib,midvein,mm,mostly,multangulate,oblong-lanceolate,obtuse,older,orangish-tan,overlapping,pale,pedicel,peduncle,petiole,plurifoliate,porrect-stellate,present,pseudoterminal,pubescent,purple,rachi,reticulate-punctate,ripe,scabridulous,sessile,shrub,side,simple,slightly,spaced,sparsely,stalk,stem,stout,style,sublenticular,subspherical,sulcate,surface,thick,thin,time,tomentose,touching,tree,unit,vein,velutinous,violet,way,wide,x,yellow,yellowish,young	0.2-0.5,0.8,0.9-1.2,1,1-2.5,1.4,1.4-2.6,1.9-4.2,1.9-5.8,2-3.8,2.6-5.9,2.9-4.7,4-13,5-7.5,accrescent,ag,along,alyx,anthesi,apparently,around,bark,blunt-tippe,blunt-tipped,bud,cylindrical,directed,distally,drying,eaf,early,echinoi,edge,eed,elongate,ength,exserted,free,fruiting,glabrous,high,inserted,lengthening,lobed,lon,longitudinal,lower,m.,nflorescence,oblong,obscured,occasionally,often,orbicular,orolla,ovate-lanceolate,ovate-orbicula,perfec,pore,poricidal,prominent,pubescence,quarter,relatively,rounded,ruit,runk,slit,somewhat,stamen,stellate,stigma,subcampanulate,suture,tamen,thicker,tip,tomentu,tube,ud,unarme,upper,usually,vary,well,ympodial	adaxial,arrangement,branching,characteristic,colour,form,growth,height,history,inflorescence,length,life,ovary,ovate-orbicular,plant,primary,pseudostipule,seed,shape,staman,sympodial,tertiary,texture,true,unarmed,unspecified,venation
208	wfo-0001028228	success	143	103	74	69	29	0.517	.5,1-1.5,1.1-1.2,1.2-1.8,1.5-2,2,2-5,2-8,6-7,abruptly,acute,anther,apex,base,beginning,beneath,berry,brown,calyx,clavate,cm,coriaceous,corolla,dark,deflexed,deltoid,difoliate,dry,elliptic,filament,free,glabrous,globose,green,greenish-yellow,impressed,leaf,lobe,major,margin,material,minor,minutely,mm,narrowing,obovate,opposite,ovary,ovoid-reniform,papillose,pedicel,petiole,portion,prominent,reticulate,rounded,shining,shrub,simple,slender,small,stem,straight,style,surface,tapering,terminal,thick-margined,tip,tree,tube,vein,white,x	0.1-1.7,0.75,1.1-2.5,1.8-3.4,10-30-flowered,2.1-4.2,2.8-6.5,3/4,6-8,7.5-12.5,age,anthesi,area,ba,bark,becoming,caly,campanulate,closely,dia,distal,eaf,edicel,eed,erect,exserted,fragrant,fruiting,geminat,inflorescenc,lateral,lobed,lon,long,lower,main,middle,minute,nflorescence,occasionally,older,overlapping,ovoid,pair,pale,planar,pore,poricidal,ruit,scar,shaped,shinin,slightly,spaced,stigma,styl,sweetly,tall,tear-drop,thickened,ud,unit,usually,way,weight,widest,woody,ympodial,young	abaxial,adaxial,arrangement,branching,characteristic,colour,diameter,form,fruit,growth,height,history,inflorescence,length,life,midvein,null,peduncle,plant,primary,pseudostipule,rachi,seed,shape,staman,tertiary,texture,unarmed,venation
209	wfo-0001028263	exception_thrown	156	0	0	156	0	0.0		0.25,1-2,1-3,1-4,11-13,11-23,14-44,2,2-3,2-4,2.6,3,3-6-foliat,3.4,3.5-4.2,4,4-5,5-7,5-7.5,6,6-8,8-1.,8-14,9,abaxiall,abaxially,acumen,acuminate,acute,adaxially,apex,apical,apically,articulate,atenuate,base,branched,broadly,calyx,cell,cm,conical,connate,cordate,corolla,covering,cuneate,cyme,darker,deep,dehiscent,diameter,dichasial,dichasially,digestion,diminishing,distal,dorsally,eaf,ebracteate,edge,eed,elliptical,emoval,enzyme,equal,exceeding,filament,first,flat,flower,folded,forked,generally,globo,gradually,green,green-white,hair-like,half,herbaceous,honeycomb,interjected,introrse,lateral,leaf,leaflet,light,living,lobe,lon,long,lower,lunat,make,maturing,medium,mm,monochasial,mucilaginous,nflorescence,nther,oblique,odd-pinnate,often,orolla,ovate,ovoid,pair,pattern,pedicel,peduncle,perennial,perfect,petiole,plan,plant,poricidally,proximal,puberulent,pubescent,reveal,rotate,ruit,seed,sessile,seudostipule,short,size,slit,specimen,stamen,stigma,straight,strigose,style,tal,tem,terminal,testal,thick,throughou,throughout,toward,truncate,tuber-bearing,two,typically,unit,vary,violet,wall,wide,yellow,ympodial,Â¼	
210	wfo-0001028280	success	87	113	71	16	42	0.816	.5,0.7-1,1-2,1-2-flowered,2-2.5,2-3,7-8,acuminate,almost,anthesi,apex,arching,attenuate,axil,bark,base,berry,branch,ciliate,closely,cm,completely,dark,decurrent,dia,elliptic,flattened,fruiting,glabrous,globose,green,immature,known,lanceolate,lateral,leaf,long,main,margin,middle,minutely,mm,narrowly,new,older,onto,opposite,pair,papillae,pedicel,pendant,petiole,present,rounded,scar,shrub,simple,small,somewhat,spaced,stem,surface,tall,tip,ultimate,unit,vein,widest,winged,woody,young	1.5-2.7,6-9,ape,brow,eaf,eed,know,lon,lower,nflorescence,ruit,sessil,ud,unifoliat,x,ympodial	abaxial,adaxial,anther,arrangement,branching,brown,bud,calyx,characteristic,colour,corolla,diameter,filament,flower,form,fruit,growth,height,history,inflorescence,length,life,lobe,midvein,null,ovary,peduncle,plant,primary,pseudostipule,rachi,seed,sessile,shape,staman,style,sympodial,tertiary,texture,unarmed,unifoliate,venation
211	wfo-0001028281	success	267	166	149	118	17	0.558	-0.9,-1,-3,-45,-5,-8,.2,.4,0.15-0.2,0.2-0.5,0.2-0.7,0.3-1,0.5-0.7,0.5-1,0.7-,0.7-1.2,0.75-1,1,1-,1-1.5,1-3,1.0-1.6,1.1-1.4,1.5-2,1.5-6,10-30,2-4,2-locular,2.1-3.0,2.5-,20-30,6,6-15,abaxial,abaxially,acuminate,acute,adaxial,almost,anther,apex,appearance,appressed,articulation,base,basiscopically,bract,bracteate,branching,brown,calyx,cell,cm,conical,corolla,dark,darker,decreasing,deep,densely,diameter,distal,doubly,dry,eglandular,elliptic,entire,extended,filament,flower,form,fruit,giving,glabrous,glandular,globose,golden,green,hair-like,half,head,imparipinnate,inflorescence,interjected,interrupted,large,largest,lateral,leaf,leaflet,like,lobe,long,margin,material,medial,midvein,mm,multi-cellular,narrowly,oblique,obovate,occasionally,once-branched,orbicular,outgrowth,ovary,ovate,pale,paler,patent,pedicel,peduncle,petiole,point,primary,proximal,pseudostipule,pubescent,rachi,regularly,serrate,shorter,shrub,silky,size,sometimes,sparsely,sprawling,stem,stripe,style,surface,terminal,tertiary,testa,thick,tip,toward,trichome,uniseriate,usually,vein,vine,wall,weak,wide,winged,yellow	+,-10,-20,-36,-7,.5,0.05-0.4,0.1-0.15,0.2-0.3,0.3-0.5,0.5-,0.5-0.6,0.5-1.1,0.5-1.2,0.7-2.5,0.8-1,1-5,1.1-2.4,1.2-1.5,1.2-1.6,1.4-4,1.7-2.5,10-18,2-13,2-4-celled,2-6.5,3-16,3-5,3-8.5,3-foliate,5-8-celled,7-30,absent,alternate,anthesi,apical,appendage,arising,autogamous,axi,bent,berr,blade,broadly,capitate,column,composed,covering,decurrent,developed,eaf,edicel,eed,either,elongate,elongate-triangular,enclosing,exerted,exserted,fragile,free,fruiting,generally,gland,gree,hal,halfway,included,internode,less,lon,longest,lower,minute,mixture,multi-celled,multicellular,nflorescence,node,opposite,other,pair,petiolule,population,portion,present,primarily,probably,rest,rotate,ruit,secondary,serrat,sessile,set,small,smaller,smooth,sparser,staminal,sterile,stiff,stigma,straight,strongly,subopposite,tem,thin,three,transparent,tube,type,ud,unicellular,unit,weak-walled,well,ympodial	arrangement,characteristic,colour,growth,height,history,length,life,null,plant,seed,shape,staman,texture,true,unarmed,venation
212	wfo-0001028317	success	204	151	127	77	24	0.623	-1.5,-5,0,0-1,0.1-0.3,0.3-1,0.6-0.8,0.6-1.2,0.6-1.5,0.8-1.1,1-1.3,1-3,1-4,1.4-2,1/3-1/4,1/5,2-2.8,2-4,2-4.5,2.8-3.3,2/3,3-4,3-5,4-6,5-8,acute,anther,apex,apically,apparently,articulated,base,berry,blade,branched,bright,broad-deltate,calyx,chartaceous,cm,concolorous,cream,cuneate,curved,dark,deltate,densely,diameter,difoliate,distance,drying,dull,erect,extending,eye,filament,filiform,flattened-reniform,flower,free,fruit,green,herb,infructescence,lanceolate,lateral,leaf,length,lobe,lobed,long,longer,lower,margin,marking,maturity,mauve,midvein,mm,moderately,naked,obtuse,one,open,orange-brown,ovate,pair,pale,pedicel,peduncle,per,petiole,portion,prickly,primary,purple,red,rounded,scandent,shrub,side,simple,sometimes,sparsely,spherical,stellate-pubescent,stem,straight,style,surface,terete,terminal,tertiary,time,tip,toward,truncate,unarmed,upper,vein,venation,visible,white,wide,yellow,yellow-green,young	/5,0-5,0.1,0.1-0.25,0.1-0.4,0.3-0.4,0.5-3.5,0.8-2.5,1.1-1.9,1.8-2.5,1/,1/4-2/3,2.5-6.5,3-10,4-5-merous,4-8,6-10,abaxially,absent,acuminat,almost,alyx,apar,apart,bark,brow,brown,eaf,eed,elongating,equal,fruiting,geminat,glabrous,gray,hair,herbaceous,mature,midpoint,minute,nflorescence,oblong,older,orolla,oung,pendulous,perfec,pericarp,poricidal,porrect,prickl,prickle,ray,reduced,reflexed,ruit,scar,sessile,shorter,smooth,spaced,spreading,stalk,stalked,stellate,subsessile,tamen,tapering,translucent,trichome,tube,unarme,unit,variously,vary,way,ympodial	1/2,abaxial,acuminate,adaxial,arrangement,branching,characteristic,colour,corolla,form,growth,height,history,inflorescence,life,null,ovary,plant,pseudostipule,rachi,seed,shape,staman,texture
213	wfo-0001028323	success	164	182	152	12	30	0.927	-2,0.2-0.5,0.2-1,0.4-1.3,0.5,0.5-1,0.6-1,0.8,0.9-1.2,1,1-1.2,1-1.5,1-2,1.1-4.5,1.5,1.5-2.5,2-3,2-9,3,3-5,3-6,3.5-4,5-6,7.5-9,abaxially,absent,acute,along,anther,anthesi,apart,apex,apparently,appressed,articulated,attenuate,bark,base,berry,blue-green,brown,c.,calyx,capiatate,cell,cm,conical,coriaceous,corolla,cup-shaped,dark,deltate,dendritic,densely,diameter,drying,ellipsoid,elliptic,entire,erect,fading,filament,fleshy,flower,free,fruiting,glabrescent,glabrous,globose,grey,growth,included,inflorescence,internodal,lanceolate,leaf-opposed,lengthening,less,like,lobe,lobed,longer,main,margin,maturity,minute,minutely,mm,new,occasionally,ovary,ovate,ovoid,pair,pale,papillose,pedicel,peduncle,peg,perfect,pericarp,petiole,pitted,planar,pore,poricidal,portion,primary,proceed,pubescent,reddish,remaining,revolute,rounded,scar,scattered,shiny,shoot,short,shrub,simple,sinus,small,soft,sometimes,somewhat,soon,sparely,sparsely,splitting,stem,stigma,straight,style,surface,tearing,testal,thick,thin,tip,trichome,tube,tuft,uniseriate,unit,vein,violet,wall,way,white,woody,x	abscissio,ba,eaf,eed,glabrescen,lower,nflorescence,papillat,plurifoliat,ruit,ud,ympodial	abaxial,abscission,adaxial,arrangement,branching,bud,characteristic,colour,form,fruit,height,history,leaf,length,life,midvein,null,papillate,plant,plurifoliate,pseudostipule,rachi,seed,shape,staman,sympodial,tertiary,texture,unarmed,venation
214	wfo-0001028329	success	215	167	140	75	27	0.651	.5-3,/10-3/10,0-100,0.2-0.3,0.8-1.1,0.8-1.4,0.9-1.3,1-6,1.3-1.8,1.5-2.3,1.5-3.5,1.5-8,10-34,12,2-3,3-14,3-8,3/4,4-15,4-5,5-10,6-11,6-8,6-9,7-19,abaxially,acuminate,acute,adaxially,anther,apart,apex,articulated,asperous,axe,axillary,base,becoming,berry,blade,branch,branched,brown,calyx,closely,cm,conical,continued,corolla,cylindrical,deltoid,dendritic-echinoid,diameter,dichotomously,due,echinoid,entire,filament,finely,fleshy,flower,fruit,glabrous,granular,granular-tomentose,gray,green,growth,hair,honeycombed,lateral,leaf,length,lobe,lobed,long-attenuate,main,margin,midvein,minutely,mm,moderately,mostly,multangulate,obovate,obtuse,occasional,older,ovate,ovate-elliptic,pale,pedicel,peduncle,petiole,plurifoliate,porrect-stellate,present,pseudo-terminal,pubescent,rachi,reniform,reticulate-punctate,ripe,sessile,several,short-,short-stalked,shrub,side,simple,small,sometimes,spaced,sparsely,stalked,stellate,stellate-pubescent,stelliform,stem,style,subglobose,suborbicular,testa,thick,time,tomentose,tree,turning,unarmed,unit,usually,vein,velutinous,way,white,whitish,x,yellow,yellowish,young	.75-2,.75-5.75,1.0-1.4,1.1-2.5,1.3-2,1.5-2.75,2-4,2.2-3.9,2.6-5,2.75-4.5,3.75-7,absen,ag,angled,anthesi,apical-lateral,apparently,ba,bark,blunt-tipped,bud,chartaceous,dehiscing,dendritic-echinoi,distantly,distinct,eaf,eed,free,glabrescen,grooved,high,inserted,introrse,large,lengthening,long,longitudinally,lower,multangulat,nflorescence,obelliptic,oblong,obscured,orbicular,orolla,perfect,pore,rather,receptacle,relatively,ruit,runk,sessil,slightly,slit,sparse,stellat,stellate-rotate,stigma,subcapitat,suture,swollen,tamen,thickened,thin,tomentu,touching,toward,tube,unarme,vary,vestigial,wide,ympodial	abaxial,absent,adaxial,arrangement,branching,characteristic,colour,form,glabrescent,height,history,inflorescence,life,ovary,plant,primary,pseudostipule,seed,shape,staman,surface,sympodial,tertiary,texture,true,unspecified,venation
215	wfo-0001028337	success	195	160	134	61	26	0.687	-2,-2.5,-4,-6,.5,.8,0,0.3-0.5,0.4-0.7,0.4-0.8,0.7-0.9,0.7-1,1,1-1.8,1-2,1-3,1.5-3,1.8-2,1/8-1/4,2-2.2,2-4,3-4,4-5,5-25,5-6,abaxial,adaxial,anther,apart,apex,apically,apparently,articulated,base,berry,blade,branched,calyx,cm,color,connivent,cuneate,curved,dark,deltate,densely,diameter,entire,equal,erect,evenly,eye,filament,flattened-reniform,flower,free,fruit,gently,glabrescent,glabrous,glaucous,gray,green,green-brown,hair,inflorescence,infructescence,known,lateral,leaf,length,lobe,long,long-styled,longer,margin,marking,mature,mauve,minutely,mm,moderately,naked,narrow-oblong,older,one,open,orange-brown,pale,pedicel,peduncle,per,pericarp,petiole,pitted,poricidal,porrect-lepidote,portion,primary,reddish,rounded,scar,sessile,shallowly,shoot,short,shrub,simple,small,smooth,spaced,sparse,spherical,stellate-pubescent,stem,stout,straight,style,surface,tapering,terete,terminal,time,tip,toward,trichome,tube,unarmed,unit,vein,visible,white,wide,young	/3,0.05-0.15,0.05-1,0.1-0.3,1.5-4,1/2,1/3-2/3,1/4-1/3,11-16,15-50,5-8,5-merous,6-7,8-10,8-14,abaxially,acut,alyx,apar,ape,bark,chartaceous,conical,discolorous,drying,eaf,eed,elongating,fruiting,fused,glabrou,gray-brown,juvenil,juvenile,lobed,lower,midpoint,nflorescence,occasionally,orolla,oung,perfect,plurifoliat,porrect,prickle,prickly,ray,reflexed,ruit,short-styled,shorter,slender,staminate,stellate,strongly,tamen,unarme,usually,vary,way,ympodial	acute,arrangement,branching,characteristic,colour,corolla,form,growth,height,history,life,midvein,null,ovary,plant,plurifoliate,pseudostipule,rachi,seed,shape,staman,sympodial,tertiary,texture,true,venation
216	wfo-0001028339	success	195	148	120	75	28	0.615	.5,0.8-1.2,1-1.2,1-2,1-5,1.1-1.4,1.2-1.5,1.5,1.5-2,1.7-3.2,10-30-flowered,2.5-5,3.5-4,5-7,5-angled,8-10,8182,acuminate,acute,almost,anther,apex,appearing,base,beneath,berry,blue,broadly,brown,calyx,carpel,cm,corolla,covered,crystalline,cuneate,dark,decurrent,densely,dia,difoliate,distinctly,dried,dry,evenly,filament,filiform,flattened,free,glabrous,globose,grainy,greyish-brown,growth,large-celled,lateral,leaf,like,little,lobe,long,long-triangular,main,major,margin,minor,minutely,mm,mustard,oblique,obscure,occasionally,opposite,ovary,ovate,ovoid-reniform,papery,papillate,papillose,pedicel,petiole,pitted,portion,pulp,schwarz,secondary,septum,shrub,simple,slender,slightly,small,somewhat,spaced,sparsely,specimen,speckled,stem,straight,strong,strongly,style,surface,tapering,texture,tip,tree,trichome,tube,uniseriate,vein,venation,white,white-speckled,winged,woody,x,yellow,yellowish,young	0.05-0.1,1-1.5,10.2-18.5,3.4-5.5,43191,5.8-7.9,7-11,across,anthesi,appearance,appressed,attenuate,bark,becoming,bud,capitate,carinate,closely,connate,cup-shaped,deflexed,differing,eaf,edicel,eed,enclosed,epidermi,erect,exserted,fide,first,floccose,flower,frui,fruiting,geminat,glabrate,irregular,later,leave,lobed,lon,lower,middle,nearly,nee,nflorescence,older,one,overlappin,ovoid,planar,pore,poricidal,proximal,red-brown,reflexed,ruit,scar,shaped,shining,size,stigma,tall,tear-drop,tightly,tub,ud,unit,urceolate,white-lenticellat,white-papillo,wide,widest,ympodial	abaxial,adaxial,arrangement,branching,characteristic,colour,diameter,form,fruit,geminate,height,history,inflorescence,length,life,midvein,null,peduncle,plant,primary,pseudostipule,rachi,seed,shape,staman,tertiary,true,unarmed
217	wfo-0001028351	success	175	148	118	57	30	0.674	.2,.8,.8â1.0,0,0.1,0.2,0.5,0â,1.0â2.0,1.0â2.5,1.4â1.5,2.0â2.5,2.1â3.5,2/3,2â2.5,2â4,3,3.4â5.0,3â4,4,40,5.0,5.0â5.5,5.5â10.5,5â7,6.5â8.5,6â12,8â15,abaxially,absent,acute,adaxially,along,annual,anther,anthesi,apart,apex,articulated,base,becoming,blue,branching,brown,calyx,cell,cm,colour,cylindrical,densely,diameter,equal,filament,flattened,flower,fruit,glabrous,globose,green,hair,herb,lanceolate,leaf,like,lobe,lobed,long,lower,margin,midvein,mm,moderately,multicellular,narrowly,number,occasionally,opposed,ovate,pair,pale,pedicel,peduncle,perennial,perfect,petiole,pitted,plurifoliate,present,pubescent,regularly,serrate,shallowly,shiny,simple,slender,smaller,spaced,stem,stone,straight,style,surface,truncate,tube,unbranched,unicellular,uniseriate,unit,unknown,velutinous,white,wing,winged,woody,x,young,â,â3.0	0.6,1.0â,1.0â1.6,1.5â4.0,1.6â,10,2,2.0â5.0,5,adaxiall,ag,apical,axe,ba,basal,blade,capitate,chartaceous,clavate,connivent,convex,directed,distally,eaf,eed,erect,fleshy,geminat,glandular,indumentum,lamin,lon,longitudinal,m.,nfloresence,oblong,obtuse,opening,orolla,pentagonal,pore,probably,ruit,shaped,side,slit,sparsely,stigma,tal,tamen,tardily,teardrop,tem,time,vary,wide,ympodial	abaxial,adaxial,arrangement,characteristic,corolla,form,geminate,growth,height,history,inflorescence,lamina,length,life,mentioned,ovary,plant,primary,pseudostipule,rachi,seed,shape,staman,sympodial,tertiary,texture,unarmed,vein,venation,ye
218	wfo-0001028353	exception_thrown	177	0	0	177	0	0.0		.5,/3,0.2-0.4,0.5,0.5-,0.9-1.2,1,1-2,1-4,1.4-2,1.5-2,1.5-5,2,2-3,2-4,3,3-5,4-7,6-8,7,8-10,abaxially,accrescent,acute,age,along,anther,anthesi,apart,apex,area,base,becoming,beneath,berry,bluntly,bright,calyx,campanulate,capitate,cell,centre,ciliate,clasping,cm,coarsely,conical,cordate,corolla,cup-shaped,curved,dark,decreasing,decumben,deep,deeply,densely,diameter,difoliate,distally,dry,drying,eaf,edicel,eed,ellipsoid,elliptic,emarginated,erect,exerted,filament,fleshy,flower,fracturing,free,frui,fruiting,geminat,glabrous,globose,gree,green,greenish,growing,herb,heteromorphic,hollow,honey-comb,horn,horned,inserted,internodal,leaf,lengthening,less,like,lobe,lon,long,lower,m.,margin,material,midrib,minute,minutely,mm,nflorescence,nodding,often,open,outline,ovary,ovoid,pair,pale,papery,papillate,papillose,pedicel,peduncle,pericarp,petiole,pitted,plant,plump,point,pore,poricidal,portion,primary,principal,pubescent,purple,reddish,rhomboid,ripe,ruit,scar,scattered,sessil,sessile,shallow,short,simple,size,sleeve,slender,slightly,slit,somewhat,sparsely,stem,stigma,straight,strongly,style,surface,tan,testal,thin,tip,toothed,toward,trichome,truncate,tube,ud,uniseriate,unit,vein,wall,way,wrinkled,x,yellow,ympodial	
219	wfo-0001028390	success	147	144	109	38	35	0.741	-10,.5-3.3,0,0.5,0.5-1,0.5-1.5,0.5-2.5,1,1-2.5,1-3,1-5,1.5-2,1.5-3.5,1.5-5.5,10-15,3-4,3-5,4-11,4-5,5-7,7-8,abaxially,acute,adaxially,angled,apart,apex,apiculate,articulated,axe,base,blade,branched,calyx,cm,connivent,cuneate,curled,cylindrical,deltate,dendritically,dendritically-branched,dense,densely,diameter,directed,divided,eglandular,elliptic,entire,felty-pubescent,flower,forked,glabrous,gland,globose,hair,lanceolate,leaving,less,like,lobe,long,margin,midvein,mixed,mm,moderately,mostly,near,obtuse,occasionally,often,orange,ovate,pedicel,peduncle,peg,perfect,petiole,pore,pseudohair,pubescent,rachi,rarely,ripe,scar,short,shrub,simple,slightly,small,spaced,sparsely,stalked,style,subclavate,subcordate,time,tip,unbranched,unequally,usually,violet,white,white-pubescent,wide,x,yellow	2,2.5,6-many-foliat,7,9,absen,adaxiall,aggregate,cell,chartaceous,distall,eaf,eed,lon,lower,narrowly,nflorescence,nther,orolla,presen,puberulent,pubescen,radiu,ruit,ste,stellate,stigma,stone,subcapitat,subcoriaceous,tal,tem,triangular,truncate,tube,unit,vary,ympodial	abaxial,adaxial,anther,arrangement,branching,characteristic,colour,corolla,distally,filament,form,fruit,growth,height,history,inflorescence,leaf,length,life,mentioned,ovary,plant,present,primary,pseudostipule,seed,shape,staman,stem,surface,tertiary,texture,unarmed,vein,venation
220	wfo-0001028405	exception_thrown	149	0	0	149	0	0.0		0.4-0.5,0.5-3,1-4,1-9,1.3-8,1.5-6.5,10-11,2,2-2.5,2-3,2-4,3-20,3-4,3-6-foliat,3.5-10,3.5-6.5,4-11.5,4-6,6-7,7-14.5,8-15,9-15,abaxially,absen,acumen,acute,adaxially,apex,apical,apically,apiculate,articulate,attenuate,base,branched,calyx,cell,cm,conical,connate,corolla,covering,cyme,decurrent,dehiscent,diameter,dichasial,dichasially,digestion,diminishing,distal,dorsally,eaf,ebracteate,edge,eed,elliptic,elliptic-lanceolate,emoval,enzyme,exceeding,filament,flat,flower,folded,forked,generally,globo,gradually,green,green-white,hair-like,half,herbaceous,honeycomb,interjected,introrse,lanceolate,lateral,leaf,leaflet,living,lobe,lon,long,lower,lunat,make,maturing,mm,monochasial,mucilaginous,nflorescence,nther,oblique,oblong,odd-pinnate,often,orolla,ovate-elliptic,ovoid,pair,pattern,pedicel,peduncle,perennial,perfect,petiole,plan,plant,poricidally,proximal,puberulent,rachi,reveal,ruit,seed,seudostipule,short,short-acuminate,short-petiolate,size,slit,specimen,stamen,stellate,stigma,straight,style,subsessile,tal,tem,terminal,testal,thick,throughou,throughout,toward,tuber-bearing,typically,unit,vary,wall,whit,wide,without,yellow,ympodial,Â¼	
221	wfo-0001028429	exception_thrown	162	0	0	162	0	0.0		0.2-0.4,0.8-1.2,0.9-2.3,1-2.5,1-4,1.5-3,1.5-4,10-11,10-27,10.5-21,2-1.,2-3,2-4,2-8,2.5-12,2.5-4,2.5-7.5,2.7-3.6,3-6,3-6-foliat,4-14,5-12,6-18,6-28,7-7,abaxiall,abaxially,acumen,acuminate,acute,adaxially,apex,apical,apically,articulate,base,branched,broadly,calyx,cell,cm,connate,cordate,corolla,covering,cuneate,cyme,darker,dehiscent,diameter,dichasial,dichasially,digestion,diminishing,distal,dorsally,eaf,ebracteate,edge,eed,elliptical,emoval,enzyme,especially,exceeding,filament,flat,flower,folded,forked,generally,glabrescent,glabrous,globo,globose,gradually,green,green-white,greenish,hair,hair-like,half,herbaceous,honeycomb,interjected,introrse,lateral,leaf,leaflet,light,living,lobe,lon,long,long-attenuate,lower,lunat,make,maturing,medium,mm,monochasial,mucilaginous,narrowly,nflorescence,nther,oblique,obovate,odd-pinnate,often,orolla,ovate,ovoid,pair,pattern,pedicel,peduncle,pentagonal,perennial,perfect,petiole,petiolule,plan,plant,poricidally,proximal,reveal,rotate,ruit,scattered,seed,seudostipule,short,size,slightly,slit,specimen,spot,stamen,stigma,straight,style,tal,tem,terminal,testal,thick,throughou,throughout,toward,tuber-bearing,typically,unit,vary,vein,violet,wall,white,wide,yellow,ympodial,Â¼	
222	wfo-0001028436	exception_thrown	150	0	0	150	0	0.0		.5,0.2-0.4,0.5,0.5-1,0.8-1.5,1-2,1-2-celled,1-3,1.5,1.5-2,1.5-2.5,10-20,1st,2-3,2-4,2.5-3,2nd,4,5-10,5-12,5-15,5-8,7,8-12,abaxially,absent,abundant,acute,adaxiall,adaxially,along,anther,apex,apically,appearance,appearing,axe,base,berry,beyond,blade,brown,calyx,cell,center,chartaceous,ciliate,cm,connected,cordat,decurrent,deflated,dehiscent,diameter,difficult,dm,dried,due,eaf,edge,eed,elliptic,entire,evaluat,explosively,exserted,filament,fine,flat,flower,frui,fruit,fruiting,geniculate,glabrescen,glabrous,globose,hair,interpetalar,leaf,lengt,like,linear,linear-lancolate,lobe,long,lower,lying,margin,membranaceous,mm,moderately,much-branched,nearly,nflorescence,notch,oblong,often,older,orolla,oung,parallel,pedicel,peduncle,per,petiole,placenta,pointing,presence,pubescen,pubescent,rachi,radiating,raised,reaching,rhizomatous,ridge,rotate,ruit,running,shallow,shrub,small,sparsely,stamen,stem,stigma,structure,style,surface,swollen,tal,tamen,taproot,tear,thick,tissue,triangular,tube,two-celled,unbranched,unifoliate,unit,vary,white,wid,woody,wrinkled,x,ympodial	
223	wfo-0001028465	success	159	141	105	54	36	0.66	0.75,1-2,1-4,1.2-2,10,11-23,2-3,2-6,2-9.3,2.4-2.8,2.5-4,3-5,3-8,4.5-5.5,5-7,8-10,9-19,abaxially,acumen,acuminate,acute,adaxially,apex,articulate,attenuate,base,branched,broadly,calyx,cell,cm,corolla,covering,cuneate,cyme,decurrent,diameter,dichasial,dichasially,digestion,distal,ebracteate,elliptical,emoval,enzyme,exceeding,filament,flower,forked,generally,globose,green,green-white,hair-like,half,herbaceous,honeycomb,interpetalar,lateral,leaf,leaflet,living,lobe,long,make,medium,mm,monochasial,mucilaginous,oblique,odd-pinnate,ovoid,pattern,pedicel,peduncle,perennial,perfect,petiole,petiolule,plant,proximal,puberulent,pubescent,purple,rachi,rarely,reveal,seed,specimen,spot,stamen,stigma,straight,strigose,style,terminal,testal,thick,throughout,tuber-bearing,typically,unit,wall,white,Â¼	1.5-2.9,10-24,2,2-4,3-4,3-6-foliat,3.8-7,4-1.,4-8,7-15,apical,apically,connate,dehiscent,diminishing,dorsally,eaf,edge,eed,equal,first,flat,folded,globo,gradually,interjected,introrse,lon,lower,lunat,maturing,nflorescence,nther,often,orolla,pair,plan,poricidally,rotate,ruit,sessile,seudostipule,short,size,slit,tal,tem,tissu,toward,two,vary,wide,yellow,ympodial	'hair-like,3-6-foliate,abaxial,adaxial,anther,arrangement,branching,characteristic,colour,form,fruit,growth,height,history,inflorescence,length,life,lunate,margin,mentioned,midvein,ovary,primary,pseudostipule,shape,staman,stem,surface,sympodial,tall,tertiary,texture,tissue,unarmed,vein,venation
224	wfo-0001028468	success	255	167	139	116	28	0.545	-1.3,-10,-3,.3-0.4,.5,.5-1.5,.5-1.6,.6-1,/10-1/5,0.2-0.3,0.4-4,0.5-2,0.5-3,0.5-8,0.6-1.2,0.7-2.5,1,1.2-1.5,1.3-2,16,2-9,2.2-3,2.5-4,2.8-4.1,2/3-3/4,4-6,5-21,5-9,6-10,6-9,abaxially,acuminate,acute,anther,apart,apex,armed,articulated,attenuate,axe,base,becoming,berry,beyond,blade,blue,broadly,brown,calyx,clavate,cm,commonly,corolla,dark,densely,diameter,distally,exserted,extra-axillary,filament,flattened,flower,foveate,fruit,glabrescent,glabrous,gradually,gray,green,greenish,hair,increasing,lateral,length,light,lobe,lobed,long,lower,main,margin,midvein,mixed,mm,moderately,narrowly,oblique,oblong-conical,obtuse,orange,pair,pale,pedicel,peduncle,petiole,porrect-stellate,proximal,pubescence,purple,rachi,recurved,reticulate,rhombic,sessile,shallowly,short,short-stalked,shrub,side,somewhat,spaced,sparsely,stamen,stellate-pubescent,stem,style,subcuneate,subelliptic,subglobose,sublenticular,subreniform,subshrub,surface,terete,testa,thick,thicknes,time,triangular,unarmed,unbranched,unifoliate,unit,upper,usually,vein,wide,x,yellowish	-4,-5.5,-7,.1-0.2,.1-0.3,.1-0.4,.2,.2-0.4,.3,/4-1/3,0.05,0.1,0.2-0.6,0.2-1.5,0.4-1,0.5-3.3,0.5-3.5,0.6-2,0.8-3.5,1.5-2.2,1.5-3.1,1.6,1/3-1/2,1/5-1/2,2,20,3-4,4-9,accrescent,adaxially,along,appressed,ark,broad-based,bu,bud,c.,campanulate,cauline,central,chartaceous,compresse,compressed,connivent,d.,decreasing,density,directed,distal,distantly,dry,eaf,eed,ellipsoid,equal,fruiting,geminat,half,inserted,interpetalar,introrsel,lamin,laterally,longer,m.,midpoint,minutely,mostly,multangulat,multangulate,nflorescence,oblong-lanceolate,occasionally,older,orangish,orolla,ovate,overlapping,ovoid,papillo,per,perfect,pore,prickle,pubescent,ray,reduced,relatively,rotate-stellate,ruit,short-,similar,similarly,simple,slightly,specimen,stalk,stelliform,stigma,straight,subacuminate,subcapitate,subchartaceous,subsessile,tal,tamen,thick-stalked,tissue,touching,toward,tube,vary,way,yellow,ympodial,young	4-5.5,abaxial,adaxial,arrangement,branching,characteristic,colour,false,form,geminate,growth,height,history,inflorescence,leaf,life,mentioned,ovary,plant,primary,pseudostipule,seed,shape,staman,sympodial,tertiary,texture,venation
225	wfo-0001028470	success	185	110	77	108	33	0.416	0.25-0.75,0.9-2.2,1-12.3,1-2,12-44,2-10,2-7,2-8,2.1-3.9,3-10,4-7,acumen,acute,anther,apex,asymmetric,attenuate,base,basiscopic,berry,brownish,cell,cm,condition,corolla,covering,dark,deep,diameter,dot,drying,elliptic,filament,fresh,fruit,glabrescent,glabrous,green,green-white,greenish,hair,herb,lateral,leaf,light,lobe,make,medium,mm,mottled,mucilaginous,odd-pinnate,ovate,ovoid,pedicel,peduncle,petiole,petiolulate,plant,pubescent,purple,ripe,rounded,scarce,seed,short,side,sometimes,style,testal,thick,throughout,tissue,wall,wet,white,whitish	0-18,0.9-2.3,1-3,1.5-2.8,1.6-3.2,11.8-21,2-5,3-5,3.2-5.5,3.5-16,3.5-7,4-6,5-merou,5.5-11.6,6-33,abaxially,adaxiall,adaxially,ag,alyx,apart,apparently,articulated,axe,axillary,blade,bud,capitat,chartaceous,clavate,connivent,decreasing,digestion,distal,dorsally,eaf,edge,eed,end,enzyme,erec,exceeding,flat,flower,folded,forked,geminat,generally,glabrou,hair-like,hal,half,high,homostylous,honeycomb-shaped,interjected,lanceolate,leaflet,lengthening,living,long,lower,nflorescence,one,orbicular,orolla,pair,pentagonal,perfect,placed,plurifoliate,pore,poricidal,removed,ruit,sessile,seudostipule,size,slit,spaced,specimen,stamen,stigma,stolo,straight,subequal,subglabrou,substellate,subtending,tall,tamen,tem,terminal,tip,toward,tri-,tube,tuber,typically,unit,unwinged,usually,vary,wide,wing,x,yellow,ympodial	'hair-like,abaxial,adaxial,arrangement,branching,calyx,characteristic,colour,form,growth,height,history,inflorescence,length,life,margin,mentioned,midvein,ovary,primary,pseudostipule,rachi,shape,staman,stem,subglabrous,surface,tertiary,texture,true,unarmed,vein,venation
226	wfo-0001028476	success	246	176	155	91	21	0.63	-6,0.1-0.15,0.1-0.4,0.2-0.6,0.25-0.5,0.3-0.4,0.4-0.6,0.5,0.5-0.6,0.8-1.2,0.8-1.6,1,1-1.4,1-2-celled,1-4,1.1-1.5,1.8-2.5,12-30,2-6,2-foliate,2-locular,2.4-3,3-foliate,4-celled,5-15,6-,8-30,abaxially,abundant,acuminate,acute,age,almost,along,also,anther,apex,appearance,articulated,basal,base,basiscopically,bifurcate,bifurcation,bract,bracteate,branched,bright,brown,calyx,cell,cm,conical,corolla,dark,deeply,diameter,distal,ebracteate,elliptic,entire,especially,filament,first,flower,fortaleza,fruit,give,glabrescent,glandular,globose,green,hair-like,half,head,herb,imparipinnate,inflorescence,internode,interrupted,irregularly,lanceolate,largest,lateral,leaf,leaflet,less,like,lobe,lobed,long,margin,maturity,midvein,minute,minutely,mixed,mm,narrowly,node,numerous,oblique,obovate,occasionally,outgrowth,ovary,pale,pedicel,peduncle,perennial,petiole,population,primary,prominent,pseudostipule,puberulent,pubescence,pubescent,purple,rachi,rarely,regularly,rest,rounded,rÃ­o,scattered,short,silky,simple,sparsely,sprawling,stem,stiff,stripe,style,surface,tall,tertiary,testa,thick,tip,trichome,truncate,unicellular,uniseriate,unit,usually,vein,wall,weak-walled,white,wide,winged,woody,yellow	-1,-16,-20,-8,.05-0.1,.5,0-,0-0.5,0.15-0.2,0.15-0.4,0.2-0.3,0.2-0.5,0.25-0.4,0.3-0.5,0.3-0.7,0.3-1.2,0.4-0.5,0.4-1.5,0.5-1.7,0.7-2.5,1-1.2,1-1.5,1-2,1-6,1-celled,1.1-1.6,1.2-2.5,2,3-12,3-7,3.5-13,7-10,absent,acroscopically,alternate,anthesi,ape,apical,appendage,axi,becoming,capitate,column,curved,decurrent,diamete,eaf,edicel,eed,elongate,exserted,fruiting,gradually,gree,hal,hyaline,incurved,interjected,lon,lower,main,nflorescence,often,pair,petiolule,present,recurve,reflexed,ruit,secondary,sessile,set,sinus,slightly,smaller,spreading,staminal,stellate,sterile,stigma,straight,subopposite,tem,terminal,toward,tube,ud,uniformly,unpaired,wid,ympodial	abaxial,adaxial,arrangement,branching,characteristic,colour,form,growth,height,history,length,life,mentioned,plant,seed,shape,staman,sympodial,texture,unarmed,venation
227	wfo-0001028481	success	194	196	174	20	22	0.897	.1,.3,.5,0-2,0.1-0.2,0.15,0.5-1,0.6-1,0Â°,1-1.4,1-2,1-4,1.5,1.5-2,1.8-2.5,1/2-2/3,2-3,2.5-3,3,3-4,3-4.5,3-6,5.5-7.5,8,abaxially,absent,acuminate,acute,adaxially,age,almost,along,alyx,anther,anthesi,apex,apically,apparently,articulated,attenuate,bark,base,branch,branched,brown,canaliculate,chartaceous,clearly,close,cm,colour,conical,corolla,cuneate,cupular,deeply,delineated,deltoid,dendritic,dendritic-pubescent,density,diameter,different,dilated,discolorous,distributed,divided,domatia,dorsifixed,dry,drying,ellipsoi,elliptic,entire,equal,erect,evenly,except,extending,extent,eye,faint,filament,flaking,flat,flexuous,flower,free,glabrous,green,increasing,known,lamina,leaf,length,lengthening,less,liana,like,linear,lobe,lobed,lon,long,long-acuminate,longer,longitudinally,lower,m.,main,margin,midvein,mm,mostly,naked,narrowly,nther,oblique,oblong,occasional,often,orange-brown,orolla,ovate,pair,pedicel,peduncle,perfec,petiole,pore,poricidal,portion,primary,pubescent,rachi,raised,ray,reddish,ribbed,ridged,shortly,shrub,side,simple,sinus,size,slender,smoothly,sparsely,spreading,stem,style,surface,tearing,terminal,tertiary,thickly,tip,together,toward,trichome,tube,ud,unarmed,uneven,unknown,vein,venation,visible,white,wide,x,yellowish,young	1-3,3-3.5,apar,clavate,eaf,eed,know,nflorescence,plurifoliat,protruding,ruit,scar,see,small,smoot,stigma,stump,unit,vary,ympodial	abaxial,adaxial,arrangement,branching,calyx,characteristic,form,fruit,growth,height,history,inflorescence,life,mentioned,ovary,plant,pseudostipule,seed,seen,shape,staman,texture
228	wfo-0001028482	success	224	183	159	65	24	0.71	.1,.5,0,0.2,0.5-1,0.5-5,00,1-1.5,1-11,1-2,1-4,1.1-5,1.2-1.6,1.5-2,10,2-3,2-celled,3-12,3-4,4-5,5-25,6-50,7-14,acuminate,acute,adaxially,age,alternate,anther,anthesi,apex,apiculae,ascending,asymmetric,base,becoming,berry,bifid,bifurcate,bilobed,branched,bright,broadly,brochiodromous,brownish,bud,calyx,capitate,channeled,cm,coriaceous,corky,corolla,corrugated,creamy,curved,cymose,deciduous,deltate,diameter,diffusely,dry,drying,elliptic,emarginate,entire,exfoliating,filament,flattened-reniform,fleshy,flower,free,fresh,fruit,glabrous,glandular,globose,golden,green,growth,hard,impressed,incrassate,internodal,irregular,keeled,leaf-opposed,lengthening,less,lobe,long,margin,material,maturity,midvein,minutely,mm,new,nodding,obovate,occasionally,olive,ovary,pair,pale,pedicel,peduncle,per,pericarp,petiole,pitted,pore,poricidal,portion,primary,pubescent,reddish,revolute,shaped,shiny,short,simple,slightly,slit,small,sometimes,somewhat,soon,stem,stigma,stout,straight,style,subglobose,subpyramidal,surface,tan,tear-drop,tiny,tip,transparent,transversely,tree,trichome,truncate,tube,tuberculate,tuft,uniseriate,usually,vegetative,vein,venation,white,x,yellow,yellowish,young,Âµm	/3,0.5,0.7-1.1,1.5-3,abaxially,angled,bark,basal,berr,campanulate,chartaceous,circinate,closely,constriction,cucullate,deflexed,densely,difoliate,discolorous,distally,distinct,eaf,eed,ellipsoid,embryo,enlarged,exerted,expanding,fruiting,geminat,glabrou,grayish,halfway,heterostylous,individual,investing,lobed,lower,markedly,materia,midrib,minute,nflorescence,overlappin,papillat,pentamerous,petal,row,ruit,scandent,scar,size,spaced,sparsely,subcoriaceous,tightly,tub,twice,two,ud,unifoliate,unit,way,woody,ympodial	abaxial,adaxial,arrangement,branching,characteristic,colour,form,height,history,inflorescence,leaf,length,life,null,papillate,plant,pseudostipule,rachi,seed,shape,staman,tertiary,texture,unarmed
229	wfo-0001028487	success	195	135	102	93	33	0.523	0.3-0.7,0.9-3,1-2,1.4-1.7,10-4.3,10-41,15-28,2-4,2-6,2.5-3.5,3-10,3-19,3-5,4-7,5-6,abaxially,acumen,acuminate,acute,adaxially,anther,apart,apex,apparently,articulated,asymmetric,attenuate,axe,axillary,base,basiscopic,berry,brownish,bud,cell,central,cm,condition,coriaceous,corolla,covering,dark,deep,diameter,distal,drying,elliptic,filament,flower,forked,fresh,fruit,generally,glabrescent,glabrous,green,green-white,greenish,hair,half,herb,high,lateral,leaf,light,lobe,long,make,medium,mm,mucilaginous,odd-pinnate,ovate,ovoid,pedicel,peduncle,perfect,petiole,petiolulate,plant,purple,ripe,rounded,scabrous,scarce,seed,short,side,spaced,star,style,subtending,terminal,testal,thick,throughout,tissue,usually,wall,wet,white,whitish	0-9,0.4-1.5,1-3,1-3.2,1.1-1.5,1.7-7,2-4.8,3-4,3.4-7.8,4.6-13.6,5-merou,7.8-16.4,adaxiall,ag,along,alyx,arranged,bead,blade,capitat,clavate,connivent,considerably,decreasing,digestion,dorsally,eaf,edge,eed,enzyme,erec,exceeding,flat,folded,geminat,glabrou,hair-like,hal,homostylous,honeycomb-shaped,interjected,lanceolate,leaflet,lengthening,like,living,lower,moniliform,multiple,narrow,necklace,nflorescence,orbicular,orolla,pair,pentagonal,plurifoliate,pore,poricidal,removed,ruit,second,sessile,seudostipule,size,slit,smaller,sometimes,specimen,stamen,stigma,stolon,straight,subequal,subglabrou,substellate,tall,tamen,tem,tip,toward,tri-,tube,tuber,typically,unit,unwinged,vary,wide,wing,x,yellow,ympodial	'hair-like,abaxial,adaxial,arrangement,branching,calyx,characteristic,colour,form,growth,height,history,inflorescence,length,life,margin,mentioned,midvein,ovary,primary,pseudostipule,rachi,shape,staman,stem,subglabrous,surface,tertiary,texture,true,unarmed,vein,venation
230	wfo-0001028489	success	224	180	155	69	25	0.692	-0.6,-10,-2.5,-5,-6,0-10,0-15,0-20,0-3,0.1,0.2-,0.2-0.4,0.2-0.7,0.3-0.5,0.3-1,0.3-1.2,0.5-0.8,0.5-1.1,0.5-1.5,0.6-1.2,0.7-3,1-3,1-4,1.5-3,1.5-4,1.8-2.2,1.8-4,1/3,1/4-1/2,2-3,2-4,2-6,2.1-3,3-7,3.5-6,4-8,5-25,7.5,acute,anther,apex,apically,apparently,articulated,base,berry,blade,branched,calyx,cell,chartaceous,cm,concolorous,cordate,cream,cuneate,curved,dark,deltate,diameter,difoliate,distance,drying,dull,elliptic,erect,extending,eye,filament,flattened-reniform,flower,free,fruit,glabrous,green,infructescence,lateral,leaf,length,less,lobe,lobed,long,longer,margin,marking,maturity,mauve,membranous,midpoint,midvein,mm,moderately,naked,obtuse,occasionally,one,open,orange,orange-brown,outline,ovate,pair,pale,pedicel,peduncle,per,pericarp,petiole,porrect,portion,prickle,prickly,primary,purple,raised,ray,red-brown,rounded,sessile,shiny,shrub,side,simple,slender,smooth,sometimes,sparsely,spherical,stalk,stellate,stellate-pubescent,stem,style,subsessile,surface,terete,tertiary,time,toward,trichome,truncate,tube,unarmed,unit,upper,vein,venation,visible,weakly,white,wide,yellow,yellow-green,young	-4,/4,0-50,0.1-0.6,0.2,0.2-0.5,0.2-0.6,0.3-0.7,0.4-0.8,0.5-1,1-6,1-7,1.8-5.5,1/3-1/2,4-10,4-13,5-8,5-merous,abaxially,acicular,alyx,apar,apart,ba,bark,beyond,broad-deltate,caudat,connivent,densely,eaf,eed,elongating,equal,fruiting,geminat,gray,hair,herbaceous,lon,lower,mature,minute,nflorescence,often,older,orange-green,orolla,oung,pendulous,perfec,perpendicular,poricidal,protruding,ruit,scar,spaced,spreading,straight,tamen,tapering,tip,unarme,vary,way,white-gra,woody,yellow-orange,ympodial	abaxial,adaxial,arrangement,branching,caudate,characteristic,colour,corolla,form,geminate,growth,height,history,inflorescence,life,null,ovary,plant,pseudostipule,rachi,seed,shape,staman,sympodial,texture
231	wfo-0001028492	success	130	132	95	35	37	0.731	0.2-2,0.5-1,1-2.5,1-4,1-5,1.5-2.5,1.5-3,1.5-6,1.75-3.5,15-20,2-2.5,2-5,2.5-9,3,3-6,4,5-15,5-25-flower,5-8,6-11,8-15,abaxially,acute,adaxially,angled,apart,apex,apiculate,articulated,axe,axi,base,blade,calyx,cell,cm,colored,containing,crystal,cylindrical,dark,deltate,diameter,elliptic-ovate,entire,except,forked,fruit,glabrous,globose,hair,herb,irregularly,leaving,lobe,long,margin,mm,obtuse,pedicel,peduncle,petiole,pubescent,punctate,purple,rachi,radiu,rarely,reticulate,ripe,rounded,sand-punctate,scar,shrub,simple,somewhat,spaced,sparse,splitting,style,subcordate,subcoriaceous,succulent,time,tip,unbranched,unevenly,unit,veiny,white,white-punctate,whitish,wide,x,x1-3	-5-foliat,2-3,2-4,6-12,absen,aggregate,chartaceous,ciliolate,color,connivent,directed,distall,eaf,eed,glabrou,lower,narrowly,nflorescence,nther,orolla,pore,ruit,san,stellate,stigma,stone,tal,tem,triangular,triangular-ovate,truncat,tube,unknown,vary,ympodial	-5-foliate,abaxial,adaxial,anther,arrangement,branching,characteristic,colour,corolla,filament,form,growth,height,history,inflorescence,leaf,length,life,midvein,null,ovary,plant,primary,pseudostipule,sand,seed,shape,staman,stem,surface,sympodial,tall,tertiary,texture,unarmed,vein,venation
232	wfo-0001028501	success	195	120	88	107	32	0.451	0-3.2,0.3-0.7,0.8-1.7,1-2,1-8,1.8-10.7,13-41,2-4,2.8-4.9,3-10,3-5,4-8,8-10,abaxially,acumen,acuminate,acute,adaxially,anther,apart,apex,articulated,base,berry,brownish,cell,cm,condition,coriaceous,corolla,covering,dark,decurrent,diameter,distal,drying,filament,fresh,fruit,glabrescent,glabrous,green,green-white,greenish,hair,half,herb,high,lateral,leaf,light,linear,lobe,long,make,medium,mm,mottled,mucilaginous,narrowly,odd-pinnate,onto,ovate,ovoid,pedicel,peduncle,petiole,plant,purple,pyriform,rachi,ripe,scarce,seed,short,simple,sometimes,spaced,spot,style,testal,thick,throughout,usually,wall,wet,white,whitish	0-3,0-4,0.3-3.3,0.6-5.8,0.8-1.6,1,1-3,2-5,2.8-18,3-7,3.1-10.4,3.1-12,4.8-18,5-merou,6.6-21.1,8-34,adaxiall,ag,along,alyx,apparently,arranged,attenuate,axe,axillary,bead,blade,broadly,bud,capitat,clavate,connivent,considerably,decreasing,digestion,dorsally,eaf,edge,eed,elliptic,enzyme,erec,exceeding,flat,flower,folded,forked,geminat,generally,glabrou,hair-like,hal,homostylous,honeycomb-shaped,interjected,lanceolate,larger,leaflet,lengthening,like,living,lower,moniliform,multiple,narrow,necklace,nflorescence,orbicular,orolla,pair,perfect,plurifoliate,pore,poricidal,present,removed,rotate,ruit,sessile,seudostipule,size,slit,specimen,stamen,stigma,stolon,straight,subglabrou,subtending,tall,tamen,tem,terminal,tip,toward,tri-,tube,tuber,typically,unit,unwinged,vary,wide,wing,x,yellow,ympodial	'hair-like,abaxial,adaxial,arrangement,branching,calyx,characteristic,colour,form,growth,height,history,inflorescence,length,life,margin,midvein,null,ovary,primary,pseudostipule,shape,staman,stem,subglabrous,surface,tertiary,texture,true,unarmed,vein,venation
233	wfo-0001028502	success	158	106	77	81	29	0.487	0.5-1,1.5-2,1.5-2.5,1.5-3,1.6-2.4,2-4,2-5,2-7,2-8,3.5-4,5-15,6-8,?,abaxial,abaxially,acute,adaxially,along,anther,apex,base,beige,branched,calyx,christmas-tree-like,cm,congested,corolla,deltate,densely,denser,elliptic,fawn,filament,flattened-reniform,flower,glabrous,globose,impressed,incrassate,inflorescence,lateral,leaf,light,like,lobe,long,main,margin,matted,minutely,mm,often,ovary,pair,pedicel,petiole,pitted,prominent,pubescent,reddish-brown,rest,scattered,seed,shining,shrub,small,stem,style,surface,time,tree,tree-like,trichome,vein,warty,white	.5,/2,1-2,1.5-6,2-2.5,3.5-15,5-6,age,anthesi,apar,ba,bark,blade,body,branch,brown,campanulate,cazalet,clavate,closely,cone,constricted,dark,dendritic,dia,eaf,edicel,eed,erect,exserted,fide,flat,fleshy,free,fruiting,glabrat,heteromorphic,included,inflorescenc,later,lengthening,lobed,lon,long-styled,lower,middle,narrower,nflorescence,obovate,older,packed,papillo,papillose,planar,plurifoliat,pore,poricidal,portion,ruit,scar,short-styled,slit,spaced,stigma,structure,tall,terminal,thick,tip,tub,tube,ud,unclear,unevenly,way,wide,widest,within,woody,ympodia,young	4-6,adaxial,arrangement,branching,characteristic,colour,diameter,form,fruit,growth,height,history,length,life,midvein,null,peduncle,plant,plurifoliate,primary,pseudostipule,rachi,shape,staman,tertiary,texture,true,unarmed,venation
234	wfo-0001028505	success	168	125	100	68	25	0.595	.1,.3,.5,/3,0.25-0.5,0.8-1,0.8-1.5,1,1-3,10-14-flowered,2,3-5,7-8,acuminate,acute,anther,anthesi,apex,aspect,barely,basal,base,beneath,berry,body,broadly,calyx,characteristic,cm,conical,corolla,darker,decurrent,deflexed,delicate,deltoid,dia,differentiated,drying,elliptic,erect,f,filament,flattened,free,gently,glabrous,globose,green,grey,incrassate,lateral,leaf,lobe,lobed,long,main,major,margin,minor,minutely,mm,narrowly,opposite,ovary,ovate,ovoid-reniform,pair,pale,papillose,pedicel,petiole,pitted,plant,portion,prominent,pubescent,rounded,seed,shape,short,shrub,simple,somewhat,stem,style,surface,tan,tapering,tip,trichome,truncate,tube,unicellular,uniseriate,vein,way,white,x,yellowish	.01,1.2-2.5,1/3,10-15,2.5-4.5,3.5-5,ba,bark,black,blade,branch,bright,bud,deciduous,differing,difoliate,distance,distinct,dried,dry,eaf,edicel,eed,expanded,exserted,exsertion,fruiting,geminat,greatly,live,lon,lower,m.,materia,material,member,minute,nflorescence,obovoid,obvious,older,overlapping,pore,poricidal,proximal,purple,reflexed,ruit,scar,shaped,size,slightly,soon,specimen,stigma,straight,strongly,tall,tear-drop,touching,ud,unit,usually,whit,widest,woody,ympodial,young	abaxial,adaxial,arrangement,branching,colour,diameter,form,fruit,growth,height,history,inflorescence,length,life,mentioned,midvein,peduncle,primary,pseudostipule,rachi,staman,tertiary,texture,unarmed,venation
235	wfo-0001028524	success	236	241	213	23	28	0.903	-2.7,-3,.5-1,/10-3/10,0-150,0.3,0.3-0.8,0.5-3.5,0.6-1.4,1-5,1.1-1.2,1.2-1.3,1.5-1.6,1.5-3,1.8-2.5,1/3-2/3,10-20,11,2-3.8,2-6,2.5-3.4,2.5-3.8,2.5-4,2.8-3.5,3-10,3-15,3-4.3,3.3-4,3.4-3.6,4-6,4-8,4.3-6,6-7,6-9,7-10,7-11,8-13,9-14,abaxially,accrescent,acuminate,acute,adaxially,along,anther,anthesi,apart,apex,apical-lateral,apparently,articulated,ascending,axe,axillary,base,becoming,berry,blade,blunt-tipped,branch,branched,brown,bud,calyx,chartaceous,closely,cm,conical,continued,corolla,cream,dark,dehiscing,deltoid,densely,diameter,distal,dm,due,echinoid,elliptic,entire,exserted,extend,ferrugineous,few-,few-rayed,filament,first,fleshy,flower,free,fruit,fruiting,glabrescent,glabrous,granular-tomentose,gray,green,greenish,growth,hair,half,honeycombed,indument,inserted,interpetalar,introrse,lacking,lanceolate,large,late,later,lateral,leaf,length,lobe,lobed,long,longitudinal,many-rayed,margin,matted,midvein,mixed,mm,multangulate,nearly,oblong,obscured,obtuse,often,older,orbicular,ovate,ovate-lanceolate,overlapping,pale,partly,pedicel,peduncle,perfect,persistent,petiole,plurifoliate,pore,porrect-stellate,present,probably,prominent,pseudo-terminal,pubescent,rachi,rather,ray,relatively,reniform,reticulate-punctate,ripe,rounded,scabridulous,sessile,short,short-stalked,side,simple,slightly,slit,small,somewhat,spaced,sparingly,sparsely,stalked,stamen,stellate,stelliform,stem,stigma,stout-stalked,strongly,style,subcoriaceous,subglobose,suborbicular,sulcate,suture,terete,testa,thick,thick-stalked,thin,thin-stalked,time,tissue,tomentose,touching,translucent,tree,tube,unarmed,unit,usually,vein,velutinous,warty,way,wide,x,yellow,yellowish,yellowish-green,young	ag,ba,bark,capitat,eaf,echinoi,eed,glabrescen,high,lanceolat,lower,m.,main,midvei,nflorescence,orolla,ruit,runk,tamen,tomentu,unarme,vary,ympodial	abaxial,adaxial,age,arrangement,branching,capitate,characteristic,colour,form,height,history,inflorescence,life,ovary,plant,primary,pseudostipule,seed,shape,staman,surface,sympodial,tertiary,texture,tomentum,true,unspecified,venation
236	wfo-0001028525	success	257	175	155	102	20	0.603	0.2-0.3,0.5,0.5-1.5,0.5-2.5,0Â°,1-2,1-2.5,1-4,1.1-1.7,1.2-1.6,1.5,1.5-3,1/3-3/4,10,10-13,1mm,2,2-2.5,3,3-5,3-7,4,4-5,4-7,6,7-13,7.5,accrescent,acuminate,acute,anther,anthesi,apart,apex,apically,around,articulated,attenuate,base,becoming,berry,black,brachyblast,branch,branched,branching,brown,calyx,clustered,cm,conical,cordate,corolla,cup,deltoid,dendritic,dendritic-pubescent,densely,detaching,developed,developing,diameter,dilated,drying,elongated,entire,erect,fertilisation,filament,fine,flat,flattened,flexible,flower,form,forming,frequently,fruit,fruiting,glabrous,green-brown,grey,known,lateral,leaf,leave,less,liana,light,like,linear,lobe,long,longitudinally,loop,loose,lumpy,main,margin,mature,mauve,midvein,mm,often,orange-brown,ovate,pair,partly,pedicel,peduncle,pendulous,pericarp,petiole,primary,pubescent,pyriform,rachi,red-brown,ridged,rounded,scar,shrub,side,slender,slightly,small,sometimes,somewhat,soon,spheroidal,spreading,stem,stigma,stump,style,surface,terete,terminal,tertiary,thin,tip,toward,trichome,truncate,unarmed,vein,venation,visible,weakly,well-developed,white,whitish,wider,x,young	.25,.4,0.2-0.6,1-1.5,2-3,2.5-5,4-15,7,age,almost,along,alternate,alyx,apar,apice,apparently,axil,bark,broadly,capitate,centre,chartaceous,clavate,clearly,clum,curved,dark,deeply,delineated,density,discolorous,divided,domatia-like,dorsal,dorsifixed,eaf,eed,ellipsoi,equal,eye,fewer,flexuous,formed,free,frui,glabrescent,increasing,inside,lamina,laterally,lengthening,lobed,longer,lower,m.,membranous,minute,much,multicellular-dendritic,naked,narrowly,nflorescence,nther,obconical,oblong,obscuring,one,orolla,outside,overlapping,ovoid,perfec,plurifoliat,pore,poricidal,portion,prominent,protruding,puberulous,ray,ruit,scattered,sessile,simple,sinus,size,smaller,smoot,smooth,sparsely,stripe,structure,tangling,tearing,thick,tube,ud,uneven,unit,vary,wide,ympodial	15-30,abaxial,adaxial,arrangement,characteristic,colour,growth,height,history,inflorescence,length,life,ovary,plant,seed,shape,specified,staman,texture,true
237	wfo-0001028528	success	155	127	101	54	26	0.652	.5,0.9-1.2,1.1-1.2,1.5,2-3,2-4,2.5-3,3.5-4,4-5,4-6,6-10,6-7,8-9,?,abaxial,acuminate,acute,adaxial,along,anther,apex,apical,attenuate,basal,base,berry,blackish,branch,branching,calyx,cm,conical,coriaceous,corolla,decurrent,dendritic,densely,diameter,elliptic,erect,filament,flattened,flower,fork,free,glabrous,glandular,globose,growth,immature,impressed,later,leaf,like,lobe,long,margin,midvein,minute,minutely,mm,mucronate,narrowly,obovate,occasionally,outline,ovary,pair,pedicel,pericarp,petiole,pitted,plurifoliate,portion,pubescent,pyramidal,reddish-brown,revolute,round,secondary,shiny,shrub,sparsely,stem,strongly,style,surface,tall,tapering,terminal,thin,time,triangular,trichome,tube,unit,vein,violet,wide,x,young	1-2,1.8-2,3.5-6,3/4,absent,adaxially,age,anthesi,ba,bark,becoming,bi-lobed,denser,dichasia,eaf,edicel,eed,ew,except,exserted,fruiting,glabrat,inserted,leave,lobed,lower,m.,nflorescence,nodding,older,papillo,per,petal,planar,pore,poricidal,prominent,ruit,scar,short,sleeve,slit-like,somewhat,stamen,ste,stigma,tip,tub,ud,way,white,winged,woody,ympodial	arrangement,characteristic,colour,dichasial,form,fruit,glabrate,height,history,inflorescence,length,life,null,peduncle,plant,primary,pseudostipule,rachi,seed,shape,staman,sympodial,tertiary,texture,unarmed,venation
238	wfo-0001028529	success	164	115	84	80	31	0.512	0.1,0.5,0.5-2,0.8-1.3,1,1-1.2,1-1.5,1.5,2.5-3,3-40-flowered,5-6,acuminate,age,anther,apex,apiculate,attenuate,base,becoming,beneath,berry,bluish,brown,calyx,cast,cm,corolla,course,dark,decurrent,deltoid,dia,erect,filament,fruiting,furcate,glabrous,globose,green,growing,immature,internodal,lanceolate,leaf,less,lobe,long,metallic,minutely,mm,narrowly,nearly,oblanceolate,occasionally,opposite,ovary,ovoid-reniform,papillose,pedicel,petiole,pitted,prominent,river,shape,shrub,simple,slender,slightly,smooth,somewhat,stem,style,subshrub,surface,tapering,tip,tube,umbonate,vein,white,winged,woody,x,yellowish	.2,0.8-3,0.8-3.2,2/3,3-5,6-9,7-8,8-14,across,acute,anthesi,apart,bark,beginning,bud,capitate,close,cork,deflexe,distal,eaf,edicel,eed,ellipsoi,elliptic,evenly,exfoliating,exserted,flower,free,heterostylous,hrub,hyaline,indistinct,inflorescenc,lateral,lenticellat,linear,lobed,lon,lower,main,major,middle,minor,minute,much,nflorescence,older,one,pair,paler,papillae,papillo,planar,pore,poricidal,portion,present,range,reflexed,ruit,scar,scattered,shaped,short,size,small,soon,spaced,species,stigma,straight,tall,tear-drop,ud,variable,way,widest,young	abaxial,adaxial,arrangement,branching,characteristic,colour,corky,deflexed,diameter,form,fruit,growth,height,history,inflorescence,length,life,margin,midvein,null,peduncle,plant,primary,pseudostipule,rachi,seed,staman,tertiary,texture,unarmed,venation
239	wfo-0001028532	success	186	111	78	108	33	0.419	0.2-1,1-1.7,1-2,1-3,1.3-8.7,17-42,2-3,2-8,2.2-4.2,3-10,3-7,4-7,5-9,abaxially,acuminate,acute,adaxially,anther,apex,articulated,attenuate,base,berry,brownish,cell,cm,condition,corolla,covering,dark,deep,diameter,drying,filament,fresh,fruit,glabrous,globose,green,green-white,greenish,herb,lanceolate,lateral,leaf,lobe,long,make,medium,mm,mottled,mucilaginous,odd-pinnate,ovate,ovate-lanceolate,ovoid,pedicel,peduncle,petiole,petiolulate,plant,purple,ripe,rounded,seed,slightly,sometimes,spot,straight,style,testal,thick,throughout,usually,wall,wet,white,whitish	0-19,1-1.6,1-5,1.4-1.6,15-36,2-6,3-5,3.3-4.4,3.9-5,5-merou,5.5-15,6.5-9.2,7.5-15.2,abaxiall,acumen,ag,along,alyx,apart,apparently,arranged,asymmetric,axe,axillary,basiscopic,bead,blade,bud,capitat,chartaceous,clavate,connivent,decreasing,digestion,distal,dorsally,eaf,edge,eed,enzyme,erec,exceeding,flat,flower,folded,forked,geminat,generally,glabrou,hair-like,half,homostylous,honeycomb-shaped,interjected,larger,leaflet,lengthening,like,linear,living,lower,middl,moniliform,multiple,necklace,nflorescence,orbicular,orolla,pair,pentagonal,perfect,plurifoliate,pore,poricidal,removed,rotate,ruit,second,sessile,seudostipule,side,size,slit,spaced,specimen,stamen,stigma,stolon,subequal,subtending,symmetric,tall,tamen,tem,terminal,tip,tissue,toward,tri-,tube,tuber,typically,unit,unwinged,vary,x,yellow,ympodial	'hair-like,abaxial,adaxial,arrangement,branching,calyx,characteristic,colour,form,growth,height,history,inflorescence,length,life,margin,mentioned,middle,midvein,ovary,primary,pseudostipule,rachi,shape,staman,stem,surface,tertiary,texture,true,unarmed,vein,venation
240	wfo-0001028547	exception_thrown	224	0	0	224	0	0.0		-1/2,-13,-3,-6,.2,.5,.7,.8,/2,/5,0,0-1,0-10,0-15,0-2,0-30,0-5,0.05-0.15,0.1-0.2,0.15,0.2-0.35,0.3-0.4,0.5-,0.7-1,0.8-1,1-2,1-2.5,1-4,1-5,1.2-1.4,1.5-2.5,1.7-2,1/3,1/5-1/4,10-12,2-1.5,2-2.5,2-4,2-6,2.5-2.8,2.8-3.2,3-5,3.5-4.5,4-5,4-6,5-merous,6-8,7-10,7-9,abaxial,abaxially,absent,acute,adaxial,alyx,anther,apar,apart,ape,apex,apically,apparently,appearing,articulated,bark,base,berry,blade,branched,branching,bright,bulbous,calyx,cell,chartaceous,cm,conical,connivent,cream,cuneate,curved,dark,deltate,densely,diameter,discolorous,distance,drying,dull,eaf,eed,elongate,elongating,entire,equal,erect,extending,faint,filament,flattened,flattened-reniform,flower,free,fruit,fruiting,gently,glabrescent,glabrou,glabrous,gray-brow,green,inflorescence,infructescence,lateral,leaf,length,lobe,lobed,lon,long,long-acuminate,long-styled,longer,lower,margin,marking,mature,maturity,mauve,midpoint,midvein,mm,moderately,narrow-deltate,nflorescence,oblong,occasionally,often,older,one,open,orange,orange-brown,orolla,oung,outline,ovate,pair,pale,pedicel,peduncle,pendulous,per,perfect,pericarp,petiole,pit,plurifoliat,poricidal,porrect,portion,prickl,prickle,prickly,primary,purple,raised,ray,red,reddish,reflexed,rounded,ruit,scandent,scar,sessile,shallowly,short-styled,shrub,side,simple,slender,small,smooth,sometimes,somewhat,spaced,spherical,spreading,stalk,stalked,staminate,stellate,stellate-pubescent,stem,straight,style,subsessile,surface,tamen,tapering,terete,terminal,tertiary,thin-acuminat,time,tip,trichome,truncate,tube,unit,usually,vary,vein,venation,villous,way,wide,woody,yellow,yellow-green,yellow-orange,ympodial,young	
241	wfo-0001028587	success	178	99	71	107	28	0.399	.4,.5,0.3-1,0.5-1,1-1.3,1-1.5,1-2,1-4,1/4,2.5,6-8,abruptly,acuminate,acute,anther,apex,base,berry,brown,calyx,cm,corolla,densely,distal,filament,flower,fruit,glabrous,globose,green,greenish-white,impressed,keeled,leaf,length,lobe,minutely,mm,narrowing,obe,obovate,occasionally,opposite,ovary,ovate,ovoid-reniform,papillose,pedicel,per,persistent,petiole,pitted,puberulent,pubesent,seed,shrub,simple,slender,slightly,sparsely,stem,style,subumbellate,surface,triangular,tube,umbonate,variable,vein,white,x	.75,0,0.3,0.5,0.7-1.2,0.8-1.6,0.8-1.8,0.8-2.9,1.3-5.1,2-5,2.1-6.9,3-8,6.5-17.7,8-10,8-10-flowered,accrescent,across,anthesi,bark,baseflower,becoming,ca,chartaceou,closely,coat,cracking,cup,deflexed,degree,dia,different,difoliate,drying,eaf,edicel,eed,ellipsoid,erect,forming,free,fruiting,geminat,geminate,lamina,lateral,layer,like,lobed,lon,long,long-styled,lower,main,major,middle,midrib,minor,minute,nearly,nflorescence,obovoid,often,older,open,outer,overlappin,pair,paler,papillo,peeling,pore,poricidal,portion,pubescence,pubescent,reflexed,ruit,scar,scattered,short,slit-like,spaced,stiff,stigma,straight,straw-colored,tall,terminal,thickened,thin,tip,transversel,trichome,two,type,ud,unicellular,uniseriate,unit,upon,upper,usually,wide,widest,woody,ympodial,young	abaxial,adaxial,arrangement,branching,characteristic,colour,diameter,form,growth,height,history,inflorescence,life,margin,midvein,null,peduncle,plant,primary,pseudostipule,rachi,shape,staman,tertiary,texture,true,unarmed,venation
242	wfo-0001028594	exception_thrown	142	0	0	142	0	0.0		.5,0-100,0.3-1.0,0.8-1.8,1-1.2,1-1.3,1-1.5,1-2,1-3,1.5-9,12,12-14,2,3-4,3-6,3-9,5-6,6-20,6-7,abaxially,acuminate,acute,adaxially,along,anther,anthesi,apex,axil,axillary,base,bearing,becoming,berry,black,bottle-shaped,calyx,capitat,cell,climbing,cm,conical,corolla,densely,denser,diameter,drying,eaf,edicel,eed,ellipsoid,elliptic,epidermal,especially,exserted,filament,flattened-reniform,floo,flower,forest,free,fruit,fruiting,glabrat,glabrous,globose,green,hair-like,herb,immature,inflorescenc,inflorescence,lax,leaf,length,like,lobe,lon,long,lower,margin,maturity,minute,minutely,mm,nflorescence,noddin,obtuse,often,open,orange-brown,ovary,ovate,pair,papillate,pedicel,pendent,per,petiole,planar,portion,primary,projection,pubescent,purple,quit,rectangular,reddish,reflexed,regular,rest,rounded,ruit,scar,scattered,side,simple,slightly,smooth,soft,somewhat,sparsely,spreading,stigma,strait,strongly,style,surface,tem,time,tip,trailing,trichome,tub,tube,ud,unifoliat,uniseriate,unit,vein,violet,x,ympodial	
243	wfo-0001028660	success	204	133	102	102	31	0.5	0.5-2.8,0.5-5.5,0.8-1,0.9-2.5,1-10,1-2,1.5-2.8,1.5-4,2-11,2-9,3-30,3-7,3-9,4-6,5-8,7-10,abaxially,acute,adaxially,anther,apart,apex,apparently,articulated,attenuate,axe,axillary,base,berry,blue,broadly,brownish,bud,cell,ciliate,cm,condition,corolla,covering,decurrent,densely,diameter,distal,drying,elliptic,entirely,filament,flower,forked,fresh,fruit,generally,glabrous,globose,green,green-white,greenish,hair,hair-like,half,herb,lateral,leaflet,like,linear,lobe,long,make,margin,mm,mucilaginous,narrowly,oblique,obtuse,odd-pinnate,ovoid,pedicel,peduncle,perfect,petiole,plant,pubescent,purple,ripe,scabrous,seed,short,spaced,sparsely,stem,style,subtending,terminal,testal,thick,throughout,tinged,usually,wall,wet,white,whitish	0-5,0.1-0.3,0.2-1.1,0.3-1.1,0.7-4.2,1.5-7.6,2-5,2-6,20,3-5,3.8-13,5-merou,6,absent,acumen,ag,along,alyx,blade,borne,capitat,chartaceous,clavate,connivent,decumbent,digestion,dorsally,dot,eaf,edge,eed,end,enzyme,erec,especially,exceeding,except,flat,folded,geminat,glabrou,greatly,homostylous,honeycomb-shaped,interjected,lanceolate,lengthening,less,living,lower,membranous,middl,midrib,minutely,nflorescence,often,orbicular,orolla,ovate,pair,pentagonal,petiolulate,petiolule,plurifoliate,pore,poricidal,proximal,puberulent,rarely,reduced,removed,rotate,ruit,scattered,sessile,seudostipule,singly,size,slit,specimen,stamen,ste,stigma,stolo,straight,subequal,substellate,sunny,tall,tamen,tem,tip,tri-,tube,tuber,typically,unit,unwinged,vary,x,yellow,ympodial	abaxial,adaxial,arrangement,branching,calyx,characteristic,colour,form,growth,height,history,inflorescence,leaf,length,life,middle,midvein,null,ovary,primary,pseudostipule,rachi,shape,staman,surface,tertiary,texture,true,unarmed,vein,venation
244	wfo-0001028667	success	129	144	113	16	31	0.876	-2.6,.5,0.4-0.7,0.7-4,1-1.5,1-2-1.5,1-4.5,1-6,1.3-2,3,3-11,5,5-20,8-10,acute,aid,apar,apex,appearing,ark,around,articulated,axillary,base,berry,branch,branched,calyx,cell,climbin,climbing,clustered,cm,completely,conical,coriaceous,corolla,creamy,curling,deciduous,diameter,discolorous,dry,elliptic,entire,exfoliatin,exfoliating,fide,flattened,flower,fragrant,fruiting,glabrous,growth,inflorescence,irregularly,leaf,like,lobe,long,margin,mentz,midrib,minutely,mm,narrowly,new,occasionally,older,other,outer,pale,papilla,papillat,pedicel,peduncle,pendan,per,petiole,primary,reniform,revolute,scar,shiny,shoot,short,simple,sleeve,slender,slightly,small,soon,spaced,stem,straw-colored,strongly,support,surface,terminal,tip,triangular,tube,twice,twining,unit,vein,vine,visible,white,woody,wrinkling,x,yellow	5-merou,alyx,anthesi,eaf,eed,ellipsoid,exserted,lower,nflorescence,orolla,perfect,pitted,plurifoliat,tem,ud,ympodial	abaxial,adaxial,anther,arrangement,branching,characteristic,colour,filament,form,fruit,height,history,length,life,midvein,null,ovary,pitte,plant,plurifoliate,pseudostipule,rachi,seed,shape,staman,style,sympodial,tertiary,texture,unarmed,venation
245	wfo-0001028688	success	137	108	73	64	35	0.533	.5,0.4-1,0.5,0.5-1,0.5-1.5,0.9-1,1-1.5,1-3,1-5,1.1-1.2,2-3,5-6,acuminate,acute,along,anther,anthesi,apex,base,beneath,calyx,clavate,cm,corolla,deflexed,deltoid,densest,dia,difoliate,filament,free,furcate,glabrous,golden,irregularly,known,lanceolate,leaf,like,lobe,long,major,minor,mm,near,occasionally,opposite,ovary,overtopping,pedicel,petiole,pilose,portion,pubescent,reddish-brown,scar,shiny,shoot,shrub,slender,slightly,spaced,sparsely,stem,style,tapering,tip,trichome,tube,uniseriate,usually,vein,white	0.5-0.75,1-1.8,1.4-2.8,2.2-4.8,5-11,across,apar,area,bark,bi-cellular,branch,curl-tipped,deciduous,decreasing,densely,differing,eaf,edicel,eed,elliptic,exfoliatin,exserted,geminat,globose,interpetalar,know,lobed,lon,lower,markedly,membraneous,middle,minutely,nearly,nflorescence,often,older,paler,papillose,planar,pore,poricidal,proximal,ruit,shaped,sinus,size,soon,stigma,straight,styl,tall,tear-drop,terminal,thickened,thin,tub,ud,unit,wide,widest,x,ympodial,young	abaxial,adaxial,apart,arrangement,branching,characteristic,colour,diameter,exfoliating,form,fruit,geminate,growth,height,history,inflorescence,length,life,margin,midvein,null,peduncle,plant,primary,pseudostipule,rachi,seed,shape,staman,surface,tertiary,texture,true,unarmed,venation
246	wfo-0001028698	success	166	140	104	62	36	0.627	0.3-0.75,1-2,1-4,1-9.8,1.8-5,1.9-4,13-25,2-10,2-3,2-4,3-17,3-5,4-14,5-15,5-6,5-8,6-13,6-27,8-10,9-35,abaxially,acuminate,acute,adaxially,apex,articulate,base,branched,broadly,calyx,cell,cm,commonly,conical,corolla,covering,cyme,dark,darker,diameter,dichasial,dichasially,distal,dot,ebracteate,ellipsoid,elliptical,exceeding,filament,flower,forked,generally,green,green-white,half,herbaceous,lateral,leaf,leaflet,light,lobe,long,long-attenuate,make,medium,mm,monochasial,mucilaginous,oblique,odd-pinnate,often,ovate,ovoid,pedicel,peduncle,perennial,perfect,petiole,plant,proximal,puberulent,pubescent,rachi,raised,seed,smooth,stamen,stigma,straight,strigose,style,terminal,testal,thick,throughout,tuber-bearing,typically,unit,usually,violet,wall,white,wide,Â¼	0-1.,3-6-foliat,3.5,6,abaxiall,acumen,apical,apically,connate,cuneate,decurrent,dehiscent,digestion,diminishing,dorsally,eaf,edge,eed,emoval,enzyme,equal,first,flat,folded,globo,gradually,hair-like,honeycomb,interjected,introrse,living,lon,lower,lunat,maturing,minute,nflorescence,nther,orolla,pair,pattern,pentagonal,petiolule,plan,poricidally,rarely,reveal,rotate,ruit,sessile,seudostipule,short,size,slit,specimen,tal,tem,toward,two,vary,yellow,ympodial	'hair-like,3-6-foliate,abaxial,adaxial,anther,arrangement,branching,characteristic,colour,form,fruit,globose,growth,height,history,inflorescence,length,life,lunate,margin,mentioned,midvein,ovary,primary,pseudostipule,shape,staman,stem,surface,sympodial,tertiary,texture,unarmed,vein,venation,wet
247	wfo-0001028716	success	145	120	90	55	30	0.621	.2,.5,0.5,0.6-1.9,0.75,1-2,10-40-flowered,2-4,2.5-8,7-8,8-9,9-10,across,acuminate,anther,apart,apex,base,beginning,beneath,bi-cellular,branched,calyx,cm,corolla,cuneate,dark,decurrent,dia,elliptic,evenly,except,filament,filiform,free,fruit,glabrous,glandular,hirsute,lateral,leaf,less,like,lobe,long,main,major,middle,minor,minutely,mm,much,node,often,older,opposite,orbicular,ovary,ovate,pair,papillose,pedicel,petiole,portion,prominent,proximal,pubescent,raised,rounded,scar,shape,shrub,simple,slightly,spaced,sparsely,stem,straight,style,tall,triangular,trichome,truncate,tube,uniseriate,vein,white,widening,widest,x	1.9-5.5,11-16.4,2.2-7.9,3.6-8.8,5-6,anisophyllou,anthesi,appearing,asymmetric,ba,bark,becoming,brown,deflexed,differing,difoliate,eaf,edicel,eed,ellipsoid,fertilization,fifth,geminate,inflorescenc,intermediate,know,known,lengthening,lenticellat,lobed,lon,long-triangular,lower,markedly,nearly,nflorescence,one,pointed,pore,poricidal,puberulent,reflexed,remaining,ruit,shaped,size,stigm,strongly,tear-drop,tip,two,ud,unit,ympodial,young	abaxial,adaxial,arrangement,branching,characteristic,colour,diameter,form,growth,height,history,inflorescence,length,life,margin,mentioned,midvein,peduncle,plant,primary,pseudostipule,rachi,seed,staman,stigma,surface,tertiary,texture,unarmed,venation
248	wfo-0001028723	success	211	172	148	63	24	0.701	-1.5,.3,0-0.5,0.8-1,0.8-2,0Â°,1,1-1.5,1-1.8,1-2.2,1-2.5,1/5-1/3,10-16,2-2.5,2-2.7,2-4,3-4,3.5-4,4,4-5,5,5-6,5-7,abaxial,abaxially,acute,adaxially,age,almost,alternate,another,anther,anthesi,apex,apically,articulated,base,brachyblast,branch,branched,branching,broadly,brown,calyx,capitate,clearly,clustered,cm,concolorous,conical,corolla,curved,dark,decurrent,delineated,deltoid,dendritic,densely,diameter,dilated,dorsifixed,drying,elliptic,entire,equal,faint,filament,fine,flat,flexuous,flower,free,glabrous,gradual,green,leaf,length,lengthening,less,liana,lobe,long,long-attenuate,margin,membranous,midvein,minutely,mm,mostly,much,oblong,obovate,obtuse,occasional,one,orange-brown,overlapping,pair,pale,pedicel,peduncle,petiole,pore,poricidal,portion,primary,protruding,rachi,raised,region,regular,ridged,scar,separated,short,shrub,side,simple,sinus,slender,small,smaller,smooth,sparsely,spreading,stem,stigma,stump,style,surface,surrounding,tearing,terminal,tertiary,tip,transition,trichome,tube,tuft,unarmed,uneven,vein,venation,white,wide,wrinkled,x,yellow	.5,0.2,1/3-1/2,10-15,2.5,alyx,apar,apice,apparently,bark,becoming,common,density,developed,divided,domatia,eaf,eed,ellipsoi,except,ey,formed,frequent,increasing,inner,junction,know,known,like,lobed,longitudinally,lower,m.,main,middle,multiply,naked,narrowly,nflorescence,nther,obconical,orolla,outer,ovate,papillo,perfec,plurifoliat,poorly,prominent,pubescent,ray,ruit,tissu,toward,ud,unevenly,unit,vary,visible,widely,ympodial,young,youngest	adaxial,apart,arrangement,characteristic,colour,form,fruit,growth,height,history,inflorescence,life,mentioned,occasionally,ovary,papillose,plant,pseudostipule,seed,shape,staman,texture,tissue,true
249	wfo-0001028736	success	180	162	132	48	30	0.733	0.2-0.4,0.5,0.5-1,0.5-1.5,0.5-1mm,0.5-2,1,1-1.5,1-2,1-3,1.5,10-15,2-4,2-5,2-7,3-5,3-6,3-8,3.5-5,4-12,4-6,40-70,5-10,5-15,6-13x3-8,6-8,abaxially,absent,acute,anther,apar,apex,apparently,armed,axe,base,berry,blade,brown,calyx,cm,contiguous,created,dark,decurrent,densely,diameter,difoliate,either,extra-axillary,filament,filiform,flattened,flower,fruit,geminate,glabrous,glandular,globose,green,hair,immature,leaf,length,light,like,lobe,long,lower,major,many,mature,midpoint,midrib,midvein,mm,moderately,mottled,multicellular,multiseriate,narrowly,nearly,netlike,obtuse,occasional,occasionally,onto,orange,pair,pedicel,peduncle,per,perfect,petiole,pit,porrect-stellate,prickle,pubescent,rachi,raised,ray,recurved,red,reniform,rhombic,ridge,roselike,shrub,side,simple,small,spaced,sparsely,stalk,stellate,stem,style,surface,thin-skinned,triangular,tube,unarmed,unbranched,unicellular,uniseriate,unit,unlobed,vein,white,x,yellow,yellow-white	1.5-3,1/6,4-9,5-merou,accrescent,adaxiall,adaxially,alyx,apical,attenuate,beyond,chartaceous,connivent,cordate,cut,cylindrical,directed,discolorous,eaf,eed,exserted,frui,fruiting,glabrou,gree,introsel,less,lobed,m.,nflorescence,orolla,pore,purple,ruit,scanden,sinus,slightly,stamen,ste,stigma,tamen,tapering,tem,unequa,vary,way,wide,ympodial	5-merous,abaxial,adaxial,apart,arrangement,branching,characteristic,colour,corolla,form,growth,height,history,inflorescence,life,margin,null,ovary,plant,primary,pseudostipule,scandent,seed,shape,staman,sympodial,tertiary,texture,unequal,venation
250	wfo-0001028737	exception_thrown	151	0	0	151	0	0.0		0.2-0.5,0.7-2,1,1-2.5,1-4,1-6,1.5-3.5,10,12-14,16-30,2-3,2-5,2.8-3.5,3-4,3-5,3-6-foliat,4-10,4-6.5,4-9,5-6,6,7-15,abaxially,absen,acumen,acuminate,acute,adaxially,apex,apical,apically,apiculate,articulate,attenuate,base,branched,calyx,caudate,cell,cm,connate,corolla,covering,cyme,decurrent,dehiscent,diameter,dichasial,dichasially,digestion,diminishing,distal,dorsally,eaf,ebracteate,edge,eed,elliptic-lanceolate,emoval,enzyme,exceeding,filament,flat,flower,folded,forked,generally,glabrescent,glandular,globo,globose,gradually,green,green-white,hair-like,half,herbaceous,honeycomb,interjected,introrse,lanceolate,larger,lateral,leaf,leaflet,living,lobe,lon,long,lower,make,maturing,mm,monochasial,mucilaginous,nflorescence,nther,oblique,oblong,odd-pinnate,often,orolla,ovoid,pair,pattern,pedicel,peduncle,perennial,perfect,petiole,pinnatifi,plan,plant,poricidally,proximal,rachi,reveal,ruit,second,seed,sessile,seudostipule,short,size,slit,specimen,stamen,stellate,stigma,straight,strongly,style,tal,tem,terminal,testal,thick,throughou,throughout,toward,tuber-bearing,typically,unit,vary,wall,whit,wide,without,yellow,ympodial,Â¼	
251	wfo-0001028777	success	205	147	122	83	25	0.595	-10,-12,-3,-4,.5,.8,.9,0-2,0-30,0.1-0.3,0.2,0.4-0.8,0.5-1.3,0.6-1,0.7-1.2,1-2,1-2.5,1-3,1.5-3,1.5-4,1.8-2.5,1/4-1/2,2-,2.5,2.5-5,3,4.5-8,8,acute,anther,apex,apically,articulated,attenuate,base,berry,blade,branched,calyx,cm,dark,deltate,diameter,entire,erect,faint,filament,flattened-reniform,flower,free,fruit,glabrescent,glabrous,green,green-brown,inflorescence,infructescence,leaf,length,lobe,long,long-styled,margin,marking,maturity,mauve,midpoint,minute,mm,moderately,obovate,one,open,orange,orange-brown,ovate,pair,pale,pedicel,peduncle,per,pericarp,petiole,porrect,portion,primary,ray,retuse,rounded,sessile,shoot,short,shorter,shrub,simple,small,smooth,sometimes,sparsely,spherical,stalk,stalked,stellate-pubescent,stem,style,surface,terete,terminal,tertiary,time,tree,trichome,truncate,unarmed,vein,venation,visible,white,whole,wide,yellow-green,young	-2.5,0.1-0.2,0.7-1.3,0.8-1,0.8-2.2,1,1.5,1/4,2.5-3,3.5-5,3/4-4/5,4-5-merous,6-10,7-11,8-15,abaxially,acuminat,alyx,ame,apar,ape,bark,briefly,c.,chartaceous,concolorous,connivent,curved,deciduou,discolorous,drying,eaf,eed,elongating,equal,fruiting,glabrescen,lengt,less,lobed,longer,lower,mature,multangulate,narrow-deltate,nflorescence,occasionally,older,orolla,oung,perfect,plurifoliat,poricidal,present,recurved,red-brown,reflexe,reflexed,ruit,scar,short-styled,shorte,somewhat,soon,spaced,spreading,staminate,stellate,stout,strongly,tamen,tapering,tip,tube,unarme,unit,usually,variously,vary,way,wider,woody,ympodial	abaxial,acuminate,adaxial,arrangement,branching,characteristic,colour,corolla,form,growth,height,history,life,midvein,null,ovary,plant,plurifoliate,pseudostipule,rachi,seed,shape,staman,texture,true
252	wfo-0001028791	success	257	173	147	110	26	0.572	+,.5,0.05-0.2,0.3-0.4,0.3-0.5,0.4-0.65,0.45-0.55,0.8-1.3,1-1.5,1-2,1-2-celled,1-3-celled,1.5-2,1.7-2.1,1.8-3.3,10,100,2-7,2-7-celled,2-locular,2.8-3.0,20-to,4-15,4-5+,4-celled,5-15,5-plurifoliate,50-80,9-30,absent,abundant,acuminate,acute,addition,anther,apex,appearance,articulated,articulation,basal,base,beneath,border,branched,broadly,brown,calyx,cell,clambering,cm,conical,corolla,dark,darker,deciduous,deltate,densely,developed,diameter,dichotomously,ebracteate,elliptic,elongating,entire,filament,flower,fruit,give,glabrescent,glabrous,glandular,globose,green,grow,hair-like,half,head,imparipinnate,internode,interrupted,large,lateral,leaf,leaflet,liana,like,lobe,long,many,margin,middle,midvein,mm,much,near,oblique,occasionally,often,outgrowth,ovary,pale,paler,pedicel,peduncle,petiole,plant,poorly,primary,pseudostipule,pubescence,pubescent,rachi,round,scandent,secondary,seed,short,shorter,silky,simple,slightly,smaller,somewhat,sparsely,stem,style,surface,tertiary,testa,time,transparent,trichome,truncate,unicellular,uniseriate,unit,upper,usually,vegetation,vein,vine,wall,white,wide,winged,woody,yellow	-0.6,-1.5,-9,0-6,0.05,0.2-0.3,0.2-0.4,0.2-0.8,0.25-0.3,0.3-0.6,0.3-0.8,0.4-0.5,0.4-0.6,0.4-1.1,0.5,0.6-0.8,0.6-0.9,0.7-1.5,0.8-1,1-3,1-celled,1.5-,1.6-4.5,2-3,2-3.5,2.5-4.5,3-,3-4,4-11.5,5-,5-10,5-22,8-10-celled,9-35,abaxially,absen,adaxially,ag,along,anthesi,apical,appendage,basiscopically,berr,breaking,bullate,capitate,colo.,column,consistently,densest,eaf,edicel,eed,eglandular,enlarged,even,exserted,extended,free,fruiting,gree,growing,halfway,interjected,lamina,leaving,less,lon,lower,minutely,mixture,multicellular,nflorescence,obovate,pair,papillate,per,petiolule,present,protuberance,reflexed,rest,rough,ruit,sandpapery,sessile,single,small,sometimes,sparse,spreading,stamen,staminal,stellate,sterile,stiff,stigma,straight,tal,tem,terminal,thick,thickened,tip,touch,tube,ud,ympodial,â1-2-celled	abaxial,adaxial,age,arrangement,branching,characteristic,color,colour,form,growth,height,history,inflorescence,length,life,mentioned,shape,staman,sympodial,tall,texture,true,type,unarmed,various,venation
253	wfo-0001028798	success	214	162	136	78	26	0.636	.5-5,0-1,0-60,0.2-0.4,0.5-2,0.9-1.2,1-3,1-4.5,1-6,1.1-2,1.5-1.8,1/2-2/3,1/20,10,15-19,2-3,2-6,2-7,2.4-4.4,2.6-4,2/3,3-5,3.3-5.6,5-8,5.25-7.5,7-8,8-18,8.5-13,abaxially,acuminate,acute,adaxially,anther,apart,apex,articulated,attenuate,axe,axillary,base,becoming,berry,blade,boat-shaped,branched,calyx,cm,conical,continued,corolla,curved,decurrent,densely,diameter,dm,downward,due,echinoid,entire,filament,fleshy,flower,fruit,granular,granular-tomentose,green,greenish,growth,hair,lacking,lanceolate,lateral,leaf,length,less,lobe,lobed,long,main,many,margin,midvein,mixed,mm,multangulate,nearly,oblanceolate,overlapping,pale,pedicel,peduncle,persistent,persistently,petiole,plurifoliate,porrect-stellate,present,probably,pseudo-terminal,pubescent,rachi,rather,ray,ripe,rough,rough-granular,sessile,short,short-stalked,shrub,side,simple,small,spaced,sparingly,stalked,stellate-pubescent,stem,style,subcampanulate,subglobose,thick,time,tip,tomentose,tomentum,toward,unarmed,unit,vein,velutinous,way,wide,x,yellow,yellowish	2-3.75,2.5-3.5,3-4,3.8-4.2,4-5.4,6-10,6-8,accrescent,ag,anthesi,apical-lateral,apparently,ba,blunt-tipped,branch,bud,capitat,chartaceous,cylindrical,dehiscing,distal,eaf,echinoi,eed,exserted,extend,free,fruiting,glabrous,hal,high,included,inserted,introrse,irregularly,large,lined,longitudinal,lower,m.,minutely,multangulat,nflorescence,oblanceolat,oblong,obovate,obscured,obtuse,often,orbicular,orolla,oung,ovate-lanceolate,perfect,pore,prominent,quite,rotate-stellate,ruit,semi-ovate,slightly,slit,somewhat,splitting,stamen,stigma,strongly,subcoriaceous,sulcate,suture,tamen,tomentu,translucent,tube,unarme,unknow,vary,ympodial	abaxial,adaxial,arrangement,branching,characteristic,colour,form,height,history,inflorescence,life,mentioned,ovary,plant,primary,pseudostipule,seed,shape,staman,surface,sympodial,tertiary,texture,true,unknown,venation
254	wfo-0001028815	success	196	165	134	62	31	0.684	0.4-0.8,0.5-1,1-10,1-2,1-3.5,1-4,1-5,10-15,14-28,2-4,2-4.5,2-9,2.5-6.5,22-35,3-4,3-5,3-7,4-10,5-6,5-7,6-10,6-8,7-16,abaxially,acumen,acute,adaxially,anther,apart,apex,apparently,articulated,articulation,auriculate,axe,axillary,base,berry,blade,broadly,brownish,bud,cell,cm,condition,corolla,covering,cuneate,dark,decreasing,diameter,digestion,distal,distinct,drying,elliptic,elliptic-lanceolate,enzyme,filament,flower,forked,fresh,fruit,generally,glabrous,globose,green,green-white,greenish,hair,hair-like,half,herb,high,honeycomb-shaped,indistinct,interjected,lateral,leaflet,like,lilac-purple,lobe,long,make,margin,medium,mm,mucilaginous,obtuse,odd-pinnate,ovate,ovoid,pair,papillose,pedicel,peduncle,perfect,petiole,petiolulate,plant,plurifoliate,pointed,pubescent,purple,rachi,red-purple,removed,ripe,rounded,seed,sessile,short,size,slightly,spaced,sparsely,splotched,stem,style,subtending,terminal,terminated,testal,thick,throughout,tinged,tri-,triangular-lanceolate,unit,usually,wall,wet,whitish,x	5-merou,ag,along,alyx,basiscopic,capitat,chartaceous,ciliate,connivent,decurrent,developing,dorsally,eaf,edge,eed,especially,exceeding,flat,folded,geminat,glabrou,hal,homostylous,lanceolate,lengthening,living,lower,membranous,midrib,minutely,narrowly,nflorescence,onto,orolla,pore,poricidal,puberulent,purpl,rotate,rugose,ruit,semi-erec,semi-rosette,seudostipule,side,slit,specimen,stamen,ste,stigma,straight,tall,tamen,tem,tip,tube,unwinged,vary,winged,yellow,ympodial,young	abaxial,adaxial,arrangement,branching,calyx,characteristic,colour,form,geminate,growth,height,history,inflorescence,leaf,length,life,mentioned,midvein,ovary,primary,pseudostipule,shape,staman,surface,sympodial,tertiary,texture,true,unarmed,vein,venation
255	wfo-0001028876	success	127	111	79	48	32	0.622	.5,0.4-1,0.5-2,1-2,1.5-2,2-2.3,3-5,4-5,4-8,5-6,abaxial,abaxially,acute,adaxially,along,anther,apex,attenuate,bark,base,brown,calyx,cm,conical,corolla,dark,dendritic,densely,difoliate,drying,elliptic,filament,flower,free,glabrous,golden,internodal,known,lateral,leaf,like,lobe,long,long-triangular,main,middle,midrib,mm,occasionally,older,opposite,ovary,pair,pedicel,petiole,portion,pubescent,reddish,rest,rounded,shining,shrub,simple,slender,small,sparsely,stem,style,subshrub,surface,trichome,tube,uniseriate,unit,vein,white,widest,x,young	/4,1.5-3,3-8,anthesi,branched,capitate,closely,dia,eaf,edicel,eed,ellipsoid,geminat,glabrat,hroughout,included,inflorescenc,know,lamina,leave,lobed,lower,minutely,nflorescence,nodding,overlappin,papillae,papillo,papillose,planar,pore,poricidal,ruti,sagittate,scar,shaped,spaced,speciman,stigma,straight,tall,tear-drop,tip,tub,type,ud,way,ympodial	adaxial,arrangement,branching,characteristic,colour,diameter,form,fruit,geminate,glabrate,growth,height,history,inflorescence,length,life,margin,midvein,null,peduncle,plant,primary,pseudostipule,rachi,seed,shape,staman,sympodial,tertiary,texture,unarmed,venation
256	wfo-0001028883	success	207	189	159	48	30	0.768	0.5â2,0.6,1,1.5â7,1â2,1â6,2,2â3,2â5,3â5,4,4â6,5,50,6,6â10,6â12,abaxially,absent,acute,adaxially,almost,along,anther,antrorse,antrorsely,apex,arched,articulated,ascending,attenuate,axi,base,becoming,berry,blade,branch,brochidodromous,calyx,capitate,cell,chartaceous,ciliate,cm,common,completely,concolorous,connivent,coriaceous,curved,cylindrical,cyme,dark,decurrent,deltate,densely,diameter,drying,dull,elliptic,entire,equal,erect,exfoliating,eye,filament,flattened,flower,fruit,glabrescent,glabrous,glandular,globose,green,greenish,growth,head,herb,hilum,hollow,impressed,lateral,leaf,length,less,light,like,lobe,long,lying,margin,midrib,mm,moderately,multicellular,naked,narrowly,new,normally,notably,oblong,often,older,onto,parallel,pedicel,peduncle,per,petiole,plurifoliate,present,primarily,prominent,pubescence,pubescent,rachi,rarely,region,reniform,ripe,secondary,seed,sessile,shiny,shrub,similar,simple,single,single-celled,slightly,small,sometimes,spaced,sparse,sparsely,spreading,stalk,stem,stigma,straight,style,subopposite,subsessile,surface,swollen,tall,trichome,unbranched,undulate,uniseriate,vein,venation,visible,white,whitish,wide,woody,yellow,Ã	0.3â0.6,0.4â1.2,5-merou,accrescent,acuminate,adaxiall,alyx,apar,ark,brow,capitat,circular,differing,directed,eaf,eed,elliptic-ovate,emarginate,frui,geminate,geniculat,glabrou,introrsely,longitudinal,lower,membranaceous,minor,nflorescence,obtuse,opening,orolla,ovate-lanceolate,pendan,perfect,pore,poricidal,rounded,ruit,shap,size,slit,stellate,subapical,tamen,tem,unit,vary,ympodial	--,3,abaxial,adaxial,apart,arrangement,bark,branching,brown,characteristic,colour,corolla,form,geniculate,height,history,inflorescence,life,midvein,null,ovary,pendant,plant,primary,pseudostipule,shape,staman,tertiary,texture,unarmed
257	wfo-0001028885	success	214	149	126	88	23	0.589	-1,0.3-0.5,0.7-2,1-1.2,1-2,1.5-3.5,10-20,2,2-2.5,2.3-2.5,2.5-3.5,3-5,3.5-4.5,7-8,7-9,9-11,?,abaxial,acute,adaxial,adaxially,along,anther,apex,apiculate,apparently,articulated,attenuate,base,berry,black,blackish,branched,broadly,brown,calyx,cm,corolla,dark,decurrent,deltate,densely,diameter,distal,dried,drying,elliptic,entire,erect,filament,flower,furcate,glabrous,glandular,globose,golden,groove,growth,height,immature,inflorescence,inserted,known,lanceolate,lateral,leaf,leaving,like,live,lobe,long,lower,margin,material,midvein,mm,mostly,narrowly,new,nodding,occasionally,often,older,pair,part,pedicel,peduncle,peg,pericarp,petiole,pigmentation,plant,primary,pubescent,purple,recorded,reddish,retaining,revolute,rhachi,ripe,scandent,scattered,shiny,short,shrub,simple,sleeve,slender,slightly,sometimes,sparsely,stem,style,surface,terminal,thin,time,tip,trichome,uniseriate,upper,vein,vine,winged,woody	.5,0.5-1,0.5-5,1-1.5,1-3,1.5-1.7,2-,2/3,3.5-8.5,4-5,5-merou,9-12,ag,alyx,anthesi,apart,archin,ark,basal,branch,capitate,cell,collapsing,connivent,cup-shaped,dark-pigmented,dendriti,eaf,eed,ellipsoid,exserted,extending,fleshy,free,fruiting,glabrescent,glabrou,gradually,groupe,ilament,irregularly,lamina,lengthening,less,lobed,loosely,minute,minutely,multicellular,narrowing,nflorescence,noddin,orolla,papillo,perfect,plurifoliat,pore,poricidal,portion,quarter,ruit,scar,shin,slit,small,smaller,spaced,spheroidal,spreading,stellate,stigma,strongly,tangled,tem,third,tube,twinin,ud,unit,usually,vary,wall,way,weak,weak-walled,wide,ympodial,Â¾	arching,arrangement,branching,characteristic,colour,form,fruit,history,length,life,ovary,plurifoliate,pseudostipule,rachi,seed,shape,staman,tertiary,texture,true,twining,unarmed,venation
258	wfo-0001028888	success	207	127	97	110	30	0.469	0-3.5,0.15-0.5,1-1.5,1-10,1-2,10-25,2-6,2.3-7,2.5-3.3,3-4,4-7,5-7,6-11,8-11,abaxially,acuminate,acute,adaxially,anther,apart,apex,apiculate,articulated,base,berry,broadly,brownish,cell,center,central,cm,condition,corolla,covered,covering,diameter,dot,drying,elliptic,filament,fresh,fruit,glabrous,glaucous,globose,green,green-white,greenish,hair,hair-like,half,herb,lateral,like,lobe,long,low,make,margin,middle,midrib,mm,mottled,mucilaginous,oblique,odd-pinnate,often,ovate,ovoid,pedicel,peduncle,petiole,plant,proximal,pubescent,purple,ripe,rounded,scattered,seed,short,slightly,sometimes,spaced,sparsely,stem,streak,style,subglabrous,testal,thick,throughout,violet,wall,wet,white,whitish	0-5,0-7,1,1-3,1.5-4,12.5-25,2-5,2.3-5,3-5,3.6-12.5,3.8-8.3,4-25,5-10,5-merou,8-13.5,acumen,ag,along,alyx,apparently,axe,axillary,blade,bud,capitat,chartaceous,ciliate,clavate,connivent,cuneate,digestion,distal,dorsally,eaf,edge,eed,end,enzyme,erec,especially,exceeding,except,flat,flower,folded,forked,geminat,generally,glabrou,greatly,hal,homostylous,honeycomb-shaped,interjected,lanceolate,leaflet,lengthening,less,living,lower,membranous,minutely,nflorescence,one,orbicular,orolla,pair,pentagonal,perfect,petiolulate,petiolule,placed,plurifoliate,pore,poricidal,puberulent,reduced,removed,ruit,sessile,seudostipule,size,slit,specimen,stamen,ste,stigma,stolo,straight,subequal,substellate,subtending,tall,tamen,tem,terminal,tip,tri-,truncate,tube,tuber,typically,unit,unwinged,usually,vary,wing,x,yellow,ympodial	abaxial,adaxial,arrangement,branching,calyx,characteristic,colour,form,growth,height,history,inflorescence,leaf,length,life,midvein,null,ovary,primary,pseudostipule,rachi,shape,staman,surface,tertiary,texture,true,unarmed,vein,venation
259	wfo-0001028920	success	152	117	87	65	30	0.572	.5,0.2-1,0.5-1,0.8-1.1,1-1.2,1-1.5,1-3,2-2.5,3-15-flowered,3-3.5,5-9,6-6.5,abaxially,acuminate,acute,adaxially,anther,apex,arachnoid,arachnoid-pubescent,attenuate,axil,base,berry,brown,brownish,calyx,cm,congested,corolla,dark,decurrent,deflexed,deltate,dendritic,dense,densely,dia,elliptic,erect,felty,filament,free,glabrate,glabrous,globose,green,lateral,leaf,lightly,lobe,long,main,major,minutely,mm,obovate,occasionally,opposite,ovary,ovoid-reniform,pair,pedicel,petiole,pitted,portion,pubescence,pubescent,shape,shrub,simple,small,soon,sparsely,stem,style,surface,tapering,tree,trichome,tube,tuft,uniseriate,vein,white,winged,x	.25,1-2.4,1.5-2,2-7,3-4,6-15,anthesi,area,ba,bark,broadly,closely,conical,cucullate,differing,difoliate,eaf,edicel,eed,ellipsoid,exserted,fleshy,flower,fruiting,geminat,gray-brow,later,lobed,lon,long-styled,lower,middle,minor,nearly,nflorescence,obovoid,older,overlappin,papillose,planar,pore,poricidal,present,ruit,scar,shaped,short-styled,size,somewhat,spaced,stigma,strongly,styl,tall,tear-drop,thick,tip,tub,ud,unifoliate,unit,widest,woody,ympodial,young	abaxial,adaxial,arrangement,branching,characteristic,colour,diameter,form,fruit,gray-brown,growth,height,history,inflorescence,length,life,margin,midvein,null,peduncle,plant,primary,pseudostipule,rachi,seed,staman,tertiary,texture,unarmed,venation
260	wfo-0001028929	exception_thrown	210	0	0	210	0	0.0		-2,-2/3,.5,.7,.9,/5,0,0-1,0-10,0-20,0-3,0.1,0.15-0.3,0.2-0.3,0.2-0.4,0.2-0.8,0.3-0.6,0.4-0.8,0.5-1.5,0.5-2,0.7-1,0.7-2,0.8-1,1,1-1.1,1-3,1.5-2.4,1/2,1/4-1/3,2-3,2-4,2-6,2-9,2.2-2.3,2.5-4,2.7-3,2/3-3/4,3-20,3-4,4-6,5-25,5-6,5-7.5,5-merous,6-8,7-9,8-10,abaxial,abaxially,acicular,acute,adaxial,alyx,anther,apar,apart,ape,apex,apically,apparently,articulated,bark,base,berry,blade,branched,calyx,cell,chartaceous,cm,concolorous,connivent,cuneate,curved,densely,diameter,difoliate,discolorous,distance,drying,dull,eaf,eed,elliptic,elongating,equal,erect,extending,filament,flattened-reniform,flower,foliaceous,free,fruit,fruiting,geminat,gently,glabrescent,glabrou,glabrous,gra,hair,inflorescence,infructescence,lateral,leaf,length,lobe,lobed,lon,long,long-styled,longer,lower,margin,mature,maturity,midpoint,midvein,minute,minutely,mm,narrow-deltate,narrow-ovate,nflorescence,oblong,obovate,obtu,obtuse,occasionally,older,one,open,orange-brown,orolla,oung,outline,pair,pale,patch,pedicel,peduncle,pendulous,per,perfect,pericarp,perpendicular,petiole,pit,poricidal,porrect,portion,prickl,prickle,prickly,primary,raised,ray,red,red-brown,red-green,reticulate,rounded,ruit,scar,sessile,short-styled,shrub,side,simple,slender,small,smooth,sometimes,spaced,spherical,spreading,stalk,stalked,staminate,stellate,stellate-pubescent,stem,straight,style,subsessile,surface,tamen,tapering,terete,tertiary,time,tip,trichome,tube,unarmed,unit,usually,variously,vary,vein,venation,visible,way,white,wide,woody,yellow,yellow-green,ympodial	
261	wfo-0001028963	success	197	121	94	103	27	0.477	.5,0-2,0.3-1,0.45-0.6,0.6-0.9,0.6-1,0.9-1.5,1.5-2,1/5,1/6,2-2.3,2-4,2-5,2.4-2.8,3.5-4.2,6-10,acute,anther,apex,apically,articulated,attenuate,base,berry,blade,bright,broad-deltate,brown,calyx,cell,cm,densely,diameter,dull,entire,erect,evenly,eye,filament,flattened-reniform,gray-green,green,herb,inflorescence,infructescence,lanceolate,leaf,length,less,light,lobe,long,lower,margin,maturity,mauve,mm,naked,narrow-cuneate,narrow-elliptic,narrowly,obtuse,orange,outline,pair,pale,pedicel,peduncle,per,petiole,pit,primary,purple,raised,red,shrub,small,smooth,spherical,stellate-pubescent,stem,style,surface,terete,tertiary,unarmed,unbranched,upper,vein,venation,visible,winged,yellow-orange,young	/2,0-0.4,0.1,0.1-0.2,0.1-0.25,0.15-0.3,0.3-0.6,0.3-0.7,0.3-1.5,0.8-1.8,1-4,1/,1/4-1/3,2-3,2-9,3-4.5,4-10,4-8,5-25,5-merous,7-8,abaxially,alyx,apar,ape,apparently,bark,becoming,chartaceous,concolorous,connivent,curved,cuspidat,deltate,difoliate,discolorous,drying,eaf,eed,elongating,equal,flower,free,frui,fruiting,geminat,glabrescent,glabrous,gra,herbaceous,lateral,lobed,long-styled,longer,mature,midpoint,moderately,nflorescence,occasionally,older,one,open,orolla,oung,pendulous,perfect,pericarp,poricidal,porrect,portion,ray,ruit,scar,sessile,short-styled,shorter,simple,slender,slightly,spaced,spreading,stalk,stalked,staminate,stellate,straight,subsessile,tamen,tapering,terminal,time,tip,trichome,tube,unarme,unit,usually,variously,vary,way,wide,woody,ympodial	1/2,abaxial,adaxial,arrangement,branching,characteristic,colour,corolla,cuspidate,form,fruit,gray,growth,height,history,life,midvein,null,ovary,plant,pseudostipule,rachi,seed,shape,staman,texture,true
262	wfo-0001028971	success	225	169	141	84	28	0.627	.1-0.2,0.1-0.4,0.25-0.6,0.25-1.25,0.3-0.6,1-2,1-5,1.5-2.2,1.5-4,1.75-2.5,1/5-1/2,10-15,2-foliate,2.2-3.5,2.5-3.5,2.5-5,3-14,3-5,3-6,4-5,4-9,5-10,5-15,6-16,6-8.5,6-9,7-16,abaxially,acute,acute-,adaxially,along,anther,apart,apex,appearance,appearing,armed,articulated,axe,base,blade,branched,broadly,calyx,cm,coarsely,cylindrical,delicate,deltoid,densely,dentate,diameter,distal,elongate,erect,essentially,farinaceous,felty,felty-pubescent,female-sterile,filament,flower,form,frequently,fruit,glabrous,globose,hair,inflorescence,inserted,invested,lateral,leaf,length,lenticular,lignescent,like,lobe,long,major,margin,midpoint,midrib,minutely,mixture,mm,narrowly,numerous,obtuse,occasionally,one,orange,outline,ovate,ovate-apiculate,pedicel,peduncle,per,perennial,persistent,petiole,pitted,prickle,prickly,principal,pubescent,rachi,ray,reniform-ovate,ripe,round-tipped,scattered,sericeous,sessile,short,short-stalked,side,similar,simple,spaced,spreading-hirsute,spreadingly,stalk,stellae,stellate,stellate-pubescent,stem,stipitate,style,surface,tan,termination,trichome,truncate,unbranched,underdeveloped,unit,vein,white,x	-0.8,-1.4,0.1-0.5,0.2-0.5,0.4-0.9,0.4-1.5,0.8-2.5,05-2.5,15-30,2-5,2.5-4.5,20-35,5-8,adaxiall,also,ascending,attenuate,ba,bearing,becoming,broad-based,campanulate,capitat,cauline,close,compressed,connivent,directed,distall,eaf,eed,elongate-deltoid,entire,extra-axillary,geminat,grading,growt,interlobal,lanceolate,largest,later,laterally,least,linear-lanceolate,lon,longer,longest,lower,manifestly,maturit,minute,much,multiseriate,nflorescence,often,orolla,other,ovate-lanceolate,pair,pore,reduced,ruit,shorter,sinus,smaller,sometimes,sparse,ste,stigma,tal,tamen,tem,thin-textured,time,tooth-like,tube,usually,variable,variously,vary,well-developed,wide,yellow,ympodial	abaxial,adaxial,arrangement,branching,characteristic,colour,corolla,false,geminate,growth,height,history,life,maturity,midvein,null,ovary,plant,primary,pseudostipule,seed,shape,staman,sympodial,tertiary,texture,unarmed,venation
263	wfo-0001028975	success	163	115	85	78	30	0.521	.5,0.1-1,0.5-1,1,1-3,1-5,1.2-1.5,1.5-2,3-10-flowered,3-3.5,6-6.5,8-9,?,acuminate,acute,anther,apart,apex,base,beneath,berry,brown,calyx,closely,cm,conical,corky,corolla,dark,densely,dia,difoliate,elliptic,filament,fruit,glabrous,globose,golden,green,immature,leaf,length,like,lobe,long,margin,member,minutely,mm,narrowly,obscured,once-furcate,opposite,ovary,ovoid-reniform,pair,pedicel,petiole,pitted,prominent,pubescent,raised,scar,shiny,shrub,simple,slender,slightly,small,spaced,sparsely,stem,style,surface,tapering,tree,triangular,trichome,tube,uniseriate,varying,vein,white,wide,young	.2,1.5-1.8,2.2-6,3-6.5,5-ribbed,5.5-10,7.5-15,along,anthesi,appearing,area,bark,broad,conically,cup-shaped,decurrent,deflexed,denser,differing,eaf,edicel,eed,entire,epidermi,equal,erect,exserted,extension,free,fruiting,geminat,hyaline,large-celled,late,lateral,lobed,lon,lower,main,mainly,major,mere,middle,minor,nearly,nflorescence,occasionally,older,one,papillo,pore,poricidal,portion,pubescenc,reddi,reflexed,remaining,rib,ruit,shaped,short,sinus,size,somewhat,stigma,straight,strongly,tall,tear-drop,tip,tub,ud,unit,upper,widest,woody,x,ympodial	abaxial,adaxial,arrangement,branching,characteristic,colour,diameter,form,growth,height,history,inflorescence,life,midvein,null,papillose,peduncle,plant,primary,pseudostipule,pubescence,rachi,seed,shape,staman,tertiary,texture,true,unarmed,venation
264	wfo-0001028980	success	168	128	100	68	28	0.595	.1,.5,0.5-1.5,1-1.2,1.2-1.8,1.5-1.8,1.5-2,1.5-6,2.5,4-5,5-6,5-8,6,6-8,acuminate,acute,along,anther,apart,apex,axil,base,beneath,berry,black,broadly,calyx,cm,coarsely,corky,corolla,deflexed,deltoid,densely,dia,drying,elliptic,expanded,filament,flattened-reniform,fleshy,free,furcate,glabrate,glabrous,glandular,globose,green,impressed,incrassate,lateral,leaf,lobe,long,main,major,margin,minor,minutely,mm,occasionally,opposite,ovary,ovate,pair,paler,papillose,pedicel,peduncle,petiole,pit,pitted,portion,prominent,pubescent,reddish,scar,seed,sharply,shining,shrub,simple,small,soon,speciman,stem,style,surface,tall,thick,tree,trichome,tube,type,uniseriate,usually,vein,white,x,yellowish	.75,/3,1.2-3,2.5-5,20-25-flowered,3-4,3/4,7-12,anthesi,bark,basal,beginning,capitate,clearly,conical,cucullate,differentiated,differing,difoliate,dry,eaf,edicel,eed,exserted,extending,f,frui,fruiting,geminat,inflorescenc,lamina,lenticellat,like,lobed,lon,lower,m.,material,member,middle,nflorescence,older,one,ovoid,pale,planar,pore,poricidal,reflexed,ruit,scarious,shaped,size,slightly,sparsely,stigma,strongly,tapering,tear-drop,ti,tip,ud,unit,way,widest,woody,ympodial,young	abaxial,adaxial,arrangement,branching,characteristic,colour,diameter,form,fruit,growth,height,history,inflorescence,length,lenticellate,life,midvein,null,plant,primary,pseudostipule,rachi,shape,staman,tertiary,texture,unarmed,venation
265	wfo-0001028984	success	180	166	130	50	36	0.722	-14,-2,-2.5,-3,-6,-65,-9,0.5-,1,1-,1-1.7,1-2,1-2.5,1-6,1-9,1.2-4,1.5,10-20,15-35,2,2-,2-16,2-2.5,2-3,2-4,20-40,3-10,3-26,3-28,3-6,4-30,4-6,4-6.3,4-7,5,5-10,7-14,8-15,abaxially,acuminate,acute,adaxially,adpressed,age,also,apart,apex,apical,articulated,axe,basal,base,blade,broadly,calyx,chartaceous,cm,color,concave,connective,cordate,densely,diameter,dilated,directed,distally,eglandular,ellipsoid-fusiform,entire,equalling,flower,forked,fruit,glabrous,gland,greenish,hair,lanceolate,laterally,leaving,lobe,long,longer,margin,mm,moderately,obconical,often,ovate,pale,pedicel,pedicellar,peduncle,perfect,petiole,pilose,pore,puberulent,puberulent-pubescent,pubescent-pilose,purple,rachi,radiu,rarely,remnant,ripe,shrub,simple,slightly,small,spaced,sparsely,stamen,stigma,strongly,style,time,tip,tree,truncate,tube,turning,two,unbranched,unit,unknown,violet,wide,x,yellow	12-20,4-5,4-foliat,abruptly,absen,aggregate,almost,ape,broad,campanulate,cell,eaf,eed,especially,exceeding,fleshy,glandular-puberulent,globose,lon,lower,minutely,narrowed,near,nflorescence,nther,obtuse,orolla,ovoid,papillose,pilo,possibly,presence,present,pubescent-pilo,ruit,shorter,stone,subcoriaceous,swelling,tal,tem,thecae,tomento,tomentose,toward,triangular,ud,unknow,vary,ympodial	4-foliate,abaxial,adaxial,anther,arrangement,branching,characteristic,colour,corolla,filament,form,growth,height,history,inflorescence,leaf,length,life,midvein,null,ovary,plant,primary,pseudostipule,seed,shape,staman,stem,surface,sympodial,tertiary,texture,true,unarmed,vein,venation
266	wfo-0001028997	success	136	114	84	52	30	0.618	.5,0.5-0.7,0.5-1,0.5-1.5,0.8-1.1,1-1.2,1-1.5,3-4,3.3.5,4-10,4-4.5,4-angled,5-6,6-7,abaxially,acute,adaxially,anther,apex,appearing,attenuate,base,berry,branched,calyx,cm,corolla,deflexed,dia,dry,drying,elliptic-obovate,erect,filament,flattened-reniform,free,glabrous,globose,golden,green,height,incrassate,lateral,leaf,lobe,long,main,many,margin,matte,minutely,mm,mustard,opposite,ovary,pair,pale,pedicel,pericarp,petiole,pitted,portion,quadrate,revolute,scar,shiny,shrub,spaced,specimen,stem,style,surface,tan,terminal,thick,thickened,time,tube,unevenly,unknown,vein,white,x,yellow	2-2.5,2-3.5,20-50-flowered,6-10,anthesi,apar,area,ba,bark,broadened,conical,coriaceous,cucullate,difoliate,eaf,edicel,eed,elliptic,exserted,filiform,fragrant,fruiting,geminat,glabrou,greenish-brow,later,lobed,lon,lower,merely,middle,nearly,nflorescence,older,papillose,partially,pore,poricidal,ruit,shaped,stigma,strongly,styl,tear-drop,tip,trifoliate,tub,ud,widest,woody,ympodia,young	abaxial,adaxial,apart,arrangement,branching,characteristic,colour,diameter,form,fruit,greenish-brown,growth,history,inflorescence,length,life,midvein,peduncle,plant,primary,pseudostipule,rachi,seed,shape,staman,tertiary,texture,true,unarmed,venation
267	wfo-0001029003	success	207	138	108	99	30	0.522	0.5,1-10,1-2,1.2-2.5,1.5-2.3,11-32,13-36,2.5-10,3,3-20,4-8,5,5-12.5,7-9,9-14,abaxially,acuminate,adaxially,anther,apart,apex,apparently,articulated,attenuate,axe,axillary,base,berry,blue-violet,brownish,bud,cell,cm,condition,conical,corolla,covering,diameter,distal,drying,elliptic,elongated,filament,flower,forked,fourth,fresh,fruit,generally,glabrous,green,green-white,greenish,hair,half,herb,highly,lanceolate,lateral,leaf,leaflet,light,like,lobe,long,make,margin,medium,middle,minute,mm,mottled,mucilaginous,odd-pinnate,ovoid,pale,pedicel,peduncle,perfect,petiole,petiolule,pigmentation,plant,proximal,pubescent,purple,rarely,ray,ripe,seed,sometimes,spaced,sparsely,stem,style,subglabrous,subtending,symmetrical,terminal,testal,thick,throughout,usually,violet,wall,wet,white,whitish	0-6,0.3-0.5,0.4-3,1,1-2.5,1-3,1-5,1.2-1.9,12.2-30,2-6,2.5-7.5,3-5,3.5-7.5,5-10.5,5-merou,7-15.5,absent,acumen,ag,alyx,blade,capitat,chartaceous,ciliate,connivent,decreasing,digestion,dorsally,eaf,edge,eed,end,enzyme,equal,erec,especially,exceeding,flat,folded,geminat,glabrou,gradually,hair-like,hal,homostylous,honeycomb-shaped,interjected,larger,lengthening,living,lower,membranous,nflorescence,obtuse,one,orbicular,orolla,ovate,pair,pentagonal,placed,plurifoliate,pore,poricidal,prostrate,removed,rotate,rounded,ruit,secondary,sessile,seudostipule,size,slightly,slit,specimen,stamen,ste,stigma,stolo,straight,subcapitate,subequal,tall,tamen,tem,tip,toward,tri-,tube,tuber,typically,unit,vary,wide,wing,x,yellow,ympodial	'hair-like,abaxial,adaxial,arrangement,branching,calyx,characteristic,colour,form,growth,height,history,inflorescence,length,life,mentioned,midvein,ovary,primary,pseudostipule,rachi,shape,staman,surface,tertiary,texture,unarmed,vein,venation,ye
268	wfo-0001029006	success	217	178	149	68	29	0.687	-+,0.2,0.4-2.5,0.5,0.5-2,0.5-4,1,1-1.5,1-4,1-5,1.8-2.2,10,10-20,2-3,2-6,2.5,3.5-4,4-6,5,50,7-8,<,>,acuminate,acute,adaxial,along,anther,anthesi,apex,articulated,asymmetrical,axi,axil,basal,base,berry,beyond,blackish,branched,bright,calyx,cell,cm,corolla,deeply,deltate,dense,diameter,elliptic,elongate,entire,exserted,extending,filament,filiform,flattened,flower,glabrous,globose,green,groove,growing,growth,inflorescence,intramarginal,irregular,irregularly,keeled,lamina,later,lateral,leaving,lobe,lobed,long,lower,many,margin,midrib,minute,minutely,mm,narrowly,nearly,nodding,oblique,obvious,occasionally,often,older,one,pair,pale,pedicel,peduncle,peg,pentagonal,per,pericarp,petiole,pinnatifid,pitted,primary,puberulent,pubescent,purple,purplish,reaching,reddish,reniform,ripe,scar,shiny,simple,sleeve,small,smaller,sometimes,spaced,sparsely,spreading,stem,strong,style,surface,tan,terminal,testal,thin,time,tip,trichome,truncate,tube,tuft,twining,uniseriate,upper,usually,variously,vein,vine,violet,white,within,woody,x,young	.5,1.2-1.5,1/3,5-6,5-merou,7-9,abaxially,adaxiall,ag,age,alyx,apar,area,ark,bilobed,black,broadest,c.,chartaceous,clavat,conical,connivent,depending,drying,eaf,eed,ellipsoid,free,fruiting,ilament,inflated,lengthening,loosely,markedly,membranous,new,nflorescence,orolla,papillate,part,pendan,perfect,planar,plurifoliat,pore,poricidal,portion,puberulen,rotate-stellate,ruit,sagittate,size,slit,somewhat,stigma,strongly,sunligh,tem,tiny,twinin,ud,unit,variable,vary,way,widest,ympodial,zig-zag	abaxial,apart,arrangement,bark,branching,characteristic,colour,form,fruit,height,history,leaf,length,life,midvein,null,ovary,plant,plurifoliate,pseudostipule,rachi,seed,shape,staman,sunlight,tertiary,texture,unarmed,venation
269	wfo-0001029031	success	213	163	137	76	26	0.643	-11.4,-12.3,-8,.5-1.2,0-5,0.1-0.5,0.5-1.5,0.5-4,0.6-1.2,0.7-1.1,1-1.5,1-2.5,1-5,1-9.4,1.8-2.7,13.5,2-10.7,2-3,2-3.3,2-5,2.5-5.5,20-150,3-10,4-5-,4-7.5,5-17,6-12,6-21,abaxially,acuminate,acute,adaxially,angle,anther,apart,apex,apparently,articulated,axe,base,becoming,berry,black,blade,bluish,branched,brown,calyx,chartaceous,cm,corolla,cuneate,curved,deltate,densely,denser,diameter,elliptic,elliptic-ovate,entire,erect,filament,flattened,fleshy,flower,forked,fruit,geminate,glabrescent,glabrous,globose,green,hair,held,immature,impressed,lateral,leaf,leaf-opposed,length,light,like,lobe,long,many-foliate,margin,midvein,mm,obtuse,occasionally,outline,pedicel,peduncle,peltate,peltate-stellate,perfect,petiole,porrect-stellate,possibly,prominent,pseudoterminal,pubescence,pubescent,rachi,reniform,ripening,rounded,rugulose,sessile,short-stalked,shrub,side,silvery,simple,small,spaced,sparsely,stellate-pubescent,stem,straight,strongly,style,suborbicular,surface,time,tree,trichome,unbranched,unit,usually,vein,white,whitish,wide,x,yellow,yellowish	-3.6,.1-0.3,0.5,1-2,1-2.6,1-3,1.3-3.3,1.5-2.8,1.5-3.5,1.8-4,1/3,10,2.5-5.6,absent,accrescent,adaxiall,ag,apexacute,around,ba,bilobe,capitate,center,connivent,covering,cylindrical,directed,distally,eaf,edge,eed,eglandula,eglandular,equal,farinose,frui,fruiting,fused,inserted,lanceolate,large,least,longitudinal,lower,major,midpoint,nearly,nflorescence,oblong,opening,orange,orolla,paired,pore,pubescen,rarely,ray,ruit,short,slightly,slit,smaller,sometimes,somewhat,ste,stellate,stigma,subtending,tall,tamen,tem,tip,tube,unarme,vary,ympodial	abaxial,adaxial,arrangement,branching,characteristic,colour,form,growth,height,history,inflorescence,life,null,ovary,plant,primary,pseudostipule,seed,shape,staman,sympodial,tertiary,texture,true,unarmed,venation
270	wfo-0001029048	success	162	139	108	54	31	0.667	.5,0.5,0.5-1,0.5-1.7,0.8-1,1,1-2,1-8,1.5-2,11,2,25,3-4,5-8,8-10,acuminate,angle,another,anther,apex,arching,attenuate,basal,base,bearing,beneath,berry,bicellular,branch,broadly,calyx,cm,conical,corolla,decurrent,dia,elliptic,except,filament,filiform,flower,geminate,glabrate,glabrous,globose,golden,greenish-white,greenish-yellow,hanging,hispidulous,incrassate,lateral,leaf,less,like,lobe,long,main,margin,matte,midrib,minute,minutely,mm,node,non-reproductive,obtuse,one,opposite,ovary,ovoid-reniform,pair,pale,papillose,parallel,pedicel,petiole,pitted,planar,puberulent,right,ripe,rounded,scar,sharply,shrub,slender,slightly,somewhat,stem,straight,style,surface,tall,tan,thread-like,time,tip,translucent,trichome,tube,uni-,unifoliate,unit,vein,winged,x,young	.01,.2,/3,14,26,3-7,3.5-4,4-6,9-15,anthesi,apar,apparent,becoming,blade,bright,eaf,edicel,eed,elongated,expanded,f,free,fruiting,greatly,green,greenish-yello,live,lobed,lower,middle,much,nflorescence,obovoid,older,papillo,pore,poricidal,portion,reflexed,ruit,shaped,small-capitate,spaced,specimen,stigma,tapering,tear-drop,ud,unevenly,way,widely,widest,ympodial,zig-zag	abaxial,adaxial,arrangement,branching,characteristic,colour,diameter,form,fruit,growth,height,history,inflorescence,length,life,mentioned,midvein,peduncle,plant,primary,pseudostipule,rachi,seed,shape,staman,sympodial,tertiary,texture,unarmed,venation,ye
271	wfo-0001029055	success	169	138	98	71	40	0.58	0.4-1.5,1-4,1-5,1.7-2.2,1.8-3.5,14-50,2-3,2-4,4-6,4-7,5-24,5.5-9,8-9,abaxially,acumen,acuminate,acute,adaxially,apex,articulate,attenuate,base,branched,calyx,cell,cm,cordate,corolla,covered,covering,cuneate,cyme,dark,densely,diameter,dichasial,dichasially,distal,ebracteate,elliptical,exceeding,filament,flower,forked,generally,gland,green,green-white,half,herbaceous,lateral,leaf,leaflet,lobe,long,long-attenuate,longitudional,make,mm,monochasial,mucilaginous,near,oblique,odd-pinnate,outline,ovate,ovoid,pedicel,peduncle,perennial,perfect,petiole,pilose,plant,proximal,pubescent,purple,seed,short-stalked,sometimes,stamen,stigma,straight,stripe,style,terminal,testal,thick,throughout,time,triangular,tuber-bearing,typically,unit,wall,wide,widest,Â¼	1-2.6,1.6-3.5,2-1.,2.2-3,2.5-8,3,3-10,3-6,3-6-foliat,4-10,6-14,9-22,apical,apically,connate,decurrent,dehiscent,digestion,diminishing,dorsally,eaf,edge,eed,elliptcal,emoval,enzyme,first,flat,folded,globo,hair,hair-like,honeycomb,interjected,introrse,living,lon,longer,lower,lunat,maturing,nflorescence,nther,often,orolla,pair,pattern,pentagonal,plan,poricidally,rarely,reveal,rotate,ruit,second,sessile,seudostipule,short,short-petiolate,size,slit,specimen,spreading,tal,tem,toward,type,vary,whit,yellow,ympodial	'hair-like,'type,2-11,3-6-foliate,abaxial,adaxial,anther,arrangement,branching,characteristic,colour,form,fruit,globose,growth,height,history,inflorescence,length,life,lunate,margin,mentioned,midvein,ovary,primary,pseudostipule,rachi,shape,staman,stem,surface,sympodial,tertiary,texture,unarmed,vein,venation,wet,white
272	wfo-0001029059	success	199	143	111	88	32	0.558	.5,0.1-0.5,0.1-1,0.2,0.5-1,1-1.5,1-3,1-4,1-6,1.2-3,1.3-1.7,1.5-2,1.5-2.8,3-3.5,3.5-6,5-15-flowered,6-10,7-9,acute,along,anther,apex,base,beneath,berry,branched,calyx,closely,cm,corolla,covered,cuneate,deltoid,densely,dia,difoliate,dirty,elliptic,extremely,filament,flattened-reniform,foetid,geminate,glabrous,globose,hispidulous,impressed,incrassate,inflorescence,lateral,leaf,lobe,long,main,major,margin,member,minor,minute,minutely,mm,oblique,occasionally,often,older,opposite,orbiculate,ovary,pair,pale,papillose,pedicel,petiole,pitted,prominent,pubescence,pubescent,purplish,rest,ripe,rounded,scar,shallowly,shape,shrub,simple,slender,small,spaced,stem,straight,style,surface,tapering,tinge,tree,trichome,tube,underside,unicellular,uniseriate,unit,variable,vein,waxy,white,x,yellowish,yellowish-green,yellowish-tan,young	0.2-0.5,0.5,1-1.2,10-19,2.5,3-6.5,3.5-8,4-10.5,5,anisophyllou,anthesi,apar,ape,apiculae,apiculate,arising,bark,bout,bud,clavate,coiba,connivent,cordate,de,deep,deflexed,dense,differing,eaf,edicel,eed,ellipsoid,expanded,exserted,extending,free,fruiting,glabrate,greatly,interpetalar,isla,lamina,lobed,lon,longest,lower,membranous,middle,narrowly,nearly,nflorescence,one,orange,orangish-yellow,paler,panama,papillo,partially,planar,pointed,population,pore,poricidal,portion,reddish-gre,ruit,shaped,sinus,size,somewhat,soon,sparse,specimen,stigma,tall,tear-drop,terminal,thickened,ti,tightly,tip,triangular,ud,usually,wide,widest,woody,ympodial	abaxial,adaxial,anisophyllous,apart,arrangement,branching,characteristic,colour,diameter,form,fruit,growth,height,history,length,life,mentioned,midvein,peduncle,plant,primary,pseudostipule,rachi,reddish-grey,seed,staman,sympodial,tertiary,texture,true,unarmed,venation
273	wfo-0001029072	exception_thrown	235	0	0	235	0	0.0		-1/2,-15,-2.5,.5,/6,0,0-2,0-20,0-4,0-8,0.1-0.4,0.2-0.3,0.2-0.4,0.3,0.4-0.9,0.5-2,0.5-3,0.7,0.8,0.8-1.5,00-200,1,1-1.2,1-1.5,1-25,1-3,1.5-2.5,1.5-2.6,1.5-3.2,1/3,1/4-1/2,1/4-1/3,12-19,2-10,2-5,2-7,2-8,2.2-2.5,2.2-3.2,2.5-3.5,2.5-3.8,2.5-4.5,20-50,3-10,3-20,3-5,3-50,3-8,3.5-6,3/,4-,4-10,4.2-6.5,4.5-9,5-10,5-50,5-7,5-9,5-merous,7-10,7-15,8-20,8-27,abaxial,abaxially,acute,adaxial,adaxially,alyx,ame,andromonoecious,angled,anther,apar,apart,apex,apically,apparently,articulated,bark,base,berry,blade,branched,bright,broad-deltate,broadly,c.,calyx,chartaceous,clearly,cm,conical,connivent,cordate,cream,cuneate,curved,dark,deltate,densely,diameter,dirty,discolorous,distal,distance,drying,dull,eaf,eed,elongated,elongating,equal,erect,extending,filament,flattened,flattened-reniform,flower,free,fruit,fruiting,gently,glabrous,gra,green,green-brown,herb,hermaphrodite,heterostylous,infructescence,lateral,leaf,least,length,lobe,lobed,long,long-styled,longer,longitudinal,lower,lowermost,margin,marking,mature,maturity,mauve,midpoint,midvein,mm,moderately,multangulate,narrow-deltate,nflorescence,obtu,older,one,open,orange-brown,orolla,oung,ovate,pair,pale,pedicel,peduncle,pendent,pendulous,per,pericarp,petiole,plant,plurifoliat,poricidal,porrect,portion,prickl,prickle,prickly,primary,raised,ray,reflexed,ridge,rounded,ruit,scar,sessile,short-styled,shrub,side,simple,smooth,sometimes,spaced,sparsely,spherical,spreading,stalk,stalked,staminat,stellate,stellate-pubescent,stem,stout,straight,strongly,style,surface,tamen,tapering,terminal,tertiary,time,tip,trichome,tube,unarmed,unit,upper,variously,vary,vein,venation,visible,way,weakly,white,whitish,wide,woody,yellow,ympodial,young	
274	wfo-0001029073	success	211	164	141	70	23	0.668	.5,0.3-1,0.5,0.5-1,0.6-0.7,0.6-2,1-1.5,1-2.5,1-3,1.2-1.6,2,2-3,2-4,2/3,3.5-9,4-5,5-merous,6-9,7-10,8-14,abaxially,acuminate,acute,adaxially,along,another,anther,anthesi,apart,apex,armed,articulated,away,awn-like,base,beneath,broad-based,brown,calyx,cm,conical,corolla,curved,dark,densely,diameter,difoliate,discolorous,drying,elliptic,entire,erect,except,exserted,filament,flower,glabrous,golden,growth,hooked,inflorescence,internodal,interpetalar,lamina,lanceolate,leaf,length,like,linear,lobe,lobed,long,lower,margin,midvein,mixture,mm,multangulate,narrowly,oblique,occasionally,one,opposite,pair,paler,pedicel,peduncle,perfect,petiole,planar,plurifoliate,porrect,prickle,prickly,primary,pubescence,pubescent,purple,ray,scar,sessile,shallowly,short-stalked,shorter,shrub,simple,sinuate,slightly,sometimes,somewhat,spaced,sparsely,stellate,stem,straight,strongly,style,surface,tapering,three,tip,tissue,triangular,trichome,truncate,tube,two,unarmed,underside,unequal,unequally,unisexual,unit,upper,vein,visible,way,x,yellowish,zygomorphic,Â½	.7,1-1.2,1.1-1.5,1.5-2,10-15,10-16,4-6,5-6,5-8,ba,bark,basal,berry,cell,chartaceous,cream,darker,dense,dimorphic,eaf,eed,enlarged,equal,flattened,four,free,frui,fruiting,geminat,globose,gre,lengthening,long-styled,maturity,midpoint,minutely,new,nflorescence,nodding,older,orange,pale,papillose,per,pericarp,pore,poricidal,portion,rectangular,reniform,reticulate,ruit,shiny,short,slit,splitting,stigma,styled,tan,testal,thin,ti,ud,upward,wall,whitish,wide,woody,yellow,ympodial	abaxial,adaxial,arrangement,branching,bud,characteristic,colour,form,fruit,geminate,height,history,life,ovary,plant,rachi,seed,shape,staman,sympodial,tertiary,texture,venation
275	wfo-0001029074	success	174	151	122	52	29	0.701	.1,.5,0,0.2-1,0.3-0.8,0.5-1,0.5-1.2,0.7-0.8,1,1-,1-1.2,1-1.5,1-2,1.4-1.8,1.5-2,11,2-4,2-5,3-,3-6,3.5-5,5-7,abaxially,absent,acute,almost,anther,anthesi,apart,apex,apparently,appearing,articulation,base,berry,black,broadly,calyx,capitate,cm,conical,corolla,cuneate,densely,diameter,entire,filament,flattened,flower,free,glabrous,globose,green,grey,growth,herb,immature,internodal,lacking,leaf,less,lignescent,like,lobe,margin,midpoint,midvein,minutely,mixture,mm,obscuring,often,opposite,ovary,ovate,pair,pale,pedicel,peduncle,per,pericarp,petiole,pitted,portion,primary,prominent,pubescent,pulp,purplish,ray,reflexed,reniform,ripening,rounded,scar,sessile,simple,small,somewhat,sparsely,stalked,stellate,stellate-pubescent,stem,stigma,style,subshrub,surface,swollen,thin,triangular,trichome,truncate,tube,underside,uniformly,unit,vein,watery,white,x,yellowish	0.3-0.4,0.7-0.95,1.5-4,2-2.3,2-7,5-6,adaxially,age,along,bark,basa,deflexed,denser,eaf,eed,ellipsoid,exerted,expanding,frui,fruiting,glabrescen,lengthening,lobed,longest,lower,markedly,new,nflorescence,older,papillat,perfect,petal,planar,plurifoliat,pore,poricidal,ruit,sagittate,scattered,slit,stalk,strongly,tip,tub,ud,uniseriate,usually,way,woody,yellow,ympodial,Â¾	abaxial,adaxial,arrangement,basal,branching,characteristic,colour,form,fruit,height,history,inflorescence,length,life,null,papillate,plant,plurifoliate,pseudostipule,rachi,seed,shape,staman,sympodial,tertiary,texture,true,unarmed,venation
276	wfo-0001029075	success	217	151	122	95	29	0.562	.5,0.8-1.5,1-10,1-2,10-20,2-4,2-5,2.5-3,30-60,4-10,4-7,4.5-6.5,5-10,5-8,6-12,7-9,8-9,abaxially,abruptly,adaxially,anther,apart,apex,apparently,articulated,attenuate-acuminate,axe,axillary,base,berry,broadly,brown,brownish,bud,canescent,cell,cm,condition,corolla,covering,cuneate,dark,densely,diameter,digestion,distal,dot,drying,elliptic-lanceolate,enzyme,exceeding,filament,flecked,flower,forked,fresh,fruit,generally,glabrescent,glabrous,glandular-pilose,glandular-puberulent,gray-green,green,green-white,greenish,hair,hair-like,half,herb,honeycomb-shaped,lanceolate,lateral,leaf,like,lobe,long,long-spatulate,make,margin,mm,mucilaginous,narrowed,narrowly,odd-pinnate,ovoid,pedicel,peduncle,perfect,petiole,plant,pointed,pubescent,rachi,removed,rounded,seed,short,slightly,small,spaced,stamen,stem,straight,style,subobtuse,subquadrate,subtending,terminal,testal,thick,throughout,unwinged,usually,wall,wet,white,whitish,whitish-gray,yellow,yellow-green,yellowish-white	.3,0-3,0-8,0.5-0.8,0.8-1.2,1-2.5,1-3,2.7-4.2,4-14,4-5,5-8.5,5-merou,7-17,acumen,ag,along,alyx,atypically,blade,ciliate,clavifor,connivent,decreasing,decurrent,dorsally,eaf,edge,eed,end,erect,erect-ascendin,especially,etota,flat,folded,geminat,glabrou,gradually,greatly,homostylous,interjected,larger,leaflet,lengthening,light,living,lower,middl,midrib,minutely,nflorescence,orbicular,orne,orolla,ovate,pair,pentagonal,petal,petiolulate,petiolule,plurifoliate,pore,poricidal,puberulent,purple,ruit,sec,sessile,seudostipule,singly,size,slit,sometimes,specimen,ste,stigma,stolo,subequal,substellate,tall,tamen,tem,tip,toward,tri-,tube,tuber,typically,unit,upper,vary,wide,woody,x,ympodial	abaxial,adaxial,arrangement,branching,calyx,characteristic,colour,form,growth,height,history,inflorescence,length,life,middle,midvein,null,ovary,primary,pseudostipule,shape,staman,surface,tertiary,texture,true,unarmed,vein,venation
277	wfo-0001029084	success	192	125	93	99	32	0.484	.5,1-10,1-2,1.1-2.2,10-50,2-3.5,3-6,3.5-7.5,4-17,4-7,4.5-10,4.5-6.5,5,5-7,7-9,8-23,abaxially,acuminate,adaxially,anther,apart,apex,apparently,articulated,axe,axillary,base,berry,brownish,bud,cell,cm,condition,conical,corolla,covering,diameter,distal,drying,filament,flower,forked,fresh,fruit,generally,glabrous,green,green-white,greenish,half,herb,lateral,leaf,light,lilac,lobe,long,make,margin,middle,minute,mm,mottled,mucilaginous,odd-pinnate,ovate-lanceolate,ovoid,pedicel,peduncle,perfect,petiole,petiolule,pilose,plant,proximal,pubescent,purple,ripe,seed,spaced,sparsely,style,subglabrous,subsessile,subtending,terminal,testal,thick,throughout,usually,wall,wet,whitish	0.8-2,0.8-2.1,1-3,1-4,1.5-2.5,2-4,2-5,3.5-8,5-merou,6-13,absent,acumen,ag,along,alyx,arranged,bead,blade,capitat,chartaceous,ciliate,connivent,darker,decreasing,digestion,dorsally,eaf,edge,eed,enzyme,especially,exceeding,flat,folded,geminat,glabrou,gradually,hair-like,homostylous,honeycomb-shaped,interjected,interpetalar,lanceolate,larger,leaflet,lengthening,like,living,lon,lower,midrib,minutely,moniliform,multiple,narrow,necklace,nflorescence,obtuse,orolla,pair,plurifoliate,pore,poricidal,puberulent,ray,removed,rotate,ruit,secondary,semierec,seudostipule,size,slit,specimen,stamen,stigma,stolon,subequal,subglabrou,symmetrical,tall,tamen,tem,thir,tip,tissue,toward,tri-,tube,tuber,typically,unit,unwinged,vary,wide,wing,x,yellow,ympodial	'hair-like,abaxial,adaxial,arrangement,branching,calyx,characteristic,colour,form,growth,height,history,inflorescence,length,life,mentioned,midvein,ovary,primary,pseudostipule,rachi,shape,staman,stem,surface,tertiary,texture,third,true,unarmed,vein,venation
278	wfo-0001029088	exception_thrown	149	0	0	149	0	0.0		.2,.3,0.1,0.6â3.2,0.9â1.5,1.3â4.5,1.5â2,1.5â3,15â25,1â1.2,1â1.5,1â1.6,1â3,2-lobe,2.5â20,2.5â4.2,25â30,2â2.5,2â3,3.5â7,3.5â8,3â16,4â8,5,5-merous,5â8,6-10,<,abaxially,accrescent,acuminate,acute,adaxially,alyx,anther,apar,apex,apicall,axe,base,berry,blade,bronze-brown,c.,calyx,capitate,ciliate,climbing,cm,cordate,cylindrical,densely,diameter,eaf,eed,emarginate,entire,extra-axillary,filament,flattened,flavor,fleshy,flower,fragrant,fruit,fruiting,glabrou,glabrous,greenish-brown,groun,hair,half,heavy,herbaceous,immature,juicy,lanceolate,leaf,lenticular,light,lobe,long,lower,m.,margin,mature,membranous,minutely,mm,moderately,narrowly,near,nflorescence,nternode,obtuse,orolla,ovoid-rhomboid,palmate,papillose,pedicel,peduncle,perfec,petiole,plurifoliat,primary,pubescent,purplish,rachi,reddish-brown,revolute,rounded,rugose,ruit,sand-punctate,scent,shortly,simple,slender,slightly,somewhat,spaced,sparsely,stellate,stigma,stout,straight,strongly,style,surface,swee,sweet,tamen,tem,terrestrial,tip,truncate,truncate-acuminat,tube,unbranched,unit,vary,vein,venation,vine,white,wider,x,ympodial,â7	
279	wfo-0001029089	success	177	127	98	79	29	0.554	.75,0.1-0.25,0.8-1,1,1-1.5,1.5-2,1.5-6,4.5-5,5-20-flowered,5-9,6-7,8-9,acute,along,anther,anthesi,apex,apiculate,axil,base,beneath,berry,branched,calyx,caniculate,cm,corolla,covered,covering,dark,decurrent,deflexed,densely,dia,difoliate,drying,either,elliptic,entire,filament,flattened-reniform,furcate,glabrous,globose,golden,green,impressed,incrassate,lamina,lateral,leaf,like,lobe,long,main,margin,material,minutely,mm,occasionally,opposite,ovary,pair,papillose,pedicel,persistent,petiole,pitted,primary,prominent,pubescent,purplish,reddish-grey,resinous,rounded,rounded-deltoid,shiny,shrub,simple,slightly,small,smooth,somewhat,stem,style,surface,tan,tapering,tip,tree,tube,underside,uniseriate,usually,vein,white,x,young	.5,/4,0.5-0.6,0.5-1,0.8-1.2,1/2,10-25,2.5-3.5,5-10,5-6,abrupt,apart,ba,bark,beginning,bilobed,bud,campanulate,closely,completely,cracking,differing,eaf,edicel,eed,enclosed,erect,expand,exserted,free,fruiting,geminat,glabrou,inflorescenc,later,lobed,lon,lower,major,member,middle,minor,nflorescence,obovoid,older,one,otherwise,overlapping,papillo,part,peeling,pinkish,planar,pore,poricidal,portion,resinou,ruit,scar,secretion,shaped,size,spaced,stigma,still,straight,tall,tear-drop,trichome,tub,ud,unit,varnish,varnished,way,widening,widest,woody,ympodial	abaxial,adaxial,arrangement,branching,characteristic,colour,diameter,form,fruit,growth,height,history,inflorescence,length,life,midvein,null,peduncle,plant,pseudostipule,rachi,seed,shape,staman,tertiary,texture,true,unarmed,venation
280	wfo-0001029091	success	212	181	149	63	32	0.703	-4,-4.5,1,1-2,1.5-,1.5-2,10,170-210,2-2.5,2-3,2.5-,20-30,3-11-lobed,3-4,4,46/1,635/1,7-8,acuminate,acute,age,anther,apex,aromatic,articulation,aspect,axil,base,becoming,berry,blunt,bluntly,broadly,brownish,buff,calyx,campanulate,cell,clonal,close,cm,colour,common,conspicuous,corolla,cuneate,cyme,dark,develop,dia,discoidal,downward,effect,elliptic,erect,filament,floral,flower,flushed,fork,forked,fresh,general,giving,glandular,globular,grey,growing,hair,half,intense,irregular,irregularly,lacking,larger,lasting,lateral,lavender,leaf,light,line,linear,lobe,long,may,mineral,minutely,mm,narrowly,obovate,obscure,occasionally,ochre-yellow,ovate,overlain,ovoid,pale,pattern,pedicel,pedicellate,peduncle,petiolate,petiole,point,pubescent,rachi,raised,readily,reddish-purple,relatively,reticulate-concentric,rh,ridge,ridged,ripe,scarcely,separate,several,shed,shortly,shrub,sigmoid,simple,slender,slightly,soft,soft-wooded,sparsely,speckled,stem,stone,straggly,style,subulate,succulent,surface,tip,toward,transverse,triangular,unit,upper,usually,violet,violet-purple,winged,without,woody,year	-1,-15,0.3-,0.5-0.8,0.5-1,1-10,10-20,10-toothed,15-40,2-12,3,3-,5,5-7,appearing,articulated,ba,capitate,cut,deeply,developed,eed,ellipsoid,emarginated,exceeding,exerted,flattened,fruiting,globose,gree,interacuminal,juvenile,later,lavende,lengthening,linear-lanceolate,long-triangular,lower,mid-vein,nflorescence,oblong,ower,pentagonal,petiol,plurifoliat,pore,poricidal,rounded,ruit,shallowly,sinus,slit,soon,stellate-rotate,stigma,swollen,tall,tissue,tub,ud,well,x,ympodial	abaxial,adaxial,arrangement,branching,characteristic,diameter,form,fruit,green,growth,height,history,inflorescence,length,life,margin,mentioned,midvein,ovary,plant,plurifoliate,primary,pseudostipule,seed,shape,staman,sympodial,tertiary,texture,unarmed,vein,venation
281	wfo-0001029101	success	233	163	141	92	22	0.605	-3,.5,0-2,0-20,0-5,0-8,0.4-1.5,0.5-1,0.8-3.5,00-200,1,1-1.5,1-3,1.3-2,1.5-2,1.5-2.5,1.8-3,1/5-1/4,10-14,10-20,2-,2-6,2.5-3.5,2.5-6,2.8-3.3,3-,3-4,30-100,4-12,5-,5-20,5-6,5-7,5-9,5.5-8,7-13,abaxial,acute,adaxial,almost,anther,apex,apically,apparently,articulated,base,berry,blade,branched,brown-green,calyx,cell,cm,concolorous,connivent,cream,cuneate,dark,deltate,diameter,discolorous,drying,dull,elliptic,equal,erect,filament,flattened-reniform,flower,free,fruit,glabrescent,glabrous,green,infructescence,lateral,leaf,length,like,lobe,lobed,long,long-styled,longer,margin,marking,maturity,mauve,midvein,mm,moderately,obovate,obtuse,orange-brown,outline,ovate,pair,pale,pedicel,peduncle,per,petiole,pit,plant,poricidal,portion,prickle,prickly,primary,raised,rarely,rounded,short-styled,shrub,side,simple,small,smooth,sometimes,sparsely,spherical,stellate-pubescent,stem,straight,style,surface,tapering,terete,tertiary,thick,time,tip,tube,unit,vein,venation,visible,wide,yellow,yellow-green,young	-15,/3,/4,0-100,0.1,0.1-0.4,0.1-0.5,0.1-0.7,0.1-1,0.2,0.7-,1-4,1-8,1.3-2.6,1.4-2.2,1.7,2-20,2/3-3/4,3-10,3-7,4-7,5-8,5-merous,6-8,8-15,abaxially,always,alyx,andromonoecious,apar,apart,bark,broad-deltate,chartaceous,darker,distal,distance,eaf,eed,elongating,extending,flattened,fruiting,green-brow,hermaphrodite,heterostylous,lengt,lon,lower,lowermost,mature,midpoint,multangulate,narrow-deltate,nflorescence,oblong,often,older,one,open,orolla,oung,pendulous,pericarp,plurifoliat,porrect,present,prickl,ray,reduced,reflexed,rounde,ruit,scar,secondary,sessile,spaced,spreading,stalk,stalked,staminat,stellate,suborbicular,tamen,trichome,variously,vary,way,well-developed,woody,yellow-orange,ympodial	arrangement,branching,characteristic,colour,corolla,form,growth,height,history,inflorescence,life,mentioned,ovary,plurifoliate,pseudostipule,rachi,seed,shape,staman,sympodial,texture,unarmed
282	wfo-0001029106	success	200	182	158	42	24	0.79	.1,.5,0-0.3,0-10,0-2,0-20,0-5,0-6,0.1,0.2-0.4,0.2-1,0.25-0.7,0.5-0.9,0.5-1,0.5-2.5,0.9-1.2,1-2,1-5,1.5-1.8,1.5-2,1.5-3.5,1/4,1/5-1/4,2-4,2-5.5,2-6,2-8,2.2-3,3-25,3-3.5,3-4,4-6,4-8,5-14,6-8,ame,anther,apart,apex,apically,apparently,articulated,bark,base,berry,blade,branched,c.,calyx,cell,cm,concolorous,cuneate,curved,deltate,densely,diameter,discolorous,distance,drying,elliptic,equal,erect,extending,eye,filament,flattened,flattened-reniform,flower,free,fruit,gently,glabrescent,glabrous,infructescence,lateral,leaf,length,light,lobe,lobed,long,longer,lower,margin,maturity,mauve,membranous,midpoint,midvein,mm,naked,obtuse,older,one,open,orange,orange-brown,orbicular,outline,ovate,pair,pale,pedicel,peduncle,per,pericarp,petiole,pit,porrect,portion,prickle,prickly,primary,raised,ray,red,reflexed,rounded,scandent,scar,sessile,shallow,shiny,shorter,shrub,side,simple,size,slender,small,smooth,sometimes,spaced,sparsely,spherical,stalk,stalked,stellate-pubescent,stem,straight,style,subentire,surface,terete,tertiary,time,trichome,tube,variously,vein,venation,visible,weakly,white,wide,yellow-orange,yellowish-green	-6,/3,0,0.5,0.5-0.8,1-1.6,2-3.5,2/,5-8,5-merous,abaxially,acuminat,acute,alyx,apar,appearing,eaf,eed,elongating,fruiting,lon,mature,nflorescence,orange-brow,orolla,oung,pendulous,perfec,plurifoliat,poricidal,prickl,spreading,stellate,tamen,tapering,tip,uit,unit,vary,way,woody,ympodial	2/3,abaxial,adaxial,arrangement,branching,characteristic,colour,corolla,form,growth,height,history,inflorescence,life,null,ovary,plant,pseudostipule,rachi,seed,shape,staman,texture,unarmed
283	wfo-0001029112	success	190	156	126	64	30	0.663	0-2,1-10,1-2,1-3,1-4,1.4-2.5,1.5-1.8,1.5-2,10-17,10-21,2-3.5,2.5-4.5,2.6-3,2.7-3.5,2.7-4.2,2.7-5.7,20,3-5,3-6,3-7,3.5-4.5,3.5-7,5,5-8,6.5-5.5,9.5-13,abaxially,acumen,acuminate,adaxially,anther,apart,apex,apparently,articulated,axe,axillary,base,berry,blade,brownish,bud,cell,chartaceous,cm,condition,conical,corolla,covering,decreasing,densely,diameter,distal,drying,elliptic-lanceolate,equal,exceeding,filament,flower,forked,fresh,fruit,generally,glabrous,gradually,green,green-white,greenish,hair,hair-like,half,herb,interjected,larger,lateral,leaf,leaflet,light,like,lobe,long,make,margin,middle,minute,mm,mottled,mucilaginous,obtuse,odd-pinnate,ovate,ovoid,pair,pale,pedicel,peduncle,perfect,petiole,petiolule,plant,present,pubescent,purple,ray,ripe,secondary,seed,size,slightly,spaced,stamen,style,subequal,subtending,symmetrical,terminal,testal,thick,throughout,toward,usually,violet,wall,wet,whitish,x	0.5,0.9-1.7,3-4,5-merou,ag,along,alyx,arranged,bead,capitat,ciliate,connivent,digestion,dorsally,eaf,edge,eed,enzyme,especially,flat,folded,geminat,glabrou,homostylous,honeycomb-shaped,lanceolate,lengthening,living,lower,moniliform,multiple,narrow,necklace,nflorescence,orolla,plurifoliate,pore,poricidal,pubescen,removed,rotate,ruit,semierec,seudostipule,slit,specimen,ste,stigma,stolon,tall,tamen,tem,thir,tip,tri-,tube,tuber,typically,unit,vary,wide,wing,yellow,ympodial	abaxial,adaxial,arrangement,branching,calyx,characteristic,colour,form,growth,height,history,inflorescence,length,life,midvein,null,ovary,primary,pseudostipule,rachi,shape,staman,stem,surface,tertiary,texture,third,unarmed,vein,venation
284	wfo-0001029120	exception_thrown	168	0	0	168	0	0.0		.05,.5,.75,/2,0.1-0.5,0.5-1.5,0.7-1,1-1.5,1.1-1.5,1.1-2,2.5-3.5,2.6-7,3-3.5,5-10-flowered,5-8,6-8,6.5-16.5,8511,abrupt,acuminate,acute,anther,anthesi,apart,apex,bark,basal,base,beginning,beneath,black,bud,bullate,calyx,cell,cm,corolla,dark,decurrent,deflexed,densely,dia,difoliate,dry,drying,eaf,edicel,eed,epidermi,erose,especially,evenly,f,fide,filament,fleshy,free,geminat,glabrous,globose,golden,greenish-brown,hirsute,inflorescenc,infloresence,internodal,know,known,lanceolate,large,larger,later,lateral,leaf,lehmann,like,lobe,lobed,lon,long,long-triangular,lower,main,margin,middle,midrib,minor,minutely,mm,narrow,narrower,narrowly,nearly,nflorescence,occasionally,often,older,opposite,outer,ovary,ovate,pair,pale,paler,papillose,pedicel,peduncl,peduncle,petaloid,petiole,point,pore,poricidal,portion,present,prominently,proximal,pubescent,raised,reproductive,rest,ruit,scar,scattered,shaped,shrub,simple,slender,slightly,spaced,sparsely,specimen,speckle,stem,stigma,straight,style,surface,sympodial,tall,tapering,tear-drop,terminal,thickened,tip,trichome,tub,tube,ud,unbranched,unifoliate,uniseriate,unit,upper,urceolate,vein,venation,way,white,white-papillo,wide,widening,widest,x,yellow,yellow-green,ympodial,young	
285	wfo-0001029121	success	161	139	101	60	38	0.627	0.2-2,1-4,1-5,1.1-3.9,15-30,2-10,2-13,2-3,2-3-celled,3.8-11,4-10,4-5.5,5-8,8-16,abaxially,acumen,acuminate,acute,adaxially,apex,articulate,attenuate,base,blue,branched,calyx,cell,cm,conical,corolla,covering,cuneate,cyme,deep,diameter,dichasial,dichasially,digestion,distal,ebracteate,elliptical,emoval,enzyme,exceeding,filament,flower,forked,generally,glabrous,green,green-white,hair,hair-like,half,herbaceous,honeycomb,lateral,leaf,living,lobe,long,make,medium,mm,monochasial,mucilaginous,narrowly,oblique,obtuse,odd-pinnate,ovate,ovoid,pattern,pedicel,peduncle,perennial,perfect,petiole,plant,proximal,purple,reveal,rounded,scattered,seed,short,short-attenuate,specimen,stamen,stigma,straight,style,testal,thick,throughout,tip,tuber-bearing,typically,unit,wall,Â¼	-6,0,0-2,1.2-2.5,1.2-3.3,10,2-,3-5,3-6-foliat,3.6-9,4.5-10.0,5-20,9-33,abaxiall,apical,apically,commonly,connate,dehiscent,diminishing,dorsally,eaf,edge,eed,flat,folded,globo,gradually,interjected,introrse,leaflet,lon,lower,lunat,maturing,nflorescence,nther,often,orolla,pair,petiolule,plan,poricidally,rarely,rotate,ruit,sessile,seudostipule,size,slit,subequal,tal,tem,terminal,throughou,toward,vary,wide,yellow,ympodial	'hair-like,3-6-foliate,abaxial,adaxial,anther,arrangement,ba,branching,characteristic,colour,form,fruit,globose,growth,height,history,inflorescence,length,life,lunate,margin,mentioned,midvein,ovary,primary,pseudostipule,rachi,shape,staman,stem,surface,sympodial,tall,tertiary,texture,unarmed,vein,venation
286	wfo-0001029125	success	197	154	133	64	21	0.675	.1,.2,.5â2.0,0.5â0.6,0.5â1.0,1.0â1.2,1.0â1.5,1.5â3.0,1.7-,1â2-celled,20â100,2â3-celled,2â4,3.0â3.4,3.5â4,35â45,3â5,4â8,5â6,6,6â7,abaxial,acuminate,acute,adaxial,along,anther,anthesi,apex,apparently,appressed,arising,articulated,attenuate,base,berry,beyond,black,branching,brownish,calyx,cell,central,cm,concave-reniform,cone,corolla,cuneate,delicate,deltate,densely,diameter,difoliate,end,entire,especially,exerted,filament,flower,fruit,glabrous,globose,green,herb,hilum,internodal,lateral,leaf,like,lobe,long,lower,margin,maturity,mm,narrower,oblique,occasionally,often,one,orange,outline,ovary,ovate-lanceolate,pair,pedicel,peduncle,pentagonal,per,petiole,place,plant,positioned,primary,pubescent,purple,purple-tinged,purplish,ridged,ripe,seed,shiny,simple,single,slightly,small,sparsely,spreading,star,stem,stemmed,stone,straight,style,sub-lateral,subshrub,surface,terete,testal,tinged,toward,traingular,trichome,turning,unequal,uniseriate,vein,white,wide,woody,yellow,young,Â¼	.0â3.5,.1â1.4,.4,.6,0.5,0.8â0.9,0.9,1,1.0â4.0,1.5â2.0,1.8â3.5,2.5â12.0,2/3,3â5-celled,5-merous,abaxially,adaxially,age,apar,ba,closely,conical,eaf,eed,ellipsoid,free,fruiting,geminat,growt,later,lengthening,live,lobed,lon,maximum,minutely,nearly,nflorescence,pale,papillate,perfect,pore,poricidal,portion,reflexe,reflexed,ruit,scar,scattered,shorter,slit,spaced,stellate,stigma,strongly,tall,tem,tip,tube,ud,unit,usually,whitewith,ympodial	1.2,arrangement,characteristic,colour,form,growth,height,history,inflorescence,length,life,midvein,null,pseudostipule,rachi,shape,staman,tertiary,texture,unarmed,venation
287	wfo-0001029150	success	177	158	128	49	30	0.723	.5,0.3,0.3-0.5,0.3â0.5,0.5â1.1,0.8-1,0.8â1,0.8â1.5,0.8â3.5,1.2â1.5,1.5,15,1â1.5,1â11,1â5,1â6,2.5â3,2.5â5,2.5â8,2â10,2â3,3-5,3â10,3â4,3â50,6,8-shaped,9â12,abaxially,across,acute,adaxially,anther,apex,apically,apiculate,axe,base,berry,branched,calyx,canopy,ciliate,climbing,cm,color,conical,cros,cylindrical,delicate,diameter,ellipsoidal,elliptical,enlarged,entire,except,extra-axillary,filament,flattened,flower,fruit,glabrous,larger,leaf,light,lobe,long,margin,membranaceous,midvein,minutely,mm,moderately,nearly,oblique,older,opposed,ovate,pair,pedicel,peduncle,petiole,pinnate,pointed,pubescent,rachi,rarely,reaching,rounded,rounded-deltoid,rugose,sand-punctate,scar,secondary,section,shortly,simple,slender,slightly,small,somewhat,spaced,sparsely,stellate,stem,strong,style,surface,tan,teardrop-shaped,thick,thickened,time,tip,tree,trichome,truncate,understory,unit,vegetation,vein,venation,vine,white,wide,wiry,woody,x	1.5â2,1.5â2.2,1â2,2â2.5,5-merous,7â8,accrescent,adaxiall,alyx,apar,apicall,attenuate,blade,c.,capitat,distant,dried,eaf,eed,fleshy,flush,fruiting,glabrou,inconspicuous,lamina,lanceolate,living,lon,lower,m.,material,mor,nflorescence,nternode,orolla,pale,perfec,pinkish-white,plurifoliat,ruit,side,specimen,stigma,tamen,tem,translucent,tube,vary,ympodial	1-1.5,2,abaxial,adaxial,apart,arrangement,branching,characteristic,colour,corolla,form,growth,height,history,inflorescence,length,life,null,ovary,plant,plurifoliate,primary,pseudostipule,seed,shape,staman,sympodial,tertiary,texture,unarmed
288	wfo-0001029152	success	197	157	129	68	28	0.655	.1,.5,0.5-1,0.8-1,0.9-1.3,1,1-1.5,1-3,1-4,1.1-1.3,1.5-2,2-2.5,2-3,2-5,2.5-3,3-8-flowered,4-6,6-8,acuminate,acute,anther,anthesi,apex,appressed,area,attenuate,base,beneath,berry,blade,branch,broadened,broadly,brown,calyx,cm,conical,corolla,cuneate,dark,deciduous,decurrent,deflexed,deltoid,densely,dia,difoliate,distal,dry,elliptic,filament,flattened,floccose,flower,free,fruit,giving,glabrous,globose,green,held,inflorescence,keeled,lateral,leaf,lightly,live,lobe,long,long-styled,main,major,margin,material,middle,midrib,minor,minutely,mm,obovate,often,opposite,ovary,ovoid-reniform,pair,pale,papillose,pedicel,per,petiole,pitted,plane,plant,portion,prominent,prominently,red,red-floccose,reddish,reddish-floccose,rounded,shape,short-styled,shrub,simple,single,slender,small,somewhat,soon,stem,stigma,straight,style,surface,tapering,third,tip,tree,trichome,tube,usually,vein,weak,white,widest,winged,x,young	0.25-0.5,0.75-1,1-2,1.5-1.7,2-4,3-5,61-25,8.5-16,appearanc,appearing,ba,bark,beginning,bud,citronella,closely,completely,corky,deep,differing,eaf,edicel,eed,ellipsoi,enclosing,erect,et,exsertion,fide,fragrance,fruiting,geminat,greyish-red,hyaline,inflorescenc,large-lenticellate,late,lobed,lon,longer,lower,nearly,nflorescence,older,one,overlapping,planar,pore,poricidal,quite,reflexed,reminiscent,ruit,scar,shaped,shiny,size,slightly,spaced,styl,tall,tear-drop,terminal,tillett,ud,unit,woody,ympodial	abaxial,adaxial,appearance,arrangement,branching,characteristic,colour,diameter,form,geminate,growth,height,history,length,life,mentioned,midvein,null,peduncle,primary,pseudostipule,rachi,seed,staman,tertiary,texture,unarmed,venation
289	wfo-0001029156	success	65	95	56	9	39	0.862	-3,0.5,1,1.5-2,10-12,2,4-6,6,6-8,<,almost,apex,apparently,berry,cell,center,cm,completely,deeply,diameter,epiphytic,flattened,fruiting,glabrous,golden,growth,lateral,liana,long,margin,minute,minutely,mm,multiseriate,new,occasionally,pale,pedicel,per,pitted,rectangular,reniform,rib-like,seed,shiny,sinuate,stem,surface,tan,testal,thickening,trichome,vine,wall,wide,woody	bark,eed,exfoliating,fide,markedly,nee,noddin,older,shreddy	abaxial,adaxial,anther,arrangement,base,branching,calyx,characteristic,colour,corolla,filament,form,fruit,height,history,inflorescence,leaf,length,life,lobe,mentioned,midvein,nodding,null,ovary,peduncle,petiole,plant,primary,pseudostipule,rachi,shape,staman,style,tertiary,texture,unarmed,vein,venation
290	wfo-0001029156	success	65	81	41	24	40	0.631	-3,1.5-2,10-12,4-6,6-8,almost,apex,berry,center,cm,completely,deeply,diameter,flattened,fruiting,glabrous,growth,lateral,liana,margin,minutely,mm,new,pale,pedicel,per,pitted,rectangular,reniform,rib-like,seed,shiny,sinuate,stem,surface,tan,thickening,vine,wall,woody,x	0.5,1,2,<,apparently,ark,cell,eed,em,epiphytic,exfoliating,fide,golden,lon,markedly,minute,multiseriate,nee,noddin,occasionally,older,shreddy,testal,trichome	6,abaxial,adaxial,anther,arrangement,base,branching,calyx,characteristic,colour,corolla,filament,form,fruit,height,history,inflorescence,leaf,length,life,lobe,mentioned,midvein,nodding,null,ovary,peduncle,petiole,plant,primary,pseudostipule,rachi,shape,staman,style,tertiary,texture,unarmed,vein,venation
291	wfo-0001029163	success	149	138	106	43	32	0.711	-25,-4,-9,0.3-2.5,0.5-1,1,1-2,1.5-2,1.5-2.5,1.5-3,10-,2,2-18,2-3,2-6,2-7,2.5-3,20-30,3-14,3-4,4-20,4-6,4.5-23,5-12,5-8,7-9,abaxial,abaxially,acuminate,acute,adaxially,aggregate,apart,apex,articulated,axe,base,blade,calyx,cell,chartaceous,cm,color,cuneate,cylindrical,decurrent,deltate,densely,denser,diameter,distally,eglandular,elliptic,elliptic-ovate,entire,flower,fruit,glabrous,glandular,globose,hair,herb,leaving,lenticular,like,lobe,long,margin,mm,moderately,narrowed,nearly,obtuse,pedicel,pedicellar,peduncle,perennial,petiole,pseudohair,puberulent,puberulent-pubescent,purple,rachi,radiu,remnant,ripe,shrub,simple,slightly,spaced,sparsely,stalked,stem,stone,style,surface,thickened,time,tip,unbranched,unknown,vein,white,whitish,wide,x	13-18,3-5,4-5-foliat,9-15,absen,adaxiall,band,connivent,directed,distall,eaf,eed,free,lanceolate,lon,lower,narrowly,nflorescence,nther,orolla,papillose,pore,projection,puberulent-pubescen,pubescence,roughened,ruit,scale-like,small,sometimes,stellate,stigma,subapical,subcoriaceous,tal,tem,triangular,truncat,tube,unit,vary,yellow,ympodial	absent,adaxial,anther,arrangement,branching,characteristic,colour,corolla,description,filament,form,growth,height,history,inflorescence,leaf,length,life,mentioned,midvein,ovary,plant,primary,pseudostipule,seed,shape,staman,tall,tertiary,texture,unarmed,venation
292	wfo-0001029171	success	137	131	96	41	35	0.701	-,-10,-15,0.5,1-3,1-4.5,1-5,1.5-2,1.5-7.5,10-25,10-35,2-3,3-4,3.5-18,3.5-6.5,4-10,4-5,5-6,5-8,6-,7-9,abaxially,abruptly,acuminate,acute,adaxially,also,and/or,angled,apart,apex,articulated,axe,base,blade,branched,calyx,cm,cuneate,cylindrical,decurrent,deltate,dendritically,dense,densely,diameter,eglandular,elliptic,entire,flower,forked,fruit,glabrous,gland,glandular,globose,hair,like,lobe,long,margin,mm,moderately,narrowed,obtuse,often,orange,ovate-elliptic,pedicel,peduncle,perfect,petiole,puberulent,pubescent,purple,rachi,radiu,rarely,red,ripe,rugose,short-stalked,shrub,simple,slightly,smooth,sometimes,spaced,style,time,tip,unbranched,unit,white,wide,x	11-20,8-17,absen,aggregate,ba,cell,chartaceous,connivent,directed,distall,eaf,eed,except,glandula,lanceolate,lower,many-foliat,midrib,narrowly,near,nearly,nflorescence,nther,orolla,pore,ruit,shoot,sparsely,ste,stellate,stigma,stone,tal,tem,triangular,truncat,tube,usually,vary,yellow,ympodial	abaxial,adaxial,anther,arrangement,branching,characteristic,colour,corolla,filament,form,growth,height,history,inflorescence,leaf,length,life,many-foliate,mentioned,midvein,ovary,plant,primary,pseudostipule,seed,shape,staman,stem,surface,sympodial,tertiary,texture,unarmed,vein,venation
293	wfo-0001029215	success	49	82	41	8	41	0.837	-1.8-2.3,.2,0.3-0.5,0.5-0.7,0.5-2.5,1,2.3-2.9,appearance,border,brown,calyx,cell,cm,coarse,diameter,elongating,entire,fruit,give,hair-like,herb,lateral,lobe,long,markedly,mm,narrowly,outgrowth,pubescent,round,shrub,silky,small,surface,tall,testa,thick,wall,wide,winged,woody	eed,fide,obovate,smelling,spreadin,strong,weigend,xyledecor	abaxial,adaxial,anther,apex,arrangement,base,branching,characteristic,colour,corolla,filament,form,growth,height,history,inflorescence,leaf,length,life,margin,mentioned,midvein,ovary,pedicel,peduncle,petiole,plant,primary,pseudostipule,rachi,seed,shape,spreading,staman,stem,style,tertiary,texture,unarmed,vein,venation
294	wfo-0001029216	success	243	182	156	87	26	0.642	+,-10,0.2-0.3,0.3-0.4,0.4-0.5,0.5,0.5-0.8,0.6-1,1-1.2,1-2,1.2-6,1.5-2.3,1.5-2.5,10,10-14,2,2-locular,2.5-3.3,3,4,5,5-15-flower,<,absent,acute,adpressed,allogamous,and/or,annual,anther,anthesi,apex,appearance,articulated,attenuate,base,basiscopically,becoming,biennial,branch,bright,brown,calyx,cell,cm,column,composed,conical,cordate,corolla,crenate,cultivar,decurrent,deep,deeply,dentate,diameter,distal,elliptic,entire,erect,exserted,extending,facultatively,fasciated,filament,fruit,giving,glabrescent,gland-tipped,glandular,globose,green,hair-like,halfway,herb,imparipinnate,included,inflorescence,initially,interrupted,later,lateral,length,less,like,linear,lobe,lobulate,long,longer,mainly,margin,maturity,minute,minutely,mixture,mm,multicellular,multilocular,narrowly,near,numerous,oblique,obovate,often,one,orange,outgrowth,ovary,ovate,pale,particularly,pedicel,peduncle,pentagonal,perennial,petiole,plant,population,primary,procumbent,pseudostipule,pubescent,rarely,red,shaggy,shape,short,silky,simple,sometimes,sparse,sparsely,staminal,stem,straight,strong,style,surface,tertiary,testa,thick,toward,trichome,truncate,unicellular,uniseriate,usually,varying,villous,viny,wall,wide,winged,yellow	-0.5,-5,.5,.8-1,0.1-0.3,0.1-0.5,0.1-0.6,0.1-0.8,0.2-0.25,0.2-0.4,0.2-0.8,0.3-0.5,0.3-2,0.4,0.5-1.5,0.5-2,0.6-0.8,0.8-2.5,1-3,1-4,1-6,1.5-3,1/,10-,2-4.5,20-35,3-,3-4,3-5,3-7,3-foliate,6-10,7-10,absen,accrescent,acroscopically,always,angeld,apical,appendage,articulation,axi,basal,capitate,cente,cone,eaf,edicel,eed,fruited,fruiting,gree,half,interjected,internode,lanceolate,large,larger,leaflet,lon,lower,nflorescence,pair,petiolule,present,reflexe,ruit,scen,secondary,sessile,shaped,somewhat,spreading,sterile,stigma,strongly,tangled,tem,terminal,thickening,tip,total,tube,ud,unit,variety,ympodial	1/3,abaxial,adaxial,arrangement,branching,bud,center,characteristic,colour,form,growth,height,history,leaf,life,midvein,null,rachi,scent,seed,staman,texture,true,unarmed,vein,venation
295	wfo-0001029226	success	206	152	122	84	30	0.592	-7,-9,.5,0-1,0.5-5,1-1.5,1-3,10-40+,2,2-6,2.5-10,3-3.5,30,5-7,7-11,8-13,>,acuminate,acute,anther,apex,apparently,articulated,basal,base,berry,branched,bright,calyx,cell,cm,cordate,corolla,decurrent,deltate,densely,diameter,dry,elongate,enation,entire,filament,flattened,flexuous,flower,glabrescent,glabrous,glandular,globose,green,growth,hairy,herbaceous,lateral,lavender,leaf,like,lobe,lobed,long,lyrate,many,margin,material,mature,mere,minutely,mm,occasionally,older,open,pair,pale,papillate,pedicel,peduncle,per,petiole,pinnatifid,pitted,primary,pubescent,red,reniform,rim,ripe,seed,shiny,short-glandular,shrub,simple,sleeve,small,sparsely,spot,sprawling,stem,style,surface,tan,terminal,testal,third,time,tip,translucent,trichome,truncate,uniformly,uniseriate,unit,usually,vein,vine,wall,weak,white,wide,widest,winged,woody,yellowish	.75,0.5,1-2,1-celled,2-3,2-9,3-6,4,4-6,5-merou,ag,alyx,anthesi,apart,ark,ba,black,blue,breaking,capitate,completely,congested,conical,connivent,dark,distall,divided,eaf,eed,ellipsoid,exserted,free,fruiting,gland,ilament,irregularly,juice,lengthening,longer,loosely,lower,membranous,minute,new,nflorescence,often,one,orolla,overtopping,papillat,papillo,perfect,pinnate,plurifoliat,pore,poricidal,portion,reflexed,remainin,ruit,sagittate,scar,scarlet,shorter,slender,slit,sometimes,spaced,spreadin,spreading,staining,stellate,stigma,strongly,tangled,tem,thin,tube,twinin,ud,vary,way,ympodial,Â¾	abaxial,adaxial,arrangement,bark,branching,characteristic,colour,form,fruit,height,history,inflorescence,length,life,midvein,null,ovary,plant,plurifoliate,pseudostipule,rachi,shape,staman,sympodial,tertiary,texture,true,twining,unarmed,venation
296	wfo-0001029236	success	159	123	99	60	24	0.623	.5,0.2-1,0.45-0.5,0.5,1-1.5,1-2,1.4-1.7,2-4,2-5,3,6-9,adaxial,anther,anthesi,apex,apical,apically,appearing,axi,basal,base,berry,branch,branching,broadly,calyx,cm,compact,completely,coriaceous,corolla,deflexed,deltate,dendritic,densely,diameter,dichasial,elliptic,erect,except,filament,flattened,fleshy,flower,fruit,glabrous,globose,grey-brown,growth,lateral,leaf,lenticular,less,lobe,long,many,margin,middle,midvein,minutely,mm,narrowly,near,nodding,obscure,occasionally,ovary,overtopping,pale,pedicel,per,pericarp,petiole,pitted,plurifoliate,pointed,pubescent,purplish-black,reddish-brown,revolute,scattered,shiny,shoot,shrub,simple,slightly,sparsely,stem,strongly,style,surface,tapering,terminal,thin,time,trichome,venation,violet,x	0.2-0.7,0.5-1.5,0.9-2.3,1/2,abaxially,absent,age,apparently,ba,bark,becoming,bi-lobe,branchlet,conical,cupulate,decurrent,eaf,edicel,eed,ew,exserted,free,fruiting,inserted,later,lobed,lower,m.,nflorescence,obscurely,older,packe,persistent,pore,poricidal,portion,prominent,purplish,ruit,scar,secondary,short,sleeve,slit-like,stamen,stigma,tall,tip,trongly,tub,tube,ud,unit,usually,way,wide,winged,woody,ympodial,young	abaxial,arrangement,characteristic,colour,form,height,history,inflorescence,length,life,null,peduncle,plant,primary,pseudostipule,rachi,seed,shape,staman,tertiary,texture,true,unarmed,vein
297	wfo-0001029246	success	209	133	111	98	22	0.531	-1,-1.5,-4,0,0-15,0-5,0.1-0.4,0.3-0.8,0.7-1.3,0.7-2,0.8-1.1,0.9-1.3,1-1.5,1-3,1.5-2.3,1/3,2,2-3,2-5,2.5-3.2,2.8-4,3-5,3.5-5,4-6,5-20,7-12,abaxial,acuminate,acute,adaxial,anther,apex,apically,articulated,base,berry,calyx,cm,cuneate,deltate,densely,diameter,dull,elliptic,entire,erect,eye,filament,flattened-reniform,flower,free,fruit,glabrescent,glabrous,infructescence,leaf,length,less,lobe,lobed,long,lower,margin,maturity,mauve,midvein,mm,moderately,naked,obtuse,one,open,orange-brown,orange-red,pair,pale,pedicel,peduncle,per,petiole,porrect,portion,prickle,prickly,primary,procumbent,purple,recurved,sessile,shrub,sometimes,sparsely,spherical,stellate-pubescent,stem,style,surface,terete,tertiary,time,trichome,tube,unarmed,unbranched,upper,vein,venation,visible,white,wide,yellow	/5,0.1-0.3,0.15-0.3,0.2-1.5,0.3-0.5,0.5,0.5-1.5,0.7-1.5,0.8-3,1-1.8,1-10,1-4,1-5,1-8,1.2-2,1.5-2.5,1.5-6,1.7-6,1.8-3,1/10-1/5,2-3.5,2/3,2/3-3/,3-20,5-,5-merous,6-10,6-8,8-16,abaxially,acuminat,almost,alyx,apar,apart,apparently,bark,blade,broad-deltate,c.,chartaceous,concolorous,connivent,curved,discolorous,distance,drying,eaf,eed,elongating,equal,extending,flattened,fruiting,lateral,lon,longer,mature,midpoint,narrow-deltate,narrow-ovate,nflorescence,oblong,older,orange-brow,orolla,oung,pendulous,perfec,pericarp,plurifoliat,poricidal,prickl,pubescent,ray,rounded,ruit,scar,side,simple,smooth,spaced,spreading,stellate,stout,straight,strongly,tamen,tapering,tip,unit,usually,vary,way,woody,yellow-orange,ympodial,Â¼	2/3-3/4,arrangement,branching,characteristic,colour,corolla,form,growth,height,history,inflorescence,life,null,ovary,plant,plurifoliate,pseudostipule,rachi,seed,shape,staman,texture
298	wfo-0001029286	success	224	148	127	97	21	0.567	.5,0.8,0Â°,1-1.5,1-2,1.5-2,1.5-4,1/8,15-50,2-3,2.5-3,3-4,4-5,4-6,4.5,4.5-7,5,5-6,6-8,6-9,7-10,abaxial,abaxially,acute,adaxially,along,anther,anthesi,apex,apically,apiculate,arising,articulation,attenuate,axil,bark,base,branch,branched,branching,broadly,brown,canaliculate,chartaceous,clustered,cm,concolorous,conical,corolla,cuspidate,deltoid,dendritic,diameter,dilated,drying,entire,except,extending,faint,filament,flat,flexuous,flower,forming,free,glabrous,green,grey,hair,isolated,leaf,length,less,liana,light,lilac,lobe,long,main,margin,mas,mauve,meeting,membranous,middle,midvein,mm,multicellular,oblong,obovate,occasional,pair,pedicel,peduncle,petiole,portion,primary,prominent,rachi,raised,rounded,side,simple,slender,smooth,sometimes,sparsely,spreading,stem,style,surface,tangled,terete,terminal,tertiary,time,tip,translucent,trichome,tube,tuft,unarmed,vein,venation,x,yellowish,young	.4,0-0.5,0.1,0.15-0.4,0.4-1.2,0.6-1.2,1.5-8,abscising,age,almost,altered,alyx,another,apar,apart,apice,apparently,around,articulated,becoming,capitate,clearly,closer,concave,crenulate,curved,delineated,density,distributed,domatia,eaf,eed,equal,fertilization,formed,fresh,glabrescent,globo,increasing,inflorescenc,inside,junction,know,known,lamina,lengthening,lobed,lower,m.,margi,minutely,much,narrowly,nflorescence,nther,obconical,often,one,orolla,outside,ovate,papillo,perfec,plurifoliat,pore,poricidal,protruding,rarely,regular,ruit,scar,separated,shallowly,smaller,somewhat,soon,specimen,stigma,stretchy,stump,tearing,textur,thick,thickened,thinner,tissue,together,toward,translucent-violet,ud,uneven,unit,vary,visible,wide,widely,ympodial	adaxial,arrangement,calyx,characteristic,colour,form,fruit,growth,height,history,inflorescence,life,mentioned,ovary,plant,pseudostipule,seed,shape,staman,texture,true
299	wfo-0001029310	success	216	137	113	103	24	0.523	.5,.6,/6,0-5,0.6-1.1,00,1,1-1.5,1.2-1.5,1.8-3,10-15,2-3.5,2-4,20-60,3-4,3-5,3.5,4-10,5-12,5-20,5-30,5-6,5-7,7-12,8,acute,anther,apex,apically,apparently,articulated,base,berry,blade,branched,calyx,cm,connivent,cordate,diameter,dull,elliptic,equal,erect,filament,flattened-reniform,flower,free,fruit,glabrescent,glabrous,hair,herb,infructescence,lateral,leaf,length,lobe,lobed,long,long-styled,lower,margin,maturity,mauve,midvein,mm,moderately,narrow-deltate,orange-green,ornately,pair,pedicel,peduncle,pendent,per,pericarp,petiole,pinnatifid,plant,poricidal,porrect,portion,prickle,prickly,primary,sessile,short-styled,shrub,side,simple,smooth,sparsely,spherical,stalked,stellate-pubescent,stem,style,surface,tapering,terete,tertiary,tip,toward,trichome,truncate,tube,variously,vein,venation,visible,wide,yellow	-16,-25,.1,/4,0-20,0.1-0.2,0.2-0.3,0.2-0.8,0.5,0.5-3,1-2,1-4,1/,10,10-13,10-20,15-20,2.5-6,2/3-3/4,20-40,200-500,4-8,45-60,5,5-10,5-8,5-merous,6-8,7-13,abaxially,accrescent,alyx,ame,andromonoecious,apar,apart,bark,beyond,brown,c.,concolorous,conical,dark,deltate,difoliate,distal,distance,drying,eaf,eed,elongating,enclosing,extending,filifor,fruiting,geminat,gently,gray,hermaphrodite,heterostylous,inflated,lobing,lon,longer,lowermost,mature,membranous,midpoint,minute,nflorescence,older,one,open,orolla,oung,pendulous,perpendicular,prickl,ray,recurved,red-brow,retrorse,ruit,scar,secondary,shorter,sometimes,spaced,spreading,stalk,staminat,stellate,stout,straight,strongly,tamen,time,tissue,unit,vary,way,woody,ympodial	1/3,abaxial,adaxial,arrangement,branching,characteristic,colour,corolla,filiform,form,growth,height,history,inflorescence,life,mentioned,ovary,pseudostipule,rachi,seed,shape,staman,texture,unarmed
300	wfo-0001029317	success	151	114	81	70	33	0.536	.5,0.25,0.5,0.5-0.75,0.5-1,0.8-1,1,1-1.5,10-30-flowered,11-14,2-3,6-8,7-8,8-9,acuminate,along,anther,apex,attenuate,base,broadly,ca,calyx,channeled,cm,corolla,cup-like,deltoid,densely,dia,difoliate,extreme,filament,free,geminate,glabrous,grayish,inflorescence,known,lateral,leaf,like,lobe,long,main,major,margin,minor,mm,narrowly,often,opposite,ovary,ovate,pair,pedicel,petiole,portion,probably,pubescent,rachi,raised,rest,rounded,shrub,simple,slender,soft,sparsely,stem,style,tapering,tip,trichome,tube,tuft,uniseriate,unit,vein,white,x	1.5-3.5,10-16,2.5-5,6.5-11,anthesi,apar,area,barely,beneath,brow,bud,closely,deciduou,deflexed,denser,differing,dry,eaf,edicel,eed,ellipsoi,epidermi,erect,exserted,frui,fruiting,glabrate,globose,immature,lobed,lon,lower,middle,minutely,nearly,nflorescence,occasionally,older,one,otherwise,overlapping,ovoid,paler,papillose,pore,poricidal,prominent,proximal,reflexed,remaining,ruit,scar,shaped,size,slightly,soon,spaced,specimen,stigma,straight,styl,tall,tear-drop,thickened,ud,visible,widest,yellowish,ympodial,young	abaxial,adaxial,arrangement,branching,brown,characteristic,colour,deciduous,diameter,form,fruit,growth,height,history,length,life,mentioned,midvein,null,peduncle,plant,primary,pseudostipule,seed,shape,staman,surface,sympodial,tertiary,texture,true,unarmed,venation
301	wfo-0001029332	success	197	166	144	53	22	0.731	.5,0-0.5,0-100,0-2,0-20,0-4,0-5,0.1,0.1-0.2,0.15-0.2,0.5-1,1-1.5,1-2,1-3,1-4,1.3-1.5,1.5-2,1/2,1/3,1/4,1/4-1/3,2,2-2.5,2-4,2.5-3.5,2.8-3.7,3-6,3.5-5,4-15,5-6,5-8,6-8,8.5-9.5,abaxial,adaxial,anther,apart,apex,apically,articulated,base,berry,blade,broad-deltate,calyx,chartaceous,cm,concolorous,conical,connivent,cordate,curved,densely,diameter,distance,drying,equal,erect,extending,filament,flattened,flattened-reniform,flower,free,fruit,glabrescent,glabrous,gland,globular,infructescence,leaf,length,less,lobe,lobed,long,long-styled,longer,lower,margin,maturity,mauve,midpoint,midvein,mm,moderately,narrow-deltate,often,orange-brown,ovate,pair,pale,pedicel,peduncle,per,pericarp,petiole,plant,poricidal,porrect,portion,prickle,prickly,primary,pubescent,ray,reduced,rounded,scandent,sessile,shorter,shrub,side,simple,slender,smooth,spaced,spherical,spreading,stalk,stalked,stellate,stellate-pubescent,stem,style,subsessile,surface,tapering,terete,tertiary,time,tip,trichome,tube,upper,variously,vein,venation,visible,weakly,wide,yellow,yellow-green,yellow-orange	-5,/3,0,0.15-0.25,0.8-1,10-30,2/,2/3-3/4,3-4,4-10,5-merous,abaxially,alyx,andromonoecious,apar,apparently,bark,becoming,difoliate,distal,eaf,eed,elongating,fruiting,geminat,grayi,herbaceous,hermaphrodite,heterostylous,lateral,long-acuminat,lowermost,mature,nflorescence,older,one,open,orolla,oung,pendulous,prickl,ruit,scar,short-styled,staminat,tamen,terminal,unbranched,unit,vary,way,woody,ympodial	2/3,arrangement,branching,characteristic,colour,corolla,form,growth,height,history,inflorescence,life,long-acuminate,mentioned,ovary,pseudostipule,rachi,seed,shape,staman,texture,unarmed
302	wfo-0001029333	success	155	121	92	63	29	0.594	.25,.5,0.7-1,1-1.2,1-1.5,1-15,1-2,1-3,1-7,1.5-2,1.5-2.5,1.5-3,10-15-flowered,100,2-2.5,5-6,9-13,abaxial,abaxially,acuminate,acute,adaxially,anther,apex,auriculate,base,berry,calyx,cm,corolla,dendritic,densely,dia,difoliate,elliptic-obovate,filament,flattened-reniform,flower,free,geminate,glabrous,globose,green,incrassate,lateral,leaf,lobe,long,long-styled,main,major,margin,minor,minutely,mm,obovate,occasionally,opposite,orbicular,ovary,pair,pale,paler,pedicel,petiole,pitted,portion,pubescent,reddish-brown,scar,sessile,shape,shining,short-styled,shrub,slender,small,somewhat,sparsely,stem,style,surface,tall,time,tree,triangular,trichome,truncate,tube,unit,vein,wide	/4,0.5,0.5-1,17-26,3-7,3-7.5,8-15,along,anisophyllou,anthesi,ba,bark,beige,beneath,broadly,clavate,conical,contracted,deflexed,dendritic-pubescent,denser,differing,dry,eaf,edicel,eed,erect,exserted,fresh,fruiting,golden,heteromorphic,inflorescenc,like,lobed,lon,lower,nflorescence,older,overlappin,papillo,planar,pore,poricidal,present,pubescence,rest,rounded,ruit,shaped,simple,size,spaced,stigma,strongly,tear-drop,tip,type,ud,way,woody,ympodial,young	adaxial,anisophyllous,arrangement,branching,characteristic,colour,diameter,form,fruit,growth,height,history,inflorescence,length,life,midvein,null,peduncle,plant,primary,pseudostipule,rachi,seed,staman,sympodial,tertiary,texture,unarmed,venation
303	wfo-0001029334	success	211	143	110	101	33	0.521	0.15-0.3,1,1-10,1-2,1-3,1-6,1.3-4.5,1.5-6,1.8-2.9,2-8,2.5-3,3-7,4-5.5,5-10,8-30,9-12,abaxially,absent,acumen,acute,adaxially,almost,anther,apart,apex,apparently,articulated,attenuate,axe,axillary,base,berry,broadly,brownish,bud,cell,cm,condition,cordate,corolla,covering,densely,diameter,distal,drying,elliptic,erect,filament,flower,forked,fresh,fruit,generally,glabrous,globose,green,green-white,greenish,hair,half,herb,interjected,lateral,leaflet,like,lobe,long,make,margin,mm,mucilaginous,narrowly,oblique,obtuse,odd-pinnate,orbicular,ovate,ovoid,pedicel,peduncle,perfect,petiole,plant,puberulent,pubescent,pure,rarely,ripe,rounded,seed,semi-rosette,shady,situation,spaced,stem,style,subtending,terminal,testal,thick,throughout,tinged,tube,typically,usually,violet,wall,wet,white,whitish	.2,0-4,1.5-3.9,2,2-2.5,2-4,2-5,3-5,3.2-5.8,3.3-6.5,4-8.5,5-merou,7.5-15.5,ag,along,alyx,among,blade,borne,capitat,chartaceous,ciliate,clavate,connivent,cuneate,decreasing,decurrent,digestion,dorsally,eaf,edge,eed,end,enzyme,especially,exceeding,except,flat,folded,geminat,glabrou,gradually,grassland,greatly,hair-like,homostylous,honeycomb-shaped,lanceolate,lengthening,living,low-growin,lower,membranous,middl,midrib,minutely,nflorescence,often,orolla,pair,petiolulate,petiolule,plurifoliate,pore,poricidal,proximal,reduced,removed,ruit,sessile,seudostipule,short,singly,size,slightly,slit,specimen,stamen,ste,stellate,stigma,stolo,straight,subequal,subsessile,sunny,tall,tamen,tem,tip,toward,tri-,tuber,unit,unwinged,vary,wide,woodland,x,yellow,ympodial	'hair-like,abaxial,adaxial,arrangement,branching,calyx,characteristic,colour,form,growth,height,history,inflorescence,leaf,length,life,low-growing,mentioned,middle,midvein,ovary,primary,pseudostipule,rachi,shape,staman,surface,tertiary,texture,true,unarmed,vein,venation
304	wfo-0001029344	success	147	127	96	51	31	0.653	.5,0.4-1,0.5-1,0.5-1.5,1,1-5,1.5,1.5-3,1.5-4,10-20,10-35,2-7,3-10,4-6,5-12,5-15,abaxially,absent,acute,adaxially,along,anther,apex,axe,base,berry,blade,brown,calyx,center,ciliate,cm,connected,decurrent,densely,denser,diameter,difoliate,dm,drying,edge,elliptic,elliptic-ovoid,entire,filament,fine,flat,flower,fruit,glabrous,globose,hair,herb,immature,lacking,linear-lanceolate,lobe,lying,margin,maturing,mm,moderately,nearly,notch,obtuse,obvious,often,one-,parallel,pedicel,peduncle,per,petiole,placenta,pubescent,rachi,radiating,raised,rhizomatous,ridge,rounded,running,semitransparent,shallow,sparsely,straight,style,surface,swollen,two-celled,unbranched,unit,vein,white,x,yellow	0.5-3,1-2,1-3,1-6,2-3,2-3-celled,2-4,abundant,adaxiall,beyond,chartaceous,cordate,dehiscing,eaf,eed,emarginat,equal,explosively,exserted,frui,geminat,held,interpetalar,long,lower,maturit,membranaceous,mesocarp,nflorescence,oblong,orolla,pressure,pubescen,rotate,ruit,short,slightly,sometimes,stamen,stigma,tal,tamen,tem,tissue,triangular,tube,vary,watery,wid,woody,ympodial	abaxial,adaxial,arrangement,branching,characteristic,colour,corolla,form,geminate,growth,height,history,inflorescence,leaf,length,life,mentioned,midvein,ovary,plant,primary,pseudostipule,seed,shape,staman,stem,sympodial,tertiary,texture,unarmed,venation
305	wfo-0001029363	success	152	135	103	49	32	0.678	.25,.75,0-0.1,0.1-0.5,0.2-1.1,0.5-1,1-1.2,1.5-1.7,2-6,3-7,5-7-flowered,6-7,6-8,7-10,acuminate,acute,anther,anthesi,apex,axil,base,becoming,beneath,berry,bi-lobed,bud,calyx,capitate,cm,corolla,deep,deflexed,deltoid,dia,drying,elliptic,erect,except,filament,free,fruit,fruiting,glabrous,globose,green,greyish,immature,internodal,known,lamina,larger,lateral,leaf,lobe,long,main,margin,maroon,mature,middle,minute,minutely,mm,much,narrowly,obtuse,occasionally,often,older,opposite,ovary,pair,pale,papillose,pedicel,petiole,portion,prominent,pubescent,shiny,shrub,simple,slender,small,somewhat,sparse,stem,straight,style,surface,tapering,tree,trichome,tube,tuft,uniseriate,unit,usually,vein,white,widest,woody,yellowish	/4,0.5,1,1.5-3.5,4-11,ba,bark,beginning,closely,coroll,cup-shaped,densely,eaf,edge,edicel,eed,exsertion,inflorescenc,later,lobed,lon,lower,meeting,near,nflorescence,overlapping,paler,papillo,pore,poricidal,reflexed,ruit,scar,slit-like,spaced,sparsely,stigma,tall,terminal,thickened,tip,ud,unifoliat,upon,way,white-papillose,wide,ympodial,young	3,abaxial,adaxial,arrangement,branching,characteristic,colour,diameter,form,growth,height,history,inflorescence,length,life,midvein,null,peduncle,plant,primary,pseudostipule,rachi,seed,shape,staman,sympodial,tertiary,texture,true,unarmed,unifoliate,venation
306	wfo-0001029364	success	153	145	111	42	34	0.725	-2,-6,.5,0.2-0.5,1,1-,1-3,1-4,1-5,1.5-2,2,2-6,4-9,5-11,5-9,7-9,8-10,8-15,?,abaxially,acuminate,adaxially,anther,apart,apex,around,articulated,axe,base,blade,blue,calyx,center,cm,color,connivent,corolla,cream,cuneate,curled,cylindrical,darker,deep,diameter,directed,distally,elliptic,entire,extra-axillary,fide,filament,finger,flower,free,fruit,glabrous,gland-tipped,globose,green,greenish,hair,herb,immature,inserted,lobe,major,margin,membranaceous,minutely,mm,moderately,narrowly,nearly,obtuse,part,pedicel,peduncle,perfect,petiole,pore,puberulent,pubescent,rachi,radiu,ripe,rusby,sagittate,shallow,shorter,shrub,side,simple,small,spaced,sparsely,spot,stellate,strongly,style,tapered,thecae,tightly,triangular,unbranched,unit,unknown,vein,white,wide,x,yellow	-3,10-27,191.,2-,2-foliat,3-4,4-12,5-,6-8,according,acute,aggregate,ba,bitter,cell,chartaceous,distall,eaf,ed,glandular-puberulen,long,lower,mesocarp,nflorescence,orolla,ovate,presence,present,puberulen,ruit,short-tomentose,stigma,stone,tal,tamen,tem,time,tomento,truncat,tube,vary,ympodial	2-foliate,abaxial,adaxial,arrangement,branching,characteristic,colour,form,glandular-puberulent,growth,height,history,inflorescence,leaf,length,life,midvein,null,ovary,plant,primary,pseudostipule,seed,shape,staman,stamen,stem,surface,sympodial,tertiary,texture,true,unarmed,venation
307	wfo-0001029368	success	139	106	76	63	30	0.547	.2,.5,0.5-2,0.9-1,1.5-1.6,1.5-2,1.5-3,2-5,2.5-4,5-6,?,abaxially,acuminate,acute,adaxially,anther,anthesi,apex,base,berry,borne,broadly,calyx,closely,cm,coarse,conical,corolla,densely,elliptic,erect,few-branched,filament,free,fruit,glabrous,globose,golden,green,half,herb,inflorescence,internodal,lanceolate,lateral,leaf,lobe,long,main,margin,minute,minutely,mm,older,opposite,ovary,papillose,parallel,pedicel,petiole,portion,puberulent,reflexed,shrub,simple,somewhat,stem,style,trichome,tube,uniseriate,upper,vein,white,winged,x	.25,0,1.5-4,11-13,16-25,along,apparently,bark,bearing,bitter,breaking,brow,capitate,crumpled,cup,deflexed,dia,distal,eaf,edicel,eed,exserted,fide,flattened,flower,fruiting,indistinct,inflorescenc,known,lamina,leaving,like,lower,margi,middle,midrib,nflorescence,non-flower,obtuse,one,overlappin,pair,papillo,pore,poricidal,rest,ruit,scar,shaped,spaced,stigma,straight,strongly,tall,tear-drop,tip,ud,unifoliat,unit,widest,woody,ympodial,young	abaxial,adaxial,arrangement,branching,brown,characteristic,colour,diameter,form,growth,height,history,length,life,mentioned,midvein,peduncle,plant,primary,pseudostipule,rachi,seed,shape,staman,surface,tertiary,texture,true,unarmed,venation
308	wfo-0001029370	success	224	210	184	40	26	0.821	-20,-32,.1,.3,.5,/4,0-10,0-100,0-3,0-35,0.2,0.5-1,0.5-2.2,1,1-2,1-3,1-4,1.5-6,1.8-2.5,1.8-2.8,1/3-1/2,1/4-1/3,10-17,10-50,12-17,15-30,2-10,2-20,2-3,2-6,2.5-3.5,3-4,3.5-4,3.5-8,4-6,4-7,5-10,5-12,5.5-7,6-15,7-11,7-13,8-23,abaxial,adaxial,ame,anther,apar,apart,apex,apically,apparently,articulated,bark,basal,base,berry,blade,branched,broad-deltate,c.,calyx,clearly,cm,conical,connivent,cordate,cream,curved,dark,densely,diameter,distance,elongate,elongating,equal,erect,extending,fewer,filament,fine,flattened,flattened-reniform,flower,free,fruit,fruiting,gently,glabrescent,glabrous,green,greenish,herb,infructescence,lateral,leaf,length,lobe,lobed,long,long-styled,longer,lower,margin,marking,mature,maturity,mauve,midpoint,midvein,mixture,mm,moderately,multangulate,obtuse,often,older,one,open,orange,orange-brown,ornate,ovate,overlapping,pair,pale,pattern,pedicel,peduncle,pendulous,per,pericarp,perpendicular,petiole,plant,poricidal,porrect,portion,prickle,prickly,primary,ray,red-brown,reticulate,rounded,scar,shiny,short-styled,shrub,side,simple,slightly,smooth,sometimes,spaced,spherical,stalk,stalked,stellate-pubescent,stem,stout,straight,style,surface,tapering,terete,tertiary,time,tip,trichome,tube,unarmed,unit,variously,vein,venation,visible,white,white-gra,whitish,wide,woody,yellow,young	0.1,0.1-0.15,0.3,10-40,3/,4-9,5-merous,8-14,8-20,abaxially,acut,almost,alyx,andromonoecious,chartaceous,discolorous,distal,drying,eaf,eed,fully,hermaphrodite,heterostylous,lowermost,nflorescence,opening,orolla,oung,plurifoliat,prickl,rotate,ruit,sessile,spreading,staminat,strongly,tamen,vary,way,ympodial	3/4,acute,arrangement,branching,characteristic,colour,corolla,description,form,growth,height,history,inflorescence,life,mentioned,ovary,patter,plurifoliate,pseudostipule,rachi,seed,shape,staman,stellate-pubescen,sympodial,texture
309	wfo-0001029373	success	199	149	124	75	25	0.623	.0â1.2,.2,.3,.5â2.0,0.4â1.6,0.5â1.2,0.6â0.7,1.0â1.2,1.0â1.6,1.2â1.5,1.4â3.5,1.5â2.5,1.5â2.7,2-celled,2.0â2.5,2.7â3.0,20â30,2â4-celled,3,30â40,3â5,4â6,5,5â6,6.8,8â9,abaxial,accrescent,acute,adaxial,anther,apex,articulated,base,bayonet,berry,broadly,bud,calyx,cell,cm,conical,corolla,curved,deltate,densely,developing,diameter,distal,ellipsoid,enclosed,entire,filament,finger,flattened-reniform,flower,free,fruit,fully,glabrous,glandular-tipped,green,growth,hair,half,herb,hilum,internodal,lateral,laterally,leaf,like,lobe,long,margin,mature,mesocarp,middle,minutely,mm,moderately,obtuse,outline,ovary,ovate-lanceolate,pair,pedicel,peduncle,pentagonal,per,petiole,pitted,plant,plurifoliate,portion,positioned,primary,pubescent,resembling,rounded,scar,seen,shape,simple,spaced,spreading,stem,straight,style,surface,tall,terete,testal,tip,trailing,trichome,tube,uniseriate,unit,upper,vein,white,wide,yellowish	.5,0.3â0.5,0.5â1.8,1.3â2.2,1.5â2.0,1.8â2.0,1.8â2.3,180Â°,3.5â4.0,4â5,5-merous,abaxially,acuminate,adaxially,age,anthesi,apar,appearanc,appressed,arising,bark,basal,beyond,capped,clavate,cone,eaf,eed,elongate,enclosing,exerted,fruiting,geminat,globose,grey-brown,halfway,immature,individual,lengthening,less,live,lobed,lon,lower,minute,mouth,new,nflorescence,node,older,papillate,perfect,pore,poricidal,reflexed,root,ruit,seudostipule,shallowly,short,slightly,slit,smoot,stellate,stigma,still,tem,thicker-walled,tub,ud,woody,yellow,yellow-green,ympodial,â5	apart,appearance,arrangement,branching,characteristic,colour,form,geminate,height,history,inflorescence,length,life,mentioned,midvein,pseudostipule,rachi,seed,staman,sympodial,tertiary,texture,true,unarmed,venation
310	wfo-0001029402	success	113	98	64	49	34	0.566	0.5-1,0.5-2,15-30,2,2-10,2-3,3-5,4-6,4-7,5-25,7-8,7-9,8-15,abaxial,abaxially,acuminate,acute,adaxially,apart,apex,articulated,axe,base,branched,calyx,ciliolate,cm,cylindrical,deltate,denser,diameter,elliptic,flower,forked,glabrate,glabrous,hair,inrolled,leaving,lobe,margin,mm,narrowed,narrowly,nearly,often,pedicel,peduncle,petiole,pubescent,rachi,scar,shrub,simple,spaced,sparsely,style,surface,tapered,thickened,tip,unknown,violet,x	1-2.5,11-17,3-4,3-6,4-8,6-16,7-11,band,blade,chartaceous,color,connivent,directed,distall,eaf,eed,fleshy,free,glabrou,lanceolate,long,lower,many-foliat,moderately,nflorescence,nther,orolla,papillose,pore,pubescence,rachise,radiu,roughened,ruit,scale-like,somewhat,stellate,stigma,tal,tem,time,triangular,truncat,tube,unit,unknow,vary,wide,ympodial	adaxial,anther,arrangement,branching,characteristic,colour,corolla,filament,form,fruit,growth,height,history,inflorescence,leaf,length,life,many-foliate,midvein,null,ovary,plant,primary,pseudostipule,seed,shape,staman,stem,tertiary,texture,true,unarmed,vein,venation
311	wfo-0001029404	success	154	150	116	38	34	0.753	-1.5,-10,-3,0-60-flower,0.5-1,1,1-4,15-25,2,2-3,2-5,2-8,2.5-22,2.5-3,20-35,3-4,3-8.5,5-10,5-20,5-24,5-6,6-8,6-9,6.5-34,abaxially,acuminate,acute,adaxially,aggregate,anther,apart,apex,apiculate,articulated,auriculate,axe,basal,base,beyond,blade,branched,calyx,cell,center,chartaceous,cm,connivent,cordate,cream,cylindrical,dark,darker,deltate,densely,diameter,directed,distally,eglandular,ellipsoidal,entire,exserted,flattened,fleshy,flower,fruit,glabrous,glandular,green,hair,lanceolate,leaving,less,light,lobe,long,longitudinal,margin,mm,moderately,mottling,orange,ovate,pedicel,pedicellar,peduncle,perfect,petiole,pink,pore,puberulent,pubescent,purple,rachi,radiu,remnant,ripe,shrub,simple,small,somewhat,spaced,sparsely,star,stellate,stone,style,subcoriaceous,time,toward,tree,unbranched,vein,white,wide,x,yellow	-5,1.5-2,2-4,3-5,4-foliat,8-12,absent,ape,connective,eaf,eed,glandular-puberulen,lemon,lon,lower,narrowly,nflorescence,nther,obtuse,orang,orolla,ovoid,presen,ruit,shorter,slightly,stigma,tal,tem,thecae,tomento,triangular,truncat,tube,ud,unit,vary,ympodial	abaxial,adaxial,arrangement,branching,characteristic,colour,corolla,filament,form,glandular-puberulent,growth,height,history,inflorescence,leaf,length,life,mentioned,midvein,ovary,plant,present,primary,pseudostipule,seed,shape,staman,stem,surface,tertiary,texture,unarmed,venation,ye
312	wfo-0001029406	success	136	106	73	63	33	0.537	.5,0.6-1,1-1.5,1-10,1-2,1.5-2.2,2-3,2.5-3.5,4-6,7-12,abaxially,acute,adaxially,along,anther,apex,arachnoid,base,berry,broadly,brown,brownish,calyx,cm,corolla,dark,deltate,difoliate,dry,elliptic,filament,glabrous,globose,grayish-brown,grayish-green,green,greenish-white,impressed,lateral,leaf,lilac,lobe,main,margin,matted,maturity,minutely,mm,occasionally,often,ovary,ovoid,ovoid-reniform,pair,pale,pedicel,petiole,pitted,pointed,population,pubescent,shiny,shrub,small,stem,style,surface,tinge,tree,trichome,unit,vein,white	0.3-1,0.5-1,0.7-1.5,1.5-2.5,1.5-5,2,2-11,28,3-9,30,4-18,anthesi,arachnoid-pubescent,ba,bark,bullate,clavate,conical,conspicuously,deciduous,deflexed,densely,dia,differing,eaf,eed,felt-like,free,fruiting,geminat,large,lenticel,lobed,lon,long,lower,major,middle,minor,nearly,older,papillo,papillose,planar,pore,poricidal,portion,ruit,shaped,size,slightly,soon,stigma,tall,tear-drop,tip,tube,waxy,wide,widest,woody,ympodial,young	0.3-1.5,abaxial,adaxial,arrangement,branching,characteristic,colour,diameter,form,fruit,geminate,growth,height,history,inflorescence,length,life,midvein,null,peduncle,plant,primary,pseudostipule,rachi,seed,shape,staman,sympodial,tertiary,texture,true,unarmed,venation
313	wfo-0001029407	success	208	127	105	103	22	0.505	.5,0-15,0-2,0-4,0-5,0.4-0.7,0.5-0.7,0.5-1.5,0.5-2,0.6-0.9,1-1.4,1-2,1-4,1.8-2.5,1/5,2-4,2.5-3,3-6,5-7,6-20,abaxial,acute,adaxial,almost,anther,apex,apically,apparently,articulated,base,berry,bright-red,calyx,cm,cuneate,dark,deltate,densely,diameter,difoliate,dull,elliptic,entire,erect,evenly,filament,flattened-reniform,flower,fruit,geminate,green,green-brown,lateral,leaf,length,lobe,lobed,long,margin,mature,maturity,mauve,mm,moderately,obtuse,one,open,orange,orange-brown,ovate,pair,pedicel,peduncle,per,petiole,porrect,prickle,prickly,primary,rarely,rounded,shrub,side,sometimes,sparsely,spherical,stalked,stellate-pubescent,stem,style,surface,terete,tertiary,time,trichome,unbranched,upper,vein,venation,visible,white,wide,yellow,yellow-green,young	-10,-2,-25,-4,-6,-7,/3,0,0.1-0.2,0.1-0.25,0.15-0.4,0.2-0.3,0.4-1,0.6,0.7-1.2,1,1-3,1-4.5,1.5,1/3,1/3-1/2,1/8-1/5,2-3,2-5,3-4,3.5-4.5,4-15,4-9,4.5-6,5-merous,6-13,7-8,abaxially,acut,alyx,apar,apart,bark,blade,brow,chartaceous,connivent,curved,discolorous,drying,eaf,eed,elongating,equal,flattened,free,fruiting,geminat,glabrescent,glabrous,gray-greenish,infructescence,lengt,longer,lower,midpoint,nflorescence,occasionally,older,orolla,oung,pale,pendulous,perfec,pericarp,poricidal,portion,prickl,pubescent,ray,recurved,reflexed,ruit,scar,sessile,shorter,simple,slender,smooth,spaced,spreading,stalk,stellate,stout,straight,straw-yellow,strongly,tamen,tapering,thick,tip,tube,unit,vary,way,weakly,woody,ympodial	arrangement,branching,characteristic,colour,corolla,form,growth,height,history,inflorescence,life,midvein,null,ovary,plant,pseudostipule,rachi,seed,shape,staman,texture,unarmed
314	wfo-0001029408	success	244	176	151	93	25	0.619	-10.5,-4.5,.2-3.5,/10,0,0-100,0.2-0.3,0.3-5,0.5-2.5,0.9-1.3,0.9-1.6,1-8,1.1-1.5,1.4-1.9,1.6-2.8,1.7-2.4,1/2,1/2-3/4,1/4,11-31,2-12,2-4,2-5,2.2-3.7,2.5-7,2/3,3-5,4-14,4-20,4-7.5,5-6.5,7-12,abaxially,acute,adaxially,anther,apart,apex,articulated,axillary,base,berry,blade,branched,broadly,brown,calyx,cm,conical,corolla,cuneate,dark,deltoid,diameter,directed,echinoid,elliptic,entire,exserted,filament,fleshy,flower,fruit,glabrous,globose,gray,green,growth,hair,honeycombed,lacking,lanate,leaf,length,lilac,lobe,lobed,long,long-,long-attenuate,long-stalked,many,margin,midvein,mixed,mm,moderately,mostly,multangulate,near,nearly,obtuse,ovate,pale,part,pedicel,peduncle,perfect,persistent,petiole,plurifoliate,porrect-stellate,present,pubescent,purplish,rachi,rarely,rather,ray,reniform,reticulate-punctate,ripe,sessile,short-,short-attenuate,short-stalked,shrub,side,simple,small,sometimes,spaced,stamen,stelliform,stem,style,subcampanulate,suborbicular,subovate,terete,testa,thick,thick-stalked,thick-textured,thin-stalked,time,tomentose,tomentum,toward,tree,unarmed,usually,vein,velutinous,way,white,whitish,wide,x,yellow,yellowish	-1.5,0.7-1.2,1.5-3,1.8-3.5,2-3.5,3.5-5,5-24,5-6,5-8,5-merou,accrescent,acuminate,adaxiall,ag,alyx,anthesi,apical-lateral,axe,ba,barely,bark,becoming,blunt-tipped,branch,bud,capitat,chartaceous,clavate,continued,decurrent,dehiscing,dendritic-echinoi,dendritic-multangulate,densely,develope,distal,distall,due,eaf,echinoi,eed,extend,faintly,few-rayed,free,fruiting,high,homostylous,indument,inserted,interpetalar,introrse,lanceolate,large,lateral,longitudinal,lower,m.,main,nflorescence,oblong,obscured,often,older,orbicular,orolla,ovate-lanceolate,overlapping,partly,pore,pseudo-terminal,relatively,ribbed,rotate-stellate,ruit,runk,slightly,slit,stigma,suture,tamen,tissue,tomentu,top,touching,tube,turbinate,unarme,unit,vary,well,ympodial,young	abaxial,adaxial,arrangement,branching,characteristic,colour,distally,form,height,history,inflorescence,life,null,ovary,plant,primary,pseudostipule,seed,shape,staman,surface,tertiary,texture,true,venation
315	wfo-0001029417	success	213	160	128	85	32	0.601	.5,0.2-0.6,0.7-3,1-10,1-2,1.3-8,1.5-1.8,1.5-8,12,2-4,2.5-10,2.8-3.5,3-5,4-7,5-15,6-11,8-9,abaxially,acuminate,acute,adaxially,anther,apart,apex,apiculate,apparently,articulated,attenuate,axe,axillary,base,basiscopic,berry,blue,broadly,brownish,bud,cell,central,cm,coarsely,condition,corolla,covering,dark,decurrent,deep,diameter,distal,dot,drying,erect,exceeding,filament,flower,forked,fresh,fruit,generally,glabrous,globose,green,green-white,greenish,hair,half,herb,lateral,like,linear,lobe,long,make,margin,medium,minute,mm,moderately,mucilaginous,narrowly,non-glandular,odd-pinnate,often,orbicular,ovate,ovoid,pedicel,peduncle,perfect,petiole,pilose,plant,pubescent,purple,rarely,ripe,rounded,scattered,seed,sessile,short,short-petiolulate,side,slightly,sometimes,spaced,stamen,star,stem,straight,style,subtending,terminal,testal,thick,throughout,tinged,trichome,typically,usually,violet,wall,wet,white,whitish,wide,widely,x	0-7,0.4-8,1,1-1.5,1-4,1-8,1.5-10,3-14,5-merou,8-15,acumen,ag,along,alyx,blade,borne,capitat,chartaceous,ciliate,clavate,connivent,decreasing,digestion,dorsally,eaf,edge,eed,end,enzyme,erec,especially,flat,folded,geminat,glabrou,greatly,hair-like,hal,homostylous,honeycomb-shaped,interjected,lanceolate,leaflet,lengthening,living,lower,lunate,membranous,midrib,minutely,nflorescence,orolla,pair,pentagonal,petiolulate,plurifoliate,pore,poricidal,puberulent,rapidly,removed,rotate,ruit,seudostipule,singly,size,slit,specimen,ste,stigma,stolo,subequal,tall,tamen,tem,tip,tri-,tube,tuber,unit,unwinged,vary,wing,yellow,ympodial	'hair-like,abaxial,adaxial,arrangement,branching,calyx,characteristic,colour,description,form,growth,height,history,inflorescence,leaf,length,life,mentioned,midvein,ovary,primary,pseudostipule,rachi,shape,staman,surface,tertiary,texture,true,unarmed,vein,venation
316	wfo-0001029461	success	217	109	85	132	24	0.392	-2,-3,-4.5,0,0.7-1,1-,1-1.6,1.2-1.8,1/3,2-2.8,2-3,2.5-3,3-6,4-6.5,4.5-7,4.7-7.2,almost,anther,apex,attenuate,base,berry,black,broad-deltate,calyx,cell,cm,cuneate,densely,diameter,dull,elliptic,erect,evenly,faint,filament,fine,flattened-reniform,fruit,green,leaf,length,lobe,lobed,margin,maturity,mauve,midvein,mm,moderately,outline,ovate,pair,pedicel,petiole,pit,plant,prickle,prickly,primary,raised,reddish,rounded,shiny,shrub,small,smooth,sometimes,sparsely,spherical,staman,stellate-pubescent,stem,style,subentire,surface,terete,tertiary,unarmed,upper,vein,venation,visible,yellow,young	-1.5,-14,-3.2,-3/4,-4,-5,.5,0.1,0.1-0.25,0.15-0.25,0.6-1,0.8,0.8-1.5,1-2,1-3,1-4,1-6,1.2-1.7,1.3-2.2,1.5-,1.5-2,1/3-2/3,1/4,1/4-1/2,2-2.4,2-4,3-20,4-10,4-7,5-10,5-25,5-merous,7-10,7-12,8-9,abaxially,acuminat,alyx,ame,andromonoecious,apart,apically,bark,becoming,blade,breaking,brittle,brown,c.,chartaceous,concolorous,curved,dark,discolorous,distal,distance,drying,eaf,eed,elongating,extending,fifth,flattened,flower,four,free,fruiting,glabrescent,glabrous,gra,hermaphrodite,heterostylous,infructescence,lengt,long,long-styled,longer,lower,lowermost,mature,midpoint,oblong,obovate,obtuse,older,orange,orolla,oung,pendulous,per,pericarp,plurifoliat,poricidal,porrect,portion,prickl,ray,reduced,reflexed,ruit,sessile,shallow,short-styled,shorter,side,simple,slender,slightly,spaced,spreading,stalk,stalked,staminat,stellate,straight,strongly,tamen,time,tip,trichome,tube,unarme,unequal,unit,variously,vary,way,weakly,wide,woody,ympodial,zygomorphic	0.6-1.5,1,abaxial,adaxial,arrangement,branching,characteristic,colour,corolla,form,growth,height,history,inflorescence,life,null,ovary,peduncle,plurifoliate,pseudostipule,rachi,seed,shape,texture
317	wfo-0001029462	exception_thrown	166	0	0	166	0	0.0		-2,-30,-4,-5,0.5-1,0.5-2,1,1-,1-2,1-3,1-6,1.5,1.5-2,1.5-3,1.5-7,10-,10-22,15-25,2-3,2-6.5,2.5-3.5,2.5-5.5,20-35,3,3-18,3-27,3-4,3-5,3-6,3-7,4-15,4-20,4-foliat,5-30,6-9,7-19,7-8,8-9,abaxially,abruptly,absent,acuminate,acute,adaxially,aggregate,apart,ape,apex,articulated,axe,basal,base,beyond,blade,broad,calyx,campanulate,cell,chartaceous,ciliate,cm,connective,connivent,constricted,cuneate,curled,cylindrical,dark,densely,dentate,diameter,directed,eaf,eed,eglandular,ellipsoidal,elliptic,entire,equal,exceeding,exserted,flattened,flower,fruit,glabrous,green,hair,lanceolate,laterally,leaving,light,lobe,lon,long,longitudinal,lower,m.,margin,membranaceous,minutely,mm,moderately,narrowly,near,nflorescence,nther,obtuse,occasionally,often,orolla,oval,ovate,ovoid,pedicel,pedicellar,peduncle,perfect,petiole,pore,puberulent,pubescent,pubescent-pilo,pubescent-pilose,purpl,purplish,rachi,radiu,remnant,reticulate,rounded,ruit,shorter,simple,slightly,small,smooth,somewhat,spaced,sparsely,stamen,stellate-,stigma,stone,stripe,style,tal,tem,thecae,time,tip,tomentose,tree,triangular,truncat,truncate,tube,ud,unbranched,unit,vary,white,wide,without,x,yellow,ympodial	
318	wfo-0001029464	success	235	193	172	63	21	0.732	-2/3,-3,-30,-5,.9,0,0-2,0-80,0.2,0.2-0.5,0.3-0.7,0.3-1,0.5,0.5-2,0.8-2,00-200,1,1-10,1-3,1-8,1/4,1/4-1/3,10-40,10-50,2,2-3.5,2.2-2.5,2.4-4,2.5-5,2.9-3.2,3-20,3-5,3-7,3.5-5,4-7,5-17,5-8,5.5-6,5.5-7.5,6-15,7-10,8-15,abaxial,acicular,acute,adaxial,ame,annual,anther,apart,apex,apically,apparently,articulated,bark,base,berry,black,blade,branched,broad,brown,c.,calyx,chartaceous,cm,cordate,curved,dark,deltate,diameter,difoliate,discolorous,distance,drying,ellipsoid,elongated,erect,extending,filament,flattened-reniform,flower,fruit,glabrescent,glabrous,glaucous,globular,green,green-brown,hair,herb,infructescence,lateral,leaf,length,less,lobe,lobed,long,long-styled,lower,margin,maroon,maturity,mauve,midpoint,midvein,minute,mm,moderately,mottled,narrow-deltate,oblong,obtuse,occasionally,older,one,open,orange-brown,ovate,ovoid,pair,pedicel,peduncle,pendent,per,pericarp,petiole,pink,plant,porrect,prickle,prickly,primary,purple,ray,red-brown,rounded,scar,sessile,short-styled,side,simple,smooth,sometimes,spaced,stalk,stalked,stellate-pubescent,stem,straight,striped,style,surface,terete,terminal,tertiary,time,translucent,trichome,unarmed,upper,usually,variously,vein,venation,visible,white,wide,yellow-green,yellow-orange,young	0.2-0.7,1.2-3,1.5-2,1/,1/4-1/2,10-15,10-23,12-50,2-3,2-4,2.5-8,4-8,4-8-merous,8-13,9-15,abaxially,alyx,andromonoecious,apar,around,broad-deltate,brow,connivent,cultivar,cup-shaped,distal,eaf,eed,elongating,equal,free,fruiting,fully,geminat,hermaphrodite,heterostylous,long-acuminat,longer,lowermost,mature,nflorescence,often,opening,orolla,oung,pendulous,poricidal,portion,prickl,ruit,sparsely,spreading,staminat,stellate,tamen,tapering,tip,tube,unit,vary,way,woody,ympodial	1/2,arrangement,branching,characteristic,colour,corolla,form,growth,height,history,inflorescence,life,long-acuminate,null,ovary,pseudostipule,rachi,seed,shape,staman,texture
319	wfo-0001029546	success	203	128	97	106	31	0.478	0.3-1,1-2,1-4.5,1.5-2,1.5-6.2,2.2-2.8,3-8,3.5-5,4-10,4.5-7,5-10,5-8,7-10,8-17,abaxially,acuminate,acute,adaxially,anther,apex,apiculate,attenuate,base,berry,blue,broadly,brownish,cell,cm,condition,cordate,corolla,covered,covering,densely,diameter,dot,drying,elliptic,elliptical,filament,frequently,fresh,fruit,glabrous,glandular,globose,green,green-white,greenish,hair,herb,lateral,leaf,like,lobe,long,longer,make,mm,mucilaginous,nearly,non-glandular,oblique,odd-pinnate,often,orbicular,ovate,ovoid,pedicel,peduncle,petiole,plant,pubescent,purple,rachi,rarely,regular,ripe,seed,short,simple,slightly,soft,sometimes,stem,style,testal,thick,throughout,tinged,trichome,wall,wet,white,whitish,x	0-2,1-10,1-3.2,1-5,1.6-6.5,2-4,2-9,4.5-12.5,5,5-18,5-merou,6.3-19.5,8,8-19.5,absent,acumen,adaxiall,ag,alyx,apart,apparently,articulated,axe,axillary,blade,bud,capitat,chartaceous,clavate,connivent,curved,decreasing,decumben,decurrent,digestion,distal,dorsally,eaf,edge,eed,enzyme,erect,exceeding,flat,flower,folded,forked,geminat,generally,glabrou,greatly,hair-like,half,homostylous,honeycomb-shaped,interjected,lanceolate,leaflet,lengthening,living,lower,lunate,membranous,middl,minutely,mottle,nflorescence,pair,pentagonal,perfect,petiolule,plurifoliate,pore,poricidal,removed,rotate-pentagonal,ruit,sessile,seudostipule,size,slit,spaced,specimen,stamen,ste,stigma,straight,subequal,subtending,tall,tamen,tem,terminal,tip,tri-,truncate,tube,typically,unit,unwinged,usually,vary,wide,wing,yellow,ympodial	'hair-like,abaxial,adaxial,arrangement,branching,calyx,characteristic,colour,form,growth,height,history,inflorescence,length,life,margin,mentioned,midvein,mottled,ovary,primary,pseudostipule,shape,staman,surface,tertiary,texture,true,unarmed,vein,venation
320	wfo-0001029552	success	161	116	88	73	28	0.547	.5,0.1-0.5,0.6-1,1-1.3,1-1.5,1-3,1-5,1.5-2,12,2.5-3,6-9,abaxial,abaxially,abruptly,acuminate,acute,adaxially,along,anther,apex,base,berry,branched,broadly,calyx,clavate,cm,contracted,corolla,decurrent,deflexed,deltate,dendritic,densely,difoliate,drying,elliptic,erect,filament,flattened-reniform,flower,glabrous,globose,green,incrassate,inflorescence,lamina,lateral,leaf,like,lobe,long-styled,main,margin,middle,minutely,mm,occasionally,opposite,ovary,pair,pale,paler,pedicel,petiole,pitted,pubescent,shape,shining,short-styled,shrub,simple,slender,small,somewhat,sparsely,stem,style,surface,tan,tree,tree-like,trichome,tube,vein,white,widest,yellowish	.25,0.5,1-2,1.5-6.5,10-20,2-2.5,2-9,5-10-flowered,5.5-8,anthesi,area,bark,broadened,closely,conical,denser,dia,differing,eaf,edicel,eed,exserted,free,fruiting,geminat,greyish-brow,heteromorphic,inflorescenc,later,lobed,lon,long,lower,major,minor,minute,nearly,nflorescence,older,onto,orbicular,overlappin,papillo,persistent,planar,pore,poricidal,portion,present,reflexed,rest,rounded,ruit,scar,scattered,shaped,size,slightly,spaced,stigma,strongly,swollen,tall,tear-drop,tip,tub,ud,unit,wide,woody,x,ympodial,young	adaxial,arrangement,branching,characteristic,colour,diameter,form,fruit,geminate,greyish-brown,growth,height,history,length,life,mentioned,midvein,peduncle,plant,primary,pseudostipule,rachi,seed,staman,tertiary,texture,unarmed,venation
321	wfo-0001029584	success	180	168	132	48	36	0.733	0-30,1,1-2,1-6,1.5-6.5,16.2-33,2-3,2-4,2.4-6.3,3-10,3-5,3-7,4-14,4-15,4.5-11.5,5.3-13.3,6-7,6.1-9.4,7-14,8-15,9.7-23.4,9.8-17,abaxially,acumen,acuminate,acute,adaxially,anther,apart,apex,apparently,articulated,asymmetric,attenuate,axe,axillary,base,basiscopic,blade,brownish,bud,cell,cm,condition,considerably,coriaceous,corolla,covering,dark,decreasing,dense,densely,diameter,digestion,distal,drying,elliptic,enzyme,filament,finer,flower,forked,fresh,fruit,generally,glabrescent,glabrous,green,green-white,greenish,hair,hair-like,half,herb,honeycomb-shaped,interjected,larger,lateral,leaf,leaflet,light,linear,lobe,long,make,margin,middle,mm,mucilaginous,odd-pinnate,orbicular,ovate,ovoid,pair,pedicel,peduncle,perfect,petiole,petiolulate,plant,plurifoliate,proximal,pubescent,purple,removed,second,seed,sessile,short,side,simple,size,spaced,straight,style,subtending,tall,terminal,testal,thick,throughout,tissue,toward,tri-,typically,unit,usually,wall,wet,white,whitish,x	1-3,4-5,5-merou,ag,alyx,borne,capitat,clavate,connivent,dorsally,eaf,edge,eed,end,erry,flat,folded,geminat,hal,homostylous,lengthening,living,lower,nflorescence,oblong-lanceolate,orolla,pentagonal,pore,poricidal,present,semi-erec,seudostipule,singly,slit,specimen,stigma,stolo,substellate,tamen,tem,tip,tube,tuber,unknow,unwinged,vary,yellow,ympodial	2,abaxial,adaxial,arrangement,berry,branching,calyx,characteristic,colour,form,geminate,growth,height,history,inflorescence,length,life,midvein,null,ovary,primary,pseudostipule,rachi,semi-erect,shape,staman,stem,surface,sympodial,tertiary,texture,true,unarmed,unknown,vein,venation
322	wfo-0001029593	exception_thrown	181	0	0	181	0	0.0		-10,0.05,0.5-1,0.5-5,0.8-1,0.8-1.2,1,1-1.2,1-1.5,1-2,1-8,1.6-2.3,10-50,100,2,2-14,2-3,2-5,2.3,2.3-3.0,3-4,3.5-8,35-60,4-6,5-10,5-15,7-25,7.5-15,9-15,abaxially,abruptly,acuminate,acute,adaxially,age,always,anther,anthesi,anticlinal,apex,apically,arising,attenuate,axil,axillary,basal,base,basiscopically,bearing,berry,broadly,brown,calyx,capitate,cateniform,cell,clavat,cm,colony,cone,conical,decurrent,deltate,densely,diameter,dry,drying,eaf,edicel,eed,elliptic,enlarged,entire,epidermal,exserted,extremely,filament,filiform,flower,free,fruit,fruiting,glabrescent,glabrous,globose,green,growing,half,hollow,included,irregular,lamina,large,lateral,leaf,leaflet,lobe,long,lower,markedly,minutely,mm,much,narrowing,nflorescence,noddin,oblique,obovate,occasionally,often,once-branched,onto,open,opposite,ovary,ovoid-reniform,pair,papillose,pedicel,per,perfectly,petiole,petiolule,pinnate,place,plant,pointed,poricidal,portion,primary,projection,pubescen,pubescence,pubescent,purple,rachi,rarely,reflecting,rest,ruit,scar,seed,shape,short-styled,shrub,similar,simple,single-stemmed,sinuous,slightly,small,smaller,smooth,somewhat,sparsely,stigma,style,surface,tall,tem,terminal,thickening,tip,trichome,tub,tube,ud,unifoliat,uniseriate,unit,usually,variable,vein,white,white-lenticellate,wider,winged,without,woody,x,ympodial	
323	wfo-0001029601	success	187	122	89	98	33	0.476	0.2-0.8,0.5-5.8,1-2,1-3,1-4,1.1-2.7,2-12,2-9,2.3-5.9,3-10,3-5,3-7,5-41,6-10,abaxially,acumen,acuminate,acute,adaxially,anther,apart,apex,articulated,asymmetric,attenuate,base,basiscopic,berry,brownish,cell,cm,condition,corolla,covering,dark,diameter,dot,drying,elliptic,filament,fresh,fruit,glabrescent,glabrous,globose,green,green-white,greenish,hair,herb,lanceolate,lateral,leaf,light,linear,lobe,long,make,middle,mm,mucilaginous,odd-pinnate,ovate,ovoid,pedicel,peduncle,petiole,petiolulate,plant,puberulent,ripe,rounded,seed,short,side,slightly,small,spaced,straight,style,testal,thick,throughout,tissue,usually,wall,wet,white,whitish	0-37,0.5-8,1-53,1.2-2.3,1.7-6.5,2,2-3,2-7,2.2-4.5,2.8-10.5,4-13.5,5-merou,6.6-22,6.8-14.5,abaxiall,ag,alyx,apparently,axe,axillary,blade,borne,bud,capitat,clavate,connivent,coriaceous,decreasing,digestion,distal,dorsally,eaf,edge,eed,end,enzyme,erec,exceeding,flat,flower,folded,forked,geminat,generally,glabrou,hair-like,half,homostylous,honeycomb-shaped,interjected,larger,leaflet,lengthening,living,lower,middl,narrow,nflorescence,orbicular,orolla,pair,pentagonal,perfect,plurifoliate,pore,poricidal,removed,rotate,ruit,sessile,seudostipule,singly,size,slit,specimen,stamen,stigma,stolo,subequal,subglabrou,subtending,tall,tamen,tem,terminal,tip,toward,tri-,tube,tuber,typically,unit,unwinged,vary,wing,x,yellow,ympodial	'hair-like,abaxial,adaxial,arrangement,branching,calyx,characteristic,colour,form,growth,height,history,inflorescence,length,life,margin,mentioned,midvein,ovary,primary,pseudostipule,rachi,shape,staman,stem,subglabrous,surface,tertiary,texture,true,unarmed,vein,venation
324	wfo-0001029621	success	165	112	81	84	31	0.491	0.5-0.75,0.5-1,0.7-1.1,0.8-1,1-1.5,1.5-2,1.5-2.5,1.5-5,2.5-3,3-3.5,3.5-4.5,7-9,acute,anther,apex,appearing,attenuate,base,becoming,beneath,berry,branched,brown,calyx,cluster,cm,corolla,dark,decurrent,deltoid,dia,dry,erect,filament,fleshy,fruit,glabrous,globose,green,irregularly,lanceolate,later,lateral,leaf,live,lobe,many,margin,material,minutely,mm,oblanceolate,often,onto,ovary,ovoid-reniform,pale,pedicel,pitted,plant,prominent,ripe,sessile,shrub,small,stem,style,surface,tan,tapering,terminal,thick,time,tube,vein,white,whorl-like,woody,x,yellow,yellowish	.1,0.5-1.2,0.5-1.5,0.8-4.5,1-2,1/3,2/3,5-20-flowered,6-20,6-8,accrescent,along,anthesi,apar,appressed,area,bark,borne,caudate,completely,constricted,course,cup-shaped,densely,distal,eaf,edicel,eed,ellipsoid,elongate,enclosed,exsertio,free,fruiting,geminate,glabrate,late,like,lobed,lon,long,lower,main,merely,middle,nflorescence,occasionally,older,pair,papillate,papillo,papillose,planar,plurifoliat,pore,poricidal,portion,puberulent,quite,rarely,reddish,reddish-gre,river,ruit,scar,shaped,shiny,somewhat,spaced,ste,stigma,straight,tall,tear-drop,tip,trichome,ud,uniseriate,unit,way,widened,widest,ympodial,young	abaxial,adaxial,arrangement,branching,characteristic,colour,diameter,form,growth,height,history,inflorescence,length,life,midvein,null,peduncle,petiole,plurifoliate,primary,pseudostipule,rachi,reddish-grey,seed,shape,staman,tertiary,texture,true,unarmed,venation
325	wfo-0001029622	success	182	124	95	87	29	0.522	.1,.2,.5,0.5-0.7,0.5-1,0.6-0.9,0.8-1,1-1.2,1.5,2.5-3,3-4,3-5,30-35,4-6.5,40,45-50,5-6,abaxially,absent,acute,adaxially,anther,apex,appearing,attenuate,axil,base,brown,calyx,cm,consisting,corolla,cylindrical,deflexed,diameter,difoliate,elliptic,entire,filament,flower,fruit,geminate,glabrous,globose,green,inflorescence,internodal,jointed,known,leaf,lobe,long,long-acuminate,long-triangular,major,margin,mature,measured,midrib,minor,mm,narrowly,occasionally,onto,opposite,ovate,pair,pedicel,peduncle,pendent,petiole,rachi,raised,reddish,rounded,shiny,shrub,simple,single,slender,slightly,somewhat,stem,straight,style,tapering,tip,trichome,tube,tuft,uniseriate,unit,vein,white,x	/3,0.3,0.5,1-1.5,1-2.7,1-4,2-11,2-4,2-5,7-11,accrescent,ag,alyx,anthesi,apparently,arising,axe,bark,beneath,blade,bud,capitat,chartaceous,connivent,deciduous,differing,dimorphic,eaf,eed,elongate,except,free,fruiting,glabrou,ilament,immature,included,interlaced,lamina,lateral,less,lobed,longitudinal,m.,main,minute,minutely,nflorescence,obconic,oblong,often,older,one,opening,orolla,oung,ovate-lanceolate,papillose,pore,portion,present,probably,reflexed,remaining,ruit,sagittate,scar,second,shaped,size,slende,slit,stellate,stigma,tal,tear-drop,thin,thus,ud,unarme,unifoliat,vary,way,within,yellow,ympodial,young	abaxial,adaxial,arrangement,branching,characteristic,colour,form,growth,height,history,length,life,midvein,null,ovary,plant,primary,pseudostipule,seed,shape,staman,surface,sympodial,tall,tertiary,texture,true,unarmed,venation
326	wfo-0001029625	success	168	154	126	42	28	0.75	-15,..,.1-0.2,.5,0.5-1,0.5-1.3,0.5-2,0.8-1.4,1-1.5,1-2,1-3,1.2-1.6,100,2,2.5-.,3,3-,3-3,3-3.5,4-4,4-5-celled,4-7-celled,4-9,5,5-10,5-6,5-8,8-13,abaxial,along,anther,base,beneath,branch,branched,brittle,calyx,cell,cm,conical,corolla,darker,deflexed,deltate,densely,denser,diameter,dry,elliptic,filament,flattened,flower,four,fruit,glabrescent,glabrous,gland,gland-tipped,glandular,globose,green,greenish,growth,herb,hyaline,inflorescence,lamina,later,lighter,like,lobe,long,margin,markedly,middle,midline,minute,mixed,mm,new,occasionally,open,outer,outline,ovary,ovate-reniform,pair,pale,papillate,pedicel,peduncle,per,pericarp,point,primary,pubescent,purplish,rarely,reddish,regularly,scar,scattered,shrub,single,sinuate,small,smooth,sparsely,stem,striate,stripe,style,surface,tan,testa,thin,time,tinged,trichome,tube,uniseriate,unit,vein,wall,white,young	0.5-2mm,0.8-1.8,4-10,6-9,9-25,anthesi,apical,bark,branc,brow,capitat,cel,cucullate,deflexe,distinct,eaf,edicel,eed,erect,frui,fruiting,lobed,lower,narrowly,nearly,nflorescence,planar,plurifoliat,pointed,ruit,single-stemmed,slightly,stigma,strongly,tip,triangular,tuft,ud,weight,without,x,ympodial	adaxial,apex,arrangement,branching,brown,characteristic,colour,form,height,history,leaf,length,life,midvein,null,petiole,plant,plurifoliate,pseudostipule,rachi,seed,shape,staman,sympodial,tertiary,texture,unarmed,venation
327	wfo-0001029645	success	160	155	121	39	34	0.756	-1,.5-1,0.2-0.5,0.3-0.5,0.5-2.5,0.5-7,1,1-1.5,1-2,1-4,1.5,2.5-4,3-10,3-15,3-7,337,4-5,4-8,5,5-8,6-12,7-12,750,?,abaxially,abundantly,acuminate,adaxially,aggregate,along,anther,apart,apex,articulated,axe,base,blade,blue,brown,calyx,cell,cm,corolla,cuneate,cylindrical,decurrent,deltate,diameter,entire,et,except,extra-axillary,fide,filament,finger,flattened,flower,free,fruit,glabrous,gland-tipped,globose,green,greenish,hair,herb,immature,inserted,kayap,knapp,line,lobe,long,major,margin,membranaceous,mesocarp,minutely,mm,moderately,nearly,obtuse,ovate,ovate-elliptic,part,pedicel,peduncle,perfect,petiole,puberulent,purple,rachi,radiu,rarely,red,rugose-verrucate,sand-punctate,short,shorter,side,simple,small,smith,spaced,sparsely,stigma,stone,style,subcordate,thecae,time,triangular,truncate,unbranched,unit,vein,veiny,white,wide,x,Â±	1.3-7,1.5-2,2-3-foliat,2-4,2.5-17,3.5-4,acute,around,ba,chartaceous,connivent,directed,distall,distally,eaf,eed,glabrou,lower,nflorescence,orolla,pore,puberulen,rotate-stellate,ruit,sagittate,short-tomentose,shru,strongly,tal,tamen,tapered,tem,tightly,tomento,truncat,tube,vary,yellow,ympodial	2,2-3-foliate,abaxial,adaxial,arrangement,branching,characteristic,colour,form,growth,height,history,inflorescence,leaf,length,life,midvein,null,ovary,plant,primary,pseudostipule,seed,shape,shrub,staman,stem,surface,sympodial,tertiary,texture,true,unarmed,venation
328	wfo-0001029646	success	141	131	96	45	35	0.681	0.1-0.6,0.5,0.5-0.8,0.7-2.2,1-4,1.5-2,1.5-4.9,10-15,2-3,3-14,4-5.5,5-15,6-8,7-15,abaxially,acumen,acuminate,acute,adaxially,apex,articulate,attenuate,base,branched,calyx,cell,cm,corolla,covering,cyme,diameter,dichasial,dichasially,digestion,distal,ebracteate,elliptic,emoval,enzyme,equaling,filament,finely,flower,forked,generally,globose,green,green-white,hair-like,half,herbaceous,honeycomb,lateral,leaf,linear,living,lobe,long,make,mm,monochasial,mucilaginous,mucronate,narrowly,ovate,ovoid,pattern,pedicel,peduncle,perennial,perfect,petiole,plant,proximal,pubescent,reveal,seed,simple,specimen,stamen,stigma,straight,style,tall,testal,thick,throughout,tone,tuber-bearing,typically,unit,wall,white,wide,yellow-green,Â¼	3-6-foliat,apical,apically,commonly,dehiscent,dorsally,eaf,edge,eed,epiphytic,flat,folded,free,globo,ground,growing,introrse,lon,lower,maturing,mos,mould,nflorescence,nther,oak,often,orolla,ovat,pine,plan,poricidally,rarely,ruit,seudostipule,short,slit,stellate,tem,throughou,tree,vary,viole,without,yellow,ympodial	3-6-foliate,abaxial,adaxial,anther,arrangement,ba,branching,characteristic,colour,form,fruit,growth,height,history,inflorescence,length,life,margin,midvein,null,ovary,primary,pseudostipule,rachi,shape,staman,stem,surface,sympodial,tertiary,texture,unarmed,vein,venation,violet
329	wfo-0001029652	success	160	132	100	60	32	0.625	.3,.5,0.5-1,0.5-4,0.75-1,0.8-1,1-3,1.5-2,2-2.5,2.5-3,3.5-4,4-4.5,7-9,abaxially,adaxially,along,anther,apex,apical,arch,attenuate,base,berry,broadly,calyx,cm,conical,corolla,curling,deflexed,deltate,denser,difoliate,elliptic-ovate,filament,filiform,flower,free,glabrous,globose,golden,green,greenish-white,hard,hispid,joining,lamina,lateral,leaf,like,lobe,long,long-acuminate,long-styled,main,major,margin,maturity,midrib,minor,minutely,mm,narrowly,near,occasionally,opposite,ovary,ovoid-reniform,pair,pale,papillose,pedicel,pericarp,petiole,pitted,portion,projection,pubescent,reddish-brown,series,short-styled,shrub,simple,slender,slightly,sparsely,stem,style,surface,swollen,tan,thickened,trichome,tube,undulate,uniseriate,unit,vein,white,x	.25,1,1-2,2,2-4,25,3/4,6-15,anthesi,apar,ape,arching,ba,bark,bearing,cone,deciduous,dia,differing,drying,eaf,edicel,eed,evenly,exserted,fruiting,geminat,golden-red,heteromorphic,included,lobed,lon,lower,middle,minute,nflorescence,older,papillo,pore,poricidal,reflexed,ruit,scar,shaped,size,slende,soon,spaced,stigma,tall,tear-drop,time,tip,tub,ud,way,widest,within,ympodial,young	abaxial,adaxial,arrangement,branching,characteristic,colour,diameter,form,fruit,geminate,growth,height,history,inflorescence,length,life,mentioned,midvein,peduncle,plant,primary,pseudostipule,rachi,seed,shape,staman,sympodial,tertiary,texture,true,unarmed,venation
330	wfo-0001029673	success	159	109	84	75	25	0.528	.5,0.5-1,0.7-1.1,0.8-1,1-10,1-2,1-5,1.5-2,10-20,2-2.5,2-4,2.5,3/4,4-6,5-25,abaxial,abaxially,acuminate,acute,adaxial,adaxially,anther,anthesi,apex,base,berry,black,branching,broadly,calyx,cm,corolla,deep,deltoid,dendritic,densely,diameter,elliptic,filament,flower,fruit,glabrous,globose,greyish-yellow,growth,lamina,leaf,length,lenticular,lobe,long,minutely,mm,monochasial,narrowly,nodding,ovary,pair,pedicel,pericarp,petiole,pitted,plurifoliate,pubescent,purple,pyramidal,reddish-brown,secondary,shrub,small,sparsely,stem,style,surface,terminal,thin,time,tree,triangular,trichome,vein,violet,winged,x	0.75-1,1.2-3.5,1.5-1.8,2-3,3-5,5.5-15,absent,accrescent,age,along,apical,appearing,bark,basal,becoming,blade,branch,clavate,conical,decurrent,deflexed,denser,dichasia,eaf,edicel,eed,ew,exserted,fork,free,fruiting,greyish,greyish-yello,individual,inserted,later,lateral,like,lon,longer,lower,m.,nflorescence,occasionally,older,overtopping,papillo,petal,planar,pore,poricidal,portion,prominent,reflexed,ruit,scar,shoot,sleeve,slightly,slit-like,somewhat,stamen,stigma,strongly,tall,tapering,tip,tub,tube,ud,unit,wide,woody,ympodial,young	arrangement,characteristic,colour,dichasial,form,height,history,inflorescence,life,margin,midvein,null,peduncle,plant,primary,pseudostipule,rachi,seed,shape,staman,tertiary,texture,true,unarmed,venation
331	wfo-0001029680	success	212	176	115	97	61	0.542	0.1,0.4,0.6,1,1.0,1.5,10,12,5,50,abaxially,acute,adaxially,annual,anther,anthesi,apart,apex,appressed,arequipa,articulated,axillary,base,becoming,beyond,bipinnate,blade,blue,borne,branched,brown,calyx,cell,cm,cylindrical,decurrent,diameter,divided,erect,extending,filament,flange,flattened,fleshy,flower,forming,fruit,glabrous,globose,green,hair,herb,indistinct,leaf,length,light,lobe,long,margin,mm,moderately,multicellular,node,oblong,obovate,obtuse,often,ovate,pair,pale,parallel,pedicel,peduncle,pendant,perfect,petiole,pinnae,pinnate,pitted,primary,prostrate,pubescent,purple,rarely,red,ripe,running,shallowly,shoot,simple,sometimes,spaced,sparsely,specimen,stem,stone,straight,style,subglabrous,surface,tacna,terminal,tertiary,time,tripinnate,turning,unicellular,uniseriate,violet,white,wide,wing,winged,woody,x	.0,0.5â1.5,0.6â1.2,0.6â2.0,0.9â1.0,1.0â1.1,1.0â1.5,1.0â1.8,1.1â1.2,1.4â2.5,1.4â7.5,1.6â2.7,1.7â7,1.8â3.8,11â16,11â25,1â2,1â3,1â6,1â8,2.2â4.2,2â20,3.0â4.2,3.3â5.5,3â22,3â6,4.0â16,4.0â6.5,4.5â20,4.5â7.0,4â10,4â30,5.5â8.5,5â11,7â10,8â32,absen,adaxiall,ag,along,arranged,asymmetrically,axe,ba,clavate,connivent,decreasing,densely,difoliate,eaf,eed,entire,equal,geminat,irregularly,lon,longitudinal,lower,m.,midrib,narrow,nflorescence,occasionally,opening,orolla,pentagonal,plurifoliate,pore,poricidal,rapidly,rotate,ruit,secondary,shaped,side,size,split,stigma,tal,tamen,tear-drop,tem,tip,tube,unit,usually,vary,winge,yellow,ympodial,â10,â12.5,â19,â3,â3.2,â46,â48	--,0.5,1-2,1.1,1.2,1.4,1.6,1.7,1.8,11,12.5,16,19,2.2,2.7,25,3,3.0,3.2,3.3,3.8,32,4,4.0,4.2,4.5,5.5,6,6.5,7,7.0,7.5,8,abaxial,absent,adaxial,arrangement,branching,characteristic,colour,corolla,form,growth,height,history,inflorescence,life,midvein,null,ovary,plant,pseudostipule,rachi,seed,shape,staman,texture,true,unarmed,vein,venation
332	wfo-0001029704	exception_thrown	146	0	0	146	0	0.0		-17,-3,.5,0-1.5,0.5,1,1-2,1-4,1.5,1.5-2.5,1.5-3,10-14,1000-1200,140-185,15-25,2-2.5,2-3,2-5,3-4-celled,3-5,4,4-7,5,7-,7-10,9-20,acuman,acuminate,acute,along,also,anther,anthesi,apex,apparently,aspect,axi,base,berry,blue,branch,broadly,brown,c.,calyx,cell,cm,composed,conical,corolla,cunate,cuneate,cut,dark,deeply,deflexed,dia,diam,eaf,eed,ellipsoid,enlarged,erect,especially,exerted,extra-axillary,few-flowered,filament,flower,flowering,fork,fruiting,glabrous,globose,gradually,green,halfway,lanceolate,leaf,lengthening,less,lobe,lobed,long,lower,midrib,minute,minutely,mm,moderately,mottled,nflorescence,obovate,obovoid,occasionally,one,ovary,pedicel,peduncle,petiole,pinnatisect,plurifoliat,pore,poricidal,pubescent,purple,record,reddish,reticulate,rounded,ruit,shoot,short,shrub,simple,single,sinus,slit,sombre,sprawling,stellate,stigma,stone,stout,straight,striped,style,subdiscoidal,subglobo,surface,swollen,tip,trichome,tub,tube,twig,ud,unit,variable,variously,vein,white,within,x,ympodial,young	
333	wfo-0001029727	success	260	128	109	151	19	0.419	-3,0-15,0-30,0-4,0-40,0.3,0.4-1,1-1.2,1-4,1.2-2,1.6-3,2.5,2.5-3.2,2.8-4,3-6,3-7,4.5,5-9,5.5-7,abaxial,acuminate,acute,adaxial,almost,anther,apex,apically,articulated,base,berry,calyx,climber,cm,colourles,cordate,corolla,covered,curved,darker,densely,diameter,drying,edge,equal,erect,ferrugineous,filament,filiform,finely,flattened-reniform,glabrous,increasing,leaf,length,like,lobe,lobed,long,margin,middle,midvein,mixture,mm,narrow-deltate,oblong,occasional,orange-brown,ovate,pair,pedicel,peduncle,per,petiole,pit,pitted,poricidal,prickle,primary,pubescent,red-brown,rounded,scandent,seed,shallowly,shape,shrub,simple,size,smooth,stellate,stellate-pubescent,stem,style,subentire,surface,tapering,tertiary,tip,toward,trichome,unarmed,vein,venation,violet,visible,wide,x,yellowish,young	-1/3,-10,.5,/3,0-2,0-20,0-5,0-8,0.1-5,0.15-0.2,0.15-0.3,0.2,0.2-0.5,0.2-2.5,0.4,0.5,0.5-1.2,0.5-3,0.7-0.9,0.7-1,1,1-,1-2,1.5-2.3,1.5-2.5,1.5-3,1.5-5.5,1/2-2/3,1/3-1/2,1/4,1/8-1/5,2-5,2.5-5.5,3-11,3/,4-7,4-merou,4-merous,4.5-,5-12,5-8,6-11,7-10,abaxially,acicular,age,along,alternate,alyx,ame,anthesi,apar,apart,apparently,bark,blade,branched,bristle,brown,c.,chartaceous,clavate,connivent,cupular,deltate,deltoid,developing,different,dimorphic,discolorous,divided,eaf,eed,elongating,except,extending,filiform-acuminat,fissure,flower,free,geminate,inside,lateral,lengthening,less,lon,longer,lower,m.,mature,mauve,midpoint,minor,minutely,moderately,nflorescence,nther,obconical,older,one,open,orolla,oung,outside,papillo,papillose,perfec,perfect,plurifoliat,pore,porrect,portion,prickl,prickly,protruding,raised,rarely,ray,red-brow,reddish,reduced,regular,scar,series,sessile,short,sinus,sometimes,spaced,spreading,stalk,stalked,stigma,straight,strongly,tamen,tearing,terete,terminal,time,translucent,transverse,tube,uneven,unit,upper,variable,variously,vary,way,ympodial	arrangement,branching,characteristic,colour,filiform-acuminate,form,fruit,growth,height,history,inflorescence,life,null,ovary,plant,pseudostipule,rachi,staman,texture
334	wfo-0001029731	success	246	185	160	86	25	0.65	.5,.6,0.1-0.8,1,1-2,1-2.5,1.5,1.5-2.5,1/3,2-3,2-6,2.5,3,3-4,4,4-5,4-9,6-7,7-11,8-9,abaxially,accrescent,acquiring,acuminate,acute,adaxially,along,anther,apex,apically,articulated,bark,basal,basally,base,beak,becoming,berry,black,boundary,branch,branched,branching,broadly,brown,bumpy,calyx,clearly,cm,concolorous,conical,coriaceous,corolla,crinkled,cuneate,delimited,deltoid,development,diameter,different,dilated,distributed,dry,drying,dull,early,elliptic,elongating,enlarge,entire,epiphyte,erect,evenly,faint,filament,filiform,finely,flattened,fleshy,flower,free,fruit,fruiting,glabrous,ground,lamina,later,lateral,leaf,less,liana,like,linear,lobe,long,long-ellipsoid,longitudinal,longitudinally,lower,main,margin,mature,maturity,mauve,midvein,mm,much,obovate,obtuse,often,orange-brown,pair,papillae,part,pedicel,peduncle,pendulous,pericarp,persisting,petiole,portion,primary,pyriform,rachi,raised,rarely,reflexed,revolute,ridge,ridged,rounded,several,slender,sometimes,sparsely,stem,stigma,straight,stretched,style,succulent,sunk,surface,terminal,thick,thinner,though,tube,tuft,usually,vein,venation,visible,white,wide,woody,wrinkling,x,yellow,yellow-green	0.05,0.25-0.3,1-1.5,1.5-3,10-20,1994,2,2.5-4.5,3-10,31,6,age,almost,alyx,anthesi,apar,apparently,arcy,clavate,connate,darker,delineated,dense,domatia,dorsal,dorsifixed,eaf,equal,even,exserted,fine,flaring,hair,iscoid,large,lengthening,lobed,lon,narrowly,nflorescence,nther,obconical,oblong,occasionally,orolla,papillose,perfec,plurifoliat,pore,poricidal,prominent,protruding,rakotozafy,reported,ribbed,ruit,scar,see,shallowly,shorter,simple,sinus,slightly,small,smaller,smoot,stump,tearing,thickened,time,tip,toward,trichome,tub,ud,unit,vary,ventral,visibl,well-developed,widely,wing,winged,ympodial,young,â	abaxial,adaxial,arrangement,characteristic,colour,discoid,explicitly,form,growth,height,history,inflorescence,length,life,mentioned,null,ovary,plant,pseudostipule,seed,shape,staman,tertiary,texture,unarmed
335	wfo-0001029741	success	137	118	88	49	30	0.642	.4,.5,0.5-1.5,0.9-1.2,1-1.5,1-3.5,1.1-1.3,1.5,1.5-4,1.5-6,10-50-flowered,3,?,acute,age,anther,apex,apiculate,attenuate,base,becoming,berry,black,ca,calyx,cm,completely,corolla,dark,deltoid,dia,difoliate,dry,drying,elliptic,filament,free,fruit,furcate,glabrous,globose,green,growth,immature,inflorescence,known,lateral,leaf,lenticellate,lighter,lobe,long,main,major,middle,minor,minutely,mm,opposite,ovary,ovate,pair,papillose,pedicel,petiole,portion,prominent,proximal,quite,raised,reddish-brown,shrub,size,slender,stem,straight,style,tapering,tree,tube,unit,usually,variable,vein,weak,white,widest,x	0.8-3.5,2-2.5,2.2-9,2.5-7.8,9.5-22.5,accrescent,anthesi,branched,caly,capitate,closely,deflexed,differing,divisio,eaf,early,edicel,eed,erect,exserted,flower,fruiting,geminat,glabrou,lobed,lon,lower,nearly,new,nflorescence,overlapping,papillo,planar,pore,poricidal,produced,ruit,scar,shaped,slightly,spaced,stigma,tall,tear-drop,tip,ud,wood,woody,ympodial	abaxial,adaxial,arrangement,branching,characteristic,colour,diameter,form,geminate,height,history,length,life,margin,midvein,null,peduncle,plant,primary,pseudostipule,rachi,seed,shape,staman,surface,sympodial,tertiary,texture,unarmed,venation
336	wfo-0001029744	success	113	132	99	14	33	0.876	0.3-0.6,0.5-1,1,1.5,1.5-3.2,2,2-4,5-8,50,7-15,8-10-flowered,8-11,abaxially,acute,adaxially,along,apart,apex,bark,base,beginning,blunt,branch,calyx,cm,deltate,dendritic,densely,denser,difoliate,distinct,elliptic,entire,examined,extreme,fide,flattened,flexuous,form,fruit,geminate,glabrescent,glabrous,golden,incrassate,lamina,lanceolate,leaf,lobe,long-acuminate,looping,margin,marginal,mature,minutely,mm,narrowly,node,non-reproductive,oblanceolate,oblique,occasionally,older,opposite,ovoid-reniform,pair,pale,pedicel,petiole,pitted,primary,pubescence,pubescent,revolute,scar,shape,shrub,simple,single-celled,slightly,small,smith,sometimes,somewhat,spaced,stem,surface,thee,thin,tip,trichome,unicellular,unifoliate,uniseriate,unit,vein,white,x,young	brow,eaf,eed,inflorescenc,leave,lower,major,minor,nflorescence,see,similar,smaller,ud,ympodial	abaxial,adaxial,anther,arrangement,branching,brown,characteristic,colour,corolla,diameter,filament,growth,height,history,inflorescence,length,life,midvein,null,ovary,peduncle,plant,pseudostipule,rachi,seed,staman,style,sympodial,tertiary,texture,true,unarmed,venation
337	wfo-0001029746	success	179	144	119	60	25	0.665	.5,0.3-2,0.7-1,1,1-1.3,1-1.5,1.5,2,2-2.5,2-8,3,3-4,3-4-pluri-foliate,3-4.5,3-6,6,6-7,8-10,8-11,abaxially,acuminate,acute,adaxially,anther,apex,base,becoming,berry,brown,calyx,cell,centre,ciliate,cm,conical,cordate,corolla,crenate,crowded,curved,dark,darker,densely,diameter,elliptic,filament,flattened,fleshy,flower,free,fruit,glabrous,gland-tipped,glandular,globose,greenish,growing,herb,heteromorphic,hollow,inflorescence,internodal,irregularly,lamina,leaf,less,lobe,long,longest,margin,mature,mid-length,mm,narrowly,near,occasionally,orange,ovary,ovate,ovoid,pair,pale,pedicel,peduncle,pericarp,petiole,pitted,portion,primary,principal,pubescent,purple,rachi,red,reddish,shallowly,shortest,simple,single,sparsely,stem,straight,strongly,style,subshrub,surface,testal,thin,tip,trichome,tube,uniseriate,unit,upper,upward,vein,wall,x,â3	0.5-1,1.2-1.5,2-4,2-7,4-9,age,anthesi,apart,bearing,blackish,broadly,c.,capitate,color,cup-shaped,eaf,edicel,eed,ellipsoid,enlarged,entire,erect,exerted,flush,fruiting,horn,lengthening,lon,longer,lower,markedly,maturit,minutely,mixed,nflorescence,nodding,papillo,papillose,plan,pore,poricidal,pubescen,reflexed,ruit,scar,slender,slightly,slit,somewhat,spaced,sparse,spreading,stigma,third,triangular,ud,widely,widest,woody,ympodial	abaxial,adaxial,arrangement,branching,characteristic,colour,form,growth,height,history,length,life,midvein,null,plant,pseudostipule,seed,shape,staman,sympodial,tertiary,texture,true,unarmed,venation
338	wfo-0001029769	success	142	122	92	50	30	0.648	.25,.5,0.5-1.5,1-1.2,1-3,1.5-2.5,2.5-3,3.5-4,30-60-flowered,5-8,6-17,7-8,8-9,abaxially,acuminate,acute,adaxially,along,anther,anthesi,apex,bark,base,bearing,berry,brochidodromu,brown,calyx,cm,corolla,dark,deflexed,deltoid,densely,dia,elliptic,filament,filiform,flower,free,fresh,glabrous,globose,golden,green,hen,horizontally,internodal,lateral,leaf,like,lobe,long,main,margin,midrib,minutely,mm,older,onto,opposite,ovary,ovoid-reniform,pair,pedicel,petiole,pitted,portion,puberulent,pubescent,ried,scattered,shrub,simple,smooth,sparsely,stem,style,surface,three,time,tip,trichome,tube,two,uniseriate,vein,white,wide,winged,x,young	1.5-2,2.5-8,4,4-5,8.5-17,apar,ape,archin,ba,branch,capitate,cerro,conical,curl-tipped,cyathiform,eaf,edicel,eed,exserted,fruiting,inglÃ©,less,lobed,lon,lower,nearly,nflorescence,papillo,papillose,pore,poricidal,reflexed,ruit,scar,shaped,somewhat,spaced,stigma,straight,swollen,tall,tear-drop,tub,ud,unevenly,unifoliat,unit,widely,woody,ympodial	abaxial,adaxial,arching,arrangement,branching,characteristic,colour,diameter,form,fruit,growth,height,history,inflorescence,length,life,midvein,null,peduncle,plant,primary,pseudostipule,rachi,seed,shape,staman,tertiary,texture,unarmed,venation
339	wfo-0001029780	exception_thrown	204	0	0	204	0	0.0		1-1.2,1-10,1-2,1.4-1.9,1.5-2,11-24,120-210,15-22,15-45,2-12,2-2.5,2-2.8,2-3.5,2-5.5,2.4-4.2,20-60,3,3-6,3.5-7.3,4-6,4.5-6,5-7,5-merou,5.5,5.5-13,50-70,600-950,8-12,?,abaxially,absent,acumen,acute,adaxially,ag,along,alyx,anther,apart,apex,apparently,articulated,attenuate,axe,axillary,base,berry,blade,borne,brownish,bud,capitat,cell,chartaceous,ciliate,cm,condition,connivent,cordate,corolla,covering,cuneate,dark,decumbent,densely,diameter,digestion,distal,dorsally,drying,eaf,edge,eed,end,enzyme,erec,especially,exceeding,except,filament,flat,flower,folded,forked,fresh,fruit,geminat,generally,glabrou,glabrous,gland,glandular,globose,greatly,green,green-white,greenish,hair,hair-like,hal,half,head,herb,high,homostylous,honeycomb-shaped,interjected,invested,lanceolate,lateral,leaflet,length,lengthening,like,living,lobe,long,longer,lower,make,margin,membranous,midrib,minute,minutely,mm,mucilaginous,nflorescence,non-glandular,obtuse,odd-pinnate,often,orbicular,orolla,ovate,ovoid,pair,pale,pedicel,peduncle,perfect,petiole,petiolulate,petiolule,pinkish,plant,plurifoliate,pore,poricidal,proximal,puberulent,pubescent,rarely,reduced,removed,ripe,rotate,ruit,seed,sessile,seudostipule,short,singly,size,slit,spaced,specimen,stamen,ste,stem,stigma,stolo,straight,streak,stripe,style,subequal,subtending,tall,tamen,tem,terminal,testal,tetralobulate,thick,throughout,tip,tri-,trichome,truncate,tube,tuber,typically,unit,unwinged,usually,vary,wall,wet,white,whitish,x,yellow,ympodial	
340	wfo-0001029784	success	237	140	117	120	23	0.494	-12,-5,.1,.2,.5,0.25-0.3,0.4-0.45,0.5-1.5,0.6-1,1-1.1,1-1.2,1-4,1.7-2.6,1/3,2,2-,2-2.5,2-4,2-foliate,2-locular,2/3,5-10,5-14,abaxial,abaxially,acuminate,acute,anther,apex,articulated,basal,base,basicopically,beneath,brown,calyx,cm,corolla,crenate-serrate,crenation,dark,decurrent,deeper,densely,developed,diameter,distal,due,eglandular,elliptic,filament,flower,fruit,glabrous,glandular,globose,golden,green,hair-like,half,herb,imparipinnate,inflorescence,interrupted,lanceolate,leaflet,like,lobe,long,margin,markedly,maturing,mm,mostly,narrowly,node,obovate,outgrowth,ovary,pair,pale,paler,pedicel,peduncle,perennial,petiole,plant,present,primary,proximal,pseudostipule,pubescence,pubescent,scattered,simple,smaller,soft,somewhat,sparsely,stem,stripe,style,surface,tertiary,trailing,trichome,truncate,tube,unit,unseriate,usually,vein,velvety,white,winged,woody,yellow	0-4,0.1-,0.1-0.15,0.1-0.5,0.2,0.2-,0.2-0.3,0.2-0.5,0.3-0.35,0.3-0.4,0.3-0.5,0.3-1,0.4-,0.4-0.5,0.4-0.6,0.5,0.5-,0.7-1.2,0.9-1.2,1,1-,1-1.5,1-2,1-2-celled,1.0-1.3,1.2-2.5,1.5-,2-3-celled,2-4.5,2.5-3.5,3-,3-5,5-8,absent,abundant,adaxially,adpressed,along,angled,anthesi,apical,appearance,appendage,arising,articulation,axi,berry,bract,broadly,capitate,cell,column,conical,distributed,eaf,edicel,eed,enclosing,entire,evenly,exserted,fruiting,giving,glabrescent,gree,hal,halfway,head,included,interjected,internode,interspersed,irregularly,lamina,larger,lateral,live,lon,long-acuminate,loosely,lower,multicellular,nflorescence,northern,occasionally,often,orbicular,patent,pentagonal,petiolule,population,rarely,reflexed,ripe,robust,ruit,secondary,sessile,silky,sometimes,sparse,spreadin,staminal,sterile,stigma,stout,straight,strongly,tem,terminal,testa,thick,ud,undulate,unicellular,uniseriate,wall,wide,x,ympodial	adaxial,arrangement,branching,characteristic,colour,form,growth,height,history,leaf,length,life,midvein,null,rachi,seed,shape,staman,sympodial,texture,true,unarmed,venation
341	wfo-0001029785	success	223	127	98	125	29	0.439	0.1-0.5,0.8-1,1-2,1-5,1.2-3.2,1.5-3.6,1.8-3.5,10-26,2-4,3-6,3.5-5,6,8-11,abaxially,absent,acute,adaxially,along,anther,apex,attenuate,base,berry,broadly,brownish,cell,cm,condition,corolla,covering,cuneate,dark,denser,diameter,drying,elliptic,especially,filament,fresh,fruit,glabrous,globose,green,greenish,hair,herb,invested,lateral,leaf,like,lobe,long,make,margin,medium,minute,mm,mottled,mucilaginous,multiple-celled,non-glandular,oblique,obovate,obtuse,odd-pinnate,ovate,ovoid,pale,pedicel,peduncle,petiole,plant,pubescent,purple,purple-tinged,rarely,ripe,rounded,scale-like,seed,short,slightly,sometimes,sparsely,stem,stripe,style,subglabrous,testal,thick,typically,unbranched,vein,violet,wall,wet,white,whitish	0-2,0-3,0.3-2.2,0.4-4.9,1-1.2,1-10,1.8-7,3-4,3-8,3.8-7.2,4-10.5,5-16,5-9,5-merou,acumen,ag,alyx,apart,apparently,articulation,axe,axillary,blade,borne,bud,capitat,chartaceous,clavate,commonly,connivent,cordate,darker,decreasing,decumbent,digestion,distal,dorsally,eaf,edge,eed,end,enzyme,erec,exceeding,flat,flower,folded,forked,geminat,generally,glabrou,greatly,green-white,hair-like,half,homostylous,honeycomb-shaped,interjected,lanceolate,larger,leaflet,lengthening,living,lower,markedly,membranous,middle,midrib,minutely,much,nflorescence,one-quarte,orbicular,orolla,outer,pair,pentagonal,perfect,petiolulate,petiolule,plurifoliate,point,pore,poricidal,present,puberulent,quite,removed,rotate,ruit,sessile,seudostipule,shallowly,singly,size,slit,spaced,specimen,stamen,ste,stigma,stolo,straight,subtending,tall,tamen,tem,terminal,throughout,tip,toward,tri-,truncate,tube,tuber,unequal,unit,unwinged,usually,variable,vary,wide,x,yellow,ympodial	'hair-like,abaxial,adaxial,arrangement,branching,calyx,characteristic,colour,form,growth,height,history,inflorescence,length,life,mentioned,midvein,ovary,primary,pseudostipule,rachi,shape,staman,surface,tertiary,texture,true,unarmed,venation
342	wfo-0001029789	success	167	131	97	70	34	0.581	0.2-0.5,1-10,1-3,12,2-25,2-6,2-6.5,2.7-4.7,3-5,3-8.5,4-13,5-7,6,6-7,7-21,8-9,abaxially,acuminate,acute,adaxially,anther,apart,apex,apparently,articulated,axe,axillary,base,basiscopic,blue,broadly,bud,cm,corolla,dark,decurrent,diameter,distal,exceeding,filament,flower,forked,formed,fruit,generally,glabrous,green,hair,half,herb,leaf,light,like,lilac,linear,lobe,long-attenuate,maturing,minute,mm,mottled,narrowly,never,odd-pinnate,ovary,ovate,pedicel,peduncle,perfect,petiole,petiolulate,plant,plurifoliate,pubescent,rachi,rarely,sessile,short,side,simple,spaced,sparsely,stamen,star,sterile,straight,style,subglabrous,subtending,terminal,tinged,tri-,typically,unit,usually,white,x	0-2,0.5-2.8,0.8-3.5,1-2,1.5-2,1.7-8.5,1.8-6.5,2-3,4-10,5-merou,7-16.6,acumen,adaxiall,ag,alyx,attenuate,blade,capitat,chartaceous,clavate,connivent,decreasing,dorsally,eaf,edge,eed,erec,flat,folded,geminat,greatly,hal,homostylous,interjected,lanceolate,lant,lateral,leaflet,lengthening,long,lower,lunate,membranous,minutely,nflorescence,orbicular,orolla,pair,pentagonal,pore,poricidal,pubescen,purpl,rotate,seudostipule,size,slightly,slit,ste,stigma,subequal,tall,tamen,tem,tip,toward,tube,vary,yellow,ympodial	abaxial,adaxial,arrangement,branching,calyx,characteristic,colour,form,geminate,growth,height,history,inflorescence,length,life,margin,midvein,null,primary,pseudostipule,purple,seed,shape,staman,stem,steril,surface,sympodial,tertiary,texture,true,unarmed,vein,venation
343	wfo-0001029810	success	149	122	92	57	30	0.617	.25,.5,0.5-1,0.5-3,1-1.3,1-1.5,1-10,1-2,1-3,1.1-2.3,1.5-3,2.5-3,3-3.5,3-4,5-15-flowered,5-6,8-12,abaxially,acuminate,acute,adaxially,along,anther,apex,apically,arachnoid,attenuate,base,berry,brown,calyx,cm,congested,corolla,dark,deltate,dendritic,densely,dia,difoliate,drying,elliptic,filament,free,glabrous,globose,green,inflorescence,lateral,leaf,like,lobe,long,main,major,margin,minor,minutely,mm,narrowly,occasionally,opposite,ovary,ovoid-reniform,pale,papillose,pedicel,petiole,pitted,pointed,portion,pubescent,reddish-brown,rest,shining,shrub,simple,slender,small,sparsely,stem,style,surface,tan,tapering,tree,trichome,tube,vein,white,wide,yellowish	2-3,2-5,3-6,4-10,5-16,anthesi,ape,bark,capitate,closely,compact,compressed,conical,deflexed,differing,eaf,edicel,eed,ellipsoid,exserted,fleshy,fruiting,geminat,glabrou,internodal,large,later,lenticel,less,lobed,lon,lower,middle,nearly,nflorescence,older,overlappin,papillo,planar,pore,poricidal,ruit,scar,shaped,size,spaced,stigma,tall,tear-drop,tip,tub,ud,unit,widest,woody,ympodial,young	abaxial,adaxial,arrangement,branching,characteristic,colour,diameter,form,fruit,geminate,growth,height,history,length,life,mentioned,midvein,peduncle,plant,primary,pseudostipule,rachi,seed,shape,staman,tertiary,texture,true,unarmed,venation
344	wfo-0001029811	exception_thrown	225	0	0	225	0	0.0		-3,-6,-merous,.5,/3,0,0-30,0-35,0.1-0.3,0.1-0.4,0.2,0.2-0.6,0.3-1,0.3-1.5,0.5-2,0.8-1.5,1,1-1.5,1-2.5,1-3,1.3-1.7,1.5-2.5,1.5-6,1/,1/2-2/3,1/3,1/3-2/3,10-22,13-20,15-23,15-50,2-2.5,2-5,2-5.5,2.5-3,2.8-3.2,20-100,3-5,3-5.5,3-7,3.5-4.5,4-8,4.5-5,5,5-11,5-17,5-40,5-9,6-12,7-18,7-9,8-12,8-18,abaxial,abaxially,acicular,adaxial,alyx,andromonoecious,anther,apar,apart,apex,apically,apparently,articulated,bark,base,berry,blade,broad-deltate,brown,calyx,cell,chartaceous,cm,connivent,cordate,cream,cuneate,dark,densely,diameter,discolorous,distal,distance,drying,eaf,eed,elongate,elongating,equal,erect,extending,eye,faint,fewer,filament,flattened,flattened-reniform,flower,free,fruit,fruiting,glabrous,glandular,green,green-brow,hair,herb,hermaphrodite,heterostylous,inflated,infructescence,lateral,leaf,length,less,lobe,lobed,lobing,long,long-acuminat,long-styled,longer,lower,lowermost,margin,marking,mature,maturity,mauve,midpoint,midvein,minute,mm,moderately,multangulate,naked,narrow-deltate,nflorescence,obtuse,often,older,one,open,orange-brown,orolla,oung,outline,ovate,pair,pale,pedicel,peduncle,pendulous,per,pericarp,perpendicular,petiole,pit,plant,plurifoliat,poricidal,porrect,portion,prickl,prickle,prickly,primary,raised,ray,ruit,scandent,scar,secondary,sessile,short,short-styled,shorter,shrub,side,simple,slightly,small,smooth,sometimes,spaced,sparsely,spherical,spreading,stalk,stalked,staminat,stellate,stellate-pubescent,stem,stout,straight,style,surface,tamen,tapering,terete,tertiary,time,tip,trichome,tube,unarmed,unbranched,unit,upper,usually,vary,vein,venation,visible,way,wide,woody,yellow,yellow-green,ympodial,young	
345	wfo-0001029978	success	208	141	110	98	31	0.529	0.5-0.6,1-10,1-2,1.4-1.5,1.5-3.1,11-19,15-27,3-5,3-7,3.2-2.5,3.7-8.1,4-11,4-7,4.2-5.2,5,8-10,abaxially,acuminate,adaxially,anther,apart,apex,apparently,articulated,asymmetrical,attenuate,axe,axillary,base,basiscopic,berry,brownish,bud,cell,cm,coarsely,commonly,condition,conical,corolla,covering,dark,darker,diameter,distal,drying,elliptic,exceeding,filament,finely,flower,forked,fresh,fruit,generally,glabrous,green,green-white,greenish,hair,half,herb,lateral,leaf,leaflet,light,like,lobe,long,make,margin,medium,middle,minute,mm,mottled,mucilaginous,odd-pinnate,ovate,ovoid,pedicel,peduncle,perfect,petiole,plant,pubescent,purple,ray,ripe,seed,side,simple,spaced,sparsely,stamen,stem,straight,style,subsessile,subtending,symmetrical,terminal,testal,thick,throughout,tissue,usually,wall,wet,whitish	0.3-0.4,0.3-0.7,0.7-1.9,0.8,0.9-2.3,1.3-1.5,1.8-5,2-4,3.1-6.3,3.5-9.5,5-16.5,5-merou,acumen,ag,along,alyx,arranged,bead,blade,capitat,chartaceous,ciliate,clavate,connivent,decreasing,digestion,dorsally,eaf,edge,eed,enzyme,erec,especially,flat,folded,fourt,geminat,glabrou,gradually,hair-like,homostylous,honeycomb-shaped,interjected,lanceolate,larger,lengthening,less,living,lower,membranous,midrib,minutely,moniliform,multiple,narrow,necklace,nflorescence,orbicular,orolla,pair,pentagonal,petiolule,plurifoliate,pore,poricidal,puberulent,pubescen,removed,rotate,ruit,secondary,semierect,sessile,seudostipule,size,slightly,slit,specimen,ste,stigma,stolon,subequal,tall,tamen,tem,tip,toward,tri-,tube,tuber,typically,unit,vary,wide,wing,x,yellow,ympodial	'hair-like,abaxial,adaxial,arrangement,branching,calyx,characteristic,colour,form,fourth,growth,height,history,inflorescence,length,life,mentioned,midvein,ovary,primary,pseudostipule,rachi,shape,staman,surface,tertiary,texture,true,unarmed,vein,venation
346	wfo-0001029980	success	173	166	133	40	33	0.769	.1,.5,0.1-0.25,0.25-0.5,0.25-1,0.5-1,0.5-1.2,0.5-2.5,0.5-5,0.7-1.3,0.8-1.2,1-1.5,1.2-2.5,1.5-2,2-5,2-6,3-4,5-10,5-50-flowered,abaxially,acute,adaxially,anther,anthesi,apex,appressed,axil,bark,base,berry,black,bright,brown,calyx,closely,cm,conical,corolla,curved,dark,decurrent,deflexed,deltoid,density,dia,difoliate,dried,drying,elevation,elliptic,especially,filament,flattened-reniform,free,glabrous,globose,gray,greatly,green,greenish-white,high,impressed,incrassate,lateral,leaf,live,lobe,long,main,major,margin,material,middle,minor,minutely,mm,near,node,often,older,one,onto,opposite,ovary,ovate,overlapping,pair,pale,paler,papillose,pedicel,petiole,pitted,plant,portion,prominent,proximal,puberulent,race,rounded,scar,shape,shiny,shrub,side,simple,slender,slightly,small-capitate,somewhat,spaced,specimen,stem,straight,style,surface,tan,tapering,trichome,tube,tuft,unicellular,uniseriate,unit,varying,vein,venezuelan,white,widest,winged,x,yellowish,young	0.9-4.5,1-1.7,1.5-6,2/3,3-9,6.4-17,apar,appearing,ba,bud,differing,eaf,edicel,eed,exserted,five,fruiting,geminat,knob,lobed,lon,lower,nflorescence,orbicular,pore,poricidal,reflexed,ruit,shaped,size,soon,stigma,tall,tear-drop,tip,ud,way,whit,woody,ympodial	-,abaxial,adaxial,apart,arrangement,branching,characteristic,colour,diameter,form,fruit,geminate,growth,height,history,inflorescence,length,life,mentioned,midvein,peduncle,primary,pseudostipule,rachi,seed,staman,sympodial,tertiary,texture,true,unarmed,venation,winge
347	wfo-0001029989	success	161	113	81	80	32	0.503	0.25-0.5,0.5-1,1-1.5,1-2.5,1-4,1.3-2.3,10-14,2.5-3,3-5,3-8,4-4.5,5-10-flowered,5-6,abaxial,abaxially,acute,adaxially,anther,apex,base,berry,branch,broadly,calyx,capitate,cm,congested,corolla,deltoid,dendritic,densely,described,dia,drying,elliptic,filament,flattened,glabrous,globose,gray,green,greenish-black,incrassate,inflorescence,internodal,lateral,leaf,lenticular,like,lobe,long,main,margin,minutely,mm,nodding,occasionally,opposite,ovary,pair,pedicel,petiole,pitted,pubescent,reddish,reddish-brown,rest,shining,short-style,shrub,simple,small,stem,style,surface,tree,tree-like,trichome,vein,white,yellow	.2,.5,/2,0.5-1.5,1-2,1.5-2.5,3.5-8,7-20,anthesi,bark,branched,brownish-re,central,closely,collection,conical,deflexed,dense,difoliate,dimaeter,discussion,due,eaf,edicel,eed,erect,exserted,fleshy,free,fruiting,geminat,golden,heteromorphic,inflorescenc,lamina,lobed,lon,lower,middle,nearly,nflorescence,northern,older,overlappin,papillo,peru,peruvian,perÃº,petal,petaloid,planar,population,pore,poricidal,portion,probably,pubescence,ruit,scar,scattered,see,shaped,somewhat,spaced,sparsely,stigma,tall,tear-drop,tip,tube,ud,unifoliate,unit,way,wide,widest,woody,x,ympodial,young	0.2,2.5,adaxial,arrangement,branching,brownish-red,characteristic,colour,diameter,form,fruit,growth,height,history,length,life,midvein,null,papillose,peduncle,plant,primary,pseudostipule,rachi,seed,shape,staman,tertiary,texture,true,unarmed,venation
348	wfo-0001030000	success	155	128	92	63	36	0.594	-4,-50,-7,-pilose,0.5-,0.5-1,0.5-14,0.5-3,1,1-,1-10,1-2,1.5-,1.5-2,15-25,2-2.5,2-3,2-5,2.5-,2.5-3,2.5-3.5,25-30,3-,3-16,3-4,3.5-5,4-4.5,4-5,adaxially,also,apart,apex,apiculate,articulated,axe,base,calyx,cm,conspicuous,deltate,densely,dia,diameter,dilated,distally,eglandular,flattened,flower,fruit,glabrous,green,hair,immature,leaving,lobe,long,margin,mature,mm,moderately,occasionally,orange,pedicel,pedicellar,peduncle,perfect,pilose,puberulent,pubescent,purplish,rachi,radiu,remnant,scar,shrub,small,spaced,sparsely,spotted,strongly,style,subcoriaceous,tinge,tip,tree,umbrella-shaped,unbranched,unit,white,x,yellow,yellow-brown	-5,10-,10-20,2-4,30-50,4,4-foliat,7-15,abaxially,absent,acute,aggregate,ape,biglandula,cell,chartaceous,ciliat,connective,connivent,coriaceous,creamy-whit,cucullate,directed,eed,ellipsoidal,equal,exceeding,globose,laterally,lon,lower,narrowly,nflorescence,nther,oblong,obtuse,orolla,ovoid,pore,produced,pubescen,rarely,ruit,shorter,slightly,smal,stamen,stellate,stigma,stone,swelling,tal,tem,thecae,tomentose,triangular,truncate,tube,ud,vary,wide,yellowish,ympodial	4-foliate,abaxial,adaxial,anther,arrangement,branching,characteristic,colour,corolla,filament,form,growth,height,history,inflorescence,leaf,length,life,midvein,null,ovary,petiole,plant,primary,pseudostipule,seed,shape,staman,stem,surface,sympodial,tertiary,texture,unarmed,vein,venation
349	wfo-0001030000	success	178	142	107	71	35	0.601	-4,-50,-7,-pilose,0.5-,0.5-1,0.5-13,0.5-14,0.5-3,1,1-,1-10,1-2,1-5,1.5-2,10-,15-25,2-2.5,2-5,2.5-,2.5-3,25-30,3-,3-4,3.5-5,30-50,4-4.5,4-5,abaxially,acuminate,acute,adaxially,aggregate,also,apart,apex,apiculate,articulated,axe,basal,base,calyx,cell,cm,conspicuous,cordate,deltate,densely,dia,diameter,eglandular,ellipsoidal,elliptic,entire,flattened,flower,fruit,glabrescent,glabrous,globose,green,hair,immature,leaving,lobe,long,margin,mature,mm,moderately,oblique,obtuse,occasionally,often,orange,ovate,pedicel,pedicellar,peduncle,perfect,petiole,pilose,puberulent,pubescent,purplish,rachi,radiu,remnant,scar,shrub,small,spaced,sparsely,spotted,stone,style,subcoriaceous,tinge,tip,tree,unbranched,unit,vein,white,x,yellow,yellow-brown	-2,-5,1-1.5,1.5-,10-20,2-,2-3,2-4,2.5-3.5,3-16,4,4-25,4-foliat,5-25,7-15,absent,ape,biglandula,blade,chartaceous,ciliat,connective,connivent,coriaceous,creamy-whit,cucullate,dilated,directed,distally,eaf,eed,equal,exceeding,laterally,lon,lower,narrowly,nflorescence,nther,oblong,orolla,ovoid,pilo,pore,produced,pubescen,rarely,ruit,shorter,simple,slightly,smal,stamen,stellate,stigma,strongly,swelling,tal,tem,thecae,time,tomentose,triangular,truncate,tube,ud,umbrella-shaped,vary,wide,yellowish,ympodial	4-foliate,abaxial,adaxial,anther,arrangement,branching,characteristic,colour,corolla,filament,form,growth,height,history,inflorescence,leaf,length,life,midvein,null,ovary,plant,primary,pseudostipule,seed,shape,staman,stem,surface,sympodial,tertiary,texture,true,unarmed,venation
350	wfo-0001030004	success	177	120	94	83	26	0.531	0-0.5,0-1.5,0.2-1,0.3-1,1.2-2,1.5-2.5,15,15-20,2-20,20-200-flowered,3-4,3.5-5,5-25,abaxial,abaxially,across,acuminate,acute,adaxially,always,anther,apex,axillary,basal,base,berry,branched,branching,broadly,calyx,cm,corolla,crotaloid,deltate,dendritic,densely,drying,elliptic,filament,flattened-reniform,glabrous,globose,green,hard,incrassate,inflorescence,knob,later,lateral,leaf,like,lobe,long,main,many,margin,minutely,mm,much,obovate,occasionally,onto,ovary,pair,pale,pedicel,pericarp,petiole,pitted,plant,portion,prominent,pubescence,pubescent,seed,sessile,shrub,small,sparsely,stem,style,surface,tan,terminal,time,translucent,tree,trichome,vein,white,winged,woody,yellowish,yellowish-green	.3,0.8-1.1,1-1.5,1-2,3-3.5,4-15,9-30,along,anthesi,apar,appearanc,barely,bark,blade,body,bushy,capitate,collection,cone,conical,decurrent,dense,denser,dia,diamete,distal,eaf,edicel,eed,erect,especially,exserted,flat,fleshy,free,fruiting,giving,greenish-yello,juvenile,lamina,large,lobed,loose,lower,middle,nearly,nflorescence,obovoid,often,older,papillate,papillo,planar,plurifoliate,pore,poricidal,possessing,rest,ruit,scar,shaped,simple,spaced,stigma,stout,strongly,surpassing,tall,tear-drop,thick,thin,tip,tub,tube,tuft,ud,unevenly,variously,wide,widest,x,ympodia,young	adaxial,arrangement,characteristic,colour,diameter,form,fruit,greenish-yellow,growth,height,history,length,life,mentioned,midvein,peduncle,primary,pseudostipule,rachi,shape,staman,tertiary,texture,true,unarmed,venation
351	wfo-0001030007	success	168	167	135	33	32	0.804	.05,.4,.5,0.1-0.5,0.2-1,0.5-1,0.8-1,1-1.5,1-15,1-2,1.6-2.2,15-20,2-4,3-5,3/4,4.5-5,6-10-flowered,7-10,7-9,abrupt,acuminate,acute,along,anther,anthesi,apex,bark,base,beneath,berry,branched,broadly,brown,calyx,campanulate,clavate,cm,corolla,dark,decurrent,deltoid,densely,dia,difoliate,dry,elliptic,erect,filament,flattened,fleshy,free,fruiting,glabrate,glabrous,globose,golden,golden-pubescent,green,hooded,impressed,incrassate,lateral,leaf,like,live,lobe,lobed,long,longer,main,major,margin,material,middle,midrib,minor,minutely,mm,oblique,occasionally,older,one,onto,opposite,ovary,pair,pale,papillose,pedicel,petiole,pitted,planar,plant,pore,poricidal,portion,prominent,pubescent,reniform,shaped,short,shrub,simple,slender,slightly,small,soft,sparsely,specimen,stem,stigma,straight,style,surface,tapering,tear-drop,thick,tip,tree,trichome,trunk,tube,two,type,uniseriate,unit,vein,way,white,widening,widest,winged,woody,x,young	1.5-5,2-7,apart,ba,becoming,bud,closely,cork,edicel,eed,exserted,geminateleaf,gre,inflorescenc,lon,lower,nflorescence,obovoid,outline,papillo,raised,rest,rounded,ruit,scar,shorter,soon,spaced,tall,thickened,tub,ud,ympodial	abaxial,adaxial,arrangement,branching,characteristic,colour,diameter,form,fruit,geminate,grey,growth,height,history,inflorescence,length,life,mentioned,midvein,null,peduncle,primary,pseudostipule,rachi,seed,shape,staman,sympodial,tertiary,texture,unarmed,venation
352	wfo-0001030010	success	156	136	104	52	32	0.667	0.5-5,0.7-1,0.9-1.1,1-1.3,1-1.5,1-2,1.5-2,10-50-flowered,11-12,2-2.2,2-7,2.5,4-4.5,5-7,acuminate,acute,anther,anthesi,apex,area,attenuate,bark,base,beneath,berry,brown,calyx,closely,cm,corolla,dark,deciduous,decurrent,deflexed,deltate,difoliate,distal,dry,filament,fleshy,fruit,furcate,glabrate,glabrous,globose,green,grey,lateral,leaf,lobe,long,main,major,margin,material,middle,midrib,minor,minute,minutely,mm,near,nearly,obovate,occasionally,often,older,opposite,orange,ovary,ovoid-reniform,pair,papillose,pedicel,petiole,pitted,prominent,puberulent,rather,reddish,scar,shrub,simple,slightly,small,smooth,soon,spaced,stem,style,surface,tiny,tip,tree,trichome,trunk,uniseriate,unit,vein,white,widest,winged,x,young	.5,.75,/4,1.2-1.5,10-15,20-40,3-5,7-10,appearing,basal,bud,cyathiform,dia,differing,eaf,edicel,eed,ellipsoid,exserted,f,free,fruiting,geminat,hooded,lobed,lon,lower,m.,materia,nflorescence,one,overlappin,persistent,planar,pore,poricidal,portion,ruit,shaped,shin,size,stigma,straight,styl,tall,tapering,tear-drop,tube,ud,way,woody,ympodial	abaxial,adaxial,arrangement,branching,characteristic,colour,diameter,form,geminate,growth,height,history,inflorescence,length,life,midvein,null,overlapping,peduncle,plant,primary,pseudostipule,rachi,seed,shape,shiny,staman,sympodial,tertiary,texture,unarmed,venation
353	wfo-0001030023	success	171	159	123	48	36	0.719	-,0-100+,0.5-1,1,1-,1-8,1.5-2,1.5-7,10-,10-25,11-40+,2,2-3,2.5-3.5,20-30,3-4.5,3-5,30-50+,4,4-10,4-12,5,5-,5-16,5-6,6-26,6-7,7-9,abaxially,acute,adaxially,aggregate,apart,apex,apiculate,articulated,axe,basal,base,beyond,blade,branched,calyx,cell,cm,color,cordate,cuneate,cylindrical,deeply,densely,denser,diameter,dilated,distally,ellipsoidal,elliptic,entire,especially,except,exserted,finely,flattened,fleshy,flower,forked,fruit,glabrous,glandular-puberulent,globose,greenish-white,highly,leaving,lobe,long,main,margin,mm,moderately,near,oblique,obtuse,occasionally,often,ovate,pedicel,pedicellar,peduncle,perfect,petiole,present,probably,puberulent,pubescence,pubescent,purplish-,rachi,radiu,remnant,ripe,short-acuminate,simple,small,somewhat,spaced,sparsely,stamen,stone,style,subcoriaceous,time,tip,tree,truncate,unbranched,unit,unknown,usually,vein,wide,x,yellowish,young	1-2,12-18,13-20,4-foliat,ape,capitat,ciliate,connective,connivent,directed,eaf,eed,exceeding,glandular-puberulen,hair,lanceolate,lon,loosely,lower,membranaceous,narrow,narrowly,nflorescence,nther,oblong,orolla,peltiform,pore,presen,prominent,pubescen,pubescent-pilo,ruit,shorter,slightly,stellate,stigma,swelling,tal,tem,thecae,triangular,tube,ud,unknow,vary,villous,ympodial	4-foliate,abaxial,adaxial,anther,arrangement,branching,characteristic,colour,corolla,filament,form,growth,height,history,inflorescence,leaf,length,life,midvein,null,ovary,plant,primary,pseudostipule,pubescent-pilose,seed,shape,staman,stem,surface,sympodial,tertiary,texture,true,unarmed,venation
354	wfo-0001030032	success	250	160	139	111	21	0.556	+,0.2-0.5,0.25-0.4,0.5,0.5-0.6,0.5-1.5,0.7-0.8,0.8-1.0,1-1.3,1-1.5,1-2-celled,1.5-2,2-3-locular,2-4,2-5,2-60,2.4-3.5,3-5,3.0-3.5,3.5-12,4-5,4.3-5.0,5-plurifoliate,60-80,8-10,8-10-celled,abaxially,acuminate,acute,adaxial,adaxially,anther,apex,appearance,articulated,articulation,basal,basally,base,basiscopically,border,branched,bright,brown,calyx,cell,cm,completely,conical,corolla,decurrent,deltate,densely,diameter,ebracteate,elliptic,entire,filament,flower,fruit,give,glabrous,golden,green,greenish-brown,hair-like,imparipinnate,interrupted,irregularly,large,lateral,leaf,leaflet,length,like,lobe,long,many,margin,markedly,middle,midvein,mm,moderately,much,oblanceolate,oblique,obovate,often,orbicular,outgrowth,ovary,pair,pale,paler,patent,pedicel,peduncle,petiole,primary,pseudostipule,pubescent,rachi,rest,round,seed,silky,simple,smaller,soft,sparsely,splitting,stem,style,surface,swollen,tangled,tertiary,testa,thick,time,transparent,trichome,truncate,tube,unicellular,uniseriate,unit,vein,venation,vine,wall,weaker-walled,white,wide,winged,woody,yellow,Â½-3/4	.05,.5,0.1-0.4,0.1-0.5,0.2,0.2-0.3,0.4-1.5,0.5-0.7,0.5-1,0.5-2,0.6-1.1,0.8-1.1,1-3,1-celled,1.5-2.5,11-20,13-35,2,2-10,2-3.5,2-lobed,3,30,4-6-celled,4-celled,6-11,7-16,7.5-10,8-20,absent,abundant,along,also,anthesi,apical,appendage,bent,branche,breaking,capitate,clambering,column,conspicuou,dark,densest,desne,dry,eaf,edicel,eed,exserted,free,fruiting,glandular,gree,halfway,hea,head,herbarium,interjected,internode,lamina,larger,leave,longest,lower,mixed,multicellular,nflorescence,node,occasionally,older,onto,opposite,petiolule,pithy,present,pubescence,reflexed,rotate,rotate-stellate,rough,ruit,secondary,set,shorter,slightly,sometimes,somewhat,sparser,specimen,spreading,stamen,staminal,sterile,stigma,straight,subopposite,tall,tem,terminal,thickened,tiny,tip,touch,ud,usually,vegetatio,well-developed,ympodial,younger	abaxial,arrangement,branching,characteristic,colour,conspicuous,dense,form,growth,height,history,inflorescence,life,mentioned,plant,shape,staman,sympodial,texture,true,unarmed
355	wfo-0001030048	success	156	112	83	73	29	0.532	.5,0.5-1.5,1-1.5,1-2,1.2-2,1.3-1.6,10-16,2-3,2-5,3-5,4-4.5,5-10-flowered,5-8,abaxial,acute,adaxially,anther,apex,apically,arachnoid,base,berry,blue,broadly,brown,calyx,cm,completely,corolla,covered,decurrent,deltate,densely,drying,elliptic,filament,glabrate,glabrous,globose,golden,green,greyish,internodal,lamina,lateral,leaf,lightly,lobe,long,main,margin,matted,middle,minutely,mm,onto,opposite,ovary,ovoid-reniform,pair,pale,pedicel,petiole,pitted,pointed,pubescent,reddish-brown,shiny,shrub,simple,small,somewhat,sparsely,stem,style,surface,tan,thickened,tree,trichome,vein,white,widest	1.5-3.5,1.5-7,3-3.5,4-15,5973,abaxially,along,anthesi,ape,apparently,bark,becoming,bi-colored,bi-lobed,clavate,closely,conical,deflexed,dia,difoliate,eaf,edicel,eed,ellipsoid,exserted,felt-like,fide,fleshy,four-angle,free,fruiting,geminat,impressed,inflorescenc,like,lobed,lon,lower,nearly,nflorescence,occasionally,older,overlappin,papillo,papillose,planar,pore,poricidal,portion,prominent,rather,rest,ruit,scar,shaped,solomon,spaced,stigma,strongly,tall,tear-drop,thick,tip,trifoliate,tub,tube,ud,unit,wide,woody,yellowish,ympodial,young	adaxial,arrangement,branching,characteristic,colour,diameter,form,four-angled,fruit,growth,height,history,inflorescence,length,life,mentioned,midvein,peduncle,plant,primary,pseudostipule,rachi,seed,shape,staman,tertiary,texture,unarmed,venation
356	wfo-0001030053	success	141	149	117	24	32	0.83	0.5,0.5-1,1-1.3,1-13,1.3-3.5,1.5-5.5,1.8-2,10-20,100,2-2.5,2.5-3,3.5-4,4-,5,7-11,7-9,<,abruptly,abscission,acuminate,acute,aiding,anthesi,apart,apex,apiculae,ark,around,articulated,base,berry,branch,branched,brown,calyx,cell,cm,completely,corolla,cyathiform,decurrent,diameter,elliptic,entire,fide,filiform,fine,flattened,flower,fragrant,fruiting,glabrous,greenish,growth,hyaline,inflorescence,irregularly,leaving,lobe,lobed,long,many,margin,mentz,minutely,mm,near,new,older,pair,pale,papillo,parallel,pedicel,peduncle,peg,pendant,per,petiole,pitted,primary,rectangular,reniform,revolute,rim,scar,secondary,shallowly,shining,shiny,simple,sleeve,slightly,small,spaced,spreading,stem,strongly,support,surface,terminal,testal,time,tiny,tip,truncate,tube,twining,unit,usually,vein,venation,vine,white,woody,x,yellowish	5-merou,alyx,apical,bfeore,climbin,coriaceous,eaf,eed,exserted,far,frui,lower,nflorescence,nipple,orolla,papilla,perfect,plurifoliat,shin,spreadin,tem,turbinate,ud,ympodial	abaxial,adaxial,anther,arrangement,branching,characteristic,climbing,colour,filament,form,fruit,height,history,leaf,length,life,midvein,null,ovary,papillae,plant,plurifoliate,pseudostipule,rachi,seed,shape,staman,style,sympodial,tertiary,texture,unarmed
357	wfo-0001030057	success	141	105	69	72	36	0.489	-2,2-3-celled,2-4,2-4.5,20-30,20-80,8,abaxially,absent,acuminate,acute,adaxially,apex,base,berry,broadly,brownish,cell,cm,condition,cordate,covering,cuneate,diameter,distal,drying,elliptic,extremely,fresh,fruit,globose,green,greenish,hair,herb,lateral,leaf,leaflet,like,long,lunate,make,mm,mottled,mucilaginous,odd-pinnate,ovate,ovoid,pedicel,peduncle,petiole,plant,pubescent,purple,scale-like,seed,short,small,sometimes,stem,subglabrous,suborbicular,terminal,testal,thick,truncate,wall,wet,whitish	1-10,1-2,2-6,2.1-4.1,3-5,3.5-8,4-10,4.3-8.2,5.5-12,7-14,8-19,apart,apparently,articulated,axe,axillary,blade,borne,bud,chartaceous,decreasing,digestion,eaf,eed,end,enzyme,erec,flower,forked,geminat,generally,glabrou,greatly,green-white,hair-like,half,high,honeycomb-shaped,interjected,larger,living,membranous,narrow,nflorescence,pair,perfect,petiolule,plurifoliate,removed,ruit,seudostipule,singly,size,spaced,specimen,ste,stolo,subtending,tall,tem,thir,throughout,toward,tri-,tuber,typically,unit,unwinged,usually,wing,x,ympodial	'hair-like,abaxial,adaxial,anther,arrangement,branching,calyx,characteristic,colour,corolla,filament,form,growth,height,history,inflorescence,length,life,lobe,margin,mentioned,midvein,ovary,primary,pseudostipule,rachi,shape,staman,style,surface,tertiary,texture,true,unarmed,vein,venation
358	wfo-0001030057	success	197	132	102	95	30	0.518	-10,-2,.5-3.5,1-10,2-3,2-3-celled,2-4,2-4.5,20-30,20-80,5-10,5-6,8,abaxially,absent,acuminate,acute,adaxially,anther,apart,apex,articulated,base,berry,broadly,brownish,cell,cm,condition,cordate,corolla,covering,cuneate,diameter,digestion,distal,drying,elliptic,enzyme,exceeding,extremely,filament,fresh,fruit,glabrous,globose,green,green-white,greenish,greenish-yellow,hair,hair-like,herb,high,honeycomb-shaped,lateral,leaf,like,linear,lobe,long,lunate,make,margin,middle,mm,mottled,mucilaginous,odd-pinnate,ovate,ovate-lanceolate,ovoid,pedicel,peduncle,petal,petiole,plant,pubescent,purple,removed,scale-like,seed,short,small,sometimes,spaced,stamen,star,stem,straight,striped,style,subglabrous,suborbicular,testal,thick,throughout,truncate,wall,wet,white,whitish	1-2,2-5,2-6,2.1-4.1,3-5,3.5-8,4-10,4.3-8.2,5-merou,5.5-12,7-14,8-19,acumen,ag,along,alyx,apparently,axe,axillary,blade,borne,bud,chartaceous,ciliate,connivent,decreasing,dorsally,eaf,edge,eed,end,erec,especially,flat,flower,folded,forked,geminat,generally,glabrou,globo,greatly,half,homostylous,interjected,lanceolate,larger,leaflet,lengthening,living,lower,membranous,midrib,minutely,narrow,nflorescence,orolla,pair,pentagonal,perfect,petiolule,plurifoliate,pore,poricidal,puberulent,rotate,ruit,seudostipule,singly,size,slit,specimen,ste,stigma,stolo,subtending,tall,tamen,tem,terminal,thir,tip,toward,tri-,tube,tuber,typically,unit,unwinged,usually,vary,wing,x,yellow,ympodial	abaxial,adaxial,arrangement,branching,calyx,characteristic,colour,form,growth,height,history,inflorescence,length,life,midvein,null,ovary,primary,pseudostipule,rachi,shape,staman,surface,tertiary,texture,third,true,unarmed,vein,venation
359	wfo-0001030080	success	186	114	84	102	30	0.452	0.3-7,0.4-1.5,0.5-4,1-2,1.5-2,1.5-2.5,2-3,2.1-7.1,3-10,3-5,4-12,4-7,5-7,8-23,acuminate,anther,apart,apex,articulated,base,berry,brownish,cell,cm,condition,coriaceous,corolla,covering,cuneate,dark,decurrent,diameter,distal,dot,drying,elliptic,exceeding,filament,fresh,fruit,glabrescent,glabrous,green,greenish,hair,half,herb,high,lanceolate,lateral,leaf,light,lobe,long,make,medium,mm,mottled,mucilaginous,odd-pinnate,onto,ovate,ovoid,pedicel,peduncle,petiole,plant,purple,pyriform,rachi,seed,sometimes,spaced,stamen,straight,style,testal,thick,throughout,tiny,wall,wet,white,whitish	1-3,1.8-4.5,1999,2-4,3.3-7.7,5-13.5,5-merou,5.5-9.9,6.5-18.6,8-16,9.9-33,abaxiall,abaxially,absent,acumen,adaxially,ag,along,alyx,apparently,arranged,axe,axillary,bead,blade,bud,capitat,ccording,clavate,connivent,decreasing,digestion,dorsally,eaf,edge,eed,enzyme,erec,flat,flower,folded,forked,geminat,generally,glabrou,green-white,hair-like,hal,homostylous,honeycomb-shaped,inconspicuous,interjected,larger,leaflet,lengthening,like,linear,living,lower,moniliform,multiple,necklace,nflorescence,ochoa,orolla,pair,perfect,plurifoliate,pore,poricidal,removed,second,seudostipule,size,slightly,slit,specimen,stellate,stigma,stolon,strongly,subequal,subtending,tall,tamen,tem,terminal,tip,toward,tri-,tube,tuber,typically,unit,unknown,usually,vary,width,winged,x,yellow,ympodial	'hair-like,abaxial,adaxial,arrangement,branching,calyx,characteristic,colour,form,growth,height,history,inflorescence,length,life,margin,midvein,null,ovary,primary,pseudostipule,shape,staman,stem,surface,tertiary,texture,unarmed,vein,venation
360	wfo-0001030081	success	157	153	121	36	32	0.771	.5,0.25-0.5,0.5-1,0.5-1.5,0.5-2.5,1,1-2-celled,1-4,1-5,1.5,1.5-3,10-20,10-35,1st,2-7,2-foliate,2nd,3-10,4-6,5-12,5-15,abaxially,absent,acute,adaxially,along,anther,apex,apically,axe,base,berry,beyond,blade,brown,calyx,cell,center,ciliate,cm,connected,decurrent,dehiscing,densely,denser,diameter,dm,drying,edge,elliptic,elliptic-ovoid,entire,equal,explosively,exserted,few-branched,filament,fine,flat,flower,fruit,geniculate,glabrous,globose,hair,held,herb,immature,linear-lanceolate,lobe,long,longer,lying,margin,maturing,mesocarp,mm,moderately,nearly,notch,obtuse,often,one,other,parallel,pedicel,peduncle,per,petiole,placenta,pointing,pressure,pubescent,rachi,radiating,raised,rarely,ridge,rounded,running,semitransparent,shallow,single-,slightly,small,sometimes,sparsely,stamen,straight,style,surface,swollen,two-celled,unbranched,usually,vein,watery,white,woody,x,yellow	1-2,1-3,1.5-7,2-4,3-6,abundant,adaxiall,chartaceous,cordate,eaf,eed,emarginat,frui,geminat,interpetalar,lower,maturit,membranaceous,nfloresence,oblong,orolla,pubescen,rotate,ruit,short,stigma,tal,tamen,tem,tissue,triangular,tube,unit,vary,wid,ympodial	abaxial,adaxial,arrangement,branching,characteristic,colour,corolla,form,geminate,growth,height,history,inflorescence,leaf,length,life,maturity,midvein,null,ovary,plant,primary,pseudostipule,seed,shape,staman,stem,tertiary,texture,true,unarmed,venation
361	wfo-0001030083	success	146	153	121	25	32	0.829	.5,.75,0.1,0.25-0.5,0.5-1,0.5-2,0.8-1,0.8-3,1-1.5,1-2,1.5-3,2,2-3,2-5-flowered,3-4,3/4,4-6,9-11,accrescent,acute,anther,anthesi,apex,bark,base,beginning,berry,broadly,calyx,closely,cm,corolla,cup-shaped,deciduous,decurrent,deeply,deflexed,deltoid,dia,dry,drying,elliptic,elongate,flower,fruit,fruiting,glabrous,globose,green,greenish-white,hyaline,internodal,lateral,leaf,lobe,lobed,long,long-acuminate,long-styled,main,minutely,mm,narrowly,near,older,onto,opposite,ovary,ovate,overlapping,ovoid-reniform,pair,pale,paler,papillae,papillose,pedicel,petiole,pitted,pore,poricidal,prominent,raised,red-papillose,reddish-gold,reflexed,scar,shallowly,shaped,short-styled,shrub,simple,single-stemmed,slender,slightly,small-capitate,somewhat,soon,spaced,specimen,stem,straight,strongly,style,surface,tall,tan,tapering,tear-drop,terminal,thickened,tip,translucent,tube,vein,way,white,winged,woody,x,young	10-30,4-15,dar,eaf,edicel,eed,exserted,fleshy,greyish-re,inflorescenc,lon,lower,membranous,middle,nflorescence,proximal,ruit,stigma,thin,tub,ud,unifoliat,unit,widest,ympodial	abaxial,adaxial,arrangement,branching,characteristic,colour,dark,diameter,filament,form,greyish-red,growth,height,history,inflorescence,length,life,margin,mentioned,midvein,peduncle,plant,primary,pseudostipule,rachi,seed,shape,staman,tertiary,texture,unarmed,venation
362	wfo-0001030093	success	181	133	101	80	32	0.558	.2,0.1-0.3,0.2-0.5,0.2-1,0.5-1.1,1-1.5,1-12,1-5,2-2.5,3-4,4-6,5-50-flowered,5-8,7-9,8-9,acuminate,acute,anther,apex,attenuate,base,beneath,berry,branched,brownish-tan,calyx,cm,corolla,cuneate,deltoid,densely,dia,difoliate,elliptic,erect,especially,filament,flower,free,furcate,glabrous,globose,golden,green,greenish-white,growth,hirsutulous,impressed,lateral,leaf,lobe,long,long-styled,main,major,many,margin,minor,minutely,mm,obovate,occasionally,often,opposite,ovary,ovoid-reniform,pair,pale,paler,pedicel,petiole,pitted,plant,population,portion,puberulent,pubescent,shiny,short-styled,shrub,simple,slender,slightly,small,southern,stem,straight,style,surface,tapering,terminal,time,tiny,tree,trichome,tube,uniseriate,vein,white,x,yellowish	.5,0,0.2,0.6-1.5,0.75-1,1.3-4.5,2.5-11,3.5-12,7-30,anthesi,apar,bark,becoming,campanulate,case,clavate,closely,collection,commonly,continues,deflexed,differing,eaf,edicel,eed,ellipsoid,evenly,except,expanded,exserted,forest,fruiting,geminat,greyish-brow,guyanese,hyaline,inundated,like,lobed,lon,lower,member,middle,narrowly,nearly,new,nflorescence,older,one,onto,open,orbicular,papillo,persisting,pore,poricidal,present,quite,reflexed,remaining,ruit,scar,shaped,shoot,size,soon,spaced,stigma,tall,tear-drop,thickened,tip,tub,ud,underside,unit,widest,woody,ympodial,young	1.5,abaxial,adaxial,arrangement,branching,characteristic,colour,diameter,form,fruit,geminate,greyish-brown,height,history,inflorescence,length,life,midvein,null,papillose,peduncle,primary,pseudostipule,rachi,seed,shape,staman,tertiary,texture,true,unarmed,venation
363	wfo-0001030145	success	153	132	96	57	36	0.627	-3,0.2-2,0.3-,0.5,0.5-1,1,1-1.5,1-2,1-2.5,1-3,1-5,1.5,1.5-2,1.5-4.5,10-12,2-3,2-4,2.5-6.5,3-10,3-4,3-5,6-40,8-11,abaxially,acute,adaxially,aggregate,also,apart,apex,articulated,axe,basal,base,beyond,calyx,cell,chartaceous,cm,color,compound,cuneate,cylindrical,deltate,densely,diameter,ellipsoidal,entire,exserted,flower,forked,fruit,glabrous,glandular,globose,hair,herb,leaf,leaving,less,lobe,long,margin,mm,moderately,narrowly,near,obtuse,pedicel,pedicellar,peduncle,petiole,pilose,puberulent,rachi,remnant,ripe,shrub,simple,sinuate,slender,slightly,spaced,sparsely,stamen,stone,style,subcordate,ternately,triangular,truncate,unbranched,unit,unknown,violet,x	-2,0.5-4,1.5-7,3,4-5,4-8,4-foliat,absent,adpressed,ape,blade,campanulate,connective,directed,distally,dunal,eaf,eed,elliptic,elliptic-ovate,exceeding,fide,fleshy,lanceolate,larger,lateral,leaflet,lon,lower,nflorescence,nther,orolla,ovate-elliptic,pore,presen,puberulen,radiu,reddish,ruit,shorter,somewhat,stigma,subcoriaceous,tal,tem,terminal,thecae,time,tomento,toward,truncat,tube,ud,vary,wide,yellow,ympodial	4-foliate,abaxial,adaxial,anther,arrangement,branching,characteristic,colour,corolla,filament,form,growth,height,history,inflorescence,length,life,midvein,null,ovary,plant,present,primary,pseudostipule,seed,shape,staman,stem,surface,sympodial,tertiary,texture,true,unarmed,vein,venation
364	wfo-0001030146	success	210	136	116	94	20	0.552	0.6â0.7,0.6â2,0.9â1,1.2â1.5,1.5â2,16â20,1â1.5,2.5â9,3â4,3â6,40â50,4â30,5â8,60+,9â9.5,abaxial,abaxially,acuminate,acute,adaxial,along,anther,anthesi,apex,appearing,articulated,axe,base,beneath,berry,branched,branching,brown,calyx,cell,cm,corolla,covered,dark,deeply,deltate,dense,densely,diameter,drying,echinoid,elliptic,elongate,entire,filament,flattened-reniform,flower,fresh,glabrous,globose,golden,green,growth,impressed,inflorescence,layer,leaf,length,like,lobe,lower,many,margin,minutely,mm,multangulate,narrowly,nodding,olive,pair,part,pedicel,peduncle,peltate,per,persistent,petiole,pitted,plant,plurifoliate,primary,pubescence,pubescent,ray,reddish,revolute,rhachi,ripe,scurfy,sessile,short-stalked,small,stem,stout,style,subtended,surface,tangled,terminal,testal,time,tree,treelet,trichome,undersurface,unevenly,upper,varying,vein,white,â18	.1,.2,.5,0.2â0.4,0.5,0.5â1,1â1.1,20,20â30,2â5,4â4.5,5-merou,6.5â16,6â7,8â15,>,absent,ag,almost,alyx,apar,ark,beig,bright,brownish,c.,capitate,center,closely,connivent,coriaceous,cup-shaped,dichasia,discolorous,eaf,edge,eed,ellipsoidal,erec,exserted,free,fruiting,fused,gradually,halfway,ilament,lamina,lengthening,less,lobed,long,loosely,midpoint,narrowing,new,nflorescence,older,orolla,pale,papillose,perfect,pericarp,pore,poricidal,portion,projection,reflexed,regularly,ruit,scar,shiny,simple,slit,spaced,sparsely,stellate,stigma,strongly,tall,tan,tem,thin,tiny,tip,tube,ud,unit,vary,visible,way,wide,woody,yellow,ympodial	arrangement,characteristic,colour,form,fruit,height,history,life,midvein,null,ovary,rachi,seed,shape,staman,tertiary,texture,true,unarmed,venation
365	wfo-0001030147	success	158	131	94	64	37	0.595	0.5-2,1-4,1-5,15-30,2,2-10,2-10.5,2-13,2-3,2-5,4-5.5,4.5-10,5-8,8-38,abaxially,acuminate,acute,adaxially,apex,articulate,attenuate,base,blue,branched,calyx,cell,cm,conical,corolla,covering,cuneate,cyme,deep,diameter,dichasial,dichasially,distal,ebracteate,elliptical,exceeding,filament,finely,flower,forked,generally,green,green-white,half,herbaceous,lateral,leaf,leaflet,lobe,long,long-attenuate,make,medium,mm,monochasial,mucilaginous,narrowly,oblique,obtuse,odd-pinnate,ovate,ovoid,pedicel,peduncle,perennial,perfect,petiole,petiolule,plant,proximal,pubescent,purple,rounded,seed,sessile,stamen,stigma,straight,style,subsessile,terminal,testal,thick,throughout,tip,tuber-bearing,typically,unit,wall,Â¼	-8,0-5,1.0-2.0,1.0-2.2,10-19,14-35,2.5-7.5,3-,3-6-foliat,4-3.,4.2-7.5,5-7,abaxiall,acumen,apical,apically,connate,dehiscent,digestion,diminishing,dorsally,eaf,edge,eed,emoval,enzyme,flat,folded,globo,gradually,hair-like,honeycomb,interjected,introrse,living,lon,lower,lunat,maturing,nflorescence,nther,often,orolla,pair,pattern,plan,poricidally,reveal,rotate,ruit,seudostipule,short,size,slit,specimen,subequal,tal,tem,throughou,toward,vary,wide,yellow,ympodial	'hair-like,3-6-foliate,abaxial,adaxial,anther,arrangement,branching,characteristic,colour,form,fruit,globose,growth,height,history,inflorescence,length,life,lunate,margin,mentioned,midvein,ovary,primary,pseudostipule,rachi,shape,staman,stem,surface,sympodial,tertiary,texture,unarmed,vein,venation,wet
366	wfo-0001030151	success	175	142	110	65	32	0.629	-50,0.2-0.5,0.5,0.5-1,1-1.5,1-17,1-3,1-5,1.5-2.5,10-25,15-35,2-11,2-3,2-6,2-7-compound,20-30,3-14,3-5,4-5,5-6,6-9,abaxially,abundantly,acuminate,acute,adaxial,adaxially,apart,apex,apiculate,articulated,axe,basal,base,blade,blotch,calyx,chartaceous,cm,cordate,cuneate,decurrent,deltate,diameter,eglandular,entire,except,flower,fruit,glabrate,glabrous,glandular,glandular-puberulent,globose,hair,leaf,leaving,less,lilac-tinged,line,lobe,long,longitudinal,margin,membranaceous,mm,near,oblique,oblong,obovate,obtuse,often,pedicel,pedicellar,peduncle,perfect,petiole,pinnately,probably,puberulent,pyriform,rachi,radiu,remnant,ripe,sand-punctate,scattered,shallowly,short,simple,slender,slightly,small,sometimes,spaced,sparsely,stripe,style,surface,tip,tree,truncate,unbranched,unit,vein,veiny,white,x,yellow,yellow-green	-3,0.3-0.5,1,1-2,1.5-2,10-20,2-25,3.5-32,4-foliat,?,absent,aggregate,ape,around,beyond,cell,channe,ciliat,compound,connate,connective,cylindrical,directed,distally,eaf,eed,elliptic,exceeding,exserted,lanceolate,leaflet,lon,lower,narrowly,nflorescence,nther,orolla,pore,presence,purplish,ring,ruit,sand-punctat,shorter,somewhat,stalked,stamen,stellate,stigma,stone,tal,tem,thecae,time,toward,triangular,truncat,tube,ud,unknow,vary,white-puberulent,whitish,wide,ympodial	4-foliate,abaxial,anther,arrangement,branching,channel,characteristic,colour,corolla,filament,form,growth,height,history,inflorescence,length,life,mentioned,midvein,ovary,plant,primary,pseudostipule,seed,shape,staman,stem,sympodial,tertiary,texture,unarmed,venation
367	wfo-0001030153	success	147	123	96	51	27	0.653	.1,.2,0.2-1,0.8-0.9,1-1.2,1-1.5,1-2,1-2.5,1.3-1.5,1.3-1.9,1.5-2,2-8,2.5-4,3-4,3-5,3-50,3.5-10.5,5-6,6-8,abaxially,acuminate,acute,adaxially,anther,anthesi,apex,apiculate,apparently,attenuate,axil,base,berry,branched,brittle,calyx,cm,conical,corolla,dark,deltate,diameter,distinct,domatia,dot,dry,elliptic,entire,erect,filament,flower,glabrous,globose,green,growth,impressed,internodal,known,lanceolate,less,lobe,margin,membranous,mm,narrowly,nodding,older,ovary,pair,paler,pedicel,peduncle,petiole,pit-like,primary,rachi,resinous,revolute,ripe,simple,slightly,small,specimen,stem,style,surface,terminal,thin,time,tree,treelet,unit,vein,white,x,yellowish,young	/3,0.8-1.3,1-10,2-lobed,absent,age,apart,ape,bark,broadly,caly,campanulate,clavate,densely,eaf,ellipsoid,enlarged,exerted,free,fruiting,glabrou,irregularly,lengthening,lobed,lower,markedly,minutely,new,nflorescence,occasionally,ot,papillat,papillate,perfect,plane,plurifoliat,pore,poricidal,portion,ruit,scar,slit,spaced,stigma,straight,strongly,tip,tube,ud,way,ympodial	abaxial,adaxial,arrangement,branching,characteristic,colour,form,fruit,height,history,inflorescence,leaf,length,life,midvein,plant,plurifoliate,provided,pseudostipule,seed,shape,staman,sympodial,tertiary,texture,unarmed,venation
368	wfo-0001030167	success	141	151	100	41	51	0.709	.8,.9,0.6,12,14â19,2â3,4.5â8,4â7,abaxially,accrescent,acuminate,acute,adaxially,along,anther,apex,apically,axe,base,berry,blade,branch,calyx,chartaceous,ciliate,clavate,climbing,cm,contiguously,densely,diameter,enlarged,entire,extra-axillary,fertile,filament,flattened,flower,fruit,fruiting,gap,glabrous,green,herbaceous,immature,lanceolate,less,lobe,long,margin,maturity,membranaceous,membranous,minutely,mm,moderately,near,nearly,obtuse,ovate,ovoid,pair,pedicel,peduncle,petal,petiole,pinnate,pointed,rachi,reflexed,rounded,sand-punctate,scar,secondary,seen,slender,slightly,somewhat,spaced,sparsely,stellate,stigma,style,subequal,symmetrical,thinly,time,tip,tube,unbranched,unit,unknown,vegetation,vein,venation,vine,weakly,white,wide,x	0.1â0.2,0.5â0.6,0.5â0.7,0.6â0.8,0.7â1.2,0.8â1,1.2â2.5,1.5â2,1.5â7,15â20,17â58,1â1.2,1â1.5,2â4.5,4â10,4â4.5,4â5,5-merous,8â10,alyx,apar,c.,ciliat,eaf,eed,glabrou,lower,m.,nflorescence,nternode,orolla,penden,perfec,plurifoliat,ruit,simple,tamen,tem,truncat,vary,ympodial	0.1-0.2,0.5-0.6,0.5-0.7,0.6-0.8,0.7-1.2,0.8-1,1-1.2,1-1.5,1.2-2.5,1.5-2,15-20,17-58,2-4.5,4-10,4-4.5,4-5,8-10,abaxial,adaxial,apart,arrangement,branching,characteristic,colour,corolla,form,growth,height,history,inflorescence,leaf,length,life,midvein,null,ovary,pendent,plant,plurifoliate,primary,pseudostipule,seed,shape,staman,stem,surface,sympodial,tertiary,texture,truncate,unarmed
369	wfo-0001030176	success	171	147	115	56	32	0.673	-6.25,.2,.7,.75-1.5,0.4-1.5,0.5,0.5-2,0.6-0.9,0.7-1.4,0.7â0.8,1,1-5,1.2,1.2-2.5,1.5-2,1.6,1/3,1/6,2-3,2-foliate,2.25-3.25,3-5,3-lobed,3.75-5,4-9,6-8,6â8,abaxially,acute,adaxially,angulate,anther,apart,apex,apparently,articulated,attenuate,axe,base,bi-lobed,bilobed,blade,branch,broadly,calyx,ciliate,cm,contact,cylindrical,decumbent,depressed-globose,diameter,downward,especially,extra-axillary,few-branched,filament,flattened-reniform,flower,forming,fruit,glabrous,hair,herb,hold,lanceolate-oblong,lateral,light,line,lobe,long,lower,major,margin,mesocarp,midrib,mm,near,nearly,node,numerous,often,ovate,pale,patch,pedicel,peduncle,perfect,petiole,plant,prostrate,pubescent,rachi,rarely,recurved,ripe,rooting,round,simple,slightly,soil,sometimes,spaced,sparsely,style,tube,unbranched,vein,violet,white,winged,x,yellow,yellow-orange,young	-1.4,-4.25,1-2,1.5-2.5,2.5,2.5â7.5,2.5â9,2â3,5-merou,accrescent,adaxiall,alyx,asymmetrically,ba,basal,berry,broad,capitat,chartaceous,connivent,covering,dehiscent,eaf,eed,erec,fruiting,geminat,hermaphroditic,interlobal,juic,lance-ovate,lon,longitudinall,minutely,nflorescence,oblong,orolla,partially,pore,recurve,rotate-stellate,ruit,sinus,somewhat,stigma,tamen,tem,terminal,time,tip,triangular,unit,vary,white-puberulent,wide,ympodial	abaxial,adaxial,arrangement,branching,characteristic,colour,corolla,erect,form,growth,height,history,inflorescence,juicy,leaf,length,life,midvein,null,ovary,primary,pseudostipule,seed,shape,staman,stem,surface,tertiary,texture,true,unarmed,venation
370	wfo-0001030180	success	135	115	85	50	30	0.63	.5,.75,0.05-1,0.5-1,0.8-2,1-1.5,1.1-1.2,10-30-flowered,3-8,4.5-5,6,8-10,?,abruptly,anther,apex,apiculate,appearing,attenuate,base,becoming,berry,calyx,cm,corolla,decurrent,deltoid,dia,erect,filament,free,fruit,furcate,glabrate,glabrous,globose,green,height,immature,known,lateral,leaf,linear,lobe,long,long-acuminate,main,middle,minutely,mm,narrowing,occasionally,opposite,ovary,pair,papillate,papillose,pedicel,petiole,portion,prominent,proximal,puberulent,rounded,shrub,slender,slightly,soon,sparsely,stem,style,surface,terminal,tip,trichome,tube,uniseriate,unknown,vein,white,widely,widest,winged,x,yellowish	.1,0.9-1.8,3-4,8.5-23,accrescent,anthesi,apart,bark,clavate,clu,dark,deflexe,eaf,edicel,eed,ellipsoid,exserted,fruiting,inflorescenc,interpetalar,lenticellat,lobed,lon,lower,minute,nearly,nflorescence,older,overlapping,peduncl,planar,plurifoliat,pore,poricidal,raised,ruit,scar,shaped,sinus,spaced,stigma,straight,tear-drop,thin,ud,unevenly,unit,woody,ympodial,young	abaxial,adaxial,arrangement,branching,characteristic,colour,deflexed,diameter,form,growth,history,inflorescence,length,life,margin,midvein,null,peduncle,plant,plurifoliate,primary,pseudostipule,rachi,seed,shape,staman,tertiary,texture,unarmed,venation
371	wfo-0001030189	success	188	128	101	87	27	0.537	-1/2,0-1,0-30,0.5-1.6,0.9-1.1,1,1-1.5,1-2,1.3-4.2,1/3,1/6-1/3,2-3,2-5.5,2.5-4,3-4,3.2-4.5,4-5.5,5-10,5-6,6-12,anther,apex,apically,apparently,articulated,base,berry,blade,branched,calyx,cm,cordate,curved,densely,diameter,dull,elliptic,entire,erect,evenly,faint,filament,flattened-reniform,flower,foliaceous,fruit,glabrescent,glabrous,green,infructescence,lateral,leaf,length,lobe,long,lower,margin,maturity,mauve,mm,moderately,oblong,obtuse,one,open,orange,ovate,pair,pedicel,peduncle,per,pericarp,petiole,primary,purple,red,rounded,scandent,shrub,slender,smooth,sometimes,sparsely,spherical,stellate-pubescent,stem,style,surface,terete,terminal,tertiary,time,unarmed,upper,vein,venation,visible,wide,yellow,yellow-green,young	-4,.2,/3,0-15,0.1,0.1-0.2,0.2-0.3,0.2-0.5,1-3-cellular,1-4-cellula,1-4-cellular,1.1-2.7,1.5-2,1.5-4.5,1.5-5,1/,2,4-13,5-,5-merous,6-10,8,8-10,8-18,abaxially,acut,alyx,apar,appressed,bark,chartaceous,concolorous,connivent,deltate,drying,eaf,eed,elongating,equal,free,frui,fruiting,glabrescen,gland-tipped,gray,lobed,longer,mature,midpoint,nflorescence,often,older,orolla,oung,perfec,plurifoliat,poricidal,porrect,portion,ray,recurved,red-brow,reflexed,ruit,scar,sessile,shorter,simple,somewhat,spaced,spreading,stalk,stalked,stellate,strongly,tamen,tapering,tip,trichome,tube,unarme,unit,variously,vary,way,woody,ympodial	1/4,abaxial,acute,adaxial,arrangement,branching,characteristic,colour,corolla,form,growth,height,history,inflorescence,life,midvein,null,ovary,plant,plurifoliate,pseudostipule,rachi,seed,shape,staman,texture,true
372	wfo-0001030219	success	191	175	108	83	67	0.565	0.5,1.5,10,3,5,60,abaxially,acute,adaxially,adnate,along,anisophyllous,anther,anthesi,apart,apex,apparently,appearing,arising,arranged,articulated,axe,base,black,blade,blue,branched,brown,calyx,cell,cm,cylindrical,decurrent,deeply,densely,diameter,difoliate,elliptic,equal,erect,filament,flattened,flower,fruit,glabrescent,glabrous,globose,green,hair,incised,indistinct,lanceolate,leaf,lilac,lobe,long,margin,marking,mm,moderately,multicellular,number,oblong,olive,opposed,oppositely,ovate,pair,pale,paler,pedicel,peduncle,perennial,perfect,petiole,pitted,present,procumbent,pubescent,purple,regularly,rounded,serrate,sessile,shallowly,shrub,side,simple,smaller,spaced,sparsely,stone,straight,strongly,style,surface,time,tube,two,unicellular,uniseriate,unit,velutinous,wide,wing,winged,woody,x	0.1â0.3,0.2â2.3,0.4â1.0,0.5â,0.7â1.1,0.8â3.0,0â,1.0â1.2,1.0â1.5,1.0â2.0,1.0â2.2,1.3â2.9,1.4â2.8,1.6â,15,1â2.5,2.0â2.5,2.0â3.2,2.0â5.5,2.4â6.0,2â,2â2.5,2â3,2â4.5,4.5â5.5,4.8â11.5,4â5,4â7,5â,5â8,6â,6â10,6â8,7â11,8â18,9â10,9â12,abaxiall,acut,adaxiall,ag,apical,ba,basal,bractâlike,chartaceous,clavat,concave,connivent,convex,decreasing,diamete,directed,distally,eaf,eed,geminat,internode,longitudinal,lower,nflorescence,opening,orolla,pentagonal,pore,rapidly,redâpurple,ruit,sid,size,split,stigma,stripe,tal,tamen,tem,vary,white,yellow,ympodial,â3.0,â7.0,â9.5	--,0,0.1,0.2,0.3,0.7,1.0,1.1,1.2,1.3,1.4,1.6,11.5,2,2.0,2.2,2.3,2.4,2.5,2.8,2.9,3.0,3.2,4,4.5,4.8,5.5,6,6.0,7,7.0,8,9,9.5,abaxial,adaxial,arrangement,bract-like,branching,characteristic,colour,corolla,form,geminate,growth,height,history,inflorescence,length,life,mentioned,midvein,ovary,plant,primary,pseudostipule,rachi,seed,shape,staman,stem,sympodial,tertiary,texture,unarmed,vein,venation
373	wfo-0001030225	success	155	127	93	62	34	0.6	-11,-30,-4,-45,-7,.5-2.5,0,0-5,1,1-4,1-6,1.5-2.5,10-15,10-30,2,2-2.5,2-6,3-11-compound,3-4,3-5,4-5,abaxially,acuminate,acute,adaxially,apart,apex,apically,articulated,axe,basal,base,beyond,calyx,cm,cordate,cuneate,cylindrical,deltate,densely,diameter,dilated,entire,exserted,fleshy,flower,forked,fruit,glabrate,glabrous,globose,immature,leaf,leaving,less,lobe,long,margin,mm,moderately,obtuse,one,pedicel,peduncle,perfect,petiole,pinnately,possibly,prominent,puberulent,purple,rachi,radiu,scar,seen,shallowly,shrub,simple,slightly,small,somewhat,spaced,sparsely,stamen,strongly,style,succulent,tip,tree,unbranched,unit,unknown,x	-1.5,.5,0-20,1.5,2-18,2-3,3-20,3-foliat,8-15,absent,ape,apical,ature,bilobed,blade,campanulate,color,compound,conivent,connective,coriaceous,directed,distally,eaf,eed,elliptic-ovate,equal,especially,exceeding,expanded,gland,laterally,leaflet,lower,minutely,narrowly,nflorescence,nther,oblong,orolla,papillose,pore,puberulen,see,stalked,stellate,stigma,tal,tem,thecae,time,tomento,toward,triangular,truncate,tube,two,ud,unknow,vary,wide,ympodial	3-foliate,abaxial,adaxial,anther,arrangement,branching,characteristic,colour,corolla,filament,form,growth,height,history,inflorescence,length,life,midvein,null,ovary,plant,primary,pseudostipule,seed,shape,staman,stem,surface,sympodial,tertiary,texture,unarmed,vein,venation
374	wfo-0001030250	success	169	126	97	72	29	0.574	.5,0-seeded,0.5-1,1-1.5,1-3,1.1-1.2,1.4-1.5,2-2.5,2.5-3.25,3-5,3.5-4,5-6,6-8,anther,apex,appearing,arching,attenuate,base,beneath,berry,brown,bullate,calyx,capitate,cm,corolla,cuneate,curved,dark,decurrent,dia,difoliate,dry,elliptic-ovate,filament,free,glabrous,globose,green,greenish-white,greenish-yellow,horizontally,inflorescence,lateral,leaf,lobe,long,long-acuminate,main,major,maturity,minor,minutely,mm,n,opposite,orbiculate,ovary,ovoid-reniform,pair,pale,paler,papillose,pedicel,petiole,pit,pitted,portion,projection,prominent,raised,rim,sea-green,seed,shallow,shape,shrub,simple,slender,slightly,smooth,specimen,spreading,stem,straight,style,surface,tall,tan,tapering,translucent,translucent-green,tube,vein,white-lenticellate,x	/4,1.1-3.5,1.25-1.5,1.7-7,1.9-2.6,11.2-22,11.3,2.1-6,25,3.4-6.6,4-7,5-50-flowered,across,anthesi,apart,bark,beginning,broadly,carinate-hooded,conical,consisting,cup-shaped,deflexed,differing,eaf,edicel,eed,elliptic,exerted,five,fresh,fruiting,geminat,glabrou,inflorescenc,irregularly,lobed,lon,lower,middle,nflorescence,node,occasionally,older,one,orbicular,papillo,pendulous,pore,poricidal,proximal,reflexed,ruit,scar,shaped,size,soon,spaced,stigma,tear-drop,tip,two,ud,unit,usually,way,white-lenticellat,wide,widest,winged,woody,ympodial	abaxial,adaxial,arrangement,branching,characteristic,colour,description,diameter,form,fruit,geminate,growth,height,history,length,life,margin,mentioned,midvein,peduncle,plant,primary,pseudostipule,rachi,staman,tertiary,texture,unarmed,venation
375	wfo-0001030271	exception_thrown	195	0	0	195	0	0.0		0-2,0.15-0.75,0.5-1.2,0.7-9.5,0.9-2.5,0.9-3.6,1-2,1-2.5,1-3,1-4,1-6,1-7,1.4-2.1,1.9-6.6,15-61,2-2.7,2-3,2-4,2-6,2.4-5.6,3-10,3-5,3.4-7.5,4-22,4-7,5-8,5-merou,5.6-12.3,6-15,abaxially,acumen,acute,adaxiall,adaxially,ag,along,alyx,anther,apart,apex,apparently,arranged,articulated,asymmetric,attenuate,axe,axillary,base,basiscopic,bead,berry,blade,blue,brownish,bud,capitat,cell,clavate,cm,coloration,completely,condition,connivent,considerably,coriaceous,corolla,covering,dark,decreasing,deep,diameter,digestion,distal,dorsally,drying,eaf,edge,eed,elliptic,enzyme,erect,exceeding,filament,flat,flower,folded,forked,fresh,fruit,geminat,generally,glabrou,glabrous,green,green-white,greenish,habi,hair-like,half,herb,homostylous,honeycomb-shaped,interjected,lanceolate,larger,lateral,leaf,leaflet,lengthening,light,like,lilac,linear,living,lobe,long,lower,make,medium,middl,mm,moniliform,mottled,mucilaginous,multiple,necklace,nflorescence,odd-pinnate,orbicular,orolla,ovate,ovoid,pair,pedicel,peduncle,pentagonal,perfect,petiole,petiolulate,plant,plurifoliate,pore,poricidal,purple,removed,ripe,rosette,rotate,rounded,ruit,seed,sessile,seudostipule,side,size,slightly,slit,sometimes,spaced,specimen,spot,stamen,stigma,stolon,straight,style,subtending,symmetric,tall,tamen,tem,terminal,testal,thick,throughout,tip,tissue,toward,tri-,tube,tuber,typically,unit,unwinged,usually,vary,vein,wall,wet,white,whitish,wide,x,yellow,ympodial	
376	wfo-0001030272	success	179	161	134	45	27	0.749	-6,.5,0-20,0.05-1.5,0.5-1,0.5-1.5,0.5-2,0.6-0.9,0.65-1,0.7-2.5,0.8-1.5,1,1-2.8,1.2-1.8,1.5-2.5,1/3,1/3-2/3,2-2.5,2-6.5,2.5-3,2.5-3.5,2.8-3.5,3-8,3.5-5,4-15,4-6,4-8,acute,almost,anther,apex,apically,apparently,articulated,bark,base,berry,blade,bright,calyx,cm,concolorous,connivent,deltate,densely,diameter,difoliate,drying,elliptic,entire,erect,evenly,filament,flattened-reniform,flower,free,fruit,glabrescent,glabrous,gland,glandular,green,hair,infructescence,lateral,leaf,length,less,lobe,long,long-attenuate,longer,margin,maturity,mauve,membranous,midpoint,minute,mm,moderately,multangulate,near,obtuse,older,one,open,orange-brown,pair,pedicel,peduncle,per,pericarp,petiole,poricidal,porrect,portion,primary,ray,red,red-brown,reduced,rounded,sessile,shallowly,shrub,simple,slender,smooth,sometimes,sparsely,spherical,spreading,stellate-pubescent,stem,straight,style,surface,tapering,terete,terminal,tertiary,time,tip,trichome,unarmed,unbranched,undulate,unit,upper,vein,venation,visible,wide,young	.3,/4,0.05-0.1,1-1.5,1.5-3,10-20,4-10,5-7,5-merous,abaxially,acut,alyx,ame,apar,ba,c.,eaf,eed,elongating,equal,fruiting,geminat,glabrescen,gra,lobed,lower,mature,narrow-deltate,nflorescence,orolla,oung,perfec,reflexe,ruit,scar,shorte,spaced,stellate,tamen,tube,unarme,vary,way,woody,ympodial	abaxial,adaxial,arrangement,branching,characteristic,colour,corolla,form,geminate,gray,growth,height,history,inflorescence,life,midvein,null,ovary,plant,pseudostipule,rachi,seed,shape,staman,sympodial,texture,true
377	wfo-0001030287	success	150	139	102	48	37	0.68	-11,-40,-many,0-15,0.5-1,1,1-10,1-15,1-2,1-2.5,1-3,1-4,1-5.5,1.5-2.5,1966,2,2-,2-12,2-5,3,3-9,4-5,4-6,4.5-6,8-13,?,abaxially,acute,adaxially,aggregate,apart,apex,articulated,base,bluish,branched,calyx,cell,cm,color,compound,cylindrical,deltate,dendritic,dendritically,densely,diameter,down,eglandular,ellipsoidal,entire,fide,flattened,flower,forked,glabrous,gland,glandular,hair,herb,leaf,leaving,lilac,lobe,long,long-stalked,margin,mm,moderately,obtuse,often,ovoid,pedicel,pedicellar,peduncle,petiole,pinnately,puberulent,pubescent,purple,rachi,radiu,rugulose,scar,scattered,shrub,simple,slightly,smith,spaced,sparser,stalked,stone,strongly,style,subcordate,tip,truncate,unbranched,unit,unknown,x	-foliat,.5-2.5,1.5-10,2-10,2.5-4,5-10,adaxiall,axe,basiscopically,blade,chartaceous,connivent,decurrent,dendritic-pubescen,directed,distall,eaf,eed,elliptic-ovate,lanceolate,lateral,leaflet,lon,lower,membranaceous,narrowly,nflorescence,nther,oblong,orolla,pore,presen,ruit,sparsely,stellate,stigma,subcapitat,subcoriaceous,tal,tem,time,triangular,tube,upper,vary,wide,yellow,ympodial	-foliate,abaxial,adaxial,anther,arrangement,branching,characteristic,colour,corolla,dendritic-pubescent,filament,form,fruit,growth,height,history,inflorescence,length,life,midvein,null,ovary,plant,present,primary,pseudostipule,seed,shape,staman,stem,surface,sympodial,tertiary,texture,unarmed,vein,venation
378	wfo-0001030300	success	235	163	141	94	22	0.6	-1,-7,.5,0.2,0.2-1.5,0.4-0.5,0.4-4.5,0.5,0.5-1,0.5-4,0.5-5,0.6-0.8,0.8-3,0.8-4,0.9-1,1,1-1.3,1-2,1-4,1-6,1-celled,1.4-2.4,2-2.1,2-foliate,2-locular,3/4,4-11,4-celled,6-15,9-12,abaxially,absent,abundant,acute,adaxial,adaxially,almost,anther,apex,appearance,articulated,basal,base,bract,bracteate,brittle,broadly,brown,calyx,cell,cm,cordate,corolla,crenate,densely,diameter,eglandular,elliptical,entire,face,filament,finely,flower,fruit,give,glabrous,glandular,globose,glutinous-viscose,golden,green,hair-like,herb,imparipinnate,inflorescence,interjected,internode,interrupted,irregularly,lateral,leaflet,less,like,lobe,long,margin,markedly,midvein,mm,moderately,narrowly,node,oblique,obovate,occasionally,once-branched,orbicular,outgrowth,ovary,pale,pedicel,peduncle,perennial,petiole,plant,population,present,primary,pseudostipule,pubescence,pubescent,rest,rounded,secondary,silky,simple,sparsely,spathulate,spreading,stem,style,surface,tall,terminal,tertiary,testa,tip,triangular,trichome,uniseriate,unit,usually,vein,wall,wide,wider,winged,woody,yellow,yellowish,yellowish-green	-0.9,0.1,0.1-0.15,0.15-1,0.2-0.5,0.4-1.5,0.5-0.6,0.6-0.7,0.7-0.8,0.7-1.2,0.7-1.5,0.8-1,1-2-celled,1.2-,1.5-,1.5-2.5,2-2.5,2-3,2-4,2.2-7.5,3.5-13,6-8-celled,although,always,anthesi,apical,appendage,articulation,ba,bent,beyond,bifid,capitate,coherent,column,crenat,curved,deltate,developed,diamete,distal,eaf,edicel,eed,ellipsoidal,elongate,even,exserted,frequently,fruiting,gree,halfway,head,introrse,lamina,large,larger,leave,lon,longer,minute,multicellular,nflorescence,pair,papillae,partially,pentagonal,petal,petiolule,pith,pore,reflexed,ruit,slightly,spreadin,staminal,sterile,stigma,straight,strongly,tem,thick,tube,two,ud,underlying,unicellular,united,upper,velvety,weak,well,ympodial,zygomorphic	abaxial,arrangement,branching,characteristic,colour,form,growth,height,history,leaf,length,life,mentioned,rachi,seed,shape,staman,sympodial,texture,true,unarmed,venation
379	wfo-0001030311	success	182	140	104	78	36	0.571	.2,.5,0.1,0.1â0.2,0.3â1.5,0.5â0.8,0.5â1,0.6â1,1.2â7,1.5â2,1.5â5.5,1.5â8,15â22,1â1.2,1â2,1â3,2â10,2â6,3â7,5-pinnate,5â10,<,abaxially,acuminate,acute,adaxial,adaxially,anther,apex,axe,base,berry,blade,brown,calyx,chartaceous,ciliate,clavate,cm,color,cordate,deltoid,densely,diameter,entire,especially,extra-axillary,filament,flower,fruit,glabrous,granular,green,groove,half,herbaceous,lenticular,lobe,long,lower,margin,membranaceous,midvein,minutely,mm,oblique,obtuse,occasionally,orangish,papillose,pedicel,peduncle,petiole,present,proximal,pubescent,purplish,rachi,rounded,sand-punctate,scattered,short,side,slender,slightly,spaced,sparsely,stem,style,surface,tan,terrestrial,thick,thinner,trichome,unbranched,unit,vein,vine,white,wide,wide-diameter,widely,x	.5â1.8,0.4â2,0.5â2,0.5â2.5,0.6â2.4,0.8â1.2,0.8â4,0.8â4.5,1.5â3,1.5â6,1.8â2,1â1.5,1â2.5,2.2â2.5,2.2â3,2.5â9,2â2.5,3â5,accrescent,along,alyx,apar,apical,appearance,basal,c.,capitat,ciliat,cuneate,dense,distal,eaf,eed,elliptical,falcate,fallen,flattened,fruiting,giving,glabrou,groov,ground,hair,lanceolate,lateral,leaflet,like,log,lon,m.,membranous,nflorescence,nternode,obovate,orolla,ovoid-rhomboid,pair,petiolulate,petiolule,plurifoliat,pubescence,rhomboid,ruit,sessile,shortly,smaller,stellate,stigma,strongly,tamen,tem,thickened,tip,trailing,tube,upper,vary,ympodial	1-1.5,1-2.5,1.8-2,2-2.5,2.2-2.5,2.2-3,3-5,abaxial,apart,arrangement,branching,characteristic,colour,corolla,form,growth,height,history,inflorescence,leaf,length,life,mentioned,ovary,plant,plurifoliate,primary,pseudostipule,seed,shape,staman,sympodial,tertiary,texture,unarmed,venation
380	wfo-0001030311	success	203	157	125	78	32	0.616	.2,.5,0.4-2,0.5-1,0.6-1,0.6-2.4,0.8-1.2,0.8-4,0.8-4.5,1-1.5,1-2.5,1-3,1.2-7,1.5-2,1.5-5.5,1.5-8,1.8-2,15-22,2-10,2-2.5,2-6,2.2-2.5,2.2-3,3-5,3-7,5-10,5-pinnate,abaxially,absent,acuminate,acute,adaxial,adaxially,anther,apart,apex,apical,apparently,appearance,articulated,axe,base,blade,chartaceous,cm,color,cuneate,dense,densely,diameter,dig,distal,elliptical,entire,equal,especially,falcate,fallen,filament,flower,formation,fruit,giving,glabrous,granular,groove,ground,hair,herb,interjected,lateral,leaflet,lenticular,like,lobe,log,long,lower,margin,membranaceous,midvein,mm,node,oblique,obovate,obtuse,occasionally,orangish,pair,pedicel,peduncle,perfect,petiole,petiolulate,plurifoliate,present,pubescent,rachi,rhomboid,rooting,scattered,sessile,short,shortly,side,simple,slender,spaced,sparsely,stem,stigma,style,surface,tan,thick,thinner,trailing,unbranched,uniseriate,unit,upper,vein,wide,widely,x	.5-1.8,0-2.5,0.1,0.5-0.8,0.5-2,1-1.2,1.5-3,1.5-6,2224,5-merou,8031,<,[,],absen,accrescent,ag,aggregate,along,alyx,ba,basal,basally,brown,capitat,cell,ciliat,ciliate,clavate,connivent,cordate,deltoid,directed,distally,eaf,eed,flattened,g,geminat,gh,green,groov,half,large,lon,longitudinal,m.,minutely,nflorescence,oblong,opening,orolla,ovoid-rhomboid,papillose,petiolule,pittier,pore,proximal,purplish,rounded,ruit,sinple,slightly,slit,smaller,stellate,stone,strongly,tamayo,tamen,tem,thickened,tip,tube,vary,white,yellow,ympodial	5-merous,abaxial,arrangement,branching,calyx,capitate,characteristic,colour,corolla,form,geminate,growth,height,history,inflorescence,leaf,length,life,null,ovary,plant,primary,pseudostipule,seed,shape,staman,stamen,sympodial,tertiary,texture,unarmed,venation
381	wfo-0001030335	success	153	144	113	40	31	0.739	.1,.25,.5,0-5,0.05-0.2,0.1-0.5,0.25-0.5,0.5-1,0.7-1,1-1.5,1-2,1-3-flowered,1.1-1.4,1.1.5,2-2.5,2-5,2.5-3,3/4,5-6,5-7,acuminate,acute,along,anther,anthesi,apex,bark,base,beneath,berry,branch,calyx,cm,conical,corolla,dark,deciduous,decurrent,deltoid,densely,dia,dry,elliptic,erect,filament,filiform,flattened,free,gently,giving,glabrous,globose,green,greyish-red,horizontally,lateral,leaf,lightly,like,lobe,lobed,long,main,material,minute,minutely,mm,narrowly,often,older,onto,opposite,ovary,ovoid-reniform,pair,pale,papillose,pedicel,petiole,pitted,portion,prominent,puberulent,pubescent,raised,reflexed,ripe,shrub,simple,slightly,soon,sparsely,spreading,stem,strongly,style,surface,tall,tan,tapering,tip,trichome,tube,underside,uniseriate,vein,way,white,winged,x,yellow,yellowish-green,young	.75,2-2.2,2-4.5,7-13,aspec,ba,bi-lobed,bud,deflexed,eaf,edicel,eed,except,expanded,exserted,fruiting,geminate,lamina,lenticellate,lon,lower,middle,nflorescence,obovoid,occasionally,papillo,pore,poricidal,puberulen,ruit,shaped,stigma,straight,tear-drop,ud,unifoliat,unit,widest,woody,ympodial	abaxial,adaxial,arrangement,aspect,branching,characteristic,colour,diameter,form,fruit,growth,height,history,inflorescence,length,life,margin,mentioned,midvein,peduncle,plant,primary,pseudostipule,rachi,seed,shape,staman,tertiary,texture,unarmed,venation
382	wfo-0001030336	success	266	200	177	89	23	0.665	-1.5,-2,.5,0.1-1,0.2,0.2-1,0.2-1.5,0.5,0.5-0.7,1,1-1.5,1-3,1-celled,1.0-1.4,1.5-,1.5-5,1.7-2.3,1.8-3.0,1/4-1/3,10,2-foliate,2-locular,2/3,3-5,4-,4-10,4-celled,8-16,8-20,8-celled,acute,adpressed,almost,amongst,anther,apex,appearance,articulated,basal,base,basiscopically,bent,bifurcate,bluntly,bract,bracteate,branch,bright,brown,calyx,cell,cm,coat,conical,cordate,corolla,crenate,curved,dark,darker,decurrent,deeply,densely,diameter,eglandular,elliptic,entire,erect,filament,first,flower,flushed,fruit,giving,glandular,globose,grayish,green,greenish,hair-like,half,head,herb,imparipinnate,inflorescence,internode,interrupted,lanceolate,largest,lateral,leaf,leaflet,less,like,lobe,lobed,long,longer,margin,markedly,maturity,midvein,minute,minutely,mixed,mm,mostly,narrowly,node,oblique,obovate,occasionally,once-branched,orbicular,outgrowth,ovary,pale,papillate,part,pedicel,peduncle,perennial,petiole,population,present,primary,proximal,pseudostipule,puberulent,pubescent,purple,rachi,range,rest,rounded,scattered,shaggy,shorter,shrub,silky,simple,small,soft,sometimes,southern,sparse,spreading,stem,stripe,style,surface,surrounding,tall,ten,tertiary,testa,thick,tip,trichome,truncate,two,unicellular,uniformly,uniseriate,unit,upper,usually,velvety,wall,way,weak-walled,white,wide,winged,woody,yellow,young	-10,-19,0-,0.1-0.3,0.1-0.5,0.1-0.7,0.15-0.2,0.15-0.9,0.2-0.25,0.2-0.8,0.3-0.4,0.3-1.1,0.5-1,0.5-1.5,0.6-0.8,0.6-1.5,0.8-0.9,0.8-1.2,0.8-1.3,0.8-3,1-1.4,1.5-2,1.5-3.5,1.6-7,2-4,2-9,4,6,absent,anthesi,apical,appearing,appendage,articulation,berry,capitate,clavat,column,completely,developed,diamete,distal,divided,eaf,edicel,eed,elongate,entir,essentially,exserted,extremely,fruiting,glandula,halfway,interjected,investing,large,larger,leave,lon,loosely,lower,mere,middl,narrowing,nflorescence,often,pair,petiolule,reflexed,rotate,ruit,secondary,sessile,sinus,slightly,spreadin,staminal,stellate,sterile,stigma,straight,strongly,tem,terminal,tube,ud,united,ympodial	abaxial,adaxial,arrangement,branching,characteristic,colour,form,growth,height,history,length,life,middle,null,plant,seed,shape,staman,sympodial,texture,unarmed,vein,venation
383	wfo-0001030342	success	155	128	81	74	47	0.523	.2,.5,1-6.5,1.5,3-pinnate,abaxially,acuminate,acute,adaxially,anther,apex,apiculate,axe,base,berry,broadly,brown,calyx,chartaceous,cm,cordate,cuneate,cylindrical,deltoid,dense,diameter,elliptical,entire,extra-axillary,filament,flattened,flower,fruit,glabrous,greenish,herbaceous,leaf,lenticular,light,lobe,long,margin,membranous,mm,mottled,oblique,obtuse,often,ovoid-rhomboid,pedicel,peduncle,petiole,pointed,proximal,pubescent,rachi,rarely,rhomboid,rounded,sand-punctate,scattered,side,slender,smooth,spaced,sparsely,stem,style,surface,trichome,truncate,unbranched,undulate,unit,vein,vine,white,wide-diameter,widely,x,yellowish	0.1â0.2,0.3â1.2,0.5â1,0.5â3,0.5â5,0.8â1.5,0.8â4,1-5,1.2â3,1.5â13,1.5â2,1.5â5,1.5â7.5,10â25,1â1.2,1â1.5,1â2.5,1â3,1â5.5,1â6,1â7,2â,2â2.5,2â4,3,3â12,4â5,4â8,5-merous,6â7,abundant,accrescent,along,alyx,apar,apical,blade,c.,capitat,ciliat,eaf,eed,fruiting,glabrou,lanceolate,lateral,leaflet,like,lon,lower,m.,minutely,nflorescence,nternode,orolla,perfec,petiolule,plurifoliat,pubescen,revolute,ruit,slightly,stellate,stigma,tamen,tem,terrestria,tip,truncate-acuminat,tube,vary,wide,ympodial,â7	0.5-1,0.8-1.5,1-1.5,1-2.5,1.5-13,1.5-2,1.5-5,10-25,2-2.5,2-3,2-4,3-12,4-5,4-8,7,abaxial,adaxial,apart,arrangement,branching,characteristic,colour,corolla,form,growth,height,history,inflorescence,length,life,midvein,null,ovary,plant,plurifoliate,primary,pseudostipule,seed,shape,staman,sympodial,terrestrial,tertiary,texture,true,unarmed,venation
384	wfo-0001030342	success	153	121	89	64	32	0.582	-7,.2,.5,0.5-1,1-1.5,1-6.5,1-7,1.5-13,1.5-2,1.5-5,1.5-7.5,10-25,2-,2-2.5,2-3,3,3-12,3-pinnate,4-5,4-8,abaxially,abundant,acuminate,acute,adaxially,along,anther,apart,apex,apiculate,apparently,articulated,axe,base,blade,brown,calyx,chartaceous,cm,cylindrical,deltoid,diameter,entire,extra-axillary,filament,flower,fruit,glabrous,hair,herb,leaf,lenticular,light,lobe,long,margin,minutely,mm,node,obtuse,pedicel,peduncle,petiole,plurifoliate,pubescent,rachi,rarely,revolute,rooting,scattered,simple,slender,smooth,spaced,style,surface,terrestrial,tip,trailing,truncate,unbranched,undulate,uniseriate,unit,vein,white,wide,widely,x	0.5-3,0.5-5,0.8-4,1-1.2,1-3,1-5,1-5.5,1-6,1.2-3,5-merou,6-7,absent,accrescent,ag,alyx,apical,ba,basally,broadly,capitat,ciliat,connivent,cordate,cuneate,directed,distally,eaf,eed,elliptical,equal,fruiting,geminat,interjected,lanceolate,lateral,leaflet,longitudinal,lower,membraceous,nflorescence,oblique,oblong,opening,orolla,perfect,petiolule,pore,proximal,pubescen,rhomboid,rounded,sagittate,side,slightly,slit,stellate,stigma,tamen,tem,truncate-acuminat,tube,vary,yellow,ympodial	abaxial,adaxial,arrangement,branching,characteristic,colour,corolla,form,geminate,growth,height,history,inflorescence,length,life,membranous,midvein,null,ovary,plant,primary,pseudostipule,seed,shape,staman,stem,sympodial,tertiary,texture,true,unarmed,venation
385	wfo-0001030353	success	227	197	176	51	21	0.775	-0.2,-1.5,-2,-3,-5,.1,.2,.5,.7,0,0-2,0-6,0.1-0.2,0.15-0.3,0.5,0.5-0.9,0.8,0.8-1.2,1,1-2,1-3,1-6,1-7,1.8-2.2,1.8-3,1/3,1/5,1/6,11-16,2-7,2.5-4,2.8-3.7,20-200,3-4,3-5.5,3.5-4,4-,4-4.5,5,5-6,6-15,6-8,7-10,abaxial,acute,adaxial,almost,anther,apart,apex,apically,apparently,articulated,bark,base,berry,blade,broad-deltate,brown,c.,calyx,cm,conical,connivent,cuneate,curved,densely,development,diameter,distance,ellipsoid,elliptic,equal,erect,evenly,extending,filament,flattened,flattened-reniform,flower,free,fruit,glabrescent,glabrous,green,half,infructescence,lateral,leaf,length,less,lobe,lobed,long,long-styled,longer,lower,margin,maturity,mauve,midpoint,midvein,mm,moderately,multangulate,narrow-deltate,older,one,open,orange-brown,pair,patch,pedicel,peduncle,per,pericarp,petiole,plant,pointed,poricidal,porrect,portion,prickle,prickly,primary,ray,red-brown,reddish-green,retaining,rounded,scar,sessile,shape,short-styled,shrub,side,simple,small,smooth,sometimes,spaced,sparsely,stalk,stalked,stellate-pubescent,stem,stout,straight,style,subentire,surface,tapering,terete,terminal,tertiary,throughout,time,tip,tree,trichome,tube,unarmed,unbranched,unit,upper,vein,venation,visible,warty,weakly,whit,white-gray,wide,wo,yellow,young	-1/2,-6,-merous,0-15,0.1-0.3,1.2-1.8,1/,1/2-2/3,1/6-1/4,10-15,2-10,4-5,6,8-15,abaxially,alyx,andromonoecious,apar,apiculat,chartaceous,deltate,discolorous,distal,drying,eaf,eed,elongating,fruiting,hermaphrodite,heterostylous,lowermost,mature,nflorescence,orolla,oung,pendulous,plurifoliat,reflexed,ruit,shorter,somewhat,spreading,staminat,stellate,strongly,tamen,unarme,vary,way,woody,ympodial	apiculate,arrangement,branching,characteristic,colour,corolla,form,growth,height,history,inflorescence,life,mentioned,ovary,plurifoliate,pseudostipule,rachi,seed,staman,sympodial,texture
386	wfo-0001030407	success	182	123	92	90	31	0.505	.5,1-10,1-2,1-4,12-14,12-15,2-2.5,2-5,2-7,3-6.5,3-9,3.5-9.5,30-60,4-5,5,6-7,7-8,abaxially,acuminate,adaxially,anther,apart,apex,apparently,articulated,axe,axillary,base,berry,brownish,bud,cm,condition,conical,corolla,densely,diameter,distal,drying,elliptic-lanceolate,exceeding,filament,flower,forked,fresh,fruit,generally,glabrous,green,green-white,greenish,hair,half,herb,leaf,light,like,lobe,long,margin,middle,minute,mm,mottled,mucilaginous,odd-pinnate,ovate,ovoid,pedicel,peduncle,perfect,petiole,petiolule,plant,proximal,pubescent,purple,ray,ripe,seed,spaced,stamen,style,subsessile,subtending,symmetrical,terminal,throughout,usually,wet,white,whitish	.2,0.7-3.2,1-3,1.5-5,2-6.7,3-10.5,3-4,5-merou,6.5-18.5,absent,acumen,ag,alyx,blade,capitat,cell,chartaceous,ciliate,connivent,covering,decreasing,digestion,dorsally,eaf,edge,eed,end,enzyme,especially,flat,folded,geminat,glabrou,gradually,hair-like,homostylous,honeycomb-shaped,interjected,lanceolate,larger,lateral,leaflet,lengthening,living,lower,make,nflorescence,obtuse,one,orolla,pair,pentagonal,placed,plurifoliate,pore,poricidal,pubescen,removed,round,ruit,secondary,semierec,seudostipule,size,slit,specimen,ste,stigma,stolo,subequal,tall,tamen,tem,testal,thick,thir,tip,toward,tri-,tube,tuber,typically,unit,unwinged,vary,wall,wide,x,yellow,ympodial	abaxial,adaxial,arrangement,branching,calyx,characteristic,colour,form,growth,height,history,inflorescence,length,life,mentioned,midvein,ovary,primary,pseudostipule,rachi,shape,staman,stem,surface,tertiary,texture,third,true,unarmed,vein,venation
387	wfo-0001030420	success	170	148	113	57	35	0.665	-2,-20,-30,-35,-9,-pubescent,0.5-,0.5-1,0.5-4,0.5-8,1,1-,1-1.5,1-2,1-3,1-4,1-6,1.5-3,1.5-5,10-,10-25,15-25,2-,2-3,2-5,2-6,2-9,3-lobed,4-7,5-,5-15,6-7,7-22,abaxially,acuminate,acute,adaxially,aggregate,also,apart,apex,articulated,axe,basal,base,beyond,calyx,cell,chartaceous,cm,color,cordate,cylindrical,deltate,densely,diameter,eglandular,eglandular-puberulent,ellipsoidal,elongated,entire,exserted,flower,forked,fruit,glabrate,glabrous,glandular-,glandular-puberulent,hair,leaf,leaving,lobe,lobed,long,margin,mm,moderately,often,pedicel,pedicellar,peduncle,perfect,petiole,pilose,pinnately,puberulent,pubescent,pubescent-pilose,purple,rachi,radiu,rarely,remnant,ripe,shrub,simple,small,spaced,sparsely,stamen,stellate,stone,style,tip,tree,truncate,unbranched,unit,unknown,unlobed,vein,x	-4,1-7.5,1/2,2-14.5,3-7,4-foliat,5-6,7-19,7/8,absent,ape,blade,connective,connivent,dark,directed,distally,divided,eaf,eed,eglandular-pilo,elliptic-ovate,equal,lanceolate,lon,lower,midrib,narrowly,nearly,nflorescence,nther,obtuse,orolla,ovate,pore,presen,puberulent-pubescent,pubescent-pilo,ruit,shorter,sinus,stigma,subcoriaceous,tal,tem,thecae,time,tomento,triangular,truncat,tube,ud,vary,wide,yello,yellow,ympodial	4-foliate,abaxial,adaxial,anther,arrangement,branching,characteristic,colour,corolla,eglandular-pilose,filament,form,growth,height,history,inflorescence,length,life,midvein,null,ovary,plant,present,primary,pseudostipule,seed,shape,staman,stem,surface,sympodial,tertiary,texture,unarmed,venation
388	wfo-0001030426	success	158	126	91	67	35	0.576	-30,0.4-0.7,1-4,1-4.2,10,15-25,2,2-3,2.5-4,2.5-6,3-12,3-4,3-6,4-10,6-8,9,abaxially,acute,adaxially,apex,apiculate,articulate,base,branched,calyx,caudate,cell,cm,corolla,covering,cyme,diameter,dichasial,dichasially,distal,ebracteate,elliptic-lanceolate,exceeding,filament,flower,forked,generally,glandular,globose,green,green-white,half,heart-shaped,herbaceous,lanceolate,lateral,leaf,linear,living,lobe,long,make,mm,monochasial,mucilaginous,oblique,oblong,odd-pinnate,ovoid,pedicel,peduncle,perennial,perfect,petiole,pilose,plant,proximal,rachi,rounded,seed,specimen,spot,stamen,stigma,straight,stripe,style,testal,thick,throughout,tuber-bearing,typically,unit,wall,white,Â¼	0.3-7,0.3-8,1.5-3,1.5-6.5,1.7-3.2,3-6-foliat,4-6.5,6-11.5,absen,acumen,apical,apically,connate,decurrent,dehiscent,digestion,diminishing,dorsally,eaf,edge,eed,emoval,enzyme,flat,folded,globo,gradually,hair-like,honeycomb,interjected,introrse,larger,leaflet,linear-lanceolate,linear-oblong,lon,lower,maturing,nflorescence,nther,obtuse,often,orolla,pair,pattern,pinnatifi,plan,poricidally,reveal,ruit,second,sessile,seudostipule,short,size,slit,stellate,tal,tem,terminal,toward,vary,whit,wide,without,yellow,ympodial	'hair-like,3-6-foliate,abaxial,adaxial,anther,arrangement,branching,characteristic,colour,form,fruit,growth,height,history,inflorescence,length,life,margin,mentioned,midvein,ovary,pinnatifid,primary,pseudostipule,shape,staman,stem,surface,sympodial,tertiary,texture,unarmed,vein,venation,wet
389	wfo-0001030430	success	171	162	103	68	59	0.602	.2,.5,0.25,0.3,0.5,0.6,0.8â5.6,1.2â2.0,1.3â8.0,30â200,3â24,3â5,5,abaxially,abundant,acute,adaxially,anther,anthesi,apart,apex,apical,appressed,articulated,axe,axillary,basal,base,blade,blue,borne,branched,brittle,brown,calyx,cell,cm,convex,cylindrical,decurrent,densely,dentate,diameter,elliptic,equal,erect,few-seeded,filament,flattened,fleshy,flower,fruit,glabrous,globose,green,hair,indumentum,leaf,lobe,lobed,long,margin,mm,moderately,multicellular,occasionally,ovate,pair,pale,pedicel,peduncle,perennial,perfect,petiole,pitted,present,pubescent,purple,regularly,rounded,serrate,shallowly,shoot,shrub,side,simple,spaced,stone,straight,style,subglabrous,surface,terminal,time,unifoliate,uniseriate,unit,violet,white,wide,woody,x,â2.7	0.4,0.5â12,0.6â0.8,0.6â1.0,0.8â3.0,0.9â1.0,0â20,1.0â1.2,1.0â1.5,1.0â2.0,1.4â1.5,1.5â1.7,1.6â1.8,1.8â5.0,12â20,12â30,1â3,1â9,2.0â3.0,2.0â4.2,2â3,3.0â4.5,3â17,3â4,3â8,5.5â12,5â10,5â6,6â10,adaxiall,ag,ba,bud,capitate,chartaceous,clavate,connivent,diamete,eaf,eed,especially,geminat,lon,longitudinal,lower,m.,nflorescence,oblong,opening,orolla,pentagonal,pore,poricidal,ruit,shaped,slit,stigma,tal,tamen,tear-drop,tem,tip,toward,tube,vary,yellow,ympodial,â40	--,0,1,1.0,1.4,1.5,1.6,1.7,1.8,10,12,17,2,2.0,20,3,3.0,30,4,4.2,4.5,40,5.0,6,8,9,abaxial,adaxial,arrangement,branching,characteristic,colour,corolla,form,geminate,growth,height,history,inflorescence,length,life,mentioned,midvein,ovary,plant,primary,pseudostipule,rachi,seed,shape,staman,stem,sympodial,tertiary,texture,unarmed,vein,venation,ye
390	wfo-0001030441	success	178	151	122	56	29	0.685	+,.5,0.5,0.5-0.75,0.5-1,0.5-3,1,1-1.4,1-1.5,1-2-celled,1.5-2,10-40,2,2-10,2-5.5,2.5,3-4,30,4-5,5-14,5-7,5-7.5,6-11,<,>,acuminate,acute,along,anther,apex,articulated,attenuate,base,berry,branched,bright,calyx,cell,cm,corolla,decurrent,deltate,diameter,elliptic,entire,eye,filament,flattened,flower,free,glabrous,glandular,globose,green,growth,hair,impressed,juicy,lateral,leaving,lobe,long,lower,making,many,margin,midvein,minutely,mm,narrowly,occasionally,older,onto,open,pair,pale,pedicel,peduncle,peg,per,pericarp,petiole,plant,portion,primary,pubescent,red,reniform,ridged,ripe,scandent,shiny,short,shrub,shrubby,simple,slightly,small,somewhat,spot,spreading,stem,style,surface,terminal,thin,time,trailing,triangular,trichome,undulate,uniseriate,upper,usually,vein,vine,violet,wall,white,wide,woody,yellow	1.2-1.4,2-3,5-6,5-merou,ag,alyx,anthesi,apart,ark,brow,c.,capitate,closely,distall,eaf,eed,ellipsoid,exerted,flexuous,fruiting,glabrou,glandula,ilament,irregularly,lengthening,lobed,lon,markedly,membranous,new,nflorescence,orolla,otherwise,papillat,papillose,perfect,plurifoliat,pore,poricidal,reflexed,ruit,scar,slit,spaced,spreadin,stellate,stigma,strongly,tem,tip,tube,ud,unit,vary,way,ympodial	abaxial,adaxial,arrangement,bark,branching,brown,characteristic,colour,form,fruit,height,history,inflorescence,leaf,length,life,mentioned,ovary,plurifoliate,pseudostipule,rachi,seed,shape,staman,tertiary,texture,unarmed,venation,ye
391	wfo-0001030444	success	196	112	81	115	31	0.413	0.15-0.8,0.8-2,1-10,1-2,1.2-1.8,11-45,2-8,2.4-3.8,3-10,3-5,4-17,4-7,acuminate,acute,anther,apex,articulated,attenuate,base,berry,blue,brownish,cell,ciliate,cm,condition,coriaceous,corolla,covering,dark,deep,diameter,distal,dot,drying,elliptic,filament,fresh,fruit,glabrous,green,green-white,greenish,half,herb,high,lanceolate,lateral,leaf,light,lilac,lobe,long,make,margin,medium,mm,mucilaginous,odd-pinnate,ovate,ovoid,pedicel,peduncle,petiole,petiolulate,plant,purple,ripe,rough,rounded,seed,sometimes,style,testal,thick,throughout,touch,wall,wet,white,whitish	0-24,1,1-4,1-5,1.1-2.7,2-3,2-6,2.3-3.6,3.7-6.8,4-39,5-merou,5.3-9,6.1-12.8,7.1-17.5,9.4-20.1,abaxiall,abaxially,acumen,adaxially,ag,along,alyx,apart,apparently,arranged,asymmetric,axe,axillary,basiscopic,bead,blade,bud,capitat,clavate,connivent,decreasing,digestion,dorsally,eaf,edge,eed,enzyme,erec,exceeding,flat,flower,folded,forked,geminat,general,generally,glabrou,hair-like,hal,homostylous,honeycomb-shaped,interjected,larger,leaflet,lengthening,like,linear,living,lower,moniliform,multiple,narrow,necklace,nflorescence,orbicular,orolla,pair,pentagonal,perfect,plurifoliate,pore,poricidal,removed,rotate,ruit,sessile,seudostipule,shortly,side,size,slit,spaced,specimen,stamen,stigma,stolon,straight,subequal,subtending,symmetric,tall,tamen,tem,terminal,tip,tissue,toward,tri-,tube,tuber,typically,unit,unwinged,usually,vary,wide,wing,x,yellow,ympodial	'hair-like,abaxial,adaxial,arrangement,branching,calyx,characteristic,colour,form,growth,height,history,inflorescence,length,life,midvein,null,ovary,primary,pseudostipule,rachi,shape,staman,stem,surface,tertiary,texture,true,unarmed,vein,venation
392	wfo-0001030445	success	226	165	134	92	31	0.593	.1,0.1-0.7,0.2,0.2-0.4,0.2-0.7,0.3,0.4,0.6-2.2,0.6-3.5,0.8,1,1-1.3,1-7,1.3-2,1.6-2,1.7-2.4,10-14,10-16,14,2.1-5.2,2.2-2.9,2.4-4.7,3.5-4.2,4.1-8.7,4.2-10,5-125,5.2-7.1,6.1-9.1,7.5-16,8.2-18,abaxial,abaxially,acuminate,acute,adaxially,along,anther,apart,apex,appressed,around,articulated,axillary,base,berry,black,blade,branch,branched,brownish-yellow,bulbous-based,calyx,cm,concentrated,corolla,decurrent,deltoid-reniform,diameter,drying,elliptic,elliptical,entire,erect,ferruginous,ferruginous-granular,ferruginous-tomentose,filament,flower,fruit,geminate,glabrate,glabrous,globose,green,greyish-tan,hair,intermediate,leaf,lobe,long,many,margin,midrib,midvein,mm,mostly,multangulate,oblong-lanceolate,obtuse,older,orangish-tan,pedicel,peduncle,petiole,plurifoliate,porrect-stellate,pseudoterminal,pubescent,rachi,ray,relatively,reniform,reticulate-punctate,semi-spherical,sessile,shrub,side,simple,slightly,small,somewhat,spaced,sparse,sparsely,stalk,stem,stout,style,sulcate,surface,thick,thicknes,thin,time,tomentose,tree,unit,vein,vestigial-rayed,white,x,yellowish,yellowish-tan,young	.5,/5-2/3,0.2-0.5,0.5,0.7,1.1-4.3,1.3,1.3-1.8,1.5-2.1,1.8-3.5,15-35,2.2-3.5,3-5.4,3.1-5,3.4-5.6,5-merou,5.9-15,5.9-8.3,8.1-10,accrescent,ag,alyx,bark,blunt-tippe,blunt-tipped,brown,bud,capitate,cylindrical,directed,distally,eaf,earl,edge,eed,elongated,exserted,free,fruiting,glabrescen,high,homostylous,inserted,lackin,lateral,lengthening,lobed,lon,longitudinal,lower,m.,main,multangulat,nflorescence,oblong,obovate,obscured,open,orange,orbicular,orolla,ovate,ovate-lanceolate,pore,poricidal,porrect-stellat,pubescence,resorption,rounded,ruit,runk,slit,soon,splitting,stamen,stellate,stigma,subcampanulate,suture,tamen,thick-textured,thin-,tip,tissue,tomentum,tube,unarme,vary,way,wide,yellow,ympodial	adaxial,alternate,arrangement,branching,characteristic,colour,form,glabrescent,growth,height,history,inflorescence,lacking,length,life,ovary,plant,primary,prominent,pseudostipule,reticulate,seed,shape,staman,sympodial,tertiary,texture,true,unarmed,unspecified,venation
393	wfo-0001030447	success	276	204	180	96	24	0.652	.3,.5,0,0.5,0.5-0.65,0.5-10,0.5-3,0.7-1,0.8-3.5,1,1-1.5,1-10,1-2,1-2.5,1-3,1-5,1.5,1.8-2.5,1/3,1/3-2/3,1/4-1/3,2-4,2.2-2.8,3,3-4.5,3-5,30-45Â°,4-8,6-16,6.5-9,7-8,8,abaxially,acute,adaxially,age,anther,apart,apex,apical,apically,armed,articulated,axe,base,berry,beyond,broad-deltate,calyx,cell,characteristically,cm,corolla,cuneate,curved,deltate,development,diameter,difoliate,distance,drying,equal,erect,exserted,extending,filament,filiform,fine,flat,flattened-reniform,flower,free,fruit,gently,glabrescent,glabrous,globose,infructescence,irregular,leaf,length,lengthening,less,lobe,lobed,long,long-styled,longer,longitudinal,lower,margin,maturity,midvein,mm,moderately,oblique,oblong,obtuse,often,one,open,orange,orange-brown,orange-red,outline,ovate,pair,pale,pedicel,peduncle,per,pericarp,persisting,petiole,pit,pore,poricidal,porrect,prickle,primary,pronounced,prostrate,purple,rachi,raised,red-brown,rest,rounded,scar,sessile,shallow,shallowly,shiny,short-styled,shortly,shrub,side,sinus,slender,slit,small,smooth,sometimes,somewhat,spaced,sparse,sparsely,spherical,spreading,stalked,stellate,stellate-pubescent,stem,stout,straight,straw-yellow,stump,style,surface,tapering,terminal,tertiary,thick,thin,throughout,time,tip,translucent,trichome,unarmed,unbranched,usually,vein,venation,visible,white,x,yellow,yellow-orange,Ã	.2,/5,0.1,0.1-0.3,0.15-0.3,0.2,0.2-0.4,0.4-0.7,0.4-0.9,0.8-1.7,1-6,1.5-2.5,1.5-7,1/3-1/2,2.5-10,2.5-6.5,5,5-15,5-merou,6,6-10,6-7,6-8,6-9,accrescent,always,alyx,apar,apparently,bark,blade,branche,c.,chartaceous,clavate,covering,cupular,dark,densely,discolorous,divided,eaf,eed,elongating,finely,finger-hair,flattened,fruiting,geminat,herbaceous,irregula,lateral,long-ovoi,mature,midpoint,minute,mostly,narrow-deltate,nflorescence,obconical,older,opening,orange-translucent,orolla,oung,papillo,pendulous,perfect,point,portion,pubescent,ray,reduced,ri,ridge,ridged,ruit,shorter,simple,stalk,stigma,subsessile,tamen,terete,toward,tube,ud,unequal,unit,variously,vary,weakly,wide,widest,woody,ympodial	0.5-1,abaxial,adaxial,arrangement,branched,branching,characteristic,colour,form,geminate,growth,height,history,inflorescence,life,null,ovary,plant,pseudostipule,rim,seed,shape,staman,texture
394	wfo-0001030453	success	127	125	93	34	32	0.732	.25,.5,/4,0.25-0.5,0.8-1.5,1-1.3,1-1.5,1.5-1.6,1.5-2.5,3-3.5,9-12,abaxially,acuminate,acute,adaxially,along,anther,anthesi,apex,arachnoid,arachnoid-pubescent,attenuate,axi,base,broadly,calyx,clavate,cm,corolla,cup-shaped,deflexed,delicate,deltate,dendritic,densely,dia,divided,elliptic,especially,filament,fine,flat,floccose,free,glabrate,glabrous,known,lateral,leaf,less,lobe,long,main,margin,middle,midrib,minute,minutely,mm,narrowly,near,nearly,occasionally,opposite,ovary,pair,pedicel,petiole,planar,portion,pubescent,reddish,shiny,shrub,simple,slender,soon,sparsely,stem,stigma,straight,style,surface,tall,trichome,tube,unit,vein,way,white,wide,widest,young	4-5,9-14,bark,closely,dark,eaf,edicel,eed,ellipsoid,exserted,know,later,lon,lower,nflorescence,older,overlappin,papillat,papillose,pore,poricidal,reddish-brow,rounded,ruit,scar,shaped,spaced,strongly,tear-drop,tip,tub,ud,unifoliat,ympodial	abaxial,adaxial,arrangement,branching,characteristic,colour,diameter,form,fruit,growth,height,history,inflorescence,length,life,midvein,null,papillate,peduncle,plant,primary,pseudostipule,rachi,seed,shape,staman,sympodial,tertiary,texture,unarmed,unifoliate,venation
395	wfo-0001030486	success	141	105	76	65	29	0.539	.5,1-1.5,1-5,1.1-1.4,1.5-2,1.7-2,10-12,2-3,3-3.5,4-4.5,4.5-5,5-8-flowered,6-7,acute,anther,apex,basal,base,beneath,berry,brown,calyx,clavate,cm,corolla,dark,deltate,dia,difoliate,dry,drying,elliptic,erect,f,filament,fleshy,fresh,glabrous,globose,green,internodal,lateral,leaf,lobe,long,main,margin,material,minutely,mm,opposite,ovary,ovoid-reniform,pair,papillose,pedicel,petiole,pitted,reddish,shrub,simple,slightly,small,stem,stout,style,surface,tan,tapering,thickened,treelet,tube,vein,white,x,yellow-green	0.8-2.2,1/2,1/4,10-14.5,2-5.5,3-5,3/4,4-6.5,abaxially,adaxially,anthesi,ba,bark,closely,clustered,completely,conical,deflexed,differing,distal,eaf,edicel,eed,ellipsoid,exserted,free,fruiting,geminat,inflorescenc,later,lobed,lon,lower,m.,major,middle,minor,nflorescence,older,overlapping,pale,papillo,planar,pore,poricidal,portion,ruit,scar,shaped,shin,size,spaced,stigma,tall,tear-drop,tip,tub,ud,unit,usually,way,widest,woody,ympodial,young	abaxial,adaxial,arrangement,branching,characteristic,colour,diameter,form,fruit,growth,height,history,inflorescence,length,life,midvein,null,peduncle,plant,primary,pseudostipule,rachi,seed,shape,staman,tertiary,texture,unarmed,venation
396	wfo-0001030489	success	196	108	82	114	26	0.418	.5-3,1/5-1/2,12-24,3-8,5,5-6,6-8,abaxially,abruptly,adaxially,anther,apex,appressed,appressed-pubescent,attenuate,axillary,bark,base,blade,branch,broadly,calyx,cinereous,cm,corolla,diameter,echinoid,elliptic,entire,filament,fruit,glabrate,growth,hair,high,lateral,leaf,length,lobe,long,long-acuminate,main,margin,midvein,minute,minutely,mostly,multangulate,narrowly,older,ovate-lanceolate,pale,pedicel,peduncle,petiole,plurifoliate,porrect-stellate,pulverulent,rachi,sessile,short,short-stalked,shrub,side,simple,slender,small,smooth,sparse,stem,style,terete,time,tree,unarmed,unit,usually,vein,wide,x,yellowish,young	-6.5,.5-2.8,.75-5.25,0.25-0.4,0.5-3,0.6-0.9,0.75-0.9,0.9-1.1,1-1.3,1-3,1-3.75,1.1-1.3,1.2-1.5,1.2-1.6,1.6-2.1,1.7-2,1.75-2,1.9-2.6,1/3-1/2,100,2.1-2.9,3-6,4-8,4.5-9,7-15,absen,acuminate,acute,adaxiall,ag,anthesi,apart,apical-lateral,apparently,articulated,axe,ba,becoming,berry,blunt-tipped,branched,brown,bud,chartaceous,closely,conical,continued,cylindrical,dehiscing,deltoid,densely,dichotomously,due,eaf,echinoi,eed,elongate,fleshy,flower,free,glabrous,globose,greenish,honeycombed,inserted,introrse,large,lobed,long-exserted,longitudinal,lower,mm,nflorescence,oblong,obtuse,orolla,ovate,perfect,pore,probably,pseudo-terminal,puberulent,pubescent,pulverulen,reniform,reticulate-punctate,ripe,ruit,runk,several,slit,somewhat,spaced,sparingly,stellate-pubescent,stellate-rotate,stigma,subcampanulate,subcapitat,subglobose,suborbicular,tamen,testa,thick,tomentose,toward,tube,turn,unarme,vary,way,white,yellow,ympodial	abaxial,absent,adaxial,arrangement,branching,characteristic,colour,form,height,history,inflorescence,life,null,ovary,plant,primary,pseudostipule,seed,shape,staman,surface,sympodial,tertiary,texture,trunk,venation
397	wfo-0001030509	success	220	181	157	63	24	0.714	-10,-2,-6,0,0-0.3,0-100,0-3,0-5,0.1-0.2,0.1-0.3,0.2,0.3-2.5,0.5-1.5,0.8-1.2,1,1-1.5,1-2,1-3,1.3-2,1.7-2,1/3-2/3,1/4,2-2.5,2-3,2-4.2,2-4.5,2-6,2.8-3,3-10,3-4,4.5-12,4.5-8,7-9,8-16,anther,apart,apex,apically,apparently,articulated,base,berry,blade,broad-deltate,calyx,cm,cordate,cream,cuneate,curved,dark,densely,diameter,difoliate,distance,entire,equal,erect,extending,eye,filament,flattened-reniform,flower,free,fruit,glabrescent,glabrous,gland,globular,gray,green,half,herb,inflated,infructescence,lateral,leaf,length,lobe,lobed,long,long-styled,lower,margin,marking,maturity,mauve,midpoint,midvein,mm,moderately,naked,narrow-deltate,narrow-oblong,obtuse,occasional,occasionally,often,older,one,open,orange,orange-brown,ovate,pair,pale,pedicel,peduncle,per,pericarp,perpendicular,petiole,plant,porrect,portion,prickle,prickly,primary,purple,ray,reduced,rounded,shorter,shrub,side,slender,smooth,sometimes,spaced,sparsely,spherical,stalk,stalked,stellate-pubescent,stem,straight,style,surface,terete,terminal,tertiary,time,trichome,tube,unarmed,unbranched,upper,usually,variously,vein,venation,visible,weakly,wide,yellow,yellow-green,young	/3,0-15,0.1,0.1-0.25,0.6-1,0.8-4,1-4,1-6,1.5-2,1/,2/3-3/4,4.5-10,5-10,5-merous,7-15,abaxially,alyx,andromonoecious,apar,apical,bark,becoming,brow,chartaceous,connivent,discolorous,distal,drying,eaf,eed,elongating,fruiting,geminat,herbaceous,hermaphrodite,heterostylous,long-acuminat,longer,lowermost,mature,nflorescence,orolla,oung,pendulous,poricidal,ruit,scar,short-styled,shorte,simple,spreading,staminat,stellate,subsessile,tamen,tapering,tip,unarme,unit,vary,way,woody,ympodial	abaxial,adaxial,arrangement,branching,brown,characteristic,colour,corolla,description,form,growth,height,history,inflorescence,life,long-acuminate,mentioned,ovary,pseudostipule,rachi,seed,shape,staman,texture
398	wfo-0001030516	success	172	149	111	61	38	0.645	0.4-1.5,1-2.5,1-4,1-7,1.5-2,1.8-2.4,2-12,2-3,2-4,3-8,4-22,4-6,4-7,8-9,9-32,abaxially,acumen,acuminate,acute,adaxially,apex,articulate,base,branched,calyx,cell,cm,cordate,corolla,covered,covering,cuneate,cyme,darker,decurrent,densely,diameter,dichasial,dichasially,digestion,distal,ebracteate,elliptical,emoval,enzyme,exceeding,filament,flower,forked,generally,gland,globose,green,green-white,hair,hair-like,half,herbaceous,honeycomb,lateral,leaf,light,living,lobe,long,long-attenuate,make,mm,monochasial,mucilaginous,oblique,odd-pinnate,outline,ovate,ovoid,pattern,pedicel,peduncle,perennial,perfect,petiole,pilose,plant,proximal,puberulent,pubescent,rarely,reveal,seed,sessile,short-petiolate,short-stalked,slightly,sometimes,specimen,spreading,stamen,stigma,straight,stripe,style,testal,thick,throughout,triangular,tuber-bearing,typically,unit,wall,Â¼,â	1.1-3.5,1.1-4.1,1.7,2-2.,3-6,3-6-foliat,3-9.8,4-4,4.2-10.7,6-15,9-22,apical,apically,connate,dehiscent,diminished,dorsally,eaf,edge,eed,first,flat,folded,globo,gradually,interjected,introrse,leaflet,less,lon,longer,lower,lunat,maturing,nflorescence,nther,often,orolla,pair,pentagonal,plan,poricidally,rotate,ruit,second,seudostipule,short,size,slit,tal,tem,terminal,time,toward,triangulat,type,vary,whit,wide,yellow,ympodial	'hair-like,'type,3-6-foliate,abaxial,adaxial,anther,arrangement,ba,branching,characteristic,colour,form,fruit,growth,height,history,inflorescence,length,life,lunate,margin,mentioned,midvein,ovary,primary,pseudostipule,rachi,shape,staman,stem,surface,sympodial,tertiary,texture,unarmed,vein,venation,white
399	wfo-0001030551	success	167	135	98	69	37	0.587	-12,-30,0-2,0.5-1,0.6-1.5,1-,1-10,1-2,1-2.5,1-3.5,1-4,1-5,1.5-,1.5-2.5,10-20,10-40,2,2-3,2-6,2.5-5,20-25,3-,3-12,3-8,4-,4-5,4-7,5-6,9-20,abaxially,acuminate,acute,adaxially,also,apart,apex,articulated,axe,basal,base,blade,blue,calyx,chartaceous,cm,color,cordate,densely,dia,diameter,distally,entire,fading,flower,fruit,glandular-puberulent,globose,hair,leaving,lobe,long,margin,mm,moderately,oblong-fusiform,obtuse,often,ovate,ovate-elliptic,pedicel,pedicellar,peduncle,perfect,petiole,pilose,puberulent,puberulent-pubescent,pubescent-pilose,rachi,remnant,ripe,shrub,simple,spaced,sparsely,style,time,tip,triangular-elliptic,truncate,unbranched,unit,unknown,violet,wide,widening,x,yellowish	-5,1,13.,2.5-4,3-5,4-foliat,5-17,abruptly,absent,adpressed,aggregate,ape,beyond,bilobe,broad,campanulate,cell,clavate,concave,connective,dilated,directed,eaf,ed,ellipsoidal,equal,et,exceeding,exserted,fleshy,glabrous,lanceolate,laterally,lon,lower,martinelli,narrow,narrowed,narrowly,nflorescence,nther,orolla,ovoid,papillose,pore,puberulen,pubescent-pilo,radiu,round,ruit,seen,shorter,slightly,small,stamen,stellate,stigma,stone,subcoriaceous,tal,tem,thecae,tomento,triangular,tube,ud,unknow,vary,ympodial	4-foliate,abaxial,adaxial,anther,arrangement,branching,characteristic,colour,corolla,filament,form,growth,height,history,inflorescence,leaf,length,life,midvein,null,ovary,plant,primary,pseudostipule,seed,shape,staman,stem,surface,sympodial,tall,tertiary,texture,true,unarmed,vein,venation
400	wfo-0001030570	exception_thrown	173	0	0	173	0	0.0		-1,.3-0.5,0-,0.3-0.5,0.5-,0.5-1,1,1-,1-1.5,1-2,1-3,1-4,1-5,1-8,1.5,1.5-2.5,1/2,10-17,10-25,15-20,15-35,2-2.5,2-3,2-4,2-5,2-7,2-7-lobed,2-8,2.5-22,20-30,3-10,3-5,3-6,3.5-5,4-25,4-5,4-7,4-foliat,4/5,5-,8-,abaxially,absent,acuminate,acute,adaxially,aggregate,apart,ape,apex,apiculate,articulated,axe,basal,base,beyond,blade,calyx,campanulate,cell,cm,color,connective,connivent,cordate,cylindrical,diameter,dilated,directed,distally,divided,eaf,eed,eglandular,ellipsoidal,elliptic-oblong,entire,exceeding,exserted,flattened,fleshy,flower,forked,fruit,glabrat,glabrous,glandular-puberulent,globose,green,hair,lanceolate,leaf,leaving,lobe,lobed,lon,long,lower,margin,midrib,mm,narrowly,near,nflorescence,nther,obtuse,occasionally,often,orolla,ovate,ovoid,pedicel,pedicellar,peduncle,perfect,petiole,pilo,pilose,pinnately,pore,presen,pubescent,punctate,purpl,purplish,rachi,radiu,rarely,remnant,ripe,rounded,rugose,ruit,shorter,simple,sinus,slightly,small,sometimes,somewhat,spaced,sparsely,stamen,stellate,stigma,stone,style,subcoriaceous,submarginally,tal,tem,thecae,time,tip,tomento,tree,triangular,truncat,truncate,tube,ud,unbranched,unequal,unit,unknown,unlobed,vary,vein,white,wide,x,yellow,ympodial	
401	wfo-0001030581	success	187	170	147	40	23	0.786	.3,.5,0.4â0.6,0.4â1.6,0.5,0.5â0.7,0.5â2.5,0.6â0.7,0.7â0.8,0.9â1,1,1-4-celled,1.2â1.5,1.8â8,1â2,1â2-celled,1â2.5,1â4-celled,20â50,2â3-celled,35â45,3â4,3â5,4.5â12,4â7,4â9,5â6,5â8,9,abaxial,acute,adaxial,adaxially,along,angle,angled,anther,apex,appressed,articulated,basal,base,becoming,berry,beyond,black,branched,calyx,cell,central,clustered,cm,cone,conical,corolla,decurrent,densely,denser,diameter,difoliate,drop,ellipsoid,elliptic,entire,exserted,filament,flattened-reniform,flower,free,fruit,fruiting,glabrous,globose,green,growth,herb,inflorescence,intermodal,lateral,leaf,less,like,lobe,long,margin,maturity,minute,minutely,mm,narrowly,near,occasionally,often,once-branched,outline,ovary,ovate,pair,pedicel,peduncle,pentagonal,per,petiole,pitted,plant,portion,primary,pubescent,purplish,rachi,reflexed,remaining,ridge,ripe,rounded,scar,shallow,simple,somewhat,spaced,sparsely,spreading,stem,straight,style,surface,tangled,terete,testal,third,translucent,trichome,tube,turning,uniseriate,unit,upper,usually,vein,white,wide,winged,woody,yellow,yellowish,â15,â5	0.2â0.8,2,5-merous,abaxially,aggregate,anthesi,apar,bright,capitate,eaf,eed,florescence,geminat,halfway,individual,lacking,later,leave,live,lobed,lon,lower,markedly,new,papillate,perfect,reflexe,ruit,shiny,shorter,slightly,sprawlin,stellate,stigma,stone,strongly,tall,tem,ud,ympodial	apart,arrangement,branching,characteristic,colour,form,geminate,height,history,length,life,midvein,null,pseudostipule,seed,shape,sprawling,staman,sympodial,tertiary,texture,unarmed,venation
402	wfo-0001030583	success	166	117	92	74	25	0.554	.5,0.2-1,0.3-1,0.5-1,1,1-1.5,1-2,1-8,1.5-4,2.5,2.5-3,3-4,4-6,5-6,abaxial,abaxially,acute,adaxially,anther,apex,base,berry,calyx,cell,cm,corolla,crisped,cultivar,deep,dendritic,densely,difoliate,dry,elliptic,filament,flattened-reniform,flower,form,fruit,glabrous,globose,golden,green,immature,incrassate,irregular,lateral,leaf,like,lobe,long-rectangular,long-triangular,main,margin,midvein,minutely,mm,narrowly,occasionally,opposite,orange-red,outline,ovary,pair,pale,papery,pedicel,pericarp,petiole,pitted,plant,prostrate,pubescent,rest,ripe,rounded,shrub,simple,small,spathulate,stem,style,surface,tall,tan,testal,thin,trichome,vein,white,x,yellow	.2,0.1-0.5,0.4-2.7,0.7-4.5,0.8-1,0.9-3.5,1/2,2.5-9,3/4,5-7,6-7,along,anthesi,ba,bark,brow,closely,conical,corky,cultivated,dark,deflexed,dia,differing,eaf,edicel,eed,ellipsoid,enlarged,erect,especially,free,frui,fruiting,geminat,included,leave,live,lobed,lon,long,lower,major,minor,nflorescence,often,older,overlapping,papillo,papillose,planar,pore,poricidal,portion,ruit,scar,shaped,size,small-capitate,soon,spaced,specimen,stigma,stout,tear-drop,tip,tube,ud,uniseriate,unit,way,woody,ympodial,young	adaxial,arrangement,branching,brown,characteristic,colour,diameter,growth,height,history,inflorescence,length,life,null,peduncle,primary,pseudostipule,rachi,seed,shape,staman,tertiary,texture,unarmed,venation
403	wfo-0001030605	success	144	121	93	51	28	0.646	.5,0.1,0.3-0.5,1,1-4,1.5-2,1.7,12-19-flowered,2,2-3,2.5,7,abaxially,acute,adaxially,almost,along,anther,apex,area,attenuate,base,beneath,berry,branched,brown,calyx,cinereous,cm,conical,coriaceous,corolla,cylindrical,dark,dendritic-echinoid,dia,dry,drying,entire,filament,free,glabrate,glabrous,globose,green,growth,inflorescence,internodal,leaf,less,lobe,long,margin,material,midrib,minutely,mm,nearly,obovate,obtuse,occasionally,olive,opposite,ovary,ovate,ovoid-reniform,pedicel,peduncle,petiole,pitted,portion,pubescent,rarely,revolute,rounded,shiny,shrub,simple,slender,slightly,smooth,sparsely,style,surface,thickened,tip,trichome,tube,vein,white,woody,x,yellow	.4,1.5-5.5,1/3-1/2,5-12.5,anthesi,apart,ape,apical,beginning,branch,commonly,covered,deflexed,densely,difoliate,eaf,edicel,eed,ellipsoid,exerted,fruiting,geminat,gold,inflorescenc,light,lobed,lower,new,nflorescence,otherwise,overlapping,papillate,papillosefruit,pore,poricidal,reflexed,scar,scattered,shaped,somewhat,soon,sparesly,stigma,tear-drop,tinged,tub,ud,unifoliate,unit,way,ympodial	abaxial,adaxial,arrangement,branching,characteristic,colour,diameter,form,fruit,height,history,length,life,mentioned,midvein,papillose,plant,primary,pseudostipule,rachi,seed,shape,staman,stem,tertiary,texture,unarmed,venation
404	wfo-0001030624	success	170	149	117	53	32	0.688	.25,.5,0.5,0.5-1,0.5-1.5,0.9-1,1-3,1.2-1.8,1.2-2,1.5-2,2,2-10,2-3,25-40-flowered,3,3-3.5,3.5-4,7-9,acute,anther,apart,apex,apiculate,attenuate,axil,bark,base,beginning,berry,branch,calyx,cm,corolla,decurrent,dia,difoliate,elliptic,except,extreme,filament,flattened-reniform,free,furcate,glabrate,glabrous,glandular,globose,green,hyaline,incrassate,large,lateral,leaf,like,lobe,long,longitudinally,main,major,margin,middle,minor,minutely,mm,narrowly,near,occasionally,older,one,opposite,ovary,pair,pale,papillose,pedicel,petiole,pitted,portion,prominent,puberulent,raised,remaining,scar,shining,short,shrub,simple,slender,slightly,small,soon,spaced,square,stem,straight,style,surface,tapering,tip,tree,trichome,trunk,tube,tuft,two,unevenly,uniseriate,unit,vein,white,widest,x,yellow,yellowish,yellowish-green,yellowish-grey,young	2.5-5.5,4.5-8,6-13,anthesi,appearing,ba,caly,cell,clavate,deflexed,differing,dimorphic,distal,dry,eaf,edicel,eed,ellipsoid,end,erect,expanded,exserted,falcate,fruiting,geminat,greyish,inflorescenc,later,lobed,lon,lower,material,midrib,nearly,nflorescence,outer,planar,pore,poricidal,round,rugo,ruit,size,somewhat,stigma,tall,thickened,three,ti,ud,wall,woody,ympodial	abaxial,adaxial,arrangement,branching,characteristic,colour,diameter,form,fruit,geminate,growth,height,history,inflorescence,length,life,mentioned,midvein,peduncle,plant,primary,pseudostipule,rachi,rugose,seed,shape,staman,sympodial,tertiary,texture,unarmed,venation
405	wfo-0001030638	success	177	108	82	95	26	0.463	0.5-1,0.5-1.5,0.5-2,0.7-1.5,1-1.2,1-2,1.4-1.7,1.5-2,1.6-2.2,2-7-flowered,3-10,4-6,8,8-11,8-9,acute,along,anther,apex,base,beneath,berry,broadly,calyx,cm,corolla,deflexed,deltoid,densely,dia,difoliate,elliptic,filament,fruit,geminate,glabrous,glandular,globose,green,impressed,inflorescence,known,lateral,leaf,like,lobe,long,main,margin,minutely,mm,obovate,occasionally,opposite,ovary,pair,papillose,pedicel,petiole,prominent,red,red-glandular,reddish,rugose,seed,shape,shrub,simple,stem,style,surface,tall,tapering,thick,tree,trichome,tube,uniseriate,unit,vein,white,x	0.1,0.5,0.5-0.7,1-1.5,2-3,2-5,2.5-4,3-13,anthesi,apically,appear,appearing,axi,axil,ba,bark,beginning,blade,branched,bud,closely,conspicuously,corky,cucullate,cup-shaped,differing,dry,eaf,eed,entire,erect,exfoliating,extending,flattened,fleshy,free,fruiting,geminat,glabrate,gre,irregular,lamina,large,later,less,lobed,lon,lower,major,material,middle,minor,near,nearly,nflorescence,often,older,one,open,overlapping,ovoi,pale,paler,papillae,papillo,persistent,planar,pore,poricidal,portion,present,rather,rest,roundish,ruit,scar,shaped,size,soon,spaced,speciman,stigma,straight,tear-drop,terminal,thickened,thickening,tip,transversely,usually,wall,widest,woody,ympodial,young	abaxial,adaxial,arrangement,branching,characteristic,colour,diameter,form,growth,height,history,length,life,midvein,null,peduncle,plant,primary,pseudostipule,rachi,staman,sympodial,tertiary,texture,unarmed,venation
406	wfo-0001030661	success	183	148	118	65	30	0.645	-24,.2,.5,0,0.5-0.6,0.5-0.75,0.5-2,0.7-0.8,1-,1-1.3,1-1.4,1-1.5,1.2-7,1.5-2,1.5-7,12-16,2-,2-2.5,3-20,3-3.5,4-15,5-5.5,50-100+,acute,along,anther,anthesi,apex,articulated,attenuate,base,berry,branched,brown,calyx,cell,cm,corolla,deltate,densely,denser,diameter,drying,elliptic,entire,extending,filament,flattened,flower,glabrescent,glabrous,globose,growth,inflorescence,insertion,lamina,lateral,leaf,lobe,long,lower,many,margin,mature,midrib,minutely,mm,narrowly,near,never,nodding,occasionally,onto,pair,pedicel,peduncle,per,pericarp,petiole,pitted,point,primary,pubescent,rectangular,red,reddish,reniform,scattered,shiny,shrub,simple,sleeve,slender,small,sparsely,stem,strongly,style,surface,tangled,terminal,testal,thin,time,tinged,tip,tree,trichome,uniseriate,unit,upper,usually,vein,violet,white,winged,x,yellow	1-.,1-1.2,3-4,4-6,5-10,5-merou,ag,alyx,ark,branch,brow,capitate,clustered,conical,connivent,dar,eaf,eed,ellipsoid,em,erec,erect,exserted,free,fruiting,glabrou,group,ilament,lengthening,lobed,lon,loosely,membranous,minute,new,nflorescence,older,orolla,otherwise,pale,papillo,perfect,planar,platform,plurifoliat,pore,poricidal,portion,ruit,scar,slightly,slit,spreading,stellate,stigma,tube,twinin,ud,vary,way,woody,yellowish,ympodial,Â½,Â¾	1-5,abaxial,adaxial,arrangement,branching,characteristic,colour,form,fruit,height,history,length,life,midvein,null,ovary,plant,plurifoliate,pseudostipule,rachi,seed,shape,staman,sympodial,tertiary,texture,true,twining,unarmed,venation
407	wfo-0001030676	success	220	176	147	73	29	0.668	-1.6,-2.5,-3.9,/10-1/5,0-100,0.4,0.6-1.2,1-1.2,1-3,1.1-1.4,1.2-1.3,1.7-2,11-14,14-17,16,19-35,2.1-2.3,2.1-2.6,2.2-5.7,2.4-3.1,3-5,3-6,4-6,4-6.5,7-10,7-8,7-9,8-10,8-12,abaxially,abruptly,acute,adaxially,anther,apart,apex,appearing,appressed-tomentose,articulated,axillary,bark,base,becoming,berry,blade,branch,branched,brown,calyx,closely,cm,conical,continued,corolla,deltoid,densely,diameter,dichotomously,due,echinoid,entire,except,filament,finely,fleshy,flower,fruit,glabrescent,glabrous,granular-tomentose,green,greenish,growth,hair,honeycombed,horizontal,initially,lamina,lateral,leaf,length,lobe,long,main,margin,midvein,minute,minutely,mm,moderately,mostly,multangulate,nearly,oblique,oblong-elliptic,obtuse,often,older,openly,ovate,parallel,pedicel,peduncle,petiole,plurifoliate,probably,pseudo-terminal,pubescent,pulverulent,rachi,ray,reniform,reticulate-punctate,ripe,scabrous,scattered,sessile,short-attenuate,short-stalked,shrub,side,small,spaced,stellate,stellate-pubescent,stem,style,subglobose,suborbicular,tending,testa,thick,time,tip,tree,tuft,unit,usually,vein,velutinous,white,whitish,wide,x,yellow,yellowish,young	-8.5,1,1.1-1.9,1.3-1.5,1/4,2.5-5.5,2.75-3.25,3-3.5,along,angled,anthesi,apical-lateral,apparently,ba,blunt-tipped,bud,chartaceous,crown,cylindrical,dehiscing,eaf,echinoi,eed,elongate,exserted,flat-topped,forming,free,glabrescen,globose,grooved,high,inserted,introrse,lackin,large,lengthen,lined,lobed,longitudinal,longitudinally,lower,midvei,nflorescence,oblong,occasional,opening,orolla,ovate-lanceolate,perfect,pore,rather,ridged,ruit,runk,simple,slit,somewhat,sparsely,spreading,stigma,strongly,subcampanulate,subcapitat,tamen,terete,thin,tomentose,tube,unarme,vary,way,ympodial	abaxial,adaxial,arrangement,branching,characteristic,colour,form,height,history,inflorescence,lacking,life,mentioned,null,ovary,plant,primary,pseudostipule,seed,shape,staman,surface,sympodial,tertiary,texture,true,trunk,unarmed,venation
408	wfo-0001030686	success	182	147	126	56	21	0.692	.2,.5,1-1.1,1-1.2,1-1.5,1-2,1.2-1.5,1.5-4.5,1.6-3,15,2-2.5,2-3,2-6.5,2.5-4,2.5-8,3-3.5,5-12,5-25,5-30,5-6,8-9,?,aborted,abruptly,acuminate,acute,anther,apex,bark,basal,base,beneath,berry,bifid,black,branched,breast,brittle,brown,calyx,cm,conical,corolla,dark,darker,deeply,densely,diameter,different,difoliate,discolorous,dry,drying,elliptic,empty,entire,erect,filament,flattened,flower,form,free,fruit,glabrous,globose,half,height,heteromorphic,internodal,lamina,leaf,leaf-opposed,lepidote,less,lilac,lobe,long,many,margin,maturity,midvein,minutely,mm,oblique,older,orange,ovary,pair,pale,paler,papillose,pedicel,peduncle,pericarp,petiole,pitted,plant,portion,primary,pubescent,purple,rachi,scarious,seed,shallowly,shiny,short,simple,slightly,sparsely,spreading,stem,stigma,style,surface,thin,time,tree,tube,uniformly,unit,usually,vein,x,yellow,â	.5-1,0.5-1,1.5-2,1972,abaxially,adam,adaxially,age,anthesi,apart,bu,c.,centre,closely,cup-shaped,denser,eaf,edicel,eed,exerted,fide,fragrant,fruiting,geminat,glabrescen,golden,lengthening,lobed,lower,midrib,nflorescence,noddin,overlapping,papillae,planar,pore,poricidal,pubescen,ruit,scar,shallow,slit,somewhat,space,spaced,stellate,strongly,styl,tip,tissue,trichome,ud,visible,way,woody,ympodial	abaxial,adaxial,arrangement,branching,characteristic,colour,geminate,growth,history,inflorescence,length,life,null,pseudostipule,shape,staman,sympodial,tertiary,texture,unarmed,venation
409	wfo-0001030709	exception_thrown	217	0	0	217	0	0.0		-2,-5,-9,0,0-,0-20,0-30,0.1-0.2,0.15-0.5,0.2-0.5,0.3-1.5,0.4,0.7-1,0.8-4,0.9-1.5,1-1.2,1-1.6,1-4.5,1-6,1.3-1.4,1.4-2,1.6-2.1,1.9-2.8,1/2-2/3,1/3-1/2,1/4,1/4-1/3,10-14,10-50,2-4,2-5,2-6,2-8,2.3-3,2/3-3/4,3-,4-5-merous,5-10,5-20,5-6,5-7,5-9,6-10,6-21,6-7,6-8,7-8,7-9,8-11,8-15,abaxially,acuminate,acute,adaxially,almost,alyx,ame,anther,apar,apart,ape,apex,apically,apparently,articulated,bark,base,berry,blade,branched,bright,broad-deltate,brow,c.,calyx,chartaceous,cm,conical,connivent,cordate,cuspidate,deltate,diameter,discolorous,distance,drying,dull,eaf,edge,eed,elliptic,elongating,equal,erect,extending,filament,finely,flattened-reniform,flower,free,fruit,fruiting,glabrescent,glabrous,increasing,inflorescence,infructescence,lanceolate,lateral,leaf,lengt,length,lobe,lobed,lobing,lon,long,long-acuminat,longer,lower,margin,mature,maturity,mauve,middle,midpoint,midvein,mm,moderately,narrow-deltate,nflorescence,occasionally,often,older,one,open,orange-brown,orolla,oung,pair,pedicel,peduncle,pendulous,per,perfect,pericarp,perpendicular,petiole,pit,pitted,plurifoliat,poricidal,porrect,portion,prickl,prickle,prickly,primary,purple,ray,red-green,red-orange,reflexed,retrorse,rounded,ruit,scar,secondary,seed,short-styled,shorter,shrub,side,simple,size,slender,smooth,sometimes,spaced,sparsely,spherical,spreading,stalk,stalked,stellate,stellate-pubescent,stem,straight,style,surface,tamen,tapering,terete,terminal,tertiary,time,tip,toward,trichome,truncate,tube,unarmed,unit,upper,usually,variously,vary,vein,venation,visible,way,weakly,wide,woody,yellow,yellow-green,ympodial	
410	wfo-0001030714	success	178	149	125	53	24	0.702	-3,0.1-0.3,0.5,0.5-0.8,0.5-1.9,0.7-0.8,1-1.2,1-1.5,1-2.5,1.2-1.5,1.2-4,1.4-3.5,1.5-2,1/3,2-2.5,2-2.6,20,3-3.5,3-7,5-100,5-6,7-17,>,abaxial,abaxially,acuminate,acute,adaxially,aid,along,anther,anthesi,apex,articulating,basal,base,beneath,berry,blue,blue-black,branching,calyx,cm,conical,cordate,corolla,dark,densely,denser,diameter,elliptic,entire,especially,except,fide,filament,flattened,flower,fruit,glabrous,globose,gradually,greyish,growth,herbaceous,howard,joined,leaf-opposed,leaving,liana,like,lobe,long,many,margin,membranous,midrib,minute,minutely,mm,narrowly,nodding,node,ob-ellipsoid,ob-elliptic,oblique,occasionally,ovary,overall,pair,pale,pedicel,peduncle,peg,per,petiole,pitted,primary,prominent,pubescent,quadrate,reniform,ripe,shape,simple,slightly,sparsely,stem,style,submarginal,surface,tapering,terminal,thickened,time,trichome,truncate,twining,uniseriate,vein,vine,violet,woody,x,yellow	.2,.5,/3,0.3-0.4,0.8-1,1-1.3,age,apar,bark,becoming,campanulate,clavate,climbin,cup,eaf,eed,ellipsoid,exserted,free,grading,gree,lengthening,lobed,lower,narrow,new,nflorescence,older,paler,papillat,papillate,pedice,perfect,planar,plurifoliat,pore,poricidal,portion,ruit,scar,slit,spaced,stellate,stigma,strongly,tip,tub,tube,ud,unit,way,widely,ympodial	adaxial,arrangement,characteristic,climbing,colour,form,green,height,history,inflorescence,leaf,length,life,midvein,null,plant,pseudostipule,rachi,seed,staman,tertiary,texture,unarmed,venation
411	wfo-0001030733	success	130	103	72	58	31	0.554	.5,1-1.2,1-1.5,1-2,2-2.5,3-4,3-5,4.5-5,5-8-flowered,6-7,6-9,abaxially,acuminate,acute,adaxially,along,anther,apex,base,berry,brown,calyx,clearly,cm,corolla,dark,decurrent,deltate,densely,denser,elliptic,embryo,filament,glabrous,globose,green,lateral,leaf,like,lobe,long,main,margin,mm,moderately,narrowly,onto,opposite,ovary,ovoid-reniform,pair,pedicel,petiole,pubescent,rounded,shrub,simple,smooth,somewhat,sparsely,stem,style,surface,testa,tip,treelet,trichome,uniseriate,vein,visible,white,x	/4,0.5-1,1.5-5,1.7-2.7,4-15,?,anthesi,ape,bark,bi-lobed,broadly,capitate,closely,conical,coriaceous,dia,eaf,eed,ellipsoid,elongate,erect,exserted,free,fruiting,grayish-brow,lamina,later,lobed,lon,lower,middle,minutely,nflorescence,older,overlappin,papillo,planar,pore,poricidal,portion,ruit,scar,shaped,spaced,stigma,strongly,tall,tear-drop,thick,tube,ud,unifoliat,unit,way,widest,woody,ympodial,young	abaxial,adaxial,arrangement,branching,characteristic,colour,diameter,form,fruit,grayish-brown,growth,height,history,inflorescence,length,life,midvein,null,peduncle,plant,primary,pseudostipule,rachi,seed,shape,staman,tertiary,texture,true,unarmed,venation
412	wfo-0001030772	success	155	130	102	53	28	0.658	-2,.2,.25,.5,0.2-0.8,0.25-0.5,0.5-1,0.75-1,0.9-1,1-2,1-2.5,1.4-1.6,1.5-2,2-7,3-3.5,3-5,5-10-flowered,5-6,8-10,acuminate,anther,anthesi,apex,attenuate,base,beginning,berry,branch,calyx,capitate,closely,cm,corolla,dark,deflexed,dia,elliptic,erect,extreme,filament,free,fruit,fruiting,gently,glabrous,globose,green,impressed,large,lateral,leaf,lobe,long,long-triangular,main,major,margin,methyl,minor,minutely,mm,occasionally,opposite,ovary,overlapping,ovoid-reniform,pair,pale,paler,papillose,pedicel,per,petiole,pitted,portion,prominent,ripe,salicylate,scar,shape,shining,shrub,simple,slender,smelling,soon,spaced,stem,straight,strongly,style,surface,tan,tapering,tip,tube,vein,white,wintergreen,woody,x,young	.05,0.9-3.1,1.2-5,4.2-6.5,9-15,acute,archin,ba,bark,becoming,beneath,bud,differing,difoliate,eaf,edicel,eed,ellipsoid,geminat,grey,inflorescenc,later,lenticellate,lobed,lon,long-acuminate,lower,middle,nearly,nflorescence,node,older,one,papillo,pore,poricidal,reflexed,rounded,ruit,shaped,size,slightly,stigma,swollen,tall,tear-drop,trichome,ud,uniseriate,unit,usually,widest,ympodial	abaxial,adaxial,arching,arrangement,branching,characteristic,colour,diameter,form,growth,height,history,inflorescence,length,life,mentioned,midvein,peduncle,plant,primary,pseudostipule,rachi,seed,staman,tertiary,texture,unarmed,venation
413	wfo-0001030781	success	213	161	132	81	29	0.62	0-5,0.2-4,0.5-6,0.5-8,1-1.5,1-10,1-12,1-2,1-4,1-8,1.5-12,1.5-2,1.5-9,10-40,15-35,2-20,2-3,2.5-14,2.5-3.5,3-4,4-15,5-6,5-7,5-8,6-7,7.5-9,abaxially,abruptly,acumen,adaxially,anther,apart,apex,apiculate,apparently,articulated,axe,axillary,base,berry,blade,brown,brownish,bud,cell,cm,condition,corolla,covering,dark,decurrent,deep,densely,diameter,distal,dot,drying,exceeding,filament,finely,flower,forked,fresh,fruit,generally,glabrous,glandular,globose,gray-green,green,green-white,greenish,hair,half,herb,high,interjected,lateral,leaf,leaflet,light,like,lobe,long,make,margin,mm,mucilaginous,narrowed,odd-pinnate,ovate,ovate-lanceolate,ovoid,papillose,pedicel,peduncle,perfect,petiole,pilose,plant,pointed,pubescent,purple,rachi,rarely,rounded,scattered,seed,simple,slightly,small,sometimes,somewhat,spaced,sparsely,stamen,stem,straight,style,subovoid,subtending,terminal,testal,thick,throughout,usually,violet,wall,wet,white,whitish,x	1.6-2.2,3-6,5-merou,ag,along,alyx,borne,broadly,caly,capitat,chartaceous,ciliate,connivent,cuneate,decreasing,digestion,dorsally,eaf,edge,eed,elliptic,end,enzyme,erect,especially,flat,folded,geminat,glabrou,gradually,hair-like,homostylous,honeycomb-shaped,lanceolate,larger,lengthening,living,low-growin,lower,membranous,midrib,minutely,nflorescence,obovate,orbicular,orolla,pair,pentagonal,petiolulate,plurifoliate,pore,poricidal,puberulent,removed,rotate-pentagonal,ruit,sessile,seudostipule,short,singly,size,slit,specimen,ste,stigma,stolo,tall,tamen,tem,tip,toward,tri-,tube,tuber,typically,unit,unwinged,vary,wide,yellow,ympodial	'hair-like,abaxial,adaxial,arrangement,branching,calyx,characteristic,colour,form,growth,height,history,inflorescence,length,life,mentioned,midvein,ovary,primary,pseudostipule,shape,staman,surface,tertiary,texture,true,unarmed,vein,venation
414	wfo-0001030782	success	198	149	119	79	30	0.601	0-1,0-7,0.4-1.5,1-2,1-3,1-5,1.5-2,1.5-7.5,11-47,12-30,13-22,15,2,2.2-4,3-10,3-5,4-6,4.6-26,5-20,6-8,7-15.6,abaxially,acumen,acuminate,acute,adaxially,anther,apart,apex,apparently,articulated,asymmetric,attenuate,axe,axillary,base,basiscopic,berry,blade,broadly,brownish,bud,cell,cm,condition,corolla,covering,dark,deep,diameter,distal,drying,exceeding,filament,flower,forked,fresh,fruit,generally,glabrescent,glabrous,globose,green,green-white,greenish,hair,half,herb,high,interjected,lateral,leaf,leaflet,light,lilac,lobe,long,make,medium,mm,mottled,mucilaginous,odd-pinnate,ovate,ovoid,pedicel,peduncle,perfect,petiole,petiolulate,plant,prominently,purple,rachi,ripe,rounded,scarce,seed,sessile,short,side,spaced,stamen,straight,style,subequal,subtending,terminal,testal,thick,throughout,tissue,usually,wall,wet,white,whitish,winged,x	1-6,1.2-3.9,1.3-1.6,1.6-4.6,2-3,2.4-11.5,4-11.6,5-merou,abaxiall,ag,along,alyx,arranged,bead,capitat,clavate,connivent,coriaceous,cuneate,decreasing,digestion,dorsally,eaf,edge,eed,elliptic,enzyme,flat,folded,geminat,glabrou,hair-like,hal,homostylous,honeycomb-shaped,inconspicuous,lanceolate,lengthening,like,living,lower,moniliform,multiple,necklace,nflorescence,orbicular,orolla,pair,pentagonal,plurifoliate,pore,poricidal,removed,rotate,ruit,second,seudostipule,size,slit,smaller,sometimes,specimen,stigma,stolon,tal,tamen,tem,tip,totally,toward,tri-,tube,tuber,typically,unit,vary,wide,yellow,ympodial	'hair-like,abaxial,adaxial,arrangement,branching,calyx,characteristic,colour,form,growth,height,history,inflorescence,length,life,margin,mentioned,midvein,ovary,primary,pseudostipule,shape,staman,stem,surface,tertiary,texture,unarmed,vein,venation
415	wfo-0001030802	success	171	137	109	62	28	0.637	.3,.5,.5mm,0,0.5-1,0.5-1.5,0.7-1cm,0.75-1,1,1-1.1,1-1.2,1-1.5,2-2.5,2-3,2.5-3,3-3.5x,3-4,4-5mm,4-6,5-10-flowered,abrupt,acuminate,acute,anther,apex,base,beginning,beneath,berry,brown,calyx,cm,cordate,corolla,deeply,densely,dia,difoliate,dry,filament,filiform,flattened-reniform,free,fruit,glabrous,gland,glandular,globose,heart-shaped,incrassate,internodal,irregularly,lamina,lateral,leaf,length,lobe,long,long-triangular,main,margin,markedly,material,midvein,minutely,mm,near,older,ovary,ovoid,pair,pale,papillate,pedicel,per,petiole,pitted,plant,portion,prominent,pubescent,raised,red,reddish,scar,shrub,simple,single-celled,slender,somewhat,spaced,stem,stigma,style,subshrub,surface,tapering,tipped,trichome,tube,unifoliate,uniseriate,unit,vein,white,widely,x,yellow,yellowish	0.25-0.4,0.5-0.75,0.9-1,2-5,3-6,abaxially,adaxially,along,anthesi,appearing,bark,basal,becoming,bud,campanulate,cucullate,deflexed,denser,eaf,edicel,eed,ellipsoid,evenly,except,exerted,exudate,fruiting,geminat,glandurla,halfway,hanging,inflorescenc,invest,later,line,live,lobed,lower,m.,nflorescence,obconic,palmate,papillose,persistently,pore,poricidal,pubescen,ruit,shaped,soon,specimen,stigm,straight,strongly,tear-drop,tip,trichoem,ud,variable,woody,ympodial,young	abaxial,adaxial,arrangement,branching,characteristic,colour,diameter,form,geminate,growth,height,history,inflorescence,life,null,peduncle,primary,pseudostipule,rachi,seed,shape,staman,sympodial,tertiary,texture,true,unarmed,venation
416	wfo-0001030809	success	154	132	97	57	35	0.63	.5,0.5-1,1-1.5,1.2-1.4,1.4-1.5,1.5-3.5,2-2.5,20-60-flowered,4.5-5,6-8,8,acute,also,anther,apex,appearing,base,beneath,berry,branched,broadly,calyx,cm,corolla,curl-tipped,curved,deltoid,dense,densely,dia,difoliate,distally,elliptic,erect,evenly,filament,free,fruit,glabrous,globose,golden,green,hair,hidden,known,large,lateral,leaf,like,lobe,long,main,mature,midrib,minutely,mm,opposite,ovary,ovate,overtopping,pedicel,petiole,pore,poricidal,portion,pubescent,round,several,shining,shoot,simple,slender,slightly,small,spaced,stem,stigma,straight,style,tall,tapering,terminal,three,time,tip,tomentose,tree,triangular,trichome,tube,two,underside,unequal,uniseriate,vein,white,yellow-brown	0.2,1-1.25,1.5-2.4,2.3-5.5,5-8,9.9-12,across,along,anthesi,apar,bark,caly,campanulate,clavate,dark-papillo,deciduous,deflexed,eaf,edicel,eed,ellipsoid,especially,exserted,falcate,fruiting,geminat,interpetalar,leave,lobed,lon,long-papillose,lower,major,markedly,membranous,middle,minor,nearly,nflorescence,older,one,planar,present,ruit,scar,scattered,shinin,sinus,size,soon,ud,unit,wide,widest,x,ympodial,young	1,abaxial,adaxial,apart,arrangement,branching,characteristic,colour,dark-papillose,diameter,form,geminate,growth,height,history,inflorescence,length,life,margin,midvein,null,peduncle,plant,primary,pseudostipule,rachi,seed,shape,staman,surface,tertiary,texture,true,unarmed,venation
417	wfo-0001030810	exception_thrown	191	0	0	191	0	0.0		0.2,0.2â0.3,0.3,0.4,0.5â,0.5â0.8,0.6â1.0,0.7â1.4,0.8â5.5,0.95â2.0,0â,1,1.0â1.5,1.0â2.0,1.0â3.0,1.1â2.0,1.1â2.2,1.2â1.5,1.5â1.9,1â2,1â3,1â5,2.9â4.5,20â100,2â3,2â4,3.0â5.0,3.3â5.5,3.3â8.5,3.5â4.6,3â19,4â14,4â5,4â7,5,5â15,5â30,5â32,6â10,6â22,7â10,7â11,8â10,abaxially,absen,accrescent,acute,adaxiall,adaxially,ag,along,anther,anthesi,apart,apex,articulated,axe,axillary,ba,base,bipinnate,blade,blue,borne,branched,brown,calyx,cell,chartaceous,clavate,cm,colour,connivent,cylindrical,dark,decreasing,densely,denser,diameter,divided,eaf,eed,elliptic,elliptical,equal,erect,especially,filament,flattened,fleshy,flower,fruit,geminat,glabrous,globose,green,greyish,hair,half,hig,indumentum,irregular,leaf,leafy,lobe,lon,long,longitudinal,lower,m.,margin,midrib,midvein,mm,moderately,multicellular,narrow,nflorescence,oblong,obtu,occasionally,older,opening,opposed,orolla,oung,pair,pale,pedicel,peduncle,pentagonal,perfect,petiole,pinnae,pinnate,pitted,plurifoliate,pore,poricidal,primary,pubescent,rarely,reflexed,rounded,ruit,secondary,shallowly,shaped,shiny,shoot,shrub,side,simple,size,slit,sometimes,spaced,sparsely,stem,stigma,stone,straight,style,subglabrous,surface,tamen,tardily,tear-drop,time,tip,tomentose,tube,unicellular,uniseriate,unit,unknown,vary,violet,white,wide,wing,woody,x,yellow,ympodial,â2.5,â3,â3.4,â4.5,â5.0,â8	
418	wfo-0001030822	success	146	144	114	32	30	0.781	.2,0-0.5,0.1-0.2,0.4,0.5-1.5,0.8-1,0.9-1,1-1.2,1-1.5,1.5-2,11-15.5,2-2.5,2-5,3-3.5,3-5,3.5-7,5-6,8-9,abaxially,acute,adaxially,anther,anthesi,apex,attenuate,base,beneath,berry,broadly,calyx,clavate,closely,clustered,cm,completely,corolla,cucullate,cup,decurrent,deflexed,deltate,dia,difoliate,elliptic-obovate,erect,filament,filiform,flattened-reniform,flower,free,fruiting,glabrous,globose,green,incrassate,inflorescence,internodal,lateral,leaf,lobe,lobed,long,main,major,margin,middle,minute,minutely,mm,near,nearly,occasionally,onto,open,opposite,ovary,pair,pale,papillose,pedicel,petiole,pitted,planar,pore,poricidal,portion,present,revolute,scar,shaped,shiny,shrub,simple,spaced,stem,stigma,strongly,style,surface,tan,tapering,tear-drop,tip,tube,unit,usually,vein,white,widest,winged,woody,x,yellowish,yellowish-brown	0.4-1,2-3.8,5-7,ba,cucullat,differing,eaf,edicel,eed,exserted,fleshy,geminat,inflorescenc,later,lon,long-ellipsoid,lower,minor,nflorescence,older,papillo,perhaps,red-papillose,ruit,size,slightly,somewhat,sparsely,tall,ud,ympodial,young	abaxial,adaxial,arrangement,branching,characteristic,colour,diameter,form,fruit,geminate,growth,height,history,length,life,midvein,null,peduncle,plant,primary,pseudostipule,rachi,seed,shape,staman,sympodial,tertiary,texture,unarmed,venation
419	wfo-0001030871	success	248	197	173	75	24	0.698	.2-3,.8-3.5,/30-1/5,0-120,0.3-4,0.4-1.8,0.6-1.5,0.7-1.3,1-18,1.3-2,1.5-6,1.8-2.6,1/2,1/2-3/4,1/4,1/4-1/3,11,2-8,2.8-4.5,3-32,3-4.4,3-6,3.5-14,30,4.5-6.5,5-33,6-40,7-12,9-13,abaxially,abruptly,acuminate,acute,adaxial,adaxially,along,anther,apart,apex,appressed,articulated,attenuate,axe,axillary,base,becoming,berry,blade,branch,branched,brown,calyx,campanulate,closely,cm,conical,continued,corolla,dark,decurrent,deltoid,dendritic-echinoid,dendritic-multangulate,densely,diameter,directed,distal,due,echinoid,elliptic,entire,erect,filament,fleshy,flower,fruit,glabrescent,glabrous,granular-tomentose,grayish,green,greenish,growth,hair,held,honeycombed,lateral,leaf,length,lobe,long,long-,long-stalked,longer,main,margin,midvein,minute,mixed,mm,mostly,multangulate,narrowly,nearly,nodding,obtuse,occasionally,often,older,orbicular,ovate,overlapping,pale,partly,pedicel,peduncle,petiole,plurifoliate,porrect-stellate,present,probably,prominent,pubescent,purple,rachi,rather,ray,reflexed,relatively,reniform,reticulate-punctate,ripe,scabridulous,sessile,short,short-,short-stalked,shrub,side,simple,sometimes,spaced,sparingly,stellate-tomentose,stem,style,subglobose,suborbicular,sulcate,terete,terminal,testa,thick,thick-stalked,thin-stalked,time,tomentose,toward,tree,tube,unarmed,unit,usually,vein,velutinous,violet,way,white,wide,x,yellow,yellowish,young	.9-1.2,0.2-0.4,0.7-2.5,1-1.3,1.3-3,1.4-2.7,1.5-3,1.8-3.5,2-3,3-5,4.8-9.5,5-7,accrescent,ag,anthesi,apical-lateral,apparently,appressed-tomentose,ba,bark,blunt-tipped,bud,capitat,chartaceous,dehiscing,dendritic-echinoi,eaf,earl,early,echinoi,eed,elongate,equal,evident,exserted,extend,free,fruiting,glabrescen,high,inserted,introrse,large,lobed,longitudinal,lower,m.,multangulat,nflorescence,oblong,open,orbicula,orolla,ovate-lanceolate,perfect,plait,pore,rotate-stellate,ruit,runk,slit,small,somewhat,soon,sparsely,splitting,stamen,stigma,striate,strongly,suture,tamen,unarme,vary,ympodial	abaxial,arrangement,branching,characteristic,colour,form,height,history,inflorescence,life,null,ovary,plant,primary,pseudostipule,seed,shape,staman,surface,sympodial,tertiary,texture,true,venation
420	wfo-0001030872	success	166	112	81	85	31	0.488	.5,0.8-1,1-1.2,1-1.5,1.2-1.5,1.5-2,1.5-5,2-5,5-6,5.5-7,acuminate,acute,adaxial,anther,apex,area,base,berry,calyx,closely,cm,consisting,corky,corolla,dark,darker,deltoid,densely,difoliate,dry,elliptic,filament,fleshy,glabrate,glabrous,globose,green,known,leaf,lobe,margin,minutely,mm,nerve,oblique,opposite,ovary,ovate,pair,paler,papillose,pedicel,petiole,primary,prominent,puberulent,raised,rather,red-glandular-puberulent,reddish-glandular,reddish-glandular-puberulent,scar,shining,simple,slightly,small,soon,spaced,specimen,stem,strongly,style,tapering,thickened,tip,tree,treelet,tube,unit,white,x	0.5,0.5-1,0.8-2,1-2,1.2-3,12-18,3-7,4-6,4-6-flowered,6-12.5,age,along,anthesi,appearing,bark,beginning,black,broadly,brown,caly,center,closed,completely,crateriform,cucullate,deflexed,dia,eaf,edicel,eed,ellipsoid-ovoid,erect,exserted,free,fruiting,full,geminat,hooded,incurved,inflorescenc,large,lenticel,lenticellate,less,like,live,lobed,lon,long,lower,major,material,middle,minor,nearly,nflorescence,older,one,overlapping,pale,petal,planar,pore,poricidal,portion,proximal,relative,rest,ridge,rounded,ruit,shaped,shorter,side,size,stigma,straight,styl,tall,tear-drop,ud,widest,woody,ympodial,young	abaxial,arrangement,branching,characteristic,colour,diameter,form,fruit,geminate,growth,height,history,inflorescence,length,life,midvein,null,peduncle,plant,pseudostipule,rachi,seed,shape,staman,surface,sympodial,tertiary,texture,unarmed,vein,venation
421	wfo-0001030882	success	144	119	88	56	31	0.611	.1,.5,0.5-0.75,0.5-1,0.5-1.1,0.8-1.1,0.9-1.1,1-1.3,1-1.5,1-4,2,2-6,3-3.5,8-12,acuminate,anther,apex,attenuate,base,beginning,beneath,berry,calyx,closely,cm,corolla,crenulate,deflexed,deltoid,difoliate,elliptic,extreme,filament,free,fruit,glabrous,globose,green,lateral,leaf,lightly,lobe,main,major,margin,middle,minor,minutely,mm,narrowly,occasionally,opposite,ovary,overlapping,ovoid-reniform,pair,pale,papillose,pedicel,petiole,pitted,portion,prominent,raised,ruguse,scar,short,shrub,simple,slender,slightly,small,spaced,stem,style,surface,tan,tapering,tip,transversely,tree,tube,unit,vein,white,widest,x,yellowish	0.75-1,0.8-2.4,1.6-2,2-5.4,2.2-4.6,3/4,6.5-15.6,?,accrescent,anthesi,bark,capitate,conical,dia,differing,eaf,edicel,eed,erect,exserted,fruiting,geminat,inflorescenc,lobed,lon,long,lower,nearly,nflorescence,older,one,ovoid,paler,papillo,peelin,planar,pore,poricidal,ruit,shaped,size,soon,stigma,straight,tall,tear-drop,terminal,thick,thickened,truncate,tub,ud,way,woody,ympodial,young	abaxial,adaxial,arrangement,branching,characteristic,colour,diameter,form,geminate,growth,height,history,inflorescence,length,life,mentioned,midvein,peduncle,peeling,plant,primary,pseudostipule,rachi,seed,shape,staman,sympodial,tertiary,texture,unarmed,venation
422	wfo-0001030883	success	179	171	141	38	30	0.788	-3,.05,.1,.5,0.5-3,0.5-5,1-1.1,1-1.2,1-1.3,1-1.5,1-4,1.5-2,1.5-3.5,10-18,2-5,20-50-flowered,3-3.5,5-6,acuminate,acute,anther,anthesi,apart,apex,appearing,arching,bark,base,berry,branched,brown,calyx,cell,clavate,cm,collapsed,collection,corolla,dark,deflexed,dia,difoliate,dry,elliptic,epidermal,evenly,filament,finely,fleshy,free,fruit,furcate,geminate,glabrous,glandular,globose,green,hard,hollow,imbedded,inflorescence,laminar,large,later,lateral,leaf,less,like,little,live,living,lobe,long,long-acuminate,main,malodorous,massive,material,midrib,minute,minutely,mm,narrowly,oblique,occasionally,older,opposite,ovary,ovate,ovoid-reniform,pair,pale,papillate,papillose,pedicel,perpendicular,petiole,pitted,placenta,plant,pore,poricidal,portion,present,puberulent,pulp,quite,rather,reticulate,russet,scar,seed,shaped,shrub,sometimes,soon,spaced,stem,stigma,stout,straight,strongly,style,surface,tan,tear-drop,thick,time,tip,triangular,trichome,tube,uniseriate,unit,upper,vein,wall,white,woody,x,young	18-44.5,3-4,3/4,9.5-27.5,accrescent,across,approximatately,becoming,bu,differing,eaf,edicel,eed,erect,fruiting,geminat,lenticellat,lobed,lon,lower,markedly,middle,nflorescence,papillo,petaloid,proximal,reflexed,ruit,size,slender,slightly,tall,tapering,two,ud,way,widest,ympodial	abaxial,adaxial,approximately,arrangement,branching,characteristic,colour,diameter,fork,form,growth,height,history,length,lenticellate,life,margin,mentioned,midvein,peduncle,primary,pseudostipule,rachi,shape,staman,sympodial,tertiary,texture,unarmed,venation
423	wfo-0001030884	success	218	154	131	87	23	0.601	0.4-3,0.5-1.2,0.8-1,0.9-5,1,1-1.5,1-3,1.5,1.5-2,1.5-2.5,100,2-5,4-5,4.5-5,5,5-30,5-6,5.5-7,6-10,9-11,>,abaxial,abruptly,acute,adaxial,along,also,anther,anthesi,apex,articulated,basal,base,berry,brown,calyx,cm,conical,dark,decurrent,densely,di-,diameter,elliptic,extend,extending,filament,flower,flowering,geminate,glabrous,glandular,gray-tinged,green,greenish,growth,half,herbaceous,inflorescence,infructescence,lateral,leaf,length,like,lobe,lobed,long,long-stalked,long-styled,long-triangular,magnification,margin,mature,midrib,mixture,mm,moderately,node,occasionally,onto,open,ovary,ovoid-reniform,pair,pedicel,peduncle,per,petiole,plant,present,prickle,prickly,primary,pubescent,reddish,rest,scattered,sessile,shallowly,short,short-stalked,short-styled,shrub,similar,simple,slender,sparsely,spherical,spreading,stellate,stem,stiff,still,style,surface,time,treelet,trichome,trifoliate,unarmed,unicellular,uniseriate,vein,visible,way,white,wide,wing,winged,without,young	.2,.5,.7,0.3,0.3-0.5,0.5,1-1.2,10,2,4-13,5-merous,6-25,6-8,7-8,abaxially,adaxiall,alyx,andromonoeciou,apar,arme,bark,blade,broad-based,c.,capitate,connivent,curved,differing,directed,discolorous,distal,eaf,eed,equal,free,fruiting,gree,heterostylous,leafy,lower,midpoint,minute,minutely,new,nflorescence,older,one,orolla,oung,outlin,pale,papillat,pore,poricidal,porrect,portion,principal,ray,red,reflexe,reflexed,regularly,ruit,sagittate,scar,shap,size,spaced,stellate-pubescent,stigma,strongly,tall,tamen,tannish,tapering,tip,tube,uniformly,unit,upward,usually,vary,varying,weakly,woody,yellow,ympodial	armed,arrangement,branching,characteristic,colour,corolla,false,form,fruit,height,history,life,mentioned,midvein,outline,pseudostipule,rachi,seed,shape,staman,tertiary,texture,venation
424	wfo-0001030899	exception_thrown	146	0	0	146	0	0.0		-45,.5-2,0.3-0.5,0.5,0.5-1,1,1-1.5,1-2,1-3,1-6,1.5-2,10-13,10-20,2,2-3,2-3.5,2.5-3.5,20-25,3-12,3-4,3-5,3-foliate,3.5-4,4-5,5-10,5-6.5,6.5-31,7-27,8-11,?,abaxially,absent,acuminate,acute,adaxially,aggregate,apart,ape,apex,articulated,axe,basal,base,beyond,blade,bronze,calyx,cell,chartaceous,cm,connective,connivent,cordate,coriaceous,deeply,densely,desc,diameter,dilated,directed,distally,eaf,eed,ellipsoidal,end,entire,ex,exceeding,exserted,extrorse,flattened,flower,fruit,glabrous,glandular-puberulent,globose,green,inside,leaving,less,light,lobe,lon,long,lower,margin,mm,mucronate,narrowly,nflorescence,nther,obconical,oblong,obtuse,orang,orolla,outside,ovate,ovoid,pedicel,pedicellar,peduncle,peltifor,perfect,petiole,pore,presen,puberulen,puberulent,pubescent,purple,rachi,radiu,remnant,ruit,shorter,shrub,simple,slightly,spaced,splotch,stamen,stellate,stigma,stone,stripe,strongly,style,tal,tem,thecae,time,tomento,triangular,tube,ud,unbranched,unit,upward,vary,vein,white,wide,x,yellow,ympodial	
425	wfo-0001030902	exception_thrown	159	0	0	159	0	0.0		-2,-20,-5,0-15,0.6-1.5,1-2,1-6,1.5-,1.5-13,1.5-2,1.5-2.5,10-15,15-50,2,2-3,2-5,2.5,2.5-4,3-13,3-20,3-4,3.5-4,30-50,4,4-22,4-6,4-7,4-foliat,5-7,5-9,6-24,8-14,abaxially,absent,acuminate,acute,adaxially,aggregate,along,angled,apart,ape,apex,apically,apiculate,articulated,axe,basal,base,beyond,blade,branched,brow,brown-pilose,calyx,cell,cm,connective,connivent,cordate,cylindrical,dark,deltate,densely,diameter,dilated,directed,distally,eaf,eed,eglandular,ellipsoidal,entire,equalling,exceeding,except,exserted,flattened,fleshy,flower,forked,fruit,glabrat,glabrescent,glabrous,glandular,glandular-puberulen,globose,hair,laterally,leaving,lobe,lon,long,lower,margin,mature,mm,narrowly,nflorescence,nther,oblong,obtuse,occasionally,orange,orolla,ovate,pedicel,pedicellar,peduncle,perfect,petiole,pinkish,pore,presen,present,puberulence,purple,purplish,rachi,radiu,rarely,reddish,remnant,ruit,shorter,simple,slightly,small,somewhat,spaced,sparse,sparsely,stamen,stellate,stigma,stone,style,subcapitat,subcoriaceous,tal,tem,thecae,time,tip,tomento,tree,triangular,truncate,tube,ud,unbranched,unit,vary,vein,wide,x,yellow,ympodial	
426	wfo-0001030914	success	186	163	134	52	29	0.72	.1,/4,0-0.25,0.1-0.5,0.5-1,0.7-1,0.8-1,1-1.5,1-2,1.2-1.5,1.5-3,1.5-8,2-10,2-2.5,2.5-3,3-4,3.5-17,5-25-flowered,7-10,7-8,9-35,acute,along,anther,anthesi,apex,attenuate,bark,base,beneath,berry,calyx,campanulate,closely,cm,corolla,dark,decurrent,deflexed,deltoid,densely,dia,difoliate,dry,elliptic,erect,evenly,filament,flower,free,furcate,glabrate,glabrous,globose,golden,green,inflorescence,lateral,leaf,lemon-yellow,length,like,live,lobe,lobed,long,long-styled,main,major,many,margin,minor,minutely,mm,narowly,obovate,occasionally,often,older,onto,opposite,otherwise,ovary,ovoid-reniform,pair,pale,pedicel,petiole,pitted,planar,plant,pore,poricidal,portion,prominent,puberulent,pubescent,raised,reddish-brown,rest,ripe,scar,shape,shaped,short-styled,shrub,simple,slightly,small,spaced,sparsely,specimen,stem,straight,style,surface,tan,tear-drop,time,tip,tree,trichome,trunk,tube,uniseriate,unit,usually,vein,way,white,winged,x,yellow,young	.5,0.8-1.3,1.5-2,2.5-11,5-17,blade,bud,capitate,constriction,differing,distal,eaf,edicel,eed,ellipsoid,equal,even,exserted,fruiting,geminat,greyish-brow,individual,later,lon,lower,middle,nflorescence,one,overlappin,papillo,papillose,quite,rounded,ruit,size,slender,sometimes,soon,stigma,tall,tapering,thick,third,ti,tub,ud,variable,weight,widest,within,woody,ympodial	abaxial,adaxial,arrangement,branching,characteristic,colour,diameter,form,fruit,geminate,greyish-brown,growth,height,history,life,mentioned,midvein,overlapping,peduncle,primary,pseudostipule,rachi,seed,staman,sympodial,tertiary,texture,unarmed,venation
427	wfo-0001030918	success	230	209	189	41	20	0.822	-12,-2.3,-3.2,-4,-40,-5,.5,0-10,0-20,0-25,0-4,0-6,0.1,0.1-0.25,0.2-0.4,0.3-1.5,0.5-0.7,0.5-2,0.6-2.5,0.7-1.2,0.7-1.7,1,1-1.5,1-1.8,1-4,1.5-2.5,1/2-2/3,1/2-3/4,1/3,1/3-,1/3-1/2,1/4-1/3,2-10,2-2.5,2-25,2-3,2-4,2.8-3,3-4,3-6.5,3-7,3.5-6,4-7,5-7,5-8,5-merous,5.5-7,7-10,abaxial,abaxially,acute,adaxial,alyx,ame,anther,apart,apex,apically,apparently,articulated,base,berry,blade,branched,c.,calyx,caudat,cell,chartaceous,cm,connivent,cuneate,curved,dark,deltate,densely,diameter,difoliate,discolorous,distance,drying,dull,elliptic,elongating,equal,erect,evenly,extending,faint,filament,flattened-reniform,flower,free,fruit,fruiting,glabrescent,glabrous,green,green-brown,infructescence,lateral,leaf,length,lobe,lobed,lobing,long,lower,margin,mature,maturity,mauve,midpoint,midvein,mm,moderately,narrow-deltate,oblong,obtuse,one,open,orange,orange-brown,orolla,outline,pair,pedicel,peduncle,pendulous,per,perfec,pericarp,petiole,pit,poricidal,porrect,portion,prickle,prickly,primary,pubescent,purple,raised,ray,red,red-brown,scandent,scar,secondary,seed,sessile,shrub,side,simple,slender,small,smooth,sometimes,spaced,sparsely,spherical,spreading,stalk,stalked,stellate,stellate-pubescent,stem,strongly,style,surface,tapering,terete,terminal,tertiary,time,tip,trichome,tube,upper,vary,vein,venation,visible,way,weakly,wide,woody,yellow,young	-4.5,-6,-9,.7,0.25-0.45,0.5-2.5,0.6,1-2,1.5-2,1.5-5.5,2-7,2-8,2/,3-15,6-8,acicular,apar,bark,brow,eaf,elongated,flattened,geminat,longer,mixture,nflorescence,occasionally,older,oung,pale,perpendicular,prickl,reduced,reflexed,ruit,somewhat,straight,tamen,unit,usually,ympodial	2/3,arrangement,branching,brown,characteristic,colour,form,geminate,growth,height,history,inflorescence,life,null,plant,pseudostipule,shape,stamen,texture,unarmed
428	wfo-0001030943	success	167	116	86	81	30	0.515	.5,0,1-1.2,1-1.5,1.1,1.8-2.2,12-15,2-6,3,4-4.5,4-5,4-6,7-8,abaxial,abaxially,acuminate,acute,adaxial,adaxially,anther,anthesi,apex,base,becoming,berry,black,branching,calyx,cm,corolla,decurrent,deflexed,dendritic,densely,diameter,drying,echinoid,elliptic,filament,flattened,glabrous,globose,golden,growth,horizontal,large,lateral,leaf,lenticular,lobe,minutely,mm,narrowly,outline,ovary,overtopping,pair,pale,pedicel,per,pericarp,petiole,pitted,plurifoliate,pubescent,purplish-black,reddish-brown,secondary,shoot,shrub,small,sparsely,stem,style,surface,terminal,thin,tree,tree-like,triangular,trichome,vein,violet,wide,x,yellowish-white	0.5-1,0.5-3,1.5-2,1/2,10-25,3-4,3/4,7-13.5,8-10,absent,age,along,apical,bark,basal,belo,bi-lobed,branch,conical,cupulate,dark,denser,eaf,edicel,eed,elongate,erect,ew,exserted,fide,flower,free,fruiting,glabrat,golden-yellow,im,inserted,lobed,lon,long,lower,m.,main,minute,monochasia,nflorescence,nodding,often,older,papillo,pearce,planar,pore,poricidal,portion,raised,ruit,scar,scattered,showy,sleeve,slightly,slit-like,somewhat,stamen,stigma,strongly,tall,tapering,time,tip,tub,tube,ud,unit,upper,way,woody,yellow,ympodial,young	?,arrangement,characteristic,colour,form,fruit,glabrate,height,history,immature,inflorescence,length,life,margin,midvein,monochasial,null,peduncle,plant,primary,pseudostipule,rachi,seed,shape,staman,tertiary,texture,true,unarmed,venation
429	wfo-0001030959	success	164	135	105	59	30	0.64	.05,.8,0.5-1.5,0.7-1.2,1-10,1-2,1.2-1.8,1/5-1/10,10-15,2-4,2.5-4,2.5-4.5,2.5-5,5-6,5-9,5-merous,6-8,9-12,almost,ame,anther,apart,apex,apparently,armed,articulated,bark,base,blade,branched,brown-green,c.,cm,color,concolorous,cuneate,densely,diameter,difoliate,drying,elliptic,equal,erect,filament,flower,fresh,glabrous,glandular,hair,inflorescence,known,lateral,leaf,length,lobe,long,long-acuminate,longer,margin,membranous,midpoint,minute,mm,numerous,older,one,open,pair,part,pedicel,peduncle,petiole,porrect,present,prickle,prickly,primary,prominent,ray,scar,scrambling,secondary,sessile,several,shrub,side,simple,spaced,stem,style,subentire,surface,terete,tertiary,time,toward,trichome,unarmed,unit,usually,vein,venation,visible,wide,youngest	.2,/5,0.5,1-7,1.5-2,1.5-3.5,4-6,4-8,abaxially,alyx,apar,apically,brown,connivent,curved,deltate,distributed,eaf,eed,evenly,free,geminat,gently,glabrescent,glabrou,green-brow,know,less,like,lobed,long-acuminat,lower,narrow-deltate,nflorescence,orolla,oung,perfec,perpendicular,poricidal,portion,prickl,ruit,short,slender,sparsely,spreading,stellate,stellate-pubescent,straight,straw,tamen,tapering,tip,tube,vary,way,whole,yellow,ympodial	abaxial,adaxial,arrangement,branching,calyx,characteristic,colour,corolla,form,fruit,geminate,green-brown,growth,height,history,life,midvein,null,ovary,perfect,plant,pseudostipule,rachi,seed,shape,staman,stamen,sympodial,texture,young
430	wfo-0001030982	success	215	165	143	72	22	0.665	-2-2.5,.1,0.05,0.05-0.5,0.1-0.15,0.2-3,0.5,0.5-0.9,0.5-1,1,1-1.5,1.5,1.5-2,1.5-3,3-8,4-12,4-5,6-8,abaxially,acuminate,acute,adaxially,angular,anisophyllous,anther,anthesi,apex,base,berry,broadly,brown,brownish,caducous,calyx,central,channelled,chartaceous,ciliate,cm,conic,conical,corolla,cream,cuneate,curved,dark,deltate,diameter,difoliate,dry,drying,elliptic,enlarged,entire,filament,flattened-reniform,flower,form,free,fresh,fruit,geminate,glabrescent,glabrous,glandular,globose,golden-green,green,greenish,growth,hilum,impressed,inconspicuously,larger,leaf,less,like,live,lobe,long,margin,material,maturity,midvein,minutely,mm,mostly,near,oblique,obovate,occasionally,olive,opposite,ovary,ovate,pair,pale,papillae,papillose,pedicel,peduncle,petiole,pitted,plant,portion,primary,prominent,puberulent,pubescent,reddish,reflexed,revolute,rhizomatous,seed,shoot,sigmoidally,simple,sinuate,situated,slightly,somewhat,sparsely,stem,straight,stripe,strongly,style,subshrub,surface,testa,tip,transverse,trichome,tube,uniseriate,unit,vegetative,vein,weakly,white,x,yellowish,young	.2,.5,0.1,0.3-2,0.5-3,1-8,2/3,3-21,age,ape,appressed,ba,beneath,bud,capitate,closely,cucullate,deflexed,differing,distall,distally,distichou,eaf,edicel,eed,ellipsoid,exerted,extension,external,fleshy,foliage,fruiting,glandular-papillose,internal,isostylous,later,lengthening,lobed,lower,major,materia,minor,new,nflorescence,often,one,overlappin,packed,papillat,papillate,planar,pore,poricidal,projection,prominently,rest,ruit,sagittate,scar,separated,size,slit,stamen,stigma,tetramerous,tightly,time,tub,ud,veined,way,ympodial	abaxial,adaxial,arrangement,branching,characteristic,colour,distichous,height,history,inflorescence,length,life,null,pseudostipule,rachi,shape,staman,sympodial,tertiary,texture,unarmed,venation
431	wfo-0001030989	success	177	122	90	87	32	0.508	.5,0.5-1,1-1.5,1-10,12-15,3-20,3-4,3-7.5,4-5,5,6-6.5,9-10,abaxially,acuminate,adaxially,anther,apart,apex,apparently,articulated,axe,axillary,base,berry,brownish,bud,cell,cm,condition,conical,corolla,covering,densely,diameter,distal,drying,filament,flower,forked,fresh,fruit,generally,glabrous,green,greenish,hair,half,herb,lateral,leaf,light,like,lobe,long,make,margin,minute,mm,mucilaginous,odd-pinnate,ovate-lanceolate,ovoid,pale,pedicel,peduncle,perfect,petiole,petiolule,plant,proximal,pubescent,ray,ripe,seed,spaced,sparsely,stem,stigma,style,subtending,terminal,testal,thick,triangular,usually,violet,wall,wet,whitish,yellow	1-2,15-27.5,2-3.5,3-5.5,4-7,4-8,5-merou,5.5-7.9,6-13,ag,alyx,blade,capitat,chartaceous,ciliate,connivent,decreasing,digestion,dorsally,eaf,edge,eed,end,enzyme,erec,especially,flat,folded,geminat,glabrou,gradually,green-white,hair-like,homostylous,honeycomb-shaped,interjected,lanceolate,larger,leaflet,lengthening,living,lower,nflorescence,obtuse,occurring,orbicular,orolla,ovate,pair,plurifoliate,pore,poricidal,present,pubescen,removed,rotate,ruit,secondary,semierect,seudostipule,singly,size,slit,specimen,ste,stolo,subequal,subsessile,symmetrical,tall,tamen,tem,thir,throughout,tip,toward,tri-,tube,tuber,typically,unit,unwinged,vary,wide,wider,x,ympodial	'hair-like,abaxial,adaxial,arrangement,branching,calyx,capitate,characteristic,colour,form,growth,height,history,inflorescence,length,life,mentioned,midvein,ovary,primary,pseudostipule,rachi,shape,staman,surface,tertiary,texture,third,true,unarmed,vein,venation
432	wfo-0001030991	success	204	136	110	94	26	0.539	.5,0,0.5-0.7,0.5-1,0.5-1.5,0.7-1.2,1-1.5,1-1.6,1-2.2,1-2.5,1.5,10-20,2.5-3,2/3,3-,3-5-lobed,4-10,5-5.5,9-11,absent,acuminate,acute,along,anther,anthesi,apex,apparently,appressed,articulated,ascending,attenuate,basal,base,berry,brown,calyx,cell,cm,color,corolla,diameter,different,elliptic,entire,eye,filament,filiform,flattened,flower,furcate,glabrous,globose,grey,growth,herb,inflorescence,lanceolate,lateral,leaf,leaf-opposed,like,lobe,long-triangular,margin,minutely,mm,narrowly,nodding,occasionally,often,pair,pedicel,peduncle,per,pericarp,petiole,pitted,primary,pseudoumbel,pubescent,rectangular,red,reniform,rest,ripe,scattered,shiny,short,shrub,simple,sleeve,small,sparsely,stem,style,suffrutescent,surface,terminal,testal,thin,trichome,uniformly,uniseriate,vein,violet,weak,white,winged,x,yellowish	0.1,0.2,0.2-0.7,0.3-0.4,0.5,0.5-3.5,0.6-0.8,1-7,2-plurifoliat,2.5-10,5-merou,<,abaxially,adaxiall,adaxially,ag,alyx,angled,arising,ark,bulbous,capitate,conical,connivent,densely,distally,drying,eaf,eed,ellipsoid,ellipsoidal,elongate,enlarged,exerted,free,frui,fruiting,fusiform,glabrescen,ilament,incised,leave,lengthening,less,lobed,loosely,lower,midrib,minute,nearly,new,nflorescence,older,orolla,outline,packed,papillo,part,particularly,pendant,perfect,pinnatifid,platfor,pointing,pore,poricidal,portion,reflexed,rootstoc,ruit,scar,shallowly,slightly,slit,somewhat,spreading,stellate,stigma,strongly,tangled,tem,tightly,tip,tube,twinin,ud,unit,upper,variably,vary,weight,woody,ympodial,young	abaxial,adaxial,arrangement,branching,characteristic,colour,form,fruit,glabrescent,height,history,length,life,midvein,null,ovary,plant,pseudostipule,rachi,seed,shape,staman,tertiary,texture,unarmed,venation
433	wfo-0001031005	success	231	189	171	60	18	0.74	.5,/3-1/2,0-0.5,0.1,0.8,0.9,1,1-1.5,1-2,1-2.5,1-3,1.5-4,10,2-3.2,2.3-3,2.5,2.5-4,3-10,3-4,3-6.5,4-6,5,5-7,5-8,5Â°,6-12,abaxial,abaxially,accrescent,acuminate,acute,adaxially,almost,along,anther,anthesi,apex,apically,articulated,attenuate,bark,base,berry,black,blue,brachyblast,branch,branched,branching,brown,calyx,chartaceous,clustered,cm,concolorous,conical,corolla,curved,dark,deltoid,dendritic,denser,density,detaching,developing,diameter,dilated,discolorous,drying,elliptic,elongated,entire,evenly,extending,eye,fertilisation,filament,fine,flat,flattened,flexuous,flower,form,forming,fruit,fruiting,glabrous,greenish,immature,increasing,known,lateral,leaf,leave,length,liana,like,lobe,long,longitudinally,loop,main,margin,membranous,midvein,mm,naked,network,obovate,obscure,occasional,occasionally,often,older,orange-brown,ovoid,pair,pedicel,peduncle,pendulous,pericarp,petiole,pointed,primary,prominent,pubescent,purple,rachi,raised,ray,ridged,scar,secondary,seed,short,side,simple,slender,sometimes,somewhat,soon,sparsely,spread,spreading,stem,stigma,strongly,stump,style,surface,tangling,terete,terminal,tertiary,thick-chartaceous,thin,tip,toward,trichome,unarmed,uneven,usually,vein,venation,visible,weakly,well-developed,white,wide,x,young	.4,0.3-0.5,0.5-1.5,1.5-2.5,age,alyx,apar,apparently,capitate,clearly,clum,common,cupular,datum,deeply,delineated,dendritic-pubescent,divided,domatia,eaf,ellipsoi,equal,free,inside,junction,lengthening,linear,lobed,lower,m.,minute,much,nflorescence,nther,oblong,onl,orolla,ou,outside,ovate,perfec,plurifoliat,pore,poricidal,portion,protruding,region,rest,ruit,smaller,smoot,smooth,standing,surrounding,tearing,tube,ud,unit,vary,ympodial	adaxial,apart,arrangement,characteristic,clump,colour,growth,height,history,inflorescence,life,null,ovary,plant,pseudostipule,shape,staman,texture
434	wfo-0001031007	success	207	159	133	74	26	0.643	.5,0.2,0.5,0.5-1,0.5-10,0.75-1.5,1,1-1.2,1-1.5,1-3.5,1.2-1.5,1.5-2,1.9-3,1/3,11-14,15,3-4,4-6,4.5-5,5.5-6,50-100,6,7-10,<,acute,along,anther,anthesi,apex,articulated,base,beginning,berry,black,branched,branching,broad,broadly,brown,calyx,cell,clustered,cm,corolla,cuneate,dark,deltate,dendritic,diameter,drying,dull,elliptic,entire,extending,filament,flattened-reniform,flower,free,fruit,glabrous,globose,growth,herbarium,impressed,inflorescence,intramarginal,irregularly,junction,lamina,lax,leaving,lilac,lobe,long,looping,loose,lower,many,margin,matte,midvein,minutely,mm,narrowly,near,occasionally,often,outline,pedicel,peduncle,peg,per,pericarp,petiole,pitted,plurifoliate,portion,primary,prominent,pubescent,reddish,revolute,round-rectangular,scar,shiny,shrub,sleeve,slender,spaced,sparsely,specimen,splitting,spreading,stem,stout,style,surface,tangled,terminal,testal,thin,time,tiny,tip,trichome,twining,upper,usually,vein,vine,way,woody,x	1.3-,1.6-2,2.5-,2.5-5,4-7,5,5-12,5-merou,8-10,abaxiall,abruptly,ag,alfway,almost,alyx,apar,apparently,ark,becoming,bifid,c.,campanulate,capitate,chartaceous,completely,connivent,cup-shaped,densely,dilated,eaf,eed,ellipsoid,exserted,fleshy,fruiting,geminat,glabrescen,glabrou,ilament,lengthening,lobed,loosely,m.,markedly,multi-celled,narrowing,new,nflorescence,nodding,older,orolla,pale,papillat,papillate,perfect,planar,pore,poricidal,rat,ruit,sagittate,simple,slightly,slit,stellate,stellate-pentagonal,stigma,strongly,tube,ud,unit,vary,yellow,ympodial	abaxial,adaxial,apart,arrangement,characteristic,colour,form,geminate,glabrescent,height,history,leaf,length,life,null,ovary,plant,pseudostipule,rachi,seed,shape,staman,tertiary,texture,unarmed,venation
435	wfo-0001031007	success	206	155	130	76	25	0.631	.5,0.2,0.5,0.5-1,0.75-1.5,1,1-1.2,1-1.5,1-3.5,1.2-1.5,1.5-2,1.9-3,1/3,11-14,15,3-4,4-6,4.5-5,5.5-6,50-100,6,7-10,<,acute,adaxial,along,anther,anthesi,apex,articulated,base,beginning,berry,black,branched,branching,broad,broadly,brown,calyx,cell,cm,corolla,cuneate,dark,deltate,dendritic,diameter,drying,dull,elliptic,entire,extending,filament,flattened,flower,free,fruit,glabrous,globose,growth,herbarium,impressed,inflorescence,intramarginal,irregularly,junction,lamina,lax,leaving,lilac,lobe,long,looping,loose,lower,many,margin,matte,midvein,minutely,mm,narrowly,near,occasionally,often,outline,pedicel,peduncle,peg,per,pericarp,petiole,pitted,portion,primary,prominent,pubescent,reddish,reniform,revolute,round-rectangular,shiny,shrub,sleeve,slender,sparsely,specimen,splitting,spreading,stem,stout,style,surface,tall,tangled,terminal,testal,thin,time,tiny,tip,trichome,upper,usually,vein,vine,way,wide,woody	0.5-10,1.3-,1.6-2,2.5-,2.5-5,4-7,5,5-12,5-merou,8-10,abaxially,abruptly,ag,alfway,almost,alyx,apar,apparently,bark,becoming,bifid,c.,campanulate,capitate,chartaceous,clustered,completely,cup-shaped,densely,dilated,eaf,eed,ellipsoid,exserted,fleshy,fruiting,glabrescen,glabrou,ilament,lengthening,lobed,m.,markedly,multi-celled,narrowing,new,nflorescence,nodding,older,orolla,pale,papillat,papillate,perfect,planar,plurifoliat,pore,poricidal,rat,ruit,sagittate,scar,simple,slightly,slit,spaced,stellate,stellate-rotate,stigma,strongly,tube,twinin,ud,unit,vary,ympodial	abaxial,arrangement,characteristic,colour,form,glabrescent,height,history,leaf,length,life,null,ovary,plant,plurifoliate,pseudostipule,rachi,seed,shape,staman,tertiary,texture,twining,unarmed,venation
436	wfo-0001031036	success	150	148	116	34	32	0.773	.2,.25,.5,0.5-1,0.8-1,0.8-1.2,1-1.3,1-2.5,1.2-1.5,1.5-3,10-20-flowered,2-2.5,3-4,3-5,5-6,7-8,abaxially,acuminate,acute,adaxially,along,angle,anther,anthesi,apex,arising,axil,base,becoming,berry,bi-lobed,broadly,brown,calyx,closely,cm,conical,corolla,crisped,dark,decurrent,deflexed,dia,difoliate,dry,drying,elliptic,enlarged,filament,filiform,flattened-reniform,fleshy,free,fresh,fruiting,glabrous,globose,green,greenish-white,knob-like,lamina,lateral,leaf,lobe,lobed,long,main,major,margin,material,middle,minor,minutely,mm,nearly,oblique,onto,opposite,ovary,pair,papillose,pedicel,perhaps,petiole,pitted,planar,portion,rounded,scar,shiny,short,shrub,simple,sinus,slightly,soon,spaced,spathulate,stem,style,surface,tapering,thickened,tip,trichome,tube,uniseriate,unit,usually,vein,white,widest,winged,woody,x,yellowish	12-15,2.2-3.7,3.5-5.5,4.5-6.5,ba,differing,eaf,edicel,eed,ellipsoid,erect,exserted,geminat,lon,lower,nflorescence,older,overlappin,papillo,pointed,pore,poricidal,ruit,sagittate,shaped,size,stigma,strongly,tall,tear-drop,tub,ud,ympodial,young	abaxial,adaxial,arrangement,branching,characteristic,colour,diameter,form,fruit,geminate,growth,height,history,inflorescence,length,life,midvein,null,overlapping,peduncle,plant,primary,pseudostipule,rachi,seed,shape,staman,sympodial,tertiary,texture,unarmed,venation
437	wfo-0001031064	success	179	171	142	37	29	0.793	.0-2.5,.5,.5-1,0,0-15,0.5,0.5-0.7,0.5-0.8,1,1-2,1-3,1.2,1.5-2,1.7-4.2,10-12,10-12.5,2,2.5-3,3,3-5.5,3-7,3.5-4,4-5-celled,5-10.5,5-6,6-16,8-10-celled,abaxially,acroscopic,acuminate,adaxially,along,anther,anthesi,anticlinal,apex,arising,attenuate,axil,basal,base,bearing,berry,blade,bright,broader,calyx,cell,cm,completely,conical,conspicuous,corolla,dark,deltate,densely,denser,diameter,distal,elongate,epidermal,filament,fleshy,flower,free,fruit,glabrous,green,half,highly,inflorescence,irregular,irregularly,lamina,lateral,leaf,leaflet,lenticel,like,lobe,long,lost,lower,margin,minute,minutely,mm,narrower,near,nodding,node,obovate,occasionally,often,open,ovary,ovoid-reniform,pedicel,per,petiole,petiolule,pinnate,poricidal,portion,projection,prominent,pubescent,purple,rachi,scar,scattered,short-pubescent,shrub,side,simple,single,sinuous,sinus,slender,smaller,somewhat,sparsely,splitting,stem,style,surface,swollen,terminal,thickening,time,tip,translucent,trichome,tube,uniseriate,unit,usually,vein,wand-like,white,without,x	.05,1-1.2,10-17,7-16,clavat,commentary,dr.,eaf,edicel,eed,erec,exserted,fruiting,globose,leave,lightly,lobed,lon,nearly,nflorescence,ovate,pair,papillate,planar,pubescen,rugose,ruit,see,stigma,strongly,tal,tem,tub,ud,unifoliat,winged,ympodial	abaxial,adaxial,arrangement,branching,characteristic,colour,dry,form,growth,height,history,length,life,mentioned,midvein,peduncle,plant,primary,pseudostipule,seed,shape,staman,sympodial,tall,tertiary,texture,unarmed,unifoliate,venation
438	wfo-0001031071	success	186	141	109	77	32	0.586	0.2-0.8,0.4-2,1-1.5,1-2,2-8,2.1-3,2.4-3.4,3-10,3-5,3-6,4-25,4-6,6-8,7-8,8-28,abaxially,acumen,acute,adaxially,anther,apart,apex,apparently,articulated,asymmetric,axe,axillary,base,basiscopic,berry,blue,brownish,bud,cell,cm,color,condition,coriaceous,corolla,covering,dark,deep,diameter,digestion,distal,drying,elliptic,enzyme,filament,flower,forked,fresh,fruit,generally,glabrous,globose,green,green-white,greenish,half,herb,honeycomb-shaped,lanceolate,lateral,leaf,lilac,lobe,long,make,medium,mm,mottled,mucilaginous,narrowly,odd-pinnate,ovate,ovoid,pedicel,peduncle,perfect,petiole,petiolulate,plant,purple,removed,ripe,round,seed,sessile,short,side,slightly,spaced,spot,star,straight,style,subtending,terminal,testal,thick,throughout,tissue,usually,wall,wet,white,whitish,winged	0-10,1-3,1-7,1.5-2.2,2-3,2-5,3.8-5.4,5-9.4,5-merou,5.7-8.8,7-16.5,abaxiall,ag,along,alyx,arranged,attenuate,bead,blade,capitat,clavate,connivent,decreasing,dorsally,eaf,edge,eed,erec,exceeding,flat,folded,geminat,glabrou,hair-like,homostylous,interjected,leaflet,lengthening,like,living,lower,middl,moniliform,multiple,necklace,nflorescence,orbicular,orolla,pair,pentagonal,plurifoliate,pore,poricidal,rotate,ruit,seudostipule,size,slit,specimen,stamen,stigma,stolon,subequal,tall,tamen,tem,tip,toward,tri-,tube,tuber,typically,unit,vary,x,yellow,ympodial	'hair-like,abaxial,adaxial,arrangement,branching,calyx,characteristic,colour,form,growth,height,history,inflorescence,length,life,margin,mentioned,middle,midvein,ovary,primary,pseudostipule,rachi,shape,staman,stem,surface,tertiary,texture,unarmed,vein,venation
439	wfo-0001031097	success	174	157	123	51	34	0.707	0.45,0.5,1-3,1-4,1-4.5,1.5,1.8-2.5,13-30,2-3,2-3.3,2-4,3-5,4-6,4-7,5-11,5-12,8-11,abaxial,abaxially,acumen,acuminate,acute,adaxially,along,apex,articulate,base,branched,calyx,cell,cm,corolla,covering,cuneate,cyme,darker,decurrent,deep,diameter,dichasial,dichasially,digestion,distal,dotted,ebracteate,edge,elliptical,emoval,enzyme,exceeding,filament,flower,forked,generally,green,green-white,hair-like,half,herbaceous,highly,honeycomb,interpetalar,lateral,leaf,leaflet,light,lighter,lobe,long,make,margin,medium,mm,monochasial,mottled,mucilaginous,narrow,noticeably,oblique,obovate,odd-pinnate,often,ovate,ovoid,pattern,pedicel,peduncle,pentagonal,perennial,perfect,petal,petiole,petiolulate,petiolule,plant,proximal,puberulent,pubescent,purple,rachi,rarely,reveal,rotate,seed,side,sometimes,stamen,stigma,straight,strigose,style,terminal,testal,thick,throughout,tuber-bearing,typically,unit,violet,violet-blue,wall,wide,Â¼	1,1.6-5.5,1.8-2.6,3-6-foliat,3.5-6,3.7-8.4,5-9,9-21,apical,apically,connate,dehiscent,diminishing,dorsally,eaf,eed,flat,folded,frequently,globo,gree,interjected,introrse,living,lon,lower,lunat,maturing,nflorescence,nther,orolla,pair,plan,poricidally,rapidly,ruit,sessile,seudostipule,short,size,slit,specimen,tal,tem,tissu,toward,vary,vbase,without,yellow,ympodial	3-6-foliate,adaxial,anther,arrangement,branching,characteristic,colour,form,fruit,globose,growth,height,history,inflorescence,length,life,lunate,mentioned,midvein,ovary,primary,pseudostipule,shape,staman,stem,surface,sympodial,tall,tertiary,texture,tissue,unarmed,vein,venation
440	wfo-0001031101	success	197	154	128	69	26	0.65	-1,-20,-30,-5,-8,0.5-0.8,0.5-3,0.6-0.8,0.7-0.8,0.8-,1-2,1-2.3,1.3-2,1.4-1.7,1/3-1/2,1/4-1/2,10-30,2-2.8,2-4,2-6,2.5-3.8,3-15,3-8,3.5-4.5,5-20,5-6,abaxial,acuminate,adaxial,almost,anther,apex,apical,apically,apparently,articulated,base,berry,blade,branched,bright,calyx,cm,concolorous,diameter,difoliate,drying,dull,entire,erect,evenly,filament,filiform,flattened-reniform,flower,free,glabrescent,glabrous,glandular,green,green-brown,hair,infructescence,lateral,leaf,length,lobe,long,long-acute,margin,maturity,mauve,minute,mm,moderately,multangulate,narrow-deltate,near,obtuse,often,older,one,open,orange-brown,orange-red,ovate,pair,pale,pedicel,peduncle,per,pericarp,petiole,porrect,portion,primary,red,resembling,rounded,scandent,sessile,shrub,simple,smooth,sparsely,spherical,stalked,stellate-pubescent,stem,straight,style,surface,terete,terminal,tertiary,time,trichome,tube,umbel,unarmed,vein,venation,visible,white,wide,yellow,yellow-green,young	-16,/2,/2-equal,0.05-0.2,0.1-0.2,0.1-0.3,0.3-0.5,1-,1-3,1.3-2.5,1.5-3,2-5,2.5-,2.5-3.5,3-10,4-10,4-5-merous,4-7,4.5-9,6-10,8-15,abaxially,alyx,ame,apar,ba,bark,c.,connivent,deltate,eaf,eed,elongating,equal,frui,fruiting,geminat,herbaceous,lobed,long-acuminat,longer,lower,mature,membranous,midpoint,nflorescence,orolla,oung,pendulous,perfec,poricidal,ray,red-brow,ruit,scar,spaced,spreading,stalk,stellate,stellate-pubescen,tamen,tapering,tip,unarme,unit,variously,vary,way,ympodial	arrangement,branching,characteristic,colour,corolla,form,fruit,geminate,growth,height,history,inflorescence,life,long-acuminate,midvein,null,ovary,plant,pseudostipule,rachi,red-brown,seed,shape,staman,texture,true
441	wfo-0001031114	success	208	162	133	75	29	0.639	.1,.2,.5,0.3-0.5,0.5,0.5-1,0.7-1.5,0.8-1.2,1-10,1-2,1-7,1-8,1.5-4,10-15,2-17,2-3,2-4,2-7,2/3,25-50,3-10,3-4,4-10,4-5,4.5-6,5-8,6-7,abaxially,acuminate,acute,adaxially,anther,apart,apex,apparently,articulated,axe,base,becoming,berry,blade,branched,brown,calyx,cm,dark,deltate,densely,diameter,differentiated,distal,echinoid,elliptic-ovate,entire,erect,especially,filament,first,flattened,fleshy,flower,fruit,geminate,glabrous,globose,green,hair,impressed,leaf,leaf-opposed,light,like,lobe,long,long-stalked,major,margin,midpoint,minor,mm,multangulate,nodding,obtuse,often,outline,ovate,pedicel,peduncle,perfect,pericarp,petiole,plurifoliate,porrect,prominent,pubescent,purple,rachi,ray,reniform,ripe,rounded,rugulose,sessile,short,short-,short-stalked,shrub,side,simple,small,spaced,sparsely,stalk,stellate,stellate-pubescent,stem,strongly,style,subcuneate,surface,thickened,thin,tip,toward,tree,truncate,vein,white,white-pubescent,white-stellate,whitish,x,yellowish	0-0.3,1-1.5,1-4.5,1.5-2.5,2.5-3,3-5,3-7,4-8,5-10,5-merou,7-15,absen,accrescent,adaxiall,ag,alyx,ba,capitat,chartaceous,connivent,covering,cylindrical,directed,discolorous,distally,dried,eaf,eed,equal,free,frui,fruiting,highly,homostylous,interpetalar,introrsely,juic,lacking,large,longitudinal,lower,membanaceous,nearly,nflorescence,oblong,one,opening,orolla,paired,part,pore,ruit,slightly,slit,somewhat,ste,stigma,straight,subcoriaceous,subcucullate,subtending,tall,tamen,tem,time,tissue,triangular,tube,unarme,unit,vary,wide,without,yellow,ympodial	abaxial,adaxial,arrangement,branching,characteristic,colour,corolla,form,growth,height,history,inflorescence,juicy,length,life,midvein,null,ovary,plant,primary,pseudostipule,seed,shape,staman,tertiary,texture,true,unarmed,venation
442	wfo-0001031116	success	191	177	152	39	25	0.796	-10,.2,.5,.8,/4,0,0.05-0.15,0.1,0.3-0.5,0.4-0.7,0.7-0.9,0.7-1,1,1-5,1/2,1/6-1/4,10-14,15-25,2-5,2.7-3.2,3.5-4,30-100,30-50,4-10,4-7,5,5-15,8-11,9-13,abaxial,acuminate,adaxial,anther,apart,apex,apically,apparently,articulated,attenuate,bark,base,berry,blade,branching,bristle,broad-deltate,calyx,caudate,clearly,cm,collapsed,densely,diameter,dirty-white,dull,elliptic,elongated,elongating,erect,evenly,filament,flattened-reniform,flexuous,flower,fragile,free,fruit,fruiting,glabrescent,glabrous,glaucous-green,green,hair,infructescence,lateral,leaf,length,less,lobe,long,longer,lower,margin,mature,maturity,mauve,midpoint,minute,mm,moderately,multangulate,obovate,obtuse,often,older,one,open,orange-brown,orange-red,pair,pedicel,peduncle,per,pericarp,perpendicular,petiole,portion,primary,ray,recurved,red-brown,reflexed,rounded,scar,secondary,sessile,sharply,shortly,shrub,simple,small,smooth,soft,sometimes,spaced,sparsely,spherical,stalk,stalked,stellate-pubescent,stem,straight,style,subentire,surface,terete,tertiary,time,tree,trichome,tube,unarmed,unit,upper,vein,venation,visible,weakly,wide,woody,yellow,young	1/3-2/,5-merous,abaxially,almost,alyx,ame,apar,arachnoid,brow,c.,connivent,discolorous,drying,eaf,eed,epidermi,equal,flat,lobed,membranous,narrow-deltate,nflorescence,obtu,orolla,oung,perfec,plurifoliat,poricidal,ruit,single,slender,stellate,tamen,tapering,tip,unarme,vary,way,ympodial	+,1/3-2/3,arrangement,brown,characteristic,colour,corolla,form,growth,height,history,inflorescence,life,mentioned,midvein,ovary,plant,plurifoliate,pseudostipule,rachi,seed,shape,staman,sympodial,texture
443	wfo-0001031128	success	213	147	124	89	23	0.582	-10,-100,-4.5,-6.5,0,0-30,0.5-0.7,0.5-1.5,0.6-1,0.8-1.7,1-,1.5-3,1.5-3.5,10-35,2-5,2.3-,20-50,20-60,3-4,3.5-4.5,5-15,5-19,8-12,abaxial,acute,almost,anther,apex,apically,apparently,articulated,base,berry,branched,branching,bristle,calyx,cm,cuneate,deltate,diameter,dull,elliptic,entire,erect,evenly,eye,filament,filiform,flattened-reniform,flower,fruit,glabrescent,glabrous,glandular,green,hair,inflorescence,infructescence,lateral,leaf,length,lobe,lobed,long,long-acuminate,lower,margin,maturity,mauve,minute,mm,moderately,multangulate,naked,near,often,one,open,orange-brown,pair,pale,pedicel,peduncle,per,pericarp,petiole,primary,purple-black,recurved,red,red-brown,secondary,sessile,shallowly,short-attenuate,shrub,side,smooth,soft,spherical,stalked,stellate,stellate-pubescent,stem,straight,style,surface,terminal,tertiary,time,trichome,unarmed,undulate,usually,vein,venation,visible,weakly,white,wide,yellow,yellow-green,young	/4,0.05-0.2,0.05-0.25,0.2,0.2-0.4,0.3-0.8,0.5-0.8,0.5-5,1,1-1.6,1.2-2,1/,1/6-1/3,10-20,2-9.5,2.5-10,2.5-3.5,4-5-merous,4-7,5-,5-30,8-23,abaxially,alyx,apar,apart,ape,bark,blade,brown,concolorous,connivent,densely,drying,eaf,eed,elongated,elongating,equal,flexuous,free,fruiting,gland,gra,less,lon,long-acuminat,longer,mature,membranous,midpoint,multangualte,narrow-deltate,nflorescence,occasionally,older,orolla,oung,perfect,perpendicular,plurifoliat,poricidal,portion,ray,reduced,reflexed,ruit,scar,short-styled,simple,single,spaced,spreading,stalk,staminate,tamen,tapering,terete,tip,tube,unarme,unit,variously,vary,way,whitish,woody,yellow-brown,ympodial	1/3,adaxial,arrangement,characteristic,colour,corolla,form,growth,height,history,life,midvein,null,ovary,plant,plurifoliate,pseudostipule,rachi,seed,shape,staman,texture,true
444	wfo-0001031135	success	189	141	107	82	34	0.566	0-2,0.7-2,1-,1-1.5,1-10,1-3,1-4,1.5-2,1.5-3,1.5-9,10-20,2,2-,2-2.5,2-3,2-3.5,2-4,3-10,3-4,3-5,3.5-12,4-5,5-30,5-9-pinnate,abaxially,acuminate,acute,adaxially,also,apart,apex,articulated,axe,basal,base,calyx,chartaceous,cm,compound,cordate,cuneate,darker,deflexed,deltate,densely,diameter,eglandular-pubescent,ellipsoidal,entire,fading,flattened,flower,frequently,fruit,fusiform,glandular-,green,interstitial,irregularly,leaf,leaflet,leaving,light,lobe,lobed,long,longitudinal,margin,mm,moderately,occasionally,often,ovoid,pedicel,pedicellar,peduncle,perfect,petiole,pilose,pink,pinnately,pinnatifid,puberulent,pubescent,purple,rachi,radiu,remnant,ripe,shrub,simple,small,smaller,spaced,sparsely,stripe,style,tree,truncate,unbranched,unit,unlobed,white,whitish,x,yellow-green,yellowish	-7,0.5-2,1-2.5,2-23,2-5,2.5-28,4-foliat,5-11,7-15,absent,adpressed,aggregate,along,ape,basiscopically,beyond,biglandula,blade,broad,campanulate,cell,color,connective,coriaceous,cylindrical,decurrent,dilated,directed,distally,eaf,eed,ellipsoida,elliptic,equal,especially,exceeding,exserted,glabrous,hair,lateral,laterally,lon,lower,midrib,narrowed,nflorescence,nther,obconical,oblique,oblong,obtuse,orolla,ovate,papillose,peltiform,pilo,pore,present,ruit,shorter,slightly,stamen,stigma,stone,strongly,subcoriaceous,tal,tem,thecae,time,tip,tomento,toward,triangular,tube,ud,unknow,upper,vary,violet,wide,ympodial	4-foliate,abaxial,adaxial,anther,arrangement,branching,characteristic,colour,corolla,filament,form,growth,height,history,inflorescence,length,life,mentioned,midvein,ovary,plant,primary,pseudostipule,seed,shape,staman,stem,surface,sympodial,tertiary,texture,unarmed,vein,venation
445	wfo-0001031144	success	231	218	192	39	26	0.831	-11,-13,.2,.5,0.2,0.5,0.8-1.4,1-,1-1.5,1-4,1.1-2.5,100,2,2-,2-3,2-6,2-9,2.5-3,25,3-7,3.5-10,4,4-20,4-4.5,4-6,5,6,7-10,<,acuminate,acute,adaxially,ag,anther,anthesi,apart,apex,apicula,apiculae,appearing,ark,around,articulated,asymmetric,away,axi,basal,base,basiscopically,berry,blac,branch,branche,bright,broadly,brow,brown,calyx,cell,closer,cm,commonly,connivent,cordate,corolla,corresponding,curved,diameter,divaricate,drying,ellipsoid,elliptic,elongate,elongating,entire,extending,filament,flattened,flattened-reniform,flower,form,four,glabrous,globose,groove,growth,inflorescence,irregularly,lamina,larger,later,lateral,leaf,leaflet,leaving,lengthening,less,like,lobe,lobed,long,longer,longest,loosely,lower,many,margin,markedly,membranous,mere,minutely,mm,near,new,number,oblique,occasionally,often,older,one,open,outline,pair,pale,pedicel,peduncle,peg,pentagonal,per,pericarp,petiole,pinnately,pinnatifid,pitted,plurifoliate,pore,poricidal,primary,progress,pubescent,quite,red,reddish,rim,ripe,scar,seed,shiny,simple,sleeve,slightly,slit,small,smaller,sometimes,spaced,sparsely,stem,strongly,style,surface,tan,terete,terminal,testal,thin,third,tiny,tip,together,triangular,trichome,truncate,tuft,twining,two,unequal,uniseriate,upper,usually,variable,vein,vine,violet,wall,white,widest,wing,woody,x,yellow,yellowish	2/3,3-4.5,5-9,5-merou,alyx,capitate,cupped,densely,eaf,eed,exserted,free,fruiting,geminat,ilament,inflated,minute,nflorescence,orolla,papillo,pendant,perfect,portion,ruit,spreading,stellate-rotate,stigma,tangle,tem,tube,twinin,ud,unit,vary,way,weight,wood,ympodial,Â½	abaxial,adaxial,arrangement,branching,characteristic,colour,fruit,geminate,height,history,length,life,midvein,null,ovary,plant,pseudostipule,pubescen,rachi,shape,staman,tertiary,texture,true,unarmed,venation
446	wfo-0001031152	success	232	191	165	67	26	0.711	-10,-5.5,.4,/100-1/16,0-100,0.2-0.3,0.2-1.5,0.3-1.3,0.3-3,1-1.5,1-3,1-6,1.1-2.2,1.2-1.8,1.4-2.6,1/2-2/3,1/2-3/4,11,13-27,2-5,2.5-7.5,2.7-3.7,3.7-7,4-19,4-6,4-8,6.5-10,8-20,9-13,abaxially,acuminate,acute,adaxially,anther,apart,apex,articulated,attenuate,axe,axillary,basal,base,becoming,berry,blade,blister,branched,brown,bullate,calyx,closely,cm,conical,continued,corolla,decurrent,deltoid,densely,diameter,directed,due,entire,exserted,few-rayed,filament,fleshy,flower,fruit,globose,granular-tomentose,green,greenish,growth,hair,honeycombed,lanceolate,lateral,lavender,leaf,length,less,lilac,lobe,lobed,long,long-,longer,main,margin,midvein,mixed,mm,moderately,mostly,multangulate,narrowly,nearly,oblanceolate,obtuse,occasionally,one,openly,pale,partly,pedicel,peduncle,persistently,petiole,pitted,plurifoliate,porrect-stellate,probably,pubescent,rachi,rather,ray,reddish,reddish-brown,relatively,reniform,reticulate-punctate,ripe,scabrous,sessile,short-,short-stalked,shrub,side,simple,spaced,sparingly,sparsely,stamen,stellate-pubescent,stelliform,stem,stipitate-glandular,stout-stalked,style,suborbicular,surface,swelling,terete,terminal,testa,thick,thick-stalked,thin-,time,tomentose,touching,toward,tree,unarmed,unit,usually,variously,vein,violet,way,wide,x,yellow,yellowish,young	-1.5,1.1-3,1.3-4,1.5-3,1.5-3.5,2.7-4.5,2.7-6,2.8-4,4-7,5-6,accrescent,ag,along,anthesi,apical-lateral,apparently,ba,blunt-tipped,branch,bud,capitat,chartaceous,dehiscing,eaf,earl,eed,evident,extend,free,fruiting,glabrescen,glabrous,high,inserted,introrse,lackin,large,longitudinal,lower,m.,multangulat,nflorescence,oblong,open,orbicular,orolla,ovate,perfect,pore,rotate-stellate,ruit,runk,slightly,slit,somewhat,soon,splitting,stigma,strongly,suture,tamen,thin,thin-stalked,tube,unarme,vary,ympodial	abaxial,adaxial,arrangement,branching,characteristic,colour,form,glabrescent,height,history,inflorescence,lacking,life,null,ovary,plant,primary,pseudostipule,seed,shape,staman,sympodial,tertiary,texture,true,venation
447	wfo-0001031202	success	198	157	128	70	29	0.646	0-0.5,0-1,0.5-1,0.6-1.1,0.8-1,1-1.5,1.5-2.5,2-3,2-8,2.5-3.5,2.5-4,3.5-4,6-25,9-11,acute,along,anther,anthesi,apex,apiculate,base,beneath,berry,broadly,calyx,capitate,cm,complex,cordate,corolla,decurrent,deflexed,deltoid,densely,dia,differing,difoliate,distal,dry,erect,filament,fleshy,flower,free,fruit,furcate,glabrate,glabrous,globose,golden,green,hard,inflorescence,large,later,lateral,leaf,like,lobe,long,long-styled,longer,main,major,many,margin,middle,minor,minute,minutely,mm,obovate,occasionally,often,older,one,opposite,orbicular,ovary,overtopping,ovoid-reniform,pair,pale,papillose,pedicel,petiole,pitted,plant,portion,prominent,puberulent,pubescent,raised,reddish-brown,rounded,scattered,sessile,shape,shoot,short-styled,shrub,size,slightly,small,sparsely,specimen,stem,stigma,straight,style,surface,tan,terminal,time,tip,tree,trichome,tube,uniseriate,unit,usually,vein,white,widest,winged,woody,x,young	.1,.5,0.1-0.3,0.5,1-1.7,1-5,1.5-2,1.5-9,15-40,2.5-13,2/3,20-100-flowered,9-20,abrupt,accrescent,apart,axi,bark,bud,completely,condition,corky,cup-shaped,due,eaf,edicel,eed,enclosed,exserted,extremely,frui,fruiting,geminat,greenish-white,greyi,irregularly,live,lobed,lon,long-ellipsoid,lower,material,narrowing,nflorescence,occasional,paler,papillo,planar,pore,poricidal,quite,ruit,scar,shaped,slender,spaced,tall,tapering,tear-drop,thick,thickened,thicker,third,tub,ud,variable,way,weight,whitish,ympodial	-,abaxial,adaxial,arrangement,branching,characteristic,colour,diameter,form,geminate,greyish,growth,height,history,length,life,mentioned,midvein,peduncle,primary,pseudostipule,rachi,seed,staman,sympodial,tertiary,texture,unarmed,venation
448	wfo-0001031207	success	219	143	119	100	24	0.543	-5,-8,0,0-0.5,0-10,0-20,0.2,0.5-1,0.6-0.9,0.6-1.2,0.85-1.4,1-3,1-4,1-5,1.4-2,1/4-1/3,2-3,2.1-2.3,2.8-3,3-5,3.5-7,5-8,9,anther,apex,apparently,articulated,base,berry,branched,bristle,bristly,calyx,cell,cm,cordate,curved,densely,diameter,difoliate,dull,erect,evenly,eye,filament,filiform,flattened-reniform,flower,fruit,glabrous,green,herb,infructescence,lateral,leaf,length,like,lobe,lobed,long,lower,margin,maturity,mauve,midvein,mm,moderately,naked,narrow-deltate,oblong,obtuse,one,open,orange-brown,outline,ovate,pair,pale,pedicel,peduncle,per,pericarp,petiole,pit,prickly,primary,raised,red,scandent,shrub,side,small,smooth,sometimes,spherical,stalk,stellate-pubescent,stem,straight,style,subentire,surface,terete,terminal,tertiary,time,tip,toward,trichome,unarmed,upper,vein,venation,visible,white,wide,yellow,yellow-green,young	-0.4,-1/2,-11,-4,-7,.1,/5,0.1-0.2,0.1-0.3,0.1-0.5,0.2-0.3,0.25-0.5,0.3-0.5,0.7-2,0.8,0.9-1.6,1,1.5-5,1/,1/3,1/3-equal,2-4,2.5-,5-merous,6-8,6.5-8,abaxially,acuminat,acute,alyx,ame,apar,apart,apically,bark,blade,broad-deltate,brow,c.,chartaceous,concolorous,dark,discolorous,distance,drying,eaf,eed,elongated,elongating,equal,extending,free,fruiting,geminat,gently,glabrescent,gray,herbaceous,lanceolate,less,longer,mature,midpoint,multangulate,nflorescence,occasionally,older,orolla,oung,pendulous,perfec,perpendicular,persistent,poricidal,porrect,portion,prickl,prickle,ray,reflexed,rounded,ruit,scar,sessile,shorter,simple,spaced,spreading,stalked,stellate,tamen,tapering,tube,unit,usually,variously,vary,way,weakly,ympodial	1/4,abaxial,adaxial,arrangement,branching,characteristic,colour,corolla,false,form,growth,height,history,inflorescence,life,null,ovary,plant,pseudostipule,rachi,seed,shape,staman,texture
449	wfo-0001031218	success	154	143	107	47	36	0.695	-5,0.5,0.5-1,1-2,1-3,1-4,15-25,2-2.5,2-22,2-3,3,3-14,3-5,4-28,4-5,4-7,4-8,40,40-100+,5-37,5.5-7,6-10,6-7,6-9,8-20,abaxially,acuminate,adaxially,aggregate,apart,apex,apiculate,articulated,axe,basal,base,beyond,blade,branched,calyx,cell,cm,cordate,cylindrical,dark,densely,diameter,eglandular,eglandular-pilose,ellipsoidal,entire,exserted,flattened,flower,fruit,glabrous,glandular,glandular-puberulent,globose,greenish-purple,hair,lavender,leaving,less,lobe,long,margin,minutely,mm,mottled,oblique,obtuse,orange,ovate,ovate-elliptic,ovoid,pedicel,pedicellar,peduncle,perfect,petiole,present,puberulent,pubescent,rachi,remnant,ripe,shorter,simple,slightly,small,sometimes,spaced,sparsely,stamen,stone,style,subcoriaceous,succulent,time,tip,tree,unit,violet,wide,x,yellow	10-19,2.5-3,4-foliat,5-7,8-17,acute,ape,connective,connivent,coriaceous,directed,distally,eaf,eed,equal,especially,exceeding,glabrou,introrse,lanceolate,lon,lower,moderately,narrowly,nflorescence,nther,orolla,papillo,pore,presen,purpl,purple,radiu,ruit,stellate,stigma,tal,tem,thecae,tomento,toward,triangular,truncat,tube,ud,vary,ympodial	4-foliate,abaxial,adaxial,anther,arrangement,branching,characteristic,colour,corolla,filament,form,growth,height,history,inflorescence,leaf,length,life,midvein,null,ovary,papillose,plant,primary,pseudostipule,seed,shape,staman,stem,surface,sympodial,tertiary,texture,unarmed,vein,venation
450	wfo-0001031225	success	163	125	98	65	27	0.601	.25,.5,0.1-0.75,0.2,0.2-0.75,0.5-1,0.7-6,0.75-1,0.8-1,1-1.5,1-5,2,2.5-3,5-50-flowered,5-6,6-8,7-9,acute,along,anther,apex,bark,base,berry,calyx,characteristic,cm,corolla,darker,decurrent,deltoid,dia,difoliate,dry,elliptic,filament,free,furcate,glabrate,glabrous,globose,green,growth,inflorescence,lateral,leaf,less,like,lobe,long,main,major,margin,middle,minor,minutely,mm,often,older,opposite,ovary,ovate,ovoid-reniform,pair,pale,papillose,pedicel,petiole,pitted,plant,portion,prominent,proximal,pubescent,raised,red-papillose,rest,shape,shrub,slender,slightly,small,specimen,stem,style,surface,tan,tapering,tree,trichome,tube,uniseriate,unit,vein,white,widest,x,young	/3,0.5,1-1.7,1-3,1.5-5,3-9,3/4,9-16,anthesi,apart,beginning,broadly,bud,closely,conspicuous,cup-shaped,differentiated,differing,eaf,edicel,eed,ellipsoid,erect,exserted,flattene,fragrant,fruiting,geminat,greyish-brow,inflorescenc,live,lobed,lon,lower,minute,much,narrowly,nflorescence,one,outline,papillo,pore,poricidal,reflexed,rhomboidal,rounded,ruit,scar,shaped,size,soon,spaced,stigma,straight,strongly,sweetly,swelling,tall,tear-drop,tip,ud,unevenly,way,woody,ympodial	abaxial,adaxial,arrangement,branching,colour,diameter,form,fruit,geminate,greyish-brown,height,history,length,life,mentioned,midvein,peduncle,primary,pseudostipule,rachi,seed,staman,sympodial,tertiary,texture,unarmed,venation
451	wfo-0001031231	success	175	66	39	136	27	0.223	-2,0.5-1.5,anther,apex,aspect,base,calyx,cell,clonal,colour,corolla,erect,except,filament,general,glabrous,green,habit,hair,lasting,leaf,lobe,margin,minute,ovary,pedicel,peduncle,petal,seed,several,shrub,soft,stone,style,surface,tip,unit,wooded,year	.5,1-1.5,1-2,1-3,1-4,1.5-2,13,2-3,2-4,2.5-3,25-35,3-4,37/2,37/3,4-8,5-7,8-10,80-110,absent,acumen,acuminate,acute,adherent,almost,along,anthesi,aromatic,axi,axillary,basal,becoming,berry,beyond,blunt,bluntly,branch,branched,brown,campanula,campanulate,cluster,cm,dark,declinate,developed,dia,discoidal,eaf,eed,ellipsoid,elliptic,entire,equal,exceeding,exerted,expanded,facetted,fleshy,flower,flowering,folded,fork,glandular,globose,gree,greyish,herbarium,interacuminal,juvenile,lanceolate,len,lengthening,less,lon,long,loosely,lower,marbled,mature,mauve,midrib,mm,nflorescence,oblong,occasionally,often,pedice,pedicellate,pentagonal,pinnatisect,plant,plurifoliat,pore,poricidal,projecting,purple,rarely,readily,recurve,rh,ripe,ripening,rotate,rounded,rugose-ruminate,ruit,sessile,shallow,shed,short,simple,sinus,slightly,slit,small,sometimes,specimen,stigma,stonrgly,stout,succulent,tinged,tissue,toward,translucent,triangular,tub,ud,usually,variable,vigorous,violet,well,without,x,ympodial	adaxial,arrangement,branching,characteristic,diameter,form,fruit,growth,history,inflorescence,length,life,midvein,petiole,plurifoliate,primary,pseudostipule,rachi,shape,staman,stem,sympodial,tertiary,texture,unarmed,vein,venation
452	wfo-0001031252	success	170	121	89	81	32	0.524	0.2-1.5,0.3-1.1,1-2,1.3-1.9,1.75-5.2,16-33,2-3,2.8-3.6,3-10,3-5,3-6,5-8,5.5-6.5,7-18,abaxially,acumen,acute,adaxially,anther,apart,apex,articulated,attenuate,base,berry,brownish,cell,ciliate,cm,condition,corolla,covering,cuneate,dark,deep,diameter,digestion,distal,drying,elliptic,entire,enzyme,filament,fresh,fruit,glabrous,globose,green,green-white,greenish,half,herb,high,honeycomb-shaped,lanceolate,lateral,light,linear,lobe,long,make,margin,medium,mm,mottled,mucilaginous,ovate,ovoid,pedicel,peduncle,petiole,plant,purple,removed,ripe,rounded,seed,serrate,sometimes,spaced,stripe,style,testal,thick,throughout,wall,wet,white,whitish	0.4-3,1-3,12-20,2.5-7,5-17,5-9,5-merou,absent,adaxiall,ag,along,alyx,apparently,arranged,axe,axillary,bead,blade,bud,capitat,clavate,connivent,coriaceous,dorsally,eaf,edge,eed,erec,exceeding,flat,flower,folded,forked,geminat,generally,glabrou,hair-like,hal,homostylous,interjected,leaflet,lengthening,like,living,lower,moniliform,multiple,necklace,nflorescence,orolla,perfect,plurifoliate,pore,poricidal,rotate,ruit,seudostipule,simple,slit,specimen,stamen,stigma,stolon,straight,subtending,tall,tamen,tem,terminal,tip,tri-,tube,tuber,typically,unit,unwinged,usually,vary,x,yellow,ympodial	'hair-like,abaxial,adaxial,arrangement,branching,calyx,characteristic,colour,form,growth,height,history,inflorescence,leaf,length,life,midvein,null,ovary,primary,pseudostipule,rachi,shape,staman,stem,surface,tertiary,texture,true,unarmed,vein,venation
453	wfo-0001031257	success	206	155	124	82	31	0.602	-12,-6,0,0.5-0.8,0.7-1,0.75-2.5,1-1.3,1.1-1.2,1.5-1.7,11.5-15,2-4.5,3.5-5.7,4-10,5-8.5,7.5-9,8,abaxially,abundant,acuminate,adaxially,aggregate,anther,anthesi,antrorse,apex,ascending,attenuate,basal,base,berry,blue-violet,broad,bud,calyx,cell,cm,coarsely,coat,corolla,cotyledon,cuneate,curved,dark,deep,densely,dentate,diameter,directed,edentate,embryo,endosperm,epidermal,erect,filament,flexuous,free,glabrous,glandular,globose,hair-like,half,herb,herbaceous,honey-combed,lamina,lateral,leaf,length,light,little,lobe,long,longer,many-seeded,margin,midvein,mm,narrowly,non-glandular,outward,ovate,pair,patent,pericarp,petiole,portion,pubescent,purple,rarely,rest,ring,robust,scarce,secondary,seed,serrate,short-stalked,shorter,shrub,sinus,small,solitary,somewhat,stem,stone,strand,striate,style,subglobose,thickened,thickening,tooth,trans-ovoidal,triangular,trichome,tube,unequal,upward,vein,wall,white,within,x,yellow	-22.5,-5,0.4,0.5,1-1.2,1.5,1.5-2,1/10,10-16,2-,3,3.5-,4-4.5,4.5-,5,5-,6-12,6-celled,7-,8-celled,accrescen,ag,bicellular,branch,campanulate,connectival,cuticle,diamete,difoliate,dorsally,eaf,eed,ellipsoidal,elliptical,finely,foliage,fruiting,geminat,head,high,hollow,inconspicuous,inserted,like,lon,long-stalked,longitudinal,longitudinally,lower,odorles,opening,orolla,papillate,pore,poricidal,prolongation,reduced,ree,ridged,ruit,saddle-shape,scarcely,separated,simple,single-celled,slightly,slit,smooth,spur-like,stalk,stigma,tem,thecae,time,tip,unit,vary,ventrifixed,verrucate,viscid,viscid-pubescen,ympodial	3.5-4.5,abaxial,adaxial,arrangement,branching,characteristic,colour,form,fruit,geminate,growth,height,history,inflorescence,life,null,ovary,pedicel,peduncle,plant,primary,pseudostipule,rachi,shape,staman,surface,tertiary,texture,unarmed,venation,viscid-pubescent
454	wfo-0001031270	success	234	194	173	61	21	0.739	+,.5,0.4-1.5,0.5-1,1,1-1.2,1-4,1.2-1.6,1.5,10,10-12,100,2-2.5,2-20,2-3,2-4,2.5-3,3-10,3-20,3-5,4-5,5,5-15,5-6,6-17,6-50,8,9-10,>,abaxial,accrescent,acute,adaxial,along,anther,anthesi,apart,apex,articulated,associated,basal,base,berry,bipinnatifid,bright,brown,calyx,cell,celled,cm,colored,conical,curved,deeply,densely,depressed-spherical,diameter,differentiated,elliptic,entire,few-rayed,filament,flower,free,fruiting,glabrous,gland,glandular,glandular-pubescent,growth,heavily,herb,inflorescence,infructescence,investing,lateral,leaf,leaf-opposed,length,like,lobe,lobed,long,long-styled,longer,margin,midpoint,midvein,minute,minutely,mixture,mm,multangulate,multiseriate,narrowly,new,obovate,occasionally,often,outline,ovoid,pair,pale,pedicel,peduncle,per,pericarp,petiole,pinnatifid,pitted,plant,prickle,prickly,primary,pubescent,rachi,ray,red,reddish,reflexed,reniform,rest,ripe,rounded,scar,scattered,secondary,sessile,shallow,shallowly,shining,short-stalked,short-styled,shrub,simple,single,sinuate,size,slender,slightly,small,sparsely,spherical,spreading,stalk,stellate,stem,straight,straw-colored,strongly,style,surface,tan,terete,testal,thin,thus,tightly,tissue,trichome,truncate,tube,uniseriate,usually,varying,vein,well,white,wide,wing,woody,yellow,yellowish	1-3,1.5-2,1/3,2-7,5-10,5-merous,7-12,abaxially,adaxiall,alyx,arme,bark,beginning,blade,brow,c.,capitate,clavate,connivent,consistently,difoliate,directed,distal,eed,ellipti,equal,erect,frui,geminat,green,heterostylous,later,leafy,live,lon,loosely,lower,membranous,nflorescence,older,orolla,oung,papillo,pore,poricidal,portion,ruit,staminat,stigma,tall,tamen,tapering,tip,unit,upward,vary,way,wice,wid,ympodial,Â½	armed,arrangement,branching,characteristic,colour,corolla,form,fruit,height,history,life,null,ovary,pseudostipule,seed,shape,staman,tertiary,texture,unarmed,venation
455	wfo-0001031283	success	52	80	40	12	40	0.769	0.4-0.5,0.5-0.7,0.7,2.2-2.8,30-40,acute,apex,appearance,base,brown,calyx,cell,cm,diameter,elongating,erect,fruit,give,hair-like,lateral,lobe,long,markedly,mm,narrowly,outgrowth,pale,pubescent,shrub,silky,small,somewhat,sprawling,surface,tall,testa,thick,wall,wide,winged	-0.25,.7-2.3,0.1-0.15,eed,fide,lo,moore,obovate,pleasant,smelling,spreadin,woody	1.7-2.3,abaxial,adaxial,anther,arrangement,branching,characteristic,colour,corolla,filament,form,growth,height,history,inflorescence,leaf,length,life,margin,mentioned,midvein,ovary,pedicel,peduncle,petiole,plant,primary,pseudostipule,rachi,seed,shape,spreading,staman,stem,style,tertiary,texture,unarmed,vein,venation
456	wfo-0001031287	success	147	119	87	60	32	0.592	.5,0.5-1.5,0.9-1,1,1-1.2,1-1.5,1-5,1.5-2,2-2.5,3-4,3-5,4-5,4-6,4.5-5,6-10-flowered,6-7,abaxially,acute,adaxially,anther,anthesi,apex,attenuate,axil,base,bearing,berry,calyx,cm,conical,connective,corolla,dark,deltate,dendritic,dia,difoliate,elliptic,enlarged,erect,filament,fleshy,free,glabrous,globose,green,greenish-white,knob,lateral,leaf,lobe,long,main,margin,minutely,mm,onto,ovary,ovoid-reniform,pair,pale,papillose,pedicel,petiole,pitted,plurifoliate,portion,pubescent,rounded,shrub,simple,small,somewhat,spaced,stem,style,surface,tan,thick,trichome,tube,tuft,unevenly,vein,white,winged,x	1-1.3,1.5-5.5,5-14,apar,ape,bark,bi-lobed,branch,coriaceous,deflexed,densely,divergently,eaf,edicel,eed,ellipsoid,elongate,exserted,frui,fruiting,geminate,internodal,lamina,later,lobed,lon,lower,many,membranous,middle,nearly,nflorescence,occasionally,older,papillo,planar,pointed,pore,poricidal,red-papillose,reddish-brow,reflexed,ruit,scar,shaped,shoot,short,sinus,stigma,strongly,tear-drop,thin,tip,tub,ud,unit,widest,woody,ympodial,young	abaxial,adaxial,apart,arrangement,branching,characteristic,colour,diameter,form,fruit,growth,height,history,inflorescence,length,life,midvein,null,peduncle,plant,primary,pseudostipule,rachi,reddish-brown,seed,shape,staman,tertiary,texture,true,unarmed,venation
457	wfo-0001031300	success	219	194	169	50	25	0.772	-2.2,-4,-5,-6,.5,0-15,0-20,0-3,0-8,0.1-0.5,0.1-0.6,0.2-0.4,0.2-0.5,0.2-0.7,0.2-1,0.3,0.3-0.6,0.3-1.3,0.5-0.9,0.5-1.5,0.5-18,0.5-2,0.6-1,0.6-1.2,0.7-0.9,0.7-1.2,0.8-1.5,1-2,1-4,1-5,1.5-3.5,1/2-3/4,1/6-1/4,2-,2-3,2-4,2-5.5,2-6,2.2-2.3,2.2-2.7,2.5-3.2,3-4,5-15,absent,acute,also,anther,apart,apex,apically,apparently,articulated,attenuate,bark,base,berry,blade,branched,brown-green,calyx,cell,chartaceous,cm,concolorous,creeping,curved,deltate,densely,diameter,difoliate,distance,drying,dull,erect,extending,eye,filament,filiform,flattened,flattened-reniform,flower,free,fruit,geniculate,glabrescent,glabrous,gray-green,hair,highly,infructescence,lateral,leaf,length,lobe,lobed,long,longer,margin,maturity,membranous,midpoint,midvein,minute,mm,moderately,naked,near,oblanceolate,oblong,obtuse,older,one,open,orange,orange-brown,orange-green,outline,pair,pale,pedicel,peduncle,per,pericarp,petiole,pit,porrect,portion,prickle,prickly,primary,pubescent,raised,rarely,ray,red,reduced,rounded,shrub,side,simple,small,smooth,spaced,sparsely,spherical,stalk,stalked,stellate,stellate-pubescent,stem,style,surface,terete,tertiary,thin,time,trichome,uniradiate,vein,venation,visible,weakly,white,wide,wider,winged,yellow,yellow-green,yellow-orange	/4,0.1,0.15-0.7,0.6-0.8,1.2-1.7,1.3-2,1/3-1/2,10-30,3-,4,4.5-6,5-merous,6-8,abaxially,alyx,apar,ba,brow,bulbous,caudat,connivent,eaf,eed,elongating,equal,fruiting,geminat,herbaceous,lon,lower,mature,nflorescence,orolla,oung,pendulous,perfec,poricidal,prickl,ruit,scar,sessile,spreading,tamen,tapering,tip,tube,unit,vary,way,ympodial	abaxial,adaxial,arrangement,branching,brown,characteristic,colour,corolla,form,geminate,growth,height,history,inflorescence,life,null,ovary,plant,pseudostipule,rachi,seed,shape,staman,texture,unarmed
458	wfo-0001031310	success	203	179	150	53	29	0.739	.5,0-3,0-4,0.5-3,1-10,1-2,1-3,1-5.5,1-6,1.5-4,15-40,2-3,2.5-5.5,2.5-8.5,3-10,4-10,4-12,4.5-4.8,5-6,5-7,5.5-21,6-7,abaxially,absent,acumen,acuminate,adaxially,anther,apart,apex,apparently,articulated,attenuate,axe,axillary,base,berry,blade,blue,blue-purple,broadly,brown,brownish,bud,cell,chartaceous,cm,condition,conspicuously,corolla,covering,cuneate,decreasing,decurrent,diameter,digestion,distal,drying,elliptic,enzyme,exceeding,extremely,filament,flower,forked,fresh,fruit,generally,glabrous,globose,gradually,green,green-white,greenish,hair,hair-like,half,herb,high,honeycomb-shaped,interjected,larger,lateral,leaf,leaflet,less,light,like,lobe,long,make,margin,membranous,mm,mottled,mucilaginous,multicellular,narrowly,obtuse,odd-pinnate,ovate,ovate-elliptic,ovate-lanceolate,ovoid,pair,pale,pedicel,peduncle,perfect,petiole,petiolule,pilose,plant,pointed,pubescent,purple,rachi,removed,rosette-forming,seed,shortly,simple,size,slightly,small,sometimes,somewhat,spaced,sparsely,stamen,stem,straight,streak,style,subrosette-forming,subtending,tall,terminal,testal,thick,throughout,tissue,toward,unwinged,usually,wall,wet,white,whitish,x	5-merou,ag,along,alyx,borne,caly,ciliate,connivent,dorsally,eaf,edge,eed,end,erect-decumben,especially,flat,folded,geminat,glabrou,homostylous,lanceolate,lengthening,living,lower,midrib,minutely,nflorescence,orolla,plurifoliate,pore,poricidal,puberulent,rotate,ruit,seudostipule,singly,slit,specimen,ste,stigma,stolo,subellipsoi,tamen,tem,tip,tri-,tube,tuber,typically,unit,vary,yellow,ympodial	abaxial,adaxial,arrangement,branching,calyx,characteristic,colour,erect-decumbent,form,growth,height,history,inflorescence,length,life,midvein,null,ovary,primary,pseudostipule,shape,staman,surface,tertiary,texture,true,unarmed,vein,venation
459	wfo-0001031316	success	207	146	121	86	25	0.585	-2,0.3-1,0.5-2,0.6-1,0.8-1.2,0.8-1.8,0.9-1.3,1-5,1.5-2,1.5-3.5,1.5-5,1/3-1/2,2-20,2-3,2-4,3-8,3.5-3.8,3.8-5,4-7,5-10,5-6,5-8,6-20,8-11,abaxial,acuminate,acute,adaxial,almost,anther,apex,apically,apparently,articulated,base,berry,blade,blue-mauve,branched,bright,calyx,cm,colored,concolorous,contrast,curved,dark,densely,diameter,difoliate,discolorous,drying,dull,entire,erect,eye,fifth,filament,flattened-reniform,flower,fruit,glabrescent,glabrous,gray,infructescence,lateral,leaf,length,lobe,long,margin,maturity,membranous,mm,moderately,multangulate,naked,narrow-deltate,obtuse,one,open,orange,orange-brown,ovate,pair,pedicel,peduncle,per,petiole,porrect,primary,purple,red-brown,sessile,shrub,slender,sometimes,spherical,stalked,stellate-pubescent,stem,strongly,style,surface,terete,terminal,tertiary,time,trichome,unarmed,unit,usually,vein,venation,visible,white,white-green,whitish,wide,yellow,yellow-green	.1,/3,0.05-0.1,0.05-0.15,0.1-0.2,0.4-0.6,0.4-0.8,1.2-2.1,1.3-3.5,1.5-,1/3-2/3,2.5-8,3-10,4,4-9,5-15,5-merous,8-12,8-25,abaxially,alyx,ame,apar,bark,becoming,broad,c.,connivent,cream,eaf,eed,elongating,foliaceou,four,free,fruiting,geminat,glabrou,green,hair,held,herbaceous,inward,lobed,long-acuminat,longer,lower,lowermost,marking,mature,midpoint,minute,nflorescence,older,orolla,oung,pale,pendulous,perfec,pericarp,poricidal,portion,ray,red-brow,reflexed,ruit,scar,simple,smooth,spaced,sparsely,spreading,stalk,stellate,stellate-pubescen,tamen,tapering,tip,tube,unarme,unequal,variously,vary,way,ympodial,young	arrangement,branching,characteristic,colour,corolla,form,geminate,growth,height,history,inflorescence,life,long-acuminate,midvein,null,ovary,plant,pseudostipule,rachi,seed,shape,staman,sympodial,texture,true
460	wfo-0001031333	success	194	146	115	79	31	0.593	+,.5,0.5,1-1.5,1-4,1-5,1.2-2,1.5,1.5-2,2,2.5-3,2.7-7,3-4,30-40,5-7,50,7-10,7-9,<,>,?,acuminate,acute,adjacent,almost,anther,apex,base,berry,branched,broadly,brown,calyx,cm,densely,diameter,elliptic,entire,filament,flattened,flower,glabrescent,glabrous,globose,golden,green,greenish,growth,half,immature,inflorescence,lamina,less,like,lobe,long,lower,many,margin,matte,mere,minutely,mm,narrowly,new,occasionally,older,outline,ovate,pair,pale,pedicel,peduncle,per,pericarp,petiole,pitted,primary,pubescent,quadrate,reniform,rest,simple,sinus,somewhat,soon,sparsely,splitting,stem,style,surface,terminal,testal,thin,time,trailing,triangular,trichome,truncate,tube,twining,undersurface,undulation,unevenly,uniseriate,unit,upper,vein,venation,vine,white,whitish,woody,x,yellowish	0.1-0.5,1.5-1.7,1/2,2-3,3/4,5-8,5-merou,abaxially,adaxiall,adaxially,ag,alyx,anthesi,apart,appearing,ark,articulated,bilobed,branche,capitate,cell,clustered,collection,composed,conical,crea,cupped,denser,eaf,eed,ellipsoidal,exserted,free,fruting,glabrescen,high,ilament,leaving,lengthening,lobed,m.,membranous,minute,near,nflorescence,nodding,orolla,papillat,peg,penden,pentagonal,perfect,planar,plurifoliat,pore,poricidal,portion,pubescent-papillate,rhachi,ruit,scar,slightly,slit,small,ste,stellate,stigma,striped,strongly,tangled,tem,thickened,tip,ud,unequal,vary,way,yellow,ympodial	2.5,abaxial,adaxial,arrangement,bark,branching,characteristic,colour,corolla,cream,form,fruit,height,history,leaf,length,life,mentioned,midvein,ovary,plant,plurifoliate,pseudostipule,rachi,seed,shape,staman,sympodial,tertiary,texture,unarmed
461	wfo-0001031333	success	194	164	134	60	30	0.691	+,.5,0.1-0.5,0.5,1-1.5,1-4,1-5,1-5-2,1.5,1.5-2,2-3,2.5-3,2.7-7,3-4,30-40,5-7,50,7-10,7-9,<,>,?,abaxially,acuminate,acute,adjacent,almost,anther,anthesi,apart,apex,articulated,base,berry,branched,broadly,brown,calyx,cell,clustered,cm,composed,corolla,cream,densely,denser,diameter,elliptic,entire,filament,flattened,flower,glabrescent,glabrous,globose,golden,green,greenish,growth,half,high,immature,inflorescence,lamina,leaving,less,like,lobe,long,lower,many,margin,matte,mere,minutely,mm,narrowly,near,new,nodding,occasionally,outline,ovate,pair,pale,pedicel,peduncle,peg,per,pericarp,petiole,pitted,primary,pubescent,quadrate,reniform,rest,rhachi,scar,simple,sinus,small,somewhat,soon,spaced,sparsely,splitting,stem,style,surface,terminal,testal,thin,time,tip,trailing,triangular,trichome,truncate,tube,undersurface,undulation,unevenly,uniseriate,unit,upper,vein,venation,vine,white,whitish,wide,woody,yellowish	1.5-1.7,1/2,2,3,3/4,5-8,5-merou,adaxiall,adaxially,ag,alyx,appearing,bark,bilobed,branche,capitate,conical,cupped,eaf,eed,ellipsoid,exserted,free,fruiting,glabrescen,ilament,lengthening,lobed,m.,membranous,minute,nflorescence,older,orolla,papillat,penden,perfect,planar,plurifoliat,pore,poricidal,portion,pubescent-papillate,rotate-stellate,ruit,slightly,slit,stellate,stigma,striped,strongly,tangled,thickened,tub,twinin,ud,unequal,vary,way,ympodial	abaxial,adaxial,arrangement,branch,branching,characteristic,colour,form,fruit,height,history,leaf,length,life,mentioned,midvein,ovary,plant,plurifoliate,pseudostipule,rachi,seed,shape,staman,sympodial,tertiary,texture,true,twining,unarmed
462	wfo-0001031359	success	166	123	90	76	33	0.542	.02,.25,.5,0.5-1,0.5-6,0.75-1,1-4,1.1-1.6,1.2-1.6,1.2-2.5,1.3-1.6,1.5-2,2.5-3,3-3.5,5-7,6-7,acuminate,anther,apex,apiculate,attenuate,base,beneath,berry,broadly,brown,calyx,cm,corolla,dark,deflexed,difoliate,dull,elliptic,filament,flattened-reniform,free,glabrous,globose,green,incrassate,lateral,leaf,live,lobe,long,main,major,margin,minor,minutely,mm,narrowly,nearly,older,opposite,outline,ovary,pair,paler,papillose,pedicel,petiole,pit,pitted,plant,portion,ripe,round,shiny,shrub,simple,slender,stem,style,surface,tan,tapering,triangular,trichome,tube,tuft,uniseriate,unit,vein,white,x,yellow,yellow-orange,young	/4,1.6-2.8,1.9-2.3,12-21,3.6-8.8,5-30-flowered,5-angled,5.3-7.5,angle,anthesi,apart,appearing,axil,ba,bark,beginning,bi-lobed,curled,dia,differing,distal,dried,eaf,edicel,eed,evenly,extending,fruiting,geminat,inflorescenc,internodal,interpetalar,lamina,lobed,lon,lower,membraneous,middle,near,nflorescence,obovoid,occasionally,often,one,originating,papillae,papillo,planar,pore,poricidal,reflexed,ridged,ruit,rusty,scar,shaped,sinus,size,slightly,somewhat,spaced,specimen,stigma,straight,strongly,tall,tear-drop,tip,tub,ud,undulate,way,white-lenticellat,widest,woody,ympodial	abaxial,adaxial,arrangement,branching,characteristic,colour,description,diameter,form,fruit,geminate,growth,height,history,inflorescence,length,life,mentioned,midvein,peduncle,primary,pseudostipule,rachi,seed,shape,staman,sympodial,tertiary,texture,true,unarmed,venation,white-lenticellate
463	wfo-0001031362	success	138	108	78	60	30	0.565	.2,.3,.5,0.5-1,1-1.1,1-1.5,1-4,1.5-2,2-2.5,3-4,3-6,?,abaxially,acute,adaxially,anther,apex,attenuate,bark,base,berry,brown,calyx,cell,closely,cm,corolla,dendritic,densely,filament,flattened-reniform,glabrous,globose,incrassate,internodal,lanceolate,lateral,leaf,lobe,long,long-triangular,main,margin,minutely,mm,nodding,older,opposite,orange-red,outline,ovary,packed,pair,pale,pedicel,pericarp,petiole,pitted,pubescent,pubesent,rectangular,red,rounded,shiny,shrub,simple,somewhat,sparsely,stem,style,subshrub,surface,tan,thin,trichome,vein,white,x	0.4-0.5,0.7-1,1-3,1-3-flowered,along,anthesi,appearance,branch,bushy,conical,denser,dia,eaf,edicel,eed,ellipsoid,erect,exceeding,exserted,flattened,free,fruiting,giving,golden,golden-brow,inflorescenc,lamina,like,lobed,lon,lower,middle,nearly,nflorescence,overlappin,papillo,papillose,planar,plurifoliat,pore,poricidal,portion,rest,ruit,scar,shaped,slender,small-capitate,spaced,stigma,straight,tear-drop,tip,tube,ud,unit,widest,woody,ympodial,young	abaxial,adaxial,arrangement,branching,characteristic,colour,diameter,form,fruit,golden-brown,growth,height,history,inflorescence,length,life,midvein,null,peduncle,plant,primary,pseudostipule,rachi,seed,shape,staman,tertiary,texture,unarmed,venation
464	wfo-0001031400	success	161	125	90	71	35	0.559	0.25-0.8,0.7-6,0.8-1.1,1-4,1.2-2,1.5-5,10-11,2,2-3,2-5,4-17,4-6.5,4-7,7-28,abaxial,abaxially,acute,adaxially,apex,apiculate,articulate,base,branched,calyx,cell,cm,corolla,covering,cyme,dark,decurrent,deeply,diameter,dichasial,dichasially,distal,ebracteate,exceeding,filament,flower,forked,generally,globose,green,green-white,half,herbaceous,lateral,leaf,linear,linear-lanceolate,lobe,long,make,mm,monochasial,mucilaginous,oblique,oblong,odd-pinnate,ovoid,pedicel,peduncle,perennial,perfect,petiole,plant,proximal,puberulent,rachi,seed,side,stamen,stigma,straight,stripe,style,subglabrous,testal,thick,throughout,tip,tone,tuber-bearing,typically,unit,violet,wall,white,Â¼	-3,0.4-1.7,0.6-1.8,1,1-,2-9,3-6-foliat,4-,4-13,5-12.5,6-23,7-25,abruptly,absen,acumen,apical,apically,connate,cuneate,dehiscent,digestion,diminishing,dorsally,eaf,edge,eed,emoval,enzyme,flat,folded,forming,globo,hair-like,honeycomb,interjected,introrse,leaflet,living,lon,lower,lunat,maturing,nflorescence,nther,occasionally,often,orolla,pair,pattern,plan,poricidally,reveal,ruit,sessile,seudostipule,short,size,slit,specimen,stellate,structure,tal,tem,terminal,toward,trilobe,vary,wide,without,yellow,ympodial	'hair-like,2-23,3-6-foliate,adaxial,anther,arrangement,branching,characteristic,colour,form,fruit,growth,height,history,inflorescence,length,life,lunate,margin,mentioned,midvein,ovary,primary,pseudostipule,shape,staman,stem,surface,sympodial,tertiary,texture,unarmed,vein,venation,wet
465	wfo-0001031401	success	182	156	130	52	26	0.714	0.5,0.6-1.2,1,1-1.4,1-1.5,1-6,1.5-2,2-2.4,2-5,2.5-4,3,3.5-4,5,5-7,7-9,8-10,abaxial,abaxially,acute,adaxial,adaxially,anther,anthesi,apex,apical,appearing,axi,bark,basal,base,berry,black,blade,branch,branching,brown,calyx,clearly,cm,corolla,dark,deciduous,deltoid,dendritic,densely,diameter,dichasial,differentiated,drying,ecuador,ecuadorian,elliptic,filament,finely,flattened,flower,fork,fruit,glabrous,globose,golden,growth,impressed,inserted,lateral,leaf,lenticular,lobe,long,long-triangular,matted,mesophyll,minutely,mm,narrowly,near,new,nodding,node,occasionally,often,older,outline,ovary,overtopping,pair,pedicel,per,pericarp,petiole,pitted,plurifoliate,pubescent,purplish-black,pyramidal,reddish-brown,rounded,roundish,secondary,shiny,shoot,short,shrub,sleev,small,sometimes,somewhat,specimen,stem,strongly,style,surface,tapering,terminal,thin,time,tree,tree-like,trichome,unit,usually,vein,violet,visible,white,wide,winged,x,yellow,young	0.8-1.2,1.1-3,1/2,3/4,5-9,age,along,attenuate,becoming,bi-lobed,conical,deflexed,denser,eaf,edicel,eed,ew,exserted,free,fruiting,golden-yellow,less,lobed,lower,m.,monochasia,nflorescence,noddin,papillo,planar,pore,poricidal,portion,prominently,puberulent,pubescen,raised,ruit,scar,slit-like,sparsely,stamen,ste,stigma,tall,tip,tub,tube,ud,way,woody,ympodial	arrangement,characteristic,colour,form,height,history,inflorescence,length,life,margin,midvein,monochasial,null,peduncle,plant,primary,pseudostipule,rachi,seed,shape,staman,sympodial,tertiary,texture,unarmed,venation
466	wfo-0001031480	exception_thrown	237	0	0	237	0	0.0		-0.25,-2,/3,0,0-0.5,0-1,0-2,0-30,0-5,0.1,0.1-0.3,0.1-0.4,0.15-0.3,0.2-0.35,0.4,0.4-0.8,0.5-,0.5-2,0.6-0.8,0.7,0.8,0.8-1,1-1.3,1-1.5,1-2,1-3,1-4,1.5-2.2,1.7-2.2,1.8-3,1/2,1/3,1/4,1/6-1/5,2-,2-2.7,2-3,2-5,2-6,3,3-10,3-6,3-7,3.5-7,4-5,4-6,5-8,5-merous,6-13,6-30,6-8,7-8,8-12,abaxial,abaxially,acuminat,acute,adaxial,alyx,andromonoecious,anther,apar,apart,apex,apically,apparently,articulated,ba,bark,base,berry,blade,branched,branching,bright,broad-deltate,calyx,cell,cm,cream,cuneate,curved,dark,deltate,densely,diameter,difoliate,discolorous,distal,distance,drying,dull,eaf,eed,ellipsoid,elongate,elongating,entire,equal,erect,extending,eye,faint,filament,flattened,flattened-reniform,flower,free,fruit,fruiting,geminat,glabrescent,glabrous,glandular,green,hair,hermaphrodite,heterostylous,inconspicuous,infructescence,lateral,leaf,length,lobe,lobed,long,long-styled,longer,lower,lowermost,margin,marking,mature,maturity,mauve,midpoint,midvein,minutely,mm,moderately,naked,near,nflorescence,obtuse,often,older,one,open,orange-brown,orolla,oung,outline,ovate,pair,pale,pedicel,peduncle,pendulous,per,pericarp,persistent,petiole,pit,plant,poricidal,porrect,portion,prickle,prickly,primary,pubescent,purple,raised,ray,red,red-brow,red-brown,red-green,red-yellow-green,reduced,reticulate,rounded,ruit,scandent,scar,sessile,shallowly,short-styled,shorter,shrub,side,simple,slender,slightly,small,smooth,somewhat,spaced,sparsely,spherical,spreading,stalk,stalked,staminat,stellate,stellate-pubescent,stem,straight,style,surface,tamen,tapering,terete,terminal,tertiary,thick-chartaceous,time,tip,trichome,truncate,tube,unarme,unarmed,unit,upper,variously,vary,vein,venation,visible,way,weakly,wide,woody,yellow,ympodial,young	
467	wfo-0001031483	success	154	118	83	71	35	0.539	.5,/2,0.5,0.5-2,1-2,2-2.5,3-4,3-8-flowered,6-10,7-10,across,acuminate,acute,almost,anther,apex,attenuate,base,bearing,beneath,berry,ca,calyx,cm,corky,corolla,decurrent,deltoid,dia,difoliate,distal,dry,end,filament,filiform,flower,free,fresh,glabrous,green,indistinct,lateral,leaf,lenticellate,linear,lobe,long,main,mm,oblanceolate,obovate,often,opposite,ovary,ovoid-reniform,pair,pale,paler,pedicel,petiole,pointed,portion,prominent,raised,shape,short-triangular,shrub,simple,slender,stem,straight,style,subshrub,tan,tapering,third,tube,turbinate,unit,vein,way,white,x	0,1,1.1-2.5,1.2-1.4,1.7-5.5,1/3,11-20.5,2-3,2.5-3.2,anew,anthesi,apart,ba,beginning,blade,caly,clavate,continuous,cork,deflexed,eaf,edicel,eed,evenly,exserted,fruiting,fusiform,geminat,indistinc,internode,larger,lea,less,lobed,lower,major,markedly,minor,minutely,nflorescence,oblong,obovoid,orbiculate,papillo,papillose,per,planar,pore,poricidal,quite,rounded,ruit,scar,shaped,short,slightly,somewhat,soon,spaced,stigma,strongly,tall,tear-drop,tip,ud,variable,widest,wing,winged,woody,ympodial	-4,abaxial,adaxial,arrangement,branching,characteristic,colour,diam,diameter,form,fruit,geminate,growth,height,history,inflorescence,length,life,margin,midvein,null,peduncle,plant,primary,pseudostipule,rachi,seed,staman,surface,sympodial,tertiary,texture,true,unarmed,venation
468	wfo-0001031492	success	175	143	115	60	28	0.657	.5,0.5,0.7-1.3,0.9-1.1,1-1.3,1-1.5,1.5-1.8,1.5-2.5,10-15,2-10,2-3,2-5,20,3-4,3-5,4-4.5,6-8,8-11,8-9,abaxially,acuminate,acute,adaxially,anther,anthesi,apex,apical,attenuate,basal,base,beneath,berry,bitter,branching,calyx,cm,conical,corolla,dark,dbh,decurrent,deltoid,dendritic,densely,diameter,drying,echinoid,elliptic,filament,flattened,flower,free,fruit,glabrous,globose,golden,grey,growth,inserted,juice,lamina,leaf,lenticular,lightly,lobe,long,medium,minutely,mm,narrowly,nodding,occasionally,ovary,pair,pedicel,per,pericarp,petiole,pitted,plurifoliate,portion,predominantly,pubescent,purplish-black,pyramidal,reddish-brown,remaining,scattered,secondary,shiny,shrub,size,sleeve,slightly,sparsely,stem,sticky,style,sunken,surface,tapering,terminal,thin,time,tree,tree-like,trichome,undersurface,unit,vein,violet,wide,winged,x,younger	/4,08,1.3-2,4-10,absent,age,appearing,axe,ba,bark,becoming,bi-lobed,deciduous,denser,distinguishable,dull,eaf,edicel,eed,erect,ew,exserted,fruiting,lateral,lobed,lower,m.,monochasia,nflorescence,older,overtopping,papillo,planar,pore,poricidal,prominent,rather,ruit,scar,scarcely,shoot,short,slit-like,sometimes,somewhat,stamen,ste,stigma,strongly,tall,tip,tub,tube,ud,upper,upturned,way,woody,ympodial,young	abaxial,adaxial,arrangement,characteristic,colour,form,height,history,inflorescence,length,life,margin,midvein,monochasial,null,peduncle,plant,primary,pseudostipule,rachi,seed,shape,staman,sympodial,tertiary,texture,unarmed,venation
469	wfo-0001031503	success	142	133	96	46	37	0.676	-10,-15,-30,-7,0.3-3,0.5-1,0.5-4,1-2.5,1-3,1-5,1-7,1.5-2,1.5-3,1.5-8,2-3,2.5-10,3-4,3-5,3-6,5613,6-7,7-10,abaxially,abruptly,acuminate,acute,adaxially,aggregate,angled,apart,apex,articulated,axe,base,branched,calyx,cell,cm,cuneate,curled,decurrent,deltate,densely,diameter,distally,eglandular,elliptic,entire,fide,flower,forked,glabrous,gland,globose,hair,lobe,margin,mm,moderately,narrowed,obtuse,occasionally,often,orange,ovate,pedicel,peduncle,perfect,petiole,present,puberulent,pubescent,rachi,radiu,rarely,reddish,ripe,rounded,rugose-pubescent,shrub,slightly,spaced,sparsely,stalked,stone,style,tip,truncate,unbranched,unequal,uniseriate,unit,vein,venturi,white,x	-25,-6,1-,1.5-7,1.7-3.5,10-19,3-15,6-many-foliat,7-15,absen,ba,blade,chartaceous,connivent,cylindrical,directed,distall,eaf,eed,except,lanceolate,long,lower,mostly,narrowly,nflorescence,nther,orolla,pore,ruit,simple,stellate,stigma,subcapitat,subclavate,tal,tem,time,toward,triangular,tube,usually,vary,wide,yellow,ympodial	6-many-foliate,abaxial,absent,adaxial,anther,arrangement,branching,characteristic,colour,corolla,filament,form,fruit,growth,height,history,inflorescence,leaf,length,life,midvein,null,ovary,plant,primary,pseudostipule,seed,shape,staman,stem,surface,sympodial,tertiary,texture,true,unarmed,venation
470	wfo-0001031586	success	167	118	89	78	29	0.533	-2,0.1-1,0.5-1,1-1.2,1-1.5,1-2,1.4-2.5,1.5-2,2,2-2.5,5-10,5-6,7-10-flowered,abrupt,acute,anther,apex,apparently,attenuate,base,borne,branch,bright,calyx,cm,completely,corolla,cream-colored,deltate,difoliate,drying,elliptic,filament,fleshy,geminate,glabrous,green,greenish,inflorescence,lateral,leaf,lobe,long,main,margin,minutely,mm,mucro,older,olive,onto,opposite,ovary,overtopping,pair,pale,papillate,pedicel,petiole,prominent,raised,remaining,ridged,rounded,scar,shiny,shrub,simple,slender,small,somewhat,soon,sparsely,stem,style,surface,tall,tapering,thick,thickened,tip,truncate,tube,unit,vein,white,x,yellow,yellowish	.25,0.5-0.8,1,1.3-5,3-11,absent,anthesi,apart,appearing,bark,becoming,beneath,broadly,bud,campanulate,capitate,closer,conical,cucullate,deflexed,dia,differing,distance,eaf,edicel,eed,ellipsoid,exerted,exfoliatin,flower,free,fresh,globose,gree,inflorescenc,know,known,later,leave,lobed,lower,major,material,may,minor,near,nearly,new,nflorescence,notched,occasionally,one,open,paler,papillose,planar,pore,poricidal,portion,present,ruit,shap,shaped,shin,size,sometimes,spaced,stigma,straight,swollen,tear-drop,trichome,trunk,ud,uniseriate,widely,ympodial,young	abaxial,adaxial,arrangement,branching,characteristic,colour,diameter,form,fruit,growth,height,history,length,life,mentioned,midvein,peduncle,plant,primary,pseudostipule,rachi,seed,shape,staman,sympodial,tertiary,texture,unarmed,venation
471	wfo-0001031587	success	142	109	79	63	30	0.556	.5,0.8-1,1.5-2,1.7-2,2-2.5,2-9-celled,3-4,5,6-7,7-9,abaxially,acute,adaxially,anther,apex,attenuate,axi,base,calyx,clavate,cm,corolla,decurrent,deflexed,deltate,dendritic,densely,drying,elliptic-ovoid,erect,filament,fleshy,free,furcate,glabrous,golden-red,inflorescence,irregular,lateral,leaf,like,lobe,long,loose,main,major,minor,mm,mostly,oblique,older,ovary,pair,pale,parallel,pedicel,petiole,portion,pubescent,rarely,reddish-grey,rest,shape,simple,soft,somewhat,stem,style,surface,thick,tree,trichome,tube,uniseriate,vein,white,winged,x,young	1-1.5,10-15,12-16,17-30,2,2/3,6-8,along,anthesi,apart,bark,bi-lobed,broadly,closely,cone,conical,denser,dia,differing,eaf,edicel,eed,elliptic,evenly,exserted,fide,globose,included,know,known,lamina,later,lobed,lower,lowered,middle,minutely,ocasionally,occasional,overlappin,papillate,papillo,perpendicular,persisten,pore,poricidal,rect,ruit,scar,shaped,size,spaced,steinbach,stigma,tall,tear-drop,thickened,tip,tub,ud,verrucose,way,widest	abaxial,adaxial,arrangement,branching,characteristic,colour,diameter,form,fruit,growth,height,history,length,life,margin,mentioned,midvein,occasionally,peduncle,persistent,plant,primary,pseudostipule,rachi,seed,staman,tertiary,texture,unarmed,venation
472	wfo-0001031589	success	222	145	120	102	25	0.541	.5,/6,0-10,0-3,0-30,0.1-0.5,0.2-0.5,0.4,0.5-1,0.55-0.7,0.9-1.3,1,1.2-1.5,1.7-2.5,1.8-2.9,1/3,2-3.5,2.8-4,3-5,3/4,4-6.5,8-30,acute,anther,apex,apically,apparently,articulated,attenuate,base,berry,blade,bright,brown-green,calyx,cell,cm,cream,dark,deltate,densely,diameter,difoliate,dull,elliptic,erect,eye,filament,flattened-reniform,flower,free,fruit,glabrescent,glabrous,gray-green,green,infructescence,lateral,leaf,length,lobe,lobed,long,long-obovate,lower,margin,marking,maturity,mauve,midvein,mm,moderately,naked,narrow-cuneate,occasionally,often,orange-brown,outline,pair,pale,pedicel,per,petiole,pit,plant,portion,prickle,prickly,primary,raised,rounded,scandent,shiny,shrub,simple,small,smooth,solitary,sparsely,spherical,stellate-pubescent,stem,stout,straight,style,subentire,surface,terete,tertiary,upper,vein,venation,visible,white,whole,wide,winged,yellow,yellow-green,young	-0.5,-15,-6,-6.5,0,0-1,0.1,0.15-0.3,0.2-0.4,0.2-3,0.6-1.2,0.7,0.8-2.3,0.9-1.6,1-1.8,1-5,1.5-5,1/3-1/2,1/3-1/4,10-30,2-,2-10,2.5-4.5,2.5-6,3-4,4/5,5-8,5-merous,6-8,8-14,abaxially,alyx,ame,apart,bark,broadly,brow,c.,caudat,chartaceous,concolorous,connivent,density,discolorous,distance,drying,eed,elongating,equal,extending,fruiting,geminat,higher,lengt,lon,longer,mature,membranous,midpoint,multangulate,narrow,nflorescence,oblong,obovate,older,orange-green,orolla,oung,part,pendulous,perfec,pericarp,poricidal,porrect,prickl,ray,reflexed,ruit,sessile,shorter,side,sometimes,somewhat,spaced,spreading,stalk,stalked,stellate,subsessile,tamen,tapering,time,tip,trichome,tube,unit,vary,way,weakly,woody,yellow-orange,ympodial	abaxial,adaxial,arrangement,branching,caudate,characteristic,colour,corolla,form,geminate,growth,height,history,inflorescence,life,null,ovary,peduncle,pseudostipule,rachi,seed,shape,staman,texture,unarmed
473	wfo-0001031609	success	154	122	88	66	34	0.571	0-30,0.4-3,0.5-3,1-10,1-6,1.3-3,1.5-2,1.5-3,10-25,2-,2-3,2.5-4,20-25,3-5,3-9-lobed,4,4-5,4-6,5-25,abaxially,absent,acute,adaxially,aggregate,apex,around,articulated,base,branch,brownish,calyx,cell,cm,conspicuous,contiguous,cuneate,deltate,dia,diameter,emerging,entire,flattened,fleshy,flower,forked,fruit,glabrous,globose,green,inflorescence,leaf,leaving,lobe,lobed,margin,mm,nearly,obovate,obtuse,occasionally,orange,pedicel,pedicellar,peduncle,petiole,pinnately,point,puberulent,rachi,radiu,reticulate,ripe,scar,shallowly,shrub,simple,small,stone,style,succulent,tree,triangular,two,unbranched,unit,unlobed,x,yellow	.5,/4,0.5-1,2,3-24,3-foliat,4.5-60,5/6,8-20,absen,ape,apiculate,axe,barely,beyond,bilobe,blade,brow,campanulate,connective,connivent,dark,dilated,directed,distally,divided,eaf,eed,ellipsoidal,elliptic,elliptic-ovate,equal,exceeding,exserted,glabrou,laterally,long,lower,midrib,minutely,nflorescence,nther,obconical,orolla,papillose,pore,rounded,ruit,sinus,stamen,stellate,stigma,strongly,succulen,tal,tem,thecae,time,tip,tomento,truncate,tube,ud,vary,wide,ympodial	3-foliate,abaxial,adaxial,anther,arrangement,branching,characteristic,colour,corolla,filament,form,growth,height,history,length,life,midvein,null,ovary,plant,primary,pseudostipule,seed,shape,staman,stem,surface,sympodial,tertiary,texture,true,unarmed,vein,venation
474	wfo-0001031615	success	154	121	93	61	28	0.604	.5,0,0.5,0.5-1,0.8-1,0.9-1.1,1-1.6,1.3-1.8,1.5,1.5-5,5-20-flowered,5-6,6-8,8-10,acuminate,anther,apex,axil,bark,base,becoming,berry,brown,calyx,cm,corolla,dark,decurrent,deep,deltoid,dia,elliptic,filament,flattened-reniform,free,fruit,furcate,glabrous,glandular,globose,green,impressed,incrassate,inflorescence,lateral,leaf,less,lobe,long,main,major,margin,middle,minor,minute,minutely,mm,occasionally,older,opposite,ovary,pair,papillae,pedicel,per,petiole,pitted,portion,prominent,shiny,shrub,simple,slender,small,somewhat,stem,style,subumbellate,surface,tapering,tip,tree,trichome,tube,tuft,uniseriate,urceolate,vein,white,widest,winged,x,young	11-15.5,2-3,2-4.2,3.8-6.1,4-6.5,acute,anthesi,arising,attenuate,ba,bilobed,caly,capitate,closely,dark-papillo,deflexed,differing,difoliate,distal,eaf,edicel,eed,expanded,exserted,fruiting,geminat,interpetalar,lamina,lobed,lon,lower,maroo,nearly,nflorescence,one,overlappin,packed,paler,papillose,pore,poricidal,reflexed,ruit,scar,scarcely,shaped,sinus,size,slightly,stigma,straight,tall,tear-drop,terminal,thickened,thin,ud,unicellular,unit,woody,ympodial	abaxial,adaxial,arrangement,branching,characteristic,colour,diameter,form,growth,height,history,length,life,maroon,mentioned,midvein,peduncle,plant,primary,pseudostipule,rachi,seed,shape,staman,tertiary,texture,unarmed,venation
475	wfo-0001031618	success	184	158	126	58	32	0.685	-2,0-3,0.5-1.5,1-1.5,1.5-2,1.5-3.5,10-18,13,2-2.5,2-3,3,3-4,3-8,4-5,40-60,5,5-12,90-110,acuman,acute,almost,also,anther,apex,axil,base,becoming,berry,blunt,branch,broadly,calyx,cell,cluster,cm,column,conical,corolla,covering,cuneate,cyme,darker,discoidal,elliptic,enlarged,equal,except,exerted,facetted,filament,finely,fleshy,floral,flower,fork,forked,glabrous,glandular,greatly,green,greyish,growing,hair,lanceolate,lavender-purple,leaf,less,lobe,lobed,long,lower,marbled,maturity,mauve,may,mid-vein,minute,mm,obovoid,occasional,occur,often,ovary,ovate-lanceolate,ovoid,pale,pedicel,pedicellate,peduncle,petiole,pinatisect,point,purple,reddish-brown,reticulate,rhachi,ripe,rounded,rugose,scorpioid,sessile,shrub,side,simple,single,sometimes,somewhat,specimen,stem,stone,stout,stripe,succulent,surface,tapering,terete,tinged,tip,triangular,unequal,unit,variable,vigorous,x,young,younger	1-7,10-lobed,anthesi,appearance,appearing,aspect,beyond,bluntly,c.,capitate,clonal,cut,developed,dia,eaf,eed,ellipsoid,emarginate,erect,extending,frui,general,giving,gree,habit,half,interacuminal,lasting,lengthening,lon,loosely,midrib,narrowly,nflorescence,oblong,pal,petal,plurifoliat,pore,poricidal,rarely,rotate,ruit,several,shallowly,sinus,slit,soft-wooded,stigma,strongly,styl,tissue,tub,ud,way,well,year,ympodial	abaxial,adaxial,arrangement,branching,characteristic,colour,diameter,form,fruit,growth,height,inflorescence,length,margin,midvein,null,plant,plurifoliate,primary,pseudostipule,rachi,seed,shape,staman,style,sympodial,tertiary,texture,true,unarmed,vein,venation
476	wfo-0001031646	success	171	128	99	72	29	0.579	-7,-pinnate,.2,.5,0.2-0.8,0.5-2,1-1.8,1-10,1-6,1.2-2.5,1.5-4,15-25,18-38,2-10,2-2.5,2-3,2.5-10,20,3.5-4,4-5,5,5-6,5-7,7-8,8-15,abaxially,acuminate,acute,adaxially,anther,apart,apex,apparently,articulated,axe,base,berry,blue,branched,brown,calyx,cm,covered,cuneate,densely,diameter,ellipsoidal,elliptic,elliptic-lanceolate,entire,filament,flattened,flower,fruit,glabrous,glandular,globose,green,hair,highly,hyaline,immature,leaf,light,lobe,margin,mature,mm,multicellular,oblique,obliquely,obtuse,ovate-lanceolate,pedicel,peduncle,perfect,petiole,pubescence,pubescent,rachi,red,rounded,rugulose,scandent,shortly,shrub,simple,smooth,spaced,spreading,stem,stout,style,surface,tawny,uniseriate,vine,violet,x	0.8-1.5,1.5-3.5,1962,4-18,4-20,4-8,4-foliate,5-7.5,5-merou,absen,absent,accrescent,acut,aggregate,alyx,apical,ba,basally,blade,cell,chartaceous,ciliat,climbing,connivent,correll,cylindrical,darker,decreasing,directed,distall,eaf,eed,equal,fide,fruiting,geminat,high,homostylous,interjected,lateral,leaflet,long,lower,maroon,nflorescence,oblong,orolla,ovate-lanceolat,part,petiolule,pore,present,pubescen,rotate-pentagonal,ruit,seudostipule,size,slightly,small,stigma,stone,tamen,tem,tip,toward,tree,truncat,tube,unit,vary,yellow,ympodial	abaxial,adaxial,arrangement,branching,characteristic,colour,corolla,form,growth,height,history,inflorescence,length,life,mentioned,midvein,obtusely,ovary,plant,primary,pseudostipule,seed,shape,staman,tertiary,texture,unarmed,vein,venation
477	wfo-0001031651	success	201	155	132	69	23	0.657	-2,-3,-3.5,.1,.6,.7,0-20,0.3-0.8,0.3-1.5,0.6-1,0.6-1.3,0.7-1,1,1-1.7,1-2,1.2-2,1.2-3,1/5,1/6-1/4,2-3,2-3.5,3-5,4-5,4-6,abaxial,absent,acute,adaxial,anther,apex,apically,apparently,articulated,base,berry,blade,branched,calyx,cell,chartaceous,cm,concolorous,cordate,curved,deltate,densely,diameter,difoliate,discolorous,drying,dull,elliptic,entire,equal,erect,eye,faint,filament,filiform,flattened-reniform,flower,free,fruit,glabrous,herb,infructescence,lateral,leaf,length,lobe,long,longer,lower,margin,maturity,mm,naked,obtuse,one,open,orange-brown,outline,ovate,pair,pedicel,peduncle,per,pericarp,petiole,pit,porrect,portion,prickly,primary,purple,raised,red,red-green,rounded,scandent,shrub,simple,small,smooth,sometimes,spherical,stalked,stellate-pubescent,stem,straight,style,subentire,surface,terete,terminal,tertiary,thick-stalked,time,tip,toward,trichome,tube,unarmed,upper,vein,venation,visible,weakly,white,wide,yellow,yellow-green	/3,/5,0.1,0.1-0.15,0.1-0.2,0.1-0.25,0.15-0.2,0.2-0.5,0.3-0.5,1-4,1.3-1.6,1.5-2,2-10,2/3-3/,4.5-7,5-merous,abaxially,acuminat,alyx,ame,apar,apart,bark,brown,c.,dark,eaf,eed,elongating,fruiting,geminat,glabrescent,gra,gray,herbaceous,lanceolate,lobed,mature,midpoint,nflorescence,oblong,older,orolla,oung,pendulous,perfec,persistent,poricidal,prickl,prickle,ray,reflexed,ruit,scar,shorter,spaced,spreading,stalk,stellate,subsessile,tamen,tapering,thick,unarme,unit,variously,vary,way,ympodial	2/3-3/4,acuminate,arrangement,branching,characteristic,colour,corolla,form,growth,height,history,inflorescence,life,midvein,null,ovary,plant,pseudostipule,rachi,seed,shape,staman,texture
478	wfo-0001031656	success	154	130	100	54	30	0.649	.5,1-1.5,1-2,1-2.5,1.2-1.5,1.5-2,1.5-5,3-3.5,3-5,5-7,5-ribbed,6-8,acuminate,acute,also,anther,apex,arising,base,berry,bright,calyx,closely,cm,corolla,dia,difoliate,directly,drying,ellipsoid,elliptic,extremely,filament,fleshy,flower,free,fruit,glabrous,globose,green,known,lateral,leaf,live,lobe,long,long-acuminate,lower,main,major,margin,matte,mature,middle,minor,minute,minutely,mm,node,oblique,often,opposite,ovary,ovate,pair,papillose,pedicel,persistent,petiole,plant,portion,prominent,proximal,rather,red-papillose,reddish,rib,ridged,rounded,scar,sessile,shiny,shrub,spaced,specimen,stem,straight,strongly,style,surface,swollen,thick,top,tube,unit,upper,vein,visible,white,widest	/4,0.5,0.5-1,10-20,2.5-3.5,4-9,anthesi,ba,bark,capitate,cork,densely,differing,eaf,edicel,eed,enclosing,erect,fruiting,geminat,greyish,hooded,lobed,lon,nflorescence,older,one,pale,paler,papillo,peelin,planar,pore,poricidal,reflexed,ruit,shaped,size,slightly,somewhat,stigma,tall,tear-drop,terminal,thickened,tip,transversely,ud,way,wide,woody,x,ympodial,young	abaxial,adaxial,arrangement,branching,characteristic,colour,corky,diameter,form,geminate,growth,height,history,inflorescence,length,life,midvein,null,peduncle,primary,pseudostipule,rachi,seed,shape,staman,sympodial,tertiary,texture,unarmed,venation
479	wfo-0001031667	success	153	136	100	53	36	0.654	0.6-1,1-1.5,1-4,1.4-3,1.5-2,10-13,12-35,2-3,2-5,2.5-5,3-13,3-8,5-15,5-9,8-13,abaxially,acuminate,acute,adaxially,apex,apiculate,articulate,base,branched,calyx,caudate,cell,cm,cordate,corolla,covering,cuneate,cyme,dark,diameter,dichasial,dichasially,digestion,distal,ebracteate,elliptic-lanceolate,emoval,enzyme,exceeding,filament,flower,forked,generally,globose,green,green-white,hair-like,half,herbaceous,honeycomb,lanceolate,lateral,leaf,living,lobe,long,make,mm,monochasial,mucilaginous,oblique,oblong,odd-pinnate,ovoid,pattern,pedicel,peduncle,perennial,perfect,petiolate,petiole,petiolule,pilose,plant,proximal,reveal,rounded,seed,sessile,specimen,spot,stamen,stigma,straight,stripe,style,testal,thick,throughout,tuber-bearing,typically,unit,wall,white,Â¼	0.6-1.5,2-6,3-5,3-6-foliat,4-1.,6-10,8-15,abruptly,acumen,apical,apically,connate,dehiscent,diminishing,dorsally,eaf,edge,eed,flat,folded,globo,interjected,introrse,irregularly,leaflet,lobed,lon,lower,lunat,maturing,nflorescence,nther,often,orolla,pair,plan,poricidally,ruit,seudostipule,short,size,slit,stellate,tal,tem,terminal,toward,vary,whit,wide,without,yellow,ympodial	'hair-like,3-6-foliate,abaxial,adaxial,anther,arrangement,ba,branching,characteristic,colour,form,fruit,growth,height,history,inflorescence,length,life,lunate,margin,mentioned,midvein,ovary,primary,pseudostipule,rachi,shape,staman,stem,surface,sympodial,tertiary,texture,unarmed,vein,venation
480	wfo-0001031672	exception_thrown	157	0	0	157	0	0.0		0,0-2,0.3-0.5,0.5,0.5-1,0.5-1.5,1,1-,1-1.5,1-10,1-2,1-5,1.5-2,1.5-2.5,1.5-3.5,1.5-5,10-20,15-20,15-50,2-12,2-28,3-4-foliat,3/4,4,4-34,4.5-5,4/5,5-6,6,9-lobed,abaxially,absent,acuminate,acute,adaxially,aggregate,apart,ape,apex,apiculate,articulated,aublet,axe,basal,base,beyond,blade,calyx,cell,chartaceous,ciliat,cm,connective,cordate,cylindrical,densely,diameter,directed,distally,divided,eaf,eed,entire,exceeding,exserted,fide,flattened,fleshy,flower,fruit,glabrous,glandular-puberulent,globose,green,greenish-brown,hair,lanceolate,leaf,leaving,lobe,lobed,lon,long,lower,margin,mature,membranaceous,midrib,mm,moderately,narrowly,near,nflorescence,nther,obtuse,occasionally,often,one,orolla,ovate,ovoid,pedicel,pedicellar,peduncle,perfect,petiole,pilo,pilose,pinnately,pore,presen,present,puberulent,pubescent,purple,rachi,radiu,remant,represented,rounded,ruit,shorter,simple,sinus,slightly,small,spaced,sparsely,stamen,stellate,stigma,stone,style,subcoriaceous,tal,tem,thecae,time,tip,toward,tree,triangular,truncat,truncate,tube,ud,unbranched,unit,unlobed,vary,white,whitish,wide,x,yello,yellow,ympodial	
481	wfo-0001031684	success	161	132	100	61	32	0.621	.25,.5,0.1,0.4-1.5,0.5-0.7,0.5-0.8,0.5-1,0.7-1,0.75-1,1-1.2,1-5,10-100,2,3-30,5-7,acuminate,acute,along,anther,apex,base,bearing,beneath,berry,black,borne,branched,calyx,cm,corolla,decurrent,densely,denser,dia,difoliate,drying,elliptic,extremely,filament,filiform,flower,free,geminate,glabrous,globose,green,inflorescence,internodal,irregularly,lateral,leaf,less,like,lobe,long,long-triangular,lower,main,middle,minutely,mm,occasionally,older,opposite,ovary,ovoid-reniform,pair,pale,pedicel,petiole,pitted,portion,previously,pubescent,raised,rest,scar,short,shrub,slender,slightly,small,sparsely,stem,style,surface,tan,tapering,time,tree,trichome,tube,unifoliate,uniseriate,unit,vein,white,widest,winged,x	.75,/4,2-9,3-3.5,4-17,anthesi,apar,bark,causing,clavate,curly,deflexed,differing,eaf,edicel,eed,elongated,except,expanded,exserted,fruiting,gre,greatly,lobed,lon,major,midrib,minor,nflorescence,obconic,one,papillo,papillose,persistently,planar,pore,poricidal,present,pulled,reflexe,reflexed,ruit,shaped,single,siz,size,soon,spaced,stigma,straight,tall,tear-drop,tip,tipped,ud,unevenly,varying,way,widely,ympodial,young	abaxial,adaxial,arrangement,branching,characteristic,colour,diameter,form,fruit,grey,growth,height,history,length,life,margin,midvein,null,peduncle,plant,primary,pseudostipule,rachi,seed,shape,staman,sympodial,tertiary,texture,true,unarmed,venation
482	wfo-0001031695	success	185	162	128	57	34	0.692	0.5-1,0.5-2,1-2,1-3,1-9,1.5-8,1/2,1/3,10-,10-35,15-20,2-3,2-4,2-5,2.5-5,20-30,3-10,3-17,3-19,3-7,30-40,4-10,4-5,4-6,5,5-20,5-7,6-10,6-20,abaxially,abruptly,acuminate,acute,adaxially,aggregate,also,apart,apex,apiculate,articulated,axe,basal,base,blade,branched,broadened,calyx,cell,cm,color,cordate,dark,deep,densely,diameter,divided,eglandular,eglandular-pilose,ellipsoidal,entire,flattened,fleshy,flower,fruit,glabrate,glabrescent,glabrous,glandular-puberulent,green,greenish,hair,hard,immature,lateral,lavender,leaf,leaving,lobe,lobed,long,margin,midrib,mm,moderately,mottled,oblique,oblong,obtuse,occasionally,often,ovate,pedicel,pedicellar,peduncle,perfect,petiole,pilose,pilose-hirsute,present,puberulent,puberulent-pubescent,pubescent,purple,rachi,remnant,ripe,rounded,shrub,simple,sinus,small,sometimes,somewhat,spaced,sparsely,stone,stripe,style,time,tip,tree,unbranched,unequal,unit,unknown,unlobed,wide,x	1,1.5-2,10-15,3-,4-foliat,6-8,7-,?,ape,apically,beyond,campanulate,capitat,chartaceous,connective,connivent,cylindrical,d,dilated,directed,eaf,eed,exceeding,exserted,lanceolate,laterally,lilac,lon,lower,narrowly,nflorescence,nther,orolla,ovoid,pilo,pilose-hirsut,pore,presen,purplish,radiu,ruit,shorter,slight,slightly,stamen,stigma,subcoriaceous,swelling,tal,tem,thecae,tomento,triangular,tube,vary,yellow,ympodial	4-foliate,abaxial,adaxial,anther,arrangement,branching,characteristic,colour,corolla,filament,form,growth,height,history,inflorescence,length,life,mentioned,midvein,ovary,plant,primary,pseudostipule,seed,shape,staman,stem,surface,sympodial,tertiary,texture,unarmed,vein,venation
483	wfo-0001031698	success	58	75	34	24	41	0.586	2-2.5,2.5,2.5-3,4-4.5,base,cm,decurrent,deflexed,dia,difoliate,elliptic,flattened,fruiting,glabrous,leaf,margin,minutely,mm,papillae,pedicel,pitted,reddish-brown,reniform,repandly,rugose,shrub,stem,stout,strongly,surface,winged,woody,x,yellowish	'',``,ape,bark,branch,dull,eaf,eed,fide,geminat,green,incrassate,long,maguire,older,otherwise,pale,paler,persistin,tall,unit,wing,ympodial,young	abaxial,adaxial,anther,apex,arrangement,branching,calyx,characteristic,colour,corolla,diameter,filament,form,fruit,geminate,growth,height,history,inflorescence,length,life,lobe,midvein,null,ovary,peduncle,petiole,plant,primary,pseudostipule,rachi,seed,shape,staman,style,tertiary,texture,true,unarmed,vein,venation
484	wfo-0001031707	success	178	153	122	56	31	0.685	-3,.5,1-1.2,1-1.3,1-1.5,1.2-1.8,1.2-2,1.5-2,1.5-6,1/3,16-20,2,2-3,2-4,2-6,24,4-5,4-6,5-10-celled,6-7,80-140,abaxially,acuminate,acute,adaxially,almost,along,anther,apex,apical,apically,attenuate,axil,axillary,base,basiscopically,bearing,berry,brown,calyx,cell,climbing,cm,conical,corolla,dense,densely,diameter,distal,distinct,drying,elliptic,enlarged,epidermal,erect,filament,flap-like,flattened,flower,four-lobed,glabrous,globose,green,greenish,high,lanceolate,leaf,leaflet,less,like,lobe,long,margin,mm,narrower,narrowly,oblique,obovate,occasionally,open,ovary,pair,pedicel,per,petiole,pink,pinnate,plant,pointed,primary,pubescent,quadrate,quite,raised,reddish,regular,rest,round,scar,scattered,simple,slightly,smooth,somewhat,spaced,sparsely,stout,style,surface,ternate,thickening,time,trichome,uniseriate,unit,usually,vein,vine,white,widely,woody,x	/4,0.5-1,1-3,1.5-1.7,2-10,3,8-12,9-15,absent,anthesi,basal,c.,capitate,cateniform,clavat,conspicuously,cucullate,eaf,edicel,eed,endrophilum,exserted,flat,fleshy,free,fruiting,horizonta,inflorescenc,lateral,lobed,lon,lower,minutely,nflorescence,papillate,penden,petiolule,planar,poricidal,portion,ruit,sagittate,smaller,stigma,strongly,tem,terminal,tip,tub,tube,type,ud,unifoliat,way,white-lenticellate,ympodial	abaxial,adaxial,arrangement,branching,cateniforme,characteristic,colour,form,fruit,growth,height,history,horizontal,inflorescence,length,life,midvein,null,peduncle,pseudostipule,rachi,seed,shape,staman,stem,sympodial,tertiary,texture,unarmed,unifoliate,venation
485	wfo-0001031723	success	228	151	129	99	22	0.566	-1.5,-15,-5,-8,0.2-1,0.4-,0.4-1,0.55-0.9,0.6-1,0.7-1,1-,1-2,1-2.5,1-3,1.2-2,15-45,2-,2-3.5,2.5-4.5,2.5-5,4-11,4-6,5-40,abaxial,abaxially,acuminate,acute,adaxial,anther,apex,apically,apparently,articulated,base,berry,branched,branching,brown,calyx,cm,cuneate,curved,dark,deltate,densely,diameter,dull,entire,erect,evenly,eye,filament,filiform,finely,flattened-reniform,free,fruit,gently,glabrescent,glabrous,green,hair,infructescence,lateral,leaf,length,lobe,long,margin,marking,maturity,mauve,minute,mm,moderately,multangulate,naked,near,obtuse,orange-brown,ovate,pair,pale,pedicel,peduncle,per,pericarp,petiole,porrect,portion,prickly,primary,recurved,red,rounded,secondary,sessile,shrub,simple,smooth,sometimes,sparsely,spherical,stalked,stellate-pubescent,stem,straight,style,subentire,surface,terete,terminal,tertiary,tip,trichome,tube,unarmed,unit,usually,vein,venation,visible,weakly,white,whitish,wide,yellow,yellow-green,young	-1/2,-16,-2,-6,-6.5,-merous,0,0.05-0.2,0.1-0.2,0.1-0.3,0.1-0.5,0.15,0.4,0.4-0.9,0.8-1.5,1-5,1.5-,1.5-10,1.5-2.5,1/3-1/2,1/4-1/3,1/6-,10-30,2-5.5,2-7,2/3,2/3-3/4,3-10,3-15,4-,4-10,4-20,4-5,5-9,8-20,acut,alyx,ame,apar,apart,ba,bark,blade,brow,c.,chartaceous,conical,connivent,discolorous,drying,eaf,eed,elongated,elongating,equal,flower,fruiting,gland,gland-tipped,glandular,gray,herbaceous,inflated,lobed,longer,lower,mature,midpoint,narrow-deltate,nflorescence,older,one,open,orange,orolla,oung,perfec,perpendicular,plurifoliat,poricidal,prickle,ray,reflexed,ruit,scar,spaced,spreading,stalk,stellate,strongly,tamen,tapering,time,unarme,variously,vary,way,woody,ympodial	arrangement,characteristic,colour,corolla,form,growth,height,history,inflorescence,life,mentioned,midvein,ovary,plant,plurifoliate,pseudostipule,rachi,seed,shape,staman,sympodial,texture
486	wfo-0001031729	success	161	144	112	49	32	0.696	-0.5,-2,..,0.5,0.5-1,0.6-,1-1.5,1-2,1-2.5,1.5,1.5-2,10-20,12-13,2-2.5,2-3,2.5-,2.5-5,3-4,3.5-4,5-,5-6,5-7,abruptly,acuminate,along,anther,apex,apicula,apiculate-deltate,attenuate,base,beneath,branched,brittle,calyx,cell,cm,conical,corolla,dark,darker,deltate,diameter,dry,drying,elliptic,elongate,filament,flattened,fruit,glabrous,globose,gradually,green,greenish,less,lobe,long,markedly,middle,minute,minutely,mm,mottling,obovate,occasionally,outer,outline,ovary,ovate-reniform,pair,pale,papillae,papillate,papillose,pedicel,peduncle,per,pericarp,petiole,pink,primary,purplish,quadrate,reddish,regularly,scattered,short,shrub,sinuate,small,smooth,somewhat,stem,stigma,striate,stripe,surface,tan,testa,thin,time,tip,toward,trichome,tuft,vein,wall,wand-like,white,widening,x	-45,0.5-4,1.0-1.3,11-30,3-celled,4.1-16,50,8-9,anthesi,branc,branch,brow,c.,cucullate,curve,eaf,edicel,eed,erec,flattened-capitat,flower,fruiting,glandular,later,lobed,lower,membranous,narrowly,nearly,never,nflorescence,noddin,open,planar,plurifoliat,point,pointed,ruit,scar,single,single-stemmed,thing,triangular,tube,ud,unit,usually,ympodial,young	abaxial,adaxial,arrangement,branching,brown,characteristic,colour,flattened-capitate,form,growth,height,history,inflorescence,leaf,length,life,margin,midvein,nodding,null,plant,plurifoliate,pseudostipule,rachi,seed,shape,staman,style,tertiary,texture,unarmed,venation
487	wfo-0001031738	success	231	208	186	45	22	0.805	-15,-5,.5,0,0-2,0-3,0.1-0.25,0.25-0.8,0.3-1,0.7-1,0.7-1.1,1-1.5,1-3,1-4,1.4-1.7,1.5-,1.5-4,1/3,1/3-2/3,1/6-1/4,10-15,15-40,2-,2-4,2.3-3,20-200,3-4,3-6,3-7,3.5-3.8,3.5-4.5,4,4-10,4-6,4-8,5,5-8,6-15,7-12.5,8-10,8-18,abaxial,abaxially,acute,adaxial,adaxially,almost,always,anther,apart,apex,apically,apparently,articulated,auriculate,base,berry,blade,branched,calyx,cell,chartaceous,cm,connivent,cordate,curved,dark,deltate,densely,diameter,discolorous,distance,drying,dull,equal,erect,evenly,extending,filament,flattened,flattened-reniform,flower,free,frequently,fruit,glabrescent,glabrous,gray,green,held,infructescence,inside,lateral,leaf,length,lobe,lobed,lobing,long,long-styled,longer,lower,margin,maturity,midpoint,midvein,mm,multangulate,narrow-deltate,oblong,obovate,often,one,open,orange,orange-brown,outline,ovate,pair,pale,pedicel,peduncle,per,pericarp,petiole,pit,plant,poorly,poricidal,porrect,portion,prickle,prickly,primary,prominent,pubescent,raised,ray,resin,rounded,scar,secondary,shorter,shrub,side,simple,small,smooth,sometimes,spaced,sparsely,spherical,stalk,stalked,stellate-pubescent,stem,sticky,stout,straight,strongly,style,surface,tapering,terete,terminal,tertiary,time,tip,tree,trichome,truncate,tube,unarmed,upper,variously,vein,venation,visible,weakly,white,wide,yellow,yellow-green,yellow-orange,yellowish,young	-6,-merous,0.2-0.3,0.9-2.1,1-1.8,1/,1/2-2/3,1/4-1/3,4-5,7-12,acuminat,alyx,andromonoecious,apar,bark,distal,eaf,eed,elongating,fruiting,hermaphrodite,heterostylous,lowermost,mature,nflorescence,older,orolla,oung,plurifoliat,prickl,reflexed,ruit,sessile,short-styled,spreading,staminat,stellate,tamen,unit,usually,vary,way,white-brow,woody,ympodial	1/4,acuminate,arrangement,branching,characteristic,colour,corolla,form,growth,height,history,inflorescence,life,null,ovary,plurifoliate,pseudostipule,rachi,seed,shape,staman,texture
488	wfo-0001031752	success	172	148	113	59	35	0.657	-10,-100,-3,-44,-47,-6,0.5-1,0.5-1.5,1,1-,1-1.5,1-3,1-4,1.5-10.5,1.5-2,1.5-2.5,1.5-3,1.5-3.5,15-25,15-40,2-2.5,2-3,2-5,20-35,3-11.5,3-4,3-7,3.5-15,3.5-5,5-23,5-6,5-8,abaxially,acuminate,acute,adaxially,aggregate,apart,apex,articulated,axe,basal,base,blade,calyx,cell,cm,cuneate,darker,densely,diameter,ellipsoidal,entire,flattened,fleshy,flower,fruit,fusiform,glabrate,glabrescent,glabrous,gland,glandular-puberulent,green,immature,leaving,less,light,lobe,long,margin,mm,moderately,near,often,older,pedicel,pedicellar,peduncle,perfect,petiole,pink,present,puberulent,pubescent,purplish,rachi,radiu,remnant,ripe,rounded,rugose,shrub,simple,small,spaced,sparsely,stalked,stone,stripe,style,subcordate,subcoriaceous,time,tree,truncate,unbranched,unit,white,wide,x,yellow,young	-pubescent,1-2,3-4-foliat,8-15,9-16,ape,apiculate,beyond,chartaceous,ciliat,ciliate,connective,connivent,cylindrical,deltate,directed,distally,eaf,eed,elliptic,equal,exceeding,exserted,glandular-puberulen,lanceolate,linear,lon,lower,membranaceous,narrowly,nearly,nflorescence,nther,oblong,obtuse,olde,orolla,ovate,ovoid,pore,presen,purpl,ruit,slightly,stamen,stellate,stigma,swelling,tal,tem,thecae,tip,tomentose,triangular,truncat,tube,ud,vary,ympodial	3-4-foliate,abaxial,adaxial,anther,arrangement,branching,characteristic,colour,corolla,filament,form,growth,height,history,inflorescence,leaf,length,life,mentioned,midvein,ovary,plant,primary,pseudostipule,seed,shape,staman,stem,surface,sympodial,tertiary,texture,unarmed,vein,venation
489	wfo-0001031756	success	186	136	108	78	28	0.581	-1,-5,.5,0,0-2,0.4-1.6,0.5-1,0.6-1.2,0.8-1,1-1.8,1-2,1-3,1-4,1.5-2,1.5-3.5,1.8-2.5,1/3,3-5,4-5,anther,apex,apically,articulated,base,berry,blade,branched,calyx,cm,color,concolorous,connivent,cordate,curved,deltate,densely,diameter,drying,entire,equal,erect,evenly,eye,filament,finely,flattened-reniform,flower,free,fruit,glabrous,gray,green,infructescence,known,leaf,lobe,long,margin,mature,mauve,mm,naked,one,open,orange-brown,ovate,pair,pale,pedicel,peduncle,per,pericarp,petiole,pitted,poricidal,portion,prickle,prickly,primary,red-brown,rounded,scandent,shoot,short,shrub,simple,slender,smooth,sparsely,spherical,stellate-pubescent,stem,style,surface,tapering,terete,terminal,time,tip,truncate,tube,unarmed,vein,visible,white,wide,yellow-green,young	.1,.8,/2,0-5,0.02-0.2,0.1,0.15-0.25,0.2,0.5-1.3,0.6-1.6,0.7-1.7,00,1/2,10,2-6,3-15,3-7,4.5,5-merous,6-9,7-10,9-14,abaxially,accrescent,acut,alyx,apar,apart,apparently,bark,broad-deltate,chartaceous,conical,eaf,eed,elongating,enclosing,fruiting,fully,glabrescent,glabrou,herbaceous,inflated,invested,lobed,longer,lower,midpoint,moderately,nflorescence,older,orolla,oung,pendulous,perfec,perpendicular,plurifoliat,porrect,prickl,ray,ruit,scar,sessile,shorter,small,spaced,spreading,stalk,stalked,stellate,straight,tamen,trichome,unit,variously,vary,way,ympodial	abaxial,acute,adaxial,arrangement,branching,characteristic,colour,corolla,form,growth,height,history,inflorescence,length,life,midvein,null,ovary,plant,plurifoliate,pseudostipule,rachi,seed,shape,staman,tertiary,texture,venation
490	wfo-0001031786	success	209	179	157	52	22	0.751	.4,.5,/2,0-2,0-20,0-3,0-5,0.1,0.1-0.4,0.2-2.5,0.25-0.5,0.5-1.5,0.7-1,0.7-1.6,0.7-4,0.8-1.2,1,1-2,1-3,1-4,1-6,1.2-1.6,1.5-2.5,1/3-1/2,2-13,2-3,2-7,2-8,2.5-3.5,3-4,4-5,6-8,acute,almost,anther,apart,apex,apically,apparently,articulated,base,becoming,berry,blade,branched,calyx,cell,chartaceous,cm,concolorous,cuneate,curved,dark,deep,deltate,diameter,distance,drying,elliptic,equal,erect,evenly,extending,eye,filament,filiform,flattened,flattened-reniform,flower,free,fruit,glabrescent,glabrous,gray,green,herb,inconspicuous,infructescence,lateral,leaf,length,lobe,lobed,long,longer,margin,maturity,mauve,membranous,midpoint,midvein,minute,mm,naked,obtuse,one,open,orange,orange-brown,outline,ovate,pair,pale,pedicel,peduncle,per,pericarp,petiole,pit,porrect,portion,prickle,prickly,primary,raised,ray,red,red-brown,reflexed,rounded,scandent,sessile,shiny,shorter,shrub,side,simple,slightly,small,smooth,sometimes,spaced,sparsely,spherical,stalk,stalked,stellate-pubescent,stem,straight,style,surface,terete,tertiary,time,trichome,truncate,tube,unarmed,variously,vein,venation,visible,weakly,white,wide,yellow-orange,young	-5,/3,0,0.2-0.3,0.8,1.5-1.9,3-5.5,5-7,5-merous,8-12,abaxially,acut,alyx,ame,apar,bark,c.,clavat,connivent,densely,eaf,eed,elongating,fruiting,gray-brow,herbaceous,lon,lower,mature,nflorescence,older,orolla,oung,pendulous,perfec,plurifoliat,poricidal,prickl,ruit,scar,spreading,stellate,stigma,tamen,tapering,thick,tip,unit,vary,way,woody,ympodial	abaxial,adaxial,arrangement,branching,characteristic,colour,corolla,form,growth,height,history,inflorescence,life,null,ovary,plant,pseudostipule,rachi,seed,shape,staman,texture
491	wfo-0001031793	success	188	134	104	84	30	0.553	-4,.5,0,1-1.5,1-2,1-8,1.5-4,10-15,15-20,2-3,2-5,20,40,absent,acumen,acuminate,aging,almost,anther,apex,articulated,base,berry,black,branched,broadly,brown,brownish,calyx,cm,cuneate,densely,diameter,difoliate,distal,elliptic,erect,evident,extra-axillary,extreme,filament,flattened,flower,forked,fruit,fruiting,glandular,globose,hair,inflorescence,leaf,linear,lobe,long,many,margin,maturing,mm,mostly,mucilaginous,oblique,often,orange-yellow,orbicular-ovate,pedicel,peduncle,per,petiole,prickle,pubescent,rachi,reddish,reduced,reticulation,rounded,rusty,scarcely,shallow,shrub,side,simple,single,small,sparsely,stellate,stellate-pubescent,stem,stout,style,surface,testa,thickened,tip,tree,triangular,trichome,unarmed,unbranched,upward,usually,well-developed,white,yellow,yellow-brown	1,1-3,1.5-2,1/3,1/4,1/5,13-20,26,3-4,3-8,3/4,4,5-merous,7,8-11,abundant,accrescent,acute,adult,alyx,apparently,armed,aspect,axe,ba,bilobe,blade,branche,broad,capitate,central,chartaceous,cut,eaf,eed,elongatin,erec,ferrugineous,geminat,general,homostylou,interpetalar,larger,lobing,lon,lower,main,midpoint,midrib,minutely,nflorescence,oblong-lanceolate,obtuse,older,orolla,ovate,perfect,pore,porocidal,porrect,principal,ruit,scattered,sessile,similar,sinus,size,smaller,stellate-pubescen,stigma,stipitate,tall,tamen,tem,tissue,triangular-acuminat,tube,unit,uvenile,vary,way,woody,x,ympodial	abaxial,adaxial,arrangement,branch,branching,characteristic,colour,corolla,due,form,geminate,growth,height,history,length,life,mentioned,midvein,ovary,plant,present,primary,pseudostipule,seed,shape,staman,tertiary,texture,vein,venation
492	wfo-0001031829	success	138	103	74	64	29	0.536	.25,.5,0.7-1,1-2,1.3-1.5,1.5-2,1.5-2.5,2-4,3-5-flowered,4-4.5,7-10,absent,acute,adaxial,anther,apex,apiculae,base,berry,branched,calyx,cm,corolla,crystalline,densely,difoliate,drying,elliptic,erect,filament,free,glabrous,globose,green,greenish-brown,growth,immature,inflorescence,known,large-celled,lateral,leaf,lobe,long,main,margin,minute,mm,often,opposite,ovary,pair,pedicel,petiole,portion,pubescent,quadrate,revolute,shrub,simple,sparsely,stem,style,surface,trichome,tube,tuft,uniseriate,vein,waxy,white,woody,x,yellowish	0.5-2.1,1,1.5-3.5,1.5-4.5,3/4,4-8.5,abaxially,adaxially,along,anthesi,ape,bae,bark,broadly,capitate,conical,deflexed,denser,dia,differing,eaf,edicel,eed,epidermi,exserted,fruiting,geminat,glabrat,leathery,like,lobed,lon,lower,major,minor,minutely,nflorescence,occasionally,older,overlappin,packed,papillo,papillose,planar,pore,poricidal,ruit,scar,shaped,size,soft,somewhat,stigma,tall,tapering,tear-drop,thick,tip,tub,ud,unit,way,ympodial,young	abaxial,arrangement,branching,characteristic,colour,diameter,form,fruit,geminate,glabrate,height,history,length,life,midvein,null,peduncle,plant,primary,pseudostipule,rachi,seed,shape,staman,tertiary,texture,true,unarmed,venation
493	wfo-0001031832	success	232	129	105	127	24	0.453	/50-1/10,0-150,0.1-0.3,0.2-1.5,0.3-0.8,0.3-3,0.7-1.5,0.7-1.6,0.7-2,0.8-1.2,1-12,1.1-2.4,1.2-1.6,1.2-2,1.3-4.2,14,2-3.6,2-6,2.5-6.5,3-6.5,3-7,4-20,5.5-10,7-10,9,abaxially,acuminate,adaxially,anther,apart,apex,articulated,attenuate,axe,axillary,basal,base,berry,blade,branched,brown,bullate,calyx,closely,cm,conical,corolla,dark,decurrent,deltoid,diameter,entire,filament,fleshy,flower,fruit,granular-tomentose,green,greenish,growth,half,honeycombed,lanceolate,leaf,length,lobe,margin,midvein,mm,nearly,oblanceolate,pale,pedicel,peduncle,petiole,pitted,plurifoliate,probably,pubescent,rachi,reniform,reticulate-punctate,ripe,rough,scabrous,shrub,side,smooth,spaced,sparingly,stem,stipitate-glandular,style,subcampanulate,suborbicular,surface,time,tree,unarmed,vein,violet,white,x,yellow,yellowish	-8,.5-1,0.2-0.6,1.2-2.5,1.5-4,1.7-4,1.8-4,1/2-3/4,2-4,2.8-4.8,3.5-7,4-7,5-21,8-25,accrescent,acute,ag,anthesi,apical-lateral,apice,apparently,ba,bark,becoming,blister,blunt-tipped,branch,brownish,bud,capitat,chartaceous,connate,continued,dehiscing,directed,due,eaf,eed,evident,exserted,extend,ferrugineous,few-rayed,forming,free,fruiting,glabrescen,glabrescent,glabrous,globose,hair,high,indument,inserted,introrse,lackin,large,lateral,line,lobed,long,long-,longer,longitudinal,lower,m.,main,minute,mixed,mostly,multangulate,nflorescence,oblong,obovoid,obtuse,occasionally,older,orbicular,orolla,ovate,partly,perfect,persistent,pore,porrect-stellat,porrect-stellate,pubescence,rather,ray,relatively,rotate-stellate,ruit,runk,sessile,short-,short-stalked,simple,slit,sometimes,somewhat,soon,sparse,splitting,stamen,stellate-pubescent,stigma,suture,swelling,tamen,terete,terminal,testa,thick,thick-stalked,toward,translucent,tube,unarme,unit,usually,vary,way,weakly,whitish,wide,ympodial,young	abaxial,adaxial,arrangement,branching,characteristic,colour,form,height,history,inflorescence,lacking,life,null,ovary,plant,primary,pseudostipule,seed,shape,staman,tertiary,texture,true,venation
494	wfo-0001031834	success	150	122	90	60	32	0.6	.5,0.5,0.5-3,0.5-3.5,0.6-1.4,0.8-1,0.8-1.3,0.9-1.4,1,1.5,1.6-2,6-7,acuminate,acute,anther,anthesi,apex,apiculate,base,berry,calyx,cm,corolla,covered,decurrent,deltoid,depression,difoliate,few-flowered,filament,flattened-reniform,free,fruit,glabrous,globose,green,greenish-yellow,hooked,incrassate,lamina,leaf,less,lobe,long,lower,major,margin,middle,minor,minute,minutely,mm,opposite,ovary,ovate,pale,papillose,pedicel,persistent,petiole,pitted,portion,proximal,pubescent,short,shrub,simple,slender,slightly,small,sparsely,stem,straight,style,surface,tan,tapering,tip,trichome,tube,tufted,uniseriate,unit,upper,usually,vein,white,widest,x,yellow	0.5-1,1.5-4,1.9-6.5,2.9-7,2/3,6.5-14,accrescent,across,apar,apically,appear,attenuate,bi-cellular,borne,campanulate,deciduou,deciduous,deflexed,dia,eaf,edicel,eed,expanded,eye,fruiting,geminat,glabrou,hook,larger,leaving,like,lobed,lon,markedly,mound-like,multicellular,naked,nflorescence,often,papillo,planar,pore,poricidal,ruit,scabrous,scar,shaped,soon,spaced,speck,stigma,tall,tear-drop,ud,unevenly,uni-,way,woody,ympodial,young	abaxial,adaxial,arrangement,branching,characteristic,colour,diam,diameter,form,geminate,growth,height,history,inflorescence,length,life,mentioned,midvein,peduncle,plant,primary,pseudostipule,rachi,seed,shape,staman,sympodial,tertiary,texture,true,unarmed,venation
495	wfo-0001031842	exception_thrown	161	0	0	161	0	0.0		.1,.4,.5,.75,0.1-0.5,0.5-1,0.5-2,0.6-1,0.7-1,1,1-1.5,1-1.8,1-3.5,1.5-2,10-12,10-20,10-30-flowered,2-10,2-3,2.5-3,2.5-6,3-8,3/4,4.5-6,7-9,9-15,acute,anther,anthesi,apart,apex,attenuate,axil,ba,bark,base,bearing,beginning,beneath,berry,bi-lobed,brown,calyx,capitate,cm,corolla,cup-shaped,cusp,dark,decurrent,deeply,deflexed,densely,dia,differing,difoliate,dry,eaf,edicel,eed,ellipsoid,elliptic,exserte,exsertion,filament,flattened-reniform,free,fruiting,geminat,glabrous,globose,green,incrassate,inflorescenc,irregularly,later,lateral,leaf,leaf-opposed,lobe,lobed,lon,long,lower,main,major,margin,middle,minor,minutely,mm,near,new,nflorescence,often,older,one,onto,opposite,ovary,overtopping,pair,pale,paler,papillo,papillose,pedicel,petiole,pitted,pore,poricidal,portion,prominent,pubescent,quadrate,reddish,reddish-resinous,reflexed,ruit,scar,shaped,shiny,shoot,shrub,simple,size,slender,somewhat,soon,spaced,sparsely,specimen,stem,stigma,straight,strongly,style,surface,tall,tapering,tear-drop,terminal,time,tip,tree,trichome,tube,tuft,ud,uniseriate,unit,vein,way,white,widest,woody,x,yellowish,yellowish-whit,ympodial,young	
496	wfo-0001031843	success	245	204	182	63	22	0.743	.2,.3,.5,0-4,0.2-2,0.5-1.5,0.6-1.2,0.7-2,1-2,1-7,1.2-2,1.2-2.2,1.5,1.8-2.5,1mm,2-3,2-4,2.5,3-4,3-7,4-12,45-60Â°,5-10,5-12,6-9,abaxially,acuminate,adaxially,age,along,always,anther,apex,apically,appressed,around,articulated,attenuate,basal,base,berry,black,branch,branched,branching,broadly,brown,calyx,canaliculate,caudate,clearly,cm,collapsing,completely,conical,corolla,curved,cuspidate,dark,deeply,delineated,deltoid,dendritic,density,diameter,dilated,discoid,discolorous,distributed,drying,dull,entire,equal,erect,evenly,eye,filament,fine,finely,flat,flexuous,flower,forming,glabrous,green,hand,honeycomb,leaf,len,length,lengthening,liana,lignified,like,lobe,long,longitudinally,loop,lower,main,margin,midvein,mm,much,multiseriate,naked,network,never,oblique,oblong,obovate,older,orange,orange-brown,orange-yellow,outline,pair,part,partly,pattern,pedicel,peduncle,pericarp,petiole,pit,pitted,pore,poricidal,present,primary,protruding,pubescent,rachi,raised,rarely,red,reddish,reveal,ribbed,ridged,rounded,scar,seed,shiny,shortly,shrub,side,simple,slender,slightly,small,smaller,smooth,sometimes,sparsely,spheroidal,spreading,stem,straight,strongly,stump,style,surface,terminal,tertiary,thick-chartaceous,thickened,thin,tip,trichome,tuft,twice,unarmed,variable,vein,venation,violet,visible,weakly,without,x,young	.6,0.4-0.5,0.5-1,0.7-1.2,0.8-2,1.5-2,1/6-1/4,accrescent,almost,alyx,anthesi,apar,apice,apparently,bark,becoming,capitate,cupular,detaching,domatia,eaf,eed,ellipsoi,even,fertilisation,free,fruiting,inner,largely,leave,lobed,looping,m.,nflorescence,nther,obscure,opening,orolla,ovate,papillo,pendulous,perfec,plurifoliat,portion,prominent,pronounced,recurve,ruit,see,shallowly,sinus,soon,stigma,surfac,tearing,tube,ud,unit,vary,white,wide,wider,ympodial	abaxial,adaxial,apart,arrangement,characteristic,colour,form,fruit,growth,height,history,inflorescence,life,null,ovary,papillose,plant,pseudostipule,shape,staman,texture,true
497	wfo-0001031852	success	155	120	85	70	35	0.548	-8,0.1-1,1-4,1-4.2,1-9,1.3-2.5,1.4-3,1.5-3,12-35,2-3,3-4,4-,4-10,4-5,4-6,7-,9-11,abaxially,acumen,acuminate,acute,adaxially,apex,apiculate,articulate,base,branched,calyx,cell,cm,conical,corolla,covering,cyme,diameter,dichasial,dichasially,distal,ebracteate,elliptic,elliptic-lanceolate,exceeding,filament,forked,green,green-white,herbaceous,lanceolate,lateral,leaf,light,living,lobe,long,make,mm,monochasial,mucilaginous,oblique,oblong,odd-pinnate,ovate-elliptic,ovoid,pedicel,peduncle,perennial,petiole,plant,proximal,pubescent,rachi,seed,shortly,specimen,stamen,stigma,straight,style,testal,thick,throughout,tuber-bearing,wall,white,Â¼	0.5-1.3,0.5-3,1-,2-5.5,2.6-9.5,3-6-foliat,3-9,3.5-10,5-15,abruptly,absen,apical,apically,attenuate,connate,decurrent,dehiscent,digestion,diminishing,dorsally,eaf,edge,eed,emoval,enzyme,flat,flower,folded,generally,globo,hair-like,half,honeycomb,interjected,introrse,leaflet,lon,lower,lunat,maturing,nflorescence,nther,often,orolla,pair,pattern,perfect,plan,poricidally,reveal,ruit,sessile,seudostipule,short,size,slit,stellate,tal,tem,terminal,throughou,toward,typically,unit,vary,white-crea,wide,without,yellow,ympodial	'hair-like,abaxial,adaxial,anther,arrangement,branching,characteristic,colour,form,fruit,globose,growth,height,history,inflorescence,length,life,lunate,margin,mentioned,midvein,ovary,primary,pseudostipule,shape,staman,stem,surface,tertiary,texture,unarmed,vein,venation,wet,white-cream
498	wfo-0001031864	success	140	154	118	22	36	0.843	.2,.25,.5,0.2-0.5,0.4-3,0.5-13.5,0.5-4,0.6-3.5,0.6-4,0.7-0.8,0.8-1,1-1.2,1-1.8,1-2,1-3,1-5,1-6.5,1.2-1.5,1.5,1.5-10,1.5-2.5,15-60,2,2-3,2.5-6,3-3.5,3-pinnate,5-15,5-9,5-merous,7.5-8,abaxially,accrescent,acuminate,acute,adaxially,anther,apex,apical,apiculate,axe,base,berry,blade,calyx,chartaceous,ciliate,clavate,cm,color,cuneate,deltoid,dense,densely,diameter,emarginate,entire,extra-axillary,filament,fine,flattened,fleshy,flower,fruit,fruiting,glabrous,hair,herbaceous,lateral,leaflet,lenticular,like,lobe,long,margin,middle,minutely,mm,moderately,near,oblique,ovoid-deltoid,papillose,pedicel,peduncle,petiole,petiolule,pointed,pubescence,pubescent,rachi,rotate,rounded,sand-punctate,scattered,short,slender,slightly,spaced,sparsely,stem,stigma,style,surface,tip,trichome,truncate,tube,typical,unbranched,unit,unknown,vein,vine,violet,wide-diameter,widely,x	alyx,apar,c.,capitat,eaf,eed,glabrou,lon,lower,m.,nflorescence,nternode,orolla,perfec,plurifoliat,pubescenc,ruit,tamen,tem,terrestria,vary,ympodial	abaxial,adaxial,apart,arrangement,branching,capitate,characteristic,colour,corolla,form,growth,height,history,inflorescence,internode,leaf,length,life,midvein,null,ovary,perfect,plant,plurifoliate,primary,pseudostipule,seed,shape,staman,stamen,sympodial,terrestrial,tertiary,texture,unarmed,venation
499	wfo-0001031864	success	148	112	78	70	34	0.527	.2,.25,.5,0.5-13.5,0.5-4,1-1.2,1-1.8,1-2,1.5-2.5,15-60,2-3,3-3.5,3-5-celled,3-pinnate,7.5-8,abaxially,adaxially,anther,apex,apiculate,apparently,axe,base,blue-purple,calyx,center,ciliate,cm,cuneate,deltoid,dense,densely,diameter,emarginate,entire,extra-axillary,filament,fine,flower,fruit,glabrous,hair,herb,lenticular,lobe,margin,minutely,mm,node,oblique,papillose,pedicel,peduncle,plurifoliate,pubescence,pubescent,rachi,rooting,rounded,scattered,short,simple,slender,sparsely,style,surface,terrestrial,thick,trailing,truncate,unbranched,uniseriate,unit,unknown,widely,wiry,woody,x	0.4-3,0.6-3.5,0.6-4,1-3,1-5,1-6.5,1.2-1.5,1.5,2,2.5-6,5-15,5-9,5-merou,absent,accrescent,acuminate,acute,ag,alyx,apart,apical,articulated,ba,basally,blade,capitat,clavate,color,connivent,cordate,directed,distally,eaf,eed,equal,etiole,fleshy,fruiting,geminat,interjected,large,lateral,leaflet,long,longitudinal,lower,m.,near,nflorescence,oblong,opening,orolla,perfect,petiolule,pore,pubescenc,rotate,slightly,slit,somewhat,spaced,stigma,tamen,tem,tip,tube,vary,weakly,yellow,ympodial	abaxial,adaxial,arrangement,branching,characteristic,colour,corolla,form,geminate,growth,height,history,inflorescence,leaf,length,life,midvein,null,ovary,petiole,plant,primary,pseudostipule,seed,shape,staman,stem,sympodial,tertiary,texture,true,unarmed,vein,venation
500	wfo-0001031871	exception_thrown	185	0	0	185	0	0.0		0.4-2,0.6-1.2,1-2,1.4-2.1,1.5-11,1.5-2,1.5-2.1,1.6-2.7,14-22,2-3,2-4,2.9-6,3-10,3-4,3-5,3.5-4,33-40,36-44,4-6,4-7,5-merou,5.4-12.3,6-12,6-7,6.5-20.5,7-9,7.5-23,abaxially,acumen,acute,adaxiall,adaxially,ag,alyx,anther,apart,apex,apparently,articulated,asymmetric,attenuate,axe,axillary,base,basiscopic,berry,blade,brownish,bud,capitat,cell,chartaceous,clavate,cm,condition,connivent,corolla,covering,dark,deep,diameter,digestion,distal,dorsally,dot,drying,eaf,edge,eed,elliptic,end,enzyme,erec,exceeding,filament,flat,flower,folded,forked,fresh,fruit,geminat,generally,glabrou,glabrous,globose,green,green-white,greenish,hair,hair-like,hal,half,herb,high,homostylous,honeycomb-shaped,interjected,lanceolate,lateral,leaflet,lengthening,linear,living,lobe,long,lower,make,medium,mm,mottled,mucilaginous,narrowly,nflorescence,odd-pinnate,one,orbicular,orolla,ovate,ovoid,pair,pedicel,peduncle,perfect,petiole,petiolulate,placed,plant,plurifoliate,pore,poricidal,pubescent,purple,removed,ripe,rotate,round,rounded,ruit,seed,sessile,seudostipule,short,side,size,slit,sometimes,spaced,specimen,stamen,stigma,stolo,straight,style,subequal,subglabrou,subglabrous,subtending,symmetric,tall,tamen,tem,terminal,testal,thick,throughout,tiny,tip,tissue,tri-,tube,tuber,typically,unit,usually,vary,wall,wet,white,whitish,wide,winged,x,yellow,ympodial	
501	wfo-0001031876	success	140	120	89	51	31	0.636	.1,.5,0-flowered,0.5,0.8-1,1,1-1.5,1-1.6,1-4,1.5-2.2,3,5,?,across,anther,anthesi,apex,apiculate,arising,base,bearing,beneath,berry,bright,calyx,closely,cm,corky,corolla,decurrent,dia,elliptic,filament,flower,free,glabrous,globose,green,immature,irregularity,lateral,leaf,less,lightly,lobe,long,long-acuminate,main,margin,mm,oblanceolate,oblique,often,opposite,ovary,pair,papillose,parallel,pedicel,perpendicular,persistent,petiole,portion,present,primary,prominent,raised,scar,secondary,shrub,simple,slender,slightly,spaced,stem,stigma,straight,style,tall,tapering,time,tube,unit,vein,venation,white,wide,winged,yellow	27-35,9-15,acute,arc,ba,bark,convergence,cup-like,differing,eaf,edicel,eed,erect,family,fruiting,glabrou,granular,greenish-yellow,known,lenticellat,lobed,lower,major,melastomataceae,member,middle,minute,minutely,nearly,nflorescence,otherwise,overlappin,point,pore,poricidal,recurved,reflexed,resemble,ruit,running,shaped,styl,tear-drop,tip,ud,unifoliat,widest,woody,x,ympodial,young	abaxial,adaxial,arrangement,branching,characteristic,colour,diameter,form,fruit,growth,height,history,inflorescence,length,life,mentioned,midvein,overlapping,peduncle,plant,pseudostipule,rachi,seed,shape,staman,surface,sympodial,tertiary,texture,unarmed,unifoliate
502	wfo-0001031877	success	216	159	131	85	28	0.606	.5,0.3-1,0.3-1.2,0.5-1,0.6-1.2,1-1.5,1-3,1.5,1.5-1.9,1.5-2,2,2-,2.5,3-5,3-6,3.5-4,6-10,6-8,abaxially,abruptly,acuminate,acute,adaxially,along,anther,apex,apparently,articulated,basal,basally,base,berry,bright,brown,calyx,cell,cm,corolla,deep,diameter,distal,dried,ellipsoid,enlarged,entire,erect,especially,exposed,eye,filament,flattened,flower,fruit,furcate,glabrous,globose,green,greenish,growth,hastate,impressed,lateral,like,line,lobe,lobed,long,long-acuminate,margin,material,mature,midvein,minutely,mm,occasionally,often,pair,pale,parallel,pedicel,peduncle,per,petiole,pitted,plant,plump,primary,prominently,pubescence,pubescent,purple,rectangular,red,reddish,reniform,rest,ripe,rounded,scrambler,seed,semi-woody,shiny,short,silky,simple,sinuate,sleeve,slender,slightly,sometimes,sparsely,stem,style,surface,terminal,testal,tinged,tip,triangular,trichome,truncate,uniseriate,usually,vein,vine,visible,wall,weak,white,woody,x	+,.3,0.2,0.3-,0.5,0.8-0.9,1,1-3.5,1-4,1.1-,1.8-5,5-merou,adaxiall,ag,alyx,angled,anthesi,apar,ark,ascending,capitate,clavate,conical,connivent,deflexed,deltate,densely,eaf,eed,ellipsoidal,exserted,fleshy,free,fruiting,ilament,internal,irregularly,lamina,later,lengthening,linear,loosely,lower,minute,nearly,new,nflorescence,older,orolla,outline,papillate,papillo,part,perfect,pericarp,plurifoliat,pointing,pore,poricidal,portion,purplish,reflexed,ruit,scar,shorte,slit,somewhat,spaced,spreadin,stellate,stigma,strongly,subshru,tem,thin,tube,twinin,ud,uniformly,unit,upper,vary,yello,ympodial,young	abaxial,adaxial,arrangement,branching,characteristic,colour,form,height,history,inflorescence,leaf,length,life,null,ovary,plurifoliate,pseudostipule,rachi,shape,staman,subshrub,tertiary,texture,true,twining,unarmed,venation,yellow
503	wfo-0001031880	success	180	144	119	61	25	0.661	0.5-2,0.7-0.8,1,1-1.3,1-1.5,1-2,1.5,2,2-3,3-3.5,3-4-pluri-foliate,3-foliate,3-lobed,4,5-6,6-9,7-9,abaxially,acuminate,acute,adaxially,anther,apex,basal,base,berry,broadly,brown,calyx,capitate,cell,ciliate,cm,conical,cordate,corolla,crenate,cup-shaped,curved,dark,densely,diameter,elliptic,entire,erect,filament,flattened,fleshy,flower,free,fruit,glabrous,gland-tipped,glandular,globose,green,herb,heteromorphic,hollow,inflorescence,internodal,irregularly,lamina,leaf,lobe,long,longest,lower,margin,mature,mid-length,minutely,mm,narrowly,orange,ovary,ovoid,pair,pale,papillose,pedicel,peduncle,petiole,pitted,portion,primary,pubescent,purple,rachi,red,reddish,shallowly,shortest,simple,single,slender,sometimes,sparse,sparsely,stem,straight,strongly,style,subshrub,surface,testal,toothed,trichome,truncate,tube,uniseriate,unit,unlobed,upper,upward,vein,wall,x,â5	.5,0.5-1,2-4,2-9,2.5-8,4-8,5,age,anthesi,apart,bearing,becoming,c.,color,crowded,eaf,edicel,eed,ellipsoid,enlarged,exerted,flush,fruiting,gland,growing,horn,lengthening,less,lon,markedly,maturit,middle,near,nflorescence,nodding,ovate,papillo,pericarp,plan,pore,poricidal,pubescen,reflexed,ruit,scar,slightly,slit,spaced,spreading,stigma,terminal,thin,tip,triangular,ud,unicellula,widely,widest,woody,yellow,ympodial	abaxial,adaxial,arrangement,branching,characteristic,colour,form,growth,height,history,length,life,midvein,null,plant,pseudostipule,seed,shape,staman,sympodial,tertiary,texture,true,unarmed,venation
504	wfo-0001031881	success	168	133	104	64	29	0.619	.5,0.1-0.5,0.2,0.2-0.6,0.4-1,0.5-1,1-1.3,1-1.5,1-7,1.2-6,1.5-2.5,1/3,10-12,2,3.5-4,5-6,absent,acute,along,anther,anthesi,apex,attenuate,axil,base,beneath,branched,broadly,brown,calyx,cm,constriction,corolla,dark,decurrent,deflexed,deltoid,densely,dia,difoliate,distal,dry,drying,either,elliptic,erect,filament,fruit,glabrous,globose,golden,golden-puberulent,golden-pubescent,green,incrassate,inflorescence,lateral,leaf,lightly,like,lobe,long,main,major,margin,material,midrib,minor,minute,minutely,mm,obovate,opposite,ovary,ovoid-reniform,pair,pedicel,petiole,pitted,puberulent,pubescent,rest,rounded,shape,shrub,simple,slender,small,somewhat,sparsely,stem,style,surface,tapering,tip,tree,trichome,tube,uniseriate,usually,vein,white,winged,x	0.5-0.7,10-30,2-9,3-19,3/4,7-14,apar,apparent,ba,bark,branch,bud,campanulate,capitate,differing,eaf,edicel,eed,ellipsoid,evenly,exserted,fleshy,free,fruiting,geminat,greyish-brow,inflorescenc,junction,lobed,lon,lower,maturity,middle,nflorescence,occasionally,older,one,orbicular,papillo,papillose,planar,pore,poricidal,portion,puberulen,ruit,scar,shaped,size,slightly,soon,spaced,stigma,straight,strong,tall,tear-drop,ud,unit,way,widest,woody,ympodial,young	abaxial,adaxial,arrangement,branching,characteristic,colour,diameter,form,geminate,greyish-brown,growth,height,history,length,life,mentioned,midvein,peduncle,plant,primary,pseudostipule,rachi,seed,staman,tertiary,texture,true,unarmed,venation
505	wfo-0001031886	success	169	136	107	62	29	0.633	-1.2,-4,-9,0,0.1,0.5-1,1-1.5,1-4,1.2-2.5,2-2.5,2-3,2-5,2.0-2.5,20-30,3-6,3.0,4,5-6,9-10,abaxially,abruptly,acuminate,adaxially,along,anther,anticlinal,apex,arising,attenuate,axil,base,beak,bearing,berry,bright,broadly,brown,calyx,cell,cm,commonly,completely,conical,corolla,deltate,diameter,distinctly,elliptic,epidermal,filament,fleshy,flower,fruit,glabrous,green,greenish,half,irregular,lobe,long,lower,margin,minutely,mm,narrowed,occasionally,ovary,ovoid-reniform,pair,papillate,papillose,pedicel,per,petiole,pinnate,portion,primary,projection,purple,rachi,raised,ripe,rugose,scar,seed,shape,shrub,simple,single,sinuous,smelling,somewhat,style,surface,thickening,time,tip,triangular,trichome,uniseriate,unit,vein,white,wintergreen,without,woody,x	-25,.5,1.5-2,10-40,2,2-4,4-15,5-10,5-ridged,6-20,6-8,absent,anthesi,axillary,basal,bud,capitate,clavat,dry,eaf,earl,edicel,eed,either,em,equal,erec,exserted,free,fruiting,lanceolate,lateral,le,leaflet,lobed,near,nearly,nflorescence,noddin,node,oblique,open-conical,papillae,petiolule,poricidal,reddish,reflexed,ruit,scattered,similar,smaller,sparse,specimen,stigma,strongly,terminal,tub,tube,ud,unifoliat,usually,ympodial	1,abaxial,adaxial,arrangement,branching,characteristic,colour,form,growth,height,history,inflorescence,leaf,length,life,mentioned,midvein,nodding,peduncle,plant,pseudostipule,staman,stem,sympodial,tertiary,texture,unarmed,unifoliate,venation
506	wfo-0001031895	success	160	112	86	74	26	0.537	-1.5,1-1.5,1.5-3,2-2.5,2.5-3,3-4,3.5-6,4,4-5,5,5-6,6-7,6-9,acute,anther,apex,attenuate,base,beneath,berry,bluish,calyx,cell,cm,completely,conical,corolla,dark,deltate,diameter,drying,elliptic,entire,filament,fleshy,glabrous,globose,green,growth,immature,leaf-opposed,less,lobe,margin,matte,minutely,mm,new,occasionally,older,once-branched,ovary,overlapping,ovoid,pair,pale,papillate,pedicel,peduncle,petiole,pitted,primary,reddish,reniform,revolute,shiny,shoot,shrub,simple,sinuate,slender,slightly,small,stem,stout,straight,style,surface,tan,testal,tip,tree,vein,violet,white,x	0.5,0.5-1,0.5-2,1.5-2,1.5-6,3-10,3-8,4.5-16.5,5-8,age,anthesi,apparently,articulating,bark,blac,broadly,campanulate,capitate,cup-shaped,densely,eaf,eed,ellipsoid,emarginated,enlarging,erec,erect,exerted,exfoliating,expand,flower,fragrant,free,fruiting,glabrou,inflorescenc,intensely,irregular,leafy,leaving,lengthening,lobed,lower,nflorescence,papillat,part,patch,peeling,peg,perfect,pericarp,planar,plurifoliat,pore,poricidal,portion,ruit,scar,short,slit,somewhat,stigma,strongly,terminal,thick,thin,tub,tube,ud,unit,way,woody,ympodial,Â¼-1/2	abaxial,adaxial,arrangement,branching,characteristic,colour,form,fruit,height,history,inflorescence,leaf,length,life,midvein,null,plant,pseudostipule,rachi,seed,shape,staman,tertiary,texture,unarmed,venation
507	wfo-0001031897	success	264	167	147	117	20	0.557	.5,0-1,0.1-0.5,0.15,0.4-1.1,0.5-1,0.6,0Â°,1-2,1.1,1.3-2,1.7-3,2-4,2/3,4-5,5-6,6-9,abaxial,abaxially,absent,acute,adaxial,adaxially,along,anther,anthesi,apex,apically,appearing,articulated,attenuate,axillary,base,bendy,berry,black,brachyblast,branch,branched,brown,calyx,clustered,cm,concolorous,condensed,conical,corolla,cuneate,dark,densely,developed,diameter,dilated,distributed,dry,drying,dull,elliptic,entire,epiphyte,erect,evenly,extending,faint,filament,filiform,flower,foliaceous,free,fruit,glabrous,green,grey,hair,lamina,lanceolate,lateral,leaf,least,light,like,linear,lobe,long,longitudinal,longitudinally,margin,mauve,membranous,midvein,mm,multicellular,oblong,obtuse,occasional,occasionally,one,orange,orange-brown,ovate,ovoid,pair,partly,pedicel,peduncle,pericarp,petiole,plant,pointed,portion,primary,pubescent,raised,rarely,reddish,revolute,ridge,ridged,shoot,short,shrub,simple,slender,slightly,smooth,sometimes,sparse,sparsely,stem,style,sunk,surface,terminal,tertiary,thick,thin,trichome,tube,unarmed,usually,vein,venation,visible,weakly,white,x,young	.1,.8,0.2-0.4,0.5-3,0.8-1.5,1,1-1.5,1-2.5,1.5,1.5-8,13,462.,8,accrescent,age,almost,alyx,apar,apparently,appendage,arising,aristate,bark,boiteau,cell,chartaceous,clavate,clearly,connate,coriaceous,covering,curved,datum,dehiscing,delineated,dendritic,dense,developing,development,divided,domatia,dorsal,dorsifixed,eaf,earliest,ed,enlarged,equal,even,except,eye,fine,fruiting,immature,indistinc,inner,inside,known,larger,lengthening,lobed,looped,lower,m.,main,margi,minute,minutely,multiseriate,naked,never,nflorescence,nther,obconical,oblon,orolla,outside,overlapping,papillose,part,pendulous,perfec,persisting,plurifoliat,pore,poricidal,prominent,pronounced,protruding,reach,ribbed,ruit,scar,secondary,see,seen,side,sinus,smaller,smoot,stigma,stump,subulate,tearing,terete,tip,toward,ud,unbranched,unicellular,unit,vary,well-developed,wide,winged,wrinkle,ympodial	arrangement,branching,characteristic,colour,form,growth,height,history,inflorescence,length,life,mentioned,ovary,pseudostipule,rachi,seed,shape,staman,texture,true
508	wfo-0001032157	success	136	117	86	50	31	0.632	.5,0.25,0.5-1,0.6-1,0.75-1,1-3,2-3,2.2,5-15-flowered,5-8,5-9,7-9,acute,anther,apex,base,becoming,beneath,berry,calyx,cm,completely,corolla,crystalline,decurrent,deflexed,deltoid,dia,difoliate,dry,elliptic,filament,free,glabrous,globose,golden,green,incrassate,lateral,leaf,less,live,lobe,long,longitudinal,main,major,margin,middle,minor,minutely,mm,obscure,older,opposite,ovary,ovoid-reniform,pair,paler,papillose,pedicel,peeling,petiole,pitted,plant,portion,raised,reddish,rounded,shrub,simple,slender,slightly,stem,strip,style,surface,tapering,tip,tube,unit,vein,white,widest,x,yellowish	.75,1.9-2.2,2-5,3-6,9-17,anthesi,apart,bark,beginning,bi-lobed,caly,differing,eaf,edicel,eed,evenly,exserted,frui,fruiting,geminat,glabrou,inflorescenc,living,lobed,lon,lower,nearly,nflorescence,one,papillo,persistent,pore,poricidal,reflexed,ruit,scar,shaped,shiny,size,soon,spaced,stigma,straight,tall,tear-drop,translucen,ud,woody,ympodial,young	abaxial,adaxial,arrangement,branching,characteristic,colour,diameter,form,fruit,geminate,growth,height,history,inflorescence,length,life,mentioned,midvein,peduncle,primary,pseudostipule,rachi,seed,shape,staman,sympodial,tertiary,texture,true,unarmed,venation
509	wfo-0001032161	success	146	123	93	53	30	0.637	.5,0.4-1.2,0.5-1,0.75-1,0.8-1,1-1.5,1-3,1.2-1.3,2-7,2-8-flowered,2.5-3,3.5-4,?,abaxially,acute,adaxially,anther,apex,apical,base,berry,branched,calyx,cm,coriaceous,corolla,dark,delicate,deltate,dendritic,densely,difoliate,drying,elliptic,filament,filiform,free,glabrous,globose,golden,green,hanging,inflorescence,internodal,leaf,like,lobe,long,many,margin,minute,minutely,mm,mustard,occasionally,opposite,ovary,ovoid-reniform,pale,pedicel,pericarp,petiole,pitted,plant,plurifoliate,portion,projection,pubescent,quadrate,rest,revolute,shiny,shoot,short,shrub,simple,sparsely,stem,style,sulcate,surface,tan,thin,trichome,tube,uniseriate,unit,usually,vein,white,x,yellow,yellowish	0.7-4,1-11,1.4-2,adaxiall,anthesi,area,ba,bark,beneath,brownish-blac,closely,color,conical,deflexed,dia,eaf,edicel,eed,ellipsoid,exserted,fruiting,giving,lamina,later,lobed,lower,merely,middle,nearly,nflorescence,obovate,older,overlappin,papillose,persistent,pore,poricidal,reflexed,ruit,scar,shaped,spaced,stigma,strongly,styl,tall,tear-drop,tip,tub,ud,widest,ympodial,young	abaxial,adaxial,arrangement,branching,brownish-black,characteristic,colour,diameter,form,fruit,growth,height,history,length,life,midvein,null,peduncle,primary,pseudostipule,rachi,seed,shape,staman,sympodial,tertiary,texture,true,unarmed,venation
510	wfo-0001032165	success	197	135	109	88	26	0.553	0.1,0.1-0.3,0.25-0.5,0.3-1,0.75-1,1-1.2,1-1.5,1-2,2-2.5,2.5-3.5,3-6,4-6,5-6,5-7,abaxial,acute,adaxial,along,anther,apex,base,beneath,berry,broadly,brown,calyx,capitate,center,cm,continued,corolla,dark,deciduous,decurrent,deltoid,densely,denser,dia,difoliate,distal,dry,due,dull,edged,elliptic,end,erect,filament,glabrous,globose,golden,golden-puberulent,golden-pubescent,green,inflorescence,lateral,leaf,less,like,lobe,long,main,major,margin,medial,midrib,minor,minute,minutely,mm,near,obovate,occasionally,once-furcate,onto,ovary,ovoid-reniform,pair,papillose,pedicel,petiole,pitted,plant,presence,prominent,purplish,ridge,ripe,shape,simple,single,small,specimen,stem,stout,stripe,style,surface,tall,tinged,tip,tree,trichome,uniseriate,vein,white,x,yellowish,young	.25,.5,1.5-4,10-25,3-4,3.5-8.5,5-15,5-30-flowered,5-9.5,8-9,anthesi,apparent,appearing,ba,bark,beginning,bud,closely,cucullate,cup-shaped,differing,eaf,edicel,eed,ellipsoid,entire,even,expansion,exserted,exsertion,free,fruiting,geminat,greyish-brown,immature,inflorescenc,later,live,lobed,lon,lower,markedly,middle,nearly,nflorescence,node,older,one,opposite,orbicular,overlapping,pale,paler,papillo,planar,pore,poricidal,portion,puberulent,rather,rest,rounded,ruit,scar,shaepd,size,slender,slightly,slow,smoot,spaced,stigma,straight,strongly,swollen,tapering,tear-drop,terminal,thickened,time,tub,tube,ud,unit,widest,winged,woody,ympodial	arrangement,branching,characteristic,colour,diameter,form,fruit,geminate,growth,height,history,length,life,mentioned,midvein,peduncle,primary,pseudostipule,rachi,seed,staman,tertiary,texture,unarmed,venation,ye
511	wfo-0001032167	success	163	128	102	61	26	0.626	.5,0.5-1,0.5-1.5,0.5-2.5,1-2,1-2-celled,1-2.5,1-5,1.5,10-20,10-35,12-20,2-4,2-7,3-6,4-6,5-15,7-10,abaxially,absent,acute,adaxially,anther,apex,appressed,axe,base,berry,brown,calyx,cell,ciliate,closely,cm,connected,curved,decurrent,densely,diameter,dm,drying,elliptic,elliptic-ovoid,entire,few-,filament,flattened,flower,forming,fruit,geniculate,glabrous,globose,growth,hair,herb,immature,larger,linear-lanceolate,lobe,many-branched,margin,maturing,mm,moderately,near,nearly,netlike,notch,obtuse,often,one-celled,pedicel,peduncle,per,petiole,placenta,projection,pubescent,purple,rachi,raised,rounded,seed,semitransparent,slightly,small,sometimes,sparsely,staman,straight,style,surface,twisted,two-celled,unbranched,vein,wall,white,woody,x,yellow	0.75-3,1,1-3,1-7,2-foliate,3-7,4-10,abundant,adaxiall,along,blade,chartaceous,common,cordate,dehiscing,dense,denser,eaf,eed,emarginat,explosively,flat,frui,geminat,growt,held,interpetalar,long,longer,lower,lowermost,lying,maturit,membranaceous,mesocarp,new,nfloresence,oblong,older,orolla,pressure,pubescen,rotate,ruit,shorter,smaller,stamen,stigma,tal,tamen,tem,tissue,triangular,tube,unit,upper,usually,vary,watery,wid,ympodial	abaxial,adaxial,arrangement,branching,characteristic,colour,corolla,form,height,history,inflorescence,leaf,length,life,midvein,null,ovary,plant,primary,pseudostipule,shape,stem,tertiary,texture,unarmed,venation
512	wfo-0001032176	success	177	145	114	63	31	0.644	.5,0,0.5,0.5-0.7,0.5-0.75,0.5-1,0.8-1,0.8-6,1-1.2,1-10,1.5-1.6,1.5-2.5,1/2,100,2-3,3-3.5,3-4,5-6-celled,6,6-10,7,adaxially,along,anther,apart,apex,apical,arising,attenuate,axil,axillary,base,beak,berry,branched,calyx,cell,cm,conical,containing,corolla,creeping,densely,denser,diameter,drying,elliptic,epidermal,especially,filament,filiform,flower,free,fruiting,glabrous,green,greenish,grey-brown,greyish,herb,leaf,like,lobe,long,long-papillose,lower,margin,minute,minutely,mm,nodding,obtuse,occasionally,onto,open,ovary,ovoid-reniform,pale,pedicel,per,petiole,pinnate,portion,projection,pubescent,quadrate,rachi,rest,rounded,scar,seed,separate,simple,single,sinuous,spaced,sparsely,stem,style,thickening,time,tip,trichome,truncate,tube,unevenly,uniseriate,unit,vein,wall,white,winged,without,x	0.42,1.5-6,2.5-10,3-15,3-7,adhering,anthesi,attaining,basal,becoming,capitat,cateniform,copiously,cucullate,eaf,edicel,eed,ellipsoid,equal,exserted,fallen,globose,hangin,inflorescenc,lateral,leaflet,lengt,lengthening,lobed,log,nearly,nflorescence,node,obovate,often,pair,papillose,petiolule,pore,poricidal,reflexed,rooting,ruit,size,slightly,slit,smaller,somewhat,soon,stigma,strait,strongly,tem,terminal,tightly,tree,trunk,tub,ud,ultimate,unifoliat,whit,ympodial	abaxial,adaxial,arrangement,branching,cateniforme,characteristic,colour,form,fruit,growth,hanging,height,history,inflorescence,length,life,mentioned,midvein,peduncle,plant,primary,pseudostipule,shape,staman,surface,sympodial,tertiary,texture,unarmed,unifoliate,venation
513	wfo-0001032187	exception_thrown	139	0	0	139	0	0.0		-11,-2.1,-4,-4.2,-5,-9,0.1â1.4,0.5,0.5-,0.5â1,0.6â1.3,1.1â3.2,1.3â1.8,1.6â2.1,1.8â2,1.8â2.8,100,1â1.7,22,24.6â26.3,2â9,3.1â3.5,3â3.2,3â4,5-merous,5â7,7â11,9,acuminate,acute,adherent,alyx,angular,anther,ape,apex,appressed,aromatic,base,berry,blade,branch,broadly,brown,brownish,changing,cm,consisting,corolla,cyme,dark,di-foliate,dia,dull,eaf,eed,eglandular,elliptic,entire,equal,erect,filament,flowered,forked,fully,geminat,glabrescent,globose,granule,green,hair,herb,hite,hooked,hydrated,leaf,light,lobe,long,lower,many,margin,marked,mature,mm,nflorescence,numerous,obovate,occasionally,ovate,pedicel,peduncle,penden,pentagonal,per,perfec,persistent,petiolate,petiole,plant,pollen,predominantly,presen,protruding,purple,rarely,ridge,ruit,running,sclerotic,short,simple,small,soft,sometimes,sparse,spreading,stage,stellate,stem,straight,style,sub-glabrous,texture,tinged,tooth,triangular,truncate,unit,well,widest,wing,yellow,yellowish,ympodial,Â±,Â±1,Âµm,Ã	
514	wfo-0001032206	exception_thrown	216	0	0	216	0	0.0		-0.8,-2,-20,-5,..,.2,.5,0,0.2,0.2â0.4,0.2â0.5,0.5â1,0.8â1.2,00â200,0â20,0â30,0â5,1,1.1â1.2,1.2â2.2,1.5â2,1.5â2.5,1/3,1/4â1/2,1/4â1/3,1/6,10â80,11â22,1â2,1â2.3,1â3,1â4,2.5â3.3,2.7â3.5,2â2.5,2â3,2â8,3.5â9,30â80,3â4,4.5â5.8,4â6,5-merous,5â15,5â20,5â6,5â8,5â9,6â10,6â15,6â8,7â10,8â20,abaxially,accrescent,acute,adaxially,alyx,andromonoecious,anther,apar,apart,apex,apically,apparently,approximately,armed,articulated,bark,base,berry,blade,bluntly,branched,broad-deltate,brow,calyx,chartaceous,clearly,cm,concolorous,connivent,covering,cream,cuneate,curved,dark,deltate,diameter,discolorous,distal,distance,drying,eaf,eed,elliptic,equal,erect,extending,filament,flattened,flattened-reniform,flower,foliaceous,free,fruit,fruiting,functionally,gently,glabrescent,glabrous,green,green-brown,hermaphroditic,heterostylous,infructescence,lateral,leaf,lengt,length,lobe,lobed,lobing,long,long-styled,longer,lowermost,mal,margin,marking,mature,maturity,mauve,midpoint,midvein,mm,moderately,nflorescence,obtuse,often,older,one,open,orange-brown,orolla,ovate,ower,pair,pale,pedicel,peduncle,pendent,pendulous,per,pericarp,petiole,plant,plurifoliat,poricidal,porrect,portion,prickle,primary,purple,rarely,ray,reflexed,scar,secondary,sessile,short-styled,shrub,side,slender,smooth,sometimes,spaced,sparsely,spherical,spreading,stalk,stalked,stellate,stellate-pubescent,stem,stout,straight,style,surface,tamen,tapering,tertiary,time,tip,toward,trichome,truncate,tube,uit,unarmed,ung,unit,usually,variously,vary,vein,venation,visible,weakly,white,wide,woody,yellow,yellow-orange,ympodial,young	
515	wfo-0001032209	success	257	170	148	109	22	0.576	-30+,0.5,0.5-1,1,1-1.5,1-2,1-6,1.5-2,1.5-6,10-13,100,2,2-3,2-3-lobed,2-5,2/3,20-30,3-7,4-20,5-8,6-8,absent,acute,adaxial,along,anther,apex,apiculae,apparently,appearing,arching,articulated,axi,basal,base,berry,blue,branch,branched,broadly,calyx,canopy,cell,climbing,cm,colour,conspicuously,cordate,corolla,deltate,dendritic,densely,denser,diameter,distally,distinct,ecuador,elliptic,entire,especially,evenly,filament,finely,flattened-reniform,flower,glabrous,globose,groove,growth,hairy,inflorescence,lamina,large,lateral,leaf,leathery,leaving,length,like,lobe,long,margin,mean,mere,metallic,midrib,midvein,minutely,mixture,mm,narrowly,occasionally,often,ovate,pair,particularly,pedicel,peduncle,peg,pentagonal,per,pericarp,petiole,pinnately,pinnatifid,primary,puberulent,pubescence,pubescent,purple,red,rest,rim,ripe,several,shiny,simple,sleeve,small,sometimes,somewhat,sparser,stem,style,surface,terminal,testa,testal,thin,time,tiny,tip,trichome,truncate,tube,twining,uniseriate,upper,variable,vein,vine,violet,w,wall,white,within,woody,x	-11,-20,.5,0.3,1-2-celled,1.5,1.5-,1.5-2.5,12-16,2.5-,3-9,4,5-merou,6-15,ag,alyx,anthesi,apart,ark,berr,bilobed,brown,bu,capitate,cast,chartaceous,conical,connivent,coriaceous,cucullat,dark,deeply,dried,eaf,early,eed,ellipsoid,enlarged,equal,erect,exerted,fleshy,flowering,free,fruiting,geminat,giving,glabrescen,hanging,hastate,held,hollow,ilament,keeled,lengthening,less,lobed,longer,longest,lower,markedly,material,middle,minute,near,nearly,new,nflorescence,nipple,older,one,orolla,papillae,papillat,papillate,part,perfect,planar,plurifoliate,pointed,pore,poricidal,portion,probably,reddish,rhachi,ruit,sagittate,scar,slit,spaced,spreading,stellate,stigma,stout,tapering,tem,third,tightly,twinin,ud,unequal,unit,usually,vary,weight,widest,yellow,ympodial	abaxial,arrangement,branching,characteristic,form,fruit,height,history,life,null,ovary,plant,pseudostipule,rachi,seed,shape,staman,tertiary,texture,true,unarmed,venation
516	wfo-0001032232	success	137	128	95	42	33	0.693	.5,0.1,0.25,0.5,0.6-3,0.8-1,1-3,2,2-2.6,20-100-flowered,5-6,abruptly,age,anther,apex,attenuate,base,becoming,berry,calyx,closely,cm,corolla,decurrent,deflexed,dia,distally,elliptic,erose,evenly,filament,filiform,flower,free,glabrous,globose,green,greenish-brown,immature,irregular,lateral,leaf,lenticellate,less,light,lightly,lobe,long,long-acuminate,main,margin,middle,midrib,minutely,mm,narrowly,node,occasionally,onto,opposite,ovary,ovoid-reniform,packed,pair,pale,paler,papillose,pedicel,petiole,pitted,portion,prominent,raised,revolute,rounded,scar,short-styled,shrub,simple,slightly,somewhat,sparsely,stem,style,subshrub,surface,tube,umbonate,undulate,unit,vein,wide,widening,widest,winged	0.5-1,1.8-2,18.8-27.5,3/4,4.8-7.3,?,anthesi,ba,bark,clavate,cup-shaped,dark-papillose,eaf,edicel,eed,erect,exfoliatin,fruiting,lobed,lower,minute,nflorescence,overlappin,papillo,pore,poricidal,reflexed,ruit,shaped,stigma,straight,tall,tear-drop,ti,tip,translucent,tub,ud,unifoliat,way,woody,ympodial	abaxial,adaxial,arrangement,branching,characteristic,colour,diameter,exfoliating,form,fruit,growth,height,history,inflorescence,length,life,midvein,null,overlapping,peduncle,plant,primary,pseudostipule,rachi,seed,shape,staman,sympodial,tertiary,texture,unarmed,unifoliate,venation
517	wfo-0001032233	success	160	129	97	63	32	0.606	0-2,0.3-2,1-1.5,1-2,1-3,1.5-2.5,10-15,157,2-15,2-3,2-5.5,2-6,2.5-4,20-100+,25-40,3-15,3-4,3-5,3.5-4,4-5,4-7,5-16,5-6,abaxially,acuminate,acute,adaxial,adaxially,almost,apart,apex,articulated,axe,basal,base,beyond,branched,calyx,cm,cordate,cylindrical,dark,densely,diameter,dilated,distally,ellipsoidal,entire,exserted,flattened,fleischmann,fleshy,flower,fruit,glabrate,glabrescent,glabrous,glandular-puberulent,green,leaving,lobe,long,longitudinal,margin,mm,moderately,obtuse,orange,ovate,ovoid,pedicel,pedicellar,peduncle,perfect,petiole,puberulent,pubescent,purple,radiu,remnant,shallowly,slightly,small,spaced,sparsely,stamen,stripe,style,tip,tree,triangular,truncate,unbranched,vein,x,yellow,yellow-green	2-4,3-4.5,4-18,4-foliat,6-25,8-12,absen,absent,aggregate,ape,bent,biglandula,blade,brow,cell,chartaceous,connective,connivent,convex,coriaceous,directed,eaf,eed,equal,especially,exceeding,globose,laterally,lon,lower,narrowly,nflorescence,nther,oblong,orolla,pore,present,projection,puberulen,rachise,ruit,shorter,simple,somewhat,stellate,stigma,stone,subcoriaceous,subpeltiform,tal,tem,thecae,time,tomento,toward,tube,ud,unit,vary,white,wide,yellow-orange,ympodial	abaxial,anther,arrangement,branching,characteristic,colour,corolla,filament,form,growth,height,history,inflorescence,leaf,length,life,mentioned,midvein,ovary,plant,primary,pseudostipule,rachi,seed,shape,staman,stem,surface,tertiary,texture,unarmed,venation
518	wfo-0001032259	success	202	175	153	49	22	0.757	-4,.5,0-2,0-20,0-4,0-5,0.1-0.2,0.15-0.3,0.45-0.6,0.5-0.8,0.5-1.5,0.7-1.1,0.9-1.2,1-1.8,1-2,1-2.5,1.5-4.5,1/2,1/3,1/4-1/3,1/6-1/5,10-30,15-40,2-2.5,2-4,2-5,2.2-3,20-60,3-4,4,4-5,5,5-30,5.5-8,7-8,abaxial,abaxially,acute,adaxial,almost,anther,apart,apex,apically,apparently,articulated,base,berry,blade,branched,broad-deltate,brown,calyx,cm,conical,connivent,cordate,cuneate,dark,deltate,densely,diameter,difoliate,distance,dull,equal,erect,evenly,extending,filament,flattened,flattened-reniform,flower,free,fruit,geminate,glabrous,gland,green,hair,infructescence,lateral,leaf,length,lobe,lobed,long,lower,margin,maturity,mauve,midpoint,midvein,minute,mm,one,open,orange,orange-brown,ovate,pair,pedicel,peduncle,per,pericarp,petiole,poricidal,porrect,portion,prickle,prickly,primary,pubescent,ray,recurved,red,reduced,rounded,scar,sessile,shrub,side,simple,slender,smooth,sometimes,spaced,sparsely,spherical,stellate,stellate-pubescent,stem,straight,style,surface,tapering,terete,terminal,tertiary,time,tip,toward,trichome,tube,unarmed,unit,vein,venation,visible,white,wide,yellow,young	/3,/4,0,0-10,0.1-0.3,0.8-1.3,3/,4-6,4-9,5-merous,7-16,9-22,acut,alyx,apar,bark,becoming,brownish,chartaceous,discolorous,drying,eaf,eed,elongating,fruiting,fully,glabrescent,green-brow,longer,mature,moderately,nflorescence,older,opening,orolla,oung,pendulous,perfec,prickl,ruit,shorter,spreading,strongly,tamen,vary,way,woody,yellow-green,ympodial	3/4,arrangement,branching,characteristic,colour,corolla,form,growth,height,history,inflorescence,life,null,ovary,plant,pseudostipule,rachi,seed,shape,staman,sympodial,texture
519	wfo-0001032260	exception_thrown	216	0	0	216	0	0.0		-0.5,-1.5,-10,-3,-8,.1,/5,0-,0-0.5,0-10,0-20,0-5,0-8,0.1,0.1-0.3,0.1-0.4,0.15-0.3,0.2,0.2-0.5,0.4,0.5-0.8,0.5-2,0.5-5,0.6-0.8,0.7,0.7-1.5,0.8-1.1,1-1.7,1-3,1-5,1-6,1.2-1.7,1.5-4,1/2,1/3,1/3-1/2,1/3-1/5,10-30,2,2-20,2-4,2-5,2.5,2.5-3,2.5-3.5,3-10,3-5,3-8,3-9,4-,5-,5-20,5-merous,6-10,6-8,7-15,abaxial,abaxially,acuminat,acuminate,acute,adaxial,alyx,anther,apar,apart,apex,apically,apparently,articulated,bark,base,berry,blade,branched,broad-deltate,calyx,cell,chartaceous,cm,connivent,cuneate,curved,deltate,densely,diameter,difoliate,discolorous,distance,drying,dull,eaf,eed,elliptic,elongating,equal,erect,extending,eye,filament,flattened,flattened-reniform,flower,free,fruit,fruiting,geminat,glabrescent,glabrou,glabrous,gland,glaucous,globular,gray-brow,green-brown,infructescence,lateral,leaf,length,lobe,lobed,lon,long,long-styled,longer,lower,margin,mature,maturity,mauve,midpoint,midvein,mm,moderately,naked,narrow-ovate,nflorescence,older,one,open,orange-brown,orolla,oung,outline,ovate,pair,pale,pedicel,peduncle,pendulous,per,perfec,pericarp,petiole,pit,poricidal,porrect,portion,prickl,prickle,prickly,primary,pubescent,purple,raised,ray,red,reduced,reflexed,rounded,ruit,scandent,scar,sessile,shallowly,shorter,shrub,side,simple,slender,small,smooth,spaced,sparsely,spherical,spreading,stalk,stalked,stellate,stellate-pubescent,stem,strongly,style,subentire,surface,tamen,tapering,terete,terminal,tertiary,time,tip,trichome,tube,unit,variously,vary,vein,venation,visible,way,wide,woody,yellow,yellow-green,ympodial	
520	wfo-0001032264	success	183	147	118	65	29	0.645	.2,.5,0.25-0.75,0.5-1,0.6-2.2,0.8-10,1-1.5,1.2-2,1.5-1.8,10-22,2-50-flowered,3,3-15,4.5-5,5-9,acuminate,acute,along,anther,apex,apiculate,appearing,base,berry,branched,broadly,calyx,cell-layer,cm,corolla,cup-like,curling,densely,dia,difoliate,dry,elliptic,epidermal,filament,flattened-reniform,flower,free,glabrous,globose,green,incrassate,inflorescence,lamina,large,lateral,layer,leaf,like,lobe,long,main,major,margin,material,middle,minor,minute,minutely,mm,narrowly,occasionally,often,older,one,opposite,ovary,pair,pale,parallel,pedicel,peeling,petiole,pitted,plant,portion,primarily,prominent,pubescent,quite,raised,red-papillose,reddish,reddish-tan,revolute,rounded-deltoid,scattered,several,sheet,short,shrub,simple,small-celled,sparsely,stem,style,surface,thick,time,transversely,tree,trichome,tube,uniseriate,unit,upper,vein,weak,white,whitish,widest,x,yellowish-brown,young	0.25-0.5,0.8-4,1.8-3,2-6,3-9,6-17,anthesi,apar,ba,bark,bud,bullate,cell,closely,deciduous,deflexed,differing,eaf,edicel,eed,exserted,fleshy,fruiting,geminat,gnarled,greyi,habitat,hair,larger,live,lobed,lon,lower,multiseriate,nearly,nflorescence,overlapping,ovoid,papillo,papillose,planar,pointed,pore,poricidal,ruit,scar,shaped,sheltered,size,slender,small-capitate,somewhat,soon,spaced,stigma,straight,tall,tapering,tear-drop,tip,trunk,ud,wide,woody,ympodial	abaxial,adaxial,arrangement,branching,characteristic,colour,diameter,form,fruit,geminate,growth,height,history,length,life,mentioned,midvein,peduncle,primary,pseudostipule,rachi,seed,shape,staman,sympodial,tertiary,texture,unarmed,venation
521	wfo-0001032274	success	192	134	109	83	25	0.568	0,0.15-0.2,0.5,0.5-0.7,0.5-1,0.5-1.5,0.7-1.8,1-1.2,1-1.5,1-3,2,2-7,3-10,3-4,5-7,<,acuminate,acute,anther,anthesi,apex,apiculate,arching,articulated,axillary,basal,base,berry,branch,brown,calyx,cell,clustered,cm,corolla,deltate,dendritic,densely,diameter,elliptic,entire,filament,filiform,flattened-reniform,flower,glabrous,globose,growth,highly,inflorescence,lanceolate,lax,leaf,lobe,long,margin,minutely,mm,nodding,obtusely,occasionally,often,once-branched,one,pair,pedicel,peduncle,per,pericarp,petiole,pitted,platform,primary,pubescent,purple,quadrate,red,reddish,ripe,rounded,shape,shiny,shoot,short,shrub,simple,sleeve,sometimes,sparsely,square,stem,style,surface,terminal,testal,thin,tinged,tip,trichome,truncate,two,uniseriate,usually,variable,vein,violet,visible,white,x	.5,0.9-1,1.5-2,2-3.5,3-5,3-6,3/4,5-merou,ag,alyx,apparently,appearance,ark,ba,borne,capitate,conical,connivent,distal,eaf,eed,ellipsoid,exserted,fleshy,free,fruiting,geminat,glabrou,green,grey,group,ilament,irregular,lengthening,less,like,lobed,loosely,lower,markedly,membranous,minute,new,nflorescence,non-reproductive,older,orolla,pale,papillo,peg,pendan,perfect,platfor,plurifoliate,pore,poricidal,portion,puberulent,reflexed,reproductive,ridge,ridged,ruit,scar,size,slit,small,somewhat,stellate,stigma,strongly,suckering,tem,tube,twinin,ud,unit,upper,vary,way,woody,yellow,ympodial	abaxial,adaxial,arrangement,branching,characteristic,colour,form,fruit,height,history,length,life,midvein,null,ovary,plant,pseudostipule,rachi,seed,staman,tertiary,texture,true,unarmed,venation
522	wfo-0001032276	success	152	139	110	42	29	0.724	-,.25,.5,0.25-1.5,0.3-1,0.5-1,0.8-1,1-1.5,1-2,2-2.5,3-3.5,3-6-flowered,5-7,7-8,acute,along,anther,anthesi,apex,attenuate,base,beneath,broadly,brown,calyx,cm,converging,corolla,cup-shaped,curly-tipped,dark,decurrent,deltoid,densely,dia,dry,elliptic,except,filament,filiform,free,geminate,glabrous,globose,green,lamina,lateral,leaf,like,lobe,lobed,long,long-pubescent,main,margin,material,middle,minutely,mm,narrowly,nearly,node,non-reproductive,occasionally,onto,opposite,ovary,ovoid-reniform,pair,pale,pedicel,perhaps,petiole,pitted,plant,pore,poricidal,portion,prominent,pubescent,raised,reflexed,rest,shaped,shrub,simple,slender,sparsely,stem,straight,straw-colored,strongly,style,surface,tall,tapering,tear-drop,tip,triangular,trichome,tube,unifoliate,uniseriate,unit,vein,white,widest,winged,x,yellow	0.5-0.75,1,1.8-2,2.5-4,9-18,apart,ba,bark,blade,capitat,deflexed,eaf,edicel,eed,ellipsoid,evenly,exserted,fruiting,greyish-gree,later,lower,minute,nflorescence,obovoid,older,papillose,raise,remaining,ruit,scar,short,slightly,somewhat,soon,spaced,stigma,tub,ud,widely,woody,ympodial,young	abaxial,adaxial,arrangement,branching,characteristic,colour,diameter,form,fruit,growth,height,history,inflorescence,length,life,midvein,null,peduncle,primary,pseudostipule,rachi,seed,shape,staman,sympodial,tertiary,texture,unarmed,venation
523	wfo-0001032277	exception_thrown	163	0	0	163	0	0.0		.5,0.1-0.5,0.2-0.6,0.75-1,0.8-3,1-1.1,1-1.2,1-1.5,1-2,1-5,1.5-1.8,1/2,10-14,2-2.5,2-4,2-6-flowered,3-3.5,3-9,5-6,8-9,acute,along,anther,anthesi,apex,apiculate,appear,appearing,area,auriculate,ba,bark,base,beneath,berry,blade,blunt,branched,bright,calyx,closely,cm,coriaceous,corolla,cup-shaped,deltoid,densely,dia,drooping,dry,eaf,edicel,eed,ellipsoid,elliptic,erect,exserted,filament,flattened-reniform,free,fruit,fruiting,geminat,glabrous,globose,gre,green,immature,impressed,incrassate,indentation,inflorescence,internodal,lateral,lax,leaf,like,lobe,lobed,long,lower,main,margin,mature,middle,minutely,mm,nflorescence,number,obscured,occasionally,older,opposite,ovary,overlapping,pair,pale,paler,papillae,papillose,partially,pedicel,petiole,pitted,pore,poricidal,portion,prominent,puberulent,pubescenc,pubescent,raised,reddish,remaining,rest,revolute,ripe,round,rounded,ruit,scar,shrub,simple,slende,slender,small,spaced,sparsely,specimen,spicy-fragrant,stem,stigma,straight,strict,strongly,styl,style,surface,tall,tapering,tip,translucent,trichome,truncate,trunk,tub,tube,two,ud,uniseriate,unit,varying,vein,virgately,way,white,widest,woody,x,yellow,yellowish-tan,ympodial,young	
524	wfo-0001032304	success	249	204	181	68	23	0.727	-3,.9-1.4,/20,0.2-0.3,0.3-1.5,0.5-3,0.5-4.5,0.9-1.3,1,1.1-2,1.2-2.3,1.2-3,1.3-2.1,1.5-3.2,1.6-1.9,1/2,1/5,1/8,10,18,2-4,2-5,2.5-19.5,2/3-3/4,21,3-10,3-15,3-20,3-6,3.2-3.8,3.2-5.5,4-7.5,44,7-27,7.5-12,9-13,abaxially,acuminate,acute,adaxially,along,anther,apart,apex,articulated,ascending,axillary,base,becoming,berry,blackish,blade,branch,branched,broadly,brown,brownish,bud,calyx,closely,cm,conical,continued,corolla,dark,decurrent,deltoid,dendritic-echinoid,densely,diameter,directed,distal,due,echinoid,elliptic,entire,especially,exserted,few-,filament,fleshy,flower,fruit,glabrescent,granular-tomentose,green,greenish,growth,hair,honeycombed,juvenile,lateral,leaf,length,lobe,long,long-,long-attenuate,long-stalked,many,many-rayed,margin,midvein,mixed,mm,mostly,multangulate,obtuse,occasionally,often,older,ovate,overlapping,pale,partly,pedicel,peduncle,petiole,plant,plurifoliate,porrect-stellate,present,probably,pseudo-terminal,pubescent,rachi,rarely,rather,ray,relatively,reniform,reticulate-punctate,ripe,scabridulous,seed,sessile,short,short-,short-stalked,shrub,side,simple,small,spaced,sparingly,spreading,stamen,stellate-tomentose,stem,style,subglobose,suborbicular,sulcate,terete,testa,thick,thick-stalked,thin-,thin-stalked,time,tomentose,touching,toward,tree,triangular-ovate,tube,unarmed,unit,usually,vein,velutinous,violet,way,white,whitish,wide,within,x,yellow,yellowish,young	.6-1.2,0-120,1-3.5,1.8-4,1/3-1/2,2-4.2,3-4.5,5-6,5.5-9,accrescent,ag,anthesi,apical-lateral,apparently,appressed-tomentose,axe,ba,bark,blunt-tipped,campanulate,capitat,chartaceous,dehiscing,dendritic,dendritic-echinoi,eaf,echinoi,extend,few-rayed,free,fruiting,glabrescen,glabrous,high,inserted,introrse,large,least,lobed,longitudinal,lower,m.,main,multangulat,nflorescence,oblong,obscured,opaque,orbicular,orolla,ovat,ovate-lanceolate,perfect,pore,rotate-stellate,ruit,runk,slit,somewhat,stigma,strongly,suture,tamen,thin,tomentu,unarme,vary,ympodial	abaxial,adaxial,arrangement,branching,characteristic,colour,form,height,history,inflorescence,life,ovary,primary,pseudostipule,shape,staman,surface,sympodial,tertiary,texture,true,unspecified,venation
525	wfo-0001032307	success	153	108	82	71	26	0.536	0.2-0.5,0.4-1.3,1-1.5,1-2,1.5-2,1.5-5,10-20,2-5,2.5-12,2.5-3.5,3.5-4,4-8,abaxial,acute,adaxial,along,anther,apex,bark,base,berry,branched,calyx,cm,congested,corolla,dark,deltate,dendritic,densely,elliptic,erect,filament,flattened-reniform,glabrous,globose,green,growth,incrassate,inflorescence,lateral,leaf,like,lobe,main,many,margin,middle,minutely,mm,older,ovary,pair,pale,pedicel,petiole,pitted,plant,prominent,pubescent,reddish,reddish-brown,rest,shrub,small,sparsely,stem,style,surface,tan,terminal,thick,thickened,time,tree,tree-like,trichome,truncate,vein,white,widest,young	.5,/3,2.5-3,30,5-12,5-25-flowered,7-18,?,anthesi,apar,blade,body,branch,brow,campanulate,capitate,christmas-tree-like,dia,eaf,edicel,eed,either,ellipsoid,elongate,exserted,flat,fleshy,free,fruiting,glabrate,immature,inflorescenc,later,lobed,lon,long,loose,lower,minute,new,nflorescence,papillae,papillo,petal,planar,plurifoliat,pore,poricidal,portion,ruit,scar,shaped,spaced,stigma,stout,strongly,tall,tear-drop,tip,tub,tube,type,ud,unevenly,upper,variable,way,wide,within,woody,ympodia	arrangement,branching,brown,characteristic,colour,diameter,form,fruit,height,history,length,life,mentioned,midvein,peduncle,primary,pseudostipule,rachi,seed,shape,staman,tertiary,texture,true,unarmed,venation
526	wfo-0001032308	success	190	167	138	52	29	0.726	0-3,0.2-2.1,0.3-5,0.7-1,1-10,1-2,1.5-2.5,1.8-2.5,1.9-3,12-16,2,2-6,3-10,3-6,3.8-5,4-7,4-8,4.8-7.7,5-7,6,6-11,8-9,abaxially,absent,acute,adaxially,anther,apart,apex,apparently,articulated,axe,axillary,base,berry,broadly,brownish,bud,cell,chartaceous,cm,condition,cordate,corolla,covering,cuneate,deep,diameter,digestion,distal,dot,drying,elliptic,enzyme,filament,flower,forked,fresh,fruit,generally,glabrous,globose,greatly,green,green-white,greenish,hair,hair-like,half,honeycomb-shaped,interjected,invested,irregular,larger,lateral,leaflet,like,lobe,lobed,long,make,margin,medium,membranous,minute,mm,much,mucilaginous,narrowly,non-glandular,obtuse,odd-pinnate,often,orbicular,ovate,ovoid,pair,pedicel,peduncle,perfect,petiole,petiolulate,petiolule,plant,plurifoliate,pubescent,pure,removed,ripe,rounded,scattered,seed,sessile,shape,short,slightly,spaced,stem,straight,style,subtending,sympodial,terminal,testal,thick,throughout,tri-,trichome,truncate,typically,unit,usually,varying,wall,wet,white,whitish,x	0.7-1.2,2-3,2-4,5-merou,acumen,ag,along,alyx,blade,capitat,ciliate,clavate,connivent,dorsally,eaf,edge,eed,especially,exceeding,flat,folded,geminat,glabrou,hal,homostylous,lanceolate,leave,lengthening,living,lower,midrib,minutely,nflorescence,orolla,pentagonal,pore,poricidal,puberulent,ruit,seudostipule,slit,specimen,stamen,ste,stigma,substellate,tamen,tip,tube,vary,wide,yellow	abaxial,adaxial,arrangement,branching,calyx,characteristic,colour,form,geminate,growth,height,history,inflorescence,leaf,length,life,midvein,null,ovary,primary,pseudostipule,rachi,staman,surface,tertiary,texture,unarmed,vein,venation
527	wfo-0001032335	success	215	173	145	70	28	0.674	.2,.5,0.05,0.2,0.2â0.3,0.4,0.5,0.5â1,100,100+,10â12,12â15,15,16,1â1.2,1â1.5,1â3,2.5â3,2â10,2â5,4â14,4â6-rayed,5â6,6â19,6â6.5,7â10,>,abaxial,abaxially,acuminate,acute,adaxial,along,anther,anthesi,apex,appearing,articulated,attenuate,axe,base,beneath,berry,branched,branching,bright,c.,calyx,cell,center,cm,corolla,covered,deltate,densely,diameter,elliptic,elongate,entire,equal,evenly,filament,flattened-reniform,flower,fused,globose,golden-yellow,growth,half,impressed,inflorescence,lamina,length,less,like,lobe,long,lower,many,margin,markedly,midpoint,minutely,mm,moderately,multangulate,narrowly,near,nodding,onto,orange,pair,pale,part,pedicel,peduncle,peltate,per,pericarp,persistent,petiole,pitted,plane,plurifoliate,porrect,porrect-stellate,primary,pubescence,pubescent,ray,ripe,scurfy,sessile,shiny,short,short-stalked,shrub,simple,slightly,small,sometimes,somewhat,sparsely,square,stem,stout,stub,style,surface,terminal,testal,thin,time,tree,trichome,unevenly,unit,upper,varying,vein,visible,white,wide,â4,âstellate	'',0,0.9â1,1.5â2,2â2.5,3361,4â5,5-merou,ag,alyx,apar,ark,boh,capitate,chartaceous,closely,connivent,cup-shaped,dichasia,discolorous,drying,eaf,eed,ellipsoidal,erec,exserted,fide,free,fruiting,glabrous,gold,golden-brow,gradually,ilament,lengthening,lobed,loosely,membranous,minute,narrowing,new,nflorescence,older,orolla,papillo,perfect,pore,poricidal,portion,reddish,reflexed,regularly,ruit,scar,silvery,slit,spaced,stellate,stigma,strongly,tal,tem,tip,tube,ud,vary,way,woody,yellow,ympodial	--,1,1.5,arrangement,characteristic,colour,dichasial,form,fruit,height,history,leaf,life,midvein,null,ovary,plant,pseudostipule,rachi,seed,shape,staman,sympodial,tertiary,texture,true,unarmed,venation
528	wfo-0001032337	success	225	154	124	101	30	0.551	0.4-1.5,0.5-3.5,1-10,1-2,1.2-2.8,1.4-2,1.6-4,2-3.5,2.3-11.5,2.3-4.8,3-8,3.6-5,4-17,4-6,4-9,5-11,8-10,9-21,abaxially,acuminate,acute,adaxially,anther,apart,apex,apiculate,apparently,articulated,attenuate,axe,axillary,base,basiscopic,berry,broadly,brownish,bud,canescent,cell,cm,condition,corolla,covering,cuneate,darker,decurrent,deep,densely,diameter,distal,dot,drying,elliptic,filament,flower,forked,fresh,fruit,generally,glabrous,globose,green,green-white,greenish,hair,half,herb,lateral,leaf,leaflet,light,like,lobe,long,make,margin,mm,mottled,mucilaginous,oblique,obtuse,odd-pinnate,often,ovate,ovoid,pedicel,peduncle,perfect,petiole,plant,pubescent,purple,rarely,ray,ripe,rounded,scattered,seed,short,side,slightly,sometimes,spaced,sparsely,stem,straight,style,subglabrous,subtending,terminal,tertiary,testal,thick,throughout,tissue,typically,usually,violet,violet-purple,wall,wet,white,whitish,x	0,1,1-4,1.5,10,2,2-14,2-4,2-4.5,2-7,3-4,4.5-14.5,5-merou,8-17,9-29,acumen,ag,along,alyx,blade,borne,capitat,chartaceous,ciliate,clavate,connivent,cordate,digestion,dorsally,eaf,edge,eed,end,enzyme,erec,especially,exceeding,except,flat,folded,frequently,geminat,glabrou,greatly,hair-like,homostylous,honeycomb-shaped,interjected,lanceolate,lengthening,living,lower,membranous,middl,midrib,minutely,nflorescence,orbicular,orolla,pair,paired,pentagonal,petiolulate,petiolule,plurifoliate,pore,poricidal,proximal,puberulent,reduced,removed,rotate,ruit,sessile,seudostipule,singly,size,slit,small,specimen,stamen,ste,stigma,stolo,subequal,subsessile,tall,tamen,tem,tip,tri-,tube,tuber,unit,unpaired,unwinged,vary,wide,wing,yellow,ympodial	'hair-like,abaxial,adaxial,arrangement,branching,calyx,characteristic,colour,form,growth,height,history,inflorescence,length,life,mentioned,middle,midvein,ovary,primary,pseudostipule,rachi,shape,staman,surface,texture,true,unarmed,vein,venation
529	wfo-0001032344	exception_thrown	157	0	0	157	0	0.0		0.2-0.5,1-1.3,1-3,1-4,1.5-4.5,1.5-6,1.6-2.4,10-29,2-2.8,2-3,2.2-4,2.8,3-5,3-6-foliat,3-7,3-8.5,3-9,3.5-6.5,4-11,4-8,5-10,6-15,9.5-21,abaxially,abruptly,absent,acumen,acuminate,acute,adaxially,apex,apical,apically,articulate,base,belo,bluish,branched,broadly,calyx,cell,cm,connate,corolla,covering,cuneate,cyme,dark,decurrent,dehiscent,diameter,dichasial,dichasially,digestion,diminishing,distal,dorsally,dot,eaf,ebracteate,edge,eed,elliptical,emoval,enzyme,exceeding,filament,flower,forked,generally,globo,globose,green,green-white,hair-like,half,herbaceous,honeycomb,inrolled,interjected,introrse,lateral,layeral,leaf,leaflet,living,lobe,lon,long,long-attenuate,lower,lunat,make,maturing,medium,mm,monochasial,mucilaginous,nflorescence,nther,oblique,odd-pinnate,often,orolla,ovate,ovoid,pair,pattern,pedicel,peduncle,perennial,perfect,petiole,petiolule,plan,plant,poricidally,proximal,puberulent,pubescent,purple,reveal,rotate,rotate-pentagonal,ruit,scarce,seed,sessile,seudostipule,short,size,slit,smooth,sometimes,specimen,stamen,stigma,straight,style,tal,tem,terminal,testal,thick,throughout,toward,tuber-bearing,typically,unit,vary,violet,wall,white,wide,yellow,ympodial,Â¼	
530	wfo-0001032354	success	171	122	92	79	30	0.538	0,0-5,1-2,1-3,1-5,2-2.5,2.5-3,250-400,3-4,38/2,40-75,acuminate,acute,angular,anther,apex,aster,axillary,base,becoming,berry,branch,branched,broadly,brown,calyx,cell,cm,coarsely,colour,corolla,cuneate,decurrent,dia,discoidal,except,facetted,filament,fork,glabrous,glandular,globose,green,greenish-ivory,greyish,hair,leaf,lobe,maturity,minute,minutely,mm,narrow,obovate,occasionally,oval,ovary,ovoid,pebble-shaped,pedicel,peduncle,pinnatisect,puberulent,pubescent,rather,rh,rounded,rugose-reticulate,several,shape,shrub,simple,somewhat,sparse,spreading,stem,stone,straight,style,surface,tall,tip,trichome,uniseriate,unpleasant,variable,vein,violet,wide,wing,woody,year	0.3,0.5-1,0.8-1,0.8-1.2,1-10,10-lobed,2,25,29,4-6,5-10,5-15,almost,anthesi,aspect,axi,bilobed,c.,campanulate,capitate,creating,cut,deep,deeply,distal,eaf,eed,effect,ellipsoid,exerted,fleshy,flower,general,gre,gree,halfway,lanceolat,large,lasting,lengthening,linear,lobed,lower,midrib,nflorescence,obovoid,ovate,pair,pale,pedicellate,plurifoliat,pore,poricidal,rotate,ruit,secondary,seedling,shoot,single,sinus,size,slightly,slit,small,smaller,smel,soft,stellate,stigma,strongly,tub,ud,unit,usually,within,wooded,x,ympodial,young	abaxial,adaxial,arrangement,branching,characteristic,diameter,form,fruit,growth,height,history,inflorescence,length,life,margin,midvein,null,petiole,plant,primary,pseudostipule,rachi,seed,smell,staman,tertiary,texture,true,unarmed,venation
531	wfo-0001032358	success	216	145	122	94	23	0.565	.5,0,0.2-4,0.5-3,0.7-1,1-2,1.3-1.7,1/4-1/2,12-20,13-20,15-40,2-3,2-5,3-10,3-4,4-4.5,4-7,4-8,4.5-5,abaxially,acute,adaxially,anther,apex,appearing,basal,base,based,berry,branched,broad,calyx,center,cm,cordate,corolla,curved,densely,diameter,difoliate,entire,equal,filament,flattened,flower,free,fruit,furcate,geminate,glabrous,globose,green,growth,heteromorphic,inflorescence,internodal,irregularly,lamina,leaf,like,linear,lobe,long,longer,lower,lowermost,margin,midrib,midvein,minutely,mm,occasionally,often,orangish,ovate,pair,pale,paler,part,pedicel,peduncle,per,pericarp,petiole,pitted,porrect,portion,prickle,prickly,primary,pubescent,purple,red,reniform,rhachi,ripening,sessile,shiny,short,short-stalked,shrub,sinuate,slightly,somewhat,spaced,sparsely,staman,stellate,stem,strongly,style,surface,tan,thin,time,trichome,tube,tuberculate,unit,vein,x,yellowish	.1,.2,.3,.4,/2,0.6-0.8,0.6-1,1-1.6,1.5-2,1.5-2.5,2,2-10,2-4,2.2-7.5,3.5-13,4-merous,abscissio,along,another,anthesi,apart,armed,away,bark,brown,bulbous,capitate,cell,cupuliform,dorsal,drying,eaf,eed,erect,expanding,exserted,frui,fruiting,glabrescen,glabrescent,interpetalar,irregular,left,lengthening,lobed,margined,markedly,maturity,membranous,midpoint,new,nflorescence,nodding,older,one,ovoid,papillat,papillate,peg,perfect,persistent,planar,pore,poricidal,present,ray,rotate-stellate,ruffly,ruit,scar,simple,sinus,slit,small,sometimes,space,spreading,stigma,thick,three,tip,tub,two,type,ud,unevenly,unisexual,upper,usually,way,whitish,widely,ympodial,zygomorphic	abaxial,adaxial,arrangement,branching,characteristic,colour,form,height,history,length,life,null,ovary,plant,pseudostipule,rachi,seed,shape,sympodial,tertiary,texture,unarmed,venation
532	wfo-0001032367	success	231	172	148	83	24	0.641	-3,.4,0-0.3,0.2â0.35,0.4-0.5,0.4â0.6,0.4â1,0.5â0.8,0.5â2,0.7-1.1,0.8,0.8â2,1-2,1.2,100-300,1â1.8,2,2-3-celled,2-4,2.2â2.5,2.2â2.8,3-5,3-celled,3â10,3â5,3â6,4,5.5â6.9,5â18,6-8,6.8â8.2,7â10,abaxial,acicular,acute,adaxial,also,anther,anthesi,apex,axi,base,berry,blade,branch,calyx,cm,congested,conical,cordate,dark,deciduous,densely,diameter,difoliate,entire,erect,expand,filament,flattened-reniform,flower,geminate,glabrous,gland-tipped,glandular-puberulent,globose,green,greenish,hair,hyaline,immature,inflorescence,infructescence,lateral,layer,leaf,least,length,light,lobe,lobed,long,longer,many,margin,maturity,mesocarp,midpoint,minute,mixed,mm,mottled,nearly,obtuse,one,ovary,ovate,pair,pale,pedicel,peduncle,per,petiole,prickle,puberulent,pubescence,pubescent,ray,red-brown,scattered,secondary,sessile,shallow,shorter,shrub,similar,simple,size,small,spongy,spreading,stellate,stem,straight,style,suborbicular,surface,terete,tightly,time,tip,tooth,triangular,trichome,truncate,twice,unarmed,unbranched,uniformly,uniseriate,usually,vein,white,whitish,wide,yellow,â15,â5	.2,0.4â0.5,0.6,0.6â0.8,1-2.1,1â1.5,2.5â3,2â2.5,3.2â4,4â6.5,5-merous,8,abaxially,accrescent,adaxiall,adaxially,alyx,arme,around,ba,broad-based,capitate,connivent,copious,cream,curved,directed,distall,eaf,eed,enlarged,equal,fertile,free,fruiting,geminat,grading,herbarium,heterostylous,lanceolate,largest,long-styled,lower,lowermost,major,membranous,minutely,mixture,moderately,narrowly,nflorescence,often,orolla,oung,papillat,pore,poricidal,portion,prickly,rarely,recurved,rest,ruit,scarcely,short-styled,slender,smaller,somewhat,sparsely,specimen,spreadin,staminat,ste,stigma,tall,tamen,tapering,thick,tube,unit,variable,vary,ympodial	2-2.5,arrangement,branching,characteristic,colour,corolla,form,fruit,growth,height,history,life,mentioned,midvein,plant,primary,pseudostipule,rachi,seed,shape,staman,tertiary,texture,venation
533	wfo-0001032407	success	216	140	110	106	30	0.509	0.5-3,1-10,1-2,1-5,1.4-2.7,1.5-2.2,10-19.5,10-27,2-10.5,2.5-9,3-15,4-11,4-48,4-7,5,6,7-9,8-10,abaxially,acuminate,adaxially,anther,apart,apex,apparently,articulated,attenuate,axe,axillary,base,berry,brownish,bud,cell,cm,coarsely,condition,conical,corolla,covering,dark,densely,diameter,distal,drying,elliptic,exceeding,filament,finely,flower,forked,fresh,fruit,generally,glabrous,green,green-white,greenish,hair,hair-like,half,herb,lateral,leaf,light,like,lobe,long,make,margin,medium,middle,minute,mm,mottled,mucilaginous,odd-pinnate,ovate,ovoid,pedicel,peduncle,perfect,petiole,petiolule,plant,proximal,puberulent,pubescent,purple,rarely,ray,ripe,seed,simple,spaced,sparsely,stamen,stem,straight,style,subtending,terminal,testal,thick,throughout,usually,wall,wet,white,whitish	0-4,0.3-0.6,0.3-8,0.4-4,0.8,0.8-0.3,1-2.4,1.2-7,12,2-4,2.5-10.5,3.1-13.5,30,38,5-23,5-30,5-merou,absent,acumen,ag,along,alyx,arranged,asymmetrical,basiscopic,bead,blade,capitat,chartaceous,ciliate,clavate,commonly,connivent,decreasing,digestion,eaf,edge,eed,elongated,enzyme,erec,especially,folded,geminat,glabrou,gradually,homostylous,honeycomb-shaped,interjected,lanceolate,larger,leaflet,lengthening,less,living,lower,membranous,minutely,moniliform,multiple,narrow,necklace,nflorescence,obtuse,orbicular,orolla,pair,pentagonal,plurifoliate,pore,poricidal,pubescen,removed,rotate,round,ruit,secondary,semierect,sessile,seudostipule,side,size,slit,specimen,ste,stigma,stolon,subequal,symmetrical,tall,tamen,tem,tip,tissue,tri-,tube,tuber,typically,unit,unwinged,vary,wide,wing,x,yellow,ympodial	abaxial,adaxial,arrangement,branching,calyx,characteristic,colour,form,growth,height,history,inflorescence,length,life,mentioned,midvein,ovary,primary,pseudostipule,rachi,shape,staman,surface,tertiary,texture,true,unarmed,vein,venation,Â¼
534	wfo-0001032465	success	233	189	165	68	24	0.708	+,-10,-11,-14,-9,.2,.5,0,0.2,0.5-,0.5-2,1-,1-1.5,1-celled,1.2-1.5,1.5,1.5-1.8,1.5-2,1.5-5,2,2-2.5,2.5-5.5,25,3-3.5,3-4,3-8,4,5,5-7,5-8,9,abaxial,acuminate,acute,anther,anthesi,apex,appearing,articulated,axi,basal,base,berry,black,branched,brown,calyx,cell,ciliate,clasping,cm,commonly,cordate,coriaceous,corolla,deep,deeper,deeply,deltate,densely,diameter,distal,drying,edge,elliptic,elongate,entire,erect,filament,filiform,flattened,flower,fringe,glabrous,gland,glandular,glandular-tipped,globose,green,greenish,growing,growth,half,inflorescence,larger,later,lateral,leaf,leaving,length,like,lobe,lobed,long,lower,margin,mature,membranous,minute,minutely,mm,narrowly,nodding,occasionally,often,outline,ovate,pair,paired,pedicel,peduncle,peg,pentagonal,per,pericarp,petiole,pinnate,pinnatifid,primary,puberulent,pubescent,purplish,reddish,reniform,reticulate,revolute,ripe,seed,shallow,shape,shiny,similar,simple,sleeve,sparsely,stem,style,subshrub,surface,terminal,testal,thin,time,tiny,tip,transparent,trichome,truncate,tuft,twining,unicellular,uniseriate,upper,usually,variously,varying,vein,vine,violet,wall,white,widest,woody,x,yellowish	1-1.7,1/3,3-5,3-9,5-merou,ag,alyx,angled,apar,apically,ark,capitate,conical,connivent,de,decreasing,eaf,eed,ellipsoid,exserte,free,fruiting,glabrescen,ilament,included,irregular,irregularly,janeiro,lengthening,loosely,new,nflorescence,older,orolla,papillate,papillo,pendan,perfect,planar,plurifoliat,pore,poricidal,portion,rio,ruit,scar,scattered,sinus,size,slit,somewhat,spaced,splitting,stellate-rotate,stigma,strongly,tem,thicker,toward,tube,twinin,ud,unit,vary,way,ympodial,young,Â½	adaxial,arrangement,branching,characteristic,colour,form,fruit,height,herb,history,life,midvein,null,ovary,plant,plurifoliate,pseudostipule,rachi,staman,tertiary,texture,true,unarmed,venation
535	wfo-0001032494	success	163	131	102	61	29	0.626	.1,.4,.5,0.6-1,0.8-1,0.9-1.2,1.45-1.5,1.5,1.5-8,1.6-2,2.5,2.5-8,4-8,5-40,8-11,acuminate,anther,apex,appearing,attenuate,axil,base,beneath,berry,brown,bullate,calyx,clavate,cm,corolla,decurrent,dia,difoliate,dry,filament,flattened-reniform,flowered,free,fruit,furcate,geminate,glabrous,globose,greenish-yellow,incrassate,lateral,leaf,light,lobe,long,main,major,margin,material,middle,minor,minutely,mm,narrowly,occasionally,opposite,orange,ovary,ovate,pair,pale,papillose,pedicel,petiole,pitted,portion,prominent,proximal,raised,revolute,shrub,simple,slender,slightly,small,stem,straight,style,surface,tan,tapering,tip,tree,triangular,trichome,tube,uniseriate,unit,upper,vein,venation,white,whitish-green,widest,winged,x,yellow	0.75-1,1-1.5,1.1-1.2,1.8-4.5,16.5-20.5,2.3-2.5,3-4,3.4-14.5,3/4,5-6.4,accrescent,anthesi,apart,ba,bark,beginning,deflexed,differing,eaf,edicel,eed,equal,evenly,except,expanded,exserted,fruiting,geminat,inflorescenc,lax,lenticellat,lobed,lon,lower,nearly,nflorescence,node,ovoid,papillae,papillo,planar,pore,poricidal,pubescent,quite,ridge,ruit,scar,shaped,size,somewhat,spaced,stigma,tall,tear-drop,two-winged,ud,way,woody,ympodial,zig-zag	abaxial,adaxial,arrangement,branching,characteristic,colour,diameter,form,growth,height,history,inflorescence,length,life,mentioned,midvein,peduncle,plant,primary,pseudostipule,rachi,seed,shape,staman,sympodial,tertiary,texture,unarmed,ye
536	wfo-0001032507	success	206	211	179	27	32	0.869	.2,.5,/4,0.25,0.3,0.5,0.7-1.2,0.8,1,1.2-1.7,1.3,1.5â2,1.5â7,10â20,15â20,1â1.5,1â10,2,2.5â4,2.5â6,20â30,2â9,3â5,3â7,4â10,5â10,5â20,5â8,6,8â15,abaxial,abaxially,absent,abundant,acuminate,acute,adaxially,adjacent,anther,anthesi,apex,apiculate,armed,articulated,base,becoming,berry,blade,blue,branched,broadly,brown,bud,calyx,campanulate,cell,cm,collection,confluent,connivent,corolla,cream,curved,deep,deltate,diameter,distally,distinct,either,elliptic,elongating,entire,equal,fertile,fifth,filament,flattened-reniform,flower,flowering,four,fruiting,glabrous,globose,green,hair,herbarium,highly,individual,internode,interpetalar,larger,lateral,leaflet,lengthening,light,lobe,lobed,long,longer,major,margin,material,minutely,mm,nearly,oblong,occasionally,often,one,ovate,pale,papery,pedicel,peduncle,pentagonal,perennial,pericarp,petiole,pinnate,pinnatifid,pistillate,pitted,plant,pore,poricidal,present,prickle,puberulent,pulp,purple,purplish,quadrate,rachi,rarely,reddish,regularly,rotate-pentagonal,rounded,rugose,shape,side,single,sinus,slender,slightly,slit,sometimes,spreading,staminate,stem,stigma,stout,straight,strongly,style,surface,tear,terminal,testal,time,tip,tissue,tube,unbranched,unequal,unit,unlobed,usually,variable,variously,vein,vine,way,white,wide,widest,woody,yellowish,Ã	adaxiall,ag,alyx,chartaceous,compound,dr.,eaf,eed,ellipsoid,exserted,herbaceous,lower,midrib,narrowly,nflorescence,observe,orolla,pinnately,plurifoliat,ranging,recurve,ruit,simple,tamen,vary,wood,ympodial	adaxial,age,arrangement,branching,characteristic,colour,dry,form,fruit,growth,height,history,inflorescence,leaf,length,life,midvein,null,observed,ovary,plurifoliate,primary,pseudostipule,recurved,seed,staman,stamen,sympodial,tertiary,texture,unarmed,venation
537	wfo-0001032523	success	200	148	127	73	21	0.635	-5,.2,.5,0-10,0-12,0-3,0.2-0.4,0.4-1.5,0.6-0.7,0.6-0.8,1-1.5,1-2,1-3,1-8,1.5-3,1/4-1/3,10-50,15-30,2-2.4,2.7-3,3-4,3.5-4,4-7,5-12,5-20,6-20,6-8,abaxial,acuminate,acute,adaxial,anther,apart,apex,apically,apparently,articulated,base,berry,blade,branching,calyx,cm,cuneate,curved,deltate,diameter,dull,elliptic,entire,equal,erect,evenly,filament,filiform,flattened-reniform,flower,free,fruit,gently,glabrescent,glabrous,green,hair,infructescence,lateral,leaf,length,lobe,long,margin,maturity,mauve,midpoint,minute,mm,moderately,multangulate,one,open,orange-brown,ovate,pair,pedicel,peduncle,per,pericarp,petiole,porrect,portion,prickle,prickly,primary,ray,recurved,red,scandent,scar,secondary,sessile,shrub,simple,smooth,sometimes,spaced,sparsely,spherical,stellate-pubescent,stem,straight,style,subentire,surface,terete,terminal,tertiary,time,trichome,tube,unarmed,vein,venation,visible,weakly,wide,yellow,young	-2,/4,0-0.15,0-15,0.1-0.2,0.2,0.3-0.5,0.4-1,0.5-1,1.3-1.6,1/3-1/2,2,2-2.5,2-4,2-5.5,2.5-6,3-15,4-5-merous,6-10,abaxially,acuminat,alyx,ame,apar,bark,brow,c.,conical,connivent,discolorous,drying,eaf,eed,elongating,fruiting,glabrou,herbaceous,inflated,lobed,lon,longer,lower,mature,membranous,narrow-deltate,nflorescence,older,orange,orolla,oung,pale,perfec,perpendicular,plurifoliat,poricidal,red-brown,reflexed,ruit,spreading,stalk,stalked,stellate,strongly,tamen,tapering,tip,unarme,unit,variously,vary,way,woody,ympodial	arrangement,characteristic,colour,corolla,form,growth,height,history,inflorescence,life,midvein,null,ovary,plant,plurifoliate,pseudostipule,rachi,seed,shape,staman,texture
538	wfo-0001032524	success	205	145	113	92	32	0.551	1-10,1-2,1-2.5,1.5-2,1.5-4,12-13,120-210,2-3,2-5,2.5-8,25-90,3-5,3-8.5,3.5-4.5,4-5,4.5-8,5-6,50-70,6-13,7-35,7-8,abaxially,acute,adaxially,anther,apart,apex,apparently,articulated,attenuate,axe,axillary,base,berry,brownish,bud,cell,cm,condition,corolla,covering,cuneate,densely,diameter,distal,drying,elliptic,filament,flower,forked,fresh,fruit,generally,glabrous,globose,grayish-green,green,green-white,greenish,hair,half,head,herb,lateral,leaflet,length,light,like,lilac,lobe,long,make,margin,middle,mm,mucilaginous,multicellular,narrowly,non-glandular,obtuse,odd-pinnate,ovate,ovoid,pedicel,peduncle,perfect,petiole,plant,pubescent,purple,ripe,rounded,seed,short,silky,silvery-white,spaced,stem,straight,style,subtending,terminal,testal,tetralobulate,thick,throughout,trichome,usually,violet,wall,wet,whitish,x	10-35,14-50,3-4,4,4.5-5,5-9,5-merou,6-16.5,?,acumen,ag,along,alyx,arranged,ascending,bead,blade,capitat,chartaceous,ciliate,clavate,connivent,different,digestion,dorsally,eaf,edge,eed,enzyme,erec,especially,exceeding,except,flat,folded,geminat,glabrou,greatly,hair-like,hal,homostylous,honeycomb-shaped,interjected,lanceolate,lengthening,living,lower,membranous,midrib,minutely,moniliform,multiple,necklace,nflorescence,often,orolla,pair,pentagonal,petiolulate,petiolule,plurifoliate,pore,poricidal,proximal,puberulent,reduced,removed,rotate,ruit,sessile,seudostipule,size,slit,specimen,stamen,ste,stigma,stolon,subequal,tall,tamen,tem,tip,tri-,tube,tuber,typically,unit,unwinged,vary,yellow,ympodial	'hair-like,2,abaxial,adaxial,arrangement,branching,calyx,characteristic,colour,form,growth,height,history,inflorescence,leaf,life,mentioned,midvein,ovary,primary,pseudostipule,rachi,shape,staman,surface,tertiary,texture,true,unarmed,vein,venation,Âµm
539	wfo-0001032532	exception_thrown	161	0	0	161	0	0.0		0-.,0.3-2.5,1-1.5,1-4,1.5-2.6,1.5-3.2,1.5-4.3,13-52,15-30,2,2-,2-10,2-13,2-3,2.8-3.6,2.8-9.5,3-10,3-5,3-6-foliat,3.4-12.2,3.7-10,4-5.5,4.5,6,6-22,8-38,abaxiall,abaxially,absent,acumen,acuminate,acute,adaxially,apex,apical,apically,articulate,attenuate,base,branched,calyx,cell,cm,coarsel,conical,connate,corolla,covering,cuneate,cyme,deep,dehiscent,diameter,dichasial,dichasially,digestion,diminishing,distal,dorsally,eaf,ebracteate,edge,eed,elliptical,emoval,enzyme,exceeding,filament,finely,flat,flower,folded,forked,generally,globo,gradually,green,green-white,hair-like,half,herbaceous,honeycomb,interjected,introrse,lateral,leaf,leaflet,light,living,lobe,lon,long,long-attenuate,lower,lunat,make,maturing,medium,minute,mm,monochasial,mucilaginous,narrowly,nflorescence,nther,oblique,obtuse,odd-pinnate,often,orolla,ovate,ovoid,pair,pattern,pedicel,peduncle,perennial,perfect,petiole,petiolule,plan,plant,poricidally,proximal,pubescent,purple,reveal,rotate,rounded,ruit,seed,sessile,seudostipule,short,size,slit,specimen,stamen,stigma,straight,style,subequal,subsessile,tal,tem,terminal,testal,thick,throughou,throughout,tip,toward,tuber-bearing,typically,unit,vary,wall,wide,yellow,ympodial,Â¼	
540	wfo-0001032536	exception_thrown	254	0	0	254	0	0.0		-3,/3,0.5,1,1-2,1-2.5,1.3-2.2,1.5,10,10-20,10-30,10-50,100,13-24,14-16,2-3,2.5-3,20-22,20-25,20-50,3,3-3.5,3-6,4-6,4-8,4-9,5,5-6,5-8,5-merous,5.5-8,7-10,<,>,abaxial,abaxially,abruptly,acute,adaxial,adaxiall,adaxially,age,almost,along,alyx,angle,anther,anthesi,apar,apex,appressed,armed,around,articulated,axi,bark,basal-most,base,berr,berry,blade,bright,bristle,bristly,broad-based,broadly,brown,calyx,capitate,caudat,caudate,cell,chartaceous,clavate,clearly,cm,conical,coriaceous,cu,curved,dark,dbh,deeply,deltate,densely,denser,depressed,diameter,difoliate,directed,diverging,eaf,eed,elliptic,enlarged,entire,equal,evenly,fading,filament,flattened,flower,free,fruit,fruiting,geminate,glabrescent,glabrous,glandular,glandular-puberulent,globose,grayish,growth,halfway,hanging,heterostylous,inflorescenc,inflorescence,infructesecnce,interpetalar,irregularly,juvenile,lamina,lateral,leaf,leaf-opposed,leaving,length,like,lobe,lobed,long,long-stalked,long-styled,lower,margin,mature,maturity,membranous,midpoint,midrib,midvein,minute,minutely,mixed,mixture,mm,multangulate,multiseriate,narrowing,narrowly,near,new,nflorescence,number,oblique,occasionally,occurring,odor,older,olive-green,once-branched,open,orolla,oung,ovary,papillae,papillat,papillate,part,pedicel,peduncle,pentagonal,per,pericarp,petiole,plant,pore,poricidal,porrect,portion,potato,prickl,prickle,prickly,primary,prominent,protuberance,pubescent,purple,rarely,ray,reddish,reniform,reproductive,rough,ruit,scar,scattered,shallowly,short-,short-styled,simple,slender,slightly,small,smooth,soft,somewhat,spaced,sparsely,spreading,stalk,staminate,stellate,stellate-pubescent,stem,stigma,strongly,style,surface,tall,tamen,tapering,terete,terminal,thick,time,tip,tissue,tree,triangular,trichome,truncate,trunk,tube,unarmed,unequal,unit,upward,urceolate,usually,vary,vein,visible,way,white,wide,wood,woody,yellow-green,yellowish,ympodial,younger	
541	wfo-0001032542	success	161	133	105	56	28	0.652	.25,.25-0.5,.5-1,0.5-1,0.7-1,1-1.3,1-1.5,1-2,1-5,10-15-flowered,2-3,2-3.5,3-4,3-5,4-7,4.5-5,5-8,abaxial,abaxially,acuminate,acute,adaxially,anther,apex,apical,attenuate,axi,basal,base,beginning,berry,bluish-green,bright,brown,calyx,closely,cm,corolla,dark,deflexed,deltate,dendritic,densely,di,difoliate,dry,elliptic,elliptic-obovate,filament,flattened-reniform,free,glabrous,globose,golden,green,growth,incrassate,inflorescence,lamina,lateral,leaf,less,like,lobe,long,main,major,margin,minor,minute,minutely,mm,narrowly,near,opposite,ovary,overlapping,pair,pedicel,petiole,pitted,portion,pubescent,reddish-brown,rounded,scar,shape,shining,shrub,simple,slender,small,spaced,sparsely,stem,style,surface,treelet,triangular,trichome,tube,unit,vein,yellow-green,yellowish	.5,/4,1.5-3.5,10-28,2.5-5,4-9.5,along,anthesi,ba,bark,capitate,compact,conical,dia,differing,distal,eaf,edicel,eed,either,erect,exserted,fruiting,geminat,inflorescenc,later,lobed,lon,loose,lower,new,nflorescence,older,papillo,persisten,planar,pore,poricidal,ruit,shaped,size,slightly,somewhat,stigma,strongly,swollen,tear-drop,tip,tub,ud,way,wide,woody,x,ympodial,young	adaxial,arrangement,branching,characteristic,colour,diameter,form,fruit,geminate,height,history,length,life,midvein,null,peduncle,plant,primary,pseudostipule,rachi,seed,staman,sympodial,tertiary,texture,true,unarmed,venation
542	wfo-0001032564	success	160	147	116	44	31	0.725	.05,.1,.5,0.3-1,1-1.2,1-1.3,1-1.5,1-2,1.5,2-2.5,4-5,4-6-flowered,6-7,8-9,along,anther,anthesi,apar,apart,apex,arched,base,becoming,beneath,berry,branch,broadly,brown,bud,calyx,cm,conical,converging,corolla,dark,deflexed,deltoid,densely,dia,dry,edicel,elliptic,exserted,extreme,filiform,flattened,flower,fresh,glabrous,globose,golden,green,greenish-white,greyish-red,halfway,lamina,later,lateral,leaf,like,lobe,long,long-acuminate,main,margin,material,member,minute,minutely,mm,narrowly,obovoi,often,one,open,opposite,ovary,ovate,ovoid-reniform,pair,pedicel,petiole,pitted,point,projection,prominent,puberulent,raised,ripe,rounded,scar,shiny,shrub,simple,slightly,small,soon,stem,style,surface,tan,tapering,thread-like,time,tiny,tip,trichome,truncate,tube,ud,uniseriate,vein,winged,x,yellowish-green,young	.05-0.1,0.25-0.5,0.75-1,1.3-2.5,5.5-9,aspec,ba,bark,clavate,eaf,eed,except,expanded,fruiting,geminate,giving,glabrate,lobed,lower,middle,nearly,nflorescence,node,non-reproductive,older,papillo,papillose,planar,pore,poricidal,proximal,reflexed,ruit,shaped,stigma,straight,strongly,tall,tear-drop,unifoliate,unit,widest,woody,ympodial	abaxial,adaxial,arrangement,branching,characteristic,colour,diameter,filament,form,fruit,growth,height,history,inflorescence,length,life,mentioned,midvein,peduncle,plant,primary,pseudostipule,rachi,seed,shape,staman,tertiary,texture,true,unarmed,venation
543	wfo-0001032569	success	164	157	126	38	31	0.768	.5,0.5-10,0.8-1,1-1.2,1-1.5,1-2,1-4,1.2-5,1.5,1.5-2,1.7-2,2-3,5-6,5-60-flowered,7-9,abaxially,acute,adaxially,along,anther,anthesi,apex,apparently,appearing,axi,bark,base,bearing,berry,branched,brown,bullate,calyx,cell,closely,cm,corolla,corrugated,dark,decurrent,deflexed,dendritic,dense,densely,denser,dia,difoliate,dry,drying,elliptic,erect,filament,flattened,fleshy,free,fruiting,geminate,glabrous,globose,golden,green,incrassate,inflorescence,irregularly,lateral,leaf,like,lobe,long,los,main,major,margin,matted,mature,middle,minor,minutely,mm,moderately,obscured,occasionally,onto,open,opposite,ovary,ovate,pair,paler,pedicel,petiole,pitted,portion,present,pubecsence,pubescent,reniform,rich,scar,shrub,simple,somewhat,spaced,sparsely,splitting,stem,stone,strongly,style,surface,thick,time,tip,triangular,trichome,tube,tuft,unifoliate,unit,vein,waxy,white,widest,woody,x,young	/3,2-4,4-18,4-8,7-27,bilobed,broadly,conical,differing,eaf,edicel,eed,ellipsoid,exserted,gra,later,lea,lobed,lon,lower,nflorescence,otherwise,papillo,papillose,pericar,planar,pore,poricidal,ruit,shaped,size,stigma,tall,tear-drop,tub,ud,way,ympodial	abaxial,adaxial,arrangement,branching,characteristic,colour,diameter,form,fruit,gray,growth,height,history,length,life,mentioned,midvein,peduncle,pericarp,plant,primary,pseudostipule,rachi,seed,shape,staman,sympodial,tertiary,texture,unarmed,venation
544	wfo-0001032576	success	229	178	155	74	23	0.677	-10,-2,-2/3,0,0-1.5,0-30,0-5,0.1,0.1-0.2,0.3-0.7,0.5-1.5,0.5-2,0.5-4,0.8-1.2,0.8-1.4,1-3,1-4,1.5-2,1.5-2.3,1.8-2.5,1/2,1/3,1/3-1/6,2-10,2-3,2-4,2-5,4,4-,4-6,4-6.5,5-30,6-8,acute,anther,apex,apically,apparently,articulated,base,berry,blade,branched,branching,bright,brown,brown-green,calyx,cell,cm,cuneate,curved,deltate,densely,diameter,difoliate,distance,dull,ellipsoid,entire,erect,evenly,extending,eye,faint,filament,flattened-reniform,flower,fruit,glabrescent,glabrous,gland,glandular,globular,gray,green,hair,herb,infructescence,lanceolate,lateral,leaf,length,lobe,lobed,long,margin,maturity,midpoint,midvein,minutely,mm,moderately,naked,near,obovate,obtuse,often,one,open,orange-brown,outline,ovate,pair,pedicel,peduncle,per,pericarp,petiole,pit,porrect,prickle,prickly,primary,purple,raised,ray,red,red-green,reduced,reticulate,rounded,scandent,sessile,shiny,short,shrub,side,simple,slender,small,smooth,sometimes,sparsely,spherical,stalk,stalked,stellate-pubescent,stem,style,surface,terminal,tertiary,time,trichome,unarmed,upper,vein,venation,visible,white,wide,yellow,yellow-green,young	-12,/4,/5,0-3,0.1-0.15,0.1-0.25,0.3-0.5,0.5-1,0.8-2,1.2-1.8,1.5-7.5,2.5-3,2.5-4,3-14,4-5-merous,7-8,abaxially,acuminat,alyx,apar,apart,ascendant,ba,bark,brow,chartaceous,concolorous,conical,drying,eaf,eed,elongating,equal,flattened,free,fruiting,geminat,herbaceous,longer,lower,mature,membranous,narrow-deltate,narrow-ovate,nflorescence,older,orolla,oung,pale,perfec,poricidal,portion,prickl,reflexed,ruit,scar,shorter,slightly,spaced,spreading,stellate,straight,tamen,tapering,tip,tube,unit,usually,variously,vary,way,woody,yellow-orange,ympodial	abaxial,acuminate,adaxial,arrangement,characteristic,colour,corolla,form,geminate,growth,height,history,inflorescence,life,null,ovary,plant,pseudostipule,rachi,seed,shape,staman,texture
545	wfo-0001032595	success	200	169	135	65	34	0.675	-20,-25,-pilose,0-,0.5-1,1-2,1-2.5,1-3,1-6,1-6.5,1.5-2,1.5-2.5,1.5-4.5,1.5-5,12-16,15-25,15-40,2-3,2-4,2.3-24,25-40,3-10,3-12,3-4,3-4-foliate,3-5,4-25,4-5,4-7,5-6,6-7,abaxially,acuminate,acute,adaxially,aggregate,along,also,anther,apart,apex,apiculate,articulated,axe,basal,base,blade,branch,branched,brownish-purple,calyx,cell,cm,cordate,coriaceous,deeply,deltate,dense,densely,denser,diameter,dilated,distally,dull,eglandular,ellipsoidal,entire,filament,finely,flattened,flower,fork,forked,fruit,fusiform,geminate,glabrous,glandular,greenish,hair,leaf-opposed,leaving,lobe,long,major,margin,mature,mm,moderately,near,oblique,often,ovate,pale,pedicel,pedicellar,peduncle,per,perfect,petiole,pilose,pseudohair,puberulent,pubescent,rachi,rarely,remnant,reniform,rugulose,shallow,shrub,side,simple,small,spaced,sparsely,stellate,stone,strongly,style,subcoriaceous,time,tip,toward,tree,truncate,umbrella-shaped,unbranched,unit,vein,violet,white,wide,x,yellow	0.5-3.5,1,5-merou,9-14,accrescen,alyx,ape,apical,brownish,ciliat,connective,connivent,cream,crow,cucullate,directed,eaf,eed,equal,exceeding,free,fruiting,gland,homostylous,lanceolate,larg,lon,longitudinal,loosely,lower,m.,midrib,narrowly,nflorescence,opening,orolla,ovoid,part,pilo,pore,produced,prominent,purple,purplish,ruit,shorter,single,slightly,slit,spreading,stamen,stigma,swelling,tall,tamen,tem,thecae,tomentose,triangular,trunk,tube,two,ud,vary,ympodial	0.5-3.5.5,abaxial,adaxial,arrangement,branching,characteristic,colour,corolla,form,growth,height,history,inflorescence,large,leaf,length,life,midvein,null,ovary,plant,primary,pseudostipule,seed,shape,staman,stem,surface,sympodial,tertiary,texture,true,unarmed,venation
