	coreid	status	nwords_original	nwords_result	nwords_recovered	nwords_omitted	nwords_created	prop_recovered	common_words	original_only	result_only
0	wfo-0001025652	success	156	124	84	72	40	0.538	.3,.5,0.5-1,1-1.5,1.5-2,10-20,15-17,2-3,2-6,20-50,4,4-6,4-7,abruptly,acuminate,acute,anther,anthesi,apex,bark,base,bilobed,calyx,closed,cm,completely,corolla,decurrent,dia,elliptic,envelope,filament,fleshy,fruit,furcate,glabrous,green,greyish,growth,lateral,leaf,lobe,main,margin,matte,minutely,mm,narrowing,nearly,new,occasionally,onto,opposite,ovary,ovoid,ovoid-reniform,pair,pale,parallel,pedicel,petiole,pitted,plant,shape,shaped,shiny,shrub,simple,size,small,stem,stigma,strongly,style,surface,tan,tapering,tear-drop,tree,tube,vein,white,winged,x	1,15-19,2-5,3-3.5,3-5,3-5-flowered,9-11,appearing,blade,broad,campanulate,closely,connate,densely,differing,difoliate,dry,eaf,edicel,eed,emerge,flower,free,geminat,glabrate,greyi,growing,irregular,like,live,lobed,lon,long,lower,major,middle,minor,minute,nflorescence,older,one,overlappin,paler,papillae,papillo,papillose,pinkish-grey,planar,pore,poricidal,portion,rather,red-papillose,ry,scar,soon,spaced,specimen,straight,tall,tear,thick,thicker,tightly,tip,ud,unit,wider,widest,wing,ympodial,young	appearance,arrangement,border,branch,bud,characteristic,colour,corrugation,diameter,distal,drying,exertion,form,fruiting,giving,glabrousnes,height,history,inflorescence,interjected,leaflet,length,life,lobing,midpoint,na,number,peduncle,per,prickle,primary,pseudostipule,ray,seed,terminal,texture,thicknes,type,variation,width
1	wfo-0001025657	success	239	138	102	137	36	0.427	0.1-0.4,0.2-0.4,1-1.1,1-3,1.3-2,1.5-1.8,2-10,2/3,25-60,3-6,4-4.4,5-14,5-16,6-12,6-8,7-27,8.3-12,abaxially,acute,adaxially,also,anther,anthesi,apex,base,berry,bluish,blunt-tipped,branch,branched,brown,bud,calyx,chartaceous,cm,conical,cordate,corolla,dark,deltoid,diameter,dried,elliptic,entire,exserted,filament,fleshy,flower,fruit,granular,green,hair,lateral,leaf,length,light,lobe,margin,midrib,mm,narrowly,nearly,oblong,orbicular,ovate,pale,parted,pedicel,peduncle,persistently,petiole,pseudo-terminal,ray,reportedly,reticulate-punctate,ripe,scented,shrub,side,simple,soft,stellate,stem,stigma,strongly,style,suborbicular,surface,tan,terete,tomentose,tomentose-pubescent,tree,unarmed,vein,velutinous-pubescent,way,weakly,white,x,yellow,yellowish	-2,/3,0.5-2.5,1-1.3,1-1.6,1.2-1.5,1.7-1.9,12x,2-3.5,2.2-5.5,2.5-9.3,2.7-4.3,3-4,3-4.8,3.2-6,4-4.5,4-7,6.5-10,7-9,7-9.5,8-10.5,accrescent,ag,apart,apparently,appearing,ark,around,articulated,ascending,axe,axillary,ba,blade,broadly,capitat,central,closely,cylindrical,dendritic-multangulat,dendritic-multangulate,dense,densely,directed,distally,due,eaf,earl,edge,eed,especially,evident,exerted,expanded,farinose,few-rayed,free,fruiting,glabrous,glandula,glandular,half,inserted,lanate-pubescent,lanceolate,lengthening,lobed,long,long-stalked,longitudinal,lower,m.,magnification,main,minutely,mixed,multangulate,nflorescence,obtuse,occasional,often,older,open,orolla,ovat,ovate-lanceolate,overlapping,part,partly,perfect,persistent,plurifoliate,pore,poricidal,porrect-stellate,present,pubescence,pubescent,rachi,ruit,semi-ovate,sessile,short,short-,short-stalked,slightly,slit,somewhat,spaced,splitting,stamen,stellate-pubescent,stipitate-glandular,stipitate-multangulate,subcampanulate,subcoriaceous,suture,tall,tamen,thick-stalked,thickened,thin-stalked,time,tip,tomentum,transparent,tube,two-third,ud,unarme,unit,upper,usually,vary,wide,ympodial,young	appearance,arrangement,bark,border,capitate,characteristic,colour,corrugation,drying,exertion,form,giving,glabrousnes,growth,height,history,inflorescence,life,lobing,midpoint,na,new,ovary,perennial,plant,prickle,primary,pseudostipule,seed,shape,size,texture,thicknes,type,variation,width
2	wfo-0001025669	invalid_json	216	151	118	98	33	0.546	'',.5,0-1,0.1-0.3,0.8-2.4,1,1-10,1-2,1-2.2,1-4,1.3-4.2,1.4-2.5,1.6-4.4,13-35,2-3,2-4,2.2-6,2.2-6.5,2.4-7,3-5,3-7,9-24.5,``,abaxially,absent,acumen,acuminate,acute,adaxially,anther,apart,apex,base,berry,blade,blue,brownish,cell,chartaceous,clavate,cm,condition,connivent,corolla,covering,cuneate,diameter,dorsally,drying,edge,end,filament,flat,flower,folded,forming,fresh,fruit,glabrous,globose,green,greenish,herb,homostylous,lanceolate,lateral,leaflet,lobe,long,membranous,minute,minutely,mm,moderately,monochasium,mottled,oblique,obtuse,odd-pinnate,one,ovoid,pedicel,peduncle,petiole,placed,plant,puberulent,pubescent,purple,rarely,ripe,rosette,rotate,scale-like,seed,size,slightly,sometimes,stem,stigma,straight,streaked,style,subglabrous,terminal,testal,thick,tinged,tube,tuber,typically,unwinged,wall,white,whitish,wide,x,yellow	0-5,0-7,1-3,2,4-6,5-merou,absen,ag,along,alyx,apparently,articulation,axe,broadly,capitat,ciliate,clearly,contracted,decurrent,digestion,discussion,distal,distinct,eaf,eed,elliptic,enzyme,erec,especially,exceeding,except,extra,flowered,geminat,glabrou,greatly,green-white,hair,hair-like,half,highly,honeycomb-shaped,interjected,larger,lengthening,like,living,lower,make,margin,midrib,mucilaginous,multicellular,near,nflorescence,obovate,often,orbicular,orolla,ovate,pair,perfect,petiolulate,petiolule,plurifoliate,pore,poricidal,proximal,reduced,removed,rounded,ruit,see,sessile,seudostipule,short,single,slit,spaced,species,specimen,stamen,ste,stolo,subequal,tall,tamen,tem,throughout,tip,tri-,truncate,unbranched,unequal,unit,vary,wet,ympodial	'extra,'hair-like,5-merous,[,],abaxial,adaxial,arrangement,calyx,capitate,characteristic,colour,erect,form,growth,height,history,inflorescence,leaf,length,life,ovary,placement,pseudostipule,shape,spacing,stolon,surface,texture,type,value,{,}
3	wfo-0001025697	success	181	134	91	90	43	0.503	0-14,0.15-0.75,0.6-3.5,1-1.7,1-2,1.5-1.8,1.7-8.6,2-10.5,2-2.6,25-35,3-10,3-4,3-6,3.3-11,4-7.5,6.5-13.5,abaxially,acuminate,acute,adaxially,anther,apex,attenuate,axillary,base,berry,blue,brownish,bud,clavate,cm,condition,coriaceous,corolla,dark,deep,diameter,distal,drying,elliptic,filament,forked,fresh,fruit,generally,glabrous,globose,green,green-white,greenish,half,herb,interjected,lanceolate,lateral,leaf,leaflet,light,lilac,lobe,medium,mm,mucilaginous,odd-pinnate,ovate,ovoid,pedicel,peduncle,petiole,petiolulate,plant,purple,ripe,rounded,seed,sessile,short,size,stigma,stripe,style,subtending,terminal,throughout,tube,typically,unwinged,usually,wet,whitish,x	-9,0.8-2,1-3,10-26,2-4,2-6,3-5,5-merou,5.5-11.5,acumen,adaxiall,ag,alyx,apart,apparently,articulated,asymmetric,axe,basiscopic,blade,capitat,cell,connivent,covering,decreasing,decurrent,digestion,dorsally,eaf,edge,eed,enzyme,erec,exceeding,flat,flower,folded,geminat,glabrescent,glabrou,hair,hair-like,hal,high,homostylous,honeycomb-shaped,lengthening,linear,living,long,lower,make,nflorescence,orbicular,orolla,pair,pentagonal,perfect,plurifoliate,pore,poricidal,rachi,removed,rotate,ruit,seudostipule,side,slightly,slit,spaced,specimen,stamen,straight,subequal,subglabrou,tall,tamen,tem,testal,thick,tip,tissue,toward,tri-,unit,vary,wall,wood,yellow,ympodial	appearance,arrangement,bark,border,branch,calyx,capitate,characteristic,colour,corrugation,exertion,form,fruiting,giving,glabrousnes,growth,height,history,inflorescence,length,life,lobing,margin,midpoint,na,new,number,ovary,per,prickle,primary,pseudostipule,ray,shape,stem,surface,texture,thicknes,type,variation,vein,width,woody
4	wfo-0001025699	invalid_json_followup	181	154	108	73	46	0.597	.2,.5,0.5,1,1-1.5,1-2.5,1-3,1.5-2,1/3,10,15-20,2,2-2.5,2-6,2cm,3-15,3-5.5,4-5,5-8,5-winged,5.5-14,8-9,absent,acute,adaxially,almost,anther,apex,attenuate,bark,base,becoming,berry,branching,brown,c.,calyx,capitate,cm,completely,conical,corolla,dark,darker,diameter,drying,ellipsoid,elliptic,entire,erect,exerted,filament,flower,fruiting,glabrous,globose,green,grey-brown,growth,immature,inflorescence,leaf,leaf-opposed,leafy,less,lobe,margin,markedly,midrib,minutely,mm,new,older,ovary,pair,pale,pedicel,peduncle,per,petiole,poricidal,primary,red,reddish,reniform,reticulate-pitted,rounded,rounded-sagittate,shoot,short,simple,slightly,somewhat,stem,stigma,style,surface,time,tip,tree,tube,vein,way,white,x,yellow,young,Â½	1-2,1.5,3-3.5,3-8,499,abaxially,age,anthesi,apart,apparently,appearing,articulating,campanulate,conspicuously,continuing,corrugate,crystal,cup-shaped,deltate,densely,difoliate,dorsal,dry,eaf,eed,face,fide,free,glabrou,included,inclusion,inflorescenc,irregularly,lanceolate,leaving,lengthening,lobed,lower,narrowly,nflorescence,nodding,one,onto,oxalate,papillat,papillose,peg,penden,perfect,plurifoliate,pore,portion,ruit,sand,scar,slit,small,spaced,stearn,straight,strongly,tangled,thickened,triangular,trichome,ud,unit,white-spotted,wide,wing,winged,woody,ympodial	'',[,``,appearance,arrangement,border,branch,bud,characteristic,colour,corrugated,corrugation,distal,exertion,form,fruit,giving,glabrousnes,height,history,interjected,lateral,leaflet,length,life,lobing,midpoint,na,number,papillate,plant,prickle,pseudostipule,ray,seed,shape,size,terminal,texture,thicknes,type,value,variation,width,{,}
5	wfo-0001025700	success	189	126	84	105	42	0.444	0-16,0.30-2.0,0.5-2,0.7-2.7,0.8-2.6,1.1-2.3,1.5-2,10.5-12,15-40,2-12,2.5-4,3.5-10.5,3.7-8.6,5-15,5.5-18,5.5-8,9-31,acuminate,acute,anther,apex,apiculate,articulated,attenuate,axillary,base,berry,bud,chartaceous,clavate,cm,corolla,diameter,distal,dot,drying,elliptic,filament,forked,fruit,generally,glabrescent,glabrous,globose,green,greenish,half,herb,high,interjected,lanceolate,lateral,leaf,leaflet,light,lilac,lobe,medium,mm,mucilaginous,narrowly,odd-pinnate,ovate,ovoid,pedicel,peduncle,petiole,petiolulate,plant,purple,rounded,seed,size,stigma,style,subtending,terminal,tube,typically,unwinged,usually,whitish,winged,x	0.8-4,1-2,1-3,10-40,2-7,3-4,3-8,4-5,5-20,5-merou,5.3-17.5,abaxially,acuman,acumen,adaxially,ag,alyx,apparently,asymmetric,axe,basal,basiscopic,blade,brownish,capitat,cell,condition,connivent,considerably,covering,decrease,decreasing,digestion,dorsally,eaf,edge,eed,enzyme,erec,exceeding,except,flat,flower,folded,fresh,geminat,glabrou,green-white,hair,hair-like,hal,homostylous,honeycomb-shaped,larger,lengthening,linear,living,long,lower,make,nflorescence,orbicular,orolla,pair,par,pentagonal,perfect,plurifoliate,pore,poricidal,proximal,removed,ripe,rotate-pentagonal,ruit,sessile,seudostipule,short,side,slightly,slit,sometimes,specimen,stamen,straight,subequal,subglabrou,tall,tamen,tem,testal,thick,throughout,tip,tissue,toward,tri-,unit,vary,wall,wet,white,whose,yellow,ympodial	appearance,arrangement,bark,border,branch,calyx,capitate,characteristic,colour,corrugation,exertion,form,fruiting,giving,glabrousnes,growth,height,history,inflorescence,length,life,lobing,margin,midpoint,na,new,number,ovary,per,prickle,primary,pseudostipule,ray,shape,stem,surface,texture,thicknes,type,variation,vein,width
6	wfo-0001025704	invalid_json_followup	248	174	136	112	38	0.548	0-100,0-3.5,0.1-0.5,0.3-0.8,0.5-1.5,0.7-1,1-3.5,1-6,1.2-3,1.5-3.2,1.5-4.5,1.8-3.5,1/2-4/5,2-10,2-3,2-4.5,2.5-4.5,2.7-4,3-15,3-5,3-6,4-5,4.5-6.5,6-12,8-12,8-15,8-17,abaxial,adaxial,almost,anther,apparently,articulated,bark,base,berry,branched,calyx,cell,chartaceous,cm,connivent,curved,densely,diameter,discolorous,distal,drying,ellipsoid,elliptic,erect,evenly,filament,flattened,flattened-reniform,flower,fruit,fruiting,glabrescent,gray,green,green-yellow,irregular,lateral,leaf,length,lobe,lobed,lobing,long,long-styled,margin,maturity,mauve,midpoint,mm,near,occasionally,often,orange,orange-brown,outline,ovate,pair,pale,pedicel,peduncle,per,petiole,pit,plant,poricidal,prickle,prickly,primary,prominent,raised,rarely,ray,red-brown,red-green,round,shape,short-styled,shrub,side,small,smooth,sometimes,somewhat,sparsely,spherical,stellate-pubescent,stem,straight,strongly,style,surface,tapering,terete,terminal,tip,tree,tube,unarmed,unbranched,vein,way,white,white-gray,wide,yellow,yellow-green,yellowish,young,Ã	-10,-2,-3,-5,/6,0,0-2,0-5,0.1,0.1-0.3,0.15-0.8,1,1-4,1.5-2,1/4-3/4,1/5,2,2-5,2-7,3-10,4-12,5-20,5-merous,6-15,abaxially,acute,age,alyx,andromonoecious,apar,apart,apex,apically,apiculate,auriculate,axe,ba,blade,broad-deltate,brow,cordate,covering,deltate,development,distance,eaf,eed,elongating,end,equal,extending,free,glabrous,half,hermaphrodite,heterostylous,infructescence,less,longer,lower,lowermost,mature,midvein,moderately,multangulate,nflorescence,obtuse,older,one,open,orolla,oung,pendulous,pericarp,plurifoliat,porrect,portion,prickl,recurved,reflexed,retaining,rounded,ruit,scar,secondary,sessile,shorter,slender,spaced,spreading,stalk,stalked,staminat,stellate,stellate-pubescen,stout,tamen,tertiary,throughout,time,trichome,truncate,unit,upper,variously,vary,venation,visible,warty,widening,woody,ympodial	'',[,``,arrangement,branch,brown,bud,characteristic,colour,corolla,corrugation,exertion,form,glabrousnes,growth,height,history,inflorescence,interjected,leaflet,life,na,new,number,ovary,perennial,pseudostipule,seed,size,stigma,texture,thicknes,type,value,variation,width,{,}
7	wfo-0001025729	invalid_json_followup	177	174	128	49	46	0.723	.5,/4,0.25-0.5,0.7-1.2,1-1.5,1-5,1.1-1.5,1.2-1.8,1.75,2,20,4-5,4-8,5-50-flowered,7-8,9-17,abaxial,abaxially,abrupt,acute,adaxially,anther,anthesi,apex,apical,apiculate,appearing,axil,bark,basal,base,berry,black,blackish,bright,bristly,bud,calyx,cm,corolla,covering,dark,densely,dia,difoliate,dirty,drying,elliptic,enclosed,expanded,f,filament,flattened-reniform,fleshy,fruiting,furcate,gently,glabrous,globose,green,greenish-yellow,greyish-brown,growing,lamina,lateral,leaf,like,live,lobe,lobed,long,main,margin,minutely,mm,oblique,occasionally,often,opposite,ovary,overtopping,pair,pale,papillose,partially,pedicel,petiole,pit,pitted,plant,pore,poricidal,portion,pubescent,quite,reflexed,ripening,rounded,shaped,shiny,short,simple,size,sparsely,stem,stigma,stout,style,surface,tapering,tear-drop,terminal,tip,tree,treelet,trichome,tube,tuft,uniseriate,unit,usually,vein,way,white,widening,woody,x,yellow	-20,1.5-2,2-3.5,3-6,6-8,along,apar,branched,covered,cyathiform,deflexed,deltoid,denser,diam,differing,eaf,edicel,eed,free,geminat,glabrou,incrassate,lat,lon,lower,m.,mainly,major,member,middle,minor,minute,nflorescence,older,one,overlapping,papillo,prominent,raised,ruit,scar,straight,tall,touching,tub,ud,widest,ympodial,young	'',4-20,[,``,arrangement,branch,characteristic,colour,corrugation,diameter,distal,exertion,form,fruit,geminate,glabrousnes,growth,height,history,inflorescence,interjected,late,leaflet,length,life,lobing,midpoint,na,new,number,peduncle,per,primary,pseudostipule,ray,seed,shape,sympodial,texture,thicknes,type,value,variation,width,{,}
8	wfo-0001025749	invalid_json_followup	217	157	114	103	43	0.525	-12,.5,/5,0.1-0.3,0.2-1.5,0.3-1.5,0.4-0.7,0.5-0.8,0.5-0.9,0.5-1.3,0.5-3,0.6-4.5,0.8-0.9,1-10,1-2,1-3,1-8.5,1.5-2.5,2-2.5,2.5-6,3-20,5-10,5-20,abaxially,acute,adaxially,anther,apart,apex,apparently,bark,base,berry,calyx,chartaceous,cm,concolorous,cuneate,curved,dark,densely,diameter,discolorous,drying,dull,filament,flattened,flattened-reniform,fruit,fruiting,gently,glabrous,gray,green-brown,lateral,leaf,length,light,lobe,lobed,long,long-ovate,lower,margin,maturity,mauve,midpoint,mm,moderately,narrow-deltate,orange-brown,orange-red,orbicular,ovate,pair,pale,pedicel,peduncle,per,petiole,poricidal,prickle,prickly,primary,ray,red-brown,rounded,shrub,spaced,sparsely,spherical,spreading,stellate,stellate-pubescent,stem,straight,straw-yellow,strongly,style,surface,tapering,terete,tip,tube,usually,vein,visible,way,white,wide,yellow,yellow-green,yellow-orange,yellowish	-1,0-10,0-3,0-5,0-6,0-8,0.1,0.1-0.2,0.1-0.4,0.2,0.5,1,1-13,1-6,1-9,1.5,1.5-2,1/4-1/3,1/5-1/2,2-10,2/3,3-5,4-8,5-,5-merous,6-8,abaxial,acuminat,adaxial,adnate,almost,alyx,apar,apically,articulated,blade,branched,broad-deltate,difoliate,distance,eaf,eed,elongating,equal,erect,extending,filiform,flower,free,geminat,glabrescent,herbaceous,indistinct,infructescence,lon,longer,magnification,markedly,mature,midvein,narrow-ovate,nflorescence,oblong,obtuse,occasionally,older,one,open,orange-brow,orolla,oung,pendulous,perfec,pericarp,porrect,portion,prickl,procumbent,purple,rarely,recurved,reduced,ruit,scar,sessile,shorter,side,smooth,sometimes,stalk,stalked,tamen,tertiary,time,toward,trichome,unit,variously,vary,venation,without,ympodial,Â½-2/	'',[,``,arrangement,branch,bud,characteristic,colour,corolla,corrugation,distal,exertion,form,glabrousnes,growth,height,history,inflorescence,interjected,leaflet,life,lobing,na,new,number,ovary,perennial,plant,pseudostipule,seed,shape,size,stigma,terminal,texture,thicknes,type,value,variation,width,{,},Â½-2/3
9	wfo-0001025754	success	164	124	93	71	31	0.567	.5,0.5-1,0.5-1.5,1,1-2,1-3,1-3.5,1.5,1.5-4,10-20,10-35,2-foliate,4-6,5-12,5-15,absent,acuminate,acute,anther,apex,asymmetrical,base,berry,beyond,branch,brown,calyx,center,chartaceous,ciliate,cm,cordate,cordiform,decumbent,decurrent,densely,diameter,dm,drying,edge,entire,equal,exserted,filament,fine,flower,fruit,glabrous,globose,hair,herb,immature,leaf,leaving,linear-lanceolate,margin,maturing,membranaceous,mm,moderately,nearly,oblong,often,palmately,parallel,pedicel,peduncle,per,petiole,pubescent,radiating,raised,ridge,running,semitransparent,shallow,short,slightly,sparsely,stamen,stem,stigma,style,surface,triangular,truncate,tube,unbranched,upright,vein,white,x,yellow	-celled,0.1-0.2,1.5-3,2-4,2-5-celled,2-7,3-10,3-5,3-6,4,abaxially,abundant,adaxiall,adaxially,along,axe,barely,blade,connected,dehiscing,denser,dried,eaf,eed,eglandular,emarginat,erect,explosively,flat,geminat,glandular,held,interpetalar,like,lobe,long,lower,lying,main,material,maturit,mesocarp,mixed,much-branched,nfloresence,notch,orolla,penden,placenta,pressure,probably,pubescen,rachi,rotate,ruit,small,solitary,sometimes,straight,swollen,tal,tamen,tem,tissue,unit,vary,visible,watery,wid,woody,ympodial	arrangement,bark,bud,characteristic,colour,corolla,corrugation,exertion,form,fruiting,glabrousnes,growth,height,history,inflorescence,length,life,lobing,na,new,number,ovary,pendent,plant,primary,seed,shape,size,texture,type,wide
10	wfo-0001025760	success	210	141	115	95	26	0.548	-12,-5,.5,/3,0-0.5,0-100,0.15-0.3,0.3-1,0.4-0.8,0.45-0.9,0.5-1.5,0.5-2,0.7-2.5,0.8-1.8,1-,1-1.8,1-4,1.5,1.5-2.5,1/5,2-2.5,2.1-3.5,2.5-10,2/3,3,3-6,5-18,acute,almost,annual,anther,apex,apically,apparently,articulated,bark,base,berry,black,broad-deltate,calyx,chartaceous,cm,cream,cultivar,cuneate,curved,dark,diameter,dull,elliptic,filament,flattened-reniform,fruit,fruiting,gently,glabrous,green,herb,infructescence,lateral,leaf,length,lobe,lobed,long,margin,marking,maturity,membranous,midpoint,mm,moderately,orange,orange-brown,ovate,pair,pale,pedicel,peduncle,per,perennial,petiole,poricidal,primary,ray,red-brown,rounded,shape,shrub,side,sometimes,spherical,stellate-pubescent,stem,style,subentire,surface,tapering,terete,tip,tube,unarmed,unbranched,upper,usually,various,vein,way,weakly,white,wide,yellow,yellow-green,young	-10,-3,-6,0.1,0.1-0.2,0.2-0.35,1,1-2,1.5-4.5,1.5-5,1/4,1/4-1/2,1/4-1/3,2-3,2.3-4,2.5-8,3.5-17,3.5-9,5-10-merous,8-10,abaxial,abaxially,acut,adaxial,alyx,apar,blade,brow,concolorous,connivent,deltate,difoliate,discolorous,distance,drying,eaf,eed,elongating,equal,erect,extending,flower,free,geminat,geminate,glabrescent,hair,lengt,longer,lower,mature,midvein,minute,nflorescence,often,older,one,open,orolla,oung,pendulous,perfec,pericarp,porrect,portion,recurved,reflexe,ruit,scar,sessile,shorter,simple,slender,smooth,spaced,spreading,stalk,stalked,stellate,stellate-pubescen,stout,straight,tamen,tertiary,thick-stalked,time,trichome,unarme,unit,variously,vary,venation,visible,woody,ympodial	arrangement,branch,brown,bud,characteristic,colour,corolla,exertion,form,glabrousnes,growth,height,history,inflorescence,life,lobing,na,new,number,ovary,plant,seed,size,stigma,texture,type
11	wfo-0001025782	invalid_json_followup	200	150	109	91	41	0.545	.5,0-10,0-5,0.1-0.15,0.1-0.2,0.4-0.6,0.55-0.75,0.9-1.3,1-2.5,1-4,1.2-6,1.3-1.6,1.5-3,10-13,2-10,2-2.5,2-3,2.5-3.5,2/3-3/4,3-4,3-5,4,4-4.5,4.5-9,5-20,5.5-6,6-14,abaxially,acuminate,anther,apex,apparently,articulated,bark,base,berry,brown,calyx,chartaceous,cm,concolorous,conical,cuneate,curved,densely,diameter,discolorous,distal,drying,dull,elliptic,evenly,filament,flattened,flattened-reniform,flower,fruit,fruiting,gently,glabrous,green,green-brown,lateral,leaf,length,lobed,long,long-styled,margin,maturity,membranous,midpoint,mm,moderately,orange-brown,pair,pedicel,peduncle,per,petiole,plant,poricidal,prickle,prickly,primary,ray,shrub,sparsely,spherical,stellate,stellate-pubescent,stem,style,surface,tapering,terete,tip,toward,trichome,tube,unbranched,vein,way,weakly,white,wide,yellow,yellow-green,young	-2,0.1-0.25,0.3-1,0.5-1,1,1-1.7,1-2,1/4-1/2,1/4-1/3,1/6,2-5,2-7,20,5-6.5,5-8,5-merous,6-8,abaxial,acuminat,adaxial,also,alyx,andromonoecious,apar,apart,apically,blade,climbing,connivent,deltate,difoliate,distance,eaf,eed,elongated,elongating,equal,extending,free,geminat,geminate,glabrescent,hair,hermaphrodite,heterostylous,infructescence,lengt,less,lobe,longer,lower,lowermost,mature,midvein,minute,nflorescence,occasionally,older,one,open,orolla,oung,pendulous,pericarp,porrect,portion,prickl,red-brow,reduced,ruit,scar,sessile,short-styled,shorter,side,simple,smooth,spaced,spreading,staminat,stout,straight,tamen,tertiary,time,unit,vary,venation,visible,woody,ympodial	'',[,``,arrangement,branch,bud,characteristic,colour,corolla,corrugation,exertion,form,glabrousnes,growth,height,history,inflorescence,interjected,leaflet,life,lobing,na,new,number,ovary,perennial,pseudostipule,red-brown,seed,shape,size,stigma,terminal,texture,thicknes,type,value,variation,width,{,}
12	wfo-0001025783	invalid_json_followup	179	153	109	70	44	0.609	.5,0.5-1.5,0.8-3.5,1-1.2,1-3,1.8-2,2-3+,2-5,2-6.5,3-4,5,7-10,abaxially,acute,anther,anthesi,apex,articulated,base,berry,branched,branching,brown,bud,c.,calyx,cm,coriaceous,corolla,dendritic,diameter,ellipsoid,elliptic,entire,erect,expanded,exserted,filiform,flattened,fleshy,flexuous,flower,fruiting,glabrous,globose,green,greyish,growth,inserted,keeled,lateral,lax,less,lobe,lobed,long,margin,minutely,mm,narrowly,new,nodding,number,obtuse,pair,pale,pedicel,peduncle,petiole,pitted,point,primary,pubescent,purple,reniform,revolute,ripe,sagittate,shiny,shoot,short,shrub,simple,sleeve,slightly,sometimes,somewhat,sparsely,stem,stigma,strongly,style,surface,terminal,thin,time,triangular,trichome,truncate,tube,type,uniseriate,vein,vine,violet,way,wide,woody,yellowish	0.5,0.5-1,1-1.5,2,5-merou,<,abaxiall,adaxiall,adaxially,along,alyx,apart,ape,ark,axil,cell,cluster,completely,confined,conical,densely,eaf,eed,exposed,free,glabrou,groove,hromosome,ilament,known,long/tall,lower,mature,midrib,midvein,minute,mmm,near,nflorescence,obscured,occasionally,older,orolla,outlin,penden,pentagonal,perfect,pericarp,plurifoliat,portion,possibly,ruit,scar,scarious,see,spaced,sparse,stellate,suture,testal,transparent,tuft,twinin,ud,unit,upper,vary,weak,within,ympodial	'',[,``,arrangement,bark,branch,characteristic,colour,corrugation,distal,drying,exertion,filament,form,fruit,glabrousnes,height,history,inflorescence,interjected,leaf,leaflet,length,life,lobing,midpoint,na,ovary,per,plant,prickle,pseudostipule,ray,seed,seen,shape,size,texture,thicknes,value,variation,width,{,}
13	wfo-0001025788	success	158	104	58	100	46	0.367	0.5-2,1-4,1-5,14-48,15-30,2-10,2-13,2-3,2-5,2.8-9.5,4-5.5,4.5-10.1,5-8,6.2-12.5,acuminate,apex,base,blue,calyx,cm,conical,corolla,cuneate,deep,diameter,distal,elliptical,filament,finely,green,green-white,herbaceous,interjected,lateral,leaf,leaflet,lobe,medium,mm,mucilaginous,narrowly,oblique,odd-pinnate,ovate,ovoid,pedicel,peduncle,perennial,petiole,plant,pubescent,purple,rounded,seed,size,stigma,style,terminal	-8,0-6,1.8-2.7,1.8-3.9,10-24,2m,3-,3-6-foliat,4-3.,4.5-12.5,6-7,8-38,abaxiall,abaxially,acumen,acute,adaxially,apical,apically,articulate,attenuate,branched,cell,connate,covering,cyme,dehiscent,dichasial,dichasially,digestion,diminishing,dorsally,eaf,ebracteate,edge,eed,emoval,enzyme,exceeding,flat,flower,folded,forked,generally,globo,gradually,hair-like,half,honeycomb,introrse,living,lon,long,long-attenuate,lower,lunat,make,maturing,monochasial,nflorescence,nther,obtuse,often,orolla,pair,pattern,perfect,petiolule,plan,poricidally,proximal,reveal,rotate,ruit,sessile,seudostipule,short,slit,specimen,stamen,straight,subequal,subsessile,tal,tem,testal,thick,throughou,throughout,tip,toward,tuber-bearing,typically,unit,vary,wall,wide,yellow,ympodial,Â¼	4-31,anther,appearance,arrangement,bark,border,branch,bud,characteristic,colour,corrugation,drying,exertion,form,fruit,fruiting,giving,glabrousnes,growth,height,history,inflorescence,length,life,lobing,margin,midpoint,na,new,number,ovary,per,prickle,primary,pseudostipule,ray,shape,stem,surface,texture,thicknes,tube,type,variation,vein,width
14	wfo-0001025792	invalid_json_followup	203	150	102	101	48	0.502	0.4-0.7,1-2,1-3,10-15,2-11,2-3,2-3.5,2.5-3.5,2.5-4,21-28,3-5,3.5-6,4-6,4.5-7,5,5-9,7-10,7.5-8,abaxially,acuminate,acute,adaxially,anther,apex,axillary,base,berry,blue-mauve,blue-purple,brownish,bud,cell,cm,condition,corolla,covering,dark,densely,diameter,distal,distinctly,drying,elliptic,filament,forked,fresh,fruit,generally,glabrous,globose,green,green-white,greenish,half,herb,interjected,lanceolate,lateral,leaflet,lobe,long,margin,mauve,minute,mm,narrow,narrowly,oblique,odd-pinnate,ovoid,papillose,pedicel,peduncle,petiole,plant,proximal,pubescent,purple,ripe,rotate-pentagonal,rounded,seed,semi-rosette,shortly,size,stem,stigma,streak,style,subtending,terminal,testal,thick,throughout,tinged,tube,usually,wall,white,whitish,wing,x	1-10,1-4,3-4,4-12,5-10,5-6,5-merou,8-10,9-12,acumen,ag,along,alyx,apart,apparently,articulated,articulation,auriculate,axe,basiscopic,blade,broadly,capitat,chartaceous,ciliate,connivent,decurrent,developing,digestion,distinct,dorsally,eaf,edge,eed,enzyme,especially,exceeding,except,flat,flower,folded,geminat,glabrou,greatly,hair,hair-like,hal,high,homostylous,honeycomb-shaped,indistinct,lengthening,like,living,lower,make,membranous,midrib,minutely,mottle,mucilaginous,nflorescence,often,onto,orolla,pair,perfect,petiolulate,plurifoliate,pore,poricidal,puberulent,rachi,reduced,removed,ruit,semi-erec,sessile,seudostipule,short,side,slightly,slit,spaced,specimen,stamen,ste,straight,sub-rosette,subequal,tall,tamen,tem,tip,tri-,unit,vary,wet,yellow,ympodial,young	'',[,\u201chair-like\u201d,``,appearance,arrangement,bark,branch,calyx,capitate,characteristic,colour,corrugation,exertion,form,fruiting,giving,glabrousnes,growth,height,history,inflorescence,leaf,length,life,lobing,midpoint,mottled,na,new,number,ovary,per,prickle,primary,pseudostipule,ray,shape,surface,texture,thicknes,type,value,variation,vein,width,{,}
15	wfo-0001025804	invalid_json_followup	155	148	100	55	48	0.645	.25,.5,0.5-1,1-3,1.2-1.5,1.4-1.7,1.5-2,10-20,16-35,2-2.5,3-4.5,3.5-12,4-10,5,6-8,7-10,abaxially,acute,adaxially,anther,apex,attenuate,bark,base,berry,bilobed,branched,calyx,clavate,cm,conical,corolla,cream,dark,decurrent,deflexed,dia,difoliate,drying,ellipsoid,elliptic,erect,exserted,filament,flattened,fleshy,flower,fruiting,glabrous,globose,green,incrassate,internodal,lateral,leaf,light,lobe,lobed,long,main,many,margin,minutely,mm,near,nearly,obovate,occasionally,often,onto,opposite,ovary,pair,paler,pedicel,pitted,plurifoliate,poricidal,red-papillose,reddish-brown,reniform,sessile,shrub,size,somewhat,stem,stigma,strongly,style,surface,thick,time,tip,tube,vein,white,whitish-green,wing,winged,x	1-1.5,11-20,2.5-4,?,age,anthesi,apar,ape,apiculate,ba,c.,covered,cucullate,densely,differing,eaf,edicel,eed,free,geminat,glandular,later,lengthening,lower,major,mere,middle,minor,minute,nflorescence,older,papillae,papillat,papillate,papillose,planar,pore,portion,projection,red,reddish-brow,regularly,rim,ruit,scar,slit,spaced,tall,tub,ud,unit,widest,woody,ympodial,young	'',[,``,arrangement,branch,bud,characteristic,colour,corrugation,diameter,distal,exertion,form,fruit,geminate,glabrousnes,growth,height,history,inflorescence,interjected,leaflet,length,life,lobing,midpoint,na,new,number,peduncle,per,petiole,plant,prickle,primary,pseudostipule,ray,seed,shape,terminal,texture,thicknes,type,value,variation,width,{,}
16	wfo-0001025813	invalid_json	197	112	83	114	29	0.421	'',0-2,0.7-1.7,1-1.5,1-10,1-2,1-4,1.2-4.5,1.3-7,1.5-1.8,1.5-6.5,15-30,2-4,3-3.5,3-4,3-5,3-6,3-7,5-18.5,5-6,6-7,``,abaxially,absent,adaxially,anther,base,berry,blade,blue,borne,brownish,chartaceous,cm,condition,corolla,dark,densely,diameter,drying,end,filament,flower,fresh,fruit,glabrous,globose,green,greenish,hair,herb,homostylous,interjected,lateral,leaflet,light,lobe,long,membranous,minute,mm,monochasium,odd-pinnate,ovoid,pedicel,peduncle,pilose,pubescent,rarely,seed,singly,size,stem,stigma,style,terminal,tube,tuber,typically,violet,white,whitish,x	1.5-2,2-3,2-5,5-merou,acumen,acuminate,acute,ag,along,alyx,apart,apex,apparently,articulated,axe,broadly,cell,ciliate,connivent,contracted,covering,cuneate,decreasing,decurrent,digestion,discussion,distal,distinct,dorsally,eaf,edge,eed,elliptic,enzyme,especially,exceeding,extra,flat,folded,geminat,glabrou,green-white,hair-like,half,highly,honeycomb-shaped,lanceolate,larger,lengthening,like,living,longer,lower,make,margin,midrib,minutely,mucilaginous,near,nflorescence,obtuse,often,orbicular,orolla,ovate,ovoi,pair,perfect,petiole,petiolulate,plant,plurifoliate,pore,poricidal,puberulent,rachi,removed,rosette-formin,rotate,ruit,see,sessile,seudostipule,short,single-flowered,slit,sometimes,spaced,species,specimen,stamen,ste,stolo,straight,strongly,suborbicular,tamen,tem,testal,thick,thir,throughout,tip,toward,tri-,unforked,unit,unwinged,vary,vein,wall,wet,yellow,ympodial	'extra,[,],arrangement,calyx,characteristic,colour,form,glabrousnes,growth,history,inflorescence,leaf,length,life,ovary,presence,pseudostipule,pubescence,rosette-forming,shape,spacing,staman,stolon,texture,type,value,{,}
17	wfo-0001025825	invalid_json_followup	187	147	98	89	49	0.524	0.4-1,0.5-10.4,0.7-2.2,0.9-2,1-2,1-5.5,1.1-1.4,10-24,10.5-26,14-85,2-3.7,2-5,3-10,3-5,3-8.5,3.7-6.5,4-8,6.6-14,abaxially,acuminate,acute,adaxially,anther,apex,axillary,back,base,berry,brownish,bud,cell,clavate,cm,condition,coriaceous,corolla,covering,dark,decurrent,diameter,distal,drying,elliptic,filament,forked,fresh,fruit,generally,glabrous,green,green-white,greenish,half,herb,interjected,lanceolate,lateral,leaf,leaflet,light,lilac,lobe,long,make,medium,mm,mucilaginous,odd-pinnate,ovate,ovoid,pedicel,peduncle,petiole,petiolulate,plant,rachi,seed,sessile,shiny,size,slightly,stigma,streak,style,subtending,terminal,testal,thick,throughout,tube,unwinged,usually,wall,wet,white,whitish,winged,x	0-0.21,0.4-3,0.5-0.8,0.9-4,1-3,22-86,4-9,5-10,5-7,5-merou,6-10,acumen,adaxiall,ag,alyx,apart,apparently,articulated,asymmetric,attenuate,axe,basiscopic,blade,capitat,connivent,cuneate,decreasing,digestion,dorsally,eaf,edge,eed,enzyme,erec,exceeding,flat,flower,folded,geminat,glabrescent,glabrou,hair,hair-like,hal,high,homostylous,honeycomb-shaped,increasing,lengthening,living,lower,middle,nflorescence,orbicular,orolla,pair,pentagonal,perfect,plurifoliate,pore,poricidal,removed,rotate-pentagonal,rounded,ruit,seudostipule,short,side,slit,smaller,spaced,specimen,stamen,straight,subequal,subglabrou,tall,tamen,tem,tip,tissue,toward,tri-,unit,vary,wide,wing,yellow,ympodial	'',[,\u201chair-like\u201d,``,appearance,arrangement,bark,border,branch,calyx,capitate,characteristic,colour,corrugation,exertion,form,fruiting,giving,glabrousnes,growth,height,history,inflorescence,length,life,lobing,margin,midpoint,na,new,number,ovary,per,prickle,primary,pseudostipule,ray,shape,stem,surface,texture,thicknes,type,value,variation,vein,width,{,}
18	wfo-0001025838	invalid_json_followup	217	159	119	98	40	0.548	-20,0.5,0.5-1,0.7-2,1-1.2,1-1.5,1.2-5,1.5-1.7,1.5-2,1.5-3.5,1.5-5,1.8-2,10-15,2-2.5,2.5-3,2/3,20-40,3.5-,4-15,4.5-5.5,6-15,6.5-7,acuminate,anther,anthesi,apex,apiculate,attenuate,base,berry,black,branch,branched,brown,calyx,capitate,clavate,cm,corolla,cup-shaped,dark,densely,diameter,drying,ellipsoidal,elliptic,entire,erect,exserted,filament,flattened,fleshy,fruit,fruiting,glabrous,globose,greenish,growth,inflorescence,lanceolate,lateral,leaf,like,lobe,lobed,long,many,margin,membranous,minute,minutely,mm,narrowly,new,nodding,often,onto,ovoid,pair,pale,pedicel,peduncle,per,petiole,pitted,pointed,primary,pubescent,purple,quadrate,reddish,reniform,revolute,ripe,seed,shrub,simple,slender,slightly,sometimes,stem,stigma,strongly,style,surface,terminal,time,tinged,tip,tree,tube,turbinate,vein,way,white,winged,x,yellow,yellowish	.5,1.5-2.5,10-60,2-5,5,5-merou,abruptly,adaxial,adaxially,ag,along,alyx,apart,appearing,archin,ark,articulated,axil,basall,broad,cell,clustered,connivent,cucullate,decurrent,dendritic,dense,denser,disintegrating,eaf,eed,extending,flower,free,glabrescent,hairy,ilament,inserted,insertion,irregularly,keeled,lamina,lengthening,less,loosely,lower,m.,midrib,mostly,narrowing,never,nflorescence,occasionally,older,orolla,papillat,papillo,perfect,pericarp,platform,plurifoliat,point,pore,poricidal,portion,ruit,scar,shin,shiny,short,sinus,sleeve,slit,small,spaced,sparsely,spreading,square,stellate,tall,tem,testal,thi,thin,trichome,tuft,twinin,ud,uniseriate,unit,upper,vary,wall,weight,wing,woody,ympodial,Â¾	'',[,\u00be,``,arching,arrangement,bark,bud,characteristic,colour,corrugation,distal,exertion,form,glabrousnes,height,history,interjected,leaflet,length,life,lobing,midpoint,na,number,ovary,plant,prickle,pseudostipule,ray,shape,size,texture,thicknes,type,value,variation,width,{,}
19	wfo-0001025845	invalid_json_followup	180	143	93	87	50	0.517	0.3-0.5,0.4-1.5,0.5-11,1-4.5,1.5,1.5-13,1.5-2,1.5-2.5,2,2-15,2-5-lobed,2.5-4,3,4-5,4-6,6-6.5,6-9,abaxially,abundantly,acuminate,acute,adaxially,anther,apex,apiculate,base,branch,brown,calyx,chartaceous,cm,compressed,corolla,cuneate,deltate,diameter,distally,eglandular,ellipsoidal,entire,extra-axillary,filament,flattened,fork,fruit,glabrous,green,greenish,herb,lateral,laterally,leaf,light,lobe,lobed,located,margin,membranaceous,minutely,mm,narrowly,obtuse,orange,ovoid,pedicel,peduncle,petiole,pinnately,puberulent,pubescent,rugose-verrucate,sagittate,sand-punctate,shrub,side,simple,sparsely,stigma,strongly,style,subcordate,tapered,terminal,tip,triangular,truncate,tube,unbranched,unlobed,vein,white,x,yellow	.5,0.5-2.5,1,1-1.8,1-2,1.5-7,2-3,3-13,3-4,3-6,3-foliat,5-6,7-10,adaxial,aggregate,along,apart,around,articulated,ascending,axe,ba,blade,cell,channe,connivent,cylindrical,dark,decurrent,diamete,directed,distall,divided,eaf,eed,elliptic,especially,flower,free,glabrou,inserted,long,longitudinal,lower,major,mesocarp,midrib,near,nearly,nflorescence,obovate,often,orolla,ovate,part,patch,perfect,pore,purple,rachi,radiu,rarely,rotate-stellate,rounded,ruit,shorter,sinus,small,spaced,stone,stripe,tal,tamen,tem,thecae,thick,tightly,time,tomento,truncat,unit,vary,veiny,wide,yellowish,ympodial,youn	'',[,``,appearance,arrangement,bark,bud,characteristic,colour,corrugation,distal,drying,exertion,form,fruiting,giving,glabrousnes,growth,height,history,inflorescence,interjected,leaflet,length,life,lobing,midpoint,na,new,number,ovary,per,plant,prickle,primary,pseudostipule,ray,seed,shape,size,stem,surface,texture,thicknes,type,value,variation,width,{,}
20	wfo-0001025850	invalid_json_followup	197	169	125	72	44	0.635	-5,-7,.5,.8,0.5,0.5-,0.5-1,0.5-3,0.6-1,1,1-1.5,1-3,1-celled,1.5,1.5-5,15-20,2,2-6.5,30,4-5,6-7,acute,anther,anthesi,apex,articulated,axi,basal,base,berry,branched,brown,calyx,capitate,cm,corolla,cyathiform,deciduous,deflexed,denser,diameter,divaricate,drying,ellipsoid,elliptic,entire,erect,exserted,filament,flattened,flower,fruiting,glabrous,gland,glandular,globose,green,growth,half,inflorescence,irregularly,lamina,later,lateral,lax,leaving,lobed,long,many,margin,minute,minutely,mm,narrowly,nearly,new,nodding,node,often,openly,orange,pair,pale,pedicel,peduncle,peg,per,petiole,pinnatifid,pitted,primary,pubescent,reddish,reniform,rhomboid,ripe,rounded,scattered,shallowly,shrub,simple,sleeve,slender,small,soon,spreading,stem,stigma,strongly,style,surface,tan,terminal,time,tiny,trichome,truncate,tube,uniseriate,vein,vine,white,woody,x,young	2-12,3-4,5-7,5-merou,abaxial,ag,along,alyx,apar,apparently,ark,broadly,cell,connivent,cupped,deltate,densely,divided,eaf,eed,elongate,em,extending,fleshy,free,geminat,glabrou,halfway,ilament,lengthening,less,lobe,loosely,lower,membranous,midrib,nflorescence,occasionally,older,orolla,outline,papillate-puberulent,papillo,perfect,planar,plurifoliate,pore,poricidal,portion,puberulen,ruit,scar,shiny,sinuate,sinus,slightly,slit,sometimes,spaced,splitting,spreadin,stellate,surfac,testal,thin,tip,twinin,ud,unit,vary,yellow,ympodial	'',[,``,arrangement,bark,branch,bud,caylx,characteristic,colour,corrugation,distal,exertion,form,fruit,glabrousnes,height,history,interjected,leaf,leaflet,length,life,lobing,midpoint,na,number,ovary,plant,prickle,pseudostipule,puberulent,ray,seed,shape,size,texture,thicknes,type,value,variation,width,{,}
21	wfo-0001025872	success	160	122	91	69	31	0.569	0.25-0.5,0.5,0.6-1,1,1-1.3,1-2,1.2-1.6,1.7-3,2-2.5,2-5,2/3,3.5-4,4-4.5,4.5-13,6-10,6-8,acute,along,anther,apex,apically,bark,base,becoming,beneath,berry,broadly,brownish,calyx,capitate,cm,coriaceous,corolla,crinkled,cup-shaped,dark,decurrent,deeply,densely,dia,dry,elliptic,exserted,filament,flattened,flattened-reniform,fleshy,glabrous,globose,green,greenish-tan,later,lateral,leaf,live,main,margin,midrib,mm,narrowly,occasionally,older,onto,opposite,ovary,pair,pedicel,petiole,pitted,plant,pubescent,red-papillose,revolute,rounded,shaped,shrub,soon,stem,stigma,style,surface,tapering,tear-drop,terminal,thick,tube,vein,way,white,x,young	.1,.5,0.5-1,1-1.5,1.2-1.5,10-25-flowered,anthesi,apart,auriculate,ba,beginning,blade,branched,bright,crowded,deflexed,dense,eaf,edicel,eed,flower,free,fruiting,glandular-resinous,grayish-brow,incrassate,inflorescenc,irregularly,junction,lobe,lobed,lon,long,lower,material,minutely,nflorescence,often,paler,papillae,papillo,papillose,planar,plurifoliat,pore,poricidal,portion,prominent,rounded-triangular,ruit,scar,several,simple,somewhat,spaced,specimen,straight,tall,thickened,time,tip,trichome,tub,ud,uniseriate,unit,visible,woody,ympodial	arrangement,branch,bud,characteristic,colour,corrugation,diameter,exertion,form,fruit,glabrousnes,grayish-brown,growth,height,history,inflorescence,length,life,lobing,na,new,perennial,primary,seed,shape,size,texture,thicknes,type,variation,width
22	wfo-0001025893	invalid_json_followup	157	149	101	56	48	0.643	.25,.4,.5,0.5-1.5,0.8-1,1-1.2,1-4,1.5-1.7,1.5-2,11-20,2-2.5,2-3,3-5,5-6,6-10,accrescent,along,anther,apex,attenuate,bark,base,beneath,berry,bi-lobed,branched,broadly,brownish-green,calyx,capitate,cm,corolla,cup-shaped,decurrent,densely,dia,dry,early,ellipsoid,elliptic,even,exserted,filament,fruit,fruiting,glabrate,glabrous,globose,golden-puberulent,green,greyish,internodal,lateral,leaf,lobe,lobed,long,long-acuminate,main,margin,minutely,mm,narrowly,nearly,obovate,occasionally,older,opposite,ovary,ovoid-reniform,pair,pale,papillose,pedicel,petiole,pitted,pore,poricidal,red-papillose,shaped,shrub,slender,slightly,sometimes,specimen,stem,stigma,straight,style,surface,tapering,tear-drop,tip,tube,vein,white,winged,woody,x,yellowish,young	1-1.5,1-2.5,anthesi,bank,barely,bearing,beginning,blade,closely,deflexed,deltoid,difoliate,eaf,eed,erect,faintly,flower,free,geminate,gravelly,growing,impressed,inflorescenc,lon,longitudinally,lower,many,material,middle,nflorescence,overlapping,papillo,planar,plurifoliat,portion,puberulent,reflexed,river,rocky,ruit,sandy,scar,spaced,stream,striat,tall,thickened,time,trichome,ud,unicellular,unit,usually,visible,widest,ympodial	'',[,``,alternate,arrangement,branch,bud,characteristic,colour,corrugation,diameter,distal,drying,exertion,form,glabrousnes,growth,height,history,inflorescence,interjected,leaflet,length,life,lobing,midpoint,na,new,number,peduncle,per,plant,prickle,primary,pseudostipule,ray,seed,shape,size,terminal,texture,thicknes,type,value,variation,width,{,}
23	wfo-0001025896	success	146	122	71	75	51	0.486	-3,-30,0.5,0.5-2,1-6.5,1-8,1.5-2,2-14,4,4-23,4-5,5-15,6-10,7743,acosta,acuminate,adaxially,also,angled,apex,base,brownish,calyx,chartaceous,cm,cuneate,densely,diameter,eglandular,elliptic-ovate,entire,flower,forked,fruit,glabrous,gland,globose,hair,lobe,margin,mm,moderately,nearly,obtuse,often,orange,ovate,pale,pedicel,peduncle,petiole,pubescent,purple,red,ripe,rugose,short-stalked,shrub,simple,smooth,solÃ­,stem,stigma,style,subcordate,surface,tube,unbranched,vein,white,x	.5-2.5,1-1.5,1-25,1-3,1.5-9,10-15,10-25,2-2.5,2.5-14,2.5-5,4-12,4-6,5-7,6-13,7-,abaxial,abaxially,absen,acute,adaxiall,aggregate,apart,articulated,axe,ba,blade,branched,cell,connivent,constricted,cylindrical,deltate,dendritically,directed,distall,eaf,eed,especially,greenish,inflated,like,long,lower,many-foliat,membranaceous,near,nflorescence,nther,occasionally,orolla,perfect,pore,present,puberulent,pubescen,rachi,radiu,rotate-stellate,ruit,spaced,sparsely,stalked,stone,tal,tem,time,tip,triangular-ovate,triangular-subulate,truncat,unit,vary,wide,yellow,ympodial	anther,appearance,arrangement,bark,border,branch,bud,characteristic,colour,corolla,corrugation,distal,drying,exertion,filament,form,fruiting,giving,glabrousnes,growth,height,history,inflorescence,interjected,lateral,leaf,leaflet,length,life,lobing,midpoint,na,new,number,ovary,per,plant,prickle,primary,pseudostipule,ray,seed,shape,size,terminal,texture,thicknes,truncate,type,variation,width
24	wfo-0001025902	success	211	132	110	101	22	0.521	.5,/2,0.1-0.5,0.5-2,0.5-2.5,1-1.2,1-1.5,1.2-1.5,1.5,1.5-2,1/3,11-15,1983,2-6,2.5-4,4,4-6,40,>,acute,adaxially,anther,anthesi,apex,attenuate,bark,base,becoming,berry,black,branch,c.,cabrera,calyx,clavate,cm,completely,conical,corolla,densely,diameter,dull,ellipsoid,entire,exserted,fide,filament,flattened-reniform,fruiting,glabrous,globose,green,growth,inflorescence,lanceolate,lateral,leaf,leaf-opposed,length,linear,long,lower,margin,mature,minute,minutely,mm,new,occasionally,ovary,pair,pale,pedicel,peduncle,per,petiole,pitted,primary,pubescent,ridged,rounded,scattered,scrambling,simple,slender,sometimes,sparsely,stem,stigma,strongly,style,surface,tangled,tapering,terminal,trichome,tube,uniseriate,vein,vine,violet,way,weak,whitish,wing,woody,x,yellow,yellowish,Â½	.2,1.5-3,3-10,4-13,4-5,5-6,5-merou,8-10,8-15,8-9,abaxially,absent,accompanied,ag,aid,along,always,alyx,apar,ark,articulated,axi,beginning,berr,branched,branching,broadly,cell,chartaceous,circular,climbin,connivent,deciduou,deltate,eaf,eed,either,except,exfoliatin,fleshy,flower,free,geminat,ilament,leaving,lengthening,less,lobe,lobed,loosely,low,markedly,midvei,nflorescence,obscured,often,older,one,orolla,papillat,papillose,peg,pendant,perfect,pericarp,planar,plurifoliate,pore,poricidal,portion,prominent,revolute,rotate-stellate,ruit,scar,semi-aquati,semi-circular,shallow,sleeve,slit,small,somewhat,soon,spaced,spreading,tem,testal,thin,time,tip,twining,ud,ultimate,unit,usually,vary,vegetation,water,weight,widely,ympodial	arrangement,bud,characteristic,colour,corrugation,drying,exertion,form,fruit,glabrousnes,height,history,life,lobing,na,number,plant,seed,shape,size,texture,type
25	wfo-0001025906	invalid_json_followup	188	152	105	83	47	0.559	0-14,0.1-2,0.15-0.6,0.2-0.6,0.20-0.60,1-2,1.1-2,1.6-12.4,1.8-4.8,16-51,2-4.4,2-6,2.6-5.2,3-10,4-7,5-7,5.2-9,8-16,abaxially,acute,adaxially,anther,apex,axillary,base,berry,blue,brownish,bud,cell,clavate,cm,condition,coriaceous,corolla,covering,cuneate,dark,decurrent,diameter,distal,drying,filament,forked,fresh,fruit,generally,glabrous,globose,green,green-white,greenish,hair,half,herb,interjected,lanceolate,lateral,leaf,leaflet,light,lilac,linear,lobe,long,make,mm,mucilaginous,obtuse,odd-pinnate,ovoid,pedicel,peduncle,petiole,plant,pubescent,purple,rachi,ripe,seed,sessile,shiny,short,size,slightly,stigma,stripe,style,sub-glabrous,subglabrous,subtending,terminal,testal,thick,throughout,tube,typically,unwinged,usually,wall,wet,white,whitish,width,x	1-3,1-6,3-5,4-10,4-12,4-5,5-6,5-merou,8.5-12.5,acumen,adaxiall,ag,alyx,apart,apparently,articulated,axe,blade,capitat,connivent,decreasing,decurrency,delimited,digestion,diminishing,dorsally,eaf,edge,eed,enzyme,erec,exceeding,falcate,first,flat,flower,folded,geminat,glabrou,hair-like,hal,high,homostylous,honeycomb-shaped,lengthening,living,lower,next,nflorescence,orolla,pair,pentagonal,perfect,plurifoliate,pore,poricidal,removed,rotate,ruit,second,seudostipule,slit,smaller,spaced,sparsely,specimen,stamen,straight,subequal,subglabrou,tall,tamen,tem,third,tip,toward,tri-,unit,vary,well,wood,yellow,ympodial	'',[,\u201chair-like\u201d,``,arrangement,bark,branch,calyx,capitate,characteristic,colour,corrugation,erect,exertion,form,fruiting,glabrousnes,growth,height,history,inflorescence,length,life,lobing,margin,midpoint,na,new,number,ovary,per,prickle,primary,pseudostipule,ray,shape,stem,surface,texture,thicknes,type,value,variation,vein,woody,{,}
26	wfo-0001025907	invalid_json_followup	148	149	100	48	49	0.676	-4,.05,.5,.5-1,0,0-60,0.8-1.8,1,1-1.2,1-2.3,1-3,1-5,1.5-2,1.5-2.2,10-15,12-45,2,2-3.5,2/3,3-,3-4,4-5,5-15,acuminate,acute,along,anther,apex,attenuate,axil,axillary,base,bearing,berry,brown,c,calyx,cm,conical,conspicuously,densely,diameter,elliptic,filament,flattened,flower,fruit,fruiting,glabrous,globose,green,greenish,growth,iquito,isolated,lobe,lobed,long,lower,margin,minutely,mm,near,nearly,new,obovate,open,ovary,ovoid-reniform,pair,papillate,papillose,pedicel,per,petiole,plant,population,poricidal,primary,pubescent,red-papillate,round,rugose,scar,seed,shrub,simple,size,stigma,style,surface,time,tip,trichome,truncate,tube,uniseriate,vein,white-lenticellate,x	2-8,3/2,absent,anthesi,anthesis5-7,anticlinal,appearing,beak,breaking,cell,clavat,deciduous,eaf,edicel,eed,epidermal,erec,free,highly,included,irregular,lamina,lon,nflorescence,occasionally,portion,projection,raised,reflexed,remaining,ruit,scattered,single-stemmed,sinuous,slender,soon,sparsely,tal,tem,thickening,tub,ud,unifoliat,unit,variable,white,without,ympodial	'',5-7,[,``,appearance,arrangement,bark,branch,bud,characteristic,clavate,colour,corolla,corrugation,distal,drying,exertion,form,giving,glabrousnes,height,history,inflorescence,interjected,lateral,leaf,leaflet,length,life,lobing,midpoint,na,number,peduncle,perennial,prickle,pseudostipule,ray,shape,stem,terminal,texture,thicknes,type,value,variation,width,{,}
27	wfo-0001026203	invalid_json_followup	197	151	105	92	46	0.533	0-39,0.06-0.86,0.38-11.3,0.4-3,0.5-2.3,0.5-3.2,0.7-2.6,1-13,1-2,1.1-7.9,1.2-5.5,2-4.9,2-43,2-8.5,2.2-13.3,3-10,3-11,3.2-22,7-47,abaxially,acuminate,acute,adaxially,anther,apex,attenuate,axillary,base,berry,blue,brownish,bud,cell,clavate,cm,condition,coriaceous,corolla,covering,dark,deep,diameter,distal,drying,elliptic,filament,flower,forked,fresh,fruit,generally,glabrescent,glabrous,globose,green,green-white,greenish,hair,half,herb,interjected,lanceolate,lateral,leaf,leaflet,light,lilac,lobe,long,make,medium,mm,mucilaginous,odd-pinnate,ovate,ovoid,pedicel,peduncle,petiole,plant,ripe,rounded,seed,sessile,short,size,sometimes,stigma,stripe,style,subtending,terminal,testal,thick,throughout,tube,typically,unwinged,usually,wall,wet,white,whitish,wide,x	0-7,0.3-11,0.3-6,1-4,1-5,1-9,2-10,2-5,3-5,3.2-23,5-merou,acumen,ag,along,alyx,apart,apparently,arranged,articulated,asymmetric,axe,basiscopic,bead,blade,capitat,connivent,decreasing,decurrent,digestion,dorsally,eaf,edge,eed,enzyme,erect,exceeding,flat,folded,geminat,glabrescen,glabrou,hair-like,hal,high,homostylous,honeycomb-shaped,lengthening,like,linear,living,lower,middle,moniliform,multiple,necklace,nflorescence,orbicular,orolla,pair,pentagonal,perfect,plurifoliate,pore,poricidal,rachi,removed,rosett,rotate,ruit,seudostipule,side,slightly,slit,spaced,specimen,stamen,stolon,straight,subequal,subglabrous,tall,tamen,tem,tip,tissue,toward,tri-,tuber,unit,vary,yellow,ympodial	'',[,\u201chair-like\u201d,``,arrangement,bark,branch,calyx,capitate,characteristic,colour,corrugation,exertion,form,fruiting,glabrousnes,growth,height,history,inflorescence,length,life,lobing,margin,midpoint,na,new,number,ovary,per,prickle,primary,pseudostipule,ray,shape,stem,surface,texture,thicknes,type,value,variation,vein,width,{,}
28	wfo-0001026208	success	214	144	108	106	36	0.505	-10,/3,0-20,0.1-0.25,0.1-0.3,0.5-1.2,0.6-0.8,0.6-0.9,0.7-2,0.8-1.5,1-5,1.8-2.3,1.8-2.5,11-25,2-20,3-30,3.5-5,4-7,5,5-17,abaxially,acuminate,acute,anther,apart,apex,apparently,bark,base,berry,bright,brown,calyx,chartaceous,cm,conical,connivent,cuneate,curved,dark,densely,diameter,dull,elliptic,erect,evenly,filament,flattened,flattened-reniform,fruit,glabrous,gray-greenish,green,green-brown,lateral,leaf,length,lobe,lobed,long,lower,margin,maturity,mauve,membranous,midpoint,mm,moderately,orange,orange-brown,ovate,pair,pale,pedicel,peduncle,per,petiole,poricidal,prickle,prickly,primary,pubescent,ray,recurved,red,rounded,shrub,sometimes,spaced,sparsely,spherical,stellate-pubescent,stem,straight,straw-yellow,style,surface,tapering,terminal,tip,tube,unarmed,vein,way,white,wide,yellow,young	-1/2,-3,-5,.5,0,0-4,0-5,0-8,0.1,0.1-0.2,0.5-0.8,0.8-1.3,1-2,1-4,1.5,1.5-2.5,1/3,1/4-1/3,1/4-1/6,2,2-3,2-4,2.5-5,2.5-6,3-5,3-6,3/,4-9,5-,5-22,5-merous,6-22,6-8,abaxial,acut,adaxial,alyx,apar,apically,articulated,becoming,blade,branched,broad-deltate,deltate,difoliate,discolorous,distance,drying,eaf,eed,elongated,elongating,equal,extending,flower,free,fruiting,geminat,geminate,glabrescent,infructescence,longer,mature,midvein,nflorescence,older,one,open,orolla,oung,pendulous,perfec,pericarp,porrect,portion,red-brow,ruit,scar,sessile,shorter,side,slender,smooth,somewhat,spreading,stalk,stalked,stellate,stout,subentire,tamen,terete,tertiary,time,toward,trichome,unarme,unit,usually,variously,vary,venation,visible,woody,ympodial	3/4,appearance,arrangement,border,branch,characteristic,colour,corolla,distal,exertion,form,giving,glabrousnes,growth,height,history,inflorescence,leaflet,life,lobing,na,new,number,ovary,perennial,plant,pseudostipule,red-brown,seed,shape,size,texture,thicknes,type,variation,width
29	wfo-0001026215	success	150	120	88	62	32	0.587	-3,0,1-3,1.5-2,1.5-2.2,13-35,18-20,2,2-3,2-3.5,3/4,4-15,4-5,7-8,abruptly,absent,acuminate,anther,anthesi,apex,axil,axillary,base,berry,broadly,brown,calyx,clavate,cm,completely,conical,conspicuously,continually,corolla,densely,diameter,elliptic,filament,flattened-round,fruit,fruiting,glabrous,globose,green,greenish,herb,horizontal,kink,length,long,marked,markedly,minutely,mm,narrowing,nearly,nodding,occasionally,often,onto,ovary,ovoid-reniform,pair,papillae,papillate,pedicel,per,petiole,poricidal,primary,purple,seed,shrub,simple,stem,stigma,strongly,style,surface,tip,tube,vein,way,white,white-lenticellate,white-pubescent,winged,x	.05,.5,0.05,0.5-1,1,1.5,15-2,2-4,abaxially,along,anticlinal,ape,beak,bifi,cell,deltate,eaf,edicel,eed,enlarged,entire,epidermal,erect,exserted,flower,free,highly,internode,irregular,less,lobe,lobed,lower,nflorescence,noddin,papillat,portion,projection,raised,red-papillose,reflexed,rounded,rugose,ruit,scar,shortsympodial,single-stemmed,sinuous,small,ste,tal,tem,thickening,time,tub,ud,unifoliat,unit,usually,wide,wing,without	arrangement,bark,bifid,branch,bud,characteristic,colour,corrugation,drying,exertion,form,glabrousnes,growth,height,history,inflorescence,leaf,life,lobing,margin,na,new,number,peduncle,perennial,plant,shape,size,tall,texture,type,unifoliate
30	wfo-0001026229	success	299	145	99	200	46	0.331	1,35,5,acute,anther,apex,asymmetric,attenuate-caudate,base,beneath,berry,black,branch,broadly,brown,calyx,camptodromous,clavate,cm,cordate,corolla,cuneate,cyme,dark,densely,developed,diameter,drying,elliptic,elongated,entire,even,flattened,flower,fruit,fully,glabrous,globose,golden,green,growth,hirsute,hispid,immature,included,inflorescence,irregular,lateral,leaf,lobe,lobed,long,margin,mature,membranaceous,midpoint,mm,moderately,narrowly,nearly,new,oblong,ovate,ovate-elliptic,pale,papillose,pedicel,peduncle,per,petiole,pit,primary,purple,ray,reniform,revolute,rounded,shiny,shrub,simple,size,slightly,small,spreading,stellate,stem,stigma,style,surface,terminal,tree,tube,type,unbranched,vein,white,wide,yellowish-white,Â¾	0.1â1.47,0.2â0.8,0.35,0.3â0.9,0.3â1.2,0.4,0.8â1.2,0.8â2,0.9,0.9â4.3,1-celled,1.2â4.8,1.3â1.5,1.3â1.7,1.4,1.7â11.8,1.7â2.3,1.8,1.8â5.5,1.9â2.5,1/3,13,1â1.4,1â2,1â4,2,2.3â3.4,2.8â4,2â3,2â3-celled,2â4-celled,3,3â4,3â5,4.5â6.5,4â6,5-merou,5â9,6â15,6â7,6â8,8.6â12,8â10,9â31,abaxial,abaxially,accrescent,acuminate,adaxial,adaxiall,adaxially,ag,almost,also,always,alyx,anthesi,ark,articulated,associated,axe,ba,barely,blade,branching,broken,capitate,celled,central,changing,commentary,commonly,completely,concentrated,connivent,covered,creating,cylindrical,deltoid,develope,differing,directed,discolorous,diÂ­,dried,eaf,eed,eglandular,ellipsoidal,faces,few-rayed,found,free,frequently,fresh,geminate,glabrescent,gland,glandular,glandular-capitate,hair,head,hyaline,ilament,impressed,insertion,internodal,introrsely,involute,lamina,lanceolate,larger,less,like,long-stalked,longer,longitudinal,lower,mainly,material,maturit,midri,midvein,minute,mixed,much,multangulate,multangulate-stellate,multiseriate,narrow-ovate,near,nflorescence,often,old,older,one,open,opening,orientation,orolla,other,oung,pair,paired,pedunculate,perfect,pink,plurifoliate,point,poorly,pore,poricidal,porrect-stellate,portion,pubescent,purplish,ra,rachi,raised,rarely,remnant,ruit,secondary,see,sessile,shin,short-,short-stalked,shorter,slit,smaller,solitary,sometimes,somewhat,sparsely,spread,spreadin,stalk,strongly,subopposite,subsessile,supported,surfac,three,trichome,trifoliate,tuft,ud,unequal,unit,upper,usually,vary,venation,vestiture,visible,weakly,whitish-green,yellow,ympodial	0.1-1.47,0.3-1.2,1-1.4,1.2-4.8,1.3-1.7,1.7-11.8,1.7-2.3,1.8-5.5,1.9-2.5,2.3-3.4,2.8-4,6-7,8-10,8.6-12,9-31,appearance,arrangement,bark,border,characteristic,colour,corrugation,distal,exertion,filament,form,giving,glabrousnes,height,history,leaflet,length,life,lobing,na,number,ovary,plant,prickle,pseudostipule,seed,shape,texture,thicknes,variation,width
31	wfo-0001026230	invalid_json_followup	144	135	86	58	49	0.597	.25,.5,.8,0.3-1.5,0.75-1,0.9-2,1-1.4,1.1-1.8,1.8-2.3,12.6-20.8,2-4,3-4,4.6-9.3,5-10,5-20-flowered,acuminate,acute,anisomorphic,anther,anthesi,apex,area,bark,base,berry,bud,calyx,cm,corolla,dia,distal,elliptic,erect,except,filament,fruit,fruiting,glabrous,globose,green,grey,immature,lateral,leaf,lobe,lobed,long,long-acuminate,main,margin,minutely,mm,nearly,older,ovary,ovoid,pair,papillose,pedicel,petiole,reflexed,rounded,rusty-papillose,shaped,shrub,simple,slender,slightly,small,stem,stigma,strongly,style,surface,tapering,tear-drop,tip,tree,tube,umbonate,vein,white,winged,woody,x,young	0.5-3,1-1.5,1-4,1.9-4.1,2-5,anisophyllou,apart,apiculate,appears,back,beginning,beneath,broadly,clavate,clu,completely,cordate,coroll,deflexed,deltoid,difoliate,eaf,edicel,eed,enclosing,evenly,free,geminate,inflorescenc,large,lon,long-triangular,lower,major,middle,minor,nflorescence,obtuse,opposite,orbicular,pointed,pore,poricidal,portion,raised,ruit,scar,sinus,spaced,straight,tall,thickened,ud,unit,unknown,white-lenticellat,widest,ympodial	'',[,``,appearance,arrangement,branch,characteristic,club,colour,corrugation,diameter,drying,exertion,form,giving,glabrousnes,growth,height,history,inflorescence,interjected,leaflet,length,life,lobing,midpoint,na,new,number,peduncle,per,perennial,plant,prickle,primary,pseudostipule,ray,seed,shape,size,terminal,texture,thicknes,type,value,variation,width,{,}
32	wfo-0001026233	success	165	138	86	79	52	0.521	-1,-1.9,-5.5,-50,.25,.75,0.7-0.8,0.8-1.55,0.8-4,1-,1.1,1.2-2.7,1/2,2-,2.1,2.3-7,2.6,2/3,3.2-3.7,3.2-4.7,3.5-4.5,5-30,6,acute,annual,anther,antrorse,apex,ascending,basal,base,bearing,berry,broadly,calyx,capitate,cm,conspicuous,cuneate-attenuate,densely,diameter,ellipsoidal,elliptic,entire,few-,filament,fruiting,glabrous,globose,herb,herbaceous,leaf,less,lilac,lobe,longitudinally,margin,mm,moderately,narrowly,non-glandular,ovate,pale,petiole,pinnatisect,present,protuberance,pubescent,ridged,rounded,seed,simple,slender,sparsely,stigma,style,subglobose,surface,trans-ovoidal,trichome,tube,tuberculate,uniseriate,winged,x,yellow	-3.8,-8.1,0.3,0.5,0.7-,0.8-1.3,1,1.5,2,2.4-3.5,4-,5-6.2,abundant,accrescent,ag,annular,articulated,campanulate,coat,curved,cylindrical,difoliat,dimorphic,eaf,eed,embryo,evident,hair,hig,interlobular,investing,lamina,larger,lobed,long,longitudinal,lower,membrane,minutely,multicellular,near,obtuse,occasionally,opening,orolla,other,outer,ovule,papery-scarious,partially,pinnatipartite,pore,poricidal,portion,pubescen,ree,reticulate,ruit,scarcely,seede,serrate,shorter,slightly,slit,small,smaller,striate,strongly,styl,tem,tip,unequal,unifoliate,unit,vary,venatio,verrucose,wider,ympodial	appearance,arrangement,bark,border,branch,bud,characteristic,colour,corolla,corrugation,distal,drying,exertion,form,fruit,giving,glabrousnes,green,growth,height,history,inflorescence,interjected,lateral,leaflet,length,life,lobing,midpoint,na,new,number,ovary,pedicel,peduncle,per,plant,prickle,primary,pseudostipule,ray,seeded,shape,size,stem,terminal,texture,thicknes,type,variation,vein,width
33	wfo-0001026241	invalid_json_followup	220	167	103	117	64	0.468	.5,10-20,109,2-flowered,abaxially,adaxially,anther,apex,appearing,appears,base,basiscopically,berry,black,branching,brown,calyx,capitate,cell,cm,conical,cordate,corolla,covered,cup,darker,densely,depressed-globose,dia,dry,drying,elliptic,entire,erect,erose,et,extended,filament,fruit,fruiting,galiano,glabrous,glandular-pubescent,globose,herb,inflorescence,internodal,irregularly,lateral,leaf,leaflet,lobe,lobed,margin,mm,near,oblique,open,orangish,outline,ovary,ovate,ovoid,papillate,pedicel,peduncle,per,perennial,petiole,pinnatifid,pitted,pubescent,pulp,rachi,remain,reniform,robust,seed,shallowly,sinuate,slightly,somewhat,spatulate,stellate,stem,stigma,stout,style,subshrub,sulcate,surface,terminal,ternate,thickened,triangular,truncate,tube,tuberculate,usually,vein,way,white,x	.2,.3,0.1â0.15,0.2â,0.3â,0.3â0.4,0.3â0.6,0.3â1,0.5,0.5â0.7,0.5â0.8,0.5â1,0.7â1.1,1-,1-celled,1.2â1.5,1.2â2,1.5â1.7,1.5â2.5,1.5â3.5,1.9â2.1,1/3â1/2,1â,1â1.1,1â1.4,1â1.5,1â2,2.5â3,2â2.1,2â3,3,3-,30â50,3â3.1,4-,4.5â5,5,5-celled,5-merous,6,always,anthesi,apical,articulated,attenuate,ba,basal,beak,brittle,broader,campanulate,center,connecting,curved,curving,decurrent,deflexe,dehiscing,deltate,denser,difoliate,discrete,dwarf,eaf,eglandular,enclosed,equal,flower,foliat,foliose,free,geminate,gland,glandular,intially,larger,like,lon,long,longitudinal,main,midvein,mixture,much,nflorescence,one,onto,papillat,perfect,pericarp,pore,portion,prolonged,pubescen,ruit,shiny,simple,slit,small,smaller,sometimes,stamen,strongly,succulent,taproot,testa,thick,tip,tissue,trichome,ud,uniseriate,unit,wide,wing,woody,ympodial	'',0.1-0.15,0.5-0.7,0.5-0.8,0.7-1.1,1-1.1,1-1.4,1-1.5,1-2,1-2.5,1-3.5,1.2-1.5,1.2-2,1.5-1.7,1.9-2.1,1/3-1/2,2-2.1,2-3,2.5-3,3-3.1,30-50,4.5-5,[,``,arrangement,bark,branch,bud,cayx,characteristic,colour,corrugation,decurrenct,diameter,distal,exertion,form,glabrousnes,growth,height,history,interjected,length,life,lobing,midpoint,na,new,number,plant,prickle,primary,pseudostipule,ray,shape,size,texture,thicknes,type,value,variation,width,{,}
34	wfo-0001026242	invalid_json_followup	210	169	125	85	44	0.595	-0.9,-1.5,-2,-6,/4,0,0-2,0.05-0.2,0.3-0.5,0.4-0.5,0.4-2,0.5-1,0.55-0.9,0.7-1.3,1-1.5,1-2.5,1-3,1.5-3,1.5-4,1/5-1/3,10-20,2-2.5,2-5,2.5-2.8,2.5-4.5,3-6.5,4-10,5-7,6.5-8,7-17,abaxially,acute,anther,apex,apically,apparently,articulated,bark,base,berry,branched,bright,broad-deltate,calyx,cm,concolorous,connivent,cuneate,deltate,densely,diameter,distance,drying,dull,elliptic,erect,evenly,extending,filament,flattened,flattened-reniform,flower,fruit,fruiting,glabrescent,glabrous,green,irregularly,lateral,leaf,length,lobe,lobed,long,margin,maturity,membranous,midpoint,midvein,mm,moderately,obtuse,one,open,orange-brown,pair,pale,pedicel,peduncle,per,petiole,poricidal,prickle,prickly,primary,ray,recurved,red,red-brown,rounded,shrub,side,sometimes,sparsely,spherical,spreading,stellate-pubescent,stem,straight,style,subentire,surface,tapering,terete,time,tip,tube,unarmed,vein,way,weakly,white,wide,yellow,young	-5,0.1,0.35-,0.4-0.55,0.5,0.5-0.7,0.7,1.2-2,1/2,1/6-1/4,10-,30-80,4-13,4-5-merous,4.5-5.5,5-,5-18,8-20,abaxial,acut,almost,alyx,ame,apar,apart,blade,c.,curved,difoliate,eaf,eed,elongating,equal,eye,filiform,free,geminat,glabrou,glandular,green-gra,hair,infructescence,largely,longer,lower,mature,minute,multangulate,naked,narrow-deltate,nflorescence,occasionally,older,orolla,oung,pale-brown,perfec,pericarp,porrect,portion,prickl,reflexed,ruit,scar,sessile,shorte,shorter,simple,smooth,spaced,stalk,stalked,stellate,tamen,tertiary,trichome,unarme,unit,upper,variously,vary,venation,visible,woody,ympodial	'',0.35-0.55,20,[,``,arrangement,branch,bud,characteristic,colour,corolla,distal,exertion,form,glabrousnes,green-gray,growth,height,history,inflorescence,interjected,leaflet,life,lobing,na,new,number,ovary,perennial,plant,pseudostipule,seed,shape,size,stigma,terminal,texture,thicknes,type,value,variation,width,{,}
35	wfo-0001026259	success	233	141	106	127	35	0.455	.1,.7,0.3â1.2,0.4â0.6,1.0â1.2,1.0â3.3,1.2â8.4,1.4â4.0,1.5,11â22,12â24,1m,2-ridged,2â17,35â45,6,7â10,8â11,acuminate,acute,anther,anthesi,apex,base,becoming,berry,branch,broadly,brown,calyx,central,cm,concave-reniform,conical-ellipsoid,corolla,cylindrical,decurrent,densely,diameter,ellipsoid,entire,exerted,filament,fruit,fruiting,glabrous,globose,green,green-orange,halfway,herb,inflorescence,internodal,lateral,leaf,length,less,lilac,lobe,long,margin,minutely,mm,nearly,often,ovary,ovate-lanceolate,pair,papillate,pedicel,peduncle,per,petiole,plant,primary,pubescent,purple,rarely,recurving,ripe,rounded,shiny,simple,slightly,smooth,sparsely,spreading,star,stem,stigma,straight,strongly,style,surface,tinged,translucent,tube,turning,vein,white,wide,winged,woody,yellow,yellow-green,young	.8,0.1â0.2,0.2â0.4,0.5,0.5â0.6,0.7â0.9,0404,0â2,1,1-celled,1.5â2.0,1â2,1â2-celled,1â3-celled,2/3,2â3-celled,3.0â3.4,4â5,5-merous,5â14,5â7-celled,?,abaxial,abaxially,adaxial,adaxially,affected,age,apar,appressed,arising,beyond,branched,branching,cell,close,coloured,cone,congested,cream-coloured,dehiscing,deltate,difoliate,drop,eaf,eed,elongating,end,especially,et,fleshy,flower,free,geminat,gradually,growt,hilum,individual,knapp,larger,leave,lengthening,like,live,lobed,lon,longer,lower,lowermost,membranous,much,narrower,narrowly,near,nflorescence,node,occasionally,once-branched,one,outline,pale,pathogen,pentagonal,perfect,pericarp,pore,poricidal,portion,positioned,purple-black,purple-coloured,rachi,reduced,reflexed,relatively,remaining,ruit,scar,short,shorter,shrub,similar,slit,sometimes,somewhat,spaced,splitting,stellate,stone,stout,sub-laterally,tall,tapering,tem,testal,thick,tightly,tip,together,toward,trichome,two,ud,uniseriate,unit,ympodial,â15	appearance,arrangement,border,bud,characteristic,colour,distal,exertion,form,giving,glabrousnes,growth,height,history,interjected,leaflet,life,lobing,midpoint,na,new,number,perennial,prickle,pseudostipule,ray,seed,shape,size,terminal,texture,thicknes,type,variation,width
36	wfo-0001026267	invalid_json_followup	162	142	91	71	51	0.562	.5,0.6-1.7,0.7-1.1,1-1.2,1-2.6,1.5-2,1.5-2.3,2.5-3,20-30-flowered,3-15,3-6.1,5-7,8.5-15,acuminate,acute,anther,apex,attenuate,bark,base,berry,blackish,bright,calyx,cm,corolla,crateriform,cuneate,dia,distally,drying,except,exerted,filament,flattened-reniform,fruiting,glabrous,globose,green,greenish-white,greyish-green,lateral,lavender,leaf,lobe,lobed,long,margin,minutely,mm,narrowly,nearly,occasionally,often,ovary,ovate,pale,papillose,pedicel,petiole,pitted,pubescent,ripening,rough,scattered,shaped,shrub,simple,size,slender,slightly,small,soon,stem,stigma,straight,style,surface,tan,tapering,tear-drop,tinge,tree,trichome,tube,tuft,uniseriate,vein,white,x,yellow-green	.25,0.1-1,0.5-1,1-1.5,1-4,3.2-8.6,4-8,8-10,anthesi,axil,ba,beginning,beneath,body,broadly,closely,decurrent,deflexed,densely,depressed,differing,difoliate,distinct,eaf,edicel,eed,free,geminat,hard,incrassate,inflorescenc,larger,lon,longinflorescence,lower,main,major,maturity,middle,minor,older,one,opposite,overlapping,pair,papillo,pitting,pore,poricidal,portion,quickly,raised,reflexed,remaining,ruit,scar,scarious,softening,spaced,sparsely,tall,tip,triangular,ud,unit,widest,wing,winged,woody,ympodial,young	'',0.25,0.5,[,``,alternate,appearance,arrangement,branch,bud,characteristic,colour,corrugation,diameter,distal,exertion,form,fruit,giving,glabrousnes,growth,height,history,inflorescence,interjected,leaflet,length,life,lobing,midpoint,na,new,number,peduncle,per,plant,prickle,primary,pseudostipule,ray,seed,shape,terminal,texture,thicknes,type,value,variation,width,{,}
37	wfo-0001026279	success	248	150	110	138	40	0.444	-34.3,-5.9,0.2-0.4,0.8-2.3,0.9-1,1-10,1-3.5,1.1-1.6,1.1-1.9,1.5-1.8,11.5-19.7,14-27,2.6-4.8,3-4,3.1-4.2,3.4-5.2,3.5-7.8,4-7.5,8,8-11,abaxially,acuminate,adaxially,anther,anthesi,apex,attenuate,base,berry,black,blunt-tipped,branched,brown,bud,calyx,capitate,cm,conical,corolla,cuneate,dark,deltoid,diameter,drying,elliptic,elongated,entire,exerted,filament,fleshy,flower,fruit,fruiting,glabrescent,glabrous,globose,granular,grayish,green,immature,lanceolate,lateral,lavender,leaf,length,lilac,lobe,long,margin,mature,midrib,mm,narrowly,oblong,obovate,occasionally,orbicular,ovate-lanceolate,pale,pedicel,peduncle,petiole,plant,pubescence,reticulate-punctate,rounded,scabridulous,scabrous,scattered,short,shrub,side,simple,slowly,stem,stigma,style,suborbicular,surface,tomentose,tomentose-pubescent,tree,tube,unarmed,vein,white,whitish,x,yellowish,yellowish-tan	-11.4,-2.9,-4,/14-1/8,0.25-0.4,0.9-1.8,1-1.4,1.5-3,1.7-2.3,1.9-3,1.9-3.2,1/2,2.4-3.2,2.5-3.2,2/3,3.1-3.6,3.8-5.1,5-200,5-8,8.5-10.5,9-22,accrescent,acute,adaxiall,ag,apart,apparently,appearing,appressed,ark,around,articulated,axe,axillary,ba,blade,branch,chartaceous,closely,completely,covering,cylindrical,dendritic-echinoi,dendritic-echinoid,dense,directed,distally,due,eaf,earl,echinoi,echinoid,edge,eed,enveloping,equal,evident,expanded,farinose,few-rayed,free,glabrescen,grayish-green,hair,half,inserted,lengthening,lobed,long-stalked,longer,longitudinal,longitudinall,lower,m.,main,many,minute,mixed,multangulate,multangulate-pubescent,multiseriate,nflorescence,occasional,often,older,open,orolla,overlapping,partly,perfect,plurifoliate,pore,poricidal,porrect-stellate,present,prominent,pseudo-terminal,rachi,ruit,secondary,semi-ovate,sessile,short-,short-decurrent,short-stalked,slightly,slit,somewhat,spaced,splitting,stalk,stamen,stellate,subcampanulate,subcoriaceous,subsessile,sulcate,suture,tall,tamen,tertiary,thickened,thin,thin-stalked,time,tip,ud,unarme,unit,unwinged,upper,usually,vary,way,wide,yellow,ympodial,young	appearance,arrangement,bark,border,characteristic,colour,corrugation,distal,exertion,form,giving,growth,height,history,inflorescence,interjected,leaflet,life,lobing,longitudinally,midpoint,na,number,ovary,per,perennial,prickle,primary,pseudostipule,pseudoterminally,ray,seed,shape,size,terminal,texture,thicknes,type,variation,width
38	wfo-0001026299	invalid_json_followup	239	151	110	129	41	0.46	0-8,0.25-0.5,0.4-0.5,0.5-0.6,0.5-1,0.5-2.5,0.8-1,1,1-1.4,1.1-1.7,1.2-1.6,1.5-2.3,1.8-2,2.2-3.2,3.5-10,5-20,acute,almost,anther,anthesi,apex,approximately,articulated,basal,base,basiscopically,beneath,broadly,brown,calyx,capitate,cell,cm,conical,corolla,crenate-serrate,dark,decurrent,densely,diameter,distal,elliptic,entire,exserted,filament,flower,fruit,fruiting,glabrous,glandular,globose,green,hair-like,half,herb,imparipinnate,inflorescence,interjected,interrupted,irregularly,lanceolate,lateral,leaf,leaflet,lobed,long,margin,middle,minute,minutely,mm,oblique,obovate,outgrowth,ovary,pale,pedicel,peduncle,pentagonal,perennial,petiole,primary,pseudostipule,pubescent,regularly,short,simple,size,sparsely,stem,stigma,straight,stripe,style,surface,terminal,testa,thick,tip,trichome,truncate,tube,variously,vein,velvety,wall,way,white,wide,yellow	--,-0.8,-1,-10,-2.5,-3.5,-5,.5,0.1-0.2,0.1-0.25,0.1-0.4,0.1-0.5,0.15-0.2,0.2-0.25,0.2-1,0.3-0.4,0.4-2,0.5,0.5-0.7,0.6-2,0.7-3.5,0.8-0.9,0.9-1,1-celled,1.2-5,1.5-,2-4,2-6,2-foliate,2-locular,2.5,2.5-7,25,3-,5,5-15,6-20,7-12,abaxially,absent,abundant,acroscopically,adaxially,along,angled,apical,appearance,appendage,axi,berr,bract,bracteate,change,chota,column,could,crenat,developed,diamete,eaf,ebracteate,edicel,eed,eglandular,erect,give,gree,hal,head,intermixed,internode,investing,jequetepeque,lacking,larger,less,like,lobe,lon,long-acuminate,longer,loosely,lower,maraÃ±Ã³n,maturity,mixture,multicellular,narrowly,nearly,nflorescence,node,occasionally,often,pair,patent,petiolule,population,present,prostrate,pubescence,purple,rachi,reflexed,rest,ruit,scarcely,scattered,secondary,sessile,silky,sparse,spreading,staminal,sterile,stout,tall,tem,tertiary,toward,ud,unicellular,uniseriate,unit,usually,valley,weak-walled,winged,woody,ympodial	'',1-7,2-15,[,``,arrangement,bark,berry,branch,bud,characteristic,colour,corrugation,drying,exertion,form,glabrousnes,growth,height,history,length,life,lobing,midpoint,na,new,number,per,plant,prickle,ray,seed,shape,texture,thicknes,type,value,variation,width,{,}
39	wfo-0001026305	success	135	125	95	40	30	0.704	.25,/4,0.2-1,0.25-0.5,0.5-2,0.6-1,0.7-1,1-1.5,1.3-1.5,2-6-flowered,2.5-3,3-8.5,4-4.5,5-7,6-9,7-16,7-9,abaxially,acute,adaxially,anther,apex,area,attenuate,bark,base,beige-tan,berry,calyx,cm,congested,conical,corolla,dark,deflexed,dendritic,densely,dia,difoliate,drying,elliptic,exserted,filament,fruiting,glabrate,glabrous,globose,green,greenish-white,lateral,leaf,leaf-opposed,like,lobed,long,main,margin,minute,minutely,mm,occasionally,older,ovary,ovoid-reniform,pair,pale,papillose,pedicel,petiole,pitted,pore,poricidal,pubescent,rounded,shaped,shining,shrub,simple,slender,sparsely,stem,stigma,strongly,style,surface,tan,tear-drop,tip,trichome,tube,unifoliate,vein,way,x,young	2-2.5,abaxial,along,anthesi,apical,ba,closely,deltate,eaf,edicel,eed,free,geminat,interlocking,knob-like,lamina,lobe,lon,lower,middle,midrib,nflorescence,overlappin,planar,portion,projection,reddish-brow,ruit,scar,scattered,spaced,styl,tall,tub,ud,unit,visible,widest,woody,ympodial	arrangement,branch,bud,characteristic,colour,corrugation,diameter,exertion,form,fruit,geminate,glabrousnes,growth,height,history,inflorescence,length,life,lobing,na,new,peduncle,plant,primary,reddish-brown,seed,shape,size,texture,type
40	wfo-0001026307	invalid_json_followup	193	160	119	74	41	0.617	.6,0.2â0.5,0.2â1.5,0.5â0.7,0.5â5.0,0.6,0.8â2,1.0â1.2,1.0â2.0,1.0â2.4,1â3-celled,1â6-celled,2.0,2.0â3.5,2/3,3.0â4.0,3.5â7.0,35â45,3â8,3â8-celled,4â5.7,8â12,9,abaxial,acute,acute-acuminate,adaxial,angled,anther,anthesi,apex,articulated,base,berry,black,broadly,calyx,central,clavate,cm,corolla,cuneate,cylindrical,decurrent,densely,diameter,ellipsoid,entire,exerted,eye,facing,filament,flattened-reniform,flower,fruit,fruiting,glabrous,glandular,globose,green,growth,herb,internodal,lateral,length,like,lobe,lobed,long,margin,membranous,minutely,mm,narrowing,new,ovary,ovate,paler,pedicel,peduncle,per,petiole,pubescent,purple,purple-yellow,restricted,ripe,shallow,shallowly,shape,shrub,side,simple,sparsely,spreading,stem,stigma,straight,strongly,style,surface,tinged,tip,toward,translucent,triangular,trichome,tube,turning,undulate,uniseriate,variable,vein,vigorous,weak-stemmed,white,wide,yellow,yellow-green	.0â1.2,.3,.5,.5â4.0,.8,0.4,0.5â0.6,0.8â0.9,0.8â5,1.0â1.5,1.0â2.5,2.0â3.0,2.6â13,5-merous,5â7,abaxially,adaxially,age,apar,appressed,becoming,beyond,cell,cone,difoliate,eaf,eed,end,free,geminat,gradually,hilum,later,lengthening,longer,lower,middle,narrower,nflorescence,one,outline,pair,papillat,pentagonal,perfect,pore,poricidal,portion,positioned,primary,recurved,reflexe,reflexed,ruit,scar,shorter,slightly,slit,spaced,ste,stellate,stone,sub-laterally,tal,tem,testal,three,two,ud,unequal,unevenly,unit,upper,ympodial	'',0.8,[,``,arrangement,bark,branch,bud,characteristic,colour,distal,exertion,form,glabrousnes,height,history,inflorescence,interjected,leaf,leaflet,life,lobing,midpoint,na,number,papillate,plant,prickle,pseudostipule,ray,seed,size,terminal,texture,thicknes,type,value,variation,width,{,}
41	wfo-0001026317	invalid_json_followup	169	143	98	71	45	0.58	/4,0.25-1,0.3-1.2,0.5,0.5-0.6,0.7-0.9,0.8-1,1-1.2,1-1.5,10-12,2-2.5,2-4,2.5-10,3-3.5,4-5,6-8,6x,abaxially,absent,acuminate,acute,adaxially,anther,anthesi,apex,approximately,attenuate,bark,base,berry,branched,bright,brown,calyx,capitate,clonal,cm,conical,corolla,dark,dendritic,densely,diameter,drying,elliptic,entire,erect,essentially,filament,flattened,fruiting,glabrous,globose,growth,inflorescence,internodal,lobe,many,margin,minutely,mm,narrowly,new,nodding,orange,ovary,pair,pale,pedicel,peduncle,per,petiole,pitted,plant,poricidal,primary,pubescent,red,reniform,shrub,simple,sparsely,stem,stigma,style,surface,terminal,time,tip,triangular,trichome,tube,uniseriate,vein,way,white,x,yellowish	.5,0.5-0.8,0.5-1,0.6-,1-5.7,2-,3,3-foliate,3.5-15,50-200,?,age,apart,apically,closely,correlated,deltate,dense,distally,eaf,eed,em,erec,exerted,extremely,flower,found,free,geminat,halfwa,lamina,lengthening,less,like,lobed,longer,lower,maturity,nflorescence,occasionally,often,packed,papillat,papillate,perfect,pericarp,planar,plane,population,pore,portion,pubescen,pubescence,pulp,rachi,reflexed,ruit,scar,shiny,slightly,slit,sticky,straight,swollen,thin,toward,ud,unit,variable,woody,ympodial	'',2,2.5-15,[,``,appearance,arrangement,branch,bud,characteristic,colour,corrugation,distal,exertion,form,fruit,giving,glabrousnes,halfway,height,history,interjected,lateral,leaf,leaflet,length,life,lobing,midpoint,na,number,prickle,pseudostipule,ray,seed,shape,size,texture,thicknes,type,value,variation,width,{,}
42	wfo-0001026335	success	157	130	84	73	46	0.535	.5,0.1-0.3,0.25-0.5,0.5-1,0.6-1,0.8-1.3,1-2,1.5-2,10-20,2,2-3,2-4,2-7.5,3-18,3-5,4-5,5-15,5-7,7-8,acuminate,adaxially,anther,apex,base,branched,calyx,cm,connivent,cuneate,curved,deltate,dense,densely,diameter,elliptic,elliptic-ovate,entire,filament,flattened,flower,forked,fruit,glabrescent,glabrous,globose,green,hair,lanceolate,leaf,leaf-opposed,like,lobe,long,margin,midpoint,mm,moderately,oblong,pedicel,peduncle,petiole,probably,pubescence,pubescent,ray,reticulate,ripe,rounded,scattered,shrub,simple,stellate,stem,stigma,straight,style,surface,unripe,usually,vein,white,x,yellow,yellowish	.5-3.5,1,1-1.5,1-3,1-4,1.5-4,10-30,5-,abaxially,accrescent,acute,adaxiall,ag,apart,apparently,articulated,axe,ba,blade,capitat,chartaceous,covering,cylindrical,directed,distally,eaf,eed,equal,erect,especially,frui,fruiting,geminate,glandula,glandular,held,large,longitudinal,lower,many-foliate,much,multangulate,nflorescence,often,opening,orolla,paired,perfect,pore,rachi,ruit,sessile,slightly,slit,smaller,sometimes,spaced,ste,stellate-pubescent,subtending,tal,tamen,tem,time,tip,toward,tube,unit,uprigh,vary,whitish,wide,ympodial	appearance,arrangement,bark,border,branch,bud,capitate,characteristic,colour,corolla,corrugation,distal,drying,exertion,form,giving,glabrousnes,growth,height,history,inflorescence,interjected,lateral,leaflet,length,life,lobing,na,new,number,ovary,per,perennial,plant,prickle,primary,pseudostipule,seed,shape,size,terminal,texture,thicknes,type,variation,width
43	wfo-0001026343	success	221	138	103	118	35	0.466	-3.5,-4,-7,.5,/5,0-4,0-40,0.05-0.5,0.45-1,0.5-1.5,0.8-1.5,1.3-1.7,1.5-2,1.5-2.5,1.8-2.2,1.8-3,1/3,2-3,2-3.2,2-4,2-6,2.2-3.2,3-5,5-10,5.5-9,acute,anther,apex,apparently,articulated,bark,base,berry,branched,broadly,calyx,chartaceous,cm,cream,cuneate,curved,dark,densely,diameter,distal,dull,elliptic,erect,filament,flattened,flattened-reniform,fruit,fruiting,green,green-brown,lateral,leaf,length,lobe,lobed,lobing,long,lower,margin,marking,maturity,mauve,mm,orange,orange-brown,pair,pale,pedicel,peduncle,per,petiole,plant,poricidal,prickle,prickly,primary,purple,reddish,rounded,shrub,small,sparsely,spherical,stellate-pubescent,stem,style,surface,tapering,terete,tip,tree,tube,vein,way,weakly,wide,yellow,young	-1,-1.5,-15,/2,0,0-10,0-2,0-5,0.05-0.2,0.1-0.2,0.15,0.2,0.2-0.3,0.2-0.7,0.3,0.5,1-2,1-3,1-4,1/,1/4-2/3,1/5,10-30,2-5,2-8,2.5-8,3-4,3.5-4.5,5-merous,6-9,7-12,7-14,7-8,7-9,abaxial,abaxially,acuminat,adaxial,alyx,andromonoecious,apar,apart,apically,blade,brow,concolorous,connivent,deltate,distance,drying,eed,elongating,equal,extending,faint,flower,free,glabrescent,glabrous,hermaphrodite,heterostylous,infructescence,less,lon,long-styled,longer,lowermost,mature,midpoint,midvein,moderately,multangulate,narrow-deltate,nflorescence,obtuse,older,one,open,orolla,oung,ovate,pendulous,pericarp,plurifoliat,porrect,portion,prickl,ray,reduced,reflexed,ruit,scar,secondary,sessile,short-styled,side,smooth,sometimes,spaced,spreading,stalk,stalked,staminat,stellate,stout,tamen,tertiary,time,trichome,unarmed,unit,upper,variously,vary,venation,visible,woody,ympodial	appearance,arrangement,border,branch,brown,bud,characteristic,colour,corolla,exertion,form,giving,glabrousnes,growth,height,history,inflorescence,interjected,leaflet,life,na,new,number,ovary,perennial,pseudostipule,seed,shape,size,stigma,terminal,texture,type,variation,width
44	wfo-0001026352	invalid_json_followup	209	156	114	95	42	0.545	.3,.5,0.5,0.5-0.8,0.5-1,0.5-3,0.6-,0.7-2,0.9-1,1-,1-1.5,1-2-celled,1.2-1.7,1.5-4.6,10+,3-15,3.5-9,4-4.5,5-6,7-9,<,acuminate,acute,anther,anthesi,antrorsely,apex,appearance,articulated,bark,base,berry,blue,branch,branching,broadly,brown,calyx,capitate-truncate,chartaceous,cm,conical,cordate,corolla,curved,deltate,densely,diameter,discolorous,ellipsoid,entire,evenly,exserted,filament,flattened,fruiting,giving,glabrous,globose,green,greenish,growth,inflorescence,leafy,length,lobe,long,many,margin,membranous,mm,narrowly,near,nearly,new,outline,ovate,pair,pale,pedicel,peduncle,per,petiole,pink,primary,pubescent,reniform,revolute,shallowly,shoot,short,simple,sleeve,small,spreading,stem,stigma,strongly,style,surface,terminal,time,trichome,truncate,tube,uniseriate,unspecified,vein,vine,weak,white,wide,woody,yellowish	0.5-1.5,1-10,1.5,1.5-2,12-60,2,2-3-celled,5-merou,6-7,?,abaxially,adaxiall,ag,almost,alyx,angle,apart,apparently,arising,articulation,axi,basal,bending,cell,deciduous,denser,eaf,eed,eventually,expanded,few-celled,flower,free,half,heigh,herbarium,ilament,immature,impressed,inflorescenc,irregularly,junction,lamina,large,largest,leave,leaving,lengthening,like,lobed,lower,mature,minutely,nflorescence,older,orolla,papillate,papillo,peg,perfect,pericarp,plurifoliat,point,pore,poricidal,portion,principal,rachi,reflexed,rest,right,ruit,scar,seen,shiny,slit,spaced,sparser,specimen,spreadin,stellate,straw-colored,tem,thin,third,tip,tub,tuberculate,ud,unit,upper,vary,violet,widest,ympodial	'',[,``,arrangement,bud,caylx,characteristic,colour,corrugation,distal,drying,exertion,form,fruit,glabrousnes,height,history,interjected,lateral,leaf,leaflet,life,lobing,midpoint,na,number,ovary,plant,prickle,pseudostipule,ray,seed,shape,size,texture,thicknes,type,value,variation,width,{,}
45	wfo-0001026352	success	214	146	122	92	24	0.57	.3,.5,0.5,0.5-0.8,0.5-1,0.5-1.5,0.5-3,0.6-,0.7-2,0.9-1,1-,1-1.5,1-2-celled,1.2-1.7,1.5,1.5-4.6,10+,3-15,3.5-9,5-6,7-9,<,?,acuminate,acute,anther,anthesi,antrorsely,apex,articulated,base,berry,blue,branch,branching,broadly,brown,calyx,capitate-truncate,chartaceous,cm,conical,connivent,cordate,corolla,curved,deltate,densely,diameter,discolorous,ellipsoid,entire,evenly,exserted,filament,flattened-reniform,form,fruiting,glabrous,globose,green,greenish,growth,herbarium,immature,impressed,inflorescence,leaf,leafy,length,lobe,long,many,margin,membranous,minutely,mm,narrowly,near,nearly,new,outline,ovate,pair,pale,pedicel,peduncle,per,petiole,pink,primary,pubescent,revolute,shallowly,shiny,shoot,short,simple,sleeve,small,specimen,spreading,stem,stigma,strongly,style,surface,terminal,time,trichome,truncate,tube,uniseriate,unspecified,vein,vine,violet,weak,white,woody,x,yellowish	1-10,1.5-2,12-60,2,2-3-celled,4-4.5,5-merou,6-7,abaxially,adaxially,ag,almost,alyx,angle,apart,apparently,appearance,arising,ark,articulation,axi,basal,bending,cell,deciduous,denser,eaf,eed,eventually,expanded,few-celled,flower,free,geminat,giving,half,heigh,ilament,inflorescenc,irregularly,junction,lamina,large,largest,leaving,lengthening,like,lobed,lower,mature,nflorescence,older,orolla,papillate,papillo,peg,perfect,pericarp,plurifoliate,point,pore,poricidal,portion,principal,rachi,reflexed,rest,right,ruit,scar,seen,slit,spaced,sparser,speciman,spreadin,stellate,straw-colored,tem,thin,third,tip,tub,tuberculate,twining,ud,unit,upper,vary,widest,yellow,ympodial	arrangement,bark,bud,characteristic,colour,corrugation,drying,exertion,fruit,glabrousnes,height,history,life,lobing,na,number,ovary,papillose,plant,seed,shape,size,texture,type
46	wfo-0001026379	invalid_json	219	142	111	108	31	0.507	-4.5,0.2-0.38,0.2-0.4,0.7-1,0.7-2.5,0.8-1.2,0.9-1.2,1-1.7,1-10,1-2,1.3-2.1,1.5-2.3,1.8-2.6,1.9-3.4,1/2,13,2-7,2.6-3.7,2.9-4,2/3,3/4,4.1-7,5.3-10.2,50-450,6-10.6,8-13,8.3-10,acute,along,anther,anthesi,apart,apex,articulated,attenuate,bark,basal,base,berry,blunt-tipped,branch,branched,brown,calyx,closely,cm,conical,corolla,dark,densely,diameter,dried,echinoid-pubescent,ellipsoid,entire,filament,finely,fleshy,flower,fruit,fruiting,glabrous,globose,granular,gray-brown,grayish,growth,included,leaf,length,long-attenuate,many,margin,minutely,mm,multangulate,nearly,oblong,obovate,obtuse,ovate,pale,pedicel,peduncle,petiole,plant,rachi,reniform,rich,scabrous,shrub,simple,size,small,spaced,stellate-tomentose,stelliform,stem,stigma,style,terete,time,tomentose-pubescent,tree,tube,velutinous-pubescent,violet,way,whitish,x,yellow	1-3.7,1.7-4.9,1.8-3.2,1.8-5,2-2.8,2.4-5.1,3-11,4-5,8-15,8-29,9-14,abaxially,accrescent,adaxiall,adaxially,ag,apparently,around,axillary,ba,blade,capitat,chartaceous,completely,covering,cylindrical,dendritic-echinoid,directed,distal,distally,eaf,echinoi,echinoid,edge,eed,enveloping,evident,farinose,few-rayed,free,hair,hig,inserted,lacking,large,lateral,lengthening,line,lobe,lobed,long,lower,m.,main,mature,midrib,minute,mostly,multangulat,multangulate-pubescent,nflorescence,often,older,orolla,ovate-lanceolate,partly,perfect,persistently,pitted,plurifoliate,pore,poricidal,porrect-stellate,present,pubescen,rather,recent,ruit,runk,scattered,semi-ovate,sessile,short-stalked,side,slit,sometimes,somewhat,sparse,stellate,stellate-,stellate-pubescent,suture,tamen,testa,thin,tip,translucent,ud,uneven,unit,upper,usually,vary,vein,vestigial,whitish-brown,ympodial,young	'',[,],``,abaxial,adaxial,arrangement,bud,capitate,characteristic,colour,exertion,form,glabrousnes,height,history,inflorescence,life,lobing,na,new,ovary,perennial,seed,shape,surface,texture,type,value,{,}
47	wfo-0001026400	invalid_json_followup	187	163	116	71	47	0.62	0.2-0.8,0.4-1,0.5-1,0.5-1.2,1-2,1.3-2.6,1.7-2.2,10-28,12-27,13-30,2-6,3.4-4.8,3.5-5.9,30-55,5-7,6-13,6.5-20,9-13,abaxially,acuminate,acute,adaxially,anther,apex,asymmetric,attenuate,axillary,base,basiscopic,berry,blue,brownish,bud,cell,clavate,cm,condition,connivent,coriaceous,corolla,covering,dark,deep,diameter,distal,drying,elliptic,filament,finely,flower,forked,fresh,fruit,generally,glabrescent,glabrous,globose,green,green-white,greenish,hair,half,herb,interjected,lanceolate,lateral,leaf,leaflet,light,lilac,linear,lobe,long,make,mm,moderately,mucilaginous,odd-pinnate,ovate,ovoid,pedicel,peduncle,petiole,plant,poricidal,puberulent,pubescent,purple,ripe,rounded,seed,sessile,short,side,simple,size,stigma,stripe,style,subtending,terminal,testal,thick,throughout,tip,tissue,tube,typically,unwinged,usually,wall,wet,white,whitish,x,yellow	0.7-1.1,1-10,10-18,2-8,2.4-5.9,3-6,4-7,5-merou,6-15,8-12,acumen,adaxiall,ag,alyx,apart,apparently,articulated,axe,blade,capitat,decreasing,decurrent,digestion,dorsally,eaf,edge,eed,enzyme,erec,exceeding,flat,folded,geminat,glabrou,gree,hair-like,hal,high,homostylous,honeycomb-shaped,lengthening,living,lower,nflorescence,orbicular,orolla,pair,pentagonal,perfect,petiolulate,plurifoliate,pore,removed,ruit,semi-stellate,seudostipule,slightly,slit,spaced,specimen,stamen,straight,subequal,tall,tamen,tem,toward,tri-,unit,vary,ympodial	'',[,\u201chair-like\u201d,``,arrangement,bark,branch,calyx,capitate,characteristic,colour,corrugation,erect,exertion,form,fruiting,glabrousnes,growth,height,history,inflorescence,length,life,lobing,margin,midpoint,na,new,number,ovary,per,prickle,primary,pseudostipule,ray,shape,stem,surface,texture,thicknes,type,value,variation,vein,width,{,}
48	wfo-0001026406	invalid_json_followup	219	158	111	108	47	0.507	0.3-0.7,0.4-0.9,0.5-1.5,1-2,1.3-1.5,1.5-5,1.8-2.4,1/3,1/4-1/2,2-2.7,2-3,2-6,2.5-8,2.9-3.2,3.2-3.8,5-25,5-50,5-6,6-12,6.5-7,9-15,acute,anther,apart,apex,apparently,bark,base,berry,calyx,chartaceous,cm,conical,connivent,cordate,cream,curved,dark,deltate,densely,diameter,discolorous,distal,drying,erect,filament,flattened,flattened-reniform,foliaceous,fruit,fruiting,gently,glabrous,green,herb,lateral,leaf,length,lobed,long,long-styled,lower,margin,marking,maturity,mauve,midpoint,midvein,mm,moderately,oblong,obtuse,orange-brown,ovate,pair,pale,pedicel,peduncle,pendent,per,petiole,plant,poricidal,prickle,prickly,primary,purple,ray,red-brown,short-styled,shrub,spaced,spherical,stellate-pubescent,stem,straight,style,surface,tapering,terete,terminal,tip,tube,vein,velvety,way,weakly,white,wide,yellow,young	-1,.2,.5,0,0-3,0-30,0-5,0.3,0.3-0.5,0.4-0.8,0.5,0.5-2.5,0.8,00-200,1,1.5-2,1/,1/4,1/4-1/3,10-30,12-19,20-60,3-10.5,3-4,30-60,5,5-7,5-8,5-merous,6-15,7-10,7-8,7-9,abaxial,abaxially,adaxial,adaxially,alyx,ame,andromonoecious,apar,apically,articulated,blade,branched,broad-deltate,c.,dirty-whitish,distance,eaf,eed,elongated,elongating,equal,extending,flower,free,fully,hermaphrodite,heterostylous,infructescence,least,lobe,lon,longer,lowermost,mature,nflorescence,older,one,open,opening,orolla,oung,pendulous,pericarp,plurifoliat,porrect,portion,prickl,reflexed,rounded,ruit,scar,sessile,side,smooth,sometimes,sparsely,spreading,stalk,stalked,staminat,stellate,stout,tamen,tertiary,time,trichome,unit,upper,variously,vary,venation,visible,woody,yellow-brow,ympodial	'',1.5,100-200,2.5,3.5,7.2,[,``,arrangement,branch,bud,characteristic,colour,corolla,corrugation,exertion,form,glabrousnes,growth,height,history,inflorescence,interjected,leaflet,life,lobing,na,new,number,ovary,perennial,plurifoliate,pseudostipule,seed,shape,size,stelate,stigma,texture,thicknes,type,value,variation,width,yellow-brown,{,}
49	wfo-0001026407	invalid_json_followup	221	172	129	92	43	0.584	-11,-6,.5,/3,0.5-0.6,0.5-2,0.9-3,1,1-1.2,1.2-1.5,1.3,1.5-1.7,1.5-7,2.5-3,20-30,3.5,4-5,5,5-10,7-10,7-8,acute,anther,anthesi,apex,appearing,around,basal,base,becoming,beneath,berry,black,branch,branched,broadly,brown,brownish,calyx,capitate,chartaceous,cm,congested,connivent,corolla,deep,dendritic,dense,densely,diameter,discolorous,ellipsoid,elliptic,entire,exserted,filament,flattened-reniform,fleshy,fruiting,glabrous,globose,golden,golden-pubescent,growth,inflorescence,internodal,lateral,lax,leafy,like,lobe,lobed,long,loosely,many,margin,markedly,membranous,minutely,mm,narrowly,near,new,numerous,oblique,occasionally,outline,pair,pale,papillate,pedicel,peduncle,per,persistent,petiole,pitted,primary,pubescence,pubescent,purple,purplish,reddish,revolute,ripe,shiny,short,shrub,simple,slightly,stellate,stem,stiff,stigma,stout,strongly,style,surface,terminal,time,trichome,truncate,tube,vein,vine,violet,way,woody,x,yellow	+,0.5,0.5-1,1-10,1.5-2,2-2.5,20-40,3.5-5.5,5-7,5-merou,abaxially,adaxially,ag,aid,along,always,alyx,apart,area,ark,articulated,axi,berr,blunt,cell,clear,climbin,conical,deltate,denser,eaf,eed,erect,evenly,flower,free,geminat,glabrescen,glabrou,ilament,interpetalar,irregularly,lamina,leaving,lengthening,lower,midvein,mixture,nflorescence,obscured,often,older,open,orolla,paler,papillat,pedice,peg,pentagonal,perfect,pericarp,planar,plurifoliate,pore,poricidal,portion,pubescenc,ruit,scar,sinus,sleeve,slit,small,spaced,sparsely,sparser,spreading,tangled,tem,testal,thin,tip,transition,twining,ud,undulate,unit,upper,usually,vary,weak,ympodial	'',.5-3,[,``,arrangement,bark,bud,characteristic,colour,corrugation,distal,drying,exertion,form,fruit,glabrousnes,height,history,interjected,leaf,leaflet,length,life,lobing,midpoint,na,number,ovary,plant,prickle,pseudostipule,ray,seed,shape,size,texture,thicknes,type,value,variation,width,{,}
50	wfo-0001026424	success	138	115	57	81	58	0.413	1-1.5,1.5-2,10,10-15,15,15-30,3-4,637/1,acuminate,acute,age,apex,base,becoming,blush-violet,broadly,calyx,campanulate,clonal,close,cm,corolla,cuneate,cyme,distinct,ellipsoid,elliptic,erect,exerted,flower,glabrous,lasting,lavender,leaf,lobe,oblique,obovate,pedicel,peduncle,petiole,pinnatisect,rh,scorpioid,several,shrub,simple,soft-wooded,soon,stem,straggly,toward,unwinged,usually,violet,woody,x,year	-25,-3.5,-4,0.75-1.5,1,1-,1-10,1-2,12-60,2,3-11,8-,acuman,acumen,angular,anthesi,aspect,axil,ba,blunt,bluntly,broad,cell,common,conspicuous,cut,dia,downard,eaf,exceeding,except,facetted,facing,floral,fork,forked,general,glandular,gree,growing,hair,interacuminal,lacking,lanceolate,lanceolate-elliptic,larger,line,lobed,lon,long,lower,midvein,minute,mm,nflorescence,often,part,pedicellate,plurifoliat,point,rachi,raised,rarely,rotate-stellate,rounded,second,shallowly,short,sinus,slightly,stone,time,tip,tissue,triangular,tub,ud,unit,within,ympodial,young	1-4,anther,appearance,arrangement,bark,border,branch,bud,characteristic,colour,corrugation,diameter,distal,drying,exertion,filament,form,fruit,fruiting,giving,glabrousnes,green,growth,height,history,inflorescence,interjected,lateral,leaflet,length,life,lobing,margin,midpoint,na,new,number,ovary,per,plant,prickle,primary,pseudostipule,ray,seed,shape,size,stigma,style,surface,terminal,texture,thicknes,tube,type,variation,vein,width
51	wfo-0001026440	invalid_json_followup	181	158	110	71	48	0.608	1-5,1.1-1.4,1.1-1.5,1.3-1.7,1.5-2.1,1/2-2/3,14-30,2-2.8,2.9-4.4,3-7,3-8,3/4,4-12,7-14,9,abaxially,acute,adaxially,along,anther,anthesi,apex,articulated,bark,basal,base,berry,blunt-tipped,bract-like,branch,branched,broadly,brown,calyx,chartaceous,closely,cm,conical,corolla,diameter,dichotomy,distal,elliptic,entire,filament,first,fleshy,flower,free,fruiting,globose,granular,green,greenish-yellow,hair,included,leaf,length,lobed,long-attenuate,many,margin,minutely,mm,multangulate,multangulate-pubescent,nearly,oblong,obovate,obovoid-oblong,obtuse,ovate,pair,pale,pedicel,peduncle,petiole,pitted,poricidal,porrect-stellate,reniform,ripe,scabrous,sessile,short-acuminate,short-stalked,shrub,simple,size,small,sometimes,spaced,sparse,stellate,stem,stigma,style,terete,time,tip,tomentose,tomentose-pubescent,tree,truncate,tube,turning,way,white,x,yellow	0-15,1.8-4.5,1.9-3.7,1/2,2-4,3-5,3.9-6.5,5-7,accrescent,adaxiall,ag,always,apparently,appressed,axillary,ba,blade,branche,capitat,dendritic-echinoid,dense,developed,directed,distally,eaf,echinoi,echinoid,eed,high,inserted,large,lengthening,lobe,long,lower,m.,minute,mostly,multangulat,nflorescence,obscure,often,older,openly,orolla,perfect,persistently,plurifoliate,pore,pubescen,rather,ruit,runk,semi-ovate,slit,somewhat,stellate-pubescent,suture,tamen,testa,thick,thin,tomentum,translucent,ud,uneven,unit,usually,vary,ympodial,young	'',[,``,arrangement,bud,capitate,characteristic,colour,corrugation,drying,exertion,form,fruit,glabrousnes,growth,height,history,inflorescence,interjected,lateral,leaflet,life,lob,lobing,midpoint,na,new,number,ovary,per,plant,prickle,primary,pseudostipule,ray,seed,shape,surface,terminal,texture,thicknes,type,value,variation,vein,width,{,}
52	wfo-0001026441	invalid_json_followup	197	149	102	95	47	0.518	0-2,0.3-0.7,0.5-1.5,0.8,1-1.5,1-2,1.5-2.5,10,15-20,2-2.5,2-5.5,2-8,4-6,4-8,4-8.5,4.5-6.5,5,7-20,7-8,acuminate,anther,apex,articulated,attenuate,axillary,base,berry,brownish,bud,cell,chartaceous,cm,condition,conical,connivent,corolla,covering,diameter,distal,drying,elliptic-lanceolate,filament,flat,forked,fresh,fruit,generally,glabrous,green,greenish,half,herb,interjected,lanceolate,lateral,leaf,leaflet,light,lobe,long,margin,middle,minute,mm,mottled,narrow,obtuse,odd-pinnate,orbicular,ovate,ovoid,pale,pedicel,peduncle,petiole,plant,pubescent,purple,ripe,rotate,rounded,seed,size,slightly,sparsely,stem,stigma,straight,style,subsessile,subtending,terminal,testal,thick,tube,usually,violet,wall,whitish,wide,wing,x	.5,0.4-3,1-10,1.5-2,10-14,3-5,5-10.5,5-merou,6-15,9-14,abaxially,absent,acumen,adaxially,ag,alyx,apart,apparently,axe,blade,capitat,ciliate,decreasing,digestion,dorsally,eaf,edge,eed,end,enzyme,equal,erec,especially,exceeding,flower,folded,fourt,geminat,glabrou,gradually,green-white,hair,hair-like,homostylous,honeycomb-shaped,internal,larger,lengthening,like,living,lower,make,minutely,mucilaginous,nflorescence,one,orolla,pair,perfect,petiolule,placed,plurifoliate,pore,poricidal,puberulent,removed,ruit,secondary,semierect,seudostipule,short,slit,spaced,specimen,stamen,star,ste,stolo,subequal,symmetrical,tall,tamen,tem,throughout,tip,toward,tri-,tuber,typically,unit,vary,wet,white,yellow,ympodial	'',[,\u201chair-like\u201d,``,appearance,arrangement,bark,branch,calyx,capitate,characteristic,colour,corrugation,exertion,form,fourth,fruiting,giving,glabrousnes,growth,height,history,inflorescence,length,life,lobing,midpoint,na,new,number,ovary,per,prickle,primary,pseudostipule,ray,shape,surface,texture,thicknes,type,value,variation,vein,width,{,}
53	wfo-0001026460	invalid_json_followup	131	137	80	51	57	0.611	.1,.5,0.5-1.5,1-1.5,1.5-2,10-15,13.5-21,2-2.5,2.5-3,4.5-5,5,6-7,6-9,7-9,8-10,abaxially,acute-acuminate,adaxially,anther,apex,base,becoming,berry,branched,brown,calyx,capitate,cm,completely,corolla,dark,dia,distal,drying,elliptic,erect,filament,filiform,floccose,flower,fruiting,glabrous,globose,green,greenish,inflorescence,leaf,lobe,long,long-exserted,minutely,mm,nearly,older,ovary,ovoid-reniform,pair,pale,pedicel,pitted,puberulent,reddish,shaped,shrub,simple,soon,stem,stigma,style,subshrub,surface,tapering,tear-drop,tiny,trichome,tube,vein,white,x,yellow	1/2,513,acut,anthesi,axi,closely,conical,deflexed,deltate,do,eaf,edicel,eed,fide,free,frui,inflorescenc,internodal,less,like,lobed,lower,major,membraneous,middle,nflorescence,often,opposite,papillo,papillose,pore,poricidal,portion,reddish-brow,reflexed,ruit,santo,scar,slightly,somewhat,spaced,tall,tip,tub,ud,unifoliat,unit,widest,woody,ympodial,young	'',[,``,acute,appearance,arrangement,bark,border,branch,bud,characteristic,colour,corrugation,diameter,exertion,form,fruit,giving,glabrousnes,growth,height,history,interjected,lateral,leaflet,length,life,lobing,margin,midpoint,na,new,number,peduncle,per,perennial,petiole,plant,prickle,primary,pseudostipule,ray,reddish-brown,seed,shape,size,terminal,texture,thicknes,type,unifoliate,value,variation,width,ye,{,}
54	wfo-0001026489	invalid_json_followup	153	150	100	53	50	0.654	.3,0.05-0.1,0.25-0.5,0.5,0.5-0.75,0.5-2,0.8-1.2,0.8-1.3,0.8-3.7,1-1.5,1.5-5,2-3,2-4,2-5,2-8-flowered,2.5-13,2.5-4,2/3,5-6,8-13,acute,along,anther,apex,area,axil,bark,base,beneath,berry,branched,broadly,brown,calyx,cm,corolla,cup-shaped,dark,densely,dia,difoliate,elliptic,exserted,filament,flattened,flattened-reniform,fruiting,glabrous,globose,green,later,lateral,leaf,lobed,long,main,margin,minutely,mm,occasionally,opposite,ovary,pair,paler,papillose,pedicel,perpendicular,petiole,pitted,poricidal,pubescent,red-papillose,rhachi,shiny,shrub,simple,size,slender,soon,stem,stigma,straight,style,surface,tapering,terminal,thickened,tip,trichome,tube,uniseriate,unit,usually,vein,way,white,whitish,widened,x,young	0.5-1,0.6-1.4,1.3-3,anthesi,appearing,ba,closely,deflexed,deltoid,differing,dry,eaf,edicel,eed,erect,extending,fleshy,free,geminat,gra,incrassate,lamina,lobe,lon,lower,major,middle,minor,nflorescence,often,older,one,overlappin,papillo,parallel,planar,pore,portion,prominent,ruit,scar,shaped,somewhat,spaced,specimen,strongly,tall,tear-drop,tub,ud,widest,woody,ympodial	'',[,``,arrangement,branch,bud,cal,characteristic,colour,corrugation,diameter,distal,drying,exertion,form,fruit,geminate,glabrousnes,gray,growth,height,history,inflorescence,interjected,leaflet,length,life,lobing,midpoint,na,new,number,peduncle,per,plant,prickle,primary,pseudostipule,ray,seed,shape,sympodial,texture,thicknes,type,value,variation,width,{,}
55	wfo-0001026490	invalid_json_followup	272	180	142	130	38	0.522	0.1â0.2,0.1â2.5,0.4â0.8,0.5â1,0.5â1.5,0.5â8,0.8â1.5,0.8â12,1.5â2,1.5â3.5,1.5â5,10â20,1â1.2,1â3,2â2.5,2â4,3,3â4.2,3â4.5,3â5,3â5-pinnate,5â7,7-pinnate,7â15,[,abaxially,absent,acute,adaxially,along,anther,anthesi,apex,axillary,base,brown,calyx,chartaceous,cm,commonly,connivent,corolla,covered,crisped,darker,densely,diameter,distal,distally,ellipsoidal,entire,expanded,extra-axillary,filament,flat,flattened,flower,fruit,fruiting,glabrous,green,immature,incurved,inflorescence,interjected,irregularly,lateral,leaf,leaflet,length,lenticular,light,lobe,long,lower,main,margin,mature,medium,middle,midvein,mm,moderately,mottled,nearly,oblique,oblong,obtuse,obtusely,orange,ovate-lanceolate,papillose,pedicel,peduncle,per,petiole,plurifoliate,pointed,pseudostipule,pubescence,pubescent,punctate,reflexed,revolute,rounded,sand,seed,shape,shoot,short,simple,size,slender,slightly,smooth,sometimes,somewhat,sparsely,spur,stem,stigma,striping,strongly,style,surface,tawny,teardrop-shaped,terminal,tip,trailing,transparent,trichome,truncate,tube,vine,violet,white,woody,yellow,Â½,Ã,â4.5	.5,0.2â1,0.2â1.5,0.3â3.5,0.5â3.5,0.7â3,1.2â8,1.5,1.8â2.2,1.9,1â15,1â2.5,1â8,2,2.5â3.5,2â6,2â8,3â8,4.6,4â4.5,4â5,5-merous,6,7,=,],accrescent,acuminate,ag,alyx,apart,apical,apicall,apparently,around,articulated,axe,ba,becoming,blade,bract,bracteate,branched,broadly,capitat,cauline,ciliate,climbing,completely,contiguously,cordate,cylindrical,decreasing,directed,eaf,eed,eglandular,elliptic,equal,exceeding,free,fused,geminat,ground,lacking,large,latrorse-introrse,lobed,longitudinal,lowermost,lunate,markedly,match,mean,mean=,minute,multicellular,near,nflorescence,node,obliqu,obliquely,oblon,occasionally,one,opening,orolla,ovate,pair,part,pentagonal,perfec,perfect,petiolule,pore,present,pubescen,pur,rachi,radial,reniform,resulting,rooting,ruit,seudostipule,shorter,similar,slit,smaller,spaced,stamen,striation,tamen,tem,thickened,toward,trichomessympodial,typically,unbranched,undulate,unit,vary,vegetation,wide,wing,yellowish-tan,youn,â4,â8,â9.5	'',``,arrangement,bark,branch,bud,capitate,characteristic,colour,corrugation,drying,exertion,form,geminate,glabrousnes,growth,height,history,life,lobing,midpoint,na,new,number,ovary,plant,prickle,primary,ray,texture,thicknes,type,value,variation,vein,width,{,}
56	wfo-0001026491	success	165	129	79	86	50	0.479	.5,1,1.5-2,1.5-2.5,1.5-3.5,1.7,2-3,2.5-3.5,3,3-pinnate,5-6,5-8,6-8,7-8,abaxially,absent,acuminate,acute,adaxially,anther,apex,averaging,base,berry,branched,broadly,cellular-papillose,cm,cuneate,deep,deltoid,densely,diameter,elliptic-lanceolate,entire,filament,globose,green,highly,inflorescence,interjected,lanceolate,lateral,leaf,leaflet,less,light,lobe,margin,middle,minutely,mm,oblong-elliptic,often,ovate,ovate-elliptic,ovoid,pale,pedicel,peduncle,petiole,pilose,pubescent,purple,rounded,shortly,shrub,simple,slender,spotted,stigma,strigose,strong,suborbicular-ovate,surface,terminal,tube,white,x	1-2,10-50,1977,2-4,2-celled,5-merou,abaxiall,alyx,anderson,apparently,appressed,articulated,axe,ba,bayonet,bent,blade,bract,branching,capitat,cellular-pilose,central,connivent,conspicuously,crinkly,deciduous,directed,distall,eaf,eed,equal,first,flower,geminat,glistening,greatly,growing,hair,homostylous,long,lower,lunulat,mean,near,nflorescence,obtuse,orolla,perfect,plurifoliate,point,pore,poricidal,porrect-incurved,present,rachi,rarely,readily,reduced,rotate-pentagonal,rotate-substellate,row,ruit,scandent,seudostipule,sharp,similar,small,straight,strigo,strongly,subacute,tal,tamen,tawny,tem,tightly,tip,tyle,uniseriate,unit,upright,usually,ventral,whitish,yellow,ympodial	appearance,arrangement,bark,border,branch,bud,calyx,capitate,characteristic,colour,corolla,corrugation,distal,distally,drying,exertion,form,fruit,fruiting,giving,glabrousnes,growth,height,history,length,life,lobing,midpoint,na,new,number,ovary,per,perennial,plant,prickle,primary,pseudostipule,ray,seed,shape,size,stem,style,texture,thicknes,type,variation,vein,width
57	wfo-0001026501	success	195	142	117	78	25	0.6	-1.7,.35,.5,.6,.7,/3,0,0-1,0.05-0.3,0.2-1.8,0.27-0.7,0.5-0.6,0.5-0.9,0.5-1,0.6-1,0.6-1.1,0.6-2,0.9-2.2,1-2.5,1.8-2.2,1/4,2-10,2.5-4,2.8-3,3-4,3-9,7-9,?,abaxially,acicular,acute,anther,apart,apex,apically,articulated,bark,base,berry,branched,brown,brown-green,calyx,chartaceous,cm,cuneate,deltate,densely,diameter,dull,elliptic,entire,erect,eye,filament,flattened-reniform,fruit,fruiting,glabrous,gray,green,known,leaf,length,light,long,margin,mauve,mm,moderately,naked,orange-brown,orbicular,ovate,pair,pale,pedicel,peduncle,per,petiole,poricidal,porrect,prickle,prickly,primary,ray,rounded,scandent,shoot,short,shrub,simple,spaced,sparsely,spherical,spreading,stalked,stellate-pubescent,stem,straight,style,surface,tapering,terete,terminal,tip,trichome,tube,unarmed,upper,vein,visible,way,white,wide,yellow,yellow-green	-3,.1,0-2,0.1,0.5,1,1-2,1/2-2/3,1/6-1/2,3-5,3.5-4,4-5,4-7,5-merous,6-9,almost,alyx,apar,apparently,becoming,blade,borne,color,concolorous,curved,discolorous,drying,eaf,eed,elongated,elongating,equal,filiform,filiform-acuminat,flattened,flower,free,glabrou,infructescence,lobe,lobed,longer,lower,mature,midpoint,nflorescence,often,older,one,open,orolla,oung,pendulous,perfec,pericarp,plurifoliat,portion,prickl,reddish,ruit,scar,sessile,shorter,slender,small,smooth,sometimes,somewhat,stalk,stellate,subsessile,tamen,time,unarme,unit,variously,vary,ympodial	arrangement,branch,characteristic,colour,corolla,exertion,filiform-acuminate,form,glabrousnes,growth,height,history,inflorescence,life,lobing,new,number,ovary,plant,seed,shape,size,stigma,texture,type
58	wfo-0001026513	success	138	107	70	68	37	0.507	/3,0.8-2,1-3,2-2.2,2-5,3-5,3-6-flowered,4-5,6-8,7-9,8-16,acute,anther,apex,area,bark,base,berry,calyx,cm,completely,corolla,darkish,decurrent,dia,elliptic,exserted,filament,flower,fruit,fruiting,glabrous,globose,green,lanceolate,lateral,leaf,lobed,long,long-styled,main,minute,mm,ovary,pair,pale,papillose,pedicel,petiole,plant,shaped,shiny,short-styled,shrub,simple,slender,small,soon,stem,stigma,style,surface,tear-drop,tip,treelet,tube,vein,way,white,x	.1,.25,.3,.75,1-1.5,anthesi,apiculate,ba,broadly,caly,closely,deflexed,delicate,deltoid,differentiated,dry,eaf,edicel,eed,erect,except,free,gre,hirsute,immature,known,leave,less,live,lobe,longer,lower,mature,middle,minutely,much,nflorescence,obscure,older,opposite,overlappin,pore,poricidal,portion,prominent,raised,reflexed,rest,ruit,scar,somewhat,spaced,specimen,straight,styl,tall,trichome,ud,undersurface,unifoliat,uniseriate,unit,venation,wide,widest,woody,ympodial,young	0.25,0.75,1,3,arrangement,branch,bud,characteristic,colour,corrugation,diameter,drying,exertion,form,glabrousnes,grey,growth,height,history,inflorescence,length,life,lobing,margin,na,new,number,peduncle,per,perennial,primary,seed,shape,size,texture,type,unifoliate
59	wfo-0001026529	invalid_json_followup	219	195	151	68	44	0.689	0-25,0.3-1,0.5-4.5,1,1-10,1-2,1-3,1-4.5,1.1-2.5,1.5-2.5,1.5-4,10-28,11-14,12-22,120-210,2-7.5,20-60,3-12,3-5,3-9.5,4-8,5-15,5-17,5-9,50-70,6-20,600-950,?,abaxially,acumen,acuminate,adaxially,anther,apart,apex,apparently,articulated,attenuate,axe,axillary,base,berry,blue,brownish,bud,cell,chartaceous,clavate,cm,condition,connivent,cordate,corolla,covering,creamy,dark,deep,densely,diameter,distal,dot,drying,faintly,filament,flat,flower,forked,fresh,fruit,generally,glabrous,gland,glandular,globose,greatly,green,green-white,greenish,hair,hair-like,half,head,herb,interjected,lanceolate,lateral,leaflet,length,lengthening,light,like,lilac,long,longer,make,margin,medium,membranous,mm,moderately,mucilaginous,non-glandular,oblique,odd-pinnate,often,ovoid,pedicel,peduncle,perfect,petiole,plant,pore,poricidal,pubescent,pure,rarely,ripe,rounded,scattered,seed,shape,short,size,slightly,slit,spaced,stem,stigma,style,subtending,terminal,testal,tetralobulate,thick,throughout,tip,trichome,tube,typically,unwinged,usually,varying,wall,wet,white,whitish,wide,wing,x,yellow,yellowish	10,2,2-5,3-6,5-merou,acute,ag,along,alyx,blade,broadly,capitat,ciliate,digestion,dorsally,eaf,edge,eed,elliptic,enzyme,erec,especially,exceeding,except,folded,geminat,glabrou,gree,hal,homostylous,honeycomb-shaped,living,lobe,lower,lunate,midrib,minutely,narrowly,nflorescence,orbicular,orolla,ovate,pair,pentagonal,petiolulate,petiolule,plurifoliate,proximal,puberulent,reduced,removed,ruit,sessile,seudostipule,specimen,stamen,ste,straight,subequal,subsessile,substellate,tall,tamen,tem,tri-,unit,vary,ympodial	'',[,``,age,arrangement,bark,branch,calyx,capitate,character,characteristic,colour,corrugation,erect,exertion,form,glabrousnes,growth,height,history,inflorescence,leaf,life,lobing,midpoint,na,new,number,ovary,per,prickle,primary,pseudostipule,ray,surface,texture,thicknes,type,value,variation,vein,width,{,}
60	wfo-0001026534	success	150	124	71	79	53	0.473	0.5-1,1.5-6,1.5-9,10-20,10-50,15-50,2-2.5,2-7,2.5-15,3-25,3-4,3-5,3.5-4,4-10,5-6,6-35,7-40,acuminate,acute,apex,apiculate,auriculate,basal,base,branched,calyx,chartaceous,cm,connivent,cordate,deltate,densely,diameter,eglandular,ellipsoidal,entire,flattened,flower,fruit,glabrous,glandular,hair,lanceolate,lobe,margin,mm,obtuse,orange,ovate,ovoid,pale,pedicel,peduncle,petiole,pinkish,puberulent,pubescent,purple,red,simple,stigma,style,tip,tree,truncate,tube,unbranched,vein,white,x,yellow	-1.5,1-2,1-2.5,1-3,10-15,2-3,2-8,2.5-4,3-,3-10,4-foliat,4.5-5,7-12,abaxially,absent,adaxially,aggregate,apart,ape,articulated,axe,beyond,blade,bright,cell,connective,cylindrical,darker,directed,distally,eaf,eed,equal,exserted,fleshy,leaving,lemon-yello,lon,long,longitudinal,lower,m.,moderately,narrowly,nflorescence,nther,often,orolla,pedicellar,perfect,pore,presen,puberulen,rachi,radiu,remnant,ruit,shorter,slightly,small,spaced,sparsely,stamen,stellate,stone,stripe,subcoriaceous,tal,tem,thecae,time,tomento,triangular,truncat,ud,unit,vary,wide,ympodial	anther,appearance,arrangement,bark,border,branch,bud,characteristic,colour,corolla,corrugation,distal,drying,exertion,filament,form,fruiting,giving,glabrousnes,growth,height,history,inflorescence,interjected,lateral,leaf,leaflet,length,life,lobing,midpoint,na,new,number,ovary,per,perennial,plant,prickle,primary,pseudostipule,ray,seed,shape,size,stem,surface,terminal,texture,thicknes,type,variation,width
61	wfo-0001026535	success	248	152	126	122	26	0.508	.5,.8,0.7-1.5,1,1-2,1-3,1.2-2,1.3,1.5-3,1/2-2/3,1/3,2-5,2.5,3,3-4.5,5-7,5Â°,7-8,acute,age,almost,along,anther,anthesi,apex,apically,bark,base,becoming,berry,black,brachyblast,branch,branched,branching,broadly,brown,calyx,chartaceous,clavate,clustered,cm,concolorous,condensed,conical,corolla,cuneate,cupular,curved,dark,dendritic,dendritic-pubescent,dense,developed,diameter,dilated,discolorous,distributed,dry,drying,elliptic,elongated,entire,evenly,filament,flower,forming,fruit,fruiting,glabrous,green-brown,leaf,length,liana,like,lobed,long,loop,lower,margin,membranous,midvein,minutely,mm,number,oblong,obovate,older,orange-brown,ovate,ovoid,pair,partly,pedicel,peduncle,petiole,plant,pointed,primary,pubescent,rachi,rarely,ridged,rounded,short,shrub,slender,sparsely,spreading,stem,stigma,style,surface,terminal,trichome,truncate,tube,unarmed,vein,violet,weakly,white,widely,x,yellowish,young	.1,.2,.4,0-0.5,0.1-0.2,0.15,0.2,0.2-0.3,0.2-1.5,0.5-1,1-5,1.5-2,2-3,3-5,3.5-4,4-15,5-10,abaxial,abaxially,absent,accrescent,adaxially,alternate,alyx,apar,apparently,area,around,articulated,clearly,cup,deeply,delineate,delineated,deltoid,detaching,developing,divided,domatia,dorsal,eaf,eed,ellipsoi,equal,except,eye,fertilisation,fine,flat,flexuous,free,frui,increasing,inside,known,leave,lengthening,linear,lobe,lon,loose,m.,main,marginal,minute,mostly,much,naked,network,nflorescence,nther,obscure,orolla,outside,papillo,pendulous,perfec,pericarp,plurifoliat,pore,poricidal,portion,prominent,protruding,raised,ray,reaching,ruit,scar,secondary,see,side,simple,sinus,slightly,smaller,smooth,soon,spaced,stump,tearing,terete,tertiary,thin,tip,tissue,toward,translucent,tufted,two,ud,uneven,unevenly,unit,unlignified,vary,venation,visible,wide,wider,ympodial,youngest	arrangement,bud,characteristic,colour,corrugation,ellipsoid,exertion,form,glabrousnes,growth,height,history,inflorescence,life,lobing,na,new,ovary,papillose,per,perennial,seed,shape,size,texture,type
62	wfo-0001026604	success	192	125	102	90	23	0.531	0,0.1,0.8-0.9,1-1.2,1.1-1.3,1.2-1.7,1.5-2,1.5-9,2-2.3,2.3-3.5,3-3.5,3-5,4.5-7,5,5-7,50-100,<,acuminate,along,anther,apex,bark,base,berry,branching,brown,c.,calyx,capitate,cm,conical,cordate,corolla,dark,diameter,drying,ellipsoid,entire,exserted,filament,flattened,flexuous,flower,fruit,fruiting,glabrous,globose,growth,inflated,later,leaf-opposed,liana,margin,midrib,minute,minutely,mm,narrowly,new,oblique,ovary,ovate,overall,ovoid,pair,pale,pedicel,peduncle,per,petiole,pitted,poricidal,primary,purple,red,reddish,reniform,ripe,shape,shrub,simple,slender,somewhat,stem,stigma,stout,strongly,style,surface,terminal,time,tip,trichome,truncate,tube,uniseriate,vein,vining,violet,way,woody,x	.4,.5,.75,0.4-0.6,0.8-1,10-30,2-2.5,3.5-4,4-4.5,?,absent,age,aid,always,anthesi,apart,appearing,articulated,articulation,atop,basal,brow,cell,clearly,climbing,comical,cucullate,cupped,deflexed,densely,differentiated,distal,distinct,due,eaf,eed,elongate,expanding,free,leaving,lengthening,lobe,lobed,lower,mere,nflorescence,nodding,occasionally,older,outline,papillo,papillose,part,particularly,peg,perfect,pericarp,planar,plurifoliat,poin,point,pore,portion,pubescent,quarter,receptacle-like,rim,ruit,scar,series,shiny,sinuate,slightly,slit,spaced,stellate,structure,support,swolle,testal,thin,tub,twisting,ud,undulation,unit,upper,widely,ympodial,Â½	arrangement,branch,bud,characteristic,colour,corrugation,exertion,form,glabrousnes,height,history,inflorescence,leaf,length,life,lobing,na,number,plant,seed,size,texture,type
63	wfo-0001026607	invalid_json_followup	204	154	108	96	46	0.529	0-3,0.1-0.3,0.3-1.8,0.5-5.8,0.8-3.4,0.8-4.5,1-2,1-3.8,10-30,2-2.5,2.4-5.8,2.5-3.8,2.7-19,4-6,5.8-19.8,6-10,acute,anther,apex,attenuate,axillary,base,basiscopic,berry,brownish,bud,cell,chartaceous,clavate,cm,coarse,condition,connivent,corolla,covering,decurrent,deep,diameter,distal,drying,elliptic,filament,finely,forked,forming,fresh,fruit,generally,glabrous,globose,green,green-white,greenish,hair,half,herb,interjected,lanceolate,lateral,leaf,leaflet,like,lobe,long,make,margin,medium,membranous,mm,moderately,mucilaginous,obtuse,odd-pinnate,ovate,ovoid,pedicel,peduncle,petiole,petiolulate,plant,puberulent,pubescent,ripe,rosette,rounded,seed,sessile,short,side,simple,size,stem,stigma,style,subtending,terminal,testal,thick,throughout,tube,typically,unwinged,usually,violet,wall,wet,whitish,x	0-4,0.8-5,1-10,1-5,1-8,1.5-4,2-10,2-3,3-8,4-10,5,5-merou,abaxially,absent,acumen,adaxially,ag,along,alyx,apart,apparently,articulated,axe,blade,capitat,ciliate,clearly,decreasing,digestion,dorsally,dot,eaf,edge,eed,enzyme,especially,exceeding,flat,flower,folded,geminat,glabrou,greatly,gree,hair-like,hal,high,homostylous,honeycomb,larger,lengthening,living,lower,marked,midrib,minute,minutely,much,nflorescence,often,orbicular,orolla,pair,pentagonal,perfect,plurifoliate,pore,poricidal,present,rachi,rarely,removed,ruit,scattered,semierec,seudostipule,shaped,slit,sometimes,spaced,specimen,stamen,ste,straight,tall,tamen,tem,tip,toward,tri-,unit,vary,white,without,yellow,ympodial	'',0-5,[,\u201chair-like\u201d,``,arrangement,bark,branch,calyx,capitate,characteristic,colour,corrugation,exertion,form,fruiting,glabrousnes,growth,height,history,inflorescence,length,life,lobing,midpoint,na,new,number,ovary,per,prickle,primary,pseudostipule,ray,semierect,shape,surface,texture,thicknes,type,value,variation,vein,width,{,}
64	wfo-0001026613	invalid_json_followup	159	141	91	68	50	0.572	1-2,1.5-4,11-19.5,2-7.5,2.3-8,2.5-2.8,3-5,4-5,4.5-8.5,5,5-6,5-7,6-12,6.2-9.5,8-18,8.5-9,9.5-13.5,abaxially,absent,acuminate,adaxially,anther,apex,apparently,attenuate,axe,axillary,base,berry,bud,chartaceous,cm,conical,connivent,cordate,corolla,densely,diameter,distal,filament,flower,forked,fruit,generally,glabrous,green,hair,half,herb,immature,interjected,lanceolate,lateral,leaf,leaflet,lengthening,like,lobe,long,margin,mature,membranous,minute,mm,mottled,odd-pinnate,ovate,pedicel,peduncle,perfect,petiole,plant,pore,poricidal,pubescent,purple,size,slit,sparsely,stem,stigma,style,subtending,terminal,tip,tube,unknown,unwinged,usually,x,yellow	0.5-1,0.6,1-10,3-10,5-merou,5.5-7,6-8,8.5-10,acumen,ag,along,alyx,apart,articulated,blade,borne,capitat,ciliate,decreasing,dorsally,eaf,edge,eed,end,erec,especially,flat,folded,geminat,greatly,hal,homostylous,larger,lower,m-1.2,middle,midrib,minutely,nflorescence,orolla,pair,petiolule,plurifoliate,proximal,puberulent,pubescen,rotate-pentagonal,ruit,secondary,semierect,seudostipule,singly,spaced,ste,stolo,subequal,symmetrical,tall,tamen,tem,toward,tri-,tuber,typically,unit,unknow,vary,ympodial	'',0.6-1.2,[,``,age,appearance,arrangement,bark,border,branch,calyx,capitate,characteristic,colour,corrugation,drying,exertion,form,fruiting,giving,glabrousnes,growth,height,history,inflorescence,length,life,lobing,midpoint,na,new,number,ovary,per,prickle,primary,pseudostipule,ray,seed,shape,surface,texture,thicknes,type,value,variation,vein,width,{,}
65	wfo-0001026614	invalid_json_followup	200	175	128	72	47	0.64	.8,0.2â0.3,0.4-0.7,0.5,0.5â2,1-,1.3-1.8,15â30,1â2,1â3,1â5,2.2,2.5,2.5â3,20â25,2â4-branched,2â6.5,3â10,4.5â11,4.5â5.5,5,5.3-8.2,50,8â10,9â16,>,abaxially,acuminate,acute,adaxially,anther,apex,armed,articulated,base,berry,black,broad-based,brown,calyx,campanulate,clavate,cm,commonly,cylindrical,dark,developed,diameter,dried,entire,erect,especially,evenly,extra-axillary,filament,flattened-reniform,flower,foveolate,fruit,fruiting,glabrescent,glabrous,gland-tipped,globose,hair,interpetalar,irregularly,lateral,leaf,linear,lobe,lobed,long,margin,midpoint,midvein,minute,minutely,mm,mottled,nearly,oblique,orange,orange-red,ovate,ovoid,pair,pedicel,peduncle,per,petiole,prickle,pubescent,rarely,ray,reflexed,repand,ripe,rotate-pentagonal,rounded,sessile,shallowly,shrub,side,simple,smaller,sometimes,somewhat,soon,sparsely,spreading,stellate-pubescent,stem,stigma,style,surface,tapering,tissue,tube,unarmed,usually,vein,weakly,well,white,x,yellow,yellowish	0.2,1.5â2,11-15,2.2-5.5,2â4,3-foliate,3.2-5.2,4-7,5-merou,6.4-8.4,6â8,7.2-9.8,absent,across,adaxiall,alyx,apart,apparently,axe,ba,blade,blunt-tipped,capitat,chartaceous,closely,concentrated,densely,denser,directed,distally,eaf,eed,expanded,fleshy,geminate,globo,golden,homostylous,internode,lanceolate-attenuate,less,lon,lower,nflorescence,obtuse,often,orolla,ovate-lanceolate,perfect,pore,pubescence,rachi,ruit,scattered,shin,similar,slightly,spaced,stellae,stellate,tall,tamen,tem,time,tissu,ud,unarme,vary,wide,ympodia,young,â5	'',.2,[,``,arrangement,bark,branch,bud,capitate,cayx,characteristic,colour,corolla,corrugation,distal,drying,exertion,form,glabrousnes,growth,height,history,inflorescence,interjected,leaflet,length,life,lobing,na,new,number,ovary,plant,primary,pseudostipule,seed,shape,size,terminal,texture,thicknes,type,value,variation,width,{,}
66	wfo-0001026642	invalid_json_followup	193	134	66	127	68	0.342	0.5,6,annual,anther,anthesi,apex,axillary,base,bipinnate,black,blue,borne,branched,brown,calyx,clavate,cm,dark,diameter,elliptic,equal,filament,flattened,fruit,glabrous,globose,green-purple,hair,herb,lavender,leaf,length,lilac,lobe,long,mm,multicellular,number,oblong,obtuse,ovate,pale,pedicel,peduncle,perennial,petiole,pinnate,pitted,primary,pubescent,shallowly,shoot,simple,sparsely,stigma,style,subglabrous,surface,time,tube,unicellular,uniseriate,vein,violet,woody,x	.05,.1,.8,0.1,0.1â0.3,0.2,0.25,0.4,0.4â2.2,0.5â,0.5â0.7,0.5â1.7,0.5â2.0,0.5â3.5,0.6,0.6â1.0,0.75â1.0,0.75â2.0,0.7â1.6,0.8â1.2,1.0,1.0â2.0,1.2â1.7,1.2â2.0,1.2â3.5,1.2â6.2,1.6â8.0,1.9â3.0,12â30,1â10,1â3,2.0â4.0,2.5â3.5,2.5â4.0,2.8â3.0,3.0â5.1,3â5,4.0â6.0,4â7,5,5.0â7.0,50â100,<,abaxial,abaxially,acute,adaxiall,adaxially,ag,along,apart,appressed,articulated,axe,ba,blade,cell,chartaceous,circular,connivent,cylindrical,decreasing,decumbent,densely,denser,divided,eaf,eed,either,erect,fleshy,flower,geminat,glabrescen,gland,glandular,half,indumentum,lon,longitudinal,lower,m.,moderately,narrow,nflorescence,occasionally,often,opening,orolla,pair,pentagonal,perfect,pinnae,pore,poricidal,present,probably,rapidly,rounded,ruit,secondary,sessile,side,slit,sometimes,spaced,stone,straight,tal,tamen,tem,tip,unifoliate,unit,usually,vary,white,wide,wing,yellow,ympodial,â1.2,â11.0,â2.0,â4.5,â6,â7	'',0.4-2.2,0.5-3.5,0.5-6.2,0.5-8.0,0.75-1.0,0.75-2.0,0.8-1.2,1-3,1.2-1.7,1.2-3.5,2.8-3.0,3.0-5.1,4-7,4.0-6.0,5.0-7.0,50-100,[,``,appearance,arrangement,bark,branch,bud,characteristic,colour,corolla,corrugation,distal,drying,exertion,form,fruiting,giving,glabrescent,glabrousnes,growth,height,history,inflorescence,interjected,lateral,leaflet,life,lobing,margin,midpoint,na,new,ovary,per,plant,prickle,pseudostipule,ray,seed,shape,size,stem,terminal,texture,thicknes,type,value,variation,width,{,}
67	wfo-0001026651	success	222	131	79	143	52	0.356	1.8,acuminate,acute,anther,apex,articulated,attenuate,base,beneath,berry,beyond,branch,brochidodromous,brownish-green,calyx,capitate,chartaceous,ciliate,cm,dark,densely,diameter,drying,dull,entire,exserted,filament,flattened,flower,fruit,glabrescent,glabrous,globose,green,herb,lanceolate,lateral,leaf,length,light,lobe,margin,mm,moderate,much-branched,narrowly-elliptic,new,oblong-ellipsoid,ovate-deltate,ovate-reniform,pedicel,peduncle,pedunculate,per,petiole,plant,pubescent,revolute,ripe,rounded,seed,shape,shrub,simple,size,slightly,sometimes,stamen,stem,stigma,style,sub-opposite,surface,terminal,translucent,undulate,vein,white,Ã	-celled,0.2â1.3,0.35â2.6,0.9â3,1,1â2,2.2â10,2.8,2â11.5,2â13,2â3,2â3.3,2â4,2â4.5,2â8,3,3-plurifoliate,3â5,3â7,4,4â6,4â7.8,5-merou,6â10,6â14,8,abaxially,absent,accrescent,adaxiall,adaxially,along,alyx,anisophyllous,antror,antrorse,antrorsely,apar,appressed,arcuate,ark,asymmetric,axi,broadly,brown,capitat,cell,circular,connivent,cordate,cylindrical,cyme,decumbent,decurrent,differing,directed,discolorous,eaf,eed,elliptic,emarginate,equal,erect,exfoliating,eye,flexuous,frui,geminate,geniculate,glabrou,glandular,growt,hair,head,highly,hilum,hollow,impressed,introrsely,less,like,long,longitudinal,lower,lying,major,markedly,matte,membranaceous,midrib,minor,moderately,mostly,multicellular,naked,nflorescence,normally,obtuse,older,one,onto,opening,orolla,ovate-lanceolate,parallel,perfect,pore,poricidal,prominent,pubescence,reduce,region,ruit,secondary,shiny,similar,single-celled,slit,small,smaller,spaced,stalk,stellate,straight,subapical,tall,tamen,tem,trichome,turning,unbranched,uniseriate,unit,upper,usually,vary,venation,visible,wide,woody,yellow,ympodial,young	0.9-3,1-2,2-11.5,2-13,2-3,2-3.3,2-4,2-4.5,2-8,2.2-10,3-5,4-6,4-7.8,6-10,6-14,appearance,arrangement,bark,border,bud,characteristic,colour,corolla,corrugation,distal,exertion,form,fruiting,giving,glabrousnes,growth,height,history,inflorescence,interjected,leaflet,life,lobing,midpoint,na,number,ovary,prickle,primary,pseudostipule,ray,texture,thicknes,tube,type,variation,width
68	wfo-0001026656	invalid_json_followup	211	143	94	117	49	0.445	0-4,0.3-3,0.3-4.2,0.4-6.5,0.7-10.5,0.9-13,1-1.8,1-10,1-2,1-3.8,1.1-8.1,2-6,2.5-17,20-60,4-8,5-35,5.5-27,9-11,acuminate,acute,anther,apex,attenuate,base,blue,borne,broadly,brownish,bud,capitate,chartaceous,cm,condition,corolla,cuneate,dark,densely,diameter,distal,dot,drying,elliptic,filament,forked,fresh,fruit,generally,glabrous,globose,green,greenish,hair,half,herb,interjected,lanceolate,lateral,leaflet,light,like,lobe,long,margin,membranous,mm,moderately,mottled,narrowly,oblique,odd-pinnate,ovate,ovoid,pedicel,peduncle,petiole,plant,pubescent,purple,scattered,seed,stem,stigma,style,subglabrous,subtending,symmetrical,terminal,truncate,tube,unwinged,violet,white,whitish,wide	1,1-4,1-5,1.5-7,10,2-8,4-10,4-13,5,5-18,5-merou,abaxially,absent,acumen,adaxially,ag,along,alyx,apart,articulated,bearing,blade,cell,ciliate,clavat,connate,connivent,covering,curved,decurrent,digestion,dorsally,eaf,edge,eed,end,enzyme,erec,especially,exceeding,flat,flower,folded,geminat,glaucous,greatly,green-white,greenish-yellow,hair-like,homostylous,honeycomb-shaped,larger,lengthening,living,lower,lunate,make,middl,midvein,minutely,mucilaginous,nflorescence,non-glandular,occasionally,often,orolla,pair,pentagonal,petiolulate,petiolule,plurifoliate,pore,poricidal,puberulent,pubescen,rachi,ranging,removed,rotate-pentagonal,ruit,scale-like,seudostipule,short,singly,slightly,slit,sometimes,somewhat,spaced,specimen,stamen,star,ste,stolo,straight,subequal,tall,tamen,tem,tertiary,testal,therefore,thick,throughout,tinged,tip,tri-,tuber,typically,unit,vary,wall,wet,wing,without,yellow,ympodial	'',[,``,appearance,arrangement,bark,border,branch,calyx,characteristic,clavate,colour,corrugation,exertion,form,fruiting,giving,glabrousnes,growth,height,history,inflorescence,leaf,length,life,lobing,midpoint,na,new,number,ovary,per,prickle,primary,pseudostipule,ray,shape,size,surface,texture,thicknes,type,value,variation,vein,width,winged,{,}
69	wfo-0001026663	success	251	148	121	130	27	0.482	-2.9,-9.7,/3,0-160,1,1-3.2,1-5,1.1,1.1-2.1,1.2-2,1.6-2.3,1.9-2.6,10-26,12-14,2-12,2.1-2.6,2.8-5.3,24-45,31,4.7-25.9,5.5-8.8,abaxially,acuminate,adaxially,along,angled,anther,anthesi,apex,attenuate,bark,base,becoming,berry,blunt-tipped,branch,branched,brown,bud,calyx,cm,conical,corolla,dark,densely,diameter,distributed,drying,echinoid,echinoid-pubescent,elongated,entire,exserted,filament,fleshy,flower,free,fruit,glabrescent,glabrous,globose,granular,green,greenish-brown,grooved,hair,immature,lanceolate,leaf,length,less,light,long,long-stalked,longitudinally,many,margin,midrib,mm,multangulate,obtuse,ovate-lanceolate,pale,pedicel,peduncle,petiole,poricidal,porrect-stellate,pubescent,rich,scabrous,sessile,short,short-stalked,shrub,side,simple,small,soon,spaced,sparsely,stem,stigma,strongly,style,subglobose,terete,time,tip,tomentose,touching,tree,tube,unarmed,vein,violet,way,white,whitish,x,yellow	-15,-8,.5-2.5,/25-1/15,0.2-0.6,0.3-0.8,0.4-2.2,0.9-1.5,1-2.5,1.4-2.6,1.4-3.1,1/2,1/3,1/4-1/2,10.3-13.2,2.5-3.7,2.9-5,2/3,3-5,3.5-5,3.8-5.7,4.5-5.7,5-8,5.5-,7.5-9,8-17,accrescent,acute,adaxiall,ag,apart,apparently,appressed,around,articulated,ascending,axe,axillary,blade,broadly,capitat,chartaceous,closely,completely,constricted,covering,cylindrical,directed,distally,eaf,echinoi,edge,eed,enveloping,especially,evident,farinose,flared,fruiting,glabrescen,granular-tomentose,inserted,lateral,lengthening,line,lined,lobe,lobed,long-stalke,longer,longitudinal,lower,m.,main,matur,midvein,minute,multangulate-pubescent,nearly,nflorescence,occasional,occuring,older,opening,openly,orolla,ovate,ovate-lanceolat,perfect,persistent,plurifoliate,pore,present,pseudo-terminal,pubescence,rachi,rather,ray,ridged,robust,ruit,runk,slightly,slit,sometimes,somewhat,stalk,stalked,stamen,stellate,subcampanulate,subcoriaceous,subglabrous,suture,tall,tamen,tangled,thick,thin,tomentose-pubescent,tomentum,ud,unarme,unit,upper,usually,vary,wide,ympodial,young	5.5-9,arrangement,capitate,characteristic,colour,exertion,form,glabrousnes,growth,height,history,inflorescence,life,lobing,na,new,ovary,perennial,plant,primary,pseud-terminal,seed,shape,size,surface,texture,type
70	wfo-0001026686	success	196	130	88	108	42	0.449	.4,0.6-0.9,1-2,1-2.5,1.2-3.4,1.5-7,1.7-2.5,10-28,2-10,2.4-3.6,2.5-8,3-4,3.7-8,4-6,5,5-16.5,5-8,7-9,8-27,acuminate,anther,apex,articulated,axillary,base,berry,brownish,bud,chartaceous,cm,condition,conical,connivent,corolla,densely,diameter,distal,drying,elliptic-lanceolate,filament,forked,fresh,fruit,generally,glabrous,green,green-white,greenish,half,herb,interjected,lanceolate,lateral,leaf,leaflet,light,lobe,long,margin,middle,minute,mm,mucilaginous,obtuse,odd-pinnate,ovoid,pedicel,peduncle,petiole,plant,pubescent,purple-violet,ripe,round,seed,size,sparsely,stigma,style,subtending,terminal,throughout,tube,usually,wet,whitish,wide,x	0.2-0.5,1,1-10,1.2-3.6,2-9,3-5,5-merou,6.5-12.7,8-10,8-14,abaxially,absent,acumen,adaxially,ag,along,alyx,apart,apparently,axe,blade,borne,capitat,cell,ciliate,covering,decreasing,digestion,dorsally,eaf,edge,eed,end,enzyme,equal,erec,especially,exceeding,flat,flower,folded,geminat,glabrou,gradually,hair,hair-like,homostylous,honeycomb-shaped,larger,lengthening,like,living,lower,make,midrib,minutely,mottled,nflorescence,often,orbicular,orolla,ovate,pair,perfect,petiolule,plurifoliate,pore,poricidal,puberulent,pubescen,purple,removed,rotate-stellate,ruit,secondary,semierect,seudostipule,singly,slightly,slit,spaced,specimen,stamen,star,ste,stolo,straight,stripe,subequal,subsessile,symmetrical,tall,tamen,tem,testal,thick,tip,toward,tri-,tuber,typically,unit,vary,wall,white,wing,yellow,ympodial	appearance,arrangement,bark,border,branch,calyx,capitate,characteristic,colour,corrugation,exertion,form,fruiting,giving,glabrousnes,growth,height,history,inflorescence,length,life,lobing,midpoint,na,new,number,ovary,per,prickle,primary,pseudostipule,ray,shape,stem,surface,texture,thicknes,type,variation,vein,width,Â¼
71	wfo-0001026696	success	139	118	68	71	50	0.489	0.3-4.5,0.8-7,0.9-7.2,1,1-1.3,1-4,1.3-2.1,2-17,3-17,3-3.5,4-16,9,abaxially,acute,adaxially,apex,articulate,base,branched,broadly,calyx,cm,corolla,cuneate,cyme,decurrent,densely,diameter,dichasial,dichasially,distal,ebracteate,entire,filament,globose,green,green-white,herbaceous,lanceolate,lateral,light,linear,lobe,long,margin,mm,monochasial,mucilaginous,oblong,obtuse,odd-pinnate,often,ovate,ovoid,pedicel,peduncle,perennial,petiole,plant,pubescent,rounded,seed,sinuate,stigma,style,throughout,white-cream,wide	1.5-3,2-3,3-6,3-6-foliat,3-8.5,5-35,acumen,apical,apically,apiculate,cell,connate,covering,dehiscent,digestion,dorsally,eaf,edge,eed,emoval,enzyme,exceeding,flat,flower,folded,forked,generally,globo,hair-like,half,honeycomb,introrse,light-yello,living,lon,lower,lunat,make,maturing,nflorescence,nther,orolla,pattern,perfect,plan,poricidally,proximal,reveal,ruit,seudostipule,short,simple,slit,specimen,stamen,stellate,straight,tal,tem,testal,thick,throughou,tuber-bearing,typically,unit,vary,wall,without,yellow,ympodial,Â¼	anther,appearance,arrangement,bark,border,branch,bud,characteristic,colour,corrugation,drying,exertion,form,fruit,fruiting,giving,glabrousnes,growth,height,history,inflorescence,interjected,leaf,leaflet,length,life,light-yellow,lobing,midpoint,na,new,number,ovary,per,prickle,primary,pseudostipule,ray,shape,size,stem,surface,terminal,texture,thicknes,tube,type,variation,vein,width
72	wfo-0001026706	success	232	128	102	130	26	0.44	0-240,0.8-1.2,0.9-2,1-2.2,1-5,1.5-3,10-15,12,14-32,2.5-3,2.7-4,3.1-3.8,4,4.2-12,4.5-5.5,5.3-6.4,6-10,abaxially,acute,adaxially,anther,apex,appearing,attenuate,bark,base,berry,blunt-tipped,branch,branched,brown,bud,calyx,cm,corolla,crisped,cuneate,dark,diameter,entire,exserted,filament,fleshy,flower,fruit,glabrate,globose,golden,grayish,green,herbarium,lanceolate,lateral,leaf,length,main,many,margin,midrib,mm,oblong,obtuse,occasionally,ovate,ovate-elliptic,ovate-lanceolate,pale,pedicel,peduncle,petiole,reddish,reticulate-punctate,shrub,side,simple,slightly,small,softly,soon,specimen,stem,stigma,strongly,style,subconical,subglobose,suborbicular,sulcate,surface,tall,time,tomentose-pubescent,tree,unarmed,vein,velutinous,wavy,white,whitish,x,yellow,yellowish-tan	-3.1,-4.4,-5.5,-6.1,.5,/14-1/6,0.2-0.3,0.2-0.5,0.6-2.2,0.8-1.5,0.8-2.8,0.9-1.9,1.1-4,1/2-2/3,2.2-3.3,2.3-3.8,2.9-6,2/3-3/4,3-4.6,3.6-5.7,5-6.5,6-8,6.1-,7-16,8-14,9.8-15.4,accrescent,adaxiall,ag,anthesi,apart,apparently,around,articulated,axe,axillary,ba,becoming,blade,capitat,chartaceous,closely,completely,coriaceous,covering,cylindrical,dendritic-echinoid,dendritic-multangulate,densely,directed,distally,eaf,edge,eed,enveloping,farinose,fourth,free,fruiting,furfuraceou,glabrous,hair,indument,inserted,lackin,lacking,lengthening,lobe,lobed,long,long-stalked,longitudinal,lower,m.,matted,minute,mixed,multangulat,multangulate,nearly,nflorescence,obscured,often,older,orolla,perfect,persistent,plurifoliate,pore,poricidal,porrect-stellate,pseudo-terminal,pubescence,pubescent,rachi,rather,ruit,runk,semi-ovate,sessile,short-,short-stalked,slit,somewhat,spaced,sparsely,splitting,stalked,stamen,stellate,subcampanulate,suture,tamen,thin-walled,tip,tomentu,touching,translucent,transparent,tube,ud,unarme,unevenly,unit,upper,vary,way,wide,ympodial,young	6.1-15.4,arrangement,capitate,characteristic,colour,exertion,form,glabrousnes,growth,height,history,inflorescence,life,lobing,new,ovary,perennial,plant,primary,pseudoterminally,seed,shape,size,texture,trunk,type
73	wfo-0001026707	invalid_json_followup	196	154	109	87	45	0.556	-5,.5,.8,/3,0,0-20,0.05-0.15,0.3-0.8,0.5-1,0.5-3,0.6-0.7,0.6-0.8,0.7-1,0.7-1.4,1-1.7,1.5-1.8,1.6-2,1/3,11-16,2-2.3,2.5-6,3-4,3-4.5,3-7,4,5-25,8-15,?,abaxially,acute,anther,apex,apically,apparently,articulated,attenuate,bark,base,berry,branched,broad-deltate,calyx,chartaceous,clustered,cm,concolorous,densely,diameter,discolorous,drying,entire,erect,filament,flattened-reniform,fruit,fruiting,glabrous,gray,green,lateral,leaf,length,long,margin,mauve,midpoint,mm,moderately,narrow-deltate,narrow-oblong,obtuse,orange-brown,pedicel,peduncle,per,petiole,poricidal,porrect,prickle,prickly,pubescent,ray,red-brown,rounded,shrub,small,sometimes,sparsely,spherical,stalked,stellate-pubescent,stem,straight,style,surface,tapering,terete,terminal,tip,tree,trichome,tube,unarmed,upper,way,weakly,white,wide,yellow-green	-1/3,-3,0.05,0.1-0.2,0.7-1.5,1-3,1-5,1/3-1/2,1/3-3/4,1/4-1/3,1/8-1/4,2-10,2-6,2.5-3,2.5-4,3-8,5-10,5-7,5-8,5-merous,alyx,apar,apart,blade,branche,broadly,color,connivent,curved,cuspidat,decurrent,eaf,eed,elongating,equal,eye,flower,foliaceous,free,fused,gently,glabrescent,glabrou,inflated,infructescence,juvenil,known,less,lobe,lobed,longer,lower,mature,naked,nflorescence,older,one,open,orolla,oung,perfec,pericarp,plurifoliat,porrect-lepidote,portion,reflexed,ruit,scar,sessile,shorter,simple,slender,smooth,spaced,spreading,stalk,stellate,stout,tamen,time,unit,variously,vary,venation,visible,ympodial,Â¼	'',[,``,arrangement,branch,bud,characteristic,colour,corolla,corrugation,cuspidate,distal,exertion,form,glabrousnes,growth,height,history,inflorescence,interjected,juvenile,leaflet,life,lobing,na,new,number,ovary,perennial,plant,primary,pseudostipule,seed,shape,size,stigma,texture,thicknes,type,value,variation,vein,width,{,}
74	wfo-0001026711	invalid_json_followup	210	195	151	59	44	0.719	-5,-6,-7,.8,0,0-0.2,0-25,0-4,0-6,0.15,0.2-0.3,0.3-1,0.5-1.5,0.7-,0.7-0.9,0.7-1.4,0.75-1,0.8-2.2,0.9-1.1,0.9-1.5,1-,1-2,1.5-2.2,1.7-4,1/2-2/3,1/3,1/4,2-2.2,2-3.5,2-4,2-6,2.1-2.5,3-4,3-4.5,3-5,3-7,3.5-5.2,4-8,4.5-7,7-8,abaxially,acute,ame,anther,apex,apically,apparently,articulated,bark,base,berry,branched,c.,calyx,cell,cm,concolorous,connivent,cuneate,curved,deltate,densely,diameter,discolorous,distance,drying,dull,elliptic,erect,evenly,extending,filament,flattened-reniform,flower,fruit,fruiting,glabrous,green,infructescence,lateral,leaf,length,lobe,lobed,long,lower,margin,maturity,mauve,midpoint,midvein,mm,narrow-deltate,obtuse,occasionally,one,open,orange,orange-brown,outline,pair,pale,pedicel,peduncle,per,petiole,pit,poricidal,porrect,prickle,prickly,primary,purple,raised,ray,red,reduced,rounded,shallowly,shrub,side,slender,small,smooth,sometimes,spherical,spreading,stalk,stalked,stellate,stellate-pubescent,stem,style,surface,tapering,terminal,time,tip,trichome,tube,unarmed,uniform,upper,variously,vein,way,weakly,wide,yellow,yellow-green,young	-15,-2,.2,.5,0.1,0.8,1-30,1.5-,1/,1/4-1/3,2-2.5,5-merous,acicular,acuminat,alyx,apar,apart,blade,brow,difoliate,eaf,eed,elongating,equal,faint,free,geminat,less,longer,mature,moderately,nflorescence,older,orolla,oung,pendulous,perfec,pericarp,perpendicular,portion,prickl,reflexed,ruit,scar,sessile,shorter,somewhat,spaced,straight,tamen,terete,tertiary,thick-chartaceous,unit,vary,venation,visible,woody,ympodial	'',0.7-1.1,[,``,acuminate,arrangement,branch,brown,bud,characteristic,colour,corolla,corrugation,distal,exertion,form,glabrousnes,growth,height,history,inflorescence,interjected,leaflet,life,lobing,na,new,number,ovary,perennial,plant,pseudostipule,seed,shape,size,stigma,texture,thicknes,type,value,variation,width,{,}
75	wfo-0001026717	invalid_json_followup	207	156	111	96	45	0.536	0.3-0.6,0.6-1.5,0.8,1-2,1-2.5,1.3-2.5,1.4-2.2,1.8-3,13-28,14-22,2.5-4.5,2.5-5.5,3-4,3-6,3.3-11,4-6,4-8,4-9,5,5-11,5-13.5,5.3-9,7-11,abaxially,acuminate,adaxially,anther,apex,attenuate,axillary,base,berry,brownish,bud,cell,chartaceous,cm,condition,conical,corolla,covering,dark,diameter,distal,drying,filament,flat,flower,forked,fresh,fruit,generally,glabrous,green,green-white,greenish,hair,half,herb,interjected,lanceolate,lateral,leaf,leaflet,light,like,lobe,long,make,margin,medium,membranous,minute,mm,mottled,mucilaginous,narrow,obtuse,odd-pinnate,orbicular,ovate,ovoid,pedicel,peduncle,petiole,plant,pubescent,purple,ripe,round,seed,sessile,size,sparsely,stigma,straight,style,subtending,terminal,testal,thick,throughout,tube,usually,violet,wall,wet,whitish,wide,wing,x	0.3-2.5,0.3-5,1-10,1-3,15-34,2.2-5,3-5,5-6,5-merou,acumen,ag,along,alyx,apart,apparently,articulated,axe,blade,borne,capitat,ciliate,connivent,darker,decreasing,decurrent,digestion,dorsally,eaf,edge,eed,elliptic,end,enzyme,equal,erec,especially,exceeding,folded,geminat,glabrou,gradually,hair-like,homostylous,honeycomb-shaped,larger,lengthening,living,lower,middle,midrib,minutely,nflorescence,often,one-quarte,orolla,pair,pentagonal,perfect,petiolule,plurifoliate,pore,poricidal,present,puberulent,pubescen,removed,rotate,ruit,secondary,semierect,seudostipule,singly,slightly,slit,spaced,specimen,stamen,ste,stolo,stripe,subequal,subglabrous,subsessile,symmetrical,tall,tamen,tem,tip,toward,tri-,tuber,typically,unit,vary,yellow,ympodial	'',[,\u201chair-like\u201d,``,arrangement,bark,branch,calyx,capitate,characteristic,colour,corrugation,exertion,form,fruiting,glabrousnes,growth,height,history,inflorescence,length,life,lobing,midpoint,na,new,number,ovary,per,prickle,primary,pseudostipule,ray,shape,stem,surface,texture,thicknes,type,value,variation,vein,width,{,}
76	wfo-0001026725	invalid_json_followup	166	142	92	74	50	0.554	.3,.5,/4,0.2,0.7-1.2,1-1.2,1-1.5,1-4.5,1-5,1.2-1.7,1.6-2,2,3.6-7.7,5-20-flowered,5-6,8-18.6,acute,anther,apex,bark,base,beneath,berry,black,bluish,broadly,calyx,capitate,cm,corolla,cup-shaped,dark,dia,drying,ellipsoid,elliptic,extremely,filament,flattened-reniform,fruit,fruiting,glabrous,glandular-papillose,globose,green,greenish-white,large,lateral,leaf,less,lobe,lobed,long,margin,minutely,mm,onto,ovary,ovate,ovoid,paler,papillose,pedicel,petiole,pitted,planar,pubescent,reddish-brown,reflexed,rounded,shaped,short,shrub,simple,size,slender,slightly,stem,stigma,stretching,style,subshrub,surface,tapering,tear-drop,tube,vein,way,white,winged,woody,x	1.5,1.5-2,1/2,2.2-4,3.5-4,5-5.5,8-9,accrescent,anthesi,apart,attenuate,axil,becoming,brownish-papillose,character,crackin,deflexed,differing,difoliate,dry,eaf,edicel,eed,evenly,free,geminat,geographically,incrassate,inflorescenc,interpetalar,lon,lower,main,major,margine,material,middle,minor,nflorescence,occasionally,often,older,one,open,opposite,pair,pale,papillo,pore,poricidal,portion,prominent,proximal,ruit,scar,scarious,sinus,spaced,split,straight,tall,tan,tip,triangular,trichome,tuft,ud,uniseriate,unit,upper,varying,widest,ympodial,young	'',[,``,alternate,appearance,arrangement,border,branch,bud,characteristic,colour,corrugation,cracking,diameter,distal,exertion,form,giving,glabrousnes,growth,height,history,inflorescence,interjected,leaflet,length,life,lobing,midpoint,na,new,number,peduncle,per,plant,prickle,primary,pseudostipule,ray,seed,shape,terminal,texture,thicknes,type,value,variation,width,{,}
77	wfo-0001026733	invalid_json_followup	188	156	97	91	59	0.516	0.3-2,0.5-2,1-3,1-7,1.5-14,10-20,15-,2-2.5,2.5-7.5,20-50,25-40,3-15,3-3.5,4,4-23,4-5,5-8,abaxially,acuminate,acute,acute-acuminate,adaxially,apex,axe,basal,base,calyx,chartaceous,cm,color,connivent,cordate,curled,deltate,dense,densely,diameter,eglandular-pubescent,ellipsoidal,elliptic-ovate,entire,flattened,flower,forked,fruit,fusiform,glabrate,glabrous,gland-tipped,glandular-,glandular-puberulent,green,greyish,hair,hirsute,immature,lanceolate,lobe,long,longitudinal,margin,mm,moderately,narrowly,oblique,ovate,ovoid,pedicel,peduncle,perfect,petiole,pilose,pubescent-pilose,ripe,round,shining,simple,smooth,sometimes,stigma,stripe,style,submarginally,tree,triangular,truncate,tube,unbranched,unknown,vein,villous,white,white-puberulent,wide,x,yellow,yellowish	-1,-11,-13,-14,-15,-2,-4,-7,-8,.5-3,0.3-0.5,0.5,0.5-1,0.5-4,1,1-1.5,1-2,1.5-2,1.5-2.5,2-3,2-4,2-6,3-4-foliat,3-7,4.5-5,7-10,8-12,aggregate,apart,ape,articulated,beyond,blade,capitat,cell,ciliat,connective,cylindrical,dia,directed,distally,eaf,eed,eglandular-pilose,eglandular-villous,equal,especially,exceeding,exserted,glandula,glandular-tomentose,leaving,linear-triangular,lon,lower,membranaceous,midrib,near,nflorescence,nther,orolla,ovum,pedicellar,pore,present,pubescent,pubescent-pilo,rachi,radiu,remnant,ruit,shorter,slightly,small,spaced,sparsely,stamen,stellate,stone,swelling,tal,tem,thecae,time,toward,ud,unit,unknow,usually,vary,ympodial	'',[,``,anther,arrangement,bark,branch,bud,capitate,characteristic,colour,corolla,corrugation,distal,drying,exertion,filament,form,fruiting,glabrousnes,glandular,growth,height,history,inflorescence,interjected,lateral,leaf,leaflet,length,life,lobing,midpoint,na,new,number,oval,ovary,per,perennial,plant,prickle,primary,pseudostipule,ray,seed,shape,size,stem,surface,terminal,texture,thicknes,type,value,variation,width,{,}
78	wfo-0001026734	invalid_json_followup	266	161	110	156	51	0.414	0.3,0.5,0.6,1,3,abaxial,absent,acuminate,anther,anthesi,apex,base,becoming,berry,branch,branched,bright,broadly,brown,calyx,camptodromous,chartaceous,clavate,cm,congested,corolla,cuneate,cylindrical,cyme,dark,densely,diameter,discolorous,distally,drying,elliptic,emergent,entire,flattened,flower,fruit,glabrescent,glabrous,globose,green,growth,immature,internodal,irregular,lanceolate,lateral,leaf,length,less,lobe,lobed,long,long-attenuate,margin,mature,maturity,membranaceous,midpoint,mm,moderately,much,narrow,new,oblong,observed,obtuse,ovary,pale,pedicel,peduncle,petiole,pit,plane,porrect-stellate,pubescent,purple,purplish,ray,reniform,scandent,sessile,shape,short-stalked,shrub,simple,size,slightly,sometimes,sparsely,spreading,stem,stigma,style,subopposite,subsessile,surface,terminal,trichome,tube,unbranched,vein,white,wide,yellowish,Â¾	0.1,0.2,0.7â0.9,0.7â1,0.8â1,1.6â2,1.6â2.5,1.8â2.2,1.8â3,1/4,1â1.2,1â3,2.2â7,2.3â5,2.5â3,2â2.4,2â3,3.2â3.8,3â4,3â4-celled,3â8,4â6,4â7,4â8,4â9,5-merou,5â9,8,abaxially,accrescent,acute,adaxial,adaxiall,adaxially,ag,also,always,alyx,apical,apice,archin,ark,articulated,associated,asymmetric,axi,barely,beneat,beneath,blade,caly,capitate,celled,central,closely,commonly,connivent,covered,covering,dense,denser,differing,directed,downward,dried,due,eaf,eed,eglandular,erect,f.,fewer,flat,foliate,forked,found,free,frequently,geminate,glabrescen,glandular,gray,hair,held,ilament,initially,introrsely,j,lamina,large,longer,longitudinal,lower,lying,material,maturit,midri,minute,mostly,multiseriate,near,nflorescence,normally,obovate,often,old,older,one,one-celled,opening,orolla,other,oung,ovate,pair,paired,papillose,perfect,pointing,pore,poricidal,porrect,portion,pubescence,rachi,raised,rarely,rayed,reaching,rounded,ruit,secondary,shiny,shorter,slit,smaller,spaced,sparse,spread,stalk,stellate,still,surfac,tuft,ud,unequal,uniseriate,unit,upward,vary,venation,vestiture,visible,whole,yellow,ympodial	'',0.7-0.9,0.8-1,1-3,1.6-2,1.8-3,2-2.4,2-3,2.2-7,2.3-5,2.5-3,3-8,5-9,[,``,arrangement,bark,bud,characteristic,colour,corrugation,distal,exertion,filament,form,fruiting,glabrousnes,height,history,inflorescence,interjected,leaflet,life,lobing,midrib,na,number,per,plant,prickle,primary,pseudostipule,seed,texture,thicknes,type,value,variation,width,{,}
79	wfo-0001026740	success	171	135	85	86	50	0.497	0-10,0.5-1,1-5,10-20,10-30,2-3,2.5-27,2.5-4.5,2.5-6,20-50,3-15,3-3.5,4-5,4.5-10,6-10,abaxially,acuminate,acute,adaxially,also,apex,apiculate,basal,base,branched,calyx,cm,connivent,cordate,corky,curled,darker,deltate,densely,diameter,eglandular,ellipsoidal,elliptic,entire,flattened,fleshy,flower,fruit,glabrate,glabrous,glandular-puberulent,greenish,hair,immature,lanceolate,lobe,long,margin,mature,mm,moderately,oblong,obtuse,often,ovate,ovoid,pedicel,peduncle,petiole,pilose,present,puberulent,purple,reticulate,simple,sparsely,stigma,stripe,style,tree,truncate,tube,unbranched,vein,violet,white-puberulent,whitish,woody,x,yellow	-17,-2,1-10,1-12,1-2,1-3,1-4,2-4,2.5-3,3-5,3-foliat,3.5-40,5-40,5-8,8-19,absen,absent,acute-acuminate,aggregate,apart,ape,articulated,axe,beyond,blade,browni,cell,ciliate,connective,cylindrical,directed,distally,eaf,eed,equal,especially,exceeding,exserted,leaving,lon,lower,narrowly,near,nearly,nflorescence,nther,orange,orolla,pedicellar,perfect,pilo,pore,pubescent,rachi,radiu,rarely,remnant,ruit,scar,sessile,shorter,slightly,small,sometimes,spaced,stamen,stellate,stone,subcoriaceous,swelling,tal,tems,thecae,time,tomentose,toward,triangular,truncat,ud,unit,unlobed,vary,villous,wide,ympodial,young	anther,appearance,arrangement,bark,border,branch,bud,characteristic,colour,corolla,corrugation,distal,drying,filament,form,giving,glabrousnes,growth,height,history,inflorescence,interjected,lateral,leaf,leaflet,length,life,lobing,midpoint,na,new,number,ovary,per,perennial,plant,prickle,pseudostipule,ray,seed,shape,size,stem,surface,terminal,texture,thicknes,type,variation,width
80	wfo-0001026752	success	169	134	80	89	54	0.473	-25,-4,1,1-12,1-5,1-6,1.5-2.5,10-20,2-2.5,2.5-20,2.5-5,3.5-4,4-45,4-5,abaxially,abruptly,acute,adaxially,apex,apiculate,basal,base,black,branched,calyx,chartaceous,cm,cordate,cuneate,darker,deltate,densely,diameter,ellipsoidal,elliptic-oblong,elliptic-ovate,entire,flattened,fleshy,forked,fruit,glabrous,globose,green,greenish-brown,immature,lanceolate,lobe,margin,mm,narrowly,obtuse,ovoid,pedicel,peduncle,petiole,pilose,possibly,pubescent,pubescent-pilose,purplish,rarely,rather,ripe,short-acuminate,simple,stigma,stripe,style,tree,triangular,truncate,tube,unbranched,vein,violet,white,whitish,x,yellow	-3,-50,0-,1-1.5,1-2,1-3,1.5-12,1.5-2,15-35,2,2-3,2-4,20-30,3,3-18,3-4,3-5,3-foliat,7-15,8-16,absent,aggregate,also,apart,ape,articulated,axe,beyond,blade,campanulate,capitat,cell,connective,connivent,coriaceous,cylindrical,dilated,directed,distally,eaf,eed,equal,exceeding,exserted,finely,flower,hair,laterally,leaving,less,lon,long,lower,moderately,near,nearly,nflorescence,nther,orolla,papillose,pedicellar,perfect,pilo,pore,presence,present,rachi,radiu,remnant,ruit,slightly,small,somewhat,spaced,stamen,stellate,stone,tal,tem,thecae,time,tomento,ud,unit,unknow,vary,wide,yello,ympodial	anther,appearance,arrangement,bark,border,branch,bud,capitate,characteristic,colour,corolla,corrugation,distal,drying,exertion,filament,form,fruiting,giving,glabrousnes,growth,height,history,inflorescence,interjected,lateral,leaf,leaflet,length,life,lobing,midpoint,na,new,number,ovary,per,perennial,plant,prickle,primary,pseudostipule,ray,seed,shape,size,stem,surface,terminal,texture,thicknes,type,variation,width
81	wfo-0001026754	success	176	100	71	105	29	0.403	0.5-1,0.9-1.1,1/2,2-2.5,2.5-3.5,2/3,5,5-lobed,5.5-9,7-9,acute,anther,apex,asymmetric,base,berry,broadly,clavate,cm,corolla,deeply,densely,diameter,ellipsoid,elliptic,entire,exerted,filament,glabrous,globose,growth,halfway,inflorescence,later,lateral,leaf,lobed,margin,membranous,minute,minutely,mm,narrowly,new,oblique,pair,pedicel,peduncle,petiole,primary,puberulent,pubescent,scandent,simple,slender,sparsely,spreading,stem,stigma,style,surface,terminal,truncate,tube,vein,vine,way,white,woody,x,yellowish	-6+,.5,0.5,1,1-,1.5-3,10,198.,2,2-3,2-4,3-4-celled,30+,4-5,5-merou,9,9-11,abaxially,adaxially,ag,along,alyx,anthesi,apar,apparently,ark,articulated,axi,basal,branched,brow,cabrera,calyx,complete,conical,connivent,cucullat,dendritic,denser,distal,divided,eaf,ed,especially,extending,fide,flower,free,half,ilament,irregularly,lamina,leaving,lengthening,like,lobe,long,loosely,lower,many,mature,midvein,mixture,mostly,nflorescence,older,orolla,outline,papillo,peg,perfect,pinnate,planar,plurifoliat,pore,poricidal,portion,ruit,scar,seen,sleeve,slit,small,sometimes,spaced,splitting,stellate-rotate,tangled,tem,time,tip,transparent,trichome,tub,twinin,twining,ud,uniseriate,unit,upper,vary,weak,within,yellow,ympodial	1-6,arrangement,bark,branch,brown,bud,characteristic,colour,corrugation,drying,exertion,form,fruit,glabrousnes,height,history,length,life,lobing,na,number,ovary,per,plant,seed,shape,size,texture,type
82	wfo-0001026756	success	147	117	76	71	41	0.517	0-7-1.2,0.25-0.5,0.5-3,1.5-1.7,1.5-10,1.5-2,1.8-3,3-4,3.5-8.5,5-10,5-10-flowered,5-5.5,6-10,6-16,acute,anther,apex,attenuate,bark,base,berry,bilobed,broadly,brown,calyx,cm,conical,corolla,dark,densely,dia,difoliate,elliptic,erect,exserted,filament,fruiting,glabrous,globose,green,lateral,leaf,lobe,long,main,minutely,mm,nearly,ovary,ovate,ovoid-reniform,pair,pale,pedicel,petiole,pinkish-white,pitted,pubescent,shape,shaped,shrub,simple,sparsely,stem,stigma,strongly,style,surface,tear-drop,thick,tree,tube,unifoliate,vein,white,wide	.25,.5,0.5-1,1-1.5,1-2,1.5-3,abaxial,abaxially,adaxially,along,anthesi,apiculate,ba,closely,corresponding,deflexed,deltate,dendritic,denser,differing,distal,eaf,edicel,eed,fleshy,free,geminat,glabrescent,grayish-brow,hard,inflorescenc,irregular,lamina,lax,like,lobed,lower,major,middle,minor,nflorescence,occasionally,older,opposite,overlappin,papillo,perhaps,pericarp,planar,pore,poricidal,portion,present,pubescence,rest,ruit,scar,somewhat,soon,spaced,tall,tip,trichome,tub,ud,uniseriate,unit,widest,woody,ympodial,young	0.5,appearance,arrangement,border,branch,bud,characteristic,colour,corrugation,diameter,drying,exertion,form,fruit,giving,glabrousnes,grayish-brown,growth,height,history,inflorescence,length,life,lobing,margin,midpoint,na,new,peduncle,perennial,plant,prickle,primary,ray,seed,size,texture,thicknes,type,variation,width
83	wfo-0001026777	invalid_json_followup	168	150	104	64	46	0.619	.5,0.25-0.5,0.5-1,0.5-1.5,1-1.3,1-10,1-2,1-4,1.2-1.8,1.5-3,2-4,2-4.5,3-3.5,4-8,5-14,5-50-flowered,5-7,acuminate,acute,anther,apex,axil,base,beneath,berry,blue,branching,brown,calyx,capitate,cm,corolla,cup,decurrent,deflexed,dense,dia,distal,elliptic,end,exserted,fide,filament,filiform,flattened,flattened-reniform,flexuous,fruiting,glabrate,glabrous,globose,green,growth,lateral,leaf,lobe,lobed,long,main,margin,minutely,mm,narrowly,near,nearly,new,occasionally,often,older,onto,opposite,ovary,overtopping,pair,papillose,pedicel,petiole,pubescent,russet,seed,shaped,shiny,shrub,size,slightly,smooth,soon,sparsely,stem,stigma,straight,style,surface,tear-drop,trichome,tube,tuft,uniseriate,vein,vellozo,white,x,yellowish,young	.25,/3,0.5-5,0.9-3,1-1.5,1.5-5,2-5,anthesi,apart,apiculate,ba,beginning,body,campanulate,cell,differing,difoliate,eaf,edicel,eed,free,geminat,greyi,hyaline,incrassate,inflorescenc,irregularly,like,lon,lower,major,matted,middle,minor,nflorescence,one,outline,papillo,pitted,planar,pore,poricidal,portion,prominent,quadrate-deltoid,quite,rest,ruit,scar,sinuate,somewhat,spaced,tall,tapering,testa,thread-like,tip,ud,unit,wall,way,widest,woody,ympodial	'',[,``,alternate,arrangement,bark,branch,bud,characteristic,colour,corrugation,diameter,drying,exertion,form,fruit,glabrousnes,greyish,height,history,inflorescence,interjected,leaflet,length,life,lobing,midpoint,na,number,peduncle,per,plant,prickle,primary,pseudostipule,ray,shape,terminal,texture,thicknes,type,value,variation,width,{,}
84	wfo-0001026819	invalid_json_followup	218	170	126	92	44	0.578	0-27,0.3-4.7,0.5-1.5,1-2,1.2-36,1.5-10,1.5-12,1.5-3.0,1.5-3.3,1.6-3.5,10-26,2.5-5,3-120,3-18,3-20,3-35,3-38,4,4-7,5-30,6-11,abaxially,acuminate,acute,anther,apex,articulated,attenuate,base,blue,borne,broadly,brownish,bud,capitate,cell,chartaceous,cm,condition,connate,connivent,corolla,covering,cuneate,dark,densely,diameter,distal,dot,drying,elliptic,especially,filament,flower,forked,fresh,fruit,generally,glabrous,glaucous,globose,green,green-white,greenish,greenish-yellow,hair,hair-like,half,herb,interjected,lanceolate,lateral,leaflet,light,like,long,make,margin,membranous,middle,mm,moderately,mottled,mucilaginous,narrowly,non-glandular,oblique,odd-pinnate,ovate,ovoid,pedicel,peduncle,petiole,plant,pubescent,purple,scattered,seed,short,slightly,sometimes,somewhat,star,stem,stigma,stripe,style,subglabrous,subtending,symmetrical,terminal,testal,thick,throughout,tinged,truncate,tube,unwinged,violet,wall,wet,white,whitish,wide,wing,within	1-10,1-2.3,1-5,1.5-3.5,10,2-5,2-6,4-10,5-merou,7,absent,acumen,adaxially,ag,along,alyx,apart,ascending,bearing,blade,ciliate,clavat,curved,decurrent,digestion,dorsally,eaf,edge,eed,end,enzyme,erec,exceeding,flat,folded,geminat,glabrou,greatly,homostylous,honeycomb-shaped,larger,lengthening,living,lobe,lower,lunate,midvein,minutely,nflorescence,often,orolla,pair,pedice,pentagonal,petiolule,plurifoliate,pore,poricidal,puberulent,rachi,ranging,removed,rotate-pentagonal,ruit,scale-like,seudostipule,singly,slit,spaced,specimen,stamen,ste,stolo,straight,subequal,suborbicular,subrosette,tall,tamen,tem,tertiary,therefore,tip,tri-,tuber,typically,unit,usually,vary,without,yellow,ympodial	'',[,``,arrangement,bark,branch,calyx,characteristic,clavate,colour,corrugation,exertion,form,glabrousnes,growth,height,history,inflorescence,leaf,length,life,lobing,midpoint,na,new,number,ovary,per,prickle,primary,pseudostipule,ray,shape,size,surface,texture,thicknes,type,value,variation,vein,width,{,}
85	wfo-0001026821	invalid_json_followup	204	156	108	96	48	0.529	.2,0.2-1.5,0.3-1.2,0.3-2.5,0.4-1.5,0.5-1.2,0.5-3.5,0.7-1.8,0.8-1,1-1.5,1-2,1-3,1-5,1.2-1.5,1.5-2.5,10-15,2-3.5,2-celled,2.5-18,3-11,3-18,3-6,3-7,3-branched,4-4.5,5-12,5-20,5-34,acuminate,angular,anther,apex,apically,appressed,base,berry,broadly,brown,cm,cordate,dark,deltate,diameter,distal,due,ellipsoidal,filament,flattened,flower,forked,frequent,fruit,gglobose,glabrous,green,hair,herb,incurved,interjected,lanceolate,lateral,leaf-opposed,leaflet,length,light,lobe,long,long-attenuate,many,margin,mature,membranous,mm,narrowly,oblique,oblong,obtuse,odd-pinnate,pale,pedicel,peduncle,per,petiole,pilose,puberulent,pubescent,rarely,remnant,rounded,scandent,short,slender,small,somewhat,sparsely,stigma,stripe,style,subglabrous,surface,terminal,thickening,tube,unbranched,wall,white,winged,x	/3,0-20,1-20,17,1977,2-15,2-6,3-celled,5-10,5-merou,abaxially,acut,adaxial,adaxially,ag,alyx,anderson,apart,apical,apiculate,articulated,auriculate,axe,ba,basal,bayonet,blade,bract,cell,chartaceous,ciliat,cuneate,directed,distally,eaf,eed,elliptic,equal,especially,exceeding,fused,geminat,glabrou,gland-tipped,greatly,homostylous,interstaminal,large,longitudinal,lower,lowermost,mean,membrane,minute,minutely,moderately,much,nflorescence,obliquely,occasional,occasionally,one-celled,opening,orolla,pair,paired,perfect,petiolule,plurifoliate,pore,present,pseudostipular,pubescen,rachi,reduced,reniform,ruit,seudostipule,slightly,slit,smaller,spaced,stamen,stellate,substellate,subtended,tamen,tem,time,tri-,truncat,unit,vary,wide,yellow,ympodial	'',[,\u201cbayonet\u201d,\u201cpuberulent\u201d,``,appearance,arrangement,border,bud,calyx,characteristic,colour,corolla,corrugation,drying,exertion,form,giving,growth,height,history,inflorescence,leaf,life,lobing,midpoint,na,number,ovary,plant,prickle,primary,pseudostipule,ray,seed,shape,size,stem,texture,thicknes,truncate,type,value,variation,vein,width,{,}
86	wfo-0001026827	success	143	136	96	47	40	0.671	/3,0.2-0.5,0.4-0.6,0.5-2,0.6-1,1-1.1,1-1.5,1-2.1,1.3-1.6,1.5-2,2-2.2,2-4,3-9,5-6,7-9,acute,age,and/or,anther,anthesi,apex,appearing,arachnoid,attenuate,bark,base,branch,branched,broadly,calyx,clavate,cm,conical,corolla,deltate,dendritic,densely,diameter,drying,ellipsoid,erect,exerted,filament,flower,glabrescent,glabrous,growth,inflorescence,internodal,irregularly,lamina,lanceolate,leaf,lengthening,less,like,lobe,margin,mm,narrowly,new,nodding,oblanceolate,ovary,pair,paler,pedicel,peduncle,petiole,pore,poricidal,primary,pubescent,reddish,revolute,shrub,simple,slender,slit,soon,sparsely,stem,stigma,stout,strongly,style,surface,terminal,tip,trichome,tube,uniseriate,vein,way,white,x	.5,1-,1-2,2-2.5,?,abaxially,adaxiall,apart,crowded,deciduou,dense,distally,dry,eaf,especially,fleshy,free,know,known,lobed,lower,minutely,near,nflorescence,ot,papillat,papillate,perfect,planar,plane,plurifoliat,portion,rachi,scar,sinus,small,straight,surfac,thick,thickened,third,tub,ud,unit,upper,widest,ympodial	adaxially,appearance,arrangement,border,bud,characteristic,colour,corrugation,deciduous,distal,exertion,form,fruit,fruiting,giving,glabrousnes,height,history,interjected,lateral,leaflet,length,life,lobing,midpoint,na,number,per,plant,prickle,pseudostipule,ray,seed,shape,size,texture,thicknes,type,variation,width
87	wfo-0001026830	invalid_json_followup	198	152	105	93	47	0.53	0-10,0.3-1.3,0.4-1,0.5-1.0,0.9-1.9,1-11,1-2,1.1-2.7,1.4-4,10-57,2.5-5,2.7-8,3.5-8.5,4-14.5,4-7,4.4-14.5,5-11,6-13,abaxially,acuminate,acute,adaxially,anther,apex,attenuate,axillary,base,berry,brown,brownish,bud,ciliate,clavate,cm,condition,coriaceous,corolla,deep,diameter,distal,drying,elliptic,filament,finely,forked,fresh,fruit,generally,glabrescent,glabrous,globose,green,green-white,greenish,hair,half,herb,interjected,lanceolate,lateral,leaf,leaflet,light,linear,lobe,long,margin,medium,mm,moderately,mucilaginous,odd-pinnate,ovate,ovoid,pedicel,peduncle,petiole,plant,puberulent,pubescent,purple,ripe,rounded,seed,sessile,short,simple,size,stigma,stripe,style,subglabrous,subtending,terminal,throughout,tube,typically,unwinged,usually,wet,white,whitish,x,yellow,yellowish	0.5-1.2,1-10,1.5-4,2-4,2-6,2.5-4.4,4-10,4.5-17.5,5-merou,7-18,acumen,adaxiall,ag,along,alyx,apart,apparently,arranged,articulated,asymmetric,axe,basiscopic,bead,blade,capitat,cell,connivent,covering,decreasing,digestion,dorsally,eaf,edge,eed,enzyme,erec,exceeding,flat,flower,folded,geminat,glabrou,hair-like,hal,high,homostylous,honeycomb,lengthening,like,living,lower,make,moniliform,multiple,necklace,nflorescence,orbicular,orolla,pair,pentagonal,perfect,petiolulate,plurifoliate,pore,poricidal,removed,rotate,ruit,seudostipule,shaped,side,slit,spaced,specimen,stamen,stolon,straight,subequal,subglabrou,tall,tamen,tem,testal,thick,tip,tissue,toward,tri-,tuber,unit,vary,wall,ympodial	'',[,``,appearance,arrangement,bark,branch,calyx,capitate,characteristic,colour,corrugation,erect,exertion,form,fruiting,giving,glabrousnes,growth,height,history,inflorescence,length,life,lobing,midpoint,na,new,number,ovary,per,prickle,primary,pseudostipule,ray,shape,stem,surface,texture,thicknes,type,value,variation,vein,width,{,}
88	wfo-0001026831	invalid_json_followup	207	155	113	94	42	0.546	-6.5,-9,.5,/4,0-10,0-3,0-6,0.2-1,0.3-0.6,0.3-0.65,0.5-1.2,0.6,0.6-2,0.65-1,0.7-1.1,1-2.2,1-2.5,1-4,1.5-2.5,1/3,2-2.5,2-4,2.3-2.9,2.5-4.5,3-6,abaxially,acute,anther,apex,apparently,articulated,attenuate,bark,base,berry,branched,bright,calyx,cell,chartaceous,cm,connivent,cream,curved,dark,densely,diameter,dull,elliptic,erect,filament,flattened-reniform,flower,fruit,fruiting,glabrous,green,lateral,leaf,length,lobe,lobed,long,lower,margin,marking,maturity,mauve,membranous,midpoint,mm,moderately,narrow-cuneate,orange,orange-brown,outline,pair,pale,pedicel,peduncle,per,petiole,poricidal,prickle,prickly,primary,raised,ray,red-brown,rounded,shiny,shrub,slender,smooth,sparsely,spherical,stellate-pubescent,stem,style,surface,tapering,tip,tube,upper,usually,vein,way,white,white-gray,wide,yellow,yellow-green,young	-0.25,-5,0-20,0.1,0.1-0.2,0.1-0.25,0.15-0.25,0.2-0.4,0.7-2,1-10,1-2,1-3,1-6,1.2-2,1/3-1/,1/3-2/3,1/5-1/4,2-3,3-5,3.5-10,5-merous,7-10,7-8,alyx,apar,apart,apically,blade,broad-deltate,brow,caudat,concolorous,deltate,difoliate,distance,drying,eaf,eed,elongating,equal,extending,eye,free,fully,geminat,glabrescent,gray-brown,herbaceous,infructescence,less,longer,mature,midvein,multangulate,naked,nflorescence,oblong,occasionally,older,one,open,opening,orolla,oung,ovate,pendulous,perfec,pericarp,porrect,portion,prickl,reduced,ruit,scandent,scar,sessile,shorter,side,sometimes,spaced,spreading,stalk,stellate,subsessile,tamen,terete,tertiary,time,trichome,unit,vary,venation,visible,ympodial	'',1/3-1/2,10-20,[,``,arrangement,branch,brown,characteristic,colour,corolla,distal,exertion,form,glabrousnes,growth,height,history,inflorescence,interjected,leaflet,life,lobing,na,new,number,ovary,perennial,plant,pseudostipule,seed,shape,size,terminal,texture,thicknes,type,value,variation,width,{,}
89	wfo-0001026841	success	139	108	74	65	34	0.532	/4,0.25-0.3,0.5-0.75,0.6-1,0.8-1,0.8-3,1.5,2-2.5,3-6.5,3.5-5,4-8,5-8-flowered,6-8,7-9,9.2-18,acute,anther,apex,bark,base,berry,bi-lobed,broadly,calyx,clavate,cm,conical,corolla,curly-tipped,decurrent,dia,ellipsoid,elliptic,filament,filiform,fruiting,glabrate,glabrous,globose,green,inflorescence,later,lateral,leaf,long,main,margin,mm,older,ovary,pair,pedicel,petiole,poricidal,pubescent,reddish,shining,shrub,simple,slightly,sparsely,stem,stigma,straight,style,tip,trichome,tube,uniseriate,vein,way,white,x,young	.25,.5,0.05,0.25-0.5,0.5-1,0.5-2,0.75-1,1.5-2,along,anthesi,apart,arch,axi,ba,beneath,coroll,deflexed,deltoid,eaf,edicel,eed,exsertion,free,greyish-gree,hyaline,immature,joined,known,like,lobe,lobed,lon,lower,middle,minutely,nflorescence,opposite,paler,papillo,papillose,pore,portion,prominent,raised,reflexed,rest,ruit,scar,series,shaped,slender,spaced,tall,tapering,tear-drop,terminal,thickened,ud,unevenly,unifoliat,unit,widest,winged,woody,ympodial	arrangement,branch,bud,characteristic,colour,corrugation,diameter,drying,exertion,form,fruit,glabrousnes,greyish-green,growth,height,history,length,life,lobing,na,new,number,peduncle,per,plant,primary,seed,shape,size,surface,texture,type,unifoliate,ye
90	wfo-0001026849	success	180	102	70	110	32	0.389	0-10,0.5-1,1,1-2,1.5-2.5,1.75-2,2,2-3,38/2,637/2,7-8,acute,anther,apex,aster,base,berry,brown,calyx,capitate,cm,colour,conical,corolla,cyme,discoidal,distinctly,ellipsoid,entire,filament,fruiting,glabrous,glandular,globose,green,grey-brown,growth,hair,inflorescence,lavender,leaf,long-cuneate,margin,minute,minutely,mm,oblong,oblong-lanceolate,ovary,pedicel,peduncle,petiole,reticulate,rh,rounded,sea,seed,short-lived,shrub,simple,soft-wooded,stem,stigma,style,surface,tube,unarmed,undulate,violet,x	-50,1-1.5,1-6,100-130,11,30-,40,5,5-10,80-,adherent,adult,amongst,appearing,aspect,australian,axil,cell,composed,conspicuous,curved,cut,deflexed,developed,dia,distinct,eed,emarginate,enlarge,erect,exceeding,except,exerted,expanded,facetted,filled,flesh,floral,flower,flowered,fork,free,general,globular,granule,greater,gree,half,interacuminal,large,leave,lengthening,less,linear-lanceolate,little,lobe,lon,long,loosely,lower,mature,maturity,mid-vein,native,nflorescence,occasionally,often,pal,pale,pedicellate,petal,plurifoliat,pore,poricidal,preparation,pruinose,purple,rarely,relatively,reproducing,rhachi,rotate,ruit,ruiting,shallow,shed,sinus,slende,slightly,slit,solanum,solitary,sometimes,somewhat,soon,stone,stony,stout,thus,tip,tissue,tub,ud,unit,uvenile,vegetatively,way,well,ympodial,young	8,80-100-130,arrangement,bark,branch,bud,characteristic,corrugation,diameter,drying,exertion,form,fruit,glabrousnes,height,history,length,life,lobing,na,new,number,per,plant,plurifoliate,primary,shape,size,slender,texture,type,vein
91	wfo-0001026858	invalid_json_followup	153	155	102	51	53	0.667	-30,0.5,0.8,0.8-1,1-10,1-11.5,1-4,1-5,1.3-1.5,1.5-4,2-2.5,2-4,3-,3-4,4.5-10.5,5-15,6-10,6-18,6-7,abaxially,acumen,acute,adaxially,apex,apical,apically,articulate,base,branched,calyx,cell,cm,connate,cordate,corolla,covering,cuneate,cyme,dehiscent,diameter,dichasial,dichasially,distal,ebracteate,exceeding,filament,glabrescent,glabrous,globose,green,green-white,herbaceous,interjected,introrse,lateral,leaf,leaflet,light,lobe,long,make,maturing,minute,mm,monochasial,mucilaginous,mucronate,oblique,oblong,obtuse,odd-pinnate,often,ovate,ovate-lanceolate,ovoid,pedicel,peduncle,perennial,petiole,plant,poricidally,proximal,rounded,seed,shiny,short,size,slightly,slit,stamen,stigma,straight,style,testal,thick,throughout,triangular,tuber-bearing,wall,wide,yellow,Â¼	-4,0-.,1-,2-3,2.5-3,3-6-foliat,4-24,abruptly,digestion,diminishing,dorsally,eaf,edge,eed,emoval,enzyme,flat,flower,folded,forked,generally,globo,hair-like,half,honeycomb,living,lon,lower,lunat,nflorescence,nther,orolla,pair,pattern,perfect,plan,reveal,ruit,seudostipule,specimen,stellate,tal,tem,throughou,toward,typically,unit,vary,white-crea,without,ympodial	'',0-2,[,\u201chair-like\u201d,``,anther,arrangement,bark,branch,bud,characteristic,colour,corrugation,drying,exertion,form,fruit,fruiting,glabrousnes,growth,height,history,inflorescence,length,life,lobing,margin,midpoint,na,new,number,ovary,per,prickle,primary,pseudostipule,ray,shape,stem,surface,terminal,texture,thicknes,tube,type,value,variation,vein,wet,white-cream,width,{,}
92	wfo-0001026895	invalid_json_followup	166	164	117	49	47	0.705	0-0.5,0.5-1,0.5-1.2,0.5-1.5,0.5-2,0.8-1,1-1.5,1-5,1.4-2.1,2-2.3,2-2.5,2-3,2.5-3.2,2/3,3-12,4.5-5,5-6,5-8-flowered,abaxial,acute,anther,apex,apically,appearing,attenuate,bark,base,berry,borne,broadly,brown,calyx,capitate,cm,conical,contracted,corolla,dark,deflexed,dendritic,dia,drying,ellipsoid,elliptic,erect,filament,filiform,flattened,fruiting,glabrate,glabrous,globose,green,incrassate,internodal,lamina,lateral,leaf,like,lobed,long,long-exserted,main,margin,minute,minutely,mm,mustard,narrowly,obovate,often,ovary,pair,pale,pedicel,petiole,pitted,pointed,pore,poricidal,pubescent,reddish,reniform,scattered,shape,shaped,shoot,short,shrub,shrublet,side,simple,size,small,somewhat,soon,sparsely,stem,stigma,style,surface,swollen,swollen-based,tan,tear-drop,tip,toothed,trichome,tube,type,uniseriate,vein,way,white,x,yellow,young	.5,1.5-2,adaxial,along,anthesi,apical,ba,broad,campanulate,closely,deltoid,denser,differing,difoliate,eaf,edicel,eed,elongate,free,geminat,hard,lobe,lon,lower,major,middle,minor,nflorescence,older,overlappin,papillo,pericarp,portion,present,projection,reddish-brow,ruit,scar,spaced,tall,thin,tub,tuft,ud,unit,usually,widest,woody,ympodial	'',[,``,arrangement,branch,bud,characteristic,colour,corrugation,diameter,distal,exertion,form,fruit,geminate,glabrousnes,growth,height,history,inflorescence,interjected,leaflet,length,life,lobing,midpoint,na,new,number,papillose,peduncle,per,plant,prickle,primary,pseudostipule,ray,reddish-brown,seed,terminal,texture,thicknes,value,variation,width,{,}
93	wfo-0001026905	invalid_json_followup	204	155	113	91	42	0.554	.5,0-2,0-25,0.2-0.5,0.4-0.9,0.4-1,0.5-0.7,0.5-1.5,0.6-0.7,0.7-1.4,0.75-1.1,0.9-1.3,1-2.5,1-20,1-3.7,1-6,1.9-2.5,1/2-3/4,2.5-2.9,2.5-3.5,3-5,3-8,5-6,acute,anther,apart,apex,articulated,attenuate,bark,base,berry,branched,calyx,cell,chartaceous,cm,cream,curved,dark,densely,diameter,dull,erect,filament,flattened-reniform,fruit,fruiting,gray-green,green,inflorescence,lateral,leaf,length,lobe,lobed,long,lower,margin,marking,maturity,mauve,midpoint,mm,moderately,oblong,orange,orange-brown,outline,ovate,pair,pale,pedicel,peduncle,per,petiole,pit,poricidal,prickle,prickly,primary,raised,ray,red,rounded,shallowly,shrub,small,smooth,sometimes,spaced,sparsely,spherical,stellate,stellate-pubescent,stem,straight,style,surface,tapering,terete,tip,tube,unarmed,usually,vein,way,weakly,white,wide,yellow,yellow-green,young	-1.5,-10,-2,-2/3,-3,-4,.2,0,0-20,0.1,0.15,0.2-0.3,0.3-0.4,0.4,1,1-2,1-4,1/3,1/4,1/5-1/3,2-3,2/3-3/,5-merous,6-8,7-8,abaxially,acuminat,alyx,ame,apar,apically,apparently,blade,brow,c.,connivent,deltate,difoliate,discolorous,distance,drying,eaf,eed,elongating,equal,extending,eye,flower,free,geminat,glabrous,infructescence,longer,mature,midvein,naked,older,one,open,orolla,oung,pendulous,perfec,pericarp,porrect,portion,prickl,reduced,ruit,scar,sessile,shorter,side,slender,somewhat,spreading,stalk,stalked,subentire,tamen,tertiary,time,trichome,unit,upper,variously,vary,venation,visible,woody,ympodial	'',2/3-3/4,[,``,alternate,arrangement,branch,brown,bud,characteristic,colour,corolla,distal,exertion,form,glabrousnes,growth,height,history,leaflet,life,lobing,na,new,number,ovary,perennial,plant,pseudostipule,seed,shape,size,stigma,terminal,texture,thicknes,type,value,variation,width,{,}
94	wfo-0001026923	invalid_json_followup	177	148	99	78	49	0.559	.5,0.25-0.5,0.5-1,0.6-0.8,0.8-1,1,1-1.5,1-7,1.5-2,2,2-2.5,2-6,20-50,3-4,3-5,4-18,5-10,5-15,abaxially,acuminate,acute,adaxially,anther,apex,articulated,base,black,branched,brown,calyx,chartaceous,cm,connivent,cuneate,curved,deltate,densely,diameter,elliptic,elliptic-ovate,entire,erect,filament,flattened,flower,forked,fruit,fruiting,glabrescent,glabrous,globose,green,hair,intermediate,lanceolate,lateral,leaf,light,like,lobe,long,margin,midpoint,mm,oblong,orange,pedicel,peduncle,peltate,petiole,possibly,pubescent,purple,ray,red,ripening,rounded,rugulose,scale,sessile,shrub,simple,small,sparsely,stellate,stem,stigma,straight,strongly,style,surface,tip,tree,trichome,tube,white,x,yellow,yellowish	-5,.1-0.3,0-5,0.5,1-3,1-4,1.5-4,10,2-3,4-5-,5-6,5-9,absent,accrescent,adaxiall,ag,apart,apparently,axe,ba,blade,capitat,center,covering,cylindrical,denser,directed,distally,eaf,eed,eglandular,equal,frui,fused,geminate,gland-tippe,glandular,held,large,leaf-opposed,longitudinal,lower,many-foliate,midvein,moderately,much,multangulate,nearly,nflorescence,opening,orolla,paired,perfect,pore,pubescence,rachi,relatively,ruit,short,slightly,slit,smaller,sometimes,somewhat,spaced,ste,subtending,tal,tamen,tem,time,unit,uprigh,usually,vary,whitish,wide,ympodial	'',[,``,arrangement,bark,branch,bud,capitate,characteristic,colour,corolla,corrugation,distal,drying,exertion,form,glabrousnes,growth,height,history,inflorescence,interjected,leaflet,length,life,lob,lobing,na,new,number,ovary,per,plant,prickle,primary,pseudostipule,seed,shape,size,terminal,texture,thicknes,type,value,variation,vein,width,{,}
95	wfo-0001026925	success	215	134	102	113	32	0.474	.5,0-7,0.5-1.5,0.9-1.8,00-200,1-1.3,1-1.4,1-25,1-3.5,1.5-2,1.5-4.5,1.8-2,1/3,1/3-1/2,2.4-2.6,2.4-3,3-20,3-7,4-14,4-5,4-7,6-17,acute,anther,apart,apex,apparently,attenuate,bark,base,berry,calyx,chartaceous,cm,concolorous,connivent,cream,dark,deltate,diameter,drying,elliptic,erect,filament,flattened,flattened-reniform,fruit,fruiting,glabrescent,glabrous,green,green-brown,lateral,leaf,length,lobe,lobed,lobing,long,lower,margin,marking,maturity,mauve,membranous,mm,moderately,narrow-deltate,orange-brown,ovate,pair,pale,pedicel,peduncle,pendent,per,petiole,plant,poricidal,prickle,prickly,primary,red-brown,shrub,spaced,spherical,stellate-pubescent,stem,style,surface,tapering,terminal,tip,tube,upper,vein,way,white,wide,yellow,yellow-orange,young	-2,/6,0,0-10,0-20,0-5,0.1,0.1-0.2,0.1-0.3,0.2,0.5-4,0.7-1.8,1-3,1-4,1.5-2.5,1.8-2.5,1/4-2/3,1/6-1/3,2-4,2-5,2.5-6,2/,4-10,5-6,5-8,5-merous,5.5-10,6-10,6-8,7-12,abaxially,acuminat,alyx,ame,andromonoecious,apar,apically,articulated,blade,branched,broad-deltate,brow,c.,curved,distal,distance,eaf,eed,elongating,equal,extending,flower,free,gently,hair,hermaphrodite,heterostylous,infructescence,long-styled,longer,lowermost,mature,midpoint,midvein,minute,nflorescence,oblong,older,one,open,orolla,oung,pendulous,pericarp,plurifoliat,porrect,portion,prickl,rarely,ray,reduced,reflexed,rounded,ruit,scar,secondary,sessile,short-styled,side,simple,smooth,sometimes,sparsely,spreading,stalk,stalked,staminat,stellate,stout,straight,tamen,terete,tertiary,time,translucent,trichome,unarmed,unit,vary,venation,visible,woody,ympodial	2/3,appearance,arrangement,border,branch,brown,bud,characteristic,colour,corolla,corrugation,exertion,form,giving,glabrousnes,growth,height,history,inflorescence,life,na,new,number,ovary,perennial,seed,shape,size,stigma,texture,type,width
96	wfo-0001026946	invalid_json_followup	205	157	111	94	46	0.541	0-20,0-5,0.5-2,0.9-3.5,0.9-4.3,1-2,1.5-2,1.6-3.7,10-39,12-23,2,2.5-10.5,2.7-9,3-20,4.1-9.4,5-7,6-24,8-15,8-25,acuminate,acute,anther,apex,axillary,base,berry,brownish,bud,cell,chartaceous,clavate,cm,condition,connivent,corolla,covering,creamy,densely,diameter,distal,dot,drying,elliptic,filament,flower,forked,fresh,fruit,generally,glabrous,globose,green,green-white,greenish,hair,half,herb,interjected,lanceolate,lateral,leaflet,like,lobe,long,make,margin,membranous,mm,mottled,mucilaginous,oblique,odd-pinnate,often,ovate,ovoid,pedicel,peduncle,petiole,plant,pubescent,pure,purple,ripe,rounded,scattered,seed,short,short-pubescent,size,slightly,stem,stigma,streak,style,subtending,terminal,testal,thick,throughout,truncate,tube,typically,unwinged,usually,wall,wet,white,whitish,wing,x,yellow-white	1,1-10,1-4,2-15,2-5,3-5,3-6,3.5-10,4-7,5-merou,abaxially,acumen,adaxially,ag,along,alyx,apart,apparently,articulation,attenuate,axe,blade,borne,broadly,capitat,ciliate,deeply,digestion,dorsally,eaf,edge,eed,end,enzyme,erec,especially,exceeding,except,extremely,flat,folded,geminat,glabrou,greatly,hair-like,homostylous,honeycomb-shaped,lengthening,living,lower,midrib,minutely,narrowly,nflorescence,orbicular,orolla,pair,pentagonal,perfect,petiolulate,petiolule,plurifoliate,pore,poricidal,proximal,puberulent,pubescen,reduced,removed,ruit,sessile,seudostipule,singly,slit,spaced,specimen,stamen,ste,stellate,stolo,straight,subequal,tall,tamen,tem,thir,tip,tri-,tuber,unit,variable,vary,yellow,ympodial	'',[,\u201chair-like\u201d,``,arrangement,bark,branch,calyx,capitate,characteristic,colour,corrugation,erect,exertion,form,fruiting,glabrousnes,growth,height,history,inflorescence,leaf,length,life,lobing,midpoint,na,new,number,ovary,per,prickle,primary,pseudostipule,ray,shape,surface,texture,thicknes,type,value,variation,vein,width,{,}
97	wfo-0001026962	success	205	133	90	115	43	0.439	.05,0.3-0.7,0.8-1,1,1-1.2,1-1.5,1-2,1-3,1-6,1.5-17,1.5-2,10-12,10-20,15-22,2-2.5,2-6,2/3-3/4,3-3.5,4-5,6-7,9-12,acute,anther,apex,bark,base,broadly,bud,calyx,chartaceous,cm,corolla,deltate,densely,diameter,elliptic,entire,evenly,exerted,filament,flattened-reniform,flower,fruit,fruiting,glabrous,globose,green,inflorescence,lateral,leaf,lobe,margin,minutely,mm,narrowly,obconic,oblong,pair,pale,pedicel,peduncle,petiole,pitted,pubescent,purplish,rounded,shrub,simple,size,small,sometimes,soon,stem,stigma,style,surface,tapering,tinged,tip,tree,triangular,tube,unbranched,vein,way,white,woody,x,yellow,yellowish	.5,0,0.5,0.5-0.8,0.5-1,0.5-1.5,1-4.5,1.5-3,1.5-5,2-5,3-6,9-17,abaxially,abrupt,abruptly,accrescent,adaxially,ag,alyx,anthesi,apparently,appearing,arising,articulated,axe,basebud,becoming,beneath,blade,brittle,capitat,cell,closely,composed,connivent,constricted,cucullat,cylindrical,darker,deflexed,denser,differing,difoliate,dimorphic,dry,eaf,eed,elongate,except,free,geminat,glabrate,glabrou,ilament,incrassate,internodal,later,like,lobed,long,longitudinal,main,major,material,minor,nflorescence,obovoid,occasionally,often,older,one,opening,opposite,orolla,oung,outline,ovate-lanceolate,overlapping,packed,papillose,paten,pendent,perfect,pore,portion,prominent,pubescen,rachi,raised,reflexed,remaining,rest,rounder,ruit,sagittate,shaped,slender,slightly,slit,somewhat,stellate,straight,tal,tear-drop,tooth,trichome,trunk,unarmed,unifoliate,uniseriate,unit,vary,whit,ympodial,young	appearance,arrangement,border,branch,capitate,cayx,characteristic,colour,corrugation,distal,drying,exertion,form,giving,glabrousnes,growth,height,history,interjected,leaflet,length,life,lobing,midpoint,na,new,number,ovary,per,perennial,plant,prickle,primary,pseudostipule,ray,seed,shape,terminal,texture,thicknes,type,variation,width
98	wfo-0001026964	success	128	104	71	57	33	0.555	.2,.5,0,0.5-1,1-1.2,10,10-30,2-2.5,3-5,7-8,?,acuminate,acute,anther,anthesi,apex,attenuate,axillary,base,berry,calyx,cm,conical,corolla,diameter,elliptic,filament,filiform,fleshy,fruiting,glabrous,globose,green,greenish,herb,horizontal,lightly,lobed,long,margin,minutely,mm,nearly,obovate,ovary,pair,pedicel,petiole,pinnate,poricidal,primary,pubescent,purple,reflexed,shape,simple,size,slender,small,sparsely,stigma,style,surface,tip,trichome,tube,uniseriate,vein,winged,x,yellow	0.5,1-2.5,2-4,3.5-7,4.5-8.5,along,basal,beak,bearing,capitat,conspicuously,differentiated,distinct,eaf,edicel,equal,erec,exserted,flower,free,glabrou,immature,known,lateral,leaflet,lenticellate,line,lobe,long-attenuate,lower,nflorescence,noddin,often,one,onto,open,ot,papillate,petiolule,portion,purpli,rachi,rugose,ruit,scar,side,smooth,somewhat,tal,tem,terminal,time,tub,ud,unifoliat,unit,ympodial	arrangement,bark,branch,bud,capitate,characteristic,colour,corrugation,drying,exertion,form,fruit,glabrousnes,growth,height,history,inflorescence,leaf,length,life,lobing,na,new,nodding,number,peduncle,per,plant,purplish,seed,stem,texture,type
99	wfo-0001026981	invalid_json_followup	252	141	103	149	38	0.409	-0.8,-2.5,-35,0.3-0.5,0.3.6,0.4-0.5,0.4-2,0.45-1.3,0.5-0.3,0.5-30,0.6-1.4,0.6-2,0.8-1.2,0.8-6,0.9-1.5,1-2,1-3,1-3.3,1-4,1.5-2.0,1.5-8.5,1.8-2.8,1/3,2-3-branched,3.5-14,4,6-10,accrescent,anther,apex,articulated,asymmetric,base,brown,calyx,capitate,cm,conical,cordate,corolla,dark,deltate,diameter,distal,entire,exserted,filament,fruit,fruiting,glabrescent,globose,green,hair-like,halfway,herb,imparipinnate,interjected,interrupted,irregularly,lateral,leaf,leaflet,lime,lobe,lobed,long,margin,minutely,mm,narrowly,obovate,orange,orbicular,outgrowth,ovary,ovate,pale,pedicel,peduncle,per,perennial,petiole,plant,present,primary,pseudostipule,pubescent,rounded,simple,sometimes,sparsely,stem,stigma,style,surface,terminal,thick,tube,type,usually,variously,wide,yellow	-0.4,-14,-2,-4,-8,.2,.2-0.2,0-5,0.05-0.1,0.1-0.2,0.1-0.3,0.15-0.2,0.2,0.2-0.4,0.2-2,0.25-0.4,0.4-0.7,0.5,0.7-0.8,0.9-1.4,1,1-2-cellular,1-3-celled,1.5-5,11,196.,2-3,2-locular,3-foliate,4-8,4-celled,7.5,<,abaxially,absen,absent,abundant,academy,acute,adaxially,adpressed,along,amongst,angled,anthesi,apical,appearance,appendage,appressed,articulation,axi,basiscopically,bay,beak,becoming,bract,bracteole-like,cell,citrus-like,coastal,column,composed,cone,d,densely,eaf,ebracteate,edicel,eed,erect,flower,giving,glandular,gree,half,head,included,initially,internode,jointles,larger,later,less,like,linear,lon,lower,mainly,maturity,mixed,much,multicellular,nflorescence,occasionally,pair,patent,pentagonal,petiolule,population,procumbent,pronounced,proximal,pubescence,rachi,reflexed,rick,robust,ruit,scen,secondary,see,sessile,several,shaggy,shaped,short,shorter,silky,slender,smaller,sparser,specimen,spreadin,staminal,sterile,straight,strong,tangled,tem,tertiary,testa,tightly,transparent,trichome,tub,uni-,unicellular,uniseriate,unit,upto,velvety,villous,viny,wall,winged,without,ympodial,â,â	'',[,``,arrangement,bark,branch,bud,characteristic,colour,corrugation,drying,exertion,form,glabrousnes,growth,height,history,inflorescence,length,life,lobing,midpoint,na,new,number,prickle,ray,seed,shape,size,texture,thicknes,value,variation,vein,width,{,}
100	wfo-0001026992	invalid_json_followup	243	160	116	127	44	0.477	0.2-0.5,0.8-3.4,1-4,1.2-1.4,1.2-1.7,1.4-1.6,1.4-1.9,1.7-2.4,1.7-4.3,10-12,12-33,2-10,2-5.6,2.6-4.6,2.8-4.6,2.8-4.7,3-4,4-8,5-15,5.3-12.1,6-10,8,abaxially,abruptly,acuminate,acute,adaxially,angled,anther,anthesi,apex,attenuate,bark,base,berry,blunt-tipped,branch,branched,broadly,brown,calyx,cm,corolla,cylindrical,deltoid,diameter,drying,elliptic,entire,exserted,filament,fleshy,flower,fruit,fruiting,glabrous,globose,granular-tomentose,greenish,grooved,hair,lance-ovate,lanceolate,lateral,leaf,length,lobe,longitudinally,many,margin,midrib,mm,oblong,occasional,orange-tan,ovate,ovate-lanceolate,pedicel,peduncle,petiole,plant,pubescent,reniform,reticulate-punctate,ripe,scabridulous-,short,shrub,side,simple,size,small,sometimes,stellate,stem,stigma,style,subcampanulate,subglobose,surface,terete,terminal,time,tomentose,tree,tube,unarmed,vein,velutinous,violet,weakly,white,whitish,x,yellow,yellowish	-2.5,/7,0.25-0.45,0.5-1.2,0.6-1.5,00-170,1.3-2.6,1.3-4.3,1.5-3.4,1.7-1.9,1/2,2.3-3.3,3.3-5.5,3.3-5.6,5-merou,8-11,8-14,abaxial,accrescent,adaxiall,ag,along,alyx,apart,apparently,appressed,approximately,around,articulated,axe,axillary,ba,blade,capitat,chartaceous,completely,coriaceous,covering,crown,dark,densely,directed,distally,eaf,echinoi,echinoid,edge,eed,enveloping,equal,evident,farinose,flat-topped,forming,free,geminate,glabrescen,high,homostylous,immature,inserted,lacking,lengthening,less,line,lobed,long,long-stalked,longitudinal,lower,m.,main,mature,maturity,minute,moderately,mostly,multangulate,nearly,nflorescence,obtuse,occasionally,often,older,orolla,overlapping,perfect,plurifoliate,pore,poricidal,porrect-stellate,pubescence,rachi,rare,rather,ruit,runk,semi-ovate,sessile,short-,short-stalked,shorter,slit,somewhat,spaced,sparingly,split,spreading,stalked,stamen,stout-stalked,suture,tamen,tan,thin-textured,tip,ud,unarme,unequal,unit,usually,vary,way,wide,ympodial,young,Â½	'',[,``,arrangement,bud,capitate,cayx,characteristic,colour,corrugation,distal,exertion,form,glabrousnes,growth,height,history,inflorescence,interjected,leaflet,life,lob,lobing,midpoint,na,new,number,ovary,per,perennial,prickle,primary,pseudostipule,ray,seed,shape,texture,thicknes,type,value,variation,width,{,}
101	wfo-0001026994	success	266	183	149	117	34	0.56	-0.7,-10,-20,-30,-foliate,0.25,0.4-0.5,0.5,0.5-0.7,0.5-0.8,0.5-0.9,0.5-1.3,0.5-2,0.7-2.5,1,1-1.4,1-1.5,1-1.6,1.2-1.6,1.2-3.5,1.4-2.1,10-20,2,2-2.6,2-4,2-5-locular,2.2-3.2,2.5-6.5,3,4,4-15,6-20,abaxially,acuminate,acute,adpressed,anther,anthesi,apex,appearance,articulate,basal,base,bent,bifurcate,branched,bright,broadly,brown,calyx,capitate,cell,cm,conical,corolla,crenate,dark,darker,decreasing,deeply,densely,diameter,distal,eglandular,elliptic,exserted,filament,fruit,fruiting,giving,glabrous,globose,grayish,green,greenish,hair-like,half,halfway,herb,imparipinnate,inflorescence,interjected,interrupted,irregularly,lanceolate,lateral,leaf,leaflet,less,lobe,lobed,locule,long,margin,markedly,medial,midvein,minutely,mm,narrowly,obovate,often,outgrowth,ovary,pair,pedicel,peduncle,perennial,petiole,primary,pseudostipule,puberulent,pubescent,purple,rachi,rarely,regularly,ripe,set,shaggy,silky,simple,size,slightly,sometimes,sparsely,stem,stigma,straight,stripe,style,surface,terminal,testa,thick,tip,toward,trichome,tube,unicellular,uniseriate,unit,usually,velvety,wall,white,wide,woody,yellow	.2,.5,0.05-0.1,0.05-0.2,0.1,0.1-0.2,0.1-0.3,0.15-0.2,0.2-0.4,0.2-0.5,0.3-0.4,0.4-1.2,0.5-0.6,0.5-1.2,0.9-1.2,0.9-1.3,1-1.2,1-2,12-,2-,20-50,3-branched,4-celled,5,5-,5-7,7-13,8,8-12,absent,abundant,acroscopically,additional,along,also,amongst,andscattered,apical,apically,appendage,articulation,basally,basiscopically,becoming,beneath,berry,bifurcation,bract,bracteate,broader,celled,column,crenat,crowded,decumbent,decurrent,developed,eaf,ebracteate,edicel,eed,erect,especially,essentially,fewer,flower,glandular,gree,habitat,hal,head,internode,investing,lamina,large,larger,largest,leave,like,lon,loosely,lower,moderately,much,narrower,narrowing,nearly,nflorescence,node,oblique,occasionally,paler,papillate,petiolule,present,reflexed,robust,rocky,rotate-stellate,secondary,sessile,short,sinus,specimen,spreadin,spreading,staminal,sterile,tall,tem,tertiary,ud,weak-walled,well,winged,ympodial,young	5-13,arrangement,bark,border,branch,bud,characteristic,colour,corrugation,decurred,drying,exertion,form,glabrousnes,growth,height,history,length,life,lobing,na,new,number,per,plant,seed,shape,sympodial,texture,thicknes,type,variation,vein,width
102	wfo-0001026996	success	188	139	95	93	44	0.505	0-6,0.6-1,0.9-2.7,1-2,1.2-1.8,1.3-7.7,1.8-4.4,15-28,3-10,3.3-6,3.8-14.1,4-4.4,5-8,6-8,6.9-10.9,8.7-18.6,acumen,acuminate,acute,anther,apex,attenuate,axillary,base,berry,blue,brownish,bud,cell,clavate,cm,condition,connivent,coriaceous,corolla,covering,dark,deep,diameter,distal,drying,elliptic,filament,forked,fresh,fruit,generally,glabrous,globose,green,green-white,greenish,hair-like,half,herb,interjected,lanceolate,lateral,leaf,leaflet,lilac,lobe,long,make,medium,mm,mucilaginous,odd-pinnate,ovate,ovoid,pedicel,peduncle,petiole,petiolulate,plant,ripe,rounded,seed,size,stigma,stripe,style,subtending,terminal,testal,thick,throughout,tube,unwinged,usually,wall,wet,white,whitish,x	1-3,1-4,1-5,14-33,2-3,3-5,3-7,4-8,4.5-10.5,5-merou,abaxiall,abaxially,adaxially,ag,along,alyx,apart,apparently,arranged,articulated,asymmetric,axe,basiscopic,bead,blade,capitat,considerably,decreasing,digestion,dorsally,eaf,edge,eed,enzyme,erec,exceeding,flat,flower,folded,geminat,glabrou,homostylous,honeycomb-shaped,larger,lengthening,like,linear,living,lower,middl,moniliform,mottled,multiple,necklace,nflorescence,orbicular,orolla,pair,pentagonal,perfect,plurifoliate,pore,poricidal,purple,removed,rotate,ruit,sessile,seudostipule,side,slightly,slit,sometimes,spaced,specimen,stamen,stolon,straight,subglabrou,symmetric,tall,tamen,tem,tip,tissue,toward,tri-,tuber,typically,unit,vary,yellow,ympodial	appearance,arrangement,bark,border,branch,calyx,capitate,cayx,characteristic,colour,corrugation,erect,exertion,form,fruiting,giving,glabrousnes,growth,height,history,inflorescence,length,life,lobing,margin,midpoint,na,new,number,ovary,per,prickle,primary,pseudostipule,ray,shape,stem,surface,texture,thicknes,type,variation,vein,width
103	wfo-0001027010	invalid_json_followup	198	145	100	98	45	0.505	0-2,0-2.5,0.4-5.1,0.5-1.5,1-10,1-2,1.2-1.7,1.2-1.9,1.4-6.9,10-60,14-46,2-9.4,2.1-15.3,2.1-4.3,2.2-12.9,3-10,3-8,3.5-13.6,4-8,4.4-29,4.9-31,abaxially,acuminate,acute,adaxially,anther,apex,attenuate,axillary,base,brownish,bud,clavate,cm,condition,coriaceous,corolla,deep,diameter,distal,drying,elliptic,filament,flower,forked,fresh,fruit,generally,glabrescent,glabrous,green,green-white,greenish,hair,half,herb,interjected,lanceolate,lateral,leaf,leaflet,light,lobe,long,mm,mucilaginous,narrow,odd-pinnate,ovate,ovoid,pedicel,peduncle,petiole,petiolulate,plant,purple,ripe,rounded,scabrous,seed,sessile,short,size,sometimes,spot,stigma,stripe,style,subtending,terminal,throughout,tube,usually,wet,white,whitish,wide,wing,winged,x	0-3,1-4,1-7,2-6,3-5,3-6,4-12,5-13,5-14,5-merou,acumen,adaxiall,ag,along,alyx,apart,apparently,arranged,articulated,asymmetric,axe,basiscopic,bead,blade,capitat,cell,coloration,connivent,covering,decreasing,digestion,dorsally,eaf,edge,eed,enzyme,erec,exceeding,flat,folded,geminat,glabrescen,glabrou,hair-like,hal,high,homostylous,honeycomb-shaped,larger,lengthening,like,living,lower,make,moniliform,multiple,necklace,nflorescence,occasionally,orbicular,orolla,pair,pentagonal,perfect,plurifoliate,pore,poricidal,present,removed,rotate,ruit,scabrou,seudostipule,side,slightly,slit,spaced,specimen,stamen,stolon,straight,subequal,tall,tamen,tem,testal,thick,tip,tissue,toward,tri-,tuber,typically,unit,vary,wall,yellow,ympodial	'',[,``,arrangement,bark,branch,calyx,capitate,characteristic,colour,corrugation,exertion,form,fruiting,glabrousnes,growth,height,history,inflorescence,length,life,lobing,margin,midpoint,na,new,number,ovary,per,prickle,primary,pseudostipule,ray,shape,stem,surface,texture,thicknes,type,value,variation,vein,width,{,}
104	wfo-0001027019	invalid_json_followup	142	140	90	52	50	0.634	.5,/4,0-0.5,0.5-1,1-1.5,1.5-2,1.5-3,10,10-40-flowered,12-30,2-3,2-8,4-5,7-14,abaxially,acute,adaxially,along,anther,apex,apparent,attenuate,bark,base,berry,branched,calyx,capitate,cm,corolla,cyathiform,deflexed,densely,dia,distal,ellipsoid,erect,even,exserted,filament,flattened,fruiting,glabrate,glabrous,globose,golden,green,inflorescence,later,leaf,like,lobe,lobed,long,midrib,minutely,mm,obovate,older,onto,opposite,ovary,ovoid-reniform,pale,pedicel,petiole,pitted,plant,pubescent,shaped,shrub,small,somewhat,stem,stigma,straight,strongly,style,surface,tan,tear-drop,tree,trichome,tube,way,white,wing,winged,x,young	1-2,1/2,2-5,4-8.5,abaxial,abruptly,anthesi,ba,bright,constriction,deltoid,difoliate,eaf,edicel,eed,elliptic,fleshy,free,geminat,inflorescenc,largely,live,lon,lower,major,minor,narrowed,nflorescence,overlapping,papillo,papillose,planar,pore,poricidal,portion,reddish-brow,rest,ruit,scar,spaced,sparsely,tall,tapering,third,tip,tub,ud,unit,waxy,widest,woody,ympodial	'',[,``,alternate,arrangement,branch,bud,characteristic,colour,corrugation,diameter,drying,exertion,form,fruit,glabrousnes,growth,height,history,interjected,lateral,leaflet,length,life,lobing,margin,midpoint,na,new,number,peduncle,per,prickle,primary,pseudostipule,ray,reddish-brown,seed,shape,size,terminal,texture,thicknes,type,value,variation,vein,width,{,}
105	wfo-0001027030	invalid_json_followup	234	199	161	73	38	0.688	-11,-15,.5,0-4,0.1-0.7,0.1-0.9,0.2,0.3-,0.4-0.8,0.4-1.5,0.5-,0.5-1,0.6-0.7,0.6-0.8,0.6-1.8,0.7-1,0.8-0.9,1,1-,1-1.3,1-3,1-3.4,1.2-1.6,1.5-,1.6-2,2-4,2-4.8,2-6,2-7,2-foliate,2.2-3.2,3-4-celled,3-8,4-celled,5-12,8-celled,abaxial,abaxially,abundant,acute,adpressed,anther,anthesi,apex,appearance,articulated,basal,base,basiscopically,beneath,berry,bract,branched,bright,brown,calyx,capitate,cell,cm,conical,corolla,crenate,crenation,dark,darker,decurrent,deeper,deeply,densely,denser,diameter,distal,due,eglandular,elliptic,entire,evenly,exserted,filament,flower,fruit,fruiting,giving,gland,glandular,globose,grayish,green,hair-like,half,halfway,herb,imparipinnate,inflorescence,interjected,internode,interrupted,interspersed,lamina,lateral,leaflet,less,like,lobe,long,longer,margin,minutely,mm,multicellular,narrowly,near,node,oblique,obovate,occasionally,often,outgrowth,ovary,pale,paler,papillate,pedicel,peduncle,perennial,petiole,primary,pseudostipule,pubescence,pubescent,robust,sessile,silky,similar,simple,size,soft,sometimes,spread,stem,stigma,style,surface,terminal,testa,thick,tiny,trichome,truncate,tube,unicellular,uniseriate,unit,vein,velvety,wall,white,wide,woody,yellow,young	.2,0.05-0.1,0.15-0.2,0.2-0.3,0.2-1,0.3-0.5,0.3-0.7,0.4-0.5,0.5,0.5-0.7,0.5-0.8,0.8-1,0.9-1.1,1-1.2,2-,2-3,2-locular,3-9,absent,acuminate,adaxially,angled,apical,appendage,articulation,axi,beyond,column,crenat,diamete,eaf,edicel,eed,extremely,gree,growt,hal,investing,irregularly,lanceolate,larger,lon,loosely,lower,nflorescence,pair,petiolule,present,reflexed,rotate-stellate,ruit,secondary,slender,slightly,small,smaller,somewhat,sparsely,spreadin,spreading,staminal,sterile,straight,stripe,tall,tem,tertiary,trailing,ud,usually,weak,winged,ympodial	'',[,``,arrangement,bark,branch,bud,characteristic,colour,corrugation,drying,exertion,form,glabrousnes,growth,height,history,leaf,length,life,lobing,midpoint,na,new,number,per,plant,seed,shape,sympodial,texture,thicknes,type,value,variation,width,{,}
106	wfo-0001027035	invalid_json_followup	199	142	95	104	47	0.477	0-36,0.1-0.9,0.3-2.3,0.4-12.8,0.5-3.4,0.5-7,0.8-4.2,0.9-3.1,1-2,1-3.4,1-8,1.5-5.9,1.7-8,1.8-5.2,10-80,2.8-10.3,3-10,4.9-23.5,acuminate,acute,anther,apex,attenuate,axillary,base,blue,brownish,bud,cell,clavate,cm,completely,condition,connivent,corolla,covering,deep,diameter,distal,drying,elliptic,filament,forked,fresh,fruit,generally,glabrescent,glabrous,globose,green,greenish,hair,half,herb,interjected,lanceolate,lateral,leaf,leaflet,light,lilac,lobe,long,medium,mm,odd-pinnate,ovate,ovoid,pedicel,peduncle,petiole,petiolulate,plant,rounded,seed,sessile,shape,short,size,stigma,style,subglabrous,subtending,terminal,testal,thick,tube,unwinged,usually,variable,wall,white,whitish,wide,x	0-7,0.5-5,0.8-3,1-3,2-38,2-7,3-5,4-18,4-18.5,5-merou,abaxially,acumen,adaxiall,adaxially,ag,along,alyx,apart,apparently,arranged,articulated,asymmetric,axe,basiscopic,bead,blade,capitat,coloration,decreasing,digestion,dorsally,eaf,edge,eed,enzyme,erec,exceeding,flat,flower,folded,geminat,glabrescen,glabrou,green-white,hair-like,hal,high,homostylous,honeycomb,larger,lengthening,like,living,lower,make,moniliform,mucilaginous,multiple,necklace,nflorescence,orbicular,orolla,pair,pentagonal,perfect,plurifoliate,pore,poricidal,present,purple,removed,ripe,rotate,ruit,second,seudostipule,shaped,side,slightly,slit,smaller,sometimes,spaced,specimen,stamen,stolon,straight,stripe,subequal,tall,tamen,tem,throughout,tip,tissue,toward,tri-,tuber,typically,unit,vary,wet,yellow,ympodial	'',[,\u201chair-like\u201d,``,arrangement,bark,branch,calyx,capitate,cayx,characteristic,colour,corrugation,erect,exertion,form,fruiting,glabrousnes,growth,height,history,inflorescence,length,life,lobing,margin,midpoint,na,new,number,ovary,per,prickle,primary,pseudostipule,ray,stem,surface,texture,thicknes,type,value,variation,vein,width,{,}
107	wfo-0001027050	invalid_json_followup	244	176	134	110	42	0.549	-12,-9,/3,0-0.2,0.1-0.3,0.3-1.5,0.5-3,0.9-2.1,1-1.5,1-2,1.5-6,10-13.5,2-2.5,2-5,2-8,2.5-3,3-5,4-20,5-7,5-9,8-26,absent,abundant,acuminate,acute,adult,anther,apex,bark,base,berry,branch,branched,broad-based,broadly,brown,calyx,capitate,chartaceous,cm,coarsely,conical,cordate,cuneate,curved,densely,diameter,distal,distally,drying,elliptic,entire,erect,ferruginous,filament,flattened-reniform,fruit,fruiting,glabrous,glandular-puberulent,green,growth,hair,inflorescence,lanceolate,lateral,leaf,leaf-opposed,length,like,lobe,lobed,long,margin,markedly,midpoint,minute,minutely,mm,moderately,narrowly,near,numerous,oblique,obtuse,often,ovate,pale,pedicel,peduncle,per,petiole,plant,present,prickle,pubescent,ray,rest,ripe,rounded,scattered,several,shallowly,shiny,short-stalked,shrub,side,small,spherical,stellate,stellate-pubescent,stem,stigma,straight,style,surface,terete,thicker,time,toothed,tree,triangular,trichome,truncate,tube,unbranched,usually,way,white,wide,woody,yellow,yellowish-green,younger	.2,.5,0-3,0.1-3,0.2-0.5,0.2-1,0.8,1,1.5-2,12-15,15-50+,2-3,2-4,4-8,5,5-10,5-6,5-merous,50,6-8,7-30+,abaxial,abaxially,absen,adaxial,adaxiall,alyx,andromonoeciou,apar,arme,articulated,axe,basal,blade,broad,brow,closely,connivent,deeply,difoliate,directed,distall,eaf,eed,eglandular,equal,erec,except,flattened,flower,free,geminat,half,heterostylous,infructescence,inside,interpetalar,juicy,juvenile,larger,least,less,long-styled,longer,lower,mature,mid-way,midrib,midvein,moist,mucilaginous,multiseriate,nflorescence,occasionally,older,orolla,oung,ovate-lanceolate,papillat,pericarp,pore,poricidal,porrect,portion,pricklier,prickly,ruit,scar,secondary,sessile,short-styled,shorter,slightly,somewhat,spaced,sparsely,stalk,stalked,tall,tamen,tip,tissue,touching,unarmed,unit,vary,weakly,whitish,ympodial,young	'',[,``,alternate,armed,arrangement,bud,cal,characteristic,colour,corolla,corrugation,exertion,form,glabrousnes,height,history,interjected,leaflet,life,lobing,na,new,number,ovary,papillate,perennial,primary,pseudostipule,seed,shape,size,terminal,texture,thicknes,type,value,variation,vein,width,{,}
108	wfo-0001027050	success	234	138	115	119	23	0.491	0-0.2,0.5-1,0.5-3,1-1.5,1-2,1.5-6,10-13.5,11-21,14-20,2-10,2-2.5,2-3,2-4,2-5,2-8,2.5-3,3-15,3-5,4-8,5-10,5-9,7-30+,absent,abundant,acuminate,acute,adult,anther,apex,base,branched,broad-based,broadly,brown,calyx,chartaceous,cm,coarsely,connivent,cordate,cuneate,curved,densely,diameter,drying,elliptic,entire,extra-axillary,ferruginous,filament,flattened,flower,forked,fruit,fruiting,glabrous,glandular-puberulent,globose,green,growth,hair,inflorescence,lanceolate,leaf,leaf-opposed,length,like,lobed,long,margin,midpoint,minutely,mm,moderately,oblique,obtuse,often,ovate,ovate-lanceolate,pale,pedicel,peduncle,per,petiole,pitted,plant,porrect,present,prickle,ray,rounded,scattered,shallowly,shrub,simple,small,somewhat,sparsely,stellate-pubescent,stem,stigma,straight,style,surface,toothed,tree,truncate,unbranched,usually,white,whitish,x,yellow,yellowish-green,younger	.2,0-0.5,0-1,0-3,0.1-3,0.2-0.6,0.2-1,0.3-0.6,0.4-1,0.5-0.8,0.8,1-5,1.5-2,10-30,12-15,15-50+,16-40,2-3-locular,2-6,2-foliate,23-40+,4-19,4-40,5,5-6,5-7,5-merous,6-8,8-26,8-40+,abaxially,absen,accrescent,across,adaxiall,adaxially,andromonoecious,anvil-shape,apart,armed,articulated,axe,ba,blade,branche,capitat,contiguous,cross-section,cylindrical,deeply,directed,distall,distally,distributed,eaf,eed,eglandular,erect,except,exocarp,functional,geminat,half,held,interpetalar,juicy,juvenile,lateral,less,lobe,longer,lower,markedly,mature,mesocarp,midvein,minute,moist,mucilaginous,multiseriate,narrowly,nearly,nflorescence,orolla,pair,pinnatifid,placenta,pore,rachi,ruit,sessile,shorter,side,slightly,spaced,stalk,stalked,stellae,stellate,tal,tamen,tem,thick,thicker,throughout,time,tip,tissue,triangular,tube,unarme,unarmed,unit,upper,upright,vary,weakly,wide,ympodial	abaxial,adaxial,arrangement,branch,capitate,characteristic,colour,corolla,form,glabrousnes,height,history,life,lobing,new,number,ovary,perennial,seed,shape,size,texture,type
109	wfo-0001027091	success	142	145	101	41	44	0.711	.3,0.7,0.8,1-1.6,1.1-1.6,1/2-2/3,2.3-2.9,2.5-3.5,3-8,3-9,30-60,4-10,5-11,8.5-11.5,9-13,acute-tipped,along,annual,anther,arcuate,armed,base,beneath,berry,blade,blue,branched,bristly,broadly,brown,calyx,capitate-glandular,cauline,cm,dark,deltoid,densely,dia,dm,extended,few-rayed,fully,glabrous,gland,glandular,green,hair,herb,internodal,lenticular,linear-lanceolate,lobe,long,longer,low,main,mm,mostly,narrowly,near,obtuse,occasionally,oriented,ovate,pedicel,per,petiole,pinnatifid,pinnatisect,prickly,radially,reticulately,ridge,rounded,scattered,sessile,short-stipitate,simple,sometimes,sparsely,spherical,spreadingly,stellae,stellate-pentagonal,stem,strait,suffused,surface,tapering,terete,terminally,tube,twice,undulate,uniseriate,usually,variously,vein,vestiture,violet,wrinkled	1.8-2.6,6-10,6-10-flowere,accrescent,across,alyx,anthesi,campanulate,developing,difoliate,divided,dry,eaf,eed,enveloped,geminat,high,invested,lon,maturity,nflorescence,orolla,ruit,short,slende,somewhat,splitting,ste,tamen,taprooted,tightly,tigma,tub,tyle,unexpande,unit,vary,wholly,yello,ympodial,younger	6-10-flowered,alternate,apex,arrangement,bark,branch,bud,characteristic,colour,corolla,corrugation,diameter,drying,exertion,filament,form,fruit,fruiting,glabrousnes,growth,height,history,inflorescence,leaf,length,life,lobing,margin,na,new,number,ovary,peduncle,plant,primary,seed,shape,size,slender,stigma,style,texture,type,unexpanded
110	wfo-0001027102	invalid_json_followup	167	144	94	73	50	0.563	.5,0.2-2,0.5,0.5-1,0.5-2,0.5-3,1-1.5,1-2,1-2.5,1.5-2,10-20,15,15-35,2-2.5,3,3-12,3-4,3-5,4-5,<,abaxially,absent,acuman,acuminate,acute,adaxially,almost,anther,apex,base,broadly,calyx,ciliate,cm,connivent,cuneate,curved,cylindrical,deltate,densely,diameter,elliptic,entire,few-,filament,flattened,flower,forked,fruit,fruiting,glabrous,globose,lanceolate,leaf,leaf-opposed,lobe,long-tapered,margin,mm,moderately,narrowly,oblong,obtuse,orange,ovate,pedicel,peduncle,per,petiole,pubescent,rarely,ripe,rugulose,shrub,simple,size,slender,small,somewhat,sparsely,stem,stigma,straight,style,surface,tip,triangular,truncate,tube,unbranched,white,wide,x,yellow-brown	.5-6,1-3,1-4,1-6,2-3,4-7,5-12,absen,accrescent,adaxial,adaxiall,ag,aggregate,alyx,apart,appearance,articulated,axe,ba,blade,broad,cell,channe,chartaceous,congested,corky,differing,difoliate,dimorphic,directed,distally,eaf,eed,free,geminat,giving,hair,ilament,long,longitudinal,m.,major,minor,multiseriate,nflorescence,often,one,opening,orolla,perfect,pore,portion,rachi,roughened,ruit,short,slit,spaced,stellate,stone,subcoriaceous,tal,tem,time,tomentose,truncat,unarme,unit,usually,vary,yellow,ympodial,young	'',[,``,arrangement,bark,branch,bud,characteristic,colour,corolla,corrugation,distal,drying,exertion,form,glabrousnes,green,growth,height,history,inflorescence,interjected,lateral,leaflet,length,life,lobing,midpoint,na,new,number,ovary,perennial,plant,prickle,primary,pseudostipule,ray,seed,shape,terminal,texture,thicknes,type,value,variation,vein,width,{,}
111	wfo-0001027104	success	141	125	72	69	53	0.511	0.15-0.35,0.5-0.8,1-3,1-4,1.2-6,1.5-2.3,1.5-4.2,10-15,2-3,2-6,2.2-5,3-5.5,5-15,6-7.5,abaxially,acuminate,acute,adaxially,apex,apical,articulate,attenuate,base,branched,calyx,cm,cordate,corolla,cyme,dehiscent,diameter,dichasial,dichasially,distal,ebracteate,filament,finely,globose,green,green-white,herbaceous,introrse,lateral,lobe,long,maturing,mm,monochasial,mucilaginous,mucronate,odd-pinnate,often,ovate,ovoid,pedicel,peduncle,perennial,petiole,plant,poricidally,pubescent,seed,short,slit,stigma,style,throughout,tone,truncate,white,wide,yellow-green	1-1.5,3-6-foliat,4-15,acumen,apically,cell,condition,connate,covering,digestion,dorsally,eaf,edge,eed,emoval,enzyme,epiphyti,epiphytic-like,exceeding,flat,flower,folded,forked,generally,globo,growing,hair-like,half,honeycomb,linear,living,lon,lower,make,mos,narrowly,nflorescence,nther,orolla,ovat,pattern,perfect,plan,proximal,rarely,reveal,ruit,seudostipule,simple,specimen,stamen,stellate,straight,tall,tem,terrestrial,testal,thick,throughou,tuber-bearing,typically,unit,vary,viole,wall,without,yellow,ympodial,Â¼	2,anther,appearance,arrangement,bark,border,branch,bud,characteristic,colour,corrugation,drying,exertion,form,fruit,fruiting,giving,glabrousnes,growth,height,history,inflorescence,interjected,leaf,leaflet,length,life,lobing,margin,midpoint,na,new,number,ovary,per,prickle,primary,pseudostipule,ray,shape,size,stem,surface,terminal,texture,thicknes,tube,type,variation,vein,violet,wet,width
112	wfo-0001027114	success	154	113	85	69	28	0.552	-17,-2,-30,.5,1-1.1,1-1.2,1.5-1.7,1/2,13-21,2-2.5,2-3,20-40,3-4,3-7,6-8,6-9,7-9,acute,anther,apex,appearing,bark,base,berry,branched,calyx,capitate,cm,conical,corolla,dark,dendritic,densely,dia,drying,elliptic,erect,exserted,filament,flattened-reniform,flowered,fruiting,glabrous,globose,green,halfway,inflorescence,lateral,leaf,lobed,long,main,many,margin,minutely,mm,opposite,ovary,pair,pedicel,petiole,pitted,poricidal,pubescent,reddish,reddish-brown,shoot-terminal,shrub,size,soft,stem,stigma,style,surface,tapering,thickened,time,tip,trichome,tube,vein,way,white,wide,yellowish	0.5-1,1-1.5,1-2,1.5-2,5,7-10,abaxial,abaxially,adaxially,along,alternating,anthesi,apar,axillary,ba,bushy,closely,commonly,deltate,differing,difoliate,due,eaf,edicel,eed,free,geminate,glabrou,growt,inflorescenc,investing,lamina,like,lobe,lon,lower,major,minor,minute,nflorescence,occasionally,older,opening,papillo,planar,plurifoliate,pore,portion,projection,rapid,rest,ruit,scar,scattered,several,shoot,simple,slit,spaced,tall,triangular,tub,ud,unevenly,uniseriate,unit,woody,ympodial,young	alternate,arrangement,branch,bud,characteristic,colour,corrugation,diameter,exertion,form,fruit,glabrousnes,growth,height,history,length,life,lobing,na,new,peduncle,perennial,plant,primary,seed,shape,texture,type
113	wfo-0001027117	invalid_json_followup	235	160	114	121	46	0.485	-1.5,-12,-2.8,.5,/3,0-10,0-20,0-5,0.1-0.7,0.15-0.35,0.5,0.5-1.5,0.6-0.9,0.7-0.9,0.7-1.3,0.7-1.5,1-2,1.5-2.3,1.7-2.5,1/3,2-3,2-8,2.3-2.8,4-7,4-8,4.5-6.5,4.5-8,5-11,abaxially,acicular,acute,almost,anther,apex,apparently,articulated,attenuate,bark,base,berry,black,branched,brown,calyx,cell,chartaceous,cm,concolorous,cordate,dark,densely,diameter,discolorous,drying,erect,evenly,filament,fine,flattened-reniform,fruit,fruiting,glabrous,green,herb,lateral,leaf,length,less,lobed,long,lower,margin,maturity,mauve,midpoint,mm,moderately,narrow-deltate,narrow-lanceolate,oblong,outline,ovate,pair,pale,pedicel,peduncle,per,petiole,pit,prickle,prickly,primary,raised,ray,red-brown,rounded,shallowly,small,smooth,spherical,stellate-pubescent,stem,style,surface,tapering,trichome,tube,vein,way,weakly,wide,yellow,yellow-green,young	-11,-3/4,0-15,0-25,0-40,0.1,0.1-,0.15-0.25,0.2,0.2-0.45,0.8-,1-4,1-6,1.2,1.5-,1.5-6.5,1.8-2.5,1/,1/4,1/8-1/2,10-20,2-6,25-100,3-10,3-15,3-6,4-6.5,5-14,5-merous,6-10,6-9,7-,8,accrescent,alyx,ame,apar,apart,apically,beyond,blade,brittle,c.,connivent,curved,deltate,distance,eaf,eed,elongating,enclosing,extending,fifth,flower,four,free,gently,glabrescent,gra,herbarium,infructescence,irregularly,lobe,lon,long-acuminat,longer,mature,membranous,midvein,narrow-elliptic,nflorescence,obovate,older,one,open,orolla,oung,pendulous,perfec,pericarp,perpendicular,plurifoliat,poricidal,porrect,portion,prickl,reduced,reflexed,ruit,scar,sessile,shiny,shorter,side,sometimes,spaced,sparsely,specimen,spreading,stalk,stalked,staman,stellate,straight,tamen,tearing,terete,tertiary,time,tip,tissue,translucent,unequal,unit,upper,variously,vary,venation,visible,woody,ympodial	'',0.8-6.5,1.5-14,10-25,[,``,arrangement,branch,bud,characteristic,colour,corolla,corrugation,distal,exertion,form,glabrousnes,gray,growth,height,history,inflorescence,interjected,leaflet,life,lobing,na,new,number,ovary,perennial,plant,pseudostipule,seed,shape,size,stigma,terminal,texture,thicknes,type,value,variation,width,{,}
114	wfo-0001027123	invalid_json_followup	181	156	110	71	46	0.608	-10,-20,.3,0.5,0.7-3.5,0.8-1.3,1,1-1.2,1.5-2,2-2.2,2-2.5,2-2.6,2-3,2-5.5,2-lobed,2.5-10.4,2.5-6,3-15,3-4,4-5,4-6,5-10,5-6,acute,adaxially,along,anther,apex,attenuate,axe,bark,base,branched,bright,brown,calyx,clavate,cm,commonly,completely,conical,constricted,coriaceous,corolla,cup-shaped,dark,darker,diameter,drying,elliptic,exerted,filament,flattened,flower,fruiting,glabrous,globose,green,inflorescence,lamina,leaf,less,long,loose,loosely,margin,mauve-purple,minutely,mm,narrowly,nodding,ovary,pair,papillate,pedicel,peduncle,petiole,pitted,primary,pubescent,reddish,reniform,revolute,scattered,shining,shiny,simple,sometimes,soon,sparsely,stellate,stem,stigma,stoutish,strongly,style,subshrub,surface,terminal,thick,time,trichome,tube,turned,vein,violet,way,white,x,young	.5,0.3-1.6cm,0.5-0.8,0.9-1.3,1-1.5,2.5-4,abaxial,adaxial,anthesi,appearing,axi,broadly,campanulate,cell,deltate,dendritic,densely,denser,eaf,edge,eed,enlarged,erect,fide,free,glandular,inserted,lax,lewi,like,lobe,lobed,lon,lower,midvein,minute,monopodia,nflorescence,older,outline,papillae,perfect,perhaps,petal,planar,plurifoliate,portion,prominent,scar,scatted,shin,shinin,short,sinuate,sleeve,slightly,spaced,straight,testal,tip,trailing,tub,ud,unit,upper,usually,warty,widely,wood,ympodial,Â¾	'',0.3-1.6,[,\u00be,``,arrangement,berry,branch,bud,characteristic,colour,corrugation,distal,exertion,form,fruit,glabrousnes,growth,height,history,interjected,lateral,leaflet,length,life,lobing,midpoint,na,new,number,per,plant,prickle,pseudostipule,ray,seed,shape,size,texture,thicknes,type,value,variation,width,{,}
115	wfo-0001027146	invalid_json_followup	213	160	117	96	43	0.549	0-11,0.3-2.2,0.5-3.2,0.7-2.4,0.8,0.8-5.8,1-2,1-2.5,1-9.5,1.9-10,10,13-36,2-12.2,2-13,2-4.2,3.3-6.1,3.5-22,4-11,4-12.5,4-38,4-8,6,6-10,6.5-52,abaxially,acuminate,adaxially,anther,apex,attenuate,axillary,base,berry,brownish,bud,cell,clavate,cm,coarsely,condition,conical,connivent,corolla,covering,dark,deep,diameter,distal,drying,elliptic,filament,finely,flower,forked,fresh,fruit,generally,glabrous,green,green-white,greenish,hair,half,herb,interjected,lanceolate,lateral,leaf,leaflet,like,lobe,long,make,margin,medium,minute,mm,mottled,mucilaginous,odd-pinnate,ovate,ovoid,pedicel,peduncle,petiole,petiolule,plant,puberulent,pubescent,purple,ray,ripe,seed,simple,size,stem,stigma,style,subglabrous,subsessile,subtending,terminal,testal,thick,throughout,tinged,tube,unwinged,usually,violet,wall,wet,white,whitish,wide,wing,x	0.6-3.3,0.8-3.1,1-10,2-5,5-merou,6-17.5,acumen,ag,along,alyx,apart,apparently,arranged,articulated,asymmetrical,axe,basiscopic,bead,blade,capitat,chartaceous,ciliate,commonly,darker,decreasing,digestion,dorsally,eaf,edge,eed,enzyme,erec,especially,exceeding,flat,folded,fourt,fourth,geminat,glabrou,gradually,hair-like,homostylous,honeycomb-shaped,lengthening,living,lower,membranous,midrib,minutely,moniliform,multiple,necklace,nflorescence,orbicular,orolla,pair,pentagonal,perfect,plurifoliate,pore,poricidal,proximal,rarely,removed,rotate,ruit,secondary,semierect,sessile,seudostipule,side,slit,sometimes,spaced,specimen,stamen,ste,stolon,straight,subequal,subglabrou,symmetrical,tall,tamen,tem,tip,tissue,toward,tri-,tuber,typically,unit,vary,yellow,ympodial	'',[,\u201chair-like\u201,``,arrangement,bark,branch,capitate,cayx,characteristic,colour,corrugation,exertion,form,fruiting,glabrousnes,growth,height,history,inflorescence,length,life,lobing,midpoint,na,new,number,ovary,per,prickle,primary,pseudostipule,shape,surface,texture,thicknes,type,value,variation,vein,width,{,}
116	wfo-0001027157	success	207	132	97	110	35	0.469	0-3,0.15-0.3,0.9-2.8,1,1-2,1-3,1-6,1.5-6.5,10-30,2-15,2-2.5,2-3,2-5,2.3-4,2.5-3,3-7,3.8-8.3,4-5,9-12,absent,anther,articulated,base,berry,broadly,brownish,cell,chartaceous,clavate,cm,condition,conical,corolla,covering,deeply,densely,diameter,drying,elliptic,end,filament,flower,forked,fresh,fruit,generally,glabrous,green,greenish,hair,hair-like,herb,homostylous,interjected,lanceolate,lateral,leaf,leaflet,like,lobe,long,membranous,mm,odd-pinnate,one,ovate,ovoid,pair,pedicel,peduncle,petiole,placed,plant,puberulent,pubescent,ripe,seed,size,sometimes,stellate,stem,stigma,straight,style,terminal,testal,thick,tinged,tube,tuber,typically,violet,wall,white,whitish,wide,x	0.7-2,1-10,1-3.8,2,3-12,3.3-7.8,5-merou,6.5-14.5,abaxially,acumen,acuminate,acute,adaxially,ag,along,alyx,among,apart,apex,apparently,attenuate,axe,axillary,blade,bud,capitat,ciliate,connivent,cordate,cuneate,decreasing,decurrent,digestion,distal,dorsally,eaf,edge,eed,enzyme,erec,especially,exceeding,flat,folded,geminat,glabrou,grassland,greatly,green-white,half,honeycomb-shaped,lengthening,living,low-growing,lower,make,margin,markedly,middl,midrib,minutely,mucilaginous,narrowly,nflorescence,oblique,obtuse,orbicular,orolla,perfect,petiolulate,petiolule,plurifoliate,pore,poricidal,rarely,removed,rounded,ruit,semi-rosette,sessile,seudostipule,shady,short,situation,slightly,slit,spaced,specimen,stamen,ste,stolo,subsessile,subtending,sunny,tall,tamen,tem,throughout,tip,toward,tri-,unequal,unit,unwinged,usually,vary,wet,woodland,yellow,ympodial	abaxial,adaxial,appearance,arrangement,border,calyx,capitate,colour,corrugation,form,giving,growth,height,history,inflorescence,length,life,middle,midpoint,na,number,ovary,per,placement,prickle,pseudostipule,ray,shape,stolon,surface,texture,thicknes,type,variation,width
117	wfo-0001027184	invalid_json_followup	219	191	145	74	46	0.662	.3,.5,.7,.8,0.2-0.4,0.4-2,0.8,0.8â1.6,1.5,1.5-5,1.8â3.5,13â18,19,1â2,1â2.5,1â4,2,2.8â4.1,2â4-celled,3-4-,3-foliolate,3.5â8,3â,4,4â12,5,7,abaxially,absent,acute,adaxially,along,anther,apex,articulated,axi,axillary,base,blue,borne,bract-like,branch,broad,brown,calyx,cm,connivent,covered,densely,diameter,directed,entire,epidermal,especially,extension,filament,flattened,fleshy,flower,fruit,fruiting,generally,glabrescent,glabrous,globose,grading,hair,hairlike,half,herbaceous,imparipinnate,introrsely,lanceolate,lateral,leaf,leaflet,leafy,least,light,long,longitudinal,lower,margin,membranous,meter,midrib,minutely,mm,mostly,nearly,oblong,obtuse,often,older,opening,orange,pedicel,peduncle,per,petiole,pilose,plurifoliate,pore,prominently,pseudostipule,puberulent,pubescent,raised,rarely,red,reticulate,revolute,ripe,several,shape,shoot,short,simple,size,slightly,slit,small,soft-woody,somewhat,sparsely,stem,stigma,style,sulcate,surface,terminal,tertiary,tip,truncate,tube,unbranched,unequal,vein,vine,wall,white,x,yellow,young,â9	0-,0-0.2,0.4â0.9,0.5-2,0â3,1-2,3â4-celled,5-7,9,accrescent,adaxiall,adventitious,ag,always,alyx,apart,appressed,axe,ba,basal,blade,broadly,cell,chartaceous,clavat,cluster,cordat,cylindrical,eaf,eed,elliptic,fasciculate,foliaceous,free,geminat,glabrou,ilament,larger,largest,less,like,lobe,m.,much,narrowly,nflorescence,node,opposite,orolla,ovate,ower,petiolule,portion,prominent,rachi,root,ruit,scarcely,secondary,spaced,stellate,straight,subopposite,tightly,tree,trunk,unarme,uniform,unit,usually,vary,visible,weak,ympodial	'',[,``,age,arrangement,bark,bud,characteristic,clavate,colour,corolla,corrugation,distal,drying,exertion,form,geminate,glabrousnes,green,growth,height,history,inflorescence,interjected,length,life,lobing,midpoint,na,new,number,ovary,plant,prickle,primary,ray,seed,texture,thicknes,type,unarmed,value,variation,width,{,}
118	wfo-0001027186	success	168	118	94	74	24	0.56	.4,.5,1-1.5,1-2.5,1.4-1.6,1.5,1.5-2,1.6-5,15,2-6,2-lobed,2.5-3,4-15,5-10,6-7,9-10,?,acute,anther,apex,attenuate,bark,base,berry,branch,broadly,brown,calyx,clavate,cm,conical,corolla,dark,dendritic,diameter,ellipsoid,elliptic,entire,exerted,filament,filiform,fruit,fruiting,glabrescent,glabrous,globose,green,growth,immature,less,longer,margin,maturity,minutely,mm,much,narrowly,new,ovary,ovoid,pair,pale,pedicel,peduncle,petiole,pitted,pointed,poridical,primary,pubescent,reddish,reniform,seed,shiny,simple,slightly,soon,sparsely,spreading,stem,stigma,strongly,style,surface,terminal,tip,tree,treelet,tube,vein,way,white,x,yellow	-6,0.5-1,1.5-2.5,3-4,3.5-4,30-40,4-9,abaxial,abaxially,adaxially,age,always,anthesi,apart,apparently,axil,branched,dbh,deflexed,deltate,denditic,densely,denser,dry,eaf,enlarging,flower,free,golden,incrassat,irregularly,keeled,lamina,lengthening,like,lobe,lobed,loose,lower,m.,midrib,nflorescence,occasionally,papillat,papillate,pendent,perfect,pericarp,planar,plane,plurifoliat,pore,portion,pubescen,rachi,rough,ruit,scar,scattered,short,slit,small,spaced,stalk,straight,time,trichome,tub,ud,uniseriate,unit,variably,woody,ympodial	arrangement,bud,characteristic,colour,corrugation,drying,exertion,form,glabrousnes,height,history,inflorescence,leaf,length,life,lobing,na,number,per,plant,shape,size,texture,type
119	wfo-0001027198	invalid_json_followup	191	155	101	90	54	0.529	0.05-1.0,0.8-1,1-1.5,1-10,1.5-10,10-11,11-20,3/4,5-120-flowered,5-6,7.5-9,acuminate,acute,anther,apex,attenuate,axil,base,beneath,berry,calyx,channeled,clavate,cm,complex,corolla,cyathiform,decurrent,dendritic,dia,elliptic,entire,exserted,extremely,filament,flower,fruiting,furcate,glabrate,glabrous,globose,golden,green,inflorescence,large,lateral,leaf,lobe,lobed,long,main,many,margin,minute,minutely,mm,obovate,often,opposite,ovary,ovoid,ovoid-reniform,pale,paler,pedicel,petiole,pitted,plant,puberulent,pubescent,set,shaped,shining,short,shrub,simple,size,slender,slightly,soon,speciman,stem,stigma,straight,style,styled,surface,tannish-yellow,tear-drop,time,trichome,tube,two,type,uniseriate,vein,way,white,x,yellowish,young	.4,.5,0.5-0.75,0.5-1,0.7-1,1-5,1.5-2,2-5.5,4-9,abruptly,always,anthesi,apart,ba,beginning,broadening,bushy,caly,closely,constriction,corky,corresponding,deltoid,densely,differing,difoliate,dry,eaf,edge,edicel,eed,erect,evenly,eye,female,found,free,geminat,impressed,inflorescenc,invisible,like,live,lon,lower,major,male,medium,meet,middle,minor,naked,nearly,nflorescence,older,overlapping,papillo,papillose,pendan,planar,pore,poricidal,portion,pubescence,rather,reddi,reflexed,rest,rounded,ruit,scar,sessile,small,spaced,specimen,strong,tall,testae,thickened,thin,tip,top,tree,ud,undersurface,unit,usually,widest,woody,ympodial	'',0.4,2.5,3.5,5,[,``,alternate,arrangement,bark,branch,bud,cal,characteristic,colour,corrugation,dense,diameter,distal,drying,exertion,form,fruit,glabrousnes,growth,height,history,interjected,leaflet,length,life,lobing,midpoint,na,new,number,peduncle,per,perennial,prickle,primary,pseudostipule,ray,reddish,seed,shape,terminal,texture,thicknes,value,variation,width,{,}
120	wfo-0001027200	invalid_json_followup	139	143	95	44	48	0.683	0.05-0.25,0.25-0.5,0.5-0.75,0.5-1,0.6-1,0.7-2.5,1-1.4,1-1.5,1.2-1.5,1.5-2,1.5-5,1.6-6,2-3,2.5-3,3-3.5,3.5-6,6-8,8-15,acute,anther,apex,bark,base,beneath,berry,branch,broadly,brown,calyx,capitate,cm,conical,corolla,dark,decurrent,deeply,deltoid,densely,dia,elliptic,except,filament,flattened,fruiting,giving,glabrous,globose,golden,green,grey-brown,horizontally,impressed,inflorescence,lateral,leaf,lobe,lobed,long,major,margin,minor,minute,mm,nearly,non-reproductive,onto,ovary,ovoid-reniform,pedicel,petiole,pitted,prominent,puberulent,shaped,shrub,size,slightly,small,sparsely,spreading,stem,stigma,style,surface,tear-drop,tree,trichome,tube,unicellular,unifoliate,uniseriate,vein,white,x,yellowish	9-11,across,anthesi,aspec,ba,branche,converging,deflexed,differing,eaf,eed,free,geminate,lightly,like,lon,lower,main,middle,minutely,near,node,occasionally,older,papillo,papillose,planar,pore,poricidal,portion,reflexed,rest,ruit,sparse,straight,tall,tip,unit,widened,widest,winged,woody,ympodial,young	'',[,``,appearance,arrangement,aspect,border,bud,characteristic,colour,corrugation,diameter,distal,drying,exertion,form,fruit,glabrousnes,growth,height,history,interjected,leaflet,length,life,lobing,midpoint,na,new,number,peduncle,per,plant,prickle,primary,pseudostipule,ray,seed,shape,terminal,texture,thicknes,type,value,variation,width,{,}
121	wfo-0001027213	invalid_json	231	119	87	144	32	0.377	-19,-3.3,0-2.5,0.2-0.4,1-2,1-5,1.1-1.7,1.2-2.5,12.3-16.3,2-5,2.5-5.1,4-9.5,5-7.5,5.7-6.2,abaxially,acute,adaxially,anther,anthesi,apex,attenuate,base,blunt-tipped,branch,branched,broadly,brown,cm,conical,corolla,cuneate,dark,deltoid,diameter,early,elliptic,entire,exserted,filament,flower,fruit,glabrescent,globose,granular,grayish-brown,green,lanceolate,leaf,length,many,margin,mm,moderately,oblanceolate,obovate,orbicular,ovate,ovate-lanceolate,pale,pedicel,peduncle,petiole,pubescent,relatively,reniform,reticulate-punctate,scabrous,short-attenuate,shrub,simple,stem,stigma,style,surface,terete,time,tomentose,tree,unarmed,violet,white,whitish,whitish-green,x,yellow-green,yellow-tan,yellowish	-230,-4.5,/10,0-160,0.2-0.5,0.7-2.3,0.8-1.8,1.2-1.6,1.2-1.7,1.3-2.2,1.7-3.6,1.7-3.9,1.8-2.8,1.8-3.2,1/2-2/3,10-24,2.4-4.7,2.9-3.8,2.9-4.8,2/3,3.5-5,3.5-8,4.2-5.9,5-8,5-merou,8-24,8.2-10.5,9-13,accrescent,acuminate,ag,along,alyx,apart,apparently,ark,around,articulated,axe,axillary,ba,basal,blade,calyx,capitat,cell,completely,covering,cylindrical,decurrent,directed,distally,drying,eaf,edge,eed,enveloping,epidermal,eventually,farinose,few-rayed,free,fruiting,glabrescen,glabrous,group,hair,high,homostylous,immature,inserted,lackin,lateral,lengthening,lobe,lobed,long,long-,long-stalked,longitudinal,lower,m.,main,midrib,mixed,mostly,multangulat,multangulate,nearly,nflorescence,obscured,obtuse,often,older,orolla,partly,perfect,plurifoliate,pore,poricidal,porrect-stellat,porrect-stellate,prominent,pseudo-terminal,pubescence,rachi,rather,ruit,sessile,short,short-,short-stalked,side,slit,sometimes,somewhat,spaced,sparsely,stamen,stellate,subcampanulate,suture,tamen,thick,thick-stalked,thin-stalked,ti,tip,tomentose-pubescent,tomentu,touching,tube,ud,unarme,unit,unwinged,vary,vein,vestigial-rayed,way,wide,yellow,ympodial,young	'',[,],``,arrangement,bark,bud,capitate,characteristic,colour,exertion,form,glabrousnes,growth,height,history,inflorescence,life,lobing,new,ovary,perennial,plant,pseud-terminal,seed,shape,size,texture,type,value,{,}
122	wfo-0001027214	invalid_json_followup	181	146	98	83	48	0.541	-20,-38,.5,0,0.5-0.8,0.5-1,0.8-1,1-1.5,1-2.8,1.2-3,1.5,1.5-1.8,10-,10-13,12-17,15-25,2,2-9,3-6,6-,6-12,7-12,abaxially,absent,adaxially,anther,apex,base,berry,broadly,calyx,climbing,cm,conical,conspicuously,corolla,deltate,densely,diameter,drying,elliptic,erect,filament,finely,flattened-round,flower,fruit,fruiting,glabrous,globose,green,greenish,height,herb,inflorescence,lateral,leaflet,length,lobe,lobed,long-acuminate,long-conical,margin,minutely,mm,nearly,nodding,oblique,obovate,occasionally,once-branched,open,ovary,pedicel,per,petiole,pinnate,pointed,poricidal,pubescent,rugose,seed,sharply,simple,somewhat,stigma,style,surface,terminal,time,tip,triangular,truncate,tube,vein,white,white-lenticellate,x	-9,..,.25,0-16,0.25,0.3-1.5,0.3-1.7,0.7-2,0.7-2.5,1.5-6,3-,4-5,5-6,8-9,acuminate,acute,along,anthesi,anticlinal,apical,basal,capitat,cell,composed,decurrent,dr.,eaf,edicel,eed,epidermal,exserted,extending,free,groove,grown,horizontal,inflorescenc,irregular,lamina,lanceolate,less,like,lon,long,lower,markedly,midrib,narrowly,nflorescence,noddin,often,onto,opposite,pair,paired,papilla,papillate,perfectly,petiolule,portion,projection,rachi,reflexed,rest,rugosity,ruit,scar,scattered,scrambling,sinuous,smaller,tem,thickening,trichome,tub,ud,unevenly,unifoliat,uniseriate,unit,whitish,without,ympodial	'',.0,2.0,[,``,appearance,arrangement,bark,border,branch,bud,capitate,characteristic,colour,corrugation,distal,dry,exertion,form,giving,glabrousnes,growth,history,interjected,leaf,life,lobing,midpoint,na,new,number,peduncle,plant,prickle,primary,pseudostipule,ray,shape,size,stem,texture,thicknes,type,value,variation,width,{,}
123	wfo-0001027219	success	143	132	104	39	28	0.727	.5,/4,0.3,0.4-0.6,0.5,0.5-0.8,1-15,1-3,1.5-2,1.5-2.5,2,2-3,2-3.5,2-4,3-5,3-6,6-8,7-8,absent,acuminate,acute,age,anther,anthesi,apex,axillary,bark,base,berry,bright,broadly,brown,c.,calyx,capitate,cm,completely,conical,corolla,cup-shaped,densely,diameter,drying,edge,elliptic,entire,erect,filament,flower,fruiting,glabrescent,glabrous,globose,green,greyish,growth,hard,leaf-opposed,lengthening,less,long-conical,long-styled,margin,maturity,minutely,mm,new,ovary,pair,pale,pedicel,peduncle,petiole,pore,poricidal,primary,pubescent,purple,shoot,short,short-styled,shrub,simple,slightly,slit,soon,stem,stigma,stout,style,surface,terminal,thickened,tip,trichome,tube,uniseriate,vein,violet,way,white,x,yellowish,â1/3	1,1-2,2-2.5,berr,closely,deltate,eaf,eed,exerte,exfoliatin,free,glabrou,heterostylous,known,lobe,lobed,lower,nflorescence,overlappin,papillo,papillose-pubescent,pendent,pericarp,planar,plurifoliat,pointed,portion,ruit,scar,sharply,sometimes,somewhat,spaced,tuft,ud,unit,weight,woody,ympodial	arrangement,branch,bud,characteristic,colour,corrugation,exerted,exertion,form,fruit,glabrousnes,height,history,inflorescence,leaf,length,life,lobing,na,number,papillose,per,plant,seed,shape,size,texture,type
124	wfo-0001027223	invalid_json_followup	189	150	103	86	47	0.545	.5,0.19-0.75,0.3-1.2,1-2,1.3-2,1.5-3.5,1.8-3.5,16-41,3-10,3-5.2,3.5-4,3.5-6,3.5-7,3.7-9.3,4-6,5-21,5-8,5.9-12.2,9-22,abaxially,acuminate,adaxially,anther,apex,attenuate,axillary,base,berry,brownish,bud,cell,clavate,cm,condition,conical,connivent,corolla,covering,deep,densely,diameter,distal,dot,drying,elliptic,filament,forked,fresh,fruit,generally,glabrous,green,green-white,greenish,hair,half,herb,hyaline,interjected,lanceolate,lateral,leaf,leaflet,light,lobe,long,make,mm,mucilaginous,odd-pinnate,ovate,ovoid,pedicel,peduncle,petiole,plant,poricidal,pubescent,purple,ripe,rounded,seed,size,sometimes,stigma,stripe,style,subtending,terminal,testal,thick,throughout,tip,tube,unwinged,usually,wall,wet,white,whitish,wide,x,yellow	1-3,2-4,2-7,3-11,3-5,5-10,5-merou,9-15,9-35,acumen,adaxiall,ag,alyx,apart,apparently,articulated,asymmetric,axe,basiscopic,blade,capitat,decreasing,digestion,dorsally,eaf,edge,eed,end,enzyme,erec,exceeding,flat,flower,folded,geminat,glabrou,hair-like,hal,homostylous,honeycomb-shaped,larger,lengthening,like,living,lower,middle,nflorescence,one,orbicular,orolla,pair,pentagonal,perfect,petiolulate,placed,plurifoliate,pore,present,removed,rotate,ruit,sessile,seudostipule,short,shortly,side,slightly,slit,spaced,specimen,stamen,ste,stolo,straight,subequal,tall,tamen,tem,tissue,toward,tri-,tuber,typically,unit,vary,ympodial	'',[,\u201chair-like\u201d,``,arrangement,bark,branch,calyx,capitate,characteristic,colour,corrugation,erect,exertion,form,fruiting,glabrousnes,growth,height,history,inflorescence,length,life,lobing,margin,midpoint,na,new,number,ovary,per,prickle,primary,pseudostipule,ray,shape,stem,surface,texture,thicknes,type,value,variation,vein,width,{,}
125	wfo-0001027237	success	122	120	73	49	47	0.598	.5,/4,1-1.2,1.5-2,1.5-2.5,2-3,3-3.5,3-4,30-100-flowered,6-11,6-8,8,anther,bark,base,berry,black,branched,brown,calyx,clavate,cm,completely,corolla,cup-shaped,dark,deflexed,dia,drying,ellipsoid,exsertion,filament,flattened,fruiting,glabrous,globose,green,greenish-white,inflorescence,internodal,later,leaf,lobe,long,many,margin,minutely,mm,ovary,paler,pedicel,pitted,regularly,reniform,shaped,shining,shrub,slender,small,stem,stigma,style,surface,tapering,tear-drop,terminal,time,tree,tube,way,white,x,x.	0.5-1,5,anthesi,apart,apiculae,apiculate,appearing,ba,blac,branc,broadly,cucullate,deltoid,difoliate,edicel,eed,erect,free,geminate,greyi,lobed,lower,nflorescence,occasionally,older,papillate,papillo,papillose,part,plurifoliat,pore,poricidal,portion,reflexed,regulary,ruit,scar,spaced,straight,tall,tip,ud,unit,upper,usually,widely,woody,ympodial,young	apex,appearance,arrangement,border,branch,bud,characteristic,colour,corrugation,diameter,distal,exertion,form,fruit,giving,glabrousnes,greyish,growth,height,history,interjected,lateral,leaflet,length,life,lobing,midpoint,na,new,number,peduncle,per,petiole,plant,prickle,primary,pseudostipule,ray,seed,shape,size,texture,thicknes,type,variation,vein,width
126	wfo-0001027238	invalid_json_followup	204	168	121	83	47	0.593	-25,.3,.5,0-1,0-1.5,0.3-0.8,0.3-5,0.5-1,0.5-16,0.5-2,1-1.5,1-2,1.5-3,1.5-4,10,15-30,2-4,3-4,3-6,4-10,4-5,5-15,6-15,6-8,abaxially,acuminate,acute,adaxially,anther,apex,base,berry,black,blade,branch,brown,calyx,chartaceous,cm,connivent,cuneate,dark,deltate,densely,diameter,elliptic,elliptic-ovate,entire,extra-axillary,filament,flattened,fleshy,flower,fruit,fruiting,glabrous,gland,globose,green,greenish,hair,lavender,leaf,light,lighter,lobe,long,major,margin,membranaceous,midpoint,minutely,mm,multangulate,narrowly,near,nearly,new,oblique,oblong,obtuse,outline,pale,pedicel,peduncle,petiole,pitted,porrect-stellate,pubescent,purple,ray,reniform,ripe,rounded,scandent,sessile,shiny,shrub,side,simple,small,sometimes,sparse,sprawling,stellate-pubescent,stem,stigma,strongly,style,surface,tip,tree,triangular,tube,unbranched,vein,white,whitish,x,yellow,yellowish	-5,0-0.7,0.3-0.5,0.3-1,1.5-7,2-3,3-5,4-,4-16,4-8,5-7,5-merou,accrescent,adaxiall,ag,alyx,apparently,articulated,axe,ba,capitat,contiguous,covering,cylindrical,differentiated,directed,discolorous,distally,eaf,eed,equal,foliaceous,fork,free,frui,geminate,glabrescent,gland-tipped,growt,homostylous,interpetalar,introrsely,juic,large,like,longitudinal,lower,minor,mixed,nflorescence,often,one,opening,orolla,paired,part,perfect,pericarp,plurifoliate,pore,rachi,ruit,short-stalked,similar,slit,somewhat,sparsely,ste,stellate,straight,subtending,tamen,tem,time,tissue,toward,unarme,unequal,unit,vary,wide,without,ympodial	'',[,``,arrangement,bark,bud,capitate,characteristic,colour,corolla,corrugation,distal,drying,exertion,form,glabrousnes,growth,height,history,inflorescence,interjected,lateral,leaflet,length,life,lobing,na,number,ovary,per,plant,prickle,primary,pseudostipule,seed,shape,size,terminal,texture,thicknes,type,unarmed,value,variation,width,{,}
127	wfo-0001027244	invalid_json_followup	294	148	117	177	31	0.398	-12,-2,-3.2,0.05,0.07-0.15,0.2-1,0.3-0.6,0.45-0.6,0.5,0.5-0.8,0.7-1.5,0.9-1.3,1,1-3.5,1.1-1.3,1.2-1.6,1.5-2.1,1.5-2.4,1.5-6.5,1.7-3.0,1/2,2.1-8,3.5-13,3/4,4-12,5-10,acute,anther,anthesi,apex,articulated,base,berry,bifurcate,branched,broadly,brown,calyx,capitate,cell,cm,conical,cordate,corolla,crenate,curved,dark,decurrent,densely,dentate,diameter,distal,elliptic,exserted,filament,fruit,fruiting,globose,green,greenish,hair-like,half,halfway,herb,imparipinnate,inflorescence,interjected,interrupted,irregularly,lateral,leaflet,length,lobe,lobed,lobing,long,margin,middle,minute,mm,oblique,obovate,often,orbicular,outgrowth,ovary,pedicel,peduncle,perennial,petiole,primary,pubescent,purple,rotate-stellate,rounded,simple,size,somewhat,stem,stigma,stripe,strongly,style,surface,terminal,testa,thick,truncate,tube,vein,velvety,vivid,wall,white,wide,woody,yellow	-1.2,.5,0-,0.02-,0.04-,0.05-1,0.1-,0.1-0.3,0.1-0.5,0.1-0.6,0.15-0.2,0.2,0.2-,0.25-0.4,0.3,0.3-0.4,0.3-0.5,0.3-0.8,0.4-,0.4-0.6,0.4-1,0.5-1,0.6-0.9,0.6-09,0.7-1,0.7-2,0.7-3,0.8-1.2,0.9-1.7,1-2-celled,1-2.5,1-celled,1.5-2,2-,2-4,2-4-celled,2-9,2-foliate,2-locular,3-5,4-celled,5-,5-9-celled,7-12,8-16,8-celled,abaxially,absent,abundance,abundant,acroscopically,acuminate,adaxially,adpressed,alfway,along,also,always,amongst,angled,apical,apparently,appearance,appendage,arequipa,around,articulatio,articulation,axi,basal,berr,bract,bracteate,c.,cage,column,common,deciduous,decumbent,deeper,deltate,dense,density,developed,diamete,eaf,edicel,eed,eglandular,either,elliptical,erect,extremely,flower,flushed,forming,general,giving,glabrescent,glabrous,gland,glandular,gree,head,hyaline,internode,investing,lamina,lanceolate,larger,largest,leave,like,lon,longer,lower,midvein,mixed,mixture,multicellular,narrowly,near,node,occasionally,onto,pair,papillate-pubescent,patent,petiolule,population,present,pseudostipule,rachi,reflexed,rest,ripe,ruit,scattered,secondary,sessile,shaggy,short,shorter,silky,sinus,slender,small,sometimes,sparse,sparsely,sparser,spreading,staminal,sterile,stout,straight,tall,tem,tertiary,tiny,tip,tipped,toward,trichome,two,ud,undulate,unicellular,uniseriate,unit,united,upper,usually,variable,variety,winged,ympodial	'',0.7-1.6,0.8,[,``,arrangement,bark,branch,bud,characteristic,colour,corrugation,drying,exertion,form,glabrousnes,growth,height,history,leaf,life,na,new,plant,seed,shape,texture,type,value,{,}
128	wfo-0001027248	invalid_json_followup	158	155	109	49	46	0.69	.5,0,0.5-1,0.5-2.5,0.7-1.2,1-1.5,1-2,1-5,2-2.5,3-4,3-7,3-7-flowered,3.5-4,5-5.5,6-13,6.5-8,7-9,abaxially,acute,adaxially,anther,apex,appearing,arachnoid,arachnoid-pubescent,area,bark,base,beige,beneath,berry,broadened,broadly,brown,brownish,calyx,cm,conical,corolla,dark,deflexed,densely,dia,difoliate,dirty,ellipsoid,elliptic,erect,exserted,felty,filament,fruit,fruiting,geminate,glabrescent,glabrous,globose,grayish-green,green,later,lateral,leaf,lightly,lobe,lobed,long,main,margin,merely,minutely,mm,nearly,node,occasionally,ovary,ovoid-reniform,pair,pale,patch,pedicel,per,petiole,pitted,pubescence,pubescent,scattered,shaped,shrub,simple,size,small,somewhat,soon,sparsely,stem,stigma,strongly,style,surface,tear-drop,top,tree,trichome,tube,unifoliate,vein,white,wide,winged	1-3,2-4.5,4-8,abaxial,along,anthesi,ape,arachnoid-pubescen,brownish-gra,closely,deltate,denser,differing,eaf,edicel,eed,fleshy,free,impressed,lamina,lower,major,minor,nflorescence,older,opposite,overlappin,papillo,papillose,planar,pore,poricidal,portion,present,ruit,scar,shoot,spaced,specimen,tall,thick,tip,tub,ud,unit,wid,woody,ympodial,young	'',[,``,arrangement,branch,brownish-gray,bud,characteristic,colour,corrugation,diameter,distal,drying,exertion,form,glabrousnes,growth,height,history,inflorescence,interjected,leaflet,length,life,lobing,midpoint,na,new,number,peduncle,plant,prickle,primary,pseudostipule,ray,seed,shape,terminal,texture,thicknes,type,value,variation,width,{,}
129	wfo-0001027258	invalid_json_followup	178	151	106	72	45	0.596	/4,0.5-1,0.6-2,0.9-1.3,1-1.5,1-2.3,1.2-2,1.5-1.6,2-2.5,3-6,3.5-4,4-5,4.5-5,5-10-flowered,6-8,7-13,7-9,abaxially,abruptly,acuminate,acute,adaxially,age,along,anther,apex,attenuate,bark,base,berry,broadly,calyx,capitate,cm,corolla,decurrent,densely,dia,drying,ellipsoid,elliptic,entire,filament,flattened-reniform,fruit,fruiting,glabrous,globose,green,greenish-yellow,large,lateral,leaf,length,lengthening,lenticel,lobe,lobed,long,main,margin,minutely,mm,onto,ovary,ovate,pair,pale,papillose,pedicel,petiole,pitted,pore,poricidal,pubescent,reddish,scattered,shrub,simple,size,slender,slightly,slit,small,sparsely,stem,stigma,straight,style,surface,swollen,tip,treelet,trichome,tube,tuft,uniseriate,urceolate,vein,way,white,widening,winged,x,yellowish,yellowish-tan	.25,.5,0.25-0.5,1-4,2.5-8,3-4,anthesi,apar,apical,apiculae,axil,ba,beneath,crystal,darker,deflexed,deltate,dense,deposit,differing,difoliate,dissecting,eaf,edicel,eed,enlarge,evenly,exserted,extending,fide,fragrant,free,geminat,glabrou,incrassate,internodal,lamina,lower,major,microscope,middle,minor,minute,nee,nflorescence,occasionally,often,older,opposite,papillo,planar,portion,projection,prominent,red-papillose,ruit,sand,scar,spaced,speck,strongly,sweetly,tall,tiny,tub,ud,unit,visible,widest,woody,ympodial,young	'',[,``,alternate,arrangement,branch,bud,characteristic,colour,corrugation,diameter,distal,exertion,form,glabrousnes,growth,height,history,inflorescence,interjected,leaflet,life,lobing,midpoint,na,new,number,peduncle,per,plant,prickle,primary,pseudostipule,ray,seed,shape,terminal,texture,thicknes,type,value,variation,width,{,}
130	wfo-0001027260	invalid_json_followup	176	150	93	83	57	0.528	-60,0.25-1,0.5-3,0.5-6.5,0.8-2,1-,1-2,1-3,1-4,1.5-13,2-18,2-2.5,2.5-14,2.5-3.5,3-4.5,3-6,3.5-25,4-25,4-32,5-40,abaxially,acuminate,acute-,adaxially,age,also,apex,basal,base,berry,beyond,branched,clavate,cm,cordate,cylindrical,darker,densely,diameter,eglandular,ellipsoidal,elliptic,elliptic-ovate,entire,exserted,fading,flattened,flower,fruit,glabrate,glabrous,globose,greenish,hair,lanceolate,lavender,lobe,long,longitudinal,margin,mm,moderately,obtuse,often,ovate,pedicel,peduncle,petiole,pilose,pink,puberulent,puberulent-pubescent,pubescent,pubescent-pilose,purple,shrub,simple,small,sparsely,stamen,stigma,stripe,style,tree,truncate,tube,unbranched,usually,vein,white,x,yellow-green,yellowish	-17,-2,-7,0.5-1,0.75-1,1-6,1-7,1.5-2,10-25,15-30,2-,2-10,3-,3-10,3-11,4-5-foliat,4-6,4.5-14,5-,5-25,5-merous,6-20,absent,acute,aggregate,alyx,apart,ape,articulated,axe,blade,cell,chartaceous,connective,connivent,diamete,directed,distally,eaf,eed,equal,exceeding,leaving,lon,lower,membranaceous,narrowly,nearly,nflorescence,nther,orolla,pedicellar,perfec,perfect,pilo,pore,presen,puberulent-pubescen,rachi,radiu,remnant,ruit,shorter,slightly,spaced,stellate,stone,strongly,subcoriaceous,tal,tapered,tem,thecae,time,tomento,triangular,ud,unit,vary,wide,yellow,yellow-orang,ympodial	'',5-10-25,[,``,anther,arrangement,bark,branch,bud,calyx,characteristic,colour,corolla,corrugation,distal,drying,exertion,filament,form,fruiting,glabrousnes,growth,height,history,inflorescence,interjected,lateral,leaf,leaflet,length,life,lobing,midpoint,na,new,number,ovary,per,plant,prickle,primary,pseudostipule,ray,seed,shape,size,stem,surface,terminal,texture,thicknes,type,value,variation,width,{,}
131	wfo-0001027265	success	159	129	70	89	59	0.44	.2,.3,.5,0.2-0.4,0.5,0.5-1,1.2-2,2,2-3,2-4,2/3,20-30,acute,anther,apex,base,berry,calyx,chartaceous,cm,diameter,entire,extra-axillary,filament,flattened-reniform,flower,fruit,fruiting,glabrous,globose,hair,herb,leaf-opposed,light,lobe,long,long-attenuate,lower,margin,minutely,mm,nearly,numerous,oblong,obtuse,orange,ovate-lanceolate,pedicel,peduncle,petiole,pitted,puberulent,pubescent,purple,recurved,red,ripe,seed,simple,sparsely,stigma,style,subcoriaceous,surface,triangular,tube,weak,white,x,yellow	-2.5,0.1â2,0.5â0.6,1-1.3,1-2.5,1-3,1.2-1.3,1.2â1.4,1.5-2.5,1.5â1.8,1.5â2,1.5â4,2-,2â2.5,2â3,3-,3-lobed,30â50,4-5,4.5â8,4â6,4â7-branched,5-merou,58409,abaxially,accrescent,adaxiall,adaxially,alyx,apart,apparently,articulated,axe,ba,blade,broad,capitat,ciliate,connivent,covering,croat,cylindrical,dehiscent,eaf,eed,erect,foliate,frui,geminat,granule,hermaphroditic,juic,larger,lon,longitudinall,low,mesocarp,near,nflorescence,node,orolla,paired,partially,pore,present,prominent,rachi,rarely,rooting,rotate-stellate,ruit,scarcely,sclerotic,slightly,sometimes,somewhat,spaced,tall,tamen,tem,time,tip,unit,usually,vary,white-puberulent,wide,winged,ympodial	0.1-2,0.5-0.6,1.2-1.4,1.5-1.8,1.5-4,2-2.5,30-50,4-6,4-7-branched,4.5-8,appearance,arrangement,bark,border,branch,bud,capitate,characteristic,colour,corolla,corrugation,distal,drying,exertion,form,giving,glabrousnes,growth,height,history,inflorescence,interjected,lateral,leaf,leaflet,length,life,lobing,midpoint,na,new,number,ovary,per,plant,prickle,primary,pseudostipule,ray,shape,size,stem,terminal,texture,thicknes,type,variation,vein,width
132	wfo-0001027265	success	156	125	67	89	58	0.429	.2,.3,0.2-0.4,0.5,0.5-1,1.2-2,2,2-3,2/3,20-30,acute,anther,apex,base,calyx,chartaceous,cm,cylindrical,diameter,entire,extra-axillary,filament,flattened-reniform,flower,fruit,fruiting,glabrous,globose,hair,herb,leaf-opposed,light,lobe,long,long-attenuate,lower,margin,minutely,mm,nearly,numerous,oblong,orange,ovate-lanceolate,pedicel,peduncle,petiole,pitted,puberulent,pubescent,purple,recurved,red,ripe,seed,simple,sparsely,stigma,style,subcoriaceous,surface,triangular,tube,weak,white,x,yellow	-2.5,.5,0.1â2,0.5â0.6,1-1.3,1-2.5,1-3,1.2-1.3,1.2â1.4,1.5-2.5,1.5â1.8,1.5â2,1.5â4,2-,2-4,2â2.5,2â3,3-,3-lobed,30â50,4-5,4.5â8,4â6,4â7-branched,5-merou,58409,abaxially,accrescent,adaxiall,adaxially,alyx,apart,apparently,articulated,axe,ba,blade,broad,capitat,ciliate,connivent,covering,croat,dehiscent,eaf,eed,erect,foliate,frui,geminat,granule,hermaphroditic,juic,larger,lon,longitudinall,low,mesocarp,near,nflorescence,node,obtuse,orolla,paired,partially,pore,prominent,rachi,rarely,rooting,rotate-stellate,ruit,scarcely,sclerotic,slightly,sometimes,somewhat,spaced,tall,tamen,tem,time,tip,unit,vary,white-puberulent,wide,winged,ympodial	0.1-2,1.2-1.4,1.5-1.8,1.5-4,2-2.5,30-50,4-6,4-7-branched,4.5-8,appearance,arrangement,bark,border,branch,bud,capitate,characteristic,colour,corolla,corrugation,distal,drying,exertion,form,giving,glabrousnes,growth,height,history,inflorescence,interjected,lateral,leaf,leaflet,length,life,lobing,midpoint,na,new,number,ovary,per,plant,prickle,primary,pseudostipule,ray,shape,size,stem,terminal,texture,thicknes,type,variation,vein,width
133	wfo-0001027284	invalid_json_followup	172	153	102	70	51	0.593	.3,0.1â0.5,0.2â,0.7â0.9,0.7â1,1.2â1.5,1.5â2,1.5â8,1.8â2,1â1.5,2â16,2â2.2,3.5â14,3â4,4,4â12,4â6,9â18,abaxially,acuminate,acute,adaxially,anther,anthesi,apex,axillary,base,berry,branch,branched,brownish,calyx,cm,cordate,deltoid,densely,diameter,elliptic,entire,extra-axillary,filament,fine,flattened-reniform,fleshy,flower,fruit,fruiting,glabrous,globose,green,herbaceous,inflorescence,lobe,margin,maturity,midvein,minutely,mm,nearly,oblique,orangish,ovate,ovoid,pale,pedicel,peduncle,petiole,pinnate,planar,pubescence,pubescent,rarely,reticulate-rugulose,rounded,sand-punctate,scandent,scar,shortly,shrub,simple,size,sometimes,somewhat,soon,sparsely,spreading,stem-terminal,stigma,style,surface,tan,thickly,tip,truncate,tube,unbranched,vein,vine,weakly,white,woody,x	0.1â2,1.5â2.5,1.5â5.5,1â2,1â3,2.5â3,2.5â3.5,5-merous,5â7,5â8,accrescent,alyx,axe,blade,c.,capitat,ciliat,climbing,conspicuous,contiguousl,cylindrical,deflected,distally,eaf,eed,enlarged,flattened,glabrescen,glabrou,gradually,immature,leafy,long,lower,m.,near,nflorescence,nternode,one,orolla,pair,pendulou,perfec,pink,plurifoliate,pointed,prominent,rachi,reduced,ruit,sand-punctat,secondary,seen,side,slightly,spaced,stellate,tamen,tem,thickened,time,toward,tree,understory,unifoliat,unit,vary,venation,wide,ympodial	'',[,``,arrangement,bark,bud,capitate,characteristic,colour,corolla,corrugation,distal,drying,exertion,form,glabrescent,glabrousnes,growth,height,history,interjected,lateral,leaf,leaflet,length,life,lobing,midpoint,na,new,number,ovary,pendulous,per,plant,prickle,primary,pseudostipule,ray,seed,shape,stem,terminal,texture,thicknes,type,value,variation,width,{,}
134	wfo-0001027302	invalid_json	188	162	130	58	32	0.691	.5,0.5,0.5-1,0.6-1,0.8-1,1,1-1.3,1-1.5,1-2,1-3,1.2-1.6,1.2-2.5,1.5-2,10,10-20,2-3,2-6,2.2,2.7-7.5,3.5-5,3/4,5-7,7,7/8,abaxial,acuminate,acute,adaxial,age,along,anther,apex,apical,appearing,bark,basal,base,becoming,berry,branching,bright,brownish-yellow,calyx,capitate,clavate,cm,cordate,corolla,crispate,dendritic,densely,denser,diameter,elliptic,entire,especially,exserted,filament,fine,flat-topped,flattened,flower,free,fruiting,glabrous,globose,growth,later,lateral,leaf,length,lenticular,less,like,long,main,margin,minutely,mm,monochasial,narrowly,occasionally,otherwise,ovary,ovate,overtopping,pale,per,petiole,plant,plurifoliate,pore,poridical,portion,prominent,puberulent,pubescent,pyramidal,red,scar,shoot,shrub,simple,slit-like,small,somewhat,sparsely,stem,stigma,strongly,style,surface,tapering,terminal,time,tiny,tip,tree,trichome,truncate,tube,undulate,usually,vein,violet,way,wide,winged,x,young	0.4-5,2,6-12,abaxially,adaxially,anthesi,ba,blade,broader,conical,cultivation,decurrent,deflexed,deltoid,dichasia,discussion,eaf,edicel,eed,ew,growing,inserted,juvenile,larger,lax,lobe,lobed,lon,long-triangular,lower,m.,nflorescence,nodding,older,pair,papillo,pedicle,pericarp,pitted,planar,reddish-brown,reflexed,ruit,scattered,scrambling,secondary,see,shade,shin,sleeve,stamen,tall,thin,tub,ud,unit,woody,ympodial	'',[,],``,arrangement,bud,characteristic,colour,dichasial,exertion,form,fruit,glabrousnes,history,inflorescence,life,lobing,new,number,papillose,pedicel,perennial,seed,shape,shiny,size,staman,texture,type,value,{,}
135	wfo-0001027310	invalid_json_followup	215	168	127	88	41	0.591	-2.2,-20,.8,/3,0,0-20,0.15-0.3,0.6-1,0.7-2,0.9-0.17,1-1.2,1-1.7,1-6,1.1-1.5,1.5-2.2,1.5-5,2-3.1,2.2-2.5,2.8-3,20-60,22-30,4-10,4.5-5.5,4.5-7,5-10,5-7,9-13,abaxially,acute,anther,apex,apparently,articulated,bark,base,berry,broadly,calyx,chartaceous,cm,connivent,cuneate,dark,deltate,densely,diameter,discolorous,distal,drying,entire,erect,evenly,filament,flattened,flattened-reniform,foliaceous,free,fruit,fruiting,glabrous,gray,green,green-brown,hair,lanceolate,lateral,leaf,length,lobe,lobed,long,margin,maturity,mauve,midpoint,minutely,mm,moderately,orange-brown,pair,pale,pedicel,peduncle,per,petiole,pitted,plant,poricidal,porrect-lepidote,prickle,prickly,primary,pubescent,purple,ray,red,reflexed,rounded,sessile,shallowly,shrub,simple,sometimes,sparse,sparsely,spherical,spreading,stellate-pubescent,stem,straight,strongly,style,surface,tapering,terminal,tip,toward,tree,trichome,truncate,tube,unarmed,vein,way,wide,yellow,young	0-5,0.05,0.05-0.15,0.1,0.1-0.2,1/10-1/6,1/3-1/2,1/3-3/4,11-16,2-10,2-4,2-5,2/3,3-15,4-9,5-20,5-merous,6-8,7-10,8-10,abaxial,acut,adaxial,alyx,andromonoecious,apar,apart,apically,blade,branched,branching,curved,eaf,eed,elongating,equal,faint,flower,fused,gently,glabrescent,glabrou,glaucous,hermaphrodite,heterostylous,inflated,infructescence,less,long-styled,longer,lower,lowermost,mature,nflorescence,older,one,open,orolla,oung,pendulous,pericarp,plurifoliat,porrect,portion,reddi,ruit,scar,secondary,short-styled,shorter,smooth,spaced,stalk,stalked,staminat,stellate,stout,tamen,terete,tertiary,time,unarme,unit,vary,venation,visible,woody,ympodial	'',[,``,arrangement,branch,bud,characteristic,colour,corolla,corrugation,exertion,form,glabrousnes,growth,height,history,inflorescence,interjected,leaflet,life,lobing,na,new,number,ovary,perennial,plurifoliate,pseudostipule,reddish,seed,shape,size,stigma,texture,thicknes,type,value,variation,width,{,}
136	wfo-0001027317	success	144	117	84	60	33	0.583	.5,0.1-0.2,0.4-1.5,0.8-3.5,1,1-1.5,1-2,1.4-1.6,1.5-2,2-3-flowered,2-9,4.5-5,7-9,?,acuminate,acute,adaxially,along,anther,apex,apically,bark,base,beneath,berry,bilobed,broadly,calyx,cm,conical,corolla,deciduous,densely,dia,difoliate,drying,ellipsoid,elliptic,erect,filament,filiform,fruit,fruiting,glabrous,globose,golden,green,lateral,leaf,like,lobed,long,long-exserted,main,margin,mm,nearly,offset,opposite,ovary,pair,pale,pedicel,petiole,pointed,pubescent,shaped,shrub,simple,size,slightly,soon,sparsely,stem,stigma,style,surface,tear-drop,trichome,tube,uniseriate,vein,white,x	.25,0.3-1,0.5-1,0.5-3,1-5,3-3.5,abaxial,anthesi,apical,arch,ba,closely,cucullate,deflexed,deltoid,differing,eaf,edicel,eed,elongated,expanded,free,geminat,greyish-whit,immature,inflorescenc,joined,known,lobe,lon,lower,major,mature,minor,minute,minutely,nflorescence,older,overlappin,papillo,papillose,pore,poricidal,portion,projection,prominent,reflexed,rest,ruit,scar,series,spaced,strongly,tall,tip,tub,ud,woody,ympodia,young	0.25,arrangement,branch,bud,characteristic,colour,corrugation,diameter,exertion,form,geminate,glabrousnes,greyish-white,growth,height,history,inflorescence,length,life,lobing,na,new,number,peduncle,per,perennial,plant,primary,seed,shape,sympodia,texture,type
137	wfo-0001027323	invalid_json_followup	175	148	100	75	48	0.571	/3,0.5-1,1-1.5,1.2-1.5,14-21,2-3,2-6,2.5-3,20-45,5-20-flowered,5-7,7-9,acute,along,anther,apex,appearing,area,asymmetric,attenuate,bark,base,berry,broadened,bud,calyx,campanulate,closed,cm,corolla,decurrent,densely,dia,difoliate,elliptic,elongate,exserted,filament,fleshy,flopping,flower,fruit,fruiting,furcate,glabrate,glabrous,globose,grey,held,higher,hooded,immature,lateral,leaf,lobe,lobed,long,main,margin,matte,minutely,mm,occasionally,older,onto,opposite,ovary,ovoid,ovoid-reniform,pair,papillose,partially,pedicel,petiole,pinkish-grey,pitted,plant,red-papillose,reddish-grey,rest,size,slightly,small,soon,stem,stigma,style,surface,tan,tip,treelet,tube,two,unit,vein,way,white,winged,x,young	.75,1-2,10-15,3-5,6-11,adaxial,anthesi,apparent,arising,ba,character,closely,cork,deflexed,differing,dried,dry,eaf,edicel,eed,entire,erect,erose,five-pointed,free,geminat,growing,hood,interpetalar,like,live,lon,long-triangular-deltoid,lower,major,mature,measured,middle,minor,nflorescence,one,overlapping,papillae,papillo,persistent,planar,pore,poricidal,portion,prominent,proximal,rather,ridge,ruit,scar,secondary,seen,shaped,sinus,smoot,spaced,specimen,straight,tall,tear-drop,thickened,thin,tiny,trunk,ud,upper,visible,widest,woody,ympodial	'',[,``,arrangement,branch,characteristic,colour,corrugation,diameter,distal,drying,exertion,form,geminate,glabrousnes,growth,height,history,inflorescence,interjected,leaflet,length,life,lob,lobing,midpoint,na,new,number,peduncle,per,prickle,primary,pseudostipule,ray,seed,shape,smooth,sympodial,terminal,texture,thicknes,type,value,variation,width,{,}
138	wfo-0001027340	invalid_json_followup	189	150	105	84	45	0.556	0.5-0.9,1-2,1.5-2.7,16-22,2-3,2-4,2.5-4.5,2.7-4.5,3.5-5,3.5-9,4-6,4-7.5,5-6,7-18,7-8,8-14,8-9.5,abaxially,absent,acuminate,adaxially,anther,apex,axillary,base,berry,brownish,bud,cell,chartaceous,cm,condition,cordate,corolla,covering,dark,diameter,distal,drying,elliptic,filament,flower,forked,fresh,fruit,generally,glabrous,globose,green,green-white,greenish,half,herb,interjected,lanceolate,lateral,leaflet,lilac-purple,lobe,long,make,margin,membranous,minute,mm,mucilaginous,narrow,odd-pinnate,ovate,ovoid,papillose,pedicel,peduncle,petiole,petiolulate,plant,pubescent,purple,ripe,rotate,rounded,seed,sessile,short,shortly,size,sparsely,splotched,stem,stigma,style,subtending,terminal,testal,thick,throughout,tinged,truncate,tube,usually,wall,wet,whitish,wing,x	1-10,1-3,10-16,2-3.5,3-4,5-11,5-merou,6-8.5,abruptly,acumen,ag,along,alyx,apart,apparently,articulated,articulation,auriculate,axe,blade,capitat,ciliate,connivent,decreasing,developing,digestion,distinct,dorsally,eaf,edge,eed,enzyme,especially,exceeding,flat,folded,geminat,glabrou,hair,hair-like,hal,high,homostylous,honeycomb-shaped,indistinct,lengthening,like,living,lower,midrib,minutely,narrowed,nflorescence,orolla,pair,perfect,plurifoliate,pointed,pore,poricidal,puberulent,purpl,removed,ruit,semi-erec,semi-rosette,seudostipule,slightly,slit,spaced,specimen,stamen,ste,straight,tall,tamen,tem,tip,tri-,unit,vary,yellow,ympodial,young	'',[,\u201chair-like\u201d,``,arrangement,bark,branch,calyx,capitate,characteristic,colour,corrugation,exertion,form,fruiting,glabrousnes,growth,height,history,inflorescence,leaf,length,life,lobing,midpoint,na,new,number,ovary,per,prickle,primary,pseudostipule,ray,shape,surface,texture,thicknes,type,value,variation,vein,width,{,}
139	wfo-0001027354	invalid_json_followup	166	156	115	51	41	0.693	0,0.5,0.5-2,0.7-1.3,1,1-1.2,1-1.5,1-7,1.5-1.8,1.7-5,10,10-20,2.5-3.5,3-4,3.4-4,3/4,4-10,5-7,6.5-13,8-12,absent,acute,age,along,anther,apex,apical,appearing,bark,basal,base,becoming,berry,bi-lobed,branch,branching,calyx,cm,conical,corolla,covered,dark,dendritic,densely,diameter,drying,elliptic,entire,exserted,filament,flattened,flower,fork,fruit,fruiting,glabrate,glabrous,globose,golden,growth,later,lateral,leaf,length,lenticular,like,long,loose,loosely,minutely,mm,mostly,narrowly,near,occasionally,ovary,pair,pedicel,per,petiole,pitted,plurifoliate,pore,poricidal,pubescent,purplish-black,pyramidal,reddish-brown,secondary,shrub,slightly,slit-like,small,sparsely,stem,stigma,strongly,style,surface,tapering,terminal,time,tip,tree,tree-like,trichome,tube,type,vein,violet,way,white,wide,x,young	.5,1.5-2,abaxial,abaxially,adaxial,anthesi,ba,belo,blade,deltoid,denser,dichasia,eaf,edicel,eed,erect,ew,free,inserted,less,lobe,lobed,lower,m.,monochasial,nflorescence,nodding,older,papillo,pericarp,planar,portion,pubescen,raised,ruit,scar,side,simple,sleeve,somewhat,stamen,tall,thecalyx,thin,tiny,tub,ud,unit,winged,woody,ympodial	'',[,``,arrangement,bud,characteristic,colour,corrugation,distal,exertion,form,glabrousnes,height,history,inflorescence,interjected,leaflet,life,lobing,margin,midpoint,na,new,number,papillose,peduncle,plant,prickle,primary,pseudostipule,ray,seed,shape,size,texture,thicknes,value,variation,width,{,}
140	wfo-0001027359	invalid_json_followup	224	166	121	103	45	0.54	-2,-3,.5,/3,0-9,0.1-0.2,0.3-0.5,0.3-1.2,0.5-1,0.5-2,0.6-1,1-1.2,1.2-1.5,1.2-2,1.5-2,1.5-2.5,1.8-3.2,2-10,2.5-3.5,2.5-5.5,4-5,6-8,acute,anther,apart,apex,apparently,bark,base,berry,bright,calyx,cell,chartaceous,cm,concolorous,cream,cuneate,dark,deltate,densely,diameter,drying,dull,entire,filament,filiform,flattened,flattened-reniform,fruit,fruiting,glabrous,gray,green,lateral,leaf,length,lobe,lobed,long,margin,marking,maturity,membranous,midpoint,minutely,mm,moderately,near,obtuse,occasional,orange-brown,outline,ovate,ovoid,pair,pale,pedicel,peduncle,per,petiole,pit,poricidal,prickle,prickly,primary,purple,raised,ray,red,reflexed,reticulate,shallowly,shrub,simple,small,smooth,sometimes,spaced,sparsely,spherical,spreading,stellate,stellate-pubescent,stem,style,surface,tapering,terminal,tip,trichome,tube,unarmed,undulate,vein,way,white,wide,yellow,yellow-brown,young	-0.25,-20,-4,-7,-9,.1,.2,/4,0,0-2,0-3,0-5,0.1,0.1-1.5,0.5,0.6-0.8,1-2,1-3,1-4,1-5,1/5-1/4,2-3,2-4,3-10,4-,5-,5-6.5,5-merous,7-8,abaxially,acut,alyx,apar,apically,articulated,ba,blade,branched,brow,coroll,curved,difoliate,distinctive,eaf,eed,elongate,elongating,equal,erect,eye,flower,free,geminat,glabrescent,herbaceous,infructescence,less,like,longer,lower,mature,naked,narrow-deltate,narrow-ovate,nflorescence,often,older,one,open,orolla,oung,perfec,pericarp,porrect,portion,rachi,rarely,ruit,scandent,scar,sessile,shorter,slender,slightly,stalk,stalked,stump,tamen,terete,tertiary,time,tinge,ud,unarme,unit,usually,variously,vary,venation,visible,weakly,woody,ympodial	'',4-6.5,7-20,[,``,alternate,arrangement,branch,brown,bud,characteristic,colour,corolla,corrugation,distal,exertion,form,glabrousnes,growth,height,history,inflorescence,interjected,leaflet,life,lobing,na,new,number,ovary,perennial,plant,pseudostipule,seed,shape,size,stigma,texture,thicknes,type,value,variation,width,{,}
141	wfo-0001027366	success	136	106	76	60	30	0.559	/4,0.25-0.5,0.5-1,0.7-1,1-1.5,1-2,1-3,1.5-2,11-21,2-2.5,3-10-flowered,3-9,4-4.5,4-5,5-7,6-19,abaxially,acute,adaxially,anther,apex,bark,base,berry,bright,broadly,brown,calyx,capitate,cm,conical,corolla,dark,dia,drying,elliptic,filament,fruiting,glabrous,globose,golden,green,greenish-white,lateral,leaf,long,main,margin,minutely,mm,orbicular,ovary,ovoid,ovoid-reniform,pair,pale,pedicel,petiole,pitted,pointed,rounded,shaped,shining,shrub,simple,somewhat,stem,stigma,style,surface,tear-drop,tip,tube,vein,way,wide	.5,/2,603,anthesi,ape,axe,ba,closely,conspicuously,deflexed,deltate,eaf,edicel,eed,erect,et,except,exserted,fide,free,internodal,lamina,less,lobe,lobed,lon,long-triangular,lower,middle,nflorescence,older,opposite,overlappin,packed,papillo,papillose,parallel,planar,pore,poridical,portion,ramo,reddish,ruit,scar,secondary,sometimes,straight,tall,trichome,tub,ud,unifoliat,unit,venation,widest,woody,yellowish-gre,ympodial,young	arrangement,branch,bud,characteristic,colour,corrugation,diameter,exertion,form,fruit,glabrousnes,growth,height,history,inflorescence,length,life,lobing,na,new,peduncle,plant,primary,seed,shape,size,texture,type,unifoliate,yellowish-grey
142	wfo-0001027368	success	145	134	81	64	53	0.559	-20,-5,.5,0.3-2.5,0.5-3.5,0.5-5,0.8-2,1-15-flower,1-2,1.5-2,1.5-2.5,2,2-2.5,3-12.5,5-15,5-6,abruptly,acuminate,acute,apex,base,branched,calyx,chartaceous,cm,cuneate,darker,decurrent,deltate,dendritically,densely,diameter,distally,ellipsiodal,elliptic,elliptic-ovate,entire,forked,glabrous,globose,lanceolate,lenticular,lighter,lobe,margin,mm,moderately,narrowed,narrowly,nearly,oblong,obtuse,occasionally,often,otherwise,ovoid-fusiform,pedicel,peduncle,petiole,puberulent,pubescent,purple,ray,shrub,simple,small,sparsely,star,stigma,style,subcoriaceous,subhastate,terminal,triangular,truncate,tube,unbranched,unknown,vein,white,x	-10,-15,-2,1-6,2-3,2-4,2-9,3,4-6,4-many-foliat,5-10,8-13,abaxially,absen,adaxiall,adaxially,aggregate,also,apart,articulated,axe,ba,blade,cell,color,connivent,contiguous,cylindrical,denser,directed,eaf,eed,except,gland,hair,long,long-stalked,lower,midvein,nflorescence,nther,orolla,pore,pubescen,rachi,radiu,ruit,sometimes,spaced,stalked,stellate,stone,subcapitat,tal,tem,three,time,tip,unit,usually,vary,wide,yellow,ympodial	anther,appearance,arrangement,bark,border,branch,bud,characteristic,colour,corolla,corrugation,distal,drying,exertion,filament,form,fruit,fruiting,giving,glabrousnes,growth,height,history,inflorescence,interjected,lateral,leaf,leaflet,length,life,lobing,midpoint,na,new,number,ovary,per,perennial,plant,prickle,primary,pseudostipule,seed,shape,size,stem,subcapitate,surface,texture,thicknes,type,variation,width
143	wfo-0001027369	success	191	121	88	103	33	0.461	-1,-10,.4,.5,.7,/4,0-1,0-15,0.2-0.5,0.5,0.5-0.8,0.6-0.8,1-2.5,1.2-2.5,1.2-3,1.5-2,2-3,4-8,anther,apart,apex,apically,apparently,articulated,bark,base,berry,calyx,cm,cordate,densely,diameter,elongating,erect,eye,filament,fruit,fruiting,glabrous,glaucous,green,known,lanceolate,lateral,leaf,length,less,lobe,lobed,long,margin,mature,mauve,membranous,mm,moderately,naked,orbicular,pale,pedicel,peduncle,per,petiole,poricidal,prickle,prickly,reflexed,reniform,rounded,shrub,simple,slightly,spaced,sparsely,spherical,spreading,stellate-pubescent,stem,straight,style,surface,tapering,terminal,tip,visible,way,wide,yellow	-11,-2,.1,0,0-3,0-5,0-6,0.05-0.15,0.1,0.1-0.2,0.1-0.3,0.25-0.4,0.3-1.5,0.5-1.5,1-,1-2,1-3,1-4,1/3,2-4,2-5,3,3-10,3-4,4-5,5,5-merous,7-15,abaxially,acut,almost,alyx,ame,apar,blade,branched,broad-deltate,c.,color,concolorous,curved,deltate,difoliate,distance,drying,eaf,eed,equal,extending,filiform,flower,free,geminat,glabrou,gra,hair,herbaceous,infructescence,know,lon,lower,midpoint,midvein,multangulate,narrowly,nflorescence,older,one,open,orolla,oung,pendulous,perfec,pericarp,perpendicular,porrect,portion,prickl,ray,ruit,scandent,scar,sessile,side,slender,smooth,stalk,stalked,stellate,strongly,tamen,terete,time,trichome,tube,unarmed,unequal,unit,vary,venation,wider,winged,ympodial	acute,appearance,arrangement,border,branch,characteristic,colour,corolla,exertion,form,giving,glabrousnes,gray,growth,height,history,inflorescence,life,lobing,na,new,number,ovary,perennial,plant,primary,seed,shape,size,texture,type,vein,width
144	wfo-0001027378	invalid_json_followup	149	148	79	70	69	0.53	.2,5-8,abaxially,acuminate,acute,adaxially,anther,apex,base,berry,blue,broadly,calyx,chartaceous,cm,cordate,deeply,deltoid,diameter,extra-axillary,filament,flattened,fleshy,flower,fruit,fruiting,glabrous,hair-tipped,half,herbaceous,lanceolate,leaf,light,lobe,long,lower,margin,markedly,minutely,mm,narrowly,obscure,often,ovate,ovoid,palmate,papillose,pedicel,peduncle,pentagonal,petiole,pointed,primary,pubescent,revolute,rotate-stellate,rounded,sand-punctate,simple,slender,slightly,small,somewhat,spaced,sparsely,stem,stigma,style,tip,tooth,trichome,tube,unbranched,unknown,vein,vine,white,widely,x	0.5â1,0.7â1,0.8â2.5,1.2â1.5,1.2â1.8,1.5â1.8,1.5â8,15â35,1â1.5,1â3,2.3â5,2.5â7,2â11,2â2.2,2â2.5,3â4.5,3â5,3â6,4â6,4â9,5-merous,5â10,5â13,5â7,6â10,6â7,adaxial,alyx,apar,apicall,axe,blade,c.,capitat,ciliate,clavate,climbin,color,cylindrical,densely,eaf,eed,glabrou,hair,like,lon,longer,m.,membranous,moderately,nflorescence,nternode,orolla,perfec,plurifoliat,rachi,ruit,sand-punctat,scattered,short,side,tamen,tem,terrestrial,unit,unknow,vary,venation,wide,ympodial	'',0.5-1,0.7-1,1.2-1.8,1.5-1.8,1.5-8,15-35,2-11,2-2.2,2-2.5,2.3-5,2.5-7,3-5,3-6,4-6,5-10,5-13,5-7,6-7,[,``,apart,arrangement,bark,branch,bud,capitate,characteristic,colour,corolla,corrugation,distal,drying,exertion,form,glabrousnes,growth,height,history,inflorescence,interjected,lateral,leaflet,length,life,lobing,midpoint,na,new,number,ovary,per,plant,prickle,pseudostipule,ray,seed,shape,size,surface,terminal,texture,thicknes,type,value,variation,width,{,}
145	wfo-0001027378	success	141	135	86	55	49	0.61	.2,0.7-1,1.5-1.8,1.5-8,15-35,2-11,2-2.2,2-4,2.5-7,3-5,3-6,4-6,5-13,abaxially,acuminate,acute,adaxially,anther,apex,basally,base,blade,blue,broadly,calyx,chartaceous,clavate,climbing,cm,connivent,cordate,cylindrical,deeply,deltoid,diameter,extra-axillary,filament,fleshy,flower,fruit,fruiting,glabrous,hair,hair-tipped,herb,lanceolate,leaf,light,lobe,margin,minutely,mm,moderately,multicellular,narrowly,oblong,obscure,often,ovate,pedicel,peduncle,petiole,pubescent,revolute,rotate-pentagonal,rounded,simple,slender,small,somewhat,spaced,sparsely,stigma,style,terrestrial,tip,tooth,trailing,tube,unbranched,unknown,vein,weakly,white,widely,x	0.8-2.5,1-1.5,1-3,1.2-1.5,2.3-5,3-4.5,4-9,5-8,5-merou,6-10,6-7,ag,alyx,apart,apicall,apparently,articulated,axe,ba,capitat,ciliate,densely,directed,distally,eaf,eed,equal,geminat,large,long,longer,longitudinal,lower,nflorescence,node,opening,orolla,perfect,plurifoliate,pore,pubescen,rachi,rooting,scattered,short,slightly,slit,tamen,tem,unit,unknow,vary,wide,yellow,ympodial	appearance,arrangement,bark,border,branch,bud,capitate,characteristic,colour,corolla,corrugation,distal,drying,exertion,form,giving,glabrousnes,growth,height,history,inflorescence,interjected,lateral,leaflet,length,life,lobing,midpoint,na,new,number,ovary,per,plant,prickle,primary,pseudostipule,ray,seed,shape,size,stem,surface,terminal,texture,thicknes,type,variation,width
146	wfo-0001027384	invalid_json_followup	155	137	88	67	49	0.568	.5,0.4-1.1,0.5-1,0.9-1,1-1.3,1-1.5,1-3,1-4,1.5-2,2.5-6.5,3-3.5,3-4,3/4,4-7,5-15-flowered,5-5.5,7-14,7.5-8,acute,anther,apex,bark,base,berry,brown,bud,calyx,capitate,clavate,cm,corolla,cuneate,deep,dia,distal,drying,ellipsoid,filament,flattened-reniform,fruiting,glabrous,globose,green,hard,later,lateral,leaf,lobe,long,long-exserted,main,margin,minutely,mm,mustard,narrowly,obovate,opposite,ovary,pair,pale,papillose,pedicel,petiole,pitted,pseudo-terminal,reddish-purple,rounded,shaped,shrub,simple,slender,small,stem,stigma,style,sulcate,surface,tapering,tear-drop,tree,tube,vein,way,white,x,yellow,young	.25,.75,/3,abov,anothe,anthesi,apart,ba,beginning,beneath,breaking,broadly,closely,difoliate,eaf,edicel,eed,equal,erect,free,geminate,herbarium,incrassate,inflorescenc,lobed,lower,member,middle,nflorescence,occasionally,older,overlapping,paler,papillo,peeling,planar,pore,poricidal,portion,prominent,rarely,ruit,scar,section,shining,siz,spaced,specimen,straight,subcoriaceous-fleshy,tall,thick,tip,transverse,triangular,trichome,tub,tuft,ud,uniseriate,unit,widely,widest,without,woody,yellowish,ympodial	'',[,``,alternate,appearance,arrangement,border,branch,characteristic,colour,corrugation,diameter,exertion,form,fruit,giving,glabrousnes,growth,height,history,inflorescence,interjected,leaflet,length,life,lobing,midpoint,na,new,number,peduncle,per,plant,prickle,primary,pseudostipule,ray,seed,shape,size,terminal,texture,thicknes,type,value,variation,width,{,}
147	wfo-0001027389	success	154	127	97	57	30	0.63	.1,.25,.5,0.25-0.3,0.5-0.75,0.5-1.5,0.6-1,1,1-1.5,1.8-1.9,11-14,2-2.5,3-3.5,3-4.5,4-5-flowered,5-7,7-8,acuminate,acute,anther,apex,bark,base,berry,broadening,broadly,brown,bud,calyx,cm,conical,corolla,dark,decurrent,dia,dry,elliptic,erect,except,exserted,filament,filiform,fruiting,geminate,glabrous,globose,green,hispidulous,inflorescence,lateral,leaf,like,lobed,long,main,margin,material,minutely,mm,nearly,node,non-reproductive,ovary,ovate,ovoid-reniform,pair,pedicel,petiole,pitted,poricidal,puberulent,reddish-golden,shrub,simple,slender,slight,soon,sparsely,stem,stigma,straight,style,surface,tapering,thread-like,tip,top,trichome,truncate,tube,uniseriate,vein,white,winged,x,yellowish,young	0.25-0.5,1-2,along,anthesi,apart,ba,beneath,deflexed,deltoid,eaf,edicel,eed,ellipsoid,evenly,expanded,foetid,foliage,free,lobe,lon,lower,making,middle,nflorescence,obovoi,occasionally,often,older,one,opposite,paler,papillo,papillose,pore,portion,prominent,prominently,proximal,raise,raised,reflexed,rest,ruit,scar,shaped,shin,side,slightly,spaced,tall,tear-drop,ud,unifoliat,unit,widest,woody,ympodial	arrangement,branch,characteristic,colour,corrugation,diameter,drying,exertion,form,fruit,glabrousnes,growth,height,history,length,life,lobing,na,new,peduncle,perennial,plant,primary,seed,shape,shiny,size,texture,type,unifoliate
148	wfo-0001027395	success	153	125	95	58	30	0.621	.25,.5,0.25-0.5,0.75-1,1-1.5,1-5,1.1-1.5,1.5-1.9,10-20-flowered,12.5-17.3,2-3,5-6.5,8,acute,anther,anthesi,apex,apically,attenuate,bark,base,beneath,berry,black,calyx,capitate,cm,conical,constricted,corolla,cucullate,decurrent,deflexed,densely,dia,drying,erect,exserted,filament,fleshy,fruit,fruiting,glabrous,globose,green,immature,imperceptibly,large,leaf,lobe,lobed,long,margin,minutely,mm,narrowly,nearly,obovate,occasionally,once-furcate,ovary,ovoid,papillose,partially,pedicel,petiole,planar,pointed,primary,pubescent,raised,robust,rusty-papillate,secondary,shaped,shining,shiny,shrub,simple,size,somewhat,stem,stigma,straight,style,tapering,tear-drop,tip,trichome,tube,uniseriate,vein,white,woody,x	0.6-1.1,1-2,1.5-2.5,1.6-2.9,11-15,2.2-7,3.5-4,4-6,apiculate,becoming,beginning,caly,closely,deltoid,depressed,differing,difoliate,eaf,edicel,eed,enlarging,exfoliating,free,geminat,inflorescenc,known,lateral,lon,lower,main,major,midrib,minor,nflorescence,older,opposite,overlapping,pair,papillo,piece,pore,poricidal,portion,restricted,ruit,scar,small,spaced,tall,thick,thickened,transverse,ud,unit,within,without,ympodial,young	alternate,arrangement,branch,bud,characteristic,colour,corrugation,diameter,exertion,form,glabrousnes,growth,height,history,inflorescence,length,life,lobing,na,new,number,peduncle,per,perennial,plant,seed,shape,surface,texture,type
149	wfo-0001027396	invalid_json_followup	244	171	130	114	41	0.533	0-100,0-3,0-4,0.5-1,0.5-1.5,0.7-2.5,0.8-1.3,1.5-3,1.5-3.5,1.8-3,1/3,1/4-1/3,10-35,2-3,2-3.5,2-7,2.5-4,2.8-4.5,20-100,3.5-6,4-7,5-8,5.5-7.5,6-20,6.5-7.5,abaxially,acute,almost,anther,apex,apparently,articulated,attenuate,bark,base,berry,black,brown,calyx,chartaceous,cm,concolorous,connivent,cream,cuneate,dark,densely,diameter,discolorous,distal,drying,elliptic,elongate,erect,filament,flattened,flattened-reniform,flower,fruit,fruiting,glabrous,glandular,green,hair,herb,lateral,leaf,length,lobed,lobing,long,long-styled,margin,marking,maturity,mauve,midpoint,mm,moderately,near,obtuse,often,orange,pair,pale,pedicel,peduncle,per,perpendicular,petiole,plant,poricidal,porrect,prickle,prickly,primary,pubescent,purple,ray,red-brown,rotate,short-styled,shrub,simple,sometimes,somewhat,sparsely,spherical,stalked,stellate-pubescent,stem,straight,style,surface,tapering,tearing,tip,trichome,tube,unbranched,upper,variously,vein,way,white,wide,yellow,yellow-green,yellowish,young	-2,-5,-6,/3,0-30,0-5,0.1-0.5,0.1-1,0.4-0.7,0.5-2,0.5-2.5,0.8,1,1-4,1.2-2,1/2-2/3,1/6,10-15,10-25,10-30,12-25,15-40,3-,3-9,4,4-5,4-6,5-10,5-20,5-30,5-50,5-merous,7-10,7-15,8-20,abaxial,adaxial,alyx,ame,andromonoecious,apar,apart,apically,ba,blade,broad,broad-deltate,bulbous,c.,curved,decurrent,deltate,difoliate,distance,eaf,eed,elongating,equal,extending,extensive,fewer,free,fully,geminat,glabrescent,gray-brow,hermaphrodite,heterostylous,infructescence,less,lignified,lobe,lon,long-acuminat,longer,lower,lowermost,mature,midvein,nflorescence,older,one,open,opening,orolla,oung,pendulous,pericarp,portion,prickl,reflexed,ruit,scar,secondary,sessile,side,smooth,spaced,spreading,stalk,staminat,stout,tamen,terete,tertiary,time,unarmed,unit,usually,vary,venation,visible,woody,ympodial	'',[,``,arrangement,branch,bud,characteristic,colour,corolla,corrugation,decurren,exertion,form,glabrousnes,gray-brown,growth,height,history,inflorescence,interjected,leaflet,life,na,new,number,ovary,perennial,pseudostipule,seed,shape,size,stigma,terminal,texture,thicknes,type,value,variation,width,{,}
150	wfo-0001027449	invalid_json_followup	160	142	93	67	49	0.581	.4,.75,/3,0.5-1,0.5-1.5,0.8-1.5,0.9-1.1,1.4-1.5,1.5-2.5,10-15-flowered,2-4,3,3-3.5,3-7,5-6,8-15,acuminate,acute,anther,apex,area,bark,base,beneath,berry,brown,bud,calyx,cm,corolla,dark,dia,difoliate,elliptic,exserted,filament,fruit,fruiting,glabrous,globose,green,inflorescence,lateral,leaf,lobe,lobed,long,long-acuminate,long-triangular,minutely,mm,narrowly,oblique,often,orangish,ovary,ovoid-reniform,pale,papillose,pedicel,persistent,petiole,pitted,pointed,prominent,pubescent,raised,red-papillose,shaped,shrub,simple,size,slender,small,soon,stem,stigma,straight,style,surface,tapering,tear-drop,tip,tree,trichome,tube,uniseriate,unit,vein,way,white,woody,x	.5,1.2-1.5,2-3,4-6,anthesi,appearing,arising,around,axil,becoming,beginning,closely,cup,deciduous,deflexed,dense,densely,density,differing,dry,eaf,edicel,eed,ellipsoid,erect,extreme,forming,free,frui,geminat,glabrate,inflorescenc,lamina,later,like,lon,lower,main,major,material,minor,nflorescence,obconic,older,one,opposite,overlapping,packed,pair,pore,poricidal,portion,reddish-brow,reflexed,rest,ruit,scar,sparse,sparsely,styl,tall,trunk,tuft,ud,varying,ympodial,young	'',[,``,arrangement,branch,ca,characteristic,colour,corrugation,diameter,distal,drying,exertion,form,geminate,glabrousnes,growth,height,history,interjected,leaflet,length,life,lobing,margin,midpoint,na,new,number,peduncle,per,plant,prickle,primary,pseudostipule,ray,reddish-brown,seed,shape,sympodial,terminal,texture,thicknes,type,value,variation,width,{,}
151	wfo-0001027452	success	152	137	90	62	47	0.592	.5,0.5-1,0.5-1.5,0.5-2,0.5-2.5,1,1-3,1-4.5,1-5,1.5,1.5-3,10-20,2-foliate,4,4-6,5-12,5-20,absent,acute,anther,apex,base,berry,branched,brown,calyx,cell,center,chartaceous,ciliate,cm,connected,densely,denser,diameter,dm,drying,elliptic,elliptic-ovoid,entire,filament,flower,fruit,globose,herb,immature,large,linear-lanceolate,lobe,margin,maturing,membranaceous,mm,moderately,nearly,new,notched,oblong,obtuse,outer,parallel,pedicel,peduncle,per,perpendicular,petiole,placenta,pubescent,raised,ridge,rotate,rounded,running,seed,semitransparent,short,significantly,single,smaller,smoother,sparsely,stigma,style,swollen,tube,vein,wall,white,x,yellow	1-2,2-4,2-6,3-6,3-9,abaxially,abundant,adaxiall,adaxially,along,axe,beyond,blade,celled,cordate,decurrent,dehiscing,eaf,eed,emarginat,equal,explosively,exserted,flat,frui,geminat,glabrous,growt,hair,held,interpetalar,long,lower,lying,maturit,mesocarp,nfloresence,often,one-,orolla,pressure,pubescen,rachi,ruit,slightly,sometimes,stamen,straight,tal,tamen,tem,tissue,triangular,two-celled,unbranched,unit,usually,vary,watery,wid,woody,ympodial	appearance,arrangement,bark,border,branch,bud,characteristic,colour,corolla,corrugation,distal,exertion,form,fruiting,giving,glabrousnes,growth,height,history,inflorescence,interjected,lateral,leaf,leaflet,length,life,lobing,midpoint,na,number,ovary,plant,prickle,primary,pseudostipule,ray,shape,size,stem,surface,terminal,texture,thicknes,type,variation,wide,width
152	wfo-0001027471	invalid_json_followup	165	146	103	62	43	0.624	.5,/4,0.1-0.2,0.2-0.5,0.4-1,0.5,0.5-0.6,0.5-0.7,0.5-1.5,0.9-1,1-1.2,1.4-3,2-2.5,2-3,2-lobed,3-4,3-7,4-5,6-7,acute,age,anther,anthesi,apex,bark,base,berry,bifid,branched,calyx,cm,conical,corolla,dendritic,densely,diameter,drying,elliptic,entire,erect,filament,flattened,flower,fruiting,glabrous,globose,growth,herb,included,inflorescence,internodal,lamina,leaf,leaf-opposed,lengthening,less,like,lobe,margin,maturity,minutely,mixture,mm,new,nodding,open-conical,ovary,ovate,pair,pale,pedicel,peduncle,petiole,pitted,pore,poridical,primary,pubescent,red-orange,reniform,shape,shrub,simple,size,slender,slit,small,somewhat,sparsely,stem,stigma,style,subshrub,surface,tan,tip,trichome,tube,vein,way,white,x,yellowish	0.2-0.4,0.7-0.9,1-1.5,1-1.6,1.5-2,abaxially,adaxially,along,appressed,ascending,brittle,c.,closely,deltate,desnsely,differing,difoliate,distant,eaf,eed,erec,especially,free,furcate-dendritic,geminate,lobed,long-triangular,lower,major,midvein,minor,nflorescence,node,occasionally,orbicular,overlapping,papillat,perfect,pericarp,petal,planar,plane,portion,pubscent,rachi,reflexed,ruit,scar,scattered,similar,slightly,spaced,straight,thickened,thin,trifoliat,ud,uniseriate,unit,usually,woody,ympodial	'',[,``,arrangement,branch,bud,cal,cayx,characteristic,colour,corrugation,distal,exertion,form,fruit,glabrousnes,height,history,interjected,lateral,leaflet,length,life,lobing,midpoint,na,number,papillate,per,plant,prickle,pseudostipule,ray,seed,terminal,texture,thicknes,type,value,variation,width,{,}
153	wfo-0001027473	success	138	129	85	53	44	0.616	/2,0.25-0.5,0.5-1,0.8-1,1-2,1.3-2,1.5-2,1.8-2,2-2.5,2.5-3,3.5-5,4.5-13,6-9,8.5-37,?,acute,adaxially,anther,apex,bark,base,berry,brown,calyx,clavate,cm,conical,corolla,decurrent,dendritic,densely,di-,dia,drying,erect,filament,flattened-reniform,fruiting,giving,glabrous,globose,green,incrassate,later,lateral,leaf,lobe,long,long-triangular,main,margin,minutely,mm,near,obovate,occasionally,ovary,pair,pale,pedicel,petiole,pitted,pointed,pubescent,pubesent,rusty,sessile,shape,shrub,somewhat,sparsely,stem,stigma,style,subshrub,surface,thick,trichome,trifoliate,tube,vein,way,white,wide,yellowish	.25,1-1.5,1/3,5,abaxially,absen,along,anthesi,ape,apparently,deccurent,deep,deflexed,denser,differing,eaf,eed,empty,free,geminat,less,like,lobed,lower,major,middle,minor,minute,older,overall,papillo,planar,pore,poricidal,portion,rootstock,ruit,sac,shaped,sterile,strongly,tall,tear-drop,tip,unit,usually,widest,wing,winged,woody,yellowish-brow,ympodial,young	absent,appearance,arrangement,border,branch,bud,characteristic,colour,corrugation,diameter,distal,exertion,form,fruit,glabrousnes,growth,height,history,inflorescence,interjected,leaflet,length,life,lobing,midpoint,na,new,number,peduncle,per,plant,prickle,primary,pseudostipule,ray,seed,size,terminal,texture,thicknes,type,variation,width,yellowish-brown
154	wfo-0001027483	success	164	127	81	83	46	0.494	0.2-1.9,0.6,1,1-2.5,1-4,1-5,1.2-2.5,1.5-10,1.5-2.6,1.5-3,2-4,2-4.5,3-15,3-6,3.5-20,5-6,acumen,acute,apex,apically,articulate,base,branched,calyx,cm,coarsely,connate,corolla,cuneate,cyme,dehiscent,diameter,dichasial,dichasially,distal,ebracteate,elliptical,filament,finely,flat,globose,green,green-white,herbaceous,interjected,lateral,leaf,leaflet,light,lobe,long,medium,minute,mm,monochasial,mucilaginous,obtuse,odd-pinnate,ovate,ovoid,pedicel,peduncle,perennial,petiole,plant,poricidally,pubescent,ray,rotate,rounded,seed,size,stigma,straight,style,terminal,tuber-bearing,violet,violet-purple,wide,yellow	0-1.,1-2,2,2-3,3-6-foliat,4.5-8,5-10,abaxially,adaxially,apical,basal,cell,covering,decurrent,digestion,diminishing,dorsally,dot,eaf,edge,eed,emoval,enzyme,erec,exceeding,flower,folded,forked,generally,globo,gradually,hair-like,half,honeycomb,interpetiolar,introrse,lighter,living,lon,lower,lunat,make,maturing,nflorescence,nther,often,orolla,pair,pattern,perfect,petiolule,plan,proximal,purple,rachi,reveal,rosette,ruit,sessile,seudostipule,short,slit,smooth,sometimes,specimen,stamen,subsessile,tall,tem,testal,thick,throughout,tissu,toward,typically,uniform,unit,vary,varying,wall,white,ympodial,Â¼	0-10,anther,appearance,arrangement,bark,border,branch,bud,characteristic,colour,corrugation,drying,exertion,form,fruit,fruiting,giving,glabrousnes,growth,height,history,inflorescence,length,life,lobing,margin,midpoint,na,new,number,ovary,per,prickle,primary,pseudostipule,shape,stem,surface,texture,thicknes,tube,type,variation,vein,wet,width
155	wfo-0001027506	invalid_json_followup	215	162	120	95	42	0.558	-7,-7.5,.2,.5,/6,0-10,0-60,0.1-0.3,0.5-1.5,0.5-6,0.7-1.3,0.8-1.5,1-2,1.2-1.5,1.5-2.2,1.8,1/3,10-40,2-3.2,2.2-3.5,2.5-5,3-6,5-10,5-7,acuminate,acute,anther,apart,apex,apically,apparently,articulated,bark,base,becoming,berry,brown,calyx,cell,chartaceous,cm,concolorous,connivent,cordate,cream,cuneate,curved,dark,densely,diameter,distal,drying,entire,erect,filament,fine,flattened,flattened-reniform,fruit,fruiting,green,lateral,leaf,length,lobe,lobed,long,margin,marking,maturity,mauve,midpoint,mm,narrow-deltate,occasionally,orange,orange-brown,outline,ovate,pair,pale,pedicel,peduncle,per,petiole,pit,plant,poricidal,prickle,prickly,primary,purple,raised,ray,reddish,shrub,simple,small,smooth,sometimes,spaced,spherical,stellate-pubescent,stem,style,subentire,surface,tapering,terminal,tip,tree,truncate,tube,upper,vein,way,wide,yellow,yellow-green,young	-0.35,-1,-20,-3,/2,0,0-2,0-6,0.1-,0.2,0.2-0.3,0.25,1-3,1-4,1/6-1/4,2.5-8,3-10,3-5,3.5-5,5-merous,6-13,6.5-10,7-8,7-9,8-10,9-13,abaxially,acuminat,alyx,ame,andromonoecious,apar,blade,branched,brow,c.,dry,eaf,eed,elongating,equal,flower,free,glabrescent,glabrous,hard,hermaphrodite,heterostylous,infructescence,lengt,long-styled,longer,lower,lowermost,mature,moderately,multangulate,nflorescence,older,one,open,orolla,oung,pendulous,pericarp,plurifoliat,porrect,portion,prickl,reduced,reflexed,ruit,scar,sessile,short-styled,spreading,stalk,stalked,staminat,stellate,stout,tamen,terete,tertiary,time,trichome,twice,unarmed,unit,variously,vary,venation,visible,woody,ympodial	'',.8,6,[,``,arrangement,branch,bud,characteristic,colour,corolla,corrugation,exertion,form,glabrousnes,growth,height,history,inflorescence,interjected,leaflet,life,lobing,na,new,number,ovary,perennial,pseudostipule,seed,shape,size,stelate-pubescent,stigma,texture,thicknes,type,value,variation,width,{,}
156	wfo-0001027548	success	216	127	90	126	37	0.417	-11.5,0.3-1.2,0.5-2,1-1.5,1-3.5,1.5-2,10-12,3-7,4.5,6-9,8-9,acuminate,acute,almost,anther,apex,attenuate,base,berry,black,branch,brown,c.,calyx,capitate,cm,corolla,dark,densely,depressed-elliptic,diameter,ellipsoid,elliptic,entire,exserted,filament,flattened-reniform,flexuous,fruiting,glabrous,globose,green,growth,immature,inflorescence,leaf,like,lilac,lobe,long,loosely,margin,membranous,minute,minutely,mm,narrowly,new,pair,pale,pedicel,peduncle,per,petiole,pitted,primary,puberulent,pubescent,reddish,revolute,ripe,simple,size,slender,stem,stigma,strongly,style,surface,terminal,tinged,tube,type,vein,vine,warty,way,white,woody,x	.3,0.2,0.5,1,1-10,1-2.5,1.2,1.5,1.5-2.5,10-50,4-6,4-8,5-merou,7-10,abaxiall,adaxially,ag,along,also,although,alyx,anthesi,apart,apical,apparently,appearing,area,ark,articulated,articulation,axi,basal,beneath,bent,branched,branching,bu,cell,conical,connivent,darker,deflexe,deltate,dendritic,denser,drying,dull,eaf,early,eed,elongate,em,extending,flower,free,geminat,glabrescen,glandular,half,herbarium,ilament,irregularly,lamina,leaving,lengthening,less,lobed,lon,long-styled,loose,lower,many,matte,mixed,near,nflorescence,occasionally,older,orolla,outline,papillae,papillate,papillo,perfect,pericarp,planar,plurifoliate,point,pore,poricidal,portion,prominent,rachi,rectangular,ruit,scar,scattered,slit,small,sometimes,somewhat,spaced,sparse,sparsely,specimen,spreading,stellate,swollen,tapering,testal,thickened,thin,time,tiny,tip,transparent,trichome,twinin,ud,uniseriate,unit,upper,usually,vary,yellow,ympodial	1.2-2.5,8,appearance,arrangement,bark,border,bud,characteristic,colour,distal,exertion,form,fruit,giving,glabrousnes,height,history,interjected,lateral,leaflet,length,life,lobing,midpoint,na,number,ovary,plant,prickle,pseudostipule,ray,seed,shape,texture,thicknes,variation,width
157	wfo-0001027581	invalid_json_followup	200	157	100	100	57	0.5	100+,12,200,>,acute,along,anther,anthesi,apex,axe,base,berry,branched,branching,broadly,brown,c.,calyx,clavate,cm,corolla,cup-shaped,dark,densely,diameter,discolorous,drying,echinoid,ellipsoidal,elliptic,entire,evenly,exserted,filament,flattened-reniform,flower,fruiting,glabrescent,glabrous,globose,golden,gradually,green,growth,inflorescence,leaf,length,like,lobed,long,many,margin,minute,minutely,mm,moderately,multangulate,multiseriate,narrowing,new,nodding,pair,part,pedicel,peduncle,per,petiole,pitted,plane,primary,pubescent,purple,ray,reddish,ripe,scarcely,sessile,shrub,simple,size,small,sparsely,stalk,stellate,stem,stigma,stout,style,surface,terminal,time,tree,trichome,tube,undersurface,upper,vein,way,wide,yellowish	0.2â0.3,0.3,0.3â1,0.5â1,0.5â1.5,1,1.2â1.5,1.3â1.5,1.5,1.5â2,1.5â3,10,10â16,12â30,15â20,1â1.5,1â3-rayed,2.5â3,3.5â4.5,3â3.5,4.5â16,4â8,5-merou,6â7,7â10,7â9,8,8â10,9â11,9â9.5,abaxial,abaxially,adaxial,ag,alyx,apar,ark,articulated,beneath,brow,bulbous,clearly,closely,connivent,deltate,dichasia,distally,eaf,eed,erec,free,greyish,ilament,lamina,largest,lengthening,less,lobe,longest,loosely,lower,midvei,mixed,near,nflorescence,older,orolla,papillo,perfect,pericarp,plurifoliate,pore,poricidal,porrect-stellate,portion,reflexed,rhachi,ruit,scar,shiny,short-stalked,slit,smaller,spaced,spreading,tall,tem,thin,tip,ud,unevenly,unit,vary,varying,visible,weak,whit,woody,yellow,ympodial	'',0.2-0.3,0.5-1,1-1.5,1-3-rayed,1.2-1.5,1.3-1.5,1.5-2,1.5-3,12-30,15-20,2.5-3,3-3.5,4-8,4.5-16,7-10,7-9,9-11,9-9.5,[,``,arrangement,bark,branch,bud,characteristic,colour,corrugation,distal,exertion,form,fruit,glabrousnes,height,history,interjected,lateral,leaflet,life,lobing,midpoint,na,number,ovary,plant,prickle,pseudostipule,seed,shape,texture,thicknes,type,value,variation,width,{,}
158	wfo-0001027584	invalid_json_followup	144	143	92	52	51	0.639	-16,-2,0.5-1.5,0.9-1,0.9-2.5,1-1.2,1.2-1.4,1.5-2,1.6-1.9,10-15,11.5-45,2,2-10,3,3-.,4-6,4-7,4.5-20,7-10,abruptly,absent,acuminate,anther,anthesi,apex,attenuate,bark,base,becoming,branch,branched,calyx,cell,cm,conical,corolla,darker,diameter,ellipsoid,elliptic,filament,flattened,four,fruit,fruiting,glabrous,green,herb,lamina,lobe,long,margin,minutely,mm,nearly,outer,outline,ovary,ovate,pair,pale,papillate,pedicel,peduncle,per,petiole,pointed,primary,reddish,regularly,reniform,scattered,shrub,sinuate,sparsely,stem,stigma,striate,stripe,style,suffruticose,surface,tan,time,trichome,tube,uniseriate,vein,wall,white,without,x	..,.5,0.5-1,1.5-8,100,2.5-3,8-9,apical,beginning,beneath,brittle,broadly,brow,c.,capitat,cucullate,deflexe,deltate,densely,dry,eaf,edicel,eed,erec,flower,irregular,lobed,lower,markedly,narrowly,nflorescence,open,pericarp,planar,plurifoliat,present,ruit,scar,single,single-stemmed,small,smooth,sparse,testal,thickening,thin,tip,triangular,tuft,ud,unit,ympdoial	'',[,``,appearance,arrangement,border,brown,bud,capitate,characteristic,colour,corrugation,deflexed,distal,drying,exertion,form,giving,glabrousnes,growth,height,history,inflorescence,interjected,lateral,leaf,leaflet,length,life,lobing,midpoint,na,new,number,plant,plurifoliate,prickle,pseudostipule,ray,seed,shape,size,terminal,texture,thicknes,type,value,variation,width,{,}
159	wfo-0001027600	success	185	132	90	95	42	0.486	0.5-1.5,1,1-14,1-4,1-5,1.5-2,10-,10-20,15-25,2-18,2-3,2-4,2-4.5,2-6,2.5-21,20-30,3-5,3-5-lobed,abaxially,acuminate,acute,adaxially,adpressed,along,apex,apical,apiculate,basal,base,calyx,cm,concave,cordate,cuneate,deltate,densely,diameter,ellipsoidal,entire,except,fading,flattened,flower,forked,fruit,glabrous,gland,greenish-white,leaf,lobe,lobed,main,margin,mature,midrib,minutely,mm,moderately,oblong,obtuse,occasionally,orange,ovoid,pedicel,peduncle,petiole,pilose,pinnately,puberulence,puberulent,purple,purplish,rarely,rounded,simple,stigma,style,subcoriaceous,surface,tip,tree,truncate,two,unbranched,unlobed,vein,white,x,yellow,yellow-green	-10,-3,0.5-1,1-2,1.5-2.5,1/2-3/4,2-11,2-3.5,2-5,2.5-6,3-15,3-6,4-6,4-foliat,5-13,8-17,abruptly,absen,absent,adaxial,aggregate,apart,ape,articulated,axe,beyond,blade,brow,campanulate,cell,channe,collection,connective,coriaceous,cream,dilated,directed,distally,divided,eaf,eed,elliptic,especially,exceeding,exserted,fleshy,glabrescent,glandular-puberulent,laterally,leaving,lon,long,lower,narrowed,nflorescence,nther,obconical,older,orolla,ovate,papillose,pedicellar,perfect,pilo,pore,puberulen,pubescent,rachi,radiu,remnant,ruit,shorter,sinus,slightly,small,somewhat,spaced,sparsely,stamen,stone,strongly,tal,tem,thecae,time,tomento,triangular,tube,ud,unit,vary,wide,yellowish,ympodial,young	anther,appearance,arrangement,bark,border,branch,bud,characteristic,colour,corolla,corrugation,drying,filament,form,giving,glabrousnes,green,growth,height,history,inflorescence,lateral,length,life,midpoint,na,new,ovary,perennial,plant,prickle,primary,ray,seed,shape,size,stem,texture,thicknes,type,variation,width
160	wfo-0001027607	success	167	129	100	67	29	0.599	.1,.25,.5,0.25-0.5,0.5,0.8-1,1-4,1.2-1.5,1.5-3,2-2.5,2-3,2-4,2.5-3,3-3.5,3/4,4-10-flowered,5-10,5-7,8-9,acuminate,acute,anther,apex,arching,area,aspect,bark,base,berry,branch,brown,calyx,cm,corolla,curling,dark,decurrent,deltoid,densely,dia,dry,elliptic,erect,exserted,filament,filiform,flattened,fruiting,giving,glabrous,globose,golden,green,lateral,leaf,like,long,main,material,minute,minutely,mm,narrowly,obovoid,occasionally,older,ovary,ovoid-reniform,pagoda-like,pair,papillose,pedicel,petiole,pitted,plant,pubescent,reddish-brown,shaped,shrub,simple,slender,soon,stem,stigma,style,surface,tan,tear-drop,tip,trichome,tube,unifoliate,uniseriate,vein,way,white,widened,winged,x,zig-zag	0.5-1,1,age,anthesi,apar,ba,basal,becoming,branche,corky,deflexed,eaf,edicel,eed,ellipsoid,elongate,evenly,except,f,free,geminate,gently,glabrate,lamina,lenticellat,less,lobe,lobed,lon,lower,m.,middle,midrib,narrow,nflorescence,non-reproductive,opposite,pore,poricidal,portion,present,prominent,raised,rarely,reflexed,ruit,scar,short,slight,slightly,small,spaced,straight,strongly,styl,tall,tapering,treelet,tub,ud,unit,widening,widest,woody,yellowish,ympodial,young	arrangement,bud,characteristic,colour,corrugation,diameter,drying,exertion,form,fruit,growth,height,history,inflorescence,length,life,lobing,margin,na,number,peduncle,per,perennial,primary,seed,shape,size,texture,type
161	wfo-0001027618	invalid_json_followup	202	143	89	113	54	0.441	-10,1,1-23,1-3,1-5,1-9,15-35,2-11.5,2-27,2-5,2.5-6,3-30,3-5,3-7,4,5-30,5-7.5,6-40,8-16,8-35,apex,articulated,base,branched,bud,campanulate,capitate,chartaceous,cm,compound,cordate,cuneate,deltate,densely,diameter,ellipsoidal,elliptic-ovate,entire,fleshy,flower,fruit,fusiform,glabrous,globose,greenish,lateral,leaf,leaflet,leaving,length,less,lobe,long,margin,membranaceous,minutely,mm,near,oblong,orange,pedicel,pedicellar,peduncle,per,petiole,pinnately,puberulent,pubescent-pilose,purple,remnant,reticulate,ripe,shrub,simple,stigma,style,sympodial,terminal,triangular,truncate,tube,unbranched,unit,urceolate,white,wide,width,x,yellow	-pubescent,0-10,0.5,0.5-1,0.5-6,1-,1-1.5,1-13,1-14,1.4-4,1.5-13,1.5-3,1.5-7,1.5-8.5,11-16,11-22,11-pinnate,12-27,15-30,2-11,2-12,2-8.5,2-9,3-18,3-7-pinnate,3.5-6,4-8,5-18,5-20,5-merous,5.5-12,6-25,7-25,abaxially,acuminat,acut,acute,adaxially,aggregate,also,alyx,apart,ape,ascending,axe,basal,beyond,blade,cell,connective,cylindrical,darker,dia,diamete,dilated,directed,distally,eaf,eed,elliptic,exceeding,exserted,laterally,lon,longitudinal,lower,mesocarp,moderately,nflorescence,nther,obovate,obtu,obtuse,often,orolla,ovate,papillose,perfec,perfect,petiolule,pilo,pilose,pore,presen,puberulent-pilo,puberulent-pubescent,pubescent,rachi,radiu,ranch,ratio,rown,ruit,runk,shallowly,shorter,slightly,small,sometimes,somewhat,spaced,sparsely,spreading,stamen,stone,stripe,tal,thecae,tomentose,tree,uni,vary,without	'',1-8.5,1.4-,[,``,acuminate,anther,arrangement,bark,branch,calyx,characteristic,colour,corolla,corrugation,distal,drying,exertion,filament,form,fruiting,glabrousnes,growth,height,history,inflorescence,interjected,life,lobing,midpoint,na,new,number,ovary,perennial,plant,prickle,primary,pseudostipule,puberulent-pilose,ray,seed,shape,size,stem,surface,texture,thicknes,type,value,variation,vein,{,}
162	wfo-0001027622	invalid_json_followup	203	166	120	83	46	0.591	.5,0-14,0-16,0.3-10,1,1-2,1.5-3.5,1.5-4.2,1.6-4.5,12-23,2-25,2-6,2.5-3.5,3-4.5,3.5-11,4-9.5,5-11,6-7,8-16,8-20,abaxially,acuminate,acute,adaxially,anther,apex,articulated,axillary,base,berry,blue,blue-purple,broadly,brownish,bud,cell,chartaceous,clavate,cm,condition,connivent,corolla,covering,diameter,distal,drying,elliptical,erect,filament,flower,forked,fresh,fruit,generally,glabrescent,glabrous,globose,green,green-white,greenish,hair-like,half,herb,interjected,lanceolate,lateral,leaflet,light,lobe,long,make,margin,membranous,middle,mm,mottled,mucilaginous,narrowly,oblique,odd-pinnate,ovate,ovate-lanceolate,ovoid,pale,pedicel,peduncle,petal,petiole,plant,poricidal,pubescent,purple,rounded,seed,shortly,size,slightly,star,stem,stigma,striped,style,subglabrous,subtending,terminal,testal,thick,throughout,tip,truncate,tube,unwinged,usually,wall,wet,whitish,wide,wing,x,yellow	1-10,1/,2-3,3-16,3-4,4-5,5-merou,6-17,acumen,ag,along,alyx,apart,apparently,axe,blade,borne,capitat,ciliate,decumben,different,digestion,dorsally,eaf,edge,eed,elliptic,end,enzyme,especially,exceeding,except,flat,folded,geminat,glabrou,greatly,hair,homostylous,honeycomb-shaped,lengthening,like,living,lower,midrib,minutely,nflorescence,often,orolla,pair,pentagonal,perfect,petiolule,plurifoliate,population,pore,proximal,puberulent,reduced,removed,ruit,seudostipule,singly,slit,sometimes,spaced,specimen,stamen,ste,stellate,stolo,straight,subequal,tall,tamen,tem,tri-,tuber,typically,unit,vary,varying,ympodial	'',1/3,[,``,arrangement,bark,branch,calyx,capitate,characteristic,colour,corrugation,decumbent,exertion,form,fruiting,glabrousnes,growth,height,history,inflorescence,leaf,length,life,lobing,midpoint,na,new,number,ovary,per,prickle,primary,pseudostipule,ray,shape,surface,texture,thicknes,type,value,variation,vein,width,{,}
163	wfo-0001027624	invalid_json_followup	189	149	102	87	47	0.54	0-7,0.1-0.9,0.3-1,0.4-3,0.5-1.5,0.8-5.6,1-2,1.1-8.4,1.2-2.6,1.3-2.9,1.5-6.6,2-20,2.4-4.8,2.9-12,3-10,3-11,4-8,5-9,6-18.5,9-41,abaxially,acute,adaxially,anther,apex,axillary,base,berry,brownish,bud,cell,clavate,cm,condition,connivent,corolla,covering,cuneate,deep,densely,diameter,distal,drying,elliptic,entirely,erect,filament,flower,forked,fresh,fruit,glabrous,globose,green,green-white,greenish,hair,half,herb,interjected,lanceolate,lateral,leaf,leaflet,light,lobe,long,make,mm,mottled,mucilaginous,odd-pinnate,ovate,ovoid,pedicel,peduncle,petiole,plant,pubescent,purple,seed,short,size,slightly,sometimes,stigma,style,subtending,terminal,testal,thick,throughout,tube,unwinged,usually,wall,wet,white,whitish,wide,x,yellow	0-3,1-3,1-5,2-5,2-7,3-4,3-5,4-15.2,4-7,5-merou,acuman,acumen,acuminate,ag,along,alyx,apart,apparently,arranged,articulated,axe,bead,blade,capitat,considerably,decreasing,decumben,decurrent,digestion,dorsally,eaf,edge,eed,enzyme,exceeding,flat,folded,geminat,glabrou,hair-like,homostylous,honeycomb-shaped,larger,leave,lengthening,like,living,lower,middl,moniliform,multiple,necklace,nflorescence,onto,orbicular,orolla,pair,pentagonal,perfect,plurifoliate,pore,poricidal,present,rachi,removed,rotate,ruit,sessile,seudostipule,slit,spaced,specimen,stamen,stolon,straight,tall,tamen,tem,tip,toward,tri-,tuber,typically,unit,vary,widely,ympodial	'',[,\u201chair-like\u201d,``,arrangement,bark,branch,calyx,capitate,characteristic,colour,corrugation,decumbent,exertion,form,fruiting,glabrousnes,growth,height,history,inflorescence,length,life,lobing,margin,midpoint,na,new,number,ovary,per,prickle,primary,pseudostipule,ray,shape,stem,surface,texture,thicknes,type,value,variation,vein,width,{,}
164	wfo-0001027626	success	152	130	81	71	49	0.533	.3,.5,0.1â0.2,0.2â0.6,0.5-1,0.7â1,1,1.3â4.5,1.5â2,13â14,2â5,3â4,3â4.5,4.4â11,4â6,5â6,8,9â18,acuminate,acute,adaxially,anther,apex,arrangement,base,berry,calyx,chartaceous,cm,cordate,coriaceous,diameter,distichous,elliptical,entire,extra-axillary,filament,fleshy,flower,fruit,fruiting,glabrous,greenish-white,lanceolate,leaf-opposed,liana,lobe,long,margin,maturity,minutely,mm,moderately,nearly,oblique,ovate,pedicel,peduncle,petiole,pinnate,possibly,pubescent,reflexed,sand-punctate,scandent,shrub,slender,somewhat,spindle-shaped,stigma,style,terminal,tip,trichome,tube,unbranched,unknown,vein,white,wiry-woody,x	0.5â1,0.7â2.8,1.5â8,14â116,2â3,2â49,3â5,3â55,5-merous,abaxially,accrescen,along,alyx,apar,axe,blade,broadly,c.,capitat,center,ciliat,clavate,climbing,color,densely,distant,distinct,eaf,eed,frequently,glabrou,immature,lamina,line,lower,m.,membranous,midvein,mor,nflorescence,nternode,orolla,pair,perfec,petal,plurifoliat,pointed,rachi,rounded,ruit,sand-punctat,scar,secondary,seen,shortly,side,simple,spaced,sparsely,ste,stellate,tamen,tem,time,truncate,two,unit,vary,venation,wide,ympodial	appearance,bark,border,branch,bud,capitate,characteristic,colour,corolla,corrugation,distal,drying,exertion,form,giving,glabrousnes,growth,height,history,inflorescence,interjected,lateral,leaf,leaflet,length,life,lobing,midpoint,na,new,number,ovary,per,plant,plurifoliate,prickle,primary,pseudostipule,ray,seed,shape,size,stem,surface,texture,thicknes,type,variation,width
165	wfo-0001027630	success	149	101	68	81	33	0.456	.1,0.5-1.2,0.5-2,1-1.5,1-5,1.5-2,2-3,3/4,4-6,8-9,acute,anther,anthesi,apart,apex,bark,base,berry,calyx,climbing,cm,corolla,deflexed,densely,erose,filament,fruit,fruiting,glabrate,glabrous,globose,golden,green,hirsute,lanceolate,leaf,linear,long-acuminate,margin,minutely,mm,near,ovary,papillose,partially,pedicel,petiole,puberulent,pubescent,reflexed,scar,shaped,shrub,simple,slender,sparsely,stem,stigma,style,tapering,tear-drop,tip,trichome,tube,way,white,winged,yellowish	.2,.5,0.05-0.1,0.5-1,1.4-1.7,2-6-flowered,5.5-11.2,6-10,also,arising,beginning,blunt,branchlet,broadly,ciliate,de,decurrent,deltoid,dia,distinguishable,eaf,edicel,eed,elongat,except,extreme,free,globo,immature,indistinct,inflorescenc,internodal,irregularly,knob-like,known,lateral,lobe,lobed,lon,long,lower,main,middle,midrib,nflorescence,novo,occasionally,older,opposite,pair,paler,pore,poricidal,portion,prominent,proximal,raised,rest,rounded,ruit,seen,spaced,straight,strongly,swollen,tall,terminal,thickened,ti,ud,ultimate,unifoliat,uniseriate,unit,vein,wide,widest,wing,x,ympodial,young	arrangement,bud,characteristic,ciliation,colour,density,diameter,distance,elongate,form,glabrousnes,growth,height,history,inflorescence,length,life,lobing,na,new,number,per,perennial,plant,seed,shape,size,spacing,surface,texture,type,unifoliate,width
166	wfo-0001027661	success	222	138	116	106	22	0.523	+,0.5,0.5-,0.5-2,0.6-1.1,0.6-1.5,1-7,1.2-6,1.3,1.5-2,2.5-7,30,4.5-6,5-9,6-12,6-9,8-10,>,acuminate,acute,anther,anthesi,apex,base,berry,branch,bright,calyx,capitate,cm,column,connivent,cordate,corolla,creeping,deeply,dendritic,diameter,ellipsoid,entire,extremely,filament,flattened,fruiting,fused,glabrous,globose,grey,growth,herbaceous,lateral,leaf,leaf-opposed,like,lobed,long,long-exserted,margin,minute,minutely,mixture,mm,moderately,new,pair,pale,pedicel,peduncle,per,petiole,pinnatifid,pitted,primary,pubescent,purple,red,reniform,ripe,shape,short,simple,single,size,slender,sparsely,spreading,stellate,stem,stigma,style,surface,tan,terminal,ternately,tightly,trailing,trichome,truncate,tube,turbinate,two,type,underground,uniseriate,usually,variable,vein,vine,violet,way,white,wide,woody,yellow,yellowish,Â¾	-10,1-,1-1.5,1-5,1.5,2,2.5-3,4-15,4-8-celled,40,5-merou,6-8,<,abaxially,adaxiall,ag,along,alyx,apart,ark,articulate,axi,basal,branched,broadly,cell,commonly,conical,densely,denser,density,eaf,eed,elliptic,even,flower,free,gre,green,ground,hue,ilament,irregularly,lamina,leaving,lengthening,lobe,lower,many,markedly,membraneous,narrowing,near,nflorescence,occasionally,often,older,open,orolla,outline,ovate,papillat,papillate,papillo,peg,pentagonal,perfect,pericarp,plurifoliat,pointed,pore,poricidal,portion,prominent,pubescen,pubescence,purplish,rachi,rarely,reflexed,ruit,scar,shiny,sinus,sleeve,slit,small,spaced,spot,spreadin,strongly,swollen,tangled,tem,testa,thin,time,tip,triangular,ud,unieriate,unit,upper,vary,ympodial,zig-za	arrangement,bark,bud,characteristic,colour,exertion,form,fruit,glabrousnes,height,history,inflorescence,length,life,lobing,na,number,ovary,papillose,plant,seed,texture
167	wfo-0001027714	invalid_json_followup	251	148	104	147	44	0.414	+,.5,/3,0,1-1.5,1-1.6,1-2,1.5-2.5,1.5-3,1.5-5,14-16,2-2.5,4-5,4.5-5,5,5-6,6-7,7-20,acuminate,acute,almost,anther,apex,appearance,basal,base,berry,bright,brown,calyx,capitate,cm,conical,cordate,corky,corolla,deep,densely,diameter,drying,ellipsoid,elliptic,entire,exserted,filament,flattened,fruit,fruiting,giving,glabrate,glabrous,globose,growth,immature,inflated,inflorescence,juicy,lateral,leaf,lobe,margin,mature,minutely,mm,new,obovate,occasionally,ovary,pair,pale,pedicel,peduncle,per,petiole,pitted,primary,pubescent,purple,red,reddish,reniform,ripe,seed,shiny,simple,slender,small,somewhat,sparsely,stem,stigma,strongly,style,surface,terminal,truncate,tube,vein,vine,violet,way,woody,x,yellowish	0.4,0.5,0.5-0.7,0.6-0.7,0.9-1.5,1,1-,1.5-2,2-,2-8,2.5-,2.5-4,2373.,3-3.5,4-10,5-10,5-merou,80,<,abaxial,abaxially,adaxial,adaxially,age,aid,along,alyx,angle,anthesi,apar,apice,ark,around,articulated,axi,branched,canop,cell,channelled,climbin,confined,connected,connivent,creating,cucullate,cupped,deflexed,dendritic,denser,eaf,eed,elongate,enlarged,especially,fide,fleshy,flower,free,furcate,glabrou,groove,hairy,hanging,ilament,individual,irregularly,lamina,large,leaving,lengthening,like,lobed,lon,long,longer,loosely,lower,many,marginal,mere,minute,mpodial,nee,nflorescence,nodding,often,older,orolla,otherwise,outline,papillate,papillo,peg,perfect,pericarp,petal,petiolule,pinnatifid,plat,plurifoliat,pore,poricidal,portion,prominent,pubescence,reaching,rectangular,rim,ruit,scar,showy,similar,sleeve,slightly,slit,spaced,spreading,stellate-rotate,tangled,tem,testa,testal,thecae,thick,thickened,thin,third,time,tiny,tip,tooth,trichome,twining,ud,uniformly,uniseriate,unit,upper,usually,visible,wall,weak,weight,widest,wing,yellow,younger	'',1-8,2-4,2.5-10,[,``,arrangement,bark,branch,bud,characteristic,colour,corrugation,distal,exertion,form,glabrousnes,h,height,history,interjected,leaflet,length,life,lobing,midpoint,na,number,papillose,plant,plate,prickle,pseudostipule,ray,shape,size,texture,thicknes,type,value,variation,width,{,}
168	wfo-0001027720	invalid_json_followup	184	149	99	85	50	0.538	0,0-15,0.25-0.35,0.3-5,0.4-0.8,0.5-0.8,0.8-1,1-1.5,1-2,1-3.5,1.5-2,13-35,15-25,2-3,2-4,2-7,2-branched,2-foliate,4-5.5,4-7,4.3-15,7-8,7-9,8-16,acute,anther,apex,articulated,base,berry,brown,calyx,chartaceous,cm,connivent,cuneate,deltate,diameter,distally,eglandular,elliptic,entire,extra-axillary,filament,flattened,flower,fruit,fruiting,glabrous,globose,green,inflorescence,lanceolate,lateral,leaf,length,lilac,lobe,long,loosely,margin,markedly,midpoint,mm,narrowly,notched,oblique,ovate,pale,part,pedicel,peduncle,per,perennial,petiole,porrect,prickle,pubescent,ray,red,sessile,shrub,simple,slightly,sparsely,stellae,stellate,stigma,straight,style,subreniform,surface,thicker,time,triangular,tube,unit,x,yellow	%,.25-0.3,0.15-0.25,0.4-0.7,0.5-1,0.6-1.2,1-locular,13-23,2.8-3.1,23-35,3-13,4-,4.3-7.5,5-merous,6,7-10,8-11,9-15,abaxially,absen,absent,adaxiall,adaxially,adult,alyx,apparently,axe,ba,blade,capitat,confined,cylindrical,densely,directed,distall,eaf,eed,erect,finger,geminat,gland-tipped,hair,half,hig,homostylous,incomplete,intepetalar,juicy,juvenile,lamina,less,lower,mature,mesocarp,mid-point,midrib,minute,nflorescence,orolla,perfec,perfect,pore,present,rachi,rhizomatous,ruit,scarce,septum,short,stellate-pubescent,succulen,tamen,tem,thick,tissue,toward,unarme,unarmed,upper,vary,white,wide,without,yellowi,ympodial	'',[,``,appearance,arrangement,bark,branch,bud,capitate,characteristic,colour,corolla,corrugation,distal,drying,exertion,form,geminate,giving,glabrousnes,growth,height,history,interjected,leaflet,life,lobing,na,new,number,ovary,plant,primary,pseudostipule,seed,shape,size,stem,sympodial,terminal,texture,thicknes,type,value,variation,vein,width,yellowish,{,}
169	wfo-0001027720	invalid_json_followup	272	198	133	139	65	0.489	.2,0,1/3,2.0,3.2,3.6,acuminate,acute,aequilateral,anther,apex,apical,apparently,appearing,attachment,attenuate,base,berry,bilobed,branch,broad,broad-based,bud,calyx,cancellate,capitate,channel,channeled,cm,concave,conical,connivent,corolla,cream,crisped,curved,deciduous,developed,diameter,distally,dry,either,elliptic,entire,erect,especially,extra-axillary,fertile,filament,flattened-irregular,flattened-orbicular,flattened-reniform,flower,fruit,glabrous,glandular,globose,gradually,growth,hair,heavily,increasing,internode,interpetalar,juvenile,lateral,lavender,leaf,long,margin,mature,midpoint,midvein,minute,mm,moderately,narrowly,notched,oblique,oblong,often,orange,ovate,pedicel,peduncle,per,petiole,point,poorly,pore,porrect,portion,potentially,prickle,pubescent,ray,red,scattered,sessile,short,shorter,shrub,side,simple,slightly,small,soon,stellae,stellate,stem,stigma,straight,style,subacute,subcoriaceous,surface,tissue,tree,triangular,tube,twice-branched,unarmed,upper,vein,violet,wavy,white,wide,yellow,yellow-ferruginous,yellow-tan,young,Â±equal	.0,.04,.3,.5,.9,0.1â0.6,0.2â0.4,0.3â0.4,0.7â0.9,0.7â1.1,0.7â1.2,0.8â1.3,0.8â1.9,0.8â2.0,0.9,1.4â1.9,1.5â1.7,1.5â2.0,1.5â2.5,1.5â3.3,1.5â9.0,1.7â1.8,1.7â2.0,1.7â2.5,1.8â2.0,1.9â2.2,1/2,1/3â1/2,10.0,10.8â18.2,12â16,13.0,19.7â30.0,2.5,2.5â2.8,2.5â2.9,2â3,3.7â5.7,3.9,4.0â12.6,4.0â18.0,4â5-merou,5.1â18.6,6.5â9.5,6â8,8.0,8.0â11.9,8.2â10.5,8.5â9.4,9.5â16.0,abaxially,adaxially,adnate,alyx,anthesi,apiculate,armed,articulated,axe,ba,becoming,blade,brochidodromous,colore,congested,dehiscence,densely,dentate,difoliate,dorsally,eaf,eed,emerging,endocarp,exocarp,filiform,free,geminat,glossy,homostylous,hooked,inclined,intersepalar,juic,lamina,large,least,like,line,lobe,lon,longer,lower,m.,major,midrib,minor,nearly,nflorescence,occasionally,orolla,part,perforate,porrect-stellate,presumably,proximal,raised,reflexed,rigid,rip,row,ruit,sinus,sparsely,splitting,spread,stamen,stellate-pubescen,stellate-pubescent,suture,tall,tamen,tem,thin,time,tip,toward,translucent,truncate,two,ud,vary,way,weakly,yellow-ferruginou,ympodia,youngest,Ã,â4	'',0.8\u20131.9,1.4\u20131.9,1.5\u20133.3,1.5\u20139.0,1.7\u20132.5,1.8\u20132.0,12\u201316,19.7\u201330.0,2.5\u20132.8,2.5\u20132.9,2\u20133,3.7\u20135.7,4.0\u201312.6,5.1\u201318.6,6.5\u20139.5,6\u20138,8.0\u201311.9,8.2\u201310.5,9.5\u201316.0,[,\u00d7,\u20134,``,arrangement,bark,characteristic,colored,colour,corrugation,distal,drying,exertion,form,fruiting,glabrousnes,green,height,history,inflorescence,interjected,leaflet,length,life,lobing,na,new,number,ovary,perennial,plant,primary,pseudostipule,seed,shape,size,terminal,texture,thicknes,type,value,variation,width,{,}
170	wfo-0001027757	success	186	114	72	114	42	0.387	0.5,2.5,abaxially,acute,anther,anthesi,apart,apex,articulated,axillary,base,blue,borne,brown,calyx,campanulate,clavate,cm,colour,dark,deeply,diameter,elliptic,erect,filament,flattened,fruit,glabrous,globose,hair,irregularly,lanceolate,leaf,leafy,lilac,lobed,long,margin,mm,moderately,multicellular,narrowly,oblong,obtuse,occasionally,often,ovate,pale,pedicel,peduncle,perennial,petiole,pitted,pubescent,regularly,rotate,shoot,shrub,simple,spaced,sparsely,stigma,style,surface,tube,unicellular,uniseriate,unknown,violet,white,woody,x	0.2,0.2â0.3,0.3â2.0,0.6,0.6â1.0,0.7,0â1.4,1.0â1.1,1.0â2.5,1.2â4.0,1.5â1.6,1.5â2.5,1.6â2.4,1.9â2.7,12,1â1.5,1â11,1â2,1â3,2,2.5â4,2.5â5.5,2.5â7,2â,2â10,3â12,3â5,4â9,5,5â,60â100,6â9,7â8,8â16,absen,accrescent,adaxiall,adaxially,ag,along,apical,arising,axe,ba,basal,blade,branching,cell,chartaceous,concave,connivent,convex,cylindrical,decurrent,densely,directed,distally,eaf,eed,entire,equal,erose,fleshy,flower,geminat,glabrescen,glabrou,lobe,lon,longitudinal,lower,m.,nflorescence,opening,opposed,orolla,pair,perfect,plurifoliate,pore,poricidal,primary,probably,rootstock,ruit,secondary,serrate,side,slit,smaller,sometimes,stone,straight,tall,tamen,tem,thic,thickened,time,tip,toward,unbranched,unit,vary,wide,yellow,ympodial,â19,â2.7,â3.2,â4.0,â5.5,â6,â9	-19,-2.7,-3.2,-5.5,-6,0-1.4,0.2-0.3,0.3-2.0,1.0-1.1,1.2-4.0,1.5-1.6,1.5-2.5,2-10,2.5-4,3-12,4-9,6-9,60-100,8-16,arrangement,characteristic,corolla,decurred,exertion,form,glabrousnes,growth,height,history,inflorescence,length,life,lobing,new,ovary,plant,seed,shape,size,stem,texture,type
171	wfo-0001027765	success	167	153	107	60	46	0.641	-30,-44,0.8,1,1-10,1-11.5,1-2,1-4,1-5,1.5-6,10-13,2-2.5,2-4,2.5-4,2.5-4.2,20-30,3-,3-12,5-15,5-6,5-8,7-20,acumen,acute,apex,apical,apically,apiculate,articulate,base,branched,calyx,cell,cm,connate,cordate,corolla,covering,cyme,dehiscent,diameter,dichasial,dichasially,distal,ebracteate,elliptic,exceeding,filament,glandular,globose,green,green-white,hair,hair-like,herbaceous,interjected,introrse,lateral,leaf,leaflet,light,lobe,long,make,maturing,mm,monochasial,mucilaginous,oblique,obtuse,odd-pinnate,often,ovate,ovate-lanceolate,ovoid,pedicel,peduncle,perennial,petiole,pilose,plant,poricidally,proximal,rounded,seed,short,simple,size,slightly,slit,stamen,stigma,straight,style,terminal,testal,thick,throughout,tone,truncate,tuber-bearing,violet,wall,white,wide,yellow,Â¼	-4,0-.,1-,2-3,3-20,3-6-foliat,5,abaxial,abaxially,abruptly,acuminate,cuneate,digestion,diminishing,dorsally,eaf,edge,eed,elliptic-lanceolate,emoval,enzyme,flat,flower,folded,forked,generally,globo,half,honeycomb,living,lon,lower,lunat,nflorescence,nther,orolla,ovate-elliptic,pair,pattern,perfect,petiolate,petiolule,plan,reveal,ruit,sessile,seudostipule,side,specimen,stellate,tal,tem,throughou,tip,toward,typically,unit,vary,without,ympodial	0-2,anther,appearance,arrangement,bark,border,branch,bud,characteristic,colour,corrugation,drying,exertion,form,fruit,giving,glabrousnes,growth,height,history,inflorescence,length,life,lobing,margin,midpoint,na,new,number,ovary,per,prickle,primary,pseudostipule,ray,shape,stem,surface,texture,thicknes,tube,type,variation,vein,wet,width
172	wfo-0001027807	success	116	126	78	38	48	0.672	.5,0-0.2,0.1-1,0.2-0.3,0.2-0.9,0.3-0.4,0.9-1,0.9-2.5,1-1.5,15-30,2-5,2-6,3.5-9,acuminate,acute,apex,attenuate,bark,base,berry,brittle,brown,bud,closely,cm,decurrent,diameter,dry,drying,elliptic,flattened,flower,fruiting,glabrous,globose,gray,grayish,green,growth,internodal,lanceolate,leaf,leaf-opposed,margin,material,maturity,minutely,mm,narrowly,new,occasionally,pair,pale,papillate,parallel,pedicel,peduncle,petiole,pitted,primary,reddish,reniform,revolute,seemingly,shrub,simple,slender,slightly,small,spaced,sparsely,stem,surface,tree,vein,winged,x,yellowish	abaxially,adaxially,almost,barely,deflexe,deflexed,difoliate,eaf,eed,ellipti,geminat,know,known,midrib,nflorescence,older,ot,overlapping,paler,papillae,plane,prominent,rachi,reddi,reproductive,ruit,scar,shoot,somewhat,thickened,ud,unifoliate,unit,usually,visible,white,ympodial,young	anther,appearance,arrangement,border,branch,calyx,characteristic,colour,corolla,corrugation,distal,exertion,filament,form,fruit,giving,glabrousnes,height,history,inflorescence,interjected,lateral,leaflet,length,life,lobe,lobing,midpoint,na,number,ovary,per,plant,prickle,pseudostipule,ray,seed,shape,size,stigma,style,terminal,texture,thicknes,tube,type,variation,width
173	wfo-0001027816	invalid_json_followup	187	158	116	71	42	0.62	.5,0.5-1,0.5-2,0.6-0.8,0.7-1,1,1-1.5,1-3,1.2-2,1.5-2,1.8-6,12-14,2-4,2/3,3-3.5,3.5-4,4-5,5-30,6-9,acuminate,acute,anther,anthesi,apex,attenuate,base,becoming,berry,bluish,branched,brown,calyx,capitate,cm,conical,corolla,dark,dense,densely,diameter,drying,ellipsoid,entire,erect,exserted,filament,filiform,flattened,flower,fruiting,glabrous,gland-tipped,glandular,globose,growth,half,inflorescence,lanceolate,lateral,leaf,less,like,linear,lobe,lobed,lower,margin,minute,minutely,mm,new,occasionally,often,orange,pair,patent,pedicel,peduncle,per,petiole,pitted,plant,primary,pubescent,purple,red,reddish,reniform,ripe,rounded,several,shrub,simple,slightly,sometimes,sparse,sparsely,stem,stigma,style,surface,terminal,time,tip,triangular,trichome,tube,ultimate,uniformly,uniseriate,vein,viscous,way,x,yellowish,Â½	..,0.2,0.5,1-1,1-4,2-2.5,5-merou,<,ag,almost,along,alyx,apar,ark,articulated,axi,cell,confined,connivent,cupped,eaf,eed,em,fleshy,free,ilament,irregularly,leaving,lengthening,loosely,m.,markedly,nflorescence,nodding,older,orolla,papillo,peg,perfect,perhaps,pericarp,plurifoliat,pore,poricidal,portion,prominen,pubescen,rectangular,ruit,scar,shiny,sleeve,slit,small,somewhat,spaced,spreadin,spreading,square,stellate,testal,thin,twinin,ud,unit,upper,usually,variable,vary,woody,ympodial	'',[,``,arrangement,bark,branch,bud,cayx,characteristic,colour,corrugation,distal,exertion,form,fruit,glabrousnes,height,history,interjected,leaflet,length,life,lobing,midpoint,na,number,ovary,papillose,prickle,pseudostipule,ray,seed,shape,size,texture,thicknes,type,value,variation,width,{,}
174	wfo-0001027819	invalid_json_followup	199	139	83	116	56	0.417	10-20,10-50,12-21,16-25,2-15,20-35,22-35,25-35,3-5,4,4-10,4-5,5-6,8-10,9-12,abaxially,acute,adaxially,apex,apical,base,branched,cm,concave,cordate,cuneate,densely,diameter,ellipsoidal,entire,especially,fading,finely,fleshy,forked,fruit,glabrous,globose,green,leaf,length,lobe,lobed,long,margin,mm,narrowly,oblong,obtuse,occasionally,pedicel,peduncle,per,petiole,pilose,probably,protuberance,puberulent,purple,rarely,rugose,simple,sometimes,sparsely,stigma,style,sympodial,tree,triangular,tube,two,umbrella-shaped,unbranched,unit,unknown,unlobed,usually,vein,whitish,wide,width,x,yellow	-100,0.5-1,1,1-,1-2,1-5,1.5-2,15-22,2,2-,2-3,20-25,20-40,3-40,3-5-lobed,4-15,4-25,5,5-merous,aggregate,also,alyx,apart,ape,apiculat,articulated,axe,ba,basal,beyond,blade,cell,ciliate,color,connective,cylindrical,deeply,denser,dia,diamete,dilated,directed,distally,divided,eaf,eed,eglandular,eglandular-pilose,elliptic,elliptic-ovate,equal,exceeding,except,exserted,flower,hair,halfway,leaving,lon,lower,main,mesocarp,midrib,moderately,narrow,near,nflorescence,nther,oblique,obtu,often,orolla,ovate,pedicellar,perfec,perfect,pinnately,pore,present,prominent,puberulen,puberulence,purplish,rachi,radiu,ranch,ratio,remnant,ripe,rounded,rown,ruit,runk,shallowly,short-acuminat,shorter,sinus,slightly,small,spaced,stamen,stellate,stone,strongly,subcoriaceous,swelling,tal,thecae,toward,truncate,ud,uni,vary,villous,without,young	'',[,``,anther,appearance,arrangement,bark,branch,bud,calyx,characteristic,colour,corolla,corrugation,distal,drying,exertion,filament,form,fruiting,giving,glabrousnes,growth,height,history,inflorescence,interjected,lateral,leaflet,life,lobing,midpoint,na,new,number,ovary,perennial,plant,prickle,primary,pseudostipule,ray,seed,shape,short-acuminate,size,stem,surface,terminal,texture,thicknes,type,value,variation,{,}
175	wfo-0001027834	invalid_json_followup	236	156	106	130	50	0.449	-6.1,0-110,0.2-0.3,0.2-0.6,0.4-1.1,0.9-1.8,1-1.6,1-1.9,1-10,1.1-1.6,1.1-1.8,1.4-2,10-25,2-8,2.3-3.4,25,3-15,4-5.2,5-merous,6.9-18.1,9-13,acuminate,acute,angled,anther,anthesi,apex,articulated,attenuate,bark,base,berry,blunt-tipped,branch,branched,brown,bud,calyx,cm,corolla,deltoid,diameter,drying,ellipsoid,entire,filament,finely,fleshy,flower,fruit,fruiting,glabrous,globose,granular-tomentose,gray,grooved,included,leaf,lenticular,lobe,longitudinally,margin,mm,numerous,obovate,obtuse,orbicular,ovate,ovate-elliptic,pair,pedicel,peduncle,petiole,primary,rarely,ray,reticulate-punctate,ripe,rounded,scabridulous,semi-spherical,short,shrub,simple,small,soft,sometimes,sparsely,stellate-pubescent,stem,stigma,style,subcampanulate,surface,tree,tube,turbinoid,vein,velutinous-tomentose,white,whitish,x,yellow,yellowish,yellowish-tan,yellowish-tomentose	.5-3,0.2-0.4,0.5-2,1-2.5,1.6-2.7,1.8-4.9,1/2,2-3.8,2.2-4.3,2.4-6.2,2.7-7.3,2.9-4.2,3-4.3,4-6,4.8-6.9,5-20,5.1-8,9-11.9,abaxial,abaxially,absent,accrescent,adaxial,adaxially,ag,alyx,apar,apical,around,axillary,ba,becoming,blade,branching,capitat,closely,completely,concentrated,connivent,coriaceous,covering,crown,cylindrical,dendritic-echinoi,dendritic-echinoid,densely,dichasia,directed,discolorous,distally,eaf,echinoi,echinoid,edge,eed,enclosing,enveloping,equal,erec,exserted,farinose,flat-topped,forming,glabrescent,hair,high,inserted,lengthening,less,light,lobed,long,long-stalked,longitudinal,lower,many,mostly,multangulat,multangulate,near,nflorescence,obscured,older,orolla,ovate-lanceolate,perfec,persistent,plurifoliate,pore,poricidal,porrect-stellate,pseudo-terminal,pubescence,pubescent,rachi,ruit,runk,scar,semi-ovate,sessile,short-stalked,slit,somewhat,spaced,spreading,stalked,stamen,stellate,subcoriaceous,suture,tamen,though,time,tip,tomentose,tomentu,tomentum,toward,trichome,ud,unarme,unit,usually,vary,villous,way,whitish-tomentose,wide,ympodial,young	'',[,``,appearance,arrangement,border,capitate,caylx,characteristic,colour,corrugation,distal,exertion,form,giving,glabrousnes,growth,height,history,inflorescence,interjected,lateral,leaflet,length,life,lobing,midpoint,na,new,number,ovary,per,perennial,plant,prickle,pseudostipule,pseudoterminally,seed,shape,size,terminal,texture,thicknes,type,unarmed,value,variation,width,{,}
176	wfo-0001027843	invalid_json_followup	154	152	103	51	49	0.669	.5,.75,0.5-0.75,0.5-1,0.8-3.5,1-1.2,1-1.3,1-1.5,1.2-1.5,3-15-flowered,3-6,5-6,6-13,6-9,acute,along,anther,anthesi,apex,bark,base,bearing,becoming,beneath,berry,broadly,calyx,clavate,cm,conical,corolla,curly,densely,dia,distally,ellipsoid,erose,exsertion,filament,flower,fruiting,glabrate,glabrous,globose,green,hairy,lamina,later,lateral,leaf,like,lobe,lobed,long,long-acuminate,main,margin,minutely,mm,near,nearly,older,one,ovary,ovate,pair,papillose,pedicel,petiole,pleated,pubescent,reflexed,shape,shaped,shrub,simple,sinus,size,slender,slightly,somewhat,sparsely,sparser,stem,stiff,stigma,straight,strongly,style,surface,tapering,tear-drop,time,tipped,trichome,tube,two,uniseriate,vein,white,winged,x,young	/3,1.2-2.5,2-2.5,2-4,apart,apiculate,ba,beginning,coroll,deflexed,deltoid,denser,differing,difoliate,eaf,edicel,eed,free,geminat,impressed,irregularly,known,larger,lon,lower,major,middle,minor,nflorescence,occasionally,opposite,orbicular,papillo,pore,poricidal,portion,prominent,proximal,reddish-gre,rounded,ruit,scar,spaced,tall,tip,ud,unit,way,widest,woody,ympodial	'',[,``,alternate,arrangement,branch,bud,characteristic,colour,corrugation,diameter,distal,drying,exertion,form,fruit,glabrousnes,growth,height,history,inflorescence,interjected,leaflet,length,life,lobing,midpoint,na,new,number,peduncle,per,perennial,plant,prickle,primary,pseudostipule,ray,reddish-grey,seed,terminal,texture,thicknes,type,value,variation,width,{,}
177	wfo-0001027847	success	219	130	111	108	19	0.507	-2.5,-4,-6,/3,0-2,0.4-1,0.8-0.9,0.8-1.2,1-2.5,1.5-2,1.9-2.3,1/4,2-2.8,2-3,2-4,2-5,2.2-3,3-5,3-6,5-25,acute,almost,anther,apex,apparently,articulated,bark,base,berry,calyx,chartaceous,cm,connivent,cordate,deltate,densely,diameter,discolorous,drying,dull,elliptic,erect,evenly,filament,finely,flattened,flattened-reniform,fruit,glabrescent,glabrous,gray,green,lateral,leaf,length,lobe,lobed,long,margin,maturity,mauve,middle,mm,narrow-deltate,orange,orange-brown,ovate,pair,pedicel,peduncle,per,perpendicular,petiole,pitted,poricidal,prickle,prickly,primary,purple,red,red-brown,reddish,retrorse,rounded,seed,shrub,side,simple,size,smooth,sometimes,sparsely,spherical,stellate-pubescent,stem,strongly,style,surface,tapering,terete,terminal,tip,tube,upper,vein,way,weakly,white,wide,yellow,young	-0.8,-2,-3,-5,.35,.7,/2,0,0-7,0.1-0.4,0.15-0.2,0.2,0.5,0.5-1,0.8,1,1-2,1.5-2.5,1.5-5,1/2,1/6-1/3,2.5-3.5,2/,3-15,3.5-6,4-5-merous,5-6,5.5-8,6-11,6-8,7-10,abaxially,alyx,ame,apar,apart,apically,blade,branched,broadly,brow,c.,curved,dimorphic,distance,eaf,edge,eed,elongating,equal,extending,faint,filiform,filiform-acuminat,flower,free,fruiting,geminate,increasing,infructescence,lon,longer,lower,mature,midpoint,midvein,minor,moderately,nflorescence,older,one,open,orbicular,orolla,oung,pendulous,perfec,pericarp,pit,plurifoliat,porrect,portion,prickl,ray,ruit,scandent,scar,sessile,slender,spaced,spreading,stalk,stalked,stellate,straight,tamen,tertiary,time,toward,trichome,unarmed,unit,usually,variously,vary,venation,visible,ympodial	arrangement,brown,characteristic,colour,corolla,form,growth,height,history,inflorescence,life,lobing,number,ovary,perennial,plant,shape,texture,type
178	wfo-0001027872	invalid_json_followup	190	157	106	84	51	0.558	1,1-4,1-8,1.0-1.3,10,15,2,2.2-3.5,20,35,5-7,5-lobed,6-20,8-11,acuminate,acute,angular,apex,apical,apically,articulate,base,branched,ca,calyx,cell,cm,commonly,connate,cordate,covering,cuneate,cyme,deep,dehiscent,densely,diameter,dichasial,dichasially,distal,ebracteate,elliptic,filament,glabrescent,glandular-pubescent,globose,gray-green,green,green-white,herbaceous,homogeneously,interjected,introrse,lanceolate,lateral,leaflet,light,lobe,long,make,maturing,middle,mm,moderately,monochasial,mottled,mucilaginous,narrowly,nearly,obliquely,odd-pinnate,often,ovate,ovoid,pedicel,peduncle,perennial,plant,poricidally,purple,rarely,rhizomatous,rounded,seed,shape,short,size,slightly,slit,sometimes,stigma,style,symmetrically,terete,terminal,testal,thick,tinged,type,typically,usually,wall,wide,wider,yellow,yellowish-green	0.5,1-1.2,1.5-4,12-35,2-3,2.8,3-6-foliat,4-6,5-10,5-8,abaxially,acumen,adaxially,apiculate,b,ba,basal,becoming,caudate,celled,clasping,decreasing,digestion,eaf,eed,emoval,enzyme,erect,exceeding,externally,flower,forked,four-celled,generally,gland,glandular,globo,hair-like,half,honeycomb,living,lon,longer,lower,nflorescence,nther,oblong,orolla,pair,pattern,pentagonal,perfect,petiolate,petiolulate,petiolule,puberulent,pubescent,purpl,reduced,reveal,rhizome,rotate,rotate-,ruit,semi-lunate,sessile,seudostipule,single,somewhat,specimen,stamen,ste,straight,subequal,tem,tip,trailing,unbranched,uniformly,unit,vary,viole,wid,ympodial	'',[,\u201chair-like\u201d,``,anther,arrangement,bark,branch,bud,characteristic,colour,corolla,corrugation,drying,exertion,form,fruit,glabrousnes,growth,height,history,inflorescence,leaf,length,life,lobing,margin,midpoint,na,new,number,ovary,per,petiole,prickle,primary,pseudostipule,ray,stem,surface,texture,thicknes,tube,value,variation,vein,violet,wet,width,{,}
179	wfo-0001027880	success	185	130	85	100	45	0.459	.25,0.3-3,0.5-5,0.6-1,0.6-1.5,0.8-1.5,1-2,1.5-2,10-15,2-3,2-80,4-10,4-6,acuminate,acute,anther,apex,apiculate,base,branch,calyx,clavate,cm,conical,cordate,coriaceous,cylindrical,densely,diameter,discolorous,distichous,entire,epiphytic,filament,flattened,flower,fruit,fruiting,glabrous,globose,greenish,inflorescence,leaf,lobe,lower,margin,minutely,mm,oblique,oblong,oblong-ovate,often,ovate,ovoid,papillose,pedicel,peduncle,petiole,pink,pubescent,purple,red-brown,revolute,ripe,rounded,rugulose,scar,shrub,size,slender,slightly,sometimes,somewhat,stigma,style,surface,tan,truncate,tube,unbranched,undulate,vein,vine,white,x	-3,-3.5,0.5-1.5,1-14,1-15,1-2.5,1-3,1.5-3,2/,3-4,5-11,5-8,5-merou,8,abaxially,absen,accrescen,adaxially,ag,aggregate,along,alyx,apart,apparently,articulated,axe,ba,blade,branching,cell,chartaceous,ciliat,connivent,contiguously,curled,deltate,dense,diminishing,directed,distally,distinct,distinctly,eaf,eed,equal,extra-axillary,geminat,green,growing,hair,increasing,internode,leaf-opposed,line,long,longer,longitudinal,midvein,multicellular,nearly,nflorescence,node,occasionally,opening,orolla,pair,pale,perfect,plurifoliate,point,pore,pubescen,rachi,reddish,rooting,ruit,secondary,simple,slit,spaced,sparsely,ste,stellate,stone,tamen,tem,thickened,time,tip,trailing,tree,trunk,typically,uniseriate,unit,usually,vary,wide,yellow,ympodial	2/3,appearance,arrangement,bark,border,bud,characteristic,colour,corolla,corrugation,distal,drying,exertion,form,giving,glabrousnes,growth,height,history,interjected,lateral,leaflet,length,life,lobing,midpoint,na,new,number,ovary,per,plant,prickle,primary,pseudostipule,ray,seed,shape,stem,terminal,texture,thicknes,type,variation,width
180	wfo-0001027880	invalid_json_followup	170	146	93	77	53	0.547	.25,0.3â3,0.5,0.5â1.5,0.5â5,0.6â1,0.6â1.5,0.8â1.5,1.5â2,10â15,1â2,2/3,2â3,4â10,4â6,absent,acuminate,acute,anther,apex,apiculate,arrangement,base,berry,bluish-purple,calyx,chartaceous,clavate,cm,conical,cordate,coriaceous,cylindrical,densely,diameter,distichous,distinctly,entire,extra-axillary,filament,flattened,flower,fruit,fruiting,glabrous,globose,greenish,leaf,leaf-opposed,lobe,long,lower,margin,minutely,mm,nearly,oblique,oblong-ovate,often,ovate,ovoid,papillose,pedicel,peduncle,petiole,pink,pinnate,pubescent,red,reddish-brown,revolute,rounded,rugulose,sand-punctate,shrubby,slender,slightly,sometimes,somewhat,stigma,style,surface,tan,truncate,tube,unbranched,undulate,vein,vine,white,woody,x,â3.5	0.2-0.5,1.5â3,1â14,1â15,1â2.5,1â3,2-80,3â4,5-merous,5â11,5â8,8,abaxially,accrescen,adaxially,along,alyx,apar,axe,blade,c.,capitat,ciliat,climbing,contiguously,curled,deltate,dense,discolored,distinct,eaf,eed,green,hair,lanceolate,line,longer,m.,membranous,midvein,mottled,nflorescence,nternode,occasionally,orolla,pair,pale,perfec,plurifoliat,rachi,reddish,rip,ruit,sand-punctat,scar,secondary,simple,spaced,sparsely,ste,stellate,tamen,tem,thickened,time,tip,tree,trichome,trunk,typically,uniseriate,unit,vary,vegetatio,venation,wide,ympodial	'',[,``,appearance,bark,branch,bud,capitate,characteristic,colour,corolla,corrugation,distal,drying,exertion,form,giving,glabrousnes,growth,height,history,inflorescence,interjected,lateral,leaflet,length,life,lobing,midpoint,na,new,number,ovary,per,plant,prickle,primary,pseudostipule,ray,ripe,seed,shape,size,stem,terminal,texture,thicknes,type,value,variation,width,{,}
181	wfo-0001027881	success	215	130	76	139	54	0.353	-3,acute,almost,anther,apex,articulated,attenuate,base,berry,blackish,calyx,camptodromous,chartaceous,ciliate,cm,connivent,contiguous,cordate,cordiform,densely,diameter,drying,entire,extra-axillary,few-,filament,flattened,flower,fruit,giving,glabrous,globose,greenish,groove,herb,immature,impression,lateral,leaf,light-brown,lobe,many-branched,margin,maturity,membranaceous,mm,moderately,netlike,ovate-elliptic,parallel,pedicel,peduncle,per,petiole,primary,projection,pubescent,raised,reniform,rotate,seed,sessile,simple,size,stem,stigma,style,subopposite,surface,translucent,triangular,tube,vein,white,yellow,Ã	.3â0.5,0.5â2.2,0.8â1.5,1-celled,1.3â2,1.8â2.9,10â25,1â2,1â2-celled,1â2.5,1â2.6,1â3,1â3-celled,1â4,2.5â3.6,20â40,2â4,2â6,2â7,4â6,4â9.5,5,5-merous,6â10,7â14,7â9,8,abaxially,absent,abundant,accrescent,acuminate,adaxiall,adaxially,alyx,appressed,asymmetric,axe,ba,barely,blade,bulge,capitat,case,central,closely,commonly,connected,curved,cylindrical,decurrent,dehiscing,denser,difoliate,directed,dorsally,eaf,ed,eglandular,emarginate,emerging,equal,erect,exceeding,exclusively,explosively,eye,fewer,forming,frequent,geminate,glandular,hair,half,held,hollow,interpetalar,introrsely,larger,less,like,long,longer,longitudinal,lower,mainly,maturit,mesocarp,mixed,much,multicelled,multicellular,naked,near,nflorescence,normally,one,opening,orolla,other,pair,part,perfec,placenta,pore,pressure,prominent,pubescence,rachi,ruit,secondary,short,side,similar,slightly,slit,small,smaller,solitary,sometimes,sparsely,stalk,staman,stamen,subapically,tal,tamen,tem,tissue,two,unbranched,unit,vary,venation,visible,watery,winged,woody,ympodial	0.5-2.2,0.8-1.5,1-2,1-2.5,1-3,1-4,1.8-2.9,10-25,2.5-3.6,20-40,6-10,7-14,7-9,appearance,arrangement,bark,border,branch,bud,capitate,characteristic,colour,corolla,corrugation,distal,exertion,form,fruiting,glabrousnes,growth,height,history,inflorescence,interjected,leaflet,length,life,lobing,midpoint,na,new,number,ovary,plant,prickle,pseudostipule,ray,shape,terminal,texture,thicknes,type,variation,width
182	wfo-0001027882	invalid_json_followup	184	178	134	50	44	0.728	.25,.5,0.1,0.5-1,1,1-5,1.5-,1.5-2,1.5-2.2,1.5-6,10-25,10-40,2-3,2-lobed,2.1-2.6,2.5-3,3-4,3.2-6,3.5-4,3.5-5,4-5,6-9,7-,9-13,abaxially,acuminate,adaxially,age,along,anther,anthesi,apex,apparently,appearing,attenuate,axil,bark,base,berry,branch,branched,broadly,brown,c.,calyx,clavate,cm,completely,conical,corolla,dark,diameter,dry,drying,elliptic,entire,erect,exerted,filament,flattened,flower,fork,fruiting,fusiform,glabrous,globose,green,growth,hairy,hollow,inflorescence,junction,lamina,leaf-opposed,lengthening,less,lobed,margin,maturity,midrib,minutely,mm,new,nodding,occasionally,ovary,ovoid,pair,pale,paulo,pedicel,peduncle,petiole,pitted,pointed,population,pore,poricidal,primary,rarely,reddish,reniform,shattering,shiny,shrub,simple,slender,slit,small,sometimes,sparse,sparsely,specimen,stem,stigma,stout,strongly,structurally,style,surface,sÃ£o,time,tip,tree,trichome,tube,uniseriate,usually,vein,way,white,x,yellow,yellowish	06a,1-1.5,1.6-2.2,2-6,absent,apart,branching,caly,cucullate,deltate,dense,densely,difoliate,eaf,eed,et,fide,free,geminat,glabrou,hooked,irregularly,kallunki,lobe,lower,markedly,nflorescence,papillat,papillate,penden,perfect,planar,plane,portion,pulp,rachi,red-papillat,ruit,scar,spaced,sticky,straight,sweet-scented,swollen,thickened,tuft,ud,unit,woody,ympodial	'',[,``,arrangement,bud,characteristic,colour,corrugation,distal,exertion,form,fruit,glabrousnes,height,history,interjected,lateral,leaf,leaflet,length,life,lobing,midpoint,na,number,per,plant,prickle,pseudostipule,ray,red-papillate,seed,shape,size,terminal,texture,thicknes,type,u00b4,value,variation,width,{,}
183	wfo-0001027889	success	151	117	63	88	54	0.417	-pubescent,0.5-1,0.5-11,0.7-2,1-10,1-3.5,1.5,10-12,10-20,10-30,2-20,3-4,acute-acuminate,apex,basal,base,calyx,chartaceous,cm,connivent,darker,densely,diameter,eglandular-puberulent,elliptic,entire,flower,fruit,glabrous,glandular-,green,greenish,immature,length,light,lobe,longitudinal,margin,mm,ovate,ovoid,pedicel,peduncle,petiole,probably,puberulent,ripe,shrub,simple,somewhat,stigma,stripe,style,subcordate,tree,truncate,tube,unbranched,unknown,violet,white,x,yellowish	-2.5,.5,.5-2,0,1,1-3,1.5-2,2-3,3-8,3-9,4-foliat,5-10,abaxially,acuminate,acute,adaxially,aggregate,apart,ape,apiculate,articulated,axe,beyond,blade,capitat,cell,color,connective,cylindrical,deltate,dilated,directed,distally,eaf,eed,eglandular-pubescent,equal,exceeding,exserted,extending,finely,introrse,laterally,leaving,lon,long,lower,moderately,narrow,nflorescence,nther,oblong,orolla,pedicellar,perfect,pore,presen,present,puberulen,puberulent-pubescen,puberulent-pubescent,rachi,radiu,remnant,ruit,slightly,small,spaced,sparsely,stamen,stellate,stone,subcoriaceous,swelling,tal,tem,thecae,time,tip,tomento,tomentose,triangular,ud,unit,vary,wide,yello,ympodial	1-2.5,anther,appearance,arrangement,bark,border,branch,bud,capitate,characteristic,colour,corolla,corrugation,distal,drying,exertion,filament,form,fruiting,giving,glabrousnes,growth,height,history,inflorescence,interjected,lateral,leaf,leaflet,life,lobing,midpoint,na,new,number,ovary,per,plant,prickle,primary,pseudostipule,ray,seed,shape,size,stem,surface,terminal,texture,thicknes,type,variation,vein,width
184	wfo-0001027901	invalid_json_followup	156	141	95	61	46	0.609	.25,.5,0.3-1.2,0.8-1,1-1.5,1-2.5,1.5-1.8,1.8-4.5,2.5-3,3-5,4-10-flowered,4-5,4.7-12,6-7,abaxially,acuminate,acute,adaxially,anther,apex,area,attenuate,bark,base,berry,bright,broadened,brown,calyx,cm,conical,corolla,curled,dark,densely,dia,dry,drying,ellipsoid,elliptic,exserted,filament,fresh,fruiting,glabrous,globose,green,immature,inflorescence,later,lateral,leaf,like,lobe,lobed,long,main,material,minutely,mm,nearly,ovary,ovoid-reniform,pair,papillose,pedicel,petiole,pitted,pubescent,reddish,ripe,shape,shaped,shiny,shrub,simple,size,slender,sparsely,stem,stigma,strongly,style,surface,tear-drop,tip,translucent,trichome,tube,uniseriate,vein,white,x,yellow,young	0.5-1,0.8-2,0.9-2.3,1-2,?,abaxial,anthesi,ba,beneath,brow,closely,deflexed,differing,difoliate,direction,eaf,edicel,eed,firm,fleshy,free,geminat,imbedded,keeled,lon,lower,major,matrix,middle,midrib,minor,nflorescence,older,opposite,orbicular,oriented,overlappin,papillo,planar,pore,poricidal,portion,prominently,reflexed,rest,rounded,ruit,scar,single,spaced,straight,swollen,tall,triangular,tub,ud,unit,usually,widest,woody,ympodial	'',[,``,alternate,arrangement,branch,bud,characteristic,colour,corrugation,diameter,distal,exertion,form,fruit,glabrousnes,growth,height,history,interjected,leaflet,length,life,lobing,margin,midpoint,na,new,number,peduncle,per,plant,prickle,primary,pseudostipule,ray,seed,terminal,texture,thicknes,type,value,variation,width,{,}
185	wfo-0001027902	invalid_json_followup	128	140	82	46	58	0.641	-2.5,0.5-1,1-1.5,1-6,1.5-3,10-20,15-30,2,2-15,2-8,20-50,3-4,3-5,4-25,4-5,5-20,6-37,7-9,8-13,abaxially,acuminate,acute,adaxially,angled,apex,articulated,base,branched,calyx,chartaceous,cm,cordate,deeply,densely,diameter,distally,eglandular,entire,flower,forked,fruit,glabrous,glandular,globose,hair,inflated,leaving,like,lobe,long,margin,mm,moderately,narrowly,nearly,obtuse,ovate,pedicel,pedicellar,peduncle,petiole,puberulent,pubescent,purple,remnant,reticulate,shrub,simple,small,sparsely,stigma,style,tip,tree,triangular,truncate,tube,unbranched,unknown,usually,whitish,x	1-2,10-15,2-12,2-3,2-9,3-foliat,absen,adaxiall,aggregate,apart,axe,blade,cell,color,connivent,cylindrical,directed,distall,eaf,eed,lon,lower,nflorescence,nther,orolla,pore,pubescen,purplish,rachi,radiu,ripe,ruit,spaced,ste,stellate,stone,subcoriaceous,tal,tem,time,truncat,unit,vary,wide,yellow,ympodial	'',[,``,anther,appearance,arrangement,bark,branch,bud,characteristic,colour,corolla,corrugation,distal,drying,exertion,filament,form,fruiting,giving,glabrousnes,growth,height,history,inflorescence,interjected,lateral,leaf,leaflet,length,life,lobing,midpoint,na,new,number,ovary,per,plant,prickle,primary,pseudostipule,ray,seed,shape,size,stem,surface,terminal,texture,thicknes,type,value,variation,vein,width,{,}
186	wfo-0001027929	invalid_json_followup	193	141	90	103	51	0.466	1,1-10,1-4,1-8,1.0-1.3,10,2,2.0-3.0,20,3.5-5,35,4-5,5-lobed,6-15,abaxially,acuminate,acute,adaxially,along,angular,apex,articulate,base,branched,calyx,cell,cm,connate,cordate,corolla,covering,cuneate,cyme,dark,deep,diameter,dichasial,dichasially,distal,ebracteate,elliptic,except,filament,glabrous,globose,green,green-white,hair,herbaceous,interjected,lanceolate,lateral,leaflet,lobe,long,middle,mm,monochasial,narrowly,obliquely,occasional,odd-pinnate,ovate,ovoid,pedicel,peduncle,perennial,plant,puberulent,purple,rarely,rounded,seed,shape,size,sometimes,spot,stigma,style,symmetrically,terete,terminal,testal,thick,tinged,vein,violet,violet-blue,wall,wide	0.2-0.9,1.5-4,15,2-3,3-6-foliat,4-30,4-6,5-10,5-6,acumen,apical,apically,apiculate,ba,basal,becoming,beyond,caudate,cente,center,clasping,coat,color,darker-violet-blue,decreasing,dehiscent,digestion,eaf,eed,embryo,emoval,enzyme,erect,exceeding,flower,forked,formed,generally,globo,hair-like,half,honeycomb,included,introrse,light,living,lon,lower,make,maturing,mostly,mucilaginous,nearly,nflorescence,nther,oblong,often,orolla,pair,pattern,pentagonal,perfect,petiolate,petiolulate,petiolule,poricidally,purpl,radiating,reduced,reveal,rhizomatous,rhizome,rotate,rotate-,ruit,semi-lunate,sessile,seudostipule,short,slightly,slit,somewhat,specimen,stamen,star,ste,straight,subequal,tem,tip,trailing,typically,unbranched,unit,usually,vary,visible,white,wid,wider,without,yellow,ympodial	'',[,\u201chair-like\u201d,``,anther,appearance,arrangement,bark,branch,bud,characteristic,colour,corrugation,drying,exertion,form,fruit,fruiting,giving,glabrousnes,growth,height,history,inflorescence,leaf,length,life,lobing,margin,midpoint,na,new,number,ovary,per,petiole,prickle,primary,pseudostipule,ray,stem,surface,texture,thicknes,tube,type,value,variation,width,{,}
187	wfo-0001027948	success	186	139	90	96	49	0.484	-15,-16,.5,0-,0.5-2,1-1.2,1-2,1.3-1.8,1.5-4.5,13,3.7-4,5,7,7-15,7.5-10,acuminate,anther,apex,attenuate,basal,base,berry,branch,calyx,cm,corolla,diameter,directed,dorsally,edentate,ellipsoidal,elliptical,erect,filament,fruiting,generally,glabrous,globose,herb,herbaceous,hollow,ill-smelling,inconspicuous,leaf,length,light,lobe,longer,longitudinally,margin,mm,narrowly,non-glandular,occasionally,ovate,ovoid,pair,papillate,petiole,pubescent,purple,reduced,ridged,seed,serrulate,shorter,simple,slightly,small,smooth,stem,stigma,straight,striate,style,sub-shrub,thickened,tip,tooth,triangular,trichome,tube,unequal,upward,vein,violet,viscid-pubescent,x,Â¼,Â½	-6,0.4,0.5-0.7,0.6,0.8-,1.2-2.2,1.6,1/10,10-14,14,2-,2.2-,2.5-,3-8.2,3.2-5.2,3.5,5-,6-celled,8-celled,abaxially,abundant,accrescen,adaxially,ag,aggregate,antrorse,ape,articulate,ature,bicellular,c.,campanulate,cell,connectival,crushed,cuticle,dark,delicate,diamete,difoliate,eaf,finely,flexuous,fragrance,free,glandular,head,hig,inserted,lamina,long,long-stalked,longitudinal,lower,many-,midvein,narrow,near,odorles,opening,orolla,patent,pericarp,pore,poricidal,portion,prolongation,pubescence,ree,ruit,saddle-shape,scarce,scarcely,secondary,seeded,seen,separated,short-stalked,single-celled,sinus,slit,solitary,spur-like,stalk,stone,striat,sub-opposite,tem,thecae,time,twice,unit,vary,ventrifixed,verrucate,ympodial	2.2-8.2,appearance,arrangement,bark,border,bud,characteristic,colour,corrugation,distal,drying,exertion,form,fruit,giving,glabrousnes,growth,height,history,inflorescence,interjected,lateral,leaflet,life,lobing,midpoint,na,new,number,ovary,pedicel,peduncle,per,perennial,plant,prickle,primary,pseudostipule,ray,saddle-shaped,shape,size,surface,terminal,texture,thicknes,type,variation,width
188	wfo-0001027961	success	177	108	79	98	29	0.446	0.9-1,1-1.5,1-4,1-5,2-2.5,2.3-2.5,2.5-9,3-3.5,7-9,8-10,?,acute,anther,anthesi,apex,asymmetric,base,berry,c.,calyx,clavate,cm,cordate,corolla,densely,diameter,ellipsoid,elliptic,entire,exserted,fading,filament,fruiting,fusiform,glabrous,globose,green,growth,immature,inflorescence,lateral,lobed,margin,membranous,minute,mm,new,obovate,occasionally,often,pair,pedicel,peduncle,petiole,pinnatifid,primary,pubescent,purple,reddish,simple,slender,slightly,sparsely,stem,stigma,style,surface,terminal,triangular,truncate,tube,vein,vine,violet,way,white,white-pubescent,woody,x	.5,0.25,0.25-0.5,0.5-1,1,1-3,1-9,10-50,4.5-5,5-8,5-merou,6-9,<,abaxially,adaxiall,adaxially,age,always,alyx,apar,ark,articulated,axil,branched,broadly,brow,clear,conical,connivent,curling,deltate,distributed,eaf,early,eed,equalling,flower,free,geminat,ilament,irregularly,lamina,lengthening,lobe,lon,long,loosely,lower,many,mature,maturity,midrib,minutely,nflorescence,observed,older,one,orolla,other,papillo,pendan,perfect,pericarp,pinched,planar,plurifoliate,pore,poricidal,portion,present,probably,pubescen,rotate-stellate,ruit,scar,shiny,sleeve,slit,small,spaced,spreading,tem,thin,time,tip,transition,trichome,tuft,twinin,twining,ud,unequal,uniseriate,unit,upper,vary,yellow,ympodial	arrangement,bark,branch,brown,bud,characteristic,colour,corrugation,drying,exertion,form,fruit,glabrousnes,height,history,leaf,length,life,lobing,na,number,ovary,per,plant,seed,shape,size,texture,type
189	wfo-0001027966	invalid_json_followup	207	155	109	98	46	0.527	0.8,0.8-2.5,1-1.8,1-2,1-4.2,1-5,1.2-4.5,1.3-2.2,1.5-5.2,10,10-30,2.2-2.9,2.5-10.5,2.8-9,3-4,3-5,4,40-80,5-10,5-6,5.5-14,absent,acuminate,anther,apex,attenuate,axillary,base,berry,blue-violet,brownish,bud,cell,chartaceous,cm,condition,conical,corolla,covering,densely,diameter,distal,drying,elliptic,filament,flower,forked,fresh,fruit,generally,glabrous,green,green-white,greenish,hair,half,herb,interjected,lanceolate,lateral,leaf,leaflet,less,light,lobe,long,make,margin,medium,membranous,minute,mm,mottled,mucilaginous,narrow,odd-pinnate,ovate,ovoid,pedicel,peduncle,petiole,plant,pubescent,purple,rarely,ray,ripe,seed,sessile,shorter,size,slightly,stem,stigma,straight,subsessile,subtending,terminal,testal,thick,throughout,tube,usually,wall,wet,whitish,wide,wing,x	0.4-0.5,0.7-3,1-10,1-3,1.5-3,3-7,5-9.5,5-merou,6-11,abaxially,acumen,adaxially,ag,along,alyx,apart,apparently,arranged,articulated,asymmetrical,axe,basiscopic,bead,blade,capitat,ciliate,commonly,connivent,decreasing,digestion,dorsally,eaf,edge,eed,enzyme,erec,especially,exceeding,flat,folded,geminat,glabrou,gradually,hair-like,homostylous,honeycomb-shaped,larger,lengthening,like,living,lower,middle,moniliform,multiple,necklace,nflorescence,orbicular,orolla,pair,pale,pentagonal,perfect,petiolule,plurifoliate,pore,poricidal,proximal,removed,rotate,ruit,secondary,semierect,seudostipule,side,slit,somewhat,spaced,sparsely,specimen,stamen,ste,stolon,subequal,symmetrical,tall,tamen,tem,tip,tissue,tri-,tuber,tyle,typically,unit,violet,white,yellow,ympodial	'',[,\u201chair-like\u201d,``,appearance,arrangement,bark,branch,calyx,capitate,characteristic,colour,corrugation,exertion,form,fruiting,giving,glabrousnes,growth,height,history,inflorescence,length,life,lobing,midpoint,na,new,number,ovary,per,prickle,primary,pseudostipule,shape,style,surface,texture,thicknes,type,value,variation,vein,width,{,}
190	wfo-0001028014	success	222	137	111	111	26	0.5	-1/2,-15,-2.5,-4,-6,.5,/5,0.2-1,0.2-1.6,0.5-1,0.5-3,0.6-0.9,0.7-1,0.9-1.2,1-10,1-3,1-4,1.3-2.4,1.8-3,1/4,2-3,2.5-4,3-10,almost,anther,apart,apex,apically,apparently,articulated,bark,base,berry,black,brown,brown-green,calyx,cell,chartaceous,cm,cordate,curved,deltate,densely,diameter,elongating,erect,filament,flattened,flattened-reniform,fruit,glabrous,gray,gray-green,lateral,leaf,length,lobe,lobed,long,margin,mature,maturity,mauve,membranous,mm,obtuse,occasionally,orange,outline,ovate,pair,pale,pedicel,peduncle,per,petiole,pit,poricidal,prickle,prickly,primary,purple,raised,red,reflexed,rough,rounded,seed,shiny,shrub,simple,spaced,spherical,stellate-pubescent,stem,straight,strongly,style,surface,tapering,terminal,tip,tube,vein,visibly,way,weakly,wide,yellow,yellow-green	-0.5,-1,-10,-3,-5,0,0.1-0.2,0.15,0.15-0.3,0.2,0.2-0.4,0.25,0.3-0.4,0.5,0.5-1.5,0.5-2,0.7-1.6,1-,1-2,1.5,1.5-2,1/4-2/3,2,2-20,2-4.5,2-6.5,4-10,4.5-7,5-merous,6-10,6-11,abaxially,acuminat,alyx,ame,apar,around,blade,branched,broad-deltate,c.,concolorous,connivent,decurrent,difoliate,discolorous,distance,drying,eaf,edge,eed,equal,extending,eye,flower,free,fruiting,geminat,glabrescent,glabrou,gland,globular,herbaceous,infructescence,lon,longer,lower,midpoint,midvein,moderately,naked,nflorescence,older,one,open,orange-gra,orolla,oung,outer,pendulous,perfec,pericarp,porrect,portion,prickl,ray,reduced,ruit,scandent,scar,sessile,shorter,side,slender,smooth,sometimes,spreading,stalk,stalked,stellate,tamen,terete,tertiary,time,trichome,unit,vary,venation,visible,winged,ympodial	acuminate,arrangement,branch,characteristic,colour,corolla,form,glabrousnes,growth,height,history,inflorescence,life,lobing,na,new,number,orange-gray,ovary,perennial,plant,shape,size,texture,type,width
191	wfo-0001028017	success	158	136	82	76	54	0.519	-2.5,0.3-1,1.5-2,10-22,13-40,15-35,2,2-3,2-4,2.5-5,3,3-12,3-4,40-50,5-7,5-9,6-8,9-11,acute,apex,apiculate,base,beyond,brown,calyx,clavate,cm,connivent,cuneate,densely,diameter,eglandular,eglandular-pubescent,ellipsoidal,elliptic,entire,exserted,flattened,forked,fruit,fusiform,glabrous,glandular,glandular-puberulent,green,greenish,hair,immature,lanceolate,lobe,margin,mm,moderately,narrowly,oblique,obtuse,ovate,ovoid,pedicel,peduncle,petiole,pointed,pubescent,rarely,ripe,short-acuminate,simple,sometimes,sparsely,stamen,stigma,style,tip,tree,triangular,truncate,tube,unbranched,vein,white,x,yellow	1,1-10,1-2,1-3,15-50-flower,3-14,3-foliat,5,6-7,abaxially,absen,absent,acuminate,adaxially,aggregate,apart,ape,articulated,axe,basal,blade,cell,chartaceous,ciliat,connective,cream,cylindrical,directed,distally,eaf,eed,eglandular-puberulent,exceeding,fleshy,flower,glandular-,introrse,leaving,lon,long,lower,near,nflorescence,nther,orolla,pedicellar,perfect,pore,puberulen,purple,purplish,rachi,radiu,remnant,ruit,shorter,slightly,small,spaced,stellate,stellate-campanulate,stone,subcoriaceous,tal,tan,tem,thecae,time,tomentose,truncat,ud,unit,vary,wide,without,ympodial	anther,appearance,arrangement,bark,border,branch,bud,characteristic,colour,corolla,corrugation,distal,drying,exertion,filament,form,fruiting,giving,glabrousnes,growth,height,history,inflorescence,interjected,lateral,leaf,leaflet,length,life,lobing,midpoint,na,new,number,ovary,per,perennial,plant,prickle,primary,pseudostipule,puberulent,ray,seed,shape,size,stem,surface,terminal,texture,thicknes,type,variation,width
192	wfo-0001028033	success	157	86	66	91	20	0.42	1.4â1.8,1â5,2â3,3â11,3â5,4â12,4â5,50,5â7,6â12,acuminate,acute,anther,apex,ascending,attenuate,base,becoming,brown,calyx,chartaceous,ciliate,cm,connivent,cyme,decurrent,deeply,densely,diameter,elliptic,entire,few-branched,filament,glabrescent,glabrous,greenish,growth,herb,hispid-pubescent,lateral,length,light,like,lobed,margin,mm,new,oblong,pedicel,petiole,pubescence,rhizomatous,sessile,shiny,shrub,simple,slightly,solitary,stem,stigma,style,surface,unbranched,white,woody,Ã	.6,1.5,1â4,2â4,2âfoliate,3,3â4,5-merou,abaxially,adaxiall,adaxially,along,alyx,anthesi,ark,blade,branch,brochidodromous,capitat,cell,contiguou,cordate,cylindrical,darker,denser,directed,discolorous,drying,eaf,eed,emarginate,equal,eye,florescence,flower,fruit,geminat,green,high,introrsely,know,known,linear-lanceolate,lobe,long,longitudinal,lower,mainly,membranaceous,midrib,naked,nearly,older,onto,opening,order,orolla,ovate-lanceolate,perfect,pore,poricidal,prominent,prostrat,pubescent,recurved,ruit,secondary,shin,shorter,slit,sparsely,spreading,stellate,straight,strongly,subapical,tamen,tem,trichome,tube,uniseriate,unit,unknown,upright,vary,vein,venation,visible,wide,yellow,ympodial	arrangement,bark,capitate,characteristic,colour,corolla,form,glabrousnes,height,history,inflorescence,leaf,life,lobing,ovary,plant,prostrate,shape,size,texture
193	wfo-0001028067	success	139	125	76	63	49	0.547	0.5-1,0.5-1.5,0.5-2,1-7,10-25,2,2-2.5,2.5-3,3-17,3-4,3-5,3-7,6-12,6-18,7-11-compound,7-20,7-9,8-13,abaxially,acuminate,acute,adaxially,apex,base,calyx,cm,connivent,cuneate,dark,diameter,elliptic-fusiform,elliptic-ovate,entire,flattened,flower,fruit,glabrous,hair,lateral,leaf,leaflet,lobe,margin,mm,moderately,narrowly,obtuse,often,pedicel,peduncle,per,petiole,pink,pinnately,puberulent,purple,rarely,ripe,several,shrub,simple,sparsely,stigma,strongly,style,tip,tomentulose,triangular,triangular-deltate,truncate,tube,unbranched,unequal,usually,x,yellow	-30,1,1-10,1-11,1-2,1-3,1.5-2.5,2-3,4-foliat,5-7,adaxiall,aggregate,along,apart,articulated,axe,basiscopically,blade,cell,chartaceous,color,compound,cylindrical,decurrent,directed,distall,eaf,eed,especially,glabrou,leaving,lon,long,lower,midrib,nearly,nflorescence,nther,orolla,pedicellar,pore,puberulen,rachi,radiu,remnant,ruit,slightly,smal,spaced,stellate,stone,subcoriaceous,tal,tem,time,truncat,unit,unknown,upper,vary,wide,ympodial,zigzag	anther,appearance,arrangement,bark,border,branch,bud,characteristic,colour,corolla,corrugation,distal,drying,exertion,filament,form,fruiting,giving,glabrousnes,growth,height,history,inflorescence,interjected,length,life,lobing,midpoint,na,new,number,ovary,plant,prickle,primary,pseudostipule,ray,seed,shape,size,stem,surface,terminal,texture,thicknes,type,variation,vein,width
194	wfo-0001028069	invalid_json_followup	253	137	98	155	39	0.387	0.1-0.3,0.4-0.5,0.4-0.8,0.5-1.8,0.6-1.1,0.6-4,0.7-1.5,0.8-1.2,1-2.7,1-3.5,1.4,1.5-2.0,1.6-3.2,10,2-17,2-3-branched,2-locular,3,5-25,acute,along,anther,anthesi,apex,appearance,articulated,base,basioscopically,bright,brown,calyx,cm,conical,corolla,decurrent,deep,deeply,densely,diameter,exserted,filament,fruit,fruiting,giving,glandular-villous,globose,green,hair-like,halfway,herb,imparipinnate,interjected,interrupted,lateral,leaf,leaflet,length,linear,lobe,lobed,long,margin,midvein,minute,minutely,mm,oblique,obovate,occasionally,orange,outgrowth,ovary,ovate,pale,pedicel,peduncle,per,perennial,petiole,plant,present,primary,pseudostipule,pubescent,rounded,silky,simple,size,stem,stigma,straight,style,surface,terminal,thick,tube,wide,yellow	-0.4,-30,-6,.1,.1-0.2,.2,.5,0.05-0.1,0.1-0.15,0.1-0.2,0.1-0.5,0.1-0.6,0.2-0.3,0.2-0.5,0.3,0.3-0.4,0.3-0.45,0.3-0.6,0.3-0.7,0.3-1,0.4,0.4-1,0.5,0.5-0.7,0.5-2,0.7-1,0.7-1.3,1-2-celled,1-4.5,1.5-3.5,10-12,10-30,12,2-4,2-7,3-,3-foliate,4-celled,5-22,6-,<,abaxially,absen,abundant,accrescent,adjacent,adpressed,alternate,always,among,apical,appendage,appressed,axi,ba,basal,becoming,berry,bilaterally,bract,bracteole-like,cell,citru,column,composed,cone-shaped,cordate,cuneate,curving,dense,due,eaf,ebracteate,edicel,eed,eglandular,erect,flower,forming,fusion,glabrescent,gland,gland-tippe,gland-tipped,glandular,gree,half,head,included,initially,internode,larger,later,less,like,lime,lon,longer,longest,lower,maturity,middl,multicellular,narrowly,nflorescence,often,one,pair,patent,pentagonal,petiolule,population,procumbent,pubescence,quaternary,rarely,reflexed,robust,ruit,scarcely,scent,secondary,sessile,several,shaggy,short,shorter,single-celled,slender,smaller,somewhat,staminal,sterile,strong,subopposite,symmetric,tangled,tem,tertiary,testa,tightly,toward,transparent,trichome,ud,unicellular,uniseriate,unit,usually,varying,viny,wall,weak,winged,ympodial	'',[,``,arrangement,bark,branch,bud,characteristic,colour,corrugation,distal,drying,exertion,form,glabrousnes,growth,height,history,inflorescence,life,lobing,middle,midpoint,na,new,number,prickle,ray,seed,shape,texture,thicknes,type,value,variation,vein,width,{,}
195	wfo-0001028075	invalid_json_followup	196	140	94	102	46	0.48	1-2,1.5-2.5,1.5-7,1.6-2.7,10-35,2-6,2.5-10,3-11,3-23.5,4-12,4-7,5-12,5-14,5-7,5-8,5-9,7-13,7-30,8-12,abaxially,absent,acuminate,acute,adaxially,anther,apex,axillary,base,berry,brownish,bud,chartaceous,ciliate,cm,condition,corolla,dark,diameter,distal,drying,filament,flower,forked,fresh,fruit,generally,glabrescent,glabrous,globose,green,green-white,greenish,half,herb,interjected,lanceolate,lateral,leaf,leaflet,light,lobe,long,margin,membranous,mm,mucilaginous,narrow,oblique,obtuse,odd-pinnate,ovoid,pale,pedicel,peduncle,petiole,plant,rounded,seed,size,stigma,style,subcordate,subtending,terminal,throughout,tube,typically,usually,wet,white,whitish,wide,wing,x	.5,1-10,1-2.7,1-3,2-3,2-4.5,5-17,5-merou,acuman,acumen,ag,along,alyx,apart,apparently,articulated,axe,blade,borne,broadly,capitat,cell,connivent,covering,cuneate,decreasing,differentiated,digestion,distally,distinctively,dorsally,dot,eaf,edge,eed,elliptic-lanceolate,end,enzyme,erec,especially,exceeding,flat,folded,geminat,glabrescen,hair-like,homostylous,honeycomb-shaped,larger,lengthening,ligulate,living,lower,make,middl,midrib,minutely,much,nflorescence,often,orolla,ovate,ovate-elliptic,pair,pentagonal,perfect,petiolule,plurifoliate,pore,poricidal,puberulent,purple,reflexed,removed,rotate,ruit,scattered,seudostipule,singly,slightly,slit,sometimes,spaced,specimen,stamen,star,stolo,straight,tall,tamen,tem,testal,thick,tip,toward,tri-,tuber,unit,vary,wall,yellow,ympodial	'',[,``,appearance,arrangement,bark,branch,calyx,capitate,characteristic,colour,corrugation,exertion,form,fruiting,giving,glabrousnes,growth,height,history,inflorescence,length,life,lobing,midpoint,na,new,number,ovary,per,prickle,primary,pseudostipule,ray,shape,stem,surface,texture,thicknes,type,value,variation,vein,width,{,}
196	wfo-0001028076	invalid_json_followup	195	151	111	84	40	0.569	.5,0.4-0.5,0.5,1-1.3,1-2,1.2-2.2,1.8-2.2,110,12-22,13-14,2-5.4,2.2-2.6,2.2-3.7,2.5-4,2.6-3.8,4-5,4.5-7,5,5-20,5-6,5-6.5,7-8,absent,acuminate,anther,apex,articulated,attenuate,axillary,base,berry,blade,borne,brownish,bud,cell,chartaceous,cm,condition,conical,connivent,corolla,covering,densely,diameter,distal,drying,end,filament,flower,forked,fresh,fruit,generally,glabrous,green,green-white,greenish,half,herb,interjected,lanceolate,lateral,leaf,leaflet,less,light,long,make,medium,membranous,minute,mm,mucilaginous,odd-pinnate,ovoid,pedicel,peduncle,petiole,plant,proximal,pubescent,purple,rarely,ray,ripe,seed,sessile,singly,size,slightly,stem,stigma,style,subsessile,subtending,tall,terminal,testal,thick,throughout,tube,tuber,typically,usually,wall,wet,whitish,wide,wing,x	1-10,1-3,2-12,2-3,2.5-3,5-merou,?,abaxially,acumen,adaxially,ag,alyx,apart,apparently,axe,capitat,ciliate,decreasing,digestion,dorsally,eaf,edge,eed,elliptic,enzyme,erec,especially,exceeding,flat,folded,geminat,glabrou,gradually,hair,hair-like,homostylous,honeycomb-shaped,larger,lengthening,like,living,lobe,lower,margin,nflorescence,obtuse,orolla,ovate,pair,pentagonal,perfect,petiolule,plurifoliate,pore,poricidal,pubescen,removed,rotate,round,ruit,secondary,semierect,seudostipule,slit,spaced,specimen,stamen,ste,stolo,straight,subequal,symmetrical,tamen,tem,thir,tip,toward,tri-,unit,unwinged,vary,white,yellow,ympodial	'',[,\u201chair-like\u201d,``,abaxial,adaxial,arrangement,calyx,capitate,characteristic,colour,exertion,form,growth,height,history,inflorescence,length,life,lobing,midpoint,na,number,ovary,per,presence,prickle,pseudostipule,shape,stolon,surface,texture,thicknes,third,type,value,variation,width,{,}
197	wfo-0001028105	success	150	123	93	57	30	0.62	.1,.5,0.3-1.5,0.5-1,0.5-2,0.6-1,1-1.2,1-1.5,1.5,1.5-1.8,2,2-2.2,3-5-celled,3-6,5-7-flowered,6-7,9.5-15,abaxially,acuminate,adaxially,anther,apex,attenuate,axil,bark,base,berry,bilobed,calyx,clavate,cm,conical,corolla,dark,dense,dia,difoliate,drying,ellipsoid,elliptic,exserted,filament,filiform,flattened-reniform,fruiting,glabrous,glandular,globose,green,incrassate,lamina,lateral,leaf,lobed,long,main,margin,mm,nearly,occasionally,olive-green,ovary,pair,pale,pedicel,petiole,pubescent,reddish-brown,scattered,shaped,shrub,simple,size,slightly,small,spreading,stem,stigma,strongly,style,surface,tear-drop,tip,tree,trichome,tube,tuft,uniseriate,unit,vein,white,x,yellowish	.4,0.5,1-2.5,1.5-2,1.5-4.5,2-5,3.5-4,acute,anthesi,apar,apical,axi,ba,deflexed,differing,distinct,eaf,edicel,eed,erect,evenly,free,geminat,greenish-yello,like,lobe,lon,lower,major,middle,minor,minutely,nflorescence,older,opposite,papillo,papillose,pitted,planar,pore,poricidal,portion,projection,quadrate,reflexed,ruit,scar,spaced,sparsely,straight,tall,tub,ud,widest,woody,ympodial,young	arrangement,branch,bud,characteristic,colour,corrugation,diameter,exertion,form,fruit,geminate,glabrousnes,greenish-yellow,growth,height,history,inflorescence,length,life,lobing,na,new,peduncle,plant,primary,seed,shape,sympodial,texture,type
198	wfo-0001028109	success	205	108	88	117	20	0.429	0.4-0.8,0.4-1.5,0.45-0.65,0.6-0.8,0.8-1.5,1.5-2.5,1.5-5.5,12-40,2-4,2.3-2.9,2/3-3/4,20-60,3-,3-7,4-13,acuminate,acute,almost,anther,apex,apparently,bark,base,berry,bright,calyx,chartaceous,cm,cuneate,deltate,densely,diameter,discolorous,drying,dull,elliptic,entire,erect,evenly,filament,flattened-reniform,fruit,glabrescent,glabrous,green,green-brown,lateral,leaf,length,light,lobed,long,margin,maturity,mauve,mm,moderately,orange-brown,pedicel,peduncle,petiole,poricidal,prickle,prickly,recurved,red,red-brown,shrub,simple,small,sometimes,spherical,stellate-pubescent,stem,strongly,style,surface,tapering,terete,terminal,tip,tree,way,weakly,white,wide,yellow,young	-20,-4,-7,.5,/3,0.05-0.15,0.05-0.2,0.1,0.1-0.2,0.3,0.5-1.2,0.5-2.5,0.7,0.8-1.6,1.5-10,1/8-1/4,10-25,10-30,15-100,2-15,2.5-3,2.5-5,3.5-6,3/4,30-150,4-5-merous,5-13,5-30,8-12,8-15,8-25,abaxial,abaxially,acut,adaxial,alyx,ame,apar,apart,apically,articulated,blade,branching,brow,c.,connivent,curved,dimorphic,eaf,eed,elongating,equal,flower,free,fruiting,fully,geminate,gently,glabrou,gray-green,infructescence,lobe,long-styled,longer,lower,mature,midpoint,minor,multangulate,nflorescence,obtuse,occasionally,older,one,open,opening,orolla,oung,pair,per,perfec,pericarp,perpendicular,plurifoliat,porrect,portion,prickl,primary,ray,reflexed,ruit,scar,secondary,sessile,slender,smooth,spaced,spreading,stalk,stalked,stellate,straight,tamen,tertiary,time,trichome,tube,unarme,unarmed,unit,usually,vary,vein,venation,visible,woody,ympodial	arrangement,brown,characteristic,colour,corolla,form,growth,height,history,inflorescence,life,lobing,ovary,perennial,plant,seed,shape,size,texture,type
199	wfo-0001028115	invalid_json_followup	165	154	100	65	54	0.606	-1.1,-2.5,.6,0.42,0.6-0.7,0.7-0.8,0.8-,1-2.4,1-3,1.1-1.8,1.4-1.7,1.7-2.2,2-,2-3.2,3-5,3-6.5,5-15,6-10,9-17,abaxially,abundant,acute,adaxially,alternate,anther,antrorse,apex,attenuate,basal,base,berry,blue,calyx,capitate,cm,diameter,ellipsoidal,elliptical,entire,especially,filament,fruiting,glabrescent,glandular,globose,half,herb,herbaceous,length,light,linear,lobe,long,longitudinally,margin,mixed,mm,moderately,narrowly,nerve,non-glandular,oblong,one,opposite,ovate,pair,pale,petiole,pinnatifid,pinnatipartite,pinnatisect,prostrate,pubescent,rarely,ridged,scarce,seed,segment,similar,simple,slender,small,smooth,stem,stigma,style,trans-ovoidal,triangular,trichome,tube,tuberculate,unequal,unifoliate,uniseriate,violet,wide,width,winged,x,yellow	-5.2,.2,0.2-0.3,0.5,1.3-1.8,1.8-3.5,12-13.5,2.5-,3-4.5,4.7-,5-8.5,7-7.5,accrescent,acuminat,ag,amply,annular,articulate,blade,campanulate,coat,connectival,curved,difoliat,dorsal,eaf,eed,embryo,evident,exceeding,glabrous,growing,hig,inflated,longer,longitudinal,lower,much,multi-seeded,near,opening,orolla,papery-scarious,papillo,pore,poricidal,portion,prolongation,ree,reticulate,ruit,slightly,slit,sometimes,strongly,styl,subsessil,tem,time,tip,unit,vary,venation,wider,ympodial	'',[,``,acuminate,arrangement,bark,branch,bud,characteristic,colour,corolla,corrugation,difoliate,distal,drying,exertion,form,fruit,glabrousnes,growth,height,history,inflorescence,interjected,lateral,leaf,leaflet,life,lobing,midpoint,na,new,number,ovary,pedicel,peduncle,per,plant,prickle,primary,pseudostipule,ray,shape,size,surface,terminal,texture,thicknes,type,value,variation,vein,{,}
200	wfo-0001028131	success	208	142	116	92	26	0.558	.5,/5,0-30,0.1-0.3,0.2-1.5,0.3-0.7,0.4-0.8,0.5-1.1,0.8-1,0.8-1.1,1-10,1.5-3,1.5-5,1.8-2.2,1/4-2/3,1/5,2-2.8,2-5,2-6.5,3-6,4-6,5-6.5,absent,anther,apart,apex,apparently,articulated,attenuate,bark,base,berry,branched,calyx,cell,chartaceous,cm,concolorous,connivent,cream,curved,dark,densely,diameter,drying,dull,elongating,erect,filament,flattened,flattened-reniform,fruit,glabrescent,glabrous,green,herb,lateral,leaf,length,like,lobe,lobed,long,margin,marking,mature,maturity,mauve,membranous,mm,narrow-obovate,narrow-ovate,obtuse,orange,orange-brown,outline,pair,pale,pale-brown,pedicel,peduncle,per,petiole,pit,poricidal,prickle,prickly,primary,purple,raised,red,rounded,shiny,simple,small,smooth,spaced,sparsely,spherical,spreading,stellate-pubescent,stem,style,surface,tapering,tip,tube,unarmed,upper,vein,visible,way,wide,yellow,yellow-green,young	-1.2,.1,0-0.6,0-2,0-3,0-4,0.05-0.2,0.1-0.15,0.7-1.1,1-3,1-4,1-5,1.8-2,2-4,2/3,5-8,5-merous,6-7,7-8,abaxial,abaxially,acuminat,adaxial,alyx,apar,apically,blade,broad-deltate,deltate,difoliate,distance,eaf,eed,epidermi,equal,extending,eye,filiform,flower,free,fruiting,geminat,gland,infructescence,lanceolate,lengt,longer,lower,midpoint,midvein,moderately,naked,nflorescence,oblong,often,older,one,open,orolla,oung,pale-gra,pendulous,perfec,pericarp,porrect,portion,prickl,ray,reduced,reflexed,ruit,scar,sessil,sessile,shorter,side,sometimes,stellate,straight,strongly,sunk,tamen,terete,tertiary,time,trichome,unarme,unit,vary,venation,woody,ympodial	arrangement,branch,characteristic,colour,corolla,exertion,form,glabrousnes,growth,height,history,inflorescence,life,lobing,new,number,ovary,pale-gray,perennial,plant,seed,shape,size,texture,type,width
201	wfo-0001028148	success	157	119	65	92	54	0.414	-6,.5-4,0.25-0.5,0.6-3.5,0.75-2,1-3.5,1.5,12-15,2,2.5-4,3.5-4,5-20,5-7,6-18,acute,angled,apex,base,blue-black,branched,calyx,cm,dark,decurrent,deltate,diameter,distal,elliptic,entire,fruit,glaucous,globose,highly,less,light-colored,lobe,margin,mature,minute,mm,narrowly,obtuse,ovate,pedicel,peduncle,petiole,pink,purple,rhizomatous,ridge,ripe,scalloped,shrub,simple,smooth,sometimes,stigma,style,surface,tapered,treelet,tube,violet,whitish,x	0.5-1.5,1-15,1.5-2.5,10-30,15,2-3,2-7,20-50,3.5-9,4-10,4.5-10,5,5-10,5-8,abaxially,absen,adaxially,aggregate,apart,apiculate,articulated,axe,ba,blade,broadly,cell,central,chartaceous,connivent,cylindrical,densely,directed,distall,eaf,eed,especially,except,fleshy,flower,fresh,glabrous,hair,long,lower,many-foliat,margi,material,midrib,moderately,nflorescence,nther,often,orange,orolla,part,perfect,plicae,plicate,pore,puberulence,puberulent,puberulent-pubescent,rachi,radiu,rarely,rotate-stellate,ruit,slender,slightly,smoot,spaced,sparse,star,stone,succulent,tal,tem,thickened,time,tip,triangular,truncat,unbranched,unit,usually,vary,white,wide,winge,yellow,ympodial,young	0.5-4,anther,appearance,arrangement,bark,border,branch,bud,characteristic,colour,corolla,corrugation,drying,exertion,filament,form,fruiting,giving,glabrousnes,growth,height,history,inflorescence,interjected,lateral,leaf,leaflet,length,life,lobing,many-foliate,midpoint,na,new,number,ovary,per,plant,prickle,primary,pseudostipule,ray,seed,shape,size,stem,terminal,texture,thicknes,truncate,type,variation,vein,width
202	wfo-0001028161	success	124	108	76	48	32	0.613	0.1-0.25,0.25-0.5,1-1.3,1-1.5,1.5-4.5,2-5-flowered,2-9,2.5-3,3-4,3-7,4-5,6-9,7.5-12,abaxially,acuminate,acute,adaxially,along,apex,attenuate,bark,base,berry,branch,branched,brown,calyx,cell,closely,cm,corolla,dendritic,densely,denser,dia,elliptic,exserted,fruiting,globose,green,lanceolate,later,lateral,leaf,like,long,main,margin,minutely,mm,narrowly,obovoid,opposite,outline,ovoid-reniform,pale,pedicel,petiole,pitted,pubescent,reddish-brown,shape,shrub,simple,sinuate,size,sparsely,stem,strongly,surface,tan,tapering,thin,trichome,vein,x	.5,0.7-1.7,1-2,1-2.3,1/3,9-11,anthesi,arising,ba,congested,consisting,deflexed,differing,difoliate,distal,eaf,edicel,eed,geminat,glabrescen,incrassate,inflorescenc,lon,major,middle,minor,nflorescence,often,older,orbicular,overlappin,pair,probably,pubescence,rest,rounded,ruit,scar,short,somewhat,spaced,tall,tub,ud,unit,widest,ympodial,young	anther,arrangement,bud,characteristic,colour,corrugation,diameter,drying,exertion,filament,form,fruit,glabrousnes,growth,height,history,inflorescence,length,life,lobing,na,new,ovary,peduncle,plant,primary,seed,stigma,style,texture,tube,type
203	wfo-0001028164	success	197	140	111	86	29	0.563	-1,/4,0.3-0.8,0.4-0.8,0.5-0.8,0.5-1,0.7-1.1,0.8-1.5,0.9-1.6,1-1.5,1-4.5,1/3,2.5-4.5,2.8-4,3-17,3-7,3.6-4.8,6-8,8-17,abaxially,acuminate,acute,anther,apex,apically,apparently,articulated,attenuate,bark,base,berry,branched,bright,calyx,cm,concolorous,dark,deltate,densely,diameter,drying,dull,elliptic,entire,erect,evenly,filament,flattened-reniform,fruit,fruiting,glabrescent,glabrous,glandular,gray,green,hair,lateral,leaf,length,long,margin,maturity,mauve,membranous,midvein,minute,mm,moderately,multangulate,obtuse,orange-brown,pair,pale,pedicel,peduncle,per,petiole,poricidal,primary,recurved,red,red-brown,sessile,shallowly,shrub,simple,sometimes,sparsely,spherical,stalked,stellate-pubescent,stem,style,surface,tapering,terete,terminal,tip,trichome,tube,unarmed,undulate,upper,variously,vein,way,white,wide,yellow,yellow-green,young	-14,-6,-8,0-20,0.05-0.2,0.05-1.5,0.1,1,1.5-2.5,1.8-2.5,1/6-1/4,12-20,2-2.5,2.5-4,4-13,4-5-merous,4-7,4-8,8-15,abaxial,almost,alyx,ame,apar,blade,c.,connivent,curved,difoliate,eaf,eed,elongating,equal,eye,filiform,flower,free,geminat,glabrescen,glabrou,infructescence,less,lobe,lobed,long-acuminat,longer,lower,mature,midpoint,naked,narrow-deltate,nflorescence,often,older,one,open,orolla,oung,perfec,pericarp,porrect,portion,ray,reflexe,ruit,scar,shorte,shorter,side,smooth,spaced,spreading,stalk,stellate,straight,tamen,tertiary,time,unarme,unit,vary,venation,visible,woody,yellow-gra,ympodial	10-20,arrangement,branch,characteristic,colour,corolla,exertion,form,glabrousnes,growth,height,history,inflorescence,life,lobing,long-acuminate,na,new,number,ovary,perennial,plant,seed,shape,size,stigma,texture,type,yellow-gray
204	wfo-0001028180	invalid_json_followup	147	151	102	45	49	0.694	.05,.5,1-1.2,1-1.5,1-1.8,1-3,15-28,2-2.2,2-3,2.5-3,20-30-flowered,3-4,4.5-5,5-6,5-8,7,abaxially,acute,adaxially,along,anther,anthesi,apex,attenuate,bark,base,berry,calyx,capitate,cm,conical,corolla,cucullate,dark,deltate,densely,dia,distinctly,drying,elliptic,elongate,erect,falcate,filament,fleshy,four-angled,fruiting,glabrous,globose,gold,golden,green,irregularly,larger,lateral,leaf,lobe,lobed,long,main,margin,midrib,minutely,mm,nearly,obscure,onto,opposite,ovary,ovoid-reniform,pale,papillose,pedicel,petiole,pinkish-white,pitted,planar,puberulent,pubescent,shaped,shiny,simple,size,small,somewhat,sparsely,stem,stigma,style,surface,tan,tear-drop,tip,tree,trichome,tube,uniseriate,vein,white,winged,x,yellow-gray	/2,0.7-1,1.5-5,3-10,8-10,ba,beginning,c.,closely,darker,deflexed,differing,difoliate,eaf,eed,free,geminat,glabrat,know,leathery,lon,lower,major,minor,nflorescence,older,overlappin,pair,pore,poricidal,portion,ruit,scar,spaced,straight,styl,tall,thick,ud,underside,unit,way,woody,ympodial,young	'',[,``,alternate,arrangement,branch,bud,characteristic,colour,corrugation,diameter,distal,exertion,form,fruit,glabrate,glabrousnes,growth,height,history,inflorescence,interjected,known,leaflet,length,life,lobing,midpoint,na,new,number,peduncle,per,plant,prickle,primary,pseudostipule,ray,seed,shape,terminal,texture,thicknes,type,value,variation,width,{,}
205	wfo-0001028182	success	150	104	71	79	33	0.473	0.1-0.2,0.5-0.6,0.5-1,0.8-1,0.9-1,1-1.5,2-2.5,2-6.5,3-5,4-6,6-9,anther,apex,arching,bark,base,beneath,branch,brown,calyx,capitate,ciliate,cm,conical,cordate,corolla,ellipsoid,filament,filiform,glabrous,globose,inflorescence,later,lateral,lax,leaf,lobed,long,long-acuminate,main,margin,mm,narrowly,nearly,obovoid,ovary,ovate,pair,pedicel,petiole,poricidal,pubescent,shiny,shrub,simple,slender,somewhat,sparsely,stem,stigma,style,surface,tip,trichome,truncate,tube,uniseriate,vein,white,x,young	.5,0-90,0.5,2,3,5-15-flowered,5-ribbed,along,anthesi,apart,apiculae,apiculate,axi,bending,black,blade,deflexed,deltoid,densely,dia,dry,eaf,edicel,eed,evenly,except,extreme,flower,free,gre,hemiepiphyte,internodal,keeled,know,known,less,like,lobe,lower,material,midrib,minute,minutely,nflorescence,older,opposite,papillo,papillose,planar,pore,portion,present,prominent,proximal,purplish,reflexed,rib,rounded,ruit,sca,scar,shaped,slightly,spaced,sparser,specimen,spindly,still,strongly,tapering,tear-drop,third,time,ud,unifoliat,unit,widest,ympodial,zig-zag	arrangement,bud,characteristic,colour,corrugation,diameter,drying,exertion,form,fruit,fruiting,glabrousnes,grey,growth,height,hemiautotrophic,history,length,life,lobing,na,new,number,peduncle,per,plant,primary,seed,shape,size,texture,type,unifoliate
206	wfo-0001028183	success	237	136	93	144	43	0.392	-10,0.2-0.5,0.5-2.5,0.7-1.2,0.7-2,1.1-1.8,1.2-1.4,1.3-1.7,10-15,11-30,2-4.2,2-5,2.2-5.7,2.5-4.1,2.8-4.2,4.5-9,5.2-6.2,6.6-20,9-13,abaxially,adaxially,anther,apex,attenuate,bark,base,berry,blunt-tipped,branch,branched,bud,calyx,capitate,cm,corolla,cuneate,deltoid,diameter,dull,elliptic,elongated,entire,exserted,filament,flower,fruit,glabrescent,glabrous,globose,granular-punctate,lanceolate,lateral,leaf,lobe,many,margin,midrib,mm,narrowly,nearly,oblong,obovoid,orangish-tan,ovate-lanceolate,pedicel,peduncle,petiole,pseudoterminal,pubescent,purple,reticulate-punctate,ripe,scabrous,shrub,side,simple,soon,spherical,stem,stigma,streak,style,sub-lenticular,surface,tan,terete,time,tree,vein,violet,white,x,yellowish	-5.3,.5-3,0.1,0.1-0.2,0.1-0.4,0.1-0.9,0.2-0.3,0.2-0.4,0.5,0.6,0.8-1.4,0.8-3.1,1.3-1.4,1.4-2.8,1.5-3.4,1.6-2.3,1.7-2.7,1.9-3.7,1/3-1/2,2.6-4.4,3.2-,3.5-6.6,4.6-6.4,5-8,5-8.5,50-400,7.5-23,8-9.1,abaxial,accrescent,acute,ag,along,alyx,anthesi,apart,apparently,around,articulated,axi,axillary,blade,brown,cell,central,chartaceous,closely,cylindrical,dark,dendritic-multangulate,directed,distally,distantly,drying,eaf,earl,edge,eed,epidermal,especially,evident,except,farinose,few-rayed,free,fruiting,glabrescen,group,hair,half,high,inserted,lackin,lengthening,lobed,lon,long,long-decurrent,longitudinal,lower,m.,main,multangulate,nflorescence,older,open,orolla,overlapping,perfec,plurifoliate,pore,poricidal,porrect-stellat,porrect-stellate,present,prominent,pubescence,rachi,rarely,relatively,reportedly,ruit,runk,sessile,short,short-,slit,small,somewhat,spaced,sparingly,sparse,splitting,stage,stalk,stamen,stellate,stipitate-glandular,stout,strongly,subcampanulate,suture,tamen,thick,thin,thin-textured,tip,tomentose,touching,translucent,tube,ud,unarme,unit,upper,usually,vary,way,whitish,wide,yellow,yellowish-tomentose,ympodial,young	3.2-6.4,appearance,arrangement,border,characteristic,colour,distal,exertion,form,giving,glabrousnes,growth,height,history,inflorescence,interjected,leaflet,length,life,lobing,midpoint,na,new,number,ovary,per,perennial,plant,prickle,primary,pseudostipule,ray,seed,shape,size,sparely,terminal,texture,thicknes,type,unarmed,variation,width
207	wfo-0001028227	invalid_json_followup	236	158	113	123	45	0.479	-6.2,0.2-0.3,0.2-0.4,0.8-1.4,0.9-1.4,1-1.7,1-4.2,1.2-2,1.3-4,1.5-2.3,1.7-2.8,1/2,1/2-3/4,10,10-24,11-15,2-12,2.5-7.8,3-4.9,3.7-7,4.8-7.6,6.7-15,abaxially,acuminate,acute,adaxially,anther,anthesi,apex,attenuate,bark,base,berry,blunt-tipped,branch,branched,brown,brownish,bud,c.,calyx,cm,corolla,cuneate,dark,decurrent,deltoid,diameter,early,elliptic,elongate,ength,entire,exserted,filament,fleshy,fruit,fruiting,glabrous,globose,granular-tomentose,gray,grayish,green,lateral,leaf,less,lobe,long,many,margin,midrib,mm,oblong,oblong-lanceolate,obtuse,orangish-tan,orbicular,ovate-lanceolate,pale,pedicel,peduncle,petiole,pseudoterminal,pubescent,purple,reticulate-punctate,ripe,scabridulous,shrub,side,simple,slightly,sparsely,stem,stigma,style,subcampanulate,sublenticular,subspherical,sulcate,surface,time,tomentose,tree,tube,vein,velutinous,violet,way,x,yellow,yellowish	-2/3,.5-4,0-250,0.1,0.2,0.2-0.5,0.3,0.4,0.5,0.7-2.1,0.8,0.9,0.9-1.2,1,1-2.5,1.1-3.1,1.4,1.4-2.6,1.9,1.9-4.2,1.9-5.8,2-3.8,2.6-5.9,2.9-4.7,3.7-6.3,4-13,5-7.5,6-16,8.1-18,8.5-22,abaxial,accrescent,ag,age,along,alyx,apart,apparently,appressed,around,articulated,axillary,becoming,blade,blunt-tippe,closely,cylindrical,dendritic-echinoid,directed,distally,drying,eaf,echinoi,echinoid,edge,eed,farinose,flower,free,glabrescent,hair,high,inserted,lacking,lanceolate,lengthening,lobed,lon,longitudinal,lower,m.,main,midvein,mostly,multangulate,nflorescence,obscured,occasionally,often,older,orolla,ovate-orbicula,overlapping,perfec,plurifoliate,pore,poricidal,porrect-stellate,present,prominent,pubescence,quarter,rachi,relatively,rounded,ruit,runk,sessile,slit,somewhat,spaced,stalk,stamen,stellate,stout,suture,tamen,thick,thicker,thin,tip,tomentu,touching,ud,unarme,unit,upper,usually,vary,well,wide,ympodial,young	'',[,``,arrangement,characteristic,colour,corrugation,distal,exertion,form,glabrousnes,growth,height,history,inflorescence,interjected,leaflet,length,life,lobing,midpoint,na,new,number,ovary,per,perennial,plant,prickle,primary,pseudostipule,ray,seed,shape,size,terminal,texture,thicknes,type,unarmed,value,variation,width,{,}
208	wfo-0001028228	invalid_json_followup	143	147	98	45	49	0.685	.5,0.1-1.7,0.75,1-1.5,1.1-1.2,1.2-1.8,1.5-2,1.8-3.4,10-30-flowered,2,2-8,2.8-6.5,3/4,6-7,6-8,7.5-12.5,abruptly,acute,age,anther,apex,area,bark,base,becoming,berry,brown,calyx,clavate,cm,coriaceous,corolla,dark,deflexed,dia,difoliate,distal,dry,elliptic,exserted,filament,fruiting,glabrous,globose,green,greenish-yellow,lateral,leaf,lobe,lobed,long,main,margin,material,minute,minutely,mm,narrowing,obovate,occasionally,ovary,ovoid,ovoid-reniform,pair,pale,papillose,pedicel,petiole,pore,poricidal,portion,reticulate,rounded,shaped,shining,shrub,simple,slender,small,stem,stigma,straight,style,surface,tapering,tear-drop,terminal,thickened,tip,tree,tube,unit,usually,vein,way,white,x,young	1.1-2.5,2-5,2.1-4.2,anthesi,ba,beginning,beneath,caly,campanulate,closely,deltoid,eaf,edicel,eed,erect,fragrant,free,geminat,impressed,inflorescenc,lon,lower,major,middle,minor,nflorescence,older,opposite,overlapping,planar,prominent,ruit,scar,shinin,slightly,spaced,styl,sweetly,tall,thick-margined,ud,weight,widest,woody,ympodial	'',[,``,arrangement,branch,bud,characteristic,colour,corrugation,diameter,drying,exertion,form,fruit,geminate,glabrousnes,growth,height,history,inflorescence,interjected,leaflet,length,life,lobing,midpoint,na,new,number,peduncle,per,perennial,plant,prickle,primary,pseudostipule,ray,seed,shape,size,sympodial,texture,thicknes,type,value,variation,width,{,}
209	wfo-0001028263	success	156	126	79	77	47	0.506	0.25,1-2,1-3,1-4,11-13,11-23,14-44,2-4,2.6,3,3.4,3.5-4.2,5-7,5-7.5,6,6-8,9,abaxially,acumen,acuminate,acute,adaxially,apex,articulate,atenuate,base,branched,broadly,calyx,cm,conical,cordate,corolla,cuneate,cyme,darker,deep,diameter,dichasial,dichasially,distal,ebracteate,elliptical,filament,flat,green,green-white,herbaceous,interjected,lateral,leaf,leaflet,light,lobe,long,medium,mm,monochasial,mucilaginous,oblique,odd-pinnate,ovate,ovoid,pedicel,peduncle,perennial,petiole,plant,puberulent,pubescent,rotate,seed,size,stigma,strigose,style,terminal,violet,wide	2,2-3,3-6-foliat,4,4-5,8-1.,8-14,abaxiall,apical,apically,cell,connate,covering,dehiscent,digestion,diminishing,dorsally,eaf,edge,eed,emoval,enzyme,equal,exceeding,first,flower,folded,forked,generally,globo,gradually,hair-like,half,honeycomb,introrse,living,lon,lower,lunat,make,maturing,nflorescence,nther,often,orolla,pair,pattern,perfect,plan,poricidally,proximal,reveal,ruit,sessile,seudostipule,short,slit,specimen,stamen,straight,tal,tem,testal,thick,throughou,throughout,toward,truncate,tuber-bearing,two,typically,unit,vary,wall,yellow,ympodial,Â¼	8-19,anther,appearance,arrangement,bark,border,branch,bud,characteristic,colour,corrugation,drying,exertion,form,fruit,fruiting,giving,glabrousnes,globose,growth,height,history,inflorescence,length,life,lobing,margin,midpoint,na,new,number,ovary,per,prickle,primary,pseudostipule,ray,shape,stem,surface,texture,thicknes,tube,type,variation,vein,width
210	wfo-0001028280	success	87	90	51	36	39	0.586	.5,0.7-1,1-2,1-2-flowered,1.5-2.7,2-2.5,2-3,6-9,7-8,acuminate,apex,arching,attenuate,bark,base,berry,branch,ciliate,cm,completely,dark,decurrent,dia,elliptic,flattened,fruiting,glabrous,globose,green,immature,lanceolate,lateral,leaf,long,main,margin,minutely,mm,narrowly,new,onto,pair,pedicel,petiole,shrub,simple,stem,surface,vein,winged,x	almost,anthesi,ape,axil,brow,closely,eaf,eed,know,known,lon,lower,middle,nflorescence,older,opposite,papillae,pendant,present,rounded,ruit,scar,sessil,small,somewhat,spaced,tall,tip,ud,ultimate,unifoliat,unit,widest,woody,ympodial,young	anther,arrangement,brown,bud,calyx,characteristic,colour,corolla,corrugation,diameter,drying,exertion,filament,form,fruit,glabrousnes,growth,height,history,inflorescence,length,life,lobing,na,number,ovary,peduncle,per,plant,primary,seed,shape,size,stigma,style,texture,tube,type,unifoliate
211	wfo-0001028281	success	267	155	124	143	31	0.464	-1,-10,-20,-3,-36,-5,-7,0.2-0.3,0.2-0.5,0.3-1,0.5-0.7,0.5-1,0.7-2.5,0.75-1,1-1.5,1-3,1-5,1.0-1.6,1.1-1.4,1.1-2.4,1.7-2.5,10-18,2-4,2-6.5,2-locular,2.1-3.0,20-30,3-16,3-8.5,6,7-30,abaxially,acuminate,acute,almost,anther,anthesi,apex,base,basiscopically,bracteate,brown,calyx,capitate,cell,cm,conical,corolla,dark,deep,densely,diameter,distal,doubly,dry,elliptic,elongate,entire,exerted,extended,filament,flower,form,fruit,fruiting,glabrous,globose,golden,green,hair-like,half,halfway,imparipinnate,inflorescence,interjected,interrupted,lateral,leaf,leaflet,like,lobe,long,margin,material,mm,narrowly,oblique,obovate,occasionally,once-branched,outgrowth,ovary,ovate,pale,pedicel,peduncle,petiole,primary,proximal,pseudostipule,pubescent,regularly,serrate,shrub,size,small,sometimes,sparsely,stem,stigma,stripe,style,surface,terminal,testa,thick,trichome,tube,type,vein,vine,wall,wide,yellow	+,-0.9,-45,-8,.2,.4,.5,0.05-0.4,0.1-0.15,0.15-0.2,0.2-0.7,0.3-0.5,0.5-,0.5-0.6,0.5-1.1,0.5-1.2,0.7-,0.7-1.2,0.8-1,1,1-,1.2-1.5,1.2-1.6,1.4-4,1.5-2,1.5-6,10-30,2-13,2-4-celled,2.5-,3-5,3-foliate,5-8-celled,6-15,abaxial,absent,adaxial,alternate,apical,appearance,appendage,appressed,arising,articulation,autogamous,axi,bent,berr,blade,bract,branching,broadly,column,composed,covering,darker,decreasing,decurrent,developed,eaf,edicel,eed,eglandular,either,elongate-triangular,enclosing,exserted,fragile,free,generally,giving,gland,glandular,gree,hal,head,included,internode,large,largest,less,lon,longest,lower,medial,midvein,minute,mixture,multi-celled,multi-cellular,multicellular,nflorescence,node,opposite,orbicular,other,pair,paler,patent,petiolule,point,population,portion,present,primarily,probably,rachi,rest,rotate,ruit,secondary,serrat,sessile,set,shorter,silky,smaller,smooth,sparser,sprawling,staminal,sterile,stiff,straight,strongly,subopposite,tem,tertiary,thin,three,tip,toward,transparent,ud,unicellular,uniseriate,unit,usually,weak,weak-walled,well,winged,ympodial	1-2,2.5-6-15,arrangement,bark,branch,bud,characteristic,colour,corrugation,drying,exertion,glabrousnes,growth,height,history,length,life,lobing,midpoint,na,new,perennial,plant,prickle,ray,seed,shape,texture,thicknes,variation,width
212	wfo-0001028317	invalid_json_followup	204	157	116	88	41	0.569	-1.5,-5,/5,0,0.1-0.3,0.3-0.4,0.3-1,0.6-0.8,0.6-1.2,0.6-1.5,0.8-1.1,0.8-2.5,1-1.3,1-3,1-4,1.1-1.9,1.4-2,1/5,2-2.8,2.5-6.5,2.8-3.3,3-10,3-4,4-6,5-8,absent,acute,almost,anther,apart,apex,apparently,articulated,bark,base,berry,branched,bright,brown,calyx,chartaceous,cm,concolorous,cream,cuneate,curved,dark,densely,diameter,drying,dull,erect,filament,flattened-reniform,fruit,fruiting,glabrous,gray,green,herb,lanceolate,lateral,leaf,length,lobed,long,margin,marking,maturity,mauve,midpoint,mm,moderately,obtuse,orange-brown,ovate,pair,pale,pedicel,peduncle,per,petiole,poricidal,prickle,prickly,primary,purple,ray,red,reflexed,shrub,simple,sometimes,spaced,sparsely,spherical,spreading,stellate-pubescent,stem,straight,style,surface,tapering,terminal,tip,truncate,tube,unarmed,upper,vein,way,white,wide,yellow,yellow-green,young	0-1,0-5,0.1,0.1-0.25,0.1-0.4,0.5-3.5,1.8-2.5,1/,1/3-1/4,1/4-2/3,2-4,2-4.5,2/3,3-5,4-5-merous,4-8,6-10,abaxially,acuminat,alyx,apar,apically,blade,broad-deltate,brow,deltate,difoliate,distance,eaf,eed,elongating,equal,extending,eye,filiform,flower,free,geminat,hair,herbaceous,infructescence,lobe,longer,lower,mature,midvein,minute,naked,nflorescence,oblong,older,one,open,orolla,oung,pendulous,perfec,pericarp,porrect,portion,prickl,reduced,rounded,ruit,scandent,scar,sessile,shorter,side,smooth,stalk,stalked,stellate,subsessile,tamen,terete,tertiary,time,toward,translucent,trichome,unarme,unit,variously,vary,venation,visible,ympodial	'',[,``,arrangement,branch,bud,characteristic,colour,corolla,corrugation,distal,exertion,form,glabrousnes,growth,height,history,inflorescence,interjected,leaflet,life,lobing,na,new,number,ovary,perennial,plant,pseudostipule,seed,shape,size,stigma,texture,thicknes,type,value,variation,width,{,}
213	wfo-0001028323	invalid_json_followup	164	147	99	65	48	0.604	0.2-1,0.4-1.3,0.5,0.6-1,0.8,0.9-1.2,1-1.2,1-1.5,1.1-4.5,1.5,1.5-2.5,2-3,2-9,3,3.5-4,5-6,7.5-9,abaxially,absent,acute,anther,anthesi,apex,attenuate,bark,base,berry,blue-green,brown,c.,calyx,cm,conical,corolla,cup-shaped,dark,densely,diameter,drying,ellipsoid,elliptic,entire,erect,fading,filament,fleshy,fruiting,glabrescent,glabrous,globose,grey,growth,included,inflorescence,internodal,leaf-opposed,less,like,lobe,margin,maturity,minutely,mm,new,ovary,ovoid,pair,pale,pedicel,peduncle,petiole,pitted,poricidal,primary,pubescent,reddish,revolute,rounded,shiny,shoot,short,shrub,simple,sometimes,somewhat,sparsely,stem,stigma,style,surface,tip,trichome,tube,uniseriate,vein,violet,way,white,x	-2,0.2-0.5,0.5-1,1,1-2,3-5,3-6,abscissio,along,apart,apparently,appressed,articulated,ba,capiatate,cell,coriaceous,deltate,dendritic,eaf,eed,flower,free,glabrescen,lanceolate,lengthening,lobed,longer,lower,main,minute,nflorescence,occasionally,ovate,papillat,papillose,peg,perfect,pericarp,planar,plurifoliat,pore,portion,proceed,remaining,ruit,scar,scattered,sinus,small,soft,soon,sparely,splitting,straight,tearing,testal,thick,thin,tuft,ud,unit,wall,woody,ympodial	'',[,``,appearance,arrangement,border,branch,bud,capitate,characteristic,colour,corrugation,distal,exertion,form,fruit,giving,glabrousnes,height,history,interjected,lateral,leaf,leaflet,length,life,lobing,midpoint,na,number,per,perennial,plant,prickle,pseudostipule,ray,seed,shape,size,terminal,texture,thicknes,type,value,variation,width,{,}
214	wfo-0001028329	success	215	161	133	82	28	0.619	.5-3,0-100,0.2-0.3,0.8-1.1,0.8-1.4,0.9-1.3,1-6,1.0-1.4,1.3-1.8,1.5-2.3,10-34,12,3-14,3-8,4-15,5-10,6-8,6-9,abaxially,acuminate,acute,adaxially,angled,anther,anthesi,apart,apex,articulated,asperous,bark,base,becoming,berry,blunt-tipped,branch,branched,brown,bud,calyx,chartaceous,closely,cm,conical,continued,corolla,deltoid,dendritic-echinoid,diameter,dichotomously,distantly,due,echinoid,entire,filament,finely,fleshy,flower,fruit,glabrous,granular,granular-tomentose,gray,green,grooved,growth,hair,honeycombed,inserted,lateral,leaf,length,long-attenuate,longitudinally,margin,midvein,minutely,mm,moderately,mostly,multangulate,obelliptic,oblong,obovate,obtuse,orbicular,ovate,ovate-elliptic,pale,pedicel,peduncle,petiole,porrect-stellate,pubescent,rather,reniform,reticulate-punctate,ripe,sessile,several,short-,short-stalked,shrub,side,simple,slightly,small,sometimes,spaced,sparse,sparsely,stellate-pubescent,stellate-rotate,stelliform,stem,stigma,style,subglobose,suborbicular,time,tomentose,touching,tree,tube,turning,unarmed,vein,velutinous,vestigial,white,whitish,x,yellow,yellowish	.75-2,.75-5.75,/10-3/10,1.1-2.5,1.3-2,1.5-2.75,1.5-3.5,1.5-8,2-3,2-4,2.2-3.9,2.6-5,2.75-4.5,3.75-7,3/4,4-5,6-11,7-19,absen,ag,apical-lateral,apparently,axe,axillary,ba,blade,cylindrical,dehiscing,dendritic-echinoi,distinct,eaf,eed,free,glabrescen,high,introrse,large,lengthening,lobe,lobed,long,lower,main,multangulat,nflorescence,obscured,occasional,older,orolla,perfect,plurifoliate,pore,present,pseudo-terminal,rachi,receptacle,relatively,ruit,runk,sessil,slit,stalked,stellat,stellate,subcapitat,suture,swollen,tamen,testa,thick,thickened,thin,tomentu,toward,unarme,unit,usually,vary,way,wide,ympodial,young	arrangement,characteristic,colour,corrugation,drying,exertion,form,fruiting,glabrousnes,height,history,inflorescence,life,lobing,na,new,ovary,perennial,plant,primary,pseud-terminal,seed,shape,size,subcapitate,surface,texture,type
215	wfo-0001028337	success	195	147	124	71	23	0.636	-2,-2.5,-4,-6,.5,.8,/3,0,0.05-1,0.3-0.5,0.4-0.7,0.4-0.8,0.7-0.9,0.7-1,1-1.8,1-2,1-3,1.5-3,1.5-4,1.8-2,15-50,2-2.2,2-4,5-25,5-6,5-8,abaxially,anther,apart,apex,apically,apparently,articulated,bark,base,berry,branched,calyx,chartaceous,cm,color,conical,connivent,cuneate,dark,deltate,densely,diameter,discolorous,drying,entire,erect,evenly,eye,filament,flattened-reniform,flower,fruit,glabrescent,glabrous,gray,gray-brown,green,green-brown,hair,inflorescence,juvenile,known,lateral,leaf,length,lobe,lobed,long,margin,marking,mature,mauve,minutely,mm,moderately,naked,narrow-oblong,orange-brown,pale,pedicel,peduncle,per,petiole,pitted,poricidal,porrect-lepidote,prickle,prickly,primary,ray,reddish,rounded,shallowly,shrub,simple,smooth,spaced,sparse,spherical,stellate-pubescent,stem,straight,strongly,style,surface,tapering,terete,terminal,tip,toward,tube,unarmed,vein,visible,way,white,wide,young	0.05-0.15,0.1-0.3,1,1/2,1/3-2/3,1/4-1/3,1/8-1/4,11-16,3-4,4-5,5-merous,6-7,8-10,8-14,abaxial,acut,adaxial,alyx,apar,ape,blade,curved,eaf,eed,elongating,equal,free,fruiting,fused,gently,glabrou,glaucous,infructescence,juvenil,long-styled,longer,lower,midpoint,nflorescence,occasionally,older,one,open,orolla,oung,perfect,pericarp,plurifoliat,porrect,portion,reflexed,ruit,scar,sessile,shoot,short,short-styled,shorter,slender,small,staminate,stellate,stout,tamen,time,trichome,unarme,unit,usually,vary,ympodial	acute,arrangement,characteristic,colour,corolla,exertion,form,glabrousnes,growth,height,history,life,lobing,new,number,ovary,perennial,plant,seed,shape,size,texture,type
216	wfo-0001028339	invalid_json_followup	195	161	113	82	48	0.579	.5,0.05-0.1,1-1.2,1-2,1-5,1.1-1.4,1.2-1.5,1.5,1.7-3.2,10-30-flowered,10.2-18.5,3.5-4,5-7,5.8-7.9,8-10,acuminate,acute,anther,apex,appearance,appressed,bark,base,beneath,berry,broadly,brown,bud,calyx,capitate,cm,corolla,covered,cuneate,cup-shaped,dark,decurrent,densely,dia,dried,dry,enclosed,evenly,exserted,filament,filiform,flattened,floccose,fruiting,glabrous,globose,grainy,greyish-brown,growth,irregular,later,lateral,leaf,like,little,lobed,long,main,margin,minutely,mm,mustard,nearly,oblique,ovary,ovate,ovoid,ovoid-reniform,papillate,pedicel,petiole,pitted,pulp,red-brown,shaped,shrub,simple,size,slender,slightly,small,somewhat,spaced,sparsely,specimen,stem,stigma,strong,strongly,style,surface,tapering,tear-drop,texture,tree,trichome,tube,uniseriate,urceolate,vein,white,white-speckled,winged,woody,x,yellow,yellowish,young	0.8-1.2,1-1.5,1.5-2,2.5-5,3.4-5.5,43191,5-angled,7-11,8182,across,almost,anthesi,appearing,attenuate,becoming,blue,carinate,carpel,closely,connate,crystalline,deflexed,differing,difoliate,distinctly,eaf,edicel,eed,epidermi,erect,fide,first,flower,free,frui,geminat,glabrate,large-celled,leave,lobe,lon,long-triangular,lower,major,middle,minor,nee,nflorescence,obscure,occasionally,older,one,opposite,overlappin,papery,papillose,planar,pore,poricidal,portion,proximal,reflexed,ruit,scar,schwarz,secondary,septum,shining,speckled,straight,tall,tightly,tip,tub,ud,unit,venation,white-lenticellat,white-papillo,wide,widest,ympodial	'',[,``,alternate,arrangement,branch,cal,characteristic,colour,corrugation,diameter,distal,drying,exertion,form,fruit,glabrousnes,green,height,history,inflorescence,interjected,leaflet,length,life,lobing,midpoint,na,new,number,peduncle,per,plant,prickle,primary,pseudostipule,ray,seed,shape,terminal,thicknes,type,value,variation,white-papillose,width,{,}
217	wfo-0001028351	success	175	130	80	95	50	0.457	.2,.8,0,0.2,1.0â2.0,2,2.0â2.5,3,3â4,40,5.0,5.0â5.5,6â12,8â15,abaxially,acute,adaxially,along,annual,anther,anthesi,apex,base,becoming,blue,branching,brown,calyx,capitate,clavate,cm,colour,densely,diameter,filament,flattened,fruit,glabrous,globose,green,herb,lanceolate,leaf,lobe,lobed,long,margin,midvein,mm,moderately,number,oblong,opposed,ovate,pale,pedicel,peduncle,perennial,petiole,pitted,pubescent,regularly,shallowly,shiny,simple,slender,sparsely,stem,stigma,style,surface,truncate,tube,unbranched,unknown,velutinous,woody,x,young,â3.0	.8â1.0,0.1,0.5,0.6,0â,1.0â,1.0â1.6,1.0â2.5,1.4â1.5,1.5â4.0,1.6â,10,2.0â5.0,2.1â3.5,2/3,2â2.5,2â4,3.4â5.0,4,5,5.5â10.5,5â7,6.5â8.5,absent,adaxiall,ag,apart,apical,articulated,axe,ba,basal,blade,cell,chartaceous,connivent,convex,cylindrical,directed,distally,eaf,eed,equal,erect,fleshy,flower,geminat,glandular,hair,indumentum,lamin,like,lon,longitudinal,lower,m.,multicellular,narrowly,nfloresence,obtuse,occasionally,opening,orolla,pair,pentagonal,perfect,plurifoliate,pore,present,probably,ruit,serrate,shaped,side,slit,smaller,spaced,stone,straight,tal,tamen,tardily,teardrop,tem,time,unicellular,uniseriate,unit,vary,white,wide,wing,winged,ympodial,â	0â2.5,1.0â4.0,1.5,1.6â5.0,appearance,arrangement,bark,border,branch,bud,characteristic,corolla,corrugation,distal,drying,exertion,form,fruiting,giving,glabrousnes,growth,height,history,inflorescence,interjected,lateral,leaflet,length,life,lobing,midpoint,na,new,ovary,per,plant,prickle,primary,pseudostipule,ray,seed,shape,size,terminal,texture,thicknes,type,variation,vein,width
218	wfo-0001028353	invalid_json	177	138	112	65	26	0.633	/3,0.2-0.4,0.5,0.9-1.2,1,1-4,1.4-2,1.5-2,1.5-5,2,2-3,2-4,3,3-5,4-7,6-8,7,acute,along,anther,apex,base,beneath,berry,bluntly,bright,calyx,capitate,cell,centre,ciliate,clasping,cm,coarsely,conical,cordate,corolla,cup-shaped,dark,deep,deeply,densely,diameter,ellipsoid,elliptic,emarginated,erect,filament,fleshy,flower,fruiting,glabrous,globose,green,greenish,herb,heteromorphic,hollow,honey-comb,internodal,leaf,less,like,lobe,long,margin,midrib,minute,minutely,mm,nodding,often,open,ovary,ovoid,pale,papery,papillate,papillose,pedicel,petiole,pitted,plant,plump,pubescent,purple,rhomboid,ripe,sessile,shallow,short,simple,size,slender,somewhat,sparsely,stem,stigma,style,surface,tan,testal,tip,toothed,trichome,truncate,tube,uniseriate,vein,way,x,yellow	.5,0.5-,1-2,8-10,abaxially,accrescent,age,anthesi,apart,area,becoming,campanulate,curved,decreasing,decumben,difoliate,distally,dry,drying,eaf,edicel,eed,exerted,fracturing,free,frui,geminat,gree,growing,horn,horned,inserted,lengthening,lon,lower,m.,material,nflorescence,outline,pair,peduncle,pericarp,point,pore,poricidal,portion,primary,principal,reddish,ruit,scar,scattered,sessil,sleeve,slightly,slit,straight,strongly,thin,toward,ud,unit,wall,wrinkled,ympodial	'',[,``,abaxial,adaxial,arrangement,bud,characteristic,colour,form,fruit,growth,height,history,inflorescence,length,life,lobing,pubescence,seed,shape,texture,type,value,{,}
219	wfo-0001028390	success	147	134	78	69	56	0.531	0,0.5,0.5-1,0.5-1.5,1-2.5,1.5-2,1.5-5.5,10-15,3-4,4-11,4-5,5-7,7-8,acute,angled,apex,apiculate,base,branched,calyx,chartaceous,cm,connivent,cuneate,deltate,dendritically,densely,diameter,divided,eglandular,elliptic,entire,felty-pubescent,flower,forked,glabrous,gland,globose,hair,lanceolate,like,lobe,margin,mixed,mm,mostly,obtuse,occasionally,often,orange,ovate,pedicel,peduncle,perfect,petiole,pseudohair,pubescent,rarely,ripe,short,shrub,simple,slightly,small,stalked,stigma,style,subcordate,subcoriaceous,truncate,tube,unbranched,unequally,usually,violet,white,x,yellow	-10,.5-3.3,0.5-2.5,1,1-3,1-5,1.5-3.5,2,2.5,3-5,6-many-foliat,7,9,abaxially,absen,adaxiall,adaxially,aggregate,apart,articulated,axe,blade,cell,curled,cylindrical,dendritically-branched,dense,directed,distall,eaf,eed,leaving,less,lon,long,lower,midvein,moderately,narrowly,near,nflorescence,nther,orolla,peg,pore,presen,puberulent,pubescen,rachi,radiu,ruit,scar,spaced,sparsely,ste,stellate,stone,subcapitat,subclavate,tal,tem,time,tip,triangular,unit,vary,white-pubescent,wide,ympodial	anther,appearance,arrangement,bark,border,branch,bud,characteristic,colour,corolla,corrugation,distal,drying,exertion,filament,form,fruit,fruiting,giving,glabrousnes,growth,height,history,inflorescence,interjected,lateral,leaf,leaflet,length,life,lobing,midpoint,na,new,number,ovary,per,plant,present,prickle,primary,pseudostipule,ray,seed,shape,size,stem,subcapitate,surface,terminal,texture,thicknes,type,variation,vein,width
220	wfo-0001028405	success	149	111	63	86	48	0.423	0.4-0.5,0.5-3,1-4,1-9,1.3-8,1.5-6.5,10-11,2,2-2.5,3-4,3.5-10,3.5-6.5,4-11.5,4-6,7-14.5,8-15,9-15,acute,apex,base,branched,calyx,cm,conical,corolla,cyme,diameter,dichasial,dichasially,distal,ebracteate,elliptic-lanceolate,filament,green,green-white,herbaceous,interjected,lanceolate,lateral,leaf,leaflet,lobe,long,mm,monochasial,mucilaginous,oblique,odd-pinnate,ovoid,pedicel,peduncle,perennial,petiole,plant,puberulent,seed,size,stigma,style,terminal,throughout,tuber-bearing,wide	2-3,2-4,3-20,3-6-foliat,6-7,abaxially,absen,acumen,adaxially,apical,apically,apiculate,articulate,attenuate,cell,connate,covering,decurrent,dehiscent,digestion,diminishing,dorsally,eaf,edge,eed,elliptic,emoval,enzyme,exceeding,flat,flower,folded,forked,generally,globo,gradually,hair-like,half,honeycomb,introrse,living,lon,lower,lunat,make,maturing,nflorescence,nther,oblong,often,orolla,ovate-elliptic,pair,pattern,perfect,plan,poricidally,proximal,rachi,reveal,ruit,seudostipule,short,short-acuminate,short-petiolate,slit,specimen,stamen,stellate,straight,subsessile,tal,tem,testal,thick,throughou,toward,typically,unit,vary,wall,whit,without,yellow,ympodial,Â¼	absent,anther,appearance,arrangement,bark,border,branch,bud,characteristic,colour,corrugation,drying,exertion,form,fruit,fruiting,giving,glabrousnes,globose,growth,height,history,inflorescence,length,life,lobing,margin,midpoint,na,new,number,ovary,per,prickle,primary,pseudostipule,ray,shape,stem,surface,texture,thicknes,tube,type,variation,vein,white,width
221	wfo-0001028429	success	162	130	84	78	46	0.519	0.2-0.4,0.8-1.2,0.9-2.3,1-2.5,1-4,1.5-3,10-11,10.5-21,2-4,2.5-12,2.5-4,2.5-7.5,2.7-3.6,3-6,4-14,5-12,6-28,abaxially,acuminate,acute,adaxially,apex,articulate,base,branched,broadly,calyx,cm,cordate,corolla,cuneate,cyme,darker,diameter,dichasial,dichasially,distal,ebracteate,elliptical,filament,glabrescent,glabrous,globose,green,green-white,greenish,herbaceous,interjected,lateral,leaf,leaflet,light,lobe,long,long-attenuate,medium,mm,monochasial,mucilaginous,narrowly,oblique,obovate,odd-pinnate,ovate,ovoid,pedicel,peduncle,perennial,petiole,plant,proximal,seed,size,slightly,spot,stigma,style,terminal,throughout,vein,violet,white,wide,Â¼	1.5-4,10-27,2-1.,2-3,2-8,3-6-foliat,6-18,7-7,abaxiall,acumen,apical,apically,cell,connate,covering,dehiscent,digestion,diminishing,dorsally,eaf,edge,eed,emoval,enzyme,especially,exceeding,flat,flower,folded,forked,generally,globo,gradually,hair,hair-like,half,honeycomb,introrse,living,lon,lower,lunat,make,maturing,nflorescence,nther,often,orolla,pair,pattern,pentagonal,perfect,petiolule,plan,poricidally,reveal,rotate,ruit,scattered,seudostipule,short,slit,specimen,stamen,straight,tal,tem,testal,thick,throughou,toward,tuber-bearing,typically,unit,vary,wall,yellow,ympodial	2-19,anther,appearance,arrangement,bark,border,branch,bud,characteristic,colour,corrugation,drying,exertion,form,fruit,fruiting,giving,glabrousnes,growth,height,history,inflorescence,length,life,lobing,margin,midpoint,na,new,number,ovary,per,prickle,primary,pseudostipule,ray,shape,stem,surface,texture,thicknes,tube,type,variation,wet,width
222	wfo-0001028436	success	150	127	80	70	47	0.533	.5,0.2-0.4,0.5,0.5-1,1-3,1.5,1.5-2,1.5-2.5,10-20,2.5-3,4,5-10,5-12,5-15,5-8,7,8-12,absent,acute,anther,apex,appearance,base,berry,brown,calyx,center,chartaceous,ciliate,cm,decurrent,deflated,diameter,dm,dried,edge,elliptic,entire,filament,fine,flower,fruit,fruiting,glabrous,globose,leaf,linear,linear-lancolate,lobe,margin,membranaceous,mm,moderately,much-branched,nearly,oblong,often,parallel,pedicel,peduncle,per,petiole,pubescent,radiating,raised,ridge,rotate,running,shallow,shrub,stem,stigma,style,surface,triangular,tube,unifoliate,white,wrinkled,x	0.8-1.5,1-2,1-2-celled,1st,2-3,2-4,2nd,abaxially,abundant,adaxiall,adaxially,along,apically,appearing,axe,beyond,blade,cell,connected,cordat,dehiscent,difficult,due,eaf,eed,evaluat,explosively,exserted,flat,frui,geniculate,glabrescen,hair,interpetalar,lengt,like,long,lower,lying,nflorescence,notch,older,orolla,oung,placenta,pointing,presence,pubescen,rachi,reaching,rhizomatous,ruit,small,sparsely,stamen,structure,swollen,tal,tamen,taproot,tear,thick,tissue,two-celled,unbranched,unit,vary,wid,woody,ympodial	arrangement,bark,border,branch,bud,characteristic,colour,corolla,corrugation,distal,drying,exertion,form,giving,glabrousnes,growth,height,history,inflorescence,interjected,lateral,leaflet,length,life,lobing,midpoint,na,new,number,ovary,perennial,plant,prickle,primary,pseudostipule,ray,seed,shape,size,terminal,texture,thicknes,type,variation,vein,wide,width
223	wfo-0001028465	invalid_json_followup	159	152	98	61	54	0.616	0.75,1-2,1-4,1.2-2,10,10-24,11-23,2-6,2-9.3,2.4-2.8,2.5-4,3-5,3-8,3.8-7,4-8,4.5-5.5,8-10,acumen,acuminate,acute,apex,apical,apically,articulate,attenuate,base,branched,broadly,calyx,cell,cm,connate,corolla,covering,cuneate,cyme,dehiscent,diameter,dichasial,dichasially,distal,ebracteate,elliptical,exceeding,filament,globose,green,green-white,herbaceous,interjected,interpetalar,introrse,lateral,leaf,leaflet,lobe,long,make,maturing,medium,mm,monochasial,mucilaginous,oblique,odd-pinnate,often,ovoid,pedicel,peduncle,perennial,petiole,petiolule,plant,poricidally,proximal,puberulent,pubescent,purple,seed,sessile,short,size,slit,spot,stamen,stigma,straight,strigose,style,terminal,testal,thick,throughout,tuber-bearing,wall,white,yellow,Â¼	1.5-2.9,2,2-3,2-4,3-4,3-6-foliat,4-1.,5-7,7-15,9-19,abaxially,adaxially,decurrent,digestion,diminishing,dorsally,eaf,edge,eed,emoval,enzyme,equal,first,flat,flower,folded,forked,generally,globo,gradually,hair-like,half,honeycomb,living,lon,lower,lunat,nflorescence,nther,orolla,pair,pattern,perfect,plan,rachi,rarely,reveal,rotate,ruit,seudostipule,specimen,tal,tem,tissu,toward,two,typically,unit,vary,wide,ympodial	'',4-18,[,\u201chair-like\u201d,``,anther,appearance,arrangement,bark,branch,bud,characteristic,colour,corrugation,drying,exertion,form,fruit,fruiting,giving,glabrousnes,growth,height,history,inflorescence,length,life,lobing,margin,midpoint,na,new,number,ovary,per,prickle,primary,pseudostipule,ray,shape,stem,surface,texture,thicknes,tissue,tube,type,value,variation,vein,wet,width,{,}
224	wfo-0001028468	invalid_json_followup	255	169	124	131	45	0.486	-10,-3,.3-0.4,.6-1,0.2-0.3,0.4-4,0.7-2.5,0.8-3.5,1.2-1.5,1.6,16,2-9,2.2-3,2.8-4.1,4-6,5-21,5-9,6-9,acute,along,anther,apex,armed,attenuate,base,berry,blue,broad-based,broadly,brown,bud,calyx,campanulate,central,chartaceous,clavate,cm,commonly,compressed,corolla,dark,densely,diameter,distal,ellipsoid,exserted,extra-axillary,filament,flattened,flower,foveate,fruit,fruiting,glabrescent,glabrous,gray,green,greenish,interpetalar,lateral,laterally,length,light,lobe,lobed,long,margin,midpoint,midvein,mm,moderately,narrowly,oblique,oblong-conical,oblong-lanceolate,obtuse,occasionally,orange,ovate,ovoid,pair,pale,pedicel,peduncle,per,petiole,prickle,purple,ray,recurved,reticulate,rhombic,shallowly,short,shrub,side,simple,slightly,somewhat,sparsely,stellate-pubescent,stelliform,stem,stigma,straight,style,subcapitate,subcuneate,subelliptic,subglobose,sublenticular,subreniform,subshrub,surface,terete,thicknes,tissue,triangular,tube,unarmed,unbranched,vein,x,yellowish	-1.3,-4,-5.5,-7,.1-0.2,.1-0.3,.1-0.4,.2,.2-0.4,.3,.5,.5-1.5,.5-1.6,/10-1/5,/4-1/3,0.05,0.1,0.2-0.6,0.2-1.5,0.4-1,0.5-2,0.5-3,0.5-3.3,0.5-3.5,0.5-8,0.6-1.2,0.6-2,1,1.3-2,1.5-2.2,1.5-3.1,1/3-1/2,1/5-1/2,2,2.5-4,2/3-3/4,20,3-4,4-9,6-10,abaxially,accrescent,acuminate,adaxially,apart,appressed,ark,articulated,axe,becoming,beyond,blade,bu,c.,cauline,compresse,connivent,d.,decreasing,density,directed,distally,distantly,dry,eaf,eed,equal,geminat,gradually,hair,half,increasing,inserted,introrsel,lamin,longer,lower,m.,main,minutely,mixed,mostly,multangulat,multangulate,nflorescence,older,orangish,orolla,overlapping,papillo,perfect,pore,porrect-stellate,proximal,pubescence,pubescent,rachi,reduced,relatively,rotate-stellate,ruit,sessile,short-,short-stalked,similar,similarly,spaced,specimen,stalk,stamen,subacuminate,subchartaceous,subsessile,tal,tamen,testa,thick,thick-stalked,time,touching,toward,unifoliate,unit,upper,usually,vary,way,wide,yellow,ympodial,young	'',0-1.3,0.1-0.3,0.5-1.5,2-7,[,``,arrangement,bark,branch,cal,characteristic,colour,corrugation,drying,exertion,form,glabrousnes,growth,height,history,inflorescence,interjected,leaf,leaflet,life,lobing,na,new,number,ovary,plant,primary,pseudostipule,seed,shape,size,terminal,texture,type,value,variation,width,{,}
225	wfo-0001028470	invalid_json_followup	185	161	114	71	47	0.616	0-18,0.25-0.75,0.9-2.2,0.9-2.3,1-12.3,1-2,1-3,1.5-2.8,1.6-3.2,11.8-21,12-44,2-10,2-8,2.1-3.9,3-10,3.2-5.5,3.5-7,4-7,5.5-11.6,6-33,abaxially,acumen,adaxially,anther,apex,apparently,articulated,attenuate,axe,axillary,base,berry,brownish,bud,cell,chartaceous,clavate,cm,condition,connivent,corolla,covering,dark,deep,diameter,distal,dot,drying,elliptic,filament,flower,forked,fresh,fruit,generally,glabrescent,glabrous,green,green-white,greenish,hair,half,herb,high,interjected,lanceolate,lateral,leaf,leaflet,light,lobe,long,make,medium,mm,mottled,mucilaginous,odd-pinnate,ovate,ovoid,pedicel,peduncle,perfect,petiole,petiolulate,plant,poricidal,purple,ripe,rounded,seed,short,size,sometimes,stigma,style,subtending,terminal,testal,thick,throughout,tip,tube,typically,unwinged,usually,wall,wet,white,whitish,wide,wing,x,yellow	2-5,2-7,3-5,3.5-16,4-6,5-merou,acute,adaxiall,ag,alyx,apart,asymmetric,basiscopic,blade,capitat,decreasing,digestion,dorsally,eaf,edge,eed,end,enzyme,erec,exceeding,flat,folded,geminat,glabrou,hair-like,hal,homostylous,honeycomb-shaped,lengthening,living,lower,nflorescence,one,orbicular,orolla,pair,pentagonal,placed,plurifoliate,pore,pubescent,removed,ruit,scarce,sessile,seudostipule,side,slit,spaced,specimen,stamen,stolo,straight,subequal,subglabrou,substellate,tall,tamen,tem,tissue,toward,tri-,tuber,unit,vary,ympodial	'',[,\u201chair-like\u201d,``,arrangement,bark,branch,cal,calyx,capitate,characteristic,colour,corrugation,exertion,form,fruiting,glabrousnes,growth,height,history,inflorescence,length,life,lobing,margin,midpoint,na,new,number,ovary,per,prickle,primary,pseudostipule,ray,shape,stem,surface,texture,thicknes,type,value,variation,vein,width,{,}
226	wfo-0001028476	invalid_json_followup	246	194	156	90	38	0.634	-16,-20,-6,-8,.05-0.1,0-,0.1-0.4,0.2-0.3,0.2-0.5,0.3-0.4,0.3-1.2,0.4-0.6,0.4-1.5,0.5,0.5-0.6,0.7-2.5,0.8-1.2,0.8-1.6,1,1-1.4,1-2,1-2-celled,1-4,1-6,1.1-1.5,1.2-2.5,1.8-2.5,12-30,2-6,2-foliate,2-locular,2.4-3,3-12,3-foliate,3.5-13,4-celled,5-15,6-,8-30,abaxially,abundant,acuminate,acute,age,almost,along,anther,anthesi,apex,appearance,articulated,basal,base,basiscopically,bifurcate,bracteate,branched,bright,brown,calyx,capitate,cell,cm,conical,corolla,curved,dark,deeply,diameter,distal,ebracteate,elliptic,entire,especially,exserted,filament,flower,fruit,fruiting,give,glabrescent,glandular,globose,green,hair-like,half,head,herb,imparipinnate,inflorescence,interjected,internode,interrupted,irregularly,lateral,leaf,leaflet,less,like,lobed,long,margin,maturity,minute,minutely,mixed,mm,narrowly,node,oblique,obovate,occasionally,outgrowth,ovary,pale,pedicel,peduncle,perennial,petiole,present,primary,pseudostipule,puberulent,pubescence,pubescent,purple,rarely,regularly,scattered,silky,simple,sparsely,stellate,stem,stiff,stigma,straight,stripe,style,surface,terminal,testa,thick,tip,trichome,truncate,tube,unicellular,uniseriate,unit,usually,vein,wall,wide,woody,yellow	-1,.5,0-0.5,0.1-0.15,0.15-0.2,0.15-0.4,0.2-0.6,0.25-0.4,0.25-0.5,0.3-0.5,0.3-0.7,0.4-0.5,0.5-1.7,1-1.2,1-1.5,1-celled,1.1-1.6,2,3-7,7-10,absent,acroscopically,also,alternate,ape,apical,appendage,axi,becoming,bifurcation,bract,column,decurrent,diamete,eaf,edicel,eed,elongate,first,fortaleza,gradually,gree,hal,hyaline,incurved,lanceolate,largest,lobe,lon,lower,main,midvein,nflorescence,numerous,often,pair,petiolule,population,prominent,rachi,recurve,reflexed,rest,rounded,ruit,rÃ­o,secondary,sessile,set,short,sinus,slightly,smaller,sprawling,spreading,staminal,sterile,subopposite,tall,tem,tertiary,toward,ud,uniformly,unpaired,weak-walled,white,wid,winged,ympodial	'',[,``,arrangement,branch,bud,characteristic,colour,corrugation,drying,exertion,form,glabrousnes,growth,height,history,length,life,lobing,midpoint,na,new,number,per,plant,ray,seed,shape,size,sympodial,texture,thicknes,type,value,variation,width,{,}
227	wfo-0001028481	invalid_json_followup	194	148	99	95	49	0.51	.5,0.5-1,0.6-1,0Â°,1-2,1.5,1.8-2.5,1/2-2/3,2.5-3,3,3-4,3-6,5.5-7.5,8,acuminate,almost,along,anther,anthesi,apex,apically,attenuate,bark,base,branch,branched,brown,canaliculate,chartaceous,clavate,cm,colour,conical,corolla,cuneate,cupular,dendritic,dendritic-pubescent,diameter,dilated,discolorous,distributed,dry,drying,elliptic,entire,equal,evenly,faint,filament,flexuous,flower,glabrous,green,leaf,length,liana,like,lobe,long,main,margin,midvein,mm,oblique,oblong,occasional,orange-brown,pair,pedicel,peduncle,petiole,primary,pubescent,ray,reddish,ribbed,ridged,shortly,shrub,size,slender,sparsely,spreading,stem,stigma,style,surface,terminal,thickly,trichome,tube,unarmed,unknown,vein,white,x,yellowish,young	.1,.3,0-2,0.1-0.2,0.15,1-1.4,1-3,1-4,1.5-2,2-3,3-3.5,3-4.5,abaxially,absent,acute,adaxially,age,alyx,apar,apparently,articulated,clearly,close,deeply,delineated,deltoid,density,different,divided,domatia,dorsifixed,eaf,eed,ellipsoi,erect,except,extending,extent,eye,flaking,flat,free,increasing,know,known,lamina,lengthening,less,linear,lobed,lon,long-acuminate,longer,longitudinally,lower,m.,mostly,naked,narrowly,nflorescence,nther,often,orolla,ovate,perfec,plurifoliat,pore,poricidal,portion,protruding,rachi,raised,ruit,scar,see,side,simple,sinus,small,smoot,smoothly,stump,tearing,tertiary,tip,together,toward,ud,uneven,unit,vary,venation,visible,wide,ympodial	'',60-100,[,``,appearance,arrangement,border,bud,calyx,characteristic,corrugation,distal,ellipsoid,exertion,form,fruit,fruiting,giving,glabrousnes,growth,height,history,inflorescence,interjected,lateral,leaflet,life,lobing,midpoint,na,new,number,ovary,per,perennial,plant,prickle,pseudostipule,seed,shape,smooth,texture,thicknes,type,value,variation,width,{,}
228	wfo-0001028482	success	224	186	163	61	23	0.728	.1,.5,/3,0,0.2,0.5,0.5-1,0.5-5,00,1-1.5,1-11,1-2,1-4,1.2-1.6,1.5-2,1.5-3,10,2-3,2-celled,3-12,3-4,4-5,5-25,6-50,7-14,abaxially,acuminate,acute,adaxially,age,alternate,angled,anther,anthesi,apex,ascending,asymmetric,bark,base,becoming,berry,bifid,bifurcate,bilobed,branched,bright,broadly,brochiodromous,brownish,bud,calyx,campanulate,capitate,channeled,chartaceous,cm,corky,corolla,corrugated,creamy,cymose,deciduous,deltate,diameter,diffusely,dry,drying,ellipsoid,elliptic,emarginate,entire,exerted,filament,flattened-reniform,fleshy,flower,fresh,fruit,fruiting,glabrous,glandular,globose,golden,green,growth,halfway,hard,impressed,internodal,irregular,keeled,leaf-opposed,lengthening,less,lobe,long,margin,material,maturity,midrib,minutely,mm,new,nodding,obovate,occasionally,olive,ovary,pair,pale,pedicel,peduncle,per,petiole,pitted,pore,poricidal,primary,pubescent,reddish,revolute,scandent,shaped,shiny,short,simple,size,slightly,slit,small,sometimes,somewhat,soon,sparsely,stem,stigma,style,subcoriaceous,subglobose,subpyramidal,surface,tan,tear-drop,tip,transparent,transversely,tree,trichome,truncate,tube,tuberculate,tuft,uniseriate,usually,vein,venation,way,white,x,yellow,yellowish,young,Âµm	0.7-1.1,1.1-5,apiculae,basal,berr,circinate,closely,constriction,coriaceous,cucullate,curved,deflexed,densely,difoliate,discolorous,distally,distinct,eaf,eed,embryo,enlarged,exfoliating,expanding,free,geminat,glabrou,grayish,heterostylous,incrassate,individual,investing,lobed,lower,markedly,materia,midvein,minute,nflorescence,overlappin,papillat,pentamerous,pericarp,petal,portion,row,ruit,scar,spaced,stout,straight,tightly,tiny,tub,twice,two,ud,unifoliate,unit,vegetative,woody,ympodial	arrangement,branch,characteristic,colour,corrugation,exertion,form,glabrousnes,height,history,inflorescence,leaf,length,life,lobing,na,number,papillate,plant,seed,shape,texture,type
229	wfo-0001028487	invalid_json_followup	195	167	120	75	47	0.615	0-9,0.3-0.7,0.4-1.5,0.9-3,1-2,1-3,1-3.2,1.1-1.5,1.4-1.7,1.7-7,10-4.3,10-41,15-28,2-4.8,2-6,2.5-3.5,3-10,3.4-7.8,4.6-13.6,5-6,7.8-16.4,abaxially,acumen,acuminate,acute,adaxially,anther,apex,apparently,asymmetric,attenuate,axe,axillary,base,basiscopic,berry,brownish,bud,cell,central,clavate,cm,condition,connivent,coriaceous,corolla,covering,dark,deep,diameter,distal,drying,elliptic,filament,flower,forked,fresh,fruit,generally,glabrescent,glabrous,green,green-white,greenish,hair,half,herb,interjected,lanceolate,lateral,leaf,leaflet,light,long,make,medium,mm,mucilaginous,narrow,odd-pinnate,orbicular,ovate,ovoid,pedicel,peduncle,perfect,petiole,petiolulate,plant,purple,ripe,rounded,scabrous,scarce,seed,sessile,short,side,size,sometimes,star,stigma,style,subtending,terminal,testal,thick,throughout,tissue,tube,typically,unwinged,usually,wall,wet,white,whitish,wide,wing,x	2-4,3-19,3-4,3-5,4-7,5-merou,adaxiall,ag,along,alyx,apart,arranged,articulated,bead,blade,capitat,considerably,decreasing,digestion,dorsally,eaf,edge,eed,enzyme,erec,exceeding,flat,folded,geminat,glabrou,hair-like,hal,high,homostylous,honeycomb-shaped,lengthening,like,living,lobe,lower,moniliform,multiple,necklace,nflorescence,orolla,pair,pentagonal,plurifoliate,pore,poricidal,removed,ruit,second,seudostipule,slit,smaller,spaced,specimen,stamen,stolon,straight,subequal,subglabrou,substellate,tall,tamen,tem,tip,toward,tri-,tuber,unit,vary,yellow,ympodial	'',[,\u201chair-like\u201d,``,arrangement,bark,branch,cal,calyx,capitate,characteristic,colour,corrugation,exertion,form,fruiting,glabrousnes,growth,height,history,inflorescence,length,life,lobing,margin,midpoint,na,new,number,ovary,per,prickle,primary,pseudostipule,ray,shape,stem,surface,texture,thicknes,type,value,variation,vein,width,{,}
230	wfo-0001028489	success	224	154	123	101	31	0.549	-10,-2.5,-4,-5,-6,/4,0-20,0-3,0.3-0.5,0.3-1,0.3-1.2,0.5-1,0.5-1.1,0.5-1.5,0.6-1.2,0.7-3,1-3,1-7,1.5-4,1.8-2.2,1.8-4,1.8-5.5,1/3,1/3-1/2,2-3,2-4,2.1-3,3-7,4-13,7.5,acicular,acute,anther,apart,apex,apparently,articulated,bark,base,berry,calyx,cell,chartaceous,cm,connivent,cordate,cream,cuneate,dark,diameter,dull,elliptic,elongating,erect,filament,flattened-reniform,fruit,glabrous,gray,green,lateral,leaf,length,lobe,lobed,long,margin,marking,mature,maturity,mauve,membranous,mm,moderately,obtuse,occasionally,orange,orange-brown,orange-green,outline,ovate,pair,pale,pedicel,peduncle,per,perpendicular,petiole,poricidal,prickle,prickly,primary,purple,raised,red-brown,rounded,shiny,shrub,side,simple,smooth,sometimes,spaced,sparsely,spherical,stellate-pubescent,stem,straight,style,surface,tapering,tip,truncate,unarmed,upper,vein,way,white,wide,yellow,yellow-green,yellow-orange,young	-0.6,0-10,0-15,0-50,0.1,0.1-0.6,0.2,0.2-,0.2-0.4,0.2-0.5,0.2-0.6,0.2-0.7,0.3-0.7,0.4-0.8,0.5-0.8,1-4,1-6,1.5-3,1/4-1/2,2-6,3.5-6,4-10,4-8,5-25,5-8,5-merous,abaxially,alyx,apar,apically,ba,beyond,blade,branched,broad-deltate,caudat,concolorous,curved,deltate,densely,difoliate,distance,drying,eaf,eed,equal,extending,eye,flower,free,fruiting,geminat,hair,herbaceous,infructescence,less,lon,longer,lower,midpoint,midvein,minute,naked,nflorescence,often,older,one,open,orolla,oung,pendulous,perfec,pericarp,porrect,portion,protruding,ray,ruit,scar,sessile,slender,spreading,stalk,stellate,subsessile,tamen,terete,tertiary,time,toward,trichome,tube,unarme,unit,vary,venation,visible,weakly,white-gra,woody,ympodial	15-25,appearance,arrangement,border,branch,characteristic,colour,corolla,exertion,form,giving,glabrousnes,growth,height,history,inflorescence,life,lobing,na,new,number,ovary,perennial,plant,seed,shape,size,texture,type,white-gray,width
231	wfo-0001028492	success	130	119	64	66	55	0.492	0.5-1,1-2.5,1-4,1.5-2.5,1.5-6,15-20,2-2.5,2-4,2.5-9,3,4,5-15,5-25-flower,5-8,6-11,6-12,acute,angled,apex,base,calyx,cell,cm,colored,containing,crystal,dark,deltate,diameter,elliptic-ovate,entire,forked,fruit,glabrous,globose,herb,lobe,margin,mm,narrowly,pedicel,peduncle,petiole,pubescent,punctate,purple,rarely,reticulate,ripe,rounded,shrub,simple,stigma,style,subcordate,triangular,tube,unbranched,white,white-punctate,whitish,wide,x,x1-3	-5-foliat,0.2-2,1-5,1.5-3,1.75-3.5,2-3,2-5,3-6,8-15,abaxially,absen,adaxially,aggregate,apart,apiculate,articulated,axe,axi,blade,chartaceous,ciliolate,color,connivent,cylindrical,directed,distall,eaf,eed,except,glabrou,hair,irregularly,leaving,long,lower,nflorescence,nther,obtuse,orolla,pore,rachi,radiu,ruit,san,sand-punctate,scar,somewhat,spaced,sparse,splitting,stellate,stone,subcoriaceous,succulent,tal,tem,time,tip,triangular-ovate,truncat,unevenly,unit,unknown,vary,veiny,ympodial	anther,appearance,arrangement,bark,border,branch,bud,characteristic,colour,corolla,corrugation,distal,drying,exertion,filament,form,fruiting,giving,glabrousnes,growth,height,history,inflorescence,interjected,lateral,leaf,leaflet,length,life,lobing,midpoint,na,new,number,ovary,per,plant,prickle,primary,pseudostipule,ray,sand,seed,shape,size,stem,surface,terminal,texture,thicknes,truncate,type,variation,vein,width
232	wfo-0001028501	invalid_json_followup	195	153	109	86	44	0.559	0-3.2,0-4,0.3-0.7,0.3-3.3,0.6-5.8,0.8-1.6,0.8-1.7,1,1-2,1-8,1.8-10.7,13-41,2.8-18,2.8-4.9,3-10,3-5,3.1-10.4,3.1-12,4-8,4.8-18,6.6-21.1,8-34,abaxially,acumen,acuminate,acute,adaxially,anther,apex,axillary,base,berry,blade,brownish,bud,clavate,cm,condition,coriaceous,corolla,dark,decurrent,diameter,distal,drying,filament,flower,forked,fresh,fruit,generally,glabrescent,glabrous,green,green-white,greenish,hair,half,herb,interjected,lanceolate,lateral,leaf,leaflet,light,linear,lobe,long,medium,mm,mottled,mucilaginous,narrow,narrowly,odd-pinnate,onto,ovate,ovoid,pedicel,peduncle,petiole,plant,purple,pyriform,rachi,ripe,scarce,seed,sessile,short,simple,size,sometimes,spot,stigma,style,subtending,terminal,throughout,tube,typically,unwinged,usually,wet,white,whitish,wide,wing,x	0-3,1-3,2-4,2-5,3-7,5-merou,8-10,adaxiall,ag,along,alyx,apart,apparently,arranged,articulated,attenuate,axe,bead,broadly,capitat,cell,connivent,considerably,covering,decreasing,digestion,dorsally,eaf,edge,eed,elliptic,enzyme,erec,exceeding,flat,folded,geminat,glabrou,hair-like,hal,high,homostylous,honeycomb-shaped,larger,lengthening,like,living,lower,make,moniliform,multiple,necklace,nflorescence,orbicular,orolla,pair,perfect,plurifoliate,pore,poricidal,present,removed,rotate,ruit,seudostipule,slit,spaced,specimen,stamen,stolon,straight,subglabrou,tall,tamen,tem,testal,thick,tip,toward,tri-,tuber,unit,vary,wall,yellow,ympodial	'',[,``,arrangement,bark,branch,calyx,capitate,characteristic,colour,corrugation,exertion,form,glabrousnes,growth,height,history,inflorescence,length,life,lobing,margin,midpoint,na,new,number,ovary,per,prickle,primary,pseudostipule,ray,shape,stem,surface,texture,thicknes,type,value,variation,vein,width,{,}
233	wfo-0001028502	invalid_json_followup	158	133	84	74	49	0.532	.5,/2,0.5-1,1-2,1.5-2,1.5-2.5,1.5-6,1.6-2.4,2-5,2-7,2-8,3.5-15,3.5-4,5-15,6-8,abaxially,acute,adaxially,anther,apex,bark,base,branch,branched,brown,calyx,campanulate,clavate,cm,congested,constricted,corolla,dark,dendritic,densely,dia,elliptic,exserted,fawn,filament,flattened-reniform,flower,fruiting,glabrous,globose,inflorescence,later,lateral,leaf,lobe,lobed,long,main,margin,minutely,mm,obovate,ovary,pair,pedicel,petiole,pitted,pubescent,reddish-brown,seed,shining,shrub,small,stem,stigma,style,surface,terminal,thick,time,tree,tree-like,trichome,tube,vein,warty,way,white,wide	1.5-3,2-2.5,2-4,5-6,?,abaxial,age,along,anthesi,apar,ba,beige,blade,body,cazalet,christmas-tree-like,closely,cone,deltate,denser,eaf,edicel,eed,erect,fide,flat,fleshy,free,glabrat,heteromorphic,impressed,included,incrassate,inflorescenc,lengthening,light,like,lon,long-styled,lower,matted,middle,narrower,nflorescence,often,older,packed,papillo,papillose,planar,plurifoliat,pore,poricidal,portion,prominent,rest,ruit,scar,scattered,short-styled,slit,spaced,structure,tall,tip,tub,ud,unclear,unevenly,widest,within,woody,ympodia,young	'',4-6,[,``,appearance,arrangement,bud,characteristic,colour,corrugation,diameter,distal,drying,exertion,form,fruit,giving,glabrousnes,growth,height,history,interjected,leaflet,length,life,lobing,midpoint,na,new,number,peduncle,per,perennial,plant,plurifoliate,prickle,primary,pseudostipule,ray,shape,size,texture,thicknes,type,value,variation,width,{,}
234	wfo-0001028505	success	168	129	89	79	40	0.53	.1,.3,.5,/3,0.25-0.5,0.8-1,0.8-1.5,1,1-3,10-14-flowered,10-15,2,3.5-5,acuminate,acute,anther,apex,aspect,bark,basal,base,beneath,berry,branch,broadly,bud,calyx,characteristic,cm,conical,corolla,dia,dry,drying,erect,exsertion,f,filament,flattened,fruiting,gently,glabrous,globose,green,grey,lateral,leaf,lobe,long,margin,minutely,mm,narrowly,obovoid,ovary,ovate,ovoid-reniform,pale,pedicel,petiole,pitted,plant,prominent,pubescent,rounded,seed,shape,shaped,shrub,simple,size,specimen,stem,stigma,style,surface,tan,tapering,tear-drop,trichome,truncate,tube,unicellular,uniseriate,vein,way,white,x,yellowish	.01,1.2-2.5,1/3,2.5-4.5,3-5,7-8,anthesi,ba,barely,black,blade,body,bright,darker,deciduous,decurrent,deflexed,delicate,deltoid,differentiated,differing,difoliate,distance,distinct,dried,eaf,edicel,eed,elliptic,expanded,exserted,free,geminat,greatly,incrassate,live,lobed,lon,lower,m.,main,major,materia,material,member,minor,minute,nflorescence,obvious,older,opposite,overlapping,pair,papillose,pore,poricidal,portion,proximal,purple,reflexed,ruit,scar,short,slightly,somewhat,soon,straight,strongly,tall,tip,touching,ud,unit,usually,whit,widest,woody,ympodial,young	alternate,appearance,arrangement,border,colour,corrugation,decurred,diameter,distal,exertion,form,fruit,giving,glabrousnes,growth,height,history,inflorescence,interjected,leaflet,length,life,lobing,midpoint,na,new,number,peduncle,per,perennial,prickle,primary,pseudostipule,ray,terminal,texture,thicknes,type,variation,width
235	wfo-0001028524	invalid_json_followup	236	180	134	102	46	0.568	-3,0.3,0.5-3.5,0.6-1.4,1-5,1.1-1.2,1.5-1.6,10-20,11,2-6,2.5-3.8,2.8-3.5,3-10,3-15,3.4-3.6,4-6,4-8,6-9,7-11,8-13,acuminate,acute,adaxially,anther,anthesi,apart,apex,apical-lateral,articulated,bark,base,becoming,berry,blunt-tipped,branch,branched,brown,bud,calyx,chartaceous,closely,cm,conical,continued,corolla,cream,dark,dehiscing,deltoid,densely,diameter,distal,dm,due,echinoid,entire,exserted,extend,ferrugineous,filament,flower,free,fruit,fruiting,glabrescent,glabrous,granular-tomentose,gray,green,greenish,growth,honeycombed,introrse,lanceolate,large,late,lateral,leaf,length,lobe,longitudinal,margin,midvein,mm,multangulate,nearly,oblong,obtuse,orbicular,ovate,ovate-lanceolate,pale,pedicel,peduncle,persistent,petiole,pore,probably,pubescent,rather,ray,reniform,reticulate-punctate,ripe,rounded,scabridulous,side,simple,slightly,slit,somewhat,spaced,stelliform,stem,stigma,strongly,style,subcoriaceous,subglobose,suborbicular,sulcate,terete,thin,time,tomentose,translucent,tree,tube,unarmed,vein,velutinous,x,yellow,yellowish	-2.7,.5-1,/10-3/10,0-150,0.3-0.8,1.2-1.3,1.5-3,1.8-2.5,1/3-2/3,2-3.8,2.5-3.4,2.5-4,3-4.3,3.3-4,4.3-6,6-7,7-10,9-14,abaxially,accrescent,ag,along,apparently,ascending,axe,axillary,ba,blade,capitat,eaf,echinoi,eed,elliptic,few-,few-rayed,first,fleshy,glabrescen,hair,half,high,indument,inserted,interpetalar,lacking,lanceolat,later,lobed,long,lower,m.,main,many-rayed,matted,midvei,mixed,nflorescence,obscured,often,older,orolla,overlapping,partly,perfect,plurifoliate,porrect-stellate,present,prominent,pseudo-terminal,rachi,relatively,ruit,runk,sessile,short,short-stalked,small,sparingly,sparsely,stalked,stamen,stellate,stout-stalked,suture,tamen,testa,thick,thick-stalked,thin-stalked,tissue,tomentu,touching,unarme,unit,usually,vary,warty,way,wide,yellowish-green,ympodial,young	'',[,``,age,arrangement,capitate,characteristic,colour,corrugation,drying,exertion,form,glabrousnes,height,history,inflorescence,interjected,leaflet,life,lobing,midpoint,na,new,number,ovary,per,perennial,plant,prickle,primary,pseud-terminal,pseudostipule,seed,shape,size,sparing,surface,terminal,texture,thicknes,type,value,variation,width,{,}
236	wfo-0001028525	success	257	133	107	150	26	0.416	0.5-1.5,0.5-2.5,1-2,1-2.5,1.1-1.7,1.2-1.6,1.5,1.5-3,1/3-3/4,10,10-13,2,2-2.5,2.5-5,3,3-7,4,4-7,7,acuminate,acute,almost,anther,anthesi,apex,apically,attenuate,bark,base,berry,black,branch,branched,branching,broadly,brown,capitate,chartaceous,clavate,cm,conical,cordate,corolla,dendritic,developed,diameter,dilated,drying,elongated,entire,filament,flattened,flexuous,form,frequently,fruit,fruiting,glabrous,green-brown,grey,lateral,leaf,liana,light,long,longitudinally,lumpy,margin,mature,mauve,membranous,mm,obconical,oblong,orange-brown,ovate,ovoid,pair,partly,pedicel,peduncle,petiole,primary,pubescent,pyriform,red-brown,ridged,rounded,shrub,simple,size,slender,sometimes,spheroidal,stem,stigma,style,surface,terete,terminal,truncate,tube,unarmed,vein,weakly,whitish,x	.25,.4,0.2-0.3,0.2-0.6,0.5,0Â°,1-1.5,1-4,1mm,2-3,3-5,4-15,4-5,6,7-13,7.5,accrescent,age,along,alternate,alyx,apar,apart,apice,apparently,around,articulated,axil,becoming,brachyblast,calyx,centre,clearly,clum,clustered,cup,curved,dark,deeply,delineated,deltoid,dendritic-pubescent,densely,density,detaching,developing,discolorous,divided,domatia-like,dorsal,dorsifixed,eaf,eed,ellipsoi,equal,erect,eye,fertilisation,fewer,fine,flat,flexible,flower,formed,forming,free,frui,glabrescent,increasing,inside,known,lamina,laterally,leave,lengthening,less,like,linear,lobe,lobed,longer,loop,loose,lower,m.,main,midvein,minute,much,multicellular-dendritic,naked,narrowly,nflorescence,nther,obscuring,often,one,orolla,outside,overlapping,pendulous,perfec,pericarp,plurifoliat,pore,poricidal,portion,prominent,protruding,puberulous,rachi,ray,ruit,scar,scattered,sessile,side,sinus,slightly,small,smaller,smoot,smooth,somewhat,soon,sparsely,spreading,stripe,structure,stump,tangling,tearing,tertiary,thick,thin,tip,toward,trichome,ud,uneven,unit,vary,venation,visible,well-developed,white,wide,wider,ympodial,young	arrangement,bud,cayx,characteristic,colour,corrugation,ellipsoid,exertion,glabrousnes,growth,height,history,inflorescence,length,life,lobing,na,new,number,ovary,per,plant,seed,shape,texture,type
237	wfo-0001028528	invalid_json_followup	155	144	98	57	46	0.632	.5,0.9-1.2,1-2,1.1-1.2,1.8-2,2-4,2.5-3,3.5-4,3.5-6,3/4,4-6,6-7,8-9,?,absent,acute,age,anther,anthesi,apex,apical,attenuate,bark,basal,base,becoming,berry,bi-lobed,blackish,branch,branching,calyx,cm,conical,corolla,decurrent,dendritic,densely,diameter,elliptic,erect,except,exserted,filament,flattened,fork,fruiting,glabrous,globose,growth,immature,later,leaf,lobe,margin,minutely,mm,mucronate,narrowly,nodding,obovate,occasionally,outline,ovary,pair,pedicel,per,petiole,pitted,plurifoliate,pore,poricidal,pubescent,reddish-brown,revolute,round,secondary,shiny,short,shrub,slit-like,somewhat,sparsely,stem,stigma,strongly,style,surface,tapering,terminal,tip,trichome,tube,vein,violet,way,white,x	1.5,2-3,4-5,6-10,abaxial,acuminate,adaxial,adaxially,along,ba,coriaceous,denser,dichasia,eaf,edicel,eed,ew,flower,free,glabrat,glandular,impressed,inserted,leave,like,lobed,long,lower,m.,midvein,minute,nflorescence,older,papillo,pericarp,petal,planar,portion,prominent,pyramidal,ruit,scar,sleeve,stamen,ste,tall,thin,time,triangular,tub,ud,unit,wide,winged,woody,ympodial,young	'',[,``,arrangement,bud,characteristic,colour,corrugation,dichasial,distal,drying,exertion,form,fruit,glabrousnes,height,history,inflorescence,interjected,lateral,leaflet,length,life,lobing,midpoint,na,new,number,papillose,peduncle,plant,prickle,primary,pseudostipule,ray,seed,shape,size,texture,thicknes,type,value,variation,width,{,}
238	wfo-0001028529	success	164	139	92	72	47	0.561	.2,0.1,0.5,0.5-2,0.8-1.3,0.8-3.2,1,1-1.2,1-1.5,1.5,2.5-3,2/3,5-6,6-9,8-14,acuminate,anther,apex,attenuate,bark,base,berry,bluish,brown,bud,calyx,capitate,cast,cm,corolla,dark,decurrent,dia,distal,erect,exserted,filament,fruiting,furcate,glabrous,globose,green,hyaline,internodal,lanceolate,lateral,leaf,less,lobe,lobed,long,main,metallic,minutely,mm,narrowly,nearly,oblanceolate,occasionally,opposite,ovary,ovoid-reniform,pair,papillose,pedicel,petiole,pitted,shape,shaped,shrub,simple,size,slender,slightly,smooth,somewhat,soon,stem,stigma,straight,style,surface,tapering,tear-drop,tube,vein,way,white,winged,woody,x,yellowish	0.8-3,3-40-flowered,3-5,7-8,across,acute,age,anthesi,apart,apiculate,becoming,beginning,beneath,close,cork,course,deflexe,deltoid,eaf,edicel,eed,ellipsoi,elliptic,evenly,exfoliating,flower,free,growing,heterostylous,hrub,immature,indistinct,inflorescenc,lenticellat,linear,lon,lower,major,middle,minor,minute,much,nflorescence,older,one,paler,papillae,papillo,planar,pore,poricidal,portion,present,prominent,range,reflexed,river,ruit,scar,scattered,short,small,spaced,species,subshrub,tall,tip,ud,umbonate,variable,widest,young	.5,2,alternate,appearance,arrangement,border,branch,characteristic,colour,corrugation,deflexed,diameter,drying,exertion,form,fruit,giving,glabrousnes,growth,height,history,inflorescence,interjected,leaflet,length,life,lobing,margin,midpoint,na,new,number,peduncle,per,perennial,plant,prickle,primary,pseudostipule,ray,seed,terminal,texture,thicknes,type,variation,width
239	wfo-0001028532	invalid_json_followup	186	148	100	86	48	0.538	0-19,0.2-1,1-1.6,1-1.7,1-2,1-3,1.3-8.7,1.4-1.6,15-36,17-42,2-8,2.2-4.2,3-10,3.3-4.4,3.9-5,4-7,5-9,6.5-9.2,7.5-15.2,acuminate,acute,anther,apex,apparently,attenuate,axe,axillary,base,berry,brownish,bud,cell,chartaceous,clavate,cm,condition,corolla,covering,dark,deep,diameter,distal,drying,filament,flower,forked,fresh,fruit,generally,glabrous,globose,green,green-white,greenish,half,herb,interjected,lanceolate,lateral,leaf,leaflet,lobe,long,make,medium,mm,mottled,mucilaginous,odd-pinnate,ovate,ovate-lanceolate,ovoid,pedicel,peduncle,perfect,petiole,petiolulate,plant,purple,ripe,rounded,seed,size,sometimes,spot,stigma,style,subtending,terminal,testal,thick,throughout,tube,unwinged,usually,wall,wet,white,whitish,x	1-5,2-3,2-6,3-5,3-7,5-merou,5.5-15,abaxiall,abaxially,acumen,adaxially,ag,along,alyx,apart,arranged,articulated,asymmetric,basiscopic,bead,blade,capitat,connivent,decreasing,digestion,dorsally,eaf,edge,eed,enzyme,erec,exceeding,flat,folded,geminat,glabrou,hair-like,homostylous,honeycomb-shaped,larger,lengthening,like,linear,living,lower,middl,moniliform,multiple,necklace,nflorescence,orbicular,orolla,pair,pentagonal,plurifoliate,pore,poricidal,removed,rotate,ruit,second,sessile,seudostipule,side,slightly,slit,spaced,specimen,stamen,stolon,straight,subequal,symmetric,tall,tamen,tem,tip,tissue,toward,tri-,tuber,typically,unit,vary,yellow,ympodial	'',[,\u201chair-like\u201d,``,appearance,arrangement,bark,branch,calyx,capitate,characteristic,colour,corrugation,exertion,form,fruiting,giving,glabrousnes,growth,height,history,inflorescence,length,life,lobing,margin,midpoint,na,new,number,ovary,per,prickle,primary,pseudostipule,ray,shape,stem,surface,texture,thicknes,type,value,variation,vein,width,{,}
240	wfo-0001028547	success	224	165	129	95	36	0.576	-13,-3,-6,.2,.5,.7,.8,/5,0,0-30,0-5,0.1-0.2,0.2-0.35,0.5-,1-2.5,1-5,1.2-1.4,1.5-2.5,1.7-2,2-1.5,2-4,2.5-2.8,2.8-3.2,3-5,3.5-4.5,4-5,7-10,absent,acute,anther,apart,apex,apically,apparently,appearing,articulated,bark,base,berry,branched,bright,calyx,cell,cm,conical,cream,cuneate,curved,dark,deltate,densely,diameter,dull,elongate,entire,erect,filament,flattened,flattened-reniform,fruit,glabrous,green,inflorescence,lateral,leaf,length,lobe,lobed,long,long-acuminate,margin,marking,maturity,mauve,midpoint,mm,moderately,narrow-deltate,oblong,often,orange,orange-brown,outline,ovate,pair,pale,pedicel,peduncle,per,petiole,pit,poricidal,prickle,prickly,primary,purple,raised,ray,red,reddish,reflexed,scandent,shallowly,shrub,simple,small,smooth,sometimes,somewhat,spaced,spherical,spreading,stellate-pubescent,stem,straight,style,surface,tapering,terminal,tip,truncate,tube,vein,villous,way,wide,yellow,yellow-orange,young	-1/2,/2,0-1,0-10,0-15,0-2,0.05-0.15,0.15,0.3-0.4,0.7-1,0.8-1,1-2,1-4,1/3,1/5-1/4,10-12,2-2.5,2-6,4-6,5-merous,6-8,7-9,abaxial,abaxially,adaxial,alyx,apar,ape,blade,branching,bulbous,chartaceous,connivent,discolorous,distance,drying,eaf,eed,elongating,equal,extending,faint,flower,free,fruiting,gently,glabrescent,glabrou,gray-brow,infructescence,lon,long-styled,longer,lower,mature,midvein,nflorescence,occasionally,older,one,open,orolla,oung,pendulous,perfect,pericarp,plurifoliat,porrect,portion,prickl,rounded,ruit,scar,sessile,short-styled,side,slender,stalk,stalked,staminate,stellate,subsessile,tamen,terete,tertiary,thin-acuminat,time,trichome,unit,usually,vary,venation,woody,yellow-green,ympodial	-8,appearance,arrangement,border,branch,characteristic,colour,corolla,distal,exertion,form,giving,glabrousnes,gray-brown,growth,height,history,interjected,leaflet,life,lobing,na,new,number,ovary,plant,pseudostipule,seed,shape,size,texture,thicknes,thin-acuminate,type,variation,width
241	wfo-0001028587	success	178	119	82	96	37	0.461	.5,.75,0,0.3-1,0.5-1,0.8-1.6,0.8-1.8,1-1.3,1-4,2.1-6.9,2.5,6-8,6.5-17.7,abruptly,acuminate,acute,anther,anthesi,apex,bark,base,berry,brown,calyx,cm,corolla,dia,distal,drying,ellipsoid,filament,fruit,fruiting,geminate,glabrous,globose,green,greenish-white,impressed,lateral,leaf,length,lobe,long,minutely,mm,narrowing,nearly,obe,obovate,obovoid,ovary,ovate,ovoid-reniform,papillose,pedicel,per,persistent,petiole,pitted,poricidal,puberulent,pubescent,reflexed,seed,shrub,simple,slender,stem,stigma,style,subumbellate,surface,terminal,tip,triangular,tube,type,umbonate,vein,white,x	.4,0.3,0.5,0.7-1.2,0.8-2.9,1-1.5,1-2,1.3-5.1,1/4,2-5,3-8,8-10,8-10-flowered,accrescent,across,baseflower,becoming,ca,chartaceou,closely,coat,cracking,cup,deflexed,degree,densely,different,difoliate,eaf,edicel,eed,erect,flower,forming,free,geminat,keeled,lamina,layer,like,lobed,lon,long-styled,lower,main,major,middle,midrib,minor,minute,nflorescence,occasionally,often,older,open,opposite,outer,overlappin,pair,paler,papillo,peeling,pore,portion,pubescence,pubesent,ruit,scar,scattered,short,slightly,slit-like,spaced,sparsely,stiff,straight,straw-colored,tall,thickened,thin,transversel,trichome,two,ud,unicellular,uniseriate,unit,upon,upper,usually,variable,wide,widest,woody,ympodial,young	appearance,arrangement,border,branch,bud,characteristic,colour,corrugation,diameter,exertion,form,giving,glabrousnes,growth,height,history,inflorescence,leaflet,life,lobing,margin,midpoint,na,new,number,peduncle,perennial,plant,prickle,primary,ray,shape,size,texture,thicknes,variation,width
242	wfo-0001028594	success	142	126	98	44	28	0.69	0-100,0.3-1.0,0.8-1.8,1-1.2,1-1.3,1-1.5,1-2,1-3,1.5-9,12,12-14,2,3-4,3-6,3-9,6-20,6-7,acuminate,acute,anther,apex,axil,axillary,base,bearing,becoming,berry,black,bottle-shaped,calyx,cm,conical,corolla,densely,diameter,drying,ellipsoid,elliptic,especially,exserted,filament,flattened-reniform,flower,fruit,fruiting,glabrous,globose,green,hair-like,herb,immature,inflorescence,lax,leaf,length,long,margin,maturity,minute,minutely,mm,obtuse,open,orange-brown,ovary,ovate,pair,pedicel,pendent,per,petiole,primary,projection,pubescent,purple,quit,rectangular,reddish,regular,rounded,scar,simple,slightly,soft,somewhat,sparsely,spreading,stigma,strongly,style,surface,time,trichome,tube,uniseriate,vein,violet,x	.5,5-6,abaxially,adaxially,along,anthesi,capitat,cell,climbing,denser,eaf,edicel,eed,epidermal,floo,forest,free,glabrat,inflorescenc,like,lobe,lon,lower,nflorescence,noddin,often,papillate,planar,portion,reflexed,rest,ruit,scattered,side,smooth,strait,tem,tip,trailing,tub,ud,unifoliat,unit,ympodial	arrangement,bark,branch,bud,capitate,characteristic,colour,corrugation,exertion,form,glabrousnes,growth,height,history,life,lobing,na,new,number,peduncle,perennial,plant,seed,shape,size,stem,texture,type
243	wfo-0001028660	success	204	138	97	107	41	0.475	0.2-1.1,0.3-1.1,0.5-2.8,0.5-5.5,0.7-4.2,0.8-1,0.9-2.5,1-2,1.5-2.8,1.5-4,1.5-7.6,2-11,2-6,3-30,3-7,3.8-13,4-6,5-8,7-10,absent,acute,anther,apex,articulated,axillary,base,berry,blue,broadly,brownish,bud,chartaceous,ciliate,clavate,cm,condition,corolla,decurrent,densely,diameter,distal,drying,elliptic,entirely,filament,forked,fresh,fruit,generally,glabrous,globose,green,greenish,hair,half,herb,honeycomb-shaped,interjected,lanceolate,lateral,leaflet,linear,lobe,long,margin,membranous,mm,narrowly,oblique,obtuse,odd-pinnate,ovoid,pedicel,peduncle,petiole,plant,pubescent,purple,ripe,scabrous,seed,short,size,sparsely,stem,stigma,style,subtending,terminal,tinged,tube,typically,unwinged,usually,white,whitish,x	0-5,0.1-0.3,1-10,2-5,2-9,20,3-5,3-9,5-merou,6,abaxially,acumen,adaxially,ag,along,alyx,apart,apparently,attenuate,axe,blade,borne,capitat,cell,connivent,covering,decumbent,digestion,dorsally,dot,eaf,edge,eed,end,enzyme,erec,especially,exceeding,except,flat,flower,folded,geminat,glabrou,greatly,green-white,hair-like,homostylous,lengthening,less,like,living,lower,make,middl,midrib,minutely,mucilaginous,nflorescence,often,orbicular,orolla,ovate,pair,pentagonal,perfect,petiolulate,petiolule,plurifoliate,pore,poricidal,proximal,puberulent,rarely,reduced,removed,rotate,ruit,scattered,sessile,seudostipule,singly,slit,spaced,specimen,stamen,ste,stolo,straight,subequal,substellate,sunny,tall,tamen,tem,testal,thick,throughout,tip,tri-,tuber,unit,vary,wall,wet,yellow,ympodial	appearance,arrangement,bark,border,branch,calyx,capitate,characteristic,colour,corrugation,exertion,form,giving,glabrousnes,growth,height,history,inflorescence,leaf,length,life,lobing,middle,midpoint,na,new,number,ovary,per,prickle,primary,pseudostipule,ray,shape,surface,texture,thicknes,type,variation,vein,width
244	wfo-0001028667	success	129	128	100	29	28	0.775	-2.6,.5,0.4-0.7,0.7-4,1-1.5,1-2-1.5,1-4.5,1-6,1.3-2,3,3-11,5,5-20,8-10,acute,aid,anthesi,apex,appearing,around,articulated,axillary,base,berry,branch,branched,calyx,cell,climbing,clustered,cm,completely,conical,corolla,creamy,curling,deciduous,diameter,dry,ellipsoid,elliptic,entire,exfoliating,exserted,flattened,flower,fruiting,glabrous,growth,inflorescence,irregularly,leaf,like,long,margin,midrib,minutely,mm,narrowly,new,occasionally,other,outer,pale,pedicel,peduncle,per,petiole,pitted,primary,reniform,revolute,scar,shiny,shoot,short,simple,sleeve,slender,slightly,small,soon,spaced,stem,straw-colored,strongly,support,surface,terminal,tip,twice,twining,vein,vine,visible,white,woody,wrinkling,x,yellow	5-merou,alyx,apar,ark,climbin,coriaceous,discolorous,eaf,eed,exfoliatin,fide,fragrant,lobe,lower,mentz,nflorescence,older,orolla,papilla,papillat,pendan,perfect,plurifoliat,tem,triangular,tube,ud,unit,ympodial	apart,arrangement,bark,bud,characteristic,colour,corrugation,drying,exertion,exfoliation,form,fruit,glabrousnes,height,history,length,life,lobing,na,number,papillae,pendant,plant,seed,shape,size,texture,type
245	wfo-0001028688	success	137	107	60	77	47	0.438	0.4-1,0.5,0.5-1,0.9-1,1-5,1.1-1.2,1.4-2.8,2-3,5-11,5-6,acuminate,acute,anther,apex,bark,base,branch,calyx,clavate,cm,corolla,deciduous,elliptic,exserted,filament,furcate,glabrous,globose,lanceolate,leaf,lobe,lobed,mm,near,nearly,occasionally,opposite,ovary,overtopping,papillose,pedicel,petiole,pilose,reddish-brown,shaped,shoot,shrub,size,soon,stem,stigma,style,tapering,tear-drop,terminal,tip,tube,vein,white,x	.5,0.5-0.75,0.5-1.5,1-1.5,1-1.8,1-3,2.2-4.8,across,along,anthesi,apar,area,beneath,bi-cellular,curl-tipped,decreasing,deflexed,deltoid,densely,densest,dia,differing,difoliate,eaf,edicel,eed,exfoliatin,free,geminat,golden,interpetalar,irregularly,know,known,like,lon,long,lower,major,markedly,membraneous,middle,minor,minutely,nflorescence,often,older,paler,planar,pore,poricidal,portion,proximal,pubescent,ruit,scar,shiny,sinus,slender,slightly,spaced,sparsely,straight,styl,tall,thickened,thin,trichome,tub,ud,uniseriate,unit,usually,wide,widest,ympodial,young	2.5,appearance,arrangement,border,bud,characteristic,colour,corrugation,diameter,distal,drying,exertion,form,fruit,fruiting,giving,glabrousnes,growth,height,history,inflorescence,interjected,lateral,leaflet,length,life,lobing,margin,midpoint,na,new,number,peduncle,per,plant,prickle,primary,pseudostipule,ray,seed,shape,surface,texture,thicknes,type,variation,width
246	wfo-0001028698	success	166	114	67	99	47	0.404	0.3-0.75,1-2,1-4,1-9.8,1.9-4,13-25,2-10,3-5,4-14,5-15,5-6,6-13,8-10,9-35,acuminate,acute,apex,base,branched,broadly,calyx,cm,conical,corolla,cyme,dark,diameter,dichasial,dichasially,distal,ebracteate,ellipsoid,elliptical,filament,green,green-white,herbaceous,interjected,lateral,leaf,leaflet,light,lobe,medium,mm,monochasial,mucilaginous,oblique,odd-pinnate,ovate,ovoid,pedicel,peduncle,perennial,petiole,plant,puberulent,pubescent,seed,size,stigma,strigose,style,terminal,throughout,violet,white	0-1.,1.8-5,2-3,2-4,3-17,3-6-foliat,3.5,5-8,6,6-27,abaxiall,abaxially,acumen,adaxially,apical,apically,articulate,cell,commonly,connate,covering,cuneate,darker,decurrent,dehiscent,digestion,diminishing,dorsally,dot,eaf,edge,eed,emoval,enzyme,equal,exceeding,first,flat,flower,folded,forked,generally,globo,gradually,hair-like,half,honeycomb,introrse,living,lon,long,long-attenuate,lower,lunat,make,maturing,minute,nflorescence,nther,often,orolla,pair,pattern,pentagonal,perfect,petiolule,plan,poricidally,proximal,rachi,raised,rarely,reveal,rotate,ruit,sessile,seudostipule,short,slit,smooth,specimen,stamen,straight,tal,tem,testal,thick,toward,tuber-bearing,two,typically,unit,usually,vary,wall,wide,yellow,ympodial,Â¼	0-10,anther,appearance,arrangement,bark,border,branch,bud,characteristic,colour,corrugation,drying,exertion,form,fruit,fruiting,giving,glabrousnes,globose,growth,height,history,inflorescence,length,life,lobing,margin,midpoint,na,new,number,ovary,per,prickle,primary,pseudostipule,ray,shape,stem,surface,texture,thicknes,tube,type,variation,vein,width
247	wfo-0001028716	success	145	107	75	70	32	0.517	.2,.5,0.5,0.6-1.9,1-2,10-40-flowered,11-16.4,2.5-8,3.6-8.8,7-8,8-9,9-10,acuminate,anther,anthesi,apex,bark,base,beneath,bi-cellular,brown,calyx,cm,corolla,cuneate,dark,decurrent,dia,ellipsoid,except,filament,filiform,fruit,glabrous,glandular,hirsute,lateral,leaf,less,like,long,main,minutely,mm,nearly,node,often,ovary,ovate,pair,papillose,pedicel,petiole,pubescent,reflexed,shape,shaped,shrub,simple,size,slightly,sparsely,stem,straight,style,tear-drop,triangular,trichome,truncate,tube,uniseriate,vein,white,widening,x	0.75,1.9-5.5,2-4,2.2-7.9,5-6,across,anisophyllou,apart,appearing,asymmetric,ba,becoming,beginning,branched,deflexed,differing,difoliate,eaf,edicel,eed,elliptic,evenly,fertilization,fifth,free,geminate,inflorescenc,intermediate,know,known,lengthening,lenticellat,lobe,lobed,lon,long-triangular,lower,major,markedly,middle,minor,much,nflorescence,older,one,opposite,orbicular,pointed,pore,poricidal,portion,prominent,proximal,puberulent,raised,remaining,rounded,ruit,scar,spaced,stigm,strongly,tall,tip,two,ud,unit,widest,ympodial,young	alternate,arrangement,bud,characteristic,colour,corrugation,diameter,drying,exertion,form,fruiting,growth,height,history,inflorescence,length,lenticellate,life,lobing,margin,na,number,peduncle,per,perennial,plant,primary,seed,stigma,surface,texture,type
248	wfo-0001028723	success	211	137	95	116	42	0.45	-1.5,0.8-1,0Â°,1-1.8,1-2.2,1-2.5,10-16,2-2.5,2-2.7,3.5-4,4-5,5,5-6,5-7,acute,almost,anther,apex,apically,bark,base,brachyblast,branch,branched,branching,broadly,calyx,capitate,clustered,cm,conical,corolla,dark,dendritic,diameter,dilated,drying,elliptic,entire,except,filament,flower,glabrous,gradual,green,leaf,length,liana,like,lobe,long,long-attenuate,margin,membranous,midvein,minutely,mm,mostly,obconical,oblong,obovate,occasional,orange-brown,pair,pedicel,peduncle,petiole,primary,pubescent,ray,ridged,short,shrub,side,simple,smooth,sparsely,spreading,stem,stigma,style,surface,terminal,tip,transition,trichome,tube,unarmed,unevenly,vein,white,widely,wrinkled,x,youngest	.3,.5,0-0.5,0.2,0.8-2,1,1-1.5,1/3-1/2,1/5-1/3,10-15,2-4,2.5,3-4,4,abaxial,abaxially,adaxially,age,alternate,alyx,another,anthesi,apar,apice,apparently,articulated,becoming,brown,clearly,common,concolorous,curved,decurrent,delineated,deltoid,densely,density,developed,divided,domatia,dorsifixed,eaf,eed,ellipsoi,equal,ey,faint,fine,flat,flexuous,formed,free,frequent,increasing,inner,junction,know,known,lengthening,less,lobed,longitudinally,lower,m.,main,middle,much,multiply,naked,narrowly,nflorescence,nther,obtuse,one,orolla,outer,ovate,overlapping,pale,papillo,perfec,plurifoliat,poorly,pore,poricidal,portion,prominent,protruding,rachi,raised,region,regular,ruit,scar,separated,sinus,slender,small,smaller,stump,surrounding,tearing,tertiary,tissu,toward,tuft,ud,uneven,unit,vary,venation,visible,wide,yellow,ympodial,young	appearance,arrangement,border,bud,characteristic,colour,corrugation,distal,ellipsoid,exertion,form,fruit,fruiting,giving,glabrousnes,growth,height,history,inflorescence,interjected,lateral,leaflet,life,lobing,midpoint,na,new,number,ovary,papillose,per,plant,prickle,pseudostipule,seed,shape,size,texture,thicknes,type,variation,width
249	wfo-0001028736	invalid_json_followup	180	158	112	68	46	0.622	0.5,0.5-1,0.5-1.5,0.5-1mm,0.5-2,1,1-1.5,1-2,1-3,10-15,2-4,2-5,3-5,3-6,3-8,3.5-5,4-12,4-6,40-70,5-10,5-15,6-13x3-8,abaxially,absent,acute,adaxially,anther,apex,armed,attenuate,base,berry,brown,calyx,chartaceous,cm,connivent,created,cylindrical,dark,decurrent,densely,diameter,discolorous,either,extra-axillary,filament,filiform,flower,fruit,fruiting,glabrous,globose,green,hair,immature,leaf,length,light,like,lobe,many,mature,midpoint,midvein,mm,moderately,mottled,narrowly,nearly,netlike,obtuse,onto,orange,pedicel,peduncle,per,petiole,pit,porrect-stellate,prickle,pubescent,raised,ray,recurved,red,reniform,rhombic,ridge,roselike,shrub,side,simple,slightly,small,sparsely,stellate,stem,stigma,style,surface,tapering,thin-skinned,triangular,tube,unbranched,unlobed,vein,white,x,yellow,yellow-white	0.2-0.4,1.5,1.5-3,1/6,2-7,4-9,5-merou,6-8,accrescent,adaxiall,alyx,apar,apical,apparently,axe,beyond,blade,contiguous,cordate,cut,difoliate,directed,eaf,eed,exserted,flattened,frui,geminate,glabrou,glandular,gree,introsel,less,lobed,long,lower,m.,major,midrib,multicellular,multiseriate,nflorescence,occasional,occasionally,orolla,pair,perfect,pore,purple,rachi,ruit,scanden,sinus,spaced,stalk,stamen,ste,tamen,tem,unarmed,unequa,unicellular,uniseriate,unit,vary,way,wide,ympodial	'',[,``,arrangement,bark,branch,bud,characteristic,colour,corolla,corrugation,distal,drying,exertion,form,glabrousnes,growth,height,history,inflorescence,interjected,lateral,leaflet,life,lobing,margin,na,new,number,ovary,perennial,plant,primary,pseudostipule,seed,shape,size,terminal,texture,thicknes,type,value,variation,width,{,}
250	wfo-0001028737	success	151	116	68	83	48	0.45	0.2-0.5,0.7-2,1,1-2.5,1-4,1-6,1.5-3.5,10,12-14,16-30,2-5,2.8-3.5,3-5,4-6.5,4-9,6,7-15,acute,apex,apiculate,articulate,base,branched,calyx,caudate,cm,corolla,cyme,diameter,dichasial,dichasially,distal,ebracteate,elliptic-lanceolate,filament,glabrescent,glandular,globose,green,green-white,herbaceous,interjected,lanceolate,lateral,leaf,leaflet,lobe,long,mm,monochasial,mucilaginous,oblique,oblong,odd-pinnate,ovoid,pedicel,peduncle,perennial,petiole,plant,seed,size,stigma,style,terminal,throughout,tuber-bearing,wide	2-3,3-4,3-6-foliat,4-10,5-6,abaxially,absen,acumen,acuminate,adaxially,apical,apically,attenuate,cell,connate,covering,decurrent,dehiscent,digestion,diminishing,dorsally,eaf,edge,eed,emoval,enzyme,exceeding,flat,flower,folded,forked,generally,globo,gradually,hair-like,half,honeycomb,introrse,larger,living,lon,lower,make,maturing,nflorescence,nther,often,orolla,pair,pattern,perfect,pinnatifi,plan,poricidally,proximal,rachi,reveal,ruit,second,sessile,seudostipule,short,slit,specimen,stamen,stellate,straight,strongly,tal,tem,testal,thick,throughou,toward,typically,unit,vary,wall,whit,without,yellow,ympodial,Â¼	absent,anther,appearance,arrangement,bark,border,branch,bud,characteristic,colour,corrugation,drying,exertion,form,fruit,fruiting,giving,glabrousnes,growth,height,history,inflorescence,length,life,lobing,margin,midpoint,na,new,number,ovary,per,prickle,primary,pseudostipule,ray,shape,stem,surface,texture,thicknes,tube,type,variation,vein,wet,white,width
251	wfo-0001028777	invalid_json_followup	205	153	110	95	43	0.537	-2.5,-4,.5,.9,0-2,0-30,0.1-0.2,0.4-0.8,0.5-1.3,0.6-1,0.7-1.2,0.7-1.3,0.8-1,0.8-2.2,1-2.5,1.5-3,1.5-4,1.8-2.5,2-,2.5,3,3/4-4/5,4.5-8,8-15,abaxially,acute,anther,apex,apically,articulated,attenuate,bark,base,berry,branched,calyx,chartaceous,cm,concolorous,dark,deltate,diameter,discolorous,drying,entire,erect,filament,flattened-reniform,fruit,fruiting,glabrescent,glabrous,green,green-brown,inflorescence,leaf,length,lobed,long,margin,marking,maturity,mauve,midpoint,mm,moderately,obovate,orange,orange-brown,ovate,pair,pale,pedicel,peduncle,per,petiole,poricidal,primary,ray,red-brown,reflexed,retuse,rounded,shoot,short,shrub,simple,small,sometimes,sparsely,spherical,stellate-pubescent,stem,style,surface,tapering,terete,terminal,tip,tree,truncate,tube,unarmed,vein,way,white,whole,wide,yellow-green,young	-10,-12,-3,.8,0.1-0.3,0.2,1,1-2,1-3,1.5,1/4,1/4-1/2,2.5-3,2.5-5,3.5-5,4-5-merous,6-10,7-11,8,acuminat,alyx,ame,apar,ape,blade,briefly,c.,connivent,curved,deciduou,eaf,eed,elongating,equal,faint,flower,free,glabrescen,infructescence,lengt,less,lobe,long-styled,longer,lower,mature,minute,multangulate,narrow-deltate,nflorescence,occasionally,older,one,open,orolla,oung,perfect,pericarp,plurifoliat,porrect,portion,present,recurved,reflexe,ruit,scar,sessile,short-styled,shorte,shorter,smooth,somewhat,soon,spaced,spreading,stalk,stalked,staminate,stellate,stout,strongly,tamen,tertiary,time,trichome,unarme,unit,usually,variously,vary,venation,visible,wider,woody,ympodial	'',[,``,acuminate,arrangement,branch,bud,characteristic,colour,corolla,corrugation,distal,exertion,form,glabrousnes,growth,height,history,interjected,lateral,leaflet,life,lobing,na,new,number,ovary,perennial,plant,prickle,pseudostipule,seed,shape,size,stigma,texture,thicknes,type,value,variation,width,{,}
252	wfo-0001028791	invalid_json_followup	257	162	121	136	41	0.471	+,-9,0-6,0.05-0.2,0.2-0.3,0.3-0.6,0.4-0.6,0.4-0.65,0.6-0.8,0.8-1.3,1-1.5,1.5-2,1.7-2.1,1.8-3.3,10,2-3,2-7,2-locular,2.8-3.0,4-5+,5-15,5-22,9-30,9-35,absent,acuminate,acute,anther,anthesi,apex,articulated,basal,base,beneath,branched,breaking,broadly,brown,calyx,capitate,cell,clambering,cm,conical,corolla,dark,deciduous,deltate,densely,developed,diameter,dichotomously,elliptic,entire,exserted,filament,fruit,fruiting,glabrous,globose,green,hair-like,half,halfway,imparipinnate,interjected,interrupted,lateral,leaf,leaflet,less,liana,lobe,long,many,margin,middle,minutely,mm,near,oblique,obovate,occasionally,outgrowth,ovary,pale,paler,pedicel,peduncle,per,petiole,plant,poorly,present,primary,pseudostipule,pubescent,scandent,seed,slightly,somewhat,sparsely,stellate,stem,stigma,style,surface,terminal,testa,thick,thickened,time,truncate,tube,usually,vein,wall,white,wide,woody,yellow	-0.6,-1.5,.5,0.05,0.2-0.4,0.2-0.8,0.25-0.3,0.3-0.4,0.3-0.5,0.3-0.8,0.4-0.5,0.4-1.1,0.45-0.55,0.5,0.6-0.9,0.7-1.5,0.8-1,1-2,1-2-celled,1-3,1-3-celled,1-celled,1.5-,1.6-4.5,100,2-3.5,2-7-celled,2.5-4.5,20-to,3-,3-4,4-11.5,4-15,4-celled,5-,5-10,5-plurifoliate,50-80,8-10-celled,abaxially,absen,abundant,adaxially,addition,ag,along,apical,appearance,appendage,articulation,basiscopically,berr,border,bullate,colo.,column,consistently,darker,densest,eaf,ebracteate,edicel,eed,eglandular,elongating,enlarged,even,extended,flower,free,give,glabrescent,glandular,gree,grow,growing,head,internode,lamina,large,leaving,like,lon,lower,midvein,mixture,much,multicellular,nflorescence,often,pair,papillate,petiolule,protuberance,pubescence,rachi,reflexed,rest,rough,round,ruit,sandpapery,secondary,sessile,short,shorter,silky,simple,single,small,smaller,sometimes,sparse,spreading,stamen,staminal,sterile,stiff,straight,tal,tem,tertiary,tip,touch,transparent,trichome,ud,unicellular,uniseriate,unit,upper,vegetation,vine,winged,ympodial,â1-2-celled	'',2,[,``,arrangement,bark,branch,bud,characteristic,colour,corrugation,dense,distal,drying,exertion,form,glabrousnes,growth,height,history,inflorescence,length,life,lobing,midpoint,na,new,number,perennial,prickle,ray,shape,size,texture,thicknes,type,value,variation,width,{,}
253	wfo-0001028798	invalid_json_followup	214	153	107	107	46	0.5	0-1,0.2-0.4,0.9-1.2,1-4.5,1.1-2,1.5-1.8,1/2-2/3,10,15-19,2-6,2-7,2/3,3-4,3-5,3.3-5.6,5-8,6-10,7-8,8-18,acuminate,acute,anther,apex,attenuate,base,becoming,berry,blunt-tipped,branch,bud,calyx,chartaceous,cm,conical,continued,corolla,cylindrical,decurrent,densely,diameter,distal,dm,due,entire,exserted,filament,flower,fruit,fruiting,glabrous,granular,green,greenish,growth,lanceolate,lateral,leaf,length,lined,lobe,lobed,long,margin,midvein,mm,nearly,oblanceolate,oblong,obovate,orbicular,ovate-lanceolate,pale,pedicel,peduncle,persistently,petiole,probably,pseudo-terminal,rather,ray,ripe,rotate-stellate,rough,rough-granular,short,shrub,side,simple,slightly,sparingly,stamen,stellate-pubescent,stem,stigma,style,subcampanulate,subcoriaceous,subglobose,sulcate,tomentose,tube,unarmed,vein,way,x,yellow,yellowish	.5-5,0-60,0.5-2,1-3,1-6,1/20,2-3,2-3.75,2.4-4.4,2.5-3.5,2.6-4,3.8-4.2,4-5.4,5.25-7.5,6-8,8.5-13,abaxially,accrescent,adaxially,ag,anthesi,apart,apical-lateral,apparently,articulated,axe,axillary,ba,blade,boat-shaped,branched,capitat,curved,dehiscing,downward,eaf,echinoi,echinoid,eed,extend,fleshy,free,granular-tomentose,hair,hal,high,included,inserted,introrse,irregularly,lacking,large,less,longitudinal,lower,m.,main,many,minutely,mixed,multangulat,multangulate,nflorescence,oblanceolat,obscured,obtuse,often,orolla,oung,overlapping,perfect,persistent,plurifoliate,pore,porrect-stellate,present,prominent,pubescent,quite,rachi,ruit,semi-ovate,sessile,short-stalked,slit,small,somewhat,spaced,splitting,stalked,strongly,suture,tamen,thick,time,tip,tomentu,tomentum,toward,translucent,unarme,unit,unknow,vary,velutinous,wide,ympodial	'',[,``,appearance,arrangement,bark,capitate,characteristic,colour,corrugation,drying,exertion,form,giving,glabrousnes,height,history,inflorescence,interjected,leaflet,life,lobing,midpoint,na,new,number,ovary,per,perennial,plant,prickle,primary,pseudostipule,seed,shape,size,surface,terminal,texture,thicknes,type,value,variation,width,{,}
254	wfo-0001028815	invalid_json_followup	196	148	104	92	44	0.531	0.4-0.8,0.5-1,1-2,1-3.5,1-4,1-5,14-28,2-4,2-9,2.5-6.5,22-35,3-4,3-5,3-7,6-10,6-8,7-16,abaxially,acumen,acute,adaxially,anther,apex,axillary,base,berry,broadly,brownish,bud,chartaceous,cm,condition,corolla,cuneate,dark,diameter,digestion,distal,drying,elliptic,elliptic-lanceolate,enzyme,filament,forked,fresh,fruit,generally,glabrous,globose,green,greenish,half,herb,honeycomb-shaped,interjected,lanceolate,lateral,leaflet,lilac-purple,lobe,long,margin,medium,membranous,mm,narrowly,obtuse,odd-pinnate,ovate,ovoid,papillose,pedicel,peduncle,petiole,plant,pointed,pubescent,purple,red-purple,removed,ripe,rotate,rounded,rugose,seed,size,sparsely,splotched,stem,stigma,straight,style,subtending,terminal,terminated,tinged,triangular-lanceolate,tube,unwinged,usually,wall,whitish,winged,x	1-10,10-15,2-4.5,4-10,5-6,5-7,5-merou,ag,along,alyx,apart,apparently,articulated,articulation,auriculate,axe,basiscopic,blade,capitat,cell,ciliate,connivent,covering,decreasing,decurrent,developing,distinct,dorsally,eaf,edge,eed,especially,exceeding,flat,flower,folded,geminat,glabrou,green-white,hair,hair-like,hal,high,homostylous,indistinct,lengthening,like,living,lower,make,midrib,minutely,mucilaginous,nflorescence,onto,orolla,pair,perfect,petiolulate,plurifoliate,pore,poricidal,puberulent,purpl,rachi,ruit,semi-erec,semi-rosette,sessile,seudostipule,short,side,slightly,slit,spaced,specimen,stamen,ste,tall,tamen,tem,testal,thick,throughout,tip,tri-,unit,vary,wet,yellow,ympodial,young	'',[,``,arrangement,bark,branch,calyx,capitate,characteristic,colour,corrugation,exertion,form,fruiting,glabrousnes,growth,height,history,inflorescence,leaf,length,life,lobing,midpoint,na,new,number,ovary,per,prickle,primary,pseudostipule,ray,shape,surface,texture,thicknes,type,value,variation,vein,width,{,}
255	wfo-0001028876	success	127	97	75	52	22	0.591	.5,/4,0.4-1,0.5-2,1-2,1.5-2,2-2.3,3-5,4-5,5-6,abaxially,acute,adaxially,along,anther,apex,attenuate,bark,base,brown,calyx,capitate,cm,conical,corolla,dark,dendritic,densely,dia,difoliate,drying,ellipsoid,elliptic,filament,flower,glabrous,golden,internodal,leaf,like,lobed,long,midrib,mm,nodding,occasionally,opposite,pedicel,petiole,pubescent,reddish,rest,sagittate,shining,shrub,simple,slender,small,sparsely,speciman,stem,stigma,style,subshrub,surface,tall,trichome,tube,type,uniseriate,unit,way,white,x,young	1.5-3,3-8,4-8,abaxial,anthesi,branched,closely,eaf,edicel,eed,free,geminat,glabrat,hroughout,included,inflorescenc,know,known,lamina,lateral,leave,lobe,long-triangular,lower,main,middle,minutely,nflorescence,older,ovary,overlappin,pair,papillae,papillo,papillose,planar,pore,poricidal,portion,rounded,ruti,scar,shaped,spaced,straight,tear-drop,tip,tub,ud,vein,widest,ympodial	arrangement,bud,characteristic,colour,diameter,form,fruit,geminate,growth,height,history,inflorescence,length,life,lobing,na,plant,seed,shape,size,sympodial,texture
256	wfo-0001028883	success	207	120	72	135	48	0.348	50,acute,almost,anther,apex,articulated,attenuate,base,berry,branch,brochidodromous,calyx,capitate,chartaceous,cm,completely,concolorous,coriaceous,dark,deltate,diameter,drying,dull,elliptic,entire,filament,flower,fruit,glabrous,globose,green,growth,herb,lateral,leaf,length,lobe,margin,mm,moderately,narrowly,new,notably,oblong,pedicel,peduncle,per,petiole,pubescent,reniform,ripe,seed,sessile,shiny,similar,simple,size,slightly,sparsely,stem,stigma,style,subopposite,subsessile,surface,trichome,undulate,uniseriate,vein,white,whitish,Ã	0.3â0.6,0.4â1.2,0.5â2,0.6,1,1.5â7,1â2,1â6,2,2â3,2â5,3â5,4,4â6,5,5-merou,6,6â10,6â12,abaxially,absent,accrescent,acuminate,adaxiall,adaxially,along,alyx,antrorse,antrorsely,apar,arched,ark,ascending,axi,becoming,blade,brow,capitat,cell,ciliate,circular,common,connivent,curved,cylindrical,cyme,decurrent,densely,differing,directed,eaf,eed,elliptic-ovate,emarginate,equal,erect,exfoliating,eye,flattened,frui,geminate,geniculat,glabrescent,glabrou,glandular,greenish,head,hilum,hollow,impressed,introrsely,less,light,like,long,longitudinal,lower,lying,membranaceous,midrib,minor,multicellular,naked,nflorescence,normally,obtuse,often,older,onto,opening,orolla,ovate-lanceolate,parallel,pendan,perfect,plurifoliate,pore,poricidal,present,primarily,prominent,pubescence,rachi,rarely,region,rounded,ruit,secondary,shap,shrub,single,single-celled,slit,small,sometimes,spaced,sparse,spreading,stalk,stellate,straight,subapical,swollen,tall,tamen,tem,unbranched,unit,vary,venation,visible,wide,woody,yellow,ympodial	0.5-2,1-2,1.5-7,2-3,2-5,3-5,4-6,6-10,6-12,appearance,arrangement,bark,border,bud,characteristic,colour,corolla,corrugation,distal,exertion,form,fruiting,giving,glabrousnes,height,history,inflorescence,interjected,leaflet,life,lobing,midpoint,na,number,ovary,plant,prickle,primary,pseudostipule,ray,shape,terminal,texture,thicknes,tube,type,variation,width
257	wfo-0001028885	success	214	145	120	94	25	0.561	-1,0.3-0.5,0.5-1,0.7-2,1-1.2,1-2,1-3,1.5-1.7,1.5-3.5,10-20,2-,2.3-2.5,2/3,3-5,3.5-8.5,7-8,7-9,9-11,?,acute,adaxially,along,anther,anthesi,apex,attenuate,basal,base,berry,black,blackish,branch,branched,brown,calyx,capitate,cm,corolla,cup-shaped,dark,decurrent,densely,diameter,drying,ellipsoid,elliptic,entire,erect,exserted,extending,filament,flower,fruiting,furcate,glabrescent,glabrous,globose,golden,gradually,groove,growth,height,immature,inflorescence,lamina,lanceolate,lateral,leaf,like,lobed,long,margin,midvein,minute,mm,mostly,multicellular,narrowing,narrowly,new,nodding,occasionally,pair,pedicel,peduncle,petiole,plant,primary,pubescent,purple,quarter,reddish,revolute,rhachi,ripe,scandent,shrub,simple,slender,slightly,sometimes,sparsely,stem,stigma,strongly,style,surface,terminal,third,time,trichome,tube,uniseriate,vein,vine,way,wide,winged,woody,Â¾	.5,0.5-5,1-1.5,2,2-2.5,2.5-3.5,3.5-4.5,4-5,5-merou,9-12,abaxial,adaxial,ag,alyx,apart,apiculate,apparently,archin,ark,articulated,broadly,cell,collapsing,connivent,dark-pigmented,deltate,dendriti,distal,dried,eaf,eed,fleshy,free,glabrou,glandular,groupe,ilament,inserted,irregularly,known,leaving,lengthening,less,live,lobe,loosely,lower,material,minutely,nflorescence,noddin,often,older,orolla,papillo,part,peg,perfect,pericarp,pigmentation,plurifoliat,pore,poricidal,portion,recorded,retaining,ruit,scar,scattered,shin,shiny,short,sleeve,slit,small,smaller,spaced,spheroidal,spreading,stellate,tangled,tem,thin,tip,twinin,ud,unit,upper,usually,vary,wall,weak,weak-walled,ympodial	arching,arrangement,bark,bud,characteristic,colour,corrugation,dendritic,exertion,form,fruit,glabrousnes,history,length,life,lobing,na,number,ovary,per,seed,shape,size,texture,type
258	wfo-0001028888	invalid_json_followup	207	153	107	100	46	0.517	0-3.5,0-7,0.15-0.5,1,1-1.5,1-2,1.5-4,10-25,12.5-25,2-6,2.3-5,2.3-7,2.5-3.3,3-4,3.6-12.5,3.8-8.3,4-25,4-7,5-7,6-11,8-11,8-13.5,acuminate,acute,anther,apex,apiculate,articulated,axillary,base,berry,brownish,bud,chartaceous,clavate,cm,condition,connivent,corolla,covered,diameter,distal,drying,filament,flower,forked,fresh,fruit,generally,glabrous,globose,green,green-white,greenish,hair,half,herb,interjected,lanceolate,lateral,leaflet,less,like,lobe,long,margin,membranous,middle,mm,mottled,mucilaginous,oblique,odd-pinnate,orbicular,ovate,ovoid,pedicel,peduncle,petiole,plant,pubescent,purple,ripe,rounded,seed,short,size,slightly,sparsely,stem,stigma,streak,style,subglabrous,subtending,terminal,throughout,tube,typically,unwinged,usually,violet,wet,white,whitish,wing,x	0-5,1-10,1-3,2-5,3-5,5-10,5-merou,abaxially,acumen,adaxially,ag,along,alyx,apart,apparently,axe,blade,broadly,capitat,cell,center,central,ciliate,covering,cuneate,digestion,dorsally,dot,eaf,edge,eed,elliptic,end,enzyme,erec,especially,exceeding,except,flat,folded,geminat,glabrou,glaucous,greatly,hair-like,hal,homostylous,honeycomb-shaped,lengthening,living,low,lower,make,midrib,minutely,nflorescence,often,one,orolla,pair,pentagonal,perfect,petiolulate,petiolule,placed,plurifoliate,pore,poricidal,proximal,puberulent,reduced,removed,ruit,scattered,sessile,seudostipule,slit,sometimes,spaced,specimen,stamen,ste,stolo,straight,subequal,substellate,tall,tamen,tem,testal,thick,tip,tri-,truncate,tuber,unit,vary,wall,yellow,ympodial	'',[,``,appearance,arrangement,bark,branch,calyx,capitate,characteristic,colour,corrugation,erect,exertion,form,giving,glabrousnes,growth,height,history,inflorescence,leaf,length,life,lobing,midpoint,na,new,number,ovary,per,prickle,primary,pseudostipule,ray,shape,surface,texture,thicknes,type,value,variation,vein,width,{,}
259	wfo-0001028920	invalid_json_followup	152	147	96	56	51	0.632	.5,0.2-1,0.5-1,0.8-1.1,1-1.2,1-1.5,1-2.4,1-3,2-2.5,2-7,3-15-flowered,3-3.5,6-15,6-6.5,abaxially,acuminate,acute,adaxially,anther,apex,arachnoid,arachnoid-pubescent,area,attenuate,bark,base,berry,broadly,brown,calyx,cm,congested,conical,corolla,dark,decurrent,deflexed,dia,difoliate,ellipsoid,elliptic,erect,exserted,filament,flower,fruiting,glabrate,glabrous,globose,green,later,lateral,leaf,lightly,lobe,lobed,long,long-styled,main,minutely,mm,nearly,obovate,obovoid,occasionally,ovary,ovoid-reniform,papillose,pedicel,petiole,pitted,pubescent,shape,shaped,short-styled,shrub,simple,size,small,sparsely,stem,stigma,strongly,style,surface,tapering,tear-drop,tip,tree,trichome,tube,unifoliate,vein,white,winged,x	.25,1.5-2,3-4,5-9,anthesi,axil,ba,brownish,closely,cucullate,deltate,dendritic,dense,densely,differing,eaf,edicel,eed,felty,fleshy,free,geminat,gray-brow,lon,lower,major,middle,minor,nflorescence,older,opposite,overlappin,pair,planar,pore,poricidal,portion,present,pubescence,ruit,scar,somewhat,soon,spaced,styl,tall,thick,tub,tuft,ud,uniseriate,unit,widest,woody,ympodial,young	'',[,``,appearance,arrangement,branch,bud,characteristic,colour,corrugation,diameter,distal,drying,exertion,form,fruit,geminate,giving,glabrousnes,gray-brown,growth,height,history,inflorescence,interjected,leaflet,length,life,lobing,margin,midpoint,na,new,number,peduncle,per,plant,prickle,primary,pseudostipule,ray,seed,terminal,texture,thicknes,type,value,variation,width,{,}
260	wfo-0001028929	invalid_json_followup	210	155	113	97	42	0.538	.5,.7,.9,/5,0-1,0-3,0.2-0.4,0.2-0.8,0.3-0.6,0.4-0.8,0.5-2,0.7-1,0.7-2,0.8-1,1-1.1,1.5-2.4,2-3,2-6,2.2-2.3,2.5-4,2.7-3,3-20,4-6,5-6,5-7.5,8-10,acicular,acute,anther,apart,apex,apically,apparently,articulated,bark,base,berry,branched,calyx,cell,chartaceous,cm,concolorous,cuneate,densely,diameter,discolorous,drying,dull,elliptic,erect,filament,flattened-reniform,fruit,fruiting,glabrous,inflorescence,lateral,leaf,length,lobe,lobed,long,margin,maturity,midpoint,minutely,mm,oblong,obovate,obtuse,orange-brown,outline,pair,pale,pedicel,peduncle,per,perpendicular,petiole,pit,poricidal,prickle,prickly,primary,raised,ray,red,red-brown,red-green,reticulate,shrub,simple,small,smooth,sometimes,spaced,spherical,stellate-pubescent,stem,style,surface,tapering,terete,tip,tube,unarmed,vein,way,white,wide,yellow,yellow-green	-2,-2/3,0,0-10,0-20,0.1,0.15-0.3,0.2-0.3,0.5-1.5,1,1-3,1/2,1/4-1/3,2-4,2-9,2/3-3/4,3-4,5-25,5-merous,6-8,7-9,abaxial,abaxially,adaxial,alyx,apar,ape,blade,connivent,curved,difoliate,distance,eaf,eed,elongating,equal,extending,flower,foliaceous,free,geminat,gently,glabrescent,glabrou,gra,hair,infructescence,lon,long-styled,longer,lower,mature,midvein,minute,narrow-deltate,narrow-ovate,nflorescence,obtu,occasionally,older,one,open,orolla,oung,patch,pendulous,perfect,pericarp,porrect,portion,prickl,rounded,ruit,scar,sessile,short-styled,side,slender,spreading,stalk,stalked,staminate,stellate,straight,subsessile,tamen,tertiary,time,trichome,unit,usually,variously,vary,venation,visible,woody,ympodial	'',15-25,[,``,arrangement,branch,bud,characteristic,colour,corolla,distal,exertion,form,glabrousnes,gray,growth,height,history,interjected,leaflet,life,lobing,na,new,number,ovary,perennial,plant,pseudostipule,seed,shape,size,stigma,terminal,texture,thicknes,type,value,variation,width,{,}
261	wfo-0001028963	invalid_json_followup	197	157	111	86	46	0.563	/2,0-0.4,0-2,0.1-0.25,0.3-0.6,0.3-0.7,0.3-1,0.3-1.5,0.45-0.6,0.6-0.9,0.6-1,0.8-1.8,0.9-1.5,2-2.3,2-4,2-9,2.4-2.8,3.5-4.2,5-25,6-10,abaxially,acute,anther,apex,apically,apparently,articulated,attenuate,bark,base,berry,bright,broad-deltate,brown,calyx,cell,chartaceous,cm,concolorous,densely,diameter,discolorous,drying,dull,entire,erect,evenly,filament,flattened-reniform,fruiting,gray-green,green,herb,inflorescence,lanceolate,lateral,leaf,length,light,lobe,lobed,long,lower,margin,maturity,mauve,midpoint,mm,moderately,narrow-cuneate,narrow-elliptic,narrowly,obtuse,orange,outline,pair,pale,pedicel,peduncle,per,petiole,pit,poricidal,primary,purple,raised,ray,red,shrub,simple,small,smooth,spherical,stellate,stellate-pubescent,stem,style,surface,tapering,terete,terminal,tip,tube,unarmed,unbranched,vein,way,wide,winged,yellow-orange,young	.5,0.1,0.1-0.2,0.15-0.3,1-4,1.5-2,1/,1/4-1/3,1/5,1/6,2-3,2-5,3-4.5,4-10,4-8,5-merous,7-8,alyx,apar,ape,becoming,blade,connivent,curved,cuspidat,deltate,difoliate,eaf,eed,elongating,equal,eye,flower,free,frui,geminat,glabrescent,glabrous,gra,herbaceous,infructescence,less,long-styled,longer,mature,naked,nflorescence,occasionally,older,one,open,orolla,oung,pendulous,perfect,pericarp,porrect,portion,ruit,scar,sessile,short-styled,shorter,slender,slightly,spaced,spreading,stalk,stalked,staminate,straight,subsessile,tamen,tertiary,time,trichome,unarme,unit,upper,usually,variously,vary,venation,visible,woody,ympodial	'',1,1/2,[,``,arrangement,branch,bud,characteristic,colour,corolla,corrugation,cuspidate,distal,exertion,form,fruit,glabrousnes,gray,growth,height,history,interjected,leaflet,life,lob,lobing,na,new,number,ovary,plant,prickle,pseudostipule,seed,shape,size,stigma,texture,thicknes,type,value,variation,width,{,}
262	wfo-0001028971	invalid_json_followup	225	151	109	116	42	0.484	-0.8,.1-0.2,0.1-0.4,0.1-0.5,0.2-0.5,0.25-0.6,0.4-0.9,0.4-1.5,0.8-2.5,1-2,1-5,1.5-2.2,1.75-2.5,10-15,15-30,2.2-3.5,2.5-3.5,20-35,3-14,3-6,4-5,4-9,5-10,6-16,6-8.5,acute,acute-,adaxially,anther,apex,appearance,articulated,attenuate,base,branched,broadly,calyx,campanulate,close,cm,coarsely,connivent,deltoid,dentate,diameter,distal,erect,extra-axillary,farinaceous,filament,flower,form,fruit,glabrous,globose,inflorescence,lanceolate,lateral,leaf,length,lenticular,lignescent,linear-lanceolate,lobe,margin,midpoint,minutely,mm,narrowly,obtuse,often,orange,outline,ovate,ovate-lanceolate,pair,pedicel,peduncle,per,perennial,petiole,pitted,prickle,pubescent,ray,reniform-ovate,ripe,round-tipped,sericeous,short,side,simple,spreadingly,stellate,stem,stigma,style,surface,tan,termination,thin-textured,truncate,tube,unbranched,usually,vein,white,x,yellow	-1.4,0.25-1.25,0.3-0.6,05-2.5,1.5-4,1/5-1/2,2-5,2-foliate,2.5-4.5,2.5-5,3-5,5-15,5-8,6-9,7-16,abaxially,adaxiall,along,also,apart,appearing,armed,ascending,axe,ba,bearing,becoming,blade,broad-based,capitat,cauline,compressed,cylindrical,delicate,densely,directed,distall,eaf,eed,elongate,elongate-deltoid,entire,essentially,felty,felty-pubescent,female-sterile,frequently,geminat,grading,growt,hair,inserted,interlobal,invested,largest,later,laterally,least,like,lon,long,longer,longest,lower,major,manifestly,maturit,midrib,minute,mixture,much,multiseriate,nflorescence,numerous,occasionally,one,orolla,other,ovate-apiculate,persistent,pore,prickly,principal,rachi,reduced,ruit,scattered,sessile,short-stalked,shorter,similar,sinus,smaller,sometimes,spaced,sparse,spreading-hirsute,stalk,ste,stellae,stellate-pubescent,stipitate,tal,tamen,tem,time,tooth-like,trichome,underdeveloped,unit,variable,variously,vary,well-developed,wide,ympodial	'',[,``,arrangement,bark,branch,bud,capitate,characteristic,colour,corolla,corrugation,exertion,fruiting,glabrousnes,growth,height,herb,history,interjected,leaflet,life,lobing,na,new,number,ovary,plant,primary,pseudostipule,seed,shape,size,terminal,texture,thicknes,type,value,variation,width,{,}
263	wfo-0001028975	success	163	126	79	84	47	0.485	0.5-1,1,1-3,1-5,1.2-1.5,1.5-1.8,3-3.5,3-6.5,6-6.5,7.5-15,8-9,acuminate,acute,anther,apex,area,bark,base,berry,broad,brown,calyx,cm,conically,corolla,cup-shaped,dark,decurrent,densely,dia,elliptic,exserted,filament,fruit,fruiting,glabrous,globose,green,immature,late,lateral,leaf,length,lobe,lobed,long,main,margin,minutely,mm,narrowly,nearly,once-furcate,ovary,ovoid-reniform,pair,pedicel,petiole,pitted,pubescent,shaped,shiny,shrub,simple,size,stem,stigma,straight,style,surface,tapering,tear-drop,tip,triangular,tube,vein,white,wide,x	.2,.5,0.1-1,1.5-2,2.2-6,3-10-flowered,5-ribbed,5.5-10,?,along,anthesi,apart,appearing,beneath,closely,conical,corky,deflexed,denser,differing,difoliate,eaf,edicel,eed,entire,epidermi,equal,erect,extension,free,geminat,golden,hyaline,large-celled,like,lon,lower,mainly,major,member,mere,middle,minor,nflorescence,obscured,occasionally,older,one,opposite,papillo,pore,poricidal,portion,prominent,pubescenc,raised,reddi,reflexed,remaining,rib,ruit,scar,short,sinus,slender,slightly,small,somewhat,spaced,sparsely,strongly,tall,tree,trichome,tub,ud,uniseriate,unit,upper,varying,widest,woody,ympodial,young	0.5,9,alternate,appearance,arrangement,border,branch,bud,characteristic,colour,corrugation,diameter,distal,drying,exertion,form,giving,glabrousnes,growth,height,history,inflorescence,interjected,leaflet,life,lobing,midpoint,na,new,number,peduncle,per,perennial,plant,prickle,primary,pseudostipule,ray,reddish,seed,shape,terminal,texture,thicknes,type,variation,width
264	wfo-0001028980	invalid_json_followup	168	143	97	71	46	0.577	.5,1-1.2,1.2-1.8,1.5-1.8,1.5-2,2.5,3-4,3/4,4-5,5-6,6,6-8,7-12,acuminate,acute,anther,apex,axil,bark,basal,base,berry,black,calyx,capitate,clearly,cm,coarsely,conical,corolla,deflexed,dia,differentiated,drying,elliptic,exserted,filament,flattened-reniform,fleshy,fruiting,furcate,glabrate,glabrous,glandular,globose,green,lateral,leaf,lobe,long,main,margin,minutely,mm,opposite,ovary,ovate,ovoid,pair,paler,pedicel,peduncle,petiole,pitted,pubescent,reddish,seed,shaped,sharply,shrub,simple,size,small,soon,speciman,stem,stigma,style,surface,tall,tapering,tear-drop,thick,tip,tree,trichome,tube,type,uniseriate,usually,vein,way,white,woody,x,yellowish,young	.1,.75,/3,0.5-1.5,1.2-3,1.5-6,2.5-5,20-25-flowered,5-8,along,anthesi,apart,beginning,beneath,broadly,corky,cucullate,deltoid,densely,differing,difoliate,dry,eaf,edicel,eed,expanded,extending,f,free,frui,geminat,impressed,incrassate,inflorescenc,lamina,lenticellat,like,lobed,lon,lower,m.,major,material,member,middle,minor,nflorescence,occasionally,older,one,pale,papillose,pit,planar,pore,poricidal,portion,prominent,reflexed,ruit,scar,scarious,shining,slightly,sparsely,strongly,ti,ud,unit,widest,ympodial	'',[,``,alternate,appearance,arrangement,branch,bud,characteristic,colour,corrugation,diameter,distal,exertion,form,fruit,giving,glabrousnes,growth,height,history,inflorescence,interjected,leaflet,length,life,lobing,midpoint,na,new,number,per,plant,prickle,primary,pseudostipule,ray,shape,terminal,texture,thicknes,value,variation,width,{,}
265	wfo-0001028984	success	180	141	88	92	53	0.489	-2,-3,-65,0.5-,1,1-1.7,1-2,1-6,1-9,1.2-4,1.5,10-20,15-35,2,2-16,2-2.5,2-3,4-6,4-6.3,acuminate,acute,age,almost,also,apex,apical,basal,base,broadly,calyx,chartaceous,cm,concave,cordate,densely,diameter,dilated,distally,eglandular,ellipsoid-fusiform,entire,flower,forked,fruit,glabrous,gland,globose,greenish,hair,lanceolate,lobe,long,margin,mm,moderately,obconical,obtuse,often,ovate,ovoid,pale,pedicel,peduncle,petiole,pilose,puberulent,pubescent-pilose,purple,rarely,shrub,simple,small,sparsely,stigma,strongly,style,subcoriaceous,tip,tree,triangular,truncate,tube,turning,two,unbranched,unknown,x,yellow	-14,-2.5,-6,-9,1-,1-2.5,12-20,2-,2-4,20-40,3-10,3-26,3-28,3-6,4-30,4-5,4-7,4-foliat,5,5-10,7-14,8-15,abaxially,abruptly,absen,adaxially,adpressed,aggregate,apart,ape,articulated,axe,blade,broad,campanulate,cell,color,connective,directed,eaf,eed,equalling,especially,exceeding,fleshy,glandular-puberulent,laterally,leaving,lon,longer,lower,minutely,narrowed,near,nflorescence,nther,orolla,papillose,pedicellar,perfect,pilo,pore,possibly,presence,present,puberulent-pubescent,pubescent-pilo,rachi,radiu,remnant,ripe,ruit,shorter,slightly,spaced,stamen,stone,swelling,tal,tem,thecae,time,tomento,tomentose,toward,ud,unit,unknow,vary,violet,wide,ympodial	anther,appearance,arrangement,bark,border,branch,bud,characteristic,colour,corolla,corrugation,distal,drying,exertion,filament,form,fruiting,giving,glabrousnes,growth,height,history,inflorescence,interjected,lateral,leaf,leaflet,length,life,lobing,midpoint,na,new,number,ovary,per,plant,prickle,primary,pseudostipule,ray,seed,shape,size,stem,surface,terminal,texture,thicknes,type,variation,vein,width
266	wfo-0001028997	success	136	125	80	56	45	0.588	0.5-0.7,0.8-1.1,1-1.2,1-1.5,2-2.5,2-3.5,3-4,3.3.5,4-4.5,4-angled,5-6,6-10,6-7,acute,anther,apex,appearing,area,attenuate,bark,base,berry,broadened,calyx,cm,conical,coriaceous,corolla,difoliate,dry,drying,elliptic,elliptic-obovate,erect,exserted,filament,filiform,flattened-reniform,fruiting,glabrous,globose,green,height,later,lateral,leaf,lobe,main,margin,minutely,mm,mustard,nearly,opposite,ovary,pair,pale,papillose,pedicel,petiole,pitted,revolute,shaped,shrub,stem,stigma,strongly,style,surface,tan,tear-drop,terminal,trifoliate,tube,unknown,vein,white,x,yellow,young	.5,0.5-1,0.5-1.5,20-50-flowered,4-10,abaxially,adaxially,anthesi,apar,ba,branched,cucullate,deflexed,dia,eaf,edicel,eed,fragrant,free,geminat,glabrou,golden,greenish-brow,incrassate,lobed,lon,long,lower,many,matte,merely,middle,nflorescence,older,partially,pericarp,pore,poricidal,portion,quadrate,ruit,scar,shiny,spaced,specimen,styl,thick,thickened,time,tip,tub,ud,unevenly,widest,woody,ympodia	0.5,appearance,arrangement,border,branch,bud,characteristic,colour,corrugation,diameter,distal,exertion,form,fruit,giving,glabrousnes,greenish-brown,growth,history,inflorescence,interjected,leaflet,length,life,lobing,midpoint,na,new,number,peduncle,per,plant,prickle,primary,pseudostipule,ray,seed,shape,size,sympodia,texture,thicknes,type,variation,width
267	wfo-0001029003	invalid_json_followup	207	147	102	105	45	0.493	0-6,0.5,1,1-2,1-3,1.2-1.9,1.2-2.5,1.5-2.3,11-32,12.2-30,2.5-10,2.5-7.5,3,3.5-7.5,4-8,5,5-12.5,7-15.5,7-9,abaxially,acuminate,anther,apex,attenuate,axillary,base,berry,blue-violet,brownish,bud,chartaceous,cm,condition,conical,corolla,diameter,distal,drying,elliptic,filament,forked,fresh,fruit,generally,glabrous,green,green-white,greenish,half,herb,highly,interjected,lanceolate,lateral,leaf,leaflet,light,lobe,long,margin,medium,membranous,minute,mm,mottled,mucilaginous,obtuse,odd-pinnate,ovoid,pale,pedicel,peduncle,petiole,pigmentation,plant,prostrate,pubescent,purple,ray,ripe,rounded,seed,size,sometimes,sparsely,stem,stigma,straight,style,subcapitate,subglabrous,subtending,terminal,throughout,tube,usually,violet,wet,whitish,wide,wing,x	0.3-0.5,0.4-3,1-10,1-2.5,1-5,13-36,2-6,3-20,3-5,5-10.5,5-merou,9-14,absent,acumen,adaxially,ag,alyx,apart,apparently,articulated,axe,blade,capitat,cell,ciliate,connivent,covering,decreasing,digestion,dorsally,eaf,edge,eed,elongated,end,enzyme,equal,erec,especially,exceeding,flat,flower,folded,fourth,geminat,glabrou,gradually,hair,hair-like,hal,homostylous,honeycomb-shaped,larger,lengthening,like,living,lower,make,middle,nflorescence,one,orbicular,orolla,ovate,pair,pentagonal,perfect,petiolule,placed,plurifoliate,pore,poricidal,proximal,rarely,removed,rotate,ruit,secondary,sessile,seudostipule,slightly,slit,spaced,specimen,stamen,ste,stolo,subequal,symmetrical,tall,tamen,tem,testal,thick,tip,toward,tri-,tuber,typically,unit,vary,wall,white,yellow,ympodial	'',[,``,appearance,arrangement,bark,branch,calyx,capitate,characteristic,colour,corrugation,erect,exertion,form,fruiting,giving,glabrousnes,growth,height,history,inflorescence,length,life,lobing,midpoint,na,new,number,ovary,per,prickle,primary,pseudostipule,shape,surface,texture,thicknes,type,value,variation,vein,width,{,}
268	wfo-0001029006	invalid_json_followup	217	169	127	90	42	0.585	-+,.5,0.2,0.4-2.5,0.5-2,0.5-4,1,1-1.5,1-5,1.2-1.5,1.8-2.2,10,10-20,2.5,3.5-4,4-6,5,7-8,<,>,acuminate,acute,adaxial,anther,anthesi,apex,area,articulated,asymmetrical,base,berry,blackish,c.,calyx,chartaceous,cm,conical,connivent,corolla,deeply,deltate,diameter,drying,ellipsoid,elliptic,elongate,entire,exserted,filament,filiform,flattened,fruiting,glabrous,globose,green,groove,growth,inflated,inflorescence,later,lateral,lobe,lobed,long,loosely,margin,membranous,midrib,minute,minutely,mm,narrowly,nearly,new,nodding,oblique,occasionally,often,pair,pale,papillate,pedicel,peduncle,per,petiole,pinnatifid,pitted,primary,puberulent,pubescent,purple,purplish,reaching,reddish,reniform,ripe,sagittate,simple,size,sleeve,small,sometimes,somewhat,sparsely,spreading,stem,stigma,strongly,style,surface,tan,terminal,tip,trichome,truncate,tube,uniseriate,vein,vine,violet,way,white,within,woody,x,young,zig-zag	0.5,1-4,1/3,2-3,2-6,5-6,5-merou,50,7-9,abaxially,adaxiall,ag,age,along,alyx,apar,ark,axi,axil,basal,beyond,bilobed,black,branched,bright,broadest,cell,clavat,dense,depending,eaf,eed,extending,flower,free,growing,ilament,intramarginal,irregular,irregularly,keeled,lamina,leaving,lengthening,lower,many,markedly,nflorescence,obvious,older,one,orolla,part,peg,pendan,pentagonal,perfect,pericarp,planar,plurifoliat,pore,poricidal,portion,puberulen,rotate-stellate,ruit,scar,shiny,slit,smaller,spaced,strong,sunligh,tem,testal,thin,time,tiny,tuft,twinin,twining,ud,unit,upper,usually,variable,variously,vary,widest,ympodial	'',[,``,arrangement,bark,branch,bud,cayx,characteristic,colour,corrugation,distal,exertion,form,fruit,glabrousnes,height,history,interjected,leaf,leaflet,length,life,lobing,midpoint,na,number,ovary,plant,prickle,pseudostipule,ray,seed,shape,texture,thicknes,type,value,variation,width,{,}
269	wfo-0001029031	invalid_json_followup	213	178	131	82	47	0.615	-11.4,-12.3,-8,.5-1.2,0-5,0.1-0.5,0.5-1.5,0.6-1.2,0.7-1.1,1-1.5,1-2,1-2.5,1-5,1-9.4,1.8-2.7,10,13.5,2-10.7,2-3,2-3.3,2-5,2.5-5.5,20-150,3-10,5-17,6-12,6-21,abaxially,acuminate,acute,adaxially,angle,anther,apart,apex,apparently,articulated,base,becoming,berry,black,bluish,branched,brown,calyx,capitate,chartaceous,cm,connivent,corolla,cuneate,deltate,densely,diameter,elliptic,elliptic-ovate,entire,erect,filament,flattened,fleshy,flower,forked,fruit,fruiting,glabrescent,glabrous,globose,green,hair,held,immature,impressed,lateral,leaf,leaf-opposed,length,light,like,long,margin,midpoint,mm,oblong,obtuse,occasionally,orange,outline,pedicel,peduncle,peltate,peltate-stellate,perfect,petiole,possibly,prominent,pseudoterminal,pubescent,rarely,ray,reniform,ripening,rounded,rugulose,sessile,short,shrub,side,simple,small,spaced,sparsely,stellate-pubescent,stem,stigma,strongly,style,suborbicular,surface,tall,tip,tree,trichome,tube,unbranched,usually,vein,white,x,yellow,yellowish	-3.6,.1-0.3,0.5,0.5-4,1-2.6,1-3,1.3-3.3,1.5-2.8,1.5-3.5,1.8-4,1/3,2.5-5.6,4-5-,4-7.5,absent,accrescent,adaxiall,ag,apexacute,around,axe,ba,bilobe,blade,center,covering,curved,cylindrical,denser,directed,distally,eaf,edge,eed,eglandula,eglandular,equal,farinose,frui,fused,geminate,inserted,lanceolate,large,least,lobe,longitudinal,lower,major,many-foliate,midvein,nearly,nflorescence,opening,orolla,paired,pore,porrect-stellate,pubescen,pubescence,rachi,ruit,short-stalked,silvery,slightly,slit,smaller,sometimes,somewhat,ste,stellate,straight,subtending,tamen,tem,time,unarme,unit,vary,whitish,wide,ympodial	'',[,``,arrangement,bark,bilobed,branch,bud,characteristic,colour,corrugation,distal,drying,exertion,form,glabrousnes,growth,height,history,inflorescence,interjected,leaflet,life,lobing,na,new,number,ovary,per,perennial,plant,pr,prickle,primary,pseudostipule,seed,shape,size,terminal,texture,thicknes,type,value,variation,width,{,}
270	wfo-0001029048	success	162	148	116	46	32	0.716	.01,.2,.5,/3,0.5,0.5-1.7,0.8-1,1-2,1-8,1.5-2,11,14,2,25,26,3-4,3.5-4,4-6,5-8,8-10,9-15,acuminate,angle,another,anther,anthesi,apex,arching,attenuate,base,bearing,becoming,beneath,berry,bicellular,branch,broadly,calyx,cm,conical,corolla,decurrent,dia,elliptic,filament,filiform,flower,fruiting,glabrate,glabrous,globose,golden,greenish-white,greenish-yellow,hanging,hispidulous,lateral,leaf,less,like,lobe,lobed,long,main,margin,matte,midrib,minute,minutely,mm,obovoid,obtuse,older,one,ovary,ovoid-reniform,pair,pale,papillose,parallel,pedicel,petiole,pitted,planar,puberulent,reflexed,right,ripe,scar,shaped,sharply,shrub,slender,slightly,small-capitate,stem,stigma,straight,style,surface,tan,tapering,tear-drop,thread-like,time,tip,translucent,trichome,tube,uni-,unifoliate,vein,way,winged,x,young	0.5-1,1,3-7,apar,apparent,basal,blade,bright,eaf,edicel,eed,elongated,except,expanded,f,free,geminate,greatly,green,greenish-yello,incrassate,live,lower,middle,much,nflorescence,node,non-reproductive,opposite,papillo,pore,poricidal,portion,rounded,ruit,somewhat,spaced,specimen,tall,ud,unevenly,unit,widely,widest,ympodial,zig-zag	arrangement,bark,bud,characteristic,colour,corrugation,diameter,drying,exertion,form,fruit,glabrousnes,growth,height,history,inflorescence,length,life,lobing,na,new,number,peduncle,per,perennial,plant,primary,seed,shape,size,texture,type
271	wfo-0001029055	success	169	118	71	98	47	0.42	0.4-1.5,1-2.6,1-4,1-5,1.6-3.5,1.8-3.5,14-50,2.2-3,2.5-8,3-10,4-10,4-6,4-7,5.5-9,6-14,8-9,9-22,acuminate,acute,apex,articulate,base,branched,calyx,cm,cordate,corolla,cuneate,cyme,diameter,dichasial,dichasially,distal,ebracteate,elliptical,filament,green,green-white,herbaceous,interjected,lateral,leaf,leaflet,lobe,long,long-attenuate,mm,monochasial,mucilaginous,oblique,odd-pinnate,ovate,ovoid,pedicel,peduncle,perennial,petiole,pilose,plant,proximal,pubescent,seed,size,stigma,style,terminal,triangular,tuber-bearing,type,wide,Â¼	1.7-2.2,2-1.,2-3,2-4,3,3-6,3-6-foliat,5-24,abaxially,acumen,adaxially,apical,apically,attenuate,cell,connate,covered,covering,dark,decurrent,dehiscent,densely,digestion,diminishing,dorsally,eaf,edge,eed,elliptcal,emoval,enzyme,exceeding,first,flat,flower,folded,forked,generally,gland,globo,hair,hair-like,half,honeycomb,introrse,living,lon,longer,longitudional,lower,lunat,make,maturing,near,nflorescence,nther,often,orolla,outline,pair,pattern,pentagonal,perfect,plan,poricidally,purple,rarely,reveal,rotate,ruit,second,sessile,seudostipule,short,short-petiolate,short-stalked,slit,sometimes,specimen,spreading,stamen,straight,stripe,tal,tem,testal,thick,throughout,time,toward,typically,unit,vary,wall,whit,widest,yellow,ympodial	2-11,anther,appearance,arrangement,bark,border,branch,bud,characteristic,colour,corrugation,drying,exertion,form,fruit,fruiting,giving,glabrousnes,globose,growth,height,history,inflorescence,length,life,lobing,margin,midpoint,na,new,number,ovary,per,prickle,primary,pseudostipule,ray,shape,stem,surface,texture,thicknes,tube,variation,vein,white,width
272	wfo-0001029059	invalid_json	199	108	80	119	28	0.402	.5,0.1-1,0.2,1-1.5,1-4,1-6,1.2-3,1.3-1.7,1.5-2,1.5-2.8,10-19,2.5,3-3.5,3-6.5,3.5-8,4-10.5,5-15-flowered,7-9,along,anther,apiculate,bark,base,berry,calyx,clavate,cm,corolla,deltoid,densely,dia,dirty,elliptic,flattened-reniform,fruiting,glabrous,globose,hispidulous,inflorescence,leaf,long,minor,minute,minutely,mm,nearly,occasionally,orbiculate,ovary,pale,papillose,pedicel,petiole,purplish,ripe,shallowly,shape,shaped,shrub,simple,size,slender,small,stem,stigma,style,tapering,tear-drop,tinge,tree,trichome,tube,unicellular,uniseriate,vein,waxy,white,x,yellowish-green,yellowish-tan	0.1-0.5,0.2-0.5,0.5,0.5-1,1-1.2,1-3,3.5-6,5,6-10,acute,anisophyllou,anthesi,apar,ape,apex,apiculae,arising,beneath,bout,branched,bud,closely,coiba,connivent,cordate,covered,cuneate,de,deep,deflexed,dense,differing,difoliate,eaf,edicel,eed,ellipsoid,expanded,exserted,extending,extremely,filament,foetid,free,geminate,glabrate,greatly,impressed,incrassate,interpetalar,isla,lamina,lateral,lobe,lobed,lon,longest,lower,main,major,margin,member,membranous,middle,narrowly,nflorescence,oblique,often,older,one,opposite,orange,orangish-yellow,pair,paler,panama,papillo,partially,pitted,planar,pointed,population,pore,poricidal,portion,prominent,pubescence,pubescent,reddish-gre,rest,rounded,ruit,scar,sinus,somewhat,soon,spaced,sparse,specimen,straight,surface,tall,terminal,thickened,ti,tightly,tip,triangular,ud,underside,unit,usually,variable,wide,widest,woody,yellowish,ympodial,young	'',[,],``,abaxial,adaxial,alternate,arrangement,characteristic,colour,diameter,form,fruit,growth,height,history,length,life,lobing,perennial,plant,reddish-grey,seed,texture,type,value,{,}
273	wfo-0001029072	invalid_json_followup	235	158	116	119	42	0.494	.5,0-4,0.1-0.4,0.4-0.9,0.5-2,0.8-1.5,00-200,1-1.2,1-1.5,1-25,1.5-2.6,1.5-3.2,1/3,1/4-1/2,2-5,2-7,2.2-2.5,2.2-3.2,2.5-3.5,2.5-3.8,2.5-4.5,3-20,3-5,4.2-6.5,4.5-9,5-7,7-15,8-20,8-27,acute,anther,apex,apparently,bark,base,berry,bright,calyx,chartaceous,cm,conical,connivent,cordate,cream,cuneate,curved,dark,densely,diameter,dirty,discolorous,distal,drying,dull,erect,filament,flattened,flattened-reniform,fruit,fruiting,glabrous,green,green-brown,herb,lateral,leaf,length,lobed,long,long-styled,lower,margin,marking,maturity,mauve,midpoint,mm,moderately,orange-brown,ovate,pair,pale,pedicel,peduncle,pendent,per,petiole,plant,poricidal,prickle,prickly,primary,ray,rounded,short-styled,shrub,simple,sometimes,spherical,stellate-pubescent,stem,strongly,style,surface,tapering,terminal,tip,tube,upper,vein,way,weakly,white,wide,yellow,young	-1/2,-15,-2.5,/6,0,0-2,0-20,0-8,0.2-0.3,0.2-0.4,0.3,0.5-3,0.7,0.8,1,1-3,1.5-2.5,1/4-1/3,12-19,2-10,2-8,20-50,3-10,3-50,3-8,3.5-6,3/,4-,4-10,5-10,5-50,5-9,5-merous,7-10,abaxial,abaxially,adaxial,adaxially,alyx,ame,andromonoecious,angled,apar,apart,apically,articulated,blade,branched,broad-deltate,broadly,c.,clearly,deltate,distance,eaf,eed,elongated,elongating,equal,extending,flower,free,gently,gra,hermaphrodite,heterostylous,infructescence,least,lobe,longer,longitudinal,lowermost,mature,midvein,multangulate,narrow-deltate,nflorescence,obtu,older,one,open,orolla,oung,pendulous,pericarp,plurifoliat,porrect,portion,prickl,raised,reflexed,ridge,ruit,scar,sessile,side,smooth,spaced,sparsely,spreading,stalk,stalked,staminat,stellate,stout,straight,tamen,tertiary,time,trichome,unarmed,unit,variously,vary,venation,visible,whitish,woody,ympodial	'',3/4,[,``,arrangement,branch,bud,characteristic,colour,corolla,corrugation,exertion,form,glabrousnes,gray,growth,height,history,inflorescence,interjected,leaflet,life,lobing,na,new,number,ovary,perennial,pseudostipule,seed,shape,size,stellate-p,stigma,texture,thicknes,type,value,variation,width,{,}
274	wfo-0001029073	invalid_json_followup	211	163	121	90	42	0.573	.5,0.3-1,0.5,0.6-2,1-1.2,1-1.5,1-2.5,1.1-1.5,1.5-2,10-16,2,2-3,2/3,3.5-9,4-5,4-6,5-6,5-8,6-9,7-10,acuminate,acute,anther,anthesi,apex,armed,awn-like,bark,base,berry,broad-based,brown,calyx,chartaceous,cm,conical,corolla,curved,dark,darker,dense,densely,diameter,dimorphic,drying,elliptic,entire,exserted,filament,flattened,fruiting,glabrous,globose,golden,growth,hooked,inflorescence,internodal,lanceolate,leaf,length,linear,lobe,lobed,long,margin,maturity,midpoint,minutely,mm,narrowly,new,oblique,occasionally,opposite,orange,pair,pale,papillose,pedicel,peduncle,per,petiole,porrect,prickle,primary,pubescent,purple,ray,reniform,reticulate,sessile,shallowly,short-stalked,shrub,simple,sinuate,slightly,somewhat,sparsely,stellate,stem,stigma,straight,strongly,style,surface,tan,tapering,tip,trichome,truncate,tube,unequally,vein,way,whitish,x,yellow,yellowish,Â½	.7,0.5-1,0.6-0.7,1-3,1.2-1.6,10-15,2-4,5-merous,8-14,abaxially,adaxially,along,another,apart,articulated,away,ba,basal,beneath,cell,cream,difoliate,discolorous,eaf,eed,enlarged,equal,erect,except,flower,four,free,frui,geminat,gre,interpetalar,lamina,lengthening,like,long-styled,lower,midvein,mixture,multangulate,nflorescence,nodding,older,one,paler,perfect,pericarp,planar,plurifoliate,pore,poricidal,portion,prickly,pubescence,rectangular,ruit,scar,shiny,short,shorter,slit,sometimes,spaced,splitting,styled,testal,thin,three,ti,tissue,triangular,two,ud,unarmed,underside,unequal,unisexual,unit,upper,upward,visible,wall,wide,woody,ympodial,zygomorphic	'',[,``,appearance,arrangement,branch,bud,characteristic,colour,corrugation,distal,exertion,form,fruit,giving,glabrousnes,grey,height,history,interjected,lateral,leaflet,life,lobing,na,number,ovary,perennial,plant,pseudostipule,seed,shape,size,terminal,texture,thicknes,type,value,variation,width,{,}
275	wfo-0001029074	invalid_json_followup	174	145	102	72	43	0.586	.5,0,0.2-1,0.3-0.8,0.5-1,0.7-0.8,1,1-,1-1.2,1-2,1.4-1.8,1.5-2,1.5-4,11,2-2.3,2-7,3-6,3.5-5,5-7,acute,anther,apart,apex,bark,base,berry,black,broadly,calyx,capitate,cm,conical,corolla,cuneate,densely,diameter,ellipsoid,entire,exerted,filament,flattened,flower,fruiting,glabrous,globose,green,grey,growth,herb,immature,internodal,leaf,less,like,lobe,margin,midpoint,minutely,mm,new,opposite,ovary,ovate,pair,pale,pedicel,peduncle,per,petiole,pitted,poricidal,primary,prominent,pubescent,purplish,ray,reniform,ripening,rounded,sagittate,simple,sparsely,stalked,stellate,stem,stigma,strongly,style,subshrub,surface,tip,trichome,truncate,tube,underside,uniformly,vein,way,white,x,yellow,yellowish	.1,0.3-0.4,0.5-1.2,0.7-0.95,1-1.5,2-4,2-5,3-,5-6,abaxially,absent,adaxially,age,almost,along,anthesi,apparently,appearing,articulation,basa,deflexed,denser,eaf,eed,expanding,free,frui,glabrescen,lacking,lengthening,lignescent,lobed,longest,lower,markedly,midvein,mixture,nflorescence,obscuring,often,older,papillat,perfect,pericarp,petal,planar,plurifoliat,pore,portion,pulp,reflexed,ruit,scar,scattered,sessile,slit,small,somewhat,stalk,stellate-pubescent,swollen,thin,triangular,tub,ud,uniseriate,unit,usually,watery,woody,ympodial,Â¾	'',0.5,[,\u00be,``,arrangement,branch,bud,characteristic,colour,corrugation,distal,drying,exertion,form,fruit,glabrousnes,height,history,inflorescence,interjected,lateral,leaflet,length,life,lobing,na,number,plant,prickle,pseudostipule,seed,shape,size,terminal,texture,thicknes,type,value,variation,width,{,}
276	wfo-0001029075	invalid_json_followup	217	178	133	84	45	0.613	.3,.5,0-8,0.8-1.2,0.8-1.5,1-2,1-2.5,10-20,2-5,2.5-3,2.7-4.2,30-60,4-10,4-14,4-7,4.5-6.5,5-8,5-8.5,6-12,7-17,7-9,8-9,abaxially,abruptly,acumen,adaxially,anther,apex,articulated,attenuate-acuminate,atypically,axillary,base,berry,broadly,brown,brownish,bud,canescent,cell,cm,condition,connivent,corolla,covering,cuneate,dark,densely,diameter,distal,dot,drying,filament,flecked,flower,forked,fresh,fruit,generally,glabrescent,glabrous,glandular-pilose,glandular-puberulent,gray-green,green,green-white,greenish,hair,half,herb,interjected,lanceolate,lateral,leaf,leaflet,light,like,lobe,long,long-spatulate,make,margin,mm,mucilaginous,narrowed,odd-pinnate,orbicular,ovate,ovoid,pedicel,peduncle,petal,petiole,petiolulate,plant,pointed,poricidal,pubescent,purple,rounded,seed,sessile,short,size,slightly,small,sometimes,stem,stigma,style,subobtuse,subquadrate,subtending,terminal,testal,thick,throughout,tip,tube,unwinged,upper,usually,wall,wet,white,whitish,whitish-gray,wide,woody,x,yellow,yellow-green,yellowish-white	0-3,0.5-0.8,1-10,1-3,2-4,4-5,5-10,5-merou,ag,along,alyx,apart,apparently,axe,blade,ciliate,clavifor,decreasing,decurrent,digestion,dorsally,eaf,edge,eed,elliptic-lanceolate,end,enzyme,erect,erect-ascendin,especially,etota,exceeding,flat,folded,geminat,glabrou,gradually,greatly,hair-like,homostylous,honeycomb-shaped,larger,lengthening,living,lower,middl,midrib,minutely,narrowly,nflorescence,orne,orolla,pair,pentagonal,perfect,petiolule,plurifoliate,pore,puberulent,rachi,removed,ruit,sec,seudostipule,singly,slit,spaced,specimen,stamen,ste,stolo,straight,subequal,substellate,tall,tamen,tem,toward,tri-,tuber,typically,unit,vary,ympodial	'',[,\u201chair-like\u201,``,arrangement,bark,branch,cayx,characteristic,claviform,colour,corrugation,exertion,form,fruiting,glabrousnes,growth,height,history,inflorescence,length,life,lobing,middle,midpoint,na,new,number,ovary,per,prickle,primary,pseudostipule,ray,shape,surface,texture,thicknes,type,value,variation,vein,width,{,}
277	wfo-0001029084	invalid_json_followup	192	153	108	84	45	0.562	.5,0.8-2,0.8-2.1,1-2,1.1-2.2,1.5-2.5,10-50,2-3.5,2-5,3-6,3.5-7.5,3.5-8,4-17,4-7,4.5-10,5,6-13,7-9,8-23,absent,acuminate,anther,apex,apparently,articulated,axe,axillary,base,berry,brownish,bud,cell,chartaceous,cm,condition,conical,connivent,corolla,covering,diameter,distal,drying,filament,flower,forked,fresh,fruit,generally,glabrous,green,green-white,greenish,half,herb,interjected,lanceolate,lateral,leaf,leaflet,light,lilac,lobe,long,make,margin,middle,minute,mm,mottled,mucilaginous,narrow,odd-pinnate,ovate-lanceolate,ovoid,pedicel,peduncle,perfect,petiole,petiolule,pilose,plant,proximal,pubescent,purple,ray,ripe,rotate,seed,size,sparsely,stigma,style,subglabrous,subsessile,subtending,terminal,testal,thick,throughout,tube,unwinged,usually,wall,wet,whitish,wide,wing,x	1-10,1-3,1-4,2-4,4.5-6.5,5-7,5-merou,abaxially,acumen,adaxially,ag,along,alyx,apart,arranged,bead,blade,capitat,ciliate,darker,decreasing,digestion,dorsally,eaf,edge,eed,enzyme,especially,exceeding,flat,folded,geminat,glabrou,gradually,hair-like,homostylous,honeycomb-shaped,interpetalar,larger,lengthening,like,living,lon,lower,midrib,minutely,moniliform,multiple,necklace,nflorescence,obtuse,orolla,pair,plurifoliate,pore,poricidal,puberulent,removed,ruit,secondary,semierec,seudostipule,slit,spaced,specimen,stamen,stolon,subequal,subglabrou,symmetrical,tall,tamen,tem,thir,tip,tissue,toward,tri-,tuber,typically,unit,vary,yellow,ympodial	'',[,\u201chair-like\u201d,``,arrangement,bark,branch,calyx,capitate,characteristic,colour,corrugation,exertion,form,fruiting,glabrousnes,growth,height,history,inflorescence,length,life,lobing,midpoint,na,new,number,ovary,per,prickle,primary,pseudostipule,shape,stem,surface,texture,thicknes,third,type,value,variation,vein,width,{,}
278	wfo-0001029088	invalid_json_followup	149	139	88	61	51	0.591	.3,0.6â3.2,1.3â4.5,1.5â2,1.5â3,15â25,1â1.2,1â1.6,1â3,25â30,2â2.5,2â3,3.5â7,3.5â8,3â16,4â8,5,6-10,acuminate,anther,apex,base,berry,bronze-brown,calyx,capitate,cm,cordate,cylindrical,diameter,entire,extra-axillary,filament,flattened,fleshy,flower,fruit,fruiting,glabrous,greenish-brown,half,herbaceous,immature,leaf,lenticular,light,lobe,long,lower,margin,mature,minutely,mm,moderately,near,obtuse,ovoid-rhomboid,palmate,papillose,pedicel,peduncle,petiole,primary,purplish,reddish-brown,revolute,rounded,rugose,sand-punctate,shortly,simple,slender,slightly,somewhat,sparsely,stigma,stout,straight,style,surface,tip,tube,unbranched,vein,vine,white,x,â7	.2,0.1,0.9â1.5,1â1.5,2-lobe,2.5â20,2.5â4.2,5-merous,5â8,<,abaxially,accrescent,acute,adaxially,alyx,apar,apicall,axe,blade,c.,ciliate,climbing,densely,eaf,eed,emarginate,flavor,fragrant,glabrou,groun,hair,heavy,juicy,lanceolate,m.,membranous,narrowly,nflorescence,nternode,orolla,perfec,plurifoliat,pubescent,rachi,ruit,scent,spaced,stellate,strongly,swee,sweet,tamen,tem,terrestrial,truncate,truncate-acuminat,unit,vary,venation,wider,ympodial	'',2-lobed,[,``,arrangement,bark,branch,bud,characteristic,colour,corolla,corrugation,distal,drying,exertion,form,glabrousnes,growth,height,history,inflorescence,interjected,lateral,leaflet,length,life,lobing,midpoint,na,new,number,ovary,per,plant,plurifoliate,prickle,pseudostipule,ray,seed,shape,size,stem,terminal,texture,thicknes,type,value,variation,width,{,}
279	wfo-0001029089	success	177	130	85	92	45	0.48	/4,0.1-0.25,0.5-0.6,0.5-1,0.8-1,1,1-1.5,1.5-2,10-25,4.5-5,5-10,5-9,6-7,acute,anther,apex,bark,base,berry,bilobed,bud,calyx,campanulate,caniculate,cm,completely,corolla,dark,decurrent,dia,drying,elliptic,enclosed,exserted,filament,flattened-reniform,fruiting,furcate,glabrous,globose,golden,green,impressed,lateral,leaf,lobe,margin,minutely,mm,occasionally,opposite,ovary,pedicel,petiole,pinkish,pitted,primary,prominent,purplish,reddish-grey,resinous,rounded,secretion,shaped,shiny,shrub,simple,size,slightly,small,somewhat,stem,stigma,style,surface,tan,tapering,tear-drop,tree,tube,vein,way,white,x,young	.5,.75,0.8-1.2,1.5-6,1/2,2.5-3.5,5-20-flowered,5-6,8-9,abrupt,along,anthesi,apart,apiculate,axil,ba,beginning,beneath,branched,closely,covered,covering,cracking,deflexed,densely,differing,difoliate,eaf,edicel,eed,either,entire,erect,expand,free,geminat,glabrou,incrassate,inflorescenc,lamina,later,like,lobed,lon,long,lower,main,major,material,member,middle,minor,nflorescence,obovoid,older,one,otherwise,overlapping,pair,papillo,papillose,part,peeling,persistent,planar,pore,poricidal,portion,pubescent,resinou,rounded-deltoid,ruit,scar,smooth,spaced,still,straight,tall,tip,trichome,tub,ud,underside,uniseriate,unit,usually,varnish,varnished,widening,widest,woody,ympodial	abaxially,adaxially,alternate,appearance,arrangement,border,branch,characteristic,colour,corrugation,diameter,distal,exertion,form,fruit,giving,glabrousnes,greyish,growth,height,history,inflorescence,interjected,leaflet,length,life,lobing,midpoint,na,new,number,peduncle,per,plant,prickle,pseudostipule,ray,seed,shape,terminal,texture,thicknes,type,variation,width
280	wfo-0001029091	success	212	129	92	120	37	0.434	-4,-4.5,1-2,1.5-,1.5-2,10,10-20,10-toothed,15-40,170-210,2-2.5,2-3,2.5-,3,3-4,4,7-8,acuminate,acute,anther,apex,base,berry,broadly,buff,calyx,campanulate,capitate,cm,colour,corolla,cuneate,cyme,dia,discoidal,ellipsoid,elliptic,exerted,filament,flattened,flower,flushed,fruiting,glandular,globose,globular,grey,intense,irregular,irregularly,larger,leaf,light,long,minutely,mm,narrowly,oblong,obovate,ochre-yellow,ovate,overlain,ovoid,pale,pattern,pedicel,peduncle,petiolate,petiole,pubescent,reddish-purple,relatively,reticulate-concentric,ridge,ridged,scarcely,separate,shortly,shrub,slender,slightly,soft-wooded,soon,speckled,stem,stigma,style,surface,transverse,violet-purple,winged,x	-1,-15,0.3-,0.5-0.8,0.5-1,1,1-10,2-12,20-30,3-,3-11-lobed,46/1,5,5-7,635/1,age,appearing,aromatic,articulated,articulation,aspect,axil,ba,becoming,blunt,bluntly,brownish,cell,clonal,close,common,conspicuous,cut,dark,deeply,develop,developed,downward,eed,effect,emarginated,erect,exceeding,floral,fork,forked,fresh,general,giving,gree,growing,hair,half,interacuminal,juvenile,lacking,lasting,later,lateral,lavende,lavender,lengthening,line,linear,linear-lanceolate,lobe,long-triangular,lower,may,mid-vein,mineral,nflorescence,obscure,occasionally,ower,pedicellate,pentagonal,petiol,plurifoliat,point,pore,poricidal,rachi,raised,readily,rh,ripe,rounded,ruit,several,shallowly,shed,sigmoid,simple,sinus,slit,soft,sparsely,stellate-rotate,stone,straggly,subulate,succulent,swollen,tall,tip,tissue,toward,triangular,tub,ud,unit,upper,usually,violet,well,without,woody,year,ympodial	arrangement,bark,branch,bud,characteristic,corrugation,diameter,drying,exertion,form,fruit,glabrousnes,green,growth,height,history,inflorescence,length,life,lobing,margin,na,new,number,ovary,per,perennial,plant,plurifoliate,primary,seed,shape,size,texture,tube,type,vein
281	wfo-0001029101	success	233	130	102	131	28	0.438	.5,/3,0-2,0.4-1.5,0.5-1,00-200,1-1.5,1-3,1.3-2,1.3-2.6,1.4-2.2,1.5-2.5,1.8-3,2.5-3.5,2.5-6,2.8-3.3,3-,3-4,5-,5-9,7-13,anther,apex,apparently,articulated,bark,base,berry,brown-green,calyx,cell,chartaceous,cm,concolorous,connivent,cream,cuneate,dark,darker,diameter,discolorous,drying,dull,elliptic,erect,filament,flattened-reniform,fruit,fruiting,glabrous,green,lateral,leaf,length,lobed,long,long-styled,margin,marking,maturity,mauve,mm,moderately,obovate,obtuse,orange-brown,outline,ovate,pair,pale,pedicel,peduncle,per,petiole,pit,plant,poricidal,prickly,primary,raised,rounded,short-styled,shrub,simple,small,smooth,sometimes,sparsely,spherical,stellate-pubescent,stem,style,surface,tapering,tip,tube,vein,way,wide,yellow,yellow-green,young	-15,-3,/4,0-100,0-20,0-5,0-8,0.1,0.1-0.4,0.1-0.5,0.1-0.7,0.1-1,0.2,0.7-,0.8-3.5,1,1-4,1-8,1.5-2,1.7,1/5-1/4,10-14,10-20,2-,2-20,2-6,2/3-3/4,3-10,3-7,30-100,4-12,4-7,5-20,5-6,5-7,5-8,5-merous,5.5-8,6-8,8-15,abaxial,abaxially,acute,adaxial,almost,always,alyx,andromonoecious,apar,apart,apically,blade,branched,broad-deltate,deltate,distal,distance,eaf,eed,elongating,equal,extending,flattened,flower,free,glabrescent,green-brow,hermaphrodite,heterostylous,infructescence,lengt,like,lobe,lon,longer,lower,lowermost,mature,midpoint,midvein,multangulate,narrow-deltate,nflorescence,oblong,often,older,one,open,orolla,oung,pendulous,pericarp,plurifoliat,porrect,portion,present,prickl,prickle,rarely,ray,reduced,reflexed,rounde,ruit,scar,secondary,sessile,side,spaced,spreading,stalk,stalked,staminat,stellate,straight,suborbicular,tamen,terete,tertiary,thick,time,trichome,unit,variously,vary,venation,visible,well-developed,woody,yellow-orange,ympodial	arrangement,branch,bud,characteristic,colour,corolla,corrugation,exertion,form,glabrousnes,green-brown,growth,height,history,inflorescence,life,lobing,na,new,number,ovary,perennial,seed,shape,size,stigma,texture,type
282	wfo-0001029106	success	200	134	107	93	27	0.535	.5,/3,0.2-1,0.25-0.7,0.5-0.8,0.5-0.9,0.5-1,0.9-1.2,1-1.6,1-5,1.5-3.5,2-4,2-5.5,2-8,2.2-3,3-25,3-3.5,3-4,4-6,anther,apart,apex,apparently,articulated,bark,base,berry,calyx,cell,cm,concolorous,cuneate,curved,densely,diameter,discolorous,drying,elliptic,elongating,erect,filament,flattened,flattened-reniform,fruit,fruiting,gently,glabrous,lateral,leaf,length,light,lobe,lobed,long,lower,margin,mature,maturity,mauve,membranous,mm,obtuse,orange,orange-brown,outline,ovate,pair,pale,pedicel,peduncle,per,petiole,pit,poricidal,prickle,prickly,primary,raised,red,reflexed,rounded,shiny,shrub,simple,size,small,smooth,spaced,sparsely,spherical,spreading,stellate-pubescent,stem,straight,style,subentire,surface,tapering,tip,tube,vein,way,weakly,white,wide,yellow-orange,yellowish-green	-6,.1,0,0-0.3,0-10,0-2,0-20,0-5,0-6,0.1,0.2-0.4,0.5,0.5-2.5,1-2,1.5-1.8,1.5-2,1/4,1/5-1/4,2-3.5,2-6,2/,4-8,5-14,5-8,5-merous,6-8,abaxially,acuminat,acute,alyx,ame,apar,apically,appearing,blade,branched,c.,deltate,distance,eaf,eed,equal,extending,eye,flower,free,glabrescent,infructescence,lon,longer,midpoint,midvein,naked,nflorescence,older,one,open,orange-brow,orbicular,orolla,oung,pendulous,perfec,pericarp,plurifoliat,porrect,portion,prickl,ray,scandent,scar,sessile,shallow,shorter,side,slender,sometimes,stalk,stalked,stellate,tamen,terete,tertiary,time,trichome,uit,unit,variously,vary,venation,visible,woody,ympodial	10-20,2/3,arrangement,branch,characteristic,colour,corolla,exertion,form,glabrousnes,growth,height,history,inflorescence,life,lobing,na,new,number,ovary,perennial,plant,seed,shape,texture,type,width
283	wfo-0001029112	invalid_json_followup	190	151	106	84	45	0.558	0.5,0.9-1.7,1-2,1.4-2.5,1.5-1.8,1.5-2,10-17,10-21,2-3.5,2.6-3,2.7-3.5,2.7-4.2,2.7-5.7,20,3-6,3-7,3.5-4.5,3.5-7,5,5-8,6.5-5.5,9.5-13,acuminate,anther,apex,apparently,articulated,axe,axillary,base,berry,brownish,bud,cell,chartaceous,cm,condition,conical,corolla,covering,densely,diameter,distal,drying,elliptic-lanceolate,filament,flower,forked,fresh,fruit,generally,glabrous,green,green-white,greenish,half,herb,interjected,lanceolate,lateral,leaf,leaflet,light,lobe,long,make,margin,middle,minute,mm,mottled,mucilaginous,narrow,obtuse,odd-pinnate,ovate,ovoid,pale,pedicel,peduncle,perfect,petiole,plant,pubescent,purple,ray,ripe,seed,size,slightly,stigma,style,subtending,terminal,testal,thick,throughout,tube,usually,violet,wall,wet,whitish,wide,wing,x	0-2,1-10,1-3,1-4,2.5-4.5,3-4,3-5,5-merou,abaxially,acumen,adaxially,ag,along,alyx,apart,arranged,bead,blade,capitat,ciliate,connivent,decreasing,digestion,dorsally,eaf,edge,eed,enzyme,equal,especially,exceeding,flat,folded,geminat,glabrou,gradually,hair,hair-like,homostylous,honeycomb-shaped,larger,lengthening,like,living,lower,moniliform,multiple,necklace,nflorescence,orolla,pair,petiolule,plurifoliate,pore,poricidal,present,pubescen,removed,rotate,ruit,secondary,semierec,seudostipule,slit,spaced,specimen,stamen,ste,stolon,subequal,symmetrical,tall,tamen,tem,thir,tip,toward,tri-,tuber,typically,unit,vary,yellow,ympodial	'',[,\u201chair-like\u201d,``,arrangement,bark,branch,calyx,capitate,characteristic,colour,corrugation,exertion,form,fruiting,glabrousnes,growth,height,history,inflorescence,length,life,lobing,midpoint,na,new,number,ovary,per,prickle,primary,pseudostipule,shape,stem,surface,texture,thicknes,third,type,value,variation,vein,width,{,}
284	wfo-0001029120	success	168	102	78	90	24	0.464	.5,0.1-0.5,0.5-1.5,0.7-1,1-1.5,1.1-1.5,1.1-2,2.6-7,3-3.5,5-10-flowered,6-8,6.5-16.5,abrupt,acuminate,acute,anther,apex,bark,basal,base,beneath,black,bud,calyx,cm,corolla,dark,decurrent,deflexed,densely,dia,drying,erose,especially,f,filament,glabrous,globose,golden,greenish-brown,hirsute,larger,leaf,long,margin,minutely,mm,narrowly,nearly,occasionally,ovary,ovate,pale,papillose,pedicel,petiole,pubescent,shaped,shrub,simple,slightly,sparsely,stem,stigma,style,surface,tapering,tear-drop,tip,trichome,tube,uniseriate,vein,white,widening,x,yellow-green,young	.05,.75,/2,2.5-3.5,5-8,8511,anthesi,apart,beginning,bullate,cell,difoliate,dry,eaf,edicel,eed,epidermi,evenly,fide,fleshy,free,geminat,inflorescenc,infloresence,internodal,know,known,lanceolate,large,later,lateral,lehmann,like,lobe,lobed,lon,long-triangular,lower,main,middle,midrib,minor,narrow,narrower,nflorescence,often,older,opposite,outer,pair,paler,peduncl,peduncle,petaloid,point,pore,poricidal,portion,present,prominently,proximal,raised,reproductive,rest,ruit,scar,scattered,slender,spaced,specimen,speckle,straight,sympodial,tall,terminal,thickened,tub,ud,unbranched,unifoliate,unit,upper,urceolate,venation,way,white-papillo,wide,widest,yellow,ympodial	characteristic,colour,decument,diameter,form,fruit,growth,height,history,inflorescence,length,life,lobing,na,perennial,plant,seed,shape,size,texture,type,variation,white-papillose,width
285	wfo-0001029121	success	161	124	77	84	47	0.478	0,0.2-2,1-4,1-5,1.1-3.9,1.2-2.5,1.2-3.3,15-30,2-10,2-13,2-3,2-3-celled,3.6-9,3.8-11,4-5.5,4.5-10.0,5-20,5-8,9-33,acuminate,acute,apex,articulate,base,blue,branched,calyx,cm,conical,corolla,cuneate,cyme,deep,diameter,dichasial,dichasially,distal,ebracteate,elliptical,filament,glabrous,green,green-white,hair,herbaceous,interjected,lateral,leaf,leaflet,lobe,long,medium,mm,monochasial,mucilaginous,oblique,odd-pinnate,ovate,ovoid,pedicel,peduncle,perennial,petiole,plant,purple,rarely,rotate,rounded,scattered,seed,short,short-attenuate,size,stigma,style,terminal,wide	-6,0-2,10,2-,3-5,3-6-foliat,4-10,8-16,abaxiall,abaxially,acumen,adaxially,apical,apically,attenuate,cell,commonly,connate,covering,dehiscent,digestion,diminishing,dorsally,eaf,edge,eed,emoval,enzyme,exceeding,flat,flower,folded,forked,generally,globo,gradually,hair-like,half,honeycomb,introrse,living,lon,lower,lunat,make,maturing,narrowly,nflorescence,nther,obtuse,often,orolla,pair,pattern,perfect,petiolule,plan,poricidally,proximal,reveal,ruit,sessile,seudostipule,slit,specimen,stamen,straight,subequal,tal,tem,testal,thick,throughou,throughout,tip,toward,tuber-bearing,typically,unit,vary,wall,yellow,ympodial,Â¼	6,anther,appearance,arrangement,bark,border,branch,bud,characteristic,colour,corrugation,drying,exertion,form,fruit,fruiting,giving,glabrousnes,globose,growth,height,history,inflorescence,length,life,lobing,margin,midpoint,na,new,number,ovary,per,prickle,primary,pseudostipule,ray,shape,stem,surface,texture,thicknes,tube,type,variation,vein,width
286	wfo-0001029125	success	197	146	88	109	58	0.447	0.5,2/3,abaxial,acuminate,adaxial,anther,anthesi,apex,appressed,attenuate,base,berry,black,brownish,calyx,central,cm,concave-reniform,conical,corolla,cuneate,diameter,ellipsoid,end,entire,exerted,filament,fruit,fruiting,glabrous,globose,green,herb,internodal,lateral,leaf,lobe,long,margin,maturity,minutely,mm,narrower,nearly,oblique,often,one,orange,ovary,ovate-lanceolate,pair,pale,papillate,pedicel,peduncle,per,petiole,plant,primary,pubescent,purple,purple-tinged,purplish,ridged,ripe,seed,simple,slightly,small,sparsely,spreading,star,stem,stigma,strongly,style,subshrub,surface,terete,trichome,tube,turning,unequal,uniseriate,vein,white,wide,yellow	.0â3.5,.1,.1â1.4,.2,.4,.5â2.0,.6,0.5â0.6,0.5â1.0,0.8â0.9,0.9,1,1.0â1.2,1.0â1.5,1.0â4.0,1.5â2.0,1.5â3.0,1.7-,1.8â3.5,1â2-celled,2.5â12.0,20â100,2â3-celled,2â4,3.0â3.4,3.5â4,35â45,3â5,3â5-celled,4â8,5-merous,5â6,6,6â7,abaxially,acute,adaxially,age,along,apar,apparently,arising,articulated,ba,beyond,branching,cell,closely,cone,delicate,deltate,densely,difoliate,eaf,eed,especially,flower,free,geminat,growt,hilum,later,lengthening,like,live,lobed,lon,lower,maximum,nflorescence,occasionally,outline,pentagonal,perfect,place,pore,poricidal,portion,positioned,reflexe,reflexed,ruit,scar,scattered,shiny,shorter,single,slit,spaced,stellate,stemmed,stone,straight,sub-lateral,tall,tem,testal,tinged,tip,toward,traingular,ud,unit,usually,whitewith,woody,ympodial,young,Â¼	0.4,0.5-0.6,0.5-1.0,1-2-celled,1.0-1.2,1.0-1.5,1.0-4.0,1.1,1.1-1.4,1.2,1.5-3.0,1.8-3.5,2-4,2.5-12.0,20-100,3.5-4,35-45,4-8,5-6,6-7,appearance,arrangement,bark,border,branch,bud,characteristic,colour,corrugation,distal,drying,exertion,form,giving,glabrousnes,growth,height,history,inflorescence,leaflet,length,life,lobing,midpoint,na,new,number,perennial,prickle,ray,shape,size,terminal,texture,thicknes,type,variation,width
287	wfo-0001029150	invalid_json_followup	177	140	88	89	52	0.497	.5,0.3,0.3-0.5,0.3â0.5,0.5â1.1,0.8-1,0.8â1,0.8â3.5,1.2â1.5,1.5,1.5â2,15,1â1.5,1â5,1â6,2.5â3,2.5â8,2â2.5,3â10,7â8,9â12,acute,adaxially,anther,apex,apiculate,base,berry,branched,calyx,cm,conical,cylindrical,diameter,ellipsoidal,elliptical,enlarged,entire,filament,flower,fruit,fruiting,glabrous,leaf,light,lobe,long,margin,midvein,minutely,mm,moderately,oblique,ovate,pedicel,peduncle,petiole,pinnate,pubescent,rarely,rounded,rounded-deltoid,rugose,sand-punctate,shortly,simple,slender,slightly,small,spaced,sparsely,stem,stigma,strong,style,surface,tan,teardrop-shaped,tip,trichome,truncate,tube,vein,vine,white,wiry,woody,x	0.8â1.5,1.5â2.2,1â11,1â2,2.5â5,2â10,2â3,3-5,3â4,3â50,5-merous,6,8-shaped,abaxially,accrescent,across,adaxiall,alyx,apar,apicall,apically,attenuate,axe,blade,c.,canopy,capitat,ciliate,climbing,color,cros,delicate,distant,dried,eaf,eed,except,extra-axillary,flattened,fleshy,flush,glabrou,inconspicuous,lamina,lanceolate,larger,living,lon,lower,m.,material,membranaceous,mor,nearly,nflorescence,nternode,older,opposed,orolla,pair,pale,perfec,pinkish-white,plurifoliat,pointed,rachi,reaching,ruit,scar,secondary,section,side,somewhat,specimen,stellate,tamen,tem,thick,thickened,time,translucent,tree,understory,unit,vary,vegetation,venation,wide,ympodial	'',[,``,apart,arrangement,bark,branch,bud,capitate,characteristic,colour,corolla,corrugation,distal,drying,exertion,form,glabrousnes,green,growth,height,history,inflorescence,interjected,lateral,leaflet,length,life,lobing,midpoint,na,new,number,ovary,per,plant,prickle,primary,pseudostipule,ray,seed,shape,size,terminal,texture,thicknes,type,value,variation,width,{,}
288	wfo-0001029152	success	197	136	101	96	35	0.513	0.5-1,0.75-1,0.8-1,0.9-1.3,1,1-3,1-4,1.1-1.3,1.5-1.7,1.5-2,2-2.5,2-5,2.5-3,3-5,3-8-flowered,6-8,8.5-16,acuminate,acute,anther,apex,area,attenuate,bark,base,berry,branch,broadly,brown,bud,calyx,cm,conical,corolla,cuneate,dark,decurrent,deep,densely,dia,distal,elliptic,filament,floccose,fruit,fruiting,giving,glabrous,globose,green,greyish-red,inflorescence,late,lateral,leaf,lightly,lobe,long,main,margin,minutely,mm,nearly,obovate,ovary,ovoid-reniform,pair,pale,papillose,pedicel,per,petiole,pitted,plane,plant,quite,red,red-floccose,reddish-floccose,shape,shaped,shiny,shrub,simple,single,size,slender,small,stem,stigma,style,surface,tapering,tear-drop,terminal,tree,tube,vein,white,winged,x	.1,.5,0.25-0.5,1-1.5,1-2,2-3,2-4,4-6,61-25,anthesi,appearanc,appearing,appressed,ba,beginning,beneath,blade,broadened,citronella,closely,completely,corky,deciduous,deflexed,deltoid,differing,difoliate,dry,eaf,edicel,eed,ellipsoi,enclosing,erect,et,exsertion,fide,flattened,flower,fragrance,free,geminat,held,hyaline,inflorescenc,keeled,large-lenticellate,live,lobed,lon,long-styled,longer,lower,major,material,middle,midrib,minor,nflorescence,often,older,one,opposite,overlapping,planar,pore,poricidal,portion,prominent,prominently,reddish,reflexed,reminiscent,rounded,ruit,scar,short-styled,slightly,somewhat,soon,spaced,straight,styl,tall,third,tillett,tip,trichome,ud,unit,usually,weak,widest,woody,ympodial,young	1.5-6,appearance,arrangement,border,characteristic,colour,corrugation,diameter,drying,exertion,form,glabrousnes,growth,height,history,interjected,leaflet,length,life,lobing,midpoint,na,new,number,peduncle,prickle,primary,pseudostipule,ray,seed,texture,thicknes,type,variation,width
289	wfo-0001029156	success	65	75	35	30	40	0.538	1.5-2,10-12,4-6,6,6-8,almost,apex,bark,berry,cm,completely,diameter,flattened,fruiting,glabrous,growth,liana,long,margin,minutely,mm,new,pale,pedicel,per,pitted,reniform,seed,shiny,stem,surface,tan,vine,wide,woody	-3,0.5,1,2,<,apparently,cell,center,deeply,eed,epiphytic,exfoliating,fide,golden,lateral,markedly,minute,multiseriate,nee,noddin,occasionally,older,rectangular,rib-like,shreddy,sinuate,testal,thickening,trichome,wall	2-3,anther,arrangement,base,branch,bud,calyx,characteristic,colour,corolla,corrugation,drying,exertion,filament,form,fruit,glabrousnes,height,history,inflorescence,leaf,length,life,lobing,na,nodding,number,ovary,peduncle,petiole,plant,primary,shape,size,stigma,style,texture,tube,type,vein
290	wfo-0001029156	success	65	74	32	33	42	0.492	1.5-2,10-12,4-6,6-8,almost,apex,berry,cm,completely,diameter,flattened,fruiting,glabrous,growth,liana,margin,minutely,mm,new,pale,pedicel,per,pitted,reniform,seed,shiny,stem,surface,tan,vine,woody,x	-3,0.5,1,2,<,apparently,ark,cell,center,deeply,eed,em,epiphytic,exfoliating,fide,golden,lateral,lon,markedly,minute,multiseriate,nee,noddin,occasionally,older,rectangular,rib-like,shreddy,sinuate,testal,thickening,trichome,wall	2-3,6,anther,arrangement,bark,base,branch,bud,calyx,characteristic,colour,corolla,corrugation,drying,exertion,filament,form,fruit,glabrousnes,height,history,inflorescence,leaf,length,life,lobing,na,nodding,number,ovary,peduncle,petiole,plant,primary,shape,size,stigma,style,texture,tube,type,vein
291	wfo-0001029163	success	149	116	65	84	51	0.436	-9,0.3-2.5,0.5-1,1-2,10-,2,2-3,2-6,2-7,2.5-3,20-30,3-4,3-5,4.5-23,5-8,7-9,9-15,acuminate,acute,apex,base,calyx,chartaceous,cm,cuneate,decurrent,deltate,densely,diameter,elliptic,elliptic-ovate,entire,fruit,glabrous,globose,herb,lanceolate,lenticular,lobe,margin,mm,nearly,obtuse,pedicel,peduncle,perennial,petiole,pseudohair,puberulent,puberulent-pubescent,purple,shrub,simple,sparsely,stem,stigma,style,surface,tube,unbranched,unknown,vein,white,whitish,x	-25,-4,1,1.5-2,1.5-2.5,1.5-3,13-18,2-18,3-14,4-20,4-5-foliat,4-6,5-12,abaxial,abaxially,absen,adaxiall,adaxially,aggregate,apart,articulated,axe,band,blade,cell,color,connivent,cylindrical,denser,directed,distall,distally,eaf,eed,eglandular,flower,free,glandular,hair,leaving,like,lon,long,lower,moderately,narrowed,narrowly,nflorescence,nther,orolla,papillose,pedicellar,pore,projection,puberulent-pubescen,pubescence,rachi,radiu,remnant,ripe,roughened,ruit,scale-like,slightly,small,sometimes,spaced,stalked,stellate,stone,subapical,subcoriaceous,tal,tem,thickened,time,tip,triangular,truncat,unit,vary,wide,yellow,ympodial	anther,appearance,arrangement,bark,border,branch,bud,characteristic,colour,corolla,corrugation,distal,drying,exertion,filament,form,fruiting,giving,glabrousnes,growth,height,history,inflorescence,interjected,lateral,leaf,leaflet,length,life,lobing,midpoint,na,new,number,ovary,per,plant,prickle,primary,pseudostipule,ray,seed,shape,size,terminal,texture,thicknes,truncate,type,variation,width
292	wfo-0001029171	invalid_json_followup	137	144	85	52	59	0.62	-,-15,0.5,1-3,1-4.5,1.5-2,1.5-7.5,10-25,10-35,2-3,3.5-18,3.5-6.5,4-10,4-5,5-6,5-8,7-9,abaxially,abruptly,acuminate,acute,adaxially,also,angled,apex,base,branched,calyx,chartaceous,cm,connivent,cuneate,decurrent,deltate,dendritically,densely,diameter,eglandular,elliptic,entire,flower,forked,fruit,glabrous,gland,glandular,globose,hair,lanceolate,like,lobe,margin,mm,moderately,narrowed,obtuse,often,orange,ovate-elliptic,pedicel,peduncle,perfect,petiole,pubescent,purple,rarely,red,ripe,rugose,shoot,short-stalked,shrub,simple,slightly,smooth,sometimes,stellate,stigma,style,tip,tube,unbranched,usually,white,x	-10,1-5,11-20,3-4,6-,8-17,absen,aggregate,and/or,apart,articulated,axe,ba,blade,cell,cylindrical,dense,directed,distall,eaf,eed,except,glandula,long,lower,many-foliat,midrib,narrowly,near,nearly,nflorescence,nther,orolla,pore,puberulent,rachi,radiu,ruit,spaced,sparsely,ste,stone,tal,tem,time,triangular,truncat,unit,vary,wide,yellow,ympodial	'',[,``,anther,appearance,arrangement,bark,branch,bud,characteristic,colour,corolla,corrugation,distal,drying,exertion,filament,form,fruiting,giving,glabrousnes,growth,height,history,inflorescence,interjected,lateral,leaf,leaflet,length,life,lobing,midpoint,na,new,number,ovary,per,plant,prickle,primary,pseudostipule,ray,seed,shape,size,stem,surface,terminal,texture,thicknes,truncate,type,value,variation,vein,width,{,}
293	wfo-0001029215	success	49	93	34	15	59	0.694	-1.8-2.3,.2,0.3-0.5,0.5-0.7,0.5-2.5,1,2.3-2.9,appearance,border,brown,calyx,cm,coarse,diameter,elongating,fruit,hair-like,herb,lateral,lobe,long,markedly,mm,narrowly,obovate,outgrowth,pubescent,shrub,silky,smelling,strong,surface,wide,winged	cell,eed,entire,fide,give,round,small,spreadin,tall,testa,thick,wall,weigend,woody,xyledecor	0.2,anther,apex,arrangement,bark,base,branch,bud,characteristic,colour,corolla,corrugation,distal,drying,exertion,filament,form,fruiting,giving,glabrousnes,growth,height,history,inflorescence,interjected,leaf,leaflet,length,life,lobing,margin,midpoint,na,new,number,ovary,pedicel,peduncle,per,petiole,plant,prickle,primary,pseudostipule,ray,seed,shape,size,stem,stigma,style,terminal,texture,thicknes,tube,type,variation,vein,width
294	wfo-0001029216	invalid_json_followup	243	163	124	119	39	0.51	+,-10,0.1-0.6,0.1-0.8,0.4-0.5,0.5,0.5-0.8,0.6-1,0.8-2.5,1-1.2,1-2,1-3,1.2-6,1.5-2.3,1.5-2.5,1.5-3,10,10-,2,2-4.5,2.5-3.3,20-35,3,3-,3-5,4,5,6-10,7-10,acute,annual,anther,apex,articulated,attenuate,base,basiscopically,biennial,branch,bright,brown,calyx,capitate,cell,cm,conical,corolla,crenate,cultivar,decurrent,deep,dentate,diameter,distal,elliptic,exserted,fasciated,filament,fruit,fruited,fruiting,globose,green,hair-like,halfway,herb,imparipinnate,inflorescence,interjected,interrupted,large,lateral,leaflet,length,less,linear,lobe,long,mainly,margin,minute,mm,near,oblique,obovate,often,orange,outgrowth,ovary,ovate,pale,pedicel,peduncle,perennial,petiole,plant,present,primary,procumbent,pseudostipule,pubescent,rarely,red,shape,simple,sometimes,sparsely,stem,stigma,straight,style,surface,terminal,testa,thick,thickening,tube,usually,variety,villous,viny,wall,wide,yellow	-0.5,-5,.5,.8-1,0.1-0.3,0.1-0.5,0.2-0.25,0.2-0.3,0.2-0.4,0.2-0.8,0.3-0.4,0.3-0.5,0.3-2,0.4,0.5-1.5,0.5-2,0.6-0.8,1-4,1-6,1/,10-14,2-locular,3-4,3-7,3-foliate,5-15-flower,<,absen,absent,accrescent,acroscopically,adpressed,allogamous,always,and/or,angeld,anthesi,apical,appearance,appendage,articulation,axi,basal,becoming,cente,column,composed,cone,cordate,deeply,eaf,edicel,eed,entire,erect,extending,facultatively,giving,glabrescent,gland-tipped,glandular,gree,half,included,initially,internode,lanceolate,larger,later,like,lobulate,lon,longer,lower,maturity,minutely,mixture,multicellular,multilocular,narrowly,nflorescence,numerous,one,pair,particularly,pentagonal,petiolule,population,reflexe,ruit,scen,secondary,sessile,shaggy,shaped,short,silky,somewhat,sparse,spreading,staminal,sterile,strong,strongly,tangled,tem,tertiary,tip,total,toward,trichome,truncate,ud,unicellular,uniseriate,unit,varying,winged,ympodial	'',1/3,[,``,arrangement,bark,berry,bud,characteristic,colour,corrugation,drying,exertion,form,glabrousnes,growth,height,history,leaf,life,lobing,midpoint,na,new,number,per,prickle,ray,seed,size,texture,thicknes,type,value,variation,vein,width,{,}
295	wfo-0001029226	success	206	130	104	102	26	0.505	-7,-9,.5,0.5-5,1-1.5,1-3,2-6,2.5-10,30,4,5-7,7-11,8-13,>,acuminate,acute,anther,anthesi,apex,base,berry,branched,bright,calyx,capitate,cm,conical,cordate,corolla,densely,diameter,dry,ellipsoid,entire,exserted,filament,flattened,flexuous,fruiting,glabrous,glandular,globose,growth,herbaceous,lateral,lavender,leaf,like,lobed,long,lyrate,many,margin,material,minute,minutely,mm,new,occasionally,open,pair,pale,pedicel,peduncle,per,petiole,pinnatifid,pitted,primary,pubescent,red,reniform,seed,short-glandular,shrub,simple,slender,sparsely,spreading,stem,stigma,strongly,style,surface,tan,terminal,time,translucent,trichome,truncate,tube,uniformly,uniseriate,usually,vein,vine,way,weak,white,wide,winged,woody,yellowish,Â¾	.75,0-1,0.5,1-2,1-celled,10-40+,2,2-3,2-9,3-3.5,3-6,4-6,5-merou,ag,alyx,apart,apparently,ark,articulated,ba,basal,black,blue,breaking,cell,completely,congested,connivent,dark,decurrent,deltate,distall,divided,eaf,eed,elongate,enation,flower,free,glabrescent,gland,green,hairy,ilament,irregularly,juice,lengthening,lobe,longer,loosely,lower,mature,membranous,mere,nflorescence,often,older,one,orolla,overtopping,papillat,papillate,papillo,perfect,pinnate,plurifoliat,pore,poricidal,portion,reflexed,remainin,rim,ripe,ruit,sagittate,scar,scarlet,shiny,shorter,sleeve,slit,small,sometimes,spaced,spot,sprawling,spreadin,staining,stellate,tangled,tem,testal,thin,third,tip,twinin,ud,unit,vary,wall,widest,ympodial	arrangement,bark,branch,bud,characteristic,colour,corrugation,drying,exertion,form,fruit,glabrousnes,height,history,inflorescence,length,life,lobing,na,number,ovary,plant,shape,size,texture,type
296	wfo-0001029236	success	159	133	102	57	31	0.642	.5,0.2-0.7,0.2-1,0.45-0.5,0.5,0.5-1.5,0.9-2.3,1-1.5,1-2,1.4-1.7,1/2,3,6-9,absent,adaxial,anther,anthesi,apex,apical,apically,appearing,bark,basal,base,berry,branch,calyx,cm,conical,coriaceous,corolla,deflexed,dendritic,densely,diameter,elliptic,erect,except,exserted,filament,flattened,fleshy,fruit,fruiting,glabrous,globose,grey-brown,growth,later,lateral,leaf,lenticular,less,lobed,long,margin,middle,midvein,minutely,mm,narrowly,near,nodding,obscure,obscurely,occasionally,ovary,overtopping,pale,pedicel,per,persistent,petiole,pitted,pointed,poricidal,pubescent,purplish,purplish-black,reddish-brown,revolute,scattered,shiny,shoot,short,shrub,slightly,stem,stigma,strongly,style,surface,tapering,terminal,tip,trichome,tube,usually,violet,way,wide,x	2-4,2-5,abaxially,age,apparently,axi,ba,becoming,bi-lobe,branching,branchlet,broadly,compact,completely,cupulate,decurrent,deltate,dichasial,eaf,edicel,eed,ew,flower,free,inserted,lobe,lower,m.,many,nflorescence,older,packe,pericarp,plurifoliate,pore,portion,prominent,ruit,scar,secondary,simple,sleeve,slit-like,sparsely,stamen,tall,thin,time,trongly,tub,ud,unit,venation,winged,woody,ympodial,young	arrangement,bi-lobed,bud,characteristic,colour,corrugation,decurren,drying,exertion,form,glabrousnes,height,history,inflorescence,length,life,lobing,na,new,number,packed,peduncle,perennial,plant,primary,seed,shape,size,texture,type,vein
297	wfo-0001029246	success	209	135	108	101	27	0.517	-1,-1.5,-4,/5,0,0-15,0-5,0.1-0.4,0.3-0.8,0.7-1.3,0.7-2,0.8-1.1,0.8-3,0.9-1.3,1-1.5,1-1.8,1.2-2,1.5-2.3,1.5-2.5,1.7-6,1/3,2,2-3,2.5-3.2,2.8-4,3-5,3.5-5,5-20,7-12,acuminate,acute,anther,apex,apparently,articulated,bark,base,berry,calyx,chartaceous,cm,concolorous,connivent,cuneate,densely,diameter,discolorous,drying,dull,elliptic,entire,erect,filament,flattened-reniform,flower,fruit,fruiting,glabrous,lateral,leaf,length,less,lobed,long,lower,margin,maturity,mauve,midvein,mm,moderately,obtuse,orange-brown,orange-red,pair,pale,pedicel,peduncle,per,petiole,poricidal,prickle,prickly,primary,procumbent,purple,recurved,shrub,simple,sometimes,sparsely,spherical,stellate,stellate-pubescent,stem,style,surface,tapering,terete,tip,tube,unbranched,upper,vein,way,white,wide,yellow	0.1-0.3,0.15-0.3,0.2-1.5,0.3-0.5,0.5,0.5-1.5,0.7-1.5,1-10,1-3,1-4,1-5,1-8,1.5-6,1.8-3,1/10-1/5,2-3.5,2-5,2/3,2/3-3/,3-20,4-6,5-,5-merous,6-10,6-8,8-16,abaxial,abaxially,acuminat,adaxial,almost,alyx,apar,apart,apically,blade,broad-deltate,c.,curved,deltate,distance,eaf,eed,elongating,equal,extending,eye,flattened,free,glabrescent,infructescence,lobe,lon,longer,mature,midpoint,naked,narrow-deltate,narrow-ovate,nflorescence,oblong,older,one,open,orange-brow,orolla,oung,pendulous,perfec,pericarp,plurifoliat,porrect,portion,prickl,pubescent,ray,rounded,ruit,scar,sessile,side,smooth,spaced,spreading,stout,straight,strongly,tamen,tertiary,time,trichome,unarmed,unit,usually,vary,venation,visible,woody,yellow-orange,ympodial,Â¼	2/3-3/4,arrangement,branch,bud,characteristic,colour,corolla,exertion,form,glabrousnes,growth,height,history,inflorescence,life,lobing,na,new,number,ovary,plant,seed,shape,size,stigma,texture,type
298	wfo-0001029286	success	224	129	85	139	44	0.379	1-2,1.5-2,1.5-4,1/8,15-50,2-3,2.5-3,3-4,4-5,4-6,4.5,4.5-7,5,5-6,6-8,6-9,7-10,acute,almost,anther,anthesi,apex,apically,apiculate,attenuate,bark,base,branch,branching,broadly,brown,canaliculate,capitate,chartaceous,clustered,cm,concolorous,conical,corolla,diameter,dilated,drying,entire,filament,flexuous,flower,glabrous,green,grey,leaf,length,less,liana,light,lilac,lobe,long,margin,mauve,membranous,minutely,mm,obconical,oblong,obovate,pair,pedicel,peduncle,petiole,primary,prominent,stem,stigma,style,surface,terete,terminal,time,tip,tube,unarmed,vein,widely,x,yellowish	.4,.5,0-0.5,0.1,0.15-0.4,0.4-1.2,0.6-1.2,0.8,0Â°,1-1.5,1.5-8,abaxial,abaxially,abscising,adaxially,age,along,altered,alyx,another,apar,apart,apice,apparently,arising,around,articulated,articulation,axil,becoming,branched,clearly,closer,concave,crenulate,curved,cuspidate,delineated,deltoid,dendritic,density,distributed,domatia,eaf,eed,equal,except,extending,faint,fertilization,flat,formed,forming,free,fresh,glabrescent,globo,hair,increasing,inflorescenc,inside,isolated,junction,know,known,lamina,lengthening,lobed,lower,m.,main,margi,mas,meeting,middle,midvein,much,multicellular,narrowly,nflorescence,nther,occasional,often,one,orolla,outside,ovate,papillo,perfec,plurifoliat,pore,poricidal,portion,protruding,rachi,raised,rarely,regular,rounded,ruit,scar,separated,shallowly,side,simple,slender,smaller,smooth,sometimes,somewhat,soon,sparsely,specimen,spreading,stretchy,stump,tangled,tearing,tertiary,textur,thick,thickened,thinner,tissue,together,toward,translucent,translucent-violet,trichome,tuft,ud,uneven,unit,vary,venation,visible,wide,ympodial,young	appearance,arrangement,border,bud,calyx,characteristic,colour,corrugation,distal,exertion,form,fruit,fruiting,giving,glabrousnes,globose,growth,height,history,inflorescence,interjected,lateral,leaflet,life,lobing,midpoint,na,new,number,ovary,papillose,per,plant,prickle,pseudostipule,ray,seed,shape,size,texture,thicknes,type,variation,width
299	wfo-0001029310	success	216	170	141	75	29	0.653	-16,-25,.5,/4,0-20,0-5,0.1-0.2,0.2-0.8,0.5,0.5-3,0.6-1.1,00,1-1.5,1-2,1.2-1.5,1.8-3,10-13,10-15,15-20,2-3.5,2-4,2.5-6,2/3-3/4,20-40,3-4,3-5,3.5,4-10,5-10,5-12,5-20,5-30,5-7,6-8,abaxially,acute,anther,apart,apex,apically,apparently,articulated,bark,base,berry,branched,brown,calyx,cm,concolorous,conical,connivent,cordate,dark,diameter,distance,drying,dull,elliptic,erect,extending,filament,flattened-reniform,flower,fruit,fruiting,glabrescent,glabrous,gray,hair,herb,lateral,leaf,length,lobe,lobed,lobing,long,long-styled,lower,margin,maturity,mauve,membranous,midpoint,midvein,mm,moderately,narrow-deltate,one,open,orange-green,ornately,pair,pedicel,peduncle,pendent,per,perpendicular,petiole,pinnatifid,plant,poricidal,porrect,prickle,prickly,primary,ray,retrorse,secondary,sessile,short-styled,shorter,shrub,side,simple,sometimes,spaced,sparsely,spherical,stalk,stalked,stellate-pubescent,stem,straight,style,surface,tapering,terete,tertiary,time,tip,toward,trichome,truncate,tube,variously,vein,way,wide,yellow	.1,.6,/6,0.2-0.3,1,1-4,1/,10,10-20,20-60,200-500,4-8,45-60,5,5-6,5-8,5-merous,7-12,7-13,8,accrescent,alyx,ame,andromonoecious,apar,beyond,blade,c.,deltate,difoliate,distal,eaf,eed,elongating,enclosing,equal,filifor,free,geminat,gently,hermaphrodite,heterostylous,inflated,infructescence,lon,longer,lowermost,mature,minute,nflorescence,older,orolla,oung,pendulous,pericarp,portion,prickl,recurved,red-brow,ruit,scar,smooth,spreading,staminat,stellate,stout,strongly,tamen,tissue,unit,vary,venation,visible,woody,ympodial	1/3,arrangement,branch,bud,characteristic,colour,corolla,corrugation,exertion,filiform,form,glabrousnes,growth,height,history,inflorescence,life,na,new,number,ovary,perennial,red-brown,seed,shape,size,stigma,texture,type
300	wfo-0001029317	success	151	125	77	74	48	0.51	.5,0.5,0.8-1,1-1.5,10-16,10-30-flowered,11-14,2-3,2.5-5,7-8,8-9,acuminate,anther,apex,area,attenuate,barely,base,broadly,bud,ca,calyx,channeled,cm,corolla,cup-like,dry,erect,exserted,filament,fruiting,glabrate,glabrous,globose,grayish,immature,inflorescence,lateral,leaf,lobe,lobed,long,main,margin,minutely,mm,narrowly,nearly,ovary,ovate,pair,papillose,pedicel,petiole,poricidal,probably,pubescent,shrub,simple,size,slender,soon,specimen,stem,stigma,straight,style,tapering,tip,trichome,tube,uniseriate,vein,visible,white,x,yellowish	0.25,0.5-0.75,0.5-1,1,1.5-3.5,6-8,6.5-11,along,anthesi,apar,beneath,brow,closely,deciduou,deflexed,deltoid,densely,denser,dia,differing,difoliate,eaf,edicel,eed,ellipsoi,epidermi,extreme,free,frui,geminate,known,like,lon,lower,major,middle,minor,nflorescence,occasionally,often,older,one,opposite,otherwise,overlapping,ovoid,paler,pore,portion,prominent,proximal,rachi,raised,reflexed,remaining,rest,rounded,ruit,scar,shaped,slightly,soft,spaced,sparsely,styl,tall,tear-drop,thickened,tuft,ud,unit,widest,ympodial,young	.25,alternate,appearance,arrangement,bark,border,brown,characteristic,colour,corrugation,diameter,distal,drying,exertion,form,fruit,giving,glabrousnes,growth,height,history,interjected,leaflet,length,life,lobing,mentioned,midpoint,na,new,number,peduncle,per,perennial,plant,prickle,primary,pseudostipule,ray,seed,shape,surface,terminal,texture,thicknes,type,variation,width
301	wfo-0001029332	success	197	138	99	98	39	0.503	0-2,0-20,0-4,0.5-1,0.8-1,1-2,1-3,1-4,1.3-1.5,1.5-2,1/2,1/3,2,2-2.5,2.5-3.5,2.8-3.7,2/3-3/4,3-6,4-15,5-6,5-8,6-8,abaxially,anther,apart,apex,apparently,articulated,bark,base,berry,calyx,chartaceous,cm,concolorous,conical,connivent,cordate,curved,densely,diameter,distal,drying,erect,filament,flattened,flattened-reniform,fruit,fruiting,glabrous,lateral,leaf,length,lobe,lobed,long,lower,margin,maturity,mauve,mm,moderately,orange-brown,ovate,pair,pale,pedicel,peduncle,per,petiole,plant,poricidal,prickle,prickly,primary,pubescent,rounded,shrub,simple,spaced,spherical,spreading,stellate,stellate-pubescent,stem,style,surface,tapering,terminal,tip,tube,upper,vein,way,weakly,wide,yellow,yellow-green,yellow-orange	-5,.5,/3,0,0-0.5,0-100,0-5,0.1,0.1-0.2,0.15-0.2,0.15-0.25,1-1.5,1/4,1/4-1/3,10-30,2-4,2/,3-4,3.5-5,4-10,5-merous,8.5-9.5,abaxial,adaxial,alyx,andromonoecious,apar,apically,becoming,blade,broad-deltate,difoliate,distance,eaf,eed,elongating,equal,extending,flower,free,geminat,glabrescent,gland,globular,grayi,herbaceous,hermaphrodite,heterostylous,infructescence,less,long-acuminat,long-styled,longer,lowermost,mature,midpoint,midvein,narrow-deltate,nflorescence,often,older,one,open,orolla,oung,pendulous,pericarp,porrect,portion,prickl,ray,reduced,ruit,scandent,scar,sessile,short-styled,shorter,side,slender,smooth,stalk,stalked,staminat,subsessile,tamen,terete,tertiary,time,trichome,unbranched,unit,variously,vary,venation,visible,woody,ympodial	1.5,2/3,50-100,appearance,arrangement,border,branch,bud,characteristic,colour,corolla,corrugation,exertion,form,giving,glabrousnes,grayish,growth,height,history,inflorescence,interjected,leaflet,life,lobing,na,new,number,ovary,perennial,pseudostipule,seed,shape,size,stigma,texture,type,variation,width
302	wfo-0001029333	success	155	114	86	69	28	0.555	.25,.5,/4,0.7-1,1-1.2,1-1.5,1-15,1-3,1-7,1.5-2.5,10-15-flowered,17-26,5-6,8-15,9-13,abaxially,acuminate,acute,adaxially,anther,apex,auriculate,bark,base,berry,broadly,calyx,clavate,cm,conical,corolla,dendritic,densely,dia,elliptic-obovate,exserted,filament,flattened-reniform,fruiting,glabrous,globose,green,incrassate,lateral,leaf,lobed,long,long-styled,main,margin,minutely,mm,obovate,occasionally,ovary,pair,pale,paler,pedicel,petiole,pitted,pubescent,reddish-brown,sessile,shape,shaped,shining,short-styled,shrub,simple,size,somewhat,stem,stigma,strongly,style,surface,tear-drop,time,trichome,truncate,tube,type,vein,way,wide	0.5,0.5-1,1-2,1.5-2,1.5-3,100,2-2.5,3-7,3-7.5,abaxial,along,anisophyllou,anthesi,ba,beige,beneath,contracted,deflexed,dendritic-pubescent,denser,differing,difoliate,dry,eaf,edicel,eed,erect,flower,free,fresh,geminate,golden,heteromorphic,inflorescenc,like,lobe,lon,lower,major,minor,nflorescence,older,opposite,orbicular,overlappin,papillo,planar,pore,poricidal,portion,present,pubescence,rest,rounded,ruit,scar,slender,small,spaced,sparsely,tall,tip,tree,triangular,ud,unit,woody,ympodial,young	alternate,arrangement,branch,bud,characteristic,colour,corrugation,diameter,drying,exertion,form,fruit,glabrousnes,growth,height,history,inflorescence,length,life,lobing,na,new,peduncle,perennial,plant,primary,seed,texture
303	wfo-0001029334	invalid_json_followup	211	149	102	109	47	0.483	0-4,0.15-0.3,1,1-2,1-3,1.3-4.5,1.5-3.9,1.5-6,1.8-2.9,2-2.5,2-4,2.5-3,3.2-5.8,3.3-6.5,4-5.5,4-8.5,7.5-15.5,8-30,9-12,absent,acute,almost,anther,apex,articulated,attenuate,axillary,base,berry,brownish,bud,cell,chartaceous,clavate,cm,condition,connivent,cordate,corolla,covering,densely,diameter,distal,drying,filament,forked,fresh,fruit,generally,glabrous,globose,green,green-white,greenish,hair,half,herb,interjected,lanceolate,lateral,leaflet,like,lobe,long,make,margin,membranous,mm,mucilaginous,oblique,odd-pinnate,ovate,ovoid,pedicel,peduncle,petiole,plant,puberulent,pubescent,pure,ripe,rounded,seed,size,stem,stigma,style,subtending,terminal,testal,thick,throughout,tinged,tube,usually,violet,wall,wet,white,whitish,wide,x	.2,1-10,1-6,2,2-5,2-8,3-5,3-7,5-10,5-merou,abaxially,acumen,adaxially,ag,along,alyx,among,apart,apparently,axe,blade,borne,broadly,capitat,ciliate,cuneate,decreasing,decurrent,digestion,dorsally,eaf,edge,eed,elliptic,end,enzyme,erect,especially,exceeding,except,flat,flower,folded,geminat,glabrou,gradually,grassland,greatly,hair-like,homostylous,honeycomb-shaped,lengthening,living,low-growin,lower,middl,midrib,minutely,narrowly,nflorescence,obtuse,often,orbicular,orolla,pair,perfect,petiolulate,petiolule,plurifoliate,pore,poricidal,proximal,rarely,reduced,removed,ruit,semi-rosette,sessile,seudostipule,shady,short,singly,situation,slightly,slit,spaced,specimen,stamen,ste,stellate,stolo,straight,subequal,subsessile,sunny,tall,tamen,tem,tip,toward,tri-,tuber,typically,unit,unwinged,vary,woodland,yellow,ympodial	'',[,\u201chair-like\u201d,``,appearance,arrangement,bark,branch,calyx,capitate,characteristic,colour,corrugation,exertion,form,giving,glabrousnes,growth,height,history,inflorescence,leaf,length,life,lobing,middle,midpoint,na,new,number,ovary,per,prickle,primary,pseudostipule,ray,shape,surface,texture,thicknes,type,value,variation,vein,width,{,}
304	wfo-0001029344	success	147	107	76	71	31	0.517	.5,0.4-1,0.5-1,0.5-3,1,1-5,1-6,1.5,1.5-4,10-20,10-35,4-6,5-12,5-15,absent,acute,anther,apex,base,berry,brown,calyx,center,chartaceous,ciliate,cm,densely,diameter,dm,drying,edge,elliptic,elliptic-ovoid,entire,filament,fine,flower,fruit,glabrous,globose,herb,immature,linear-lanceolate,margin,maturing,membranaceous,mm,moderately,nearly,oblong,obtuse,parallel,pedicel,peduncle,per,petiole,pubescent,radiating,raised,rhizomatous,ridge,rotate,rounded,running,semitransparent,shallow,short,sparsely,stigma,style,surface,tube,vein,white,x,yellow	0.5-1.5,1-2,1-3,1.5-3,2-3,2-3-celled,2-4,2-7,3-10,abaxially,abundant,adaxiall,adaxially,along,axe,beyond,blade,connected,cordate,decurrent,dehiscing,denser,difoliate,eaf,eed,emarginat,equal,explosively,exserted,flat,frui,geminat,hair,held,interpetalar,lacking,lobe,long,lower,lying,maturit,mesocarp,nflorescence,notch,obvious,often,one-,orolla,placenta,pressure,pubescen,rachi,ruit,slightly,sometimes,stamen,straight,swollen,tal,tamen,tem,tissue,triangular,two-celled,unbranched,unit,vary,watery,wid,woody,ympodial	arrangement,bud,characteristic,colour,corolla,corrugation,exertion,form,geminate,glabrousnes,growth,height,history,inflorescence,leaf,length,life,lobing,na,new,number,ovary,plant,primary,seed,shape,size,stem,texture,type,wide
305	wfo-0001029363	success	152	113	84	68	29	0.553	.75,/4,0-0.1,0.2-1.1,0.5-1,1-1.2,1.5-1.7,1.5-3.5,2-6,3-7,4-11,5-7-flowered,6-7,6-8,7-10,acuminate,acute,anther,anthesi,apex,bark,base,becoming,beneath,berry,bi-lobed,bud,calyx,capitate,cm,corolla,cup-shaped,deep,deflexed,densely,dia,drying,elliptic,exsertion,filament,fruit,fruiting,glabrous,globose,green,greyish,immature,lateral,leaf,lobed,long,main,margin,maroon,minutely,mm,narrowly,obtuse,ovary,pair,pale,pedicel,petiole,poricidal,pubescent,shiny,shrub,simple,small,sparsely,stem,stigma,style,surface,tapering,tip,tree,tube,vein,way,white,white-papillose,wide,yellowish	.25,0.1-0.5,0.5,1,axil,ba,beginning,closely,coroll,deltoid,eaf,edge,edicel,eed,erect,except,free,inflorescenc,internodal,known,lamina,larger,later,lobe,lon,lower,mature,meeting,middle,minute,much,near,nflorescence,occasionally,often,older,opposite,overlapping,paler,papillo,papillose,pore,portion,prominent,reflexed,ruit,scar,slender,slit-like,somewhat,spaced,sparse,straight,tall,terminal,thickened,trichome,tuft,ud,unifoliat,uniseriate,unit,upon,usually,widest,woody,ympodial,young	arrangement,branch,characteristic,colour,corrugation,diameter,exertion,form,glabrousnes,growth,height,history,inflorescence,length,life,lobing,na,new,number,peduncle,per,plant,primary,seed,shape,size,texture,type,unifoliate
306	wfo-0001029364	success	153	117	67	86	50	0.438	-2,0.2-0.5,1-3,1-5,1.5-2,10-27,3-4,4-9,5-11,5-9,6-8,8-15,?,acuminate,anther,apex,base,calyx,chartaceous,cm,corolla,cream,cuneate,diameter,distally,elliptic,entire,extra-axillary,filament,finger,flower,fruit,glabrous,gland-tipped,globose,green,greenish,hair,herb,immature,lobe,margin,minutely,mm,narrowly,pedicel,peduncle,petiole,puberulent,pubescent,sagittate,shrub,side,simple,sparsely,spot,stigma,strongly,style,tapered,triangular,tube,unbranched,unknown,vein,white,x	-3,-6,.5,1,1-,1-4,191.,2,2-,2-6,2-foliat,4-12,5-,7-9,8-10,abaxially,according,acute,adaxially,aggregate,apart,around,articulated,axe,ba,bitter,blade,blue,cell,center,color,connivent,curled,cylindrical,darker,deep,directed,distall,eaf,ed,fide,free,glandular-puberulen,inserted,long,lower,major,membranaceous,mesocarp,moderately,nearly,nflorescence,obtuse,orolla,ovate,part,perfect,pore,presence,present,puberulen,rachi,radiu,ripe,ruit,rusby,shallow,short-tomentose,shorter,small,spaced,stellate,stone,tal,tamen,tem,thecae,tightly,time,tomento,truncat,unit,vary,wide,yellow,ympodial	2-12,appearance,arrangement,bark,border,branch,bud,characteristic,colour,corrugation,distal,drying,exertion,form,giving,glabrousnes,growth,height,history,inflorescence,interjected,lateral,leaf,leaflet,length,life,lobing,midpoint,na,new,number,ovary,per,plant,prickle,primary,pseudostipule,ray,seed,shape,size,stem,surface,terminal,texture,thicknes,truncate,type,variation,width
307	wfo-0001029368	success	139	102	69	70	33	0.496	.2,.5,0.5-2,1.5-3,1.5-4,11-13,16-25,2-5,2.5-4,5-6,?,acuminate,acute,anther,anthesi,apex,bark,base,berry,broadly,calyx,capitate,closely,cm,corolla,crumpled,deflexed,dia,elliptic,erect,exserted,filament,fruit,fruiting,glabrous,globose,golden,green,herb,inflorescence,lanceolate,lateral,leaf,long,main,margin,minute,minutely,mm,ovary,parallel,pedicel,petiole,puberulent,shaped,shrub,simple,stem,stigma,straight,strongly,style,tear-drop,trichome,tube,uniseriate,vein,white,x	.25,0,0.9-1,1.5-1.6,1.5-2,abaxially,adaxially,along,apparently,bearing,bitter,borne,breaking,brow,coarse,conical,cup,densely,distal,eaf,edicel,eed,few-branched,fide,flattened,flower,free,half,indistinct,inflorescenc,internodal,known,lamina,leaving,like,lobe,lower,margi,middle,midrib,nflorescence,non-flower,obtuse,older,one,opposite,overlappin,pair,papillo,papillose,pore,poricidal,portion,reflexed,rest,ruit,scar,somewhat,spaced,tall,tip,ud,unifoliat,unit,upper,widest,winged,woody,ympodial,young	arrangement,branch,brown,bud,characteristic,colour,corrugation,diameter,drying,exertion,form,glabrousnes,growth,height,history,length,life,lobing,na,new,number,peduncle,per,perennial,plant,primary,seed,shape,size,surface,texture,type,unifoliate
308	wfo-0001029370	invalid_json_followup	224	174	131	93	43	0.585	-20,.3,0-100,0-35,0.5-1,0.5-2.2,1-2,1.5-6,1.8-2.5,1.8-2.8,1/4-1/3,10-17,2-3,2.5-3.5,3-4,3.5-4,3.5-8,4-6,4-9,5-12,5.5-7,7-13,8-14,8-23,almost,anther,apex,apically,apparently,articulated,bark,basal,base,berry,branched,broad-deltate,calyx,chartaceous,cm,conical,connivent,cordate,cream,curved,dark,densely,diameter,discolorous,distal,drying,elongate,erect,filament,fine,flattened,flattened-reniform,flower,fruit,fruiting,fully,green,greenish,herb,lateral,leaf,length,lobe,lobed,long,long-styled,lower,margin,marking,maturity,mauve,midpoint,mm,moderately,multangulate,obtuse,often,opening,orange,orange-brown,ornate,ovate,overlapping,pair,pale,pattern,pedicel,peduncle,per,petiole,plant,poricidal,prickle,prickly,primary,ray,red-brown,reticulate,rotate,rounded,shiny,short-styled,shrub,simple,slightly,smooth,sometimes,spherical,spreading,stalked,stellate-pubescent,stem,straight,strongly,style,surface,tapering,tip,trichome,tube,variously,vein,way,white,wide,yellow,young	-32,.1,.5,/4,0-10,0-3,0.1,0.1-0.15,0.2,0.3,1,1-3,1-4,1/3-1/2,10-40,10-50,12-17,15-30,2-10,2-20,2-6,3/,4-7,5-10,5-merous,6-15,7-11,8-20,abaxial,abaxially,acut,adaxial,alyx,ame,andromonoecious,apar,apart,blade,c.,clearly,distance,eaf,eed,elongating,equal,extending,fewer,free,gently,glabrescent,glabrous,hermaphrodite,heterostylous,infructescence,longer,lowermost,mature,midvein,mixture,nflorescence,older,one,open,orolla,oung,pendulous,pericarp,perpendicular,plurifoliat,porrect,portion,prickl,ruit,scar,sessile,side,spaced,stalk,staminat,stout,tamen,terete,tertiary,time,unarmed,unit,vary,venation,visible,white-gra,whitish,woody,ympodial	'',3/4,[,``,acute,arrangement,branch,bud,characteristic,colour,corolla,corrugation,exertion,form,glabrousnes,growth,height,history,inflorescence,interjected,leaflet,life,lobing,na,new,number,ovary,perennial,pseudostipule,seed,shape,size,stigma,terminal,texture,thicknes,type,value,variation,white-gray,width,{,}
309	wfo-0001029373	success	199	121	76	123	45	0.382	5,6.8,acute,anther,anthesi,apex,articulated,bark,base,berry,broadly,bud,calyx,clavate,cm,conical,corolla,curved,deltate,densely,diameter,ellipsoid,entire,filament,flattened-reniform,fruit,globose,green,grey-brown,growth,halfway,herb,internodal,lateral,leaf,less,lobe,long,margin,minute,minutely,mm,moderately,new,node,obtuse,ovary,ovate-lanceolate,pair,papillate,pedicel,peduncle,per,petiole,pitted,plant,primary,pubescent,rounded,shape,simple,slightly,stem,stigma,straight,style,surface,terete,tip,trailing,tube,vein,white,wide,woody,yellowish	.0â1.2,.2,.3,.5,.5â2.0,0.3â0.5,0.4â1.6,0.5â1.2,0.5â1.8,0.6â0.7,1.0â1.2,1.0â1.6,1.2â1.5,1.3â2.2,1.4â3.5,1.5â2.0,1.5â2.5,1.5â2.7,1.8â2.0,1.8â2.3,180Â°,2-celled,2.0â2.5,2.7â3.0,20â30,2â4-celled,3,3.5â4.0,30â40,3â5,4â5,4â6,5-merous,5â6,8â9,abaxial,abaxially,accrescent,acuminate,adaxial,adaxially,age,apar,appearanc,appressed,arising,basal,bayonet,beyond,capped,cell,cone,developing,distal,eaf,eed,elongate,enclosed,enclosing,exerted,finger,flower,free,fruiting,fully,geminat,glabrous,glandular-tipped,hair,half,hilum,immature,individual,laterally,lengthening,like,live,lobed,lon,lower,mature,mesocarp,middle,mouth,nflorescence,older,outline,pentagonal,perfect,plurifoliate,pore,poricidal,portion,positioned,reflexed,resembling,root,ruit,scar,seen,seudostipule,shallowly,short,slit,smoot,spaced,spreading,stellate,still,tall,tem,testal,thicker-walled,trichome,tub,ud,uniseriate,unit,upper,yellow,yellow-green,ympodial,â5	0.4-1.6,0.5-1.2,0.6-0.7,1.0-1.2,1.0-1.6,1.2-1.5,1.4-3.5,1.5-2.5,2.7-3.0,20-30,30-40,4-6,5-6,8-9,appearance,arrangement,border,branch,characteristic,colour,exertion,form,giving,glabrousnes,height,history,inflorescence,length,life,lobing,midpoint,na,number,prickle,pseudostipule,ray,rooting,seed,size,smooth,texture,thicknes,type,variation,width
310	wfo-0001029402	success	113	99	45	68	54	0.398	0.5-1,0.5-2,1-2.5,15-30,2,2-3,4-6,5-25,6-16,7-8,7-9,acute,apex,base,branched,calyx,ciliolate,cm,connivent,diameter,elliptic,flower,free,glabrous,inrolled,lanceolate,lobe,margin,mm,narrowly,often,pedicel,peduncle,petiole,shrub,simple,stigma,style,surface,tapered,thickened,tube,unknown,violet,x	11-17,2-10,3-4,3-5,3-6,4-7,4-8,7-11,8-15,abaxial,abaxially,acuminate,adaxially,apart,articulated,axe,band,blade,chartaceous,color,cylindrical,deltate,denser,directed,distall,eaf,eed,fleshy,forked,glabrate,glabrou,hair,leaving,long,lower,many-foliat,moderately,narrowed,nearly,nflorescence,nther,orolla,papillose,pore,pubescence,pubescent,rachi,rachise,radiu,roughened,ruit,scale-like,scar,somewhat,spaced,sparsely,stellate,tal,tem,time,tip,triangular,truncat,unit,unknow,vary,wide,ympodial	anther,appearance,arrangement,bark,border,branch,bud,characteristic,colour,corolla,corrugation,distal,drying,exertion,filament,form,fruit,fruiting,giving,glabrousnes,growth,height,history,inflorescence,interjected,lateral,leaf,leaflet,length,life,lobing,midpoint,na,new,number,ovary,per,plant,prickle,primary,pseudostipule,ray,seed,shape,size,stem,terminal,texture,thicknes,truncate,type,variation,vein,width
311	wfo-0001029404	invalid_json_followup	154	152	95	59	57	0.617	0-60-flower,0.5-1,1,1-4,2,2-3,2-5,2.5-22,2.5-3,20-35,3-4,3-8.5,5-10,5-20,5-24,6-8,6.5-34,abaxially,acuminate,acute,adaxially,anther,apex,apiculate,auriculate,basal,base,beyond,branched,calyx,center,chartaceous,cm,connivent,cordate,cream,dark,darker,deltate,densely,diameter,directed,distally,eglandular,ellipsoidal,entire,exserted,flattened,fleshy,flower,fruit,glabrous,glandular,green,hair,lanceolate,less,light,lobe,long,longitudinal,margin,mm,moderately,mottling,obtuse,orange,ovate,ovoid,pedicel,peduncle,perfect,petiole,pink,pore,puberulent,pubescent,purple,ripe,shrub,simple,somewhat,sparsely,star,stigma,style,toward,tree,triangular,tube,unbranched,vein,white,x,yellow	-1.5,-10,-3,-5,1.5-2,15-25,2-4,2-8,3-5,4-foliat,5-6,6-9,8-12,absent,aggregate,apart,ape,articulated,axe,blade,cell,connective,cylindrical,eaf,eed,glandular-puberulen,leaving,lemon,lon,lower,narrowly,nflorescence,nther,orang,orolla,pedicellar,presen,rachi,radiu,remnant,ruit,shorter,slightly,small,spaced,stellate,stone,subcoriaceous,tal,tem,thecae,time,tomento,truncat,ud,unit,vary,wide,ympodial	'',[,``,arrangement,bark,branch,bud,characteristic,colour,corolla,corrugation,distal,drying,exertion,filament,form,fruiting,glabrousnes,glandular-puberulent,growth,height,history,inflorescence,interjected,lateral,leaf,leaflet,length,life,lobing,midpoint,na,new,number,ovary,per,plant,prickle,primary,pseudostipule,ray,seed,shape,size,stem,surface,terminal,texture,thicknes,tomentose,truncate,type,value,variation,width,{,}
312	wfo-0001029406	success	136	138	91	45	47	0.669	0.5-1,0.6-1,0.7-1.5,1-1.5,1-10,1.5-2.2,1.5-2.5,2,2-11,2-3,2.5-3.5,28,30,4-18,4-6,7-12,abaxially,acute,adaxially,anther,apex,arachnoid,arachnoid-pubescent,bark,base,berry,broadly,brown,brownish,calyx,clavate,cm,conical,corolla,dark,deciduous,densely,dia,difoliate,elliptic,felt-like,filament,fruiting,glabrous,globose,grayish-brown,grayish-green,green,greenish-white,lateral,leaf,lilac,lobe,lobed,long,main,margin,matted,maturity,minutely,mm,nearly,ovary,ovoid,ovoid-reniform,pair,pale,pedicel,petiole,pitted,pubescent,shaped,shiny,shrub,size,slightly,small,soon,stem,stigma,style,surface,tear-drop,tinge,tree,trichome,tube,unit,vein,white,wide	.5,0.3-1,1-2,1.5-5,3-9,along,anthesi,ba,bullate,conspicuously,deflexed,deltate,differing,dry,eaf,eed,free,geminat,impressed,large,lenticel,lon,lower,major,middle,minor,occasionally,often,older,papillo,papillose,planar,pointed,population,pore,poricidal,portion,ruit,tall,tip,waxy,widest,woody,ympodial,young	1.5,appearance,arrangement,border,branch,bud,characteristic,colour,corrugation,diameter,distal,drying,exertion,form,fruit,geminate,giving,glabrousnes,growth,height,history,inflorescence,interjected,leaflet,length,life,lobing,midpoint,na,new,number,peduncle,per,plant,prickle,primary,pseudostipule,ray,seed,shape,sympodial,terminal,texture,thicknes,type,variation,width
313	wfo-0001029407	invalid_json_followup	208	158	114	94	44	0.548	-25,-6,-7,.5,/3,0-4,0.1-0.25,0.4-0.7,0.4-1,0.5-0.7,0.5-1.5,0.5-2,0.6-0.9,0.7-1.2,1-1.4,1-4,1-4.5,1.8-2.5,1/5,2-4,2.5-3,3-4,3-6,4-15,5-7,acute,almost,anther,apex,apparently,articulated,bark,base,berry,bright-red,calyx,cm,connivent,cuneate,curved,dark,densely,diameter,discolorous,drying,dull,elliptic,entire,erect,evenly,filament,flattened,flattened-reniform,fruit,fruiting,glabrous,gray-greenish,green,green-brown,lateral,leaf,length,lobe,lobed,long,margin,mature,maturity,mauve,midpoint,mm,moderately,obtuse,orange,orange-brown,ovate,pair,pale,pedicel,peduncle,per,petiole,poricidal,prickle,prickly,primary,pubescent,rarely,ray,rounded,shrub,simple,sometimes,sparsely,spherical,stellate,stellate-pubescent,stem,straw-yellow,strongly,style,surface,tapering,tip,tube,unbranched,upper,vein,way,white,wide,yellow,yellow-green,young	-10,-2,-4,0,0-15,0-2,0-5,0.1-0.2,0.15-0.4,0.2-0.3,0.6,1,1-2,1-3,1.5,1/3,1/3-1/2,1/8-1/5,2-3,2-5,3.5-4.5,4-9,4.5-6,5-merous,6-13,6-20,7-8,abaxial,abaxially,acut,adaxial,alyx,apar,apart,apically,blade,brow,chartaceous,deltate,difoliate,eaf,eed,elongating,equal,flower,free,geminat,geminate,glabrescent,infructescence,lengt,longer,lower,nflorescence,occasionally,older,one,open,orolla,oung,pendulous,perfec,pericarp,porrect,portion,prickl,recurved,reflexed,ruit,scar,sessile,shorter,side,slender,smooth,spaced,spreading,stalk,stalked,stout,straight,tamen,terete,tertiary,thick,time,trichome,unit,vary,venation,visible,weakly,woody,ympodial	'',10-15,[,``,arrangement,branch,brown,bud,characteristic,colour,corolla,corrugation,distal,exertion,form,glabrousnes,growth,height,history,inflorescence,interjected,leaflet,life,lobing,na,new,number,ovary,perennial,plant,pseudostipule,seed,shape,size,stigma,terminal,texture,thicknes,type,value,variation,width,{,}
314	wfo-0001029408	invalid_json_followup	244	165	120	124	45	0.492	0,0.2-0.3,0.7-1.2,0.9-1.3,0.9-1.6,1-8,1.1-1.5,1.4-1.9,1.5-3,1.7-2.4,1/2,11-31,2-12,2-5,2.2-3.7,2/3,3-5,4-14,4-20,5-6.5,7-12,abaxially,acute,adaxially,anther,anthesi,apex,barely,bark,base,becoming,berry,blade,blunt-tipped,branch,branched,broadly,brown,bud,calyx,clavate,cm,conical,continued,corolla,cuneate,dark,decurrent,deltoid,diameter,distal,due,elliptic,entire,exserted,filament,fleshy,flower,fruit,fruiting,glabrous,globose,gray,green,growth,honeycombed,lanate,lateral,leaf,length,lilac,long,long-attenuate,margin,midvein,mm,moderately,mostly,oblong,orbicular,ovate,pale,pedicel,peduncle,petiole,pubescent,purplish,rarely,ray,reniform,reticulate-punctate,ripe,short-attenuate,shrub,side,simple,slightly,small,stelliform,stem,stigma,style,subcampanulate,suborbicular,terete,time,tomentose,top,tree,tube,turbinate,unarmed,vein,velutinous,way,white,whitish,x,yellow,yellowish	-1.5,-10.5,-4.5,.2-3.5,/10,0-100,0.3-5,0.5-2.5,1.6-2.8,1.8-3.5,1/2-3/4,1/4,2-3.5,2-4,2.5-7,3.5-5,4-7.5,5-24,5-6,5-8,5-merou,accrescent,acuminate,adaxiall,ag,alyx,apart,apical-lateral,articulated,axe,axillary,ba,capitat,chartaceous,dehiscing,dendritic-echinoi,dendritic-multangulate,densely,develope,directed,distall,eaf,echinoi,echinoid,eed,extend,faintly,few-rayed,free,hair,high,homostylous,indument,inserted,interpetalar,introrse,lacking,lanceolate,large,lobe,lobed,long-,long-stalked,longitudinal,lower,m.,main,many,mixed,multangulate,near,nearly,nflorescence,obscured,obtuse,often,older,orolla,ovate-lanceolate,overlapping,part,partly,perfect,persistent,plurifoliate,pore,porrect-stellate,present,pseudo-terminal,rachi,rather,relatively,ribbed,rotate-stellate,ruit,runk,sessile,short-,short-stalked,slit,sometimes,spaced,stamen,subovate,suture,tamen,testa,thick,thick-stalked,thick-textured,thin-stalked,tissue,tomentu,tomentum,touching,toward,unarme,unit,usually,vary,well,wide,ympodial,young	'',5-merous,[,``,arrangement,capitate,characteristic,colour,corrugation,drying,exertion,form,glabrousnes,height,history,inflorescence,interjected,leaflet,life,lobing,midpoint,na,new,number,ovary,per,perennial,plant,prickle,primary,pseud-terminal,pseudostipule,seed,shape,size,surface,terminal,texture,thicknes,type,value,variation,width,{,}
315	wfo-0001029417	invalid_json_followup	213	170	125	88	45	0.587	.5,0-7,0.2-0.6,0.4-8,0.7-3,1-2,1-8,1.3-8,1.5-1.8,1.5-10,1.5-8,12,2.8-3.5,3-14,3-5,4-7,5-15,8-15,8-9,abaxially,acuminate,acute,adaxially,anther,apex,articulated,attenuate,axillary,base,basiscopic,berry,blue,brownish,bud,cell,central,chartaceous,clavate,cm,coarsely,condition,connivent,corolla,covering,dark,decurrent,deep,diameter,distal,dot,drying,erect,filament,forked,fresh,fruit,generally,glabrous,globose,green,green-white,greenish,hair,half,herb,interjected,lanceolate,lateral,leaflet,like,linear,lobe,long,make,margin,medium,membranous,minute,mm,moderately,mucilaginous,non-glandular,odd-pinnate,often,orbicular,ovate,ovoid,pedicel,peduncle,petiole,pilose,plant,pubescent,purple,ripe,scattered,seed,sessile,short,side,size,slightly,sometimes,star,stem,stigma,style,subtending,terminal,testal,thick,throughout,tinged,trichome,tube,typically,usually,violet,wall,wet,white,whitish,wide,widely,x	1,1-1.5,1-10,1-4,2-4,2.5-10,5-merou,6-11,acumen,ag,along,alyx,apart,apiculate,apparently,axe,blade,borne,broadly,capitat,ciliate,decreasing,digestion,dorsally,eaf,edge,eed,end,enzyme,erec,especially,exceeding,flat,flower,folded,geminat,glabrou,greatly,hair-like,hal,homostylous,honeycomb-shaped,lengthening,living,lower,lunate,midrib,minutely,narrowly,nflorescence,orolla,pair,pentagonal,perfect,petiolulate,plurifoliate,pore,poricidal,puberulent,rapidly,rarely,removed,rotate,rounded,ruit,seudostipule,short-petiolulate,singly,slit,spaced,specimen,stamen,ste,stolo,straight,subequal,tall,tamen,tem,tip,tri-,tuber,unit,unwinged,vary,wing,yellow,ympodial	'',[,\u201chair-like\u201d,``,arrangement,bark,branch,calyx,capitate,characteristic,colour,corrugation,exertion,form,fruiting,glabrousnes,growth,height,history,inflorescence,leaf,length,life,lobing,midpoint,na,new,number,ovary,per,prickle,primary,pseudostipule,ray,shape,surface,texture,thicknes,type,value,variation,vein,width,{,}
316	wfo-0001029461	invalid_json_followup	217	156	111	106	45	0.512	-1.5,-3,-3.2,-5,.5,0.1-0.25,0.6-1,0.7-1,0.8-1.5,1-,1-1.6,1.2-1.7,1.2-1.8,1.3-2.2,1.5-,1/4-1/2,2-2.4,2-2.8,2-4,2.5-3,3-20,3-6,4.5-7,5-10,5-25,7-10,almost,anther,apart,apex,attenuate,bark,base,becoming,berry,black,broad-deltate,brown,calyx,cell,chartaceous,cm,concolorous,cuneate,dark,densely,diameter,discolorous,distal,drying,dull,elliptic,evenly,filament,fine,flattened-reniform,fruit,fruiting,glabrous,green,leaf,length,lobe,lobed,long,margin,maturity,mauve,midpoint,mm,moderately,oblong,orange,outline,ovate,pair,pedicel,per,petiole,pit,plant,poricidal,prickle,prickly,primary,raised,ray,reddish,rounded,shiny,shrub,simple,small,smooth,sometimes,spaced,sparsely,spherical,stellate-pubescent,stem,style,subentire,surface,tip,tube,vein,way,weakly,wide,yellow,young	-14,-2,-3/4,-4,-4.5,0,0.1,0.15-0.25,0.8,1-2,1-3,1-4,1-6,1.5-2,1/3,1/3-2/3,1/4,2-3,4-10,4-6.5,4-7,4.7-7.2,5-merous,7-12,8-9,abaxially,acuminat,alyx,ame,andromonoecious,apically,blade,breaking,brittle,c.,curved,distance,eaf,eed,elongating,erect,extending,faint,fifth,flattened,flower,four,free,glabrescent,gra,hermaphrodite,heterostylous,infructescence,lengt,long-styled,longer,lower,lowermost,mature,midvein,obovate,obtuse,older,orolla,oung,pendulous,pericarp,plurifoliat,porrect,portion,prickl,reduced,reflexed,ruit,sessile,shallow,short-styled,shorter,side,slender,slightly,spreading,stalk,stalked,staman,staminat,stellate,straight,strongly,tamen,terete,tertiary,time,trichome,unarme,unarmed,unequal,unit,upper,variously,vary,venation,visible,woody,ympodial,zygomorphic	'',1,[,``,appearance,arrangement,branch,bud,characteristic,colour,corolla,corrugation,exertion,form,giving,glabrousnes,gray,growth,height,history,inflorescence,interjected,lateral,leaflet,life,lobing,na,new,number,ovary,peduncle,pseudostipule,seed,shape,size,stigma,terminal,texture,thicknes,type,value,variation,width,{,}
317	wfo-0001029462	success	166	110	70	96	40	0.422	-30,-4,0.5-1,0.5-2,1-3,1-6,1.5-7,10-,15-25,2-6.5,2.5-3.5,2.5-5.5,3-18,4-20,6-9,acuminate,acute,apex,base,calyx,chartaceous,cm,connivent,cuneate,curled,dark,densely,diameter,eglandular,ellipsoidal,elliptic,entire,flattened,flower,fruit,glabrous,green,hair,lanceolate,laterally,light,longitudinal,margin,membranaceous,mm,narrowly,obtuse,ovate,ovoid,pedicel,peduncle,petiole,pubescent-pilose,purplish,reticulate,rounded,simple,smooth,somewhat,stigma,stripe,style,tip,tree,triangular,truncate,tube,unbranched,white,x	-2,-5,1,1-,1-2,1.5,1.5-2,1.5-3,10-22,2-3,20-35,3,3-27,3-4,3-5,3-6,3-7,4-15,4-foliat,5-30,7-19,7-8,8-9,abaxially,abruptly,absent,adaxially,aggregate,apart,ape,articulated,axe,basal,beyond,blade,broad,campanulate,cell,ciliate,connective,constricted,cylindrical,dentate,directed,eaf,eed,equal,exceeding,exserted,leaving,lobe,lon,long,lower,m.,minutely,moderately,near,nflorescence,nther,occasionally,often,orolla,oval,pedicellar,perfect,pore,puberulent,pubescent,pubescent-pilo,purpl,rachi,radiu,remnant,ruit,shorter,slightly,small,spaced,sparsely,stamen,stellate-,stone,tal,tem,thecae,time,tomentose,truncat,ud,unit,vary,wide,without,yellow,ympodial	anther,arrangement,bark,branch,bud,characteristic,colour,corolla,corrugation,drying,exertion,filament,form,fruiting,glabrousnes,growth,height,history,inflorescence,leaf,length,life,lobing,na,new,number,ovary,per,perennial,plant,primary,seed,shape,size,stellate-campanulate,stem,surface,texture,type,vein
318	wfo-0001029464	invalid_json_followup	235	162	123	112	39	0.523	.9,0-80,0.2-0.5,0.2-0.7,0.8-2,00-200,1-10,1-3,1.2-3,1/4-1/2,10-23,10-40,2-3,2-3.5,2-4,2.2-2.5,2.4-4,2.5-5,2.5-8,2.9-3.2,3-20,3-7,4-7,5.5-6,5.5-7.5,6-15,7-10,9-15,abaxially,acicular,acute,annual,anther,apex,apparently,bark,base,berry,black,branched,brown,calyx,chartaceous,cm,connivent,cordate,curved,dark,diameter,discolorous,distal,drying,ellipsoid,erect,filament,flattened-reniform,flower,fruit,fruiting,glabrescent,globular,green,green-brown,herb,lateral,leaf,length,lobed,long,long-styled,lower,margin,maroon,maturity,mauve,midpoint,mm,moderately,mottled,oblong,obtuse,occasionally,orange-brown,ovate,ovoid,pair,pedicel,peduncle,pendent,per,petiole,pink,plant,poricidal,prickle,prickly,primary,purple,ray,red-brown,short-styled,simple,sometimes,stellate-pubescent,stem,straight,striped,style,surface,tapering,terete,terminal,tip,tube,unarmed,usually,variously,vein,way,white,wide,yellow-green,young	-2/3,-3,-30,-5,0,0-2,0.2,0.3-0.7,0.3-1,0.5,0.5-2,1,1-8,1.5-2,1/,1/4,1/4-1/3,10-15,10-50,12-50,2,3-5,3.5-5,4-8,4-8-merous,5-17,5-8,8-13,8-15,abaxial,adaxial,alyx,ame,andromonoecious,apar,apart,apically,around,articulated,blade,broad,broad-deltate,brow,c.,cultivar,cup-shaped,deltate,difoliate,distance,eaf,eed,elongated,elongating,equal,extending,free,fully,geminat,glabrous,glaucous,hair,hermaphrodite,heterostylous,infructescence,less,lobe,long-acuminat,longer,lowermost,mature,midvein,minute,narrow-deltate,nflorescence,often,older,one,open,opening,orolla,oung,pendulous,pericarp,porrect,portion,prickl,rounded,ruit,scar,sessile,side,smooth,spaced,sparsely,spreading,stalk,stalked,staminat,stellate,tamen,tertiary,time,translucent,trichome,unit,upper,vary,venation,visible,woody,yellow-orange,ympodial	'',1/2,[,``,arrangement,branch,bud,characteristic,colour,corolla,corrugation,exertion,form,glabrousnes,growth,height,history,inflorescence,interjected,leaflet,life,lobing,na,new,number,ovary,pseudostipule,seed,shape,size,stigma,texture,thicknes,type,value,variation,width,{,}
319	wfo-0001029546	invalid_json_followup	203	186	140	63	46	0.69	0.3-1,1-2,1-3.2,1-4.5,1-5,1.5-2,1.5-6.2,1.6-6.5,2-9,2.2-2.8,3.5-5,4.5-12.5,4.5-7,5,5-10,5-18,5-8,6.3-19.5,7-10,8,8-17,8-19.5,abaxially,absent,acumen,acuminate,acute,adaxially,anther,apex,apiculate,apparently,attenuate,axe,axillary,base,berry,blue,brownish,bud,cell,chartaceous,clavate,cm,condition,connivent,cordate,corolla,covered,covering,curved,decurrent,densely,diameter,distal,dot,drying,elliptical,erect,filament,flower,forked,frequently,fresh,fruit,generally,glabrous,glandular,globose,green,green-white,greenish,hair,hair-like,half,herb,interjected,lanceolate,lateral,leaf,leaflet,lengthening,like,lobe,long,longer,make,membranous,mm,mucilaginous,non-glandular,oblique,odd-pinnate,often,ovoid,pedicel,peduncle,perfect,petiole,petiolule,plant,pore,poricidal,pubescent,purple,rarely,regular,ripe,seed,sessile,short,simple,size,slightly,slit,soft,stem,stigma,straight,style,subtending,terminal,testal,thick,throughout,tinged,tip,trichome,tube,typically,unwinged,usually,wall,wet,white,whitish,wide,wing,x,yellow	0-2,1-10,2-4,3-8,4-10,5-merou,adaxiall,ag,alyx,apart,articulated,blade,broadly,capitat,decreasing,decumben,digestion,dorsally,eaf,edge,eed,elliptic,enzyme,exceeding,flat,folded,geminat,glabrou,greatly,homostylous,honeycomb-shaped,living,lower,lunate,middl,minutely,mottle,nearly,nflorescence,orbicular,ovate,pair,pentagonal,plurifoliate,rachi,removed,rotate-pentagonal,ruit,seudostipule,sometimes,spaced,specimen,stamen,ste,subequal,tall,tamen,tem,tri-,truncate,unit,vary,ympodial	'',[,``,age,arrangement,bark,branch,calyx,capitate,characteristic,colour,corrugation,decumbent,exertion,form,fruiting,glabrousnes,growth,height,history,inflorescence,length,life,lobing,margin,midpoint,mottled,na,new,number,ovary,per,primary,pseudostipule,ray,shape,surface,texture,thicknes,type,value,variation,vein,width,{,}
320	wfo-0001029552	success	161	136	107	54	29	0.665	.25,.5,0.6-1,1-1.3,1-1.5,1-2,1-3,1-5,10-20,12,2-2.5,2.5-3,5-10-flowered,5.5-8,6-9,abaxially,abruptly,acuminate,acute,adaxially,along,anther,apex,area,bark,base,berry,branched,broadened,calyx,cm,conical,contracted,corolla,deflexed,dendritic,densely,dia,difoliate,drying,elliptic,erect,exserted,filament,flattened-reniform,flower,fruiting,glabrous,globose,green,incrassate,inflorescence,later,lateral,leaf,like,lobed,long,long-styled,main,margin,minute,minutely,mm,nearly,occasionally,older,onto,opposite,ovary,pair,pale,paler,pedicel,persistent,petiole,pitted,pubescent,shape,shaped,shining,short-styled,shrub,simple,size,slender,small,sparsely,stem,stigma,strongly,style,surface,tan,tear-drop,tip,tree,tree-like,trichome,tube,unit,vein,white,wide,x,yellowish,young	0.1-0.5,0.5,1.5-2,1.5-6.5,2-9,abaxial,anthesi,broadly,clavate,closely,decurrent,deltate,denser,differing,eaf,edicel,eed,free,geminat,greyish-brow,heteromorphic,inflorescenc,lamina,lobe,lon,lower,major,middle,minor,nflorescence,orbicular,overlappin,papillo,planar,pore,poricidal,portion,present,reflexed,rest,rounded,ruit,scar,scattered,slightly,somewhat,spaced,swollen,tall,tub,ud,widest,woody,ympodial	arrangement,branch,bud,characteristic,colour,corrugation,diameter,exertion,form,fruit,geminate,glabrousnes,greyish-brown,growth,height,history,length,life,lobing,na,new,peduncle,perennial,plant,primary,seed,sympodial,texture,type
321	wfo-0001029584	invalid_json_followup	180	148	98	82	50	0.544	0-30,1,1-2,1-6,1.5-6.5,16.2-33,2-3,2-4,2.4-6.3,3-10,3-7,4-14,5.3-13.3,6-7,6.1-9.4,8-15,9.7-23.4,9.8-17,abaxially,acuminate,acute,adaxially,anther,apex,asymmetric,axillary,base,basiscopic,brownish,bud,cell,clavate,cm,condition,coriaceous,corolla,covering,dark,densely,diameter,distal,drying,elliptic,filament,forked,fresh,fruit,generally,glabrescent,glabrous,green,green-white,greenish,hair,half,herb,interjected,lateral,leaf,leaflet,light,lobe,make,margin,mm,mucilaginous,oblong-lanceolate,odd-pinnate,ovate,ovoid,pedicel,peduncle,petiole,petiolulate,plant,pubescent,purple,seed,short,side,simple,size,stigma,style,subtending,terminal,testal,thick,throughout,tissue,tube,unwinged,usually,wall,wet,white,whitish,x	1-3,3-5,4-15,4-5,4.5-11.5,5-merou,7-14,acumen,ag,alyx,apart,apparently,articulated,attenuate,axe,blade,borne,capitat,connivent,considerably,decreasing,dense,digestion,dorsally,eaf,edge,eed,end,enzyme,erry,finer,flat,flower,folded,geminat,hair-like,hal,homostylous,honeycomb-shaped,larger,lengthening,linear,living,long,lower,middle,nflorescence,orbicular,orolla,pair,pentagonal,perfect,plurifoliate,pore,poricidal,present,proximal,removed,second,semi-erec,sessile,seudostipule,singly,slit,spaced,specimen,stolo,straight,substellate,tall,tamen,tem,tip,toward,tri-,tuber,typically,unit,unknow,vary,yellow,ympodial	'',[,\u201chair-like\u201d,``,appearance,arrangement,bark,berry,border,branch,calyx,capitate,characteristic,colour,corrugation,exertion,form,fruiting,giving,glabrousnes,growth,height,history,inflorescence,length,life,lobing,midpoint,na,new,number,ovary,per,prickle,primary,pseudostipule,ray,semi-erect,shape,stem,surface,texture,thicknes,type,value,variation,vein,width,{,}
322	wfo-0001029593	invalid_json_followup	181	163	117	64	46	0.646	-10,0.05,0.5-1,0.5-5,0.8-1,0.8-1.2,1,1-1.2,1-1.5,1-8,1.6-2.3,10-50,100,2-14,2.3,2.3-3.0,3-4,3.5-8,35-60,4-6,5-10,5-15,7-25,7.5-15,9-15,abaxially,abruptly,acuminate,acute,anther,anthesi,apex,apically,arising,attenuate,axil,axillary,base,basiscopically,bearing,berry,broadly,brown,calyx,capitate,cm,conical,deltate,densely,diameter,dry,drying,elliptic,enlarged,extremely,filament,filiform,flower,fruit,fruiting,glabrous,globose,green,half,hollow,lateral,leaf,leaflet,long,lower,markedly,minutely,mm,narrowing,oblique,obovate,occasionally,once-branched,ovary,ovoid-reniform,pair,papillose,pedicel,per,petiole,pinnate,plant,pointed,poricidal,primary,pubescence,pubescent,rest,scar,seed,shape,shrub,simple,slightly,smooth,somewhat,sparsely,stigma,style,surface,terminal,tip,trichome,tube,uniseriate,usually,variable,vein,white,white-lenticellate,woody,x	1-2,2,2-3,2-5,adaxially,age,always,anticlinal,basal,cateniform,cell,clavat,colony,cone,decurrent,eaf,edicel,eed,entire,epidermal,exserted,free,glabrescent,growing,included,irregular,lamina,large,lobe,much,nflorescence,noddin,often,onto,open,opposite,perfectly,petiolule,place,portion,projection,pubescen,purple,rachi,rarely,reflecting,ruit,short-styled,similar,single-stemmed,sinuous,small,smaller,tall,tem,thickening,tub,ud,unifoliat,unit,wider,winged,without,ympodial	'',[,``,arrangement,bark,branch,bud,cateniforme,characteristic,clavate,colour,corolla,corrugation,distal,exertion,form,glabrousnes,growth,height,history,inflorescence,interjected,length,life,lobing,margin,midpoint,na,new,nodding,number,peduncle,perennial,prickle,pseudostipule,ray,size,stem,texture,thicknes,type,value,variation,width,{,}
323	wfo-0001029601	invalid_json_followup	187	150	104	83	46	0.556	0-37,0.2-0.8,0.5-5.8,1-2,1-3,1.1-2.7,1.2-2.3,1.7-6.5,2,2-12,2-9,2.2-4.5,2.3-5.9,2.8-10.5,3-10,4-13.5,5-41,6-10,6.6-22,abaxially,acute,adaxially,anther,apex,articulated,attenuate,axillary,base,berry,brownish,bud,cell,clavate,cm,condition,coriaceous,corolla,covering,dark,diameter,distal,dot,drying,elliptic,filament,forked,fresh,fruit,generally,glabrescent,glabrous,globose,green,green-white,greenish,hair,half,herb,interjected,lanceolate,lateral,leaf,leaflet,light,lobe,long,make,middle,mm,mucilaginous,narrow,odd-pinnate,ovate,ovoid,pedicel,peduncle,petiole,petiolulate,plant,puberulent,ripe,rounded,seed,short,size,slightly,small,stigma,style,subtending,terminal,testal,thick,throughout,tube,typically,unwinged,usually,wall,wet,white,whitish,wing,x	0.5-8,1-4,1-53,2-3,2-7,3-5,3-7,5-merou,6.8-14.5,abaxiall,acumen,acuminate,ag,alyx,apart,apparently,asymmetric,axe,basiscopic,blade,borne,capitat,connivent,decreasing,digestion,dorsally,eaf,edge,eed,end,enzyme,erec,exceeding,flat,flower,folded,geminat,glabrou,hair-like,homostylous,honeycomb-shaped,larger,lengthening,linear,living,lower,middl,nflorescence,orbicular,orolla,pair,pentagonal,perfect,plurifoliate,pore,poricidal,removed,rotate,ruit,sessile,seudostipule,side,singly,slit,spaced,specimen,stamen,stolo,straight,subequal,subglabrou,tall,tamen,tem,tip,tissue,toward,tri-,tuber,unit,vary,yellow,ympodial	'',[,\u201chair-like\u201d,``,arrangement,bark,branch,calyx,capitate,characteristic,colour,corrugation,exertion,form,fruiting,glabrousnes,growth,height,history,inflorescence,length,life,lobing,margin,midpoint,na,new,number,ovary,per,prickle,primary,pseudostipule,ray,shape,stem,surface,texture,thicknes,type,value,variation,vein,width,{,}
324	wfo-0001029621	success	165	140	95	70	45	0.576	0.5-0.75,0.5-1.2,0.7-1.1,0.8-1,0.8-4.5,1-1.5,1-2,1.5-2,1.5-5,2/3,3-3.5,3.5-4.5,6-20,6-8,7-9,accrescent,acute,anther,apex,area,attenuate,bark,base,becoming,berry,branched,brown,calyx,cm,constricted,corolla,cup-shaped,dark,decurrent,dia,distal,dry,ellipsoid,erect,filament,fruit,fruiting,glabrate,glabrous,globose,green,lanceolate,later,lateral,leaf,live,lobe,lobed,long,main,many,margin,material,merely,minutely,mm,oblanceolate,often,ovary,ovoid-reniform,pair,pale,pedicel,pitted,plant,puberulent,ripe,sessile,shaped,shrub,stem,stigma,style,surface,tan,tear-drop,terminal,thick,time,tip,tube,vein,way,white,whorl-like,widened,woody,x,yellow,yellowish	.1,0.5-1,0.5-1.5,1.5-2.5,1/3,2.5-3,5-20-flowered,along,anthesi,apar,appearing,appressed,beneath,borne,caudate,cluster,completely,course,deltoid,densely,eaf,edicel,eed,elongate,enclosed,exsertio,fleshy,free,geminate,irregularly,late,like,lon,lower,middle,nflorescence,occasionally,older,onto,papillate,papillo,papillose,planar,plurifoliat,pore,poricidal,portion,prominent,quite,rarely,reddish,reddish-gre,river,ruit,scar,shiny,small,somewhat,spaced,ste,straight,tall,tapering,trichome,ud,uniseriate,unit,widest,ympodial,young	appearance,arrangement,border,branch,bud,characteristic,colour,corrugation,diameter,drying,exertion,exsertion,form,giving,glabrousnes,growth,height,history,inflorescence,interjected,leaflet,length,life,lobing,midpoint,na,new,number,peduncle,per,perennial,petiole,prickle,primary,pseudostipule,ray,reddish-grey,seed,shape,size,texture,thicknes,type,variation,width
325	wfo-0001029622	success	182	120	91	91	29	0.5	.1,.5,/3,0.5-0.7,0.5-1,0.6-0.9,0.8-1,1-1.2,1-4,1.5,2-11,3-4,30-35,45-50,5-6,abaxially,acute,adaxially,anther,apex,apparently,attenuate,bark,base,beneath,brown,bud,calyx,chartaceous,cm,consisting,corolla,deflexed,diameter,elliptic,elongate,entire,filament,flower,fruit,fruiting,glabrous,globose,green,included,inflorescence,leaf,lobe,lobed,long-acuminate,major,margin,minor,mm,narrowly,obconic,oblong,occasionally,older,onto,ovate,pair,pedicel,peduncle,petiole,present,reddish,rounded,sagittate,scar,second,shiny,shrub,simple,single,size,slightly,somewhat,stellate,stem,stigma,style,tapering,tip,tube,vein,way,white,within,x,young	.2,0.3,0.5,1-1.5,1-2.7,2-4,2-5,2.5-3,3-5,4-6.5,40,7-11,absent,accrescent,ag,alyx,anthesi,appearing,arising,axe,axil,blade,capitat,connivent,cylindrical,deciduous,differing,difoliate,dimorphic,eaf,eed,except,free,geminate,glabrou,ilament,immature,interlaced,internodal,jointed,known,lamina,lateral,less,long,long-triangular,longitudinal,m.,main,mature,measured,midrib,minute,minutely,nflorescence,often,one,opening,opposite,orolla,oung,ovate-lanceolate,papillose,pendent,pore,portion,probably,rachi,raised,reflexed,remaining,ruit,shaped,slende,slender,slit,straight,tal,tear-drop,thin,thus,trichome,tuft,ud,unarme,unifoliat,uniseriate,unit,vary,yellow,ympodial	arrangement,berry,branch,capitate,characteristic,colour,corrugation,drying,exertion,form,glabrousnes,growth,height,history,length,life,lobing,na,new,number,ovary,per,plant,primary,seed,shape,surface,texture,type
326	wfo-0001029625	invalid_json	168	161	134	34	27	0.798	-15,..,.1-0.2,.5,0.5-1,0.5-1.3,0.5-2,0.5-2mm,0.8-1.4,0.8-1.8,1-1.5,1-2,1-3,1.2-1.6,2,2.5-.,3,3-,3-3,3-3.5,4-10,4-4,4-5-celled,4-7-celled,4-9,5,5-10,5-6,5-8,6-9,9-25,abaxial,along,anther,anthesi,bark,base,beneath,branch,branched,calyx,cell,cm,conical,corolla,cucullate,darker,deflexed,deltate,densely,denser,diameter,elliptic,erect,filament,flattened,four,fruit,fruiting,glabrescent,glabrous,gland,gland-tipped,globose,green,greenish,growth,herb,hyaline,inflorescence,lamina,later,lighter,like,lobe,lobed,long,margin,markedly,middle,midline,mixed,mm,narrowly,nearly,occasionally,outer,outline,ovary,ovate-reniform,pair,pale,papillate,pedicel,peduncle,per,planar,point,pointed,pubescent,purplish,rarely,reddish,regularly,scattered,shrub,single,sinuate,slightly,small,smooth,sparsely,stem,stigma,striate,stripe,strongly,style,surface,tan,testa,time,tinged,tip,triangular,trichome,tube,uniseriate,vein,wall,weight,white,x,young	100,8-13,apical,branc,brittle,brow,capitat,cel,deflexe,distinct,dry,eaf,edicel,eed,flower,frui,glandular,lower,minute,new,nflorescence,open,pericarp,plurifoliat,primary,ruit,scar,single-stemmed,thin,tuft,ud,unit,without,ympodial	'',[,``,adaxial,arrangement,brown,bud,capitate,characteristic,colour,form,hair,height,history,leaf,length,life,plant,plurifoliate,seed,shape,size,texture,type,value,{,}
327	wfo-0001029645	invalid_json_followup	160	151	96	64	55	0.6	.5-1,0.2-0.5,0.5-7,1,1-1.5,1-2,1.3-7,1.5,1.5-2,2-4,2.5-17,2.5-4,3-15,3-7,3.5-4,337,4-8,5,5-8,6-12,7-12,750,?,acuminate,anther,apex,base,blue,brown,calyx,chartaceous,cm,corolla,cuneate,deltate,diameter,distally,entire,et,except,extra-axillary,fide,filament,finger,flattened,flower,fruit,glabrous,gland-tipped,globose,green,greenish,hair,herb,immature,kayap,line,lobe,margin,membranaceous,minutely,mm,moderately,nearly,obtuse,ovate,ovate-elliptic,pedicel,peduncle,petiole,puberulent,purple,radiu,rarely,red,rotate-stellate,rugose-verrucate,sagittate,short,side,simple,smith,sparsely,stigma,strongly,style,subcordate,tapered,triangular,truncate,tube,unbranched,vein,white,x,Â±	-1,0.3-0.5,0.5-2.5,1-4,2-3-foliat,3-10,4-5,abaxially,abundantly,acute,adaxially,aggregate,along,apart,around,articulated,axe,ba,blade,cell,connivent,cylindrical,decurrent,directed,distall,eaf,eed,free,glabrou,inserted,knapp,long,lower,major,mesocarp,nflorescence,orolla,part,perfect,pore,puberulen,rachi,ruit,sand-punctate,short-tomentose,shorter,shru,small,spaced,stone,tal,tamen,tem,thecae,tightly,time,tomento,truncat,unit,vary,veiny,wide,yellow,ympodial	'',.5,0.5-1,[,``,arrangement,bark,branch,bud,characteristic,colour,corrugation,distal,drying,exertion,form,fruiting,glabrousnes,growth,height,history,inflorescence,interjected,lateral,leaf,leaflet,length,life,lobing,midpoint,na,new,number,ovary,per,plant,prickle,primary,pseudostipule,ray,seed,shape,shrub,size,stem,surface,terminal,texture,thicknes,type,value,variation,width,{,}
328	wfo-0001029646	success	141	121	70	71	51	0.496	0.1-0.6,0.5-0.8,0.7-2.2,1-4,1.5-2,1.5-4.9,10-15,2-3,3-14,4-5.5,5-15,6-8,acuminate,acute,apex,apical,apically,articulate,attenuate,base,branched,calyx,cm,corolla,cyme,dehiscent,diameter,dichasial,dichasially,distal,ebracteate,elliptic,epiphytic,filament,finely,globose,green,green-white,herbaceous,introrse,lateral,leaf,lobe,long,maturing,mm,monochasial,mucilaginous,narrowly,often,ovate,ovoid,pedicel,peduncle,perennial,petiole,plant,poricidally,pubescent,seed,short,simple,slit,stigma,style,throughout,tone,white,wide,yellow-green	0.5,3-6-foliat,7-15,abaxially,acumen,adaxially,cell,commonly,covering,digestion,dorsally,eaf,edge,eed,emoval,enzyme,equaling,flat,flower,folded,forked,free,generally,globo,ground,growing,hair-like,half,honeycomb,linear,living,lon,lower,make,mos,mould,mucronate,nflorescence,nther,oak,orolla,ovat,pattern,perfect,pine,plan,proximal,rarely,reveal,ruit,seudostipule,specimen,stamen,stellate,straight,tall,tem,testal,thick,throughou,tree,tuber-bearing,typically,unit,vary,viole,wall,without,yellow,ympodial,Â¼	anther,appearance,arrangement,bark,border,branch,bud,characteristic,colour,corrugation,drying,exertion,form,fruit,fruiting,giving,glabrousnes,growth,height,history,inflorescence,interjected,leaflet,length,life,lobing,margin,midpoint,na,new,number,ovary,per,prickle,primary,pseudostipule,ray,shape,size,stem,surface,terminal,texture,thicknes,tube,type,variation,vein,violet,wet,width
329	wfo-0001029652	invalid_json_followup	160	136	87	73	49	0.544	.5,0.5-4,0.75-1,0.8-1,1-3,1.5-2,2-2.5,2-4,2.5-3,3.5-4,3/4,4-4.5,6-15,7-9,abaxially,adaxially,along,anther,apex,attenuate,bark,base,berry,calyx,cm,conical,corolla,curling,deflexed,drying,elliptic-ovate,exserted,filament,filiform,fruiting,glabrous,globose,golden,golden-red,green,greenish-white,hispid,lateral,leaf,lobe,long,long-acuminate,long-styled,main,margin,minute,minutely,mm,narrowly,near,occasionally,ovary,ovoid-reniform,pair,pale,papillose,pedicel,petiole,pitted,pubescent,reddish-brown,shaped,short-styled,shrub,simple,size,slender,stem,stigma,style,surface,tan,tear-drop,tip,trichome,tube,undulate,uniseriate,vein,way,white,x	.25,.3,0.5-1,1,1-2,2,25,anthesi,apar,ape,apical,arch,arching,ba,bearing,broadly,cone,deciduous,deltate,denser,dia,differing,difoliate,eaf,edicel,eed,evenly,flower,free,geminat,hard,heteromorphic,included,joining,lamina,like,lobed,lon,lower,major,maturity,middle,midrib,minor,nflorescence,older,opposite,papillo,pericarp,pore,poricidal,portion,projection,reflexed,ruit,scar,series,slende,slightly,soon,spaced,sparsely,swollen,tall,thickened,time,tub,ud,unit,widest,within,ympodial,young	'',[,``,alternate,appearance,arrangement,branch,bud,characteristic,colour,corrugation,diameter,distal,exertion,form,fruit,giving,glabrousnes,growth,height,history,inflorescence,interjected,leaflet,length,life,lobing,midpoint,na,new,number,peduncle,per,plant,prickle,primary,pseudostipule,ray,seed,shape,terminal,texture,thicknes,type,value,variation,width,{,}
330	wfo-0001029673	invalid_json_followup	159	142	94	65	48	0.591	.5,0.5-1,0.7-1.1,0.8-1,1-10,1-2,1.2-3.5,1.5-1.8,1.5-2,10-20,2-2.5,2.5,3-5,3/4,4-6,5.5-15,absent,accrescent,acuminate,acute,age,anther,anthesi,apex,appearing,bark,base,becoming,berry,black,branch,calyx,clavate,cm,conical,corolla,deep,dendritic,densely,diameter,elliptic,exserted,filament,fork,fruit,fruiting,glabrous,globose,greyish,greyish-yellow,growth,later,lateral,leaf,length,lenticular,lobe,minutely,mm,narrowly,nodding,occasionally,ovary,overtopping,pair,pedicel,petiole,pitted,planar,pore,poricidal,pubescent,purple,reddish-brown,reflexed,secondary,shoot,shrub,slightly,slit-like,somewhat,sparsely,stem,stigma,strongly,style,surface,terminal,tip,trichome,tube,vein,violet,x	0.75-1,1-5,2-3,2-4,5-25,abaxial,abaxially,adaxial,adaxially,along,apical,basal,blade,branching,broadly,decurrent,deflexed,deltoid,denser,dichasia,eaf,edicel,eed,ew,flower,free,greyish-yello,individual,inserted,lamina,like,lon,long,longer,lower,m.,monochasial,nflorescence,older,papillo,pericarp,petal,plurifoliate,portion,prominent,pyramidal,ruit,scar,sleeve,small,stamen,tall,tapering,thin,time,tree,triangular,tub,ud,unit,wide,winged,woody,ympodial,young	'',[,``,alternate,appearance,arrangement,bud,characteristic,colour,corrugation,distal,drying,exertion,form,giving,glabrousnes,green,height,history,inflorescence,interjected,leaflet,life,lobing,margin,midpoint,na,new,number,peduncle,per,perennial,plant,prickle,primary,pseudostipule,ray,seed,shape,size,texture,thicknes,type,value,variation,width,{,}
331	wfo-0001029680	invalid_json_followup	212	157	111	101	46	0.524	0.1,0.5â1.5,0.6,0.6â1.2,0.6â2.0,1.0â1.1,1.0â1.5,1.1â1.2,1.4â7.5,1.7â7,1.8â3.8,11â16,11â25,12,1â2,3.0â4.2,3â6,4.0â16,4.0â6.5,4.5â20,4.5â7.0,50,5â11,8â32,acute,annual,anther,anthesi,apex,axillary,base,becoming,bipinnate,blue,borne,branched,brown,calyx,clavate,cm,connivent,decurrent,diameter,divided,equal,filament,flattened,fleshy,flower,fruit,glabrous,globose,green,hair,herb,indistinct,leaf,length,light,lobe,long,margin,mm,moderately,multicellular,oblong,obovate,obtuse,ovate,pair,pale,pedicel,peduncle,petiole,pinnae,pinnate,pitted,poricidal,primary,pubescent,purple,rarely,red,ripe,shallowly,shoot,simple,size,sometimes,sparsely,stem,stigma,style,surface,terminal,time,tip,tripinnate,tube,turning,uniseriate,violet,white,winged,woody,x,yellow,â10,â12.5,â19,â3	.0,0.4,0.9â1.0,1,1.0,1.0â1.8,1.4â2.5,1.5,1.6â2.7,10,1â3,1â6,1â8,2.2â4.2,2â20,3.3â5.5,3â22,4â10,4â30,5,5.5â8.5,7â10,abaxially,absen,adaxiall,adaxially,ag,along,apart,appressed,arequipa,arranged,articulated,asymmetrically,axe,ba,beyond,blade,cell,cylindrical,decreasing,densely,difoliate,eaf,eed,entire,erect,extending,flange,forming,geminat,irregularly,lon,longitudinal,lower,m.,midrib,narrow,nflorescence,node,occasionally,often,opening,orolla,parallel,pendant,pentagonal,perfect,plurifoliate,pore,prostrate,rapidly,rotate,ruit,running,secondary,shaped,side,spaced,specimen,split,stone,straight,subglabrous,tacna,tal,tamen,tear-drop,tem,tertiary,unicellular,unit,usually,vary,wide,wing,winge,ympodial,â3.2,â46,â48	'',2.2,[,``,arrangement,bud,characteristic,colour,corolla,corrugation,distal,drying,exertion,form,fruiting,glabrousnes,growth,height,history,inflorescence,interjected,lateral,leaflet,life,lobing,midpoint,na,new,number,ovary,per,plant,prickle,pseudostipule,ray,seed,shape,texture,thicknes,type,value,variation,vein,width,{,}
332	wfo-0001029704	success	146	119	83	63	36	0.568	0-1.5,1.5,1.5-2.5,1.5-3,1000-1200,15-25,2-2.5,2-3,2-5,3-4-celled,3-5,4,5,7-10,9-20,acuminate,acute,along,anther,apex,base,berry,blue,branch,broadly,brown,calyx,cm,composed,conical,corolla,cuneate,dark,deeply,dia,ellipsoid,extra-axillary,few-flowered,filament,flower,fork,fruiting,glabrous,globose,green,halfway,leaf,less,minute,minutely,mm,mottled,obovate,obovoid,occasionally,one,ovary,pedicel,peduncle,petiole,pinnatisect,poricidal,pubescent,purple,record,reddish,reticulate,shrub,simple,single,stigma,stout,striped,style,subdiscoidal,surface,tip,trichome,tube,variously,vein,white,x	-17,-3,.5,0.5,1,1-2,1-4,10-14,140-185,4-7,7-,acuman,also,anthesi,apparently,aspect,axi,c.,cell,cunate,cut,deflexed,diam,eaf,eed,enlarged,erect,especially,exerted,flowering,gradually,lanceolate,lengthening,lobe,lobed,long,lower,midrib,moderately,nflorescence,plurifoliat,pore,rounded,ruit,shoot,short,sinus,slit,sombre,sprawling,stellate,stone,straight,subglobo,swollen,tub,twig,ud,unit,variable,within,ympodial,young	arrangement,bark,bud,characteristic,colour,corrugation,diameter,drying,exertion,form,fruit,glabrousnes,growth,height,history,inflorescence,length,life,lobing,margin,na,new,number,per,perennial,plant,plurifoliate,primary,seed,shape,size,stem,subglobose,texture,type,ye
333	wfo-0001029727	invalid_json_followup	260	147	107	153	40	0.412	-10,-3,/3,0-30,0-4,0.1-5,0.15-0.2,0.15-0.3,0.4-1,0.7-0.9,1,1-1.2,1-4,1.5-5.5,1.6-3,1/3-1/2,2.5-3.2,2.8-4,3-11,3-6,3-7,5.5-7,acuminate,acute,anther,anthesi,apart,apex,apparently,articulated,bark,base,berry,brown,calyx,chartaceous,clavate,climber,cm,colourles,cordate,corolla,cupular,curved,densely,diameter,drying,erect,filament,finely,flattened-reniform,glabrous,lateral,leaf,length,less,lobe,lobed,long,margin,mauve,midpoint,mm,obconical,oblong,occasional,orange-brown,ovate,pair,papillose,pedicel,peduncle,per,petiole,pitted,poricidal,prickle,prickly,primary,ray,red-brown,reddish,rounded,seed,shallowly,shape,shrub,simple,size,smooth,spaced,stellate,stellate-pubescent,stem,stigma,straight,style,subentire,surface,tapering,terminal,tip,trichome,tube,vein,wide,yellowish	-1/3,.5,0-15,0-2,0-20,0-40,0-5,0-8,0.2,0.2-0.5,0.2-2.5,0.3,0.4,0.5,0.5-1.2,0.5-3,0.7-1,1-,1-2,1.2-2,1.5-2.3,1.5-2.5,1.5-3,1/2-2/3,1/4,1/8-1/5,2-5,2.5,2.5-5.5,3/,4-7,4-merou,4-merous,4.5,4.5-,5-12,5-8,5-9,6-11,7-10,abaxial,abaxially,acicular,adaxial,age,almost,along,alternate,alyx,ame,apar,apically,blade,branched,bristle,c.,connivent,covered,darker,deltate,deltoid,developing,different,dimorphic,discolorous,divided,eaf,edge,eed,elongating,equal,except,extending,ferrugineous,filiform,filiform-acuminat,fissure,flower,free,geminate,increasing,inside,lengthening,like,lon,longer,lower,m.,mature,middle,midvein,minor,minutely,mixture,moderately,narrow-deltate,nflorescence,nther,older,one,open,orolla,oung,outside,papillo,perfec,perfect,pit,plurifoliat,pore,porrect,portion,prickl,protruding,pubescent,raised,rarely,red-brow,reduced,regular,scandent,scar,series,sessile,short,sinus,sometimes,spreading,stalk,stalked,strongly,tamen,tearing,terete,tertiary,time,toward,translucent,transverse,unarmed,uneven,unit,upper,variable,variously,vary,venation,violet,visible,way,x,ympodial,young	'',[,``,appearance,arrangement,branch,bud,characteristic,colour,corrugation,distal,exertion,form,fruit,fruiting,giving,glabrousnes,growth,height,history,inflorescence,interjected,leaflet,life,lobing,na,new,number,ovary,perennial,plant,pseudostipule,texture,thicknes,type,value,variation,width,{,}
334	wfo-0001029731	success	246	157	117	129	40	0.476	.5,.6,1-2,1-2.5,1.5,1.5-2.5,10-20,2-3,2.5,2.5-4.5,3-4,31,4,4-9,6,6-7,7-11,8-9,abaxially,acuminate,acute,adaxially,almost,along,anther,apex,apically,bark,basally,base,beak,berry,black,branch,branched,branching,brown,calyx,clavate,cm,concolorous,conical,coriaceous,corolla,crinkled,cuneate,diameter,dilated,distributed,drying,dull,elliptic,entire,epiphyte,erect,evenly,exserted,filament,flaring,fruit,fruiting,glabrous,ground,lateral,leaf,liana,like,linear,lobe,lobed,long,long-ellipsoid,longitudinal,margin,maturity,mauve,midvein,mm,obconical,oblong,obovate,orange-brown,pedicel,peduncle,pendulous,petiole,primary,pyriform,raised,revolute,ribbed,ridge,ridged,rounded,several,slender,sometimes,sparsely,stem,stigma,stretched,style,succulent,sunk,surface,terminal,thick,toward,tube,vein,white,wide,widely,winged,x,yellow,yellow-green	0.05,0.1-0.8,0.25-0.3,1,1-1.5,1.5-3,1/3,1994,2,2-6,3,3-10,4-5,accrescent,acquiring,age,alyx,anthesi,apar,apparently,arcy,articulated,basal,becoming,boundary,broadly,bumpy,clearly,connate,darker,delimited,delineated,deltoid,dense,development,different,domatia,dorsal,dorsifixed,dry,eaf,early,elongating,enlarge,equal,even,faint,filiform,fine,finely,flattened,fleshy,flower,free,hair,iscoid,lamina,large,later,lengthening,less,lon,longitudinally,lower,main,mature,much,narrowly,nflorescence,nther,obtuse,occasionally,often,orolla,pair,papillae,papillose,part,perfec,pericarp,persisting,plurifoliat,pore,poricidal,portion,prominent,protruding,rachi,rakotozafy,rarely,reflexed,reported,ruit,scar,see,shallowly,shorter,simple,sinus,slightly,small,smaller,smoot,straight,stump,tearing,thickened,thinner,though,time,tip,trichome,tub,tuft,ud,unit,usually,vary,venation,ventral,visibl,visible,well-developed,wing,woody,wrinkling,ympodial,young,â	appearance,arrangement,border,bud,characteristic,colour,corrugation,distal,exertion,form,giving,glabrousnes,growth,height,history,inflorescence,interjected,leaflet,length,life,lobing,midpoint,na,new,number,ovary,per,plant,prickle,pseudostipule,ray,seed,shape,size,smooth,texture,thicknes,type,variation,width
335	wfo-0001029741	success	137	114	86	51	28	0.628	.4,.5,0.9-1.2,1-3.5,1.1-1.3,1.5-4,1.5-6,10-50-flowered,2-2.5,2.5-7.8,3,9.5-22.5,?,acute,age,anther,apex,attenuate,base,becoming,berry,black,calyx,capitate,cm,completely,corolla,dark,dia,dry,drying,early,elliptic,exserted,filament,fruit,fruiting,furcate,glabrous,globose,green,growth,inflorescence,lateral,leaf,lenticellate,lighter,lobed,long,main,minutely,mm,nearly,new,opposite,ovary,ovate,pair,papillose,pedicel,petiole,pore,poricidal,prominent,quite,raised,reddish-brown,shaped,shrub,size,slender,stem,stigma,straight,style,tapering,tear-drop,tip,tree,tube,usually,variable,vein,weak,white,x	0.5-1.5,0.8-3.5,1-1.5,1.5,2.2-9,accrescent,anthesi,apiculate,branched,ca,caly,closely,deflexed,deltoid,differing,difoliate,divisio,eaf,edicel,eed,erect,flower,free,geminat,glabrou,immature,known,lobe,lon,lower,major,middle,minor,nflorescence,overlapping,papillo,planar,portion,produced,proximal,ruit,scar,slightly,spaced,tall,ud,unit,widest,wood,woody,ympodial	arrangement,bark,branch,bud,characteristic,colour,corrugation,diameter,exertion,form,glabrousnes,height,history,length,life,lobing,margin,na,number,peduncle,per,plant,primary,seed,shape,surface,texture,type
336	wfo-0001029744	success	113	117	67	46	50	0.593	0.3-0.6,1.5-3.2,2,5-8,50,7-15,8-10-flowered,8-11,abaxially,acute,adaxially,apex,bark,base,blunt,branch,calyx,cm,deltate,densely,difoliate,elliptic,entire,extreme,flattened,form,fruit,geminate,glabrescent,glabrous,golden,lanceolate,leaf,lobe,long-acuminate,margin,minutely,mm,narrowly,oblanceolate,oblique,occasionally,older,ovoid-reniform,pair,pale,pedicel,petiole,pitted,primary,pubescent,revolute,shape,shrub,simple,slightly,small,sometimes,somewhat,stem,surface,tip,unifoliate,vein,white,x,young	0.5-1,1,1.5,2-4,along,apart,beginning,brow,dendritic,denser,distinct,eaf,eed,examined,fide,flexuous,incrassate,inflorescenc,lamina,leave,looping,lower,major,marginal,mature,minor,nflorescence,node,non-reproductive,opposite,pubescence,scar,see,similar,single-celled,smaller,smith,spaced,thee,thin,trichome,ud,unicellular,uniseriate,unit,ympodial	anther,appearance,arrangement,border,brown,bud,characteristic,colour,corolla,corrugation,diameter,distal,drying,exertion,filament,fruiting,giving,glabrousnes,growth,height,history,inflorescence,interjected,lateral,leaflet,length,life,lobing,midpoint,na,new,number,ovary,peduncle,per,plant,prickle,pseudostipule,ray,seed,size,stigma,style,terminal,texture,thicknes,tube,type,variation,width
337	wfo-0001029746	success	179	135	92	87	43	0.514	0.3-2,0.7-1,1,1-1.3,1-1.5,1.2-1.5,1.5,2-7,3,3-4,4-9,6,8-11,acuminate,acute,anther,apex,base,berry,broadly,brown,calyx,capitate,centre,cm,conical,cordate,corolla,crenate,cup-shaped,dark,darker,densely,diameter,ellipsoid,elliptic,entire,erect,exerted,filament,flattened,fleshy,fruit,fruiting,glabrous,glandular,globose,herb,heteromorphic,hollow,inflorescence,internodal,irregularly,leaf,less,lobe,margin,minutely,mm,narrowly,nodding,orange,ovary,ovate,ovoid,pair,pale,papillose,pedicel,peduncle,petiole,pitted,primary,principal,pubescent,purple,red,reddish,shallowly,simple,slender,somewhat,stem,stigma,strongly,style,subshrub,surface,tube,vein,x,â3	.5,0.5-1,2,2-2.5,2-4,2-8,3-4-pluri-foliate,3-4.5,3-6,6-7,8-10,abaxially,adaxially,age,anthesi,apart,bearing,becoming,blackish,c.,cell,ciliate,color,crowded,curved,eaf,edicel,eed,enlarged,flower,flush,free,gland-tipped,greenish,growing,horn,lamina,lengthening,lon,long,longer,longest,lower,markedly,mature,maturit,mid-length,mixed,near,nflorescence,occasionally,papillo,pericarp,plan,pore,poricidal,portion,pubescen,rachi,reflexed,ruit,scar,shortest,single,slightly,slit,spaced,sparse,sparsely,spreading,straight,testal,thin,third,tip,triangular,trichome,ud,uniseriate,unit,upper,upward,wall,widely,widest,woody,ympodial	appearance,arrangement,bark,border,branch,bud,characteristic,colour,corrugation,distal,drying,exertion,form,giving,glabrousnes,green,growth,height,history,interjected,lateral,leaflet,length,life,lobing,midpoint,na,new,number,per,plant,prickle,pseudostipule,ray,seed,shape,size,terminal,texture,thicknes,type,variation,width
338	wfo-0001029769	success	142	132	101	41	31	0.711	.25,.5,1-1.2,1-3,1.5-2,2.5-3,2.5-8,3.5-4,30-60-flowered,4,5-8,6-17,7-8,8-9,8.5-17,abaxially,acuminate,acute,adaxially,along,anther,anthesi,apex,bark,base,bearing,berry,branch,brochidodromu,brown,calyx,capitate,cm,conical,corolla,curl-tipped,cyathiform,dark,densely,dia,elliptic,exserted,filament,filiform,flower,fresh,fruiting,glabrous,globose,golden,green,hen,horizontally,lateral,leaf,less,lobe,lobed,long,main,margin,midrib,minutely,mm,nearly,onto,ovary,ovoid-reniform,pair,pedicel,petiole,pitted,puberulent,pubescent,reflexed,ried,scattered,shaped,shrub,simple,smooth,somewhat,sparsely,stem,stigma,style,surface,swollen,tear-drop,three,time,tip,trichome,tube,two,uniseriate,vein,white,wide,winged,x	0.5-1.5,1.5-2.5,4-5,apar,ape,archin,ba,cerro,deflexed,deltoid,eaf,edicel,eed,free,inglÃ©,internodal,like,lon,lower,nflorescence,older,opposite,papillo,papillose,pore,poricidal,portion,ruit,scar,spaced,straight,tall,tub,ud,unevenly,unifoliat,unit,widely,woody,ympodial,young	arching,arrangement,bud,characteristic,colour,corrugation,diameter,drying,exertion,form,fruit,glabrousnes,growth,height,history,inflorescence,length,life,lobing,na,new,peduncle,perennial,plant,primary,seed,shape,size,texture,type,unifoliate
339	wfo-0001029780	invalid_json_followup	204	158	115	89	43	0.564	1-1.2,1-2,1.4-1.9,11-24,120-210,15-22,15-45,2-2.5,2-2.8,2-3.5,2-5.5,2.4-4.2,20-60,3,3-6,4-6,5-7,5.5-13,50-70,600-950,8-12,?,abaxially,absent,acute,adaxially,anther,apex,apparently,attenuate,axillary,base,berry,brownish,bud,chartaceous,cm,condition,cordate,corolla,cuneate,dark,densely,diameter,distal,drying,filament,flower,forked,fresh,fruit,generally,glabrous,gland,glandular,globose,green,green-white,greenish,hair,half,head,herb,interjected,invested,lanceolate,lateral,leaflet,length,like,lobe,longer,margin,membranous,minute,mm,mucilaginous,non-glandular,obtuse,odd-pinnate,ovate,ovoid,pedicel,peduncle,perfect,petiole,plant,pubescent,rarely,ripe,rotate,seed,short,size,stem,stigma,streak,stripe,style,subtending,terminal,tetralobulate,throughout,tip,trichome,truncate,tube,typically,unwinged,usually,wet,white,whitish,x,yellow	1-10,1.5-2,2-12,3.5-7.3,4.5-6,5-merou,5.5,acumen,ag,along,alyx,apart,articulated,axe,blade,borne,capitat,cell,ciliate,connivent,covering,decumbent,digestion,dorsally,eaf,edge,eed,end,enzyme,erec,especially,exceeding,except,flat,folded,geminat,glabrou,greatly,hair-like,hal,high,homostylous,honeycomb-shaped,lengthening,living,long,lower,make,midrib,minutely,nflorescence,often,orbicular,orolla,pair,pale,petiolulate,petiolule,pinkish,plurifoliate,pore,poricidal,proximal,puberulent,reduced,removed,ruit,sessile,seudostipule,singly,slit,spaced,specimen,stamen,ste,stolo,straight,subequal,tall,tamen,tem,testal,thick,tri-,tuber,unit,vary,wall,ympodial	'',[,``,arrangement,bark,branch,calyx,capitate,characteristic,colour,corrugation,exertion,form,fruiting,glabrousnes,growth,height,history,inflorescence,leaf,life,lobing,midpoint,na,new,number,ovary,per,prickle,primary,pseudostipule,ray,shape,surface,texture,thicknes,type,value,variation,vein,width,{,}
340	wfo-0001029784	invalid_json_followup	237	143	104	133	39	0.439	-12,-5,.5,0-4,0.2-,0.2-0.3,0.25-0.3,0.3-0.5,0.3-1,0.4-,0.4-0.45,0.4-0.6,0.5-1.5,0.6-1,0.7-1.2,0.9-1.2,1-1.1,1-1.2,1-1.5,1-2,1-4,1.0-1.3,1.5-,1.7-2.6,2,2-2.5,3-,3-5,5-10,5-8,acuminate,acute,anther,apex,articulated,base,berry,broadly,brown,calyx,capitate,cm,conical,corolla,crenate-serrate,dark,densely,diameter,distal,eglandular,elliptic,exserted,filament,flower,fruit,fruiting,globose,golden,green,hair-like,half,halfway,herb,imparipinnate,inflorescence,interjected,interrupted,lateral,leaflet,lobe,long,margin,mm,mostly,narrowly,obovate,outgrowth,ovary,pale,pedicel,peduncle,perennial,petiole,plant,primary,pseudostipule,pubescent,simple,soft,sparsely,stem,stigma,stripe,style,surface,terminal,thick,trichome,truncate,tube,vein,velvety,wide,yellow	.1,.2,0.1-,0.1-0.15,0.1-0.5,0.2,0.2-0.5,0.3-0.35,0.3-0.4,0.4-0.5,0.5,0.5-,1,1-,1-2-celled,1.2-2.5,1/3,2-,2-3-celled,2-4,2-4.5,2-foliate,2-locular,2.5-3.5,2/3,5-14,abaxial,abaxially,absent,abundant,adaxially,adpressed,along,angled,anthesi,apical,appearance,appendage,arising,articulation,axi,basal,basicopically,beneath,bract,cell,column,crenation,decurrent,deeper,developed,distributed,due,eaf,edicel,eed,enclosing,entire,evenly,giving,glabrescent,glabrous,glandular,gree,hal,head,included,internode,interspersed,irregularly,lamina,lanceolate,larger,like,live,lon,long-acuminate,loosely,lower,markedly,maturing,multicellular,nflorescence,node,northern,occasionally,often,orbicular,pair,paler,patent,pentagonal,petiolule,population,present,proximal,pubescence,rarely,reflexed,ripe,robust,ruit,scattered,secondary,sessile,silky,smaller,sometimes,somewhat,sparse,spreadin,staminal,sterile,stout,straight,strongly,tem,tertiary,testa,trailing,ud,undulate,unicellular,uniseriate,unit,unseriate,usually,wall,white,winged,woody,x,ympodial	'',[,``,arrangement,bark,branch,bud,characteristic,colour,corrugation,drying,exertion,form,glabrousnes,growth,height,history,leaf,length,life,lobing,midpoint,na,new,number,per,prickle,ray,seed,shape,size,texture,thicknes,type,value,variation,width,{,}
341	wfo-0001029785	invalid_json_followup	223	146	104	119	42	0.466	0-2,0.1-0.5,0.3-2.2,0.4-4.9,0.8-1,1-1.2,1-2,1.2-3.2,1.5-3.6,1.8-3.5,1.8-7,10-26,2-4,3.5-5,3.8-7.2,4-10.5,5-16,6,8-11,abaxially,acute,adaxially,anther,apex,axillary,base,berry,brownish,bud,chartaceous,clavate,cm,commonly,condition,connivent,corolla,cuneate,dark,darker,diameter,distal,drying,filament,forked,fresh,fruit,generally,glabrous,globose,green,greenish,hair,half,herb,interjected,invested,lanceolate,lateral,leaf,leaflet,like,lobe,long,margin,membranous,mm,multiple-celled,non-glandular,oblique,odd-pinnate,orbicular,outer,ovate,ovoid,pedicel,peduncle,petiole,plant,pubescent,purple,purple-tinged,ripe,rounded,seed,short,size,slightly,sparsely,stem,stigma,style,subglabrous,subtending,terminal,tube,typically,unbranched,unwinged,usually,vein,violet,whitish,wide,x	0-3,1-10,1-5,3-4,3-6,3-8,5-9,5-merou,absent,acumen,ag,along,alyx,apart,apparently,articulation,attenuate,axe,blade,borne,broadly,capitat,cell,cordate,covering,decreasing,decumbent,denser,digestion,dorsally,eaf,edge,eed,elliptic,end,enzyme,erec,especially,exceeding,flat,flower,folded,geminat,glabrou,greatly,green-white,hair-like,homostylous,honeycomb-shaped,larger,lengthening,living,lower,make,markedly,medium,middle,midrib,minute,minutely,mottled,much,mucilaginous,nflorescence,obovate,obtuse,one-quarte,orolla,pair,pale,pentagonal,perfect,petiolulate,petiolule,plurifoliate,point,pore,poricidal,present,puberulent,quite,rarely,removed,rotate,ruit,scale-like,sessile,seudostipule,shallowly,singly,slit,sometimes,spaced,specimen,stamen,ste,stolo,straight,stripe,tall,tamen,tem,testal,thick,throughout,tip,toward,tri-,truncate,tuber,unequal,unit,variable,vary,wall,wet,white,yellow,ympodial	'',[,``,arrangement,bark,branch,calyx,capitate,characteristic,colour,corrugation,exertion,form,fruiting,glabrousnes,growth,height,history,inflorescence,length,life,lobing,midpoint,na,new,number,ovary,per,prickle,primary,pseudostipule,ray,shape,surface,texture,thicknes,type,value,variation,width,{,}
342	wfo-0001029789	success	167	114	73	94	41	0.437	0-2,0.2-0.5,0.5-2.8,0.8-3.5,1-3,1.7-8.5,1.8-6.5,12,2-6,2-6.5,2.7-4.7,3-8.5,4-10,5-7,7-16.6,8-9,acuminate,acute,anther,apex,axillary,base,blue,broadly,bud,chartaceous,clavate,cm,corolla,decurrent,diameter,distal,filament,flat,fruit,glabrous,green,herb,interjected,lanceolate,lateral,leaf,leaflet,light,lilac,linear,lobe,long-attenuate,membranous,minute,mm,narrowly,odd-pinnate,ovary,ovate,pedicel,peduncle,petiole,plant,pubescent,sessile,short,size,sparsely,stigma,style,subglabrous,subtending,terminal,tube,typically,white,x	1-10,1-2,1.5-2,2-25,2-3,3-5,4-13,5-merou,6,6-7,7-21,abaxially,acumen,adaxiall,adaxially,ag,alyx,apart,apparently,articulated,attenuate,axe,basiscopic,blade,capitat,connivent,dark,decreasing,dorsally,eaf,edge,eed,erec,exceeding,flower,folded,forked,formed,geminat,generally,greatly,hair,hal,half,homostylous,lant,lengthening,like,long,lower,lunate,maturing,minutely,mottled,never,nflorescence,orbicular,orolla,pair,pentagonal,perfect,petiolulate,plurifoliate,pore,poricidal,pubescen,purpl,rachi,rarely,rotate,seudostipule,side,simple,slightly,slit,spaced,stamen,star,ste,sterile,straight,subequal,tall,tamen,tem,tinged,tip,toward,tri-,unit,usually,vary,yellow,ympodial	appearance,arrangement,border,calyx,capitate,characteristic,colour,corrugation,drying,exertion,form,fruiting,giving,glabrousnes,growth,height,history,inflorescence,length,life,lobing,margin,midpoint,na,new,number,per,prickle,primary,pseudostipule,ray,seed,shape,stem,surface,texture,thicknes,type,variation,vein,width
343	wfo-0001029810	invalid_json_followup	149	147	101	48	46	0.678	.25,.5,0.5-3,1-1.3,1-10,1-2,1-3,1.1-2.3,1.5-3,2-3,2.5-3,3-3.5,3-4,3-6,5-15-flowered,5-16,5-6,acuminate,acute,adaxially,along,anther,apex,apically,arachnoid,attenuate,bark,base,berry,brown,calyx,capitate,cm,compact,compressed,congested,conical,corolla,dark,dendritic,densely,dia,drying,ellipsoid,elliptic,exserted,filament,fruiting,glabrous,globose,green,inflorescence,internodal,later,lateral,leaf,like,lobe,lobed,long,margin,minutely,mm,narrowly,nearly,occasionally,opposite,ovary,ovoid-reniform,pale,papillose,pedicel,petiole,pitted,pointed,pubescent,reddish-brown,rest,shaped,shining,shrub,simple,size,slender,small,sparsely,stem,stigma,style,surface,tan,tapering,tear-drop,tree,trichome,tube,vein,white,wide,yellowish,young	0.5-1,1-1.5,2-5,4-10,8-12,abaxially,anthesi,ape,closely,deflexed,deltate,differing,difoliate,eaf,edicel,eed,fleshy,free,geminat,glabrou,large,lenticel,less,lon,lower,main,major,middle,minor,nflorescence,older,overlappin,papillo,planar,pore,poricidal,portion,ruit,scar,spaced,tall,tip,tub,ud,unit,widest,woody,ympodial	'',[,``,alternate,arrangement,branch,bud,characteristic,colour,corrugation,diameter,distal,exertion,form,fruit,glabrousnes,growth,height,history,interjected,leaflet,length,life,lobing,midpoint,na,new,number,peduncle,per,plant,prickle,primary,pseudostipule,ray,seed,shape,terminal,texture,thicknes,type,value,variation,width,{,}
344	wfo-0001029811	invalid_json_followup	225	172	132	93	40	0.587	-3,0,0-35,0.1-0.4,0.3-1,0.5-2,0.8-1.5,1-1.5,1-3,1.3-1.7,1.5-2.5,1.5-6,1/2-2/3,1/3,13-20,2-2.5,2-5.5,2.5-3,2.8-3.2,3-5,3-5.5,3-7,3.5-4.5,4.5-5,5-11,5-9,6-12,7-18,7-9,8-12,acicular,anther,apex,apparently,articulated,bark,base,berry,calyx,cell,chartaceous,cm,connivent,cordate,cream,cuneate,dark,densely,diameter,discolorous,distal,drying,erect,filament,flattened,flattened-reniform,flower,fruit,fruiting,glabrous,glandular,green,hair,herb,lateral,leaf,length,lobe,lobed,lobing,long,long-styled,lower,margin,marking,maturity,mauve,midpoint,minute,mm,moderately,obtuse,orange-brown,outline,ovate,pair,pale,pedicel,peduncle,per,perpendicular,petiole,pit,plant,poricidal,porrect,prickle,prickly,primary,raised,ray,scandent,sessile,short-styled,shrub,side,simple,slightly,small,smooth,sometimes,spherical,stellate,stellate-pubescent,stem,stout,straight,style,surface,tapering,terete,tip,trichome,tube,unbranched,upper,vein,way,wide,yellow,yellow-green,young	-6,-merous,.5,/3,0-30,0.1-0.3,0.2,0.2-0.6,0.3-1.5,1,1-2.5,1/,1/3-2/3,10-22,15-23,15-50,2-5,20-100,4-8,5,5-17,5-40,8-18,abaxial,abaxially,adaxial,alyx,andromonoecious,apar,apart,apically,blade,broad-deltate,brown,distance,eaf,eed,elongate,elongating,equal,extending,eye,faint,fewer,free,green-brow,hermaphrodite,heterostylous,inflated,infructescence,less,long-acuminat,longer,lowermost,mature,midvein,multangulate,naked,narrow-deltate,nflorescence,often,older,one,open,orolla,oung,pendulous,pericarp,plurifoliat,portion,prickl,ruit,scar,secondary,short,shorter,spaced,sparsely,spreading,stalk,stalked,staminat,tamen,tertiary,time,unarmed,unit,usually,vary,venation,visible,woody,ympodial	'',1/2,[,``,arrangement,branch,bud,characteristic,colour,corolla,corrugation,exertion,form,glabrousnes,green-brown,growth,height,history,inflorescence,interjected,leaflet,life,na,new,number,ovary,pseudostipule,seed,shape,size,stigma,terminal,texture,thicknes,type,value,variation,width,{,}
345	wfo-0001029978	invalid_json_followup	208	157	114	94	43	0.548	0.5-0.6,0.7-1.9,0.8,0.9-2.3,1-2,1.3-1.5,1.4-1.5,1.5-3.1,1.8-5,11-19,15-27,2-4,3-7,3.1-6.3,3.2-2.5,3.5-9.5,3.7-8.1,4.2-5.2,5,5-16.5,8-10,acuminate,anther,apex,articulated,attenuate,axillary,base,berry,brownish,bud,cell,chartaceous,clavate,cm,coarsely,condition,conical,connivent,corolla,covering,dark,diameter,distal,drying,elliptic,filament,finely,flat,flower,forked,fresh,fruit,generally,glabrous,green,green-white,greenish,hair,half,herb,interjected,lanceolate,lateral,leaf,leaflet,less,light,lobe,long,make,margin,medium,membranous,middle,minute,mm,mottled,mucilaginous,narrow,odd-pinnate,orbicular,ovate,ovoid,pedicel,peduncle,petiole,plant,pubescent,purple,ray,ripe,seed,sessile,simple,size,sparsely,stem,stigma,style,subsessile,subtending,terminal,testal,thick,throughout,tube,usually,wall,wet,whitish,wide,wing,x	0.3-0.4,0.3-0.7,1-10,3-5,4-11,4-7,5-merou,abaxially,acumen,adaxially,ag,along,alyx,apart,apparently,arranged,asymmetrical,axe,basiscopic,bead,blade,capitat,ciliate,commonly,darker,decreasing,digestion,dorsally,eaf,edge,eed,enzyme,erec,especially,exceeding,folded,fourt,geminat,glabrou,gradually,hair-like,homostylous,honeycomb-shaped,larger,lengthening,like,living,lower,midrib,minutely,moniliform,multiple,necklace,nflorescence,orolla,pair,pentagonal,perfect,petiolule,plurifoliate,pore,poricidal,puberulent,pubescen,removed,rotate,ruit,secondary,semierect,seudostipule,side,slightly,slit,spaced,specimen,stamen,ste,stolon,straight,subequal,symmetrical,tall,tamen,tem,tip,tissue,toward,tri-,tuber,typically,unit,vary,yellow,ympodial	'',[,\u201chair-like\u201d,``,arrangement,bark,branch,calyx,capitate,characteristic,colour,corrugation,exertion,form,fourth,glabrousnes,growth,height,history,inflorescence,length,life,lobing,midpoint,na,new,number,ovary,per,prickle,primary,pseudostipule,shape,surface,texture,thicknes,type,value,variation,vein,width,{,}
346	wfo-0001029980	invalid_json_followup	173	163	117	56	46	0.676	.1,0.1-0.25,0.25-0.5,0.5-1.2,0.5-2.5,0.5-5,0.7-1.3,0.8-1.2,1-1.5,1-1.7,1.2-2.5,1.5-2,2-5,2/3,3-4,3-9,5-50-flowered,6.4-17,acute,adaxially,anther,apex,appearing,appressed,bark,base,berry,black,bright,brown,bud,calyx,cm,corolla,curved,dark,decurrent,deflexed,dia,difoliate,dried,drying,elliptic,especially,exserted,filament,five,flattened-reniform,fruiting,glabrous,globose,gray,green,greenish-white,impressed,knob,lateral,leaf,live,lobe,lobed,long,margin,material,minutely,mm,near,node,often,older,one,opposite,ovary,ovate,pale,papillose,pedicel,petiole,pitted,plant,pore,poricidal,puberulent,rounded,shape,shaped,shiny,shrub,side,simple,size,slender,slightly,small-capitate,soon,stem,stigma,straight,style,surface,tan,tapering,tear-drop,tip,trichome,tube,tuft,unicellular,uniseriate,unit,vein,way,white,winged,x,yellowish,young	.5,0.25-1,0.5-1,0.9-4.5,1.5-6,2-6,5-10,abaxially,anthesi,apar,axil,ba,closely,conical,deltoid,density,differing,eaf,edicel,eed,elevation,free,geminat,greatly,high,incrassate,lon,lower,main,major,middle,minor,nflorescence,onto,orbicular,overlapping,pair,paler,portion,prominent,proximal,race,reflexed,ruit,scar,somewhat,spaced,specimen,tall,ud,varying,venezuelan,whit,widest,woody,ympodial	'',[,``,arrangement,branch,characteristic,colour,corrugation,diameter,distal,exertion,form,fruit,geminate,glabrousnes,growth,height,history,inflorescence,interjected,leaflet,length,life,lobing,midpoint,na,new,number,peduncle,per,pr,prickle,primary,pseudostipule,ray,seed,sympodial,terminal,texture,thicknes,type,value,variation,width,{,}
347	wfo-0001029989	success	161	120	90	71	30	0.559	/2,0.5-1,0.5-1.5,1-1.5,1-2.5,1.3-2.3,1.5-2.5,10-14,2.5-3,3-8,3.5-8,4-4.5,5-10-flowered,7-20,abaxially,acute,adaxially,anther,apex,bark,base,berry,branch,branched,calyx,capitate,cm,congested,conical,corolla,dendritic,densely,dia,difoliate,drying,elliptic,exserted,filament,flattened,fruiting,glabrous,globose,golden,gray,green,greenish-black,incrassate,inflorescence,internodal,lateral,leaf,lenticular,lobed,long,main,margin,minutely,mm,nearly,nodding,occasionally,opposite,ovary,pair,pedicel,petiole,pitted,pubescent,reddish,reddish-brown,shaped,shining,shrub,simple,small,stem,stigma,style,surface,tear-drop,tree,tree-like,trichome,tube,unifoliate,vein,way,white,wide,x	.2,.5,0.25-0.5,1-2,1-4,3-5,5-6,abaxial,anthesi,broadly,brownish-re,central,closely,collection,deflexed,deltoid,dense,described,dimaeter,discussion,due,eaf,edicel,eed,erect,fleshy,free,geminat,heteromorphic,inflorescenc,lamina,like,lobe,lon,lower,middle,nflorescence,northern,older,overlappin,papillo,peru,peruvian,perÃº,petal,petaloid,planar,population,pore,poricidal,portion,probably,pubescence,rest,ruit,scar,scattered,see,short-style,somewhat,spaced,sparsely,tall,tip,ud,unit,widest,woody,yellow,ympodial,young	0.2,2.5-6,arrangement,brownish-red,bud,characteristic,colour,corrugation,diameter,exertion,form,fruit,glabrousnes,growth,height,history,length,life,lobing,na,new,peduncle,perennial,plant,primary,seed,shape,size,texture,type
348	wfo-0001030000	success	155	156	128	27	28	0.826	-4,-5,-50,-7,-pilose,0.5-,0.5-1,0.5-14,0.5-3,1,1-,1-10,1-2,1.5-,1.5-2,10-,10-20,15-25,2-2.5,2-3,2-4,2-5,2.5-,2.5-3,2.5-3.5,25-30,3-4,3.5-5,30-50,4,4-4.5,4-5,7-15,abaxially,absent,acute,adaxially,also,apart,apex,apiculate,articulated,axe,base,calyx,chartaceous,cm,connective,connivent,conspicuous,coriaceous,cucullate,deltate,densely,dia,diameter,dilated,directed,distally,eglandular,ellipsoidal,equal,exceeding,flattened,flower,fruit,glabrous,globose,green,hair,immature,laterally,leaving,lobe,long,margin,mature,mm,moderately,narrowly,oblong,obtuse,occasionally,orange,ovoid,pedicel,pedicellar,peduncle,perfect,pilose,pore,produced,puberulent,pubescent,purplish,rachi,radiu,rarely,remnant,scar,shorter,shrub,slightly,small,sparsely,spotted,stellate,stigma,strongly,style,subcoriaceous,swelling,thecae,tinge,tip,tomentose,tree,triangular,truncate,tube,umbrella-shaped,unbranched,white,wide,x,yellow,yellow-brown,yellowish	3-,3-16,4-foliat,aggregate,ape,biglandula,cell,ciliat,creamy-whit,eed,lon,lower,nflorescence,nther,orolla,pubescen,ruit,smal,spaced,stamen,stone,tal,tem,ud,unit,vary,ympodial	anther,articulation,biglandular,bud,characteristic,ciliate,colour,corolla,creamy-white,direction,form,glabrousnes,growth,height,history,inflorescence,length,life,ovary,perennial,plant,seed,shape,size,spacing,stem,theca,type
349	wfo-0001030000	invalid_json_followup	178	157	101	77	56	0.567	-50,-7,-pilose,0.5-,0.5-1,0.5-13,0.5-3,1-10,1-2,1-5,1.5-,10-,15-25,2-,2-2.5,2-4,2.5-,2.5-3.5,25-30,3-,3-4,3.5-5,30-50,4-25,4-4.5,4-5,5-25,7-15,abaxially,acuminate,acute,adaxially,also,apex,apiculate,basal,base,calyx,cm,cordate,cucullate,deltate,densely,dia,diameter,eglandular,ellipsoidal,entire,flattened,flower,fruit,glabrescent,glabrous,globose,green,hair,immature,lobe,long,margin,mature,mm,moderately,narrowly,oblique,oblong,obtuse,occasionally,often,orange,ovate,ovoid,pedicel,peduncle,perfect,petiole,pilose,puberulent,pubescent,purplish,shrub,simple,slightly,small,sparsely,spotted,stigma,style,subcoriaceous,tinge,tip,tree,triangular,truncate,tube,unbranched,vein,white,x,yellow,yellow-brown	-2,-4,-5,0.5-14,1,1-,1-1.5,1.5-2,10-20,2-3,2-5,2.5-3,3-16,4,4-foliat,absent,aggregate,apart,ape,articulated,axe,biglandula,blade,cell,chartaceous,ciliat,connective,connivent,conspicuous,coriaceous,creamy-whit,dilated,directed,distally,eaf,eed,elliptic,equal,exceeding,laterally,leaving,lon,lower,nflorescence,nther,orolla,pedicellar,pilo,pore,produced,pubescen,rachi,radiu,rarely,remnant,ruit,scar,shorter,smal,spaced,stamen,stellate,stone,strongly,swelling,tal,tem,thecae,time,tomentose,ud,umbrella-shaped,unit,vary,wide,yellowish,ympodial	'',[,``,anther,arrangement,bark,biglandular,branch,bud,characteristic,colour,corolla,corrugation,distal,drying,exertion,filament,form,fruiting,glabrousnes,growth,height,history,inflorescence,interjected,lateral,leaf,leaflet,length,life,lobing,midpoint,na,new,number,ovary,per,plant,prickle,primary,pseudostipule,ray,seed,shape,size,stem,surface,terminal,texture,thicknes,type,value,variation,width,{,}
350	wfo-0001030004	success	177	141	115	62	26	0.65	0-0.5,0-1.5,0.2-1,0.8-1.1,1-2,1.2-2,1.5-2.5,15,15-20,2-20,20-200-flowered,3-3.5,3.5-5,4-15,5-25,9-30,abaxial,across,acuminate,acute,adaxially,along,anther,apex,bark,basal,base,berry,branched,broadly,calyx,capitate,cm,collection,conical,corolla,crotaloid,decurrent,dendritic,dense,densely,dia,drying,elliptic,erect,exserted,filament,flattened-reniform,fruiting,glabrous,globose,green,incrassate,inflorescence,later,lateral,leaf,like,lobed,long,loose,main,many,margin,minutely,mm,nearly,obovate,obovoid,occasionally,often,older,onto,ovary,pair,pale,pedicel,petiole,pitted,plant,plurifoliate,portion,prominent,pubescence,pubescent,seed,sessile,shaped,shrub,small,sparsely,stem,stigma,stout,strongly,style,surface,tan,tear-drop,terminal,thick,time,translucent,tree,trichome,tube,variously,vein,white,wide,winged,x,yellowish,yellowish-green,young	.3,0.3-1,1-1.5,3-4,abaxially,always,anthesi,apar,appearanc,axillary,barely,blade,body,branching,bushy,cone,deltate,denser,diamete,distal,eaf,edicel,eed,especially,flat,fleshy,free,giving,greenish-yello,hard,juvenile,knob,lamina,large,lobe,lower,middle,much,nflorescence,papillate,papillo,pericarp,planar,pore,poricidal,possessing,rest,ruit,scar,simple,spaced,surpassing,tall,thin,tip,tub,tuft,ud,unevenly,widest,woody,ympodia	arrangement,branch,bud,characteristic,colour,corrugation,diameter,exertion,form,fruit,glabrousnes,greenish-yellow,growth,height,history,length,life,lobing,na,new,peduncle,primary,shape,size,texture,type
351	wfo-0001030007	success	168	124	81	87	43	0.482	.4,.5,0.8-1,1-1.5,1-15,1-2,1.6-2.2,15-20,2-4,3/4,6-10-flowered,7-10,7-9,acuminate,acute,anther,apex,bark,base,berry,brown,bud,calyx,campanulate,clavate,cm,corolla,decurrent,densely,dia,elliptic,exserted,filament,flattened,fruiting,glabrous,globose,golden-pubescent,green,lateral,leaf,lobe,long,main,margin,minutely,mm,oblique,onto,ovary,pair,pale,papillose,pedicel,petiole,pitted,plant,pubescent,reniform,shaped,shrub,simple,slender,slightly,soon,sparsely,stem,stigma,straight,style,surface,tapering,tear-drop,tube,type,vein,way,white,winged,x,young	.05,0.1-0.5,0.2-1,0.5-1,1.5-5,2-7,3-5,4.5-5,abrupt,along,anthesi,apart,ba,becoming,beneath,branched,broadly,closely,cork,dark,deltoid,difoliate,dry,edicel,eed,erect,fleshy,free,geminateleaf,glabrate,golden,gre,hooded,impressed,incrassate,inflorescenc,like,live,lobed,lon,longer,lower,major,material,middle,midrib,minor,nflorescence,obovoid,occasionally,older,one,opposite,outline,papillo,planar,pore,poricidal,portion,prominent,raised,rest,rounded,ruit,scar,short,shorter,small,soft,spaced,specimen,tall,thick,thickened,tip,tree,trichome,trunk,tub,two,ud,uniseriate,unit,widening,widest,woody,ympodial	alternate,appearance,arrangement,border,branch,characteristic,colour,diameter,distal,exertion,form,fruit,giving,glabrousnes,grey,growth,height,history,inflorescence,interjected,leaflet,length,life,lobing,midpoint,na,new,number,peduncle,per,perennial,prickle,primary,pseudostipule,ray,seed,shape,size,terminal,texture,thicknes,variation,width
352	wfo-0001030010	success	156	132	104	52	28	0.667	.5,.75,/4,0.5-5,0.9-1.1,1-1.3,1-1.5,1.5-2,10-15,10-50-flowered,11-12,2-2.2,2-7,2.5,20-40,5-7,acuminate,acute,anther,apex,area,attenuate,bark,basal,base,beneath,berry,brown,bud,calyx,cm,corolla,cyathiform,dark,deciduous,decurrent,dia,exserted,f,filament,fleshy,fruit,fruiting,furcate,glabrate,glabrous,globose,green,grey,lateral,leaf,lobed,long,main,margin,midrib,minute,minutely,mm,near,nearly,obovate,occasionally,often,older,opposite,orange,ovary,ovoid-reniform,pair,papillose,pedicel,petiole,pitted,pore,poricidal,puberulent,reddish,shaped,shrub,simple,size,slightly,small,smooth,soon,stem,stigma,style,surface,tapering,tear-drop,tiny,tip,tree,trichome,tube,uniseriate,vein,way,white,winged,x,young	0.7-1,1-2,1.2-1.5,3-5,4-4.5,7-10,anthesi,appearing,closely,deflexed,deltate,differing,difoliate,distal,dry,eaf,edicel,eed,ellipsoid,free,geminat,hooded,lobe,lon,lower,m.,major,materia,material,middle,minor,nflorescence,one,overlappin,persistent,planar,portion,prominent,rather,ruit,scar,shin,spaced,straight,styl,tall,trunk,ud,unit,widest,woody,ympodial	alternate,arrangement,branch,characteristic,colour,corrugation,diameter,drying,exertion,form,glabrousnes,growth,height,history,inflorescence,length,life,lobing,na,new,peduncle,plant,primary,seed,shape,shiny,texture,type
353	wfo-0001030023	invalid_json_followup	171	148	87	84	61	0.509	0-100+,0.5-1,1-8,1.5-2,1.5-7,10-,10-25,12-18,2.5-3.5,20-30,3-4.5,3-5,30-50+,4,4-12,5,5-16,5-6,6-26,7-9,abaxially,acute,adaxially,apex,apiculate,basal,base,branched,calyx,cm,connivent,cordate,cuneate,deeply,densely,diameter,ellipsoidal,elliptic,entire,finely,flattened,fleshy,flower,forked,fruit,glabrous,glandular-puberulent,globose,greenish-white,highly,lanceolate,lobe,long,loosely,margin,mm,moderately,narrowly,oblique,oblong,obtuse,occasionally,often,ovate,pedicel,peduncle,peltiform,petiole,probably,puberulent,pubescent,purplish-,short-acuminate,simple,sparsely,stigma,style,tip,tree,triangular,truncate,tube,unbranched,usually,vein,x,yellowish	-,1,1-,1-2,11-40+,13-20,2,2-3,4-10,4-foliat,5-,6-7,aggregate,apart,ape,articulated,axe,beyond,blade,capitat,cell,ciliate,color,connective,cylindrical,denser,dilated,directed,distally,eaf,eed,especially,exceeding,except,exserted,glandular-puberulen,hair,leaving,lon,lower,main,membranaceous,narrow,near,nflorescence,nther,orolla,pedicellar,perfect,pore,presen,present,prominent,pubescen,pubescence,pubescent-pilo,rachi,radiu,remnant,ripe,ruit,shorter,slightly,small,somewhat,spaced,stamen,stellate,stone,subcoriaceous,swelling,tal,tem,thecae,time,ud,unit,unknow,unknown,vary,villous,wide,ympodial,young	'',[,``,anther,appearance,arrangement,bark,branch,bud,capitate,characteristic,colour,corolla,corrugation,distal,drying,exertion,filament,form,fruiting,giving,glabrousnes,green,growth,height,history,inflorescence,interjected,lateral,leaf,leaflet,length,life,lobing,midpoint,na,new,number,ovary,per,perennial,plant,prickle,primary,pseudostipule,pubescent-pilose,ray,seed,shape,size,stem,surface,terminal,texture,thicknes,type,value,variation,width,{,}
354	wfo-0001030032	success	250	140	107	143	33	0.428	0.2-0.3,0.5,0.5-0.6,0.5-1.5,0.8-1.0,1-1.3,1-1.5,1.5-2,1.5-2.5,11-20,13-35,2-10,2-3-locular,2-3.5,2-4,2-5,2.4-3.5,3.0-3.5,3.5-12,30,4-5,4.3-5.0,5-plurifoliate,6-11,7-16,7.5-10,8-10,8-20,acuminate,acute,anther,apex,articulated,base,branched,bright,brown,calyx,capitate,cm,completely,conical,corolla,dark,decurrent,deltate,densely,diameter,elliptic,entire,exserted,filament,fruit,fruiting,glabrous,golden,green,greenish-brown,hair-like,halfway,imparipinnate,interjected,internode,interrupted,irregularly,lateral,leaf,leaflet,length,lobe,long,many,margin,mm,oblanceolate,obovate,orbicular,outgrowth,ovary,pale,pedicel,peduncle,petiole,primary,pseudostipule,pubescence,pubescent,seed,splitting,stem,stigma,style,surface,terminal,thick,thickened,time,truncate,tube,unit,vein,vine,white,wide,woody,yellow,Â½-3/4	+,.05,.5,0.1-0.4,0.1-0.5,0.2,0.2-0.5,0.25-0.4,0.4-1.5,0.5-0.7,0.5-1,0.5-2,0.6-1.1,0.7-0.8,0.8-1.1,1-2-celled,1-3,1-celled,2,2-60,2-lobed,3,3-5,4-6-celled,4-celled,60-80,8-10-celled,abaxially,absent,abundant,adaxial,adaxially,along,also,anthesi,apical,appearance,appendage,articulation,basal,basally,basiscopically,bent,border,branche,breaking,cell,clambering,column,conspicuou,densest,desne,dry,eaf,ebracteate,edicel,eed,flower,free,give,glandular,gree,hea,head,herbarium,lamina,large,larger,leave,like,longest,lower,markedly,middle,midvein,mixed,moderately,much,multicellular,nflorescence,node,oblique,occasionally,often,older,onto,opposite,pair,paler,patent,petiolule,pithy,present,rachi,reflexed,rest,rotate,rotate-stellate,rough,round,ruit,secondary,set,shorter,silky,simple,slightly,smaller,soft,sometimes,somewhat,sparsely,sparser,specimen,spreading,stamen,staminal,sterile,straight,subopposite,swollen,tall,tangled,tem,tertiary,testa,tiny,tip,touch,transparent,trichome,ud,unicellular,uniseriate,usually,vegetatio,venation,wall,weaker-walled,well-developed,winged,ympodial,younger	arrangement,branch,bud,characteristic,colour,corrugation,dense,distal,drying,exertion,form,glabrousnes,growth,height,history,inflorescence,life,lobing,midpoint,na,new,perennial,plant,prickle,ray,shape,size,sympodial,texture,thicknes,type,variation,width
355	wfo-0001030048	success	156	133	102	54	31	0.654	0.5-1.5,1-1.5,1.2-2,1.3-1.6,1.5-3.5,1.5-7,10-16,2-5,3-3.5,3-5,4-15,4-4.5,5-10-flowered,5-8,abaxial,acute,adaxially,along,anther,anthesi,apex,apically,arachnoid,bark,base,becoming,berry,bi-colored,bi-lobed,blue,brown,calyx,clavate,cm,completely,conical,corolla,covered,decurrent,deflexed,densely,dia,difoliate,drying,ellipsoid,elliptic,exserted,felt-like,filament,fruiting,glabrous,globose,golden,green,greyish,internodal,lamina,lateral,leaf,lobed,long,main,margin,matted,minutely,mm,nearly,occasionally,onto,opposite,ovary,ovoid-reniform,pair,pale,pedicel,petiole,pitted,pointed,pubescent,reddish-brown,shaped,shiny,shrub,simple,small,somewhat,stem,stigma,strongly,style,surface,tan,tear-drop,tree,trichome,trifoliate,tube,unit,vein,white,wide,yellowish	.5,1-2,2-3,5973,abaxially,ape,apparently,broadly,closely,deltate,eaf,edicel,eed,fide,fleshy,four-angle,free,geminat,glabrate,impressed,inflorescenc,lightly,like,lobe,lon,lower,middle,nflorescence,older,overlappin,papillo,papillose,planar,pore,poricidal,portion,prominent,rather,rest,ruit,scar,solomon,spaced,sparsely,tall,thick,thickened,tip,tub,ud,widest,woody,ympodial,young	0.5,arrangement,branch,bud,characteristic,colour,corrugation,diameter,exertion,form,fruit,glabrousnes,growth,height,history,inflorescence,length,life,lobing,na,new,peduncle,perennial,plant,primary,seed,shape,size,sympodial,texture,type
356	wfo-0001030053	success	141	105	74	67	31	0.525	0.5-1,1-1.3,1-13,1.3-3.5,1.5-5.5,1.8-2,10-20,2.5-3,3.5-4,4-,7-11,7-9,abruptly,acuminate,acute,anthesi,apex,apical,base,berry,branch,branched,brown,calyx,cm,corolla,cyathiform,decurrent,diameter,elliptic,entire,exserted,far,filiform,flattened,fruiting,glabrous,greenish,growth,inflorescence,long,many,margin,minutely,mm,new,nipple,pair,pale,pedicel,peduncle,per,petiole,pitted,primary,reniform,revolute,shining,shiny,simple,slightly,stem,surface,terminal,time,truncate,tube,turbinate,vein,vine,white,woody,x,yellowish	0.5,100,2-2.5,5,5-merou,<,abscission,aiding,alyx,apart,apiculae,ark,around,articulated,bfeore,cell,climbin,completely,coriaceous,eaf,eed,fide,fine,flower,fragrant,frui,hyaline,irregularly,leaving,lobe,lobed,lower,mentz,near,nflorescence,older,orolla,papilla,papillo,parallel,peg,pendant,perfect,plurifoliat,rectangular,rim,scar,secondary,shallowly,shin,sleeve,small,spaced,spreadin,spreading,strongly,support,tem,testal,tiny,tip,twining,ud,unit,usually,venation,ympodial	anther,arrangement,bark,bud,characteristic,colour,corrugation,drying,exertion,filament,form,fruit,glabrousnes,height,history,leaf,length,life,lobing,na,number,ovary,papillose,plant,seed,shape,size,stigma,style,texture,type
357	wfo-0001030057	success	141	124	76	65	48	0.539	-2,2-3-celled,2-4,2-4.5,2-6,2.1-4.1,20-30,20-80,3.5-8,4.3-8.2,5.5-12,7-14,8,8-19,absent,acuminate,acute,apex,articulated,axillary,base,berry,bud,chartaceous,cm,cordate,cuneate,diameter,distal,drying,elliptic,flower,forked,fruit,generally,globose,green,greenish,hair,half,herb,high,interjected,lateral,leaf,leaflet,like,long,membranous,mm,mottled,mucilaginous,narrow,odd-pinnate,ovate,ovoid,pedicel,peduncle,petiole,plant,pubescent,purple,seed,short,size,sometimes,stem,subglabrous,subtending,terminal,truncate,unwinged,usually,whitish,wing,x	1-10,1-2,3-5,4-10,abaxially,adaxially,apart,apparently,axe,blade,borne,broadly,brownish,cell,condition,covering,decreasing,digestion,eaf,eed,end,enzyme,erec,extremely,fresh,geminat,glabrou,greatly,green-white,hair-like,honeycomb-shaped,larger,living,lunate,make,nflorescence,pair,perfect,petiolule,plurifoliate,removed,ruit,scale-like,seudostipule,singly,small,spaced,specimen,ste,stolo,suborbicular,tall,tem,testal,thick,thir,throughout,toward,tri-,tuber,typically,unit,wall,wet,ympodial	anther,appearance,arrangement,bark,border,branch,calyx,characteristic,colour,corolla,corrugation,exertion,filament,form,fruiting,giving,glabrousnes,growth,height,history,inflorescence,length,life,lobe,lobing,margin,midpoint,na,new,number,ovary,per,prickle,primary,pseudostipule,ray,shape,stigma,style,surface,texture,thicknes,third,tube,type,variation,vein,width
358	wfo-0001030057	invalid_json_followup	197	174	128	69	46	0.65	-10,-2,.5-3.5,1-2,2-3-celled,2-4,2-4.5,2-6,2.1-4.1,20-30,20-80,3.5-8,4.3-8.2,5-6,5.5-12,7-14,8,8-19,abaxially,absent,acuminate,acute,adaxially,along,anther,apex,apparently,articulated,axe,axillary,base,berry,brownish,bud,cell,chartaceous,ciliate,cm,condition,connivent,cordate,corolla,covering,cuneate,diameter,distal,drying,elliptic,especially,filament,flower,forked,fresh,fruit,generally,glabrous,globose,green,green-white,greenish,greenish-yellow,hair,half,herb,high,interjected,lanceolate,lateral,leaf,leaflet,lengthening,like,linear,long,make,margin,membranous,middle,midrib,minutely,mm,mottled,mucilaginous,narrow,odd-pinnate,ovate,ovate-lanceolate,ovoid,pedicel,peduncle,pentagonal,perfect,petal,petiole,plant,pore,poricidal,puberulent,pubescent,purple,rotate,seed,short,size,slit,sometimes,stem,stigma,striped,style,subglabrous,subtending,terminal,testal,thick,throughout,tip,truncate,tube,unwinged,usually,wall,wet,white,whitish,wing,x,yellow	1-10,2-3,2-5,3-5,4-10,5-10,5-merou,acumen,ag,alyx,apart,blade,borne,broadly,decreasing,digestion,dorsally,eaf,edge,eed,end,enzyme,erec,exceeding,extremely,flat,folded,geminat,glabrou,globo,greatly,hair-like,homostylous,honeycomb-shaped,larger,living,lobe,lower,lunate,nflorescence,orolla,pair,petiolule,plurifoliate,removed,ruit,scale-like,seudostipule,singly,small,spaced,specimen,stamen,star,ste,stolo,straight,suborbicular,tall,tamen,tem,thir,toward,tri-,tuber,typically,unit,vary,ympodial	'',[,\u201chair-like\u201d,\u201cstar\u201d,``,age,arrangement,bark,branch,calyx,characteristic,colour,corrugation,exertion,form,fruiting,glabrousnes,growth,height,history,inflorescence,length,life,lobing,midpoint,na,new,number,ovary,per,prickle,primary,pseudostipule,ray,shape,surface,texture,thicknes,third,type,value,variation,vein,width,{,}
359	wfo-0001030080	invalid_json_followup	186	147	98	88	49	0.527	0.3-7,0.4-1.5,0.5-4,1-2,1-3,1.5-2,1.5-2.5,1.8-4.5,2.1-7.1,3-10,3.3-7.7,4-12,5-7,5.5-9.9,6.5-18.6,8-23,9.9-33,abaxially,absent,acuminate,adaxially,anther,apex,axillary,base,berry,brownish,bud,cell,clavate,cm,condition,coriaceous,corolla,covering,cuneate,dark,decurrent,diameter,distal,dot,drying,elliptic,filament,forked,fresh,fruit,generally,glabrescent,glabrous,green,green-white,greenish,hair,half,herb,interjected,lanceolate,lateral,leaf,leaflet,light,lobe,make,medium,mm,mucilaginous,odd-pinnate,onto,ovate,ovoid,pedicel,peduncle,petiole,plant,purple,pyriform,rachi,seed,size,sometimes,stigma,style,subtending,terminal,testal,thick,throughout,tiny,tube,usually,wall,wet,white,whitish,width,winged,x	1999,2-3,2-4,3-5,4-7,5-13.5,5-merou,8-16,abaxiall,acumen,ag,along,alyx,apart,apparently,arranged,articulated,axe,bead,blade,capitat,ccording,connivent,decreasing,digestion,dorsally,eaf,edge,eed,enzyme,erec,exceeding,flat,flower,folded,geminat,glabrou,hair-like,hal,high,homostylous,honeycomb-shaped,inconspicuous,larger,lengthening,like,linear,living,long,lower,moniliform,mottled,multiple,necklace,nflorescence,ochoa,orolla,pair,perfect,plurifoliate,pore,poricidal,removed,second,seudostipule,slightly,slit,spaced,specimen,stamen,stellate,stolon,straight,strongly,subequal,tall,tamen,tem,tip,toward,tri-,tuber,typically,unit,unknown,vary,yellow,ympodial	'',[,\u201chair-like\u201d,``,appearance,arrangement,bark,border,branch,calyx,capitate,characteristic,colour,corrugation,erect,exertion,form,fruiting,giving,glabrousnes,growth,height,history,inflorescence,length,life,lobing,margin,midpoint,na,new,number,ovary,per,prickle,primary,pseudostipule,ray,shape,stem,surface,texture,thicknes,type,value,variation,vein,{,}
360	wfo-0001030081	success	157	124	89	68	35	0.567	.5,0.5-1,0.5-1.5,0.5-2.5,1,1-2,1-3,1-4,1-5,1.5,1.5-7,10-20,10-35,2-foliate,4-6,5-12,5-15,absent,acute,anther,apex,base,berry,brown,calyx,center,chartaceous,ciliate,cm,cordate,decurrent,densely,diameter,dm,drying,edge,elliptic,elliptic-ovoid,entire,few-branched,filament,fine,flower,fruit,geniculate,glabrous,globose,hair,herb,immature,linear-lanceolate,long,margin,maturing,membranaceous,mm,moderately,nearly,oblong,obtuse,often,parallel,pedicel,peduncle,per,petiole,pubescent,radiating,raised,ridge,rounded,running,semitransparent,shallow,short,single-,sparsely,stigma,style,surface,triangular,tube,two-celled,unbranched,usually,vein,white,x,yellow	0.25-0.5,1-2-celled,1.5-3,1st,2-4,2-7,2nd,3-10,3-6,abaxially,abundant,adaxiall,adaxially,along,apically,axe,beyond,blade,cell,connected,dehiscing,denser,eaf,eed,emarginat,equal,explosively,exserted,flat,frui,geminat,held,interpetalar,lobe,longer,lower,lying,maturit,mesocarp,nfloresence,notch,one,orolla,other,placenta,pointing,pressure,pubescen,rachi,rarely,rotate,ruit,slightly,small,sometimes,stamen,straight,swollen,tal,tamen,tem,tissue,unit,vary,watery,wid,woody,ympodial	arrangement,bark,branch,bud,characteristic,colour,corolla,corrugation,emarginate,exertion,form,fruiting,geminate,glabrousnes,growth,height,history,inflorescence,leaf,length,life,lobing,na,new,number,ovary,plant,primary,seed,shape,size,stem,texture,type,wide
361	wfo-0001030083	invalid_json_followup	146	145	95	51	50	0.651	.75,0.5-2,0.8-1,0.8-3,1-1.5,1-2,1.5-3,10-30,2,2-3,2-5-flowered,3-4,3/4,4-15,4-6,9-11,accrescent,acute,anther,apex,bark,base,berry,broadly,calyx,cm,corolla,cup-shaped,decurrent,deeply,dia,drying,elliptic,exserted,fleshy,fruit,fruiting,glabrous,globose,green,greenish-white,hyaline,lateral,leaf,lobe,lobed,long,long-acuminate,long-styled,main,membranous,minutely,mm,narrowly,onto,ovary,ovate,ovoid-reniform,pair,pale,papillose,pedicel,petiole,pitted,poricidal,red-papillose,reddish-gold,shallowly,short-styled,shrub,simple,single-stemmed,slender,small-capitate,somewhat,soon,stem,stigma,straight,strongly,style,surface,tan,tapering,terminal,thin,tip,translucent,tube,vein,way,white,winged,woody,x	.5,0.1,0.25-0.5,0.5-1,anthesi,beginning,closely,dar,deciduous,deflexed,deltoid,dry,eaf,edicel,eed,elongate,flower,greyish-re,inflorescenc,internodal,lon,lower,middle,near,nflorescence,older,opposite,overlapping,paler,papillae,pore,prominent,proximal,raised,reflexed,ruit,scar,shaped,slightly,spaced,specimen,tall,tear-drop,thickened,tub,ud,unifoliat,unit,widest,ympodial,young	'',[,``,arrangement,branch,bud,characteristic,colour,corrugation,diameter,distal,exertion,filament,form,glabrousnes,greyish-red,growth,height,history,inflorescence,interjected,leaflet,length,life,lobing,margin,midpoint,na,new,number,peduncle,per,perennial,plant,prickle,primary,pseudostipule,ray,seed,shape,size,texture,thicknes,type,unifoliate,value,variation,width,{,}
362	wfo-0001030093	invalid_json_followup	181	151	105	76	46	0.58	.5,0.1-0.3,0.2-0.5,0.5-1.1,0.6-1.5,0.75-1,1-1.5,1-12,1-5,2-2.5,3-4,3.5-12,4-6,7-30,7-9,8-9,acuminate,acute,anther,apex,attenuate,bark,base,becoming,beneath,berry,branched,brownish-tan,calyx,campanulate,case,clavate,cm,continues,corolla,cuneate,densely,dia,ellipsoid,elliptic,erect,exserted,filament,fruiting,glabrous,globose,golden,green,greenish-white,growth,hirsutulous,lateral,leaf,lobe,lobed,long-styled,main,margin,minutely,mm,narrowly,nearly,new,obovate,occasionally,often,opposite,ovary,ovoid-reniform,pair,pale,pedicel,petiole,pitted,plant,puberulent,pubescent,shaped,shiny,shoot,short-styled,shrub,simple,size,slender,slightly,small,soon,stem,stigma,straight,style,surface,tapering,tear-drop,terminal,tiny,tree,trichome,tube,uniseriate,vein,white,x,yellowish	.2,0,0.2,0.2-1,1.3-4.5,2.5-11,5-50-flowered,5-8,anthesi,apar,closely,collection,commonly,deflexed,deltoid,differing,difoliate,eaf,edicel,eed,especially,evenly,except,expanded,flower,forest,free,furcate,geminat,greyish-brow,guyanese,hyaline,impressed,inundated,like,lon,long,lower,major,many,member,middle,minor,nflorescence,older,one,onto,open,orbicular,paler,papillo,persisting,population,pore,poricidal,portion,present,quite,reflexed,remaining,ruit,scar,southern,spaced,tall,thickened,time,tip,tub,ud,underside,unit,widest,woody,ympodial,young	'',[,``,alternate,arrangement,branch,bud,characteristic,colour,corrugation,diameter,distal,drying,exertion,form,fruit,glabrousnes,greyish-brown,height,history,inflorescence,interjected,leaflet,length,life,lobing,midpoint,na,number,papillose,peduncle,per,prickle,primary,pseudostipule,ray,seed,shape,texture,thicknes,type,value,variation,width,{,}
363	wfo-0001030145	success	153	131	81	72	50	0.529	-3,0.2-2,0.3-,0.5,0.5-1,0.5-4,1,1-2,1-2.5,1-3,1.5-2,1.5-7,10-12,2.5-6.5,3,3-10,3-5,4-8,6-40,abaxially,acute,adaxially,adpressed,also,apex,basal,base,calyx,cm,compound,cuneate,deltate,densely,diameter,ellipsoidal,elliptic-ovate,entire,flower,forked,fruit,glabrous,glandular,globose,hair,herb,lateral,leaf,leaflet,less,lobe,long,margin,mm,moderately,narrowly,obtuse,ovate-elliptic,pedicel,peduncle,petiole,pilose,puberulent,ripe,shrub,simple,sinuate,slender,sparsely,stigma,style,subcordate,subcoriaceous,terminal,ternately,triangular,truncate,tube,unbranched,unknown,violet,x	-2,1-1.5,1-5,1.5,1.5-4.5,2-3,2-4,3-4,4-5,4-foliat,8-11,absent,aggregate,apart,ape,articulated,axe,beyond,blade,campanulate,cell,chartaceous,color,connective,cylindrical,directed,distally,dunal,eaf,eed,elliptic,exceeding,exserted,fide,fleshy,lanceolate,larger,leaving,lon,lower,near,nflorescence,nther,orolla,pedicellar,pore,presen,puberulen,rachi,radiu,reddish,remnant,ruit,shorter,slightly,somewhat,spaced,stamen,stone,tal,tem,thecae,time,tomento,toward,truncat,ud,unit,vary,wide,yellow,ympodial	anther,appearance,arrangement,bark,border,branch,bud,characteristic,colour,corolla,corrugation,distal,drying,exertion,filament,form,fruiting,giving,glabrousnes,green,growth,height,history,inflorescence,interjected,length,life,lobing,midpoint,na,new,number,ovary,per,plant,prickle,primary,pseudostipule,ray,seed,shape,size,stem,surface,texture,thicknes,type,variation,vein,width
364	wfo-0001030146	invalid_json_followup	210	158	95	115	63	0.452	.2,60+,acuminate,acute,along,anther,anthesi,apex,articulated,axe,base,berry,branched,branching,brown,brownish,c.,calyx,capitate,cm,corolla,cup-shaped,dark,densely,diameter,drying,echinoid,ellipsoidal,elliptic,entire,filament,flattened-reniform,flower,fresh,fruiting,glabrous,globose,golden,green,growth,halfway,inflorescence,leaf,length,like,long,many,margin,midpoint,minutely,mm,multangulate,narrowly,new,nodding,olive,pair,pale,part,pedicel,peduncle,peltate,per,persistent,petiole,pitted,plant,primary,pubescent,ray,reddish,revolute,ripe,shiny,short-stalked,simple,small,stem,stigma,stout,style,surface,tan,terminal,time,tree,treelet,trichome,tube,undersurface,upper,vein,way,white,wide	.1,.5,0.2â0.4,0.5,0.5â1,0.6â0.7,0.6â2,0.9â1,1.2â1.5,1.5â2,16â20,1â1.1,1â1.5,2.5â9,20,20â30,2â5,3â4,3â6,40â50,4â30,4â4.5,5-merou,5â8,6.5â16,6â7,8â15,9â9.5,>,abaxial,abaxially,absent,adaxial,ag,almost,alyx,apar,appearing,ark,beig,beneath,bright,cell,center,closely,connivent,coriaceous,covered,deeply,deltate,dense,dichasia,discolorous,eaf,edge,eed,elongate,erec,exserted,free,fused,gradually,ilament,impressed,lamina,layer,lengthening,less,lobe,lobed,loosely,lower,narrowing,nflorescence,older,orolla,papillose,perfect,pericarp,plurifoliate,pore,poricidal,portion,projection,pubescence,reflexed,regularly,rhachi,ruit,scar,scurfy,sessile,slit,spaced,sparsely,stellate,strongly,subtended,tall,tangled,tem,testal,thin,tiny,tip,ud,unevenly,unit,vary,varying,visible,woody,yellow,ympodial,â18	'',0.2\u20130.4,0.5\u20131,0.6\u20130.7,0.6\u20132,0.9\u20131,1.2\u20131.5,1.5,16\u201320,1\u20131.1,1\u20131.5,2.5\u20139,20\u201330,2\u20135,3\u20134,3\u20136,40\u201350,4\u201330,5\u20138,6.5\u201316,8\u201315,9\u20139.5,[,\u201318,``,arrangement,bark,beige,branch,bud,cayx,characteristic,colour,corrugation,distal,exertion,form,fruit,glabrousnes,height,history,interjected,lateral,leaflet,life,lobing,na,number,ovary,prickle,pseudostipule,seed,shape,size,texture,thicknes,type,u00b4,value,variation,width,{,}
365	wfo-0001030147	success	158	116	69	89	47	0.437	0.5-2,1-4,1-5,14-35,15-30,2-10,2-10.5,2-13,2-3,2-5,2.5-7.5,4-5.5,4.2-7.5,5-8,acuminate,acute,apex,articulate,base,blue,branched,calyx,cm,conical,corolla,cuneate,cyme,deep,diameter,dichasial,dichasially,distal,ebracteate,elliptical,filament,finely,green,green-white,herbaceous,interjected,lateral,leaf,leaflet,lobe,long-attenuate,medium,mm,monochasial,mucilaginous,narrowly,oblique,odd-pinnate,ovate,ovoid,pedicel,peduncle,perennial,petiole,plant,pubescent,purple,rotate,rounded,seed,size,stigma,style,terminal,tuber-bearing	-8,0-5,1.0-2.0,1.0-2.2,10-19,2,3-,3-6-foliat,4-3.,4.5-10,5-7,8-38,abaxiall,abaxially,acumen,adaxially,apical,apically,attenuate,cell,connate,covering,dehiscent,digestion,diminishing,dorsally,eaf,edge,eed,emoval,enzyme,exceeding,flat,flower,folded,forked,generally,globo,gradually,hair-like,half,honeycomb,introrse,living,lon,long,lower,lunat,make,maturing,nflorescence,nther,obtuse,often,orolla,pair,pattern,perfect,petiolule,plan,poricidally,proximal,reveal,ruit,sessile,seudostipule,short,slit,specimen,stamen,straight,subequal,subsessile,tal,tem,testal,thick,throughou,throughout,tip,toward,typically,unit,vary,wall,wide,yellow,ympodial,Â¼	4-31,anther,appearance,arrangement,bark,border,branch,bud,characteristic,colour,corrugation,drying,exertion,form,fruit,fruiting,giving,glabrousnes,globose,growth,height,history,inflorescence,length,life,lobing,margin,midpoint,na,new,number,ovary,per,prickle,primary,pseudostipule,ray,shape,stem,surface,texture,thicknes,tube,type,variation,vein,width
366	wfo-0001030151	invalid_json_followup	175	149	94	81	55	0.537	-50,0.2-0.5,0.5,0.5-1,1-17,1-3,1.5-2.5,10-25,15-35,2-25,2-6,2-7-compound,20-30,3-5,3.5-32,4-5,5-6,6-9,abundantly,acuminate,acute,adaxial,apex,apiculate,basal,base,beyond,blotch,calyx,chartaceous,cm,cordate,cuneate,decurrent,deltate,diameter,elliptic,entire,except,exserted,flower,fruit,glabrous,globose,hair,lanceolate,leaf,leaflet,less,lilac-tinged,line,lobe,long,longitudinal,margin,membranaceous,mm,narrowly,oblique,oblong,obovate,obtuse,often,pedicel,peduncle,petiole,pinnately,probably,puberulent,pyriform,ripe,sand-punctate,shallowly,simple,slender,slightly,sometimes,sparsely,stamen,stigma,stripe,style,surface,tip,tree,triangular,truncate,tube,unbranched,vein,white,x,yellow,yellow-green	-3,0.3-0.5,1,1-1.5,1-2,1-5,1.5-2,10-20,2-11,2-3,3-14,4-foliat,?,abaxially,absent,adaxially,aggregate,apart,ape,around,articulated,axe,blade,cell,channe,ciliat,compound,connate,connective,cylindrical,directed,distally,eaf,eed,eglandular,exceeding,glabrate,glandular,glandular-puberulent,leaving,lon,lower,near,nflorescence,nther,orolla,pedicellar,perfect,pore,presence,purplish,rachi,radiu,remnant,ring,ruit,sand-punctat,scattered,short,shorter,small,somewhat,spaced,stalked,stellate,stone,tal,tem,thecae,time,toward,truncat,ud,unit,unknow,vary,veiny,white-puberulent,whitish,wide,ympodial	'',[,``,anther,arrangement,bark,branch,bud,channel,characteristic,colour,corolla,corrugation,distal,drying,exertion,filament,form,fruiting,glabrousnes,green,growth,height,history,inflorescence,interjected,lateral,length,life,lobing,midpoint,na,new,number,ovary,per,perennial,plant,prickle,primary,pseudostipule,ray,seed,shape,size,stem,terminal,texture,thicknes,type,value,variation,width,{,}
367	wfo-0001030153	success	147	126	101	46	25	0.687	.1,.2,/3,0.2-1,0.8-0.9,1-2,1-2.5,1.3-1.5,1.3-1.9,2-8,2-lobed,3-4,3-5,3-50,3.5-10.5,5-6,6-8,abaxially,absent,acuminate,acute,adaxially,age,anther,apex,apparently,attenuate,axil,bark,base,berry,branched,brittle,calyx,clavate,cm,conical,corolla,dark,diameter,distinct,domatia,dry,ellipsoid,elliptic,entire,erect,exerted,filament,flower,fruiting,glabrous,globose,green,growth,impressed,internodal,lanceolate,lengthening,margin,minutely,mm,narrowly,new,occasionally,older,ovary,pair,papillate,pedicel,peduncle,petiole,pit-like,pore,poricidal,primary,revolute,ripe,simple,slightly,slit,small,specimen,stem,stigma,strongly,style,surface,terminal,thin,time,tip,tree,treelet,tube,vein,way,white,x,yellowish,young	0.8-1.3,1-1.2,1-1.5,1-10,1.5-2,2.5-4,anthesi,apart,ape,apiculate,broadly,caly,campanulate,deltate,densely,dot,eaf,enlarged,free,glabrou,irregularly,known,less,lobe,lobed,lower,markedly,membranous,nflorescence,nodding,ot,paler,papillat,perfect,plane,plurifoliat,portion,rachi,resinous,ruit,scar,spaced,straight,ud,unit,ympodial	arrangement,branch,bud,characteristic,colour,corrugation,drying,exertion,form,fruit,glabrousnes,height,history,inflorescence,leaf,length,life,lobing,na,plant,seed,shape,size,texture,type
368	wfo-0001030167	success	141	118	54	87	64	0.383	.8,.9,0.6,acuminate,anther,apex,base,berry,branch,calyx,chartaceous,cm,densely,diameter,entire,extra-axillary,filament,flattened,flower,fruit,fruiting,glabrous,green,herbaceous,lanceolate,less,lobe,margin,membranaceous,mm,obtuse,ovate,ovoid,pedicel,peduncle,petiole,pinnate,pointed,rounded,sand-punctate,simple,slender,somewhat,stigma,style,symmetrical,thinly,tube,unbranched,vein,vine,weakly,white,x	0.1â0.2,0.5â0.6,0.5â0.7,0.6â0.8,0.7â1.2,0.8â1,1.2â2.5,1.5â2,1.5â7,12,14â19,15â20,17â58,1â1.2,1â1.5,2â3,2â4.5,4.5â8,4â10,4â4.5,4â5,4â7,5-merous,8â10,abaxially,accrescent,acute,adaxially,along,alyx,apar,apically,axe,blade,c.,ciliat,ciliate,clavate,climbing,contiguously,eaf,eed,enlarged,fertile,gap,glabrou,immature,long,lower,m.,maturity,membranous,minutely,moderately,near,nearly,nflorescence,nternode,orolla,pair,penden,perfec,petal,plurifoliat,rachi,reflexed,ruit,scar,secondary,seen,slightly,spaced,sparsely,stellate,subequal,tamen,tem,time,tip,truncat,unit,unknown,vary,vegetation,venation,wide,ympodial	0.1-0.2,0.7-1.2,0.8-1,1-1.5,1.2-2.5,1.5-2,1.5-7,14-19,15-20,2-4.5,4-4.5,4-5,4.5-8,8-10,appearance,arrangement,bark,border,bud,characteristic,colour,corolla,corrugation,distal,drying,exertion,form,giving,glabrousnes,growth,height,history,inflorescence,interjected,lateral,leaf,leaflet,length,life,lobing,midpoint,na,new,number,ovary,pendent,per,plant,prickle,primary,pseudostipule,ray,seed,shape,size,stem,surface,terminal,texture,thicknes,truncate,type,variation,width
369	wfo-0001030176	invalid_json_followup	171	133	81	90	52	0.474	.2,.7,0.5-2,0.7-1.4,0.7â0.8,1.2,1.2-2.5,1.6,2.25-3.25,2.5â7.5,2.5â9,3-5,3-lobed,6-8,6â8,acute,anther,apex,attenuate,base,berry,bilobed,branch,broadly,calyx,ciliate,cm,decumbent,depressed-globose,diameter,especially,extra-axillary,few-branched,filament,flattened-reniform,flower,fruit,fruiting,glabrous,herb,lanceolate-oblong,lateral,light,lobe,long,margin,midrib,mm,near,nearly,node,numerous,oblong,often,ovate,pale,pedicel,peduncle,petiole,plant,prostrate,pubescent,rarely,recurved,ripe,simple,slightly,sometimes,sparsely,stigma,style,terminal,tube,unbranched,vein,violet,white,x,yellow,yellow-orange,young	-1.4,-4.25,-6.25,.75-1.5,0.4-1.5,0.5,0.6-0.9,1,1-2,1-5,1.5-2,1.5-2.5,1/3,1/6,2-3,2-foliate,2.5,2â3,3.75-5,4-9,5-merou,abaxially,accrescent,adaxiall,adaxially,alyx,angulate,apart,apparently,articulated,asymmetrically,axe,ba,basal,bi-lobed,blade,broad,capitat,chartaceous,connivent,contact,covering,cylindrical,dehiscent,downward,eaf,eed,erec,forming,geminat,hair,hermaphroditic,hold,interlobal,juic,lance-ovate,line,lon,longitudinall,lower,major,mesocarp,minutely,nflorescence,orolla,partially,patch,perfect,pore,rachi,recurve,rooting,rotate-stellate,round,ruit,sinus,soil,somewhat,spaced,tamen,tem,time,tip,triangular,unit,vary,white-puberulent,wide,winged,ympodial	'',[,``,appearance,arrangement,bark,border,bud,capitate,characteristic,colour,corolla,corrugation,distal,drying,exertion,form,giving,glabrousnes,growth,height,history,inflorescence,interjected,leaf,leaflet,length,life,lobing,midpoint,na,new,number,ovary,per,prickle,primary,pseudostipule,ray,seed,shape,size,stem,surface,texture,thicknes,type,value,variation,width,{,}
370	wfo-0001030180	success	135	123	90	45	33	0.667	.1,.5,.75,0.05-1,0.8-2,0.9-1.8,1-1.5,1.1-1.2,10-30-flowered,3-8,4.5-5,6,8-10,8.5-23,?,abruptly,anther,anthesi,apex,appearing,attenuate,bark,base,becoming,berry,calyx,clavate,cm,corolla,dark,decurrent,dia,ellipsoid,erect,exserted,filament,fruit,fruiting,furcate,glabrate,glabrous,globose,green,height,immature,lateral,leaf,linear,lobed,long,long-acuminate,main,minutely,mm,narrowing,nearly,occasionally,opposite,ovary,pair,papillate,papillose,pedicel,petiole,planar,puberulent,rounded,shaped,shrub,slender,slightly,soon,sparsely,stem,stigma,straight,style,surface,tear-drop,terminal,tip,trichome,tube,uniseriate,unknown,vein,white,winged,x,yellowish	0.5-1,3-4,accrescent,apart,apiculate,clu,deflexe,deltoid,eaf,edicel,eed,free,inflorescenc,interpetalar,known,lenticellat,lobe,lon,lower,middle,minute,nflorescence,older,overlapping,peduncl,plurifoliat,pore,poricidal,portion,prominent,proximal,raised,ruit,scar,sinus,spaced,thin,ud,unevenly,unit,widely,widest,woody,ympodial,young	alternate,arrangement,branch,bud,characteristic,club,colour,corrugation,deflexed,diameter,drying,exertion,form,glabrousnes,growth,history,inflorescence,length,life,lobing,margin,na,new,number,peduncle,per,plant,primary,seed,shape,size,texture,type
371	wfo-0001030189	success	188	118	90	98	28	0.479	-4,/3,0-1,0-30,0.5-1.6,0.9-1.1,1,1-1.5,1.1-2.7,1.3-4.2,1.5-4.5,1.5-5,1/3,2-5.5,3-4,3.2-4.5,4-5.5,abaxially,anther,apex,apparently,articulated,bark,base,berry,calyx,chartaceous,cm,concolorous,cordate,densely,diameter,drying,dull,elliptic,entire,erect,evenly,filament,flattened-reniform,fruit,fruiting,glabrescent,gray,green,lateral,leaf,length,long,lower,margin,maturity,mauve,mm,moderately,oblong,obtuse,orange,ovate,pair,pedicel,peduncle,per,petiole,poricidal,primary,purple,red,rounded,shrub,simple,sometimes,sparsely,spherical,stellate-pubescent,stem,style,surface,tapering,terminal,tip,tube,unarmed,upper,vein,way,wide,yellow,yellow-green,young	-1/2,.2,0-15,0.1,0.1-0.2,0.2-0.3,0.2-0.5,1-2,1-3-cellular,1-4-cellula,1-4-cellular,1.5-2,1/,1/6-1/3,2,2-3,2.5-4,4-13,5-,5-10,5-6,5-merous,6-10,6-12,8,8-10,8-18,acut,alyx,apar,apically,appressed,blade,branched,connivent,curved,deltate,eaf,eed,elongating,equal,faint,flower,foliaceous,free,frui,glabrescen,glabrous,gland-tipped,infructescence,lobe,lobed,longer,mature,midpoint,nflorescence,often,older,one,open,orolla,oung,perfec,pericarp,plurifoliat,porrect,portion,ray,recurved,red-brow,reflexed,ruit,scandent,scar,sessile,shorter,slender,smooth,somewhat,spaced,spreading,stalk,stalked,stellate,strongly,tamen,terete,tertiary,time,trichome,unarme,unit,variously,vary,venation,visible,woody,ympodial	1/4,arrangement,branch,characteristic,colour,corolla,exertion,form,glabrousnes,growth,height,history,inflorescence,life,lobing,na,new,number,ovary,perennial,plant,red-brown,seed,shape,size,stigma,texture,type
372	wfo-0001030219	invalid_json_followup	191	149	95	96	54	0.497	0.1â0.3,0.2â2.3,0.5,0.5â,0.7â1.1,1.0â1.2,1.0â2.2,1.5,1.6â,2.0â2.5,2.0â3.2,2.4â6.0,2â,2â3,3,4.5â5.5,4.8â11.5,4â5,4â7,60,6â8,9â10,abaxially,acute,adaxially,anther,anthesi,apex,articulated,base,black,blue,branched,brown,calyx,cm,decurrent,deeply,densely,diameter,elliptic,filament,flattened,flower,fruit,glabrescent,glabrous,globose,green,hair,incised,indistinct,lanceolate,leaf,lilac,lobe,long,margin,marking,mm,moderately,multicellular,number,oblong,olive,ovate,pair,pale,paler,pedicel,peduncle,perennial,petiole,pitted,pubescent,purple,regularly,shallowly,shrub,simple,size,spaced,sparsely,stigma,style,surface,time,tube,unicellular,uniseriate,velutinous,winged,woody,x,â9.5	0.4â1.0,0.8â3.0,0â,1.0â1.5,1.0â2.0,1.3â2.9,1.4â2.8,10,15,1â2.5,2.0â5.5,2â2.5,2â4.5,5,5â,5â8,6â,6â10,7â11,8â18,9â12,abaxiall,acut,adaxiall,adnate,ag,along,anisophyllous,apart,apical,apparently,appearing,arising,arranged,axe,ba,basal,blade,bractâlike,cell,chartaceous,clavat,concave,connivent,convex,cylindrical,decreasing,diamete,difoliate,directed,distally,eaf,eed,equal,erect,geminat,internode,longitudinal,lower,nflorescence,opening,opposed,oppositely,orolla,pentagonal,perfect,pore,present,procumbent,rapidly,redâpurple,rounded,ruit,serrate,sessile,sid,side,smaller,split,stone,straight,stripe,strongly,tal,tamen,tem,two,unit,vary,white,wide,wing,yellow,ympodial,â3.0,â7.0	'',[,``,appearance,arrangement,bark,branch,bud,characteristic,clavate,colour,corolla,corrugation,distal,drying,exertion,form,fruiting,giving,glabrousnes,growth,height,history,inflorescence,interjected,lateral,leaflet,length,life,lobing,midpoint,na,new,opposite,ovary,per,plant,prickle,primary,pseudostipule,ray,seed,shape,stem,terminal,texture,thicknes,type,value,variation,vein,width,{,}
373	wfo-0001030225	success	155	124	73	82	51	0.471	-30,.5-2.5,1,1-4,1-6,10-15,10-30,2-18,2-3,2-6,3-11-compound,3-20,3-5,4-5,8-15,acuminate,acute,apex,apical,basal,base,bilobed,calyx,cm,conivent,cordate,cuneate,deltate,densely,diameter,elliptic-ovate,entire,expanded,flower,forked,fruit,glabrous,gland,globose,leaf,leaflet,less,lobe,long,margin,mm,moderately,narrowly,oblong,obtuse,pedicel,peduncle,petiole,pinnately,possibly,puberulent,purple,shallowly,shrub,simple,small,sparsely,stigma,style,succulent,tip,tree,triangular,truncate,tube,two,unbranched,x	-1.5,-11,-4,-45,-7,.5,0,0-20,0-5,1.5,1.5-2.5,2,2-2.5,3-4,3-foliat,abaxially,absent,adaxially,apart,ape,apically,articulated,ature,axe,beyond,blade,campanulate,color,compound,connective,coriaceous,cylindrical,dilated,directed,distally,eaf,eed,equal,especially,exceeding,exserted,fleshy,glabrate,immature,laterally,leaving,lower,minutely,nflorescence,nther,one,orolla,papillose,perfect,pore,prominent,puberulen,rachi,radiu,scar,see,seen,slightly,somewhat,spaced,stalked,stamen,stellate,strongly,tal,tem,thecae,time,tomento,toward,ud,unit,unknow,unknown,vary,wide,ympodial	anther,appearance,arrangement,bark,border,branch,bud,characteristic,colour,corolla,corrugation,distal,drying,exertion,filament,form,fruiting,giving,glabrousnes,growth,height,history,inflorescence,interjected,lateral,length,life,lobing,midpoint,na,new,number,ovary,per,plant,prickle,primary,pseudostipule,ray,seed,shape,size,stem,surface,terminal,texture,thicknes,type,variation,vein,width
374	wfo-0001030250	invalid_json_followup	169	149	97	72	52	0.574	/4,0.5-1,1-1.5,1-3,1.1-1.2,1.4-1.5,1.7-7,1.9-2.6,11.2-22,11.3,2-2.5,2.5-3.25,25,3.4-6.6,3.5-4,4-7,5-50-flowered,5-6,6-8,anther,apex,bark,base,berry,brown,bullate,calyx,capitate,cm,conical,corolla,curved,dark,decurrent,dia,dry,elliptic-ovate,exerted,filament,fruiting,glabrous,globose,green,greenish-white,greenish-yellow,horizontally,inflorescence,lateral,leaf,lobe,lobed,long,long-acuminate,main,minutely,mm,node,ovary,ovoid-reniform,pair,pale,paler,papillose,pedicel,pendulous,petiole,pit,pitted,seed,shallow,shape,shaped,shrub,simple,size,slender,slightly,smooth,soon,specimen,spreading,stem,stigma,straight,style,surface,tan,tapering,tear-drop,translucent-green,tube,vein,way,white-lenticellate,wide,winged,x	.5,0-seeded,1.1-3.5,1.25-1.5,2.1-6,3-5,across,anthesi,apart,appearing,arching,attenuate,beginning,beneath,broadly,carinate-hooded,consisting,cuneate,cup-shaped,deflexed,differing,difoliate,eaf,edicel,eed,elliptic,five,free,fresh,geminat,glabrou,inflorescenc,irregularly,lon,lower,major,maturity,middle,minor,n,nflorescence,occasionally,older,one,opposite,orbicular,orbiculate,papillo,pore,poricidal,portion,projection,prominent,proximal,raised,reflexed,rim,ruit,scar,sea-green,spaced,tall,tip,translucent,two,ud,unit,usually,white-lenticellat,widest,woody,ympodial	'',0.5,50,[,``,alternate,appearance,arrangement,branch,bud,characteristic,colour,corrugation,decurren,diameter,distal,drying,exertion,form,fruit,giving,glabrousnes,growth,height,history,interjected,leaflet,length,life,lobing,margin,midpoint,na,new,number,peduncle,per,perennial,plant,prickle,primary,pseudostipule,ray,terminal,texture,thicknes,type,value,variation,width,{,}
375	wfo-0001030271	invalid_json_followup	195	142	95	100	47	0.487	0-2,0.15-0.75,0.5-1.2,0.7-9.5,0.9-2.5,0.9-3.6,1-2,1-2.5,1.4-2.1,1.9-6.6,15-61,2-2.7,2-6,2.4-5.6,3-10,3.4-7.5,4-7,5.6-12.3,abaxially,acute,adaxially,anther,apex,attenuate,axillary,base,berry,blue,brownish,bud,clavate,cm,coloration,completely,condition,coriaceous,corolla,dark,deep,diameter,distal,drying,elliptic,filament,forked,fresh,fruit,generally,glabrous,green,green-white,greenish,half,herb,interjected,lanceolate,lateral,leaf,leaflet,light,lilac,lobe,long,medium,mm,mottled,mucilaginous,odd-pinnate,ovate,ovoid,pedicel,peduncle,petiole,petiolulate,plant,purple,ripe,rounded,seed,size,spot,stigma,style,subtending,terminal,throughout,tube,unwinged,usually,vein,wet,white,whitish,wide,x	1-3,1-4,1-6,1-7,2-3,2-4,3-5,4-22,5-8,5-merou,6-15,acumen,adaxiall,ag,along,alyx,apart,apparently,arranged,articulated,asymmetric,axe,basiscopic,bead,blade,capitat,cell,connivent,considerably,covering,decreasing,digestion,dorsally,eaf,edge,eed,enzyme,erect,exceeding,flat,flower,folded,geminat,glabrou,habi,hair-like,homostylous,honeycomb-shaped,larger,lengthening,like,linear,living,lower,make,middl,moniliform,multiple,necklace,nflorescence,orbicular,orolla,pair,pentagonal,perfect,plurifoliate,pore,poricidal,removed,rosette,rotate,ruit,sessile,seudostipule,side,slightly,slit,sometimes,spaced,specimen,stamen,stolon,straight,symmetric,tall,tamen,tem,testal,thick,tip,tissue,toward,tri-,tuber,typically,unit,vary,wall,yellow,ympodial	'',[,``,appearance,arrangement,bark,border,branch,calyx,capitate,characteristic,colour,corrugation,exertion,form,fruiting,giving,glabrousnes,growth,height,history,inflorescence,length,life,lobing,margin,midpoint,na,new,number,ovary,per,prickle,primary,pseudostipule,ray,shape,stem,surface,texture,thicknes,type,value,variation,width,{,}
376	wfo-0001030272	success	179	128	106	73	22	0.592	.3,.5,/4,0.5-1,0.5-1.5,0.6-0.9,0.65-1,0.7-2.5,0.8-1.5,1,1-1.5,1-2.8,1.2-1.8,1.5-2.5,1/3,2-6.5,2.5-3.5,2.8-3.5,4-6,4-8,acute,almost,anther,apex,apically,apparently,articulated,bark,base,berry,bright,calyx,cm,concolorous,connivent,deltate,densely,diameter,drying,elliptic,entire,erect,evenly,filament,flattened-reniform,flower,fruit,fruiting,glabrescent,glabrous,glandular,green,hair,lateral,leaf,length,less,long,long-attenuate,margin,maturity,mauve,membranous,minute,mm,multangulate,near,obtuse,orange-brown,pair,pedicel,peduncle,petiole,poricidal,primary,red,red-brown,rounded,sessile,shallowly,shrub,simple,slender,sometimes,sparsely,spherical,spreading,stellate-pubescent,stem,straight,style,surface,tapering,terete,terminal,tip,trichome,tube,unarmed,unbranched,undulate,upper,vein,way,wide,young	-6,0-20,0.05-0.1,0.05-1.5,0.5-2,1.5-3,1/3-2/3,10-20,2-2.5,2.5-3,3-8,3.5-5,4-10,4-15,5-7,5-merous,abaxially,acut,alyx,ame,apar,ba,blade,c.,difoliate,eaf,eed,elongating,equal,free,geminat,glabrescen,gland,gra,infructescence,lobe,lobed,longer,lower,mature,midpoint,moderately,narrow-deltate,nflorescence,older,one,open,orolla,oung,per,perfec,pericarp,porrect,portion,ray,reduced,reflexe,ruit,scar,shorte,smooth,spaced,stellate,tamen,tertiary,time,unarme,unit,vary,venation,visible,woody,ympodial	arrangement,characteristic,colour,corolla,form,glabrousnes,gray,growth,height,history,inflorescence,life,lobing,new,ovary,perennial,plant,seed,shape,size,texture,type
377	wfo-0001030287	invalid_json_followup	150	141	81	69	60	0.54	-11,-40,0-15,0.5-1,1-2,1-2.5,1-4,1-5.5,1.5-10,1.5-2.5,1966,2,2-,2-10,2-12,2.5-4,3-9,4-5,4.5-6,5-10,acute,apex,base,bluish,branched,calyx,chartaceous,cm,compound,deltate,dendritically,densely,diameter,down,eglandular,ellipsoidal,elliptic-ovate,entire,fide,flattened,flower,forked,glabrous,gland,hair,herb,lanceolate,lateral,leaf,leaflet,lilac,lobe,long-stalked,margin,mm,moderately,narrowly,oblong,ovoid,pedicel,peduncle,petiole,pinnately,pubescent,purple,rugulose,scattered,shrub,simple,smith,stigma,strongly,style,subcordate,subcoriaceous,tip,truncate,tube,unbranched,unknown,x	-foliat,-many,.5-2.5,1,1-10,1-15,1-3,2-5,3,4-6,8-13,?,abaxially,adaxiall,adaxially,aggregate,apart,articulated,axe,basiscopically,blade,cell,color,connivent,cylindrical,decurrent,dendritic,dendritic-pubescen,directed,distall,eaf,eed,glandular,leaving,lon,long,lower,membranaceous,nflorescence,nther,obtuse,often,orolla,pedicellar,pore,presen,puberulent,rachi,radiu,ruit,scar,slightly,spaced,sparsely,sparser,stalked,stellate,stone,subcapitat,tal,tem,time,triangular,unit,upper,vary,wide,yellow,ympodial	'',[,``,anther,appearance,arrangement,bark,border,branch,bud,characteristic,colour,corolla,corrugation,dendritic-pubescent,distal,drying,exertion,filament,form,fruit,fruiting,giving,glabrousnes,green,growth,height,history,inflorescence,interjected,length,life,lobing,midpoint,na,new,number,ovary,per,plant,prickle,primary,pseudostipule,ray,seed,shape,size,stem,subcapitate,surface,terminal,texture,thicknes,type,value,variation,vein,width,{,}
378	wfo-0001030300	invalid_json_followup	235	164	122	113	42	0.519	-1,-7,0.4-0.5,0.4-4.5,0.5,0.5-0.6,0.5-1,0.5-4,0.5-5,0.6-0.8,0.7-1.2,0.7-1.5,0.8-3,0.8-4,0.9-1,1,1-1.3,1-2,1-4,1.4-2.4,2-2.1,2-2.5,2-foliate,2-locular,3/4,4-11,absent,almost,anther,anthesi,apex,appendage,articulated,basal,base,bifid,brittle,broadly,brown,calyx,capitate,cm,cordate,corolla,crenate,curved,deltate,densely,diameter,distal,ellipsoidal,elliptical,elongate,entire,filament,finely,fruit,fruiting,glabrous,globose,golden,green,hair-like,halfway,herb,imparipinnate,inflorescence,interjected,interrupted,introrse,irregularly,large,lateral,leaflet,less,like,long,margin,minute,mm,obovate,occasionally,once-branched,orbicular,outgrowth,ovary,pale,pedicel,peduncle,pentagonal,perennial,petiole,plant,population,pore,primary,pseudostipule,pubescent,rounded,simple,slightly,sparsely,spathulate,stem,stigma,strongly,style,surface,terminal,thick,triangular,tube,unit,united,usually,vein,wide,woody,yellow,yellowish,yellowish-green,zygomorphic	-0.9,.5,0.1,0.1-0.15,0.15-1,0.2,0.2-0.5,0.2-1.5,0.4-1.5,0.6-0.7,0.7-0.8,0.8-1,1-2-celled,1-6,1-celled,1.2-,1.5-,1.5-2.5,2-3,2-4,2.2-7.5,3.5-13,4-celled,6-15,6-8-celled,9-12,abaxially,abundant,acute,adaxial,adaxially,although,always,apical,appearance,articulation,ba,bent,beyond,bract,bracteate,cell,coherent,column,crenat,developed,diamete,eaf,edicel,eed,eglandular,even,exserted,face,flower,frequently,give,glandular,glutinous-viscose,gree,head,internode,lamina,larger,leave,lobe,lon,longer,markedly,midvein,moderately,multicellular,narrowly,nflorescence,node,oblique,pair,papillae,partially,petal,petiolule,pith,present,pubescence,reflexed,rest,ruit,secondary,silky,spreadin,spreading,staminal,sterile,straight,tall,tem,tertiary,testa,tip,trichome,two,ud,underlying,unicellular,uniseriate,upper,velvety,wall,weak,well,wider,winged,ympodial	'',1.2-7.5,1.5-13,[,``,arrangement,bark,branch,bud,characteristic,colour,corrugation,drying,exertion,form,glabrousnes,growth,height,history,leaf,length,life,lobing,midpoint,na,new,number,per,prickle,ray,seed,shape,size,sympodial,texture,thicknes,type,value,variation,width,{,}
379	wfo-0001030311	invalid_json_followup	182	138	71	111	67	0.39	.2,5-pinnate,acuminate,acute,anther,apex,appearance,base,berry,brown,calyx,chartaceous,clavate,cm,cordate,deltoid,densely,diameter,distal,entire,extra-axillary,filament,flattened,flower,fruit,fruiting,giving,glabrous,granular,green,half,herbaceous,lateral,leaflet,lenticular,lobe,lower,margin,membranaceous,membranous,minutely,mm,oblique,obtuse,orangish,ovoid-rhomboid,papillose,pedicel,peduncle,petiole,pubescent,purplish,rounded,sand-punctate,slender,slightly,sparsely,stellate,stem,stigma,style,surface,tan,thickened,tip,tube,unbranched,vein,vine,white,x	.5,.5â1.8,0.1,0.1â0.2,0.3â1.5,0.4â2,0.5â0.8,0.5â1,0.5â2,0.5â2.5,0.6â1,0.6â2.4,0.8â1.2,0.8â4,0.8â4.5,1.2â7,1.5â2,1.5â3,1.5â5.5,1.5â6,1.5â8,1.8â2,15â22,1â1.2,1â1.5,1â2,1â2.5,1â3,2.2â2.5,2.2â3,2.5â9,2â10,2â2.5,2â6,3â5,3â7,5â10,<,abaxially,accrescent,adaxial,adaxially,along,alyx,apar,apical,axe,basal,blade,c.,capitat,ciliat,ciliate,color,cuneate,dense,eaf,eed,elliptical,especially,falcate,fallen,glabrou,groov,groove,ground,hair,lanceolate,like,log,lon,long,m.,midvein,nflorescence,nternode,obovate,occasionally,orolla,pair,petiolulate,petiolule,plurifoliat,present,proximal,pubescence,rachi,rhomboid,ruit,scattered,sessile,short,shortly,side,smaller,spaced,strongly,tamen,tem,terrestrial,thick,thinner,trailing,trichome,unit,upper,vary,wide,wide-diameter,widely,ympodial	'',0.5,0.6-1,0.8-1.2,1-1.5,1-2.5,1-3,1.2-7,1.5-5.5,1.5-8,1.8-2,15-22,2-2.5,2-6,2.2-2.5,2.2-3,2.5-9,3-5,5-10,[,``,arrangement,bark,border,branch,bud,capitate,characteristic,colour,corolla,corrugation,drying,exertion,form,glabrousnes,growth,height,history,inflorescence,interjected,leaf,length,life,lobing,midpoint,na,new,number,ovary,per,plant,prickle,primary,pseudostipule,ray,seed,shape,size,terminal,texture,thicknes,type,value,variation,width,{,}
380	wfo-0001030311	invalid_json_followup	203	132	83	120	49	0.409	.2,0.4-2,0.6-1,0.8-1.2,0.8-4,1-1.5,1-2.5,1-3,1.2-7,1.5-2,1.5-5.5,1.5-8,1.8-2,15-22,2-2.5,2-6,2.2-2.5,2.2-3,3-5,5-10,5-pinnate,[,absent,acuminate,acute,anther,apex,basally,base,brown,chartaceous,cm,cordate,densely,diameter,distal,entire,filament,flattened,flower,fruit,glabrous,granular,green,half,herb,interjected,lateral,leaflet,lenticular,lobe,long,lower,margin,membranaceous,minutely,mm,oblique,oblong,obtuse,orangish,ovoid-rhomboid,papillose,pedicel,peduncle,petiole,plurifoliate,pubescent,purplish,rounded,slender,slightly,sparsely,stem,stigma,style,surface,tan,tube,unbranched,vein,white,x	.5,.5-1.8,0-2.5,0.1,0.5-0.8,0.5-1,0.5-2,0.6-2.4,0.8-4.5,1-1.2,1.5-3,1.5-6,2-10,2224,3-7,5-merou,8031,<,],abaxially,absen,accrescent,adaxial,adaxially,ag,aggregate,along,alyx,apart,apical,apparently,appearance,articulated,axe,ba,basal,blade,capitat,cell,ciliat,ciliate,clavate,color,connivent,cuneate,deltoid,dense,dig,directed,distally,eaf,eed,elliptical,equal,especially,falcate,fallen,formation,g,geminat,gh,giving,groov,groove,ground,hair,large,like,log,lon,longitudinal,m.,midvein,nflorescence,node,obovate,occasionally,opening,orolla,pair,perfect,petiolulate,petiolule,pittier,pore,present,proximal,rachi,rhomboid,rooting,ruit,scattered,sessile,short,shortly,side,simple,sinple,slit,smaller,spaced,stellate,stone,strongly,tamayo,tamen,tem,thick,thickened,thinner,tip,trailing,uniseriate,unit,upper,vary,wide,widely,yellow,ympodial	'',0.5,``,arrangement,bark,branch,bud,calyx,capitate,characteristic,colour,corolla,corrugation,drying,exertion,form,fruiting,glabrousnes,growth,height,history,inflorescence,leaf,length,life,lobing,midpoint,na,new,number,ovary,per,plant,prickle,primary,pseudostipule,ray,seed,shape,size,terminal,texture,thicknes,type,value,variation,width,{,}
381	wfo-0001030335	invalid_json_followup	153	166	117	36	49	0.765	.25,.75,0-5,0.05-0.2,0.1-0.5,0.25-0.5,0.5-1,0.7-1,1-1.5,1-2,1-3-flowered,1.1-1.4,1.1.5,2-2.2,2-2.5,2-4.5,2-5,2.5-3,3/4,5-6,5-7,7-13,acuminate,acute,along,anther,anthesi,apex,bark,base,beneath,berry,bi-lobed,branch,bud,calyx,cm,conical,corolla,dark,deciduous,decurrent,densely,dia,dry,elliptic,erect,exserted,filament,filiform,flattened,fruiting,gently,giving,glabrous,globose,green,greyish-red,horizontally,lateral,leaf,lightly,like,lobe,lobed,long,main,material,minute,minutely,mm,narrowly,obovoid,often,older,onto,opposite,ovary,ovoid-reniform,pair,pale,papillose,pedicel,petiole,pitted,pore,poricidal,puberulent,pubescent,reflexed,ripe,shaped,shrub,simple,soon,spreading,stem,stigma,straight,strongly,style,surface,tan,tapering,tear-drop,tip,trichome,tube,uniseriate,vein,way,white,winged,x,yellow,yellowish-green,young	.1,.5,aspec,ba,deflexed,deltoid,eaf,edicel,eed,except,expanded,free,geminate,lamina,lenticellate,lon,lower,middle,nflorescence,occasionally,papillo,portion,prominent,puberulen,raised,ruit,slightly,sparsely,tall,ud,underside,unifoliat,unit,widest,woody,ympodial	'',[,``,arrangement,aspect,characteristic,colour,corrugation,diameter,distal,drying,exertion,form,fruit,glabrousnes,growth,height,history,inflorescence,interjected,leaflet,length,life,lobing,margin,midpoint,na,new,number,peduncle,per,plant,prickle,primary,pseudostipule,ray,seed,shape,size,terminal,texture,thicknes,type,unifoliate,value,variation,width,{,}
382	wfo-0001030336	invalid_json_followup	266	211	173	93	38	0.65	-10,-19,.5,0-,0.1-0.5,0.1-0.7,0.15-0.9,0.2-1,0.3-1.1,0.5,0.5-0.7,0.5-1.5,0.6-1.5,0.8-1.3,0.8-3,1,1-1.5,1-3,1-celled,1.0-1.4,1.5-,1.5-2,1.5-3.5,1.6-7,1.7-2.3,1.8-3.0,1/4-1/3,2-9,2-foliate,2-locular,4,4-10,4-celled,6,8-20,8-celled,acute,adpressed,almost,amongst,anther,anthesi,apex,appearance,articulated,base,basiscopically,bent,bifurcate,bluntly,branch,bright,brown,calyx,capitate,cell,cm,coat,conical,corolla,crenate,curved,dark,darker,decurrent,deeply,densely,diameter,distal,eglandular,elliptic,elongate,entire,exserted,extremely,filament,flower,flushed,fruit,fruiting,giving,glandular,globose,grayish,green,greenish,hair-like,half,halfway,head,herb,imparipinnate,inflorescence,interjected,interrupted,lanceolate,large,lateral,leaf,leaflet,less,like,lobed,long,longer,margin,markedly,midvein,minutely,mixed,mm,oblique,obovate,occasionally,once-branched,orbicular,outgrowth,ovary,pale,pedicel,peduncle,perennial,petiole,petiolule,present,primary,proximal,pseudostipule,puberulent,pubescent,purple,rachi,rest,rotate,rounded,scattered,sessile,shaggy,shorter,silky,simple,slightly,sometimes,sparse,stellate,stem,stigma,strongly,style,surface,ten,terminal,testa,thick,tip,trichome,truncate,tube,two,unicellular,uniformly,uniseriate,unit,upper,usually,velvety,wall,way,white,wide,woody,yellow,young	-1.5,-2,0.1-0.3,0.1-1,0.15-0.2,0.2,0.2-0.25,0.2-0.8,0.2-1.5,0.3-0.4,0.5-1,0.6-0.8,0.8-0.9,0.8-1.2,1-1.4,1.5-5,10,2-4,2/3,3-5,4-,8-16,absent,apical,appearing,appendage,articulation,basal,berry,bract,bracteate,clavat,column,completely,cordate,developed,diamete,divided,eaf,edicel,eed,entir,erect,essentially,first,glandula,internode,investing,larger,largest,leave,lobe,lon,loosely,lower,maturity,mere,middl,minute,mostly,narrowing,narrowly,nflorescence,node,often,pair,papillate,part,population,range,reflexed,ruit,secondary,shrub,sinus,small,soft,southern,spreadin,spreading,staminal,sterile,straight,stripe,surrounding,tall,tem,tertiary,ud,united,weak-walled,winged,ympodial	'',[,``,arrangement,bark,bud,characteristic,clavate,colour,corrugation,drying,exertion,form,glabrousnes,growth,height,history,length,life,lobing,middle,na,new,number,per,plant,seed,shape,size,sympodial,texture,type,value,variation,vein,width,{,}
383	wfo-0001030342	success	155	109	83	72	26	0.535	.2,0.8â1.5,1.2â3,1.5â13,1.5â5,1.5â7.5,10â25,1â1.5,1â2.5,1â7,2â,2â2.5,2â4,3,3-pinnate,4â5,6â7,abundant,acuminate,acute,adaxially,along,anther,apex,berry,brown,calyx,chartaceous,cm,cylindrical,deltoid,dense,diameter,entire,extra-axillary,filament,flattened,flower,fruit,glabrous,greenish,herbaceous,lanceolate,leaf,lenticular,light,like,long,margin,membranous,minutely,mm,mottled,often,ovoid-rhomboid,pedicel,peduncle,petiole,pointed,pubescent,rarely,revolute,scattered,slender,smooth,stem,stigma,style,surface,tip,trichome,truncate,tube,unbranched,undulate,vein,vine,white,wide-diameter,widely,x,yellowish,â7	.5,0.1â0.2,0.3â1.2,0.5â1,0.5â3,0.5â5,0.8â4,1-5,1-6.5,1.5,1.5â2,1â1.2,1â3,1â5.5,1â6,3â12,4â8,5-merous,abaxially,accrescent,alyx,apar,apical,apiculate,axe,base,blade,broadly,c.,capitat,ciliat,cordate,cuneate,eaf,eed,elliptical,fruiting,glabrou,lateral,leaflet,lobe,lon,lower,m.,nflorescence,nternode,oblique,obtuse,orolla,perfec,petiolule,plurifoliat,proximal,pubescen,rachi,rhomboid,rounded,ruit,sand-punctate,side,slightly,spaced,sparsely,stellate,tamen,tem,terrestria,truncate-acuminat,unit,vary,wide,ympodial	abaxial,arrangement,capitate,characteristic,colour,corolla,exertion,form,glabrousnes,growth,height,history,inflorescence,length,life,lobing,new,ovary,plant,primary,seed,shape,size,terrestrial,texture,type
384	wfo-0001030342	success	153	120	75	78	45	0.49	.2,.5,0.5-3,0.5-5,0.8-4,1-1.2,1-1.5,1-5.5,1-6,1-7,1.2-3,1.5-13,1.5-2,1.5-5,1.5-7.5,10-25,2-2.5,3-pinnate,4-5,6-7,absent,acuminate,anther,apex,basally,base,brown,calyx,chartaceous,cm,cordate,cuneate,deltoid,diameter,elliptical,entire,extra-axillary,filament,fruit,fruiting,glabrous,herb,interjected,lateral,leaf,leaflet,lenticular,light,lobe,margin,membraceous,mm,oblique,oblong,obtuse,pedicel,peduncle,petiole,pubescent,rarely,rounded,sagittate,slender,smooth,stigma,style,surface,terrestrial,truncate,tube,unbranched,undulate,vein,white,x	-7,0.5-1,1-3,1-5,1-6.5,2-,2-3,3,3-12,4-8,5-merou,abaxially,abundant,accrescent,acute,adaxially,ag,along,alyx,apart,apical,apiculate,apparently,articulated,axe,ba,blade,broadly,capitat,ciliat,connivent,cylindrical,directed,distally,eaf,eed,equal,flower,geminat,hair,lanceolate,long,longitudinal,lower,minutely,nflorescence,node,opening,orolla,perfect,petiolule,plurifoliate,pore,proximal,pubescen,rachi,revolute,rhomboid,rooting,scattered,side,simple,slightly,slit,spaced,stellate,tamen,tem,tip,trailing,truncate-acuminat,uniseriate,unit,vary,wide,widely,yellow,ympodial	appearance,arrangement,bark,border,branch,bud,capitate,characteristic,colour,corolla,corrugation,distal,drying,exertion,form,giving,glabrousnes,growth,height,history,inflorescence,length,life,lobing,midpoint,na,new,number,ovary,per,plant,prickle,primary,pseudostipule,ray,seed,shape,size,stem,terminal,texture,thicknes,type,variation,width
385	wfo-0001030353	invalid_json_followup	227	157	115	112	42	0.507	.2,.7,0-6,0.1-0.2,0.5-0.9,0.8-1.2,1-6,1.2-1.8,1.8-2.2,1.8-3,1/2-2/3,1/3,2-7,2.5-4,2.8-3.7,3-4,3.5-4,4-,4-4.5,5-6,6-15,6-8,abaxial,acute,adaxial,almost,anther,apically,apparently,articulated,bark,base,berry,brown,calyx,chartaceous,cm,conical,cuneate,curved,densely,diameter,discolorous,distal,drying,ellipsoid,elliptic,erect,evenly,filament,flattened,flattened-reniform,flower,fruit,fruiting,glabrous,green,lateral,leaf,length,lobed,long,long-styled,lower,margin,maturity,mauve,midpoint,mm,moderately,multangulate,narrow-deltate,orange-brown,pair,pedicel,peduncle,per,petiole,plant,poricidal,prickle,prickly,primary,ray,red-brown,reddish-green,sessile,shape,short-styled,shrub,simple,small,sparsely,stellate,stellate-pubescent,stem,straight,strongly,style,subentire,surface,tapering,terminal,tip,tree,trichome,tube,unarmed,vein,way,weakly,white-gray,wide,yellow,young	-0.2,-1.5,-1/2,-2,-3,-5,-6,-merous,.1,.5,0,0-15,0-2,0.1-0.3,0.15-0.3,0.5,0.8,1,1-2,1-3,1-7,1/,1/5,1/6,1/6-1/4,10-15,11-16,2-10,20-200,3-5.5,4-5,5,6,7-10,8-15,abaxially,alyx,andromonoecious,apar,apart,apex,apiculat,blade,broad-deltate,c.,connivent,deltate,development,distance,eaf,eed,elongating,equal,extending,free,glabrescent,half,hermaphrodite,heterostylous,infructescence,less,lobe,longer,lowermost,mature,midvein,nflorescence,older,one,open,orolla,oung,patch,pendulous,pericarp,plurifoliat,pointed,porrect,portion,reflexed,retaining,rounded,ruit,scar,shorter,side,smooth,sometimes,somewhat,spaced,spreading,stalk,stalked,staminat,stout,tamen,terete,tertiary,throughout,time,unarme,unbranched,unit,upper,vary,venation,visible,warty,whit,wo,woody,ympodial	'',30,[,``,apiculate,arrangement,branch,bud,characteristic,colour,corolla,corrugation,exertion,form,glabrousnes,growth,hair,height,history,inflorescence,interjected,leaflet,life,lobing,na,new,number,ovary,perennial,pseudostipule,seed,size,stigma,texture,thicknes,type,value,variation,white,width,{,}
386	wfo-0001030407	invalid_json_followup	182	146	98	84	48	0.538	.2,.5,0.7-3.2,1-2,1.5-5,12-14,2-5,2-6.7,2-7,3-10.5,3-6.5,3-9,3.5-9.5,30-60,4-5,5,6.5-18.5,7-8,absent,acuminate,anther,apex,articulated,axillary,base,berry,brownish,bud,cell,chartaceous,cm,condition,conical,connivent,corolla,covering,densely,diameter,distal,drying,elliptic-lanceolate,filament,forked,fresh,fruit,generally,glabrous,green,green-white,greenish,half,herb,interjected,lanceolate,lateral,leaf,leaflet,light,lobe,long,make,margin,middle,minute,mm,mottled,mucilaginous,obtuse,odd-pinnate,ovate,ovoid,pedicel,peduncle,petiole,plant,proximal,pubescent,purple,ray,ripe,round,seed,size,stigma,style,subtending,terminal,testal,thick,throughout,tube,unwinged,usually,wall,wet,whitish,wide,x	1-10,1-3,1-4,12-15,2-2.5,3-4,5-merou,6-7,abaxially,acumen,adaxially,ag,alyx,apart,apparently,axe,blade,capitat,ciliate,decreasing,digestion,dorsally,eaf,edge,eed,end,enzyme,especially,exceeding,flat,flower,folded,geminat,glabrou,gradually,hair,hair-like,homostylous,honeycomb-shaped,larger,lengthening,like,living,lower,nflorescence,one,orolla,pair,pentagonal,perfect,petiolule,placed,plurifoliate,pore,poricidal,pubescen,removed,ruit,secondary,semierec,seudostipule,slit,spaced,specimen,stamen,ste,stolo,subequal,subsessile,symmetrical,tall,tamen,tem,thir,tip,toward,tri-,tuber,typically,unit,vary,white,yellow,ympodial	'',[,\u201chair-like\u201d,``,appearance,arrangement,bark,branch,calyx,capitate,characteristic,colour,corrugation,exertion,form,fruiting,giving,glabrousnes,growth,height,history,inflorescence,length,life,lobing,midpoint,na,new,number,ovary,per,prickle,primary,pseudostipule,shape,stem,surface,texture,thicknes,third,type,value,variation,vein,width,ye,{,}
387	wfo-0001030420	invalid_json_followup	170	145	87	83	58	0.512	-2,-20,-30,-pubescent,0.5-,0.5-1,0.5-4,0.5-8,1,1-1.5,1-2,1-3,1-4,1-7.5,1.5-5,10-,15-25,2-,2-14.5,2-9,3-lobed,4-7,5-15,acuminate,acute,also,apex,basal,base,beyond,calyx,chartaceous,cm,connivent,cordate,deltate,densely,diameter,eglandular,ellipsoidal,elongated,entire,exserted,flower,forked,fruit,glabrate,glabrous,glandular-,lanceolate,leaf,lobe,lobed,long,margin,mm,moderately,narrowly,obtuse,often,pedicel,peduncle,petiole,pinnately,puberulent,pubescent-pilose,purple,rarely,shrub,simple,small,sparsely,stamen,stigma,style,subcoriaceous,tip,tree,triangular,truncate,tube,unbranched,unknown,unlobed,vein,x,yellow	-35,-4,-9,1-,1-6,1.5-3,1/2,10-25,2-3,2-5,2-6,3-7,4-foliat,5-,5-6,6-7,7-19,7-22,7/8,abaxially,absent,adaxially,aggregate,apart,ape,articulated,axe,blade,cell,color,connective,cylindrical,dark,directed,distally,divided,eaf,eed,eglandular-pilo,eglandular-puberulent,elliptic-ovate,equal,glandular-puberulent,hair,leaving,lon,lower,midrib,nearly,nflorescence,nther,orolla,ovate,pedicellar,perfect,pilose,pore,presen,puberulent-pubescent,pubescent,pubescent-pilo,rachi,radiu,remnant,ripe,ruit,shorter,sinus,spaced,stellate,stone,tal,tem,thecae,time,tomento,truncat,ud,unit,vary,wide,yello,ympodial	'',[,``,anther,appearance,arrangement,bark,border,branch,bud,characteristic,colour,corolla,corrugation,distal,drying,eglandular-pilose,exertion,filament,form,fruiting,giving,glabrousnes,growth,height,history,inflorescence,interjected,lateral,leaflet,length,life,lobing,midpoint,na,new,number,ovary,per,plant,prickle,primary,pseudostipule,ray,seed,shape,size,stem,surface,terminal,texture,thicknes,type,value,variation,width,{,}
388	wfo-0001030426	success	158	140	94	64	46	0.595	-30,0.3-7,0.3-8,0.4-0.7,1-4,1-4.2,1.5-3,1.7-3.2,10,15-25,2,2.5-4,2.5-6,3-4,3-6,4-6.5,6-11.5,6-8,9,acute,apex,apical,apically,apiculate,articulate,base,branched,calyx,caudate,cell,cm,connate,corolla,covering,cyme,dehiscent,diameter,dichasial,dichasially,distal,ebracteate,elliptic-lanceolate,exceeding,filament,glandular,globose,green,green-white,hair-like,heart-shaped,herbaceous,interjected,introrse,lanceolate,lateral,leaf,leaflet,linear,lobe,long,make,maturing,mm,monochasial,mucilaginous,oblique,oblong,odd-pinnate,often,ovoid,pedicel,peduncle,perennial,petiole,pilose,plant,poricidally,rounded,seed,short,size,slit,spot,stamen,stigma,straight,style,terminal,testal,thick,wall,white,wide,yellow	1.5-6.5,2-3,3-12,3-6-foliat,4-10,abaxially,absen,acumen,adaxially,decurrent,digestion,diminishing,dorsally,eaf,edge,eed,emoval,enzyme,flat,flower,folded,forked,generally,globo,gradually,half,honeycomb,larger,linear-lanceolate,linear-oblong,living,lon,lower,nflorescence,nther,obtuse,orolla,pair,pattern,perfect,pinnatifi,plan,proximal,rachi,reveal,ruit,second,sessile,seudostipule,specimen,stellate,stripe,tal,tem,throughout,toward,tuber-bearing,typically,unit,vary,whit,without,ympodial,Â¼	absent,anther,appearance,arrangement,bark,border,branch,bud,characteristic,colour,corrugation,drying,exertion,form,fruit,giving,glabrousnes,growth,height,history,inflorescence,length,life,lobing,margin,midpoint,na,new,number,ovary,per,prickle,primary,pseudostipule,ray,shape,stem,surface,texture,thicknes,tube,type,variation,vein,wet,width
389	wfo-0001030430	success	171	138	93	78	45	0.544	.2,0.25,0.5â12,0.8â3.0,0.8â5.6,0â20,1.0â1.2,1.0â2.0,1.3â8.0,1.4â1.5,1.6â1.8,12â20,2â3,30â200,3â17,3â4,3â5,3â8,5â10,5â6,acute,anther,anthesi,apex,axillary,base,blade,blue,borne,branched,brittle,brown,bud,calyx,capitate,clavate,cm,connivent,decurrent,densely,diameter,equal,few-seeded,filament,flattened,fleshy,fruit,glabrous,globose,green,hair,indumentum,leaf,lobe,lobed,long,margin,mm,moderately,multicellular,oblong,occasionally,pair,pale,pedicel,peduncle,pentagonal,perennial,petiole,pitted,poricidal,pubescent,purple,regularly,rounded,shallowly,shoot,shrub,simple,stigma,style,subglabrous,surface,terminal,time,tip,tube,uniseriate,violet,white,woody,x,yellow	.5,0.3,0.4,0.5,0.6,0.6â0.8,0.6â1.0,0.9â1.0,1.0â1.5,1.2â2.0,1.5â1.7,1.8â5.0,12â30,1â3,1â9,2.0â3.0,2.0â4.2,3.0â4.5,3â24,5,5.5â12,6â10,abaxially,abundant,adaxiall,adaxially,ag,apart,apical,appressed,articulated,axe,ba,basal,cell,chartaceous,convex,cylindrical,dentate,diamete,eaf,eed,elliptic,erect,especially,flower,geminat,lon,longitudinal,lower,m.,nflorescence,opening,orolla,ovate,perfect,pore,present,ruit,serrate,shaped,side,slit,spaced,stone,straight,tal,tamen,tear-drop,tem,toward,unifoliate,unit,vary,wide,ympodial,â2.7,â40	appearance,arrangement,border,characteristic,colour,corolla,corrugation,distal,drying,exertion,form,fruiting,giving,glabrousnes,growth,height,history,inflorescence,interjected,lateral,leaflet,length,life,lobing,midpoint,na,new,number,ovary,per,plant,prickle,primary,pseudostipule,ray,seed,shape,size,stem,texture,thicknes,type,variation,vein,width
390	wfo-0001030441	invalid_json	178	146	111	67	35	0.624	+,.5,0.5,0.5-0.75,0.5-1,0.5-3,1,1-1.4,1-2-celled,1.2-1.4,10-40,2,2-10,2-5.5,2.5,30,5-7.5,6-11,<,>,acuminate,acute,along,anther,anthesi,apex,attenuate,base,berry,branched,bright,c.,calyx,capitate,cell,cm,corolla,decurrent,diameter,ellipsoid,elliptic,entire,exerted,eye,filament,flattened,flexuous,flower,fruiting,glabrous,glandular,globose,green,growth,hair,lateral,lobe,lobed,long,making,many,margin,membranous,midvein,minutely,mm,narrowly,new,occasionally,onto,open,pale,pedicel,peduncle,per,petiole,plant,poricidal,pubescent,red,reniform,ridged,ripe,shrub,simple,slightly,spot,spreading,stellate,stem,stigma,strongly,style,surface,terminal,thin,time,tip,trichome,tube,undulate,uniseriate,usually,vine,violet,wall,way,white,wide,woody,yellow	1-1.5,1.5-2,2-3,3-4,4-5,5-14,5-6,5-7,5-merou,ag,alyx,apart,ark,articulated,brow,closely,deltate,distall,eaf,eed,free,glabrou,glandula,ilament,impressed,irregularly,juicy,leaving,lengthening,lon,lower,markedly,nflorescence,older,orolla,otherwise,pair,papillat,papillose,peg,perfect,pericarp,plurifoliat,pore,portion,primary,reflexed,ruit,scandent,scar,shiny,short,shrubby,slit,small,somewhat,spaced,spreadin,tem,trailing,triangular,ud,unit,upper,vary,vein,ympodial	'',[,],``,abaxial,adaxial,arrangement,bark,brown,bud,characteristic,colour,exertion,form,fruit,glabrousnes,height,history,inflorescence,leaf,length,life,lobing,number,ovary,papillate,perennial,seed,shape,size,texture,type,value,{,}
391	wfo-0001030444	invalid_json_followup	196	157	112	84	45	0.571	0-24,0.15-0.8,0.8-2,1,1-10,1-2,1.1-2.7,1.2-1.8,11-45,2.3-3.6,2.4-3.8,3-10,3.7-6.8,4-17,4-39,4-7,5.3-9,6.1-12.8,9.4-20.1,abaxially,acuminate,acute,adaxially,anther,apex,apparently,attenuate,axe,axillary,base,berry,blue,brownish,bud,cell,ciliate,clavate,cm,condition,coriaceous,corolla,covering,dark,deep,diameter,distal,dot,drying,elliptic,filament,flower,forked,fresh,fruit,generally,glabrous,green,green-white,greenish,hair-like,half,herb,interjected,lanceolate,lateral,leaf,leaflet,light,lilac,lobe,long,make,margin,medium,mm,mucilaginous,narrow,odd-pinnate,ovate,ovoid,pedicel,peduncle,perfect,petiole,petiolulate,plant,purple,ripe,rough,rounded,seed,size,sometimes,stigma,style,subtending,terminal,testal,thick,throughout,touch,tube,typically,unwinged,usually,wall,wet,white,whitish,wide,wing,x	1-4,1-5,2-3,2-6,2-8,3-5,5-merou,7.1-17.5,abaxiall,acumen,ag,along,alyx,apart,arranged,articulated,asymmetric,basiscopic,bead,blade,capitat,connivent,decreasing,digestion,dorsally,eaf,edge,eed,enzyme,erec,exceeding,flat,folded,geminat,general,glabrou,hal,high,homostylous,honeycomb-shaped,larger,lengthening,like,linear,living,lower,moniliform,multiple,necklace,nflorescence,orbicular,orolla,pair,pentagonal,plurifoliate,pore,poricidal,removed,rotate,ruit,sessile,seudostipule,shortly,side,slit,spaced,specimen,stamen,stolon,straight,subequal,symmetric,tall,tamen,tem,tip,tissue,toward,tri-,tuber,unit,vary,yellow,ympodial	'',[,``,arrangement,bark,branch,calyx,capitate,cayx,characteristic,colour,corrugation,exertion,form,fruiting,glabrousnes,growth,height,history,inflorescence,length,life,lobing,midpoint,na,new,number,ovary,per,prickle,primary,pseudostipule,ray,shape,stem,surface,texture,thicknes,type,value,variation,vein,width,{,}
392	wfo-0001030445	invalid_json	226	124	93	133	31	0.412	0.2-0.4,0.2-0.5,0.6-2.2,1-1.3,1-7,1.3,1.3-2,1.7-2.4,10-14,14,15-35,3-5.4,4.1-8.7,4.2-10,5.9-15,6.1-9.1,7.5-16,8.1-10,abaxially,acuminate,adaxially,anther,apex,bark,base,berry,black,blunt-tipped,branch,branched,bud,calyx,capitate,cm,corolla,decurrent,deltoid-reniform,diameter,drying,elliptic,elliptical,elongated,entire,exserted,ferruginous-tomentose,filament,flower,fruit,glabrate,glabrous,globose,green,greyish-tan,leaf,long,many,margin,midrib,mm,oblong,oblong-lanceolate,obovate,obtuse,orangish-tan,orbicular,ovate,ovate-lanceolate,pedicel,peduncle,petiole,pseudoterminal,reniform,reticulate-punctate,semi-spherical,shrub,side,simple,slightly,small,soon,stem,stigma,style,sulcate,surface,time,tomentose,tree,vein,white,x,yellowish,yellowish-tan	.1,.5,/5-2/3,0.1-0.7,0.2,0.2-0.7,0.3,0.4,0.5,0.6-3.5,0.7,0.8,1,1.1-4.3,1.3-1.8,1.5-2.1,1.6-2,1.8-3.5,10-16,2.1-5.2,2.2-2.9,2.2-3.5,2.4-4.7,3.1-5,3.4-5.6,3.5-4.2,5-125,5-merou,5.2-7.1,5.9-8.3,8.2-18,abaxial,accrescent,acute,ag,along,alyx,apart,appressed,around,articulated,axillary,blade,blunt-tippe,brown,brownish-yellow,bulbous-based,concentrated,cylindrical,directed,distally,eaf,earl,edge,eed,erect,ferruginous,ferruginous-granular,free,fruiting,geminate,glabrescen,hair,high,homostylous,inserted,intermediate,lackin,lateral,lengthening,lobe,lobed,lon,longitudinal,lower,m.,main,midvein,mostly,multangulat,multangulate,nflorescence,obscured,older,open,orange,orolla,plurifoliate,pore,poricidal,porrect-stellat,porrect-stellate,pubescence,pubescent,rachi,ray,relatively,resorption,rounded,ruit,runk,sessile,slit,somewhat,spaced,sparse,sparsely,splitting,stalk,stamen,stellate,stout,subcampanulate,suture,tamen,thick,thick-textured,thicknes,thin,thin-,tip,tissue,tomentum,tube,unarme,unit,vary,vestigial-rayed,way,wide,yellow,ympodial,young	'',[,],``,arrangement,characteristic,colour,exertion,form,glabrousnes,growth,height,history,inflorescence,length,life,lobing,new,ovary,perennial,plant,primary,seed,shape,size,texture,type,unarmed,value,{,}
393	wfo-0001030447	success	276	158	131	145	27	0.475	.2,.3,.5,/5,0,0.4-0.9,0.5-0.65,0.5-10,0.7-1,0.8-1.7,0.8-3.5,1.8-2.5,1/3,1/3-2/3,2-4,2.2-2.8,2.5-10,2.5-6.5,3,3-5,30-45Â°,6-10,6-7,6.5-9,7-8,abaxially,acute,always,anther,apex,apparently,armed,bark,base,berry,calyx,cell,chartaceous,clavate,cm,corolla,cuneate,cupular,curved,development,diameter,discolorous,drying,filament,flat,flattened,flattened-reniform,flower,fruit,fruiting,glabrescent,glabrous,globose,irregular,lateral,leaf,length,lobed,long,long-styled,lower,margin,maturity,midvein,mm,moderately,narrow-deltate,obconical,oblique,oblong,often,opening,orange,orange-brown,orange-red,outline,ovate,pair,pale,pedicel,peduncle,per,petiole,pit,porrect,prickle,primary,pubescent,purple,raised,red-brown,rounded,sessile,shallowly,short-styled,shortly,shrub,simple,small,sometimes,somewhat,sparsely,spherical,spreading,stalked,stellate,stellate-pubescent,stem,stigma,straight,straw-yellow,style,surface,tapering,throughout,translucent,trichome,tube,unarmed,unbranched,vein,weakly,white,yellow,yellow-orange,Ã	0.1,0.1-0.3,0.15-0.3,0.2,0.2-0.4,0.4-0.7,0.5,0.5-3,1,1-1.5,1-10,1-2,1-2.5,1-3,1-5,1-6,1.5,1.5-2.5,1.5-7,1/3-1/2,1/4-1/3,3-4.5,4-8,5,5-15,5-merou,6,6-16,6-8,6-9,8,accrescent,adaxially,age,alyx,apar,apart,apical,apically,articulated,axe,beyond,blade,branche,broad-deltate,c.,characteristically,covering,dark,deltate,densely,difoliate,distance,divided,eaf,eed,elongating,equal,erect,exserted,extending,filiform,fine,finely,finger-hair,free,geminat,gently,herbaceous,infructescence,irregula,lengthening,less,lobe,long-ovoi,longer,longitudinal,mature,midpoint,minute,mostly,nflorescence,obtuse,older,one,open,orange-translucent,orolla,oung,papillo,pendulous,perfect,pericarp,persisting,point,pore,poricidal,portion,pronounced,prostrate,rachi,ray,reduced,rest,ri,ridge,ridged,ruit,scar,shallow,shiny,shorter,side,sinus,slender,slit,smooth,spaced,sparse,stalk,stout,stump,subsessile,tamen,terete,terminal,tertiary,thick,thin,time,tip,toward,ud,unequal,unit,usually,variously,vary,venation,visible,wide,widest,woody,x,ympodial	arrangement,branch,branched,bud,characteristic,colour,exertion,form,glabrousnes,growth,height,history,inflorescence,life,lobing,long-ovoid,new,number,ovary,papillose,perennial,plant,seed,shape,size,texture,type
394	wfo-0001030453	success	127	101	68	59	33	0.535	.25,/4,0.8-1.5,1-1.3,1.5-1.6,4-5,9-12,9-14,acuminate,acute,anther,apex,arachnoid,arachnoid-pubescent,attenuate,bark,base,broadly,calyx,clavate,cm,corolla,cup-shaped,dark,densely,ellipsoid,elliptic,exserted,filament,flat,glabrate,glabrous,later,lateral,leaf,long,main,margin,mm,narrowly,nearly,ovary,pair,pedicel,petiole,pubescent,reddish,rounded,shaped,shiny,shrub,simple,soon,sparsely,stem,stigma,strongly,style,surface,tall,tear-drop,trichome,tube,vein,way,white,wide,young	.5,0.25-0.5,1-1.5,1.5-2.5,3-3.5,abaxially,adaxially,along,anthesi,axi,closely,deflexed,delicate,deltate,dendritic,dia,divided,eaf,edicel,eed,especially,fine,floccose,free,know,known,less,lobe,lon,lower,middle,midrib,minute,minutely,near,nflorescence,occasionally,older,opposite,overlappin,papillat,papillose,planar,pore,poricidal,portion,reddish-brow,ruit,scar,slender,spaced,straight,tip,tub,ud,unifoliat,unit,widest,ympodial	arrangement,bud,characteristic,colour,corrugation,diameter,drying,exertion,form,fruit,fruiting,glabrousnes,growth,height,history,inflorescence,length,life,lobing,na,new,number,peduncle,per,plant,primary,reddish-brown,seed,shape,size,texture,type,unifoliate
395	wfo-0001030486	success	141	109	86	55	23	0.61	.5,1-1.5,1-5,1.1-1.4,1.7-2,10-12,10-14.5,2-3,3-3.5,3/4,4-4.5,4-6.5,5-8-flowered,6-7,acute,anther,apex,bark,basal,base,beneath,berry,brown,calyx,clavate,cm,completely,corolla,dark,dia,dry,drying,ellipsoid,elliptic,erect,exserted,f,filament,fleshy,fresh,fruiting,glabrous,globose,green,later,lateral,leaf,lobed,long,main,margin,material,minutely,mm,ovary,ovoid-reniform,pair,pale,papillose,pedicel,petiole,pitted,pore,poricidal,reddish,shaped,shrub,simple,size,slightly,stem,stigma,stout,style,surface,tan,tapering,tear-drop,thickened,tip,tube,vein,way,white,x,yellow-green	0.8-2.2,1.5-2,1/2,1/4,2-5.5,3-5,4.5-5,abaxially,adaxially,anthesi,ba,closely,clustered,conical,deflexed,deltate,differing,difoliate,distal,eaf,edicel,eed,free,geminat,inflorescenc,internodal,lobe,lon,lower,m.,major,middle,minor,nflorescence,older,opposite,overlapping,papillo,planar,portion,ruit,scar,shin,small,spaced,tall,treelet,tub,ud,unit,usually,widest,woody,ympodial,young	arrangement,bud,characteristic,colour,diameter,exertion,form,fruit,growth,height,history,inflorescence,length,life,lobing,perennial,plant,primary,seed,shape,shiny,texture,type
396	wfo-0001030489	success	196	116	89	107	27	0.454	0.5-3,0.9-1.1,1-1.3,1-3,1.2-1.6,1.6-2.1,1.7-2,1.9-2.6,1/3-1/2,3-6,3-8,4-8,4.5-9,5,7-15,abruptly,anther,apart,apex,appressed-pubescent,attenuate,bark,base,becoming,berry,blunt-tipped,broadly,brown,bud,calyx,chartaceous,cinereous,cm,conical,continued,corolla,deltoid,diameter,due,elliptic,elongate,entire,filament,flower,fruit,glabrate,glabrous,globose,greenish,growth,honeycombed,lateral,leaf,length,long-acuminate,margin,minutely,mm,narrowly,oblong,ovate-lanceolate,pedicel,peduncle,petiole,probably,pubescent,rachi,reniform,reticulate-punctate,ripe,short,shrub,simple,somewhat,stellate-pubescent,stem,stigma,style,subcampanulate,subglobose,suborbicular,tomentose,tube,unarmed,way,white,x,yellow,yellowish	-6.5,.5-2.8,.5-3,.75-5.25,0.25-0.4,0.6-0.9,0.75-0.9,1-3.75,1.1-1.3,1.2-1.5,1.75-2,1/5-1/2,100,12-24,2.1-2.9,5-6,6-8,abaxially,absen,acuminate,acute,adaxiall,adaxially,ag,anthesi,apical-lateral,apparently,appressed,articulated,axe,axillary,ba,blade,branch,branched,closely,cylindrical,dehiscing,densely,dichotomously,eaf,echinoi,echinoid,eed,fleshy,free,hair,high,inserted,introrse,large,lobe,lobed,long,long-exserted,longitudinal,lower,main,midvein,minute,mostly,multangulate,nflorescence,obtuse,older,orolla,ovate,pale,perfect,plurifoliate,pore,porrect-stellate,pseudo-terminal,puberulent,pulverulen,pulverulent,ruit,runk,sessile,several,short-stalked,side,slender,slit,small,smooth,spaced,sparingly,sparse,stellate-rotate,subcapitat,tamen,terete,testa,thick,time,toward,tree,turn,unarme,unit,usually,vary,vein,wide,ympodial,young	2.5-2.8,5-6.5,abaxial,adaxial,arrangement,characteristic,colour,form,height,history,inflorescence,life,lobing,na,ovary,perennial,plant,pseud-terminal,seed,shape,size,spacing,subcapitate,surface,texture,thicknes,type
397	wfo-0001030509	invalid_json_followup	220	183	143	77	40	0.65	-10,-6,0,0-100,0-3,0-5,0.1-0.2,0.2,0.3-2.5,0.5-1.5,0.6-1,0.8-1.2,0.8-4,1-1.5,1-2,1-3,1-4,1.3-2,1.7-2,1/4,2-2.5,2-3,2-4.2,2-4.5,2-6,2.8-3,2/3-3/4,3-10,3-4,4.5-12,4.5-8,7-9,8-16,anther,apart,apex,apically,apparently,articulated,bark,base,berry,calyx,cm,connivent,cordate,cream,cuneate,curved,dark,densely,diameter,distal,entire,erect,filament,flattened-reniform,flower,fruit,fruiting,glabrous,gland,globular,gray,green,half,herb,inflated,lateral,leaf,length,lobe,lobed,long,long-styled,lower,margin,marking,maturity,mauve,midpoint,mm,moderately,narrow-deltate,narrow-oblong,obtuse,occasional,occasionally,often,one,open,orange,orange-brown,ovate,pair,pale,pedicel,peduncle,per,perpendicular,petiole,plant,poricidal,porrect,prickle,prickly,primary,purple,ray,reduced,rounded,shorter,shrub,simple,sometimes,spaced,sparsely,spherical,stalk,stalked,stellate,stellate-pubescent,stem,straight,style,surface,tapering,terminal,time,tip,trichome,tube,unarmed,unbranched,upper,variously,vein,way,weakly,wide,yellow,yellow-green,young	-2,/3,0-0.3,0-15,0.1,0.1-0.25,0.1-0.3,1,1-6,1.5-2,1/,1/3-2/3,4.5-10,5-10,5-merous,7-15,abaxially,alyx,andromonoecious,apar,apical,becoming,blade,broad-deltate,brow,chartaceous,difoliate,discolorous,distance,drying,eaf,eed,elongating,equal,extending,eye,free,geminat,glabrescent,herbaceous,hermaphrodite,heterostylous,infructescence,long-acuminat,longer,lowermost,mature,midvein,naked,nflorescence,older,orolla,oung,pendulous,pericarp,portion,ruit,scar,short-styled,shorte,side,slender,smooth,spreading,staminat,subsessile,tamen,terete,tertiary,unarme,unit,usually,vary,venation,visible,woody,ympodial	'',[,``,arrangement,branch,brown,bud,characteristic,colour,corolla,exertion,form,glabrousnes,growth,height,history,inflorescence,interjected,leaflet,life,lobing,long-acuminate,na,new,number,ovary,perennial,pseudostipule,seed,shape,size,stigma,texture,thicknes,type,value,variation,width,{,}
398	wfo-0001030516	invalid_json	172	99	69	103	30	0.401	0.4-1.5,1-7,1.1-3.5,1.1-4.1,1.5-2,1.8-2.4,2-12,2-3,3-8,3-9.8,4-22,4-6,4-7,4.2-10.7,6-15,8-9,9-22,acute,branched,calyx,cm,corolla,cyme,darker,diameter,dichasial,dichasially,ebracteate,forked,gland,globose,green,green-white,herbaceous,interjected,lateral,leaf,leaflet,light,lobe,long,long-attenuate,mm,monochasial,mucilaginous,odd-pinnate,ovoid,pedicel,peduncle,pentagonal,perennial,petiole,pilose,plant,puberulent,pubescent,rotate,seed,short-stalked,size,slightly,sometimes,stripe,style,terminal,throughout,triangular,wide,yellow	1-2.5,1-4,1.7,2-2.,2-4,3-6,3-6-foliat,4-4,9-32,abaxially,acumen,acuminate,adaxially,apex,apical,apically,articulate,base,cell,connate,cordate,covered,covering,cuneate,decurrent,dehiscent,densely,digestion,diminished,distal,dorsally,eaf,edge,eed,elliptical,emoval,enzyme,exceeding,filament,first,flat,flower,folded,generally,globo,gradually,hair,hair-like,half,honeycomb,introrse,less,living,lon,longer,lower,lunat,make,maturing,nflorescence,nther,oblique,often,orolla,outline,ovate,pair,pattern,perfect,plan,poricidally,proximal,rarely,reveal,ruit,second,sessile,seudostipule,short,short-petiolate,slit,specimen,spreading,stamen,stigma,straight,tal,tem,testal,thick,time,toward,triangulat,tuber-bearing,type,typically,unit,vary,wall,whit,ympodial,Â¼,â	'','type,2-21,[,],``,anther,arrangement,branching,characteristic,colour,form,fruit,growth,height,history,inflorescence,length,life,ovary,pseudostipule,shape,stem,surface,texture,value,wet,width,{,}
399	wfo-0001030551	success	167	133	77	90	56	0.461	-30,0-2,0.5-1,0.6-1.5,1-2,1-2.5,1-3.5,1-4,1.5-2.5,10-20,10-40,20-25,3-12,3-8,4-,5-6,acuminate,acute,adaxially,adpressed,also,apex,basal,base,blue,calyx,chartaceous,cm,concave,cordate,densely,dia,diameter,ellipsoidal,entire,fading,flower,fruit,glandular-puberulent,globose,hair,lanceolate,lobe,long,margin,mm,moderately,narrowly,oblong-fusiform,obtuse,often,ovate,ovate-elliptic,ovoid,pedicel,peduncle,perfect,petiole,pilose,puberulent,pubescent-pilose,shrub,simple,sparsely,stigma,style,subcoriaceous,tip,triangular,triangular-elliptic,truncate,tube,unbranched,unknown,violet,x,yellowish	-12,-5,1,1-,1-10,1-5,1.5-,13.,2,2-3,2-6,2.5-4,2.5-5,3-,3-5,4-5,4-7,4-foliat,5-17,9-20,abaxially,abruptly,absent,aggregate,apart,ape,articulated,axe,beyond,bilobe,blade,broad,campanulate,cell,clavate,color,connective,dilated,directed,distally,eaf,ed,equal,et,exceeding,exserted,fleshy,glabrous,laterally,leaving,lon,lower,martinelli,narrow,narrowed,nflorescence,nther,orolla,papillose,pedicellar,pore,puberulen,puberulent-pubescent,pubescent-pilo,rachi,radiu,remnant,ripe,round,ruit,seen,shorter,slightly,small,spaced,stamen,stellate,stone,tal,tem,thecae,time,tomento,ud,unit,unknow,vary,wide,widening,ympodial	anther,appearance,arrangement,bark,bilobed,border,branch,bud,caylx,characteristic,colour,corolla,corrugation,distal,drying,exertion,filament,form,fruiting,giving,glabrousnes,growth,height,history,inflorescence,interjected,lateral,leaf,leaflet,length,life,lobing,midpoint,na,new,number,ovary,per,perennial,plant,prickle,primary,pseudostipule,ray,seed,shape,size,stem,surface,terminal,texture,thicknes,type,variation,vein,width
400	wfo-0001030570	invalid_json_followup	173	147	93	80	54	0.538	0-,0.3-0.5,1-3,1-4,1-8,1.5,10-25,15-35,2-3,2-5,2-7-lobed,2-8,2.5-22,20-30,3-10,3-5,4-25,4-5,4-7,abaxially,acuminate,acute,adaxially,apex,apiculate,basal,base,beyond,calyx,cm,connivent,cordate,cylindrical,diameter,dilated,distally,eglandular,ellipsoidal,entire,exserted,flattened,flower,forked,fruit,glabrous,glandular-puberulent,globose,green,hair,lanceolate,leaf,lobe,lobed,long,margin,mm,narrowly,obtuse,occasionally,often,ovoid,pedicel,peduncle,petiole,pilose,pinnately,pubescent,purplish,rarely,rounded,rugose,simple,slightly,sometimes,sparsely,stamen,stigma,style,subcoriaceous,submarginally,tip,tree,triangular,truncate,tube,unbranched,unequal,unknown,unlobed,vein,white,x,yellow	-1,.3-0.5,0.5-,0.5-1,1,1-,1-1.5,1-2,1-5,1.5-2.5,1/2,10-17,15-20,2-2.5,2-4,2-7,3-6,3.5-5,4-foliat,4/5,5-,8-,absent,aggregate,apart,ape,articulated,axe,blade,campanulate,cell,color,connective,directed,divided,eaf,eed,elliptic-oblong,exceeding,fleshy,glabrat,leaving,lon,lower,midrib,near,nflorescence,nther,orolla,ovate,pedicellar,perfect,pilo,pore,presen,punctate,purpl,rachi,radiu,remnant,ripe,ruit,shorter,sinus,small,somewhat,spaced,stellate,stone,tal,tem,thecae,time,tomento,truncat,ud,unit,vary,wide,ympodial	'',[,``,anther,arrangement,bark,branch,bud,characteristic,colour,corolla,corrugation,distal,drying,exertion,filament,form,fruiting,glabrousnes,growth,height,history,inflorescence,interjected,lateral,leaflet,length,life,lobing,midpoint,na,new,number,ovary,per,plant,prickle,primary,pseudostipule,ray,seed,shape,size,stem,surface,terminal,texture,thicknes,type,value,variation,width,{,}
401	wfo-0001030581	invalid_json_followup	187	163	100	87	63	0.535	1-4-celled,9,abaxial,acute,adaxial,along,angle,angled,anther,anthesi,apex,appressed,articulated,basal,base,berry,black,calyx,capitate,central,clustered,cm,conical,corolla,decurrent,densely,denser,diameter,ellipsoid,elliptic,entire,exserted,filament,flattened-reniform,flower,fruit,fruiting,globose,green,growth,halfway,herb,inflorescence,intermodal,lateral,leaf,less,like,lobe,long,margin,maturity,minute,minutely,mm,near,new,occasionally,often,once-branched,ovary,ovate,pair,papillate,pedicel,peduncle,per,petiole,pitted,plant,portion,primary,pubescent,purplish,ridge,ripe,shallow,simple,slightly,somewhat,sparsely,spreading,stem,stigma,straight,style,surface,terete,third,translucent,trichome,tube,turning,uniseriate,upper,vein,white,wide,yellow,yellowish	.3,.5,0.2â0.8,0.4â0.6,0.4â1.6,0.5,0.5â0.7,0.5â2.5,0.6â0.7,0.7â0.8,0.9â1,1,1.2â1.5,1.8â8,1â2,1â2-celled,1â2.5,1â4-celled,2,20â50,2â3-celled,35â45,3â4,3â5,4.5â12,4â7,4â9,5-merous,5â6,5â8,abaxially,adaxially,aggregate,apar,becoming,beyond,branched,bright,cell,cone,difoliate,drop,eaf,eed,florescence,free,geminat,glabrous,individual,lacking,later,leave,live,lobed,lon,lower,markedly,narrowly,outline,pentagonal,perfect,rachi,reflexe,reflexed,remaining,rounded,ruit,scar,shiny,shorter,spaced,sprawlin,stellate,stone,strongly,tall,tangled,tem,testal,ud,unit,usually,winged,woody,ympodial,â15,â5	'',0.2-0.8,0.4-1.6,0.5-2.5,0.6-0.7,0.9-1,1-2-celled,1-2.5,1.2-1.5,1.5,1.8-8,15,20-50,3-4,3-5,35-45,4-7,4-9,4.5-12,5,5-6,5-8,[,``,appearance,arrangement,bark,branch,bud,characteristic,colour,corrugation,distal,drying,exertion,form,giving,glabrousnes,height,history,leaflet,length,life,lobing,midpoint,na,number,perennial,prickle,pseudostipule,ray,seed,shape,size,terminal,texture,thicknes,type,value,variation,width,{,}
402	wfo-0001030583	invalid_json_followup	166	143	95	71	48	0.572	.5,0.1-0.5,0.2-1,0.3-1,0.5-1,0.7-4.5,0.8-1,1,1-1.5,1-8,1/2,2.5,2.5-3,2.5-9,3-4,3/4,4-6,5-6,5-7,acute,anther,apex,bark,base,berry,calyx,cm,corolla,crisped,cultivar,deep,deflexed,dendritic,densely,dia,ellipsoid,elliptic,enlarged,filament,flattened-reniform,flower,form,fruit,fruiting,glabrous,globose,golden,green,immature,included,incrassate,irregular,lateral,leaf,lobe,lobed,long,main,margin,minutely,mm,narrowly,often,orange-red,ovary,pair,pale,pedicel,petiole,pitted,plant,prostrate,pubescent,ripe,rounded,shaped,shrub,simple,size,small-capitate,stem,stigma,stout,style,surface,tall,tan,tear-drop,trichome,tube,vein,way,white,x,yellow	.2,0.4-2.7,0.9-3.5,1-2,1.5-4,6-7,abaxial,abaxially,adaxially,along,anthesi,ba,brow,cell,closely,conical,corky,cultivated,dark,differing,difoliate,dry,eaf,edicel,eed,erect,especially,free,frui,geminat,leave,like,live,lon,long-rectangular,long-triangular,lower,major,midvein,minor,nflorescence,occasionally,older,opposite,outline,overlapping,papery,papillo,papillose,pericarp,planar,pore,poricidal,portion,rest,ruit,scar,small,soon,spaced,spathulate,specimen,testal,thin,tip,ud,uniseriate,unit,woody,ympodial,young	'',[,``,alternate,arrangement,branch,brown,bud,characteristic,colour,corrugation,diameter,distal,drying,exertion,giving,glabrousnes,growth,height,history,inflorescence,interjected,leaflet,length,life,lobing,midpoint,na,new,number,peduncle,per,perennial,prickle,primary,pseudostipule,ray,seed,shape,terminal,texture,thicknes,type,value,variation,width,{,}
403	wfo-0001030605	invalid_json_followup	144	158	111	33	47	0.771	.4,.5,0.1,0.3-0.5,1,1-4,1.5-2,1.5-5.5,1.7,12-19-flowered,2,2-3,2.5,5-12.5,7,acute,adaxially,almost,anther,anthesi,apex,apical,area,attenuate,base,berry,branch,branched,brown,calyx,cinereous,cm,commonly,conical,coriaceous,corolla,covered,cylindrical,dark,dendritic-echinoid,densely,dia,difoliate,dry,drying,ellipsoid,exerted,filament,fruiting,glabrate,glabrous,globose,gold,green,growth,inflorescence,internodal,leaf,less,light,lobe,long,margin,material,minutely,mm,nearly,new,obovate,obtuse,occasionally,olive,opposite,ovary,ovoid-reniform,pedicel,peduncle,petiole,pitted,pubescent,rarely,reflexed,revolute,rounded,scattered,shaped,shiny,shrub,simple,slender,slightly,smooth,soon,sparesly,sparsely,stigma,style,surface,tear-drop,thickened,tinged,tip,trichome,tube,unifoliate,vein,way,white,woody,x,yellow	1/3-1/2,abaxially,along,apart,ape,beginning,beneath,deflexed,eaf,edicel,eed,entire,free,geminat,inflorescenc,lobed,lower,midrib,nflorescence,otherwise,ovate,overlapping,papillate,papillosefruit,pore,poricidal,portion,scar,somewhat,tub,ud,unit,ympodial	'',[,``,arrangement,bark,bud,characteristic,colour,corrugation,diameter,distal,exertion,form,fruit,geminate,glabrousnes,height,history,interjected,lateral,leaflet,length,life,lobing,midpoint,na,number,papillose,per,plant,prickle,primary,pseudostipule,ray,seed,shape,size,stem,terminal,texture,thicknes,type,value,variation,width,{,}
404	wfo-0001030624	success	170	120	77	93	43	0.453	.5,0.9-1,1.2-1.8,1.2-2,1.5-2,2-10,2.5-5.5,3-3.5,3.5-4,6-13,7-9,acute,anther,apex,attenuate,bark,base,berry,branch,calyx,clavate,cm,corolla,dia,distal,ellipsoid,elliptic,exserted,falcate,filament,flattened-reniform,fruiting,furcate,glabrate,glabrous,glandular,globose,green,hyaline,later,lateral,leaf,lobe,main,margin,minutely,mm,narrowly,nearly,occasionally,ovary,pair,pale,pedicel,petiole,pitted,puberulent,shrub,simple,size,slender,small,soon,stem,stigma,straight,style,surface,tapering,tree,tube,vein,white,x,yellow,yellowish,yellowish-green	.25,0.5,0.5-1,0.5-1.5,1-3,2,2-3,25-40-flowered,3,4.5-8,anthesi,apart,apiculate,appearing,axil,ba,beginning,caly,cell,decurrent,deflexed,differing,difoliate,dimorphic,dry,eaf,edicel,eed,end,erect,except,expanded,extreme,free,geminat,greyish,incrassate,inflorescenc,large,like,lobed,lon,long,longitudinally,lower,major,material,middle,midrib,minor,near,nflorescence,older,one,opposite,outer,papillose,planar,pore,poricidal,portion,prominent,raised,remaining,round,rugo,ruit,scar,shining,short,slightly,somewhat,spaced,square,tall,thickened,three,ti,tip,trichome,trunk,tuft,two,ud,unevenly,uniseriate,unit,wall,widest,woody,yellowish-grey,ympodial,young	alternate,appearance,arrangement,border,bud,characteristic,colour,corrugation,diameter,drying,exertion,form,fruit,giving,glabrousnes,growth,height,history,inflorescence,interjected,leaflet,length,life,lobing,midpoint,na,new,number,peduncle,per,plant,prickle,primary,pseudostipule,ray,seed,shape,terminal,texture,thicknes,type,variation,width
405	wfo-0001030638	success	177	133	105	72	28	0.593	0.1,0.5-0.7,0.5-1,0.5-1.5,0.7-1.5,1-1.2,1-1.5,1.4-1.7,1.6-2.2,2-3,2-5,2-7-flowered,3-10,3-13,8,8-11,8-9,acute,along,anther,anthesi,apex,apically,axi,bark,base,berry,branched,broadly,bud,calyx,cm,corolla,cup-shaped,deflexed,densely,dia,difoliate,elliptic,filament,flattened,fruit,fruiting,geminate,glabrate,glabrous,glandular,globose,green,inflorescence,later,lateral,leaf,less,lobed,long,main,margin,minutely,mm,nearly,obovate,occasionally,often,older,open,opposite,ovary,pair,pale,papillae,papillose,pedicel,persistent,petiole,poricidal,red,red-glandular,reddish,roundish,rugose,seed,shape,shrub,simple,size,soon,stem,stigma,style,surface,tapering,terminal,thickening,tip,tree,trichome,tube,uniseriate,unit,usually,vein,white,x,young	0.5,0.5-2,1-2,1.5-2,2.5-4,4-6,appear,appearing,axil,ba,beginning,beneath,blade,closely,conspicuously,corky,cucullate,deltoid,differing,dry,eaf,eed,entire,erect,exfoliating,extending,fleshy,free,geminat,gre,impressed,irregular,known,lamina,large,like,lobe,lon,lower,major,material,middle,minor,near,nflorescence,one,overlapping,ovoi,paler,papillo,planar,pore,portion,present,prominent,rather,rest,ruit,scar,shaped,spaced,speciman,straight,tall,tear-drop,thick,thickened,transversely,wall,widest,woody,ympodial	arrangement,branch,characteristic,colour,corrugation,diameter,drying,exertion,form,glabrousnes,grey,growth,height,history,length,life,lobing,na,new,number,ovoid,peduncle,per,plant,primary,sympodial,texture,type
406	wfo-0001030661	invalid_json_followup	183	166	123	60	43	0.672	-24,.5,0,0.5-0.6,0.5-0.75,0.5-2,0.7-0.8,1-,1-1.2,1-1.4,1-1.5,1.2-7,1.5-2,1.5-7,12-16,2-,2-2.5,3-20,3-3.5,4-15,5-5.5,50-100+,acute,anther,anthesi,apex,articulated,attenuate,base,berry,branch,branched,brown,calyx,capitate,cm,conical,connivent,corolla,denser,diameter,drying,ellipsoid,elliptic,entire,erect,exserted,filament,flattened,flower,fruiting,glabrescent,glabrous,globose,growth,inflorescence,insertion,lateral,leaf,lobe,lobed,long,loosely,many,margin,mature,membranous,minute,minutely,mm,narrowly,near,new,nodding,occasionally,onto,pair,pale,pedicel,peduncle,per,petiole,pitted,point,poricidal,primary,pubescent,red,reddish,reniform,scattered,shrub,simple,sleeve,slender,slightly,small,sparsely,stellate,stem,stigma,strongly,style,surface,terminal,time,tinged,tip,tree,trichome,tube,uniseriate,vein,violet,way,white,winged,woody,x,yellow,yellowish,Â½,Â¾	.2,1-.,1-1.3,3-4,4-6,5-10,5-merou,ag,along,alyx,ark,brow,cell,clustered,dar,deltate,densely,eaf,eed,em,erec,extending,free,glabrou,group,ilament,lamina,lengthening,lon,lower,midrib,never,nflorescence,older,orolla,otherwise,papillo,perfect,pericarp,planar,platform,plurifoliat,pore,portion,rectangular,ruit,scar,shiny,slit,spreading,tangled,testal,thin,twinin,ud,unit,upper,usually,vary,ympodial	'',1-5,[,``,arrangement,bark,bud,cayx,characteristic,colour,corrugation,distal,exertion,form,fruit,glabrousnes,height,history,interjected,leaflet,length,life,lobing,midpoint,na,number,ovary,papillose,plant,prickle,pseudostipule,ray,seed,shape,size,texture,thicknes,type,value,variation,width,{,}
407	wfo-0001030676	success	220	143	101	119	42	0.459	0.4,1-1.2,1.1-1.4,1.2-1.3,1.7-2,16,19-35,2.1-2.6,2.2-5.7,3-6,4-6,7-8,7-9,8-10,8-12,abaxially,abruptly,acute,adaxially,angled,anther,anthesi,apex,appressed-tomentose,bark,base,becoming,berry,blunt-tipped,branch,branched,brown,bud,calyx,cm,conical,continued,corolla,deltoid,diameter,dichotomously,due,elongate,entire,exserted,filament,finely,fleshy,fruit,globose,granular-tomentose,green,greenish,grooved,growth,honeycombed,lateral,leaf,length,lobe,longitudinally,margin,midvein,minutely,mm,oblique,oblong,oblong-elliptic,often,openly,ovate-lanceolate,pedicel,peduncle,petiole,probably,pulverulent,ray,reniform,reticulate-punctate,ripe,scabrous,short-attenuate,shrub,side,simple,somewhat,stem,stigma,strongly,style,subcampanulate,subglobose,suborbicular,terete,vein,velutinous,white,whitish,x,yellow,yellowish	-1.6,-2.5,-3.9,-8.5,/10-1/5,0-100,0.6-1.2,1,1-3,1.1-1.9,1.3-1.5,1/4,11-14,14-17,2.1-2.3,2.4-3.1,2.5-5.5,2.75-3.25,3-3.5,3-5,4-6.5,7-10,along,apart,apical-lateral,apparently,appearing,articulated,axillary,ba,blade,chartaceous,closely,crown,cylindrical,dehiscing,densely,eaf,echinoi,echinoid,eed,except,flat-topped,flower,forming,free,glabrescen,glabrescent,glabrous,hair,high,horizontal,initially,inserted,introrse,lackin,lamina,large,lengthen,lined,lobed,long,longitudinal,lower,main,midvei,minute,moderately,mostly,multangulate,nearly,nflorescence,obtuse,occasional,older,opening,orolla,ovate,parallel,perfect,plurifoliate,pore,pseudo-terminal,pubescent,rachi,rather,ridged,ruit,runk,scattered,sessile,short-stalked,slit,small,spaced,sparsely,spreading,stellate,stellate-pubescent,subcapitat,tamen,tending,testa,thick,thin,time,tip,tomentose,tree,tube,tuft,unarme,unit,usually,vary,way,wide,ympodial,young	3-3.9,appearance,arrangement,border,characteristic,colour,distal,exertion,form,giving,glabrousnes,height,history,inflorescence,interjected,leaflet,life,lobing,midpoint,na,new,number,ovary,per,perennial,plant,prickle,primary,pseud-terminal,pseudostipule,seed,shape,size,subcapitate,surface,terminal,texture,thicknes,type,unarmed,variation,width
408	wfo-0001030686	success	182	125	106	76	19	0.582	.5,1-1.1,1-1.2,1-2,1.2-1.5,1.5-4.5,1.6-3,15,2-2.5,2-3,2-6.5,2.5-8,3-3.5,5-12,5-25,5-30,5-6,8-9,abruptly,acuminate,acute,age,anther,apex,bark,base,berry,bifid,black,branched,brown,c.,calyx,centre,cm,conical,corolla,dark,darker,deeply,densely,diameter,drying,elliptic,entire,erect,exerted,filament,flattened,flower,form,fruit,fruiting,glabrous,globose,golden,height,internodal,leaf,leaf-opposed,lengthening,lepidote,lilac,lobe,long,margin,maturity,mm,oblique,orange,ovary,pair,pale,pedicel,peduncle,petiole,pitted,plant,pore,poricidal,primary,pubescent,purple,seed,shallow,shallowly,shiny,simple,slit,sparsely,spreading,stem,stigma,strongly,style,surface,time,tip,tree,tube,uniformly,usually,vein,way,x,yellow	.2,.5-1,0.5-1,1-1.5,1.5-2,1972,2.5-4,?,abaxially,aborted,adam,adaxially,anthesi,apart,basal,beneath,breast,brittle,bu,closely,cup-shaped,denser,different,difoliate,discolorous,dry,eaf,edicel,eed,empty,fide,fragrant,free,geminat,glabrescen,half,heteromorphic,lamina,less,lobed,lower,many,midrib,midvein,minutely,nflorescence,noddin,older,overlapping,paler,papillae,papillose,pericarp,planar,portion,pubescen,rachi,ruit,scar,scarious,short,slightly,somewhat,space,spaced,stellate,styl,thin,tissue,trichome,ud,unit,visible,woody,ympodial,â	arrangement,bud,characteristic,colour,exertion,glabrescent,glabrousnes,growth,history,inflorescence,length,life,lobing,na,new,shape,size,texture,type
409	wfo-0001030709	success	217	154	127	90	27	0.585	-9,0-,0-30,0.7-1,0.9-1.5,1-1.2,1-1.6,1-4.5,1-6,1.3-1.4,1.4-2,1.6-2.1,1.9-2.8,1/2-2/3,1/3-1/2,1/4,10-14,2-6,2-8,2.3-3,3-,5-20,5-6,5-9,6-21,6-7,7-9,8-11,8-15,abaxially,acuminate,acute,almost,anther,apart,apex,apically,apparently,articulated,bark,base,berry,branched,bright,calyx,chartaceous,cm,conical,connivent,cordate,diameter,discolorous,drying,dull,elliptic,elongating,erect,filament,finely,flattened-reniform,fruit,fruiting,glabrous,inflorescence,lateral,leaf,length,lobe,lobed,lobing,long,margin,mature,maturity,mauve,middle,mm,moderately,narrow-deltate,orange-brown,pair,pedicel,peduncle,per,perpendicular,petiole,pitted,poricidal,porrect,prickle,prickly,primary,purple,red-green,red-orange,seed,shrub,side,simple,size,smooth,spaced,sparsely,spherical,spreading,stalked,stellate-pubescent,stem,straight,style,surface,tapering,terete,terminal,tip,trichome,truncate,tube,unarmed,upper,variously,vein,way,weakly,wide,yellow,yellow-green	-2,-5,0,0-20,0.1-0.2,0.15-0.5,0.2-0.5,0.3-1.5,0.4,0.8-4,1/4-1/3,10-50,2-4,2-5,2/3-3/4,4-5-merous,5-10,5-7,6-10,6-8,7-8,adaxially,alyx,ame,apar,ape,blade,broad-deltate,brow,c.,cuspidate,deltate,distance,eaf,edge,eed,equal,extending,flower,free,glabrescent,increasing,infructescence,lanceolate,lengt,lon,long-acuminat,longer,lower,midpoint,midvein,nflorescence,occasionally,often,older,one,open,orolla,oung,pendulous,perfect,pericarp,pit,plurifoliat,portion,prickl,ray,reflexed,retrorse,rounded,ruit,scar,secondary,short-styled,shorter,slender,sometimes,stalk,stellate,tamen,tertiary,time,toward,unit,usually,vary,venation,visible,woody,ympodial	appearance,arrangement,border,branch,brown,characteristic,colour,corolla,exertion,form,giving,glabrousnes,growth,height,history,life,long-acuminate,na,new,number,ovary,perennial,plant,shape,texture,type,width
410	wfo-0001030714	invalid_json_followup	178	178	134	44	44	0.753	-3,.2,/3,0.1-0.3,0.5,0.5-0.8,0.5-1.9,0.7-0.8,1-1.2,1-2.5,1.2-1.5,1.2-4,1.4-3.5,1/3,2-2.5,2-2.6,20,3-3.5,3-7,5-100,5-6,7-17,>,acuminate,acute,adaxially,age,aid,along,anther,apex,articulating,bark,basal,base,becoming,beneath,berry,blue,blue-black,branching,calyx,clavate,cm,conical,cordate,corolla,dark,denser,diameter,ellipsoid,elliptic,entire,especially,except,exserted,filament,flattened,flower,fruit,glabrous,globose,gradually,greyish,growth,herbaceous,joined,leaf-opposed,leaving,lengthening,liana,like,lobed,long,many,margin,membranous,midrib,minute,minutely,mm,narrowly,new,node,ob-ellipsoid,ob-elliptic,oblique,occasionally,ovary,overall,pair,pale,papillate,pedicel,peduncle,peg,per,petiole,pitted,pore,poricidal,primary,prominent,pubescent,reniform,ripe,shape,simple,slightly,slit,sparsely,stellate,stem,stigma,strongly,style,submarginal,surface,tapering,terminal,time,tip,trichome,truncate,tube,twining,uniseriate,vein,vine,violet,way,woody,x,yellow	.5,0.3-0.4,0.8-1,1-1.3,1-1.5,1.5-2,abaxial,abaxially,anthesi,apar,campanulate,climbin,cup,densely,eaf,eed,fide,free,grading,gree,howard,lobe,lower,narrow,nflorescence,nodding,older,paler,papillat,pedice,perfect,planar,plurifoliat,portion,quadrate,ruit,scar,spaced,thickened,tub,ud,unit,widely,ympodial	'',[,``,arrangement,branch,bud,characteristic,climbing,colour,corrugation,distal,drying,exertion,form,fruiting,glabrousnes,green,height,history,inflorescence,interjected,lateral,leaf,leaflet,length,life,lobing,midpoint,na,number,plant,prickle,pseudostipule,ray,seed,size,texture,thicknes,type,value,variation,width,{,}
411	wfo-0001030733	success	130	129	81	49	48	0.623	/4,1-1.2,1-1.5,1-2,1.5-5,1.7-2.7,2-2.5,3-4,3-5,4-15,4.5-5,5-8-flowered,6-7,6-9,abaxially,acuminate,acute,adaxially,anther,apex,bark,base,berry,bi-lobed,broadly,brown,calyx,capitate,cm,conical,coriaceous,corolla,dark,decurrent,densely,dia,ellipsoid,elliptic,erect,exserted,filament,fruiting,glabrous,globose,green,later,lateral,leaf,lobe,long,main,margin,minutely,mm,moderately,narrowly,onto,ovary,ovoid-reniform,pair,pedicel,petiole,pubescent,shaped,shrub,simple,smooth,somewhat,stem,stigma,strongly,style,surface,tear-drop,thick,treelet,tube,vein,way,white,x	.5,0.5-1,?,along,anthesi,ape,clearly,closely,deltate,denser,eaf,eed,elongate,embryo,free,grayish-brow,lamina,like,lobed,lon,lower,middle,nflorescence,older,opposite,overlappin,papillo,planar,pore,poricidal,portion,rounded,ruit,scar,spaced,sparsely,tall,testa,tip,trichome,ud,unifoliat,uniseriate,unit,visible,widest,woody,ympodial,young	0.5,appearance,arrangement,border,branch,bud,characteristic,colour,corrugation,diameter,distal,drying,exertion,form,fruit,giving,glabrousnes,grayish-brown,growth,height,history,inflorescence,interjected,leaflet,length,life,lobing,midpoint,na,new,number,peduncle,per,plant,prickle,primary,pseudostipule,ray,seed,shape,size,terminal,texture,thicknes,type,unifoliate,variation,width
412	wfo-0001030772	success	155	122	95	60	27	0.613	-2,.2,.25,.5,0.2-0.8,0.25-0.5,0.9-1,1-2,1-2.5,1.4-1.6,3-3.5,3-5,4.2-6.5,5-10-flowered,5-6,8-10,9-15,acuminate,anther,anthesi,apex,attenuate,bark,base,becoming,beneath,berry,branch,bud,calyx,capitate,cm,corolla,dark,deflexed,dia,ellipsoid,elliptic,extreme,filament,fruit,fruiting,gently,glabrous,globose,green,grey,impressed,later,lateral,leaf,lobed,long,long-acuminate,main,margin,minutely,mm,nearly,occasionally,ovary,ovoid-reniform,pair,pale,paler,papillose,pedicel,per,petiole,pitted,pore,poricidal,prominent,reflexed,shape,shaped,shining,shrub,simple,size,slender,soon,stem,stigma,style,surface,tan,tapering,tear-drop,tip,tube,vein,white,x,young	.05,0.5-1,0.75-1,0.9-3.1,1.2-5,1.5-2,2-7,acute,archin,ba,beginning,closely,differing,difoliate,eaf,edicel,eed,erect,free,geminat,inflorescenc,large,lenticellate,lobe,lon,long-triangular,lower,major,methyl,middle,minor,nflorescence,node,older,one,opposite,overlapping,papillo,portion,ripe,rounded,ruit,salicylate,scar,slightly,smelling,spaced,straight,strongly,swollen,tall,trichome,ud,uniseriate,unit,usually,widest,wintergreen,woody,ympodial	alternate,arching,arrangement,characteristic,colour,corrugation,diameter,drying,exertion,form,glabrousnes,growth,height,history,inflorescence,length,life,lobing,na,new,number,peduncle,plant,primary,seed,texture,type
413	wfo-0001030781	invalid_json_followup	213	164	120	93	44	0.563	0-5,0.2-4,0.5-6,0.5-8,1-2,1-8,1.5-12,1.5-2,1.5-9,1.6-2.2,10-40,15-35,2-20,2.5-14,2.5-3.5,3-4,5-6,5-7,7.5-9,abaxially,adaxially,anther,apex,apiculate,axillary,base,berry,brownish,bud,cell,chartaceous,cm,condition,connivent,corolla,covering,dark,decurrent,deep,diameter,distal,dot,drying,filament,forked,fresh,fruit,generally,glabrous,glandular,globose,gray-green,green,green-white,greenish,hair,half,herb,interjected,lanceolate,lateral,leaf,leaflet,light,like,lobe,long,make,margin,membranous,mm,mucilaginous,odd-pinnate,ovate,ovate-lanceolate,ovoid,papillose,pedicel,peduncle,petiole,petiolulate,pilose,plant,pointed,pubescent,purple,rachi,rarely,rounded,scattered,seed,sessile,short,simple,size,slightly,small,sometimes,somewhat,sparsely,stem,stigma,style,subovoid,subtending,terminal,testal,thick,throughout,tube,typically,unwinged,usually,violet,wall,wet,white,whitish,wide,x	1-1.5,1-10,1-12,1-4,2-3,3-6,4-15,5-8,5-merou,6-7,abruptly,acumen,ag,along,alyx,apart,apparently,articulated,axe,blade,borne,broadly,brown,caly,capitat,ciliate,cuneate,decreasing,densely,digestion,dorsally,eaf,edge,eed,elliptic,end,enzyme,erect,especially,exceeding,finely,flat,flower,folded,geminat,glabrou,gradually,hair-like,high,homostylous,honeycomb-shaped,larger,lengthening,living,low-growin,lower,midrib,minutely,narrowed,nflorescence,obovate,orbicular,orolla,pair,pentagonal,perfect,plurifoliate,pore,poricidal,puberulent,removed,rotate-pentagonal,ruit,seudostipule,singly,slit,spaced,specimen,stamen,ste,stolo,straight,tall,tamen,tem,tip,toward,tri-,tuber,unit,vary,yellow,ympodial	'',[,\u201chair-like\u201d,``,arrangement,bark,branch,calyx,capitate,characteristic,colour,corrugation,exertion,form,fruiting,glabrousnes,growth,height,history,inflorescence,length,life,lobing,midpoint,na,new,number,ovary,per,prickle,primary,pseudostipule,ray,shape,surface,texture,thicknes,type,value,variation,vein,width,{,}
414	wfo-0001030782	invalid_json_followup	198	158	111	87	47	0.561	0-1,0-7,0.4-1.5,1-2,1.2-3.9,1.3-1.6,1.5-2,1.5-7.5,1.6-4.6,11-47,13-22,15,2,2.2-4,2.4-11.5,3-10,4-11.6,4.6-26,5-20,6-8,abaxially,acumen,acuminate,acute,adaxially,anther,apex,attenuate,axillary,base,berry,broadly,brownish,bud,cell,clavate,cm,condition,connivent,coriaceous,corolla,covering,dark,deep,diameter,distal,drying,elliptic,filament,forked,fresh,fruit,generally,glabrescent,glabrous,globose,green,green-white,greenish,hair,half,herb,interjected,lanceolate,lateral,leaf,leaflet,light,lilac,lobe,long,make,medium,mm,mottled,mucilaginous,odd-pinnate,ovate,ovoid,pedicel,peduncle,petiole,petiolulate,plant,poricidal,purple,ripe,rounded,scarce,seed,sessile,short,size,stigma,style,subtending,terminal,testal,thick,throughout,tip,tube,usually,wall,wet,white,whitish,wide,winged,x,yellow	1-3,1-5,1-6,12-30,2-3,3-5,4-6,5-merou,7-15.6,abaxiall,ag,along,alyx,apart,apparently,arranged,articulated,asymmetric,axe,basiscopic,bead,blade,capitat,cuneate,decreasing,digestion,dorsally,eaf,edge,eed,enzyme,exceeding,flat,flower,folded,geminat,glabrou,hair-like,hal,high,homostylous,honeycomb-shaped,inconspicuous,lengthening,like,living,lower,moniliform,multiple,necklace,nflorescence,orbicular,orolla,pair,pentagonal,perfect,plurifoliate,pore,prominently,rachi,removed,rotate,ruit,second,seudostipule,side,slit,smaller,sometimes,spaced,specimen,stamen,stolon,straight,subequal,tal,tamen,tem,tissue,totally,toward,tri-,tuber,typically,unit,vary,ympodial	'',[,\u201chair-like\u201d,``,arrangement,bark,branch,cal,calyx,capitate,characteristic,colour,corrugation,exertion,form,fruiting,glabrousnes,growth,height,history,inflorescence,length,life,lobing,margin,midpoint,na,new,number,ovary,per,prickle,primary,pseudostipule,ray,shape,stem,surface,texture,thicknes,type,value,variation,vein,width,{,}
415	wfo-0001030802	invalid_json_followup	171	159	113	58	46	0.661	.3,.5,.5mm,0,0.5-0.75,0.5-1,0.5-1.5,0.9-1,1,1-1.1,1-1.2,1-1.5,2-3,2-5,2.5-3,3-4,3-6,4-6,5-10-flowered,abrupt,acuminate,acute,anther,anthesi,apex,appearing,bark,base,beneath,berry,brown,bud,calyx,cm,cordate,corolla,deeply,densely,dia,difoliate,dry,ellipsoid,evenly,exerted,exudate,filament,filiform,flattened-reniform,fruit,fruiting,glabrous,gland,glandular,globose,halfway,hanging,heart-shaped,internodal,lamina,lateral,leaf,length,lobe,lobed,long,main,margin,material,minutely,mm,obconic,older,ovary,ovoid,pair,pale,papillate,pedicel,per,petiole,pitted,plant,pubescent,raised,red,reddish,shaped,shrub,simple,single-celled,slender,somewhat,soon,specimen,stem,stigma,style,subshrub,surface,tapering,tear-drop,tipped,trichome,tube,unifoliate,uniseriate,variable,vein,white,x,yellow,yellowish,young	0.25-0.4,0.7-1cm,0.75-1,2-2.5,3-3.5x,4-5mm,abaxially,adaxially,along,basal,becoming,beginning,campanulate,cucullate,deflexed,denser,eaf,edicel,eed,except,free,geminat,glandurla,incrassate,inflorescenc,invest,irregularly,later,line,live,long-triangular,lower,m.,markedly,midvein,near,nflorescence,palmate,papillose,persistently,pore,poricidal,portion,prominent,pubescen,ruit,scar,spaced,stigm,straight,strongly,tip,trichoem,ud,unit,widely,woody,ympodial	'',0.7-1,4-5,[,``,arrangement,branch,characteristic,colour,corrugation,diameter,distal,drying,exertion,form,geminate,glabrousnes,growth,height,history,inflorescence,interjected,leaflet,life,lobing,midpoint,na,new,number,peduncle,prickle,primary,pseudostipule,ray,seed,shape,size,terminal,texture,thicknes,type,value,variation,width,{,}
416	wfo-0001030809	success	154	102	55	99	47	0.357	1.2-1.4,1.4-1.5,1.5-3.5,2-2.5,4.5-5,6-8,8,9.9-12,acute,anther,apex,bark,base,berry,calyx,clavate,cm,corolla,dia,ellipsoid,elliptic,erect,exserted,falcate,filament,fruit,fruiting,glabrous,globose,green,lateral,leaf,lobe,lobed,mm,nearly,ovary,ovate,pedicel,petiole,pubescent,size,soon,stem,stigma,style,tapering,terminal,tomentose,tree,tube,vein,white,x,yellow-brown	.5,0.2,0.5-1,1-1.25,1-1.5,1.5-2.4,2.3-5.5,20-60-flowered,5-8,across,along,also,anthesi,apar,appearing,beneath,branched,broadly,caly,campanulate,curl-tipped,curved,dark-papillo,deciduous,deflexed,deltoid,dense,densely,difoliate,distally,eaf,edicel,eed,especially,evenly,free,geminat,golden,hair,hidden,interpetalar,known,large,leave,like,lon,long,long-papillose,lower,main,major,markedly,mature,membranous,middle,midrib,minor,minutely,nflorescence,older,one,opposite,overtopping,planar,pore,poricidal,portion,present,round,ruit,scar,scattered,several,shinin,shining,shoot,simple,sinus,slender,slightly,small,spaced,straight,tall,three,time,tip,triangular,trichome,two,ud,underside,unequal,uniseriate,unit,wide,widest,ympodial,young	0.5,1,appearance,arrangement,border,branch,bud,characteristic,colour,corrugation,dark-papillose,diameter,distal,drying,exertion,form,giving,glabrousnes,growth,height,history,inflorescence,interjected,leaflet,length,life,lobing,margin,midpoint,na,new,number,peduncle,per,plant,prickle,primary,pseudostipule,ray,seed,shape,surface,texture,thicknes,type,variation,width
417	wfo-0001030810	success	191	121	64	127	57	0.335	anther,apex,axillary,base,bipinnate,blue,borne,branched,brown,calyx,clavate,cm,colour,dark,decreasing,densely,diameter,divided,elliptic,elliptical,filament,flattened,fleshy,fruit,glabrous,globose,green,greyish,leaf,leafy,lobe,long,margin,mm,moderately,oblong,opposed,pair,pale,pedicel,peduncle,pentagonal,petiole,pinnae,pinnate,pitted,primary,pubescent,shallowly,shiny,shoot,shrub,size,stem,stigma,style,subglabrous,surface,time,tomentose,unknown,violet,woody,x	0.2,0.2â0.3,0.3,0.4,0.5â,0.5â0.8,0.6â1.0,0.7â1.4,0.8â5.5,0.95â2.0,0â,1,1.0â1.5,1.0â2.0,1.0â3.0,1.1â2.0,1.1â2.2,1.2â1.5,1.5â1.9,1â2,1â3,1â5,2.9â4.5,20â100,2â3,2â4,3.0â5.0,3.3â5.5,3.3â8.5,3.5â4.6,3â19,4â14,4â5,4â7,5,5â15,5â30,5â32,6â10,6â22,7â10,7â11,8â10,abaxially,absen,accrescent,acute,adaxiall,adaxially,ag,along,anthesi,apart,articulated,axe,ba,blade,cell,chartaceous,connivent,cylindrical,denser,eaf,eed,equal,erect,especially,flower,geminat,hair,half,hig,indumentum,irregular,lon,longitudinal,lower,m.,midrib,midvein,multicellular,narrow,nflorescence,obtu,occasionally,older,opening,orolla,oung,perfect,plurifoliate,pore,poricidal,rarely,reflexed,rounded,ruit,secondary,shaped,side,simple,slit,sometimes,spaced,sparsely,stone,straight,tamen,tardily,tear-drop,tip,tube,unicellular,uniseriate,unit,vary,white,wide,wing,yellow,ympodial,â2.5,â3,â3.4,â4.5,â5.0,â8	0.2-0.3,0.6-1.0,0.8-5.5,1-2,1.1-2.2,1.2-1.5,1.5-1.9,20-100,3,3.3-5.5,3.3-8.5,4-14,4-5,4-7,5-32,7-10,8-10,abaxial,adaxial,appearance,arrangement,border,characteristic,corolla,distal,form,giving,glabrousnes,growth,height,history,inflorescence,interjected,lateral,leaflet,length,life,lobing,midpoint,na,new,number,ovary,per,plant,prickle,pseudostipule,ray,seed,shape,terminal,texture,thicknes,type,variation,vein,width
418	wfo-0001030822	success	146	111	66	80	45	0.452	0.1-0.2,0.5-1.5,0.8-1,0.9-1,1-1.2,1-1.5,11-15.5,2-2.5,3-3.5,3.5-7,5-6,8-9,acute,anther,apex,attenuate,base,berry,calyx,clavate,cm,corolla,elliptic-obovate,exserted,filament,filiform,flattened-reniform,fruiting,glabrous,globose,green,inflorescence,internodal,lateral,leaf,lobe,lobed,main,margin,minutely,mm,ovary,pair,pale,pedicel,petiole,pitted,revolute,shaped,shiny,shrub,size,stem,stigma,strongly,style,surface,tan,tear-drop,tube,usually,vein,white,x,yellowish,yellowish-brown	.2,0-0.5,0.4,0.4-1,1.5-2,2-3.8,2-5,3-5,5-7,abaxially,adaxially,anthesi,ba,beneath,broadly,closely,clustered,completely,cucullat,cucullate,cup,decurrent,deflexed,deltate,dia,differing,difoliate,eaf,edicel,eed,erect,fleshy,flower,free,geminat,incrassate,inflorescenc,later,lon,long,long-ellipsoid,lower,major,middle,minor,minute,near,nearly,nflorescence,occasionally,older,onto,open,opposite,papillo,papillose,perhaps,planar,pore,poricidal,portion,present,red-papillose,ruit,scar,simple,slightly,somewhat,spaced,sparsely,tall,tapering,tip,ud,unit,widest,winged,woody,ympodial,young	alternate,appearance,arrangement,bark,border,branch,bud,characteristic,colour,corrugation,diameter,distal,drying,exertion,form,fruit,giving,glabrousnes,growth,height,history,interjected,leaflet,length,life,lobing,midpoint,na,new,number,peduncle,per,plant,prickle,primary,pseudostipule,ray,seed,shape,terminal,texture,thicknes,type,variation,width
419	wfo-0001030871	invalid_json	248	182	147	101	35	0.593	0-120,0.2-0.4,0.3-4,0.6-1.5,0.7-1.3,1-18,1.3-2,1.5-3,1.8-2.6,1/2-3/4,11,2-8,3-32,3-5,3-6,3.5-14,30,4.5-6.5,4.8-9.5,6-40,9-13,abaxially,abruptly,acuminate,acute,adaxial,adaxially,along,anther,anthesi,apex,apical-lateral,appressed,attenuate,bark,base,becoming,berry,blade,blunt-tipped,branch,branched,brown,bud,calyx,campanulate,chartaceous,cm,conical,continued,corolla,dark,decurrent,dehiscing,deltoid,densely,diameter,due,early,echinoid,elongate,entire,equal,erect,exserted,extend,filament,fleshy,flower,free,fruit,fruiting,glabrescent,glabrous,granular-tomentose,green,greenish,growth,hair,honeycombed,introrse,large,lateral,leaf,length,long,longer,longitudinal,margin,midvein,mm,mostly,narrowly,nearly,nodding,oblong,obtuse,often,orbicular,ovate,ovate-lanceolate,pale,pedicel,peduncle,petiole,pore,probably,prominent,pubescent,purple,reflexed,reniform,reticulate-punctate,ripe,scabridulous,sessile,short,short-stalked,shrub,side,simple,slit,sometimes,sparingly,stamen,stem,stigma,strongly,style,subglobose,suborbicular,sulcate,terete,terminal,time,tomentose,tree,tube,unarmed,vein,velutinous,violet,way,white,x,yellow,yellowish	.2-3,.8-3.5,.9-1.2,/30-1/5,0.4-1.8,0.7-2.5,1-1.3,1.3-3,1.4-2.7,1.5-6,1.8-3.5,1/2,1/4,1/4-1/3,2-3,2.8-4.5,3-4.4,5-33,5-7,7-12,accrescent,ag,apart,apparently,appressed-tomentose,articulated,axe,axillary,ba,capitat,closely,dendritic-echinoi,dendritic-echinoid,dendritic-multangulate,directed,distal,eaf,earl,echinoi,eed,elliptic,evident,glabrescen,grayish,held,high,inserted,lobe,lobed,long-,long-stalked,lower,m.,main,minute,mixed,multangulat,multangulate,nflorescence,occasionally,older,open,orbicula,orolla,overlapping,partly,perfect,plait,plurifoliate,porrect-stellate,present,rachi,rather,ray,relatively,rotate-stellate,ruit,runk,short-,small,somewhat,soon,spaced,sparsely,splitting,stellate-tomentose,striate,suture,tamen,testa,thick,thick-stalked,thin-stalked,toward,unarme,unit,usually,vary,wide,ympodial,young	'',[,],``,age,arrangement,capitate,characteristic,colour,drying,exertion,form,glabrousnes,height,history,inflorescence,life,lobing,na,new,number,ovary,per,perennial,plant,primary,seed,shape,size,surface,texture,type,value,{,}
420	wfo-0001030872	success	166	136	88	78	48	0.53	.5,0.5,0.8-1,1-1.2,1-1.5,1.2-1.5,1.5-2,1.5-5,12-18,2-5,4-6,4-6-flowered,5-6,5.5-7,6-12.5,acuminate,acute,anther,apex,area,bark,base,berry,black,brown,calyx,closed,cm,completely,corolla,dark,darker,deflexed,dia,ellipsoid-ovoid,elliptic,erect,exserted,filament,fleshy,fruiting,glabrate,glabrous,globose,green,hooded,leaf,less,lobe,lobed,long,margin,minutely,mm,nearly,oblique,one,opposite,ovary,ovate,pair,papillose,pedicel,petiole,primary,puberulent,red-glandular-puberulent,reddish-glandular,rest,shaped,shining,simple,size,small,soon,stem,stigma,straight,strongly,style,tear-drop,tip,tree,treelet,tube,white,x,young	0.5-1,0.8-2,1-2,1.2-3,3-7,adaxial,age,along,anthesi,appearing,beginning,broadly,caly,center,closely,consisting,corky,crateriform,cucullate,deltoid,densely,difoliate,dry,eaf,edicel,eed,free,full,geminat,incurved,inflorescenc,known,large,lenticel,lenticellate,like,live,lon,lower,major,material,middle,minor,nerve,nflorescence,older,overlapping,pale,paler,petal,planar,pore,poricidal,portion,prominent,proximal,raised,rather,reddish-glandular-puberulent,relative,ridge,rounded,ruit,scar,shorter,side,slightly,spaced,specimen,styl,tall,tapering,thickened,ud,unit,widest,woody,ympodial	alternate,appearance,arrangement,border,branch,bud,characteristic,colour,corrugation,diameter,distal,drying,exertion,form,fruit,giving,glabrousnes,growth,height,history,inflorescence,interjected,lateral,leaflet,length,life,lobing,midpoint,na,new,number,peduncle,per,perennial,plant,prickle,pseudostipule,ray,seed,shape,surface,terminal,texture,thicknes,type,variation,vein,width
421	wfo-0001030882	success	144	128	84	60	44	0.583	.5,0.5-0.75,0.5-1,0.5-1.1,0.8-1.1,0.9-1.1,1-1.3,1-1.5,1-4,1.6-2,2,2.2-4.6,3-3.5,3/4,6.5-15.6,8-12,accrescent,acuminate,anther,apex,attenuate,bark,base,berry,calyx,capitate,cm,corolla,crenulate,deflexed,dia,difoliate,elliptic,exserted,filament,fruit,fruiting,glabrous,globose,green,lateral,leaf,lightly,lobe,main,margin,minutely,mm,narrowly,nearly,occasionally,ovary,ovoid,ovoid-reniform,pair,pale,papillose,pedicel,petiole,pitted,shaped,shrub,simple,size,slightly,small,soon,stem,stigma,style,surface,tan,tapering,tear-drop,terminal,tree,truncate,tube,unit,vein,way,white,woody,x	.1,0.75-1,0.8-2.4,2-5.4,2-6,?,anthesi,beginning,beneath,closely,conical,deltoid,differing,eaf,edicel,eed,erect,extreme,free,geminat,inflorescenc,lobed,lon,long,lower,major,middle,minor,nflorescence,older,one,opposite,overlapping,paler,papillo,peelin,planar,pore,poricidal,portion,prominent,raised,ruguse,ruit,scar,short,slender,spaced,straight,tall,thick,thickened,tip,transversely,tub,ud,widest,yellowish,ympodial,young	appearance,arrangement,border,branch,bud,characteristic,colour,corrugation,diameter,distal,drying,exertion,form,geminate,giving,glabrousnes,growth,height,history,inflorescence,interjected,leaflet,length,life,lobing,midpoint,na,new,number,peduncle,per,plant,prickle,primary,pseudostipule,ray,seed,shape,sympodial,texture,thicknes,type,variation,width
422	wfo-0001030883	invalid_json_followup	179	164	117	62	47	0.654	-3,.05,.1,.5,0.5-3,0.5-5,1-1.1,1-1.2,1-1.3,1-4,1.5-2,1.5-3.5,10-18,18-44.5,2-5,20-50-flowered,3/4,5-6,9.5-27.5,acuminate,acute,anther,apex,arching,bark,base,berry,brown,calyx,cell,clavate,cm,collapsed,corolla,dark,dia,dry,elliptic,epidermal,filament,finely,fleshy,fruit,fruiting,furcate,glabrous,glandular,globose,green,hollow,inflorescence,large,later,lateral,leaf,like,live,lobe,long,long-acuminate,massive,material,midrib,minute,minutely,mm,oblique,occasionally,older,opposite,ovary,ovate,ovoid-reniform,pair,pale,papillate,papillose,pedicel,perpendicular,petaloid,petiole,pitted,plant,pore,poricidal,puberulent,quite,reticulate,russet,seed,shaped,shrub,size,slender,soon,stem,stigma,stout,style,surface,tan,tapering,tear-drop,thick,time,tip,trichome,tube,uniseriate,upper,vein,wall,way,white,woody,x,young	1-1.5,3-3.5,3-4,accrescent,across,anthesi,apart,appearing,approximatately,becoming,branched,bu,collection,deflexed,differing,difoliate,eaf,edicel,eed,erect,evenly,free,geminat,geminate,hard,imbedded,laminar,lenticellat,less,little,living,lobed,lon,lower,main,malodorous,markedly,middle,narrowly,nflorescence,papillo,placenta,portion,present,proximal,pulp,rather,reflexed,ruit,scar,slightly,sometimes,spaced,straight,strongly,tall,triangular,two,ud,unit,widest,ympodial	'',.5-2,[,``,alternate,approximately,arrangement,branch,bud,characteristic,colour,corrugation,diameter,distal,drying,exertion,form,glabrousnes,growth,height,history,interjected,leaflet,length,life,lobing,margin,midpoint,na,new,number,peduncle,per,prickle,primary,pseudostipule,ray,shape,terminal,texture,thicknes,type,value,variation,width,{,}
423	wfo-0001030884	invalid_json_followup	218	164	124	94	40	0.569	0.4-3,0.5,0.5-1.2,0.8-1,1-1.2,1-1.5,1.5,1.5-2,1.5-2.5,10,100,2-5,4-13,4.5-5,5-30,5-6,6-25,9-11,>,abruptly,acute,along,anther,anthesi,apex,bark,basal,base,berry,broad-based,brown,c.,calyx,capitate,cm,conical,curved,dark,decurrent,densely,diameter,distal,elliptic,filament,flower,fruiting,glabrous,glandular,gray-tinged,green,greenish,growth,half,inflorescence,lateral,leaf,length,like,lobe,lobed,long,long-styled,long-triangular,margin,mature,midpoint,minute,minutely,mixture,mm,moderately,new,ovary,ovoid-reniform,pair,pale,pedicel,peduncle,per,petiole,plant,poricidal,porrect,prickle,prickly,primary,pubescent,ray,red,reddish,reflexed,rest,sagittate,sessile,shallowly,short-stalked,short-styled,shrub,simple,size,slender,sparsely,spherical,spreading,stellate,stem,stigma,strongly,style,surface,tannish,tapering,tip,treelet,trichome,tube,uniseriate,vein,way,white,wide,wing,winged,yellow	.2,.5,.7,0.3,0.3-0.5,0.9-5,1,1-3,2,4-5,5,5-merous,5.5-7,6-10,6-8,7-8,abaxial,abaxially,adaxial,adaxiall,also,alyx,andromonoeciou,apar,arme,articulated,blade,connivent,di-,differing,directed,discolorous,eaf,eed,equal,extend,extending,flowering,free,geminate,gree,herbaceous,heterostylous,infructescence,leafy,long-stalked,lower,magnification,midrib,nflorescence,node,occasionally,older,one,onto,open,orolla,oung,outlin,papillat,pore,portion,present,principal,reflexe,regularly,ruit,scar,scattered,shap,short,similar,spaced,stellate-pubescent,stiff,still,tall,tamen,time,trifoliate,unarmed,unicellular,uniformly,unit,upward,usually,vary,varying,visible,weakly,without,woody,ympodial,young	'',[,``,armed,arrangement,branch,bud,characteristic,colour,corolla,corrugation,drying,exertion,form,fruit,glabrousnes,height,history,interjected,leaflet,life,lobing,na,number,outline,papillate,perennial,pseudostipule,seed,shape,terminal,texture,thicknes,type,u00b4,value,variation,width,{,}
424	wfo-0001030899	success	146	98	64	82	34	0.438	-45,0.3-0.5,10-20,2-3,2-3.5,20-25,3-12,3-4,3-5,3.5-4,4-5,5-6.5,6.5-31,7-27,8-11,acuminate,apex,basal,base,bronze,calyx,chartaceous,cm,cordate,deeply,densely,desc,diameter,ellipsoidal,end,entire,ex,flattened,fruit,glabrous,globose,green,inside,lobe,margin,mm,mucronate,oblong,outside,ovate,ovoid,pedicel,peduncle,petiole,puberulent,pubescent,purple,shrub,simple,splotch,stigma,stripe,style,triangular,tube,unbranched,vein,x,yellow	.5-2,0.5,0.5-1,1,1-1.5,1-2,1-3,1-6,1.5-2,10-13,2,2.5-3.5,3-foliate,5-10,?,abaxially,absent,acute,adaxially,aggregate,apart,ape,articulated,axe,beyond,blade,cell,connective,connivent,coriaceous,dilated,directed,distally,eaf,eed,exceeding,exserted,extrorse,flower,glandular-puberulent,leaving,less,light,lon,long,lower,narrowly,nflorescence,nther,obconical,obtuse,orang,orolla,pedicellar,peltifor,perfect,pore,presen,puberulen,rachi,radiu,remnant,ruit,shorter,slightly,spaced,stamen,stellate,stone,strongly,tal,tem,thecae,time,tomento,ud,unit,upward,vary,white,wide,ympodial	anther,arrangement,bud,characteristic,colour,corolla,drying,exertion,filament,form,fruiting,growth,height,history,inflorescence,leaf,length,life,lobing,na,number,ovary,peltiform,per,perennial,plant,primary,seed,shape,size,stem,surface,texture,type
425	wfo-0001030902	success	159	128	73	86	55	0.459	-2,0.6-1.5,1-6,1.5-13,1.5-2.5,10-15,2,2-3,2-5,2.5-4,3-13,3.5-4,30-50,4-7,5-7,5-9,6-24,8-14,acuminate,acute,angled,apex,apiculate,base,branched,brown-pilose,calyx,cm,connivent,cordate,dark,deltate,densely,diameter,eglandular,ellipsoidal,entire,flattened,forked,fruit,glabrescent,glabrous,globose,hair,lobe,long,margin,mature,mm,narrowly,oblong,occasionally,orange,ovate,pedicel,peduncle,petiole,purple,rarely,reddish,simple,stigma,style,subcoriaceous,tip,tree,triangular,truncate,tube,unbranched,vein,x,yellow	-20,-5,0-15,1-2,1.5-,1.5-2,15-50,2.5,3-20,3-4,4,4-22,4-6,4-foliat,abaxially,absent,adaxially,aggregate,along,apart,ape,apically,articulated,axe,basal,beyond,blade,brow,cell,connective,cylindrical,dilated,directed,distally,eaf,eed,equalling,exceeding,except,exserted,fleshy,flower,glabrat,glandular,glandular-puberulen,laterally,leaving,lon,lower,nflorescence,nther,obtuse,orolla,pedicellar,perfect,pinkish,pore,presen,present,puberulence,purplish,rachi,radiu,remnant,ruit,shorter,slightly,small,somewhat,spaced,sparse,sparsely,stamen,stellate,stone,subcapitat,tal,tem,thecae,time,tomento,ud,unit,vary,wide,ympodial	anther,appearance,arrangement,bark,border,branch,bud,characteristic,colour,corolla,corrugation,distal,drying,exertion,filament,form,fruiting,giving,glabrate,glabrousnes,growth,height,history,inflorescence,interjected,lateral,leaf,leaflet,length,life,lobing,midpoint,na,new,number,ovary,per,perennial,plant,prickle,primary,pseudostipule,ray,seed,shape,size,stem,subcapitate,surface,terminal,texture,thicknes,type,variation,width
426	wfo-0001030914	success	186	130	90	96	40	0.484	0-0.25,0.5-1,0.7-1,0.8-1.3,1-1.5,1.2-1.5,1.5-2,1.5-3,2-10,2-2.5,2.5-3,3-4,3.5-17,7-10,7-8,9-35,acute,anther,apex,attenuate,bark,base,berry,bud,calyx,campanulate,capitate,cm,corolla,dark,deflexed,distal,elliptic,erect,exserted,filament,fruiting,furcate,glabrous,globose,green,inflorescence,lateral,leaf,lemon-yellow,length,lobe,lobed,main,many,margin,minutely,mm,narowly,obovate,ovary,ovoid-reniform,pair,pale,pedicel,petiole,pitted,plant,puberulent,reddish-brown,shape,shaped,shrub,simple,size,small,soon,stem,stigma,straight,style,surface,tan,tapering,tear-drop,time,tree,trichome,tube,uniseriate,vein,white,winged,x,yellow	.1,.5,/4,0.1-0.5,0.8-1,1-2,1.5-8,2.5-11,5-17,5-25-flowered,along,anthesi,beneath,blade,closely,constriction,decurrent,deltoid,densely,dia,differing,difoliate,dry,eaf,edicel,eed,ellipsoid,equal,even,evenly,flower,free,geminat,glabrate,golden,greyish-brow,individual,later,like,live,lon,long,long-styled,lower,major,middle,minor,nflorescence,occasionally,often,older,one,onto,opposite,otherwise,overlappin,papillo,papillose,planar,pore,poricidal,portion,prominent,pubescent,quite,raised,rest,ripe,rounded,ruit,scar,short-styled,slender,slightly,sometimes,spaced,sparsely,specimen,tall,thick,third,ti,tip,trunk,tub,ud,unit,usually,variable,way,weight,widest,within,woody,ympodial,young	alternate,appearance,arrangement,border,branch,characteristic,colour,corrugation,diameter,drying,exertion,form,fruit,giving,glabrousnes,growth,height,history,interjected,leaflet,life,lobing,midpoint,na,new,number,peduncle,per,perennial,prickle,primary,pseudostipule,ray,seed,terminal,texture,thicknes,type,variation,width
427	wfo-0001030918	invalid_json_followup	230	157	115	115	42	0.5	-2.3,-3.2,-40,-5,-6,-9,.5,0-25,0-4,0.2-0.4,0.25-0.45,0.3-1.5,0.5-0.7,0.6-2.5,0.7-1.2,0.7-1.7,1,1-1.5,1-1.8,1-2,1.5-2.5,1.5-5.5,2-2.5,2-25,2-7,2-8,2.8-3,3-4,abaxially,acicular,acute,anther,apex,apically,apparently,articulated,bark,base,berry,calyx,cell,chartaceous,cm,cuneate,dark,diameter,drying,dull,elliptic,erect,filament,flattened,flattened-reniform,fruit,fruiting,glabrous,green-brown,lateral,leaf,length,lobe,lobed,lobing,long,margin,mauve,midpoint,mm,moderately,narrow-deltate,obtuse,orange,orange-brown,outline,pair,pale,pedicel,peduncle,per,perpendicular,petiole,pit,poricidal,prickle,prickly,primary,purple,raised,ray,red,red-brown,reflexed,seed,shrub,simple,small,smooth,sometimes,somewhat,sparsely,spherical,stellate,stellate-pubescent,stem,style,surface,tapering,terminal,tip,trichome,tube,vein,weakly,wide,yellow	-12,-4,-4.5,.7,0-10,0-20,0-6,0.1,0.1-0.25,0.5-2,0.5-2.5,0.6,1-4,1.5-2,1/2-2/3,1/2-3/4,1/3,1/3-,1/3-1/2,1/4-1/3,2-10,2-3,2-4,2/,3-15,3-6.5,3-7,3.5-6,4-7,5-7,5-8,5-merous,5.5-7,6-8,7-10,abaxial,adaxial,alyx,ame,apar,apart,blade,branched,brow,c.,caudat,connivent,curved,deltate,densely,difoliate,discolorous,distance,eaf,elongated,elongating,equal,evenly,extending,faint,flower,free,geminat,glabrescent,green,infructescence,longer,lower,mature,maturity,midvein,mixture,nflorescence,oblong,occasionally,older,one,open,orolla,oung,pendulous,perfec,pericarp,porrect,portion,prickl,pubescent,reduced,ruit,scandent,scar,secondary,sessile,side,slender,spaced,spreading,stalk,stalked,straight,strongly,tamen,terete,tertiary,time,unit,upper,usually,vary,venation,visible,way,woody,ympodial,young	'',[,``,arrangement,branch,brown,bud,cal,caudate,characteristic,colour,corolla,corrugation,distal,exertion,form,glabrousnes,growth,height,history,inflorescence,interjected,leaflet,life,na,new,number,ovary,perennial,plant,pseudostipule,shape,size,stigma,texture,thicknes,type,value,variation,width,{,}
428	wfo-0001030943	success	167	140	110	57	30	0.659	.5,0,0.5-1,1-1.2,1-1.5,1.1,1.5-2,1.8-2.2,1/2,12-15,2-6,3,3-4,3/4,4-4.5,7-13.5,7-8,8-10,abaxial,absent,acuminate,acute,adaxial,age,anther,apex,apical,bark,basal,base,becoming,berry,bi-lobed,black,branch,branching,calyx,cm,conical,corolla,dark,decurrent,dendritic,densely,diameter,drying,echinoid,elliptic,elongate,exserted,filament,flattened,fruiting,glabrous,globose,golden,golden-yellow,growth,im,large,lateral,leaf,lenticular,minute,minutely,mm,narrowly,often,outline,ovary,overtopping,pair,pale,pedicel,per,petiole,pitted,plurifoliate,pore,poricidal,pubescent,purplish-black,reddish-brown,scattered,secondary,shoot,shrub,slit-like,small,sparsely,stem,stigma,strongly,style,surface,tapering,terminal,time,tip,tree,tree-like,trichome,tube,upper,vein,violet,way,x,yellow,yellowish-white	0.5-3,10-25,4-5,4-6,abaxially,adaxially,along,anthesi,belo,cupulate,deflexed,denser,eaf,edicel,eed,erect,ew,fide,flower,free,glabrat,horizontal,inserted,lobe,lobed,lon,long,lower,m.,main,monochasia,nflorescence,nodding,older,papillo,pearce,pericarp,planar,portion,raised,ruit,scar,showy,sleeve,slightly,somewhat,stamen,tall,thin,triangular,tub,ud,unit,wide,woody,ympodial,young	arrangement,bud,characteristic,colour,corrugation,exertion,form,fruit,glabrate,glabrousnes,height,history,inflorescence,length,life,lobing,margin,monochasial,na,new,number,papillose,peduncle,plant,primary,seed,shape,size,texture,type
429	wfo-0001030959	success	164	94	68	96	26	0.415	.8,/5,0.5-1.5,0.7-1.2,1-10,1-7,1.2-1.8,10-15,2.5-5,4-6,5-9,6-8,9-12,almost,anther,apart,apex,bark,base,brown,brown-green,cm,color,concolorous,cuneate,deltate,diameter,drying,elliptic,erect,filament,fresh,glabrous,glandular,hair,inflorescence,known,lateral,leaf,length,long-acuminate,margin,membranous,minute,mm,pair,pedicel,peduncle,petiole,prickle,prickly,primary,scar,shrub,simple,spaced,stem,straight,straw,style,subentire,surface,tapering,toward,tube,vein,way,yellow	.05,.2,0.5,1-2,1.5-2,1.5-3.5,1/5-1/10,2-4,2.5-4,2.5-4.5,4-8,5-6,5-merous,abaxially,alyx,ame,apar,apically,apparently,armed,articulated,blade,branched,c.,connivent,curved,densely,difoliate,distributed,eaf,eed,equal,evenly,flower,free,geminat,gently,glabrescent,glabrou,green-brow,know,less,like,lobe,lobed,long,long-acuminat,longer,lower,midpoint,narrow-deltate,nflorescence,numerous,older,one,open,orolla,oung,part,perfec,perpendicular,poricidal,porrect,portion,present,prickl,prominent,ray,ruit,scrambling,secondary,sessile,several,short,side,slender,sparsely,spreading,stellate,stellate-pubescent,tamen,terete,tertiary,time,tip,trichome,unarmed,unit,usually,vary,venation,visible,whole,wide,ympodial,youngest	0.2,arrangement,calyx,characteristic,colour,corolla,form,fruit,glabrousnes,green-brown,growth,height,history,life,lobing,na,new,ovary,perennial,plant,seed,shape,size,texture,type,width
430	wfo-0001030982	success	215	148	132	83	16	0.614	-2-2.5,.1,.5,0.05,0.05-0.5,0.2-3,0.5,0.5-0.9,0.5-1,1-1.5,1.5,1.5-2,2/3,3-8,4-12,6-8,abaxially,acuminate,acute,adaxially,angular,anther,apex,base,berry,broadly,brown,brownish,bud,caducous,calyx,capitate,channelled,chartaceous,ciliate,cm,conic,conical,corolla,cuneate,dark,diameter,dry,drying,ellipsoid,elliptic,enlarged,entire,exerted,external,filament,flattened-reniform,flower,form,fresh,fruit,fruiting,glabrescent,glabrous,globose,golden-green,green,growth,impressed,inconspicuously,larger,later,leaf,less,long,margin,material,maturity,minutely,mm,mostly,near,new,oblique,obovate,occasionally,olive,opposite,ovary,ovate,pair,pale,papillate,papillose,pedicel,peduncle,petiole,pitted,plant,poricidal,primary,prominent,puberulent,pubescent,reddish,reflexed,revolute,rhizomatous,sagittate,seed,shoot,simple,sinuate,size,slightly,somewhat,sparsely,stem,stigma,stripe,strongly,style,subshrub,surface,tip,transverse,trichome,tube,uniseriate,vegetative,vein,way,weakly,white,x,yellowish,young	.2,0.1,0.1-0.15,0.3-2,0.5-3,1,1-8,1.5-3,3-21,4-5,age,anisophyllous,anthesi,ape,appressed,ba,beneath,central,closely,cream,cucullate,curved,deflexed,deltate,differing,difoliate,distall,distally,distichou,eaf,edicel,eed,extension,fleshy,foliage,free,geminate,glandular,glandular-papillose,greenish,hilum,internal,isostylous,lengthening,like,live,lobe,lobed,lower,major,materia,midvein,minor,nflorescence,often,one,overlappin,packed,papillae,papillat,planar,pore,portion,projection,prominently,rest,ruit,scar,separated,sigmoidally,situated,slit,stamen,straight,testa,tetramerous,tightly,time,tub,ud,unit,veined,ympodial	abaxial,adaxial,arrangement,characteristic,colour,exertion,glabrousnes,height,history,inflorescence,length,life,lobing,shape,texture,type
431	wfo-0001030989	invalid_json_followup	177	146	98	79	48	0.554	.5,0.5-1,1-1.5,1-2,12-15,15-27.5,2-3.5,3-4,3-5.5,3-7.5,4-8,5,5.5-7.9,6-13,6-6.5,9-10,abaxially,acuminate,adaxially,anther,apex,articulated,axillary,base,berry,brownish,bud,cell,chartaceous,cm,condition,conical,connivent,corolla,covering,densely,diameter,distal,drying,filament,forked,fresh,fruit,generally,glabrous,green,green-white,greenish,half,herb,interjected,lanceolate,lateral,leaf,leaflet,light,lobe,long,margin,minute,mm,obtuse,odd-pinnate,orbicular,ovate,ovate-lanceolate,ovoid,pedicel,peduncle,petiole,plant,proximal,pubescent,ray,ripe,rotate,seed,semierect,size,sparsely,stem,stigma,style,subsessile,subtending,terminal,testal,thick,throughout,triangular,tube,unwinged,usually,violet,wall,whitish,wide,x	1-10,3-20,4-5,4-7,5-merou,ag,alyx,apart,apparently,axe,blade,capitat,ciliate,decreasing,digestion,dorsally,eaf,edge,eed,end,enzyme,erec,especially,flat,flower,folded,geminat,glabrou,gradually,hair,hair-like,homostylous,honeycomb-shaped,larger,lengthening,like,living,lower,make,mucilaginous,nflorescence,occurring,orolla,pair,pale,perfect,petiolule,plurifoliate,pore,poricidal,present,pubescen,removed,ruit,secondary,seudostipule,singly,slit,spaced,specimen,ste,stolo,subequal,symmetrical,tall,tamen,tem,thir,tip,toward,tri-,tuber,typically,unit,vary,wet,wider,yellow,ympodial	'',[,\u201chair-like\u201d,``,appearance,arrangement,bark,border,branch,calyx,capitate,characteristic,colour,corrugation,erect,exertion,form,fruiting,giving,glabrousnes,growth,height,history,inflorescence,length,life,lobing,midpoint,na,new,number,ovary,per,prickle,primary,pseudostipule,shape,surface,texture,thicknes,third,type,value,variation,vein,width,{,}
432	wfo-0001030991	success	204	135	112	92	23	0.549	.5,0,0.5,0.5-0.7,0.5-1,0.5-1.5,0.7-1.2,1-1.5,1-1.6,1-2.2,1-2.5,1-7,1.5,10-20,2.5-10,2/3,3-5-lobed,9-11,absent,acuminate,acute,along,angled,anther,anthesi,apex,apparently,appressed,ascending,attenuate,basal,base,berry,brown,calyx,capitate,cm,corolla,densely,diameter,drying,ellipsoid,ellipsoidal,elliptic,elongate,entire,exerted,filament,filiform,flattened,fruiting,furcate,fusiform,glabrous,globose,grey,growth,herb,inflorescence,lanceolate,lateral,leaf,leaf-opposed,like,lobed,margin,minutely,mm,narrowly,nearly,new,occasionally,pair,pedicel,peduncle,per,petiole,pinnatifid,pitted,primary,pubescent,red,reniform,rest,ripe,scattered,short,shrub,simple,slightly,small,sparsely,stellate,stem,stigma,strongly,style,suffrutescent,surface,terminal,trichome,tube,uniseriate,variably,vein,violet,weak,white,winged,x,yellowish,young	0.1,0.2,0.2-0.7,0.3-0.4,0.5-3.5,0.6-0.8,2-plurifoliat,2.5-3,3-,4-10,5-5.5,5-merou,<,abaxially,adaxiall,adaxially,ag,alyx,arising,ark,articulated,bulbous,cell,color,conical,connivent,different,distally,eaf,eed,enlarged,eye,flower,free,frui,glabrescen,ilament,incised,leave,lengthening,less,lobe,long-triangular,loosely,lower,midrib,minute,nflorescence,nodding,often,older,orolla,outline,packed,papillo,part,particularly,pendant,perfect,pericarp,platfor,pointing,pore,poricidal,portion,pseudoumbel,rectangular,reflexed,rootstoc,ruit,scar,shallowly,shiny,sleeve,slit,somewhat,spreading,tangled,tem,testal,thin,tightly,tip,twinin,ud,uniformly,unit,upper,vary,weight,woody,ympodial	arrangement,bark,bud,characteristic,colour,exertion,form,fruit,glabrousnes,height,history,length,life,lobing,na,number,ovary,plant,seed,shape,size,texture,type
433	wfo-0001031005	success	231	133	109	122	24	0.472	/3-1/2,0.8,0.9,1-2,1-2.5,1-3,10,2-3.2,2.3-3,2.5,2.5-4,3-10,3-6.5,5,5-7,5-8,5Â°,acuminate,acute,almost,anther,anthesi,apex,apically,attenuate,bark,base,berry,black,blue,brachyblast,branch,branched,branching,brown,calyx,capitate,chartaceous,clustered,cm,concolorous,conical,corolla,cupular,dendritic,diameter,dilated,discolorous,drying,elliptic,entire,evenly,filament,flattened,flexuous,flower,form,forming,fruit,fruiting,glabrous,greenish,lateral,leaf,length,liana,lobed,long,loop,margin,membranous,midvein,mm,oblong,obovate,occasionally,older,orange-brown,ovoid,pair,pedicel,peduncle,petiole,primary,pubescent,purple,ridged,seed,short,slender,smooth,somewhat,sparsely,spreading,stem,stigma,style,surface,terete,terminal,thick-chartaceous,tip,toward,tube,unarmed,vein,weakly,white,x	.4,.5,0-0.5,0.1,0.3-0.5,0.5-1.5,1,1-1.5,1.5-2.5,1.5-4,3-4,4-6,6-12,abaxial,abaxially,accrescent,adaxially,age,along,alyx,apar,apparently,articulated,clearly,clum,common,curved,dark,datum,deeply,delineated,deltoid,dendritic-pubescent,denser,density,detaching,developing,divided,domatia,eaf,ellipsoi,elongated,equal,extending,eye,fertilisation,fine,flat,free,immature,increasing,inside,junction,known,leave,lengthening,like,linear,lobe,longitudinally,lower,m.,main,minute,much,naked,network,nflorescence,nther,obscure,occasional,often,onl,orolla,ou,outside,ovate,pendulous,perfec,pericarp,plurifoliat,pointed,pore,poricidal,portion,prominent,protruding,rachi,raised,ray,region,rest,ruit,scar,secondary,side,simple,smaller,smoot,sometimes,soon,spread,standing,strongly,stump,surrounding,tangling,tearing,tertiary,thin,trichome,ud,uneven,unit,usually,vary,venation,visible,well-developed,wide,ympodial,young	arrangement,bud,characteristic,colour,corrugation,ellipsoid,exertion,glabrousnes,growth,height,history,inflorescence,life,lobing,na,new,number,ovary,per,plant,shape,size,texture,type
434	wfo-0001031007	success	207	172	146	61	26	0.705	.5,0.2,0.5-1,0.75-1.5,1,1-1.2,1-1.5,1-3.5,1.2-1.5,1.3-,1.6-2,1.9-3,1/3,11-14,15,2.5-,2.5-5,3-4,4-6,4-7,5-12,5.5-6,50-100,6,7-10,8-10,<,abruptly,acute,almost,anther,anthesi,apex,apparently,articulated,base,becoming,beginning,berry,bifid,black,branched,broad,brown,calyx,campanulate,capitate,cell,chartaceous,cm,completely,connivent,corolla,cuneate,cup-shaped,dark,dendritic,diameter,dilated,drying,dull,ellipsoid,elliptic,entire,exserted,filament,flattened-reniform,fleshy,flower,fruit,fruiting,glabrous,globose,growth,herbarium,impressed,inflorescence,intramarginal,lax,leaving,lengthening,lilac,long,looping,loose,loosely,many,margin,markedly,matte,minutely,mm,multi-celled,narrowing,narrowly,near,new,nodding,occasionally,often,outline,papillate,pedicel,peduncle,peg,per,petiole,pitted,planar,pore,poricidal,primary,prominent,pubescent,reddish,revolute,round-rectangular,sagittate,shiny,shrub,simple,sleeve,slender,slightly,slit,sparsely,specimen,stem,stigma,strongly,style,surface,tangled,terminal,testal,time,tip,trichome,tube,usually,vein,vine,way,woody,x,yellow	0.5,0.5-10,1.5-2,4.5-5,5,5-merou,abaxiall,ag,alfway,along,alyx,apar,ark,branching,broadly,c.,clustered,deltate,densely,eaf,eed,extending,free,geminat,glabrescen,glabrou,ilament,irregularly,junction,lamina,lobe,lobed,lower,m.,midvein,nflorescence,older,orolla,pale,papillat,perfect,pericarp,plurifoliate,portion,rat,ruit,scar,spaced,splitting,spreading,stellate,stellate-pentagonal,stout,thin,tiny,twining,ud,unit,upper,vary,ympodial	age,arrangement,bark,branch,bud,characteristic,colour,corrugation,exertion,form,glabrousnes,height,history,leaf,length,life,lobing,na,number,ovary,plant,seed,shape,size,texture,type
435	wfo-0001031007	invalid_json_followup	206	159	117	89	42	0.568	0.2,0.75-1.5,1,1-1.5,1-3.5,1.2-1.5,1.3-,1.6-2,1.9-3,1/3,11-14,15,2.5-,2.5-5,3-4,4-6,4.5-5,5,5-12,5.5-6,6,7-10,<,acute,alfway,almost,anther,anthesi,apex,bark,base,becoming,beginning,berry,bifid,black,branched,broad,brown,c.,calyx,capitate,chartaceous,cm,completely,corolla,cuneate,cup-shaped,dark,dendritic,diameter,drying,ellipsoid,elliptic,entire,exserted,filament,flattened,fleshy,fruit,fruiting,glabrous,globose,growth,inflorescence,intramarginal,lax,lilac,lobe,lobed,long,looping,loose,many,margin,minutely,mm,narrowly,near,new,occasionally,pedicel,peduncle,per,petiole,pitted,poricidal,primary,prominent,pubescent,reddish,reniform,revolute,sagittate,shiny,shrub,simple,slender,sparsely,stem,stigma,strongly,style,surface,tall,tangled,terminal,time,tip,trichome,tube,usually,vein,vine,way,wide,woody	.5,0.5,0.5-1,0.5-10,1-1.2,1.5-2,4-7,5-merou,50-100,8-10,abaxially,abruptly,adaxial,ag,along,alyx,apar,apparently,articulated,branching,broadly,campanulate,cell,clustered,deltate,densely,dilated,dull,eaf,eed,extending,flower,free,glabrescen,glabrou,herbarium,ilament,impressed,irregularly,junction,lamina,leaving,lengthening,lower,m.,markedly,matte,midvein,multi-celled,narrowing,nflorescence,nodding,often,older,orolla,outline,pale,papillat,papillate,peg,perfect,pericarp,planar,plurifoliat,pore,portion,rat,round-rectangular,ruit,scar,sleeve,slightly,slit,spaced,specimen,splitting,spreading,stellate,stellate-rotate,stout,testal,thin,tiny,twinin,ud,unit,upper,vary,ympodial	'',[,``,arrangement,branch,bud,characteristic,colour,corrugation,distal,exertion,form,glabrousnes,height,history,interjected,lateral,leaf,leaflet,length,life,lobing,midpoint,na,number,ovary,pal,plant,prickle,pseudostipule,ray,seed,shape,size,texture,thicknes,type,value,variation,width,{,}
436	wfo-0001031036	invalid_json_followup	150	150	101	49	49	0.673	.2,.25,.5,0.8-1,0.8-1.2,1-1.3,1-2.5,1.2-1.5,1.5-3,10-20-flowered,12-15,2-2.5,3-4,4.5-6.5,5-6,7-8,abaxially,acuminate,acute,adaxially,along,angle,anther,apex,axil,base,becoming,berry,bi-lobed,broadly,brown,calyx,cm,conical,corolla,crisped,dark,decurrent,dia,difoliate,dry,drying,ellipsoid,elliptic,exserted,filament,filiform,flattened-reniform,fruiting,glabrous,globose,green,greenish-white,lateral,leaf,lobed,long,main,margin,material,minutely,mm,nearly,oblique,older,onto,opposite,ovary,pair,papillose,pedicel,petiole,pitted,pointed,poricidal,sagittate,shiny,short,shrub,simple,size,slightly,soon,stem,stigma,strongly,style,surface,tapering,thickened,tip,trichome,tube,uniseriate,unit,usually,vein,white,winged,x,yellowish	0.5-1,2.2-3.7,3-5,3.5-5.5,anthesi,arising,ba,closely,deflexed,differing,eaf,edicel,eed,enlarged,erect,fleshy,free,fresh,geminat,knob-like,lamina,lobe,lon,lower,major,middle,minor,nflorescence,overlappin,papillo,perhaps,planar,pore,portion,rounded,ruit,scar,shaped,sinus,spaced,spathulate,tall,tear-drop,tub,ud,widest,woody,ympodial,young	'',[,``,arrangement,bark,branch,bud,characteristic,colour,corrugation,diameter,distal,exertion,form,fruit,geminate,glabrousnes,growth,height,history,inflorescence,interjected,leaflet,length,life,lobing,midpoint,na,new,number,peduncle,per,plant,prickle,primary,pseudostipule,ray,seed,shape,sympodial,terminal,texture,thicknes,type,value,variation,width,{,}
437	wfo-0001031064	success	179	132	91	88	41	0.508	.0-2.5,0,0.5-0.7,1-1.2,1-2,1-3,1.2,10-12,10-17,2.5-3,3,3-7,3.5-4,5-6,6-16,7-16,abaxially,acuminate,anther,apex,arising,attenuate,axil,base,berry,bright,calyx,cm,completely,conical,corolla,densely,diameter,distal,elongate,filament,fleshy,fruit,fruiting,glabrous,globose,green,half,inflorescence,lateral,leaf,leaflet,lightly,lobe,lobed,lower,margin,minute,minutely,mm,nearly,nodding,obovate,occasionally,ovary,ovate,ovoid-reniform,pedicel,per,petiole,pinnate,poricidal,pubescent,purple,rachi,rugose,scattered,short-pubescent,shrub,simple,single,somewhat,sparsely,stem,stigma,style,surface,terminal,tip,translucent,trichome,tube,uniseriate,vein,white,x	.05,.5,.5-1,0-15,0.5,0.5-0.8,1,1.5-2,1.7-4.2,10-12.5,2,3-5.5,4-5-celled,5-10.5,8-10-celled,acroscopic,adaxially,along,anthesi,anticlinal,basal,bearing,blade,broader,cell,clavat,commentary,conspicuous,dark,deltate,denser,dr.,eaf,edicel,eed,epidermal,erec,exserted,flower,free,highly,irregular,irregularly,lamina,leave,lenticel,like,lon,long,lost,narrower,near,nflorescence,node,often,open,pair,papillate,petiolule,planar,portion,projection,prominent,pubescen,ruit,scar,see,side,sinuous,sinus,slender,smaller,splitting,strongly,swollen,tal,tem,thickening,time,tub,ud,unifoliat,unit,usually,wand-like,winged,without,ympodial	appearance,arrangement,bark,border,branch,bud,characteristic,clavate,colour,corrugation,drying,exertion,form,giving,glabrousnes,growth,height,history,interjected,length,life,lobing,midpoint,na,new,number,peduncle,perennial,plant,prickle,primary,pseudostipule,ray,seed,shape,size,texture,thicknes,type,variation,width
438	wfo-0001031071	success	186	133	92	94	41	0.495	0-10,0.2-0.8,1-1.5,1-2,1.5-2.2,2-8,2.1-3,2.4-3.4,3-10,3.8-5.4,4-6,5-9.4,5.7-8.8,6-8,7-16.5,8-28,abaxially,acute,adaxially,anther,apex,axillary,base,berry,blue,brownish,bud,clavate,cm,color,condition,coriaceous,corolla,dark,deep,diameter,distal,drying,elliptic,filament,forked,fresh,fruit,generally,glabrous,globose,green,green-white,greenish,half,herb,interjected,lanceolate,lateral,leaf,leaflet,lilac,lobe,long,medium,mm,mucilaginous,narrowly,odd-pinnate,ovate,ovoid,pedicel,peduncle,petiole,petiolulate,plant,purple,round,seed,sessile,short,size,spot,star,stigma,style,subtending,terminal,throughout,tube,typically,usually,wet,white,whitish,winged,x	0.4-2,1-3,1-7,2-3,2-5,3-5,3-6,4-25,5-merou,7-8,abaxiall,acumen,ag,along,alyx,apart,apparently,arranged,articulated,asymmetric,attenuate,axe,basiscopic,bead,blade,capitat,cell,connivent,covering,decreasing,digestion,dorsally,eaf,edge,eed,enzyme,erec,exceeding,flat,flower,folded,geminat,glabrou,hair-like,homostylous,honeycomb-shaped,lengthening,like,living,lower,make,middl,moniliform,mottled,multiple,necklace,nflorescence,orbicular,orolla,pair,pentagonal,perfect,plurifoliate,pore,poricidal,removed,ripe,rotate,ruit,seudostipule,side,slightly,slit,spaced,specimen,stamen,stolon,straight,subequal,tall,tamen,tem,testal,thick,tip,tissue,toward,tri-,tuber,unit,vary,wall,yellow,ympodial	appearance,arrangement,bark,border,branch,calyx,capitate,characteristic,colour,corrugation,exertion,form,giving,glabrousnes,growth,height,history,inflorescence,length,life,lobing,margin,midpoint,na,new,number,ovary,per,prickle,primary,pseudostipule,ray,shape,stem,surface,texture,thicknes,type,variation,vein,width
439	wfo-0001031097	success	174	130	85	89	45	0.489	0.45,1,1-4,1-4.5,1.6-5.5,1.8-2.5,1.8-2.6,13-30,2-3.3,3-5,3.5-6,3.7-8.4,4-6,5-11,5-9,8-11,9-21,abaxial,abaxially,acuminate,acute,adaxially,along,apex,articulate,base,branched,calyx,cm,corolla,cuneate,cyme,darker,deep,diameter,dichasial,dichasially,distal,dotted,ebracteate,edge,elliptical,filament,green,green-white,herbaceous,interjected,lateral,leaf,leaflet,light,lighter,lobe,long,margin,medium,mm,monochasial,mottled,narrow,oblique,obovate,odd-pinnate,ovate,ovoid,pedicel,peduncle,perennial,petiole,plant,puberulent,pubescent,purple,rarely,seed,side,size,stigma,strigose,style,terminal,throughout,violet,violet-blue,wide	0.5,1-3,1.5,2-3,2-4,3-6-foliat,4-7,5-12,acumen,apical,apically,cell,connate,covering,decurrent,dehiscent,digestion,diminishing,dorsally,eaf,eed,emoval,enzyme,exceeding,flat,flower,folded,forked,frequently,generally,globo,gree,hair-like,half,highly,honeycomb,interpetalar,introrse,living,lon,lower,lunat,make,maturing,mucilaginous,nflorescence,noticeably,nther,often,orolla,pair,pattern,pentagonal,perfect,petal,petiolulate,petiolule,plan,poricidally,proximal,rachi,rapidly,reveal,rotate,ruit,sessile,seudostipule,short,slit,sometimes,specimen,stamen,straight,tal,tem,testal,thick,tissu,toward,tuber-bearing,typically,unit,vary,vbase,wall,without,yellow,ympodial,Â¼	2,anther,appearance,arrangement,bark,border,branch,bud,characteristic,colour,corrugation,drying,exertion,form,fruit,giving,glabrousnes,globose,growth,height,history,inflorescence,length,life,lobing,midpoint,na,new,number,ovary,per,prickle,primary,pseudostipule,ray,shape,stem,surface,texture,thicknes,tube,type,variation,vein,width
440	wfo-0001031101	success	197	145	117	80	28	0.594	-1,-16,-5,-8,/2,0.3-0.5,0.5-0.8,0.5-3,0.6-0.8,0.8-,1-,1-2,1-2.3,1.3-2,1.3-2.5,1.4-1.7,1/4-1/2,2-2.8,2-5,2-6,2.5-,2.5-3.5,2.5-3.8,3-15,4-10,4-7,5-6,abaxially,acuminate,almost,anther,apex,apical,apically,apparently,articulated,bark,base,berry,branched,bright,calyx,cm,concolorous,deltate,diameter,drying,dull,entire,erect,evenly,filament,filiform,flattened-reniform,fruiting,glabrescent,glabrous,glandular,green,green-brown,hair,lateral,leaf,length,lobed,long,long-acute,margin,maturity,mauve,membranous,minute,mm,moderately,narrow-deltate,near,obtuse,often,orange-brown,orange-red,ovate,pair,pale,pedicel,peduncle,petiole,poricidal,primary,red,resembling,rounded,shrub,simple,sparsely,spherical,spreading,stellate,stellate-pubescent,stem,straight,style,surface,tapering,terete,terminal,tip,trichome,tube,umbel,unarmed,vein,way,white,wide,yellow,yellow-green,young	-20,-30,/2-equal,0.05-0.2,0.1-0.2,0.1-0.3,0.7-0.8,1-3,1.5-3,1/3-1/2,10-30,2-4,3-10,3-8,3.5-4.5,4-5-merous,4.5-9,5-20,6-10,8-15,abaxial,adaxial,alyx,ame,apar,ba,blade,c.,connivent,difoliate,eaf,eed,elongating,equal,flower,free,frui,geminat,herbaceous,infructescence,lobe,long-acuminat,longer,lower,mature,midpoint,multangulate,nflorescence,older,one,open,orolla,oung,pendulous,per,perfec,pericarp,porrect,portion,ray,red-brow,ruit,scandent,scar,sessile,smooth,spaced,stalk,stalked,stellate-pubescen,tamen,tertiary,time,unarme,unit,variously,vary,venation,visible,ympodial	arrangement,branch,characteristic,colour,corolla,exertion,form,fruit,glabrousnes,growth,height,history,inflorescence,life,lobing,long-acuminate,na,new,ovary,perennial,plant,red-brown,seed,shape,size,stigma,texture,type
441	wfo-0001031114	success	208	155	118	90	37	0.567	.2,.5,0-0.3,0.5,0.5-1,0.7-1.5,0.8-1.2,1-10,1-2,1-7,2-17,2-3,2-4,2-7,2.5-3,2/3,25-50,3-10,3-4,3-5,4-10,4-8,4.5-6,5-10,5-8,6-7,abaxially,acuminate,acute,adaxially,anther,apex,base,becoming,berry,branched,brown,calyx,chartaceous,cm,connivent,cylindrical,dark,deltate,densely,diameter,distal,echinoid,elliptic-ovate,entire,erect,especially,filament,first,flattened,fleshy,flower,fruit,glabrous,globose,green,hair,impressed,leaf,leaf-opposed,light,lobe,long,margin,midpoint,mm,multangulate,nodding,oblong,obtuse,outline,ovate,pedicel,peduncle,petiole,porrect,prominent,pubescent,purple,ray,reniform,ripe,rounded,rugulose,short,shrub,simple,small,sparsely,stellate,stellate-pubescent,stem,stigma,straight,strongly,style,subcoriaceous,subcuneate,surface,thickened,tip,toward,tree,triangular,truncate,tube,vein,white,white-pubescent,white-stellate,x,yellow,yellowish	.1,0.3-0.5,1-1.5,1-4.5,1-8,1.5-2.5,1.5-4,10-15,3-7,4-5,5-merou,7-15,absen,accrescent,adaxiall,ag,alyx,apart,apparently,articulated,axe,ba,blade,capitat,covering,differentiated,directed,discolorous,distally,dried,eaf,eed,equal,free,frui,fruiting,geminate,highly,homostylous,interpetalar,introrsely,juic,lacking,large,like,long-stalked,longitudinal,lower,major,membanaceous,minor,nearly,nflorescence,often,one,opening,orolla,paired,part,perfect,pericarp,plurifoliate,pore,rachi,ruit,sessile,short-,short-stalked,side,slightly,slit,somewhat,spaced,stalk,ste,subcucullate,subtending,tall,tamen,tem,thin,time,tissue,unarme,unit,vary,whitish,wide,without,ympodial	appearance,arrangement,border,capitate,characteristic,colour,corolla,form,giving,growth,height,history,inflorescence,interjected,lateral,leaflet,length,life,lobing,na,number,ovary,per,perennial,plant,prickle,primary,pseudostipule,seed,shape,size,terminal,texture,thicknes,type,variation,width
442	wfo-0001031116	invalid_json_followup	191	171	129	62	42	0.675	-10,.5,.8,/4,0,0.05-0.15,0.3-0.5,0.7-0.9,0.7-1,1-5,1/2,2-5,2.7-3.2,3.5-4,30-100,4-10,4-7,5,8-11,9-13,abaxial,abaxially,acuminate,adaxial,almost,ame,anther,apex,apically,apparently,articulated,attenuate,bark,base,berry,branching,bristle,broad-deltate,c.,calyx,caudate,cm,collapsed,connivent,densely,diameter,discolorous,drying,dull,elliptic,epidermi,erect,evenly,filament,flat,flattened-reniform,flower,fragile,fruit,fruiting,glabrescent,glabrous,glaucous-green,green,lateral,leaf,length,lobe,long,lower,margin,maturity,mauve,membranous,midpoint,mm,moderately,multangulate,narrow-deltate,obovate,obtuse,often,orange-brown,orange-red,pair,pedicel,peduncle,per,petiole,poricidal,primary,ray,recurved,red-brown,reflexed,rounded,secondary,sessile,sharply,shortly,shrub,simple,slender,small,soft,sometimes,sparsely,spherical,stalked,stellate,stellate-pubescent,stem,straight,style,subentire,surface,tapering,tip,tree,trichome,tube,unarmed,upper,vein,way,weakly,wide,yellow,young	.2,0.1,0.4-0.7,1,1/3-2/,1/6-1/4,10-14,15-25,30-50,5-15,5-merous,alyx,apar,apart,arachnoid,blade,brow,clearly,dirty-white,eaf,eed,elongated,elongating,equal,flexuous,free,hair,infructescence,less,lobed,longer,mature,minute,nflorescence,obtu,older,one,open,orolla,oung,perfec,pericarp,perpendicular,plurifoliat,portion,ruit,scar,single,smooth,spaced,stalk,tamen,terete,tertiary,time,unarme,unit,vary,venation,visible,woody,ympodial	'',1/3-2/3,[,``,arrangement,branch,brown,character,characteristic,colour,corolla,distal,exertion,form,glabrousnes,growth,height,history,inflorescence,leaflet,life,lobing,na,new,number,ovary,perennial,plant,prickle,pseudostipule,seed,shape,size,terminal,texture,thicknes,type,value,variation,width,{,}
443	wfo-0001031128	success	213	138	111	102	27	0.521	/4,0.3-0.8,0.5-0.7,0.5-0.8,0.6-1,0.8-1.7,1-1.6,1.2-2,1.5-3,2-9.5,3-4,3.5-4.5,4-7,5-19,8-12,8-23,almost,anther,apex,apparently,articulated,bark,base,berry,branched,bristle,brown,calyx,cm,concolorous,connivent,cuneate,densely,diameter,drying,dull,elliptic,entire,erect,evenly,filament,filiform,flattened-reniform,fruit,fruiting,glabrescent,glabrous,glandular,green,hair,inflorescence,lateral,leaf,length,lobed,long,long-acuminate,lower,margin,maturity,mauve,membranous,minute,mm,moderately,multangulate,narrow-deltate,near,orange-brown,pair,pale,pedicel,peduncle,petiole,poricidal,primary,purple-black,recurved,red,red-brown,reflexed,sessile,shallowly,short-attenuate,shrub,simple,soft,spherical,spreading,stalked,stellate,stellate-pubescent,stem,straight,style,surface,tapering,terminal,tip,trichome,tube,unarmed,undulate,variously,vein,way,white,wide,yellow,yellow-green,young	-10,-100,-4.5,-6.5,0,0-30,0.05-0.2,0.05-0.25,0.2,0.2-0.4,0.5-1.5,0.5-5,1,1-,1.5-3.5,1/,1/6-1/3,10-20,10-35,2-5,2.3-,2.5-10,2.5-3.5,20-50,20-60,4-5-merous,5-,5-15,5-30,abaxial,abaxially,acute,alyx,apar,apart,ape,apically,blade,branching,deltate,eaf,eed,elongated,elongating,equal,eye,flexuous,flower,free,gland,gra,infructescence,less,lobe,lon,long-acuminat,longer,mature,midpoint,multangualte,naked,nflorescence,occasionally,often,older,one,open,orolla,oung,per,perfect,pericarp,perpendicular,plurifoliat,portion,ray,reduced,ruit,scar,secondary,short-styled,side,single,smooth,spaced,stalk,staminate,tamen,terete,tertiary,time,unarme,unit,usually,vary,venation,visible,weakly,whitish,woody,yellow-brown,ympodial	0-10,1-6.5,1/3,20-60-100,arrangement,branch,characteristic,colour,corolla,exertion,form,glabrousnes,gray,growth,height,history,life,lobing,new,ovary,perennial,plant,seed,shape,size,texture,type
444	wfo-0001031135	invalid_json_followup	189	153	98	91	55	0.519	0-2,0.7-2,1-1.5,1-10,1-3,1.5-2,1.5-3,10-20,2,2-,2-2.5,2-23,2-3.5,2-4,2.5-28,3-4,3.5-12,5-30,5-9-pinnate,abaxially,acuminate,acute,adaxially,adpressed,also,apex,basal,base,beyond,calyx,cm,compound,cordate,cuneate,cylindrical,darker,deflexed,deltate,densely,diameter,ellipsoidal,entire,exserted,fading,flattened,flower,frequently,fruit,fusiform,green,hair,lateral,leaf,leaflet,light,lobe,lobed,long,longitudinal,margin,mm,moderately,obconical,oblong,obtuse,often,ovoid,pedicel,peduncle,peltiform,petiole,pilose,pink,pinnately,pinnatifid,puberulent,pubescent,purple,ripe,shrub,simple,sparsely,stamen,stigma,stripe,style,tip,tree,triangular,truncate,tube,unbranched,unlobed,white,whitish,x,yellow-green,yellowish	-7,0.5-2,1-,1-2.5,1-4,1.5-9,2-3,2-5,3-10,3-5,4-5,4-foliat,5-11,7-15,absent,aggregate,along,apart,ape,articulated,axe,basiscopically,biglandula,blade,broad,campanulate,cell,chartaceous,color,connective,coriaceous,decurrent,dilated,directed,distally,eaf,eed,eglandular-pubescent,ellipsoida,elliptic,equal,especially,exceeding,glabrous,glandular-,interstitial,irregularly,laterally,leaving,lon,lower,midrib,narrowed,nflorescence,nther,oblique,occasionally,orolla,ovate,papillose,pedicellar,perfect,pilo,pore,present,rachi,radiu,remnant,ruit,shorter,slightly,small,smaller,spaced,stone,strongly,subcoriaceous,tal,tem,thecae,time,tomento,toward,ud,unit,unknow,upper,vary,violet,wide,ympodial	'',[,``,anther,arrangement,bark,biglandular,branch,bud,characteristic,colour,corolla,corrugation,distal,drying,exertion,filament,form,fruiting,glabrousnes,growth,height,history,inflorescence,interjected,length,life,lobing,midpoint,na,new,number,ovary,per,perennial,plant,prickle,primary,pseudostipule,ray,seed,shape,size,stem,surface,terminal,texture,thicknes,type,value,variation,vein,width,{,}
445	wfo-0001031144	success	231	165	143	88	22	0.619	-11,-13,.2,.5,0.2,0.8-1.4,1-,1-4,1.1-2.5,100,2,2-,2-3,2-9,2.5-3,2/3,25,3-7,3.5-10,4,4-20,4-4.5,4-6,5,6,7-10,<,acuminate,acute,adaxially,anther,anthesi,apex,apiculae,articulated,asymmetric,axi,base,basiscopically,berry,branch,bright,broadly,brown,calyx,capitate,cm,commonly,connivent,cordate,corolla,diameter,divaricate,drying,ellipsoid,elliptic,entire,exserted,filament,flattened,flattened-reniform,flower,form,fruiting,glabrous,globose,groove,growth,inflated,inflorescence,later,lateral,leaf,leaflet,leaving,less,like,lobe,lobed,long,loosely,many,margin,mere,minute,minutely,mm,new,number,oblique,occasionally,often,open,outline,pair,pale,pedicel,peduncle,peg,per,petiole,pinnately,pinnatifid,pitted,primary,pubescent,red,reddish,rim,ripe,seed,shiny,simple,sleeve,slightly,small,smaller,sparsely,stem,stigma,strongly,style,surface,tan,terete,terminal,tiny,triangular,trichome,truncate,tube,uniseriate,upper,usually,vein,vine,violet,way,white,woody,x,yellowish,Â½	0.5,1-1.5,2-6,3-4.5,5-9,5-merou,ag,alyx,apart,apicula,appearing,ark,around,away,basal,blac,branche,brow,cell,closer,corresponding,cupped,curved,densely,eaf,eed,elongate,elongating,extending,four,free,geminat,ilament,irregularly,lamina,larger,lengthening,longer,longest,lower,markedly,membranous,near,nflorescence,older,one,orolla,papillo,pendant,pentagonal,perfect,pericarp,plurifoliate,pore,poricidal,portion,progress,quite,ruit,scar,slit,sometimes,spaced,spreading,stellate-rotate,tangle,tem,testal,thin,third,tip,together,tuft,twinin,twining,two,ud,unequal,unit,variable,vary,wall,weight,widest,wing,wood,yellow,ympodial	arrangement,bark,bud,characteristic,colour,corrugation,exertion,fruit,glabrousnes,height,history,length,life,lobing,na,ovary,papillose,plant,shape,size,texture,type
446	wfo-0001031152	invalid_json_followup	232	171	126	106	45	0.543	-1.5,-10,.4,0.2-0.3,0.2-1.5,1-1.5,1-3,1-6,1.1-2.2,1.2-1.8,1.4-2.6,1/2-3/4,11,13-27,2.5-7.5,2.7-3.7,4-19,4-6,4-8,9-13,abaxially,acuminate,acute,adaxially,anther,anthesi,apex,attenuate,basal,base,becoming,berry,blunt-tipped,branch,branched,brown,bud,bullate,calyx,cm,conical,continued,corolla,decurrent,deltoid,densely,diameter,due,entire,exserted,filament,fleshy,flower,fruit,fruiting,glabrous,globose,granular-tomentose,green,greenish,growth,hair,honeycombed,lanceolate,lateral,lavender,leaf,length,lilac,lobe,long,long-,margin,midvein,mm,mostly,multangulate,narrowly,nearly,oblanceolate,oblong,obtuse,openly,orbicular,ovate,pale,pedicel,peduncle,persistently,petiole,porrect-stellate,probably,pubescent,rather,ray,reddish,reniform,reticulate-punctate,ripe,scabrous,sessile,shrub,side,simple,slightly,soon,sparingly,stelliform,stem,stigma,strongly,style,suborbicular,surface,terete,terminal,thick-stalked,time,tube,unarmed,variously,vein,violet,x,yellow,yellowish	-5.5,/100-1/16,0-100,0.3-1.3,0.3-3,1.1-3,1.3-4,1.5-3,1.5-3.5,1/2-2/3,2-5,2.7-4.5,2.7-6,2.8-4,3.7-7,4-7,5-6,6.5-10,8-20,accrescent,ag,along,apart,apical-lateral,apparently,articulated,axe,axillary,ba,blade,blister,capitat,chartaceous,closely,dehiscing,directed,eaf,earl,eed,evident,extend,few-rayed,free,glabrescen,high,inserted,introrse,lackin,large,less,lobed,longer,longitudinal,lower,m.,main,mixed,moderately,multangulat,nflorescence,occasionally,one,open,orolla,partly,perfect,pitted,plurifoliate,pore,rachi,reddish-brown,relatively,rotate-stellate,ruit,runk,short-,short-stalked,slit,somewhat,spaced,sparsely,splitting,stamen,stellate-pubescent,stipitate-glandular,stout-stalked,suture,swelling,tamen,testa,thick,thin,thin-,thin-stalked,tomentose,touching,toward,tree,unarme,unit,usually,vary,way,wide,ympodial,young	'',[,``,arrangement,bark,capitate,cayx,character,characteristic,colour,corrugation,distal,drying,exertion,form,glabrousnes,height,history,inflorescence,interjected,leaflet,life,lobing,midpoint,na,new,number,ovary,per,perennial,plant,prickle,primary,pseudostipule,seed,shape,size,texture,thicknes,type,value,variation,width,{,}
447	wfo-0001031202	invalid_json_followup	198	156	113	85	43	0.571	0-0.5,0-1,0.5-1,0.6-1.1,0.8-1,1-1.5,1-1.7,1.5-2,1.5-2.5,15-40,2-3,2-8,2.5-4,2/3,3.5-4,6-25,9-11,9-20,accrescent,acute,along,anther,apex,bark,base,beneath,berry,broadly,bud,calyx,capitate,cm,completely,cordate,corolla,cup-shaped,decurrent,deflexed,densely,dia,distal,enclosed,erect,exserted,filament,fleshy,fruit,fruiting,glabrate,glabrous,globose,golden,green,inflorescence,later,lateral,leaf,lobe,lobed,main,margin,minute,minutely,mm,obovate,occasional,occasionally,opposite,ovary,overtopping,ovoid-reniform,pair,pale,papillose,pedicel,petiole,pitted,plant,puberulent,pubescent,quite,reddish-brown,scattered,sessile,shape,shaped,shoot,shrub,size,slightly,small,stem,stigma,straight,style,surface,tan,tear-drop,terminal,thicker,tip,tree,trichome,tube,uniseriate,variable,vein,way,white,winged,woody,x,young	.1,.5,0.1-0.3,0.5,1-5,1.5-9,2.5-13,2.5-3.5,20-100-flowered,abrupt,anthesi,apart,apiculate,axi,complex,condition,corky,deltoid,differing,difoliate,dry,due,eaf,edicel,eed,extremely,flower,free,frui,furcate,geminat,greenish-white,greyi,hard,irregularly,large,like,live,lon,long,long-ellipsoid,long-styled,longer,lower,major,many,material,middle,minor,narrowing,nflorescence,often,older,one,orbicular,paler,papillo,planar,pore,poricidal,portion,prominent,raised,rounded,ruit,scar,short-styled,slender,spaced,sparsely,specimen,tall,tapering,thick,thickened,third,time,tub,ud,unit,usually,weight,whitish,widest,ympodial	'',[,``,alternate,arrangement,branch,characteristic,colour,corrugation,diameter,drying,exertion,form,glabrousnes,greyish,growth,height,history,interjected,leaflet,length,life,lobing,midpoint,na,new,number,peduncle,per,perennial,prickle,primary,pseudostipule,ray,seed,texture,thicknes,type,value,variation,width,{,}
448	wfo-0001031207	invalid_json_followup	219	166	123	96	43	0.562	-11,-4,-7,-8,/5,0,0-20,0.1-0.5,0.25-0.5,0.3-0.5,0.5-1,0.6-0.9,0.6-1.2,0.7-2,0.85-1.4,0.9-1.6,1,1.4-2,1.5-5,1/4-1/3,2.1-2.3,2.8-3,3-5,5-8,6-8,anther,apart,apex,apparently,articulated,bark,base,berry,bristly,calyx,cell,chartaceous,cm,concolorous,cordate,curved,dark,densely,diameter,discolorous,drying,dull,erect,evenly,filament,flattened-reniform,fruit,fruiting,gently,glabrous,gray,green,herb,lateral,leaf,length,less,lobed,long,lower,margin,maturity,mauve,midpoint,mm,moderately,narrow-deltate,oblong,obtuse,orange-brown,outline,ovate,pair,pale,pedicel,peduncle,per,petiole,pit,poricidal,prickle,prickly,primary,raised,ray,red,reflexed,scandent,shrub,simple,small,smooth,sometimes,spaced,spherical,spreading,stellate,stellate-pubescent,stem,straight,style,subentire,surface,tapering,terminal,tip,tube,upper,usually,vein,visible,way,weakly,white,wide,yellow,yellow-green,young	-0.4,-1/2,-5,.1,0-0.5,0-10,0.1-0.2,0.1-0.3,0.2,0.2-0.3,0.8,1-3,1-4,1-5,1/,1/3,1/3-equal,2-3,2-4,2.5-,3.5-7,5-merous,6.5-8,9,abaxially,acuminat,acute,alyx,ame,apar,apically,blade,branched,bristle,broad-deltate,brow,c.,difoliate,distance,eaf,eed,elongated,elongating,equal,extending,eye,filiform,flower,free,geminat,glabrescent,herbaceous,infructescence,lanceolate,like,lobe,longer,mature,midvein,multangulate,naked,nflorescence,occasionally,older,one,open,orolla,oung,pendulous,perfec,pericarp,perpendicular,persistent,porrect,portion,prickl,rounded,ruit,scar,sessile,shorter,side,stalk,stalked,tamen,terete,tertiary,time,toward,trichome,unarmed,unit,variously,vary,venation,ympodial	'',1/4,2.5-5,[,``,arrangement,branch,brown,bud,characteristic,colour,corolla,corrugation,distal,exertion,form,glabrousnes,growth,height,history,inflorescence,interjected,leaflet,life,lobing,na,new,number,ovary,plant,pseudostipule,seed,shape,size,stigma,texture,thicknes,type,value,variation,width,{,}
449	wfo-0001031218	invalid_json_followup	154	157	98	56	59	0.636	0.5,0.5-1,1-2,1-4,15-25,2-22,2-3,2.5-3,3-5,4-28,4-7,4-8,40,40-100+,5-37,5.5-7,6-10,6-7,6-9,8-17,abaxially,acuminate,acute,adaxially,apex,apiculate,basal,base,beyond,branched,calyx,cm,connivent,cordate,dark,densely,diameter,directed,distally,eglandular,eglandular-pilose,ellipsoidal,entire,especially,exserted,flattened,flower,fruit,glabrous,glandular,glandular-puberulent,globose,greenish-purple,hair,introrse,lanceolate,lavender,less,lobe,long,margin,minutely,mm,moderately,mottled,narrowly,oblique,obtuse,orange,ovate,ovate-elliptic,ovoid,pedicel,peduncle,perfect,petiole,pore,puberulent,pubescent,purple,ripe,shorter,simple,slightly,sometimes,sparsely,stamen,stigma,style,succulent,tip,toward,tree,triangular,tube,violet,x,yellow	-5,1-3,10-19,2-2.5,3,3-14,4-5,4-foliat,5-7,8-20,aggregate,apart,ape,articulated,axe,blade,cell,connective,coriaceous,cylindrical,eaf,eed,equal,exceeding,glabrou,leaving,lon,lower,nflorescence,nther,orolla,papillo,pedicellar,presen,present,purpl,rachi,radiu,remnant,ruit,small,spaced,stellate,stone,subcoriaceous,tal,tem,thecae,time,tomento,truncat,ud,unit,vary,wide,ympodial	'',[,``,anther,arrangement,bark,branch,bud,characteristic,colour,corolla,corrugation,distal,drying,exertion,filament,form,fruiting,glabrousnes,growth,height,history,inflorescence,interjected,lateral,leaf,leaflet,length,life,lobing,midpoint,na,new,number,ovary,papillose,per,plant,prickle,primary,pseudostipule,ray,seed,shape,size,stem,surface,terminal,texture,thicknes,tomentose,truncate,type,value,variation,vein,width,{,}
450	wfo-0001031225	invalid_json_followup	163	155	111	52	44	0.681	.25,.5,0.2,0.2-0.75,0.7-6,0.75-1,0.8-1,1-1.5,1-1.7,1-5,2,2.5-3,3-9,3/4,5-50-flowered,5-6,6-8,7-9,9-16,acute,along,anther,anthesi,apex,bark,base,berry,broadly,bud,calyx,characteristic,cm,corolla,cup-shaped,darker,decurrent,dia,dry,ellipsoid,elliptic,exserted,filament,fruiting,furcate,glabrate,glabrous,globose,green,growth,inflorescence,lateral,leaf,less,like,lobe,lobed,long,main,margin,minute,minutely,mm,narrowly,often,older,opposite,ovary,ovate,ovoid-reniform,pair,pale,papillose,pedicel,petiole,pitted,plant,pore,poricidal,prominent,pubescent,red-papillose,reflexed,rest,shape,shaped,shrub,size,slender,slightly,small,soon,specimen,stem,stigma,straight,strongly,style,surface,tan,tapering,tear-drop,tip,tree,trichome,tube,uniseriate,vein,way,white,x,young	/3,0.1-0.75,0.5,0.5-1,1-3,1.5-5,apart,beginning,closely,conspicuous,deltoid,differentiated,differing,difoliate,eaf,edicel,eed,erect,flattene,fragrant,free,geminat,greyish-brow,inflorescenc,live,lon,lower,major,middle,minor,much,nflorescence,one,outline,papillo,portion,proximal,raised,rhomboidal,rounded,ruit,scar,spaced,sweetly,swelling,tall,ud,unevenly,unit,widest,woody,ympodial	'',[,``,alternate,arrangement,branch,colour,corrugation,diameter,distal,drying,exertion,flattened,form,fruit,glabrousnes,greyish-brown,height,history,interjected,leaflet,length,life,lobing,midpoint,na,new,number,peduncle,per,prickle,primary,pseudostipule,ray,seed,terminal,texture,thicknes,type,value,variation,width,{,}
451	wfo-0001031231	success	175	138	91	84	47	0.52	-2,.5,0.5-1.5,1-1.5,1-2,1.5-2,2-3,2.5-3,25-35,37/2,37/3,4-8,5-7,8-10,acuminate,acute,almost,anther,apex,axillary,base,berry,branch,branched,brown,calyx,campanula,cm,colour,corolla,dark,dia,discoidal,ellipsoid,elliptic,entire,equal,erect,except,filament,fork,glabrous,globose,green,greyish,hair,juvenile,lanceolate,lasting,leaf,len,less,lobe,long,loosely,marbled,margin,minute,mm,oblong,occasionally,ovary,pedicel,pedicellate,peduncle,petal,pinnatisect,plant,purple,rh,ripening,rounded,rugose-ruminate,seed,sessile,several,shrub,simple,soft,sometimes,stigma,stout,style,surface,tinged,tip,vigorous,violet,wooded,x,year	1-3,1-4,13,2-4,3-4,80-110,absent,acumen,adherent,along,anthesi,aromatic,aspect,axi,basal,becoming,beyond,blunt,bluntly,campanulate,cell,clonal,cluster,declinate,developed,eaf,eed,exceeding,exerted,expanded,facetted,fleshy,flower,flowering,folded,general,glandular,gree,habit,herbarium,interacuminal,lengthening,lon,lower,mature,mauve,midrib,nflorescence,often,pedice,pentagonal,plurifoliat,pore,poricidal,projecting,rarely,readily,recurve,ripe,rotate,ruit,shallow,shed,short,sinus,slightly,slit,small,specimen,stone,stonrgly,succulent,tissue,toward,translucent,triangular,tub,ud,unit,usually,variable,well,without,ympodial	appearance,arrangement,bark,border,bud,characteristic,corrugation,diameter,distal,exertion,form,fruit,fruiting,giving,glabrousnes,growth,height,history,inflorescence,interjected,lateral,leaflet,length,life,lobing,midpoint,na,new,number,per,petiole,plurifoliate,prickle,primary,pseudostipule,ray,shape,size,stem,terminal,texture,thicknes,tube,type,variation,vein,width
452	wfo-0001031252	success	170	137	94	76	43	0.553	0.2-1.5,0.3-1.1,1-2,1.3-1.9,1.75-5.2,16-33,2-3,2.5-7,2.8-3.6,3-10,3-6,5-17,5-8,7-18,abaxially,absent,acute,adaxially,anther,apex,attenuate,axillary,base,berry,brownish,bud,cell,clavate,cm,condition,coriaceous,corolla,covering,cuneate,dark,deep,diameter,distal,drying,elliptic,entire,filament,forked,fresh,fruit,generally,glabrous,globose,green,green-white,greenish,hair-like,half,herb,interjected,lanceolate,lateral,leaflet,light,lobe,long,make,margin,medium,mm,mucilaginous,ovate,ovoid,pedicel,peduncle,petiole,plant,purple,ripe,rounded,seed,simple,sometimes,stigma,stripe,style,subtending,terminal,testal,thick,throughout,tube,unwinged,usually,wall,wet,white,whitish,x	0.4-3,1-3,12-20,3-5,5-9,5-merou,5.5-6.5,acumen,adaxiall,ag,along,alyx,apart,apparently,arranged,articulated,axe,bead,blade,capitat,ciliate,connivent,digestion,dorsally,eaf,edge,eed,enzyme,erec,exceeding,flat,flower,folded,geminat,glabrou,hal,high,homostylous,honeycomb-shaped,lengthening,like,linear,living,lower,moniliform,mottled,multiple,necklace,nflorescence,orolla,perfect,plurifoliate,pore,poricidal,removed,rotate,ruit,serrate,seudostipule,slit,spaced,specimen,stamen,stolon,straight,tall,tamen,tem,tip,tri-,tuber,typically,unit,vary,yellow,ympodial	appearance,arrangement,bark,border,branch,calyx,capitate,characteristic,colour,corrugation,exertion,form,fruiting,giving,glabrousnes,growth,height,history,inflorescence,leaf,length,life,lobing,midpoint,na,new,number,ovary,per,prickle,primary,pseudostipule,ray,shape,size,stem,surface,texture,thicknes,type,variation,vein,width
453	wfo-0001031257	invalid_json_followup	206	174	123	83	51	0.597	-12,-22.5,-6,0,0.7-1,0.75-2.5,1-1.3,1.1-1.2,1.5-1.7,10-16,2-,2-4.5,3.5-5.7,4-10,5,5-8.5,6-celled,7.5-9,abaxially,abundant,acuminate,adaxially,anther,anthesi,antrorse,apex,ascending,attenuate,basal,base,berry,blue-violet,branch,bud,calyx,cm,coarsely,connectival,corolla,cuneate,dark,dentate,diameter,directed,dorsally,edentate,ellipsoidal,erect,filament,finely,flexuous,foliage,fruiting,glabrous,glandular,globose,half,herb,herbaceous,hollow,honey-combed,inconspicuous,lamina,lateral,leaf,length,light,like,little,lobe,long,long-stalked,longer,longitudinally,margin,midvein,mm,non-glandular,odorles,outward,ovate,pair,papillate,patent,petiole,prolongation,pubescent,purple,reduced,ridged,ring,robust,scarce,secondary,seed,serrate,short-stalked,shrub,simple,smooth,somewhat,spur-like,stem,stigma,striate,style,subglobose,thickened,tip,tooth,trans-ovoidal,trichome,tube,unequal,upward,vein,ventrifixed,verrucate,viscid,white,within,x,yellow	-5,0.4,0.5,0.5-0.8,1-1.2,1.5,1.5-2,1/10,11.5-15,3,3.5-,4-4.5,4.5-,5-,6-12,7-,8,8-celled,accrescen,ag,aggregate,bicellular,broad,campanulate,cell,coat,cotyledon,curved,cuticle,deep,densely,diamete,difoliate,eaf,eed,elliptical,embryo,endosperm,epidermal,free,geminat,hair-like,head,high,inserted,lon,longitudinal,lower,many-seeded,narrowly,opening,orolla,pericarp,pore,poricidal,portion,rarely,ree,rest,ruit,saddle-shape,scarcely,separated,shorter,single-celled,sinus,slightly,slit,small,solitary,stalk,stone,strand,tem,thecae,thickening,time,triangular,unit,vary,viscid-pubescen,wall,ympodial	'',4.5-6-12,[,``,arrangement,bark,characteristic,colour,corrugation,distal,drying,exertion,form,fruit,glabrousnes,growth,height,history,inflorescence,interjected,leaflet,life,lobing,midpoint,na,new,number,ovary,pedicel,peduncle,per,perennial,plant,prickle,primary,pseudostipule,ray,saddle-shaped,shape,size,surface,terminal,texture,thicknes,type,value,variation,viscid-pubescent,width,{,}
454	wfo-0001031270	success	234	174	154	80	20	0.658	+,0.4-1.5,0.5-1,1,1-1.2,1-4,1.2-1.6,1/3,10,10-12,100,2-2.5,2-3,2-4,2-7,2.5-3,3-10,3-20,4-5,5,5-10,5-15,5-6,6-50,7-12,>,acute,along,anther,anthesi,apex,associated,bark,base,berry,bipinnatifid,bright,brown,calyx,capitate,clavate,cm,conical,curved,deeply,densely,depressed-spherical,diameter,differentiated,directed,elliptic,entire,few-rayed,filament,flower,free,fruiting,glabrous,glandular,glandular-pubescent,green,growth,herb,inflorescence,later,lateral,leaf,leaf-opposed,length,like,live,lobe,lobed,long,long-styled,margin,membranous,midpoint,midvein,minute,minutely,mixture,mm,multangulate,multiseriate,new,obovate,often,ovoid,pair,pale,pedicel,peduncle,per,petiole,pinnatifid,pitted,plant,pore,poricidal,prickle,prickly,primary,pubescent,ray,red,reddish,reflexed,reniform,rest,ripe,rounded,scattered,sessile,shallowly,short-stalked,short-styled,shrub,simple,size,slender,slightly,small,sparsely,spherical,spreading,stalk,stellate,stem,stigma,straight,straw-colored,style,surface,tan,tapering,terete,tip,tissue,trichome,truncate,tube,uniseriate,upward,varying,vein,way,well,white,wide,wing,yellow,yellowish,Â½	.5,1-3,1.5,1.5-2,2-20,3-5,5-merous,6-17,8,9-10,abaxial,abaxially,accrescent,adaxial,adaxiall,alyx,apart,arme,articulated,basal,beginning,blade,brow,c.,cell,celled,colored,connivent,consistently,difoliate,distal,eed,ellipti,equal,erect,frui,geminat,gland,heavily,heterostylous,infructescence,investing,leafy,lon,longer,loosely,lower,narrowly,nflorescence,occasionally,older,orolla,oung,outline,papillo,pericarp,portion,rachi,ruit,scar,secondary,shallow,shining,single,sinuate,staminat,strongly,tall,tamen,testal,thin,thus,tightly,unit,usually,vary,wice,wid,woody,ympodial	arrangement,characteristic,colour,corolla,exertion,form,fruit,glabrousnes,height,history,life,lobing,na,number,ovary,papillose,seed,shape,texture,type
455	wfo-0001031283	invalid_json_followup	52	100	36	16	64	0.692	-0.25,0.1-0.15,0.4-0.5,0.5-0.7,0.7,2.2-2.8,30-40,apex,appearance,base,brown,calyx,cell,cm,diameter,erect,fruit,hair-like,lateral,lobe,long,mm,obovate,outgrowth,pale,pubescent,shrub,silky,somewhat,sprawling,surface,testa,thick,wall,wide,woody	.7-2.3,acute,eed,elongating,fide,give,lo,markedly,moore,narrowly,pleasant,small,smelling,spreadin,tall,winged	'',1.7-2.3,[,``,anther,arrangement,bark,border,branch,bud,characteristic,colour,corolla,corrugation,distal,drying,exertion,filament,form,fruiting,giving,glabrousnes,growth,height,history,inflorescence,interjected,leaf,leaflet,length,life,lobing,margin,midpoint,na,new,number,ovary,pedicel,peduncle,per,petiole,plant,prickle,primary,pseudostipule,ray,seed,shape,size,stem,stigma,style,terminal,texture,thicknes,tube,type,value,variation,vein,width,{,}
456	wfo-0001031287	invalid_json_followup	147	145	93	54	52	0.633	.5,0.5-1.5,0.9-1,1,1-1.2,1-1.3,1-1.5,1-5,1.5-2,1.5-5.5,2-2.5,3-4,4-5,4-6,4.5-5,5-14,6-10-flowered,6-7,abaxially,acute,adaxially,anther,apex,attenuate,axil,bark,base,berry,bi-lobed,branch,calyx,cm,conical,corolla,dark,dendritic,densely,dia,divergently,ellipsoid,elliptic,elongate,erect,exserted,filament,fruiting,glabrous,globose,green,greenish-white,later,lateral,leaf,lobe,lobed,long,main,margin,minutely,mm,nearly,onto,ovary,ovoid-reniform,pair,pale,pedicel,petiole,pitted,pointed,pubescent,red-papillose,reflexed,rounded,shaped,shrub,simple,somewhat,stem,stigma,strongly,style,surface,tan,tear-drop,trichome,tube,tuft,vein,white,winged,x,young	3-5,anthesi,apar,ape,bearing,connective,coriaceous,deflexed,deltate,difoliate,eaf,edicel,eed,enlarged,fleshy,free,frui,geminate,internodal,knob,lamina,lon,lower,many,membranous,middle,nflorescence,occasionally,older,papillo,papillose,planar,plurifoliate,pore,poricidal,portion,reddish-brow,ruit,scar,shoot,short,sinus,small,spaced,thick,thin,tip,tub,ud,unevenly,unit,widest,woody,ympodial	'',[,``,appearance,arrangement,bud,characteristic,colour,corrugation,diameter,distal,drying,exertion,form,fruit,giving,glabrousnes,growth,height,history,inflorescence,interjected,leaflet,length,life,lobing,midpoint,na,new,number,peduncle,per,perennial,plant,prickle,primary,pseudostipule,ray,reddish-brown,seed,shape,size,specified,terminal,texture,thicknes,type,value,variation,width,{,}
457	wfo-0001031300	invalid_json_followup	219	160	118	101	42	0.539	-2.2,-4,-5,.5,/4,0.2-0.4,0.2-0.5,0.2-1,0.3,0.5-0.9,0.5-18,0.5-2,0.6-0.8,0.6-1.2,0.7-0.9,0.7-1.2,0.8-1.5,1-2,1.2-1.7,1.5-3.5,2-3,2-4,2-5.5,2.2-2.3,2.2-2.7,2.5-3.2,3-4,5-15,acute,anther,apart,apex,apparently,articulated,attenuate,bark,base,berry,branched,brown-green,calyx,cell,chartaceous,cm,creeping,curved,deltate,densely,diameter,dull,erect,filament,filiform,flattened,flattened-reniform,fruit,fruiting,glabrous,gray-green,lateral,leaf,length,lobe,lobed,long,margin,maturity,membranous,midpoint,mm,moderately,near,oblanceolate,orange,orange-brown,orange-green,outline,pair,pale,pedicel,peduncle,per,petiole,pit,poricidal,prickle,prickly,primary,pubescent,raised,rarely,ray,red,rounded,shrub,simple,small,smooth,spaced,sparsely,spherical,stellate,stellate-pubescent,stem,style,surface,tapering,terete,tip,trichome,tube,vein,way,white,wide,yellow,yellow-green,yellow-orange	-6,0-15,0-20,0-3,0-8,0.1,0.1-0.5,0.1-0.6,0.15-0.7,0.2-0.7,0.3-0.6,0.3-1.3,0.5-1.5,0.6-1,1-4,1-5,1.3-2,1/2-3/4,1/3-1/2,1/6-1/4,10-30,2-,2-6,3-,4,4.5-6,5-merous,6-8,abaxially,absent,also,alyx,apar,apically,ba,blade,brow,bulbous,caudat,concolorous,connivent,difoliate,distance,drying,eaf,eed,elongating,equal,extending,eye,flower,free,geminat,geniculate,glabrescent,hair,herbaceous,highly,infructescence,lon,longer,lower,mature,midvein,minute,naked,nflorescence,oblong,obtuse,older,one,open,orolla,oung,pendulous,perfec,pericarp,porrect,portion,prickl,reduced,ruit,scar,sessile,side,spreading,stalk,stalked,tamen,tertiary,thin,time,uniradiate,unit,vary,venation,visible,weakly,wider,winged,ympodial	'',10-20,[,``,arrangement,branch,brown,bud,characteristic,colour,corolla,distal,exertion,form,glabrousnes,growth,height,history,inflorescence,interjected,leaflet,life,lobing,na,new,number,ovary,plant,pseudostipule,seed,shape,size,stigma,terminal,texture,thicknes,type,value,variation,width,{,}
458	wfo-0001031310	invalid_json_followup	203	161	115	88	46	0.567	.5,0-3,0.5-3,1-3,1-5.5,1-6,1.5-4,15-40,2-3,2.5-5.5,2.5-8.5,4-10,4-12,4.5-4.8,5.5-21,abaxially,absent,acuminate,adaxially,anther,apex,axillary,base,berry,blue,blue-purple,brown,brownish,bud,cell,chartaceous,cm,condition,connivent,corolla,covering,cuneate,decurrent,diameter,distal,drying,filament,flower,forked,fresh,fruit,generally,glabrous,globose,green,green-white,greenish,hair,half,herb,interjected,lanceolate,lateral,leaf,leaflet,less,light,like,lobe,make,margin,membranous,mm,mottled,mucilaginous,multicellular,narrowly,obtuse,odd-pinnate,ovate,ovate-elliptic,ovate-lanceolate,ovoid,pale,pedicel,peduncle,petiole,petiolule,pilose,plant,pubescent,purple,rosette-forming,rotate,seed,shortly,simple,size,slightly,sometimes,somewhat,sparsely,stem,stigma,streak,style,subrosette-forming,subtending,terminal,testal,thick,throughout,tube,unwinged,usually,wall,wet,white,whitish,x	0-4,1-10,1-2,3-10,5-6,5-7,5-merou,6-7,acumen,ag,along,alyx,apart,apparently,articulated,attenuate,axe,blade,borne,broadly,caly,ciliate,conspicuously,decreasing,digestion,dorsally,eaf,edge,eed,elliptic,end,enzyme,erect-decumben,especially,exceeding,extremely,flat,folded,geminat,glabrou,gradually,hair-like,high,homostylous,honeycomb-shaped,larger,lengthening,living,long,lower,midrib,minutely,nflorescence,orolla,pair,perfect,plurifoliate,pointed,pore,poricidal,puberulent,rachi,removed,ruit,seudostipule,singly,slit,small,spaced,specimen,stamen,ste,stolo,straight,subellipsoi,tall,tamen,tem,tip,tissue,toward,tri-,tuber,typically,unit,vary,yellow,ympodial	'',[,\u201chair-like\u201d,``,arrangement,bark,branch,calyx,characteristic,colour,corrugation,erect-decumbent,exertion,form,fruiting,glabrousnes,growth,height,history,inflorescence,length,life,lob,lobing,midpoint,na,new,number,ovary,per,prickle,primary,pseudostipule,ray,shape,subellipsoid,surface,texture,thicknes,type,value,variation,vein,width,{,}
459	wfo-0001031316	success	207	146	119	88	27	0.575	-2,.1,/3,0.05-0.1,0.3-1,0.4-0.8,0.5-2,0.8-1.2,0.8-1.8,0.9-1.3,1.2-2.1,1.3-3.5,1.5-2,1.5-3.5,2-20,2-3,2.5-8,3-10,3.5-3.8,3.8-5,4-7,5-10,5-6,abaxially,acuminate,acute,almost,ame,anther,apex,apically,apparently,bark,base,berry,blue-mauve,bright,c.,calyx,cm,concolorous,connivent,cream,curved,dark,densely,diameter,discolorous,drying,dull,entire,erect,filament,flattened-reniform,fruit,fruiting,glabrescent,glabrous,gray,green,held,inward,lateral,leaf,length,lobe,long,lowermost,margin,marking,maturity,membranous,midpoint,mm,moderately,multangulate,narrow-deltate,obtuse,orange,orange-brown,ovate,pair,pale,pedicel,peduncle,per,petiole,poricidal,porrect,primary,purple,ray,red-brown,sessile,shrub,simple,slender,sparsely,spherical,stellate-pubescent,stem,strongly,style,surface,tapering,terete,terminal,tip,trichome,tube,unarmed,vein,way,white,white-green,wide,yellow,yellow-green,young	0.05-0.15,0.1-0.2,0.4-0.6,0.6-1,1-5,1.5-,1.5-5,1/3-1/2,1/3-2/3,2-4,3-8,4,4-9,5-15,5-8,5-merous,6-20,8-11,8-12,8-25,abaxial,adaxial,alyx,apar,articulated,becoming,blade,branched,broad,colored,contrast,difoliate,eaf,eed,elongating,eye,fifth,flower,foliaceou,four,free,geminat,glabrou,hair,herbaceous,infructescence,lobed,long-acuminat,longer,lower,mature,minute,naked,nflorescence,older,one,open,orolla,oung,pendulous,perfec,pericarp,portion,red-brow,reflexed,ruit,scar,smooth,sometimes,spaced,spreading,stalk,stalked,stellate,stellate-pubescen,tamen,tertiary,time,unarme,unequal,unit,usually,variously,vary,venation,visible,whitish,ympodial	arrangement,branch,characteristic,colour,corolla,exertion,form,glabrousnes,growth,height,history,inflorescence,life,lobing,long-acuminate,na,new,number,ovary,perennial,plant,seed,shape,size,stigma,texture,type
460	wfo-0001031333	success	194	118	88	106	30	0.454	+,.5,1-1.5,1-4,1-5,1.2-2,1.5,1.5-1.7,1.5-2,1/2,2,2.7-7,3-4,3/4,5-7,50,7-9,>,?,acuminate,acute,anther,anthesi,apex,base,berry,bilobed,branched,broadly,brown,capitate,cm,conical,densely,diameter,ellipsoidal,elliptic,entire,exserted,filament,flattened,glabrous,globose,golden,green,greenish,growth,immature,inflorescence,many,margin,membranous,minute,minutely,mm,narrowly,new,nodding,ovate,pair,pale,pedicel,peduncle,per,petiole,pitted,primary,pubescent,reniform,simple,somewhat,sparsely,stem,stigma,strongly,style,surface,terminal,time,truncate,tube,vein,vine,way,white,woody,x,yellowish	0.1-0.5,0.5,2-3,2.5-3,30-40,5-8,5-merou,7-10,<,abaxially,adaxiall,adaxially,adjacent,ag,almost,alyx,apart,appearing,ark,articulated,branche,calyx,cell,clustered,collection,composed,crea,cupped,denser,eaf,eed,flower,free,fruting,glabrescen,glabrescent,half,high,ilament,lamina,leaving,lengthening,less,like,lobe,lobed,long,lower,m.,matte,mere,near,nflorescence,occasionally,older,orolla,outline,papillat,peg,penden,pentagonal,perfect,pericarp,planar,plurifoliat,pore,poricidal,portion,pubescent-papillate,quadrate,rest,rhachi,ruit,scar,sinus,slightly,slit,small,soon,splitting,ste,stellate,striped,tangled,tem,testal,thickened,thin,tip,trailing,triangular,trichome,twining,ud,undersurface,undulation,unequal,unevenly,uniseriate,unit,upper,vary,venation,whitish,yellow,ympodial	arrangement,bark,branch,bud,caylx,characteristic,colour,corolla,corrugation,drying,exertion,form,fruit,fruiting,glabrousnes,height,history,leaf,length,life,lobing,na,number,ovary,plant,seed,shape,size,texture,type
461	wfo-0001031333	success	194	132	92	102	40	0.474	+,.5,1-1.5,1-4,1-5,1.5,1.5-1.7,1.5-2,1/2,2.5-3,2.7-7,3-4,3/4,5-7,50,7-9,>,?,acuminate,acute,anther,anthesi,apex,bark,base,berry,bilobed,branched,broadly,brown,calyx,capitate,cm,corolla,densely,diameter,ellipsoid,elliptic,entire,exserted,filament,flattened,fruiting,glabrous,globose,golden,green,greenish,growth,immature,inflorescence,lobe,long,many,margin,membranous,minute,minutely,mm,narrowly,new,nodding,ovate,pair,pale,pedicel,peduncle,per,petiole,pitted,primary,pubescent,reniform,simple,somewhat,sparsely,stem,stigma,strongly,style,surface,terminal,time,truncate,tube,vein,vine,way,white,wide,woody,yellowish	0.1-0.5,0.5,1-5-2,2,2-3,3,30-40,5-8,5-merou,7-10,<,abaxially,adaxiall,adaxially,adjacent,ag,almost,alyx,apart,appearing,articulated,branche,cell,clustered,composed,conical,cream,cupped,denser,eaf,eed,flower,free,glabrescen,glabrescent,half,high,ilament,lamina,leaving,lengthening,less,like,lobed,lower,m.,matte,mere,near,nflorescence,occasionally,older,orolla,outline,papillat,peg,penden,perfect,pericarp,planar,plurifoliat,pore,poricidal,portion,pubescent-papillate,quadrate,rest,rhachi,rotate-stellate,ruit,scar,sinus,slightly,slit,small,soon,spaced,splitting,stellate,striped,tangled,testal,thickened,thin,tip,trailing,triangular,trichome,tub,twinin,ud,undersurface,undulation,unequal,unevenly,uniseriate,unit,upper,vary,venation,whitish,ympodial	appearance,arrangement,border,branch,bud,characteristic,colour,corrugation,distal,drying,exertion,form,fruit,giving,glabrousnes,height,history,interjected,lateral,leaf,leaflet,length,life,lobing,midpoint,na,number,ovary,plant,prickle,pseudostipule,ray,seed,shape,size,texture,thicknes,type,variation,width
462	wfo-0001031359	invalid_json_followup	166	148	100	66	48	0.602	.02,.25,.5,/4,0.5-1,0.5-6,1-4,1.1-1.6,1.2-1.6,1.2-2.5,1.3-1.6,1.9-2.3,12-21,2.5-3,3-3.5,3.6-8.8,5-30-flowered,5-angled,6-7,acuminate,angle,anther,apex,attenuate,axil,bark,base,beneath,berry,bi-lobed,brown,calyx,cm,corolla,dark,dia,distal,dried,dull,elliptic,extending,filament,flattened-reniform,fruiting,glabrous,globose,green,internodal,lateral,leaf,live,lobe,long,main,margin,minutely,mm,narrowly,nearly,obovoid,occasionally,often,opposite,outline,ovary,papillae,papillose,pedicel,petiole,pit,pitted,plant,ripe,round,rusty,shaped,shiny,shrub,simple,size,slender,somewhat,specimen,stem,stigma,style,surface,tan,tapering,tear-drop,trichome,tube,tuft,uniseriate,vein,way,white,x,yellow,yellow-orange	0.75-1,1.5-2,1.6-2.8,5-7,5.3-7.5,anthesi,apart,apiculate,appearing,ba,beginning,broadly,curled,deflexed,differing,difoliate,eaf,edicel,eed,evenly,free,geminat,incrassate,inflorescenc,interpetalar,lamina,lobed,lon,lower,major,membraneous,middle,minor,near,nflorescence,older,one,originating,pair,paler,papillo,planar,pore,poricidal,portion,reflexed,ridged,ruit,scar,sinus,slightly,spaced,straight,strongly,tall,tip,triangular,tub,ud,undulate,unit,white-lenticellat,widest,woody,ympodial,young	'',[,``,alternate,arrangement,branch,bud,characteristic,colour,corrugation,diameter,drying,exertion,form,fruit,glabrousnes,growth,height,history,inflorescence,interjected,leaflet,length,life,lobing,midpoint,na,new,number,peduncle,per,perennial,prickle,primary,pseudostipule,ray,seed,shape,terminal,texture,thicknes,type,value,variation,white-lenticellate,width,{,}
463	wfo-0001031362	success	138	115	85	53	30	0.616	.2,.5,0.4-0.5,0.5-1,0.7-1,1-1.1,1-1.5,1-3,1-4,1.5-2,2-2.5,3-4,?,abaxially,acute,adaxially,anther,apex,appearance,attenuate,bark,base,berry,branch,brown,bushy,calyx,closely,cm,conical,corolla,dendritic,densely,dia,ellipsoid,filament,flattened-reniform,fruiting,giving,glabrous,globose,golden,incrassate,lanceolate,lateral,leaf,lobed,long,main,margin,minutely,mm,nearly,nodding,orange-red,ovary,packed,pair,pale,pedicel,petiole,pitted,pubescent,pubesent,red,rounded,shaped,shrub,simple,slender,small-capitate,somewhat,sparsely,stem,stigma,style,subshrub,surface,tan,tear-drop,trichome,tube,vein,white,x	.3,1-3-flowered,3-6,along,anthesi,cell,denser,eaf,edicel,eed,erect,exceeding,exserted,flattened,free,golden-brow,inflorescenc,internodal,lamina,like,lobe,lon,long-triangular,lower,middle,nflorescence,older,opposite,outline,overlappin,papillo,papillose,pericarp,planar,plurifoliat,pore,poricidal,portion,rectangular,rest,ruit,scar,shiny,spaced,straight,thin,tip,ud,unit,widest,woody,ympodial,young	arrangement,bud,characteristic,colour,corrugation,diameter,drying,exertion,form,fruit,glabrousnes,golden-brown,growth,height,history,inflorescence,length,life,lobing,na,new,peduncle,plant,plurifoliate,primary,seed,shape,size,texture,type
464	wfo-0001031400	success	161	130	83	78	47	0.516	0.25-0.8,0.4-1.7,0.6-1.8,0.7-6,0.8-1.1,1-4,1.2-2,1.5-5,10-11,2-5,2-9,4-,4-13,4-6.5,4-7,5-12.5,6-23,7-25,7-28,acute,apex,apically,articulate,base,branched,calyx,cell,cm,corolla,covering,cyme,dark,deeply,dehiscent,diameter,dichasial,dichasially,distal,ebracteate,filament,globose,green,green-white,hair-like,herbaceous,interjected,lateral,leaf,leaflet,linear,linear-lanceolate,lobe,long,make,mm,monochasial,mucilaginous,oblique,oblong,odd-pinnate,ovoid,pedicel,peduncle,perennial,petiole,plant,poricidally,puberulent,seed,size,stellate,stigma,straight,style,subglabrous,terminal,testal,thick,tone,violet,wall,white,wide	-3,1,1-,2,2-3,3-6-foliat,4-17,abaxial,abaxially,abruptly,absen,acumen,adaxially,apical,apiculate,connate,cuneate,decurrent,digestion,diminishing,dorsally,eaf,edge,eed,emoval,enzyme,exceeding,flat,flower,folded,forked,forming,generally,globo,half,honeycomb,introrse,living,lon,lower,lunat,maturing,nflorescence,nther,occasionally,often,orolla,pair,pattern,perfect,plan,proximal,rachi,reveal,ruit,sessile,seudostipule,short,side,slit,specimen,stamen,stripe,structure,tal,tem,throughout,tip,toward,trilobe,tuber-bearing,typically,unit,vary,without,yellow,ympodial,Â¼	absent,anther,appearance,arrangement,bark,border,branch,bud,characteristic,colour,corrugation,drying,exertion,form,fruit,fruiting,giving,glabrousnes,growth,height,history,inflorescence,length,life,lobing,margin,midpoint,na,new,number,ovary,per,prickle,primary,pseudostipule,ray,shape,stem,surface,texture,thicknes,tube,type,variation,vein,wet,width
465	wfo-0001031401	success	182	153	126	56	27	0.692	0.5,0.6-1.2,0.8-1.2,1,1-1.4,1-1.5,1-6,1.1-3,1.5-2,1/2,2-2.4,2-5,2.5-4,3,3.5-4,3/4,5,5-9,7-9,abaxial,acute,adaxial,age,along,anther,apex,apical,appearing,attenuate,bark,basal,base,becoming,berry,bi-lobed,black,blade,branch,brown,calyx,cm,corolla,dark,deciduous,dendritic,densely,diameter,dichasial,drying,ecuador,ecuadorian,elliptic,exserted,filament,finely,flattened,fork,fruit,fruiting,glabrous,globose,golden,golden-yellow,growth,lateral,leaf,lenticular,less,long,matted,minutely,mm,narrowly,near,new,occasionally,often,outline,ovary,overtopping,pair,pedicel,per,petiole,pitted,pore,poricidal,puberulent,pubescent,purplish-black,reddish-brown,rounded,roundish,secondary,shiny,shoot,short,shrub,slit-like,small,sometimes,somewhat,sparsely,specimen,stem,stigma,strongly,style,surface,tapering,terminal,tip,tree,tree-like,trichome,tube,usually,vein,violet,way,white,wide,winged,x,yellow,young	5-7,8-10,abaxially,adaxially,anthesi,axi,branching,clearly,conical,deflexed,deltoid,denser,differentiated,eaf,edicel,eed,ew,flower,free,impressed,inserted,lobe,lobed,long-triangular,lower,m.,mesophyll,monochasia,nflorescence,noddin,nodding,node,older,papillo,pericarp,planar,plurifoliate,portion,prominently,pubescen,pyramidal,raised,ruit,scar,sleev,stamen,ste,tall,thin,time,tub,ud,unit,visible,woody,ympodial	arrangement,bud,characteristic,colour,corrugation,exertion,form,glabrousnes,height,history,inflorescence,length,life,lobing,margin,monochasial,na,number,papillose,peduncle,plant,primary,seed,shape,size,texture,type
466	wfo-0001031480	success	237	161	127	110	34	0.536	/3,0.1-0.3,0.1-0.4,0.5-2,0.6-0.8,0.8-1,1-1.3,1-1.5,1-2,1-3,1.5-2.2,1.7-2.2,1.8-3,1/3,2-2.7,3-6,3-7,3.5-7,4-5,4-6,6-13,6-8,8-12,acute,anther,apex,apically,apparently,articulated,bark,base,berry,bright,broad-deltate,calyx,cell,cm,cream,cuneate,curved,dark,deltate,densely,diameter,distal,dull,ellipsoid,entire,erect,filament,flattened-reniform,fruit,fruiting,glabrous,glandular,green,hair,lateral,leaf,length,lobe,lobed,long,margin,marking,maturity,mauve,midpoint,minutely,mm,moderately,near,obtuse,orange-brown,outline,ovate,pair,pale,pedicel,peduncle,per,petiole,pit,plant,poricidal,porrect,prickle,prickly,primary,purple,raised,ray,red,red-brown,red-green,red-yellow-green,reticulate,scandent,shallowly,shrub,simple,slender,small,smooth,spherical,spreading,stalked,stellate-pubescent,stem,straight,style,surface,tapering,terminal,thick-chartaceous,tip,trichome,truncate,tube,unarmed,upper,variously,vein,way,wide,yellow,young	-0.25,-2,0,0-0.5,0-1,0-2,0-30,0-5,0.1,0.15-0.3,0.2-0.35,0.4,0.4-0.8,0.5-,0.7,0.8,1-4,1/2,1/4,1/6-1/5,2-,2-3,2-5,2-6,3,3-10,5-8,5-merous,6-30,7-8,abaxial,abaxially,acuminat,adaxial,alyx,andromonoecious,apar,apart,ba,blade,branched,branching,difoliate,discolorous,distance,drying,eaf,eed,elongate,elongating,equal,extending,eye,faint,flattened,flower,free,geminat,glabrescent,hermaphrodite,heterostylous,inconspicuous,infructescence,long-styled,longer,lower,lowermost,mature,midvein,naked,nflorescence,often,older,one,open,orolla,oung,pendulous,pericarp,persistent,portion,pubescent,red-brow,reduced,rounded,ruit,scar,sessile,short-styled,shorter,side,slightly,somewhat,spaced,sparsely,stalk,staminat,stellate,tamen,terete,tertiary,time,unarme,unit,vary,venation,visible,weakly,woody,ympodial	20-30,acuminate,appearance,arrangement,border,branch,characteristic,colour,corolla,exertion,form,giving,glabrousnes,growth,height,history,inflorescence,interjected,leaflet,life,lobing,na,new,number,ovary,pseudostipule,seed,shape,size,texture,thicknes,type,variation,width
467	wfo-0001031483	success	154	131	97	57	34	0.63	/2,0,0.5,0.5-2,1-2,1.2-1.4,1.7-5.5,11-20.5,2-2.5,3-4,3-8-flowered,6-10,7-10,across,acuminate,acute,almost,anther,apex,attenuate,base,bearing,berry,ca,calyx,clavate,cm,corky,corolla,decurrent,deltoid,dia,difoliate,distal,dry,end,exserted,filament,filiform,flower,fresh,fruiting,fusiform,glabrous,green,indistinct,larger,lateral,leaf,lenticellate,linear,lobed,long,main,markedly,minutely,mm,oblanceolate,obovate,obovoid,often,ovary,ovoid-reniform,pair,pale,paler,papillose,pedicel,per,petiole,pointed,pore,poricidal,shape,shaped,short-triangular,shrub,simple,slender,slightly,soon,stem,stigma,style,subshrub,tan,tapering,tear-drop,third,tip,tube,turbinate,unit,vein,way,white,x	.5,1,1.1-2.5,1/3,2-3,2.5-3.2,anew,anthesi,apart,ba,beginning,beneath,blade,caly,continuous,cork,deflexed,eaf,edicel,eed,evenly,free,geminat,indistinc,internode,lea,less,lobe,lower,major,minor,nflorescence,oblong,opposite,orbiculate,papillo,planar,portion,prominent,quite,raised,rounded,ruit,scar,short,somewhat,spaced,straight,strongly,tall,ud,variable,widest,wing,winged,woody,ympodial	arrangement,bark,branch,bud,characteristic,colour,corrugation,diameter,drying,exertion,form,fruit,geminate,glabrousnes,growth,height,history,inflorescence,length,life,lobing,margin,na,new,number,peduncle,plant,primary,seed,size,surface,sympodial,texture,type
468	wfo-0001031492	success	175	144	117	58	27	0.669	.5,/4,0.5,0.7-1.3,0.9-1.1,08,1-1.3,1-1.5,1.3-2,1.5-1.8,1.5-2.5,10-15,2-10,2-3,2-5,20,3-4,3-5,4-10,4-4.5,6-8,8-11,8-9,absent,acuminate,acute,age,anther,apex,apical,appearing,attenuate,bark,basal,base,becoming,berry,bi-lobed,branching,calyx,cm,conical,corolla,dark,decurrent,densely,diameter,distinguishable,drying,dull,echinoid,elliptic,exserted,filament,flattened,flower,fruit,fruiting,glabrous,globose,golden,grey,growth,lamina,lateral,leaf,lenticular,lightly,lobed,long,minutely,mm,narrowly,ovary,overtopping,pair,pedicel,per,petiole,pitted,plurifoliate,pore,poricidal,predominantly,pubescent,purplish-black,pyramidal,reddish-brown,scarcely,scattered,secondary,shiny,shoot,short,shrub,size,slit-like,sometimes,sparsely,stem,stigma,strongly,style,surface,tapering,terminal,time,tip,tree-like,trichome,tube,vein,violet,way,wide,winged,x	abaxially,adaxially,anthesi,axe,ba,beneath,bitter,dbh,deciduous,deltoid,dendritic,denser,eaf,edicel,eed,erect,ew,free,inserted,juice,lobe,lower,m.,medium,monochasia,nflorescence,nodding,occasionally,older,papillo,pericarp,planar,portion,prominent,rather,remaining,ruit,scar,sleeve,slightly,somewhat,stamen,ste,sticky,sunken,tall,thin,tree,tub,ud,undersurface,unit,upper,upturned,woody,ympodial,young,younger	arrangement,branch,bud,characteristic,colour,exertion,form,glabrousnes,height,history,inflorescence,length,life,lobing,margin,monochasial,na,new,number,papillose,peduncle,plant,primary,seed,shape,texture,type
469	wfo-0001031503	success	142	138	83	59	55	0.585	-10,-15,-25,-30,-7,0.3-3,0.5-1,0.5-4,1-,1-2.5,1-3,1-5,1.5-7,2-3,2.5-10,3-15,3-4,3-5,6-7,7-10,7-15,abruptly,acuminate,acute,angled,apex,base,branched,calyx,chartaceous,cm,connivent,cuneate,decurrent,deltate,densely,diameter,distally,eglandular,elliptic,entire,flower,forked,glabrous,globose,hair,lanceolate,lobe,margin,mm,moderately,narrowed,narrowly,obtuse,often,orange,ovate,pedicel,peduncle,petiole,puberulent,pubescent,rarely,reddish,ripe,rounded,rugose-pubescent,shrub,simple,slightly,sparsely,stigma,style,tip,triangular,truncate,tube,unbranched,unequal,usually,vein,white,x	-6,1-7,1.5-2,1.5-3,1.5-8,1.7-3.5,10-19,3-6,5613,6-many-foliat,abaxially,absen,adaxially,aggregate,apart,articulated,axe,ba,blade,cell,curled,cylindrical,directed,distall,eaf,eed,except,fide,gland,long,lower,mostly,nflorescence,nther,occasionally,orolla,perfect,pore,present,rachi,radiu,ruit,spaced,stalked,stellate,stone,subcapitat,subclavate,tal,tem,time,toward,uniseriate,unit,vary,venturi,wide,yellow,ympodial	anther,appearance,arrangement,bark,border,branch,bud,characteristic,colour,corolla,corrugation,distal,drying,exertion,filament,form,fruit,fruiting,giving,glabrousnes,growth,height,history,inflorescence,interjected,lateral,leaf,leaflet,length,life,lobing,midpoint,na,new,number,ovary,per,perennial,plant,prickle,primary,pseudostipule,ray,seed,shape,size,stem,subcapitate,surface,terminal,texture,thicknes,type,variation,width
470	wfo-0001031586	success	167	122	80	87	42	0.479	.25,0.1-1,0.5-1,1-1.2,1-2,1.3-5,1.4-2.5,2,3-11,7-10-flowered,absent,acute,anther,apex,attenuate,bark,base,beneath,branch,bright,broadly,bud,calyx,capitate,cm,completely,conical,corolla,cream-colored,drying,ellipsoid,elliptic,exerted,filament,glabrous,globose,green,greenish,inflorescence,lateral,leaf,lobe,lobed,long,margin,mm,nearly,new,olive,onto,open,ovary,pale,papillate,pedicel,petiole,poricidal,prominent,raised,ridged,shiny,shrub,simple,size,somewhat,soon,stem,stigma,style,surface,tapering,thickened,tip,truncate,tube,vein,white,x,yellow,yellowish	-2,0.5-0.8,1,1-1.5,1.5-2,2-2.5,5-10,5-6,abrupt,anthesi,apart,apparently,appearing,becoming,borne,campanulate,closer,cucullate,deflexed,deltate,dia,differing,difoliate,distance,eaf,edicel,eed,exfoliatin,fleshy,flower,free,fresh,geminate,gree,inflorescenc,know,known,later,leave,lower,main,major,material,may,minor,minutely,mucro,near,nflorescence,notched,occasionally,older,one,opposite,overtopping,pair,paler,papillose,planar,pore,portion,present,remaining,rounded,ruit,scar,shap,shaped,shin,slender,small,sometimes,spaced,sparsely,straight,swollen,tall,tear-drop,thick,trichome,trunk,ud,uniseriate,unit,widely,ympodial,young	alternate,appearance,arrangement,border,characteristic,colour,corrugation,diameter,distal,exertion,form,fruit,fruiting,giving,glabrousnes,growth,height,history,interjected,leaflet,length,life,lobing,midpoint,na,number,peduncle,per,perennial,plant,prickle,primary,pseudostipule,ray,seed,shape,terminal,texture,thicknes,type,variation,width
471	wfo-0001031587	success	142	100	71	71	29	0.5	0.8-1,1-1.5,1.7-2,12-16,17-30,2,2-2.5,2-9-celled,2/3,5,acute,anther,apex,attenuate,bark,base,bi-lobed,broadly,calyx,clavate,cm,conical,corolla,decurrent,dendritic,densely,drying,elliptic-ovoid,exserted,filament,fleshy,furcate,glabrous,globose,golden-red,inflorescence,lateral,leaf,main,minutely,mm,oblique,ovary,pale,parallel,pedicel,petiole,pubescent,rarely,reddish-grey,shape,shaped,simple,size,soft,somewhat,stem,stigma,style,surface,tear-drop,thick,tree,trichome,tube,uniseriate,vein,way,white,winged,x	.5,1.5-2,10-15,3-4,6-7,6-8,7-9,abaxially,adaxially,along,anthesi,apart,axi,closely,cone,deflexed,deltate,denser,dia,differing,eaf,edicel,eed,elliptic,erect,evenly,fide,free,included,irregular,know,known,lamina,later,like,lobe,lobed,long,loose,lower,lowered,major,middle,minor,mostly,ocasionally,occasional,older,overlappin,pair,papillate,papillo,perpendicular,persisten,pore,poricidal,portion,rect,rest,ruit,scar,spaced,steinbach,tall,thickened,tip,tub,ud,verrucose,widest,young	1,arrangement,bud,characteristic,colour,corrugation,diameter,exertion,form,fruit,growth,height,history,length,life,lobing,margin,na,number,occasionally,papillose,peduncle,per,perennial,plant,primary,seed,texture,type
472	wfo-0001031589	success	222	137	105	117	32	0.473	-6.5,0.1-0.5,0.2-0.5,0.4,0.5-1,0.55-0.7,0.6-1.2,0.8-2.3,0.9-1.3,0.9-1.6,1-1.8,1.2-1.5,1.7-2.5,1.8-2.9,1/3,1/3-1/4,2.5-6,3-5,3/4,acute,anther,apex,apically,articulated,attenuate,base,berry,bright,brown-green,calyx,cell,chartaceous,cm,cream,dark,deltate,densely,diameter,dull,elliptic,erect,filament,flattened-reniform,fruit,fruiting,glabrous,gray-green,green,lateral,leaf,length,lobe,lobed,long,long-obovate,lower,margin,marking,maturity,mauve,membranous,mm,moderately,narrow-cuneate,occasionally,often,orange-brown,outline,pair,pale,pedicel,per,petiole,pit,plant,poricidal,prickle,prickly,primary,raised,rounded,shiny,shrub,simple,small,smooth,sparsely,spherical,stellate-pubescent,stem,style,subentire,surface,tapering,tip,tube,upper,vein,way,white,whole,wide,yellow,yellow-green,young	-0.5,-15,-6,.5,/6,0,0-1,0-10,0-3,0-30,0.1,0.15-0.3,0.2-0.4,0.2-3,0.7,1,1-5,1.5-5,1/3-1/2,10-30,2-,2-10,2-3.5,2.5-4.5,2.8-4,3-4,4-6.5,4/5,5-8,5-merous,6-8,8-14,8-30,abaxially,alyx,ame,apart,apparently,bark,blade,broadly,brow,c.,caudat,concolorous,connivent,density,difoliate,discolorous,distance,drying,eed,elongating,equal,extending,eye,flower,free,geminat,glabrescent,higher,infructescence,lengt,lon,longer,mature,midpoint,midvein,multangulate,naked,narrow,nflorescence,oblong,obovate,older,orange-green,orolla,oung,part,pendulous,perfec,pericarp,porrect,portion,prickl,ray,reflexed,ruit,scandent,sessile,shorter,side,solitary,sometimes,somewhat,spaced,spreading,stalk,stalked,stellate,stout,straight,subsessile,tamen,terete,tertiary,time,trichome,unit,vary,venation,visible,weakly,winged,woody,yellow-orange,ympodial	20-30,appearance,arrangement,border,bud,caudate,characteristic,colour,corolla,exertion,form,giving,glabrousnes,growth,height,history,inflorescence,life,lobing,na,new,number,ovary,peduncle,perennial,seed,shape,size,stigma,texture,type,width
473	wfo-0001031609	success	154	122	71	83	51	0.461	0.5-3,1-10,1-6,1.3-3,10-25,2-,2-3,20-25,3-24,3-9-lobed,4,4-5,4-6,4.5-60,abaxially,acute,adaxially,apex,apiculate,around,base,branch,brownish,calyx,cm,connivent,cuneate,deltate,dia,diameter,ellipsoidal,elliptic,entire,flattened,forked,fruit,glabrous,globose,green,inflorescence,leaf,lobe,lobed,margin,mm,obovate,obtuse,orange,pedicel,peduncle,petiole,pinnately,puberulent,reticulate,ripe,shallowly,shrub,simple,small,stigma,style,succulent,tip,tree,triangular,truncate,tube,unbranched,unlobed,x,yellow	.5,/4,0-30,0.4-3,0.5-1,1.5-2,1.5-3,2,2.5-4,3-5,3-foliat,5-25,5/6,8-20,absen,absent,aggregate,ape,articulated,axe,barely,beyond,bilobe,blade,brow,campanulate,cell,connective,conspicuous,contiguous,dark,dilated,directed,distally,divided,eaf,eed,elliptic-ovate,emerging,equal,exceeding,exserted,fleshy,flower,glabrou,laterally,leaving,long,lower,midrib,minutely,nearly,nflorescence,nther,obconical,occasionally,orolla,papillose,pedicellar,point,pore,rachi,radiu,rounded,ruit,scar,sinus,stamen,stellate,stone,strongly,succulen,tal,tem,thecae,time,tomento,two,ud,unit,vary,wide,ympodial	anther,appearance,arrangement,bark,bilobed,border,bud,characteristic,colour,corolla,corrugation,distal,drying,exertion,filament,form,fruiting,giving,glabrousnes,growth,height,history,interjected,lateral,leaflet,length,life,lobing,midpoint,na,new,number,ovary,per,plant,prickle,primary,pseudostipule,ray,seed,shape,size,stem,surface,terminal,texture,thicknes,type,variation,vein,width
474	wfo-0001031615	success	154	126	93	61	33	0.604	.5,0,0.5,0.8-1,0.9-1.1,1-1.6,1.3-1.8,1.5,1.5-5,11-15.5,2-4.2,3.8-6.1,4-6.5,5-20-flowered,5-6,6-8,8-10,acuminate,acute,anther,apex,attenuate,bark,base,berry,bilobed,brown,calyx,capitate,cm,corolla,dark,decurrent,deep,dia,difoliate,elliptic,exserted,filament,flattened-reniform,fruit,fruiting,furcate,glabrous,glandular,globose,green,inflorescence,lateral,leaf,less,lobed,long,main,major,margin,minor,minutely,mm,nearly,occasionally,older,opposite,ovary,pair,pedicel,per,petiole,pitted,scarcely,shaped,shrub,simple,size,slender,small,stem,stigma,straight,style,subumbellate,surface,tapering,tear-drop,tree,tube,unit,urceolate,vein,white,winged,x,young	0.5-1,2-3,anthesi,arising,axil,ba,becoming,caly,closely,dark-papillo,deflexed,deltoid,differing,distal,eaf,edicel,eed,expanded,free,geminat,impressed,incrassate,interpetalar,lamina,lobe,lon,lower,maroo,middle,minute,nflorescence,one,overlappin,packed,paler,papillae,papillose,pore,poricidal,portion,prominent,reflexed,ruit,scar,shiny,sinus,slightly,somewhat,tall,terminal,thickened,thin,tip,trichome,tuft,ud,unicellular,uniseriate,widest,woody,ympodial	arrangement,branch,bud,characteristic,colour,corrugation,dark-papillose,decurred,diameter,drying,exertion,form,geminate,glabrousnes,growth,height,hirsute,history,length,life,lobing,maroon,na,new,number,peduncle,plant,primary,seed,shape,sympodial,texture,type
475	wfo-0001031618	success	184	132	84	100	48	0.457	-2,0-3,1-1.5,1.5-2,10-18,10-lobed,2-2.5,2-3,3-4,3-8,4-5,90-110,acute,anther,apex,appearance,axil,base,berry,branch,broadly,calyx,capitate,cm,corolla,cuneate,cyme,darker,discoidal,ellipsoid,equal,erect,except,exerted,filament,finely,giving,glabrous,glandular,green,greyish,growing,hair,lavender-purple,leaf,less,lobe,long,marbled,maturity,minute,mm,narrowly,oblong,obovoid,ovary,ovoid,pale,pedicel,peduncle,petiole,pinatisect,point,purple,reddish-brown,reticulate,rounded,rugose,scorpioid,shrub,simple,somewhat,stem,stigma,stripe,surface,tapering,terete,tinged,triangular,unequal,variable,x,young	0.5-1.5,1-7,1.5-3.5,13,3,40-60,5,5-12,acuman,almost,also,anthesi,appearing,aspect,becoming,beyond,blunt,bluntly,c.,cell,clonal,cluster,column,conical,covering,cut,developed,dia,eaf,eed,elliptic,emarginate,enlarged,extending,facetted,fleshy,floral,flower,fork,forked,frui,general,greatly,gree,habit,half,interacuminal,lanceolate,lasting,lengthening,lobed,lon,loosely,lower,mauve,may,mid-vein,midrib,nflorescence,occasional,occur,often,ovate-lanceolate,pal,pedicellate,petal,plurifoliat,pore,poricidal,rarely,rhachi,ripe,rotate,ruit,sessile,several,shallowly,side,single,sinus,slit,soft-wooded,sometimes,specimen,stone,stout,strongly,styl,succulent,tip,tissue,tub,ud,unit,vigorous,way,well,year,ympodial,younger	arrangement,bark,border,bud,characteristic,colour,corrugation,diameter,distal,drying,exertion,form,fruit,fruiting,glabrousnes,growth,height,history,inflorescence,interjected,lateral,leaflet,length,life,lobing,margin,midpoint,na,new,number,per,plant,prickle,primary,pseudostipule,ray,seed,shape,size,style,terminal,texture,thicknes,tube,type,variation,vein,width
476	wfo-0001031646	success	171	131	86	85	45	0.503	.2,0.2-0.8,0.5-2,0.8-1.5,1-1.8,1-6,1.2-2.5,15-25,18-38,2-3,2.5-10,4-18,4-20,4-5,7-8,8-15,absent,acuminate,acute,anther,apex,articulated,basally,base,berry,blue,branched,brown,calyx,chartaceous,cm,covered,cuneate,densely,diameter,ellipsoidal,entire,filament,flattened,flower,fruit,fruiting,glabrous,globose,green,hair,highly,immature,interjected,lateral,leaf,leaflet,light,lobe,margin,mature,mm,multicellular,oblique,oblong,ovate-lanceolate,pedicel,peduncle,petiole,pubescence,pubescent,red,rotate-pentagonal,rounded,rugulose,shortly,shrub,simple,size,smooth,spreading,stem,stigma,stout,style,surface,tawny,tube,uniseriate,violet,x	-7,-pinnate,.5,1-10,1.5-3.5,1.5-4,1962,2-10,2-2.5,20,3.5-4,4-8,4-foliate,5,5-6,5-7,5-7.5,5-merou,abaxially,absen,accrescent,acut,adaxially,aggregate,alyx,apart,apical,apparently,axe,ba,blade,cell,ciliat,climbing,connivent,correll,cylindrical,darker,decreasing,directed,distall,eaf,eed,elliptic,elliptic-lanceolate,equal,fide,geminat,glandular,high,homostylous,hyaline,long,lower,maroon,nflorescence,obliquely,obtuse,orolla,ovate-lanceolat,part,perfect,petiolule,pore,present,pubescen,rachi,ruit,scandent,seudostipule,slightly,small,spaced,stone,tamen,tem,tip,toward,tree,truncat,unit,vary,vine,yellow,ympodial	appearance,arrangement,bark,border,branch,bud,characteristic,colour,corolla,corrugation,distal,drying,exertion,form,giving,glabrousnes,growth,height,history,inflorescence,length,life,lobing,midpoint,na,new,number,ovary,per,pinnate,plant,prickle,primary,pseudostipule,ray,seed,shape,terminal,texture,thicknes,truncate,type,variation,vein,width
477	wfo-0001031651	invalid_json_followup	201	157	114	87	43	0.567	-2,-3.5,.6,.7,/5,0-20,0.2-0.5,0.3-0.5,0.3-0.8,0.3-1.5,0.6-1,0.6-1.3,0.7-1,1,1-1.7,1.2-2,1.2-3,1.3-1.6,2-10,3-5,4-5,4-6,absent,anther,apart,apex,apparently,articulated,bark,base,berry,branched,brown,calyx,cell,chartaceous,cm,concolorous,cordate,curved,dark,densely,diameter,discolorous,drying,dull,elliptic,entire,erect,faint,filament,flattened-reniform,fruit,fruiting,glabrous,gray,herb,lateral,leaf,length,lobed,long,lower,margin,maturity,midpoint,mm,obtuse,orange-brown,outline,ovate,pair,pedicel,peduncle,per,petiole,pit,poricidal,prickle,prickly,primary,purple,raised,ray,red,red-green,rounded,shrub,simple,small,smooth,sometimes,spaced,spherical,spreading,stellate-pubescent,stem,style,subentire,surface,tapering,terete,terminal,tip,tube,unarmed,vein,visible,way,weakly,white,wide,yellow,yellow-green	-3,.1,/3,0.1,0.1-0.15,0.1-0.2,0.1-0.25,0.15-0.2,1-2,1-4,1.5-2,1/5,1/6-1/4,2-3,2-3.5,2/3-3/,4.5-7,5-merous,abaxial,abaxially,acuminat,acute,adaxial,alyx,ame,apar,apically,blade,c.,deltate,difoliate,eaf,eed,elongating,equal,eye,filiform,flower,free,geminat,glabrescent,gra,herbaceous,infructescence,lanceolate,lobe,longer,mature,naked,nflorescence,oblong,older,one,open,orolla,oung,pendulous,perfec,pericarp,persistent,porrect,portion,prickl,reflexed,ruit,scandent,scar,shorter,stalk,stalked,stellate,straight,subsessile,tamen,tertiary,thick,thick-stalked,time,toward,trichome,unarme,unit,upper,variously,vary,venation,ympodial	'',.1-0.2,2/3-3/4,[,``,arrangement,branch,bud,characteristic,colour,corolla,corrugation,distal,exertion,form,glabrousnes,growth,height,history,inflorescence,interjected,leaflet,life,lob,lobing,na,new,number,ovary,plant,pseudostipule,seed,shape,size,stigma,texture,thicknes,type,value,variation,width,{,}
478	wfo-0001031656	invalid_json_followup	154	152	104	50	48	0.675	.5,/4,0.5-1,1-2,1-2.5,1.2-1.5,1.5-2,1.5-5,10-20,2.5-3.5,3-3.5,4-9,5-7,5-ribbed,6-8,acuminate,acute,anther,anthesi,apex,arising,bark,base,berry,bright,calyx,capitate,cm,corolla,dia,difoliate,directly,drying,ellipsoid,elliptic,enclosing,filament,fleshy,flower,fruit,fruiting,glabrous,globose,green,greyish,lateral,leaf,live,lobe,long,long-acuminate,lower,main,margin,matte,minute,minutely,mm,node,oblique,opposite,ovary,ovate,pair,papillose,pedicel,persistent,petiole,planar,plant,prominent,rather,red-papillose,reddish,reflexed,rounded,sessile,shaped,shiny,shrub,size,slightly,somewhat,specimen,stem,stigma,straight,strongly,style,surface,swollen,tear-drop,terminal,thick,tip,tube,unit,upper,vein,visible,way,white,woody,x	0.5,1-1.5,3-5,also,ba,closely,cork,densely,differing,eaf,edicel,eed,erect,extremely,free,geminat,hooded,known,lobed,lon,major,mature,middle,minor,nflorescence,often,older,one,pale,paler,papillo,peelin,pore,poricidal,portion,proximal,rib,ridged,ruit,scar,spaced,tall,thickened,top,transversely,ud,wide,widest,ympodial,young	'',[,``,appearance,arrangement,branch,bud,characteristic,colour,corky,corrugation,diameter,distal,exertion,form,geminate,giving,glabrousnes,growth,height,history,inflorescence,interjected,leaflet,length,life,lobing,midpoint,na,new,number,peduncle,per,prickle,primary,pseudostipule,ray,seed,shape,sympodial,texture,thicknes,type,value,variation,width,{,}
479	wfo-0001031667	success	153	114	68	85	46	0.444	0.6-1,1-1.5,1-4,1.4-3,1.5-2,12-35,2-5,2.5-5,3-13,3-5,5-9,8-13,8-15,acute,apex,apiculate,articulate,base,branched,calyx,cm,cordate,corolla,cuneate,cyme,dark,diameter,dichasial,dichasially,distal,ebracteate,elliptic-lanceolate,filament,globose,green,green-white,herbaceous,interjected,irregularly,lanceolate,lateral,leaf,leaflet,lobe,lobed,long,mm,monochasial,mucilaginous,oblique,odd-pinnate,ovoid,pedicel,peduncle,perennial,petiole,pilose,plant,rounded,seed,size,spot,stigma,stripe,style,terminal,tuber-bearing,white	0.6-1.5,10-13,2-3,2-6,3-6-foliat,3-8,4-1.,5-15,6-10,abaxially,abruptly,acumen,acuminate,adaxially,apical,apically,caudate,cell,connate,covering,dehiscent,digestion,diminishing,dorsally,eaf,edge,eed,emoval,enzyme,exceeding,flat,flower,folded,forked,generally,globo,hair-like,half,honeycomb,introrse,living,lon,lower,lunat,make,maturing,nflorescence,nther,oblong,often,orolla,pair,pattern,perfect,petiolate,petiolule,plan,poricidally,proximal,reveal,ruit,sessile,seudostipule,short,slit,specimen,stamen,stellate,straight,tal,tem,testal,thick,throughout,toward,typically,unit,vary,wall,whit,wide,without,yellow,ympodial,Â¼	4-10,anther,appearance,arrangement,bark,border,branch,bud,characteristic,colour,corrugation,drying,exertion,form,fruit,fruiting,giving,glabrousnes,growth,height,history,inflorescence,length,life,lobing,margin,midpoint,na,new,number,ovary,per,prickle,primary,pseudostipule,ray,shape,stem,surface,texture,thicknes,tube,type,variation,vein,width
480	wfo-0001031672	success	157	132	79	78	53	0.503	0-2,0.3-0.5,0.5-1.5,1,1-2,1-5,1.5-2,1.5-2.5,1.5-3.5,1.5-5,10-20,15-20,15-50,2-28,4,4-34,4.5-5,6,9-lobed,acuminate,acute,apex,apiculate,articulated,basal,base,beyond,calyx,chartaceous,cm,cordate,densely,diameter,entire,exserted,flattened,flower,fruit,glabrous,glandular-puberulent,globose,green,greenish-brown,hair,lanceolate,leaf,lobe,lobed,long,margin,mm,moderately,narrowly,near,ovate,ovoid,pedicel,peduncle,petiole,pilose,pinnately,puberulent,rounded,simple,sparsely,stamen,stigma,style,subcoriaceous,tip,tree,triangular,truncate,tube,unbranched,white,whitish,x,yellow	0,0.5,0.5-1,1-,1-1.5,1-10,2-12,3-4-foliat,3/4,4/5,5-6,abaxially,absent,adaxially,aggregate,apart,ape,aublet,axe,blade,cell,ciliat,connective,cylindrical,directed,distally,divided,eaf,eed,exceeding,fide,fleshy,leaving,lon,lower,mature,membranaceous,midrib,nflorescence,nther,obtuse,occasionally,often,one,orolla,pedicellar,perfect,pilo,pore,presen,present,pubescent,purple,rachi,radiu,remant,represented,ruit,shorter,sinus,slightly,small,spaced,stellate,stone,tal,tem,thecae,time,toward,truncat,ud,unit,unlobed,vary,wide,yello,ympodial	anther,appearance,arrangement,bark,border,branch,bud,characteristic,colour,corolla,corrugation,distal,drying,exertion,filament,form,fruiting,giving,glabrousnes,growth,height,history,inflorescence,interjected,lateral,leaflet,length,life,lobing,midpoint,na,new,number,ovary,per,perennial,plant,prickle,primary,pseudostipule,ray,seed,shape,size,stem,surface,terminal,texture,thicknes,type,variation,vein,width
481	wfo-0001031684	invalid_json_followup	161	160	113	48	47	0.702	.25,.5,.75,/4,0.1,0.4-1.5,0.5-0.7,0.5-0.8,0.7-1,0.75-1,1-1.2,1-5,10-100,2,2-9,3-3.5,3-30,4-17,acuminate,acute,along,anther,apex,bark,base,bearing,beneath,berry,black,borne,branched,calyx,clavate,cm,corolla,curly,decurrent,densely,dia,difoliate,drying,elliptic,expanded,exserted,extremely,filament,filiform,flower,fruiting,geminate,glabrous,globose,green,inflorescence,internodal,irregularly,lateral,leaf,less,like,lobe,lobed,long,lower,minutely,mm,occasionally,older,opposite,ovary,ovoid-reniform,pale,papillose,pedicel,persistently,petiole,pitted,pore,poricidal,previously,pubescent,scar,shaped,short,shrub,size,slender,slightly,small,soon,sparsely,stem,stigma,straight,style,surface,tan,tapering,tear-drop,time,tip,tipped,tree,trichome,tube,unifoliate,uniseriate,vein,way,white,winged,x,young	0.5-1,5-7,anthesi,apar,causing,deflexed,denser,differing,eaf,edicel,eed,elongated,except,free,gre,greatly,lon,long-triangular,main,major,middle,midrib,minor,nflorescence,obconic,one,pair,papillo,planar,portion,present,pulled,raised,reflexe,reflexed,rest,ruit,single,siz,spaced,tall,ud,unevenly,unit,varying,widely,widest,ympodial	'',[,``,arrangement,branch,bud,characteristic,colour,corrugation,diameter,distal,exertion,form,fruit,glabrousnes,grey,growth,height,history,interjected,leaflet,length,life,lobing,margin,midpoint,na,new,number,peduncle,per,plant,prickle,primary,pseudostipule,ray,seed,shape,terminal,texture,thicknes,type,value,variation,width,{,}
482	wfo-0001031695	invalid_json_followup	185	156	98	87	58	0.53	0.5-1,0.5-2,1-2,1-9,1.5-8,10-35,2-3,2-4,2.5-5,20-30,3-19,3-7,30-40,4-10,4-5,4-6,5-20,6-10,abruptly,acuminate,acute,also,apex,apiculate,articulated,basal,base,beyond,branched,calyx,chartaceous,cm,color,connivent,cordate,dark,deep,densely,diameter,ellipsoidal,entire,exserted,flattened,flower,fruit,glabrescent,glabrous,glandular-puberulent,green,greenish,immature,lateral,lavender,leaf,leaving,lobe,lobed,long,margin,mm,moderately,mottled,narrowly,oblique,oblong,obtuse,occasionally,often,ovate,ovoid,pedicel,pedicellar,peduncle,petiole,pilose,pilose-hirsute,puberulent,pubescent,purple,remnant,ripe,shrub,simple,sometimes,somewhat,sparsely,stamen,stigma,stripe,style,subcoriaceous,tip,triangular,tube,unbranched,unequal,unknown,x	1,1-3,1.5-2,1/2,1/3,10-,10-15,15-20,2-5,3-,3-10,3-17,4-foliat,5,5-7,6-20,6-8,7-,?,abaxially,adaxially,aggregate,apart,ape,apically,axe,blade,broadened,campanulate,capitat,cell,connective,cylindrical,d,dilated,directed,divided,eaf,eed,eglandular,eglandular-pilose,exceeding,fleshy,glabrate,hair,hard,lanceolate,laterally,lilac,lon,lower,midrib,nflorescence,nther,orolla,perfect,pilo,pilose-hirsut,pore,presen,present,puberulent-pubescent,purplish,rachi,radiu,rounded,ruit,shorter,sinus,slight,slightly,small,spaced,stone,swelling,tal,tem,thecae,time,tomento,tree,unit,unlobed,vary,wide,yellow,ympodial	'',[,``,anther,appearance,arrangement,bark,branch,bud,capitate,characteristic,colour,corolla,corrugation,distal,drying,exertion,filament,form,fruiting,giving,glabrousnes,growth,height,history,inflorescence,interjected,leaflet,length,life,lobing,midpoint,na,new,number,ovary,per,perennial,plant,prickle,primary,pseudostipule,ray,seed,shape,size,stem,surface,terminal,texture,thicknes,type,value,variation,vein,width,{,}
483	wfo-0001031698	success	58	61	34	24	27	0.586	2-2.5,2.5,2.5-3,4-4.5,bark,base,branch,cm,dull,elliptic,flattened,fruiting,glabrous,green,incrassate,leaf,margin,minutely,mm,pale,paler,pedicel,pitted,reddish-brown,reniform,repandly,rugose,shrub,stem,stout,strongly,surface,winged,x	'',``,ape,decurrent,deflexed,dia,difoliate,eaf,eed,fide,geminat,long,maguire,older,otherwise,papillae,persistin,tall,unit,wing,woody,yellowish,ympodial,young	1,apex,arrangement,characteristic,colour,decument,diameter,form,fruit,glabrousnes,growth,height,history,length,life,na,new,number,per,plant,primary,seed,shape,size,texture,type,vein
484	wfo-0001031707	success	178	143	108	70	35	0.607	/4,1-1.2,1-1.3,1-1.5,1-3,1.2-1.8,1.2-2,1.5-1.7,1.5-2,1.5-6,1/3,16-20,2,2-10,2-4,2-6,3,4-5,6-7,8-12,80-140,9-15,acuminate,acute,almost,anther,apex,apical,apically,attenuate,axil,axillary,base,basiscopically,bearing,berry,brown,calyx,capitate,cm,conical,conspicuously,corolla,densely,diameter,distal,distinct,elliptic,enlarged,erect,filament,flat,flattened,flower,four-lobed,fruiting,glabrous,globose,green,greenish,lanceolate,lateral,leaf,leaflet,lobe,long,mm,narrowly,oblique,obovate,occasionally,open,ovary,pair,pedicel,per,petiole,pink,pinnate,plant,pointed,poricidal,pubescent,quadrate,quite,reddish,round,sagittate,simple,slightly,smooth,somewhat,sparsely,stigma,stout,style,surface,terminal,ternate,time,tip,type,vine,way,white,white-lenticellate,woody,x	-3,.5,0.5-1,2-3,24,4-6,5-10-celled,abaxially,absent,adaxially,along,anthesi,basal,c.,cateniform,cell,clavat,climbing,cucullate,dense,drying,eaf,edicel,eed,endrophilum,epidermal,exserted,flap-like,fleshy,free,high,horizonta,inflorescenc,less,like,lobed,lon,lower,margin,minutely,narrower,nflorescence,papillate,penden,petiolule,planar,portion,primary,raised,regular,rest,ruit,scar,scattered,smaller,spaced,strongly,tem,thickening,trichome,tub,tube,ud,unifoliat,uniseriate,unit,usually,vein,widely,ympodial	0.5,appearance,arrangement,border,bud,characteristic,clavate,colour,form,fruit,giving,glabrousnes,growth,height,history,horizontal,inflorescence,length,life,lobing,midpoint,na,new,number,peduncle,prickle,ray,seed,shape,size,stem,texture,thicknes,variation,width
485	wfo-0001031723	success	228	172	147	81	25	0.645	-1.5,-16,-2,-5,-6.5,-8,0,0.1-0.2,0.2-1,0.4,0.4-,0.4-0.9,0.4-1,0.55-0.9,0.6-1,0.7-1,0.8-1.5,1-,1-2,1-2.5,1-3,1.2-2,1.5-,15-45,2-,2-3.5,2-5.5,2.5-4.5,2.5-5,2/3-3/4,4-10,4-11,4-6,5-9,8-20,abaxially,acuminate,acute,ame,anther,apex,apically,apparently,articulated,bark,base,berry,branched,branching,brown,c.,calyx,chartaceous,cm,connivent,cuneate,curved,dark,deltate,densely,diameter,discolorous,drying,dull,elongated,entire,erect,evenly,filament,filiform,finely,flattened-reniform,fruit,fruiting,gently,glabrous,glandular,green,hair,lateral,leaf,length,lobe,lobed,long,margin,marking,maturity,mauve,midpoint,minute,mm,moderately,multangulate,narrow-deltate,near,obtuse,orange,orange-brown,ovate,pair,pale,pedicel,peduncle,petiole,poricidal,prickle,prickly,primary,ray,recurved,red,reflexed,rounded,secondary,sessile,shrub,simple,sometimes,sparsely,spherical,spreading,stalked,stellate,stellate-pubescent,stem,straight,strongly,style,subentire,surface,tapering,terminal,tip,trichome,tube,unarmed,usually,variously,vein,way,weakly,white,wide,yellow,yellow-green,young	-1/2,-15,-6,-merous,0.05-0.2,0.1-0.3,0.1-0.5,0.15,1-5,1.5-10,1.5-2.5,1/3-1/2,1/4-1/3,1/6-,10-30,2-7,2/3,3-10,3-15,4-,4-20,4-5,5-40,abaxial,acut,adaxial,alyx,apar,apart,ba,blade,brow,conical,eaf,eed,elongating,equal,eye,flower,free,glabrescent,gland,gland-tipped,gray,herbaceous,inflated,infructescence,longer,lower,mature,naked,nflorescence,older,one,open,orolla,oung,per,perfec,pericarp,perpendicular,plurifoliat,porrect,portion,ruit,scar,smooth,spaced,stalk,tamen,terete,tertiary,time,unarme,unit,vary,venation,visible,whitish,woody,ympodial	arrangement,branch,characteristic,colour,corolla,exertion,form,glabrousnes,growth,height,history,inflorescence,life,lobing,na,new,ovary,perennial,plant,seed,shape,size,stigma,texture,type
486	wfo-0001031729	success	161	125	90	71	35	0.559	-2,-45,..,0.5-1,0.6-,1-1.5,1-2,1-2.5,1.0-1.3,1.5,1.5-2,10-20,11-30,12-13,2-2.5,2-3,2.5-,2.5-5,3-4,3.5-4,4.1-16,5-,5-6,5-7,abruptly,acuminate,anther,apex,attenuate,base,branch,branched,calyx,cm,conical,corolla,dark,darker,diameter,drying,elliptic,filament,flattened,fruit,fruiting,glabrous,globose,green,greenish,later,lobed,long,markedly,membranous,middle,mm,mottling,nearly,obovate,occasionally,ovary,ovate-reniform,pair,pale,pedicel,peduncle,per,petiole,pink,point,pointed,primary,purplish,reddish,shrub,single,small,smooth,somewhat,stem,stigma,stripe,surface,tan,time,tube,vein,white,x,young	-0.5,0.5,0.5-4,3-celled,50,8-9,along,anthesi,apicula,apiculate-deltate,beneath,branc,brittle,brow,c.,cell,cucullate,curve,deltate,dry,eaf,edicel,eed,elongate,erec,flattened-capitat,flower,glandular,gradually,less,lobe,lower,minute,minutely,narrowly,never,nflorescence,noddin,open,outer,outline,papillae,papillate,papillose,pericarp,planar,plurifoliat,quadrate,regularly,ruit,scar,scattered,short,single-stemmed,sinuate,striate,testa,thin,thing,tip,toward,triangular,trichome,tuft,ud,unit,usually,wall,wand-like,widening,ympodial	0-0.5,arrangement,bark,brown,bud,characteristic,colour,corrugation,curved,exertion,flattened-capitate,form,glabrousnes,growth,height,history,inflorescence,leaf,length,life,lobing,margin,na,new,nodding,number,perennial,plant,plurifoliate,seed,shape,size,style,texture,type
487	wfo-0001031738	invalid_json_followup	231	191	150	81	41	0.649	-15,-5,0,0-2,0.1-0.25,0.7-1,0.7-1.1,0.9-2.1,1-1.5,1-1.8,1-4,1.4-1.7,1.5-,1.5-4,1/2-2/3,1/3,1/3-2/3,10-15,15-40,2-,2-4,2.3-3,3-4,3-6,3.5-3.8,3.5-4.5,4,4-5,4-6,4-8,5,5-8,6-15,7-12,7-12.5,8-18,acute,always,anther,apex,apically,apparently,articulated,auriculate,bark,base,berry,branched,calyx,cell,chartaceous,cm,connivent,cordate,dark,deltate,densely,diameter,discolorous,distal,distance,drying,dull,erect,evenly,extending,filament,flattened-reniform,flower,frequently,fruit,fruiting,glabrescent,glabrous,green,lateral,leaf,length,lobe,lobed,lobing,long,long-styled,lower,margin,maturity,midpoint,midvein,mm,narrow-deltate,oblong,obovate,often,one,open,orange,orange-brown,outline,ovate,pair,pale,pedicel,peduncle,per,petiole,pit,plant,poricidal,prickle,prickly,primary,prominent,raised,ray,reflexed,rounded,secondary,shrub,side,simple,small,smooth,sometimes,spherical,spreading,stellate-pubescent,stem,strongly,style,surface,tapering,terete,terminal,time,tip,tree,trichome,truncate,tube,unarmed,upper,vein,way,weakly,white,wide,yellow,yellow-green,yellow-orange,young	-6,-merous,.5,0-3,0.2-0.3,0.25-0.8,0.3-1,1-3,1/,1/4-1/3,1/6-1/4,20-200,3-7,4-10,8-10,abaxial,abaxially,acuminat,adaxial,adaxially,almost,alyx,andromonoecious,apar,apart,blade,curved,eaf,eed,elongating,equal,flattened,free,gray,held,hermaphrodite,heterostylous,infructescence,inside,longer,lowermost,mature,multangulate,nflorescence,older,orolla,oung,pericarp,plurifoliat,poorly,porrect,portion,prickl,pubescent,resin,ruit,scar,sessile,short-styled,shorter,spaced,sparsely,stalk,stalked,staminat,stellate,sticky,stout,straight,tamen,tertiary,unit,usually,variously,vary,venation,visible,white-brow,woody,yellowish,ympodial	'',1/4,[,``,acuminate,arrangement,branch,bud,characteristic,colour,corolla,corrugation,exertion,form,glabrousnes,growth,height,history,inflorescence,interjected,leaflet,life,na,new,number,ovary,perennial,pseudostipule,seed,shape,size,stigma,texture,thicknes,type,value,variation,white-brown,width,{,}
488	wfo-0001031752	invalid_json_followup	172	159	101	71	58	0.587	-10,-100,-6,0.5-1,1,1-2,1-4,1.5-3,1.5-3.5,15-25,15-40,2-2.5,2-5,20-35,3-11.5,3-4,3-7,3.5-5,5-23,5-8,abaxially,acuminate,acute,adaxially,apex,apiculate,articulated,basal,base,beyond,calyx,chartaceous,cm,connivent,cuneate,darker,deltate,densely,diameter,ellipsoidal,elliptic,entire,exserted,flattened,flower,fruit,fusiform,glabrate,glabrescent,glabrous,glandular-puberulent,green,immature,lanceolate,leaving,less,light,lobe,long,margin,mm,moderately,narrowly,near,oblong,older,ovate,ovoid,pedicel,pedicellar,peduncle,petiole,pink,puberulent,pubescent,purplish,remnant,ripe,rounded,rugose,shrub,simple,small,sparsely,stamen,stigma,stripe,style,subcordate,subcoriaceous,tip,tree,triangular,truncate,tube,unbranched,white,wide,x,yellow,young	-3,-44,-47,-pubescent,0.5-1.5,1-,1-1.5,1-3,1.5-10.5,1.5-2,1.5-2.5,2-3,3-4-foliat,3.5-15,5-6,8-15,9-16,aggregate,apart,ape,axe,blade,cell,ciliat,ciliate,connective,cylindrical,directed,distally,eaf,eed,equal,exceeding,fleshy,gland,glandular-puberulen,linear,lon,lower,membranaceous,nearly,nflorescence,nther,obtuse,often,olde,orolla,perfect,pore,presen,present,purpl,rachi,radiu,ruit,slightly,spaced,stalked,stellate,stone,swelling,tal,tem,thecae,time,tomentose,truncat,ud,unit,vary,ympodial	'',[,``,anther,appearance,arrangement,bark,branch,bud,characteristic,colour,corolla,corrugation,distal,drying,exertion,filament,form,fruiting,giving,glabrousnes,growth,height,history,inflorescence,interjected,lateral,leaf,leaflet,length,life,lobing,midpoint,na,new,number,ovary,per,plant,prickle,primary,pseudostipule,ray,seed,shape,size,stem,surface,terminal,texture,thicknes,type,value,variation,vein,width,{,}
489	wfo-0001031756	invalid_json_followup	186	147	103	83	44	0.554	.1,.5,.8,/2,0,0-2,0.02-0.2,0.4-1.6,0.5-1,0.5-1.3,0.6-1.2,0.6-1.6,0.7-1.7,0.8-1,1-4,1.5-2,1.8-2.5,3-15,3-5,3-7,7-10,9-14,abaxially,anther,apart,apex,apically,articulated,bark,base,berry,calyx,cm,color,concolorous,conical,cordate,deltate,densely,diameter,drying,entire,erect,evenly,filament,finely,flattened-reniform,fruit,fruiting,glabrous,gray,green,inflated,known,leaf,lobe,long,margin,mature,mauve,midpoint,mm,moderately,older,orange-brown,ovate,pair,pale,pedicel,peduncle,per,petiole,pitted,poricidal,prickle,prickly,primary,ray,red-brown,rounded,shoot,short,shrub,simple,spaced,sparsely,spherical,stellate-pubescent,stem,straight,style,surface,tapering,terminal,tip,truncate,tube,vein,way,white,wide,yellow-green,young	-1,-5,0-5,0.1,0.15-0.25,0.2,00,1-1.8,1-2,1-3,1.5-3.5,1/2,1/3,10,2-6,4-5,4.5,5-merous,6-9,accrescent,acut,alyx,apar,apparently,blade,branched,broad-deltate,chartaceous,connivent,curved,eaf,eed,elongating,enclosing,equal,eye,flower,free,fully,glabrescent,glabrou,herbaceous,infructescence,invested,lobed,longer,lower,naked,nflorescence,one,open,orolla,oung,pendulous,perfec,pericarp,perpendicular,plurifoliat,porrect,portion,prickl,ruit,scandent,scar,sessile,shorter,slender,small,smooth,spreading,stalk,stalked,stellate,tamen,terete,time,trichome,unarmed,unit,variously,vary,visible,ympodial	'',[,``,acute,arrangement,branch,bud,characteristic,colour,corolla,corrugation,distal,exertion,form,glabrousnes,growth,height,history,inflorescence,interjected,lateral,leaflet,length,life,lobing,na,new,number,ovary,perennial,plant,pseudostipule,seed,shape,size,stigma,texture,thicknes,type,value,variation,width,{,}
490	wfo-0001031786	invalid_json_followup	209	162	120	89	42	0.574	.5,/3,0-20,0.1-0.4,0.2-2.5,0.5-1.5,0.7-1,0.7-1.6,0.7-4,0.8-1.2,1,1-3,1-6,1.2-1.6,1.5-1.9,1.5-2.5,2-13,2-3,2-7,2.5-3.5,4-5,6-8,acute,almost,anther,apart,apex,apparently,articulated,bark,base,becoming,berry,branched,calyx,cell,chartaceous,cm,concolorous,connivent,cuneate,curved,dark,deep,diameter,drying,elliptic,erect,evenly,filament,flattened-reniform,fruit,fruiting,glabrous,gray,green,herb,lateral,leaf,length,lobe,lobed,long,margin,maturity,mauve,membranous,midpoint,minute,mm,orange,orange-brown,outline,ovate,pair,pale,pedicel,peduncle,per,petiole,pit,poricidal,prickle,prickly,primary,raised,ray,red,red-brown,reflexed,scandent,shiny,shrub,simple,small,smooth,sometimes,spaced,sparsely,spherical,spreading,stellate-pubescent,stem,stigma,straight,style,surface,tapering,terete,tip,trichome,truncate,tube,vein,way,weakly,white,wide,yellow-orange,young	-5,.4,/2,0,0-2,0-3,0-5,0.1,0.2-0.3,0.25-0.5,0.8,1-2,1-4,1/3-1/2,2-8,3-4,3-5.5,5-7,5-merous,8-12,abaxially,acut,alyx,ame,apar,apically,blade,c.,clavat,deltate,densely,distance,eaf,eed,elongating,equal,extending,eye,filiform,flattened,flower,free,glabrescent,gray-brow,herbaceous,inconspicuous,infructescence,lon,longer,lower,mature,midvein,naked,nflorescence,obtuse,older,one,open,orolla,oung,pendulous,perfec,pericarp,plurifoliat,porrect,portion,prickl,rounded,ruit,scar,sessile,shorter,side,slightly,stalk,stalked,stellate,tamen,tertiary,thick,time,unarmed,unit,variously,vary,venation,visible,woody,ympodial	'',[,``,arrangement,branch,bud,characteristic,clavate,colour,corolla,corrugation,distal,exertion,form,glabrousnes,gray-brown,growth,height,history,inflorescence,interjected,leaflet,life,lobing,na,new,number,ovary,plant,pseudostipule,seed,shape,size,terminal,texture,thicknes,type,value,variation,width,{,}
491	wfo-0001031793	success	188	114	84	104	30	0.447	-4,.5,1-1.5,1-2,1.5-4,10-15,13-20,15-20,2-3,2-5,3-8,8-11,abundant,acuminate,aging,almost,anther,apex,armed,articulated,base,berry,black,branched,broadly,brownish,capitate,cm,cuneate,densely,diameter,distal,elliptic,extra-axillary,filament,flattened,flower,forked,fruit,globose,hair,inflorescence,interpetalar,leaf,lobe,lobing,long,many,margin,midpoint,minutely,mm,oblong-lanceolate,orange-yellow,orbicular-ovate,pedicel,peduncle,per,petiole,porocidal,prickle,pubescent,rounded,scattered,shallow,shrub,simple,size,small,stellate,stellate-pubescent,stem,stigma,style,surface,tip,tissue,tree,unbranched,well-developed,white,x,yellow,yellow-brown	0,1,1-3,1-8,1.5-2,1/3,1/4,1/5,20,26,3-4,3/4,4,40,5-merous,7,absent,accrescent,acumen,acute,adult,alyx,apparently,aspect,axe,ba,bilobe,blade,branche,broad,brown,calyx,central,chartaceous,cut,difoliate,eaf,eed,elongatin,erec,erect,evident,extreme,ferrugineous,fruiting,geminat,general,glandular,homostylou,larger,linear,lon,lower,main,maturing,midrib,mostly,mucilaginous,nflorescence,oblique,obtuse,often,older,orolla,ovate,perfect,pore,porrect,principal,rachi,reddish,reduced,reticulation,ruit,rusty,scarcely,sessile,side,similar,single,sinus,smaller,sparsely,stellate-pubescen,stipitate,stout,tall,tamen,tem,testa,thickened,triangular,triangular-acuminat,trichome,tube,unarmed,unit,upward,usually,uvenile,vary,way,woody,ympodial	arrangement,bilobed,characteristic,colour,corolla,form,growth,height,history,lateral,leaflet,length,life,na,number,ovary,perennial,plant,primary,pseudostipule,ray,seed,shape,terminal,texture,thicknes,type,variation,vein,width
492	wfo-0001031829	success	138	105	76	62	29	0.551	.25,.5,0.7-1,1-2,1.3-1.5,1.5-3.5,2-4,3-5-flowered,3/4,4-8.5,absent,acute,anther,apex,bark,base,berry,branched,broadly,calyx,capitate,cm,conical,corolla,deflexed,densely,drying,elliptic,exserted,filament,fruiting,glabrous,globose,green,greenish-brown,growth,immature,inflorescence,known,leaf,leathery,like,lobed,long,margin,minute,mm,occasionally,often,ovary,pedicel,petiole,pubescent,revolute,shaped,shrub,simple,size,soft,somewhat,sparsely,stem,stigma,style,surface,tapering,tear-drop,thick,trichome,tube,uniseriate,vein,way,white,x,yellowish	0.5-2.1,1,1.5-2,1.5-2.5,1.5-4.5,4-4.5,7-10,abaxially,adaxial,adaxially,along,anthesi,ape,apiculae,bae,crystalline,denser,dia,differing,difoliate,eaf,edicel,eed,epidermi,erect,free,geminat,glabrat,large-celled,lateral,lobe,lon,lower,main,major,minor,minutely,nflorescence,older,opposite,overlappin,packed,pair,papillo,papillose,planar,pore,poricidal,portion,quadrate,ruit,scar,tall,tip,tub,tuft,ud,unit,waxy,woody,ympodial,young	alternate,arrangement,branch,bud,characteristic,colour,corrugation,diameter,exertion,form,fruit,glabrousnes,height,history,length,life,lobing,na,new,number,peduncle,per,perennial,plant,primary,seed,shape,texture,type
493	wfo-0001031832	invalid_json_followup	232	162	120	112	42	0.517	0.1-0.3,0.2-0.6,0.2-1.5,0.3-3,0.7-1.6,0.7-2,0.8-1.2,1-12,1.2-1.6,1.2-2,1.7-4,14,2-3.6,2-6,2.8-4.8,3-6.5,3-7,4-20,7-10,8-25,9,abaxially,acuminate,acute,adaxially,anther,anthesi,apart,apex,articulated,attenuate,bark,base,becoming,berry,blunt-tipped,branch,branched,brown,brownish,bud,bullate,calyx,closely,cm,conical,continued,corolla,dark,deltoid,diameter,due,entire,exserted,ferrugineous,filament,fleshy,flower,fruit,fruiting,glabrescent,glabrous,globose,granular-tomentose,green,greenish,growth,honeycombed,lanceolate,lateral,leaf,length,lobe,margin,midvein,mm,mostly,oblanceolate,oblong,obovoid,obtuse,orbicular,ovate,pale,pedicel,peduncle,persistent,petiole,pitted,probably,ray,reniform,reticulate-punctate,ripe,rough,scabrous,shrub,side,simple,somewhat,soon,spaced,stem,stigma,style,suborbicular,surface,terete,terminal,time,tree,tube,unarmed,vein,violet,weakly,white,x,yellow,yellowish	-8,.5-1,/50-1/10,0-150,0.3-0.8,0.7-1.5,1.1-2.4,1.2-2.5,1.3-4.2,1.5-4,1.8-4,1/2-3/4,2-4,2.5-6.5,3.5-7,4-7,5-21,5.5-10,accrescent,ag,apical-lateral,apice,apparently,axe,axillary,ba,basal,blade,blister,capitat,chartaceous,connate,decurrent,dehiscing,directed,eaf,eed,evident,extend,few-rayed,forming,free,glabrescen,hair,half,high,indument,inserted,introrse,lackin,large,line,lobed,long,long-,longer,longitudinal,lower,m.,main,minute,mixed,multangulate,nearly,nflorescence,occasionally,older,orolla,partly,perfect,plurifoliate,pore,porrect-stellat,porrect-stellate,pubescence,pubescent,rachi,rather,relatively,rotate-stellate,ruit,runk,sessile,short-,short-stalked,slit,smooth,sometimes,sparingly,sparse,splitting,stamen,stellate-pubescent,stipitate-glandular,subcampanulate,suture,swelling,tamen,testa,thick,thick-stalked,toward,translucent,unarme,unit,usually,vary,way,whitish,wide,ympodial,young	'',[,``,arrangement,capitate,characteristic,colour,corrugation,distal,drying,exertion,form,glabrousnes,height,history,inflorescence,interjected,leaflet,life,lobing,midpoint,na,new,number,ovary,per,perennial,plant,prickle,primary,pseudostipule,seed,shape,size,texture,thicknes,type,value,variation,width,{,}
494	wfo-0001031834	success	150	113	64	86	49	0.427	0.5,0.5-3,0.5-3.5,0.6-1.4,0.8-1,0.8-1.3,1.5,1.6-2,1.9-6.5,2/3,6-7,6.5-14,acuminate,acute,anther,apex,base,berry,calyx,cm,corolla,decurrent,deltoid,dia,filament,flattened-reniform,fruit,fruiting,globose,green,greenish-yellow,leaf,less,lobe,margin,minutely,mm,ovary,ovate,pale,papillose,pedicel,petiole,pitted,pubescent,scabrous,shaped,shrub,simple,slender,sparsely,stem,stigma,style,surface,tan,tapering,tear-drop,tube,vein,way,white,x,yellow	.5,0.5-1,0.9-1.4,1,1.5-4,2.9-7,accrescent,across,anthesi,apar,apically,apiculate,appear,attenuate,bi-cellular,borne,campanulate,covered,deciduou,deciduous,deflexed,depression,difoliate,eaf,edicel,eed,expanded,eye,few-flowered,free,geminat,glabrou,glabrous,hook,hooked,incrassate,lamina,larger,leaving,like,lobed,lon,long,lower,major,markedly,middle,minor,minute,mound-like,multicellular,naked,nflorescence,often,opposite,papillo,persistent,planar,pore,poricidal,portion,proximal,ruit,scar,short,slightly,small,soon,spaced,speck,straight,tall,tip,trichome,tufted,ud,unevenly,uni-,uniseriate,unit,upper,usually,widest,woody,ympodial,young	2,alternate,appearance,arrangement,bark,border,branch,bud,characteristic,colour,corrugation,diameter,distal,drying,exertion,form,giving,glabrousnes,growth,height,history,inflorescence,interjected,lateral,leaflet,length,life,lobing,midpoint,na,new,number,peduncle,per,perennial,plant,prickle,primary,pseudostipule,ray,seed,shape,size,terminal,texture,thicknes,type,variation,width
495	wfo-0001031842	success	161	155	113	48	42	0.702	.4,.5,.75,0.1-0.5,0.6-1,0.7-1,1,1-1.5,1-1.8,1-3.5,1.5-2,10-20,10-30-flowered,2-10,2-3,2.5-3,3-8,3/4,4.5-6,7-9,acute,anther,anthesi,apex,attenuate,axil,bark,base,bearing,beneath,berry,bi-lobed,brown,calyx,capitate,cm,corolla,cusp,dark,decurrent,deeply,dia,difoliate,dry,ellipsoid,elliptic,exsertion,filament,flattened-reniform,fruiting,glabrous,globose,green,later,lateral,leaf,leaf-opposed,lobe,lobed,long,main,margin,minor,minutely,mm,near,new,often,onto,opposite,ovary,overtopping,pale,papillose,pedicel,petiole,pitted,pore,poricidal,quadrate,reddish-resinous,reflexed,shaped,shiny,shoot,shrub,simple,size,slender,somewhat,soon,specimen,stem,stigma,strongly,style,surface,tapering,tear-drop,terminal,time,tip,tree,trichome,tube,tuft,uniseriate,unit,vein,way,white,x,young	.1,0.5-1,0.5-2,10-12,2.5-6,9-15,apart,ba,beginning,cup-shaped,deflexed,densely,differing,eaf,edicel,eed,exserte,free,geminat,incrassate,inflorescenc,irregularly,lon,lower,major,middle,nflorescence,older,one,pair,paler,papillo,portion,prominent,pubescent,reddish,ruit,scar,spaced,sparsely,straight,tall,ud,widest,woody,yellowish,yellowish-whit,ympodial	appearance,arrangement,border,bud,characteristic,colour,diameter,distal,exertion,exserted,form,fruit,geminate,giving,glabrousnes,growth,height,history,inflorescence,interjected,leaflet,length,life,lobing,midpoint,na,number,peduncle,per,plant,prickle,pseudostipule,ray,seed,shape,sympodial,texture,thicknes,type,variation,width,yellowish-white
496	wfo-0001031843	invalid_json_followup	245	162	118	127	44	0.482	.5,.6,0.5-1,0.6-1.2,1-7,1.2-2,1.2-2.2,1.5,1.5-2,1.8-2.5,1/6-1/4,2-3,2.5,3-4,3-7,4-12,45-60Â°,5-10,5-12,6-9,acuminate,almost,along,anther,anthesi,apex,apically,attenuate,bark,base,berry,black,branch,branched,branching,brown,calyx,canaliculate,capitate,caudate,cm,completely,conical,corolla,cupular,dark,deeply,diameter,dilated,discoid,discolorous,distributed,drying,dull,equal,evenly,filament,finely,flower,forming,fruiting,glabrous,green,honeycomb,leaf,length,liana,lobe,long,loop,main,margin,midvein,mm,oblique,oblong,obovate,orange,orange-brown,orange-yellow,pair,partly,pattern,pedicel,peduncle,petiole,pitted,primary,pubescent,red,reddish,rounded,seed,shiny,shortly,shrub,slender,slightly,smooth,sometimes,sparsely,spheroidal,spreading,stem,stigma,strongly,style,surface,terminal,thick-chartaceous,tube,twice,unarmed,vein,violet,weakly,x,young	.2,.3,0-4,0.2-2,0.4-0.5,0.5-1.5,0.7-1.2,0.7-2,0.8-2,1-2,1mm,2-4,abaxially,accrescent,adaxially,age,always,alyx,apar,apice,apparently,appressed,around,articulated,basal,becoming,broadly,clearly,collapsing,curved,cuspidate,delineated,deltoid,dendritic,density,detaching,domatia,eaf,eed,ellipsoi,entire,erect,even,eye,fertilisation,fine,flat,flexuous,free,hand,inner,largely,leave,len,lengthening,lignified,like,lobed,longitudinally,looping,lower,m.,much,multiseriate,naked,network,never,nflorescence,nther,obscure,older,opening,orolla,outline,ovate,papillo,part,pendulous,perfec,pericarp,pit,plurifoliat,pore,poricidal,portion,present,prominent,pronounced,protruding,rachi,raised,rarely,recurve,reveal,ribbed,ridged,ruit,scar,see,shallowly,side,simple,sinus,small,smaller,soon,straight,stump,surfac,tearing,tertiary,thickened,thin,tip,trichome,tuft,ud,unit,variable,vary,venation,visible,white,wide,wider,without,ympodial	'',[,``,arrangement,bud,characteristic,colour,corrugation,distal,ellipsoid,exertion,form,fruit,glabrousnes,growth,height,history,inflorescence,interjected,lateral,leaflet,life,lobing,midpoint,na,new,number,ovary,papillose,per,plant,prickle,pseudostipule,ray,shape,size,texture,thicknes,type,value,variation,width,{,}
497	wfo-0001031852	success	155	118	70	85	48	0.452	0.1-1,0.5-1.3,0.5-3,1-4,1-4.2,1-9,1.3-2.5,1.4-3,12-35,2-5.5,2.6-9.5,3.5-10,4-10,4-6,5-15,7-,9-11,acuminate,acute,apex,base,branched,calyx,cm,conical,corolla,cyme,decurrent,diameter,dichasial,dichasially,distal,ebracteate,elliptic,elliptic-lanceolate,filament,green,green-white,herbaceous,interjected,lanceolate,lateral,leaf,leaflet,light,lobe,long,mm,monochasial,mucilaginous,oblique,oblong,odd-pinnate,ovate-elliptic,ovoid,pedicel,peduncle,perennial,petiole,plant,pubescent,seed,sessile,size,stigma,style,terminal,throughout,white,wide	-8,1-,1.5-3,2-3,3-4,3-6-foliat,3-9,4-,4-5,abaxially,abruptly,absen,acumen,adaxially,apical,apically,apiculate,articulate,attenuate,cell,connate,covering,dehiscent,digestion,diminishing,dorsally,eaf,edge,eed,emoval,enzyme,exceeding,flat,flower,folded,forked,generally,globo,hair-like,half,honeycomb,introrse,living,lon,lower,lunat,make,maturing,nflorescence,nther,often,orolla,pair,pattern,perfect,plan,poricidally,proximal,rachi,reveal,ruit,seudostipule,short,shortly,slit,specimen,stamen,stellate,straight,tal,tem,testal,thick,throughou,toward,tuber-bearing,typically,unit,vary,wall,white-crea,without,yellow,ympodial,Â¼	absent,anther,appearance,arrangement,bark,border,branch,bud,characteristic,colour,corrugation,drying,exertion,form,fruit,fruiting,giving,glabrousnes,globose,growth,height,history,inflorescence,length,life,lobing,margin,midpoint,na,new,number,ovary,per,prickle,primary,pseudostipule,ray,shape,stem,surface,texture,thicknes,tube,type,variation,vein,white-cream,width
498	wfo-0001031864	invalid_json_followup	140	146	96	44	50	0.686	.2,.25,.5,0.2-0.5,0.4-3,0.5-13.5,0.6-3.5,0.6-4,0.7-0.8,0.8-1,1-1.2,1-1.8,1-2,1-5,1-6.5,1.2-1.5,1.5,1.5-10,1.5-2.5,15-60,2-3,2.5-6,3-3.5,3-pinnate,acuminate,acute,adaxially,anther,apex,apiculate,base,berry,calyx,chartaceous,ciliate,clavate,cm,cuneate,deltoid,dense,diameter,entire,extra-axillary,filament,fine,flattened,fleshy,flower,fruit,fruiting,glabrous,hair,herbaceous,lateral,leaflet,lenticular,lobe,long,margin,middle,minutely,mm,moderately,oblique,ovoid-deltoid,papillose,pedicel,peduncle,petiole,pointed,pubescence,pubescent,rotate,rounded,sand-punctate,scattered,short,slender,slightly,sparsely,stem,stigma,style,surface,tip,trichome,truncate,tube,unbranched,unknown,vein,vine,violet,wide-diameter,widely,x	0.5-4,1-3,2,5-15,5-9,5-merous,7.5-8,abaxially,accrescent,alyx,apar,apical,axe,blade,c.,capitat,color,densely,eaf,eed,emarginate,glabrou,like,lon,lower,m.,near,nflorescence,nternode,orolla,perfec,petiolule,plurifoliat,pubescenc,rachi,ruit,spaced,tamen,tem,terrestria,typical,unit,vary,ympodial	'',[,``,arrangement,bark,branch,bud,cal,capitate,characteristic,colour,corolla,corrugation,distal,drying,exertion,form,glabrousnes,growth,height,history,inflorescence,interjected,leaf,length,life,lobing,midpoint,na,new,number,ovary,per,plant,prickle,primary,pseudostipule,ray,seed,shape,size,terminal,texture,thicknes,type,value,variation,width,{,}
499	wfo-0001031864	invalid_json_followup	148	148	96	52	52	0.649	.2,.25,.5,0.4-3,0.5-13.5,0.6-3.5,0.6-4,1-1.2,1-1.8,1-2,1-5,1-6.5,1.5,15-60,2-3,3-3.5,3-5-celled,3-pinnate,5-15,5-9,abaxially,absent,acuminate,acute,adaxially,anther,apart,apex,apiculate,articulated,basally,base,blue-purple,calyx,center,ciliate,clavate,cm,connivent,cordate,cuneate,deltoid,dense,diameter,entire,extra-axillary,filament,fine,fleshy,flower,fruit,fruiting,glabrous,hair,herb,interjected,lateral,leaflet,lenticular,long,margin,minutely,mm,oblique,oblong,papillose,pedicel,peduncle,pubescence,pubescent,rotate,rounded,scattered,short,simple,slender,somewhat,spaced,sparsely,stigma,style,surface,terrestrial,thick,tip,truncate,tube,unbranched,uniseriate,unknown,weakly,widely,wiry,woody,x,yellow	0.5-4,1-3,1.2-1.5,1.5-2.5,2,2.5-6,5-merou,7.5-8,accrescent,ag,alyx,apical,apparently,axe,ba,blade,capitat,color,densely,directed,distally,eaf,eed,emarginate,equal,etiole,geminat,large,lobe,longitudinal,lower,m.,near,nflorescence,node,opening,orolla,perfect,petiolule,plurifoliate,pore,pubescenc,rachi,rooting,slightly,slit,tamen,tem,trailing,unit,vary,ympodial	'',[,``,arrangement,bark,branch,bud,capitate,characteristic,colour,corolla,corrugation,distal,drying,exertion,form,glabrousnes,green,growth,height,history,inflorescence,leaf,length,life,lobing,midpoint,na,new,number,ovary,per,petiole,plant,prickle,primary,pseudostipule,ray,seed,shape,size,stem,terminal,texture,thicknes,type,value,variation,vein,width,{,}
500	wfo-0001031871	invalid_json	185	128	95	90	33	0.514	0.4-2,0.6-1.2,1-2,1.4-2.1,1.5-11,1.5-2,1.5-2.1,1.6-2.7,2-3,2-4,2.9-6,3-10,3.5-4,33-40,36-44,4-6,4-7,5.4-12.3,6-12,6-7,6.5-20.5,7-9,7.5-23,anther,berry,blade,brownish,cell,chartaceous,clavate,cm,condition,corolla,covering,dark,deep,diameter,dot,drying,end,filament,flower,fresh,fruit,glabrous,globose,green,green-white,greenish,hair,hair-like,herb,homostylous,interjected,lateral,leaflet,lobe,long,make,medium,mm,mottled,mucilaginous,narrowly,odd-pinnate,one,ovoid,pedicel,peduncle,petiole,placed,plant,purple,ripe,seed,short,size,stigma,style,subglabrous,terminal,testal,thick,throughout,tiny,tube,tuber,typically,wall,wet,white,whitish,wide,winged,x	14-22,3-4,3-5,5-merou,abaxially,acumen,acute,adaxiall,adaxially,ag,alyx,apart,apex,apparently,articulated,asymmetric,attenuate,axe,axillary,base,basiscopic,bud,capitat,connivent,digestion,distal,dorsally,eaf,edge,eed,elliptic,enzyme,erec,exceeding,flat,folded,forked,geminat,generally,glabrou,hal,half,high,honeycomb-shaped,lanceolate,lengthening,linear,living,lower,nflorescence,orbicular,orolla,ovate,pair,perfect,petiolulate,plurifoliate,pore,poricidal,pubescent,removed,rotate,round,rounded,ruit,sessile,seudostipule,side,slit,sometimes,spaced,specimen,stamen,stolo,straight,subequal,subglabrou,subtending,symmetric,tall,tamen,tem,tip,tissue,tri-,unit,usually,vary,yellow,ympodial	'',5-merous,[,``,abaxial,adaxial,arrangement,calyx,capitate,characteristic,colour,erect,form,growth,height,history,inflorescence,leaf,length,life,ovary,placement,pseudostipule,shape,staman,stem,stolon,surface,texture,type,value,{,}
501	wfo-0001031876	success	140	111	64	76	47	0.457	.1,.5,0.5,0.8-1,1-1.6,1.5-2.2,27-35,9-15,acute,anther,apex,arc,bark,base,berry,bright,calyx,cm,corolla,cup-like,decurrent,dia,elliptic,filament,fruiting,glabrous,globose,green,lateral,leaf,less,lightly,lobe,long,long-acuminate,margin,mm,nearly,oblanceolate,oblique,ovary,papillose,pedicel,petiole,primary,recurved,reflexed,shaped,shrub,simple,slender,slightly,stem,stigma,straight,style,tapering,tear-drop,tube,vein,white,winged,x,yellow	0-flowered,1,1-1.5,1-4,3,5,?,across,anthesi,apiculate,arising,ba,bearing,beneath,closely,convergence,corky,differing,eaf,edicel,eed,erect,family,flower,free,glabrou,granular,greenish-yellow,immature,irregularity,known,lenticellat,lobed,lower,main,major,melastomataceae,member,middle,minute,minutely,nflorescence,often,opposite,otherwise,overlappin,pair,parallel,perpendicular,persistent,point,pore,poricidal,portion,present,prominent,raised,resemble,ruit,running,scar,secondary,spaced,styl,tall,time,tip,ud,unifoliat,unit,venation,wide,widest,woody,ympodial,young	appearance,arrangement,border,branch,bud,characteristic,colour,corrugation,diameter,distal,drying,exertion,form,fruit,giving,glabrousnes,growth,height,history,inflorescence,interjected,leaflet,length,life,lobing,midpoint,na,new,number,peduncle,per,plant,prickle,pseudostipule,ray,seed,shape,size,surface,terminal,texture,thicknes,type,unifoliate,variation,width,ye
502	wfo-0001031877	success	216	150	111	105	39	0.514	+,0.3-,0.3-1,0.3-1.2,0.6-1.2,1-1.5,1-3,1-3.5,1.1-,1.5,1.5-1.9,1.8-5,2,2.5,3-5,6-8,abruptly,acuminate,acute,adaxially,angled,anther,anthesi,apex,basal,basally,base,berry,bright,brown,calyx,capitate,clavate,cm,conical,connivent,corolla,deltate,densely,diameter,distal,ellipsoid,ellipsoidal,entire,exserted,filament,flattened,fruit,fruiting,glabrous,globose,greenish,growth,hastate,later,lateral,line,lobe,lobed,long-acuminate,loosely,margin,minute,minutely,mm,nearly,new,often,outline,pair,pale,pedicel,peduncle,per,petiole,pitted,plant,plump,primary,pubescent,purple,red,reddish,reniform,ripe,scrambler,seed,simple,slender,slightly,somewhat,sparsely,stellate,stem,stigma,strongly,style,surface,terminal,tinged,tip,triangular,trichome,truncate,tube,uniseriate,usually,vein,vine,white,x	.3,.5,0.2,0.5,0.5-1,0.8-0.9,1,1-4,1.5-2,2-,3-6,3.5-4,5-merou,6-10,abaxially,adaxiall,ag,along,alyx,apar,apparently,ark,articulated,ascending,cell,deep,deflexed,dried,eaf,eed,enlarged,erect,especially,exposed,eye,fleshy,flower,free,furcate,green,ilament,impressed,internal,irregularly,lamina,lengthening,like,linear,long,lower,material,mature,midvein,nflorescence,occasionally,older,orolla,papillate,papillo,parallel,part,perfect,pericarp,plurifoliat,pointing,pore,poricidal,portion,prominently,pubescence,purplish,rectangular,reflexed,rest,rounded,ruit,scar,semi-woody,shiny,short,shorte,silky,sinuate,sleeve,slit,sometimes,spaced,spreadin,subshru,tem,testal,thin,twinin,ud,uniformly,unit,upper,vary,visible,wall,weak,woody,yello,ympodial,young	2-6-10,appearance,arrangement,bark,border,branch,bud,characteristic,colour,corrugation,drying,exertion,form,giving,glabrousnes,height,history,inflorescence,leaf,leaflet,length,life,lobing,midpoint,na,number,ovary,perennial,prickle,ray,shape,size,sparingly,texture,thicknes,type,variation,width,yellow
503	wfo-0001031880	invalid_json_followup	180	151	104	76	47	0.578	.5,0.5-2,0.7-0.8,1,1-1.3,1-1.5,1.5,2-3,2-9,2.5-8,3-3.5,3-foliate,3-lobed,4,4-8,5-6,6-9,acuminate,acute,anther,anthesi,apex,base,berry,broadly,brown,calyx,capitate,ciliate,cm,conical,cordate,corolla,crenate,cup-shaped,curved,dark,densely,diameter,ellipsoid,elliptic,entire,erect,exerted,filament,flattened,fleshy,flower,fruit,fruiting,gland-tipped,glandular,globose,green,herb,heteromorphic,hollow,inflorescence,internodal,irregularly,leaf,less,lobe,long,margin,minutely,mm,orange,ovary,ovate,ovoid,pair,pale,papillose,pedicel,peduncle,petiole,pitted,primary,pubescent,purple,red,reddish,reflexed,shallowly,simple,slender,slightly,stem,stigma,strongly,style,subshrub,surface,terminal,toothed,triangular,trichome,truncate,tube,upward,vein,x,â5	0.5-1,1-2,2,2-4,3-4-pluri-foliate,5,7-9,abaxially,adaxially,age,apart,basal,bearing,becoming,c.,cell,color,crowded,eaf,edicel,eed,enlarged,flush,free,glabrous,gland,growing,horn,lamina,lengthening,lon,longest,lower,markedly,mature,maturit,mid-length,middle,narrowly,near,nflorescence,nodding,papillo,pericarp,plan,pore,poricidal,portion,pubescen,rachi,ruit,scar,shortest,single,slit,sometimes,spaced,sparse,sparsely,spreading,straight,testal,thin,tip,ud,unicellula,uniseriate,unit,unlobed,upper,wall,widely,widest,woody,yellow,ympodial	'',[,``,appearance,arrangement,bark,branch,bud,character,characteristic,colour,corrugation,distal,drying,exertion,form,giving,glabrousnes,growth,height,history,interjected,lateral,leaflet,length,life,lobing,midpoint,na,new,number,per,plant,prickle,pseudostipule,ray,seed,shape,size,texture,thicknes,type,value,variation,width,{,}
504	wfo-0001031881	invalid_json	168	115	87	81	28	0.518	.5,0.2,0.5-0.7,1-1.3,1-1.5,1-7,1.2-6,1.5-2.5,1/3,2,3/4,5-6,absent,anther,base,beneath,branch,branched,broadly,brown,bud,calyx,campanulate,capitate,cm,corolla,dark,decurrent,deflexed,densely,dia,distal,dry,ellipsoid,elliptic,erect,exserted,filament,fruit,fruiting,glabrous,globose,golden,golden-pubescent,green,inflorescence,leaf,lightly,lobed,long,material,minute,minutely,mm,obovate,opposite,ovary,ovoid-reniform,papillose,pedicel,petiole,pitted,pore,poricidal,puberulent,pubescent,shape,shaped,shrub,size,small,soon,sparsely,stem,stigma,style,surface,tear-drop,tip,tree,tube,usually,way,white,winged,x,young	0.1-0.5,0.2-0.6,0.4-1,0.5-1,10-12,10-30,2-9,3-19,3.5-4,7-14,acute,along,anthesi,apar,apex,apparent,attenuate,axil,ba,bark,constriction,deltoid,differing,difoliate,drying,eaf,edicel,eed,either,evenly,fleshy,free,geminat,golden-puberulent,greyish-brow,incrassate,inflorescenc,junction,lateral,like,lobe,lon,lower,main,major,margin,maturity,middle,midrib,minor,nflorescence,occasionally,older,one,orbicular,pair,papillo,planar,portion,puberulen,rest,rounded,ruit,scar,simple,slender,slightly,somewhat,spaced,straight,strong,tall,tapering,trichome,ud,uniseriate,unit,vein,widest,woody,ympodial	'',[,],``,abaxial,adaxial,alternate,arrangement,characteristic,colour,diameter,exertion,form,growth,hair,height,history,length,life,lobing,perennial,plant,seed,texture,type,value,{,}
505	wfo-0001031886	success	169	128	83	86	45	0.491	-25,-9,0.5-1,1-1.5,1-4,1.2-2.5,1.5-2,10-40,2-2.5,2-4,2-5,2.0-2.5,3-6,3.0,4-15,5-10,5-6,5-ridged,6-20,6-8,9-10,absent,acuminate,anther,anthesi,apex,attenuate,axillary,base,berry,brown,bud,calyx,capitate,cm,completely,conical,corolla,diameter,elliptic,filament,fruit,fruiting,glabrous,green,greenish,lateral,leaflet,lobe,long,margin,minutely,mm,nearly,occasionally,ovary,ovoid-reniform,pair,papillate,papillose,pedicel,per,petiole,pinnate,poricidal,primary,reflexed,rugose,seed,shape,shrub,simple,somewhat,stigma,strongly,style,surface,terminal,tip,tube,vein,white,x	-1.2,-4,.5,0,0.1,2,2-3,20-30,4,abaxially,abruptly,adaxially,along,anticlinal,arising,axil,basal,beak,bearing,bright,broadly,cell,clavat,commonly,deltate,distinctly,dry,eaf,earl,edicel,eed,either,em,epidermal,equal,erec,exserted,fleshy,flower,free,half,irregular,lanceolate,le,lobed,lower,narrowed,near,nflorescence,noddin,node,oblique,open-conical,papillae,petiolule,portion,projection,purple,rachi,raised,reddish,ripe,ruit,scar,scattered,similar,single,sinuous,smaller,smelling,sparse,specimen,thickening,time,triangular,trichome,tub,ud,unifoliat,uniseriate,unit,usually,wintergreen,without,woody,ympodial	1,1-1.2,40,appearance,arrangement,bark,border,branch,characteristic,clavate,colour,corrugation,distal,drying,exertion,form,giving,glabrousnes,growth,height,history,inflorescence,interjected,leaf,length,life,lobing,midpoint,na,new,nodding,number,peduncle,perennial,plant,prickle,pseudostipule,ray,size,stem,texture,thicknes,type,variation,width
506	wfo-0001031895	invalid_json_followup	160	147	100	60	47	0.625	-1.5,0.5,1-1.5,1.5-2,1.5-3,1.5-6,2-2.5,2.5-3,3-10,3-4,3-8,3.5-6,4,4-5,4.5-16.5,5,6-7,6-9,acute,anther,anthesi,apex,attenuate,bark,base,beneath,berry,bluish,broadly,calyx,campanulate,capitate,cm,completely,conical,corolla,cup-shaped,dark,diameter,drying,ellipsoid,elliptic,entire,erect,filament,fleshy,flower,fruiting,glabrous,globose,green,growth,immature,leaf-opposed,leafy,less,lobe,margin,matte,minutely,mm,new,occasionally,older,once-branched,ovary,ovoid,pair,pale,pedicel,peduncle,petiole,pitted,planar,poricidal,primary,reddish,reniform,revolute,shiny,shoot,short,shrub,simple,slightly,somewhat,stem,stigma,stout,style,surface,tan,terminal,tip,tube,vein,violet,way,white,x	0.5-1,0.5-2,5-6,5-8,age,apparently,articulating,blac,cell,deltate,densely,eaf,eed,emarginated,enlarging,erec,exerted,exfoliating,expand,fragrant,free,glabrou,inflorescenc,intensely,irregular,leaving,lengthening,lobed,lower,nflorescence,overlapping,papillat,papillate,part,patch,peeling,peg,perfect,pericarp,plurifoliat,pore,portion,ruit,scar,sinuate,slender,slit,small,straight,strongly,testal,thick,thin,tree,tub,ud,unit,woody,ympodial,Â¼-1/2	'',[,\u00bc-1/2,``,appearance,arrangement,black,branch,bud,characteristic,colour,corrugation,distal,exertion,form,fruit,giving,glabrousnes,height,history,inflorescence,interjected,lateral,leaf,leaflet,length,life,lobing,midpoint,na,number,per,plant,prickle,pseudostipule,ray,seed,shape,size,texture,thicknes,type,value,variation,width,{,}
507	wfo-0001031897	success	264	145	122	142	23	0.462	.1,.8,0.1-0.5,0.15,0.5-1,0.5-3,0.6,0Â°,1.1,1.3-2,1.5-8,1.7-3,13,2-4,4-5,6-9,absent,acute,almost,along,anther,apex,apically,attenuate,bark,base,berry,black,brachyblast,branch,branched,brown,calyx,chartaceous,clavate,clustered,cm,concolorous,conical,coriaceous,corolla,cuneate,curved,dendritic,densely,diameter,dilated,distributed,dry,drying,dull,elliptic,entire,epiphyte,erect,evenly,eye,faint,filament,fruit,fruiting,glabrous,green,grey,hair,lanceolate,lateral,leaf,light,long,longitudinally,main,margin,mauve,midvein,mm,multicellular,naked,never,obconical,oblong,occasionally,ovoid,pair,pedicel,peduncle,petiole,plant,pointed,primary,pubescent,rarely,reddish,revolute,ribbed,ridged,short,shrub,simple,slender,slightly,smooth,sparse,sparsely,stem,stigma,style,surface,terete,terminal,thick,trichome,tube,unarmed,usually,vein,visible,weakly,white,winged,x,young	.5,0-1,0.2-0.4,0.4-1.1,0.8-1.5,1,1-1.5,1-2,1-2.5,1.5,2/3,462.,5-6,8,abaxial,abaxially,accrescent,adaxial,adaxially,age,alyx,anthesi,apar,apparently,appearing,appendage,arising,aristate,articulated,axillary,bendy,boiteau,cell,clearly,condensed,connate,covering,dark,datum,dehiscing,delineated,dense,developed,developing,development,divided,domatia,dorsal,dorsifixed,eaf,earliest,ed,enlarged,equal,even,except,extending,filiform,fine,flower,foliaceous,free,immature,indistinc,inner,inside,known,lamina,larger,least,lengthening,like,linear,lobe,lobed,longitudinal,looped,lower,m.,margi,membranous,minute,minutely,multiseriate,nflorescence,nther,oblon,obtuse,occasional,one,orange,orange-brown,orolla,outside,ovate,overlapping,papillose,part,partly,pendulous,perfec,pericarp,persisting,plurifoliat,pore,poricidal,portion,prominent,pronounced,protruding,raised,reach,ridge,ruit,scar,secondary,see,seen,shoot,side,sinus,smaller,smoot,sometimes,stump,subulate,sunk,tearing,tertiary,thin,tip,toward,ud,unbranched,unicellular,unit,vary,venation,well-developed,wide,wrinkle,ympodial	arrangement,bud,characteristic,colour,exertion,form,growth,height,history,inflorescence,length,life,lobing,na,number,ovary,per,perennial,seed,shape,size,texture,type
508	wfo-0001032157	invalid_json_followup	136	134	86	50	48	0.632	.5,.75,0.25,0.6-1,0.75-1,1-3,1.9-2.2,2-3,2.2,3-6,5-15-flowered,5-9,7-9,9-17,acute,anther,apex,bark,base,becoming,beneath,berry,bi-lobed,calyx,cm,completely,corolla,crystalline,decurrent,deflexed,dia,dry,elliptic,exserted,filament,fruiting,glabrous,globose,golden,green,lateral,leaf,less,live,lobe,lobed,long,main,margin,minutely,mm,nearly,ovary,ovoid-reniform,pair,paler,papillose,pedicel,persistent,petiole,pitted,plant,pore,poricidal,reddish,rounded,shaped,shiny,shrub,simple,size,slender,soon,stem,stigma,style,surface,tapering,tear-drop,tip,tube,vein,white,woody,x,yellowish	0.5-1,2-5,5-8,anthesi,apart,beginning,caly,deltoid,differing,difoliate,eaf,edicel,eed,evenly,free,frui,geminat,glabrou,incrassate,inflorescenc,living,lon,longitudinal,lower,major,middle,minor,nflorescence,obscure,older,one,opposite,papillo,peeling,portion,raised,reflexed,ruit,scar,slightly,spaced,straight,strip,tall,translucen,ud,unit,widest,ympodial,young	'',.2,[,``,alternate,arrangement,branch,bud,characteristic,colour,corrugation,diameter,distal,drying,exertion,form,fruit,glabrousnes,growth,height,history,inflorescence,interjected,leaflet,length,life,lobing,midpoint,na,new,number,peduncle,per,prickle,primary,pseudostipule,ray,seed,shape,terminal,texture,thicknes,type,value,variation,width,{,}
509	wfo-0001032161	success	146	116	79	67	37	0.541	0.4-1.2,0.7-4,0.8-1,1-1.5,1-11,1-3,1.2-1.3,1.4-2,2-7,2.5-3,3.5-4,?,acute,adaxially,anther,apex,area,bark,base,berry,calyx,cm,conical,corolla,dark,delicate,densely,dia,drying,ellipsoid,elliptic,filament,filiform,fruiting,giving,glabrous,globose,green,inflorescence,internodal,later,leaf,lobe,lobed,many,margin,merely,minutely,mm,mustard,nearly,obovate,opposite,ovary,ovoid-reniform,papillose,pedicel,petiole,pitted,plant,pubescent,revolute,shaped,shoot,short,shrub,sparsely,stem,stigma,style,sulcate,surface,tear-drop,thin,vein,white,x,yellow,yellowish	.5,0.5-1,0.75-1,2-8-flowered,abaxially,adaxiall,anthesi,apical,ba,beneath,branched,brownish-blac,closely,color,coriaceous,deflexed,deltate,dendritic,difoliate,eaf,edicel,eed,exserted,free,golden,hanging,lamina,like,long,lower,middle,minute,nflorescence,occasionally,older,overlappin,pale,pericarp,persistent,plurifoliate,pore,poricidal,portion,projection,quadrate,reflexed,rest,ruit,scar,shiny,simple,spaced,strongly,styl,tall,tan,tip,trichome,tub,tube,ud,uniseriate,unit,usually,widest,ympodial,young	alternate,appearance,arrangement,border,branch,brownish-black,bud,characteristic,colour,corrugation,diameter,form,fruit,glabrousnes,growth,height,history,lateral,length,life,lobing,midpoint,na,new,peduncle,perennial,prickle,pseudostipule,ray,seed,shape,size,texture,thicknes,type,variation,width
510	wfo-0001032165	success	197	106	82	115	24	0.416	0.25-0.5,1-1.2,1-1.5,1-2,10-25,2-2.5,3-6,5-15,5-6,5-7,8-9,acute,anther,apex,bark,base,berry,broadly,brown,bud,calyx,capitate,center,cm,corolla,cup-shaped,dark,decurrent,densely,dry,ellipsoid,elliptic,exserted,filament,fruiting,glabrous,globose,golden-puberulent,golden-pubescent,green,greyish-brown,inflorescence,later,lateral,leaf,main,margin,minutely,mm,nearly,obovate,occasionally,once-furcate,ovary,ovoid-reniform,pair,pedicel,petiole,pitted,plant,purplish,ripe,shape,simple,size,slender,specimen,stem,stigma,strongly,style,surface,tapering,tear-drop,tinged,tree,tube,vein,white,x,yellowish,young	.25,.5,0.1,0.1-0.3,0.3-1,0.75-1,1.5-4,2.5-3.5,3-4,3.5-8.5,4-6,5-30-flowered,5-9.5,abaxial,adaxial,along,anthesi,apparent,appearing,ba,beginning,beneath,closely,continued,cucullate,deciduous,deltoid,denser,dia,differing,difoliate,distal,due,dull,eaf,edged,edicel,eed,end,entire,erect,even,expansion,exsertion,free,geminat,golden,immature,inflorescenc,less,like,live,lobe,lobed,lon,long,lower,major,markedly,medial,middle,midrib,minor,minute,near,nflorescence,node,older,one,onto,opposite,orbicular,overlapping,pale,paler,papillo,papillose,planar,pore,poricidal,portion,presence,prominent,puberulent,rather,rest,ridge,rounded,ruit,scar,shaepd,single,slightly,slow,small,smoot,spaced,stout,straight,stripe,swollen,tall,terminal,thickened,time,tip,trichome,tub,ud,uniseriate,unit,widest,winged,woody,ympodial	0.25,alternate,arrangement,characteristic,colour,diameter,drying,exertion,form,fruit,growth,height,history,length,life,lobing,na,peduncle,perennial,primary,seed,shaped,texture,type
511	wfo-0001032167	success	163	134	89	74	45	0.546	.5,0.5-1,0.5-1.5,0.5-2.5,0.75-3,1,1-2,1-2.5,1-3,1-5,1-7,1.5,10-20,10-35,12-20,2-4,2-7,2-foliate,4-6,5-15,7-10,absent,acute,along,anther,apex,base,berry,brown,calyx,cell,chartaceous,ciliate,cm,dense,densely,denser,diameter,dm,drying,elliptic,elliptic-ovoid,entire,few-,filament,flower,forming,fruit,glabrous,globose,growth,herb,immature,linear-lanceolate,lobe,many-branched,margin,maturing,membranaceous,mm,moderately,nearly,netlike,new,oblong,obtuse,pedicel,peduncle,per,petiole,projection,pubescent,purple,raised,rotate,rounded,seed,semitransparent,sparsely,stigma,style,surface,tube,twisted,vein,wall,white,x,yellow	1-2-celled,3-6,3-7,4-10,abaxially,abundant,adaxiall,adaxially,appressed,axe,blade,closely,common,connected,cordate,curved,decurrent,dehiscing,eaf,eed,emarginat,explosively,flat,flattened,frui,geminat,geniculate,growt,hair,held,interpetalar,larger,long,longer,lower,lowermost,lying,maturit,mesocarp,near,nfloresence,notch,often,older,one-celled,orolla,placenta,pressure,pubescen,rachi,ruit,shorter,slightly,small,smaller,sometimes,staman,stamen,straight,tal,tamen,tem,tissue,triangular,two-celled,unbranched,unit,upper,usually,vary,watery,wid,woody,ympodial	appearance,arrangement,bark,border,branch,bud,characteristic,colour,corolla,corrugation,distal,exertion,form,fruiting,giving,glabrousnes,height,history,inflorescence,interjected,lateral,leaf,leaflet,length,life,lobing,midpoint,na,number,ovary,plant,prickle,primary,pseudostipule,ray,shape,size,stem,terminal,texture,thicknes,type,variation,wide,width
512	wfo-0001032176	invalid_json_followup	177	169	124	53	45	0.701	.5,0,0.5-0.7,0.5-1,0.8-1,0.8-6,1-1.2,1.5-1.6,1.5-2.5,1/2,100,2-3,2.5-10,3-15,3-3.5,3-4,5-6-celled,6,6-10,7,anther,apart,apex,arising,attenuate,axil,axillary,base,becoming,berry,branched,calyx,cell,cm,conical,copiously,corolla,creeping,densely,diameter,drying,ellipsoid,elliptic,epidermal,equal,especially,exserted,filament,filiform,flower,fruiting,glabrous,globose,green,greenish,grey-brown,greyish,herb,lateral,leaf,leaflet,lengthening,like,lobed,long,long-papillose,lower,margin,minute,minutely,mm,nearly,nodding,node,obtuse,occasionally,onto,open,ovary,ovoid-reniform,pair,pale,pedicel,per,petiole,pinnate,pore,poricidal,projection,pubescent,rachi,rest,rooting,rounded,scar,seed,separate,simple,single,sinuous,size,slit,soon,spaced,sparsely,stem,stigma,strongly,style,terminal,thickening,time,tip,trichome,tube,ultimate,unevenly,uniseriate,vein,wall,white,winged,without,x	0.42,0.5,0.5-0.75,1-10,1.5-6,3-7,adaxially,adhering,along,anthesi,apical,attaining,basal,beak,capitat,cateniform,containing,cucullate,denser,eaf,edicel,eed,fallen,free,hangin,inflorescenc,lengt,lobe,log,nflorescence,obovate,often,papillose,petiolule,portion,quadrate,reflexed,ruit,slightly,smaller,somewhat,strait,tem,tightly,tree,truncate,trunk,tub,ud,unifoliat,unit,whit,ympodial	'',[,``,arrangement,bark,branch,bud,capitate,cateniforme,characteristic,colour,corrugation,distal,exertion,form,fruit,glabrousnes,growth,height,history,inflorescence,interjected,length,life,lobing,midpoint,na,new,number,peduncle,plant,prickle,primary,pseudostipule,ray,shape,surface,texture,thicknes,type,value,variation,width,{,}
513	wfo-0001032187	success	139	145	94	45	51	0.676	-11,-4.2,-5,-9,0.1â1.4,0.5,0.5-,0.5â1,0.6â1.3,1.1â3.2,1.3â1.8,1.6â2.1,1.8â2,1.8â2.8,100,22,2â9,3.1â3.5,3â4,5â7,7â11,9,acuminate,acute,angular,anther,apex,appressed,base,berry,branch,broadly,brown,brownish,cm,consisting,corolla,cyme,dark,dia,dull,eglandular,elliptic,entire,equal,erect,filament,flowered,forked,glabrescent,globose,green,hair,herb,leaf,light,lobe,long,margin,marked,mature,mm,numerous,obovate,occasionally,ovate,pedicel,peduncle,pentagonal,per,petiole,plant,purple,rarely,ridge,short,simple,small,sparse,spreading,stage,stem,style,sub-glabrous,texture,tinged,tooth,triangular,truncate,well,yellowish,Â±,Â±1,Ã	-2.1,-4,1â1.7,24.6â26.3,3â3.2,5-merous,adherent,alyx,ape,aromatic,blade,changing,di-foliate,eaf,eed,fully,geminat,granule,hite,hooked,hydrated,lower,many,nflorescence,penden,perfec,persistent,petiolate,pollen,predominantly,presen,protruding,ruit,running,sclerotic,soft,sometimes,stellate,straight,unit,widest,wing,yellow,ympodial,Âµm	appearance,arrangement,bark,border,bud,calyx,characteristic,colour,corrugation,diameter,distal,drying,exertion,form,fruit,fruiting,giving,glabrousnes,growth,height,history,inflorescence,interjected,lateral,leaflet,length,life,lobing,midpoint,na,new,number,ovary,pendent,prickle,primary,pseudostipule,ray,seed,shape,size,stigma,surface,terminal,thicknes,tube,type,variation,vein,white,width
514	wfo-0001032206	invalid_json	216	183	112	104	71	0.519	-20,-5,.5,0,1/3,acute,anther,apart,apex,apically,apparently,approximately,armed,articulated,bark,base,berry,branched,calyx,chartaceous,cm,concolorous,connivent,cream,cuneate,dark,deltate,diameter,discolorous,distal,distance,drying,elliptic,erect,extending,filament,flattened,flattened-reniform,flower,foliaceous,fruit,fruiting,glabrescent,glabrous,green,green-brown,lateral,leaf,length,lobe,lobed,lobing,long,long-styled,margin,marking,maturity,mauve,midpoint,midvein,mm,moderately,obtuse,often,one,open,orange-brown,ovate,pair,pale,pedicel,peduncle,pendent,per,petiole,plant,poricidal,prickle,primary,purple,rarely,ray,secondary,short-styled,shrub,side,slender,sometimes,spaced,spherical,stellate,stellate-pubescent,stem,straight,style,surface,tapering,time,tip,toward,trichome,truncate,tube,unarmed,usually,vein,weakly,white,wide,yellow,yellow-orange,young	-0.8,-2,..,.2,0.2,0.2â0.4,0.2â0.5,0.5â1,0.8â1.2,00â200,0â20,0â30,0â5,1,1.1â1.2,1.2â2.2,1.5â2,1.5â2.5,1/4â1/2,1/4â1/3,1/6,10â80,11â22,1â2,1â2.3,1â3,1â4,2.5â3.3,2.7â3.5,2â2.5,2â3,2â8,3.5â9,30â80,3â4,4.5â5.8,4â6,5-merous,5â15,5â20,5â6,5â8,5â9,6â10,6â15,6â8,7â10,8â20,abaxially,accrescent,adaxially,alyx,andromonoecious,apar,blade,bluntly,broad-deltate,brow,clearly,covering,curved,eaf,eed,equal,free,functionally,gently,hermaphroditic,heterostylous,infructescence,lengt,longer,lowermost,mal,mature,nflorescence,older,orolla,ower,pendulous,pericarp,plurifoliat,porrect,portion,reflexed,scar,sessile,smooth,sparsely,spreading,stalk,stalked,stout,tamen,tertiary,uit,ung,unit,variously,vary,venation,visible,woody,ympodial	'',0-20,0-5,0.5-1.5,0.8-1.2,00-200,1-2,1-2.3,1-3,1-4,1.1-1.2,1.2-2.2,1.5-2.5,1/4-1/2,11-22,2-2.5,2-3,2.5-3.3,2.7-3.5,3-4,3.5-9,4-6,4.5-5.8,5-15,5-20,5-6,5-8,5-9,6-10,6-15,8-20,[,``,appearance,arrangement,border,branch,brown,bud,characteristic,colour,corolla,exertion,form,giving,glabrousnes,growth,height,history,inflorescence,interjected,leaflet,life,na,new,number,ovary,pseudostipule,seed,shape,size,stigma,terminal,texture,thicknes,type,value,variation,width,{,}
515	wfo-0001032209	success	257	149	125	132	24	0.486	-11,-20,-30+,.5,0.5-1,1-2-celled,1-6,1.5,1.5-,1.5-6,10-13,2,2-3,2-3-lobed,2-5,2.5-,2/3,20-30,3-7,3-9,4-20,6-15,6-8,acute,along,anther,anthesi,apex,appearing,basal,base,berry,bilobed,blue,branch,branched,broadly,brown,calyx,capitate,cell,climbing,cm,colour,conical,cordate,corolla,dark,deeply,dendritic,densely,diameter,early,ellipsoid,elliptic,entire,evenly,exerted,filament,flattened-reniform,fruiting,glabrous,globose,growth,hairy,hollow,inflorescence,lamina,lateral,leaf,length,lobed,margin,metallic,minute,minutely,mm,narrowly,nearly,new,occasionally,ovate,pair,papillae,pedicel,peduncle,per,petiole,pinnately,pinnatifid,primary,puberulent,pubescent,purple,red,reddish,ripe,several,shiny,simple,sometimes,somewhat,spreading,stellate,stem,stigma,stout,style,surface,tapering,terminal,testa,time,tiny,trichome,truncate,tube,uniseriate,vein,vine,violet,wall,white,woody,x	0.3,0.5,1,1-1.5,1-2,1.5-2,1.5-2.5,100,12-16,4,5-8,5-merou,absent,adaxial,ag,alyx,apart,apiculae,apparently,arching,ark,articulated,axi,berr,bu,canopy,cast,chartaceous,connivent,conspicuously,coriaceous,cucullat,deltate,denser,distally,distinct,dried,eaf,ecuador,eed,enlarged,equal,erect,especially,finely,fleshy,flower,flowering,free,geminat,giving,glabrescen,groove,hanging,hastate,held,ilament,keeled,large,leathery,leaving,lengthening,less,like,lobe,long,longer,longest,lower,markedly,material,mean,mere,middle,midrib,midvein,mixture,near,nflorescence,nipple,often,older,one,orolla,papillat,papillate,part,particularly,peg,pentagonal,perfect,pericarp,planar,plurifoliate,pointed,pore,poricidal,portion,probably,pubescence,rest,rhachi,rim,ruit,sagittate,scar,sleeve,slit,small,spaced,sparser,tem,testal,thin,third,tightly,tip,twinin,twining,ud,unequal,unit,upper,usually,variable,vary,w,weight,widest,within,yellow,ympodial	arrangement,bark,bud,cayx,characteristic,corrugation,drying,exertion,form,fruit,glabrousnes,height,history,life,lobing,na,number,ovary,plant,seed,shape,size,texture,type
516	wfo-0001032232	success	137	119	89	48	30	0.65	.5,0.1,0.25,0.5-1,0.6-3,0.8-1,1-3,1.8-2,18.8-27.5,2,2-2.6,20-100-flowered,3/4,4.8-7.3,5-6,abruptly,anther,anthesi,apex,attenuate,bark,base,berry,calyx,clavate,cm,corolla,cup-shaped,dark-papillose,decurrent,deflexed,dia,distally,elliptic,erose,filament,filiform,fruiting,glabrous,globose,green,greenish-brown,immature,leaf,less,light,lightly,lobed,long,long-acuminate,margin,minutely,mm,narrowly,occasionally,onto,ovary,ovoid-reniform,pair,pale,papillose,pedicel,petiole,pitted,reflexed,revolute,shaped,shrub,simple,slightly,somewhat,sparsely,stem,stigma,straight,style,subshrub,surface,tear-drop,tip,translucent,tube,umbonate,undulate,vein,way,wide,widening,winged	0.5,?,age,ba,becoming,closely,eaf,edicel,eed,erect,evenly,exfoliatin,flower,free,irregular,lateral,lenticellate,lobe,lower,main,middle,midrib,minute,nflorescence,node,opposite,overlappin,packed,paler,papillo,pore,poricidal,portion,prominent,raised,rounded,ruit,scar,short-styled,tall,ti,tub,ud,unifoliat,unit,widest,woody,ympodial	arrangement,branch,bud,characteristic,colour,corrugation,diameter,drying,exertion,form,fruit,glabrousnes,growth,height,history,inflorescence,length,life,lobing,na,new,peduncle,plant,primary,seed,shape,size,texture,type,unifoliate
517	wfo-0001032233	success	160	129	75	85	54	0.469	0.3-2,1-1.5,1.5-2.5,10-15,2-15,2-3,2-5.5,2-6,20-100+,25-40,3-4,3-5,3.5-4,4-18,4-5,5-6,6-25,acuminate,acute,almost,apex,basal,base,branched,calyx,chartaceous,cm,convex,cordate,dark,densely,diameter,ellipsoidal,entire,flattened,flower,fruit,glabrescent,glabrous,globose,green,lobe,longitudinal,margin,mm,moderately,narrowly,oblong,obtuse,orange,ovate,ovoid,pedicel,peduncle,petiole,puberulent,pubescent,purple,shallowly,simple,stigma,stripe,style,subcoriaceous,subpeltiform,tip,tree,triangular,truncate,tube,unbranched,vein,x,yellow,yellow-green	0-2,1-2,1-3,157,2-4,2.5-4,3-15,3-4.5,4-7,4-foliat,5-16,8-12,abaxially,absen,absent,adaxial,adaxially,aggregate,apart,ape,articulated,axe,bent,beyond,biglandula,blade,brow,cell,connective,connivent,coriaceous,cylindrical,dilated,directed,distally,eaf,eed,equal,especially,exceeding,exserted,fleischmann,fleshy,glabrate,glandular-puberulent,laterally,leaving,lon,long,lower,nflorescence,nther,orolla,pedicellar,perfect,pore,present,projection,puberulen,rachise,radiu,remnant,ruit,shorter,slightly,small,somewhat,spaced,sparsely,stamen,stellate,stone,tal,tem,thecae,time,tomento,toward,ud,unit,vary,white,wide,yellow-orange,ympodial	anther,appearance,arrangement,bark,biglandular,border,branch,bud,characteristic,colour,corolla,corrugation,distal,drying,exertion,filament,form,fruiting,giving,glabrousnes,growth,height,history,inflorescence,interjected,lateral,leaf,leaflet,length,life,lobing,midpoint,na,new,number,ovary,per,perennial,plant,prickle,primary,pseudostipule,ray,seed,shape,size,stem,surface,terminal,texture,thicknes,type,variation,width
518	wfo-0001032259	success	202	131	102	100	29	0.505	.5,/3,/4,0.45-0.6,0.5-0.8,0.7-1.1,0.9-1.2,1-2.5,1.5-4.5,10-30,2-2.5,2.2-3,3-4,4,4-5,4-6,5-30,7-16,9-22,abaxially,acute,almost,anther,apart,apex,apparently,articulated,bark,base,becoming,berry,brown,brownish,calyx,chartaceous,cm,conical,connivent,cordate,cuneate,dark,densely,diameter,dull,elongating,evenly,filament,flattened,flattened-reniform,fruit,glabrous,green,lateral,leaf,length,lobe,lobed,long,margin,mature,maturity,mauve,mm,moderately,orange,orange-brown,ovate,pair,pedicel,peduncle,petiole,poricidal,prickle,prickly,primary,pubescent,recurved,red,shrub,side,simple,spaced,sparsely,spherical,stellate,stellate-pubescent,stem,straight,style,surface,tapering,terminal,tip,toward,trichome,vein,way,white,wide,yellow,yellow-green,young	-4,0,0-10,0-2,0-20,0-4,0-5,0.1-0.2,0.1-0.3,0.15-0.3,0.5-1.5,0.8-1.3,1-1.8,1-2,1/2,1/3,1/4-1/3,1/6-1/5,15-40,2-4,2-5,20-60,3/,4-9,5,5-merous,5.5-8,7-8,abaxial,acut,adaxial,alyx,apar,apically,blade,branched,broad-deltate,deltate,difoliate,discolorous,distance,drying,eaf,eed,equal,erect,extending,flower,free,fruiting,fully,geminate,glabrescent,gland,green-brow,hair,infructescence,longer,lower,midpoint,midvein,minute,nflorescence,older,one,open,opening,orolla,oung,pendulous,per,perfec,pericarp,porrect,portion,prickl,ray,reduced,rounded,ruit,scar,sessile,shorter,slender,smooth,sometimes,spreading,strongly,tamen,terete,tertiary,time,tube,unarmed,unit,vary,venation,visible,woody,ympodial	appearance,arrangement,border,branch,characteristic,colour,corolla,exertion,form,giving,glabrousnes,green-brown,growth,height,history,inflorescence,life,lobing,na,new,ovary,perennial,plant,seed,shape,size,texture,type,width
519	wfo-0001032260	invalid_json_followup	216	154	113	103	41	0.523	-1.5,-10,-3,-8,/5,0-20,0-5,0.1-0.4,0.2-0.5,0.5-0.8,0.5-2,0.5-5,0.6-0.8,0.7-1.5,0.8-1.1,1-1.7,1.2-1.7,1.5-4,2,2.5,2.5-3,2.5-3.5,3-5,3-8,3-9,6-10,acuminate,acute,anther,apart,apex,apparently,articulated,bark,base,berry,calyx,cell,cm,connivent,cuneate,curved,deltate,densely,diameter,discolorous,drying,dull,elliptic,erect,filament,flattened,flattened-reniform,fruit,fruiting,glabrous,glaucous,green-brown,lateral,leaf,length,lobed,long,margin,maturity,mauve,midpoint,mm,orange-brown,outline,ovate,pair,pale,pedicel,peduncle,per,petiole,pit,poricidal,prickle,prickly,primary,pubescent,purple,raised,ray,red,rounded,scandent,shallowly,shrub,simple,slender,small,spaced,sparsely,spherical,stellate,stellate-pubescent,stem,strongly,style,subentire,surface,tapering,terminal,tip,tube,vein,way,wide,yellow,yellow-green	-0.5,.1,0-,0-0.5,0-10,0-8,0.1,0.1-0.3,0.15-0.3,0.2,0.4,0.7,1-3,1-5,1-6,1/2,1/3,1/3-1/2,1/3-1/5,10-30,2-20,2-4,2-5,3-10,4-,5-,5-20,5-merous,6-8,7-15,abaxial,abaxially,acuminat,adaxial,alyx,apar,apically,blade,branched,broad-deltate,chartaceous,difoliate,distance,eaf,eed,elongating,equal,extending,eye,flower,free,geminat,glabrescent,glabrou,gland,globular,gray-brow,infructescence,lobe,lon,long-styled,longer,lower,mature,midvein,moderately,naked,narrow-ovate,nflorescence,older,one,open,orolla,oung,pendulous,perfec,pericarp,porrect,portion,prickl,reduced,reflexed,ruit,scar,sessile,shorter,side,smooth,spreading,stalk,stalked,tamen,terete,tertiary,time,trichome,unit,variously,vary,venation,visible,woody,ympodial	'',[,``,arrangement,branch,bud,characteristic,colour,corolla,corrugation,distal,exertion,form,glabrousnes,gray-brown,growth,height,history,inflorescence,interjected,leaflet,life,lobing,na,new,number,ovary,plant,pseudostipule,seed,shape,size,stigma,texture,thicknes,type,value,variation,width,{,}
520	wfo-0001032264	success	183	115	84	99	31	0.459	.2,.5,0.25-0.75,0.6-2.2,1.2-2,1.5-1.8,1.8-3,2-6,3,3-15,6-17,acuminate,acute,anther,apex,apiculate,bark,base,berry,branched,broadly,bud,calyx,cm,corolla,cup-like,dia,elliptic,exserted,filament,flattened-reniform,fruiting,glabrous,globose,green,inflorescence,lateral,leaf,lobed,long,main,margin,minute,minutely,mm,narrowly,nearly,occasionally,ovary,ovoid,pale,parallel,pedicel,petiole,pitted,plant,pubescent,red-papillose,reddish,reddish-tan,revolute,several,shaped,shrub,simple,size,slender,small-capitate,soon,stem,stigma,straight,style,surface,tapering,tear-drop,time,trichome,tube,uniseriate,vein,white,x,yellowish-brown	0.25-0.5,0.5-1,0.8-10,0.8-4,1-1.5,10-22,2-50-flowered,3-9,4.5-5,5-9,along,anthesi,apar,appearing,ba,bullate,cell,cell-layer,closely,curling,deciduous,deflexed,densely,differing,difoliate,dry,eaf,edicel,eed,epidermal,fleshy,flower,free,geminat,gnarled,greyi,habitat,hair,incrassate,lamina,large,larger,layer,like,live,lobe,lon,lower,major,material,middle,minor,multiseriate,nflorescence,often,older,one,opposite,overlapping,pair,papillo,papillose,peeling,planar,pointed,pore,poricidal,portion,primarily,prominent,quite,raised,rounded-deltoid,ruit,scar,scattered,sheet,sheltered,short,small-celled,somewhat,spaced,sparsely,tall,thick,tip,transversely,tree,trunk,ud,unit,upper,weak,whitish,wide,widest,woody,ympodial,young	4-8,alternate,arrangement,branch,characteristic,colour,corrugation,diameter,drying,exertion,form,fruit,glabrousnes,greyish,growth,height,history,length,life,lobing,na,new,number,peduncle,per,perennial,primary,seed,shape,texture,type
521	wfo-0001032274	success	192	128	92	100	36	0.479	0,0.15-0.2,0.5-0.7,0.5-1,0.7-1.8,0.9-1,1-1.2,1-1.5,1-3,1.5-2,2,2-7,3-4,3-6,3/4,5-7,acuminate,acute,anther,apex,appearance,arching,axillary,base,berry,branch,brown,calyx,capitate,cm,corolla,densely,diameter,distal,ellipsoid,elliptic,entire,exserted,filament,filiform,flattened-reniform,fruiting,glabrous,globose,green,grey,growth,inflorescence,lanceolate,leaf,lobe,margin,minute,minutely,mm,new,obtusely,occasionally,once-branched,pair,pedicel,peduncle,per,petiole,pitted,plurifoliate,primary,puberulent,pubescent,purple,red,reddish,rounded,shape,shiny,shoot,short,shrub,simple,size,sparsely,stem,stigma,style,surface,terminal,truncate,tube,vein,way,white,x	.5,0.5,0.5-1.5,2-3.5,3-10,3-5,5-merou,<,ag,alyx,anthesi,apiculate,apparently,ark,articulated,ba,basal,borne,cell,clustered,conical,connivent,deltate,dendritic,eaf,eed,fleshy,flower,free,geminat,glabrou,group,highly,ilament,irregular,lax,lengthening,less,like,lobed,long,loosely,lower,markedly,membranous,nflorescence,nodding,non-reproductive,often,older,one,orolla,pale,papillo,peg,pendan,perfect,pericarp,platfor,platform,pore,poricidal,portion,quadrate,reflexed,reproductive,ridge,ridged,ripe,ruit,scar,sleeve,slit,small,sometimes,somewhat,square,stellate,strongly,suckering,tem,testal,thin,tinged,tip,trichome,twinin,two,ud,uniseriate,unit,upper,usually,variable,vary,violet,visible,woody,yellow,ympodial	arrangement,bark,border,bud,characteristic,colour,corrugation,drying,exertion,form,fruit,giving,glabrousnes,height,history,interjected,lateral,leaflet,length,life,lobing,midpoint,na,number,ovary,perennial,plant,prickle,pseudostipule,ray,seed,texture,thicknes,type,variation,width
522	wfo-0001032276	success	152	123	77	75	46	0.507	-,.25,0.3-1,0.5-0.75,0.8-1,1-1.5,1-2,1.8-2,2-2.5,2.5-4,3-3.5,5-7,7-8,9-18,acute,anther,apex,attenuate,bark,base,broadly,brown,calyx,cm,corolla,cup-shaped,dark,densely,dia,elliptic,exserted,filament,filiform,fruiting,glabrous,globose,green,lateral,leaf,lobe,lobed,long-pubescent,main,margin,minute,minutely,mm,narrowly,nearly,ovary,ovoid-reniform,pair,pale,pedicel,petiole,pitted,plant,pubescent,shaped,short,shrub,simple,soon,sparsely,stem,stigma,strongly,style,surface,tear-drop,tube,unifoliate,vein,white,winged,x,yellow	.5,0.25-1.5,0.5-1,1,3-6-flowered,along,anthesi,apart,ba,beneath,blade,capitat,converging,curly-tipped,decurrent,deflexed,deltoid,dry,eaf,edicel,eed,ellipsoid,evenly,except,free,geminate,greyish-gree,lamina,later,like,long,lower,material,middle,nflorescence,node,non-reproductive,obovoid,occasionally,older,onto,opposite,papillose,perhaps,pore,poricidal,portion,prominent,raise,raised,reflexed,remaining,rest,ruit,scar,slender,slightly,somewhat,spaced,straight,straw-colored,tall,tapering,tip,triangular,trichome,tub,ud,uniseriate,unit,widely,widest,woody,ympodial,young	8,appearance,arrangement,border,branch,bud,capitate,characteristic,colour,diameter,distal,exertion,form,fruit,giving,glabrousnes,greyish-green,growth,height,history,inflorescence,interjected,leaflet,length,life,lobing,midpoint,na,new,number,peduncle,per,perennial,prickle,primary,pseudostipule,ray,seed,shape,size,terminal,texture,thicknes,type,variation,width
523	wfo-0001032277	success	163	121	89	74	32	0.546	0.75-1,0.8-3,1-1.1,1-1.2,1-2,1-5,1.5-1.8,1/2,10-14,2-2.5,2-6-flowered,3-3.5,3-9,5-6,8-9,acute,anther,apex,area,bark,base,beneath,berry,blunt,branched,bright,calyx,cm,coriaceous,corolla,cup-shaped,densely,dia,ellipsoid,elliptic,filament,flattened-reniform,fruit,fruiting,glabrous,globose,green,immature,inflorescence,internodal,lateral,lax,leaf,lobed,main,margin,minutely,mm,number,opposite,ovary,pair,pale,papillose,pedicel,petiole,pitted,poricidal,pubescent,revolute,ripe,rounded,shrub,simple,slender,sparsely,stem,stigma,straight,style,surface,tapering,tip,translucent,trichome,tube,uniseriate,vein,virgately,way,white,x,yellow,yellowish-tan	.5,0.1-0.5,0.2-0.6,1-1.5,2-4,along,anthesi,apiculate,appear,appearing,auriculate,ba,blade,closely,deltoid,drooping,dry,eaf,edicel,eed,erect,exserted,free,geminat,gre,impressed,incrassate,indentation,like,lobe,long,lower,mature,middle,nflorescence,obscured,occasionally,older,overlapping,paler,papillae,partially,pore,portion,prominent,puberulent,pubescenc,raised,reddish,remaining,rest,round,ruit,scar,slende,small,spaced,specimen,spicy-fragrant,strict,strongly,styl,tall,truncate,trunk,tub,two,ud,unit,varying,widest,woody,ympodial,young	1,alternate,arrangement,branch,bud,characteristic,colour,corrugation,diameter,drying,exertion,form,glabrousnes,grey,growth,height,history,length,life,lobing,na,new,peduncle,per,perennial,plant,primary,seed,shape,size,texture,type
524	wfo-0001032304	invalid_json_followup	249	165	123	126	42	0.494	0.2-0.3,0.5-4.5,1-3.5,1.1-2,1.2-2.3,1.3-2.1,1.6-1.9,10,18,2-5,2.5-19.5,2/3-3/4,3-10,3-15,3-4.5,3-6,4-7.5,5.5-9,7-27,9-13,abaxially,acuminate,acute,adaxially,anther,anthesi,apex,bark,base,becoming,berry,blackish,blunt-tipped,branch,branched,broadly,brown,brownish,bud,calyx,campanulate,cm,conical,continued,corolla,dark,deltoid,densely,diameter,distal,due,elliptic,entire,exserted,filament,fleshy,flower,fruit,fruiting,glabrescent,glabrous,granular-tomentose,green,greenish,growth,honeycombed,lateral,leaf,least,length,lobe,long-attenuate,margin,midvein,mm,mostly,oblong,obtuse,orbicular,ovate,ovate-lanceolate,pale,pedicel,peduncle,petiole,plant,probably,pubescent,rather,ray,reniform,reticulate-punctate,ripe,scabridulous,seed,short-,shrub,side,simple,small,sparingly,spreading,stamen,stem,stigma,style,subglobose,suborbicular,terete,time,tomentose,tree,tube,unarmed,vein,velutinous,violet,way,white,whitish,x,yellow,yellowish	-3,.6-1.2,.9-1.4,/20,0-120,0.3-1.5,0.5-3,0.9-1.3,1,1.2-3,1.5-3.2,1.8-4,1/2,1/3-1/2,1/5,1/8,2-4,2-4.2,21,3-20,3.2-3.8,3.2-5.5,44,5-6,7.5-12,accrescent,ag,along,apart,apical-lateral,apparently,appressed-tomentose,articulated,ascending,axe,axillary,ba,blade,capitat,chartaceous,closely,decurrent,dehiscing,dendritic,dendritic-echinoi,dendritic-echinoid,directed,eaf,echinoi,echinoid,especially,extend,few-,few-rayed,free,glabrescen,hair,high,inserted,introrse,juvenile,large,lobed,long,long-,long-stalked,longitudinal,lower,m.,main,many,many-rayed,mixed,multangulat,multangulate,nflorescence,obscured,occasionally,often,older,opaque,orolla,ovat,overlapping,partly,perfect,plurifoliate,pore,porrect-stellate,present,pseudo-terminal,rachi,rarely,relatively,rotate-stellate,ruit,runk,sessile,short,short-stalked,slit,somewhat,spaced,stellate-tomentose,strongly,sulcate,suture,tamen,testa,thick,thick-stalked,thin,thin-,thin-stalked,tomentu,touching,toward,triangular-ovate,unarme,unit,usually,vary,wide,within,ympodial,young	'',0.9-1.4,[,``,arrangement,capitate,characteristic,colour,corrugation,drying,exertion,form,glabrousnes,height,history,inflorescence,interjected,leaflet,life,lobing,midpoint,na,new,number,ovary,per,prickle,primary,pseud-terminal,pseudostipule,shape,size,surface,terminal,texture,thicknes,type,value,variation,width,{,}
525	wfo-0001032307	success	153	128	103	50	25	0.673	.5,/3,0.2-0.5,0.4-1.3,1-1.5,1-2,1.5-5,10-20,2-5,2.5-12,2.5-3,3.5-4,30,4-8,5-12,5-25-flowered,7-18,abaxial,acute,along,anther,apex,bark,base,berry,branch,branched,calyx,campanulate,capitate,christmas-tree-like,cm,congested,corolla,dark,dendritic,densely,dia,ellipsoid,elliptic,erect,exserted,filament,flattened-reniform,fruiting,glabrate,glabrous,globose,green,growth,incrassate,inflorescence,later,lateral,leaf,like,lobed,long,loose,main,many,margin,minutely,mm,new,ovary,pair,pale,pedicel,petiole,pitted,plant,prominent,pubescent,reddish,reddish-brown,rest,shaped,shrub,small,sparsely,stem,stigma,stout,strongly,style,surface,tan,tear-drop,terminal,thick,time,tree,tree-like,trichome,truncate,tube,type,upper,vein,way,white,wide	1.5-2,2.5-3.5,?,adaxial,anthesi,apar,blade,body,brow,deltate,eaf,edicel,eed,either,elongate,flat,fleshy,free,immature,inflorescenc,lobe,lon,lower,middle,minute,nflorescence,older,papillae,papillo,petal,planar,plurifoliat,pore,poricidal,portion,ruit,scar,spaced,tall,thickened,tip,tub,ud,unevenly,variable,widest,within,woody,ympodia,young	arrangement,brown,bud,characteristic,colour,corrugation,diameter,exertion,form,fruit,glabrousnes,height,history,length,life,lobing,na,peduncle,perennial,plurifoliate,primary,seed,shape,size,texture
526	wfo-0001032308	success	190	139	98	92	41	0.516	0.2-2.1,0.3-5,0.7-1,0.7-1.2,1-2,1.5-2.5,1.8-2.5,1.9-3,12-16,2-6,3.8-5,4-7,4.8-7.7,6,6-11,8-9,absent,acute,anther,apex,axillary,base,berry,brownish,bud,cell,chartaceous,clavate,cm,condition,connivent,cordate,corolla,covering,deep,diameter,distal,dot,drying,filament,fresh,fruit,generally,glabrous,globose,green,green-white,greenish,hair-like,interjected,invested,irregular,lanceolate,lateral,leaflet,lobe,long,make,margin,medium,membranous,mm,mucilaginous,non-glandular,odd-pinnate,often,orbicular,ovate,ovoid,pedicel,peduncle,petiole,plant,pubescent,pure,ripe,rounded,scattered,seed,shape,short,slightly,stem,stigma,style,terminal,testal,thick,throughout,trichome,tube,typically,wall,wet,white,whitish,wide,x	0-3,1-10,2,2-3,2-4,3-10,3-6,4-8,5-7,5-merou,abaxially,acumen,adaxially,ag,along,alyx,apart,apparently,articulated,axe,blade,broadly,capitat,ciliate,cuneate,digestion,dorsally,eaf,edge,eed,elliptic,enzyme,especially,exceeding,flat,flower,folded,forked,geminat,glabrou,greatly,hair,hal,half,homostylous,honeycomb-shaped,larger,leave,lengthening,like,living,lobed,lower,midrib,minute,minutely,much,narrowly,nflorescence,obtuse,orolla,pair,pentagonal,perfect,petiolulate,petiolule,plurifoliate,pore,poricidal,puberulent,removed,ruit,sessile,seudostipule,slit,spaced,specimen,stamen,ste,straight,substellate,subtending,sympodial,tamen,tip,tri-,truncate,unit,usually,vary,varying,yellow	appearance,arrangement,bark,border,branch,calyx,capitate,characteristic,colour,corrugation,exertion,form,fruiting,giving,glabrousnes,growth,height,history,inflorescence,leaf,length,life,lobing,midpoint,na,new,number,ovary,per,prickle,primary,pseudostipule,ray,size,surface,texture,thicknes,type,variation,vein,width
527	wfo-0001032335	success	215	133	90	125	43	0.419	.2,100,100+,>,acuminate,acute,along,anther,anthesi,apex,articulated,attenuate,axe,base,berry,branched,bright,calyx,capitate,chartaceous,cm,connivent,corolla,densely,diameter,discolorous,ellipsoidal,elliptic,entire,exserted,filament,flattened-reniform,flower,fruiting,glabrous,globose,gold,golden-yellow,growth,inflorescence,length,like,long,loosely,many,margin,membranous,minute,minutely,mm,narrowly,new,nodding,onto,orange,pair,pale,pedicel,peduncle,peltate,per,persistent,petiole,pitted,plane,porrect-stellate,primary,pubescent,reddish,ripe,short-stalked,shrub,simple,small,somewhat,stem,stigma,stout,strongly,style,surface,terminal,time,tree,trichome,tube,vein,way,white,wide	'',.5,0,0.05,0.2,0.2â0.3,0.4,0.5,0.5â1,0.9â1,1.5â2,10â12,12â15,15,16,1â1.2,1â1.5,1â3,2.5â3,2â10,2â2.5,2â5,3361,4â14,4â5,4â6-rayed,5-merou,5â6,6â19,6â6.5,7â10,abaxial,abaxially,adaxial,ag,alyx,apar,appearing,ark,beneath,boh,branching,c.,cell,center,closely,covered,cup-shaped,deltate,dichasia,drying,eaf,eed,elongate,equal,erec,evenly,fide,free,fused,golden-brow,gradually,half,ilament,impressed,lamina,lengthening,less,lobe,lobed,lower,markedly,midpoint,moderately,multangulate,narrowing,near,nflorescence,older,orolla,papillo,part,perfect,pericarp,plurifoliate,pore,poricidal,porrect,portion,pubescence,ray,reflexed,regularly,ruit,scar,scurfy,sessile,shiny,short,silvery,slightly,slit,sometimes,spaced,sparsely,square,stellate,stub,tal,tem,testal,thin,tip,ud,unevenly,unit,upper,vary,varying,visible,woody,yellow,ympodial,â4,âstellate	-4,/4,0.2-0.3,0.5-1,0.9-1,1-1.2,1-1.5,1-3,1.5-2,12-15,2-10,2-5,4-14,4-6-rayed,5-6,6-19,6-6.5,7-10,arrangement,bark,branch,bud,characteristic,colour,dichasial,exertion,form,fruit,glabrousnes,height,history,leaf,life,lobing,number,ovary,perennial,plant,seed,shape,size,texture,type
528	wfo-0001032337	invalid_json_followup	225	154	111	114	43	0.493	0.4-1.5,0.5-3.5,1-2,1.2-2.8,1.4-2,1.5,2-14,2-3.5,2-7,2.3-11.5,2.3-4.8,3-8,4-17,4-6,4.5-14.5,5-11,8-10,8-17,9-21,9-29,abaxially,acuminate,acute,adaxially,anther,apex,apiculate,attenuate,axillary,base,basiscopic,berry,broadly,brownish,bud,canescent,chartaceous,clavate,cm,condition,corolla,cuneate,darker,decurrent,deep,densely,diameter,distal,drying,filament,flower,forked,fresh,fruit,generally,glabrous,globose,green,greenish,hair,half,herb,interjected,lanceolate,lateral,leaf,leaflet,light,like,lobe,long,margin,membranous,mm,mottled,oblique,odd-pinnate,often,ovate,ovoid,pedicel,peduncle,petiole,plant,pubescent,purple,ray,rounded,seed,short,side,size,sometimes,sparsely,stem,stigma,style,subglabrous,subtending,terminal,tissue,tube,typically,unwinged,usually,violet,violet-purple,whitish,wide,wing,x	0,1,1-10,1-4,1.6-4,10,2,2-4,2-4.5,3-4,3.6-5,4-9,5-merou,acumen,ag,along,alyx,apart,apparently,articulated,axe,blade,borne,capitat,cell,ciliate,connivent,cordate,covering,digestion,dorsally,dot,eaf,edge,eed,elliptic,end,enzyme,erec,especially,exceeding,except,flat,folded,frequently,geminat,glabrou,greatly,green-white,hair-like,homostylous,honeycomb-shaped,lengthening,living,lower,make,middl,midrib,minutely,mucilaginous,nflorescence,obtuse,orbicular,orolla,pair,paired,pentagonal,perfect,petiolulate,petiolule,plurifoliate,pore,poricidal,proximal,puberulent,rarely,reduced,removed,ripe,rotate,ruit,scattered,sessile,seudostipule,singly,slightly,slit,small,spaced,specimen,stamen,ste,stolo,straight,subequal,subsessile,tall,tamen,tem,tertiary,testal,thick,throughout,tip,tri-,tuber,unit,unpaired,vary,wall,wet,white,yellow,ympodial	'',[,``,arrangement,bark,branch,calyx,capitate,characteristic,colour,corrugation,erect,exertion,form,fruiting,glabrousnes,growth,height,history,inflorescence,length,life,lobing,midpoint,na,new,number,ovary,per,prickle,primary,pseudostipule,shape,surface,texture,thicknes,type,value,variation,vein,width,{,}
529	wfo-0001032344	invalid_json_followup	157	153	100	57	53	0.637	0.2-0.5,1-1.3,1-4,1.5-4.5,1.5-6,1.6-2.4,10-29,2-2.8,2.2-4,3-5,3-7,3-8.5,3-9,3.5-6.5,5-10,6-15,9.5-21,absent,acuminate,acute,apex,apical,apically,articulate,base,bluish,branched,broadly,calyx,cell,cm,connate,corolla,covering,cuneate,cyme,dark,dehiscent,diameter,dichasial,dichasially,distal,dot,ebracteate,elliptical,exceeding,filament,globose,green,green-white,herbaceous,interjected,introrse,lateral,leaf,leaflet,lobe,long,long-attenuate,make,maturing,medium,mm,monochasial,mucilaginous,oblique,odd-pinnate,often,ovate,ovoid,pedicel,peduncle,perennial,petiole,plant,poricidally,puberulent,pubescent,purple,rotate,rotate-pentagonal,scarce,seed,short,size,slit,smooth,stamen,stigma,straight,style,terminal,testal,thick,typically,violet,wall,white,wide,yellow	1-3,2-3,2.8,3-6-foliat,4-11,4-8,abaxially,abruptly,acumen,adaxially,belo,decurrent,digestion,diminishing,dorsally,eaf,edge,eed,emoval,enzyme,flower,forked,generally,globo,hair-like,half,honeycomb,inrolled,layeral,living,lon,lower,lunat,nflorescence,nther,orolla,pair,pattern,perfect,petiolule,plan,proximal,reveal,ruit,sessile,seudostipule,sometimes,specimen,tal,tem,throughout,toward,tuber-bearing,unit,vary,ympodial,Â¼	'',7,[,\u201chair-like\u201d,``,anther,appearance,arrangement,bark,branch,bud,characteristic,colour,corrugation,drying,exertion,form,fruit,fruiting,giving,glabrousnes,growth,height,history,inflorescence,length,life,lobing,margin,midpoint,na,new,number,ovary,per,prickle,primary,pseudostipule,ray,shape,stem,surface,texture,thicknes,tube,type,value,variation,vein,wet,width,{,}
530	wfo-0001032354	success	171	143	93	78	50	0.544	0-5,1-2,2-2.5,2.5-3,250-400,38/2,5-15,acute,anther,apex,aster,axillary,base,becoming,berry,bilobed,branch,branched,broadly,brown,calyx,campanulate,capitate,cm,coarsely,colour,corolla,cuneate,decurrent,deep,dia,discoidal,distal,ellipsoid,except,exerted,filament,fork,glabrous,glandular,globose,green,greenish-ivory,greyish,hair,halfway,lasting,leaf,lobe,lobed,maturity,minute,minutely,mm,narrow,obovate,obovoid,occasionally,ovary,ovoid,pedicel,peduncle,pinnatisect,poricidal,puberulent,rh,rounded,rugose-reticulate,several,shape,shrub,simple,size,slightly,soft,somewhat,sparse,spreading,stem,stigma,straight,strongly,style,surface,tip,variable,vein,violet,wide,wing,wooded,woody,year	0,0.3,0.5-1,0.8-1,0.8-1.2,1-10,1-3,1-5,10-lobed,2,25,29,3-4,4-6,40-75,5-10,acuminate,almost,angular,anthesi,aspect,axi,c.,cell,creating,cut,deeply,eaf,eed,effect,facetted,fleshy,flower,general,gre,gree,lanceolat,large,lengthening,linear,lower,midrib,nflorescence,oval,ovate,pair,pale,pebble-shaped,pedicellate,plurifoliat,pore,pubescent,rather,rotate,ruit,secondary,seedling,shoot,single,sinus,slit,small,smaller,smel,stellate,stone,tall,trichome,tub,ud,uniseriate,unit,unpleasant,usually,within,x,ympodial,young	10,4,5,appearance,arrangement,bark,border,bud,characteristic,corrugation,diameter,drying,exertion,form,fruit,fruiting,giving,glabrousnes,growth,height,history,inflorescence,interjected,lateral,leaflet,length,life,lobing,margin,midpoint,na,new,number,per,perennial,petiole,plant,plurifoliate,prickle,primary,pseudostipule,ray,seed,terminal,texture,thicknes,tube,type,variation,width
531	wfo-0001032358	success	216	138	118	98	20	0.546	.1,.2,.4,.5,/2,0,0.2-4,0.5-3,0.7-1,1-2,1.3-1.7,1.5-2,13-20,15-40,2-3,2.2-7.5,3-10,3-4,3.5-13,4-4.5,4-7,4-8,4.5-5,abaxially,acute,adaxially,anther,anthesi,apex,appearing,armed,bark,base,berry,branched,brown,calyx,capitate,center,cm,cordate,corolla,curved,densely,diameter,entire,exserted,filament,flattened,flower,fruit,fruiting,furcate,glabrescent,glabrous,globose,green,growth,inflorescence,internodal,irregular,leaf,like,lobe,long,longer,margin,membranous,midpoint,minutely,mm,new,often,ovate,ovoid,pair,pale,paler,pedicel,peduncle,per,petiole,pitted,planar,porrect,present,primary,pubescent,purple,ray,reniform,rhachi,ripening,sessile,short-stalked,shrub,simple,sinuate,slightly,somewhat,sparsely,spreading,stellate,stem,stigma,strongly,style,surface,tan,time,trichome,tube,tuberculate,type,vein,way,x,yellowish	.3,0.6-0.8,0.6-1,1-1.6,1.5-2.5,1/4-1/2,12-20,2,2-10,2-4,2-5,4-merous,abscissio,along,another,apart,away,basal,based,broad,bulbous,cell,cupuliform,difoliate,dorsal,drying,eaf,eed,equal,erect,expanding,free,frui,geminate,glabrescen,heteromorphic,interpetalar,irregularly,lamina,left,lengthening,linear,lobed,lower,lowermost,margined,markedly,maturity,midrib,midvein,nflorescence,nodding,occasionally,older,one,orangish,papillat,papillate,part,peg,perfect,pericarp,persistent,pore,poricidal,portion,prickle,prickly,red,rotate-stellate,ruffly,ruit,scar,shiny,short,sinus,slit,small,sometimes,space,spaced,staman,thick,thin,three,tip,tub,two,ud,unevenly,unisexual,unit,upper,usually,whitish,widely,ympodial,zygomorphic	arrangement,bud,characteristic,colour,exertion,form,glabrousnes,height,history,length,life,lobing,na,number,perennial,plant,seed,shape,size,texture
532	wfo-0001032367	invalid_json_followup	231	140	81	150	59	0.351	0-0.3,0.4-0.5,0.7-1.1,1-2.1,100-300,6-8,acicular,acute,anther,apex,base,berry,branch,broad-based,calyx,capitate,cm,conical,cordate,dark,diameter,erect,filament,flattened-reniform,free,fruiting,glabrous,glandular-puberulent,globose,green,greenish,immature,inflorescence,lateral,leaf,length,light,lobe,lobed,long,margin,maturity,membranous,midpoint,minute,minutely,mm,mottled,nearly,obtuse,ovary,ovate,pale,pedicel,peduncle,per,petiole,prickle,pubescent,ray,red-brown,sessile,shrub,simple,size,spreading,stellate,stem,stigma,style,suborbicular,surface,tapering,tip,triangular,truncate,tube,vein,white,wide,yellow	-3,.2,.4,0.2â0.35,0.4â0.5,0.4â0.6,0.4â1,0.5â0.8,0.5â2,0.6,0.6â0.8,0.8,0.8â2,1-2,1.2,1â1.5,1â1.8,2,2-3-celled,2-4,2.2â2.5,2.2â2.8,2.5â3,2â2.5,3-5,3-celled,3.2â4,3â10,3â5,3â6,4,4â6.5,5-merous,5.5â6.9,5â18,6.8â8.2,7â10,8,abaxial,abaxially,accrescent,adaxial,adaxiall,adaxially,also,alyx,anthesi,arme,around,axi,ba,blade,congested,connivent,copious,cream,curved,deciduous,densely,difoliate,directed,distall,eaf,eed,enlarged,entire,equal,expand,fertile,flower,geminat,geminate,gland-tipped,grading,hair,herbarium,heterostylous,hyaline,infructescence,lanceolate,largest,layer,least,long-styled,longer,lower,lowermost,major,many,mesocarp,mixed,mixture,moderately,narrowly,nflorescence,often,one,orolla,oung,pair,papillat,pore,poricidal,portion,prickly,puberulent,pubescence,rarely,recurved,rest,ruit,scarcely,scattered,secondary,shallow,short-styled,shorter,similar,slender,small,smaller,somewhat,sparsely,specimen,spongy,spreadin,staminat,ste,straight,tall,tamen,terete,thick,tightly,time,tooth,trichome,twice,unarmed,unbranched,uniformly,uniseriate,unit,usually,variable,vary,whitish,ympodial,â15,â5	'',0.5-0.8,0.5-2,0.6-0.8,0.8-2,1-1.8,15,2-2.5,2.2-2.5,2.2-2.8,3-6,5-18,5.5-6.9,6.8-8.2,7-10,[,``,appearance,armed,arrangement,bark,border,bud,characteristic,colour,corolla,corrugation,distal,drying,exertion,form,fruit,giving,glabrousnes,growth,height,history,interjected,leaflet,life,lobing,na,new,number,papillate,plant,primary,pseudostipule,seed,shape,terminal,texture,thicknes,type,value,variation,width,{,}
533	wfo-0001032407	invalid_json_followup	216	160	117	99	43	0.542	0-4,0.4-4,0.5-3,0.8,1-2,1-2.4,1.2-7,1.4-2.7,1.5-2.2,10-27,2-10.5,2.5-10.5,2.5-9,3.1-13.5,4-48,4-7,5,5-23,5-30,8-10,abaxially,acuminate,adaxially,anther,apex,attenuate,axillary,base,berry,brownish,bud,cell,clavate,cm,coarsely,condition,conical,connivent,corolla,covering,dark,densely,diameter,distal,drying,elliptic,filament,finely,flower,forked,fresh,fruit,generally,glabrous,green,green-white,greenish,hair,hair-like,half,herb,interjected,lanceolate,lateral,leaf,leaflet,less,light,like,lobe,long,make,margin,medium,minute,mm,mucilaginous,narrow,obtuse,odd-pinnate,orbicular,ovate,ovoid,pedicel,peduncle,petiole,plant,puberulent,pubescent,purple,rarely,ray,ripe,round,seed,sessile,simple,size,sparsely,stem,stigma,style,subtending,terminal,testal,thick,throughout,tube,unwinged,usually,wall,wet,white,whitish,wide,wing,x	0.3-0.6,0.3-8,0.8-0.3,1-10,1-5,10-19.5,12,2-4,3-15,30,38,4-11,5-merou,6,7-9,absent,acumen,ag,along,alyx,apart,apparently,arranged,articulated,asymmetrical,axe,basiscopic,bead,blade,capitat,chartaceous,ciliate,commonly,decreasing,digestion,eaf,edge,eed,elongated,enzyme,erec,especially,exceeding,folded,geminat,glabrou,gradually,homostylous,honeycomb-shaped,larger,lengthening,living,lower,membranous,middle,minutely,moniliform,mottled,multiple,necklace,nflorescence,orolla,pair,pentagonal,perfect,petiolule,plurifoliate,pore,poricidal,proximal,pubescen,removed,rotate,ruit,secondary,semierect,seudostipule,side,slit,spaced,specimen,stamen,ste,stolon,straight,subequal,symmetrical,tall,tamen,tem,tip,tissue,tri-,tuber,typically,unit,vary,yellow,ympodial	'',[,``,arrangement,bark,branch,calyx,capitate,cayx,characteristic,colour,corrugation,exertion,form,fruiting,glabrousnes,growth,height,history,inflorescence,length,life,lobing,midpoint,na,new,number,ovary,per,prickle,primary,pseudostipule,shape,surface,texture,thicknes,type,value,variation,vein,width,{,}
534	wfo-0001032465	success	233	182	158	75	24	0.678	+,-10,-11,-14,-9,.2,.5,0,0.2,0.5-,0.5-2,1-,1-1.5,1-1.7,1-celled,1.2-1.5,1.5-1.8,1.5-2,1.5-5,1/3,2,2-2.5,2.5-5.5,25,3-3.5,3-8,4,5,5-7,5-8,9,acuminate,acute,angled,anther,anthesi,apex,articulated,axi,basal,base,berry,black,branched,brown,calyx,capitate,clasping,cm,commonly,conical,connivent,cordate,corolla,de,deeply,deltate,densely,diameter,distal,drying,ellipsoid,elliptic,entire,filament,filiform,flattened,flower,fruiting,glabrous,gland,glandular,glandular-tipped,globose,green,greenish,growth,half,included,inflorescence,janeiro,larger,later,lateral,leaf,leaving,length,like,lobe,lobed,long,loosely,lower,margin,minute,minutely,mm,narrowly,new,nodding,often,outline,ovate,pair,pedicel,peduncle,peg,per,petiole,pinnate,pinnatifid,poricidal,primary,puberulent,pubescent,purplish,reddish,reniform,reticulate,revolute,rio,ripe,seed,shape,similar,simple,size,sleeve,sparsely,stem,stigma,strongly,style,surface,terminal,time,tiny,tip,transparent,trichome,truncate,tube,unicellular,uniseriate,upper,usually,variously,varying,vein,vine,violet,way,white,woody,x,yellowish,young,Â½	1.5,3-4,3-5,3-9,5-merou,abaxial,ag,alyx,apar,apically,appearing,ark,cell,ciliate,coriaceous,decreasing,deep,deeper,eaf,edge,eed,elongate,erect,exserte,free,fringe,glabrescen,growing,ilament,irregular,irregularly,lengthening,mature,membranous,nflorescence,occasionally,older,orolla,paired,papillate,papillo,pendan,pentagonal,perfect,pericarp,planar,plurifoliat,pore,portion,ruit,scar,scattered,shallow,shiny,sinus,slit,somewhat,spaced,splitting,stellate-rotate,subshrub,tem,testal,thicker,thin,toward,tuft,twinin,twining,ud,unit,vary,wall,widest,ympodial	arrangement,bark,branch,bud,characteristic,colour,corrugation,exertion,exserted,form,fruit,glabrescent,glabrousnes,height,history,life,lobing,na,number,ovary,papillose,plant,texture,type
535	wfo-0001032494	invalid_json_followup	163	143	94	69	49	0.577	.1,.5,0.75-1,0.8-1,0.9-1.2,1-1.5,1.45-1.5,1.5,1.5-8,1.6-2,16.5-20.5,2.3-2.5,2.5,2.5-8,3/4,5-40,5-6.4,8-11,accrescent,acuminate,anther,anthesi,apex,attenuate,bark,base,berry,brown,calyx,clavate,cm,corolla,decurrent,dia,exserted,filament,flattened-reniform,flowered,fruit,fruiting,furcate,glabrous,globose,greenish-yellow,lateral,leaf,light,lobe,lobed,long,main,margin,minutely,mm,narrowly,occasionally,opposite,ovary,ovate,ovoid,pair,pale,papillose,pedicel,petiole,pitted,revolute,shaped,shrub,simple,size,slender,small,stem,stigma,straight,style,surface,tapering,tear-drop,tree,triangular,trichome,tube,two-winged,uniseriate,vein,way,white,whitish-green,winged,x,yellow,zig-zag	.4,0.6-1,1.1-1.2,1.8-4.5,3-4,3.4-14.5,4-8,apart,appearing,axil,ba,beginning,beneath,bullate,deflexed,differing,difoliate,dry,eaf,edicel,eed,equal,evenly,except,expanded,free,geminat,geminate,incrassate,inflorescenc,lax,lenticellat,lon,lower,major,material,middle,minor,nearly,nflorescence,node,orange,papillae,papillo,planar,pore,poricidal,portion,prominent,proximal,pubescent,quite,raised,ridge,ruit,scar,slightly,somewhat,spaced,tall,tan,tip,ud,unit,upper,venation,widest,woody,ympodial	'',2.4,[,``,alternate,arrangement,branch,bud,character,characteristic,colour,corrugation,diameter,distal,drying,exertion,form,glabrousnes,growth,height,history,inflorescence,interjected,leaflet,length,life,lobing,midpoint,na,new,number,peduncle,per,plant,prickle,primary,pseudostipule,ray,seed,shape,terminal,texture,thicknes,type,value,variation,width,{,}
536	wfo-0001032507	invalid_json_followup	206	146	85	121	61	0.413	.5,/4,0.3,0.5,1,1.3,2,6,abaxially,acuminate,acute,adaxially,anther,anthesi,apex,base,berry,blue,branched,brown,bud,calyx,campanulate,chartaceous,cm,compound,connivent,corolla,diameter,ellipsoid,entire,exserted,filament,flattened-reniform,fruiting,glabrous,globose,green,herbaceous,lateral,leaflet,light,lobe,lobed,long,margin,minutely,mm,narrowly,oblong,pedicel,peduncle,perennial,petiole,pinnate,pinnately,pinnatifid,pitted,plant,prickle,pulp,purple,quadrate,rarely,reddish,rounded,shape,side,simple,slender,stem,stigma,strongly,style,surface,terminal,tube,unbranched,variously,vein,vine,way,white,woody,Ã	.2,0.25,0.7-1.2,0.8,1.2-1.7,1.5â2,1.5â7,10â20,15â20,1â1.5,1â10,2.5â4,2.5â6,20â30,2â9,3â5,3â7,4â10,5â10,5â20,5â8,8â15,abaxial,absent,abundant,adaxiall,adjacent,ag,alyx,apiculate,armed,articulated,becoming,blade,broadly,cell,collection,confluent,cream,curved,deep,deltate,distally,distinct,dr.,eaf,eed,either,elliptic,elongating,equal,fertile,fifth,flower,flowering,four,hair,herbarium,highly,individual,internode,interpetalar,larger,lengthening,longer,lower,major,material,midrib,nearly,nflorescence,observe,occasionally,often,one,orolla,ovate,pale,papery,pentagonal,pericarp,pistillate,plurifoliat,pore,poricidal,present,puberulent,purplish,rachi,ranging,recurve,regularly,rotate-pentagonal,rugose,ruit,single,sinus,slightly,slit,sometimes,spreading,staminate,stout,straight,tamen,tear,testal,time,tip,tissue,unequal,unit,unlobed,usually,variable,vary,wide,widest,wood,yellowish,ympodial	'',0.25-0.8,1-1.5,1.5-2,1.5-7,10-20,15-20,2.5-4,2.5-6,3-5,4,4-10,5-10,5-8,8-15,[,``,appearance,arrangement,bark,branch,characteristic,colour,corrugation,distal,drying,exertion,form,fruit,giving,glabrousnes,growth,height,history,inflorescence,interjected,leaf,length,life,lobing,midpoint,na,new,number,ovary,per,plurifoliate,primary,pseudostipule,ray,recurved,seed,size,texture,thicknes,type,value,variation,width,{,}
537	wfo-0001032523	invalid_json_followup	200	155	112	88	43	0.56	-2,-5,.2,.5,/4,0.1-0.2,0.3-0.5,0.4-1,0.6-0.7,0.6-0.8,1-1.5,1-3,1.3-1.6,1.5-3,10-50,2-2.4,2-4,2-5.5,2.7-3,3-15,5-20,6-10,6-8,abaxially,acuminate,acute,anther,apart,apex,apically,apparently,bark,base,berry,calyx,cm,conical,cuneate,curved,deltate,diameter,discolorous,drying,dull,elliptic,entire,erect,evenly,filament,filiform,flattened-reniform,fruit,fruiting,gently,glabrescent,glabrous,green,inflated,lateral,leaf,length,lobe,long,margin,maturity,mauve,membranous,midpoint,mm,moderately,older,orange,orange-brown,ovate,pair,pale,pedicel,peduncle,per,petiole,poricidal,prickle,prickly,primary,ray,recurved,red,red-brown,shrub,simple,sometimes,spaced,sparsely,spherical,stellate-pubescent,stem,straight,strongly,style,subentire,surface,tapering,terminal,tip,tube,unarmed,vein,way,weakly,wide,yellow,young	0-0.15,0-10,0-12,0-15,0-3,0.2,0.2-0.4,0.4-1.5,0.5-1,1-2,1-8,1/3-1/2,1/4-1/3,15-30,2,2-2.5,2.5-6,3-4,3.5-4,4-5-merous,4-7,5-12,6-20,abaxial,acuminat,adaxial,alyx,ame,apar,articulated,blade,branching,brow,c.,connivent,eaf,eed,elongating,equal,flower,free,glabrou,hair,herbaceous,infructescence,lobed,lon,longer,lower,mature,minute,multangulate,narrow-deltate,nflorescence,one,open,orolla,oung,perfec,pericarp,perpendicular,plurifoliat,porrect,portion,reflexed,ruit,scandent,scar,secondary,sessile,smooth,spreading,stalk,stalked,stellate,tamen,terete,tertiary,time,trichome,unarme,unit,variously,vary,venation,visible,woody,ympodial	'',[,``,appearance,arrangement,branch,brown,bud,characteristic,colour,corolla,distal,exertion,form,giving,glabrousnes,growth,height,history,inflorescence,interjected,leaflet,life,lobing,na,new,number,ovary,perennial,plant,pseudostipule,seed,shape,size,stigma,texture,thicknes,type,value,variation,width,{,}
538	wfo-0001032524	success	205	119	79	126	40	0.385	1-2,1-2.5,1.5-2,1.5-4,10-35,12-13,14-50,2-3,2-5,2.5-8,25-90,3-8.5,3.5-4.5,4.5-8,6-16.5,7-8,acute,anther,apex,axillary,base,berry,bud,clavate,cm,corolla,cuneate,densely,diameter,distal,drying,elliptic,filament,forked,fruit,generally,glabrous,globose,grayish-green,green,greenish,half,herb,interjected,lanceolate,lateral,leaflet,length,light,lilac,lobe,margin,mm,mucilaginous,narrowly,obtuse,odd-pinnate,ovate,ovoid,pedicel,peduncle,petiole,plant,pubescent,purple,rounded,seed,size,stem,stigma,style,subtending,terminal,tube,unwinged,usually,violet,whitish,x	1-10,120-210,3-4,3-5,4,4-5,4.5-5,5-6,5-9,5-merou,50-70,6-13,7-35,?,abaxially,acumen,adaxially,ag,along,alyx,apart,apparently,arranged,articulated,ascending,attenuate,axe,bead,blade,brownish,capitat,cell,chartaceous,ciliate,condition,connivent,covering,different,digestion,dorsally,eaf,edge,eed,enzyme,erec,especially,exceeding,except,flat,flower,folded,fresh,geminat,glabrou,greatly,green-white,hair,hair-like,hal,head,homostylous,honeycomb-shaped,lengthening,like,living,long,lower,make,membranous,middle,midrib,minutely,moniliform,multicellular,multiple,necklace,nflorescence,non-glandular,often,orolla,pair,pentagonal,perfect,petiolulate,petiolule,plurifoliate,pore,poricidal,proximal,puberulent,reduced,removed,ripe,rotate,ruit,sessile,seudostipule,short,silky,silvery-white,slit,spaced,specimen,stamen,ste,stolon,straight,subequal,tall,tamen,tem,testal,tetralobulate,thick,throughout,tip,tri-,trichome,tuber,typically,unit,vary,wall,wet,yellow,ympodial	appearance,arrangement,bark,border,branch,calyx,capitate,characteristic,colour,corrugation,exertion,form,fruiting,giving,glabrousnes,growth,height,history,inflorescence,leaf,life,lobing,midpoint,na,new,number,ovary,per,prickle,primary,pseudostipule,ray,shape,surface,texture,thicknes,type,variation,vein,width
539	wfo-0001032532	success	161	121	73	88	48	0.453	0.3-2.5,1-4,1.5-2.6,1.5-3.2,1.5-4.3,13-52,15-30,2-10,2-13,2.8-3.6,2.8-9.5,3-10,3.4-12.2,3.7-10,4-5.5,6,6-22,acuminate,acute,apex,articulate,base,branched,calyx,cm,conical,corolla,cuneate,cyme,deep,diameter,dichasial,dichasially,distal,ebracteate,elliptical,filament,finely,green,green-white,herbaceous,interjected,lateral,leaf,leaflet,light,lobe,long,long-attenuate,medium,mm,monochasial,mucilaginous,oblique,odd-pinnate,ovate,ovoid,pedicel,peduncle,perennial,petiole,plant,pubescent,purple,rotate,rounded,seed,size,stigma,straight,style,terminal,wide	0-.,1-1.5,2,2-,2-3,3-5,3-6-foliat,4.5,8-38,abaxiall,abaxially,absent,acumen,adaxially,apical,apically,attenuate,cell,coarsel,connate,covering,dehiscent,digestion,diminishing,dorsally,eaf,edge,eed,emoval,enzyme,exceeding,flat,flower,folded,forked,generally,globo,gradually,hair-like,half,honeycomb,introrse,living,lon,lower,lunat,make,maturing,minute,narrowly,nflorescence,nther,obtuse,often,orolla,pair,pattern,perfect,petiolule,plan,poricidally,proximal,reveal,ruit,sessile,seudostipule,short,slit,specimen,stamen,subequal,subsessile,tal,tem,testal,thick,throughou,throughout,tip,toward,tuber-bearing,typically,unit,vary,wall,yellow,ympodial,Â¼	0-2,anther,appearance,arrangement,bark,border,branch,bud,characteristic,coarsely,colour,corrugation,drying,exertion,form,fruit,fruiting,giving,glabrousnes,globose,growth,height,history,inflorescence,length,life,lobing,margin,midpoint,na,new,number,ovary,per,prickle,primary,pseudostipule,ray,shape,stem,surface,texture,thicknes,tube,type,variation,vein,width
540	wfo-0001032536	invalid_json_followup	254	170	134	120	36	0.528	/3,0.5,1,1-2.5,1.3-2.2,10,10-30,100,14-16,2-3,2.5-3,20-22,20-50,3-3.5,4-6,4-9,5,5-8,5.5-8,7-10,<,>,abruptly,acute,age,almost,anther,anthesi,apex,appressed,armed,bark,basal-most,base,berry,bright,bristle,bristly,broad-based,brown,calyx,capitate,caudate,chartaceous,clavate,cm,conical,curved,dark,deeply,densely,depressed,diameter,elliptic,entire,fading,filament,flattened,fruit,fruiting,glabrous,glandular,globose,grayish,growth,inflorescence,lateral,leaf,leaf-opposed,length,lobe,lobed,long,margin,maturity,membranous,midpoint,minute,minutely,mixture,mm,multiseriate,narrowing,near,new,number,oblique,olive-green,once-branched,ovary,papillae,papillate,part,pedicel,peduncle,per,petiole,plant,poricidal,porrect,prickle,prickly,primary,pubescent,purple,ray,reddish,reniform,simple,slightly,small,somewhat,sparsely,spreading,stellate,stem,stigma,style,surface,tapering,terete,terminal,tip,tree,trichome,truncate,tube,unarmed,vein,way,white,wide,yellow-green,yellowish	-3,1-2,1.5,10-20,10-50,13-24,20-25,3,3-6,4-8,5-6,5-merous,abaxial,abaxially,adaxial,adaxiall,adaxially,along,alyx,angle,apar,around,articulated,axi,berr,blade,broadly,caudat,cell,clearly,coriaceous,cu,dbh,deltate,denser,difoliate,directed,diverging,eaf,eed,enlarged,equal,evenly,flower,free,geminate,glabrescent,glandular-puberulent,halfway,hanging,heterostylous,inflorescenc,infructesecnce,interpetalar,irregularly,juvenile,lamina,leaving,like,long-stalked,long-styled,lower,mature,midrib,midvein,mixed,multangulate,narrowly,nflorescence,occasionally,occurring,odor,older,open,orolla,oung,papillat,pentagonal,pericarp,pore,portion,potato,prickl,prominent,protuberance,rarely,reproductive,rough,ruit,scar,scattered,shallowly,short-,short-styled,slender,smooth,soft,spaced,stalk,staminate,stellate-pubescent,strongly,tall,tamen,thick,time,tissue,triangular,trunk,unequal,unit,upward,urceolate,usually,vary,visible,wood,woody,ympodial,younger	'',[,``,arrangement,branch,bud,characteristic,colour,corolla,corrugation,distal,drying,exertion,form,glabrousnes,height,history,interjected,leaflet,life,lob,lobing,na,perennial,pseudostipule,seed,shape,size,texture,thicknes,type,value,variation,width,{,}
541	wfo-0001032542	success	161	117	89	72	28	0.553	/4,0.5-1,0.7-1,1-1.3,1-1.5,1-5,10-15-flowered,10-28,2-3,3-4,4-9.5,4.5-5,5-8,acuminate,acute,adaxially,anther,apex,attenuate,bark,base,berry,bluish-green,bright,brown,calyx,capitate,cm,conical,corolla,dark,deflexed,dendritic,densely,dia,difoliate,elliptic,elliptic-obovate,exserted,filament,flattened-reniform,fruiting,glabrous,globose,golden,green,growth,incrassate,inflorescence,later,leaf,less,long,margin,minutely,mm,new,opposite,ovary,pedicel,petiole,pitted,pubescent,reddish-brown,shape,shaped,shining,shrub,simple,size,slender,small,stem,stigma,strongly,style,surface,tear-drop,treelet,trichome,tube,unit,vein,way,wide,x,yellow-green,yellowish,young	.25,.25-0.5,.5,.5-1,1-2,1.5-3.5,2-3.5,2.5-5,3-5,4-7,abaxial,abaxially,along,anthesi,apical,axi,ba,basal,beginning,closely,compact,deltate,di,differing,distal,dry,eaf,edicel,eed,either,erect,free,geminat,inflorescenc,lamina,lateral,like,lobe,lobed,lon,loose,lower,main,major,minor,minute,narrowly,near,nflorescence,older,overlapping,pair,papillo,persisten,planar,pore,poricidal,portion,rounded,ruit,scar,slightly,somewhat,spaced,sparsely,swollen,tip,triangular,tub,ud,woody,ympodial	0.25,arrangement,branch,bud,characteristic,colour,corrugation,diameter,drying,exertion,form,fruit,geminate,glabrousnes,height,history,length,life,lobing,na,peduncle,perennial,plant,primary,seed,sympodial,texture,type
542	wfo-0001032564	success	160	140	96	64	44	0.6	.05-0.1,.1,.5,0.25-0.5,0.3-1,1-1.3,1-1.5,1-2,1.3-2.5,1.5,2-2.5,4-5,4-6-flowered,5.5-9,6-7,8-9,along,anther,apex,arched,bark,base,becoming,beneath,berry,branch,broadly,brown,bud,calyx,clavate,cm,conical,corolla,dark,deflexed,densely,dia,dry,elliptic,exserted,filiform,flattened,fresh,fruiting,giving,glabrous,globose,green,greenish-white,greyish-red,lateral,leaf,lobe,lobed,long,long-acuminate,main,margin,material,minutely,mm,narrowly,nearly,ovary,ovate,ovoid-reniform,pair,papillose,pedicel,petiole,pitted,puberulent,ripe,shaped,shiny,shrub,simple,soon,stem,stigma,style,surface,tan,tear-drop,thread-like,trichome,truncate,tube,unifoliate,uniseriate,vein,winged,x,yellowish-green,young	.05,0.75-1,1-1.2,anthesi,apar,apart,aspec,ba,converging,deltoid,eaf,edicel,eed,except,expanded,extreme,flower,geminate,glabrate,golden,halfway,lamina,later,like,lower,member,middle,minute,nflorescence,node,non-reproductive,obovoi,often,older,one,open,opposite,papillo,planar,point,pore,poricidal,projection,prominent,proximal,raised,reflexed,rounded,ruit,scar,slightly,small,straight,strongly,tall,tapering,time,tiny,tip,ud,unit,widest,woody,ympodial	appearance,arrangement,border,characteristic,colour,corrugation,diameter,distal,drying,exertion,filament,form,fruit,glabrousnes,growth,height,history,inflorescence,interjected,leaflet,length,life,lobing,midpoint,na,new,number,peduncle,per,perennial,plant,prickle,primary,pseudostipule,ray,seed,shape,size,terminal,texture,thicknes,type,variation,width
543	wfo-0001032569	success	164	136	92	72	44	0.561	.5,/3,0.5-10,0.8-1,1-1.2,1-2,1-4,1.2-5,1.5-2,1.7-2,2-3,4-18,5-6,7-27,7-9,acute,anther,apex,bark,base,berry,bilobed,branched,broadly,brown,bullate,calyx,cm,conical,corolla,corrugated,dark,decurrent,deflexed,dendritic,densely,dia,dry,drying,ellipsoid,elliptic,erect,exserted,filament,flattened,fruiting,glabrous,globose,green,inflorescence,irregularly,later,lateral,leaf,lobe,lobed,main,margin,matted,minutely,mm,occasionally,onto,ovary,ovate,pair,papillose,pedicel,petiole,pitted,pubescent,reniform,shaped,shrub,simple,size,somewhat,splitting,stem,stigma,strongly,style,surface,tear-drop,thick,triangular,trichome,tube,vein,way,white,x	1-1.5,1.5,2-4,4-8,5-60-flowered,abaxially,adaxially,along,anthesi,apparently,appearing,axi,bearing,cell,closely,dense,denser,differing,difoliate,eaf,edicel,eed,fleshy,free,geminate,golden,gra,incrassate,lea,like,lon,long,los,lower,major,mature,middle,minor,moderately,nflorescence,obscured,open,opposite,otherwise,paler,papillo,pericar,planar,pore,poricidal,portion,present,pubecsence,rich,ruit,scar,spaced,sparsely,stone,tall,time,tip,tub,tuft,ud,unifoliate,unit,waxy,widest,woody,ympodial,young	alternate,appearance,arrangement,border,branch,bud,characteristic,colour,corrugation,diameter,distal,exertion,form,fruit,giving,glabrousnes,gray,growth,height,history,interjected,leaflet,length,life,lobing,midpoint,na,new,number,peduncle,per,plant,prickle,primary,pseudostipule,ray,seed,shape,terminal,texture,thicknes,type,variation,width
544	wfo-0001032576	invalid_json_followup	229	174	133	96	41	0.581	/5,0-5,0.1-0.15,0.3-0.5,0.3-0.7,0.5-1,0.5-2,0.5-4,0.8-1.2,0.8-1.4,0.8-2,1.2-1.8,1.5-2,1.5-2.3,1.5-7.5,1.8-2.5,1/3,2-10,2-4,3-14,4,4-6,4-6.5,abaxially,acute,anther,apart,apex,apically,apparently,articulated,bark,base,berry,bright,brown,brown-green,calyx,cell,chartaceous,cm,conical,cuneate,curved,deltate,densely,diameter,dull,ellipsoid,entire,erect,evenly,filament,flattened,flattened-reniform,fruit,fruiting,glabrescent,glabrous,glandular,gray,green,hair,herb,lanceolate,lateral,leaf,length,lobe,lobed,long,margin,maturity,membranous,midpoint,minutely,mm,moderately,near,obtuse,often,orange-brown,outline,ovate,pair,pale,pedicel,peduncle,per,petiole,pit,poricidal,prickle,prickly,primary,purple,raised,ray,red,red-green,reflexed,reticulate,scandent,shiny,shrub,simple,slightly,small,sometimes,spaced,sparsely,spherical,spreading,stellate,stellate-pubescent,stem,straight,style,surface,tapering,terminal,tip,trichome,tube,upper,vein,way,white,wide,yellow,yellow-green,yellow-orange,young	-10,-12,-2,-2/3,/4,0,0-1.5,0-3,0-30,0.1,0.1-0.2,0.1-0.25,0.5-1.5,1-3,1-4,1/2,1/3-1/6,2-3,2-5,2.5-3,2.5-4,4-,4-5-merous,5-30,6-8,7-8,acuminat,alyx,apar,ascendant,ba,blade,branched,branching,brow,concolorous,difoliate,distance,drying,eaf,eed,elongating,equal,extending,eye,faint,flower,free,geminat,gland,globular,herbaceous,infructescence,longer,lower,mature,midvein,naked,narrow-deltate,narrow-ovate,nflorescence,obovate,older,one,open,orolla,oung,perfec,pericarp,porrect,portion,prickl,reduced,rounded,ruit,scar,sessile,short,shorter,side,slender,smooth,stalk,stalked,tamen,tertiary,time,unarmed,unit,usually,variously,vary,venation,visible,woody,ympodial	'',15-30,[,``,acuminate,arrangement,branch,bud,characteristic,colour,corolla,distal,exertion,form,glabrousnes,growth,height,history,inflorescence,interjected,leaflet,life,lobing,na,new,number,ovary,plant,pseudostipule,seed,shape,size,stigma,texture,thicknes,type,value,variation,width,{,}
545	wfo-0001032595	success	200	143	101	99	42	0.505	-25,0-,0.5-1,0.5-3.5,1-2,1-3,1.5-2,1.5-2.5,1.5-4.5,1.5-5,15-25,15-40,2-4,25-40,3-10,3-12,3-4,4-7,5-6,6-7,acuminate,acute,along,also,anther,apex,apical,basal,base,branch,branched,brownish-purple,calyx,cm,connivent,cordate,cream,deeply,densely,diameter,dull,eglandular,ellipsoidal,entire,filament,finely,flattened,flower,fork,forked,fruit,fusiform,glabrous,gland,glandular,greenish,hair,lanceolate,leaf-opposed,lobe,long,loosely,margin,mature,mm,moderately,oblique,often,ovate,ovoid,pale,pedicel,peduncle,petiole,pilose,prominent,pseudohair,puberulent,pubescent,purplish,rarely,reniform,rugulose,shrub,simple,small,sparsely,stellate,stigma,style,subcoriaceous,tree,truncate,tube,two,unbranched,vein,violet,white,x,yellow	-20,-pilose,1,1-2.5,1-6,1-6.5,12-16,2-3,2.3-24,3-4-foliate,3-5,4-25,4-5,5-merou,9-14,abaxially,accrescen,adaxially,aggregate,alyx,apart,ape,apiculate,articulated,axe,blade,brownish,cell,ciliat,connective,coriaceous,crow,cucullate,deltate,dense,denser,dilated,directed,distally,eaf,eed,equal,exceeding,free,fruiting,geminate,homostylous,larg,leaving,lon,longitudinal,lower,m.,major,midrib,narrowly,near,nflorescence,opening,orolla,part,pedicellar,per,perfect,pilo,pore,produced,purple,rachi,remnant,ruit,shallow,shorter,side,single,slightly,slit,spaced,spreading,stamen,stone,strongly,swelling,tall,tamen,tem,thecae,time,tip,tomentose,toward,triangular,trunk,ud,umbrella-shaped,unit,vary,wide,ympodial	abaxial,adaxial,appearance,arrangement,bark,border,bud,characteristic,colour,corolla,corrugation,drying,exertion,form,giving,glabrousnes,growth,height,history,inflorescence,lateral,leaf,length,life,lobing,midpoint,na,new,ovary,perennial,plant,prickle,ray,seed,shape,size,stem,surface,texture,type,variation,width
