	coreid	status	nwords_original	nwords_result	nwords_recovered	nwords_omitted	nwords_created	prop_recovered	common_words	original_only	result_only
0	wfo-0001025652	success	156	93	66	90	27	0.423	0.5-1,1,1-1.5,1.5-2,15-17,2-3,2-6,3-3.5,3-5,4,4-6,4-7,acuminate,acute,anther,apex,base,calyx,cm,corolla,decurrent,densely,elliptic,filament,fleshy,fruit,furcate,glabrous,green,growth,irregular,leaf,lobe,margin,minutely,mm,occasionally,ovary,ovoid-reniform,pair,pale,paler,papillose,parallel,pedicel,petiole,pinkish-grey,pitted,plant,red-papillose,shape,shiny,shrub,simple,small,stem,straight,strongly,style,surface,tan,tree,vein,white,winged,x	.3,.5,10-20,15-19,2-5,20-50,3-5-flowered,9-11,abruptly,anthesi,appearing,bark,bilobed,blade,broad,campanulate,closed,closely,completely,connate,dia,differing,difoliate,dry,eaf,edicel,eed,emerge,envelope,flower,free,geminat,glabrate,greyi,greyish,growing,lateral,like,live,lobed,lon,long,lower,main,major,matte,middle,minor,minute,narrowing,nearly,new,nflorescence,older,one,onto,opposite,overlappin,ovoid,papillae,papillo,planar,pore,poricidal,portion,rather,ry,scar,shaped,size,soon,spaced,specimen,stigma,tall,tapering,tear,tear-drop,thick,thicker,tightly,tip,tube,ud,unit,wider,widest,wing,ympodial,young	1.3,abaxial,adaxial,alternate,arrangement,branching,characteristic,colour,diameter,form,height,history,inflorescence,length,life,midvein,na,peduncle,primary,pseudostipule,rachi,seed,staman,tertiary,texture,unarmed,venation
1	wfo-0001025657	success	239	116	93	146	23	0.389	0.1-0.4,0.2-0.4,0.5-2.5,1-1.1,1-1.3,1-1.6,1-3,1.2-1.5,1.3-2,1.5-1.8,2-10,2-3.5,2.2-5.5,2.5-9.3,2.7-4.3,3-6,4-4.4,5-16,6-8,7-9.5,8-10.5,8.3-12,acute,anther,apart,apex,articulated,base,berry,bluish,branched,brown,calyx,chartaceous,closely,cm,cordate,corolla,dark,deltoid,densely,diameter,dried,entire,expanded,filament,fleshy,flower,fruit,glabrous,granular,green,hair,half,lanate-pubescent,lanceolate,leaf,length,lobe,lower,margin,mm,narrowly,ovate,pale,pedicel,peduncle,petiole,porrect-stellate,rachi,reticulate-punctate,ripe,semi-ovate,shrub,simple,slightly,soft,spaced,stellate-pubescent,stem,style,suborbicular,surface,tan,tomentose,tomentose-pubescent,tree,unarmed,vein,white,x,yellow,yellowish	-2,/3,1.7-1.9,12x,2/3,25-60,3-4,3-4.8,3.2-6,4-4.5,4-7,5-14,6-12,6.5-10,7-27,7-9,abaxially,accrescent,adaxially,ag,also,anthesi,apparently,appearing,ark,around,ascending,axe,axillary,ba,blade,blunt-tipped,branch,broadly,bud,capitat,central,conical,cylindrical,dendritic-multangulat,dendritic-multangulate,dense,directed,distally,due,eaf,earl,edge,eed,elliptic,especially,evident,exerted,exserted,farinose,few-rayed,free,fruiting,glandula,glandular,inserted,lateral,lengthening,light,lobed,long,long-stalked,longitudinal,m.,magnification,main,midrib,minutely,mixed,multangulate,nearly,nflorescence,oblong,obtuse,occasional,often,older,open,orbicular,orolla,ovat,ovate-lanceolate,overlapping,part,parted,partly,perfect,persistent,persistently,plurifoliate,pore,poricidal,present,pseudo-terminal,pubescence,pubescent,ray,reportedly,ruit,scented,sessile,short,short-,short-stalked,side,slit,somewhat,splitting,stamen,stellate,stigma,stipitate-glandular,stipitate-multangulate,strongly,subcampanulate,subcoriaceous,suture,tall,tamen,terete,thick-stalked,thickened,thin-stalked,time,tip,tomentum,transparent,tube,two-third,ud,unarme,unit,upper,usually,vary,velutinous-pubescent,way,weakly,wide,ympodial,young	abaxial,adaxial,arrangement,branching,characteristic,colour,form,growth,height,history,inflorescence,life,midvein,na,ovary,perennial,plant,primary,seed,shape,staman,texture,true
2	wfo-0001025669	invalid_json	216	129	92	124	37	0.426	'',.5,0.1-0.3,1,1-2,1-2.2,1-4,1.4-2.5,13-35,2,2-3,2-4,2.2-6.5,3-5,``,absent,acuminate,acute,anther,apex,articulation,base,berry,blue,broadly,brownish,cell,chartaceous,cm,condition,contracted,corolla,covering,cuneate,diameter,distinct,drying,elliptic,filament,flower,flowered,fresh,fruit,glabrous,globose,green,greenish,hair,herb,highly,lateral,like,lobe,long,margin,membranous,minute,mm,moderately,monochasium,mottled,oblique,obtuse,odd-pinnate,often,ovate,ovoid,pedicel,peduncle,petiole,plant,pubescent,purple,rarely,ripe,scale-like,seed,single,slightly,sometimes,species,stem,streaked,style,subglabrous,testal,thick,tinged,typically,wall,white,whitish	0-1,0-5,0-7,0.8-2.4,1-10,1-3,1.3-4.2,1.6-4.4,2.2-6,2.4-7,3-7,4-6,5-merou,9-24.5,abaxially,absen,acumen,adaxially,ag,along,alyx,apart,apparently,axe,blade,capitat,ciliate,clavate,clearly,connivent,decurrent,digestion,discussion,distal,dorsally,eaf,edge,eed,end,enzyme,erec,especially,exceeding,except,extra,flat,folded,forming,geminat,glabrou,greatly,green-white,hair-like,half,homostylous,honeycomb-shaped,interjected,lanceolate,larger,leaflet,lengthening,living,lower,make,midrib,minutely,mucilaginous,multicellular,near,nflorescence,obovate,one,orbicular,orolla,pair,perfect,petiolulate,petiolule,placed,plurifoliate,pore,poricidal,proximal,puberulent,reduced,removed,rosette,rotate,rounded,ruit,see,sessile,seudostipule,short,size,slit,spaced,specimen,stamen,ste,stigma,stolo,straight,subequal,tall,tamen,tem,terminal,throughout,tip,tri-,truncate,tube,tuber,unbranched,unequal,unit,unwinged,vary,wet,wide,x,yellow,ympodial	'extra,'hair-like,[,abaxial,adaxial,arrangement,branching,calyx,characteristic,colour,form,growth,height,history,inflorescence,leaf,length,life,midvein,na,ovary,perennial,primary,pseudostipule,rachi,shape,staman,surface,tertiary,texture,true,unarmed,value,vein,venation,{,}
3	wfo-0001025697	success	181	130	98	83	32	0.541	-9,0.15-0.75,1-1.7,1-2,1.7-8.6,10-26,2-6,25-35,3-10,3-4,3-5,3-6,abaxially,acuminate,acute,adaxially,anther,apart,apex,articulated,asymmetric,attenuate,axillary,base,basiscopic,berry,blue,brownish,bud,cell,cm,condition,coriaceous,corolla,covering,dark,deep,diameter,distal,drying,elliptic,filament,flower,forked,fresh,fruit,generally,glabrescent,glabrous,globose,green,green-white,greenish,hair,hair-like,half,herb,high,lanceolate,lateral,leaf,light,lilac,lobe,long,make,medium,mm,mucilaginous,odd-pinnate,ovate,ovoid,pedicel,peduncle,petiole,plant,purple,rachi,ripe,rounded,seed,sessile,short,side,spaced,stripe,style,subtending,terminal,testal,thick,throughout,tissue,typically,usually,wall,wet,whitish	0-14,0.6-3.5,0.8-2,1-3,1.5-1.8,2-10.5,2-2.6,2-4,3.3-11,4-7.5,5-merou,5.5-11.5,6.5-13.5,acumen,adaxiall,ag,alyx,apparently,axe,blade,capitat,clavate,connivent,decreasing,decurrent,digestion,dorsally,eaf,edge,eed,enzyme,erec,exceeding,flat,folded,geminat,glabrou,hal,homostylous,honeycomb-shaped,interjected,leaflet,lengthening,linear,living,lower,nflorescence,orbicular,orolla,pair,pentagonal,perfect,petiolulate,plurifoliate,pore,poricidal,removed,rotate,ruit,seudostipule,size,slightly,slit,specimen,stamen,stigma,straight,subequal,subglabrou,tall,tamen,tem,tip,toward,tri-,tube,unit,unwinged,vary,wood,x,yellow,ympodial	2,abaxial,adaxial,arrangement,branching,calyx,characteristic,colour,form,growth,height,history,inflorescence,length,life,margin,midvein,na,ovary,primary,pseudostipule,shape,staman,stem,subglabrous,surface,tertiary,texture,unarmed,vein,venation,woody
4	wfo-0001025699	success	181	125	101	80	24	0.558	.2,1,1-1.5,1-2.5,1-3,1.5-2,10,15-20,2,2-2.5,2cm,3-3.5,3-8,4-5,5-8,5-winged,8-9,abaxially,absent,acute,almost,anther,anthesi,apex,attenuate,base,becoming,berry,branching,brown,c.,calyx,cm,completely,conical,conspicuously,corolla,crystal,dark,darker,diameter,ellipsoid,elliptic,entire,exerted,filament,glabrous,globose,green,grey-brown,growth,immature,inclusion,inflorescence,lanceolate,leaf,leaf-opposed,leafy,lobe,margin,markedly,midrib,minutely,mm,narrowly,nodding,older,ovary,oxalate,pair,pale,pedicel,peduncle,petiole,primary,red,reniform,reticulate-pitted,rounded,sand,shoot,short,simple,small,somewhat,stem,strongly,style,surface,time,tip,tree,triangular,tube,vein,way,white,white-spotted,winged,x,young	.5,0.5,1-2,1.5,1/3,2-6,3-15,3-5.5,499,5.5-14,adaxially,age,apart,apparently,appearing,articulating,bark,campanulate,capitate,continuing,corrugate,cup-shaped,deltate,densely,difoliate,dorsal,dry,drying,eaf,eed,erect,face,fide,flower,free,fruiting,glabrou,included,inflorescenc,irregularly,leaving,lengthening,less,lobed,lower,new,nflorescence,one,onto,papillat,papillose,peg,penden,per,perfect,plurifoliate,pore,poricidal,portion,reddish,rounded-sagittate,ruit,scar,slightly,slit,spaced,stearn,stigma,straight,tangled,thickened,trichome,ud,unit,wide,wing,woody,yellow,ympodial,Â½	abaxial,adaxial,arrangement,characteristic,colour,corrugated,form,fruit,height,history,length,life,midvein,na,plant,pseudostipule,rachi,seed,shape,staman,tertiary,texture,unarmed,venation
5	wfo-0001025700	invalid_json	189	108	72	117	36	0.381	0.30-2.0,0.5-2,0.8-2.6,1-2,10.5-12,15-40,2-12,2-7,2.5-4,3-8,5-15,5-20,5.5-8,acuminate,acute,anther,apex,apiculate,articulated,attenuate,base,berry,brownish,cell,chartaceous,cm,condition,corolla,covering,diameter,distal,dot,drying,elliptic,filament,fresh,fruit,glabrescent,glabrous,globose,green,greenish,hair-like,half,herb,high,lateral,leaf,light,lilac,lobe,long,medium,mm,odd-pinnate,ovate,ovoid,pedicel,peduncle,petiole,petiolulate,plant,purple,rounded,seed,sometimes,style,testal,thick,wall,white,whitish	0-16,0.7-2.7,0.8-4,1-3,1.1-2.3,1.5-2,10-40,3-4,3.5-10.5,3.7-8.6,4-5,5-merou,5.3-17.5,5.5-18,9-31,abaxially,acuman,acumen,adaxially,ag,alyx,apparently,asymmetric,axe,axillary,basal,basiscopic,blade,bud,capitat,clavate,connivent,considerably,decrease,decreasing,digestion,dorsally,eaf,edge,eed,enzyme,erec,exceeding,except,flat,flower,folded,forked,geminat,generally,glabrou,green-white,hair,hal,homostylous,honeycomb-shaped,interjected,lanceolate,larger,leaflet,lengthening,linear,living,lower,make,mucilaginous,narrowly,nflorescence,orbicular,orolla,pair,par,pentagonal,perfect,plurifoliate,pore,poricidal,proximal,removed,ripe,rotate-pentagonal,ruit,sessile,seudostipule,short,side,size,slightly,slit,specimen,stamen,stigma,straight,subequal,subglabrou,subtending,tall,tamen,tem,terminal,throughout,tip,tissue,toward,tri-,tube,typically,unit,unwinged,usually,vary,wet,whose,winged,x,yellow,ympodial	'',2,[,``,abaxial,adaxial,arrangement,branching,calyx,characteristic,colour,form,growth,height,inflorescence,length,margin,midvein,na,ovary,primary,pseudostipule,rachi,shape,staman,stem,subglabrous,surface,tertiary,texture,unarmed,value,vein,venation,{,}
6	wfo-0001025704	success	248	135	115	133	20	0.464	0-100,0-2,0-3.5,0.3-0.8,0.5-1.5,0.7-1,1-3.5,1-6,1.2-3,1.5-3.2,1/5,2-3,2-7,2.7-4,3-15,3-5,3-6,4-5,4.5-6.5,abaxial,acute,adaxial,almost,anther,apex,apically,apiculate,apparently,articulated,auriculate,base,berry,branched,calyx,cell,chartaceous,cm,cordate,deltate,densely,diameter,discolorous,drying,ellipsoid,elliptic,erect,evenly,filament,flattened-reniform,fruit,glabrous,green,green-yellow,lateral,leaf,length,lobe,lobed,long,margin,maturity,mauve,midvein,mm,near,orange,orange-brown,outline,ovate,pair,pale,pedicel,peduncle,per,petiole,pit,plant,prickle,prickly,primary,raised,rarely,red-green,round,shape,shrub,side,small,smooth,sometimes,sparsely,spherical,stellate-pubescent,stem,strongly,style,surface,terminal,tertiary,tree,truncate,unarmed,unbranched,unit,upper,vein,venation,visible,white,white-gray,yellow,yellow-green,yellowish,young,Ã	-10,-2,-3,-5,/6,0,0-5,0.1,0.1-0.3,0.1-0.5,0.15-0.8,1,1-4,1.5-2,1.5-4.5,1.8-3.5,1/2-4/5,1/4-3/4,2,2-10,2-4.5,2-5,2.5-4.5,3-10,4-12,5-20,5-merous,6-12,6-15,8-12,8-15,8-17,abaxially,age,alyx,andromonoecious,apar,apart,axe,ba,bark,blade,broad-deltate,brow,connivent,covering,curved,development,distal,distance,eaf,eed,elongating,end,equal,extending,flattened,flower,free,fruiting,glabrescent,gray,half,hermaphrodite,heterostylous,infructescence,irregular,less,lobing,long-styled,longer,lower,lowermost,mature,midpoint,moderately,multangulate,nflorescence,obtuse,occasionally,often,older,one,open,orolla,oung,pendulous,pericarp,plurifoliat,poricidal,porrect,portion,prickl,prominent,ray,recurved,red-brown,reflexed,retaining,rounded,ruit,scar,secondary,sessile,short-styled,shorter,slender,somewhat,spaced,spreading,stalk,stalked,staminat,stellate,stellate-pubescen,stout,straight,tamen,tapering,terete,throughout,time,tip,trichome,tube,variously,vary,warty,way,wide,widening,woody,ympodial	arrangement,branching,characteristic,colour,corolla,form,growth,height,history,inflorescence,life,na,ovary,perennial,plurifoliate,rachi,seed,staman,sympodial,texture
7	wfo-0001025729	success	177	132	104	73	28	0.588	.5,0.25-0.5,0.7-1.2,1-1.5,1-5,1.1-1.5,1.2-1.8,1.5-2,1.75,2,20,4-5,5-50-flowered,7-8,abaxial,abaxially,abrupt,acute,adaxially,anther,apex,apiculate,appearing,axil,basal,base,berry,black,bright,calyx,cm,corolla,covering,dark,deltoid,densely,dia,diam,dirty,drying,elliptic,f,filament,flattened-reniform,fleshy,furcate,glabrous,globose,green,greenish-yellow,greyish-brown,growing,incrassate,lamina,lateral,leaf,like,live,lobe,long,main,margin,minute,minutely,mm,oblique,occasionally,often,opposite,ovary,overtopping,pair,pale,papillose,pedicel,petiole,pit,pitted,plant,pubescent,ripening,rounded,shiny,simple,sparsely,stem,straight,style,surface,tapering,terminal,tip,tree,treelet,trichome,tube,tuft,uniseriate,usually,vein,white,widening,x,yellow	-20,/4,2-3.5,3-6,4-8,6-8,9-17,along,anthesi,apar,apical,bark,blackish,branched,bristly,bud,covered,cyathiform,deflexed,denser,differing,difoliate,eaf,edicel,eed,enclosed,expanded,free,fruiting,geminat,gently,glabrou,lat,lobed,lon,lower,m.,mainly,major,member,middle,minor,nflorescence,older,one,overlapping,papillo,partially,pore,poricidal,portion,prominent,quite,raised,reflexed,ruit,scar,shaped,short,size,stigma,stout,tall,tear-drop,touching,tub,ud,unit,way,widest,woody,ympodial,young	4-20,adaxial,arrangement,branching,characteristic,colour,diameter,form,fruit,growth,height,history,inflorescence,length,life,midvein,na,peduncle,primary,pseudostipule,rachi,seed,shape,staman,tertiary,texture,unarmed,venation
8	wfo-0001025749	success	217	129	106	111	23	0.488	0-10,0-3,0-5,0-6,0.2-1.5,0.3-1.5,0.5-0.8,0.5-0.9,0.8-0.9,1-10,1-13,1-2,1-3,1-6,1-9,1.5-2,1.5-2.5,2-2.5,2.5-6,3-5,5-20,abaxial,acute,adaxial,anther,apex,apically,apparently,articulated,base,berry,branched,calyx,chartaceous,cm,cuneate,curved,dark,densely,diameter,dull,filament,flattened-reniform,flower,fruit,gently,glabrous,green-brown,indistinct,infructescence,lateral,leaf,length,lobe,lobed,long,long-ovate,lower,magnification,margin,maturity,mauve,midvein,mm,moderately,narrow-deltate,orange-brown,orange-red,orbicular,ovate,pair,pale,pedicel,peduncle,per,petiole,prickle,prickly,primary,rarely,red-brown,rounded,shrub,sometimes,sparsely,spherical,stellate,stellate-pubescent,stem,straight,straw-yellow,style,surface,tertiary,toward,trichome,usually,vein,venation,visible,white,wide,without,yellow,yellow-green,yellow-orange	-1,-12,.5,/5,0-8,0.1,0.1-0.2,0.1-0.3,0.1-0.4,0.2,0.4-0.7,0.5,0.5-1.3,0.5-3,0.6-4.5,1,1-8.5,1.5,1/4-1/3,1/5-1/2,2-10,2/3,3-20,4-8,5-,5-10,5-merous,6-8,abaxially,acuminat,adaxially,adnate,almost,alyx,apar,apart,bark,blade,broad-deltate,concolorous,difoliate,discolorous,distance,drying,eaf,eed,elongating,equal,erect,extending,filiform,flattened,free,fruiting,geminat,glabrescent,gray,herbaceous,light,lon,longer,markedly,mature,midpoint,narrow-ovate,nflorescence,oblong,obtuse,occasionally,older,one,open,orange-brow,orolla,oung,pendulous,perfec,pericarp,poricidal,porrect,portion,prickl,procumbent,purple,ray,recurved,reduced,ruit,scar,sessile,shorter,side,smooth,spaced,spreading,stalk,stalked,strongly,tamen,tapering,terete,time,tip,tube,unit,variously,vary,way,yellowish,ympodial,Â½-2/	acuminate,arrangement,branching,characteristic,colour,corolla,form,growth,height,history,inflorescence,life,na,ovary,plant,pseudostipule,rachi,seed,shape,staman,texture,unarmed,Â½-2/3
9	wfo-0001025754	success	164	123	93	71	30	0.567	-celled,.5,0.5-1,0.5-1.5,1,1-2,1-3,1.5,1.5-3,10-20,10-35,2-7,3-10,3-5,4,4-6,5-12,5-15,absent,acuminate,acute,anther,apex,asymmetrical,base,berry,beyond,brown,calyx,center,chartaceous,ciliate,cm,cordate,cordiform,decurrent,densely,diameter,dm,drying,edge,eglandular,entire,equal,exserted,filament,fine,flower,fruit,glabrous,globose,hair,herb,immature,leaf,leaving,linear-lanceolate,lobe,margin,maturing,membranaceous,mm,moderately,much-branched,nearly,often,palmately,parallel,pedicel,peduncle,per,petiole,pubescent,rachi,radiating,raised,ridge,running,semitransparent,shallow,slightly,solitary,sparsely,stamen,stem,style,surface,truncate,unbranched,vein,white,x,yellow	0.1-0.2,1-3.5,1.5-4,2-4,2-5-celled,2-foliate,3-6,abaxially,abundant,adaxiall,adaxially,along,axe,barely,blade,branch,connected,decumbent,dehiscing,denser,dried,eaf,eed,emarginat,erect,explosively,flat,geminat,glandular,held,interpetalar,like,long,lower,lying,main,material,maturit,mesocarp,mixed,nfloresence,notch,oblong,orolla,penden,placenta,pressure,probably,pubescen,rotate,ruit,short,small,sometimes,stigma,straight,swollen,tal,tamen,tem,tissue,triangular,tube,unit,upright,vary,visible,watery,wid,woody,ympodial	2.5,abaxial,adaxial,arrangement,branching,characteristic,colour,corolla,form,geminate,growth,height,history,inflorescence,length,life,midvein,na,ovary,pendent,plant,primary,pseudostipule,seed,shape,staman,tertiary,texture,unarmed,venation
10	wfo-0001025760	success	210	116	95	115	21	0.452	-6,0-0.5,0.3-1,0.4-0.8,0.45-0.9,0.5-2,0.8-1.8,1-4,1.5-5,1/5,2.1-3.5,2.3-4,2/3,3-6,3.5-9,abaxial,acute,adaxial,almost,annual,anther,apex,apically,articulated,base,black,broad-deltate,calyx,cm,cream,cuneate,curved,dark,diameter,dull,elliptic,filament,flattened-reniform,fruit,gently,glabrous,green,herb,infructescence,lateral,leaf,length,lobe,lobed,margin,marking,maturity,midvein,mm,moderately,orange,orange-brown,ovate,pair,pale,pedicel,peduncle,per,perennial,petiole,primary,recurved,red-brown,rounded,shape,shrub,slender,sometimes,spherical,stellate-pubescent,stem,stout,straight,style,subentire,surface,terete,tertiary,unarmed,unbranched,upper,usually,vein,venation,visible,weakly,white,yellow,yellow-green,young	-10,-12,-3,-5,.5,/3,0-100,0.1,0.1-0.2,0.15-0.3,0.2-0.35,0.5-1.5,0.7-2.5,1,1-,1-1.8,1-2,1.5,1.5-2.5,1.5-4.5,1/4,1/4-1/2,1/4-1/3,2-2.5,2-3,2.5-10,2.5-8,3,3.5-17,5-10-merous,5-18,8-10,abaxially,acut,alyx,apar,apparently,bark,berry,blade,brow,chartaceous,concolorous,connivent,cultivar,deltate,difoliate,discolorous,distance,drying,eaf,eed,elongating,equal,erect,extending,flower,free,fruiting,geminat,geminate,glabrescent,hair,lengt,long,longer,lower,mature,membranous,midpoint,minute,nflorescence,often,older,one,open,orolla,oung,pendulous,perfec,pericarp,poricidal,porrect,portion,ray,reflexe,ruit,scar,sessile,shorter,side,simple,smooth,spaced,spreading,stalk,stalked,stellate,stellate-pubescen,tamen,tapering,thick-stalked,time,tip,trichome,tube,unarme,unit,various,variously,vary,way,wide,woody,ympodial	arrangement,branching,brown,characteristic,colour,corolla,form,growth,height,history,inflorescence,life,na,ovary,plant,pseudostipule,rachi,seed,staman,texture,ye
11	wfo-0001025782	success	200	116	95	105	21	0.475	.5,0-10,0-5,0.4-0.6,0.55-0.75,0.9-1.3,1-2,1-4,1.2-6,1.3-1.6,2-10,2-2.5,2-3,3-4,3-5,4,4-4.5,5-20,5.5-6,abaxial,acuminate,adaxial,anther,apex,apically,apparently,articulated,base,berry,brown,calyx,chartaceous,climbing,cm,cuneate,curved,deltate,diameter,difoliate,dull,elliptic,evenly,filament,flattened-reniform,flower,fruit,geminate,gently,glabrous,green,green-brown,lateral,leaf,length,lobe,lobed,long,margin,maturity,membranous,midvein,mm,moderately,orange-brown,pair,pedicel,peduncle,per,petiole,plant,prickle,prickly,primary,shrub,sparsely,spherical,stellate,stellate-pubescent,stem,style,surface,tertiary,toward,trichome,unbranched,unit,vein,venation,visible,weakly,white,wide,yellow,yellow-green,young	-2,0.1-0.15,0.1-0.2,0.1-0.25,0.3-1,0.5-1,1,1-1.7,1-2.5,1.5-3,1/4-1/2,1/4-1/3,1/6,10-13,2-5,2-7,2.5-3.5,2/3-3/4,20,4.5-9,5-6.5,5-8,5-merous,6-14,6-8,abaxially,acuminat,also,alyx,andromonoecious,apar,apart,bark,blade,concolorous,conical,connivent,densely,discolorous,distal,distance,drying,eaf,eed,elongated,elongating,equal,extending,flattened,free,fruiting,geminat,glabrescent,hair,hermaphrodite,heterostylous,infructescence,lengt,less,long-styled,longer,lower,lowermost,mature,midpoint,minute,nflorescence,occasionally,older,one,open,orolla,oung,pendulous,pericarp,poricidal,porrect,portion,prickl,ray,red-brow,reduced,ruit,scar,sessile,short-styled,shorter,side,simple,smooth,spaced,spreading,staminat,stout,straight,tamen,tapering,terete,time,tip,tube,vary,way,woody,ympodial	arrangement,branching,characteristic,colour,corolla,form,growth,height,history,inflorescence,life,na,ovary,perennial,rachi,seed,shape,staman,sympodial,texture,unarmed
12	wfo-0001025783	success	179	125	97	82	28	0.542	.5,0.5,0.5-1.5,1-1.2,1-1.5,1-3,2-3+,2-5,3-4,5,7-10,<,acute,anther,apex,articulated,base,berry,branched,branching,brown,calyx,cell,cm,coriaceous,corolla,dendritic,diameter,elliptic,entire,erect,filiform,flattened,fleshy,flower,glabrous,globose,greyish,growth,inserted,keeled,lateral,lax,less,lobe,long,margin,midvein,minutely,mm,narrowly,nodding,obtuse,pair,pale,pedicel,peduncle,pentagonal,pericarp,petiole,pitted,point,primary,pubescent,purple,reniform,revolute,ripe,scarious,shiny,shoot,short,shrub,simple,sleeve,slightly,sometimes,somewhat,sparsely,stem,style,surface,terminal,testal,thin,time,transparent,triangular,trichome,truncate,tuft,uniseriate,vein,vine,violet,wide,woody	0.5-1,0.8-3.5,1.8-2,2,2-6.5,5-merou,abaxiall,abaxially,adaxiall,adaxially,along,alyx,anthesi,apart,ape,ark,axil,bud,c.,cluster,completely,confined,conical,densely,eaf,eed,ellipsoid,expanded,exposed,exserted,flexuous,free,fruiting,glabrou,green,groove,hromosome,ilament,known,lobed,long/tall,lower,mature,midrib,minute,mmm,near,new,nflorescence,number,obscured,occasionally,older,orolla,outlin,penden,perfect,plurifoliat,portion,possibly,ruit,sagittate,scar,see,spaced,sparse,stellate,stigma,strongly,suture,tube,twinin,type,ud,unit,upper,vary,way,weak,within,yellowish,ympodial	abaxial,adaxial,arrangement,characteristic,colour,filament,form,fruit,height,history,inflorescence,leaf,length,life,na,outline,ovary,perennial,plant,pseudostipule,rachi,seed,shape,staman,tertiary,texture,unarmed,venation
13	wfo-0001025788	invalid_json	158	110	81	77	29	0.513	-8,0.5-2,1-5,15-30,2-13,2-3,2-5,2.8-9.5,4-5.5,4.5-12.5,5-8,6-7,acuminate,acute,apex,apical,apically,base,blue,branched,calyx,cell,cm,conical,corolla,covering,cuneate,cyme,dehiscent,diameter,dichasial,dichasially,ebracteate,elliptical,exceeding,finely,hair-like,herbaceous,interjected,introrse,lateral,leaf,leaflet,long,make,maturing,mm,monochasial,mucilaginous,narrowly,oblique,obtuse,odd-pinnate,often,ovate,ovoid,pair,pedicel,peduncle,perennial,petiole,plant,poricidally,pubescent,purple,rounded,seed,sessile,short,slit,stamen,stigma,straight,style,subsessile,terminal,testal,thick,tip,tuber-bearing,wall	0-6,1-4,1.8-2.7,1.8-3.9,10-24,14-48,2-10,2m,3-,3-6-foliat,4-3.,4.5-10.1,6.2-12.5,8-38,abaxiall,abaxially,acumen,adaxially,articulate,attenuate,connate,deep,digestion,diminishing,distal,dorsally,eaf,edge,eed,emoval,enzyme,filament,flat,flower,folded,forked,generally,globo,gradually,green,green-white,half,honeycomb,living,lobe,lon,long-attenuate,lower,lunat,medium,nflorescence,nther,orolla,pattern,perfect,petiolule,plan,proximal,reveal,rotate,ruit,seudostipule,size,specimen,subequal,tal,tem,throughou,throughout,toward,typically,unit,vary,wide,yellow,ympodial,Â¼	'',4-31,[,``,anther,arrangement,attachment,characteristic,colour,dehiscence,form,fruit,globose,growth,height,history,inflorescence,length,life,ovary,shape,stem,surface,texture,value,wet,ye,{,}
14	wfo-0001025792	success	203	138	103	100	35	0.507	0.4-0.7,1-2,1-3,10-15,2-11,2-3,2.5-3.5,21-28,4-12,4-6,5,7.5-8,8-10,acute,anther,apex,articulated,articulation,base,basiscopic,berry,blue-mauve,blue-purple,broadly,brownish,cell,ciliate,cm,condition,connivent,corolla,covering,dark,decurrent,densely,diameter,distal,distinct,distinctly,drying,elliptic,filament,fresh,fruit,glabrous,globose,green,green-white,greenish,hair,hair-like,half,herb,high,honeycomb-shaped,indistinct,lanceolate,lateral,lengthening,like,lobe,long,margin,mauve,midrib,minute,mm,mucilaginous,narrowly,oblique,odd-pinnate,ovoid,papillose,pedicel,peduncle,petiole,petiolulate,plant,pore,poricidal,proximal,pubescent,purple,rachi,rounded,seed,semi-rosette,sessile,short,slightly,slit,stem,streak,style,sub-rosette,terminal,testal,thick,tinged,wall,wet,white,whitish	1-10,1-4,2-3.5,2.5-4,3-4,3-5,3.5-6,4.5-7,5-10,5-6,5-9,5-merou,7-10,9-12,abaxially,acumen,acuminate,adaxially,ag,along,alyx,apart,apparently,auriculate,axe,axillary,blade,bud,capitat,chartaceous,developing,digestion,dorsally,eaf,edge,eed,enzyme,especially,exceeding,except,flat,flower,folded,forked,geminat,generally,glabrou,greatly,hal,homostylous,interjected,leaflet,living,lower,make,membranous,minutely,mottle,narrow,nflorescence,often,onto,orolla,pair,perfect,plurifoliate,puberulent,reduced,removed,ripe,rotate-pentagonal,ruit,semi-erec,seudostipule,shortly,side,size,spaced,specimen,stamen,ste,stigma,straight,subequal,subtending,tall,tamen,tem,throughout,tip,tri-,tube,unit,usually,vary,wing,x,yellow,ympodial,young	2,abaxial,adaxial,age,apical,arrangement,branching,calyx,characteristic,colour,deciduous,form,growth,height,history,inflorescence,leaf,length,life,midvein,mottled,na,ovary,persistent,primary,pseudostipule,semi-erect,shape,staman,surface,tertiary,texture,unarmed,vein,venation
15	wfo-0001025804	success	155	111	80	75	31	0.516	.5,0.5-1,1-1.5,1-3,1.2-1.5,1.4-1.7,1.5-2,2-2.5,3-4.5,3.5-12,6-8,7-10,abaxially,acute,adaxially,anther,apex,apiculate,attenuate,base,berry,branched,calyx,clavate,cm,corolla,cream,dark,deflexed,difoliate,drying,elliptic,erect,filament,flattened,fleshy,glabrous,globose,green,incrassate,internodal,leaf,light,lobe,many,margin,mere,minutely,mm,near,obovate,occasionally,often,opposite,ovary,pair,paler,papillose,pedicel,pitted,plurifoliate,projection,red-papillose,reddish-brown,reniform,rim,shrub,somewhat,stem,strongly,style,surface,thick,time,tip,vein,white,whitish-green,winged,x	.25,10-20,11-20,16-35,2.5-4,4-10,5,?,age,anthesi,apar,ape,ba,bark,bilobed,c.,conical,covered,cucullate,decurrent,densely,dia,differing,eaf,edicel,eed,ellipsoid,exserted,flower,free,fruiting,geminat,glandular,later,lateral,lengthening,lobed,long,lower,main,major,middle,minor,minute,nearly,nflorescence,older,onto,papillae,papillat,papillate,planar,pore,poricidal,portion,red,reddish-brow,regularly,ruit,scar,sessile,size,slit,spaced,stigma,tall,tub,tube,ud,unit,widest,wing,woody,ympodial,young	abaxial,adaxial,arrangement,branching,characteristic,colour,diameter,form,fruit,geminate,growth,height,history,inflorescence,length,life,midvein,na,peduncle,petiole,plant,primary,pseudostipule,rachi,seed,shape,staman,tertiary,texture,unarmed,venation
16	wfo-0001025813	invalid_json	197	114	80	117	34	0.406	'',1-1.5,1-2,1-4,1.5-1.8,15-30,2-3,3-3.5,3-4,3-5,5-6,6-7,``,acuminate,acute,anther,apex,articulated,base,berry,blue,broadly,brownish,cell,chartaceous,cm,condition,contracted,corolla,covering,cuneate,dark,densely,diameter,distal,drying,elliptic,filament,flower,fresh,fruit,glabrous,globose,green,greenish,hair,highly,lanceolate,lateral,light,like,lobe,long,margin,membranous,mm,monochasium,obtuse,odd-pinnate,often,ovoid,pedicel,peduncle,petiole,pilose,pubescent,rachi,rarely,seed,single-flowered,stem,style,suborbicular,testal,thick,vein,violet,wall,white,whitish	0-2,0.7-1.7,1-10,1.2-4.5,1.3-7,1.5-2,1.5-6.5,2-4,2-5,3-6,3-7,5-18.5,5-merou,abaxially,absent,acumen,adaxially,ag,along,alyx,apart,apparently,axe,blade,borne,ciliate,connivent,decreasing,decurrent,digestion,discussion,distinct,dorsally,eaf,edge,eed,end,enzyme,especially,exceeding,extra,flat,folded,geminat,glabrou,green-white,hair-like,half,herb,homostylous,honeycomb-shaped,interjected,larger,leaflet,lengthening,living,longer,lower,make,midrib,minute,minutely,mucilaginous,near,nflorescence,orbicular,orolla,ovate,ovoi,pair,perfect,petiolulate,plant,plurifoliate,pore,poricidal,puberulent,removed,rosette-formin,rotate,ruit,see,sessile,seudostipule,short,singly,size,slit,sometimes,spaced,species,specimen,stamen,ste,stigma,stolo,straight,strongly,tamen,tem,terminal,thir,throughout,tip,toward,tri-,tube,tuber,typically,unforked,unit,unwinged,vary,wet,x,yellow,ympodial	'extra,'hair-like,2,[,],abaxial,adaxial,arrangement,branching,calyx,characteristic,colour,form,growth,inflorescence,leaf,length,midvein,na,ovary,primary,pseudostipule,rosette-forming,shape,staman,surface,tertiary,texture,third,unarmed,value,venation,{,}
17	wfo-0001025825	success	187	118	89	98	29	0.476	0.4-1,0.5-10.4,1-2,1-5.5,1.1-1.4,10-24,2-3.7,2-5,22-86,3-10,3-5,4-8,4-9,acuminate,acute,anther,apex,articulated,axillary,back,base,berry,brownish,bud,cell,cm,condition,coriaceous,corolla,covering,dark,decurrent,diameter,distal,drying,elliptic,filament,flower,forked,fresh,fruit,generally,glabrescent,glabrous,green,green-white,greenish,hair,hair-like,half,herb,high,lanceolate,lateral,leaf,light,lilac,lobe,long,make,medium,mm,mucilaginous,odd-pinnate,ovate,ovoid,pedicel,peduncle,petiole,petiolulate,plant,rachi,seed,sessile,shiny,short,slightly,streak,style,subtending,terminal,testal,thick,throughout,usually,wall,wet,white,whitish	0-0.21,0.4-3,0.5-0.8,0.7-2.2,0.9-2,0.9-4,1-3,10.5-26,14-85,3-8.5,3.7-6.5,5-10,5-7,5-merou,6-10,6.6-14,abaxially,acumen,adaxiall,adaxially,ag,alyx,apart,apparently,asymmetric,attenuate,axe,basiscopic,blade,capitat,clavate,connivent,cuneate,decreasing,digestion,dorsally,eaf,edge,eed,enzyme,erec,exceeding,flat,folded,geminat,glabrou,hal,homostylous,honeycomb-shaped,increasing,interjected,leaflet,lengthening,living,lower,middle,nflorescence,orbicular,orolla,pair,pentagonal,perfect,plurifoliate,pore,poricidal,removed,rotate-pentagonal,rounded,ruit,seudostipule,side,size,slit,smaller,spaced,specimen,stamen,stigma,straight,subequal,subglabrou,tall,tamen,tem,tip,tissue,toward,tri-,tube,unit,unwinged,vary,wide,wing,winged,x,yellow,ympodial	2,abaxial,adaxial,arrangement,calyx,characteristic,colour,form,growth,height,history,inflorescence,length,life,margin,midvein,na,ovary,primary,pseudostipule,shape,staman,stem,subglabrous,surface,tertiary,texture,vein,venation
18	wfo-0001025838	success	217	129	101	116	28	0.465	-20,0.5,0.5-1,0.7-2,1-1.2,1-1.5,1.5-2,1.5-2.5,1.5-3.5,1.5-5,1.8-2,10-15,2-2.5,2.5-3,20-40,4-15,4.5-5.5,6.5-7,acuminate,adaxial,anther,apex,apiculate,articulated,attenuate,base,berry,black,branched,brown,calyx,cm,corolla,dark,densely,diameter,elliptic,entire,erect,filament,flattened,fruit,glabrous,globose,greenish,growth,inflorescence,inserted,keeled,lanceolate,lateral,leaf,like,lobe,long,many,margin,minutely,mm,narrowly,nodding,often,onto,pair,pale,pedicel,peduncle,per,petiole,pitted,primary,pubescent,purple,quadrate,reddish,reniform,revolute,ripe,seed,short,shrub,simple,sleeve,slender,sometimes,sparsely,stem,style,surface,terminal,time,tinged,tip,tree,trichome,uniseriate,vein,white,winged,x,yellow	.5,1.2-5,1.5-1.7,10-60,2-5,2/3,3.5-,5,5-merou,6-15,abruptly,adaxially,ag,along,alyx,anthesi,apart,appearing,archin,ark,axil,basall,branch,broad,capitate,cell,clavate,clustered,connivent,cucullate,cup-shaped,decurrent,dendritic,dense,denser,disintegrating,drying,eaf,eed,ellipsoidal,exserted,extending,fleshy,flower,free,fruiting,glabrescent,hairy,ilament,insertion,irregularly,lamina,lengthening,less,lobed,loosely,lower,m.,membranous,midrib,minute,mostly,narrowing,never,new,nflorescence,occasionally,older,orolla,ovoid,papillat,papillo,perfect,pericarp,platform,plurifoliat,point,pointed,pore,poricidal,portion,ruit,scar,shin,shiny,sinus,slightly,slit,small,spaced,spreading,square,stellate,stigma,strongly,tall,tem,testal,thi,thin,tube,tuft,turbinate,twinin,ud,unit,upper,vary,wall,way,weight,wing,woody,yellowish,ympodial,Â¾	abaxial,arching,arrangement,branching,characteristic,colour,form,green,greyish,hair,height,hirsute,history,length,life,midvein,na,ovary,perennial,plant,pseudostipule,rachi,shape,staman,tertiary,texture,unarmed,venation
19	wfo-0001025845	success	180	110	83	97	27	0.461	0.3-0.5,0.4-1.5,0.5-11,0.5-2.5,1-2,1-4.5,1.5,1.5-2,1.5-2.5,2,2-3,2.5-4,4-5,4-6,5-6,6-6.5,6-9,acuminate,acute,adaxial,anther,apex,apiculate,articulated,base,branch,brown,calyx,chartaceous,cm,compressed,corolla,cuneate,deltate,diameter,ellipsoidal,entire,extra-axillary,filament,flattened,fork,fruit,glabrous,green,greenish,herb,laterally,leaf,light,lobe,lobed,located,margin,membranaceous,minutely,mm,obtuse,orange,ovate,ovoid,pedicel,peduncle,petiole,pinnately,puberulent,rachi,rarely,rugose-verrucate,sand-punctate,shrub,side,simple,sparsely,style,subcordate,tip,truncate,unbranched,vein,veiny,white,x,yellow	.5,1,1-1.8,1.5-13,1.5-7,2-15,2-5-lobed,3,3-13,3-4,3-6,3-foliat,7-10,abaxially,abundantly,adaxially,aggregate,along,apart,around,ascending,axe,ba,blade,cell,channe,connivent,cylindrical,dark,decurrent,diamete,directed,distall,distally,divided,eaf,eed,eglandular,elliptic,especially,flower,free,glabrou,inserted,lateral,long,longitudinal,lower,major,mesocarp,midrib,narrowly,near,nearly,nflorescence,obovate,often,orolla,part,patch,perfect,pore,pubescent,purple,radiu,rotate-stellate,rounded,ruit,sagittate,shorter,sinus,small,spaced,stigma,stone,stripe,strongly,tal,tamen,tapered,tem,terminal,thecae,thick,tightly,time,tomento,triangular,truncat,tube,unit,unlobed,vary,wide,yellowish,ympodial,youn	abaxial,arrangement,branching,characteristic,colour,form,growth,height,history,inflorescence,length,life,midvein,na,ovary,plant,primary,pseudostipule,seed,shape,staman,stem,surface,tertiary,texture,unarmed,venation
20	wfo-0001025850	invalid_json	197	135	105	92	30	0.533	-7,.5,.8,0.5-1,0.5-3,0.6-1,1,1-1.5,1.5,15-20,2,2-6.5,30,4-5,6-7,abaxial,acute,anther,anthesi,apex,articulated,axi,base,berry,branched,broadly,brown,calyx,cell,cm,corolla,deltate,diameter,divaricate,elliptic,elongate,entire,filament,flattened,flower,glabrous,glandular,globose,green,growth,inflorescence,later,lateral,lax,leaving,lobe,lobed,long,many,margin,minutely,mm,narrowly,nodding,often,openly,orange,outline,pair,pale,pedicel,peduncle,peg,per,petiole,pitted,primary,pubescent,reddish,reniform,rhomboid,ripe,rounded,scattered,shallowly,shiny,shrub,simple,sinuate,sleeve,slender,small,stem,style,surface,tan,terminal,testal,thin,time,tiny,tip,trichome,truncate,uniseriate,vein,vine,white,woody,x	-5,0.5,0.5-,1-3,1-celled,1.5-5,2-12,3-4,5-7,5-merou,ag,along,alyx,apar,apparently,ark,basal,capitate,connivent,cupped,cyathiform,deciduous,deflexed,densely,denser,divided,drying,eaf,eed,ellipsoid,em,erect,exserted,extending,fleshy,free,fruiting,geminat,glabrou,gland,half,halfway,ilament,irregularly,lamina,lengthening,less,loosely,lower,membranous,midrib,minute,nearly,new,nflorescence,node,occasionally,older,orolla,papillate-puberulent,papillo,perfect,pinnatifid,planar,plurifoliate,pore,poricidal,portion,puberulen,ruit,scar,sinus,slightly,slit,sometimes,soon,spaced,splitting,spreadin,spreading,stellate,stigma,strongly,surfac,tube,twinin,ud,unit,vary,yellow,ympodial,young	'',[,``,adaxial,arrangement,branching,characteristic,colour,form,fruit,height,leaf,length,midvein,na,ovary,plant,pseudostipule,puberulent,rachi,seed,shape,staman,tertiary,texture,unarmed,value,venation,{,}
21	wfo-0001025872	success	160	108	78	82	30	0.487	.5,0.25-0.5,0.6-1,1,1-1.3,1-1.5,1-2,1.2-1.6,2-2.5,3.5-4,4-4.5,6-10,6-8,acute,anther,apex,auriculate,base,becoming,berry,branched,brownish,calyx,cm,coriaceous,corolla,crinkled,dark,deeply,deflexed,densely,dia,dry,elliptic,filament,flattened-reniform,fleshy,glabrous,globose,green,greenish-tan,later,lateral,leaf,live,lobe,margin,material,mm,narrowly,occasionally,often,opposite,ovary,pair,pedicel,petiole,pitted,plant,pubescent,red-papillose,revolute,rounded,rounded-triangular,several,shrub,stem,straight,style,surface,tapering,terminal,thick,time,tube,vein,white,x	.1,0.5,0.5-1,1.2-1.5,1.7-3,10-25-flowered,2-5,2/3,4.5-13,along,anthesi,apart,apically,ba,bark,beginning,beneath,blade,bright,broadly,capitate,crowded,cup-shaped,decurrent,dense,eaf,edicel,eed,exserted,flattened,flower,free,fruiting,glandular-resinous,grayish-brow,incrassate,inflorescenc,irregularly,junction,lobed,lon,long,lower,main,midrib,minutely,nflorescence,older,onto,paler,papillae,papillo,papillose,planar,plurifoliat,pore,poricidal,portion,prominent,ruit,scar,shaped,simple,somewhat,soon,spaced,specimen,stigma,tall,tear-drop,thickened,tip,trichome,tub,ud,uniseriate,unit,visible,way,woody,ympodial,young	abaxial,adaxial,alternate,arrangement,branching,characteristic,colour,diameter,form,fruit,growth,height,history,inflorescence,length,life,midvein,na,peduncle,perennial,primary,pseudostipule,rachi,seed,shape,staman,tertiary,texture,unarmed,venation
22	wfo-0001025893	success	157	108	79	78	29	0.503	.4,.5,0.5-1.5,0.8-1,1-1.2,1-1.5,1-2.5,1-4,1.5-2,2-2.5,2-3,5-6,6-10,along,anther,apex,attenuate,base,beneath,berry,branched,brownish-green,calyx,cm,corolla,decurrent,deflexed,deltoid,dia,dry,elliptic,filament,fruit,glabrate,glabrous,globose,golden-puberulent,green,greyish,internodal,lateral,leaf,lobe,long,long-acuminate,main,margin,minutely,mm,narrowly,nearly,obovate,occasionally,opposite,ovary,ovoid-reniform,pair,pale,pedicel,petiole,pitted,puberulent,red-papillose,shrub,slender,sometimes,specimen,stem,straight,style,surface,tapering,tip,tube,vein,white,winged,x,yellowish	.25,1.5-1.7,11-20,3-5,accrescent,anthesi,bank,barely,bark,bearing,beginning,bi-lobed,blade,broadly,capitate,closely,cup-shaped,densely,difoliate,eaf,early,eed,ellipsoid,erect,even,exserted,faintly,flower,free,fruiting,geminate,gravelly,growing,impressed,inflorescenc,lobed,lon,longitudinally,lower,many,material,middle,nflorescence,older,overlapping,papillo,papillose,planar,plurifoliat,pore,poricidal,portion,reflexed,river,rocky,ruit,sandy,scar,shaped,slightly,spaced,stigma,stream,striat,tall,tear-drop,thickened,time,trichome,ud,unicellular,unit,usually,visible,widest,woody,ympodial,young	abaxial,adaxial,arrangement,branching,characteristic,colour,diameter,form,growth,height,history,inflorescence,length,life,midvein,na,peduncle,perennial,plant,primary,pseudostipule,rachi,seed,shape,staman,tertiary,texture,unarmed,venation
23	wfo-0001025896	success	146	94	64	82	30	0.438	-3,0.5,0.5-2,1-1.5,1-3,1-6.5,1-8,1.5-2,1.5-9,10-25,2-2.5,2.5-5,4,4-5,4-6,5-15,6-10,abaxial,acuminate,angled,apex,articulated,base,brownish,calyx,cm,cuneate,deltate,densely,diameter,elliptic-ovate,entire,forked,fruit,glabrous,globose,lobe,margin,mm,moderately,nearly,orange,ovate,pale,pedicel,peduncle,petiole,pubescent,purple,rachi,red,rugose,shrub,simple,smooth,stem,style,subcordate,surface,triangular-subulate,unbranched,vein,white,x	-30,.5-2.5,1-25,10-15,2-14,2.5-14,4-12,4-23,5-7,6-13,7-,7743,abaxially,absen,acosta,acute,adaxiall,adaxially,aggregate,also,apart,axe,ba,blade,branched,cell,chartaceous,connivent,constricted,cylindrical,dendritically,directed,distall,eaf,eed,eglandular,especially,flower,gland,greenish,hair,inflated,like,long,lower,many-foliat,membranaceous,near,nflorescence,nther,obtuse,occasionally,often,orolla,perfect,pore,present,puberulent,pubescen,radiu,ripe,rotate-stellate,ruit,short-stalked,solÃ­,spaced,sparsely,stalked,stigma,stone,tal,tem,time,tip,triangular-ovate,truncat,tube,unit,vary,wide,yellow,ympodial	adaxial,anther,arrangement,branching,characteristic,colour,corolla,filament,form,growth,height,history,inflorescence,leaf,length,life,midvein,na,ovary,perennial,plant,primary,pseudostipule,seed,shape,staman,tertiary,texture,unarmed,venation
24	wfo-0001025902	invalid_json	211	155	134	77	21	0.635	.2,.5,/2,0.1-0.5,0.5-2.5,1-1.2,1-1.5,1.2-1.5,1.5,1/3,11-15,1983,2.5-4,3-10,4,4-13,4-5,4-6,40,5-6,8-15,>,abaxially,absent,acute,adaxially,along,anther,apex,articulated,attenuate,axi,bark,base,becoming,beginning,berry,black,branch,branched,branching,cabrera,cell,circular,clavate,cm,completely,corolla,densely,diameter,dull,ellipsoid,entire,except,fide,filament,flattened-reniform,flower,fruiting,glabrous,globose,green,growth,inflorescence,lanceolate,lateral,leaf,leaf-opposed,leaving,length,linear,lobed,lower,margin,mature,minute,minutely,mm,new,occasionally,ovary,pair,pale,papillose,pedicel,peduncle,peg,per,perfect,pericarp,petiole,pitted,primary,pubescent,ridged,rotate-stellate,rounded,scar,scattered,simple,sleeve,small,sometimes,spaced,sparsely,stem,stigma,strongly,style,surface,tangled,tapering,terminal,testal,thin,time,tip,trichome,tube,uniseriate,usually,vein,vine,violet,way,weak,whitish,widely,wing,woody,x,yellow,yellowish,Â½	0.5-2,1.5-2,1.5-3,2-6,5-merou,8-10,8-9,accompanied,ag,aid,always,alyx,anthesi,apar,ark,berr,broadly,c.,calyx,chartaceous,climbin,conical,connivent,deciduou,deltate,eaf,eed,either,exfoliatin,exserted,fleshy,free,geminat,ilament,lengthening,less,lobe,long,loosely,low,markedly,midvei,nflorescence,obscured,often,older,one,orolla,papillat,pendant,planar,plurifoliate,pore,poricidal,portion,prominent,revolute,ruit,scrambling,semi-aquati,semi-circular,shallow,slender,slit,somewhat,soon,spreading,tem,twining,ud,ultimate,unit,vary,vegetation,water,weight,ympodial	'',5-merous,[,``,apart,arrangement,bud,characteristic,colour,form,fruit,midvein,number,papillate,seed,shape,texture,type,value,{,}
25	wfo-0001025906	success	188	131	99	89	32	0.527	0.1-2,0.20-0.60,1-2,1.1-2,1.6-12.4,16-51,2-4.4,2-6,3-10,3-5,4-12,4-5,4-7,5-6,5-7,abaxially,acumen,acute,adaxially,anther,apart,apex,articulated,axillary,base,berry,blue,brownish,bud,cell,cm,condition,coriaceous,corolla,covering,cuneate,dark,decurrent,diameter,distal,drying,filament,flower,forked,fresh,fruit,generally,glabrous,globose,green,green-white,greenish,hair,hair-like,half,herb,high,lanceolate,lateral,leaf,light,lilac,linear,lobe,long,make,mm,mucilaginous,obtuse,odd-pinnate,ovoid,pedicel,peduncle,petiole,plant,pubescent,purple,rachi,ripe,seed,shiny,short,slightly,spaced,sparsely,stripe,style,sub-glabrous,subglabrous,subtending,terminal,testal,thick,throughout,usually,wall,wet,white,whitish	0-14,0.15-0.6,0.2-0.6,1-3,1-6,1.8-4.8,2.6-5.2,4-10,5-merou,5.2-9,8-16,8.5-12.5,adaxiall,ag,alyx,apparently,axe,blade,capitat,clavate,connivent,decreasing,decurrency,delimited,digestion,diminishing,dorsally,eaf,edge,eed,enzyme,erec,exceeding,falcate,first,flat,folded,geminat,glabrou,hal,homostylous,honeycomb-shaped,interjected,leaflet,lengthening,living,lower,next,nflorescence,orolla,pair,pentagonal,perfect,plurifoliate,pore,poricidal,removed,rotate,ruit,second,sessile,seudostipule,size,slit,smaller,specimen,stamen,stigma,straight,subequal,subglabrou,tall,tamen,tem,third,tip,toward,tri-,tube,typically,unit,unwinged,vary,well,width,wood,x,yellow,ympodial	2,abaxial,adaxial,arrangement,branching,calyx,characteristic,colour,form,growth,height,history,inflorescence,length,life,margin,midvein,na,ovary,perennial,primary,pseudostipule,shape,staman,stem,surface,tertiary,texture,unarmed,vein,venation,woody
26	wfo-0001025907	success	148	139	110	38	29	0.743	-4,.5,.5-1,0,0-60,1-1.2,1-2.3,1-3,1-5,1.5-2,1.5-2.2,10-15,2,2-3.5,2-8,2/3,3-4,4-5,absent,acuminate,acute,along,anther,anthesi,anticlinal,apex,appearing,attenuate,axil,axillary,base,beak,bearing,berry,breaking,brown,calyx,cm,conical,conspicuously,deciduous,densely,diameter,elliptic,filament,flattened,flower,fruit,glabrous,green,greenish,growth,highly,iquito,irregular,isolated,lamina,lobe,lobed,long,lower,margin,minutely,mm,near,nearly,new,obovate,occasionally,open,ovary,ovoid-reniform,pair,papillate,papillose,pedicel,per,petiole,plant,population,portion,primary,projection,pubescent,raised,red-papillate,reflexed,remaining,round,rugose,scar,scattered,seed,shrub,simple,sinuous,sparsely,style,surface,thickening,time,tip,trichome,truncate,uniseriate,vein,white,white-lenticellate,without,x	.05,0.8-1.8,1,12-45,3-,3/2,5-15,anthesis5-7,c,cell,clavat,eaf,edicel,eed,epidermal,erec,free,fruiting,globose,included,lon,nflorescence,poricidal,ruit,single-stemmed,size,slender,soon,stigma,tal,tem,tub,tube,ud,unifoliat,unit,variable,ympodial	0.05,5-7,abaxial,adaxial,arrangement,branching,characteristic,colour,corolla,form,height,history,inflorescence,leaf,length,life,midvein,na,peduncle,pseudostipule,rachi,shape,staman,stem,tertiary,texture,unarmed,unifoliate,venation
27	wfo-0001026203	invalid_json	197	132	95	102	37	0.482	0.06-0.86,0.3-11,0.38-11.3,0.4-3,0.7-2.6,1-13,1-2,1-9,2-10,2-4.9,2-43,3-10,3-11,7-47,acuminate,acute,anther,apex,articulated,attenuate,axillary,base,berry,blue,brownish,bud,cell,cm,condition,coriaceous,corolla,covering,dark,deep,diameter,distal,drying,elliptic,filament,flower,forked,fresh,fruit,generally,glabrescent,glabrous,globose,green,green-white,greenish,hair,hair-like,half,herb,high,lanceolate,lateral,leaf,light,lilac,lobe,long,make,medium,middle,mm,mucilaginous,odd-pinnate,ovate,ovoid,pedicel,peduncle,petiole,plant,rachi,ripe,rounded,seed,sessile,short,sometimes,stripe,style,subglabrous,subtending,terminal,testal,thick,throughout,typically,usually,wall,wet,white,whitish	0-39,0-7,0.3-6,0.5-2.3,0.5-3.2,1-4,1-5,1.1-7.9,1.2-5.5,2-5,2-8.5,2.2-13.3,3-5,3.2-22,3.2-23,5-merou,abaxially,acumen,adaxially,ag,along,alyx,apart,apparently,arranged,asymmetric,axe,basiscopic,bead,blade,capitat,clavate,connivent,decreasing,decurrent,digestion,dorsally,eaf,edge,eed,enzyme,erect,exceeding,flat,folded,geminat,glabrescen,glabrou,hal,homostylous,honeycomb-shaped,interjected,leaflet,lengthening,like,linear,living,lower,moniliform,multiple,necklace,nflorescence,orbicular,orolla,pair,pentagonal,perfect,plurifoliate,pore,poricidal,removed,rosett,rotate,ruit,seudostipule,side,size,slightly,slit,spaced,specimen,stamen,stigma,stolon,straight,subequal,tall,tamen,tem,tip,tissue,toward,tri-,tube,tuber,unit,unwinged,vary,wide,x,yellow,ympodial	'',2,[,``,abaxial,adaxial,arrangement,branching,calyx,characteristic,colour,form,growth,height,history,inflorescence,length,life,margin,midvein,na,ovary,perennial,primary,pseudostipule,shape,staman,stem,surface,tertiary,texture,unarmed,value,vein,venation,{,}
28	wfo-0001026208	success	214	126	105	109	21	0.491	0-20,0-4,0-5,0.5-1.2,0.6-0.8,0.6-0.9,0.7-2,0.8-1.5,1-2,1-5,1.8-2.3,1.8-2.5,2-20,2.5-6,3-5,3.5-5,4-7,6-22,abaxial,acuminate,acute,adaxial,anther,apex,apically,apparently,articulated,base,berry,branched,bright,brown,calyx,chartaceous,cm,cuneate,dark,deltate,densely,diameter,dull,elliptic,erect,evenly,filament,flattened-reniform,fruit,glabrous,green,green-brown,infructescence,lateral,leaf,length,lobe,lobed,long,lower,margin,maturity,mauve,membranous,midvein,mm,moderately,orange,orange-brown,ovate,pair,pale,pedicel,peduncle,per,petiole,prickle,prickly,primary,pubescent,recurved,red,rounded,shrub,side,sometimes,somewhat,sparsely,spherical,stellate,stellate-pubescent,stem,straw-yellow,style,surface,terminal,tertiary,toward,trichome,unarmed,vein,venation,visible,white,wide,yellow,young	-1/2,-10,-3,-5,.5,/3,0,0-8,0.1,0.1-0.2,0.1-0.25,0.1-0.3,0.5-0.8,0.8-1.3,1-4,1.5,1.5-2.5,1/3,1/4-1/3,1/4-1/6,11-25,2,2-3,2-4,2.5-5,3-30,3-6,3/,4-9,5,5-,5-17,5-22,5-merous,6-8,abaxially,acut,alyx,apar,apart,bark,becoming,blade,broad-deltate,conical,connivent,curved,difoliate,discolorous,distance,drying,eaf,eed,elongated,elongating,equal,extending,flattened,flower,free,fruiting,geminat,geminate,glabrescent,gray-greenish,longer,mature,midpoint,nflorescence,older,one,open,orolla,oung,pendulous,perfec,pericarp,poricidal,porrect,portion,ray,red-brow,ruit,scar,sessile,shorter,slender,smooth,spaced,spreading,stalk,stalked,stout,straight,subentire,tamen,tapering,terete,time,tip,tube,unarme,unit,usually,variously,vary,way,woody,ympodial	3/4,arrangement,branching,characteristic,colour,corolla,form,growth,height,history,inflorescence,life,na,ovary,plant,pseudostipule,rachi,seed,shape,staman,texture
29	wfo-0001026215	success	150	129	99	51	30	0.66	-3,.05,.5,0,0.05,0.5-1,1,1-3,1.5,1.5-2,1.5-2.2,18-20,2,2-3,2-3.5,2-4,4-5,7-8,abruptly,acuminate,along,anther,anticlinal,apex,axil,axillary,base,beak,berry,broadly,brown,calyx,cell,cm,completely,conical,continually,corolla,deltate,densely,diameter,elliptic,entire,epidermal,filament,flattened-round,flower,fruit,glabrous,green,greenish,herb,highly,horizontal,irregular,kink,length,less,lobe,long,marked,minutely,mm,narrowing,nodding,occasionally,onto,ovary,ovoid-reniform,pair,papillae,papillate,pedicel,per,petiole,portion,primary,projection,purple,raised,red-papillose,rounded,rugose,seed,shrub,simple,sinuous,stem,strongly,style,surface,thickening,vein,white,white-pubescent,wing,winged,without,x	13-35,15-2,3/4,4-15,abaxially,absent,anthesi,ape,bifi,clavate,conspicuously,eaf,edicel,eed,enlarged,erect,exserted,free,fruiting,globose,internode,lobed,lower,markedly,nearly,nflorescence,noddin,often,papillat,poricidal,reflexed,ruit,scar,shortsympodial,single-stemmed,small,ste,stigma,tal,tem,time,tip,tub,tube,ud,unifoliat,unit,usually,way,white-lenticellate,wide	-5,abaxial,adaxial,arrangement,branching,characteristic,colour,form,growth,height,history,inflorescence,leaf,life,margin,midvein,na,peduncle,perennial,plant,pseudostipule,rachi,shape,staman,tall,tertiary,texture,unarmed,unifoliate,venation
30	wfo-0001026229	success	299	123	87	212	36	0.291	1,35,5,abaxial,abaxially,acute,adaxial,anther,apex,articulated,asymmetric,attenuate-caudate,base,berry,black,branching,brown,calyx,camptodromous,cm,corolla,covered,cuneate,cylindrical,cyme,dark,densely,diameter,elliptic,elongated,entire,flattened,flower,fruit,glabrescent,glabrous,globose,golden,green,growth,hirsute,immature,inflorescence,irregular,lanceolate,leaf,lobe,long,margin,mature,midvein,mm,moderately,narrow-ovate,narrowly,ovate-elliptic,pair,pale,pedicel,peduncle,per,petiole,pink,pit,primary,pubescent,purple,purplish,rachi,reniform,revolute,rounded,shiny,shrub,simple,slightly,stem,style,surface,trichome,type,unbranched,vein,venation,white,wide,yellowish-white	0.1â1.47,0.2â0.8,0.35,0.3â0.9,0.3â1.2,0.4,0.8â1.2,0.8â2,0.9,0.9â4.3,1-celled,1.2â4.8,1.3â1.5,1.3â1.7,1.4,1.7â11.8,1.7â2.3,1.8,1.8â5.5,1.9â2.5,1/3,13,1â1.4,1â2,1â4,2,2.3â3.4,2.8â4,2â3,2â3-celled,2â4-celled,3,3â4,3â5,4.5â6.5,4â6,5-merou,5â9,6â15,6â7,6â8,8.6â12,8â10,9â31,accrescent,acuminate,adaxiall,adaxially,ag,almost,also,always,alyx,anthesi,ark,associated,axe,ba,barely,beneath,blade,branch,broadly,broken,capitate,celled,central,changing,clavate,commentary,commonly,completely,concentrated,connivent,cordate,creating,deltoid,develope,developed,differing,directed,discolorous,diÂ­,dried,drying,eaf,eed,eglandular,ellipsoidal,even,faces,few-rayed,found,free,frequently,fresh,fully,geminate,gland,glandular,glandular-capitate,hair,head,hispid,hyaline,ilament,impressed,included,insertion,internodal,introrsely,involute,lamina,larger,lateral,less,like,lobed,long-stalked,longer,longitudinal,lower,mainly,material,maturit,membranaceous,midpoint,midri,minute,mixed,much,multangulate,multangulate-stellate,multiseriate,near,nearly,new,nflorescence,oblong,often,old,older,one,open,opening,orientation,orolla,other,oung,ovate,paired,papillose,pedunculate,perfect,plurifoliate,point,poorly,pore,poricidal,porrect-stellate,portion,ra,raised,rarely,ray,remnant,ruit,secondary,see,sessile,shin,short-,short-stalked,shorter,size,slit,small,smaller,solitary,sometimes,somewhat,sparsely,spread,spreadin,spreading,stalk,stellate,stigma,strongly,subopposite,subsessile,supported,surfac,terminal,three,tree,trifoliate,tube,tuft,ud,unequal,unit,upper,usually,vary,vestiture,visible,weakly,whitish-green,yellow,ympodial,Â¾	0.1-1.47,0.3-1.2,0.35-4.3,1-2,1.3-1.7,1.7-2.3,1.8-5.5,1.9-2.5,2.3-3.4,2.8-4,5-9,6-7,6-8,8.6-12,9-31,arrangement,characteristic,colour,filament,form,height,history,length,life,na,ovary,perennial,plant,pseudostipule,seed,shape,staman,tertiary,texture,unarmed,ye
31	wfo-0001026230	success	144	91	60	84	31	0.417	.5,.8,0.3-1.5,0.5-3,0.9-2,1-1.4,1-1.5,1.1-1.8,2-4,3-4,5-10,5-20-flowered,acuminate,acute,anther,apex,base,berry,calyx,clavate,cm,corolla,deflexed,deltoid,elliptic,filament,fruit,glabrous,globose,green,grey,immature,leaf,lobe,long,long-triangular,margin,mm,ovary,pair,pedicel,petiole,rounded,shrub,simple,slightly,small,stem,straight,strongly,style,surface,tapering,tree,umbonate,unknown,vein,white,winged,x	.25,0.75-1,1-4,1.8-2.3,1.9-4.1,12.6-20.8,2-5,4.6-9.3,anisomorphic,anisophyllou,anthesi,apart,apiculate,appears,area,back,bark,beginning,beneath,broadly,bud,clu,completely,cordate,coroll,dia,difoliate,distal,eaf,edicel,eed,enclosing,erect,evenly,except,free,fruiting,geminate,inflorescenc,large,lateral,lobed,lon,long-acuminate,lower,main,major,middle,minor,minutely,nearly,nflorescence,obtuse,older,opposite,orbicular,ovoid,papillose,pointed,pore,poricidal,portion,raised,reflexed,ruit,rusty-papillose,scar,shaped,sinus,slender,spaced,stigma,tall,tear-drop,thickened,tip,tube,ud,unit,white-lenticellat,widest,woody,ympodial,young	0.25,abaxial,adaxial,anisophyllous,arrangement,branching,characteristic,colour,diameter,form,growth,height,history,inflorescence,length,life,midvein,na,peduncle,perennial,plant,primary,pseudostipule,rachi,seed,shape,staman,tertiary,texture,unarmed,venation
32	wfo-0001026233	success	165	121	81	84	40	0.491	-1,-1.9,-3.8,-5.5,-50,-8.1,.25,.75,0.7-0.8,0.8-1.55,1-,1.2-2.7,1.5,1/2,2,2-,2.1,2.4-3.5,2.6,2/3,3.5-4.5,5-30,6,acute,annual,anther,antrorse,apex,basal,base,bearing,berry,broadly,calyx,cm,coat,conspicuous,cuneate-attenuate,densely,diameter,elliptic,entire,evident,few-,filament,glabrous,globose,hair,herb,leaf,less,lilac,lobe,margin,mm,moderately,non-glandular,ovate,ovule,pale,papery-scarious,petiole,pinnatisect,protuberance,pubescent,reticulate,seed,simple,small,sparsely,striate,style,subglobose,surface,trans-ovoidal,trichome,tuberculate,unifoliate,uniseriate,x,yellow	0.3,0.5,0.7-,0.8-1.3,0.8-4,1,1.1,2.3-7,3.2-3.7,3.2-4.7,4-,5-6.2,abundant,accrescent,ag,annular,articulated,ascending,campanulate,capitate,curved,cylindrical,difoliat,dimorphic,eaf,eed,ellipsoidal,embryo,fruiting,herbaceous,hig,interlobular,investing,lamina,larger,lobed,long,longitudinal,longitudinally,lower,membrane,minutely,multicellular,narrowly,near,obtuse,occasionally,opening,orolla,other,outer,partially,pinnatipartite,pore,poricidal,portion,present,pubescen,ree,ridged,rounded,ruit,scarcely,seede,serrate,shorter,slender,slightly,slit,smaller,stigma,strongly,styl,tem,tip,tube,unequal,unit,vary,venatio,verrucose,wider,winged,ympodial	0.7-1.3,4-6.2,abaxial,adaxial,arrangement,branching,characteristic,colour,corolla,difoliate,form,fruit,green,greyish,growth,height,hirsute,history,inflorescence,length,life,midvein,na,ovary,pedicel,peduncle,plant,primary,pseudostipule,rachi,seeded,shape,staman,stem,tertiary,texture,unarmed,vein,venation,white
33	wfo-0001026241	success	220	121	85	135	36	0.386	0.5,10-20,109,2-flowered,abaxially,adaxially,anther,apex,appearing,appears,base,basiscopically,berry,black,branching,brown,calyx,cell,cm,conical,corolla,covered,densely,dia,dry,elliptic,entire,erose,et,extended,filament,fruit,galiano,glabrous,glandular-pubescent,globose,herb,inflorescence,internodal,irregularly,leaf,lobe,margin,midvein,mm,near,oblique,orangish,outline,ovary,ovate,ovoid,papillate,pedicel,peduncle,per,perennial,petiole,pinnatifid,pitted,pubescent,pulp,rachi,remain,reniform,robust,seed,shallowly,sinuate,somewhat,spatulate,stem,stout,style,subshrub,surface,ternate,testa,triangular,truncate,tuberculate,usually,vein,white,x	.2,.3,.5,0.1â0.15,0.2â,0.3â,0.3â0.4,0.3â0.6,0.3â1,0.5â0.7,0.5â0.8,0.5â1,0.7â1.1,1-,1-celled,1.2â1.5,1.2â2,1.5â1.7,1.5â2.5,1.5â3.5,1.9â2.1,1/3â1/2,1â,1â1.1,1â1.4,1â1.5,1â2,2.5â3,2â2.1,2â3,3,3-,30â50,3â3.1,4-,4.5â5,5,5-celled,5-merous,6,always,anthesi,apical,articulated,attenuate,ba,basal,beak,brittle,broader,campanulate,capitate,center,connecting,cordate,cup,curved,curving,darker,decurrent,deflexe,dehiscing,deltate,denser,depressed-globose,difoliate,discrete,drying,dwarf,eaf,eglandular,enclosed,equal,erect,flower,foliat,foliose,free,fruiting,geminate,gland,glandular,intially,larger,lateral,leaflet,like,lobed,lon,long,longitudinal,main,mixture,much,nflorescence,one,onto,open,papillat,perfect,pericarp,pore,portion,prolonged,pubescen,ruit,shiny,simple,slightly,slit,small,smaller,sometimes,stamen,stellate,stigma,strongly,succulent,sulcate,taproot,terminal,thick,thickened,tip,tissue,trichome,tube,ud,uniseriate,unit,way,wide,wing,woody,ympodial	0.5-0.7,1-1.1,1-1.4,1-1.5,1-2,1.5-1.7,1.9-2.1,2-2.1,2-3,2.5-3,3-3.1,30-50,4.5-5,abaxial,adaxial,arrangement,characteristic,colour,decurren,diameter,form,growth,height,history,length,life,na,plant,primary,pseudostipule,shape,staman,tertiary,texture,unarmed,venation
34	wfo-0001026242	success	210	125	103	107	22	0.49	-2,-6,0,0-2,0.4-0.5,0.4-2,0.5-1,0.55-0.9,0.7-1.3,1-1.5,1-2.5,1-3,1.5-3,1.5-4,1/2,2-2.5,2.5-2.8,2.5-4.5,5-18,5-7,abaxial,acute,anther,apex,apically,apparently,articulated,base,berry,branched,bright,calyx,cm,concolorous,cuneate,deltate,densely,diameter,drying,dull,erect,evenly,eye,filament,flattened-reniform,fruit,glabrescent,glabrous,glandular,green,hair,infructescence,lateral,leaf,length,lobe,lobed,long,margin,maturity,membranous,midvein,minute,mm,moderately,naked,obtuse,orange-brown,pair,pale,pale-brown,pedicel,peduncle,per,petiole,prickle,prickly,primary,recurved,red,red-brown,shrub,side,sometimes,sparsely,spherical,stellate-pubescent,stem,style,subentire,surface,terete,tertiary,unarmed,upper,vein,venation,visible,weakly,white,wide,yellow,young	-0.9,-1.5,-5,/4,0.05-0.2,0.1,0.3-0.5,0.35-,0.4-0.55,0.5,0.5-0.7,0.7,1.2-2,1/5-1/3,1/6-1/4,10-,10-20,2-5,3-6.5,30-80,4-10,4-13,4-5-merous,4.5-5.5,5-,6.5-8,7-17,8-20,abaxially,acut,almost,alyx,ame,apar,apart,bark,blade,broad-deltate,c.,connivent,curved,difoliate,distance,eaf,eed,elliptic,elongating,equal,extending,filiform,flattened,flower,free,fruiting,geminat,glabrou,green-gra,irregularly,largely,longer,lower,mature,midpoint,multangulate,narrow-deltate,nflorescence,occasionally,older,one,open,orolla,oung,perfec,pericarp,poricidal,porrect,portion,prickl,ray,reflexed,rounded,ruit,scar,sessile,shorte,shorter,simple,smooth,spaced,spreading,stalk,stalked,stellate,straight,tamen,tapering,time,tip,trichome,tube,unarme,unit,variously,vary,way,woody,ympodial	0.35-0.4-0.55-0.9,adaxial,arrangement,branching,characteristic,colour,corolla,form,growth,height,history,inflorescence,life,na,ovary,plant,pseudostipule,rachi,seed,shape,staman,texture
35	wfo-0001026259	success	233	117	85	148	32	0.365	.1,.7,1.5,2/3,6,abaxial,acuminate,acute,adaxial,anther,anthesi,apex,base,becoming,berry,branching,broadly,brown,calyx,central,cm,concave-reniform,corolla,cylindrical,decurrent,deltate,densely,diameter,ellipsoid,end,entire,filament,fruit,glabrous,green,green-orange,herb,inflorescence,internodal,lateral,leaf,length,lilac,lobe,long,margin,mm,much,narrower,nearly,once-branched,one,ovary,ovate-lanceolate,pair,pedicel,peduncle,per,petiole,plant,primary,pubescent,purple-coloured,rachi,rarely,recurving,ripe,rounded,shrub,simple,sparsely,spreading,star,stem,straight,style,surface,translucent,turning,vein,white,wide,woody,yellow,yellow-green	.8,0.1â0.2,0.2â0.4,0.3â1.2,0.4â0.6,0.5,0.5â0.6,0.7â0.9,0404,0â2,1,1-celled,1.0â1.2,1.0â3.3,1.2â8.4,1.4â4.0,1.5â2.0,11â22,12â24,1m,1â2,1â2-celled,1â3-celled,2-ridged,2â17,2â3-celled,3.0â3.4,35â45,4â5,5-merous,5â14,5â7-celled,7â10,8â11,?,abaxially,adaxially,affected,age,apar,appressed,arising,beyond,branch,branched,cell,close,coloured,cone,congested,conical-ellipsoid,cream-coloured,dehiscing,difoliate,drop,eaf,eed,elongating,especially,et,exerted,fleshy,flower,free,fruiting,geminat,globose,gradually,growt,halfway,hilum,individual,knapp,larger,leave,lengthening,less,like,live,lobed,lon,longer,lower,lowermost,membranous,minutely,narrowly,near,nflorescence,node,occasionally,often,outline,pale,papillate,pathogen,pentagonal,perfect,pericarp,pore,poricidal,portion,positioned,purple,purple-black,reduced,reflexed,relatively,remaining,ruit,scar,shiny,short,shorter,similar,slightly,slit,smooth,sometimes,somewhat,spaced,splitting,stellate,stigma,stone,stout,strongly,sub-laterally,tall,tapering,tem,testal,thick,tightly,tinged,tip,together,toward,trichome,tube,two,ud,uniseriate,unit,winged,ympodial,young,â15	0.2-0.4,0.3-1.2,0.4-0.6,0.7-0.9,1.0-1.2,1.0-3.3,1.5-2.0,12-24,2,2.8-3.4,35-45,7-10,8-11,arrangement,characteristic,colour,form,growth,height,history,life,midvein,na,perennial,pseudostipule,seed,shape,staman,tertiary,texture,unarmed,venation
36	wfo-0001026267	success	162	140	102	60	38	0.63	0.5-1,0.6-1.7,0.7-1.1,1-1.2,1-2.6,1.5-2,2.5-3,20-30-flowered,3-15,5-7,8-10,acuminate,acute,anther,anthesi,apex,attenuate,bark,base,berry,blackish,body,bright,broadly,calyx,closely,cm,corolla,cuneate,decurrent,deflexed,densely,dia,distally,drying,except,exerted,filament,flattened-reniform,glabrous,globose,green,greenish-white,greyish-green,hard,incrassate,larger,lavender,leaf,lobe,long,margin,maturity,minutely,mm,narrowly,occasionally,often,opposite,ovary,ovate,overlapping,pair,pale,pedicel,petiole,pitted,pitting,pubescent,quickly,remaining,ripening,rough,scar,scattered,shrub,simple,slender,slightly,small,softening,soon,spaced,sparsely,stem,straight,style,surface,tan,tapering,tinge,tree,triangular,trichome,tube,tuft,uniseriate,vein,white,winged,x,yellow-green	.25,.5,0.1-1,1-1.5,1-4,1.5-2.3,3-6.1,3.2-8.6,4-8,8.5-15,axil,ba,beginning,beneath,crateriform,depressed,differing,difoliate,distinct,eaf,edicel,eed,free,fruiting,geminat,inflorescenc,lateral,lobed,lon,longinflorescence,lower,main,major,middle,minor,nearly,older,one,papillo,papillose,pore,poricidal,portion,raised,reflexed,ruit,scarious,shaped,size,stigma,tall,tear-drop,tip,ud,unit,widest,wing,woody,ympodial,young	0.25,1,abaxial,adaxial,arrangement,branching,bud,characteristic,colour,deflexion,diameter,exertion,form,fruit,growth,hardnes,height,history,inflorescence,length,life,midvein,na,peduncle,plant,position,primary,pseudostipule,rachi,seed,shape,spacing,staman,tertiary,texture,unarmed,venation,winging
37	wfo-0001026279	success	248	130	105	143	25	0.423	-11.4,-2.9,-34.3,-5.9,0.2-0.4,0.8-2.3,0.9-1.8,1-1.4,1-10,1-3.5,1.1-1.6,1.1-1.9,1.5-1.8,1.5-3,1.7-2.3,1.9-3.2,11.5-19.7,3-4,3.1-4.2,3.4-5.2,3.8-5.1,8,8-11,8.5-10.5,abaxially,acute,adaxially,anther,apart,apex,attenuate,base,berry,black,branched,brown,calyx,closely,cm,conical,corolla,cuneate,dark,deltoid,diameter,drying,elliptic,entire,filament,fleshy,flower,fruit,glabrescent,granular,grayish,grayish-green,green,lanceolate,lavender,leaf,length,lilac,lobe,many,margin,midrib,mm,multangulate-pubescent,narrowly,pale,pedicel,peduncle,petiole,plant,porrect-stellate,prominent,pubescence,rachi,reticulate-punctate,scabridulous,scabrous,scattered,semi-ovate,short,shrub,side,simple,spaced,stem,style,subcoriaceous,suborbicular,surface,tertiary,time,tomentose,tomentose-pubescent,tree,unarmed,vein,white,whitish,x,yellowish,yellowish-tan	-4,/14-1/8,0.25-0.4,0.9-1,1.9-3,1/2,14-27,2.4-3.2,2.5-3.2,2.6-4.8,2/3,3.1-3.6,3.5-7.8,4-7.5,5-200,5-8,9-22,accrescent,acuminate,adaxiall,ag,anthesi,apparently,appearing,appressed,ark,around,articulated,axe,axillary,ba,blade,blunt-tipped,branch,bud,capitate,chartaceous,completely,covering,cylindrical,dendritic-echinoi,dendritic-echinoid,dense,directed,distally,due,eaf,earl,echinoi,echinoid,edge,eed,elongated,enveloping,equal,evident,exerted,expanded,farinose,few-rayed,free,fruiting,glabrescen,glabrous,globose,hair,half,immature,inserted,lateral,lengthening,lobed,long,long-stalked,longer,longitudinal,longitudinall,lower,m.,main,mature,minute,mixed,multangulate,multiseriate,nflorescence,oblong,obovate,occasional,occasionally,often,older,open,orbicular,orolla,ovate-lanceolate,overlapping,partly,perfect,plurifoliate,pore,poricidal,present,pseudo-terminal,rounded,ruit,secondary,sessile,short-,short-decurrent,short-stalked,slightly,slit,slowly,somewhat,splitting,stalk,stamen,stellate,stigma,subcampanulate,subsessile,sulcate,suture,tall,tamen,thickened,thin,thin-stalked,tip,tube,ud,unarme,unit,unwinged,upper,usually,vary,way,wide,yellow,ympodial,young	abaxial,adaxial,arrangement,branching,characteristic,colour,form,growth,height,history,inflorescence,life,midvein,na,ovary,perennial,primary,pseudostipule,pseudoterminal,seed,shape,staman,texture,venation,ye
38	wfo-0001026299	success	239	127	104	135	23	0.435	-0.8,-3.5,0.25-0.5,0.4-0.5,0.5-0.6,0.5-0.7,0.5-1,0.5-2.5,0.8-1,1,1.1-1.7,1.8-2,2-locular,2.2-3.2,5-20,7-12,acute,almost,anther,apex,articulated,basal,base,basiscopically,beneath,bracteate,broadly,brown,calyx,cell,cm,corolla,crenate-serrate,dark,decurrent,densely,diameter,distal,ebracteate,elliptic,entire,erect,filament,flower,fruit,glabrous,glandular,globose,green,hair-like,half,imparipinnate,inflorescence,interrupted,irregularly,jequetepeque,lanceolate,lateral,leaf,lobe,lobed,margin,middle,minute,minutely,mm,nearly,node,oblique,obovate,often,outgrowth,ovary,pale,pedicel,peduncle,perennial,petiole,primary,prostrate,pseudostipule,pubescent,rachi,regularly,short,silky,simple,sparsely,spreading,stem,stripe,style,surface,tall,tertiary,testa,trichome,truncate,variously,vein,velvety,wall,white,yellow	--,-1,-10,-2.5,-5,.5,0-8,0.1-0.2,0.1-0.25,0.1-0.4,0.1-0.5,0.15-0.2,0.2-0.25,0.2-1,0.3-0.4,0.4-2,0.5,0.6-2,0.7-3.5,0.8-0.9,0.9-1,1-1.4,1-celled,1.2-1.6,1.2-5,1.5-,1.5-2.3,2-4,2-6,2-foliate,2.5,2.5-7,25,3-,3.5-10,5,5-15,6-20,abaxially,absent,abundant,acroscopically,adaxially,along,angled,anthesi,apical,appearance,appendage,approximately,axi,berr,bract,capitate,change,chota,column,conical,could,crenat,developed,diamete,eaf,edicel,eed,eglandular,exserted,fruiting,give,gree,hal,head,herb,interjected,intermixed,internode,investing,lacking,larger,leaflet,less,like,lon,long,long-acuminate,longer,loosely,lower,maraÃ±Ã³n,maturity,mixture,multicellular,narrowly,nflorescence,occasionally,pair,patent,pentagonal,petiolule,population,present,pubescence,purple,reflexed,rest,ruit,scarcely,scattered,secondary,sessile,size,sparse,staminal,sterile,stigma,stout,straight,tem,terminal,thick,tip,toward,tube,ud,unicellular,uniseriate,unit,usually,valley,way,weak-walled,wide,winged,woody,ympodial	1.5-10,abaxial,adaxial,arrangement,branching,characteristic,colour,form,growth,height,history,length,life,midvein,na,plant,reproduction,seed,shape,staman,texture,unarmed,venation
39	wfo-0001026305	success	135	108	71	64	37	0.526	0.2-1,0.25-0.5,0.5-2,0.6-1,0.7-1,1-1.5,2-2.5,2-6-flowered,2.5-3,4-4.5,5-7,6-9,7-9,abaxial,acute,anther,apex,attenuate,bark,base,beige-tan,calyx,closely,cm,corolla,dark,deflexed,deltate,dendritic,drying,elliptic,exserted,filament,free,glabrous,globose,green,greenish-white,leaf,lobe,lobed,margin,minutely,mm,ovary,ovoid-reniform,pair,pale,pedicel,petiole,pitted,pore,portion,pubescent,rounded,scar,shaped,shrub,simple,spaced,stem,strongly,style,surface,tan,tear-drop,trichome,tube,unifoliate,vein,x	.25,/4,1.3-1.5,3-8.5,7-16,abaxially,adaxially,along,anthesi,apical,area,ba,berry,congested,conical,densely,dia,difoliate,eaf,edicel,eed,fruiting,geminat,glabrate,interlocking,knob-like,lamina,lateral,leaf-opposed,like,lon,long,lower,main,middle,midrib,minute,nflorescence,occasionally,older,overlappin,papillose,planar,poricidal,projection,reddish-brow,ruit,scattered,shining,slender,sparsely,stigma,styl,tall,tip,tub,ud,unit,visible,way,widest,woody,ympodial,young	0.25,adaxial,arrangement,branching,bud,characteristic,colour,diameter,exsertion,flower,form,fruit,growth,height,history,inflorescence,length,life,midvein,na,number,overlap,overlapping,peduncle,plant,primary,pseudostipule,rachi,reddish-brown,seed,shape,spacing,staman,tertiary,texture,unarmed,venation
40	wfo-0001026307	success	193	118	97	96	21	0.503	.6,.8,0.2â0.5,0.2â1.5,0.5â0.7,0.5â5.0,1.0â1.2,1.0â2.4,2/3,3.0â4.0,3.5â7.0,35â45,3â8,4â5.7,5â7,8â12,9,abaxial,acute,acute-acuminate,adaxial,anther,apex,articulated,base,berry,black,broadly,calyx,central,cm,corolla,cuneate,decurrent,densely,diameter,ellipsoid,end,entire,eye,filament,flattened-reniform,flower,fruit,glabrous,glandular,globose,green,growth,herb,internodal,lateral,length,lobe,lobed,long,margin,membranous,mm,narrowing,one,ovary,ovate,pair,paler,pedicel,peduncle,per,petiole,primary,pubescent,purple,purple-yellow,ripe,shallowly,shape,shrub,simple,sparsely,spreading,stem,straight,style,surface,tinged,toward,triangular,trichome,turning,undulate,uniseriate,variable,vein,white,wide,yellow,yellow-green	.0â1.2,.3,.5,.5â4.0,0.4,0.5â0.6,0.6,0.8â0.9,0.8â2,0.8â5,1.0â1.5,1.0â2.0,1.0â2.5,1â3-celled,1â6-celled,2.0,2.0â3.0,2.0â3.5,2.6â13,3â8-celled,5-merous,abaxially,adaxially,age,angled,anthesi,apar,appressed,becoming,beyond,cell,clavate,cone,cylindrical,difoliate,eaf,eed,exerted,facing,free,fruiting,geminat,gradually,hilum,later,lengthening,like,longer,lower,middle,minutely,narrower,new,nflorescence,outline,papillat,pentagonal,perfect,pore,poricidal,portion,positioned,recurved,reflexe,reflexed,restricted,ruit,scar,shallow,shorter,side,slightly,slit,spaced,ste,stellate,stigma,stone,strongly,sub-laterally,tal,tem,testal,three,tip,translucent,tube,two,ud,unequal,unevenly,unit,upper,vigorous,weak-stemmed,ympodial	arrangement,branching,characteristic,colour,form,height,history,inflorescence,leaf,life,midvein,na,plant,pseudostipule,rachi,seed,staman,tertiary,texture,unarmed,venation
41	wfo-0001026317	success	169	99	75	94	24	0.444	0.3-1.2,0.5,0.5-0.6,0.8-1,1-1.2,1-1.5,10-12,2-2.5,2-4,3-3.5,4-5,6-8,abaxially,acuminate,acute,anther,apex,attenuate,base,berry,branched,bright,brown,calyx,clonal,cm,conical,corolla,dark,dendritic,densely,diameter,elliptic,entire,filament,flattened,glabrous,globose,growth,inflorescence,internodal,lobe,many,margin,minutely,mm,narrowly,orange,ovary,pair,pale,pedicel,peduncle,per,petiole,pitted,plant,primary,pubescent,rachi,red,reniform,shrub,simple,sparsely,stem,style,surface,terminal,time,triangular,vein,white,x,yellowish	.5,/4,0.25-1,0.5-0.8,0.5-1,0.6-,0.7-0.9,1-5.7,2-,2.5-10,3,3-foliate,3.5-15,50-200,6x,?,absent,adaxially,age,anthesi,apart,apically,approximately,bark,capitate,closely,correlated,deltate,dense,distally,drying,eaf,eed,em,erec,erect,essentially,exerted,extremely,flower,found,free,fruiting,geminat,halfwa,lamina,lengthening,less,like,lobed,longer,lower,maturity,new,nflorescence,nodding,occasionally,often,packed,papillat,papillate,perfect,pericarp,planar,plane,population,pore,poricidal,portion,pubescen,pubescence,pulp,reflexed,ruit,scar,shiny,slightly,slit,sticky,stigma,straight,swollen,thin,tip,toward,trichome,tube,ud,uniseriate,unit,variable,way,woody,ympodial	2,abaxial,adaxial,arrangement,branching,characteristic,colour,form,fruit,height,history,leaf,length,life,midvein,na,pseudostipule,seed,shape,staman,tertiary,texture,unarmed,venation
42	wfo-0001026335	success	157	130	97	60	33	0.618	.5,0.1-0.3,0.25-0.5,0.5-1,0.6-1,0.8-1.3,1,1-1.5,1-2,1-4,1.5-2,10-20,2,2-3,2-4,3-18,4-5,5-15,acuminate,acute,anther,apart,apex,articulated,base,branched,calyx,chartaceous,cm,connivent,covering,cuneate,curved,cylindrical,deltate,dense,densely,diameter,directed,distally,elliptic,elliptic-ovate,entire,erect,filament,flattened,flower,forked,fruit,glabrescent,glabrous,glandular,globose,green,hair,held,leaf,leaf-opposed,lobe,long,longitudinal,margin,midpoint,mm,often,opening,pedicel,peduncle,petiole,probably,pubescence,pubescent,rachi,ray,reticulate,ripe,rounded,shrub,simple,slit,spaced,stellate,stellate-pubescent,stem,straight,style,surface,time,tip,unripe,usually,vein,white,whitish,wide,x,yellowish	.5-3.5,1-3,1.5-4,10-30,2-7.5,3-5,5-,5-7,7-8,abaxially,accrescent,adaxiall,adaxially,ag,apparently,axe,ba,blade,capitat,eaf,eed,equal,especially,frui,fruiting,geminate,glandula,lanceolate,large,like,lower,many-foliate,moderately,much,multangulate,nflorescence,oblong,orolla,paired,perfect,pore,ruit,scattered,sessile,slightly,smaller,sometimes,ste,stigma,subtending,tal,tamen,tem,toward,tube,unit,uprigh,vary,yellow,ympodial	1.5-3.5,abaxial,adaxial,age,arrangement,branching,characteristic,colour,corolla,form,growth,height,history,inflorescence,length,life,midvein,na,ovary,perennial,plant,primary,pseudostipule,ratio,seed,shape,staman,tertiary,texture,unarmed,upright,venation,width
43	wfo-0001026343	success	221	117	96	125	21	0.434	-4,0-2,0-4,0-40,0-5,0.05-0.5,0.45-1,0.5-1.5,1-2,1.3-1.7,1.8-2.2,1.8-3,1/3,2-3,2-3.2,2-6,2.2-3.2,3-4,3-5,5.5-9,abaxial,acute,adaxial,anther,apex,apparently,articulated,base,berry,branched,broadly,calyx,chartaceous,cm,cream,cuneate,dark,deltate,densely,diameter,dull,erect,faint,filament,flattened-reniform,fruit,glabrescent,green,green-brown,infructescence,lateral,leaf,length,lobe,lobed,long,lower,margin,marking,maturity,mauve,midvein,mm,orange,orange-brown,ovate,pair,pale,pedicel,peduncle,per,petiole,plant,prickle,primary,purple,rounded,shrub,small,sparsely,spherical,stellate-pubescent,stem,style,surface,tertiary,tree,unarmed,upper,vein,venation,visible,weakly,wide,yellow,young	-1,-1.5,-15,-3.5,-7,.5,/2,/5,0,0-10,0.05-0.2,0.1-0.2,0.15,0.2,0.2-0.3,0.2-0.7,0.3,0.5,0.8-1.5,1-3,1-4,1.5-2,1.5-2.5,1/,1/4-2/3,1/5,10-30,2-4,2-5,2-8,2.5-8,3.5-4.5,5-10,5-merous,6-9,7-12,7-14,7-8,7-9,abaxially,acuminat,alyx,andromonoecious,apar,apart,apically,bark,blade,brow,concolorous,connivent,curved,distal,distance,drying,eed,elliptic,elongating,equal,extending,flattened,flower,free,fruiting,glabrous,hermaphrodite,heterostylous,less,lobing,lon,long-styled,longer,lowermost,mature,midpoint,moderately,multangulate,narrow-deltate,nflorescence,obtuse,older,one,open,orolla,oung,pendulous,pericarp,plurifoliat,poricidal,porrect,portion,prickl,prickly,ray,reddish,reduced,reflexed,ruit,scar,secondary,sessile,short-styled,side,smooth,sometimes,spaced,spreading,stalk,stalked,staminat,stellate,stout,tamen,tapering,terete,time,tip,trichome,tube,unit,variously,vary,way,woody,ympodial	5.5,arrangement,branching,characteristic,colour,corolla,false,form,growth,height,history,inflorescence,life,na,ovary,pseudostipule,rachi,seed,shape,staman,texture
44	wfo-0001026352	invalid_json	209	111	84	125	27	0.402	.3,.5,0.5,0.5-0.8,0.5-1,0.5-3,0.7-2,1-2-celled,1.2-1.7,1.5,10+,3-15,4-4.5,5-6,7-9,?,acuminate,acute,anther,apex,base,berry,blue,branching,broadly,calyx,chartaceous,cm,cordate,corolla,deltate,densely,diameter,ellipsoid,entire,filament,flattened,glabrous,globose,green,growth,immature,impressed,inflorescence,leafy,length,lobe,long,many,margin,membranous,mm,narrowly,outline,ovate,pair,pedicel,peduncle,per,petiole,pink,primary,pubescent,rachi,reniform,shallowly,shoot,short,simple,stem,style,surface,terminal,time,trichome,truncate,unspecified,vein,vine,violet,weak,white,woody,yellowish	0.5-1.5,0.6-,0.9-1,1-,1-1.5,1-10,1.5-2,1.5-4.6,12-60,2,2-3-celled,3.5-9,5-merou,6-7,<,abaxially,adaxiall,ag,almost,alyx,angle,anthesi,antrorsely,apart,apparently,appearance,arising,articulated,articulation,axi,bark,basal,bending,branch,brown,capitate-truncate,cell,conical,curved,deciduous,denser,discolorous,eaf,eed,evenly,eventually,expanded,exserted,few-celled,flower,free,fruiting,giving,greenish,half,heigh,herbarium,ilament,inflorescenc,irregularly,junction,lamina,large,largest,leave,leaving,lengthening,like,lobed,lower,mature,minutely,near,nearly,new,nflorescence,older,orolla,pale,papillate,papillo,peg,perfect,pericarp,plurifoliat,point,pore,poricidal,portion,principal,reflexed,rest,revolute,right,ruit,scar,seen,shiny,sleeve,slit,small,spaced,sparser,specimen,spreadin,spreading,stellate,stigma,straw-colored,strongly,tem,thin,third,tip,tub,tube,tuberculate,ud,uniseriate,unit,upper,vary,wide,widest,ympodial	'','pale,[,],``,abaxial,adaxial,arrangement,characteristic,colour,form,fruit,height,leaf,midvein,na,ovary,plant,pseudostipule,seed,shape,staman,texture,unarmed,value,{,}
45	wfo-0001026352	success	214	114	92	122	22	0.43	.3,.5,0.5,0.5-0.8,0.5-1,0.5-3,0.7-2,1-2-celled,1.2-1.7,1.5,10+,3-15,4-4.5,5-6,7-9,?,acuminate,acute,anther,apex,base,berry,blue,branching,broadly,brown,calyx,chartaceous,cm,cordate,corolla,deltate,densely,diameter,ellipsoid,entire,evenly,filament,flattened-reniform,form,glabrous,globose,green,greenish,growth,immature,impressed,inflorescence,leaf,leafy,length,lobe,long,many,margin,membranous,mm,narrowly,outline,ovate,pair,pale,pedicel,peduncle,per,pericarp,petiole,pink,primary,pubescent,rachi,shallowly,shiny,shoot,short,simple,stem,style,surface,terminal,thin,time,trichome,truncate,unspecified,vein,vine,weak,white,woody,x,yellowish	0.5-1.5,0.6-,0.9-1,1-,1-1.5,1-10,1.5-2,1.5-4.6,12-60,2,2-3-celled,3.5-9,5-merou,6-7,<,abaxially,adaxially,ag,almost,alyx,angle,anthesi,antrorsely,apart,apparently,appearance,arising,ark,articulated,articulation,axi,basal,bending,branch,capitate-truncate,cell,conical,connivent,curved,deciduous,denser,discolorous,eaf,eed,eventually,expanded,exserted,few-celled,flower,free,fruiting,geminat,giving,half,heigh,herbarium,ilament,inflorescenc,irregularly,junction,lamina,large,largest,leaving,lengthening,like,lobed,lower,mature,minutely,near,nearly,new,nflorescence,older,orolla,papillate,papillo,peg,perfect,plurifoliate,point,pore,poricidal,portion,principal,reflexed,rest,revolute,right,ruit,scar,seen,sleeve,slit,small,spaced,sparser,speciman,specimen,spreadin,spreading,stellate,stigma,straw-colored,strongly,tem,third,tip,tub,tube,tuberculate,twining,ud,uniseriate,unit,upper,vary,violet,widest,yellow,ympodial	abaxial,adaxial,arrangement,characteristic,colour,fruit,height,history,life,midvein,na,ovary,perennial,plant,pseudostipule,seed,shape,staman,tertiary,texture,unarmed,venation
46	wfo-0001026379	invalid_json	219	131	109	110	22	0.498	-4.5,0.2-0.4,0.7-1,0.7-2.5,0.8-1.2,0.9-1.2,1-1.7,1-10,1-2,1.3-2.1,1.5-2.3,1.8-2.6,1.9-3.4,1/2,13,2-7,2.6-3.7,2/3,4.1-7,5.3-10.2,50-450,8-13,8-15,8.3-10,abaxially,acute,adaxially,along,anther,apart,apex,articulated,attenuate,bark,basal,base,branch,branched,brown,calyx,closely,cm,conical,corolla,dark,dendritic-echinoid,densely,diameter,dried,echinoid,echinoid-pubescent,ellipsoid,entire,filament,finely,flower,fruit,globose,granular,gray-brown,grayish,growth,hair,leaf,length,lobe,long-attenuate,many,margin,minutely,mm,multangulate,multangulate-pubescent,nearly,obovate,ovate,pale,pedicel,peduncle,persistently,petiole,pitted,plant,porrect-stellate,rachi,reniform,rich,scabrous,semi-ovate,shrub,simple,small,spaced,stellate-,stellate-tomentose,stelliform,stem,stigma,style,terete,time,tomentose-pubescent,tree,upper,velutinous-pubescent,violet,whitish,x,young	0.2-0.38,1-3.7,1.7-4.9,1.8-3.2,1.8-5,2-2.8,2.4-5.1,2.9-4,3-11,3/4,4-5,6-10.6,8-29,9-14,accrescent,adaxiall,ag,anthesi,apparently,around,axillary,ba,berry,blade,blunt-tipped,capitat,chartaceous,completely,covering,cylindrical,directed,distal,distally,eaf,echinoi,edge,eed,enveloping,evident,farinose,few-rayed,fleshy,free,fruiting,glabrous,hig,included,inserted,lacking,large,lateral,lengthening,line,lobed,long,lower,m.,main,mature,midrib,minute,mostly,multangulat,nflorescence,oblong,obtuse,often,older,orolla,ovate-lanceolate,partly,perfect,plurifoliate,pore,poricidal,present,pubescen,rather,recent,ruit,runk,scattered,sessile,short-stalked,side,size,slit,sometimes,somewhat,sparse,stellate,stellate-pubescent,suture,tamen,testa,thin,tip,translucent,tube,ud,uneven,unit,usually,vary,vein,vestigial,way,whitish-brown,yellow,ympodial	'',[,],``,arrangement,bud,capitate,characteristic,colour,form,height,inflorescence,ovary,pubescent,seed,shape,staman,surface,texture,value,{,}
47	wfo-0001026400	invalid_json	187	128	104	83	24	0.556	0.2-0.8,0.4-1,0.5-1.2,1-10,1-2,1.7-2.2,10-18,12-27,3.4-4.8,30-55,4-7,5-7,6.5-20,8-12,9-13,abaxially,acuminate,acute,adaxially,anther,apart,articulated,asymmetric,attenuate,axillary,base,basiscopic,berry,blue,brownish,bud,cell,cm,condition,coriaceous,corolla,covering,dark,deep,diameter,distal,drying,elliptic,filament,finely,flower,forked,fresh,fruit,generally,glabrescent,glabrous,globose,green,green-white,greenish,hair,hair-like,half,herb,high,lateral,leaf,light,lilac,linear,lobe,long,make,mm,moderately,mucilaginous,odd-pinnate,ovoid,pedicel,peduncle,petiole,plant,puberulent,pubescent,purple,ripe,rounded,seed,sessile,short,side,simple,spaced,stripe,style,subtending,terminal,testal,thick,throughout,tip,tissue,typically,usually,wall,wet,white,whitish	0.5-1,0.7-1.1,1.3-2.6,10-28,13-30,2-6,2-8,2.4-5.9,3-6,3.5-5.9,5-merou,6-13,6-15,acumen,adaxiall,ag,alyx,apex,apparently,axe,blade,capitat,clavate,connivent,decreasing,decurrent,digestion,dorsally,eaf,edge,eed,enzyme,erec,exceeding,flat,folded,geminat,glabrou,gree,hal,homostylous,honeycomb-shaped,interjected,lanceolate,leaflet,lengthening,living,lower,nflorescence,orbicular,orolla,ovate,pair,pentagonal,perfect,petiolulate,plurifoliate,pore,poricidal,removed,ruit,semi-stellate,seudostipule,size,slightly,slit,specimen,stamen,stigma,straight,subequal,tall,tamen,tem,toward,tri-,tube,unit,unwinged,vary,x,yellow,ympodial	'',2,[,``,arrangement,calyx,characteristic,colour,form,growth,height,inflorescence,length,margin,ovary,pseudostipule,shape,staman,stem,surface,texture,value,{,}
48	wfo-0001026406	success	219	139	116	103	23	0.53	.2,.5,0-3,0-30,0-5,0.4-0.9,0.5-1.5,00-200,1,1-2,1.8-2.4,1/3,1/4,12-19,2-2.7,2-3,2-6,2.5-8,2.9-3.2,3-10.5,3.2-3.8,30-60,5-25,5-6,5-8,6-15,6.5-7,7-10,abaxial,abaxially,acute,adaxial,adaxially,anther,apex,apparently,articulated,base,berry,branched,calyx,cm,cordate,cream,dark,deltate,densely,diameter,dirty-whitish,erect,filament,flattened-reniform,flower,foliaceous,fruit,glabrous,green,herb,infructescence,lateral,leaf,length,lobe,lobed,long,long-styled,lower,margin,marking,maturity,mauve,midvein,mm,moderately,oblong,obtuse,one,open,orange-brown,ovate,pair,pale,pedicel,peduncle,pendent,per,pericarp,petiole,plant,prickle,prickly,primary,purple,red-brown,short-styled,shrub,smooth,sometimes,spherical,stellate-pubescent,stem,style,surface,terminal,tertiary,time,unit,upper,vein,velvety,venation,visible,white,wide,yellow,young	-1,0,0.3,0.3-0.5,0.3-0.7,0.4-0.8,0.5,0.5-2.5,0.8,1.3-1.5,1.5-2,1.5-5,1/,1/4-1/2,1/4-1/3,10-30,20-60,3-4,5,5-50,5-7,5-merous,6-12,7-8,7-9,9-15,alyx,ame,andromonoecious,apar,apart,apically,bark,blade,broad-deltate,c.,chartaceous,conical,connivent,curved,discolorous,distal,distance,drying,eaf,eed,elongated,elongating,equal,extending,flattened,free,fruiting,fully,gently,hermaphrodite,heterostylous,least,lon,longer,lowermost,mature,midpoint,nflorescence,older,opening,orolla,oung,pendulous,plurifoliat,poricidal,porrect,portion,prickl,ray,reflexed,rounded,ruit,scar,sessile,side,spaced,sparsely,spreading,stalk,stalked,staminat,stellate,stout,straight,tamen,tapering,terete,tip,trichome,tube,variously,vary,way,weakly,woody,yellow-brow,ympodial	arrangement,branching,characteristic,colour,corolla,form,growth,height,history,inflorescence,life,na,ovary,perennial,plurifoliate,pseudostipule,rachi,seed,shape,staman,sympodial,texture,unarmed
49	wfo-0001026407	success	221	118	92	129	26	0.416	.5,0.5-0.6,0.5-2,1.2-1.5,1.5-1.7,1.5-2,2-2.5,2.5-3,20-30,3.5,4-5,5,7-10,7-8,acute,anther,apex,appearing,base,becoming,berry,black,branched,brown,brownish,calyx,chartaceous,cm,corolla,deep,deltate,dense,densely,diameter,elliptic,entire,evenly,filament,fleshy,glabrous,globose,golden,growth,inflorescence,internodal,lateral,lax,lobe,many,margin,markedly,membranous,midvein,minutely,mm,narrowly,oblique,occasionally,pair,pale,papillate,pedicel,peduncle,per,petiole,pitted,primary,pubescence,pubescent,purple,purplish,reddish,revolute,shiny,short,shrub,simple,slightly,sparsely,stem,stout,style,surface,terminal,time,truncate,vein,vine,violet,woody,x,yellow	+,-11,-6,/3,0.5,0.5-1,0.9-3,1,1-1.2,1-10,1.3,1.5-7,20-40,3.5-5.5,5-10,5-7,5-merou,abaxially,adaxially,ag,aid,along,always,alyx,anthesi,apart,area,ark,around,articulated,axi,basal,beneath,berr,blunt,branch,broadly,capitate,cell,clear,climbin,congested,conical,connivent,dendritic,denser,discolorous,eaf,eed,ellipsoid,erect,exserted,flattened-reniform,flower,free,fruiting,geminat,glabrescen,glabrou,golden-pubescent,ilament,interpetalar,irregularly,lamina,leafy,leaving,lengthening,like,lobed,long,loosely,lower,mixture,near,new,nflorescence,numerous,obscured,often,older,open,orolla,outline,paler,papillat,pedice,peg,pentagonal,perfect,pericarp,persistent,planar,plurifoliate,pore,poricidal,portion,pubescenc,ripe,ruit,scar,sinus,sleeve,slit,small,spaced,sparser,spreading,stellate,stiff,stigma,strongly,tangled,tem,testal,thin,tip,transition,trichome,tube,twining,ud,undulate,unit,upper,usually,vary,way,weak,ympodial	abaxial,adaxial,arrangement,branching,characteristic,colour,form,fruit,height,history,leaf,length,life,na,ovary,perennial,plant,pseudostipule,rachi,seed,shape,staman,tertiary,texture,unarmed,venation
50	wfo-0001026424	success	138	89	51	87	38	0.37	0.75-1.5,1-1.5,1.5-2,10,12-60,15,3-4,acuminate,acute,apex,base,bluntly,blush-violet,broadly,calyx,cell,cm,conspicuous,corolla,cuneate,cyme,distinct,elliptic,facetted,flower,glabrous,lacking,larger,leaf,lobe,lobed,midvein,mm,oblique,obovate,pedicel,peduncle,petiole,pinnatisect,rachi,rarely,rounded,scorpioid,shrub,simple,stem,stone,triangular,unit,unwinged,usually	-25,-3.5,-4,1,1-,1-10,1-2,10-15,15-30,2,3-11,637/1,8-,acuman,acumen,age,angular,anthesi,aspect,axil,ba,becoming,blunt,broad,campanulate,clonal,close,common,cut,dia,downard,eaf,ellipsoid,erect,exceeding,except,exerted,facing,floral,fork,forked,general,glandular,gree,growing,hair,interacuminal,lanceolate,lanceolate-elliptic,lasting,lavender,line,lon,long,lower,minute,nflorescence,often,part,pedicellate,plurifoliat,point,raised,rh,rotate-stellate,second,several,shallowly,short,sinus,slightly,soft-wooded,soon,straggly,time,tip,tissue,toward,tub,ud,violet,within,woody,x,year,ympodial,young	1-4,abaxial,adaxial,anther,arrangement,branching,characteristic,colour,diameter,filament,form,fruit,green,growth,height,history,inflorescence,length,life,margin,na,ovary,perennial,plant,plurifoliate,primary,pseudostipule,seed,shape,staman,style,surface,sympodial,tertiary,texture,unarmed,vein,venation
51	wfo-0001026440	success	181	129	98	83	31	0.541	0-15,1-5,1.1-1.4,1.1-1.5,1.5-2.1,1.9-3.7,2-2.8,2-4,2.9-4.4,3-5,3-7,3-8,7-14,9,abaxially,acute,adaxially,along,anther,apex,articulated,base,berry,bract-like,branched,broadly,brown,calyx,closely,cm,conical,corolla,dendritic-echinoid,diameter,dichotomy,echinoid,elliptic,entire,filament,first,fleshy,flower,globose,granular,green,greenish-yellow,hair,leaf,length,lobe,long-attenuate,many,margin,minutely,mm,multangulate,multangulate-pubescent,nearly,obovate,obtuse,openly,ovate,pair,pale,pedicel,peduncle,persistently,petiole,pitted,plurifoliate,porrect-stellate,reniform,ripe,scabrous,semi-ovate,sessile,short-acuminate,short-stalked,shrub,simple,small,sometimes,spaced,sparse,stellate-pubescent,stem,style,terete,testa,thick,time,tomentose,tomentose-pubescent,tree,turning,white,x,yellow	1.3-1.7,1.8-4.5,1/2,1/2-2/3,14-30,3.9-6.5,3/4,4-12,5-7,accrescent,adaxiall,ag,always,anthesi,apparently,appressed,axillary,ba,bark,basal,blade,blunt-tipped,branch,branche,capitat,chartaceous,dense,developed,directed,distal,distally,eaf,echinoi,eed,free,fruiting,high,included,inserted,large,lengthening,lobed,long,lower,m.,minute,mostly,multangulat,nflorescence,oblong,obovoid-oblong,obscure,often,older,orolla,perfect,pore,poricidal,pubescen,rather,ruit,runk,size,slit,somewhat,stellate,stigma,suture,tamen,thin,tip,tomentum,translucent,truncate,tube,ud,uneven,unit,usually,vary,way,ympodial,young	abaxial,adaxial,arrangement,branching,characteristic,colour,form,fruit,greyish,growth,height,hirsute,history,inflorescence,life,midvein,na,ovary,plant,primary,pseudostipule,pubescent,seed,shape,staman,surface,tertiary,texture,unarmed,vein,venation
52	wfo-0001026441	success	197	105	74	123	31	0.376	0.3-0.7,1-2,10,15-20,2-2.5,2-8,4-8,4.5-6.5,5,7-8,9-14,acuminate,anther,apex,articulated,attenuate,base,berry,brownish,cell,chartaceous,cm,condition,conical,corolla,covering,diameter,distal,drying,elliptic-lanceolate,filament,fresh,fruit,glabrous,green,greenish,hair,hair-like,herb,lateral,leaf,light,like,lobe,long,margin,middle,minute,mm,mottled,obtuse,odd-pinnate,ovate,ovoid,pale,pedicel,peduncle,petiole,plant,pubescent,purple,ripe,rounded,seed,slightly,sparsely,stem,style,testal,thick,usually,violet,wall,whitish	.5,0-2,0.4-3,0.5-1.5,0.8,1-1.5,1-10,1.5-2,1.5-2.5,10-14,2-5.5,3-5,4-6,4-8.5,5-10.5,5-merou,6-15,7-20,abaxially,absent,acumen,adaxially,ag,alyx,apart,apparently,axe,axillary,blade,bud,capitat,ciliate,connivent,decreasing,digestion,dorsally,eaf,edge,eed,end,enzyme,equal,erec,especially,exceeding,flat,flower,folded,forked,fourt,geminat,generally,glabrou,gradually,green-white,half,homostylous,honeycomb-shaped,interjected,internal,lanceolate,larger,leaflet,lengthening,living,lower,make,minutely,mucilaginous,narrow,nflorescence,one,orbicular,orolla,pair,perfect,petiolule,placed,plurifoliate,pore,poricidal,puberulent,removed,rotate,ruit,secondary,semierect,seudostipule,short,size,slit,spaced,specimen,stamen,star,ste,stigma,stolo,straight,subequal,subsessile,subtending,symmetrical,tall,tamen,tem,terminal,throughout,tip,toward,tri-,tube,tuber,typically,unit,vary,wet,white,wide,wing,x,yellow,ympodial	2,abaxial,adaxial,arrangement,branching,calyx,characteristic,colour,form,fourth,growth,height,history,inflorescence,length,life,midvein,na,ovary,perennial,primary,pseudostipule,rachi,shape,staman,surface,tertiary,texture,unarmed,vein,venation
53	wfo-0001026460	success	131	85	51	80	34	0.389	.5,0.5-1.5,1-1.5,1.5-2,2.5-3,4.5-5,6-7,7-9,8-10,acute-acuminate,anther,apex,base,brown,calyx,cm,completely,corolla,dark,deltate,elliptic,erect,filament,filiform,glabrous,globose,green,greenish,inflorescence,leaf,lobe,long-exserted,membraneous,minutely,mm,ovary,ovoid-reniform,pair,pale,pedicel,pitted,shrub,simple,stem,style,subshrub,surface,vein,white,x,yellow	.1,1/2,10-15,13.5-21,2-2.5,5,513,6-9,abaxially,acut,adaxially,anthesi,axi,becoming,berry,branched,capitate,closely,conical,deflexed,dia,distal,do,drying,eaf,edicel,eed,fide,floccose,flower,free,frui,fruiting,inflorescenc,internodal,less,like,lobed,long,lower,major,middle,nearly,nflorescence,often,older,opposite,papillo,papillose,pore,poricidal,portion,puberulent,reddish,reddish-brow,reflexed,ruit,santo,scar,shaped,slightly,somewhat,soon,spaced,stigma,tall,tapering,tear-drop,tiny,tip,trichome,tub,tube,ud,unifoliat,unit,widest,woody,ympodial,young	abaxial,acute,adaxial,arrangement,branching,characteristic,colour,diameter,form,fruit,growth,height,history,length,life,margin,midvein,na,peduncle,perennial,petiole,plant,primary,pseudostipule,rachi,reddish-brown,seed,shape,staman,tertiary,texture,unarmed,unifoliate,venation
54	wfo-0001026489	success	153	90	60	93	30	0.392	0.05-0.1,0.5-1,0.5-2,0.8-1.2,0.8-1.3,1-1.5,1.5-5,2-3,2-4,2-5,2-8-flowered,2.5-4,5-6,8-13,acute,anther,apex,base,beneath,berry,broadly,brown,calyx,cm,corolla,dark,deltoid,elliptic,filament,flattened-reniform,geminat,glabrous,globose,green,leaf,lobe,long,margin,middle,minutely,mm,ovary,pair,parallel,pedicel,petiole,pitted,pubescent,shiny,shrub,simple,stem,straight,strongly,style,surface,vein,white,widest,x	.3,0.25-0.5,0.5,0.5-0.75,0.6-1.4,0.8-3.7,1.3-3,2.5-13,2/3,along,anthesi,appearing,area,axil,ba,bark,branched,closely,cup-shaped,deflexed,densely,dia,differing,difoliate,dry,eaf,edicel,eed,erect,exserted,extending,flattened,fleshy,free,fruiting,gra,incrassate,lamina,later,lateral,lobed,lon,lower,main,major,minor,nflorescence,occasionally,often,older,one,opposite,overlappin,paler,papillo,papillose,perpendicular,planar,pore,poricidal,portion,prominent,red-papillose,rhachi,ruit,scar,shaped,size,slender,somewhat,soon,spaced,specimen,stigma,tall,tapering,tear-drop,terminal,thickened,tip,trichome,tub,tube,ud,uniseriate,unit,usually,way,whitish,widened,woody,ympodial,young	abaxial,adaxial,arrangement,branching,characteristic,colour,diameter,form,fruit,growth,height,history,inflorescence,length,life,midvein,na,peduncle,perennial,plant,primary,pseudostipule,rachi,seed,shape,staman,tertiary,texture,unarmed,venation
55	wfo-0001026490	success	272	156	113	159	43	0.415	1.5,3,7-pinnate,abaxially,acute,adaxially,along,anther,apex,around,axillary,base,branched,brown,calyx,chartaceous,cm,corolla,covered,crisped,cylindrical,darker,densely,diameter,ellipsoidal,elliptic,entire,extra-axillary,filament,flattened,flower,fruit,glabrous,green,immature,inflorescence,irregularly,lacking,leaf,length,lenticular,light,lobe,long,lower,main,margin,mature,medium,middle,midvein,mm,moderately,mottled,near,nearly,oblique,obliquely,oblong,obtuse,obtusely,orange,ovate,ovate-lanceolate,papillose,part,pedicel,peduncle,petiole,pointed,pseudostipule,pubescence,pubescent,punctate,rachi,radial,reniform,revolute,rounded,sand,seed,shape,shoot,short,simple,slightly,smooth,sometimes,sparsely,spur,stem,striation,striping,style,surface,tawny,teardrop-shaped,terminal,thickened,tip,transparent,trichome,truncate,vine,violet,white,wide,wing,woody,yellow,yellowish-tan,Â½,Ã	.5,0.1â0.2,0.1â2.5,0.2â1,0.2â1.5,0.3â3.5,0.4â0.8,0.5â1,0.5â1.5,0.5â3.5,0.5â8,0.7â3,0.8â1.5,0.8â12,1.2â8,1.5â2,1.5â3.5,1.5â5,1.8â2.2,1.9,10â20,1â1.2,1â15,1â2.5,1â3,1â8,2,2.5â3.5,2â2.5,2â4,2â6,2â8,3â4.2,3â4.5,3â5,3â5-pinnate,3â8,4.6,4â4.5,4â5,5-merous,5â7,6,7,7â15,=,[,],absent,accrescent,acuminate,ag,alyx,anthesi,apart,apical,apicall,apparently,articulated,axe,ba,becoming,blade,bract,bracteate,broadly,capitat,cauline,ciliate,climbing,commonly,completely,connivent,contiguously,cordate,decreasing,directed,distal,distally,eaf,eed,eglandular,equal,exceeding,expanded,flat,free,fruiting,fused,geminat,ground,incurved,interjected,large,lateral,latrorse-introrse,leaflet,lobed,longitudinal,lowermost,lunate,markedly,match,mean,mean=,minute,multicellular,nflorescence,node,obliqu,oblon,occasionally,one,opening,orolla,pair,pentagonal,per,perfec,perfect,petiolule,plurifoliate,pore,present,pubescen,pur,reflexed,resulting,rooting,ruit,seudostipule,shorter,similar,size,slender,slit,smaller,somewhat,spaced,stamen,stigma,strongly,tamen,tem,toward,trailing,trichomessympodial,tube,typically,unbranched,undulate,unit,vary,vegetation,youn,â4,â4.5,â8,â9.5	0.1-2.5,0.2-1,0.5-1,0.5-1.5,0.8-1.5,1-3,1.5-2,1.5-3.5,1.8-2.2,10-20,2-2.5,2-4,2-6,2.5-3.5,3-4.2,3-4.5,4-5,4.5,5-7,7-15,abaxial,adaxial,arrangement,branching,characteristic,colour,form,growth,height,history,life,na,ovary,perennial,plant,primary,staman,tertiary,texture,unarmed,vein,venation,young
56	wfo-0001026491	success	165	105	72	93	33	0.436	.5,1,1-2,1.5-2,1.5-2.5,1.7,2-4,2.5-3.5,3,3-pinnate,5-6,5-8,abaxially,acuminate,acute,adaxially,anther,apex,articulated,averaging,base,branched,branching,broadly,cellular-papillose,cm,cuneate,deep,deltoid,diameter,elliptic-lanceolate,entire,filament,globose,green,highly,inflorescence,lanceolate,leaf,less,light,lobe,margin,middle,minutely,mm,obtuse,often,ovate,ovate-elliptic,ovoid,pale,pedicel,peduncle,petiole,pubescent,purple,rachi,rounded,shortly,shrub,simple,slender,spotted,strigose,subacute,suborbicular-ovate,surface,tawny,tip,white,whitish	1.5-3.5,10-50,1977,2-3,2-celled,5-merou,6-8,7-8,abaxiall,absent,alyx,anderson,apparently,appressed,axe,ba,bayonet,bent,berry,blade,bract,capitat,cellular-pilose,central,connivent,conspicuously,crinkly,deciduous,densely,directed,distall,eaf,eed,equal,first,flower,geminat,glistening,greatly,growing,hair,homostylous,interjected,lateral,leaflet,long,lower,lunulat,mean,near,nflorescence,oblong-elliptic,orolla,perfect,pilose,plurifoliate,point,pore,poricidal,porrect-incurved,present,rarely,readily,reduced,rotate-pentagonal,rotate-substellate,row,ruit,scandent,seudostipule,sharp,similar,small,stigma,straight,strigo,strong,strongly,tal,tamen,tem,terminal,tightly,tube,tyle,uniseriate,unit,upright,usually,ventral,x,yellow,ympodial	abaxial,adaxial,arrangement,calyx,characteristic,colour,corolla,distally,form,fruit,growth,height,history,length,life,lunulate,midvein,na,ovary,perennial,plant,primary,pseudostipule,seed,shape,staman,stem,style,tertiary,texture,unarmed,vein,venation
57	wfo-0001026501	success	195	101	76	119	25	0.39	.5,.6,0,0-1,0.27-0.7,0.5-0.9,0.5-1,0.9-2.2,1-2,1/4,2.5-4,2.8-3,3-4,3.5-4,?,acute,anther,apex,apically,articulated,base,berry,branched,brown,brown-green,calyx,cm,cuneate,deltate,densely,diameter,dull,elliptic,entire,erect,filament,fruit,glabrous,gray,green,leaf,length,light,lobe,margin,mauve,mm,moderately,orange-brown,orbicular,ovate,pair,pale,pedicel,peduncle,per,petiole,primary,rounded,scandent,shoot,short,shrub,simple,spherical,stellate-pubescent,stem,style,surface,terminal,unarmed,upper,vein,white,yellow,yellow-green	-1.7,-3,.1,.35,.7,/3,0-2,0.05-0.3,0.1,0.2-1.8,0.5,0.5-0.6,0.6-1,0.6-1.1,0.6-2,1,1-2.5,1.8-2.2,1/2-2/3,1/6-1/2,2-10,3-5,3-9,4-5,4-7,5-merous,6-9,7-9,abaxially,acicular,almost,alyx,apar,apart,apparently,bark,becoming,blade,borne,chartaceous,color,concolorous,curved,discolorous,drying,eaf,eed,elongated,elongating,equal,eye,filiform,filiform-acuminat,flattened,flattened-reniform,flower,free,fruiting,glabrou,infructescence,known,lobed,long,longer,lower,mature,midpoint,naked,nflorescence,often,older,one,open,orolla,oung,pendulous,perfec,pericarp,plurifoliat,poricidal,porrect,portion,prickl,prickle,prickly,ray,reddish,ruit,scar,sessile,shorter,slender,small,smooth,sometimes,somewhat,spaced,sparsely,spreading,stalk,stalked,stellate,straight,subsessile,tamen,tapering,terete,time,tip,trichome,tube,unarme,unit,variously,vary,visible,way,wide,ympodial	abaxial,adaxial,arrangement,branching,characteristic,colour,corolla,filiform-acuminate,form,growth,height,history,inflorescence,life,midvein,na,ovary,plant,pseudostipule,rachi,seed,shape,staman,texture,true
58	wfo-0001026513	success	138	96	67	71	29	0.486	.25,.3,0.8-2,1-1.5,1-3,3-5,3-6-flowered,4-5,6-8,7-9,acute,anther,apex,apiculate,base,berry,broadly,calyx,cm,corolla,decurrent,deflexed,deltoid,dia,elliptic,except,filament,flower,fruit,glabrous,globose,green,immature,known,lanceolate,leaf,lobe,long,long-styled,longer,mature,minute,minutely,mm,obscure,older,opposite,ovary,pair,pale,pedicel,petiole,plant,short-styled,shrub,simple,slender,small,stem,straight,style,surface,tip,treelet,vein,venation,white	.1,.75,/3,2-2.2,2-5,8-16,anthesi,area,ba,bark,caly,closely,completely,darkish,delicate,differentiated,dry,eaf,edicel,eed,erect,exserted,free,fruiting,gre,hirsute,lateral,leave,less,live,lobed,lower,main,middle,much,nflorescence,overlappin,papillose,pore,poricidal,portion,prominent,raised,reflexed,rest,ruit,scar,shaped,shiny,somewhat,soon,spaced,specimen,stigma,styl,tall,tear-drop,trichome,tube,ud,undersurface,unifoliat,uniseriate,unit,way,wide,widest,woody,x,ympodial,young	abaxial,adaxial,alternate,arrangement,branching,characteristic,colour,diameter,form,growth,height,history,inflorescence,length,life,margin,midvein,na,peduncle,perennial,primary,pseudostipule,rachi,seed,shape,staman,tertiary,texture,unarmed
59	wfo-0001026529	success	219	150	122	97	28	0.557	0.3-1,0.5-4.5,1,1-10,1-2,1-3,1.1-2.5,1.5-2.5,10,11-14,12-22,2,3-5,3-9.5,4-8,5-15,5-17,5-9,abaxially,acumen,acuminate,adaxially,anther,apart,apex,articulated,attenuate,axillary,base,berry,blue,brownish,bud,cell,chartaceous,cm,condition,cordate,corolla,covering,creamy,dark,deep,densely,diameter,distal,dot,drying,faintly,filament,flower,forked,fresh,fruit,generally,glabrous,glandular,globose,greatly,green,green-white,greenish,hair,hair-like,half,herb,lateral,length,light,like,lilac,lobe,long,make,margin,medium,membranous,mm,moderately,mucilaginous,non-glandular,oblique,odd-pinnate,often,ovoid,pedicel,peduncle,petiole,petiolule,plant,pubescent,pure,rarely,ripe,rounded,scattered,seed,shape,short,size,slightly,spaced,stem,style,subsessile,subtending,terminal,testal,thick,throughout,trichome,typically,unwinged,usually,varying,wall,wet,white,whitish,wide,wing,yellowish	0-25,1-4.5,1.5-4,10-28,120-210,2-5,2-7.5,20-60,3-12,3-6,5-merou,50-70,6-20,600-950,?,acute,ag,along,alyx,apparently,axe,blade,broadly,capitat,ciliate,clavate,connivent,digestion,dorsally,eaf,edge,eed,elliptic,enzyme,erec,especially,exceeding,except,flat,folded,geminat,glabrou,gland,gree,hal,head,homostylous,honeycomb-shaped,interjected,lanceolate,leaflet,lengthening,living,longer,lower,lunate,midrib,minutely,narrowly,nflorescence,orbicular,orolla,ovate,pair,pentagonal,perfect,petiolulate,plurifoliate,pore,poricidal,proximal,puberulent,reduced,removed,ruit,sessile,seudostipule,slit,specimen,stamen,ste,stigma,straight,subequal,substellate,tall,tamen,tem,tetralobulate,tip,tri-,tube,unit,vary,x,yellow,ympodial	abaxial,adaxial,arrangement,branching,calyx,characteristic,colour,form,growth,height,history,inflorescence,leaf,life,midvein,na,ovary,perennial,primary,pseudostipule,rachi,staman,surface,tertiary,texture,unarmed,vein,venation
60	wfo-0001026534	success	150	115	81	69	34	0.54	0.5-1,1-2,1-3,1.5-9,10-20,15-50,2-2.5,2-3,2-7,2-8,2.5-15,3-10,3-25,3-4,3-5,3.5-4,4-10,5-6,acuminate,acute,aggregate,apart,apex,apiculate,articulated,auriculate,base,branched,calyx,cell,chartaceous,cm,cordate,cylindrical,darker,deltate,densely,diameter,ellipsoidal,entire,flattened,fleshy,fruit,glabrous,leaving,lobe,long,longitudinal,margin,mm,moderately,obtuse,often,orange,ovate,ovoid,pedicel,pedicellar,peduncle,petiole,pinkish,puberulent,pubescent,purple,rachi,red,remnant,simple,spaced,sparsely,stone,stripe,style,tip,tree,truncate,unbranched,vein,white,x,yellow	-1.5,1-2.5,1.5-6,10-15,10-50,2.5-4,3-,4-foliat,4.5-5,6-35,7-12,7-40,abaxially,absent,adaxially,ape,axe,basal,beyond,blade,bright,connective,connivent,directed,distally,eaf,eed,eglandular,equal,exserted,flower,glandular,hair,lanceolate,lemon-yello,lon,lower,m.,narrowly,nflorescence,nther,orolla,pale,perfect,pore,presen,puberulen,radiu,ruit,shorter,slightly,small,stamen,stellate,stigma,subcoriaceous,tal,tem,thecae,time,tomento,triangular,truncat,tube,ud,unit,vary,wide,ympodial	abaxial,adaxial,anther,arrangement,branching,characteristic,colour,corolla,filament,form,growth,height,history,inflorescence,leaf,length,life,midvein,na,ovary,plant,present,primary,pseudostipule,seed,shape,staman,stem,surface,tertiary,texture,unarmed,venation,ye
61	wfo-0001026535	success	248	142	123	125	19	0.496	.5,0.7-1.5,1,1-2,1-3,1.2-2,1.3,1/2-2/3,1/3,2-3,2-5,2.5,3-5,3.5-4,5-7,7-8,abaxial,abaxially,acute,adaxially,age,almost,along,anther,anthesi,apex,apically,base,becoming,berry,black,brachyblast,branch,branched,branching,brown,calyx,chartaceous,clustered,cm,concolorous,condensed,conical,corolla,cuneate,deltoid,dendritic,dendritic-pubescent,dense,developed,diameter,dilated,discolorous,distributed,dry,drying,elliptic,elongated,entire,evenly,filament,fine,flat,flower,fruit,glabrous,green-brown,known,leaf,length,liana,like,lobe,lobed,long,lower,margin,membranous,midvein,mm,network,obovate,older,orange-brown,ovate,ovoid,pair,partly,pedicel,peduncle,petiole,plant,pointed,primary,prominent,pubescent,rachi,raised,rarely,ridged,rounded,short,shrub,side,sparsely,stem,style,surface,terminal,tertiary,trichome,truncate,unarmed,uneven,vein,venation,violet,visible,weakly,white,x,yellowish,young	.1,.2,.4,.8,0-0.5,0.1-0.2,0.15,0.2,0.2-0.3,0.2-1.5,0.5-1,1-5,1.5-2,1.5-3,3,3-4.5,4-15,5-10,5Â°,absent,accrescent,alternate,alyx,apar,apparently,area,around,articulated,bark,broadly,clavate,clearly,cup,cupular,curved,dark,deeply,delineate,delineated,detaching,developing,divided,domatia,dorsal,eaf,eed,ellipsoi,equal,except,eye,fertilisation,flexuous,forming,free,frui,fruiting,increasing,inside,leave,lengthening,linear,lon,loop,loose,m.,main,marginal,minute,minutely,mostly,much,naked,nflorescence,nther,number,oblong,obscure,orolla,outside,papillo,pendulous,perfec,pericarp,plurifoliat,pore,poricidal,portion,protruding,ray,reaching,ruit,scar,secondary,see,simple,sinus,slender,slightly,smaller,smooth,soon,spaced,spreading,stigma,stump,tearing,terete,thin,tip,tissue,toward,translucent,tube,tufted,two,ud,unevenly,unit,unlignified,vary,wide,widely,wider,ympodial,youngest	1.5,adaxial,arrangement,characteristic,colour,form,growth,height,history,inflorescence,life,na,ovary,perennial,seed,shape,staman,texture,ye
62	wfo-0001026604	success	192	145	115	77	30	0.599	.75,0,0.4-0.6,0.8-0.9,0.8-1,1-1.2,1.2-1.7,1.5-2,1.5-9,10-30,2-2.3,2-2.5,2.3-3.5,3-3.5,3.5-4,4-4.5,5,5-7,50-100,?,acuminate,aid,along,always,anther,apex,articulated,basal,base,berry,branching,brown,calyx,cell,climbing,cm,conical,cordate,corolla,cupped,dark,diameter,distal,distinct,ellipsoid,elongate,entire,filament,flattened,flexuous,flower,fruit,glabrous,globose,growth,leaf-opposed,leaving,liana,lobe,margin,midrib,minute,minutely,mm,narrowly,oblique,occasionally,outline,ovary,ovate,overall,ovoid,pair,pale,pedicel,peduncle,peg,per,pericarp,petiole,pitted,planar,primary,purple,quarter,red,reddish,reniform,ripe,shape,shiny,shrub,simple,sinuate,slender,slightly,stem,style,support,surface,terminal,testal,thin,time,trichome,truncate,tube,twisting,uniseriate,vein,vining,violet,woody,x,Â½	.4,.5,0.1,1.1-1.3,3-5,4.5-7,<,absent,age,anthesi,apart,appearing,articulation,atop,bark,brow,c.,capitate,clearly,comical,cucullate,deflexed,densely,differentiated,drying,due,eaf,eed,expanding,exserted,free,fruiting,inflated,later,lengthening,lobed,lower,mere,new,nflorescence,nodding,older,papillo,papillose,part,particularly,perfect,plurifoliat,poin,point,pore,poricidal,portion,pubescent,receptacle-like,rim,ruit,scar,series,slit,somewhat,spaced,stellate,stigma,stout,strongly,structure,swolle,tip,tub,ud,undulation,unit,upper,way,widely,ympodial	60-100,abaxial,adaxial,arrangement,characteristic,colour,form,green,greyish,hair,height,hirsute,history,inflorescence,leaf,length,life,midvein,na,perennial,plant,pseudostipule,rachi,seed,staman,tertiary,texture,unarmed,venation,white
63	wfo-0001026607	invalid_json	204	143	111	93	32	0.544	0.1-0.3,0.8-3.4,0.8-4.5,1-10,1-2,1-5,1-8,1.5-4,10-30,2-10,2.5-3.8,3-8,4-10,4-6,5,6-10,abaxially,absent,acumen,acute,adaxially,anther,apart,apex,articulated,attenuate,axillary,base,basiscopic,berry,brownish,bud,cell,chartaceous,cm,coarse,condition,corolla,covering,decurrent,deep,diameter,distal,dot,drying,elliptic,filament,finely,flower,forked,fresh,fruit,generally,glabrous,globose,green,green-white,greenish,hair,hair-like,half,herb,high,lateral,leaf,like,lobe,long,make,margin,medium,membranous,minute,mm,moderately,mucilaginous,obtuse,odd-pinnate,often,ovate,ovoid,pedicel,peduncle,petiole,plant,puberulent,pubescent,rachi,rarely,ripe,rounded,scattered,seed,sessile,side,simple,spaced,stem,style,subtending,terminal,testal,thick,throughout,typically,usually,violet,wall,wet,white,whitish	0-3,0-4,0.3-1.8,0.5-5.8,0.8-5,1-3.8,2-2.5,2-3,2.4-5.8,2.7-19,5-merou,5.8-19.8,ag,along,alyx,apparently,axe,blade,capitat,ciliate,clavate,clearly,connivent,decreasing,digestion,dorsally,eaf,edge,eed,enzyme,especially,exceeding,flat,folded,forming,geminat,glabrou,greatly,gree,hal,homostylous,honeycomb,interjected,lanceolate,larger,leaflet,lengthening,living,lower,marked,midrib,minutely,much,nflorescence,orbicular,orolla,pair,pentagonal,perfect,petiolulate,plurifoliate,pore,poricidal,present,removed,rosette,ruit,semierec,seudostipule,shaped,short,size,slit,sometimes,specimen,stamen,ste,stigma,straight,tall,tamen,tem,tip,toward,tri-,tube,unit,unwinged,vary,without,x,yellow,ympodial	'',2,[,``,abaxial,adaxial,arrangement,branching,calyx,characteristic,colour,form,growth,height,inflorescence,length,midvein,na,ovary,primary,pseudostipule,shape,staman,surface,tertiary,texture,unarmed,value,vein,venation,{,}
64	wfo-0001026613	success	159	97	67	92	30	0.421	1-2,2.3-8,2.5-2.8,3-5,4-5,5,5-6,5-7,6-12,6-8,8-18,8.5-9,acuminate,anther,apex,articulated,attenuate,axillary,base,berry,bud,chartaceous,cm,conical,cordate,corolla,densely,diameter,distal,filament,flower,forked,fruit,generally,glabrous,green,hair,half,herb,immature,leaf,like,lobe,long,margin,mature,membranous,middle,minute,mm,mottled,odd-pinnate,pedicel,peduncle,petiole,plant,proximal,pubescent,purple,sparsely,stem,style,subtending,terminal,unknown,unwinged,usually	0.5-1,0.6,1-10,1.5-4,11-19.5,2-7.5,3-10,4.5-8.5,5-merou,5.5-7,6.2-9.5,8.5-10,9.5-13.5,abaxially,absent,acumen,adaxially,ag,along,alyx,apart,apparently,axe,blade,borne,capitat,ciliate,connivent,decreasing,dorsally,eaf,edge,eed,end,erec,especially,flat,folded,geminat,greatly,hal,homostylous,interjected,lanceolate,larger,lateral,leaflet,lengthening,lower,m-1.2,midrib,minutely,nflorescence,orolla,ovate,pair,perfect,petiolule,plurifoliate,pore,poricidal,puberulent,pubescen,rotate-pentagonal,ruit,secondary,semierect,seudostipule,singly,size,slit,spaced,ste,stigma,stolo,subequal,symmetrical,tall,tamen,tem,tip,toward,tri-,tube,tuber,typically,unit,unknow,vary,x,yellow,ympodial	0.6-1.2,abaxial,adaxial,arrangement,branching,calyx,characteristic,colour,form,growth,height,history,inflorescence,length,life,midvein,na,ovary,primary,pseudostipule,rachi,seed,shape,staman,surface,tertiary,texture,unarmed,vein,venation
65	wfo-0001026614	success	200	122	83	117	39	0.415	.8,0.4-0.7,0.5,1-,1.3-1.8,11-15,2.2,2.2-5.5,2.5,3-foliate,4-7,5,acuminate,acute,anther,apex,base,berry,black,brown,calyx,closely,cm,commonly,dark,densely,diameter,dried,entire,erect,evenly,extra-axillary,filament,flattened-reniform,flower,foveolate,fruit,geminate,glabrous,gland-tipped,globose,hair,irregularly,leaf,lobe,lobed,margin,midvein,minute,minutely,mm,mottled,oblique,orange,orange-red,ovate,ovate-lanceolate,pair,pedicel,peduncle,petiole,pubescent,rachi,reflexed,repand,ripe,shallowly,shrub,simple,sometimes,spaced,sparsely,stellate-pubescent,stem,style,surface,unarmed,usually,vein,white,x,yellow,yellowish	0.2,0.2â0.3,0.5â2,1.5â2,15â30,1â2,1â3,1â5,2.5â3,20â25,2â4,2â4-branched,2â6.5,3.2-5.2,3â10,4.5â11,4.5â5.5,5-merou,5.3-8.2,50,6.4-8.4,6â8,7.2-9.8,8â10,9â16,>,abaxially,absent,across,adaxiall,adaxially,alyx,apart,apparently,armed,articulated,axe,ba,blade,blunt-tipped,broad-based,campanulate,capitat,chartaceous,clavate,concentrated,cylindrical,denser,developed,directed,distally,eaf,eed,especially,expanded,fleshy,fruiting,glabrescent,globo,golden,homostylous,internode,interpetalar,lanceolate-attenuate,lateral,less,linear,lon,long,lower,midpoint,nearly,nflorescence,obtuse,often,orolla,ovoid,per,perfect,pore,prickle,pubescence,rarely,ray,rotate-pentagonal,rounded,ruit,scattered,sessile,shin,side,similar,slightly,smaller,somewhat,soon,spreading,stellae,stellate,stigma,tall,tamen,tapering,tem,time,tissu,tissue,tube,ud,unarme,vary,weakly,well,wide,ympodia,young,â5	0.2-0.3,1-2,1-3,1-5,1.5-2,15-30,2-4,2-4-branched,2.5-3,20-25,4.5-5.5,8-10,9-16,abaxial,adaxial,arrangement,branching,characteristic,colour,corolla,form,growth,height,history,inflorescence,length,life,na,ovary,perennial,plant,primary,pseudostipule,seed,shape,staman,tertiary,texture,venation
66	wfo-0001026642	success	193	102	59	134	43	0.306	6,abaxial,along,annual,anther,apex,articulated,base,bipinnate,black,blade,blue,branched,brown,calyx,cm,cylindrical,dark,densely,denser,diameter,elliptic,filament,flattened,fruit,glabrous,globose,green-purple,herb,indumentum,lavender,leaf,length,lilac,lobe,mm,moderately,obtuse,ovate,pale,pedicel,peduncle,perennial,petiole,pinnate,pitted,primary,pubescent,shallowly,sometimes,sparsely,straight,style,subglabrous,surface,time,vein,violet,x	.05,.1,.8,0.1,0.1â0.3,0.2,0.25,0.4,0.4â2.2,0.5,0.5â,0.5â0.7,0.5â1.7,0.5â2.0,0.5â3.5,0.6,0.6â1.0,0.75â1.0,0.75â2.0,0.7â1.6,0.8â1.2,1.0,1.0â2.0,1.2â1.7,1.2â2.0,1.2â3.5,1.2â6.2,1.6â8.0,1.9â3.0,12â30,1â10,1â3,2.0â4.0,2.5â3.5,2.5â4.0,2.8â3.0,3.0â5.1,3â5,4.0â6.0,4â7,5,5.0â7.0,50â100,<,abaxially,acute,adaxiall,adaxially,ag,anthesi,apart,appressed,axe,axillary,ba,borne,cell,chartaceous,circular,clavate,connivent,decreasing,decumbent,divided,eaf,eed,either,equal,erect,fleshy,flower,geminat,glabrescen,gland,glandular,hair,half,lon,long,longitudinal,lower,m.,multicellular,narrow,nflorescence,number,oblong,occasionally,often,opening,orolla,pair,pentagonal,perfect,pinnae,pore,poricidal,present,probably,rapidly,rounded,ruit,secondary,sessile,shoot,side,simple,slit,spaced,stigma,stone,tal,tamen,tem,tip,tube,unicellular,unifoliate,uniseriate,unit,usually,vary,white,wide,wing,woody,yellow,ympodial,â1.2,â11.0,â2.0,â4.5,â6,â7	0.1-0.3,0.4-2.2,0.5-0.7,0.5-2.0,0.5-3.5,0.75-1.0,0.75-2.0,0.8-1.2,1-3,1.2-1.7,1.2-2.0,1.2-3.5,2.0-4.0,2.8-3.0,5.0-7.0,50-100,adaxial,arrangement,branching,characteristic,colour,corolla,form,growth,height,history,inflorescence,life,margin,midvein,na,ovary,plant,pseudostipule,rachi,seed,shape,staman,stem,tertiary,texture,unarmed,venation
67	wfo-0001026651	success	222	143	103	119	40	0.464	-celled,1.8,2.8,3,3-plurifoliate,4,8,abaxially,acuminate,acute,adaxially,anther,antrorse,apex,appressed,arcuate,articulated,attenuate,base,berry,brochidodromous,brownish-green,calyx,cell,chartaceous,ciliate,cm,connivent,cylindrical,cyme,dark,densely,diameter,discolorous,drying,dull,entire,erect,eye,filament,flattened,flower,fruit,geminate,glabrous,globose,green,herb,lanceolate,lateral,leaf,length,light,like,lobe,margin,membranaceous,mm,moderate,moderately,mostly,much-branched,naked,narrowly-elliptic,oblong-ellipsoid,ovate-deltate,ovate-reniform,pedicel,peduncle,pedunculate,per,petiole,plant,pubescence,pubescent,revolute,ripe,rounded,seed,shape,shrub,similar,size,slightly,sometimes,spaced,stellate,stem,straight,style,sub-opposite,surface,terminal,translucent,trichome,unbranched,undulate,vein,venation,visible,white,yellow,Ã	0.2â1.3,0.35â2.6,0.9â3,1,1â2,2.2â10,2â11.5,2â13,2â3,2â3.3,2â4,2â4.5,2â8,3â5,3â7,4â6,4â7.8,5-merou,6â10,6â14,absent,accrescent,adaxiall,along,alyx,anisophyllous,antror,antrorsely,apar,ark,asymmetric,axi,beneath,beyond,branch,broadly,brown,capitat,capitate,circular,cordate,decumbent,decurrent,differing,directed,eaf,eed,elliptic,emarginate,equal,exfoliating,exserted,flexuous,frui,geniculate,glabrescent,glabrou,glandular,growt,hair,head,highly,hilum,hollow,impressed,introrsely,less,long,longitudinal,lower,lying,major,markedly,matte,midrib,minor,multicellular,new,nflorescence,normally,obtuse,older,one,onto,opening,orolla,ovate-lanceolate,parallel,perfect,pore,poricidal,prominent,reduce,region,ruit,secondary,shiny,simple,single-celled,slit,small,smaller,stalk,stamen,stigma,subapical,tall,tamen,tem,turning,uniseriate,unit,upper,usually,vary,wide,woody,ympodial,young	0.9-3,1-2,2-11.5,2-13,2-3,2-3.3,2-4,2-4.5,2-8,2.2-10,3-7,4-6,6-10,6-14,abaxial,adaxial,apart,arrangement,branching,characteristic,colour,corolla,form,growth,height,history,inflorescence,life,midvein,na,ovary,perennial,primary,pseudostipule,rachi,staman,tertiary,texture,unarmed,variation
68	wfo-0001026656	invalid_json	211	127	95	116	32	0.45	0.3-3,1-10,1-2,1-3.8,1.1-8.1,1.5-7,2-6,20-60,4-10,4-8,5-35,9-11,abaxially,acuminate,acute,anther,apex,articulated,attenuate,base,blue,broadly,brownish,cell,chartaceous,cm,condition,corolla,covering,cuneate,dark,densely,diameter,distal,dot,drying,elliptic,especially,filament,fresh,fruit,glabrous,glaucous,globose,green,greenish,hair,hair-like,herb,lanceolate,lateral,light,like,lobe,long,lunate,make,margin,membranous,midvein,mm,moderately,mottled,mucilaginous,narrowly,oblique,odd-pinnate,ovate,ovoid,pedicel,peduncle,petiole,plant,pubescent,purple,rachi,scale-like,scattered,seed,sometimes,somewhat,stem,style,subglabrous,symmetrical,tertiary,testal,thick,tinged,truncate,violet,wall,wet,white,whitish	0-4,0.3-4.2,0.4-6.5,0.7-10.5,0.9-13,1,1-1.8,1-4,1-5,10,2-8,2.5-17,4-13,5,5-18,5-merou,5.5-27,absent,acumen,adaxially,ag,along,alyx,apart,bearing,blade,borne,bud,capitate,ciliate,clavat,connate,connivent,curved,decurrent,digestion,dorsally,eaf,edge,eed,end,enzyme,erec,exceeding,flat,flower,folded,forked,geminat,generally,greatly,green-white,greenish-yellow,half,homostylous,honeycomb-shaped,interjected,larger,leaflet,lengthening,living,lower,middl,minutely,nflorescence,non-glandular,occasionally,often,orolla,pair,pentagonal,petiolulate,petiolule,plurifoliate,pore,poricidal,puberulent,pubescen,ranging,removed,rotate-pentagonal,ruit,seudostipule,short,singly,slightly,slit,spaced,specimen,stamen,star,ste,stigma,stolo,straight,subequal,subtending,tall,tamen,tem,terminal,therefore,throughout,tip,tri-,tube,tuber,typically,unit,unwinged,vary,wide,wing,without,yellow,ympodial	'',2,[,``,abaxial,adaxial,arrangement,branching,calyx,characteristic,colour,form,growth,height,inflorescence,leaf,length,middle,na,ovary,primary,pseudostipule,shape,staman,surface,texture,unarmed,value,vein,venation,{,}
69	wfo-0001026663	success	251	119	92	159	27	0.367	-15,-2.9,0.2-0.6,0.4-2.2,0.9-1.5,1,1-2.5,1-3.2,1-5,1.1,1.1-2.1,1.2-2,1.4-2.6,1.6-2.3,10.3-13.2,12-14,2-12,2.1-2.6,2.9-5,3.8-5.7,31,4.7-25.9,abaxially,acuminate,acute,adaxially,along,anther,apex,attenuate,base,berry,branched,brown,calyx,cm,conical,corolla,dark,diameter,drying,echinoid-pubescent,entire,filament,fleshy,flower,fruit,granular,granular-tomentose,green,greenish-brown,leaf,length,less,lobe,long,many,margin,midrib,midvein,mm,openly,ovate,ovate-lanceolate,pale,pedicel,peduncle,petiole,plurifoliate,pubescent,rachi,rich,scabrous,short,shrub,side,slightly,small,sparsely,stem,style,subglobose,time,tomentose,tomentose-pubescent,tree,unarmed,vein,violet,white,whitish,x	-8,-9.7,.5-2.5,/25-1/15,/3,0-160,0.3-0.8,1.4-3.1,1.9-2.6,1/2,1/3,1/4-1/2,10-26,2.5-3.7,2.8-5.3,2/3,24-45,3-5,3.5-5,4.5-5.7,5-8,5.5-,5.5-8.8,7.5-9,8-17,accrescent,adaxiall,ag,angled,anthesi,apart,apparently,appressed,around,articulated,ascending,axe,axillary,bark,becoming,blade,blunt-tipped,branch,broadly,bud,capitat,chartaceous,closely,completely,constricted,covering,cylindrical,densely,directed,distally,distributed,eaf,echinoi,echinoid,edge,eed,elongated,enveloping,especially,evident,exserted,farinose,flared,free,fruiting,glabrescen,glabrescent,glabrous,globose,grooved,hair,immature,inserted,lanceolate,lateral,lengthening,light,line,lined,lobed,long-stalke,long-stalked,longer,longitudinal,longitudinally,lower,m.,main,matur,minute,multangulate,multangulate-pubescent,nearly,nflorescence,obtuse,occasional,occuring,older,opening,orolla,ovate-lanceolat,perfect,persistent,pore,poricidal,porrect-stellate,present,pseudo-terminal,pubescence,rather,ray,ridged,robust,ruit,runk,sessile,short-stalked,simple,slit,sometimes,somewhat,soon,spaced,stalk,stalked,stamen,stellate,stigma,strongly,subcampanulate,subcoriaceous,subglabrous,suture,tall,tamen,tangled,terete,thick,thin,tip,tomentum,touching,tube,ud,unarme,unit,upper,usually,vary,way,wide,yellow,ympodial,young	5.5-9,abaxial,adaxial,arrangement,branching,characteristic,colour,form,growth,height,history,inflorescence,life,na,ovary,plant,primary,pseudostipule,pseudoterminally,seed,shape,staman,surface,tertiary,texture,venation,ye
70	wfo-0001026686	success	196	118	87	109	31	0.444	0.6-0.9,1-2,1.5-7,1.7-2.5,10-28,2.4-3.6,3-4,4-6,5,5-8,7-9,8-10,8-14,abaxially,acuminate,adaxially,anther,apex,articulated,axillary,base,berry,brownish,bud,cell,chartaceous,cm,condition,conical,corolla,covering,densely,diameter,distal,drying,filament,flower,forked,fresh,fruit,generally,glabrous,green,green-white,greenish,hair,hair-like,half,herb,lateral,leaf,light,like,lobe,long,make,margin,middle,minute,mm,mottled,mucilaginous,obtuse,odd-pinnate,ovoid,pedicel,peduncle,petiole,plant,pubescent,purple,purple-violet,ripe,round,seed,sparsely,style,subtending,terminal,testal,thick,throughout,usually,wall,wet,whitish,x	.4,0.2-0.5,1,1-10,1-2.5,1.2-3.4,1.2-3.6,2-10,2-9,2.5-8,3-5,3.7-8,5-16.5,5-merou,6.5-12.7,8-27,absent,acumen,ag,along,alyx,apart,apparently,axe,blade,borne,capitat,ciliate,connivent,decreasing,digestion,dorsally,eaf,edge,eed,elliptic-lanceolate,end,enzyme,equal,erec,especially,exceeding,flat,folded,geminat,glabrou,gradually,homostylous,honeycomb-shaped,interjected,lanceolate,larger,leaflet,lengthening,living,lower,midrib,minutely,nflorescence,often,orbicular,orolla,ovate,pair,perfect,petiolule,plurifoliate,pore,poricidal,puberulent,pubescen,removed,rotate-stellate,ruit,secondary,semierect,seudostipule,singly,size,slightly,slit,spaced,specimen,stamen,star,ste,stigma,stolo,straight,stripe,subequal,subsessile,symmetrical,tall,tamen,tem,tip,toward,tri-,tube,tuber,typically,unit,vary,white,wide,wing,yellow,ympodial	2,abaxial,adaxial,arrangement,branching,calyx,characteristic,colour,form,growth,height,history,inflorescence,length,life,midvein,na,ovary,primary,pseudostipule,rachi,shape,staman,stem,surface,tertiary,texture,unarmed,vein,venation,Â¼
71	wfo-0001026696	invalid_json	139	115	78	61	37	0.561	0.3-4.5,0.8-7,1,1-1.3,1-4,1.3-2.1,3-17,3-3.5,3-6,3-8.5,4-16,9,acumen,acute,apex,apiculate,articulate,base,branched,broadly,calyx,cell,cm,corolla,covering,cuneate,cyme,decurrent,densely,diameter,dichasial,dichasially,distal,ebracteate,entire,filament,globose,green,green-white,hair-like,herbaceous,honeycomb,lanceolate,lateral,light,linear,lobe,long,make,margin,mm,monochasial,mucilaginous,oblong,obtuse,odd-pinnate,often,ovate,ovoid,pattern,pedicel,peduncle,perennial,petiole,plant,proximal,pubescent,rounded,seed,sinuate,style,testal,thick,throughout,tuber-bearing,wall,white-cream,Â¼	0.9-7.2,1.5-3,2-17,2-3,3-6-foliat,5-35,abaxially,adaxially,apical,apically,connate,dehiscent,digestion,dorsally,eaf,edge,eed,emoval,enzyme,exceeding,flat,flower,folded,forked,generally,globo,half,introrse,light-yello,living,lon,lower,lunat,maturing,nflorescence,nther,orolla,perfect,plan,poricidally,reveal,ruit,seudostipule,short,simple,slit,specimen,stamen,stellate,stigma,straight,tal,tem,throughou,typically,unit,vary,wide,without,yellow,ympodial	'',[,``,abaxial,adaxial,anther,arrangement,branching,characteristic,colour,form,fruit,growth,height,inflorescence,leaf,length,light-yellow,midvein,na,ovary,primary,pseudostipule,rachi,shape,staman,stem,surface,tertiary,texture,unarmed,value,vein,venation,wet,{,}
72	wfo-0001026706	success	232	130	105	127	25	0.453	-3.1,-4.4,0-240,0.2-0.3,0.6-2.2,0.8-1.2,0.8-1.5,0.8-2.8,0.9-2,1-2.2,1-5,1.1-4,1.5-3,10-15,12,2.5-3,2/3-3/4,3-4.6,3.1-3.8,3.6-5.7,4,4.5-5.5,5.3-6.4,8-14,abaxially,acute,adaxially,anther,apart,apex,appearing,articulated,attenuate,base,berry,branched,brown,calyx,chartaceous,closely,cm,corolla,crisped,cuneate,dark,densely,diameter,entire,filament,fleshy,flower,fruit,glabrate,globose,green,herbarium,leaf,length,lobe,lower,many,margin,midrib,mm,obtuse,occasionally,ovate,ovate-elliptic,pale,pedicel,peduncle,petiole,pubescent,rachi,reticulate-punctate,semi-ovate,shrub,side,simple,slightly,small,softly,somewhat,spaced,sparsely,specimen,stem,style,subconical,subglobose,suborbicular,sulcate,surface,time,tomentose-pubescent,translucent,tree,unarmed,vein,velutinous,wavy,white,whitish,x,yellowish-tan	-5.5,-6.1,.5,/14-1/6,0.2-0.5,0.9-1.9,1/2-2/3,14-32,2.2-3.3,2.3-3.8,2.7-4,2.9-6,4.2-12,5-6.5,6-10,6-8,6.1-,7-16,9.8-15.4,accrescent,adaxiall,ag,anthesi,apparently,around,axe,axillary,ba,bark,becoming,blade,blunt-tipped,branch,bud,capitat,completely,coriaceous,covering,cylindrical,dendritic-echinoid,dendritic-multangulate,directed,distally,eaf,edge,eed,enveloping,exserted,farinose,fourth,free,fruiting,furfuraceou,glabrous,golden,grayish,hair,indument,inserted,lackin,lacking,lanceolate,lateral,lengthening,lobed,long,long-stalked,longitudinal,m.,main,matted,minute,mixed,multangulat,multangulate,nearly,nflorescence,oblong,obscured,often,older,orolla,ovate-lanceolate,perfect,persistent,plurifoliate,pore,poricidal,porrect-stellate,pseudo-terminal,pubescence,rather,reddish,ruit,runk,sessile,short-,short-stalked,slit,soon,splitting,stalked,stamen,stellate,stigma,strongly,subcampanulate,suture,tall,tamen,thin-walled,tip,tomentu,touching,transparent,tube,ud,unarme,unevenly,unit,upper,vary,way,wide,yellow,ympodial,young	6.1-15.4,abaxial,adaxial,arrangement,branching,characteristic,colour,form,growth,height,history,inflorescence,life,midvein,na,ovary,plant,primary,pseud-terminal,pseudostipule,seed,shape,staman,texture,ye
73	wfo-0001026707	success	196	131	101	95	30	0.515	-5,.5,0,0.5-1,0.6-0.7,0.7-1,0.7-1.4,0.7-1.5,1-3,1.5-1.8,1.6-2,1/3,2-2.3,2-6,2.5-4,3-4,3-4.5,3-8,4,5-25,8-15,?,acute,anther,apex,apically,apparently,articulated,attenuate,base,berry,branched,broad-deltate,calyx,chartaceous,clustered,cm,color,concolorous,decurrent,diameter,discolorous,drying,entire,erect,eye,filament,flattened-reniform,flower,fruit,glabrous,gray,green,infructescence,known,lateral,leaf,length,lobe,long,margin,mauve,mm,moderately,naked,narrow-oblong,obtuse,one,open,orange-brown,pedicel,peduncle,per,pericarp,petiole,prickle,prickly,red-brown,rounded,shrub,small,smooth,sometimes,spherical,stellate-pubescent,stem,style,surface,terete,terminal,time,tip,tree,unarmed,upper,venation,visible,weakly,white,wide,yellow-green	-1/3,-3,.8,/3,0-20,0.05,0.05-0.15,0.1-0.2,0.3-0.8,0.5-3,0.6-0.8,1-1.7,1-5,1/3-1/2,1/3-3/4,1/4-1/3,1/8-1/4,11-16,2-10,2.5-3,2.5-6,3-7,5-10,5-7,5-8,5-merous,abaxially,alyx,apar,apart,bark,blade,branche,broadly,connivent,curved,cuspidat,densely,eaf,eed,elongating,equal,foliaceous,free,fruiting,fused,gently,glabrescent,glabrou,inflated,juvenil,less,lobed,longer,lower,mature,midpoint,narrow-deltate,nflorescence,older,orolla,oung,perfec,plurifoliat,poricidal,porrect,porrect-lepidote,portion,pubescent,ray,reflexed,ruit,scar,sessile,shorter,simple,slender,spaced,sparsely,spreading,stalk,stalked,stellate,stout,straight,tamen,tapering,trichome,tube,unit,variously,vary,way,ympodial,Â¼	abaxial,adaxial,arrangement,branch,branching,characteristic,colour,corolla,cuspidate,form,growth,height,history,inflorescence,juvenile,life,midvein,na,ovary,perennial,plant,primary,pseudostipule,rachi,seed,shape,staman,tertiary,texture,vein
74	wfo-0001026711	success	210	128	104	106	24	0.495	-2,-5,-7,.8,0,0-25,0-4,0-6,0.3-1,0.5-1.5,0.7-1.4,0.75-1,1.5-2.2,1/3,2-2.2,2-3.5,2.1-2.5,3-4.5,3-7,3.5-5.2,4.5-7,acute,anther,apex,apically,apparently,articulated,base,berry,branched,calyx,cell,cm,cuneate,curved,densely,diameter,dull,elliptic,erect,evenly,faint,filament,flattened-reniform,fruit,glabrous,green,lateral,leaf,length,lobe,lobed,long,lower,margin,maturity,mauve,midvein,mm,narrow-deltate,obtuse,occasionally,orange,orange-brown,outline,pair,pale,pedicel,peduncle,per,petiole,pit,prickle,prickly,primary,purple,raised,red,rounded,shallowly,shrub,slender,small,smooth,sometimes,spherical,stellate-pubescent,stem,style,surface,terminal,tertiary,trichome,unarmed,uniform,upper,vein,venation,visible,weakly,wide,yellow,yellow-green,young	-15,-6,.2,.5,0-0.2,0.1,0.15,0.2-0.3,0.7-,0.7-0.9,0.8,0.8-2.2,0.9-1.1,0.9-1.5,1-,1-2,1-30,1.5-,1.7-4,1/,1/2-2/3,1/4,1/4-1/3,2-2.5,2-4,2-6,3-4,3-5,4-8,5-merous,7-8,abaxially,acicular,acuminat,alyx,ame,apar,apart,bark,blade,brow,c.,concolorous,connivent,deltate,difoliate,discolorous,distance,drying,eaf,eed,elongating,equal,extending,flower,free,fruiting,geminat,infructescence,less,longer,mature,midpoint,moderately,nflorescence,older,one,open,orolla,oung,pendulous,perfec,pericarp,perpendicular,poricidal,porrect,portion,prickl,ray,reduced,reflexed,ruit,scar,sessile,shorter,side,somewhat,spaced,spreading,stalk,stalked,stellate,straight,tamen,tapering,terete,thick-chartaceous,time,tip,tube,unit,variously,vary,way,woody,ympodial	abaxial,acuminate,adaxial,arrangement,branching,characteristic,colour,corolla,form,growth,height,history,inflorescence,life,na,ovary,perennial,plant,pseudostipule,rachi,seed,shape,staman,texture
75	wfo-0001026717	success	207	90	61	146	29	0.295	0.6-1.5,1-2,1.4-2.2,13-28,2.5-4.5,2.5-5.5,3-4,3-6,3.3-11,4-6,5,5-11,5-6,acuminate,anther,apex,articulated,attenuate,base,berry,chartaceous,cm,conical,corolla,dark,diameter,elliptic,filament,fruit,glabrous,green,greenish,herb,lanceolate,leaf,light,lobe,long,margin,medium,membranous,minute,mm,mottled,mucilaginous,obtuse,odd-pinnate,ovoid,pedicel,peduncle,petiole,plant,pubescent,purple,round,seed,sparsely,style,subglabrous,violet,whitish	0.3-0.6,0.3-2.5,0.3-5,0.8,1-10,1-2.5,1-3,1.3-2.5,1.8-3,14-22,15-34,2.2-5,3-5,4-8,4-9,5-13.5,5-merou,5.3-9,7-11,abaxially,acumen,adaxially,ag,along,alyx,apart,apparently,axe,axillary,blade,borne,brownish,bud,capitat,cell,ciliate,condition,connivent,covering,darker,decreasing,decurrent,digestion,distal,dorsally,drying,eaf,edge,eed,end,enzyme,equal,erec,especially,exceeding,flat,flower,folded,forked,fresh,geminat,generally,glabrou,gradually,green-white,hair,hair-like,half,homostylous,honeycomb-shaped,interjected,larger,lateral,leaflet,lengthening,like,living,lower,make,middle,midrib,minutely,narrow,nflorescence,often,one-quarte,orbicular,orolla,ovate,pair,pentagonal,perfect,petiolule,plurifoliate,pore,poricidal,present,puberulent,pubescen,removed,ripe,rotate,ruit,secondary,semierect,sessile,seudostipule,singly,size,slightly,slit,spaced,specimen,stamen,ste,stigma,stolo,straight,stripe,subequal,subsessile,subtending,symmetrical,tall,tamen,tem,terminal,testal,thick,throughout,tip,toward,tri-,tube,tuber,typically,unit,usually,vary,wall,wet,wide,wing,x,yellow,ympodial	abaxial,adaxial,arrangement,branching,calyx,characteristic,colour,form,growth,height,history,inflorescence,length,life,midvein,na,ovary,primary,pseudostipule,rachi,shape,staman,stem,surface,tertiary,texture,unarmed,vein,venation
76	wfo-0001026725	success	166	100	65	101	35	0.392	.5,0.7-1.2,1-1.2,1-1.5,1-4.5,1-5,1.5,1.5-2,1.6-2,2,3.5-4,5-20-flowered,8-9,acute,anther,apex,base,beneath,berry,broadly,calyx,cm,corolla,dark,dia,drying,elliptic,filament,flattened-reniform,fruit,glabrous,glandular-papillose,globose,green,greenish-white,leaf,lobe,long,margin,minutely,mm,onto,ovary,ovate,pair,pedicel,petiole,pitted,pubescent,reddish-brown,rounded,scarious,shrub,simple,slender,stem,style,subshrub,surface,tapering,triangular,vein,white,winged,x	.3,/4,0.2,1.2-1.7,1/2,2.2-4,3.6-7.7,5-5.5,5-6,8-18.6,accrescent,anthesi,apart,attenuate,axil,bark,becoming,black,bluish,brownish-papillose,capitate,character,crackin,cup-shaped,deflexed,differing,difoliate,dry,eaf,edicel,eed,ellipsoid,evenly,extremely,free,fruiting,geminat,geographically,incrassate,inflorescenc,interpetalar,large,lateral,less,lobed,lon,lower,main,major,margine,material,middle,minor,nflorescence,occasionally,often,older,one,open,opposite,ovoid,pale,paler,papillo,papillose,planar,pore,poricidal,portion,prominent,proximal,reflexed,ruit,scar,shaped,short,sinus,size,slightly,spaced,split,stigma,straight,stretching,tall,tan,tear-drop,tip,trichome,tube,tuft,ud,uniseriate,unit,upper,varying,way,widest,woody,ympodial,young	0.3,1,4.5,abaxial,adaxial,alternate,arrangement,branching,characteristic,colour,diameter,form,greyish,growth,height,hirsute,history,inflorescence,length,life,midvein,na,peduncle,perennial,plant,primary,pseudostipule,rachi,seed,shape,staman,tertiary,texture,unarmed,venation
77	wfo-0001026733	success	188	136	102	86	34	0.543	-11,-15,-2,-7,0.3-0.5,0.3-2,0.5-2,1,1-1.5,1-3,1-7,1.5-14,1.5-2,1.5-2.5,10-20,15-,2-2.5,2-3,2-6,2.5-7.5,20-50,25-40,3-3.5,4,4-5,5-8,8-12,abaxially,acuminate,acute,adaxially,apex,articulated,axe,basal,base,calyx,chartaceous,cm,color,cordate,curled,deltate,dense,densely,diameter,eglandular-pubescent,ellipsoidal,elliptic-ovate,entire,flattened,flower,forked,fruit,fusiform,glabrate,glabrous,gland-tipped,glandular-,glandular-puberulent,green,greyish,hair,hirsute,immature,leaving,lobe,long,longitudinal,margin,mm,moderately,near,oblique,ovate,pedicel,pedicellar,peduncle,perfect,petiole,pilose,pubescent-pilose,rachi,remnant,ripe,shining,simple,sometimes,stripe,style,submarginally,tree,truncate,unbranched,unknown,vein,villous,white,white-puberulent,wide,x,yellowish	-1,-13,-14,-4,-8,.5-3,0.5,0.5-1,0.5-4,1-2,2-4,3-15,3-4-foliat,3-7,4-23,4.5-5,7-10,acute-acuminate,aggregate,apart,ape,beyond,blade,capitat,cell,ciliat,connective,connivent,cylindrical,dia,directed,distally,eaf,eed,eglandular-pilose,eglandular-villous,equal,especially,exceeding,exserted,glandula,glandular-tomentose,lanceolate,linear-triangular,lon,lower,membranaceous,midrib,narrowly,nflorescence,nther,orolla,ovoid,ovum,pore,present,pubescent,pubescent-pilo,radiu,round,ruit,shorter,slightly,small,smooth,spaced,sparsely,stamen,stellate,stigma,stone,swelling,tal,tem,thecae,time,toward,triangular,tube,ud,unit,unknow,usually,vary,yellow,ympodial	abaxial,adaxial,anther,arrangement,branching,characteristic,colour,corolla,filament,form,glandular,growth,height,history,inflorescence,leaf,length,life,midvein,na,ovary,perennial,plant,primary,pseudostipule,seed,shape,staman,stem,surface,tertiary,texture,unarmed,venation
78	wfo-0001026734	success	266	113	83	183	30	0.312	0.5,1,3,abaxial,abaxially,absent,acuminate,adaxial,anther,apex,articulated,barely,base,becoming,berry,branched,bright,broadly,brown,calyx,camptodromous,chartaceous,cm,congested,corolla,covered,cuneate,cyme,densely,diameter,distally,elliptic,entire,flower,fruit,geminate,glabrous,globose,green,growth,immature,irregular,lanceolate,leaf,length,lobe,long-attenuate,margin,mature,maturity,membranaceous,mm,moderately,much,narrow,oblong,observed,obtuse,ovary,pair,pale,pedicel,peduncle,petiole,pit,porrect-stellate,pubescent,purple,purplish,rachi,shape,shrub,sparsely,stem,style,surface,trichome,unbranched,vein,venation,visible,white,yellowish	0.1,0.2,0.3,0.6,0.7â0.9,0.7â1,0.8â1,1.6â2,1.6â2.5,1.8â2.2,1.8â3,1/4,1â1.2,1â3,2.2â7,2.3â5,2.5â3,2â2.4,2â3,3.2â3.8,3â4,3â4-celled,3â8,4â6,4â7,4â8,4â9,5-merou,5â9,8,accrescent,acute,adaxiall,adaxially,ag,also,always,alyx,anthesi,apical,apice,archin,ark,associated,asymmetric,axi,beneat,beneath,blade,branch,caly,capitate,celled,central,clavate,closely,commonly,connivent,covering,cylindrical,dark,dense,denser,differing,directed,discolorous,downward,dried,drying,due,eaf,eed,eglandular,emergent,erect,f.,fewer,flat,flattened,foliate,forked,found,free,frequently,glabrescen,glabrescent,glandular,gray,hair,held,ilament,initially,internodal,introrsely,j,lamina,large,lateral,less,lobed,long,longer,longitudinal,lower,lying,material,maturit,midpoint,midri,minute,mostly,multiseriate,near,new,nflorescence,normally,obovate,often,old,older,one,one-celled,opening,orolla,other,oung,ovate,paired,papillose,perfect,plane,pointing,pore,poricidal,porrect,portion,pubescence,raised,rarely,ray,rayed,reaching,reniform,rounded,ruit,scandent,secondary,sessile,shiny,short-stalked,shorter,simple,size,slightly,slit,smaller,sometimes,spaced,sparse,spread,spreading,stalk,stellate,stigma,still,subopposite,subsessile,surfac,terminal,tube,tuft,ud,unequal,uniseriate,unit,upward,vary,vestiture,whole,wide,yellow,ympodial,Â¾	0.8-1,1.6-2,1.6-2.5,1.8-3,2-3,2.3-5,2.5-3,3-8,4-6,5-9,arrangement,branching,characteristic,colour,filament,form,height,history,inflorescence,life,midvein,na,plant,primary,pseudostipule,seed,staman,tertiary,texture,unarmed
79	wfo-0001026740	success	171	138	105	66	33	0.614	0-10,0.5-1,1-10,1-12,1-2,1-3,1-5,10-20,10-30,2-3,2-4,2.5-27,2.5-3,2.5-4.5,2.5-6,20-50,3-3.5,3-5,4-5,4.5-10,5-8,6-10,8-19,abaxially,acuminate,acute,adaxially,also,apart,apex,apiculate,articulated,basal,base,branched,calyx,cm,cordate,corky,curled,cylindrical,darker,deltate,densely,diameter,eglandular,ellipsoidal,elliptic,entire,especially,flattened,fleshy,flower,fruit,glabrate,glabrous,glandular-puberulent,greenish,hair,immature,leaving,lobe,long,margin,mature,mm,moderately,near,nearly,oblong,obtuse,often,ovate,pedicel,pedicellar,peduncle,perfect,petiole,pilose,present,puberulent,purple,rachi,remnant,reticulate,scar,sessile,simple,sometimes,spaced,sparsely,stripe,style,tomentose,tree,truncate,unbranched,vein,villous,white-puberulent,whitish,woody,x,yellow,young	-17,-2,1-4,3-15,3-foliat,3.5-40,5-40,absen,absent,acute-acuminate,aggregate,ape,axe,beyond,blade,browni,cell,ciliate,connective,connivent,directed,distally,eaf,eed,equal,exceeding,exserted,lanceolate,lon,lower,narrowly,nflorescence,nther,orange,orolla,ovoid,pilo,pore,pubescent,radiu,rarely,ruit,shorter,slightly,small,stamen,stellate,stigma,stone,subcoriaceous,swelling,tal,tems,thecae,time,toward,triangular,truncat,tube,ud,unit,unlobed,vary,violet,wide,ympodial	abaxial,adaxial,anther,arrangement,branching,characteristic,colour,corolla,filament,form,green,growth,height,history,inflorescence,leaf,length,life,midvein,na,ovary,plant,primary,pseudostipule,seed,shape,staman,stem,surface,tertiary,texture,unarmed,venation
80	wfo-0001026752	success	169	122	90	79	32	0.533	-25,-3,-4,0-,1,1-12,1-2,1-5,1-6,1.5-12,1.5-2,1.5-2.5,10-20,2-2.5,2-3,2.5-5,20-30,3-4,3.5-4,4-5,8-16,abaxially,abruptly,acute,adaxially,also,apex,apiculate,articulated,basal,base,black,branched,calyx,cm,cordate,cuneate,darker,deltate,densely,diameter,ellipsoidal,elliptic-oblong,elliptic-ovate,entire,finely,flattened,fleshy,forked,fruit,glabrous,globose,green,greenish-brown,immature,leaving,less,lobe,long,margin,mm,moderately,near,obtuse,pedicel,pedicellar,peduncle,petiole,pilose,possibly,pubescent,pubescent-pilose,purplish,rachi,rarely,remnant,ripe,short-acuminate,simple,stripe,style,tree,truncate,unbranched,vein,violet,white,whitish,x,yellow	-50,1-1.5,1-3,15-35,2,2-4,2.5-20,3,3-18,3-5,3-foliat,4-45,7-15,absent,aggregate,apart,ape,axe,beyond,blade,campanulate,capitat,cell,chartaceous,connective,connivent,coriaceous,cylindrical,dilated,directed,distally,eaf,eed,equal,exceeding,exserted,flower,hair,lanceolate,laterally,lon,lower,narrowly,nearly,nflorescence,nther,orolla,ovoid,papillose,perfect,pilo,pore,presence,present,radiu,rather,ruit,slightly,small,somewhat,spaced,stamen,stellate,stigma,stone,tal,tem,thecae,time,tomento,triangular,tube,ud,unit,unknow,vary,wide,yello,ympodial	abaxial,adaxial,anther,arrangement,branching,characteristic,colour,corolla,filament,form,growth,height,history,inflorescence,leaf,length,life,midvein,na,ovary,plant,primary,pseudostipule,seed,shape,staman,stem,surface,tertiary,texture,unarmed,venation
81	wfo-0001026754	success	176	116	86	90	30	0.489	-6+,0.5,0.5-1,0.9-1.1,1-,1.5-3,10,2,2-2.5,2-3,2-4,30+,5,5-lobed,7-9,acute,adaxially,anther,anthesi,apex,asymmetric,axi,basal,base,berry,branched,calyx,cm,conical,corolla,deeply,dendritic,densely,diameter,elliptic,entire,especially,filament,flower,glabrous,globose,growth,half,inflorescence,later,lateral,leaf,like,lobe,lobed,long,many,margin,membranous,midvein,mixture,mm,narrowly,oblique,pair,pedicel,peduncle,petiole,primary,pubescent,simple,slender,sparsely,spreading,stem,style,surface,tangled,terminal,time,trichome,truncate,twining,uniseriate,vein,vine,weak,white,woody,x,yellowish	.5,1,1/2,198.,2.5-3.5,2/3,3-4-celled,4-5,5-merou,5.5-9,9,9-11,abaxially,ag,along,alyx,apar,apparently,ark,articulated,broadly,brow,cabrera,clavate,complete,connivent,cucullat,denser,distal,divided,eaf,ed,ellipsoid,exerted,extending,fide,free,halfway,ilament,irregularly,lamina,leaving,lengthening,loosely,lower,mature,minute,minutely,mostly,new,nflorescence,older,orolla,outline,papillo,peg,perfect,pinnate,planar,plurifoliat,pore,poricidal,portion,puberulent,ruit,scandent,scar,seen,sleeve,slit,small,sometimes,spaced,splitting,stellate-rotate,stigma,tem,tip,transparent,tub,tube,twinin,ud,unit,upper,vary,way,within,yellow,ympodial	60-100,abaxial,adaxial,arrangement,branching,brown,characteristic,colour,form,fruit,green,greyish,height,hirsute,history,length,life,na,ovary,perennial,plant,pseudostipule,rachi,seed,shape,staman,tertiary,texture,unarmed,venation
82	wfo-0001026756	success	147	113	83	64	30	0.565	.25,.5,0-7-1.2,0.5-3,1-1.5,1.5-10,1.5-2,1.8-3,3-4,5-10,5-10-flowered,5-5.5,6-10,abaxial,acute,anther,anthesi,apex,apiculate,attenuate,bark,base,berry,brown,calyx,cm,corolla,dark,deflexed,deltate,dendritic,densely,difoliate,elliptic,erect,exserted,filament,fleshy,free,glabrescent,glabrous,globose,green,lax,leaf,lobe,long,minutely,mm,occasionally,ovary,ovate,ovoid-reniform,pair,pale,pedicel,petiole,pinkish-white,pitted,planar,pore,poricidal,pubescent,shape,shaped,shrub,simple,soon,sparsely,stem,strongly,style,surface,tear-drop,thick,tip,tree,trichome,tube,unifoliate,vein,white,woody	0.25-0.5,0.5-1,1-2,1.5-1.7,1.5-3,3.5-8.5,6-16,abaxially,adaxially,along,ba,bilobed,broadly,closely,conical,corresponding,denser,dia,differing,distal,eaf,edicel,eed,fruiting,geminat,grayish-brow,hard,inflorescenc,irregular,lamina,lateral,like,lobed,lower,main,major,middle,minor,nearly,nflorescence,older,opposite,overlappin,papillo,perhaps,pericarp,portion,present,pubescence,rest,ruit,scar,somewhat,spaced,stigma,tall,tub,ud,uniseriate,unit,wide,widest,ympodial,young	0.25,adaxial,arrangement,branching,characteristic,colour,diameter,form,fruit,grayish-brown,growth,height,history,inflorescence,length,life,margin,midvein,na,peduncle,plant,primary,pseudostipule,rachi,seed,staman,tertiary,texture,unarmed,venation
83	wfo-0001026777	success	168	106	77	91	29	0.458	0.25-0.5,0.5-1.5,1-1.3,1-1.5,1-2,1-4,1.2-1.8,1.5-3,2-4,3-3.5,4-8,5-7,acuminate,acute,anther,apex,apiculate,base,beneath,berry,blue,branching,brown,calyx,cm,corolla,decurrent,deflexed,elliptic,fide,filament,filiform,flattened-reniform,flexuous,glabrate,glabrous,globose,green,growth,leaf,lobe,long,margin,mm,narrowly,near,new,occasionally,often,onto,opposite,ovary,overtopping,pair,pedicel,petiole,pubescent,quadrate-deltoid,russet,seed,shiny,shrub,slightly,smooth,sparsely,stem,style,surface,tapering,thread-like,trichome,tube,uniseriate,vein,vellozo,white,x	.25,.5,/3,0.5-1,0.5-5,0.9-3,1-10,1.5-5,2-4.5,2-5,5-14,5-50-flowered,anthesi,apart,axil,ba,beginning,body,campanulate,capitate,cell,cup,dense,dia,differing,difoliate,distal,eaf,edicel,eed,end,exserted,flattened,free,fruiting,geminat,greyi,hyaline,incrassate,inflorescenc,irregularly,lateral,like,lobed,lon,lower,main,major,matted,middle,minor,minutely,nearly,nflorescence,older,one,outline,papillo,papillose,pitted,planar,pore,poricidal,portion,prominent,quite,rest,ruit,scar,shaped,sinuate,size,somewhat,soon,spaced,stigma,straight,tall,tear-drop,testa,tip,tuft,ud,unit,wall,way,widest,woody,yellowish,ympodial,young	abaxial,adaxial,alternate,arrangement,characteristic,colour,diameter,form,fruit,greyish,height,history,inflorescence,length,life,midvein,na,peduncle,perennial,plant,primary,pseudostipule,rachi,shape,staman,tertiary,texture,unarmed,venation
84	wfo-0001026819	success	218	123	96	122	27	0.44	0.5-1.5,1-2,1.5-10,1.5-12,1.5-3.3,10-26,2-5,2.5-5,3-120,4,4-10,4-7,5-30,6-11,abaxially,acuminate,acute,anther,apex,articulated,attenuate,base,blue,broadly,brownish,cell,chartaceous,cm,condition,corolla,covering,cuneate,dark,densely,diameter,distal,dot,drying,elliptic,especially,filament,forked,fresh,fruit,glabrous,glaucous,globose,green,greenish,hair-like,herb,lanceolate,lateral,light,lobe,long,margin,membranous,middle,midvein,mm,moderately,mottled,narrowly,oblique,odd-pinnate,ovate,ovoid,pedicel,peduncle,petiole,plant,pubescent,purple,rachi,scattered,seed,slightly,sometimes,somewhat,stem,stripe,style,subglabrous,symmetrical,tertiary,testal,thick,tinged,truncate,unwinged,violet,wall,white,whitish,wing	0-27,0.3-4.7,1-10,1-2.3,1-5,1.2-36,1.5-3.0,1.5-3.5,1.6-3.5,10,2-6,3-18,3-20,3-35,3-38,5-merou,7,absent,acumen,adaxially,ag,along,alyx,apart,ascending,bearing,blade,borne,bud,capitate,ciliate,clavat,connate,connivent,curved,decurrent,digestion,dorsally,eaf,edge,eed,end,enzyme,erec,exceeding,flat,flower,folded,geminat,generally,glabrou,greatly,green-white,greenish-yellow,hair,half,homostylous,honeycomb-shaped,interjected,larger,leaflet,lengthening,like,living,lower,lunate,make,minutely,mucilaginous,nflorescence,non-glandular,often,orolla,pair,pedice,pentagonal,petiolule,plurifoliate,pore,poricidal,puberulent,ranging,removed,rotate-pentagonal,ruit,scale-like,seudostipule,short,singly,slit,spaced,specimen,stamen,star,ste,stigma,stolo,straight,subequal,suborbicular,subrosette,subtending,tall,tamen,tem,terminal,therefore,throughout,tip,tri-,tube,tuber,typically,unit,usually,vary,wet,wide,within,without,yellow,ympodial	abaxial,adaxial,arrangement,branching,calyx,characteristic,colour,form,growth,height,history,inflorescence,leaf,length,life,na,ovary,perennial,primary,pseudostipule,shape,staman,surface,texture,unarmed,vein,venation
85	wfo-0001026821	success	204	124	93	111	31	0.456	.2,0.3-1.2,0.3-2.5,0.4-1.5,0.5-1.2,0.7-1.8,0.8-1,1-1.5,1-2,1-20,1-5,1.2-1.5,1.5-2.5,10-15,2-3.5,2.5-18,3-branched,4-4.5,5-10,5-12,5-20,acuminate,adaxial,anther,apart,apex,apically,appressed,auriculate,base,berry,bract,broadly,brown,cm,cordate,dark,diameter,due,ellipsoidal,elliptic,filament,flattened,flower,forked,fruit,gglobose,glabrous,green,herb,lanceolate,lateral,leaf-opposed,length,light,lobe,long-attenuate,margin,mature,mm,obliquely,obtuse,odd-pinnate,pair,pale,pedicel,peduncle,petiole,pilose,pseudostipular,puberulent,pubescent,rachi,rarely,remnant,reniform,rounded,slender,somewhat,spaced,sparsely,stellate,stripe,style,subglabrous,substellate,subtended,surface,thickening,unbranched,wall,white,x	/3,0-20,0.2-1.5,0.5-3.5,1-3,17,1977,2-15,2-6,2-celled,3-11,3-18,3-6,3-7,3-celled,5-34,5-merou,abaxially,acut,adaxially,ag,alyx,anderson,angular,apical,apiculate,articulated,axe,ba,basal,bayonet,blade,cell,chartaceous,ciliat,cuneate,deltate,directed,distal,distally,eaf,eed,equal,especially,exceeding,frequent,fused,geminat,glabrou,gland-tipped,greatly,hair,homostylous,incurved,interjected,interstaminal,large,leaflet,long,longitudinal,lower,lowermost,many,mean,membrane,membranous,minute,minutely,moderately,much,narrowly,nflorescence,oblique,oblong,occasional,occasionally,one-celled,opening,orolla,paired,per,perfect,petiolule,plurifoliate,pore,present,pubescen,reduced,ruit,scandent,seudostipule,short,slightly,slit,small,smaller,stamen,stigma,tamen,tem,terminal,time,tri-,truncat,tube,unit,vary,wide,winged,yellow,ympodial	abaxial,arrangement,branching,calyx,characteristic,ciliate,colour,corolla,form,growth,height,history,inflorescence,leaf,life,midvein,na,ovary,perennial,plant,primary,pseudostipule,seed,shape,staman,stem,tertiary,texture,unarmed,vein,venation
86	wfo-0001026827	success	143	94	68	75	26	0.476	0.2-0.5,0.4-0.6,0.5-2,1-1.1,1-1.5,1.3-1.6,1.5-2,2-2.2,2-4,5-6,7-9,acute,anther,apex,arachnoid,attenuate,base,branched,broadly,calyx,cm,conical,corolla,deltate,dendritic,densely,diameter,especially,filament,fleshy,glabrescent,glabrous,growth,inflorescence,irregularly,lanceolate,leaf,like,lobe,margin,mm,narrowly,near,oblanceolate,ovary,pair,pedicel,peduncle,petiole,primary,pubescent,rachi,reddish,revolute,shrub,simple,slender,sparsely,stem,style,surface,thick,tip,trichome,uniseriate,vein,white,x	.5,/3,0.6-1,1-,1-2,1-2.1,2-2.5,3-9,?,abaxially,adaxiall,age,and/or,anthesi,apart,appearing,bark,branch,clavate,crowded,deciduou,dense,distally,dry,drying,eaf,ellipsoid,erect,exerted,flower,free,internodal,know,known,lamina,lengthening,less,lobed,lower,minutely,new,nflorescence,nodding,ot,paler,papillat,papillate,perfect,planar,plane,plurifoliat,pore,poricidal,portion,scar,sinus,slit,small,soon,stigma,stout,straight,strongly,surfac,terminal,thickened,third,tub,tube,ud,unit,upper,way,widest,ympodial	1-2.5,abaxial,adaxial,adaxially,arrangement,branching,characteristic,colour,form,fruit,height,history,length,life,midvein,na,perennial,plant,pseudostipule,seed,shape,staman,tertiary,texture,unarmed,venation
87	wfo-0001026830	invalid_json	198	143	108	90	35	0.545	0.3-1.3,0.4-1,0.5-1.0,1-10,1-11,1-2,1.5-4,10-57,2.5-5,4-10,4-7,5-11,6-13,7-18,abaxially,acuminate,acute,adaxially,anther,apart,apex,articulated,asymmetric,attenuate,axillary,base,basiscopic,berry,brown,brownish,bud,cell,ciliate,cm,condition,coriaceous,corolla,covering,deep,diameter,distal,drying,elliptic,filament,finely,flower,forked,fresh,fruit,generally,glabrescent,glabrous,globose,green,green-white,greenish,hair,hair-like,half,herb,high,lateral,leaf,light,linear,lobe,long,make,margin,medium,mm,moderately,mucilaginous,odd-pinnate,ovate,ovoid,pedicel,peduncle,petiole,plant,puberulent,pubescent,purple,ripe,rounded,seed,sessile,short,side,simple,spaced,stripe,style,subglabrous,subtending,terminal,testal,thick,throughout,tissue,typically,usually,wall,wet,white,whitish,yellow,yellowish	0-10,0.5-1.2,0.9-1.9,1.1-2.7,1.4-4,2-4,2-6,2.5-4.4,2.7-8,3.5-8.5,4-14.5,4.4-14.5,4.5-17.5,5-merou,acumen,adaxiall,ag,along,alyx,apparently,arranged,axe,bead,blade,capitat,clavate,connivent,decreasing,digestion,dorsally,eaf,edge,eed,enzyme,erec,exceeding,flat,folded,geminat,glabrou,hal,homostylous,honeycomb,interjected,lanceolate,leaflet,lengthening,like,living,lower,moniliform,multiple,necklace,nflorescence,orbicular,orolla,pair,pentagonal,perfect,petiolulate,plurifoliate,pore,poricidal,removed,rotate,ruit,seudostipule,shaped,size,slit,specimen,stamen,stigma,stolon,straight,subequal,subglabrou,tall,tamen,tem,tip,toward,tri-,tube,tuber,unit,unwinged,vary,x,ympodial	'',2,[,``,abaxial,adaxial,arrangement,branching,calyx,characteristic,colour,form,growth,height,inflorescence,length,midvein,na,ovary,primary,pseudostipule,rachi,shape,staman,stem,surface,tertiary,texture,true,unarmed,value,vein,venation,{,}
88	wfo-0001026831	success	207	126	101	106	25	0.488	.5,0-10,0-20,0-3,0-6,0.2-1,0.3-0.65,0.5-1.2,0.6,0.7-2,1-2.2,1/3,2-2.5,2-4,2.3-2.9,2.5-4.5,3-6,acute,anther,apex,apically,apparently,articulated,attenuate,base,berry,branched,bright,calyx,cell,cm,cream,curved,dark,deltate,densely,diameter,dull,elliptic,erect,eye,filament,flattened-reniform,fruit,glabrous,gray-brown,green,lateral,leaf,length,lobe,lobed,long,lower,margin,marking,maturity,mauve,midvein,mm,moderately,naked,narrow-cuneate,orange,orange-brown,outline,pair,pale,pedicel,peduncle,per,petiole,prickle,prickly,primary,raised,red-brown,rounded,shiny,shrub,slender,smooth,sometimes,sparsely,spherical,stellate-pubescent,stem,style,surface,terete,tertiary,upper,usually,vein,venation,visible,white,wide,yellow,yellow-green,young	-0.25,-5,-6.5,-9,/4,0.1,0.1-0.2,0.1-0.25,0.15-0.25,0.2-0.4,0.3-0.6,0.6-2,0.65-1,0.7-1.1,1-10,1-2,1-2.5,1-3,1-4,1-6,1.2-2,1.5-2.5,1/3-1/,1/3-2/3,1/5-1/4,2-3,3-5,3.5-10,5-merous,7-10,7-8,abaxially,alyx,apar,apart,bark,blade,broad-deltate,brow,caudat,chartaceous,concolorous,connivent,difoliate,distance,drying,eaf,eed,elongating,equal,extending,flower,free,fruiting,fully,geminat,glabrescent,herbaceous,infructescence,less,longer,mature,membranous,midpoint,multangulate,nflorescence,oblong,occasionally,older,one,open,opening,orolla,oung,ovate,pendulous,perfec,pericarp,poricidal,porrect,portion,prickl,ray,reduced,ruit,scandent,scar,sessile,shorter,side,spaced,spreading,stalk,stellate,subsessile,tamen,tapering,time,tip,trichome,tube,unit,vary,way,white-gray,ympodial	1/3-1/2,abaxial,adaxial,arrangement,branching,caudate,characteristic,colour,corolla,form,growth,height,history,inflorescence,life,na,ovary,plant,pseudostipule,rachi,seed,shape,staman,texture,unarmed
89	wfo-0001026841	success	139	88	56	83	32	0.403	0.25-0.3,0.25-0.5,0.5-1,0.6-1,0.75-1,0.8-1,0.8-3,1.5,1.5-2,3.5-5,4-8,5-8-flowered,6-8,7-9,acute,anther,apex,base,berry,calyx,cm,corolla,decurrent,deltoid,elliptic,filament,glabrate,glabrous,globose,green,hyaline,inflorescence,leaf,lobe,long,margin,mm,ovary,pair,pedicel,petiole,prominent,pubescent,raised,reddish,shining,shrub,simple,slightly,sparsely,stem,straight,style,vein,white,x	.25,.5,/4,0.05,0.5-0.75,0.5-2,2-2.5,3-6.5,9.2-18,along,anthesi,apart,arch,axi,ba,bark,beneath,bi-lobed,broadly,clavate,conical,coroll,curly-tipped,deflexed,dia,eaf,edicel,eed,ellipsoid,exsertion,filiform,free,fruiting,greyish-gree,immature,joined,known,later,lateral,like,lobed,lon,lower,main,middle,minutely,nflorescence,older,opposite,paler,papillo,papillose,pore,poricidal,portion,reflexed,rest,ruit,scar,series,shaped,slender,spaced,stigma,tall,tapering,tear-drop,terminal,thickened,tip,trichome,tube,ud,unevenly,unifoliat,uniseriate,unit,way,widest,winged,woody,ympodial,young	0.5,abaxial,adaxial,arrangement,branching,characteristic,colour,diameter,form,fruit,greyish-green,growth,height,history,length,life,midvein,na,peduncle,plant,primary,pseudostipule,rachi,seed,shape,staman,surface,tertiary,texture,unarmed,unifoliate,venation
90	wfo-0001026849	success	180	88	58	122	30	0.322	0-10,0.5-1,1,1-2,1.5-2.5,1.75-2,2-3,38/2,5,637/2,7-8,acute,anther,apex,aster,base,berry,brown,calyx,cm,colour,corolla,cyme,discoidal,distinctly,filament,glabrous,green,grey-brown,growth,hair,inflorescence,lavender,leaf,lobe,long-cuneate,margin,minutely,mm,oblong-lanceolate,ovary,pale,pedicel,peduncle,petiole,reticulate,rh,rounded,sea,seed,short-lived,shrub,stem,style,surface,unarmed,undulate,violet	-50,1-1.5,1-6,100-130,11,2,30-,40,5-10,80-,adherent,adult,amongst,appearing,aspect,australian,axil,capitate,cell,composed,conical,conspicuous,curved,cut,deflexed,developed,dia,distinct,eed,ellipsoid,emarginate,enlarge,entire,erect,exceeding,except,exerted,expanded,facetted,filled,flesh,floral,flower,flowered,fork,free,fruiting,general,glandular,globose,globular,granule,greater,gree,half,interacuminal,large,leave,lengthening,less,linear-lanceolate,little,lon,long,loosely,lower,mature,maturity,mid-vein,minute,native,nflorescence,oblong,occasionally,often,pal,pedicellate,petal,plurifoliat,pore,poricidal,preparation,pruinose,purple,rarely,relatively,reproducing,rhachi,rotate,ruit,ruiting,shallow,shed,simple,sinus,slende,slightly,slit,soft-wooded,solanum,solitary,sometimes,somewhat,soon,stigma,stone,stony,stout,thus,tip,tissue,tub,tube,ud,unit,uvenile,vegetatively,way,well,x,ympodial,young	abaxial,adaxial,arrangement,branching,characteristic,diameter,form,fruit,greyish,height,hirsute,history,length,life,midvein,na,plant,plurifoliate,primary,pseudostipule,rachi,shape,slender,staman,tertiary,texture,true,vein,venation,white
91	wfo-0001026858	success	153	113	79	74	34	0.516	0.5,0.8,0.8-1,1-11.5,1-4,1.3-1.5,1.5-4,2-2.5,2-4,2.5-3,3-4,6-10,6-18,6-7,abaxially,acumen,acute,adaxially,apex,base,branched,calyx,cell,cm,cordate,corolla,covering,cuneate,cyme,diameter,dichasial,dichasially,ebracteate,exceeding,filament,glabrescent,glabrous,globose,green,green-white,hair-like,herbaceous,lateral,leaf,light,lobe,long,make,minute,mm,monochasial,mucilaginous,mucronate,oblique,oblong,obtuse,odd-pinnate,ovate,ovate-lanceolate,ovoid,pedicel,peduncle,perennial,petiole,plant,rounded,seed,shiny,slightly,stamen,stellate,stigma,straight,style,testal,thick,throughout,triangular,wall	-30,-4,0-.,1-,1-10,1-5,2-3,3-,3-6-foliat,4-24,4.5-10.5,5-15,abruptly,apical,apically,articulate,connate,dehiscent,digestion,diminishing,distal,dorsally,eaf,edge,eed,emoval,enzyme,flat,flower,folded,forked,generally,globo,half,honeycomb,interjected,introrse,leaflet,living,lon,lower,lunat,maturing,nflorescence,nther,often,orolla,pair,pattern,perfect,plan,poricidally,proximal,reveal,ruit,seudostipule,short,size,slit,specimen,tal,tem,throughou,toward,tuber-bearing,typically,unit,vary,white-crea,wide,without,yellow,ympodial,Â¼	abaxial,adaxial,anther,arrangement,branching,characteristic,colour,form,fruit,growth,height,history,inflorescence,length,life,lunate,margin,midvein,na,ovary,primary,pseudostipule,rachi,shape,staman,stem,surface,tertiary,texture,unarmed,vein,venation,wet,white-cream
92	wfo-0001026895	success	166	127	98	68	29	0.59	.5,0.5-1,0.5-1.2,0.5-1.5,0.5-2,0.8-1,1-1.5,1.4-2.1,1.5-2,2-2.3,2-2.5,2-3,4.5-5,5-6,5-8-flowered,abaxial,acute,adaxial,anther,apex,apically,appearing,attenuate,base,berry,borne,brown,calyx,cm,contracted,corolla,dark,deflexed,deltoid,dendritic,dia,drying,elliptic,erect,filament,filiform,flattened,glabrate,glabrous,globose,green,hard,incrassate,internodal,lamina,leaf,like,lobe,long,margin,minutely,mm,mustard,narrowly,often,ovary,pair,pale,pedicel,pericarp,petiole,pitted,pointed,pubescent,reddish,reniform,scattered,shape,shoot,short,shrub,shrublet,side,simple,small,somewhat,sparsely,stem,style,surface,swollen,swollen-based,tan,toothed,trichome,tube,type,uniseriate,vein,white,woody,x,yellow	0-0.5,1-5,2.5-3.2,2/3,3-12,along,anthesi,apical,ba,bark,broad,broadly,campanulate,capitate,closely,conical,denser,differing,difoliate,eaf,edicel,eed,ellipsoid,elongate,free,fruiting,geminat,lateral,lobed,lon,long-exserted,lower,main,major,middle,minor,minute,nflorescence,obovate,older,overlappin,papillo,pore,poricidal,portion,present,projection,reddish-brow,ruit,scar,shaped,size,soon,spaced,stigma,tall,tear-drop,thin,tip,tub,tuft,ud,unit,usually,way,widest,ympodial,young	alternate,arrangement,branching,characteristic,colour,diameter,form,fruit,growth,height,history,inflorescence,length,life,midvein,na,peduncle,perennial,plant,primary,pseudostipule,rachi,reddish-brown,seed,staman,tertiary,texture,unarmed,venation
93	wfo-0001026905	invalid_json_followup	204	122	91	113	31	0.446	0-2,0.4-1,0.5-0.7,0.5-1.5,0.6-0.7,0.9-1.3,1-2,1/3,2.5-2.9,2.5-3.5,3-5,5-6,acute,anther,apex,apically,articulated,attenuate,base,berry,branched,calyx,cell,cm,cream,dark,deltate,densely,diameter,dull,erect,eye,filament,flattened-reniform,fruit,gray-green,green,inflorescence,lateral,leaf,length,lobe,lobed,lower,margin,marking,maturity,mauve,midvein,mm,moderately,naked,oblong,orange,orange-brown,outline,ovate,pair,pale,pedicel,peduncle,petiole,pit,prickle,prickly,primary,raised,red,rounded,shallowly,shrub,small,smooth,sometimes,spherical,stellate-pubescent,stem,style,surface,tertiary,unarmed,upper,usually,vein,venation,visible,weakly,white,yellow,yellow-green,young	-1.5,-10,-2,-2/3,-3,-4,.2,.5,0,0-20,0-25,0.1,0.15,0.2-0.3,0.2-0.5,0.3-0.4,0.4,0.4-0.9,0.7-1.4,0.75-1.1,1,1-2.5,1-20,1-3.7,1-4,1-6,1.9-2.5,1/2-3/4,1/4,1/5-1/3,2-3,2/3-3/,3-8,5-merous,6-8,7-8,abaxially,acuminat,alyx,ame,apar,apart,apparently,bark,blade,brow,c.,chartaceous,connivent,curved,difoliate,discolorous,distance,drying,eaf,eed,elongating,equal,extending,flower,free,fruiting,geminat,glabrous,infructescence,long,longer,mature,midpoint,older,one,open,orolla,oung,pendulous,per,perfec,pericarp,poricidal,porrect,portion,prickl,ray,reduced,ruit,scar,sessile,shorter,side,slender,somewhat,spaced,sparsely,spreading,stalk,stalked,stellate,straight,subentire,tamen,tapering,terete,time,tip,trichome,tube,unit,variously,vary,way,wide,woody,ympodial	'',0-10,0.5,2/3-3/4,[,``,abaxial,acuminate,adaxial,arrangement,branching,characteristic,colour,corolla,form,growth,height,history,life,na,ovary,plant,pseudostipule,rachi,seed,shape,staman,texture,value,{,}
94	wfo-0001026923	success	177	109	81	96	28	0.458	.5,0-5,0.25-0.5,0.5-1,0.6-0.8,1,1-1.5,1.5-4,2,2-2.5,2-6,3-5,5-10,5-15,5-6,acuminate,acute,anther,apart,apex,articulated,base,black,branched,brown,calyx,chartaceous,cm,cuneate,deltate,densely,diameter,elliptic,elliptic-ovate,entire,erect,filament,flattened,flower,forked,fruit,glabrescent,glabrous,globose,green,leaf,leaf-opposed,light,lobe,margin,midvein,mm,moderately,pedicel,peduncle,petiole,possibly,pubescent,purple,rachi,red,ripening,rounded,rugulose,shrub,simple,small,spaced,sparsely,stem,strongly,style,surface,tip,tree,usually,white,whitish,x,yellow,yellowish	-5,.1-0.3,0.5,0.8-1,1-3,1-4,1-7,1.5-2,10,2-3,20-50,3-4,4-18,4-5-,5-9,abaxially,absent,accrescent,adaxiall,adaxially,ag,apparently,axe,ba,blade,capitat,center,connivent,covering,curved,cylindrical,denser,directed,distally,eaf,eed,eglandular,equal,frui,fruiting,fused,geminate,gland-tippe,glandular,hair,held,intermediate,lanceolate,large,lateral,like,long,longitudinal,lower,many-foliate,midpoint,much,multangulate,nearly,nflorescence,oblong,opening,orange,orolla,paired,peltate,perfect,pore,pubescence,ray,relatively,ruit,scale,sessile,short,slightly,slit,smaller,sometimes,somewhat,ste,stellate,stigma,straight,subtending,tal,tamen,tem,time,trichome,tube,unit,uprigh,vary,wide,ympodial	abaxial,adaxial,arrangement,branching,characteristic,colour,corolla,form,growth,height,history,inflorescence,length,life,na,ovary,perennial,plant,primary,pseudostipule,seed,shape,staman,tertiary,texture,unarmed,vein,venation
95	wfo-0001026925	success	215	126	102	113	24	0.474	0-20,0-5,0-7,0.5-1.5,0.7-1.8,0.9-1.8,00-200,1-1.3,1-1.4,1-25,1-3.5,1.8-2,1.8-2.5,1/3,2.4-2.6,2.4-3,2.5-6,3-7,4-5,4-7,5-6,5.5-10,6-8,7-12,acute,anther,apex,apparently,articulated,attenuate,base,berry,branched,calyx,chartaceous,cm,cream,dark,deltate,diameter,elliptic,erect,filament,flattened-reniform,fruit,glabrescent,glabrous,green,green-brown,lateral,leaf,length,lobe,lobed,long,long-styled,lower,margin,marking,maturity,mauve,membranous,midvein,mm,moderately,narrow-deltate,orange-brown,ovate,pair,pale,pedicel,peduncle,pendent,per,petiole,plant,prickle,prickly,primary,rarely,red-brown,short-styled,shrub,sparsely,spherical,stellate-pubescent,stem,style,surface,terminal,tertiary,unarmed,unit,upper,vein,venation,visible,white,wide,yellow,yellow-orange,young	-2,.5,/6,0,0-10,0.1,0.1-0.2,0.1-0.3,0.2,0.5-4,1-3,1-4,1.5-2,1.5-2.5,1.5-4.5,1/3-1/2,1/4-2/3,1/6-1/3,2-4,2-5,2/,3-20,4-10,4-14,5-8,5-merous,6-10,6-17,abaxially,acuminat,alyx,ame,andromonoecious,apar,apart,apically,bark,blade,broad-deltate,brow,c.,concolorous,connivent,curved,distal,distance,drying,eaf,eed,elongating,equal,extending,flattened,flower,free,fruiting,gently,hair,hermaphrodite,heterostylous,infructescence,lobing,longer,lowermost,mature,midpoint,minute,nflorescence,oblong,older,one,open,orolla,oung,pendulous,pericarp,plurifoliat,poricidal,porrect,portion,prickl,ray,reduced,reflexed,rounded,ruit,scar,secondary,sessile,side,simple,smooth,sometimes,spaced,spreading,stalk,stalked,staminat,stellate,stout,straight,tamen,tapering,terete,time,tip,translucent,trichome,tube,vary,way,woody,ympodial	0-2,2/3,abaxial,adaxial,arrangement,branching,characteristic,colour,corolla,form,growth,height,history,inflorescence,life,na,ovary,perennial,plurifoliate,seed,shape,staman,sympodial,texture
96	wfo-0001026946	success	205	117	88	117	29	0.429	0-5,0.5-2,1-2,1-4,1.6-3.7,12-23,2,2.5-10.5,3-20,3-5,3.5-10,5-7,8-15,acuminate,acute,anther,apex,attenuate,base,berry,brownish,cell,chartaceous,cm,condition,corolla,covering,creamy,densely,diameter,dot,drying,elliptic,filament,fresh,fruit,glabrous,globose,green,green-white,greenish,hair,hair-like,herb,lateral,like,lobe,long,make,margin,membranous,mm,mottled,mucilaginous,oblique,odd-pinnate,often,ovate,ovoid,pedicel,peduncle,petiole,plant,pubescent,pure,purple,ripe,rounded,scattered,seed,short,short-pubescent,slightly,stem,streak,style,testal,thick,throughout,truncate,typically,unwinged,wall,wet,white,whitish,wing,yellow-white	0-20,0.9-3.5,0.9-4.3,1,1-10,1.5-2,10-39,2-15,2-5,2.7-9,3-6,4-7,4.1-9.4,5-merou,6-24,8-25,abaxially,acumen,adaxially,ag,along,alyx,apart,apparently,articulation,axe,axillary,blade,borne,broadly,bud,capitat,ciliate,clavate,connivent,deeply,digestion,distal,dorsally,eaf,edge,eed,end,enzyme,erec,especially,exceeding,except,extremely,flat,flower,folded,forked,geminat,generally,glabrou,greatly,half,homostylous,honeycomb-shaped,interjected,lanceolate,leaflet,lengthening,living,lower,midrib,minutely,narrowly,nflorescence,orbicular,orolla,pair,pentagonal,perfect,petiolulate,petiolule,plurifoliate,pore,poricidal,proximal,puberulent,pubescen,reduced,removed,ruit,sessile,seudostipule,singly,size,slit,spaced,specimen,stamen,ste,stellate,stigma,stolo,straight,subequal,subtending,tall,tamen,tem,terminal,thir,tip,tri-,tube,tuber,unit,usually,variable,vary,x,yellow,ympodial	abaxial,adaxial,arrangement,branching,calyx,characteristic,colour,form,growth,height,history,inflorescence,leaf,length,life,midvein,na,ovary,primary,pseudostipule,rachi,shape,staman,surface,tertiary,texture,unarmed,vein,venation
97	wfo-0001026962	success	205	112	85	120	27	0.415	.05,0,0.3-0.7,0.8-1,1,1-1.2,1-1.5,1-3,1-4.5,1.5-2,10-12,10-20,15-22,2-2.5,2-6,3-3.5,4-5,6-7,9-12,acute,anther,apex,base,beneath,broadly,calyx,chartaceous,cm,corolla,deflexed,deltate,densely,diameter,difoliate,dry,elliptic,entire,filament,flattened-reniform,flower,fruit,glabrous,globose,green,inflorescence,internodal,leaf,lobe,margin,material,minutely,mm,narrowly,occasionally,pair,pale,pedicel,peduncle,petiole,pitted,prominent,pubescent,purplish,rachi,raised,rounded,shrub,small,sometimes,somewhat,stem,style,surface,tinged,tip,tree,triangular,unarmed,unbranched,unifoliate,vein,white,x,yellow,yellowish	.5,0.5,0.5-0.8,0.5-1,0.5-1.5,1-2,1-6,1.5-17,1.5-3,1.5-5,2-5,2/3-3/4,3-6,9-17,abaxially,abrupt,abruptly,accrescent,adaxially,ag,alyx,anthesi,apparently,appearing,arising,articulated,axe,bark,basebud,becoming,blade,brittle,bud,capitat,cell,closely,composed,connivent,constricted,cucullat,cylindrical,darker,denser,differing,dimorphic,eaf,eed,elongate,evenly,except,exerted,free,fruiting,geminat,glabrate,glabrou,ilament,incrassate,later,lateral,like,lobed,long,longitudinal,main,major,minor,nflorescence,obconic,oblong,obovoid,often,older,one,opening,opposite,orolla,oung,outline,ovate-lanceolate,overlapping,packed,papillose,paten,pendent,perfect,pore,portion,pubescen,reflexed,remaining,rest,rounder,ruit,sagittate,shaped,simple,size,slender,slightly,slit,soon,stellate,stigma,straight,tal,tapering,tear-drop,tooth,trichome,trunk,tube,uniseriate,unit,vary,way,whit,woody,ympodial,young	abaxial,adaxial,arrangement,branching,characteristic,colour,form,geminate,growth,height,history,length,life,midvein,na,ovary,perennial,plant,primary,pseudostipule,seed,shape,staman,tertiary,texture,venation,ye
98	wfo-0001026964	success	128	85	52	76	33	0.406	0.5,0.5-1,10-30,2-2.5,3-5,7-8,acuminate,acute,anther,apex,attenuate,axillary,base,berry,calyx,cm,conical,corolla,diameter,elliptic,filament,filiform,fleshy,glabrous,green,greenish,herb,horizontal,lobe,margin,mm,obovate,ovary,pair,pedicel,petiole,pinnate,primary,pubescent,purple,rachi,shape,simple,slender,sparsely,style,surface,trichome,uniseriate,vein,x,yellow	.2,.5,0,1-1.2,1-2.5,10,2-4,3.5-7,4.5-8.5,?,along,anthesi,basal,beak,bearing,capitat,conspicuously,differentiated,distinct,eaf,edicel,equal,erec,exserted,flower,free,fruiting,glabrou,globose,immature,known,lateral,leaflet,lenticellate,lightly,line,lobed,long,long-attenuate,lower,minutely,nearly,nflorescence,noddin,often,one,onto,open,ot,papillate,petiolule,poricidal,portion,purpli,reflexed,rugose,ruit,scar,side,size,small,smooth,somewhat,stigma,tal,tem,terminal,time,tip,tub,tube,ud,unifoliat,unit,winged,ympodial	1,1.5,3,5,abaxial,adaxial,arrangement,branching,characteristic,colour,form,fruit,growth,height,history,inflorescence,leaf,length,life,midvein,na,nodding,peduncle,plant,pseudostipule,purplish,seed,staman,stem,tertiary,texture,unarmed,venation
99	wfo-0001026981	success	252	122	99	153	23	0.393	-0.8,-2.5,-35,0.05-0.1,0.2-0.4,0.3-0.5,0.5-30,0.6-2,1-2,1-3.3,1.5-2.0,1.8-2.8,1/3,2-3-branched,2-locular,4,6-10,abaxially,absent,adaxially,anther,apex,articulated,articulation,asymmetric,base,becoming,brown,calyx,cell,cm,conical,cordate,corolla,dark,densely,diameter,distal,entire,filament,fruit,glabrescent,glandular,globose,green,hair-like,herb,imparipinnate,interrupted,irregularly,lateral,leaf,like,lime,linear,lobe,lobed,long,margin,maturity,minutely,mm,multicellular,obovate,occasionally,orange,orbicular,outgrowth,ovary,ovate,pale,pedicel,peduncle,perennial,petiole,plant,primary,pseudostipule,pubescent,rachi,rounded,short,simple,sometimes,sparsely,stem,style,surface,tertiary,testa,trichome,uni-,uniseriate,variously,velvety,villous,wall,without,yellow	-0.4,-14,-2,-4,-8,.2,.2-0.2,0-5,0.1-0.2,0.1-0.3,0.15-0.2,0.2,0.2-2,0.25-0.4,0.3.6,0.4-0.5,0.4-0.7,0.4-2,0.45-1.3,0.5,0.5-0.3,0.6-1.4,0.7-0.8,0.8-1.2,0.8-6,0.9-1.4,0.9-1.5,1,1-2-cellular,1-3,1-3-celled,1-4,1.5-5,1.5-8.5,11,196.,2-3,3-foliate,3.5-14,4-8,4-celled,7.5,<,absen,abundant,academy,accrescent,acute,adpressed,along,amongst,angled,anthesi,apical,appearance,appendage,appressed,axi,basiscopically,bay,beak,bract,bracteole-like,capitate,citrus-like,coastal,column,composed,cone,d,deltate,eaf,ebracteate,edicel,eed,erect,exserted,flower,fruiting,giving,gree,half,halfway,head,included,initially,interjected,internode,jointles,larger,later,leaflet,less,lon,lower,mainly,mixed,much,narrowly,nflorescence,pair,patent,pentagonal,per,petiolule,population,present,procumbent,pronounced,proximal,pubescence,reflexed,rick,robust,ruit,scen,secondary,see,sessile,several,shaggy,shaped,shorter,silky,slender,smaller,sparser,specimen,spreadin,staminal,sterile,stigma,straight,strong,tangled,tem,terminal,thick,tightly,transparent,tub,tube,type,unicellular,unit,upto,usually,viny,wide,winged,ympodial,â,â	0.3-0.6,abaxial,adaxial,arrangement,branching,characteristic,colour,form,growth,height,history,inflorescence,length,life,midvein,na,seed,shape,staman,texture,unarmed,vein,venation
100	wfo-0001026992	success	243	121	99	144	22	0.407	0.2-0.5,0.25-0.45,0.5-1.2,0.6-1.5,1-4,1.2-1.7,1.3-2.6,1.3-4.3,1.4-1.6,1.4-1.9,1.7-2.4,1.7-4.3,10-12,2-10,2.8-4.7,3-4,3.3-5.6,5.3-12.1,6-10,8,8-11,abaxial,abaxially,abruptly,acuminate,acute,adaxially,along,anther,apex,articulated,attenuate,base,berry,branched,broadly,brown,calyx,cm,corolla,deltoid,diameter,elliptic,entire,filament,fleshy,flower,fruit,glabrous,granular-tomentose,greenish,hair,lance-ovate,leaf,length,lobe,lower,many,margin,midrib,mm,moderately,occasional,orange-tan,ovate,pedicel,peduncle,petiole,plant,pubescent,rachi,reniform,reticulate-punctate,ripe,scabridulous-,semi-ovate,short,shrub,side,simple,small,sometimes,stellate,stem,style,surface,terminal,time,tomentose,tree,unarmed,vein,velutinous,violet,white,x,yellow,yellowish,Â½	-2.5,/7,0.8-3.4,00-170,1.2-1.4,1.5-3.4,1.7-1.9,1/2,12-33,2-5.6,2.3-3.3,2.6-4.6,2.8-4.6,3.3-5.5,4-8,5-15,5-merou,8-14,accrescent,adaxiall,ag,alyx,angled,anthesi,apart,apparently,appressed,approximately,around,axe,axillary,ba,bark,blade,blunt-tipped,branch,capitat,chartaceous,completely,coriaceous,covering,crown,cylindrical,dark,densely,directed,distally,drying,eaf,echinoi,echinoid,edge,eed,enveloping,equal,evident,exserted,farinose,flat-topped,forming,free,fruiting,geminate,glabrescen,globose,grooved,high,homostylous,immature,inserted,lacking,lanceolate,lateral,lengthening,less,line,lobed,long,long-stalked,longitudinal,longitudinally,m.,main,mature,maturity,minute,mostly,multangulate,nearly,nflorescence,oblong,obtuse,occasionally,often,older,orolla,ovate-lanceolate,overlapping,perfect,plurifoliate,pore,poricidal,porrect-stellate,pubescence,rare,rather,ruit,runk,sessile,short-,short-stalked,shorter,size,slit,somewhat,spaced,sparingly,split,spreading,stalked,stamen,stigma,stout-stalked,subcampanulate,subglobose,suture,tamen,tan,terete,thin-textured,tip,tube,ud,unarme,unequal,unit,usually,vary,way,weakly,whitish,wide,ympodial,young	adaxial,arrangement,branching,characteristic,colour,form,growth,height,history,inflorescence,life,midvein,na,ovary,primary,pseudostipule,seed,shape,sparing,staman,texture,ye
101	wfo-0001026994	success	266	126	104	162	22	0.391	-0.7,-30,0.05-0.1,0.4-0.5,0.5,0.5-0.6,0.5-0.7,0.5-0.8,0.5-0.9,0.5-2,1,1-1.4,1-1.5,1-1.6,1.2-1.6,2-2.6,2-5-locular,2.2-3.2,4,4-15,6-20,8-12,acuminate,acute,anther,apex,articulate,basal,base,beneath,bifurcate,branched,bright,broadly,brown,calyx,cell,cm,corolla,crenate,dark,darker,deeply,densely,diameter,distal,elliptic,filament,fruit,glabrous,globose,grayish,green,greenish,hair-like,half,herb,imparipinnate,inflorescence,interrupted,irregularly,lanceolate,lateral,leaf,less,lobe,lobed,locule,long,margin,medial,midvein,minutely,mm,narrowly,obovate,outgrowth,ovary,paler,pedicel,peduncle,perennial,petiole,primary,pseudostipule,puberulent,pubescent,purple,rachi,regularly,ripe,stem,stripe,style,surface,tertiary,testa,thick,usually,velvety,wall,white,wide,yellow	-10,-20,-foliate,.2,.5,0.05-0.2,0.1,0.1-0.2,0.1-0.3,0.15-0.2,0.2-0.4,0.2-0.5,0.25,0.3-0.4,0.4-1.2,0.5-1.2,0.5-1.3,0.7-2.5,0.9-1.2,0.9-1.3,1-1.2,1-2,1.2-3.5,1.4-2.1,10-20,12-,2,2-,2-4,2.5-6.5,20-50,3,3-branched,4-celled,5,5-,5-7,7-13,8,abaxially,absent,abundant,acroscopically,additional,adpressed,along,also,amongst,andscattered,anthesi,apical,apically,appearance,appendage,articulation,basally,basiscopically,becoming,bent,berry,bifurcation,bract,bracteate,broader,capitate,celled,column,conical,crenat,crowded,decreasing,decumbent,decurrent,developed,eaf,ebracteate,edicel,eed,eglandular,erect,especially,essentially,exserted,fewer,flower,fruiting,giving,glandular,gree,habitat,hal,halfway,head,interjected,internode,investing,lamina,large,larger,largest,leaflet,leave,like,lon,loosely,lower,markedly,moderately,much,narrower,narrowing,nearly,nflorescence,node,oblique,occasionally,often,pair,papillate,petiolule,present,rarely,reflexed,robust,rocky,rotate-stellate,secondary,sessile,set,shaggy,short,silky,simple,sinus,size,slightly,sometimes,sparsely,specimen,spreadin,spreading,staminal,sterile,stigma,straight,tall,tem,terminal,tip,toward,trichome,tube,ud,unicellular,uniseriate,unit,weak-walled,well,winged,woody,ympodial,young	abaxial,adaxial,arrangement,branching,characteristic,colour,decurren,form,growth,height,history,length,life,na,plant,seed,shape,staman,texture,unarmed,vein,venation
102	wfo-0001026996	success	188	94	71	117	23	0.378	0.6-1,1-2,1.2-1.8,1.8-4.4,14-33,15-28,2-3,3-10,3-7,3.3-6,4-8,5-8,6-8,acumen,anther,axillary,berry,blue,brownish,bud,cm,condition,coriaceous,corolla,dark,deep,diameter,distal,drying,elliptic,filament,flower,forked,fresh,fruit,generally,glabrous,globose,green,green-white,greenish,half,herb,lanceolate,leaf,lilac,lobe,long,medium,mm,mottled,mucilaginous,odd-pinnate,ovate,ovoid,pedicel,peduncle,plant,purple,ripe,seed,stripe,style,subtending,terminal,throughout,unwinged,usually,wet,white,whitish	0-6,0.9-2.7,1-3,1-4,1-5,1.3-7.7,3-5,3.8-14.1,4-4.4,4.5-10.5,5-merou,6.9-10.9,8.7-18.6,abaxiall,abaxially,acuminate,acute,adaxially,ag,along,alyx,apart,apex,apparently,arranged,articulated,asymmetric,attenuate,axe,base,basiscopic,bead,blade,capitat,cell,clavate,connivent,considerably,covering,decreasing,digestion,dorsally,eaf,edge,eed,enzyme,erec,exceeding,flat,folded,geminat,glabrou,hair-like,homostylous,honeycomb-shaped,interjected,larger,lateral,leaflet,lengthening,like,linear,living,lower,make,middl,moniliform,multiple,necklace,nflorescence,orbicular,orolla,pair,pentagonal,perfect,petiole,petiolulate,plurifoliate,pore,poricidal,removed,rotate,rounded,ruit,sessile,seudostipule,side,size,slightly,slit,sometimes,spaced,specimen,stamen,stigma,stolon,straight,subglabrou,symmetric,tall,tamen,tem,testal,thick,tip,tissue,toward,tri-,tube,tuber,typically,unit,vary,wall,x,yellow,ympodial	2,abaxial,adaxial,arrangement,calyx,characteristic,colour,form,growth,height,history,inflorescence,length,life,ovary,perennial,pseudostipule,shape,staman,stem,subglabrous,surface,texture
103	wfo-0001027010	success	198	105	73	125	32	0.369	0.4-5.1,0.5-1.5,1-10,1-2,1.2-1.9,14-46,2.1-4.3,2.2-12.9,3-10,3-8,4-8,5-13,5-14,acuminate,acute,anther,apex,articulated,attenuate,base,brownish,cell,cm,condition,coriaceous,corolla,covering,deep,diameter,distal,drying,elliptic,filament,fresh,fruit,glabrescent,glabrous,green,greenish,hair,hair-like,half,herb,high,lanceolate,lateral,leaf,light,lobe,long,mm,odd-pinnate,ovate,ovoid,pedicel,peduncle,petiole,petiolulate,plant,purple,rounded,scabrous,seed,sessile,short,stripe,style,testal,thick,usually,wall,white,whitish	0-2,0-2.5,0-3,1-4,1-7,1.2-1.7,1.4-6.9,10-60,2-6,2-9.4,2.1-15.3,3-5,3-6,3.5-13.6,4-12,4.4-29,4.9-31,5-merou,abaxially,acumen,adaxiall,adaxially,ag,along,alyx,apart,apparently,arranged,asymmetric,axe,axillary,basiscopic,bead,blade,bud,capitat,clavate,coloration,connivent,decreasing,digestion,dorsally,eaf,edge,eed,enzyme,erec,exceeding,flat,flower,folded,forked,geminat,generally,glabrescen,glabrou,green-white,hal,homostylous,honeycomb-shaped,interjected,larger,leaflet,lengthening,like,living,lower,make,moniliform,mucilaginous,multiple,narrow,necklace,nflorescence,occasionally,orbicular,orolla,pair,pentagonal,perfect,plurifoliate,pore,poricidal,present,removed,ripe,rotate,ruit,scabrou,seudostipule,side,size,slightly,slit,sometimes,spaced,specimen,spot,stamen,stigma,stolon,straight,subequal,subtending,tall,tamen,tem,terminal,throughout,tip,tissue,toward,tri-,tube,tuber,typically,unit,vary,wet,wide,wing,winged,x,yellow,ympodial	2,abaxial,adaxial,arrangement,branching,calyx,characteristic,colour,form,growth,height,history,inflorescence,length,life,margin,midvein,na,ovary,perennial,primary,pseudostipule,rachi,shape,staman,stem,surface,tertiary,texture,unarmed,vein,venation
104	wfo-0001027019	success	142	91	62	80	29	0.437	0-0.5,1-1.5,1-2,1.5-2,1.5-3,10,10-40-flowered,2-3,2-8,4-5,abaxial,acute,anther,apex,attenuate,base,berry,branched,calyx,cm,corolla,deflexed,deltoid,densely,erect,filament,flattened,glabrate,glabrous,globose,golden,green,inflorescence,leaf,lobe,long,minutely,mm,obovate,onto,opposite,ovary,ovoid-reniform,pale,pedicel,petiole,pitted,plant,pubescent,shrub,small,somewhat,sparsely,stem,style,surface,tan,tapering,tree,white,winged,x	.5,/4,0.5-1,1/2,12-30,2-5,4-8.5,7-14,abaxially,abruptly,adaxially,along,anthesi,apparent,ba,bark,bright,capitate,constriction,cyathiform,dia,difoliate,distal,eaf,edicel,eed,ellipsoid,elliptic,even,exserted,fleshy,free,fruiting,geminat,inflorescenc,largely,later,like,live,lobed,lon,lower,major,midrib,minor,narrowed,nflorescence,older,overlapping,papillo,papillose,planar,pore,poricidal,portion,reddish-brow,rest,ruit,scar,shaped,spaced,stigma,straight,strongly,tall,tear-drop,third,tip,trichome,tub,tube,ud,unit,waxy,way,widest,wing,woody,ympodial,young	adaxial,arrangement,branching,characteristic,colour,diameter,form,fruit,growth,height,history,length,life,margin,midvein,na,peduncle,primary,pseudostipule,rachi,reddish-brown,seed,shape,staman,tertiary,texture,unarmed,vein,venation
105	wfo-0001027030	success	234	110	88	146	22	0.376	-11,.5,0.05-0.1,0.3-0.5,0.4-0.5,0.5-0.7,0.5-1,0.6-0.7,0.7-1,0.8-0.9,1,1-,1-1.3,1-3,1.6-2,2-4,2-locular,2.2-3.2,abaxial,acute,anther,apex,articulated,base,branched,bright,brown,calyx,cm,corolla,crenate,dark,decurrent,deeply,densely,denser,diameter,distal,elliptic,entire,evenly,filament,fruit,globose,grayish,green,half,imparipinnate,inflorescence,interrupted,lanceolate,like,lobe,margin,minutely,mm,narrowly,oblique,obovate,ovary,pale,paler,papillate,pedicel,peduncle,perennial,petiole,primary,pseudostipule,pubescent,silky,simple,soft,sometimes,sparsely,spread,spreading,stem,style,surface,tall,tertiary,trailing,truncate,vein,velvety,white,yellow	-15,.2,0-4,0.1-0.7,0.1-0.9,0.15-0.2,0.2,0.2-0.3,0.2-1,0.3-,0.3-0.7,0.4-0.8,0.4-1.5,0.5,0.5-,0.5-0.8,0.6-0.8,0.6-1.8,0.8-1,0.9-1.1,1-1.2,1-3.4,1.2-1.6,1.5-,2-,2-3,2-4.8,2-6,2-7,2-foliate,3-4-celled,3-8,3-9,4-celled,5-12,8-celled,abaxially,absent,abundant,acuminate,adaxially,adpressed,angled,anthesi,apical,appearance,appendage,articulation,axi,basal,basiscopically,beneath,berry,beyond,bract,capitate,cell,column,conical,crenat,crenation,darker,deeper,diamete,due,eaf,edicel,eed,eglandular,exserted,extremely,flower,fruiting,giving,gland,glandular,gree,growt,hair-like,hal,halfway,herb,interjected,internode,interspersed,investing,irregularly,lamina,larger,lateral,leaflet,less,lon,long,longer,loosely,lower,multicellular,near,nflorescence,node,occasionally,often,outgrowth,pair,petiolule,present,pubescence,reflexed,robust,rotate-stellate,ruit,secondary,sessile,similar,size,slender,slightly,small,smaller,somewhat,spreadin,staminal,sterile,stigma,straight,stripe,tem,terminal,testa,thick,tiny,trichome,tube,ud,unicellular,uniseriate,unit,usually,wall,weak,wide,winged,woody,ympodial,young	adaxial,arrangement,branching,characteristic,colour,form,growth,height,history,leaf,length,life,midvein,na,plant,rachi,seed,shape,staman,texture,unarmed,venation
106	wfo-0001027035	invalid_json	199	131	94	105	37	0.472	0.1-0.9,0.3-2.3,0.4-12.8,0.5-7,1-2,1-3.4,1-8,1.8-5.2,10-80,3-10,3-5,4-18,acuminate,acute,anther,apart,apex,articulated,attenuate,axillary,base,blue,brownish,bud,cell,cm,coloration,completely,condition,corolla,covering,deep,diameter,distal,drying,elliptic,filament,forked,fresh,fruit,generally,glabrescent,glabrous,globose,green,green-white,greenish,hair,hair-like,half,herb,high,lanceolate,lateral,leaf,light,lilac,lobe,long,make,medium,mm,mucilaginous,odd-pinnate,ovate,ovoid,pedicel,peduncle,petiole,petiolulate,plant,purple,ripe,rounded,seed,sessile,shape,short,sometimes,spaced,stripe,style,subglabrous,subtending,terminal,testal,thick,throughout,usually,variable,wall,wet,white,whitish	0-36,0-7,0.5-3.4,0.5-5,0.8-3,0.8-4.2,0.9-3.1,1-3,1.5-5.9,1.7-8,2-38,2-7,2.8-10.3,4-18.5,4.9-23.5,5-merou,abaxially,acumen,adaxiall,adaxially,ag,along,alyx,apparently,arranged,asymmetric,axe,basiscopic,bead,blade,capitat,clavate,connivent,decreasing,digestion,dorsally,eaf,edge,eed,enzyme,erec,exceeding,flat,flower,folded,geminat,glabrescen,glabrou,hal,homostylous,honeycomb,interjected,larger,leaflet,lengthening,like,living,lower,moniliform,multiple,necklace,nflorescence,orbicular,orolla,pair,pentagonal,perfect,plurifoliate,pore,poricidal,present,removed,rotate,ruit,second,seudostipule,shaped,side,size,slightly,slit,smaller,specimen,stamen,stigma,stolon,straight,subequal,tall,tamen,tem,tip,tissue,toward,tri-,tube,tuber,typically,unit,unwinged,vary,wide,x,yellow,ympodial	'',2,[,``,abaxial,adaxial,arrangement,branching,calyx,characteristic,colour,form,growth,height,history,inflorescence,length,life,margin,midvein,na,ovary,perennial,primary,pseudostipule,rachi,staman,stem,surface,tertiary,texture,unarmed,value,vein,venation,{,}
107	wfo-0001027050	success	244	119	96	148	23	0.393	-12,-9,0.3-1.5,0.5-3,1-1.5,1-2,1.5-6,10-13.5,2-2.5,2-5,2-8,2.5-3,3-5,5-10,5-9,7-30+,abaxial,acuminate,acute,adaxial,anther,apex,base,berry,branched,broadly,brown,calyx,chartaceous,cm,coarsely,conical,cordate,cuneate,densely,diameter,drying,elliptic,entire,ferruginous,filament,flattened-reniform,fruit,glabrous,glandular-puberulent,green,growth,inflorescence,infructescence,lanceolate,lateral,leaf,leaf-opposed,length,lobe,lobed,long,margin,midvein,mm,moderately,narrowly,numerous,obtuse,often,ovate,pale,pedicel,peduncle,per,petiole,plant,pubescent,ripe,rounded,several,shallowly,shrub,small,spherical,stellate-pubescent,stem,style,surface,time,toothed,tree,triangular,truncate,unarmed,unbranched,white,whitish,wide,yellow,yellowish-green	.2,.5,/3,0-0.2,0-3,0.1-0.3,0.1-3,0.2-0.5,0.2-1,0.8,0.9-2.1,1,1.5-2,12-15,15-50+,2-3,2-4,4-20,4-8,5,5-6,5-7,5-merous,50,6-8,8-26,abaxially,absen,absent,abundant,adaxiall,adult,alyx,andromonoeciou,apar,arme,articulated,axe,bark,basal,blade,branch,broad,broad-based,brow,capitate,closely,connivent,curved,deeply,difoliate,directed,distal,distall,distally,eaf,eed,eglandular,equal,erec,erect,except,flattened,flower,free,fruiting,geminat,hair,half,heterostylous,inside,interpetalar,juicy,juvenile,larger,least,less,like,long-styled,longer,lower,markedly,mature,mid-way,midpoint,midrib,minute,minutely,moist,mucilaginous,multiseriate,near,nflorescence,oblique,occasionally,older,orolla,oung,ovate-lanceolate,papillat,pericarp,pore,poricidal,porrect,portion,present,prickle,pricklier,prickly,ray,rest,ruit,scar,scattered,secondary,sessile,shiny,short-stalked,short-styled,shorter,side,slightly,somewhat,spaced,sparsely,stalk,stalked,stellate,stigma,straight,tall,tamen,terete,thicker,tip,tissue,touching,trichome,tube,unit,usually,vary,way,weakly,woody,ympodial,young,younger	armed,arrangement,branching,characteristic,colour,corolla,form,height,history,life,na,ovary,perennial,primary,pseudostipule,rachi,seed,shape,staman,tertiary,texture,vein,venation
108	wfo-0001027050	success	234	134	111	123	23	0.474	0.5-1,0.5-3,1-1.5,1-2,1-5,1.5-2,1.5-6,10-13.5,11-21,14-20,2-10,2-2.5,2-3,2-3-locular,2-5,2-8,2.5-3,3-15,3-5,5,5-10,5-9,7-30+,acuminate,acute,anther,apart,apex,armed,articulated,base,branched,broadly,brown,calyx,chartaceous,cm,coarsely,contiguous,cordate,cuneate,densely,diameter,distally,drying,elliptic,entire,extra-axillary,ferruginous,filament,flattened,flower,forked,fruit,glabrous,glandular-puberulent,globose,green,growth,hair,inflorescence,lanceolate,leaf,leaf-opposed,length,like,lobe,lobed,margin,markedly,midvein,minutely,mm,moderately,narrowly,nearly,oblique,obtuse,often,ovate,pale,pedicel,peduncle,per,petiole,pitted,plant,rachi,rounded,shallowly,shrub,simple,small,spaced,stellate-pubescent,stem,style,surface,thicker,toothed,tree,triangular,truncate,unarmed,unbranched,usually,white,whitish,x,yellow,yellowish-green	.2,0-0.2,0-0.5,0-1,0-3,0.1-3,0.2-0.6,0.2-1,0.3-0.6,0.4-1,0.5-0.8,0.8,10-30,12-15,15-50+,16-40,2-4,2-6,2-foliate,23-40+,4-19,4-40,4-8,5-6,5-7,5-merous,6-8,8-26,8-40+,abaxially,absen,absent,abundant,accrescent,across,adaxiall,adaxially,adult,andromonoecious,anvil-shape,axe,ba,blade,branche,broad-based,capitat,connivent,cross-section,curved,cylindrical,deeply,directed,distall,distributed,eaf,eed,eglandular,erect,except,exocarp,fruiting,functional,geminat,half,held,interpetalar,juicy,juvenile,lateral,less,long,longer,lower,mature,mesocarp,midpoint,minute,moist,mucilaginous,multiseriate,nflorescence,orolla,ovate-lanceolate,pair,pinnatifid,placenta,pore,porrect,present,prickle,ray,ruit,scattered,sessile,shorter,side,slightly,somewhat,sparsely,stalk,stalked,stellae,stellate,stigma,straight,tal,tamen,tem,thick,throughout,time,tip,tissue,tube,unarme,unit,upper,upright,vary,weakly,wide,ympodial,younger	abaxial,adaxial,arrangement,branching,characteristic,colour,corolla,form,height,history,life,na,ovary,perennial,primary,pseudostipule,seed,shape,staman,tertiary,texture,vein,venation
109	wfo-0001027091	success	142	124	89	53	35	0.627	.3,0.7,1-1.6,1.1-1.6,1.8-2.6,1/2-2/3,2.3-2.9,2.5-3.5,3-8,3-9,5-11,6-10,8.5-11.5,9-13,acute-tipped,along,annual,anther,armed,base,berry,blade,blue,branched,bristly,broadly,brown,calyx,capitate-glandular,cm,dark,densely,developing,dm,extended,few-rayed,fully,glabrous,gland,glandular,green,hair,herb,internodal,invested,lenticular,linear-lanceolate,lobe,long,longer,low,main,mm,mostly,near,occasionally,oriented,ovate,pedicel,petiole,pinnatifid,pinnatisect,prickly,radially,reticulately,ridge,scattered,sessile,short-stipitate,simple,sometimes,sparsely,spherical,spreadingly,stellae,stem,strait,surface,tightly,tube,twice,undulate,uniseriate,usually,variously,vein,vestiture,violet,wrinkled	0.8,30-60,4-10,6-10-flowere,accrescent,across,alyx,anthesi,arcuate,beneath,campanulate,cauline,deltoid,dia,difoliate,divided,dry,eaf,eed,enveloped,geminat,high,lon,maturity,narrowly,nflorescence,obtuse,orolla,per,rounded,ruit,short,slende,somewhat,splitting,ste,stellate-pentagonal,suffused,tamen,tapering,taprooted,terete,terminally,tigma,tub,tyle,unexpande,unit,vary,wholly,yello,ympodial,younger	6-10-flowered,abaxial,adaxial,apex,arrangement,branching,characteristic,colour,corolla,diameter,filament,form,fruit,growth,height,history,inflorescence,leaf,length,life,margin,na,ovary,peduncle,plant,pseudostipule,rachi,seed,shape,slender,staman,style,texture,unarmed,various
110	wfo-0001027102	success	167	119	88	79	31	0.527	.5,0.2-2,0.5-1,0.5-2,1-1.5,1-2,1-2.5,1-4,1-6,1.5-2,10-20,15-35,2-3,3,3-4,4-5,4-7,abaxially,acuman,acuminate,acute,adaxial,adaxially,almost,anther,apart,apex,articulated,base,broadly,calyx,ciliate,cm,congested,cuneate,curved,cylindrical,deltate,densely,diameter,elliptic,entire,filament,flattened,flower,forked,fruit,glabrous,globose,hair,lanceolate,leaf,leaf-opposed,lobe,long-tapered,margin,mm,moderately,narrowly,obtuse,orange,pedicel,peduncle,petiole,pubescent,rachi,rarely,ripe,rugulose,short,shrub,simple,slender,small,somewhat,spaced,sparsely,stem,straight,style,surface,tip,tomentose,truncate,unbranched,white,x,yellow-brown	.5-6,0.5,0.5-3,1-3,15,2-2.5,3-12,3-5,5-12,<,absen,absent,accrescent,adaxiall,ag,aggregate,alyx,appearance,axe,ba,blade,broad,cell,channe,chartaceous,connivent,corky,differing,difoliate,dimorphic,directed,distally,eaf,eed,few-,free,fruiting,geminat,giving,ilament,long,longitudinal,m.,major,minor,multiseriate,nflorescence,oblong,often,one,opening,orolla,ovate,per,perfect,pore,portion,roughened,ruit,size,slit,stellate,stigma,stone,subcoriaceous,tal,tem,time,triangular,truncat,tube,unarme,unit,usually,vary,wide,yellow,ympodial,young	abaxial,arrangement,branching,channel,characteristic,colour,corolla,form,green,growth,height,history,inflorescence,length,life,midvein,na,ovary,perennial,plant,primary,pseudostipule,seed,shape,staman,tertiary,texture,unarmed,vein,venation,ye
111	wfo-0001027104	success	141	98	63	78	35	0.447	0.15-0.35,1-1.5,1-3,1-4,1.2-6,1.5-2.3,10-15,2-3,2.2-5,3-5.5,5-15,6-7.5,acuminate,acute,apex,articulate,attenuate,base,branched,calyx,cell,cm,cordate,corolla,covering,cyme,diameter,dichasial,dichasially,ebracteate,filament,finely,globose,green,green-white,hair-like,herbaceous,lateral,lobe,long,mm,monochasial,mucilaginous,mucronate,odd-pinnate,ovate,ovoid,pedicel,peduncle,perennial,petiole,plant,pubescent,seed,style,testal,thick,throughout,tone,truncate,wall,white,yellow-green	0.5-0.8,1.5-4.2,2-6,3-6-foliat,4-15,abaxially,acumen,adaxially,apical,apically,condition,connate,dehiscent,digestion,distal,dorsally,eaf,edge,eed,emoval,enzyme,epiphyti,epiphytic-like,exceeding,flat,flower,folded,forked,generally,globo,growing,half,honeycomb,introrse,linear,living,lon,lower,make,maturing,mos,narrowly,nflorescence,nther,often,orolla,ovat,pattern,perfect,plan,poricidally,proximal,rarely,reveal,ruit,seudostipule,short,simple,slit,specimen,stamen,stellate,stigma,straight,tall,tem,terrestrial,throughou,tuber-bearing,typically,unit,vary,viole,wide,without,yellow,ympodial,Â¼	2,abaxial,adaxial,anther,arrangement,branching,characteristic,colour,form,fruit,growth,height,history,inflorescence,leaf,length,life,margin,midvein,na,ovary,primary,pseudostipule,rachi,shape,staman,stem,surface,tertiary,texture,unarmed,vein,venation,violet,wet
112	wfo-0001027114	success	154	84	54	100	30	0.351	-2,0.5-1,1-1.1,1-1.2,1-1.5,1.5-2,2-3,3-4,3-7,6-8,7-9,abaxial,acute,anther,apex,appearing,base,berry,branched,calyx,cm,corolla,dark,deltate,densely,elliptic,filament,glabrous,globose,green,inflorescence,leaf,lobe,many,margin,minutely,mm,opposite,ovary,pair,pedicel,petiole,pitted,pubescent,reddish,reddish-brown,shoot-terminal,shrub,stem,style,surface,time,vein,white	-17,-30,.5,1-2,1.5-1.7,1/2,13-21,2-2.5,20-40,5,6-9,7-10,abaxially,adaxially,along,alternating,anthesi,apar,axillary,ba,bark,bushy,capitate,closely,commonly,conical,dendritic,dia,differing,difoliate,drying,due,eaf,edicel,eed,erect,exserted,flattened-reniform,flowered,free,fruiting,geminate,glabrou,growt,halfway,inflorescenc,investing,lamina,lateral,like,lobed,lon,long,lower,main,major,minor,minute,nflorescence,occasionally,older,opening,papillo,planar,plurifoliate,pore,poricidal,portion,projection,rapid,rest,ruit,scar,scattered,several,shoot,simple,size,slit,soft,spaced,stigma,tall,tapering,thickened,tip,triangular,trichome,tub,tube,ud,unevenly,uniseriate,unit,way,wide,woody,yellowish,ympodial,young	0.5,adaxial,alternate,arrangement,branching,characteristic,colour,diameter,form,fruit,growth,height,history,length,life,midvein,na,peduncle,perennial,plant,primary,pseudostipule,rachi,seed,shape,staman,tertiary,texture,unarmed,venation
113	wfo-0001027117	success	235	115	89	146	26	0.379	-12,0-25,0-5,0.1-0.7,0.6-0.9,0.7-1.3,0.7-1.5,1-2,1.5-2.3,1/3,2-3,2.3-2.8,4-6.5,4-8,4.5-6.5,5-11,acute,almost,anther,apex,articulated,attenuate,base,berry,black,branched,brown,calyx,cell,chartaceous,cm,cordate,dark,densely,diameter,erect,evenly,filament,fine,fruit,glabrous,green,herb,lateral,leaf,length,lobe,lobed,lower,margin,maturity,mauve,midvein,mm,moderately,narrow-deltate,narrow-lanceolate,outline,ovate,pair,pale,pedicel,peduncle,per,petiole,pit,prickly,primary,raised,rounded,shallowly,small,smooth,sparsely,spherical,staman,stellate-pubescent,stem,style,surface,tertiary,unit,upper,vein,venation,visible,yellow,yellow-green,young	-1.5,-11,-2.8,-3/4,.5,/3,0-10,0-15,0-20,0-40,0.1,0.1-,0.15-0.25,0.15-0.35,0.2,0.2-0.45,0.5,0.5-1.5,0.7-0.9,0.8-,1-4,1-6,1.2,1.5-,1.5-6.5,1.7-2.5,1.8-2.5,1/,1/4,1/8-1/2,10-20,2-6,2-8,25-100,3-10,3-15,3-6,4-7,4.5-8,5-14,5-merous,6-10,6-9,7-,8,abaxially,accrescent,acicular,alyx,ame,apar,apart,apically,apparently,bark,beyond,blade,brittle,c.,concolorous,connivent,curved,deltate,discolorous,distance,drying,eaf,eed,elongating,enclosing,extending,fifth,flattened-reniform,flower,four,free,fruiting,gently,glabrescent,gra,herbarium,infructescence,irregularly,less,lon,long,long-acuminat,longer,mature,membranous,midpoint,narrow-elliptic,nflorescence,oblong,obovate,older,one,open,orolla,oung,pendulous,perfec,pericarp,perpendicular,plurifoliat,poricidal,porrect,portion,prickl,prickle,ray,red-brown,reduced,reflexed,ruit,scar,sessile,shiny,shorter,side,sometimes,spaced,specimen,spreading,stalk,stalked,stellate,straight,tamen,tapering,tearing,terete,time,tip,tissue,translucent,trichome,tube,unequal,variously,vary,way,weakly,wide,woody,ympodial	1.5-2.5,abaxial,adaxial,arrangement,branching,characteristic,colour,corolla,form,growth,height,history,inflorescence,life,na,ovary,perennial,plant,plurifoliate,pseudostipule,rachi,seed,shape,sympodial,texture,unarmed
114	wfo-0001027123	success	181	112	89	92	23	0.492	-10,.3,0.8-1.3,1,1-1.2,1-1.5,1.5-2,2-2.6,2-5.5,2.5-4,2.5-6,3-4,4-5,4-6,5-10,5-6,abaxial,acute,adaxial,adaxially,anther,apex,attenuate,base,branched,broadly,brown,calyx,cell,cm,commonly,conical,corolla,dark,deltate,densely,diameter,elliptic,filament,flattened,glabrous,inflorescence,leaf,less,lobe,long,loosely,margin,mauve-purple,midvein,minute,minutely,mm,narrowly,nodding,outline,ovary,pair,papillate,pedicel,peduncle,petiole,pitted,primary,pubescent,reddish,reniform,revolute,scattered,shining,shiny,simple,sinuate,sparsely,stem,stoutish,strongly,style,subshrub,surface,terminal,testal,time,trichome,turned,vein,violet,white,x	-20,.5,0.3-1.6cm,0.5,0.5-0.8,0.7-3.5,0.9-1.3,2-2.2,2-2.5,2-3,2-lobed,2.5-10.4,3-15,along,anthesi,appearing,axe,axi,bark,bright,campanulate,clavate,completely,constricted,coriaceous,cup-shaped,darker,dendritic,denser,drying,eaf,edge,eed,enlarged,erect,exerted,fide,flower,free,fruiting,glandular,globose,green,inserted,lamina,lax,lewi,like,lobed,lon,loose,lower,monopodia,nflorescence,older,papillae,perfect,perhaps,petal,planar,plurifoliate,portion,prominent,scar,scatted,shin,shinin,short,sleeve,slightly,sometimes,soon,spaced,stellate,stigma,straight,thick,tip,trailing,tub,tube,ud,unit,upper,usually,warty,way,widely,wood,ympodial,young,Â¾	0.3-1.6,arrangement,branching,characteristic,colour,form,fruit,growth,height,history,length,life,na,plant,pseudostipule,rachi,seed,shape,staman,tertiary,texture,unarmed,venation
115	wfo-0001027146	success	213	137	108	105	29	0.507	0.3-2.2,0.7-2.4,1-10,1-2,1-2.5,1-9.5,10,13-36,2-13,2-4.2,3.3-6.1,4-11,4-12.5,4-38,4-8,6,6-10,6-17.5,abaxially,acuminate,adaxially,anther,apart,apex,articulated,attenuate,axillary,base,berry,brownish,bud,cell,chartaceous,cm,coarsely,condition,conical,corolla,covering,dark,deep,diameter,distal,drying,elliptic,filament,finely,flower,forked,fourth,fresh,fruit,generally,glabrous,green,green-white,greenish,hair,hair-like,half,herb,lateral,leaf,like,lobe,long,make,margin,medium,membranous,minute,mm,mottled,mucilaginous,odd-pinnate,ovate,ovoid,pedicel,peduncle,petiole,petiolule,plant,proximal,puberulent,pubescent,purple,ripe,seed,simple,spaced,stem,style,subglabrous,subsessile,subtending,terminal,testal,thick,throughout,tinged,usually,violet,wall,wet,white,whitish,wide,x	0-11,0.5-3.2,0.6-3.3,0.8,0.8-3.1,0.8-5.8,1.9-10,2-12.2,2-5,3.5-22,5-merou,6.5-52,acumen,ag,along,alyx,apparently,arranged,asymmetrical,axe,basiscopic,bead,blade,capitat,ciliate,clavate,commonly,connivent,darker,decreasing,digestion,dorsally,eaf,edge,eed,enzyme,erec,especially,exceeding,flat,folded,fourt,geminat,glabrou,gradually,homostylous,honeycomb-shaped,interjected,lanceolate,leaflet,lengthening,living,lower,midrib,minutely,moniliform,multiple,necklace,nflorescence,orbicular,orolla,pair,pentagonal,perfect,plurifoliate,pore,poricidal,rarely,ray,removed,rotate,ruit,secondary,semierect,sessile,seudostipule,side,size,slit,sometimes,specimen,stamen,ste,stigma,stolon,straight,subequal,subglabrou,symmetrical,tall,tamen,tem,tip,tissue,toward,tri-,tube,tuber,typically,unit,unwinged,vary,wing,yellow,ympodial	abaxial,adaxial,arrangement,branching,calyx,characteristic,colour,form,growth,height,history,inflorescence,length,life,midvein,na,ovary,perennial,primary,pseudostipule,rachi,shape,staman,surface,tertiary,texture,unarmed,vein,venation
116	wfo-0001027157	invalid_json	207	104	68	139	36	0.329	0.15-0.3,0.9-2.8,1,1-2,1-3,1-6,1.5-6.5,10-30,2,2-2.5,2-3,2.5-3,3-7,4-5,9-12,acuminate,acute,anther,apex,attenuate,base,berry,brownish,chartaceous,cm,condition,conical,cordate,corolla,densely,diameter,drying,filament,fresh,fruit,glabrous,green,greenish,herb,leaf,lobe,long,margin,membranous,mm,mucilaginous,oblique,odd-pinnate,orbicular,ovate,ovoid,pedicel,peduncle,petiole,plant,puberulent,pubescent,ripe,rounded,seed,sometimes,stem,style,tinged,violet,wet,white,whitish	0-3,0.7-2,1-10,1-3.8,2-15,2-5,2.3-4,3-12,3.3-7.8,3.8-8.3,5-merou,6.5-14.5,abaxially,absent,acumen,adaxially,ag,along,alyx,among,apart,apparently,articulated,axe,axillary,blade,broadly,bud,capitat,cell,ciliate,clavate,connivent,covering,cuneate,decreasing,decurrent,deeply,digestion,distal,dorsally,eaf,edge,eed,elliptic,end,enzyme,erec,especially,exceeding,flat,flower,folded,forked,geminat,generally,glabrou,grassland,greatly,green-white,hair,hair-like,half,homostylous,honeycomb-shaped,interjected,lanceolate,lateral,leaflet,lengthening,like,living,low-growing,lower,make,markedly,middl,midrib,minutely,narrowly,nflorescence,obtuse,one,orolla,pair,perfect,petiolulate,petiolule,placed,plurifoliate,pore,poricidal,rarely,removed,ruit,semi-rosette,sessile,seudostipule,shady,short,situation,size,slightly,slit,spaced,specimen,stamen,ste,stellate,stigma,stolo,straight,subsessile,subtending,sunny,tall,tamen,tem,terminal,testal,thick,throughout,tip,toward,tri-,tube,tuber,typically,unequal,unit,unwinged,usually,vary,wall,wide,woodland,x,yellow,ympodial	'',[,``,abaxial,adaxial,arrangement,branching,calyx,characteristic,colour,form,growth,height,history,inflorescence,length,life,midvein,na,ovary,perennial,primary,pseudostipule,rachi,shape,staman,surface,tertiary,texture,unarmed,value,vein,venation,width,{,}
117	wfo-0001027184	success	219	152	122	97	30	0.557	.3,.5,.7,.8,0-0.2,0.2-0.4,0.4-2,0.8,13â18,19,1â2,1â4,2,2â4-celled,3-4-,3.5â8,3â,4,5,5-7,7,abaxially,acute,adaxially,along,anther,apex,articulated,axi,axillary,base,blue,borne,bract-like,brown,calyx,cm,covered,cylindrical,densely,diameter,entire,epidermal,especially,extension,filament,flattened,fleshy,flower,foliaceous,fruit,generally,glabrescent,glabrous,globose,hair,hairlike,half,herbaceous,imparipinnate,lanceolate,leaf,leaflet,leafy,least,light,lobe,long,lower,margin,membranous,meter,midrib,mm,mostly,nearly,obtuse,older,orange,pedicel,peduncle,per,petiole,pilose,plurifoliate,prominently,pseudostipule,pubescent,rachi,raised,rarely,red,reticulate,revolute,ripe,several,shape,shoot,short,simple,slightly,small,soft-woody,somewhat,sparsely,stem,straight,style,sulcate,surface,tertiary,truncate,unbranched,unequal,unit,vein,vine,wall,white,x,young,â9	0-,0.4â0.9,0.5-2,0.8â1.6,0â3,1-2,1.5,1.5-5,1.8â3.5,1â2.5,2.8â4.1,3-foliolate,3â4-celled,4â12,9,absent,accrescent,adaxiall,adventitious,ag,always,alyx,apart,appressed,axe,ba,basal,blade,branch,broad,broadly,cell,chartaceous,clavat,cluster,connivent,cordat,directed,eaf,eed,elliptic,fasciculate,free,fruiting,geminat,glabrou,grading,ilament,introrsely,larger,largest,lateral,less,like,longitudinal,m.,minutely,much,narrowly,nflorescence,node,oblong,often,opening,opposite,orolla,ovate,ower,petiolule,pore,portion,prominent,puberulent,root,ruit,scarcely,secondary,size,slit,spaced,stellate,stigma,subopposite,terminal,tightly,tip,tree,trunk,tube,unarme,uniform,usually,vary,visible,weak,yellow,ympodial	abaxial,adaxial,arrangement,branching,characteristic,colour,cordate,corolla,form,geminate,green,greyish,growth,height,hirsute,history,inflorescence,length,life,midvein,na,ovary,plant,primary,seed,staman,sympodial,texture,unarmed,venation
118	wfo-0001027186	success	168	106	81	87	25	0.482	-6,1-1.5,1-2.5,1.4-1.6,1.5,1.5-2,1.5-2.5,15,2-6,3-4,3.5-4,5-10,6-7,9-10,abaxial,acute,anther,anthesi,apex,attenuate,base,berry,branched,brown,calyx,cm,conical,corolla,dark,deflexed,deltate,dendritic,densely,diameter,elliptic,entire,filament,filiform,fruit,glabrous,globose,green,growth,keeled,less,lobe,longer,margin,minutely,mm,much,narrowly,new,ovary,ovoid,pair,pale,pedicel,peduncle,petiole,pitted,primary,pubescent,rachi,reddish,reniform,seed,shiny,simple,slightly,sparsely,stem,style,surface,terminal,time,tree,vein,white,x,yellow	.4,.5,0.5-1,1.6-5,2-lobed,2.5-3,30-40,4-15,4-9,?,abaxially,adaxially,age,always,apart,apparently,axil,bark,branch,broadly,clavate,dbh,denditic,denser,dry,eaf,ellipsoid,enlarging,exerted,flower,free,fruiting,glabrescent,golden,immature,incrassat,irregularly,lamina,lengthening,like,lobed,loose,lower,m.,maturity,midrib,nflorescence,occasionally,papillat,papillate,pendent,perfect,pericarp,planar,plane,plurifoliat,pointed,pore,poridical,portion,pubescen,rough,ruit,scar,scattered,short,slit,small,soon,spaced,spreading,stalk,stigma,straight,strongly,tip,treelet,trichome,tub,tube,ud,uniseriate,unit,variably,way,woody,ympodial	2,adaxial,arrangement,branching,characteristic,colour,form,height,history,inflorescence,leaf,length,life,midvein,na,perennial,plant,pseudostipule,shape,staman,tertiary,texture,unarmed,variously,venation
119	wfo-0001027198	success	191	129	98	93	31	0.513	.5,0.5-1,0.8-1,1-1.5,1-10,1.5-10,1.5-2,10-11,5-6,abruptly,acuminate,acute,anther,apex,attenuate,axil,base,beneath,berry,broadening,bushy,calyx,channeled,cm,complex,corolla,deltoid,dendritic,densely,dia,elliptic,entire,extremely,filament,flower,furcate,glabrate,glabrous,globose,golden,green,impressed,inflorescence,large,lateral,leaf,like,lobe,long,main,many,margin,medium,minute,minutely,mm,obovate,often,opposite,ovary,ovoid-reniform,pale,paler,pedicel,petiole,pitted,plant,puberulent,pubescent,rounded,set,shining,short,shrub,simple,size,slender,slightly,small,speciman,stem,style,styled,surface,tannish-yellow,testae,thin,time,tree,trichome,tube,two,type,vein,white,x,yellowish,young	.4,0.05-1.0,0.5-0.75,0.7-1,1-5,11-20,2-5.5,3/4,4-9,5-120-flowered,7.5-9,always,anthesi,apart,ba,beginning,caly,clavate,closely,constriction,corky,corresponding,cyathiform,decurrent,differing,difoliate,dry,eaf,edge,edicel,eed,erect,evenly,exserted,eye,female,found,free,fruiting,geminat,inflorescenc,invisible,live,lobed,lon,lower,major,male,meet,middle,minor,naked,nearly,nflorescence,older,overlapping,ovoid,papillo,papillose,pendan,planar,pore,poricidal,portion,pubescence,rather,reddi,reflexed,rest,ruit,scar,sessile,shaped,soon,spaced,specimen,stigma,straight,strong,tall,tear-drop,thickened,tip,top,ud,undersurface,uniseriate,unit,usually,way,widest,woody,ympodial	0.4,5,abaxial,adaxial,arrangement,branching,characteristic,colour,diameter,form,fruit,growth,height,history,length,life,midvein,na,peduncle,perennial,primary,pseudostipule,rachi,reddish,seed,shape,staman,tertiary,texture,unarmed,venation
120	wfo-0001027200	success	139	92	63	76	29	0.453	0.25-0.5,0.5-1,0.6-1,1-1.4,1-1.5,1.2-1.5,1.5-2,1.5-5,2.5-3,3-3.5,6-8,9-11,acute,anther,apex,base,berry,brown,calyx,cm,corolla,dark,decurrent,deeply,deltoid,dia,elliptic,filament,glabrous,globose,green,grey-brown,horizontally,inflorescence,lateral,leaf,lobe,main,margin,minutely,mm,onto,ovary,ovoid-reniform,papillose,pedicel,petiole,pitted,puberulent,shrub,slightly,small,sparsely,spreading,stem,straight,style,surface,tree,unifoliate,vein,white,x	0.05-0.25,0.5-0.75,0.7-2.5,1.6-6,2-3,3.5-6,8-15,across,anthesi,aspec,ba,bark,beneath,branch,branche,broadly,capitate,conical,converging,deflexed,densely,differing,eaf,eed,except,flattened,free,fruiting,geminate,giving,golden,impressed,lightly,like,lobed,lon,long,lower,major,middle,minor,minute,near,nearly,node,non-reproductive,occasionally,older,papillo,planar,pore,poricidal,portion,prominent,reflexed,rest,ruit,shaped,size,sparse,stigma,tall,tear-drop,tip,trichome,tube,unicellular,uniseriate,unit,widened,widest,winged,woody,yellowish,ympodial,young	abaxial,adaxial,arrangement,branching,characteristic,colour,diameter,form,fruit,growth,height,history,length,life,midvein,na,peduncle,perennial,plant,primary,pseudostipule,rachi,seed,shape,staman,tertiary,texture,unarmed,venation
121	wfo-0001027213	success	231	137	111	120	26	0.481	-19,-230,-3.3,-4.5,0-160,0-2.5,0.2-0.4,0.2-0.5,0.7-2.3,0.8-1.8,1-2,1-5,1.2-1.6,1.2-2.5,1.3-2.2,1.7-3.9,1.8-3.2,1/2-2/3,12.3-16.3,2-5,2.9-3.8,2.9-4.8,2/3,4-9.5,4.2-5.9,5.7-6.2,8.2-10.5,9-13,abaxially,acuminate,acute,adaxially,anther,apart,apex,articulated,attenuate,basal,base,branched,broadly,brown,calyx,cm,conical,corolla,cuneate,dark,deltoid,diameter,elliptic,entire,filament,flower,fruit,glabrescent,glabrous,globose,grayish-brown,green,hair,immature,leaf,length,lobe,lobed,long-,long-stalked,many,margin,midrib,mm,mostly,multangulate,oblanceolate,pale,partly,pedicel,peduncle,petiole,porrect-stellate,pubescent,rachi,reniform,reticulate-punctate,scabrous,short-,short-attenuate,short-stalked,shrub,side,simple,spaced,sparsely,stem,style,surface,thin-stalked,time,tomentose,tomentose-pubescent,tree,unarmed,vein,violet,way,white,whitish-green,x,yellow-green,yellow-tan	/10,1.1-1.7,1.2-1.7,1.7-3.6,1.8-2.8,10-24,2.4-4.7,2.5-5.1,3.5-5,3.5-8,5-7.5,5-8,5-merou,8-24,accrescent,ag,along,alyx,anthesi,apparently,ark,around,axe,axillary,ba,blade,blunt-tipped,branch,capitat,cell,completely,covering,cylindrical,decurrent,directed,distally,drying,eaf,early,edge,eed,enveloping,epidermal,eventually,exserted,farinose,few-rayed,free,fruiting,glabrescen,granular,group,high,homostylous,inserted,lackin,lanceolate,lateral,lengthening,long,longitudinal,lower,m.,main,mixed,moderately,multangulat,nearly,nflorescence,obovate,obscured,obtuse,often,older,orbicular,orolla,ovate,ovate-lanceolate,perfect,plurifoliate,pore,poricidal,porrect-stellat,prominent,pseudo-terminal,pubescence,rather,relatively,ruit,sessile,short,slit,sometimes,somewhat,stamen,stellate,stigma,subcampanulate,suture,tamen,terete,thick,thick-stalked,ti,tip,tomentu,touching,tube,ud,unarme,unit,unwinged,vary,vestigial-rayed,whitish,wide,yellow,yellowish,ympodial,young	abaxial,adaxial,arrangement,branching,characteristic,colour,form,growth,height,history,inflorescence,life,midvein,na,ovary,plant,primary,pseudostipule,pseudoterminally,seed,shape,staman,tertiary,texture,true,venation
122	wfo-0001027214	success	181	100	73	108	27	0.403	.5,0.5-0.8,0.5-1,0.7-2.5,1-1.5,1.5,1.5-1.8,10-13,2,2-9,8-9,abaxially,adaxially,anther,apex,apical,base,berry,broadly,calyx,climbing,cm,conical,corolla,deltate,densely,diameter,elliptic,erect,filament,finely,flattened-round,fruit,glabrous,green,greenish,grown,height,herb,inflorescence,length,lobe,long-acuminate,long-conical,margin,mm,oblique,occasionally,once-branched,ovary,pair,papillate,pedicel,petiole,pinnate,pointed,projection,pubescent,rachi,rugose,rugosity,scrambling,seed,sharply,simple,somewhat,style,surface,triangular,truncate,vein,white,x	-20,-38,-9,..,.25,0,0-16,0.25,0.3-1.5,0.3-1.7,0.7-2,0.8-1,1-2.8,1.2-3,1.5-6,10-,12-17,15-25,3-,3-6,4-5,5-6,6-,6-12,7-12,absent,acuminate,acute,along,anthesi,anticlinal,basal,capitat,cell,composed,conspicuously,decurrent,dr.,drying,eaf,edicel,eed,epidermal,exserted,extending,flower,free,fruiting,globose,groove,horizontal,inflorescenc,irregular,lamina,lanceolate,lateral,leaflet,less,like,lobed,lon,long,lower,markedly,midrib,minutely,narrowly,nearly,nflorescence,noddin,nodding,obovate,often,onto,open,opposite,paired,papilla,per,perfectly,petiolule,poricidal,portion,reflexed,rest,ruit,scar,scattered,sinuous,smaller,stigma,tem,terminal,thickening,time,tip,trichome,tub,tube,ud,unevenly,unifoliat,uniseriate,unit,white-lenticellate,whitish,without,ympodial	.0,2.0,abaxial,adaxial,arrangement,branching,characteristic,colour,form,growth,history,leaf,life,midvein,na,peduncle,perennial,plant,primary,pseudostipule,shape,staman,stem,tertiary,texture,unarmed,venation
123	wfo-0001027219	success	143	109	79	64	30	0.552	0.3,0.4-0.6,0.5,0.5-0.8,1-15,1-2,1-3,1.5-2,2,2-2.5,2-3.5,2-4,3-5,6-8,7-8,absent,acuminate,acute,anther,anthesi,apex,axillary,base,berry,bright,brown,calyx,cm,conical,corolla,deltate,densely,diameter,elliptic,entire,erect,filament,flower,glabrescent,glabrous,green,greyish,growth,hard,known,leaf-opposed,less,lobe,long-conical,long-styled,margin,maturity,mm,ovary,pair,pale,pedicel,peduncle,petiole,primary,pubescent,purple,shoot,short,short-styled,shrub,simple,stem,stout,style,surface,terminal,trichome,tuft,uniseriate,vein,violet,white,x	.5,/4,1,1.5-2.5,2-3,3-6,age,bark,berr,broadly,c.,capitate,closely,completely,cup-shaped,drying,eaf,edge,eed,exerte,exfoliatin,free,fruiting,glabrou,globose,heterostylous,lengthening,lobed,lower,minutely,new,nflorescence,overlappin,papillo,papillose-pubescent,pendent,pericarp,planar,plurifoliat,pointed,pore,poricidal,portion,ruit,scar,sharply,slightly,slit,sometimes,somewhat,soon,spaced,stigma,thickened,tip,tube,ud,unit,way,weight,woody,yellowish,ympodial,â1/3	abaxial,adaxial,arrangement,branching,characteristic,colour,form,fruit,hair,height,hirsute,history,inflorescence,leaf,length,life,mentioned,midvein,na,perennial,plant,pseudostipule,rachi,seed,shape,staman,tertiary,texture,unarmed,venation
124	wfo-0001027223	invalid_json	189	121	83	106	38	0.439	0.19-0.75,0.3-1.2,1-2,1.8-3.5,16-41,3-10,3-11,3-5.2,3.5-4,3.7-9.3,4-6,5-8,9-35,acuminate,anther,apex,articulated,attenuate,base,berry,brownish,cell,cm,condition,conical,corolla,covering,deep,densely,diameter,distal,dot,drying,elliptic,filament,flower,forked,fresh,fruit,glabrous,green,greenish,hair,hair-like,half,herb,hyaline,lanceolate,lateral,leaf,light,like,lobe,long,make,middle,mm,mucilaginous,odd-pinnate,ovoid,pedicel,peduncle,petiole,petiolulate,plant,pubescent,purple,ripe,rounded,seed,sessile,short,shortly,sometimes,stripe,style,testal,thick,usually,wall,wet,white,whitish	.5,1-3,1.3-2,1.5-3.5,2-4,2-7,3-5,3.5-6,3.5-7,5-10,5-21,5-merou,5.9-12.2,9-15,9-22,abaxially,acumen,adaxiall,adaxially,ag,alyx,apart,apparently,asymmetric,axe,axillary,basiscopic,blade,bud,capitat,clavate,connivent,decreasing,digestion,dorsally,eaf,edge,eed,end,enzyme,erec,exceeding,flat,folded,geminat,generally,glabrou,green-white,hal,homostylous,honeycomb-shaped,interjected,larger,leaflet,lengthening,living,lower,nflorescence,one,orbicular,orolla,ovate,pair,pentagonal,perfect,placed,plurifoliate,pore,poricidal,present,removed,rotate,ruit,seudostipule,side,size,slightly,slit,spaced,specimen,stamen,ste,stigma,stolo,straight,subequal,subtending,tall,tamen,tem,terminal,throughout,tip,tissue,toward,tri-,tube,tuber,typically,unit,unwinged,vary,wide,x,yellow,ympodial	'',2,[,``,abaxial,adaxial,arrangement,branching,calyx,characteristic,colour,form,growth,height,history,inflorescence,length,life,margin,midvein,na,ovary,perennial,primary,pseudostipule,rachi,shape,staman,stem,surface,tertiary,texture,unarmed,value,vein,venation,{,}
125	wfo-0001027237	success	122	98	66	56	32	0.541	.5,0.5-1,1-1.2,1.5-2,1.5-2.5,2-3,3-3.5,3-4,30-100-flowered,6-11,6-8,8,anther,apiculae,apiculate,base,berry,black,branched,broadly,brown,calyx,cm,completely,corolla,dark,deflexed,deltoid,dia,drying,filament,flattened,glabrous,globose,green,greenish-white,inflorescence,internodal,leaf,lobe,long,many,margin,minutely,mm,ovary,paler,papillate,pedicel,pitted,regularly,reniform,shining,shrub,slender,small,stem,style,surface,tapering,time,tip,tree,tube,white,x	/4,5,anthesi,apart,appearing,ba,bark,blac,branc,clavate,cucullate,cup-shaped,difoliate,edicel,eed,ellipsoid,erect,exsertion,free,fruiting,geminate,greyi,later,lobed,lower,nflorescence,occasionally,older,papillo,papillose,part,plurifoliat,pore,poricidal,portion,reflexed,regulary,ruit,scar,shaped,spaced,stigma,straight,tall,tear-drop,terminal,ud,unit,upper,usually,way,widely,woody,x.,ympodial,young	0.5,abaxial,adaxial,apex,arrangement,branching,characteristic,colour,diameter,form,fruit,growth,height,history,length,life,midvein,na,peduncle,petiole,plant,primary,pseudostipule,rachi,seed,shape,staman,tertiary,texture,unarmed,vein,venation
126	wfo-0001027238	success	204	131	106	98	25	0.52	-25,.3,0-0.7,0-1,0-1.5,0.3-0.8,0.5-1,1-1.5,1.5-3,1.5-4,15-30,2-4,3-4,3-5,3-6,5-15,5-7,6-15,6-8,acuminate,acute,anther,apex,articulated,base,berry,black,blade,brown,calyx,chartaceous,cm,contiguous,cuneate,dark,deltate,densely,diameter,elliptic,elliptic-ovate,entire,extra-axillary,filament,flattened,fleshy,flower,foliaceous,fruit,glabrescent,glabrous,globose,green,greenish,hair,lavender,leaf,light,lobe,long,major,margin,membranaceous,minutely,mm,multangulate,near,nearly,oblique,obtuse,outline,pale,pedicel,peduncle,petiole,pitted,porrect-stellate,pubescent,purple,rachi,reniform,ripe,rounded,scandent,shiny,shrub,side,simple,small,sometimes,sparsely,sprawling,stellate-pubescent,stem,strongly,style,surface,tip,tree,unbranched,unequal,vein,white,whitish,x,yellow,yellowish	-5,.5,0.3-0.5,0.3-1,0.3-5,0.5-16,0.5-2,1-2,1.5-7,10,2-3,4-,4-10,4-16,4-5,4-8,5-merou,abaxially,accrescent,adaxiall,adaxially,ag,alyx,apparently,axe,ba,branch,capitat,connivent,covering,cylindrical,differentiated,directed,discolorous,distally,eaf,eed,equal,fork,free,frui,fruiting,geminate,gland,gland-tipped,growt,homostylous,interpetalar,introrsely,juic,large,lighter,like,longitudinal,lower,midpoint,minor,mixed,narrowly,new,nflorescence,oblong,often,one,opening,orolla,paired,part,perfect,pericarp,plurifoliate,pore,ray,ruit,sessile,short-stalked,similar,slit,somewhat,sparse,ste,stellate,stigma,straight,subtending,tamen,tem,time,tissue,toward,triangular,tube,unarme,unit,vary,wide,without,ympodial	abaxial,adaxial,arrangement,branching,characteristic,colour,corolla,form,growth,height,history,inflorescence,length,life,midvein,na,ovary,plant,primary,seed,shape,staman,texture,unarmed,ye
127	wfo-0001027244	success	294	130	109	185	21	0.371	-12,-2,-3.2,0.2-1,0.3-0.6,0.3-0.8,0.4-1,0.45-0.6,0.5,0.5-0.8,0.7-1.5,1,1.1-1.3,1.2-1.6,1.5-2.4,1.7-3.0,1/2,2-locular,2.1-8,3/4,7-12,acute,anther,apex,articulated,articulation,base,bifurcate,branched,broadly,brown,calyx,cell,cm,cordate,corolla,crenate,dark,decumbent,deltate,densely,dentate,diameter,distal,eglandular,elliptic,erect,filament,fruit,glabrous,glandular,globose,green,greenish,hair-like,half,imparipinnate,inflorescence,interrupted,irregularly,lanceolate,lateral,length,like,lobe,lobed,long,margin,middle,midvein,mixture,mm,narrowly,obovate,often,orbicular,outgrowth,ovary,patent,pedicel,peduncle,perennial,petiole,primary,pseudostipule,pubescent,purple,rachi,rounded,simple,slender,spreading,stem,stripe,style,surface,tertiary,testa,thick,trichome,truncate,uniseriate,vein,velvety,vivid,wall,white,wide,yellow	-1.2,.5,0-,0.02-,0.04-,0.05,0.05-1,0.07-0.15,0.1-,0.1-0.3,0.1-0.5,0.1-0.6,0.15-0.2,0.2,0.2-,0.25-0.4,0.3,0.3-0.4,0.3-0.5,0.4-,0.4-0.6,0.5-1,0.6-0.9,0.6-09,0.7-1,0.7-2,0.7-3,0.8-1.2,0.9-1.3,0.9-1.7,1-2-celled,1-2.5,1-3.5,1-celled,1.5-2,1.5-2.1,1.5-6.5,2-,2-4,2-4-celled,2-9,2-foliate,3-5,3.5-13,4-12,4-celled,5-,5-10,5-9-celled,8-16,8-celled,abaxially,absent,abundance,abundant,acroscopically,acuminate,adaxially,adpressed,alfway,along,also,always,amongst,angled,anthesi,apical,apparently,appearance,appendage,arequipa,around,articulatio,axi,basal,berr,berry,bract,bracteate,c.,cage,capitate,column,common,conical,curved,deciduous,decurrent,deeper,dense,density,developed,diamete,eaf,edicel,eed,either,elliptical,exserted,extremely,flower,flushed,forming,fruiting,general,giving,glabrescent,gland,gree,halfway,head,herb,hyaline,interjected,internode,investing,lamina,larger,largest,leaflet,leave,lobing,lon,longer,lower,minute,mixed,multicellular,near,node,oblique,occasionally,onto,pair,papillate-pubescent,petiolule,population,present,reflexed,rest,ripe,rotate-stellate,ruit,scattered,secondary,sessile,shaggy,short,shorter,silky,sinus,size,small,sometimes,somewhat,sparse,sparsely,sparser,staminal,sterile,stigma,stout,straight,strongly,tall,tem,terminal,tiny,tip,tipped,toward,tube,two,ud,undulate,unicellular,unit,united,upper,usually,variable,variety,winged,woody,ympodial	abaxial,adaxial,arrangement,branching,characteristic,colour,form,growth,height,history,leaf,life,na,plant,reproduction,seed,shape,staman,texture,unarmed,venation
128	wfo-0001027248	success	158	100	70	88	30	0.443	0,0.5-1,0.5-2.5,0.7-1.2,1-1.5,1-2,1-3,1-5,3-4,3-7-flowered,3.5-4,5-5.5,6.5-8,7-9,abaxial,acute,anther,apex,arachnoid,arachnoid-pubescent,base,beige,berry,broadly,brown,brownish,calyx,cm,corolla,dark,deltate,densely,dia,dirty,elliptic,filament,fruit,glabrous,globose,grayish-green,green,leaf,lobe,long,margin,minutely,mm,ovary,ovoid-reniform,pair,patch,pedicel,per,petiole,pitted,pubescence,pubescent,scattered,shrub,simple,small,sparsely,stem,style,surface,tree,trichome,vein,white,wide	.5,2-2.5,2-4.5,3-7,4-8,6-13,abaxially,adaxially,along,anthesi,ape,appearing,arachnoid-pubescen,area,bark,beneath,broadened,brownish-gra,closely,conical,deflexed,denser,differing,difoliate,eaf,edicel,eed,ellipsoid,erect,exserted,felty,fleshy,free,fruiting,geminate,glabrescent,impressed,lamina,later,lateral,lightly,lobed,lower,main,major,merely,minor,nearly,nflorescence,node,occasionally,older,opposite,overlappin,pale,papillo,papillose,planar,pore,poricidal,portion,present,ruit,scar,shaped,shoot,size,somewhat,soon,spaced,specimen,stigma,strongly,tall,tear-drop,thick,tip,top,tub,tube,ud,unifoliate,unit,wid,winged,woody,ympodial,young	1.5,adaxial,alternate,arrangement,branching,characteristic,colour,diameter,form,growth,height,history,inflorescence,length,life,midvein,na,peduncle,perennial,plant,primary,pseudostipule,rachi,seed,shape,staman,tertiary,texture,unarmed,venation
129	wfo-0001027258	success	178	110	81	97	29	0.455	0.25-0.5,0.6-2,0.9-1.3,1-1.5,1-2.3,1.5-1.6,2-2.5,3-4,3.5-4,4-5,4.5-5,5-10-flowered,6-8,7-9,abaxially,acuminate,acute,adaxially,along,anther,apex,apical,apiculae,attenuate,base,berry,calyx,cm,corolla,decurrent,deltate,densely,elliptic,entire,filament,flattened-reniform,fruit,glabrous,globose,green,greenish-yellow,leaf,length,lobe,long,margin,minute,minutely,mm,onto,ovary,ovate,pair,pale,pedicel,petiole,pitted,projection,prominent,pubescent,reddish,scattered,shrub,simple,slender,slightly,sparsely,stem,straight,style,surface,treelet,trichome,tuft,uniseriate,vein,white,winged,x,yellowish,yellowish-tan	.25,.5,/4,0.5-1,1-4,1.2-2,2.5-8,3-6,7-13,abruptly,age,anthesi,apar,axil,ba,bark,beneath,broadly,capitate,crystal,darker,deflexed,dense,deposit,dia,differing,difoliate,dissecting,drying,eaf,edicel,eed,ellipsoid,enlarge,evenly,exserted,extending,fide,fragrant,free,fruiting,geminat,glabrou,incrassate,internodal,lamina,large,lateral,lengthening,lenticel,lobed,lower,main,major,microscope,middle,minor,nee,nflorescence,occasionally,often,older,opposite,papillo,papillose,planar,pore,poricidal,portion,red-papillose,ruit,sand,scar,size,slit,small,spaced,speck,stigma,strongly,sweetly,swollen,tall,tiny,tip,tub,tube,ud,unit,urceolate,visible,way,widening,widest,woody,ympodial,young	abaxial,adaxial,alternate,arrangement,branching,characteristic,colour,diameter,form,growth,height,history,inflorescence,life,midvein,na,peduncle,perennial,plant,primary,pseudostipule,rachi,seed,shape,staman,tertiary,texture,unarmed,venation
130	wfo-0001027260	success	176	128	92	84	36	0.523	-60,0.25-1,0.5-3,0.5-6.5,0.8-2,1-2,1-3,1-6,1.5-13,1.5-2,15-30,2-10,2-18,2-2.5,2.5-3.5,3-11,3-4.5,3-6,5-40,acuminate,acute,acute-,age,also,apex,articulated,basal,base,berry,beyond,branched,chartaceous,cm,cordate,cylindrical,darker,densely,diameter,ellipsoidal,elliptic,elliptic-ovate,entire,exserted,fading,flattened,flower,fruit,glabrate,glabrous,globose,greenish,lanceolate,lavender,leaving,lobe,long,longitudinal,margin,mm,moderately,obtuse,often,ovate,pedicel,pedicellar,peduncle,petiole,pilose,pink,puberulent,puberulent-pubescent,pubescent,pubescent-pilose,purple,rachi,remnant,shrub,simple,small,sparsely,stamen,stripe,style,subcoriaceous,tree,unbranched,usually,vein,white,x,yellow-green,yellowish	-17,-2,-7,0.5-1,0.75-1,1-,1-4,1-7,10-25,2-,2.5-14,3-,3-10,3.5-25,4-25,4-32,4-5-foliat,4-6,4.5-14,5-,5-25,5-merous,6-20,abaxially,absent,adaxially,aggregate,alyx,apart,ape,axe,blade,cell,clavate,connective,connivent,diamete,directed,distally,eaf,eed,eglandular,equal,exceeding,hair,lon,lower,membranaceous,narrowly,nearly,nflorescence,nther,orolla,perfec,perfect,pilo,pore,presen,puberulent-pubescen,radiu,ruit,shorter,slightly,spaced,stellate,stigma,stone,strongly,tal,tapered,tem,thecae,time,tomento,triangular,truncate,tube,ud,unit,vary,wide,yellow,yellow-orang,ympodial	1-4.5-14,5-10-25,abaxial,adaxial,anther,arrangement,branching,calyx,characteristic,colour,corolla,filament,form,growth,height,history,inflorescence,leaf,length,life,midvein,na,ovary,perennial,plant,primary,pseudostipule,seed,shape,staman,stem,surface,tertiary,texture,unarmed,venation
131	wfo-0001027265	success	159	111	70	89	41	0.44	.2,0.2-0.4,0.5,0.5-1,1-3,1.2-1.3,1.2-2,2,2-3,2/3,20-30,4-5,acute,anther,apart,apex,articulated,base,berry,calyx,chartaceous,cm,diameter,entire,extra-axillary,filament,flattened-reniform,flower,fruit,glabrous,globose,herb,leaf-opposed,light,lobe,long,long-attenuate,lower,margin,mesocarp,minutely,mm,nearly,numerous,obtuse,orange,ovate-lanceolate,pedicel,peduncle,petiole,pitted,puberulent,pubescent,purple,rachi,recurved,red,ripe,seed,simple,spaced,sparsely,style,subcoriaceous,surface,triangular,white,winged,x,yellow	-2.5,.3,.5,0.1â2,0.5â0.6,1-1.3,1-2.5,1.2â1.4,1.5-2.5,1.5â1.8,1.5â2,1.5â4,2-,2-4,2â2.5,2â3,3-,3-lobed,30â50,4.5â8,4â6,4â7-branched,5-merou,58409,abaxially,accrescent,adaxiall,adaxially,alyx,apparently,axe,ba,blade,broad,capitat,ciliate,connivent,covering,croat,cylindrical,dehiscent,eaf,eed,erect,foliate,frui,fruiting,geminat,granule,hair,hermaphroditic,juic,larger,lon,longitudinall,low,near,nflorescence,node,oblong,orolla,paired,partially,pore,present,prominent,rarely,rooting,rotate-stellate,ruit,scarcely,sclerotic,slightly,sometimes,somewhat,stigma,tall,tamen,tem,time,tip,tube,unit,usually,vary,weak,white-puberulent,wide,ympodial	0.1-2,0.5-0.6,1.2-1.4,1.5-1.8,1.5-2,2-2.5,30-50,4-6,4-7-branched,abaxial,adaxial,arrangement,branching,characteristic,colour,corolla,form,green,growth,height,history,inflorescence,juicy,leaf,length,life,midvein,na,ovary,perennial,plant,primary,pseudostipule,shape,staman,stem,tertiary,texture,unarmed,vein,venation
132	wfo-0001027265	success	156	112	71	85	41	0.455	.2,.5,0.2-0.4,0.5,0.5-1,1-3,1.2-1.3,1.2-2,2,2-3,2/3,20-30,4-5,acute,anther,apart,apex,articulated,base,calyx,chartaceous,cm,cylindrical,diameter,entire,extra-axillary,filament,flattened-reniform,flower,fruit,glabrous,globose,herb,leaf-opposed,light,lobe,long,long-attenuate,lower,margin,mesocarp,minutely,mm,nearly,numerous,obtuse,orange,ovate-lanceolate,pedicel,peduncle,petiole,pitted,puberulent,pubescent,purple,rachi,recurved,red,ripe,seed,simple,spaced,sparsely,style,subcoriaceous,surface,triangular,white,winged,x,yellow	-2.5,.3,0.1â2,0.5â0.6,1-1.3,1-2.5,1.2â1.4,1.5-2.5,1.5â1.8,1.5â2,1.5â4,2-,2-4,2â2.5,2â3,3-,3-lobed,30â50,4.5â8,4â6,4â7-branched,5-merou,58409,abaxially,accrescent,adaxiall,adaxially,alyx,apparently,axe,ba,blade,broad,capitat,ciliate,connivent,covering,croat,dehiscent,eaf,eed,erect,foliate,frui,fruiting,geminat,granule,hair,hermaphroditic,juic,larger,lon,longitudinall,low,near,nflorescence,node,oblong,orolla,paired,partially,pore,prominent,rarely,rooting,rotate-stellate,ruit,scarcely,sclerotic,slightly,sometimes,somewhat,stigma,tall,tamen,tem,time,tip,tube,unit,vary,weak,white-puberulent,wide,ympodial	0.1-2,0.5-0.6,1.2-1.4,1.5-1.8,1.5-2,2-2.5,30-50,4-6,4-7-branched,abaxial,adaxial,arrangement,branching,characteristic,colour,corolla,form,green,growth,height,history,inflorescence,juicy,leaf,length,life,midvein,na,ovary,perennial,plant,primary,pseudostipule,shape,staman,stem,tertiary,texture,unarmed,vein,venation
133	wfo-0001027284	success	172	135	88	84	47	0.512	.3,4,abaxially,acuminate,acute,adaxially,anther,apex,axillary,base,branched,brownish,calyx,cm,cordate,cylindrical,deflected,deltoid,densely,diameter,elliptic,entire,extra-axillary,filament,fine,flattened,flattened-reniform,fleshy,flower,fruit,glabrous,globose,green,herbaceous,inflorescence,lobe,margin,maturity,midvein,minutely,mm,nearly,oblique,one,orangish,ovate,ovoid,pair,pale,pedicel,peduncle,petiole,pinnate,pointed,pubescence,pubescent,rachi,rarely,reticulate-rugulose,rounded,sand-punctate,scandent,scar,shortly,shrub,side,simple,slightly,sometimes,somewhat,soon,spaced,sparsely,stem-terminal,style,surface,tan,thickly,tip,truncate,unbranched,vein,venation,vine,weakly,white,woody,x	0.1â0.5,0.1â2,0.2â,0.7â0.9,0.7â1,1.2â1.5,1.5â2,1.5â2.5,1.5â5.5,1.5â8,1.8â2,1â1.5,1â2,1â3,2.5â3,2.5â3.5,2â16,2â2.2,3.5â14,3â4,4â12,4â6,5-merous,5â7,5â8,9â18,accrescent,alyx,anthesi,axe,berry,blade,branch,c.,capitat,ciliat,climbing,conspicuous,contiguousl,distally,eaf,eed,enlarged,fruiting,glabrescen,glabrou,gradually,immature,leafy,long,lower,m.,near,nflorescence,nternode,orolla,pendulou,perfec,pink,planar,plurifoliate,prominent,reduced,ruit,sand-punctat,secondary,seen,size,spreading,stellate,stigma,tamen,tem,thickened,time,toward,tree,tube,understory,unifoliat,unit,vary,wide,ympodial	0.1-0.5,0.1-2,0.2-,0.7-0.9,0.7-1,1-1.5,1.2-1.5,1.5-2,1.5-2.5,1.8-2,2-16,2-2.2,2.5-3.5,3-4,4-12,4-6,5-7,5-8,9-18,abaxial,adaxial,arrangement,branching,characteristic,colour,contiguously,corolla,form,glabrescent,growth,height,history,leaf,length,life,na,ovary,plant,primary,pseudostipule,seed,shape,staman,stem,tertiary,texture,unarmed
134	wfo-0001027302	success	188	118	92	96	26	0.489	0.4-5,0.5-1,0.6-1,1-1.3,1-1.5,1.2-2.5,2,2-3,2-6,2.2,3.5-5,5-7,6-12,abaxial,acuminate,acute,adaxial,anther,apex,appearing,bark,base,berry,branching,bright,broader,brownish-yellow,calyx,cm,cordate,corolla,crispate,deflexed,deltoid,dendritic,densely,diameter,filament,flattened,fruiting,glabrous,globose,growth,juvenile,larger,later,lateral,leaf,length,lenticular,lobe,long-triangular,margin,minutely,mm,monochasial,narrowly,ovary,ovate,pair,pale,pedicle,petiole,pitted,plant,plurifoliate,prominent,puberulent,pubescent,red,reddish-brown,scar,scattered,shade,shrub,simple,small,somewhat,sparsely,stem,style,surface,terminal,time,tree,trichome,truncate,tube,undulate,vein,violet,woody	.5,0.5,0.8-1,1,1-2,1-3,1.2-1.6,1.5-2,10,10-20,2.7-7.5,3/4,7,7/8,abaxially,adaxially,age,along,anthesi,apical,ba,basal,becoming,blade,capitate,clavate,conical,cultivation,decurrent,denser,dichasia,discussion,eaf,edicel,eed,elliptic,entire,especially,ew,exserted,fine,flat-topped,flower,free,growing,inserted,lax,less,like,lobed,lon,long,lower,m.,main,nflorescence,nodding,occasionally,older,otherwise,overtopping,papillo,per,pericarp,planar,pore,poridical,portion,pyramidal,reflexed,ruit,scrambling,secondary,see,shin,shoot,sleeve,slit-like,stamen,stigma,strongly,tall,tapering,thin,tiny,tip,tub,ud,unit,usually,way,wide,winged,x,ympodial,young	arrangement,characteristic,colour,dichasial,form,fruit,height,history,inflorescence,life,midvein,na,new,pedicel,peduncle,primary,pseudostipule,rachi,seed,shape,shiny,staman,tertiary,texture,unarmed,venation
135	wfo-0001027310	success	215	114	94	121	20	0.437	0-5,0.6-1,0.7-2,1-1.2,1-1.7,1-6,1.1-1.5,2-3.1,2-4,2.8-3,20-60,22-30,4-9,4.5-5.5,5-7,abaxial,acute,adaxial,anther,apex,apically,apparently,articulated,base,berry,branched,branching,calyx,chartaceous,cm,cuneate,dark,deltate,densely,diameter,entire,erect,evenly,faint,filament,flattened-reniform,fruit,glabrous,glaucous,green,green-brown,hair,lanceolate,lateral,leaf,length,lobe,long,margin,maturity,mauve,minutely,mm,moderately,orange-brown,pair,pedicel,peduncle,petiole,pitted,plant,prickle,prickly,primary,purple,red,rounded,secondary,shallowly,shrub,simple,sometimes,sparse,spherical,stellate-pubescent,stem,style,surface,terminal,tertiary,toward,tree,truncate,unarmed,vein,venation,visible,yellow,young	-2.2,-20,.8,/3,0,0-20,0.05,0.05-0.15,0.1,0.1-0.2,0.15-0.3,0.9-0.17,1.5-2.2,1.5-5,1/10-1/6,1/3-1/2,1/3-3/4,11-16,2-10,2-5,2.2-2.5,2/3,3-15,4-10,4.5-7,5-10,5-20,5-merous,6-8,7-10,8-10,9-13,abaxially,acut,alyx,andromonoecious,apar,apart,bark,blade,broadly,connivent,curved,discolorous,distal,drying,eaf,eed,elongating,equal,flattened,flower,foliaceous,free,fruiting,fused,gently,glabrescent,glabrou,gray,hermaphrodite,heterostylous,inflated,infructescence,less,lobed,long-styled,longer,lower,lowermost,mature,midpoint,nflorescence,older,one,open,orolla,oung,pale,pendulous,per,pericarp,plurifoliat,poricidal,porrect,porrect-lepidote,portion,pubescent,ray,reddi,reflexed,ruit,scar,sessile,short-styled,shorter,smooth,spaced,sparsely,spreading,stalk,stalked,staminat,stellate,stout,straight,strongly,tamen,tapering,terete,time,tip,trichome,tube,unarme,unit,vary,way,wide,woody,ympodial	arrangement,characteristic,colour,corolla,form,growth,height,history,inflorescence,life,midvein,na,ovary,perennial,pseudostipule,rachi,seed,shape,staman,texture
136	wfo-0001027317	success	144	83	51	93	32	0.354	.25,0.4-1.5,0.5-1,1,1-1.5,1.4-1.6,2-3-flowered,3-3.5,4.5-5,7-9,?,abaxial,acuminate,acute,adaxially,anther,apex,base,berry,calyx,cm,corolla,deltoid,difoliate,elliptic,filament,filiform,fruit,glabrous,globose,golden,green,leaf,lobe,margin,mm,ovary,pair,pale,pedicel,petiole,pubescent,shrub,simple,sparsely,stem,style,surface,vein,white,x	.5,0.1-0.2,0.3-1,0.5-3,0.8-3.5,1-2,1-5,1.5-2,2-9,along,anthesi,apical,apically,arch,ba,bark,beneath,bilobed,broadly,closely,conical,cucullate,deciduous,deflexed,densely,dia,differing,drying,eaf,edicel,eed,ellipsoid,elongated,erect,expanded,free,fruiting,geminat,greyish-whit,immature,inflorescenc,joined,known,lateral,like,lobed,lon,long,long-exserted,lower,main,major,mature,minor,minute,minutely,nearly,nflorescence,offset,older,opposite,overlappin,papillo,papillose,pointed,pore,poricidal,portion,projection,prominent,reflexed,rest,ruit,scar,series,shaped,size,slightly,soon,spaced,stigma,strongly,tall,tear-drop,tip,trichome,tub,tube,ud,uniseriate,woody,ympodia,young	abaxially,adaxial,arrangement,branching,characteristic,colour,diameter,form,geminate,greyish-white,growth,height,history,inflorescence,length,life,midvein,na,peduncle,perennial,plant,primary,pseudostipule,rachi,seed,shape,staman,sympodia,tertiary,texture,unarmed,venation
137	wfo-0001027323	success	175	93	62	113	31	0.354	0.5-1,1-1.5,1.2-1.5,2-3,2-6,2.5-3,3-5,5-7,7-9,acute,adaxial,anther,apex,attenuate,base,berry,calyx,cm,corolla,decurrent,densely,elliptic,filament,fleshy,fruit,furcate,glabrate,glabrous,globose,grey,immature,leaf,lobe,long-triangular-deltoid,margin,matte,minutely,mm,occasionally,opposite,ovary,ovoid-reniform,pair,papillose,partially,pedicel,petiole,pinkish-grey,pitted,plant,red-papillose,reddish-grey,stem,straight,style,surface,tan,treelet,vein,white,winged,x	.75,/3,1-2,10-15,14-21,20-45,5-20-flowered,6-11,along,anthesi,apparent,appearing,area,arising,asymmetric,ba,bark,broadened,bud,campanulate,character,closed,closely,cork,deflexed,dia,differing,difoliate,dried,dry,eaf,edicel,eed,elongate,entire,erect,erose,exserted,five-pointed,flopping,flower,free,fruiting,geminat,growing,held,higher,hood,hooded,interpetalar,lateral,like,live,lobed,lon,long,lower,main,major,mature,measured,middle,minor,nflorescence,older,one,onto,overlapping,ovoid,papillae,papillo,persistent,planar,pore,poricidal,portion,prominent,proximal,rather,rest,ridge,ruit,scar,secondary,seen,shaped,sinus,size,slightly,small,smoot,soon,spaced,specimen,stigma,tall,tear-drop,thickened,thin,tiny,tip,trunk,tube,two,ud,unit,upper,visible,way,widest,woody,ympodial,young	3,5,7,abaxial,alternate,arrangement,branching,characteristic,colour,diameter,form,green,growth,height,history,inflorescence,length,life,midvein,na,peduncle,primary,pseudostipule,rachi,seed,shape,staman,tertiary,texture,unarmed,venation
138	wfo-0001027340	success	189	144	111	78	33	0.587	0.5-0.9,1-10,1-2,1.5-2.7,10-16,16-22,2-4,2.5-4.5,3.5-5,4-6,4-7.5,5-6,6-8.5,7-8,8-14,8-9.5,absent,acuminate,anther,apart,apex,articulated,articulation,axillary,base,berry,brownish,bud,cell,chartaceous,cm,condition,cordate,corolla,covering,dark,decreasing,diameter,distal,distinct,drying,elliptic,filament,flower,forked,fresh,fruit,generally,glabrous,globose,green,green-white,greenish,hair,hair-like,half,herb,high,honeycomb-shaped,indistinct,interjected,lanceolate,lateral,leaflet,lengthening,like,lilac-purple,lobe,long,make,margin,membranous,minute,mm,mucilaginous,odd-pinnate,ovate,ovoid,pair,papillose,pedicel,peduncle,petiole,plant,pore,pubescent,purple,ripe,rounded,seed,shortly,size,slightly,slit,spaced,sparsely,splotched,stem,style,subtending,terminal,testal,thick,throughout,tinged,truncate,usually,wall,wet,whitish,x	1-3,2-3,2-3.5,2.7-4.5,3-4,3.5-9,5-11,5-merou,7-18,abaxially,abruptly,acumen,adaxially,ag,along,alyx,apparently,auriculate,axe,blade,capitat,ciliate,connivent,developing,digestion,dorsally,eaf,edge,eed,enzyme,especially,exceeding,flat,folded,geminat,glabrou,hal,homostylous,living,lower,midrib,minutely,narrow,narrowed,nflorescence,orolla,perfect,petiolulate,plurifoliate,pointed,poricidal,puberulent,purpl,removed,rotate,ruit,semi-erec,semi-rosette,sessile,seudostipule,short,specimen,stamen,ste,stigma,straight,tall,tamen,tem,tip,tri-,tube,unit,vary,wing,yellow,ympodial,young	2,abaxial,adaxial,age,arrangement,branching,calyx,characteristic,colour,form,growth,height,history,inflorescence,leaf,length,life,midvein,na,ovary,perennial,primary,pseudostipule,rachi,shape,spacing,staman,surface,tertiary,texture,unarmed,vein,venation
139	wfo-0001027354	success	166	102	77	89	25	0.464	0.5-2,0.7-1.3,1-1.2,1-1.5,1-7,1.5-1.8,1.5-2,3-4,3.4-4,4-10,5-7,8-12,abaxial,abaxially,acute,adaxial,along,anther,apex,appearing,base,berry,branch,branching,calyx,cm,corolla,dark,deltoid,dendritic,densely,diameter,elliptic,entire,filament,flattened,fork,fruit,glabrate,glabrous,globose,golden,growth,later,lateral,leaf,length,lenticular,lobe,loose,minutely,mm,monochasial,narrowly,occasionally,ovary,pair,pedicel,petiole,pitted,plurifoliate,pubescent,purplish-black,reddish-brown,shrub,small,sparsely,stem,style,surface,terminal,tree,tree-like,trichome,vein,violet,white	.5,0,0.5,1,1.7-5,10,10-20,2.5-3.5,3/4,6.5-13,absent,age,anthesi,apical,ba,bark,basal,becoming,belo,bi-lobed,blade,conical,covered,denser,dichasia,drying,eaf,edicel,eed,erect,ew,exserted,flower,free,fruiting,inserted,less,like,lobed,long,loosely,lower,m.,mostly,near,nflorescence,nodding,older,papillo,per,pericarp,planar,pore,poricidal,portion,pubescen,pyramidal,raised,ruit,scar,secondary,side,simple,sleeve,slightly,slit-like,somewhat,stamen,stigma,strongly,tall,tapering,thecalyx,thin,time,tiny,tip,tub,tube,type,ud,unit,way,wide,winged,woody,x,ympodial,young	arrangement,characteristic,colour,dichasial,form,height,history,inflorescence,life,margin,midvein,na,peduncle,perennial,plant,primary,pseudostipule,rachi,seed,shape,staman,tertiary,texture,unarmed,venation
140	wfo-0001027359	success	224	121	96	128	25	0.429	-2,-20,.5,0-9,0.1-1.5,0.3-1.2,0.5-2,1-1.2,1-2,1.2-1.5,2-4,2.5-3.5,4-,4-5,5-6.5,6-8,acute,anther,apex,apically,apparently,base,berry,branched,bright,calyx,cell,chartaceous,cm,cuneate,deltate,diameter,difoliate,dull,entire,eye,filament,fruit,glabrous,lateral,leaf,length,like,lobe,lobed,margin,maturity,membranous,minutely,mm,moderately,naked,near,obtuse,occasional,orange-brown,outline,ovate,pair,pale,pedicel,peduncle,per,petiole,pit,prickly,primary,purple,rachi,raised,red,reticulate,shallowly,shrub,simple,small,smooth,spherical,stellate,stellate-pubescent,stem,style,surface,terminal,tertiary,trichome,unarmed,undulate,unit,vein,venation,visible,white,yellow,yellow-brown,young	-0.25,-3,-4,-7,-9,.1,.2,/3,/4,0,0-2,0-3,0-5,0.1,0.1-0.2,0.3-0.5,0.5,0.5-1,0.6-0.8,0.6-1,1-3,1-4,1-5,1.2-2,1.5-2,1.5-2.5,1.8-3.2,1/5-1/4,2-10,2-3,2.5-5.5,3-10,5-,5-merous,7-8,abaxially,acut,alyx,apar,apart,articulated,ba,bark,blade,brow,concolorous,coroll,cream,curved,dark,densely,distinctive,drying,eaf,eed,elongate,elongating,equal,erect,filiform,flattened,flattened-reniform,flower,free,fruiting,geminat,glabrescent,gray,green,herbaceous,infructescence,less,long,longer,lower,marking,mature,midpoint,narrow-deltate,narrow-ovate,nflorescence,often,older,one,open,orolla,oung,ovoid,perfec,pericarp,poricidal,porrect,portion,prickle,rarely,ray,reflexed,ruit,scandent,scar,sessile,shorter,slender,slightly,sometimes,spaced,sparsely,spreading,stalk,stalked,stump,tamen,tapering,terete,time,tinge,tip,tube,ud,unarme,usually,variously,vary,way,weakly,wide,woody,ympodial	abaxial,adaxial,arrangement,branching,characteristic,colour,corolla,form,geminate,growth,height,history,inflorescence,life,midvein,na,ovary,perennial,plant,pseudostipule,seed,shape,staman,sympodial,texture
141	wfo-0001027366	success	136	88	58	78	30	0.426	0.5-1,0.7-1,1-1.5,1-2,1-3,2-2.5,3-10-flowered,3-9,4-4.5,4-5,5-7,acute,anther,apex,base,berry,bright,broadly,brown,calyx,cm,conspicuously,corolla,dark,deltate,drying,elliptic,filament,glabrous,globose,golden,green,greenish-white,leaf,lobe,long-triangular,margin,minutely,mm,orbicular,ovary,ovoid-reniform,pair,pale,parallel,pedicel,petiole,pitted,rounded,shining,shrub,simple,somewhat,stem,style,surface,vein,venation	.5,/2,/4,0.25-0.5,1.5-2,11-21,6-19,603,abaxially,adaxially,anthesi,ape,axe,ba,bark,capitate,closely,conical,deflexed,dia,eaf,edicel,eed,erect,et,except,exserted,fide,free,fruiting,internodal,lamina,lateral,less,lobed,lon,long,lower,main,middle,nflorescence,older,opposite,overlappin,ovoid,packed,papillo,papillose,planar,pointed,pore,poridical,portion,ramo,reddish,ruit,scar,secondary,shaped,sometimes,stigma,straight,tall,tear-drop,tip,trichome,tub,tube,ud,unifoliat,unit,way,wide,widest,woody,yellowish-gre,ympodial,young	abaxial,adaxial,arrangement,branching,characteristic,colour,diameter,form,fruit,growth,height,history,inflorescence,length,life,midvein,na,peduncle,plant,primary,pseudostipule,rachi,seed,shape,staman,tertiary,texture,unarmed,unifoliate,yellowish-grey
142	wfo-0001027368	success	145	114	80	65	34	0.552	-15,-20,-5,.5,0.3-2.5,0.5-3.5,0.8-2,1-2,1-6,1.5-2,1.5-2.5,2,2-2.5,2-9,3,4-6,5-15,5-6,8-13,abruptly,acuminate,acute,apart,apex,articulated,base,branched,calyx,chartaceous,cm,contiguous,cuneate,decurrent,deltate,dendritically,densely,diameter,distally,ellipsiodal,elliptic,elliptic-ovate,entire,forked,glabrous,globose,lanceolate,lenticular,lobe,margin,midvein,mm,moderately,narrowed,narrowly,nearly,occasionally,often,otherwise,ovoid-fusiform,pedicel,peduncle,petiole,puberulent,pubescent,purple,rachi,shrub,simple,small,spaced,sparsely,style,subcoriaceous,subhastate,triangular,unbranched,unknown,vein,white,x	-10,-2,0.5-5,1-15-flower,2-3,2-4,3-12.5,4-many-foliat,5-10,abaxially,absen,adaxiall,adaxially,aggregate,also,axe,ba,blade,cell,color,connivent,cylindrical,darker,denser,directed,eaf,eed,except,gland,hair,lighter,long,long-stalked,lower,nflorescence,nther,oblong,obtuse,orolla,pore,pubescen,radiu,ray,ruit,sometimes,stalked,star,stellate,stigma,stone,subcapitat,tal,tem,terminal,three,time,tip,truncate,tube,unit,usually,vary,wide,yellow,ympodial	abaxial,adaxial,anther,arrangement,branching,characteristic,colour,corolla,filament,form,fruit,green,growth,height,history,inflorescence,leaf,length,life,na,ovary,perennial,plant,primary,pseudostipule,seed,shape,staman,stem,surface,tertiary,texture,unarmed,venation
143	wfo-0001027369	success	191	108	82	109	26	0.429	.5,.7,0-1,0-3,0-5,0.5-0.8,0.6-0.8,1-,1-2.5,1-3,1-4,1.5-2,2-4,2-5,3-4,almost,anther,apex,apically,apparently,articulated,base,berry,branched,calyx,cm,color,cordate,diameter,erect,filament,filiform,flower,fruit,glabrous,glaucous,green,infructescence,known,lanceolate,lateral,leaf,length,lobe,lobed,long,margin,mauve,membranous,midvein,mm,moderately,narrowly,one,open,orbicular,pale,pedicel,peduncle,per,pericarp,petiole,prickle,prickly,reniform,rounded,scandent,shrub,simple,smooth,sparsely,spherical,stellate-pubescent,stem,style,surface,terminal,time,unarmed,venation,winged,yellow	-1,-10,-11,-2,.1,.4,/4,0,0-15,0-6,0.05-0.15,0.1,0.1-0.2,0.1-0.3,0.2-0.5,0.25-0.4,0.3-1.5,0.5,0.5-1.5,1-2,1.2-2.5,1.2-3,1/3,2-3,3,3-10,4-5,4-8,5,5-merous,7-15,abaxially,acut,alyx,ame,apar,apart,bark,blade,broad-deltate,c.,concolorous,curved,deltate,densely,difoliate,distance,drying,eaf,eed,elongating,equal,extending,eye,free,fruiting,geminat,glabrou,gra,hair,herbaceous,know,less,lon,lower,mature,midpoint,multangulate,naked,nflorescence,older,orolla,oung,pendulous,perfec,perpendicular,poricidal,porrect,portion,prickl,ray,reflexed,ruit,scar,sessile,side,slender,slightly,spaced,spreading,stalk,stalked,stellate,straight,strongly,tamen,tapering,terete,tip,trichome,tube,unequal,unit,vary,visible,way,wide,wider,ympodial	abaxial,acute,adaxial,arrangement,branching,characteristic,colour,corolla,form,growth,height,history,inflorescence,life,na,ovary,plant,primary,pseudostipule,rachi,seed,shape,staman,tertiary,texture,vein
144	wfo-0001027378	success	149	114	72	77	42	0.483	.2,abaxially,acuminate,acute,adaxial,anther,apex,base,blue,broadly,calyx,chartaceous,cm,cordate,deeply,diameter,extra-axillary,filament,flattened,fleshy,flower,fruit,glabrous,hair,half,herbaceous,lanceolate,leaf,light,lobe,lower,margin,markedly,minutely,mm,ovate,ovoid,palmate,papillose,pedicel,peduncle,petiole,pointed,primary,pubescent,rachi,revolute,rounded,sand-punctate,scattered,short,side,simple,slender,slightly,small,somewhat,spaced,sparsely,stem,style,tip,tooth,trichome,unbranched,unknown,vein,venation,vine,white,widely,x	0.5â1,0.7â1,0.8â2.5,1.2â1.5,1.2â1.8,1.5â1.8,1.5â8,15â35,1â1.5,1â3,2.3â5,2.5â7,2â11,2â2.2,2â2.5,3â4.5,3â5,3â6,4â6,4â9,5-8,5-merous,5â10,5â13,5â7,6â10,6â7,adaxially,alyx,apar,apicall,axe,berry,blade,c.,capitat,ciliate,clavate,climbin,color,cylindrical,deltoid,densely,eaf,eed,fruiting,glabrou,hair-tipped,like,lon,long,longer,m.,membranous,moderately,narrowly,nflorescence,nternode,obscure,often,orolla,pentagonal,perfec,plurifoliat,rotate-stellate,ruit,sand-punctat,stigma,tamen,tem,terrestrial,tube,unit,unknow,vary,wide,ympodial	0.5-1,0.7-1,0.8-2.5,1-3,1.2-1.5,1.2-1.8,1.5-1.8,15-35,2-11,2-2.2,2-2.5,2.5-7,3-4.5,3-6,4-6,5-7,6-10,abaxial,arrangement,branching,characteristic,colour,corolla,form,growth,height,history,inflorescence,length,life,midvein,na,ovary,plant,pseudostipule,seed,shape,staman,surface,tertiary,texture,unarmed
145	wfo-0001027378	success	141	107	77	64	30	0.546	.2,0.7-1,0.8-2.5,1-3,1.2-1.5,1.5-1.8,15-35,2-11,2-2.2,2.5-7,3-4.5,3-6,4-6,5-8,6-10,abaxially,acuminate,acute,anther,apart,apex,articulated,base,blue,broadly,calyx,chartaceous,clavate,cm,cordate,cylindrical,deeply,densely,diameter,extra-axillary,filament,fleshy,flower,fruit,glabrous,hair,hair-tipped,herb,lanceolate,leaf,light,lobe,margin,minutely,mm,obscure,often,ovate,pedicel,peduncle,petiole,pubescent,rachi,revolute,rounded,scattered,short,simple,slender,small,somewhat,spaced,sparsely,style,tip,tooth,trailing,unbranched,vein,white,widely,x	1-1.5,1.5-8,2-4,2.3-5,3-5,4-9,5-13,5-merou,6-7,adaxially,ag,alyx,apicall,apparently,axe,ba,basally,blade,capitat,ciliate,climbing,connivent,deltoid,directed,distally,eaf,eed,equal,fruiting,geminat,large,long,longer,longitudinal,lower,moderately,multicellular,narrowly,nflorescence,node,oblong,opening,orolla,perfect,plurifoliate,pore,pubescen,rooting,rotate-pentagonal,slightly,slit,stigma,tamen,tem,terrestrial,tube,unit,unknow,unknown,vary,weakly,wide,yellow,ympodial	abaxial,adaxial,arrangement,branching,characteristic,colour,corolla,form,growth,height,history,inflorescence,length,life,midvein,na,ovary,perennial,plant,primary,pseudostipule,seed,shape,staman,stem,surface,tertiary,texture,unarmed,venation
146	wfo-0001027384	success	155	104	73	82	31	0.471	.75,0.4-1.1,0.5-1,0.9-1,1-1.3,1-1.5,1-3,1-4,1.5-2,3-3.5,3-4,4-7,5-15-flowered,5-5.5,7.5-8,acute,anther,apex,base,berry,broadly,brown,calyx,cm,corolla,cuneate,deep,dia,filament,flattened-reniform,glabrous,globose,green,hard,herbarium,leaf,lobe,long,margin,minutely,mm,mustard,narrowly,obovate,opposite,ovary,pair,pale,papillose,pedicel,petiole,pitted,pseudo-terminal,reddish-purple,rounded,shrub,simple,slender,small,specimen,stem,straight,style,sulcate,surface,tapering,tree,triangular,tube,vein,white,x,yellow	.25,.5,/3,2.5-6.5,3/4,7-14,abov,anothe,anthesi,apart,ba,bark,beginning,beneath,breaking,bud,capitate,clavate,closely,difoliate,distal,drying,eaf,edicel,eed,ellipsoid,equal,erect,free,fruiting,geminate,incrassate,inflorescenc,later,lateral,lobed,long-exserted,lower,main,member,middle,nflorescence,occasionally,older,overlapping,paler,papillo,peeling,planar,pore,poricidal,portion,prominent,rarely,ruit,scar,section,shaped,shining,siz,spaced,stigma,subcoriaceous-fleshy,tall,tear-drop,thick,tip,transverse,trichome,tub,tuft,ud,uniseriate,unit,way,widely,widest,without,woody,yellowish,ympodial,young	abaxial,adaxial,alternate,arrangement,branching,characteristic,colour,diameter,form,fruit,growth,height,history,inflorescence,length,life,midvein,na,peduncle,perennial,plant,primary,pseudostipule,rachi,seed,shape,staman,tertiary,texture,unarmed,venation
147	wfo-0001027389	success	154	117	81	73	36	0.526	.5,0.25-0.3,0.25-0.5,0.5-1.5,0.6-1,1-1.5,1-2,2-2.5,3-3.5,5-7,7-8,acuminate,acute,anther,anthesi,apart,apex,bark,base,berry,broadening,brown,bud,calyx,cm,corolla,dark,decurrent,deflexed,deltoid,ellipsoid,elliptic,evenly,exserted,filament,glabrous,globose,green,hispidulous,inflorescence,leaf,lobe,margin,minutely,mm,ovary,ovate,ovoid-reniform,pair,pedicel,petiole,pitted,pore,puberulent,raised,reddish-golden,reflexed,scar,shaped,shrub,simple,slender,slight,slightly,soon,spaced,sparsely,stem,straight,style,surface,tapering,tear-drop,thread-like,top,truncate,tube,vein,white,winged,x	.1,.25,0.5-0.75,1,1.8-1.9,11-14,3-4.5,4-5-flowered,along,ba,beneath,broadly,conical,dia,dry,eaf,edicel,eed,erect,except,expanded,filiform,foetid,foliage,free,fruiting,geminate,lateral,like,lobed,lon,long,lower,main,making,material,middle,nearly,nflorescence,node,non-reproductive,obovoi,occasionally,often,older,one,opposite,paler,papillo,papillose,poricidal,portion,prominent,prominently,proximal,raise,rest,ruit,shin,side,stigma,tall,tip,trichome,ud,unifoliat,uniseriate,unit,widest,woody,yellowish,ympodial,young	abaxial,adaxial,arrangement,branching,characteristic,colour,deflexion,diameter,exsertion,form,fruit,growth,height,history,length,life,midvein,na,obovoid,peduncle,plant,primary,pseudostipule,rachi,reflexion,seed,shape,shiny,spacing,staman,tertiary,texture,unarmed,unifoliate,venation,winging
148	wfo-0001027395	success	153	88	58	95	30	0.379	.5,1-1.5,1-2,1.1-1.5,1.5-1.9,1.5-2.5,2-3,3.5-4,8,acute,anther,apex,apiculate,attenuate,base,berry,black,calyx,cm,corolla,deltoid,densely,depressed,dia,filament,fruit,glabrous,globose,green,immature,leaf,lobe,margin,minutely,mm,narrowly,obovate,occasionally,once-furcate,ovary,papillose,pedicel,petiole,primary,pubescent,raised,rusty-papillate,shiny,shrub,simple,stem,straight,style,vein,white,within,without,x	.25,0.25-0.5,0.6-1.1,0.75-1,1-5,1.6-2.9,10-20-flowered,11-15,12.5-17.3,2.2-7,4-6,5-6.5,anthesi,apically,bark,becoming,beginning,beneath,caly,capitate,closely,conical,constricted,cucullate,decurrent,deflexed,differing,difoliate,drying,eaf,edicel,eed,enlarging,erect,exfoliating,exserted,fleshy,free,fruiting,geminat,imperceptibly,inflorescenc,known,large,lateral,lobed,lon,long,lower,main,major,midrib,minor,nearly,nflorescence,older,opposite,overlapping,ovoid,pair,papillo,partially,piece,planar,pointed,pore,poricidal,portion,restricted,robust,ruit,scar,secondary,shaped,shining,size,small,somewhat,spaced,stigma,tall,tapering,tear-drop,thick,thickened,tip,transverse,trichome,tube,ud,uniseriate,unit,woody,ympodial,young	abaxial,adaxial,alternate,arrangement,branching,characteristic,colour,diameter,form,growth,height,history,inflorescence,length,life,midvein,na,peduncle,perennial,plant,pseudostipule,rachi,seed,shape,staman,surface,tertiary,texture,unarmed,venation
149	wfo-0001027396	success	244	129	107	137	22	0.439	0-3,0-30,0-4,0-5,0.5-1,0.5-1.5,0.7-2.5,0.8-1.3,1.5-3.5,1/3,10-30,12-25,2-3,2.8-4.5,20-100,3.5-6,5-30,5-8,5.5-7.5,6.5-7.5,7-10,8-20,abaxial,abaxially,acute,adaxial,almost,anther,apex,apically,apparently,articulated,attenuate,base,berry,black,brown,calyx,cm,cream,cuneate,dark,deltate,densely,diameter,elliptic,elongate,erect,fewer,filament,flattened-reniform,fruit,glabrous,glandular,green,hair,herb,lateral,leaf,length,lobe,lobed,long-styled,margin,marking,maturity,mauve,midvein,mm,near,obtuse,orange,pair,pale,pedicel,peduncle,petiole,plant,prickle,primary,pubescent,purple,red-brown,short-styled,shrub,simple,sometimes,somewhat,sparsely,spherical,stellate-pubescent,stem,style,surface,tertiary,trichome,unarmed,unbranched,upper,vein,venation,visible,white,yellow,yellow-green,yellowish,young	-2,-5,-6,/3,0-100,0.1-0.5,0.1-1,0.4-0.7,0.5-2,0.5-2.5,0.8,1,1-4,1.2-2,1.5-3,1.8-3,1/2-2/3,1/4-1/3,1/6,10-15,10-25,10-35,15-40,2-3.5,2-7,2.5-4,3-,3-9,4,4-5,4-6,4-7,5-10,5-20,5-50,5-merous,6-20,7-15,alyx,ame,andromonoecious,apar,apart,ba,bark,blade,broad,broad-deltate,bulbous,c.,chartaceous,concolorous,connivent,curved,decurrent,difoliate,discolorous,distal,distance,drying,eaf,eed,elongating,equal,extending,extensive,flattened,flower,free,fruiting,fully,geminat,glabrescent,gray-brow,hermaphrodite,heterostylous,infructescence,less,lignified,lobing,lon,long,long-acuminat,longer,lower,lowermost,mature,midpoint,moderately,nflorescence,often,older,one,open,opening,orolla,oung,pendulous,per,pericarp,perpendicular,poricidal,porrect,portion,prickl,prickly,ray,reflexed,rotate,ruit,scar,secondary,sessile,side,smooth,spaced,spreading,stalk,stalked,staminat,stout,straight,tamen,tapering,tearing,terete,time,tip,tube,unit,usually,variously,vary,way,wide,woody,ympodial	arrangement,branching,characteristic,colour,corolla,false,form,growth,height,history,inflorescence,life,long-acuminate,na,ovary,perennial,pseudostipule,rachi,seed,shape,staman,texture
150	wfo-0001027449	success	160	97	67	93	30	0.419	.4,0.5-1,0.5-1.5,0.8-1.5,0.9-1.1,1.4-1.5,10-15-flowered,2-4,3,3-3.5,4-6,5-6,acuminate,acute,anther,apex,base,beneath,berry,brown,calyx,cm,corolla,dark,densely,elliptic,filament,fruit,glabrate,glabrous,globose,green,inflorescence,leaf,lobe,long,long-triangular,minutely,mm,narrowly,oblique,often,older,ovary,ovoid-reniform,pair,papillose,pedicel,petiole,pitted,pubescent,red-papillose,shrub,simple,small,sparsely,stem,straight,style,surface,tree,trichome,uniseriate,vein,white,x,young	.5,.75,/3,1.2-1.5,1.5-2.5,2-3,3-7,8-15,anthesi,appearing,area,arising,around,axil,bark,becoming,beginning,bud,closely,cup,deciduous,deflexed,dense,density,dia,differing,difoliate,dry,eaf,edicel,eed,ellipsoid,erect,exserted,extreme,forming,free,frui,fruiting,geminat,inflorescenc,lamina,later,lateral,like,lobed,lon,long-acuminate,lower,main,major,material,minor,nflorescence,obconic,one,opposite,orangish,overlapping,packed,pale,persistent,pointed,pore,poricidal,portion,prominent,raised,reddish-brow,reflexed,rest,ruit,scar,shaped,size,slender,soon,sparse,stigma,styl,tall,tapering,tear-drop,tip,trunk,tube,tuft,ud,unit,varying,way,woody,ympodial	abaxial,adaxial,alternate,arrangement,branching,characteristic,colour,diameter,form,growth,height,history,length,life,margin,midvein,na,peduncle,perennial,plant,primary,pseudostipule,rachi,seed,shape,staman,tertiary,texture,unarmed,venation
151	wfo-0001027452	success	152	123	92	60	31	0.605	.5,0.5-1,0.5-1.5,0.5-2,1,1-3,1-5,1.5,1.5-3,10-20,2-6,2-foliate,3-6,3-9,4,4-6,5-12,5-20,absent,acute,anther,apex,base,berry,beyond,branched,brown,calyx,cell,center,chartaceous,ciliate,cm,connected,decurrent,densely,diameter,dm,drying,elliptic,elliptic-ovoid,entire,equal,exserted,filament,flower,fruit,glabrous,globose,hair,herb,immature,large,linear-lanceolate,lobe,margin,maturing,membranaceous,mm,moderately,nearly,obtuse,often,outer,parallel,pedicel,peduncle,per,perpendicular,petiole,pubescent,rachi,raised,ridge,rounded,running,seed,semitransparent,single,smaller,smoother,sparsely,stamen,style,swollen,unbranched,usually,vein,wall,white,x,yellow	0.5-2.5,1-2,1-4.5,2-4,abaxially,abundant,adaxiall,adaxially,along,axe,blade,celled,cordate,dehiscing,denser,eaf,eed,emarginat,explosively,flat,frui,geminat,growt,held,interpetalar,long,lower,lying,maturit,mesocarp,new,nfloresence,notched,oblong,one-,orolla,placenta,pressure,pubescen,rotate,ruit,short,significantly,slightly,sometimes,stigma,straight,tal,tamen,tem,tissue,triangular,tube,two-celled,unit,vary,watery,wid,woody,ympodial	abaxial,adaxial,arrangement,branching,characteristic,colour,corolla,form,geminate,growth,height,history,inflorescence,leaf,length,life,midvein,na,ovary,perennial,plant,primary,pseudostipule,shape,staman,stem,surface,tertiary,texture,unarmed,venation
152	wfo-0001027471	success	165	140	108	57	32	0.655	.5,0.1-0.2,0.2-0.5,0.4-1,0.5-0.6,0.5-0.7,0.5-1.5,0.9-1,1-1.2,1-1.5,2-2.5,2-3,3-4,4-5,6-7,acute,age,anther,apex,base,berry,branched,brittle,calyx,closely,cm,conical,corolla,dendritic,densely,desnsely,diameter,difoliate,distant,elliptic,entire,filament,flattened,flower,fruiting,geminate,glabrous,globose,growth,herb,included,inflorescence,internodal,lamina,leaf,leaf-opposed,lengthening,less,like,lobe,long-triangular,margin,maturity,midvein,minutely,mixture,mm,new,node,occasionally,ovary,ovate,overlapping,pair,pale,pedicel,peduncle,pericarp,petiole,pitted,plane,pore,primary,pubescent,pubscent,rachi,red-orange,reniform,scar,shape,shrub,simple,slender,slit,small,somewhat,spaced,sparsely,stem,style,subshrub,surface,tan,thin,tip,trichome,uniseriate,unit,usually,vein,white,x,yellowish	/4,0.2-0.4,0.5,0.7-0.9,1-1.6,1.4-3,1.5-2,2-lobed,3-7,abaxially,adaxially,along,anthesi,appressed,ascending,bark,bifid,c.,deltate,differing,drying,eaf,eed,erec,erect,especially,free,furcate-dendritic,lobed,lower,major,minor,nflorescence,nodding,open-conical,orbicular,papillat,perfect,petal,planar,poridical,portion,reflexed,ruit,scattered,similar,size,slightly,stigma,straight,thickened,trifoliat,tube,ud,way,woody,ympodial	abaxial,adaxial,arrangement,branching,bud,characteristic,colour,distance,form,fruit,height,history,inclusion,length,life,na,perennial,plant,position,pseudostipule,pubescence,seed,spacing,staman,sympodial,tertiary,texture,thicknes,trifoliate,trifoliation,unarmed,venation
153	wfo-0001027473	success	138	116	83	55	33	0.601	0.5-1,0.8-1,1-1.5,1-2,1.3-2,1.8-2,2.5-3,3.5-5,5,6-9,?,acute,anther,apex,apparently,bark,base,berry,brown,calyx,clavate,cm,corolla,deccurent,decurrent,deflexed,dendritic,densely,di-,differing,empty,filament,flattened-reniform,glabrous,globose,green,incrassate,leaf,lobe,long-triangular,major,margin,minor,minute,minutely,mm,near,obovate,occasionally,ovary,pair,pale,pedicel,petiole,pitted,pointed,pore,pubescent,rootstock,rusty,sac,sessile,shape,shaped,shrub,somewhat,sparsely,stem,sterile,stigma,strongly,style,subshrub,surface,tear-drop,thick,trichome,trifoliate,vein,white,wing,winged,woody	.25,/2,0.25-0.5,1.5-2,1/3,2-2.5,4.5-13,8.5-37,abaxially,absen,adaxially,along,anthesi,ape,conical,deep,denser,dia,drying,eaf,eed,erect,free,fruiting,geminat,giving,later,lateral,less,like,lobed,long,lower,main,middle,older,overall,papillo,planar,poricidal,portion,pubesent,ruit,tall,tip,tube,unit,usually,way,wide,widest,yellowish,yellowish-brow,ympodial,young	0,abaxial,absent,adaxial,arrangement,branching,characteristic,colour,depth,diameter,form,fruit,growth,height,history,inflorescence,length,life,midvein,na,papillose,peduncle,plant,primary,pseudostipule,rachi,seed,staman,tertiary,texture,unarmed,venation,yellowish-brown
154	wfo-0001027483	success	164	83	61	103	22	0.372	0.2-1.9,0.6,1-4,1.5-2.6,1.5-3,2-4,2-4.5,3-15,3-6,4.5-8,5-6,branched,calyx,cell,cm,coarsely,corolla,covering,cyme,diameter,dichasial,dichasially,ebracteate,elliptical,filament,finely,globose,green,green-white,hair-like,herbaceous,lateral,leaf,leaflet,light,lobe,long,medium,mm,monochasial,mucilaginous,odd-pinnate,ovate,ovoid,pair,pedicel,peduncle,perennial,petiole,plant,pubescent,rachi,seed,straight,style,terminal,testal,thick,violet,violet-purple,wall	0-1.,1,1-2,1-2.5,1-5,1.2-2.5,1.5-10,2,2-3,3-6-foliat,3.5-20,5-10,abaxially,acumen,acute,adaxially,apex,apical,apically,articulate,basal,base,connate,cuneate,decurrent,dehiscent,digestion,diminishing,distal,dorsally,dot,eaf,edge,eed,emoval,enzyme,erec,exceeding,flat,flower,folded,forked,generally,globo,gradually,half,honeycomb,interjected,interpetiolar,introrse,lighter,living,lon,lower,lunat,make,maturing,minute,nflorescence,nther,obtuse,often,orolla,pattern,perfect,petiolule,plan,poricidally,proximal,purple,ray,reveal,rosette,rotate,rounded,ruit,sessile,seudostipule,short,size,slit,smooth,sometimes,specimen,stamen,stigma,subsessile,tall,tem,throughout,tissu,toward,tuber-bearing,typically,uniform,unit,vary,varying,white,wide,yellow,ympodial,Â¼	anther,arrangement,branching,characteristic,colour,form,fruit,growth,height,history,inflorescence,length,life,na,ovary,shape,staman,stem,surface,texture,unarmed,width
155	wfo-0001027506	success	215	128	105	110	23	0.488	-1,.2,0,0-10,0-2,0-6,0-60,0.5-1.5,0.5-6,0.7-1.3,0.8-1.5,1-2,1.2-1.5,1.8,1/3,2-3.2,2.2-3.5,3-5,3.5-5,5-7,6.5-10,acuminate,acute,anther,apex,apically,apparently,articulated,base,becoming,berry,branched,brown,calyx,cell,cm,cordate,cream,cuneate,dark,densely,diameter,entire,erect,filament,fine,flattened-reniform,fruit,green,infructescence,lateral,leaf,length,lobe,long,margin,marking,maturity,mauve,mm,moderately,narrow-deltate,occasionally,orange,orange-brown,outline,ovate,pair,pale,pedicel,peduncle,per,petiole,pit,plant,prickle,prickly,primary,purple,raised,shrub,simple,small,smooth,sometimes,spherical,stellate-pubescent,stem,style,subentire,surface,terminal,tertiary,tree,truncate,twice,unarmed,upper,vein,venation,visible,wide,yellow,yellow-green,young	-0.35,-20,-3,-7,-7.5,.5,/2,/6,0.1-,0.1-0.3,0.2,0.2-0.3,0.25,1-3,1-4,1.5-2.2,1/6-1/4,10-40,2.5-5,2.5-8,3-10,3-6,5-10,5-merous,6-13,7-8,7-9,8-10,9-13,abaxially,acuminat,alyx,ame,andromonoecious,apar,apart,bark,blade,brow,c.,chartaceous,concolorous,connivent,curved,distal,dry,drying,eaf,eed,elongating,equal,flattened,flower,free,fruiting,glabrescent,glabrous,hard,hermaphrodite,heterostylous,lengt,lobed,long-styled,longer,lower,lowermost,mature,midpoint,multangulate,nflorescence,older,one,open,orolla,oung,pendulous,pericarp,plurifoliat,poricidal,porrect,portion,prickl,ray,reddish,reduced,reflexed,ruit,scar,sessile,short-styled,spaced,spreading,stalk,stalked,staminat,stellate,stout,tamen,tapering,terete,time,tip,trichome,tube,unit,variously,vary,way,woody,ympodial	abaxial,adaxial,arrangement,branching,characteristic,colour,corolla,form,growth,height,history,inflorescence,life,midvein,na,ovary,perennial,pseudostipule,rachi,seed,shape,staman,texture
156	wfo-0001027548	success	216	130	105	111	25	0.486	.3,0.3-1.2,0.5-2,1,1-1.5,1-2.5,1.2,1.5-2.5,10-12,4-8,4.5,6-9,8-9,acuminate,acute,almost,along,anther,apex,attenuate,base,berry,black,branched,branching,brown,calyx,cell,cm,corolla,dark,deltate,dendritic,densely,depressed-elliptic,diameter,dull,elliptic,elongate,entire,filament,flattened-reniform,glabrous,globose,green,growth,immature,inflorescence,lamina,leaf,like,lilac,lobe,long,loose,loosely,many,margin,matte,membranous,minutely,mm,narrowly,near,outline,pair,pale,pedicel,peduncle,per,pericarp,petiole,pitted,primary,puberulent,pubescent,rachi,rectangular,reddish,revolute,ripe,scattered,simple,slender,small,sparsely,stem,style,surface,terminal,testal,thickened,thin,time,tinged,tiny,trichome,uniseriate,upper,usually,vein,vine,white,woody,x	-11.5,0.2,0.5,1-10,1-3.5,1.5,1.5-2,10-50,3-7,4-6,5-merou,7-10,abaxiall,adaxially,ag,also,although,alyx,anthesi,apart,apical,apparently,appearing,area,ark,articulated,articulation,axi,basal,beneath,bent,branch,bu,c.,capitate,conical,connivent,darker,deflexe,denser,drying,eaf,early,eed,ellipsoid,em,exserted,extending,flexuous,flower,free,fruiting,geminat,glabrescen,glandular,half,herbarium,ilament,irregularly,leaving,lengthening,less,lobed,lon,long-styled,lower,minute,mixed,new,nflorescence,occasionally,older,orolla,papillae,papillate,papillo,perfect,planar,plurifoliate,point,pore,poricidal,portion,prominent,ruit,scar,size,slit,sometimes,somewhat,spaced,sparse,specimen,spreading,stellate,stigma,strongly,swollen,tapering,tip,transparent,tube,twinin,type,ud,unit,vary,warty,way,yellow,ympodial	8,abaxial,adaxial,arrangement,characteristic,colour,form,fruit,height,history,length,life,midvein,na,ovary,perennial,plant,pseudostipule,seed,shape,staman,tertiary,texture,unarmed,venation
157	wfo-0001027581	success	200	97	63	137	34	0.315	abaxial,abaxially,acute,adaxial,anther,anthesi,apex,base,berry,branched,branching,broadly,brown,calyx,cm,corolla,dark,deltate,densely,diameter,elliptic,entire,evenly,filament,flattened-reniform,globose,golden,green,greyish,growth,inflorescence,leaf,length,lobe,many,margin,minutely,mm,moderately,nodding,pair,pedicel,peduncle,petiole,pitted,plane,primary,pubescent,purple,reddish,ripe,shrub,simple,small,sparsely,stem,stout,style,surface,terminal,time,tree,vein	0.2â0.3,0.3,0.3â1,0.5â1,0.5â1.5,1,1.2â1.5,1.3â1.5,1.5,1.5â2,1.5â3,10,100+,10â16,12,12â30,15â20,1â1.5,1â3-rayed,2.5â3,200,3.5â4.5,3â3.5,4.5â16,4â8,5-merou,6â7,7â10,7â9,8,8â10,9â11,9â9.5,>,ag,along,alyx,apar,ark,articulated,axe,beneath,brow,bulbous,c.,clavate,clearly,closely,connivent,cup-shaped,dichasia,discolorous,distally,drying,eaf,echinoid,eed,ellipsoidal,erec,exserted,flower,free,fruiting,glabrescent,glabrous,gradually,ilament,lamina,largest,lengthening,less,like,lobed,long,longest,loosely,lower,midvei,minute,mixed,multangulate,multiseriate,narrowing,near,new,nflorescence,older,orolla,papillo,part,per,perfect,pericarp,plurifoliate,pore,poricidal,porrect-stellate,portion,ray,reflexed,rhachi,ruit,scar,scarcely,sessile,shiny,short-stalked,size,slit,smaller,spaced,spreading,stalk,stellate,stigma,tall,tem,thin,tip,trichome,tube,ud,undersurface,unevenly,unit,upper,vary,varying,visible,way,weak,whit,wide,woody,yellow,yellowish,ympodial	1-1.5,1.3-1.5,1.5-2,1.5-3,2.5-3,3-3.5,4-8,7-10,7-9,9-11,9-9.5,arrangement,characteristic,colour,form,fruit,height,history,life,midvein,na,ovary,plant,pseudostipule,rachi,seed,shape,staman,tertiary,texture,unarmed,venation,white,ye
158	wfo-0001027584	success	144	101	72	72	29	0.5	-16,-2,0.5-1,0.5-1.5,0.9-1,0.9-2.5,1-1.2,1.5-2,1.6-1.9,10-15,2,2-10,3,3-.,4-6,4-7,7-10,abruptly,acuminate,anther,apex,attenuate,base,branched,broadly,calyx,cm,conical,corolla,darker,deltate,densely,diameter,ellipsoid,elliptic,filament,flattened,four,fruit,glabrous,green,herb,lobe,long,margin,minutely,mm,ovary,ovate,pair,pale,papillate,pedicel,peduncle,per,petiole,primary,reddish,reniform,shrub,smooth,sparsely,stem,stripe,style,suffruticose,surface,tan,time,vein,white,x	..,.5,1.2-1.4,1.5-8,100,11.5-45,2.5-3,4.5-20,8-9,absent,anthesi,apical,bark,becoming,beginning,beneath,branch,brittle,brow,c.,capitat,cell,cucullate,deflexe,dry,eaf,edicel,eed,erec,flower,fruiting,irregular,lamina,lobed,lower,markedly,narrowly,nearly,nflorescence,open,outer,outline,pericarp,planar,plurifoliat,pointed,present,regularly,ruit,scar,scattered,single,single-stemmed,sinuate,small,sparse,stigma,striate,testal,thickening,thin,tip,triangular,trichome,tube,tuft,ud,uniseriate,unit,wall,without,ympdoial	abaxial,adaxial,arrangement,branching,brown,characteristic,colour,deflexed,form,growth,height,history,inflorescence,leaf,length,life,midvein,na,plant,plurifoliate,pseudostipule,rachi,seed,shape,staman,tertiary,texture,unarmed,venation
159	wfo-0001027600	success	185	141	109	76	32	0.589	0.5-1.5,1,1-14,1-2,1-4,1-5,1.5-2,10-,10-20,15-25,2-11,2-3,2-3.5,2-4,2-4.5,2-6,20-30,3-15,3-5,3-5-lobed,3-6,8-17,abaxially,acuminate,acute,adaxial,adaxially,along,apex,articulated,axe,basal,base,beyond,calyx,cm,collection,cordate,cuneate,deltate,densely,diameter,dilated,distally,ellipsoidal,entire,especially,except,exserted,fading,flattened,fleshy,flower,forked,fruit,glabrescent,glabrous,greenish-white,leaf,leaving,lobe,lobed,long,main,margin,mature,midrib,minutely,mm,moderately,obconical,obtuse,occasionally,older,orange,pedicel,pedicellar,peduncle,perfect,petiole,pilose,pinnately,puberulence,puberulent,pubescent,purple,rachi,rarely,remnant,rounded,simple,slightly,somewhat,sparsely,stamen,strongly,style,subcoriaceous,surface,tip,tree,truncate,unbranched,unlobed,vein,x,yellow,yellow-green,young	-10,-3,0.5-1,1.5-2.5,1/2-3/4,2-18,2-5,2.5-21,2.5-6,4-6,4-foliat,5-13,abruptly,absen,absent,adpressed,aggregate,apart,ape,apical,apiculate,blade,brow,campanulate,cell,channe,concave,connective,coriaceous,cream,directed,divided,eaf,eed,elliptic,exceeding,gland,glandular-puberulent,laterally,lon,lower,narrowed,nflorescence,nther,oblong,orolla,ovate,ovoid,papillose,pilo,pore,puberulen,purplish,radiu,ruit,shorter,sinus,small,spaced,stigma,stone,tal,tem,thecae,time,tomento,triangular,tube,two,ud,unit,vary,white,wide,yellowish,ympodial	abaxial,anther,arrangement,branching,channel,characteristic,colour,corolla,filament,form,green,growth,height,history,inflorescence,length,life,midvein,na,ovary,perennial,plant,primary,pseudostipule,seed,shape,staman,stem,tertiary,texture,unarmed,venation
160	wfo-0001027607	success	167	133	99	68	34	0.593	.1,.5,0.25-0.5,0.5-1,0.8-1,1-4,1.2-1.5,2-2.5,2-3,2-4,2.5-3,3-3.5,4-10-flowered,5-7,8-9,acuminate,acute,age,anther,apex,arching,bark,base,becoming,berry,branch,brown,calyx,cm,corky,corolla,curling,dark,decurrent,deflexed,deltoid,densely,dia,dry,ellipsoid,elliptic,elongate,evenly,exserted,filament,filiform,flattened,fruiting,gently,glabrate,glabrous,globose,golden,green,leaf,lobe,long,material,minute,minutely,mm,narrowly,obovoid,ovary,ovoid-reniform,pair,papillose,pedicel,petiole,pitted,plant,present,pubescent,raised,reddish-brown,scar,short,shrub,simple,slender,slightly,soon,spaced,stem,straight,style,surface,tan,tapering,treelet,trichome,tube,unifoliate,uniseriate,vein,white,winged,woody,x	.25,0.5,1,1.5-3,3/4,5-10,anthesi,apar,area,aspect,ba,basal,branche,eaf,edicel,eed,erect,except,f,free,geminate,giving,lamina,lateral,lenticellat,less,like,lobed,lon,lower,m.,main,middle,midrib,narrow,nflorescence,non-reproductive,occasionally,older,opposite,pagoda-like,pore,poricidal,portion,prominent,rarely,reflexed,ruit,shaped,slight,small,stigma,strongly,styl,tall,tear-drop,tip,tub,ud,unit,way,widened,widening,widest,yellowish,ympodial,young,zig-zag	0.25,2.5,abaxial,adaxial,apart,arrangement,branching,bud,characteristic,colour,diameter,exsertion,form,fruit,growth,height,history,inflorescence,length,life,margin,midvein,na,peduncle,primary,pseudostipule,rachi,seed,shape,staman,tertiary,texture,unarmed,venation
161	wfo-0001027618	success	202	122	86	116	36	0.426	-pubescent,1,1-14,1-23,1-5,1-9,1.4-4,15-35,2-11,2-11.5,2.5-6,3-5,4,4-8,5-7.5,6-40,8-16,8-35,abaxially,acute,adaxially,also,apex,articulated,base,branched,chartaceous,cm,compound,cordate,cuneate,deltate,densely,diameter,ellipsoidal,entire,flower,fruit,fusiform,glabrous,globose,greenish,leaf,leaving,length,less,lobe,long,margin,membranaceous,minutely,mm,moderately,near,obtuse,orange,pedicel,pedicellar,peduncle,per,petiole,pilose,pinnately,puberulent,puberulent-pubescent,pubescent,pubescent-pilose,purple,rachi,remnant,reticulate,ripe,shrub,simple,sometimes,sparsely,style,sympodial,tree,triangular,truncate,unbranched,unit,white,x,yellow	-10,0-10,0.5,0.5-1,0.5-6,1-,1-1.5,1-13,1-3,1.5-13,1.5-3,1.5-7,1.5-8.5,11-16,11-22,11-pinnate,12-27,15-30,2-12,2-27,2-5,2-8.5,2-9,3-18,3-30,3-7,3-7-pinnate,3.5-6,5-18,5-20,5-30,5-merous,5.5-12,6-25,7-25,acuminat,acut,aggregate,alyx,apart,ape,ascending,axe,basal,beyond,blade,bud,campanulate,capitate,cell,connective,cylindrical,darker,dia,diamete,dilated,directed,distally,eaf,eed,elliptic,elliptic-ovate,exceeding,exserted,fleshy,lateral,laterally,leaflet,lon,longitudinal,lower,mesocarp,nflorescence,nther,oblong,obovate,obtu,often,orolla,ovate,papillose,perfec,perfect,petiolule,pilo,pore,presen,puberulent-pilo,radiu,ranch,ratio,rown,ruit,runk,shallowly,shorter,slightly,small,somewhat,spaced,spreading,stamen,stigma,stone,stripe,tal,terminal,thecae,tomentose,tube,uni,urceolate,vary,wide,width,without	1-8.5,abaxial,acuminate,adaxial,anther,arrangement,branching,calyx,characteristic,colour,corolla,filament,form,green,growth,height,history,inflorescence,life,midvein,na,ovary,plant,primary,pseudostipule,puberulent-pilose,seed,shape,staman,stem,surface,tertiary,texture,unarmed,vein,venation
162	wfo-0001027622	invalid_json	203	129	94	109	35	0.463	.5,0-14,0.3-10,1,1-2,1.5-3.5,2-25,2-6,2.5-3.5,3-4,3-4.5,3.5-11,6-7,abaxially,acuminate,acute,adaxially,anther,apex,articulated,base,berry,blue,blue-purple,broadly,brownish,cell,chartaceous,cm,condition,corolla,covering,diameter,distal,drying,elliptical,filament,fresh,fruit,glabrescent,glabrous,globose,green,green-white,greenish,hair,hair-like,herb,lateral,light,like,lobe,long,make,margin,membranous,middle,mm,mottled,mucilaginous,narrowly,oblique,odd-pinnate,ovate,ovate-lanceolate,ovoid,pale,pedicel,peduncle,petal,petiole,plant,pubescent,purple,rounded,seed,shortly,slightly,star,stem,striped,style,subglabrous,testal,thick,throughout,truncate,unwinged,wall,wet,whitish,wide,wing,yellow	0-16,1-10,1.5-4.2,1.6-4.5,1/,12-23,2-3,3-16,4-5,4-9.5,5-11,5-merou,6-17,8-16,8-20,acumen,ag,along,alyx,apart,apparently,axe,axillary,blade,borne,bud,capitat,ciliate,clavate,connivent,decumben,different,digestion,dorsally,eaf,edge,eed,elliptic,end,enzyme,erect,especially,exceeding,except,flat,flower,folded,forked,geminat,generally,glabrou,greatly,half,homostylous,honeycomb-shaped,interjected,lanceolate,leaflet,lengthening,living,lower,midrib,minutely,nflorescence,often,orolla,pair,pentagonal,perfect,petiolule,plurifoliate,population,pore,poricidal,proximal,puberulent,reduced,removed,ruit,seudostipule,singly,size,slit,sometimes,spaced,specimen,stamen,ste,stellate,stigma,stolo,straight,subequal,subtending,tall,tamen,tem,terminal,tip,tri-,tube,tuber,typically,unit,usually,vary,varying,x,ympodial	'',1/3,2,[,``,abaxial,adaxial,arrangement,branching,calyx,characteristic,colour,form,growth,height,inflorescence,leaf,length,midvein,na,ovary,primary,pseudostipule,rachi,shape,staman,surface,tertiary,texture,unarmed,value,vein,venation,{,}
163	wfo-0001027624	success	189	109	78	111	31	0.413	0.1-0.9,0.3-1,0.5-1.5,1-2,1.1-8.4,1.2-2.6,2-20,2.4-4.8,3-10,3-4,4-7,4-8,5-9,9-41,acuminate,acute,anther,apex,articulated,base,berry,brownish,cell,cm,condition,corolla,covering,decurrent,deep,densely,diameter,drying,elliptic,entirely,filament,flower,forked,fresh,fruit,glabrous,globose,green,greenish,hair,hair-like,herb,lanceolate,lateral,leaf,light,like,lobe,long,mm,mottled,odd-pinnate,onto,ovate,ovoid,pedicel,peduncle,petiole,plant,pubescent,purple,rachi,seed,short,sometimes,style,testal,thick,unwinged,usually,wall,white,whitish,widely	0-3,0-7,0.4-3,0.8-5.6,1-3,1-5,1.3-2.9,1.5-6.6,2-5,2-7,2.9-12,3-11,3-5,4-15.2,5-merou,6-18.5,abaxially,acuman,acumen,adaxially,ag,along,alyx,apart,apparently,arranged,axe,axillary,bead,blade,bud,capitat,clavate,connivent,considerably,cuneate,decreasing,decumben,digestion,distal,dorsally,eaf,edge,eed,enzyme,erect,exceeding,flat,folded,geminat,glabrou,green-white,half,homostylous,honeycomb-shaped,interjected,larger,leaflet,leave,lengthening,living,lower,make,middl,moniliform,mucilaginous,multiple,necklace,nflorescence,orbicular,orolla,pair,pentagonal,perfect,plurifoliate,pore,poricidal,present,removed,rotate,ruit,sessile,seudostipule,size,slightly,slit,spaced,specimen,stamen,stigma,stolon,straight,subtending,tall,tamen,tem,terminal,throughout,tip,toward,tri-,tube,tuber,typically,unit,vary,wet,wide,x,yellow,ympodial	2,abaxial,adaxial,arrangement,branching,calyx,characteristic,colour,form,growth,height,history,inflorescence,length,life,margin,mentioned,middle,midvein,ovary,primary,pseudostipule,shape,staman,stem,surface,tertiary,texture,unarmed,vein,venation
164	wfo-0001027626	success	152	109	68	84	41	0.447	.3,.5,0.5-1,1,8,acuminate,adaxially,anther,apex,arrangement,base,broadly,calyx,chartaceous,cm,cordate,coriaceous,densely,diameter,distichous,elliptical,entire,extra-axillary,filament,fleshy,flower,fruit,glabrous,greenish-white,leaf-opposed,liana,lobe,margin,midvein,minutely,mm,moderately,nearly,oblique,ovate,pair,pedicel,peduncle,petiole,pinnate,pointed,possibly,pubescent,rachi,rounded,sand-punctate,shortly,shrub,slender,somewhat,spaced,sparsely,spindle-shaped,style,terminal,tip,unbranched,unknown,vein,venation,white,wiry-woody,x	0.1â0.2,0.2â0.6,0.5â1,0.7â1,0.7â2.8,1.3â4.5,1.5â2,1.5â8,13â14,14â116,2â3,2â49,2â5,3â4,3â4.5,3â5,3â55,4.4â11,4â6,5-merous,5â6,9â18,abaxially,accrescen,acute,along,alyx,apar,axe,berry,blade,c.,capitat,center,ciliat,clavate,climbing,color,distant,distinct,eaf,eed,frequently,fruiting,glabrou,immature,lamina,lanceolate,line,long,lower,m.,maturity,membranous,mor,nflorescence,nternode,orolla,perfec,petal,plurifoliat,reflexed,ruit,sand-punctat,scandent,scar,secondary,seen,side,simple,ste,stellate,stigma,tamen,tem,time,trichome,truncate,tube,two,unit,vary,wide,ympodial	0.2-0.6,0.7-1,1.5-2,1.5-8,13-14,2-49,2-5,3-4,3-5,4-6,5-6,9-18,abaxial,adaxial,apart,branching,characteristic,colour,corolla,form,growth,height,history,inflorescence,leaf,length,life,na,ovary,perennial,plant,primary,pseudostipule,seed,shape,staman,stem,surface,tertiary,texture,unarmed
165	wfo-0001027630	success	149	95	65	84	30	0.436	0.5-1,0.5-1.2,0.5-2,1-5,1.5-2,2-6-flowered,4-6,6-10,8-9,acute,anther,apex,base,berry,broadly,calyx,ciliate,climbing,cm,corolla,decurrent,deflexed,deltoid,densely,erose,filament,fruit,glabrate,glabrous,globose,golden,green,hirsute,knob-like,lanceolate,leaf,linear,lobe,long,long-acuminate,margin,mm,ovary,pair,partially,pedicel,petiole,puberulent,pubescent,raised,shrub,simple,sparsely,stem,straight,strongly,style,swollen,tapering,trichome,uniseriate,vein,white,winged,yellowish	.1,.2,.5,0.05-0.1,1-1.5,1.4-1.7,2-3,3/4,5.5-11.2,also,anthesi,apart,arising,bark,beginning,blunt,branchlet,de,dia,distinguishable,eaf,edicel,eed,elongat,except,extreme,free,fruiting,globo,immature,indistinct,inflorescenc,internodal,irregularly,known,lateral,lobed,lon,lower,main,middle,midrib,minutely,near,nflorescence,novo,occasionally,older,opposite,paler,papillose,pore,poricidal,portion,prominent,proximal,reflexed,rest,rounded,ruit,scar,seen,shaped,slender,spaced,stigma,tall,tear-drop,terminal,thickened,ti,tip,tube,ud,ultimate,unifoliat,unit,way,wide,widest,wing,x,ympodial,young	abaxial,adaxial,arrangement,branching,characteristic,colour,diameter,form,growth,height,history,inflorescence,length,life,midvein,na,peduncle,perennial,plant,primary,pseudostipule,rachi,seed,shape,staman,surface,tertiary,texture,unifoliate,venation
166	wfo-0001027661	success	222	113	88	134	25	0.396	+,0.5,0.5-,0.5-2,0.6-1.1,1-1.5,1-7,1.5-2,30,4.5-6,5-9,6-12,6-9,8-10,<,>,acuminate,acute,anther,apex,base,berry,bright,broadly,calyx,cm,cordate,corolla,densely,diameter,ellipsoid,entire,extremely,filament,flattened,glabrous,globose,green,grey,growth,herbaceous,lateral,leaf,leaf-opposed,lobe,lobed,margin,minutely,mm,moderately,often,pair,pale,pedicel,peduncle,per,petiole,pinnatifid,pitted,primary,pubescent,purple,purplish,rachi,red,reniform,ripe,shape,simple,slender,sparsely,spreading,stem,style,surface,tan,terminal,ternately,triangular,truncate,variable,vein,vine,violet,white,woody,yellow,yellowish	-10,0.6-1.5,1-,1-5,1.2-6,1.3,1.5,2,2.5-3,2.5-7,4-15,4-8-celled,40,5-merou,6-8,abaxially,adaxiall,ag,along,alyx,anthesi,apart,ark,articulate,axi,basal,branch,branched,capitate,cell,column,commonly,conical,connivent,creeping,deeply,dendritic,denser,density,eaf,eed,elliptic,even,flower,free,fruiting,fused,gre,ground,hue,ilament,irregularly,lamina,leaving,lengthening,like,long,long-exserted,lower,many,markedly,membraneous,minute,mixture,narrowing,near,new,nflorescence,occasionally,older,open,orolla,outline,ovate,papillat,papillate,papillo,peg,pentagonal,perfect,pericarp,plurifoliat,pointed,pore,poricidal,portion,prominent,pubescen,pubescence,rarely,reflexed,ruit,scar,shiny,short,single,sinus,size,sleeve,slit,small,spaced,spot,spreadin,stellate,stigma,strongly,swollen,tangled,tem,testa,thin,tightly,time,tip,trailing,trichome,tube,turbinate,two,type,ud,underground,unieriate,uniseriate,unit,upper,usually,vary,way,wide,ympodial,zig-za,Â¾	abaxial,adaxial,arrangement,branching,characteristic,colour,form,fruit,height,history,inflorescence,length,life,midvein,na,ovary,plant,plurifoliate,pseudostipule,seed,staman,tertiary,texture,unarmed,venation
167	wfo-0001027714	success	251	117	95	156	22	0.378	+,0.5,1-1.5,1-1.6,1-2,1.5-2,1.5-3,1.5-5,14-16,2-,2-2.5,2.5-4,3-3.5,4-5,4.5-5,5,5-6,6-7,7-20,<,abaxial,acuminate,acute,adaxial,anther,apex,basal,base,berry,branched,bright,brown,calyx,cm,conical,cordate,corolla,deep,densely,diameter,elliptic,elongate,entire,filament,flattened,fruit,glabrous,globose,growth,inflorescence,juicy,lateral,leaf,lobe,longer,many,margin,mm,obovate,occasionally,often,ovary,pair,pale,pedicel,peduncle,petiole,pinnatifid,primary,pubescent,purple,red,reddish,reniform,ripe,seed,shiny,simple,slender,somewhat,sparsely,stem,style,surface,terminal,time,tip,truncate,usually,vein,vine,violet,woody,x,yellowish	.5,/3,0,0.4,0.5-0.7,0.6-0.7,0.9-1.5,1,1-,1.5-2.5,2-8,2.5-,2373.,4-10,5-10,5-merou,80,abaxially,adaxially,age,aid,almost,along,alyx,angle,anthesi,apar,apice,appearance,ark,around,articulated,axi,canop,capitate,cell,channelled,climbin,confined,connected,connivent,corky,creating,cucullate,cupped,deflexed,dendritic,denser,drying,eaf,eed,ellipsoid,enlarged,especially,exserted,fide,fleshy,flower,free,fruiting,furcate,giving,glabrate,glabrou,groove,hairy,hanging,ilament,immature,individual,inflated,irregularly,lamina,large,leaving,lengthening,like,lobed,lon,long,loosely,lower,marginal,mature,mere,minute,minutely,mpodial,nee,new,nflorescence,nodding,older,orolla,otherwise,outline,papillate,papillo,peg,per,perfect,pericarp,petal,petiolule,pitted,plat,plurifoliat,pore,poricidal,portion,prominent,pubescence,reaching,rectangular,rim,ruit,scar,showy,similar,sleeve,slightly,slit,small,spaced,spreading,stellate-rotate,stigma,strongly,tangled,tem,testa,testal,thecae,thick,thickened,thin,third,tiny,tooth,trichome,tube,twining,ud,uniformly,uniseriate,unit,upper,visible,wall,way,weak,weight,widest,wing,yellow,younger	arrangement,branching,characteristic,colour,form,green,height,history,length,life,midvein,na,perennial,plant,pseudostipule,rachi,shape,staman,tertiary,texture,unarmed,venation
168	wfo-0001027720	success	184	115	88	96	27	0.478	0,0-15,0.25-0.35,0.3-5,0.5-0.8,0.5-1,0.8-1,1-1.5,1-2,1-3.5,1-locular,15-25,2-3,2-4,2-7,2-branched,2-foliate,3-13,4-5.5,4-7,7-8,7-9,8-16,absent,acute,anther,apex,base,berry,brown,calyx,chartaceous,cm,confined,cuneate,cylindrical,deltate,densely,diameter,elliptic,entire,extra-axillary,filament,flattened,flower,fruit,glabrous,globose,green,hair,inflorescence,leaf,length,lilac,lobe,long,margin,midrib,mm,narrowly,notched,oblique,ovate,pale,part,pedicel,peduncle,per,perennial,petiole,present,pubescent,rachi,red,shrub,simple,slightly,sparsely,stellate,stellate-pubescent,straight,style,subreniform,surface,toward,triangular,unarmed,yellow	%,.25-0.3,0.15-0.25,0.4-0.7,0.4-0.8,0.6-1.2,1.5-2,13-23,13-35,2.8-3.1,23-35,4-,4.3-15,4.3-7.5,5-merous,6,7-10,8-11,9-15,abaxially,absen,adaxiall,adaxially,adult,alyx,apparently,articulated,axe,ba,blade,capitat,connivent,directed,distall,distally,eaf,eed,eglandular,erect,finger,fruiting,geminat,gland-tipped,half,hig,homostylous,incomplete,intepetalar,juicy,juvenile,lamina,lanceolate,lateral,less,loosely,lower,markedly,mature,mesocarp,mid-point,midpoint,minute,nflorescence,orolla,perfec,perfect,pore,porrect,prickle,ray,rhizomatous,ruit,scarce,septum,sessile,short,stellae,stigma,succulen,tamen,tem,thick,thicker,time,tissue,tube,unarme,unit,upper,vary,white,wide,without,x,yellowi,ympodial	abaxial,adaxial,arrangement,branching,characteristic,colour,corolla,form,geminate,growth,height,history,life,midvein,na,ovary,plant,primary,pseudostipule,seed,shape,staman,stem,tertiary,texture,vein,venation
169	wfo-0001027720	success	272	128	103	169	25	0.379	0.1â0.6,0.8â1.9,1.5â2.5,1.5â3.3,1.5â9.0,1.7â2.5,1.8â2.0,12â16,2.0,2.5â2.8,2â3,3.7â5.7,4.0â12.6,5.1â18.6,6.5â9.5,8.0,8.0â11.9,abaxially,acuminate,acute,adaxially,anther,apex,apiculate,attachment,attenuate,base,berry,calyx,cancellate,channeled,cm,conical,corolla,curved,developed,diameter,distally,elliptic,entire,filament,filiform,flattened-irregular,flattened-orbicular,flattened-reniform,flower,fruit,glabrous,globose,gradually,growth,hair,hooked,increasing,interpetalar,lavender,leaf,lobe,long,margin,mature,midvein,mm,notched,occasionally,often,orange,ovate,pedicel,peduncle,petiole,point,poorly,prickle,raised,red,scattered,short,shrub,simple,slightly,small,stellae,stellate,stem,straight,style,subacute,subcoriaceous,surface,tissue,tree,twice-branched,unarmed,vein,violet,wavy,white,yellow,yellow-ferruginous,yellow-tan,Ã,â4	.0,.04,.2,.3,.5,.9,0,0.2â0.4,0.3â0.4,0.7â0.9,0.7â1.1,0.7â1.2,0.8â1.3,0.8â2.0,0.9,1.4â1.9,1.5â1.7,1.5â2.0,1.7â1.8,1.7â2.0,1.9â2.2,1/2,1/3,1/3â1/2,10.0,10.8â18.2,13.0,19.7â30.0,2.5,2.5â2.9,3.2,3.6,3.9,4.0â18.0,4â5-merou,6â8,8.2â10.5,8.5â9.4,9.5â16.0,adnate,aequilateral,alyx,anthesi,apical,apparently,appearing,armed,articulated,axe,ba,becoming,bilobed,blade,branch,broad,broad-based,brochidodromous,bud,capitate,channel,colore,concave,congested,connivent,cream,crisped,deciduous,dehiscence,densely,dentate,difoliate,dorsally,dry,eaf,eed,either,emerging,endocarp,erect,especially,exocarp,extra-axillary,fertile,free,geminat,glandular,glossy,heavily,homostylous,inclined,internode,intersepalar,juic,juvenile,lamina,large,lateral,least,like,line,lon,longer,lower,m.,major,midpoint,midrib,minor,minute,moderately,narrowly,nearly,nflorescence,oblique,oblong,orolla,part,per,perforate,pore,porrect,porrect-stellate,portion,potentially,presumably,proximal,pubescent,ray,reflexed,rigid,rip,row,ruit,sessile,shorter,side,sinus,soon,sparsely,splitting,spread,stamen,stellate-pubescen,stellate-pubescent,stigma,suture,tall,tamen,tem,thin,time,tip,toward,translucent,triangular,truncate,tube,two,ud,upper,vary,way,weakly,wide,yellow-ferruginou,ympodia,young,youngest,Â±equal	abaxial,adaxial,arrangement,branching,characteristic,colour,form,height,history,inflorescence,length,life,na,ovary,perennial,plant,primary,pseudostipule,rachi,seed,shape,staman,tertiary,texture,venation
170	wfo-0001027757	success	186	115	71	115	44	0.382	0.5,0.6,12,2,2.5,acute,anther,anthesi,apex,axillary,base,blue,borne,branching,brown,calyx,clavate,cm,colour,cylindrical,dark,decurrent,deeply,densely,diameter,elliptic,erect,filament,flattened,fruit,glabrous,globose,hair,irregularly,lanceolate,leaf,leafy,lilac,lobe,lobed,long,margin,mm,moderately,narrowly,oblong,obtuse,occasionally,often,ovate,pale,pedicel,peduncle,perennial,petiole,pitted,primary,pubescent,regularly,shoot,shrub,simple,sparsely,stigma,straight,style,surface,unknown,violet,woody,x	0.2,0.2â0.3,0.3â2.0,0.6â1.0,0.7,0â1.4,1.0â1.1,1.0â2.5,1.2â4.0,1.5â1.6,1.5â2.5,1.6â2.4,1.9â2.7,1â1.5,1â11,1â2,1â3,2.5â4,2.5â5.5,2.5â7,2â,2â10,3â12,3â5,4â9,5,5â,60â100,6â9,7â8,8â16,abaxially,absen,accrescent,adaxiall,adaxially,ag,along,apart,apical,arising,articulated,axe,ba,basal,blade,campanulate,cell,chartaceous,concave,connivent,convex,directed,distally,eaf,eed,entire,equal,erose,fleshy,flower,geminat,glabrescen,glabrou,lon,longitudinal,lower,m.,multicellular,nflorescence,opening,opposed,orolla,pair,perfect,plurifoliate,pore,poricidal,probably,rootstock,rotate,ruit,secondary,serrate,side,slit,smaller,sometimes,spaced,stone,tall,tamen,tem,thic,thickened,time,tip,toward,tube,unbranched,unicellular,uniseriate,unit,vary,white,wide,yellow,ympodial,â19,â2.7,â3.2,â4.0,â5.5,â6,â9	0-1.4,0.2-0.3,1-1.5,1.0-1.1,1.0-2.5,1.5-1.6,1.5-2.5,19,2-10,2.5-4,2.5-5.5,2.5-7,4-9,5-8,6-9,60-100,8-16,abaxial,adaxial,arrangement,characteristic,corolla,form,growth,height,history,inflorescence,length,life,midvein,na,ovary,plant,pseudostipule,rachi,seed,shape,staman,stem,tertiary,texture,unarmed,vein,venation
171	wfo-0001027765	success	167	114	82	85	32	0.491	-44,0.8,1,1-11.5,1-2,1-4,10-13,2-2.5,2-4,2.5-4,2.5-4.2,20-30,5-6,7-20,abaxial,acute,apex,apiculate,articulate,base,branched,calyx,cell,cm,cordate,corolla,covering,cyme,diameter,dichasial,dichasially,distal,ebracteate,elliptic,exceeding,filament,glandular,globose,green,green-white,hair,hair-like,herbaceous,lateral,leaf,light,lobe,long,make,mm,monochasial,mucilaginous,oblique,obtuse,odd-pinnate,ovate,ovate-lanceolate,ovoid,pedicel,peduncle,perennial,petiole,pilose,plant,proximal,rounded,seed,simple,slightly,stamen,stigma,straight,style,testal,thick,throughout,tone,truncate,violet,wall,white,Â¼	-30,-4,0-.,1-,1-10,1-5,1.5-6,2-3,3-,3-12,3-20,3-6-foliat,5,5-15,5-8,abaxially,abruptly,acumen,acuminate,apical,apically,connate,cuneate,dehiscent,digestion,diminishing,dorsally,eaf,edge,eed,elliptic-lanceolate,emoval,enzyme,flat,flower,folded,forked,generally,globo,half,honeycomb,interjected,introrse,leaflet,living,lon,lower,lunat,maturing,nflorescence,nther,often,orolla,ovate-elliptic,pair,pattern,perfect,petiolate,petiolule,plan,poricidally,reveal,ruit,sessile,seudostipule,short,side,size,slit,specimen,stellate,tal,tem,terminal,throughou,tip,toward,tuber-bearing,typically,unit,vary,wide,without,yellow,ympodial	adaxial,anther,arrangement,branching,characteristic,colour,form,fruit,growth,height,history,inflorescence,length,life,lunate,margin,midvein,na,ovary,primary,pseudostipule,rachi,shape,staman,stem,surface,tertiary,texture,unarmed,vein,venation,wet
172	wfo-0001027807	invalid_json	116	102	80	36	22	0.69	.5,0-0.2,0.2-0.3,0.2-0.9,0.3-0.4,0.9-1,1-1.5,15-30,2-5,2-6,abaxially,acuminate,acute,adaxially,apex,attenuate,barely,bark,base,berry,brown,bud,closely,cm,decurrent,deflexed,diameter,dry,elliptic,flattened,flower,fruiting,glabrous,globose,gray,grayish,green,growth,known,lanceolate,leaf,margin,material,maturity,minutely,mm,narrowly,new,overlapping,pair,pale,papillate,parallel,pedicel,peduncle,petiole,pitted,plane,primary,prominent,rachi,reddish,reniform,revolute,scar,shrub,simple,slender,slightly,small,somewhat,spaced,sparsely,stem,surface,tree,vein,visible,white,winged	0.1-1,0.9-2.5,3.5-9,almost,brittle,deflexe,difoliate,drying,eaf,eed,ellipti,geminat,internodal,know,leaf-opposed,midrib,nflorescence,occasionally,older,ot,paler,papillae,reddi,reproductive,ruit,seemingly,shoot,thickened,ud,unifoliate,unit,usually,x,yellowish,ympodial,young	'',[,``,arrangement,characteristic,colour,form,fruit,height,inflorescence,length,midvein,papilla,plant,seed,shape,texture,type,value,width,{,}
173	wfo-0001027816	success	187	106	80	107	26	0.428	.5,0.5-1,0.6-0.8,0.7-1,1,1-1.5,1-3,1.5-2,3-3.5,3.5-4,4-5,6-9,acuminate,acute,almost,anther,apex,attenuate,base,becoming,berry,bluish,branched,brown,calyx,cm,corolla,dark,dense,densely,diameter,entire,filament,filiform,flattened,glabrous,glandular,globose,growth,inflorescence,lanceolate,lateral,leaf,less,linear,lobe,margin,minutely,mm,occasionally,orange,pair,pedicel,peduncle,petiole,pitted,plant,primary,pubescent,purple,reddish,reniform,several,shrub,simple,sparse,sparsely,stem,style,surface,terminal,time,triangular,trichome,uniformly,uniseriate,variable,vein,x,yellowish	..,0.2,0.5,0.5-2,1-1,1-4,1.2-2,1.8-6,12-14,2-2.5,2-4,2/3,5-30,5-merou,<,ag,along,alyx,anthesi,apar,ark,articulated,axi,capitate,cell,confined,conical,connivent,cupped,drying,eaf,eed,ellipsoid,em,erect,exserted,fleshy,flower,free,fruiting,gland-tipped,half,ilament,irregularly,leaving,lengthening,like,lobed,loosely,lower,m.,markedly,minute,new,nflorescence,nodding,often,older,orolla,papillo,patent,peg,per,perfect,perhaps,pericarp,plurifoliat,pore,poricidal,portion,prominen,pubescen,rectangular,red,ripe,rounded,ruit,scar,shiny,sleeve,slightly,slit,small,sometimes,somewhat,spaced,spreadin,spreading,square,stellate,stigma,testal,thin,tip,tube,twinin,ud,ultimate,unit,upper,usually,vary,viscous,way,woody,ympodial,Â½	abaxial,adaxial,arrangement,branching,characteristic,colour,form,fruit,green,height,history,length,life,midvein,na,ovary,perennial,pseudostipule,rachi,seed,shape,staman,tertiary,texture,unarmed,venation
174	wfo-0001027819	success	199	124	90	109	34	0.452	1,1-,1-2,10-20,10-50,16-25,2-15,2-3,20-35,3-40,3-5,4,4-10,4-5,5-6,8-10,9-12,abaxially,acute,adaxially,also,apart,apex,articulated,base,branched,cm,cordate,cuneate,cylindrical,densely,diameter,eglandular,eglandular-pilose,ellipsoidal,entire,especially,fading,finely,forked,fruit,glabrous,globose,green,hair,leaf,leaving,length,lobe,lobed,long,margin,mm,moderately,near,obtuse,occasionally,often,pedicel,pedicellar,peduncle,per,petiole,pilose,probably,puberulent,purple,rachi,rarely,remnant,rugose,simple,sometimes,spaced,sparsely,style,subcoriaceous,sympodial,tree,truncate,unbranched,unit,unknown,unlobed,usually,vein,whitish,wide,x,yellow	-100,0.5-1,1-5,1.5-2,12-21,15-22,2,2-,20-25,20-40,22-35,25-35,3-5-lobed,4-15,4-25,5,5-merous,aggregate,alyx,ape,apical,apiculat,axe,ba,basal,beyond,blade,cell,ciliate,color,concave,connective,deeply,denser,dia,diamete,dilated,directed,distally,divided,eaf,eed,elliptic,elliptic-ovate,equal,exceeding,except,exserted,fleshy,flower,halfway,lon,lower,main,mesocarp,midrib,narrow,narrowly,nflorescence,nther,oblique,oblong,obtu,orolla,ovate,perfec,perfect,pinnately,pore,present,prominent,protuberance,puberulen,puberulence,purplish,radiu,ranch,ratio,ripe,rounded,rown,ruit,runk,shallowly,short-acuminat,shorter,sinus,slightly,small,stamen,stellate,stigma,stone,strongly,swelling,tal,thecae,toward,triangular,tube,two,ud,umbrella-shaped,uni,vary,villous,width,without,young	abaxial,adaxial,anther,apiculate,arrangement,branching,calyx,characteristic,colour,corolla,filament,form,growth,height,history,inflorescence,life,midvein,na,ovary,perennial,plant,primary,pseudostipule,seed,shape,short-acuminate,staman,stem,surface,tertiary,texture,unarmed,venation
175	wfo-0001027834	success	236	121	98	138	23	0.415	-6.1,0.2-0.3,0.2-0.4,0.2-0.6,0.5-2,0.9-1.8,1-1.6,1-1.9,1-10,1.1-1.6,1.1-1.8,1.4-2,1.8-4.9,2-8,2.2-4.3,2.3-3.4,25,4-5.2,4.8-6.9,5-20,6.9-18.1,9-11.9,9-13,abaxial,abaxially,acuminate,acute,adaxial,adaxially,anther,apex,attenuate,base,berry,branched,branching,brown,bud,calyx,cm,coriaceous,corolla,deltoid,diameter,entire,filament,finely,fleshy,flower,fruit,glabrous,globose,granular-tomentose,gray,leaf,lenticular,lobe,many,margin,mm,numerous,obtuse,ovate,ovate-elliptic,pair,pedicel,peduncle,petiole,primary,pubescence,rachi,reticulate-punctate,ripe,rounded,scabridulous,semi-ovate,short,shrub,simple,small,soft,sometimes,sparsely,stellate-pubescent,stem,style,surface,time,tomentose,tree,vein,velutinous-tomentose,white,whitish-tomentose,x,yellow,yellowish-tan,yellowish-tomentose	.5-3,0-110,0.4-1.1,1-2.5,1.6-2.7,1/2,10-25,2-3.8,2.4-6.2,2.7-7.3,2.9-4.2,3-15,3-4.3,4-6,5-merous,5.1-8,absent,accrescent,ag,alyx,angled,anthesi,apar,apical,around,articulated,axillary,ba,bark,becoming,blade,blunt-tipped,branch,capitat,closely,completely,concentrated,connivent,covering,crown,cylindrical,dendritic-echinoi,dendritic-echinoid,densely,dichasia,directed,discolorous,distally,drying,eaf,echinoi,echinoid,edge,eed,ellipsoid,enclosing,enveloping,equal,erec,exserted,farinose,flat-topped,forming,fruiting,glabrescent,grooved,hair,high,included,inserted,lengthening,less,light,lobed,long,long-stalked,longitudinal,longitudinally,lower,mostly,multangulat,multangulate,near,nflorescence,obovate,obscured,older,orbicular,orolla,ovate-lanceolate,perfec,persistent,plurifoliate,pore,poricidal,porrect-stellate,pseudo-terminal,pubescent,rarely,ray,ruit,runk,scar,semi-spherical,sessile,short-stalked,slit,somewhat,spaced,spreading,stalked,stamen,stellate,stigma,subcampanulate,subcoriaceous,suture,tamen,though,tip,tomentu,tomentum,toward,trichome,tube,turbinoid,ud,unarme,unit,usually,vary,villous,way,whitish,wide,yellowish,ympodial,young	arrangement,characteristic,colour,dichasial,form,growth,height,history,inflorescence,length,life,midvein,na,ovary,plant,pseud-terminal,pseudostipule,seed,shape,staman,texture,unarmed,ye
176	wfo-0001027843	success	154	82	51	103	31	0.331	0.5-1,0.8-3.5,1-1.2,1-1.3,1-1.5,1.2-1.5,2-2.5,5-6,6-9,acute,anther,apex,base,calyx,cm,corolla,deltoid,erose,filament,glabrate,glabrous,globose,green,impressed,leaf,lobe,long-acuminate,margin,mm,ovary,ovate,pair,pedicel,petiole,pubescent,shape,shrub,simple,slender,somewhat,sparsely,stem,straight,strongly,style,surface,tapering,vein,white,winged,x	.5,.75,/3,0.5-0.75,1.2-2.5,2-4,3-15-flowered,3-6,6-13,along,anthesi,apart,apiculate,ba,bark,bearing,becoming,beginning,beneath,berry,broadly,clavate,conical,coroll,curly,deflexed,densely,denser,dia,differing,difoliate,distally,eaf,edicel,eed,ellipsoid,exsertion,flower,free,fruiting,geminat,hairy,irregularly,known,lamina,larger,later,lateral,like,lobed,lon,long,lower,main,major,middle,minor,minutely,near,nearly,nflorescence,occasionally,older,one,opposite,orbicular,papillo,papillose,pleated,pore,poricidal,portion,prominent,proximal,reddish-gre,reflexed,rounded,ruit,scar,shaped,sinus,size,slightly,spaced,sparser,stiff,stigma,tall,tear-drop,time,tip,tipped,trichome,tube,two,ud,uniseriate,unit,way,widest,woody,ympodial,young	abaxial,adaxial,alternate,arrangement,branching,characteristic,colour,diameter,form,fruit,growth,height,history,inflorescence,length,life,midvein,na,peduncle,perennial,plant,primary,pseudostipule,rachi,reddish-grey,seed,staman,tertiary,texture,unarmed,venation
177	wfo-0001027847	success	219	107	83	136	24	0.379	-2.5,0-2,0.4-1,0.8-1.2,1.5-2,1.5-2.5,1/4,2-2.8,2.2-3,3-5,3-6,5-25,5.5-8,acute,anther,apex,apparently,articulated,base,berry,calyx,cm,cordate,deltate,densely,diameter,dull,elliptic,erect,evenly,faint,filament,finely,fruit,glabrous,gray,green,lateral,leaf,length,lobe,lobed,lower,margin,maturity,mauve,midvein,mm,narrow-deltate,orange,orange-brown,ovate,pair,pedicel,peduncle,per,petiole,pitted,primary,purple,red,red-brown,rounded,seed,shrub,simple,sometimes,sparsely,spherical,stellate-pubescent,stem,style,surface,terminal,tertiary,unarmed,upper,vein,venation,visible,white,yellow,young	-0.8,-2,-3,-4,-5,-6,.35,.7,/2,/3,0,0-7,0.1-0.4,0.15-0.2,0.2,0.5,0.5-1,0.8,0.8-0.9,1,1-2,1-2.5,1.5-5,1.9-2.3,1/2,1/6-1/3,2-3,2-4,2-5,2.5-3.5,2/,3-15,3.5-6,4-5-merous,5-6,6-11,6-8,7-10,abaxially,almost,alyx,ame,apar,apart,apically,bark,blade,branched,broadly,brow,c.,chartaceous,connivent,curved,dimorphic,discolorous,distance,drying,eaf,edge,eed,elongating,equal,extending,filiform,filiform-acuminat,flattened,flattened-reniform,flower,free,fruiting,geminate,glabrescent,increasing,infructescence,lon,long,longer,mature,middle,midpoint,minor,moderately,nflorescence,older,one,open,orbicular,orolla,oung,pendulous,perfec,pericarp,perpendicular,pit,plurifoliat,poricidal,porrect,portion,prickl,prickle,prickly,ray,reddish,retrorse,ruit,scandent,scar,sessile,side,size,slender,smooth,spaced,spreading,stalk,stalked,stellate,straight,strongly,tamen,tapering,terete,time,tip,toward,trichome,tube,unit,usually,variously,vary,way,weakly,wide,ympodial	2/3,abaxial,adaxial,arrangement,branching,characteristic,colour,corolla,false,form,growth,height,history,inflorescence,life,na,ovary,perennial,plant,pseudostipule,rachi,shape,staman,texture
178	wfo-0001027872	success	190	134	100	90	34	0.526	1,1-4,1-8,1.0-1.3,10,2,2.2-3.5,20,5-7,5-8,6-20,8-11,abaxially,acuminate,acute,adaxially,apex,apiculate,b,base,branched,ca,calyx,caudate,cell,celled,clasping,cm,commonly,cordate,covering,cuneate,cyme,deep,densely,diameter,dichasial,dichasially,ebracteate,elliptic,externally,filament,four-celled,glabrescent,gland,glandular,glandular-pubescent,globose,gray-green,green,green-white,hair-like,herbaceous,homogeneously,lanceolate,lateral,light,lobe,long,longer,make,mm,moderately,monochasial,mottled,mucilaginous,narrowly,obliquely,oblong,odd-pinnate,ovate,ovoid,pedicel,peduncle,perennial,petiolulate,petiolule,plant,pubescent,purple,rhizomatous,rounded,seed,semi-lunate,sessile,shape,short,single,sometimes,straight,style,testal,thick,tinged,tip,type,uniformly,usually,wall,yellowish-green	0.5,1-1.2,1.5-4,12-35,15,2-3,2.8,3-6-foliat,35,4-6,5-10,5-lobed,acumen,angular,apical,apically,articulate,ba,basal,becoming,connate,decreasing,dehiscent,digestion,distal,eaf,eed,emoval,enzyme,erect,exceeding,flower,forked,generally,globo,half,honeycomb,interjected,introrse,leaflet,living,lon,lower,maturing,middle,nearly,nflorescence,nther,often,orolla,pair,pattern,pentagonal,perfect,petiolate,poricidally,puberulent,purpl,rarely,reduced,reveal,rhizome,rotate,rotate-,ruit,seudostipule,size,slightly,slit,somewhat,specimen,stamen,ste,stigma,subequal,symmetrically,tem,terete,terminal,trailing,typically,unbranched,unit,vary,viole,wid,wide,wider,yellow,ympodial	abaxial,adaxial,anther,arrangement,branching,characteristic,colour,corolla,form,fruit,growth,height,history,inflorescence,leaf,length,life,margin,midvein,na,ovary,petiole,primary,pseudostipule,rachi,staman,stem,surface,tertiary,texture,vein,venation,violet,wet
179	wfo-0001027880	success	185	128	103	82	25	0.557	.25,0.5-1.5,0.5-5,0.6-1,0.6-1.5,0.8-1.5,1-14,1-15,1-2,1-3,1.5-2,1.5-3,10-15,2-3,2-80,3-4,4-10,4-6,5-8,8,abaxially,acuminate,acute,adaxially,anther,apart,apex,apiculate,articulated,base,blade,branching,calyx,cm,contiguously,cordate,coriaceous,curled,cylindrical,deltate,densely,diameter,discolorous,entire,epiphytic,extra-axillary,filament,flattened,flower,fruit,glabrous,globose,greenish,hair,inflorescence,leaf,leaf-opposed,lobe,margin,midvein,minutely,mm,nearly,oblique,oblong-ovate,often,ovate,ovoid,pair,papillose,pedicel,peduncle,petiole,pink,pubescent,purple,rachi,red-brown,revolute,ripe,rounded,rugulose,scar,shrub,simple,slender,slightly,sometimes,somewhat,spaced,style,surface,tan,thickened,tip,truncate,unbranched,undulate,uniseriate,vein,vine,white,x	-3,-3.5,0.3-3,1-2.5,2/,5-11,5-merou,absen,accrescen,ag,aggregate,along,alyx,apparently,axe,ba,branch,cell,chartaceous,ciliat,clavate,conical,connivent,dense,diminishing,directed,distally,distichous,distinct,distinctly,eaf,eed,equal,fruiting,geminat,green,growing,increasing,internode,line,long,longer,longitudinal,lower,multicellular,nflorescence,node,oblong,occasionally,opening,orolla,pale,perfect,plurifoliate,point,pore,pubescen,reddish,rooting,ruit,secondary,size,slit,sparsely,ste,stellate,stigma,stone,tamen,tem,time,trailing,tree,trunk,tube,typically,unit,usually,vary,wide,yellow,ympodial	abaxial,adaxial,arrangement,characteristic,colour,corolla,form,growth,height,history,length,life,na,ovary,plant,primary,pseudostipule,seed,shape,staman,stem,tertiary,texture,unarmed,venation
180	wfo-0001027880	success	170	129	86	84	43	0.506	.25,0.5,2/3,8,absent,acuminate,acute,along,anther,apex,apiculate,arrangement,base,bluish-purple,calyx,chartaceous,cm,contiguously,cordate,coriaceous,curled,deltate,dense,densely,diameter,distichous,entire,extra-axillary,filament,flattened,flower,fruit,glabrous,globose,green,greenish,hair,leaf,leaf-opposed,lobe,lower,margin,midvein,minutely,mm,mottled,nearly,oblique,oblong-ovate,often,ovate,ovoid,pair,papillose,pedicel,peduncle,petiole,pink,pinnate,pubescent,rachi,red,reddish-brown,revolute,rounded,rugulose,sand-punctate,shrubby,simple,slightly,sometimes,spaced,sparsely,style,surface,tan,tip,truncate,unbranched,undulate,uniseriate,vein,venation,vine,white,x	0.2-0.5,0.3â3,0.5â1.5,0.5â5,0.6â1,0.6â1.5,0.8â1.5,1.5â2,1.5â3,10â15,1â14,1â15,1â2,1â2.5,1â3,2-80,2â3,3â4,4â10,4â6,5-merous,5â11,5â8,abaxially,accrescen,adaxially,alyx,apar,axe,berry,blade,c.,capitat,ciliat,clavate,climbing,conical,cylindrical,discolored,distinct,distinctly,eaf,eed,fruiting,lanceolate,line,long,longer,m.,membranous,nflorescence,nternode,occasionally,orolla,pale,perfec,plurifoliat,reddish,rip,ruit,sand-punctat,scar,secondary,slender,somewhat,ste,stellate,stigma,tamen,tem,thickened,time,tree,trichome,trunk,tube,typically,unit,vary,vegetatio,wide,woody,ympodial,â3.5	0.5-1.5,0.6-1,0.6-1.5,0.8-1.5,1-14,1-2,1.5-2,1.5-3,10-15,2-3,3-4,4-10,4-6,5-8,60-100,abaxial,adaxial,apart,branching,characteristic,colour,corolla,form,growth,height,history,inflorescence,length,life,na,ovary,perennial,plant,primary,pseudostipule,ripe,seed,shape,staman,stem,tertiary,texture,unarmed
181	wfo-0001027881	success	215	120	79	136	41	0.367	-3,abaxially,absent,acute,almost,anther,apex,articulated,attenuate,barely,base,berry,calyx,camptodromous,chartaceous,ciliate,cm,contiguous,cordate,cordiform,densely,diameter,entire,extra-axillary,eye,few-,filament,flattened,flower,fruit,giving,glabrous,globose,greenish,groove,herb,immature,impression,lateral,leaf,lobe,many-branched,margin,maturity,membranaceous,mm,moderately,naked,netlike,ovate-elliptic,parallel,pedicel,peduncle,per,petiole,primary,projection,pubescence,pubescent,rachi,raised,reniform,seed,sessile,short,similar,simple,sparsely,staman,stem,style,subopposite,surface,translucent,vein,venation,visible,white,Ã	.3â0.5,0.5â2.2,0.8â1.5,1-celled,1.3â2,1.8â2.9,10â25,1â2,1â2-celled,1â2.5,1â2.6,1â3,1â3-celled,1â4,2.5â3.6,20â40,2â4,2â6,2â7,4â6,4â9.5,5,5-merous,6â10,7â14,7â9,8,abundant,accrescent,acuminate,adaxiall,adaxially,alyx,appressed,asymmetric,axe,ba,blackish,blade,bulge,capitat,case,central,closely,commonly,connected,connivent,curved,cylindrical,decurrent,dehiscing,denser,difoliate,directed,dorsally,drying,eaf,ed,eglandular,emarginate,emerging,equal,erect,exceeding,exclusively,explosively,fewer,forming,frequent,geminate,glandular,hair,half,held,hollow,interpetalar,introrsely,larger,less,light-brown,like,long,longer,longitudinal,lower,mainly,maturit,mesocarp,mixed,much,multicelled,multicellular,near,nflorescence,normally,one,opening,orolla,other,pair,part,perfec,placenta,pore,pressure,prominent,rotate,ruit,secondary,side,size,slightly,slit,small,smaller,solitary,sometimes,stalk,stamen,stigma,subapically,tal,tamen,tem,tissue,triangular,tube,two,unbranched,unit,vary,watery,winged,woody,yellow,ympodial	0.5-2.2,0.8-1.5,1-2,1-2.5,1-2.6,1.3-2,1.8-2.9,10-25,2-6,2-7,2.5-3.6,20-40,4-6,6-10,7-14,7-9,abaxial,adaxial,arrangement,branching,characteristic,colour,corolla,form,growth,height,history,inflorescence,length,life,midvein,na,number,ovary,perennial,plant,pseudostipule,shape,tertiary,texture,unarmed
182	wfo-0001027882	success	184	125	100	84	25	0.543	0.1,0.5-1,1,1-1.5,1-5,1.5-2,1.5-2.2,1.5-6,10-40,2-3,2.1-2.6,3-4,3.5-4,3.5-5,4-5,6-9,9-13,abaxially,absent,acuminate,adaxially,along,anther,anthesi,apex,apparently,appearing,attenuate,axil,base,berry,branch,branched,branching,calyx,cm,completely,conical,corolla,dark,deltate,dense,diameter,elliptic,entire,erect,filament,flattened,flower,fork,glabrous,globose,green,growth,hairy,inflorescence,leaf-opposed,less,lobe,margin,maturity,midrib,minutely,mm,nodding,ovary,ovoid,pair,pale,pedicel,peduncle,petiole,pitted,primary,rachi,rarely,reddish,reniform,shiny,shrub,simple,slender,small,sometimes,sparse,stem,structurally,style,surface,swollen,time,tip,tree,trichome,tuft,uniseriate,vein,white,x,yellow	.25,.5,06a,1.5-,1.6-2.2,10-25,2-6,2-lobed,2.5-3,3.2-6,7-,age,apart,bark,broadly,brown,c.,caly,clavate,cucullate,densely,difoliate,dry,drying,eaf,eed,et,exerted,fide,free,fruiting,fusiform,geminat,glabrou,hollow,hooked,irregularly,junction,kallunki,lamina,lengthening,lobed,lower,markedly,new,nflorescence,occasionally,papillat,papillate,paulo,penden,perfect,planar,plane,pointed,population,pore,poricidal,portion,pulp,red-papillat,ruit,scar,shattering,slit,spaced,sparsely,specimen,sticky,stigma,stout,straight,strongly,sweet-scented,sÃ£o,thickened,tube,ud,unit,usually,way,woody,yellowish,ympodial	abaxial,adaxial,arrangement,characteristic,colour,form,fruit,height,history,leaf,length,life,midvein,na,perennial,plant,pseudostipule,seed,shape,staman,tertiary,texture,unarmed,venation,ye
183	wfo-0001027889	success	151	109	80	71	29	0.53	-pubescent,0,0.5-1,0.5-11,0.7-2,1,1-3,1-3.5,1.5,1.5-2,10-12,10-20,10-30,2-3,3-4,3-8,acute,acute-acuminate,apart,apex,apiculate,articulated,basal,base,calyx,chartaceous,cm,darker,deltate,densely,diameter,eglandular-puberulent,eglandular-pubescent,elliptic,entire,finely,flower,fruit,glabrous,glandular-,green,greenish,immature,leaving,length,light,lobe,long,longitudinal,margin,mm,moderately,ovate,ovoid,pedicel,pedicellar,peduncle,perfect,petiole,probably,puberulent,puberulent-pubescent,rachi,remnant,ripe,shrub,simple,spaced,stripe,style,subcordate,tip,tree,truncate,unbranched,unknown,violet,white,x,yellowish	-2.5,.5,.5-2,1-10,2-20,3-9,4-foliat,5-10,abaxially,acuminate,adaxially,aggregate,ape,axe,beyond,blade,capitat,cell,color,connective,connivent,cylindrical,dilated,directed,distally,eaf,eed,equal,exceeding,exserted,extending,introrse,laterally,lon,lower,narrow,nflorescence,nther,oblong,orolla,pore,presen,present,puberulen,puberulent-pubescen,radiu,ruit,slightly,small,somewhat,sparsely,stamen,stellate,stigma,stone,subcoriaceous,swelling,tal,tem,thecae,time,tomento,tomentose,triangular,tube,ud,unit,vary,wide,yello,ympodial	1-2.5,abaxial,adaxial,anther,arrangement,branching,characteristic,colour,corolla,filament,form,growth,height,history,inflorescence,leaf,life,na,ovary,perennial,plant,pseudostipule,seed,shape,staman,stem,surface,texture,unarmed
184	wfo-0001027901	success	156	102	73	83	29	0.468	.25,.5,0.3-1.2,0.8-1,1-1.5,1-2.5,2.5-3,3-5,4-5,6-7,abaxial,abaxially,acuminate,acute,adaxially,anther,anthesi,apex,attenuate,base,berry,bright,brown,calyx,cm,corolla,dark,dry,elliptic,filament,firm,fleshy,fresh,glabrous,globose,green,imbedded,immature,inflorescence,keeled,leaf,lobe,long,material,matrix,minutely,mm,ovary,ovoid-reniform,pair,pedicel,petiole,pitted,prominently,pubescent,reflexed,ripe,shape,shiny,shrub,simple,sparsely,stem,style,surface,translucent,triangular,trichome,uniseriate,vein,white,x,yellow	0.5-1,0.8-2,0.9-2.3,1-2,1.5-1.8,1.8-4.5,4-10-flowered,4.7-12,?,area,ba,bark,beneath,broadened,brow,closely,conical,curled,deflexed,densely,dia,differing,difoliate,direction,drying,eaf,edicel,eed,ellipsoid,exserted,free,fruiting,geminat,later,lateral,like,lobed,lon,lower,main,major,middle,midrib,minor,nearly,nflorescence,older,opposite,orbicular,oriented,overlappin,papillo,papillose,planar,pore,poricidal,portion,reddish,rest,rounded,ruit,scar,shaped,single,size,slender,spaced,stigma,straight,strongly,swollen,tall,tear-drop,tip,tub,tube,ud,unit,usually,widest,woody,ympodial,young	adaxial,alternate,arrangement,branching,characteristic,colour,diameter,form,fruit,growth,height,history,length,life,margin,midvein,na,peduncle,perennial,plant,primary,pseudostipule,rachi,seed,staman,tertiary,texture,unarmed,venation
185	wfo-0001027902	success	128	90	62	66	28	0.484	-2.5,0.5-1,1-1.5,1-6,10-20,2,2-12,2-15,2-3,2-8,3-4,3-5,4-5,7-9,acuminate,acute,angled,apex,articulated,base,branched,calyx,chartaceous,cm,cordate,deeply,densely,diameter,entire,forked,fruit,globose,leaving,lobe,long,margin,mm,moderately,obtuse,ovate,pedicel,pedicellar,peduncle,petiole,puberulent,pubescent,purple,rachi,remnant,reticulate,shrub,simple,small,sparsely,style,tip,tree,truncate,unknown,usually,whitish,x	1-2,1.5-3,10-15,15-30,2-9,20-50,3-foliat,4-25,5-20,6-37,8-13,abaxially,absen,adaxiall,adaxially,aggregate,apart,axe,blade,cell,color,connivent,cylindrical,directed,distall,distally,eaf,eed,eglandular,flower,glabrous,glandular,hair,inflated,like,lon,lower,narrowly,nearly,nflorescence,nther,orolla,pore,pubescen,purplish,radiu,ripe,ruit,spaced,ste,stellate,stigma,stone,subcoriaceous,tal,tem,time,triangular,truncat,tube,unbranched,unit,vary,wide,yellow,ympodial	abaxial,adaxial,anther,arrangement,branching,characteristic,colour,corolla,filament,form,growth,height,history,inflorescence,leaf,length,life,na,ovary,plant,pseudostipule,seed,shape,staman,stem,surface,texture,unarmed
186	wfo-0001027929	success	193	131	106	87	25	0.549	1,1-10,1.0-1.3,10,2.0-3.0,20,3.5-5,4-5,5-6,5-lobed,6-15,along,apical,apically,apiculate,articulate,base,beyond,branched,calyx,caudate,cell,center,clasping,cm,coat,connate,corolla,covering,cyme,dark,darker-violet-blue,deep,dehiscent,diameter,dichasial,dichasially,distal,ebracteate,elliptic,embryo,exceeding,except,forked,formed,generally,glabrous,globose,green,green-white,hair,hair-like,half,herbaceous,included,introrse,lanceolate,lateral,light,lobe,long,make,maturing,middle,mm,monochasial,mucilaginous,narrowly,oblong,occasional,odd-pinnate,often,ovate,ovoid,pedicel,peduncle,perennial,plant,poricidally,puberulent,purple,rhizomatous,rotate,seed,semi-lunate,shape,short,slightly,slit,sometimes,spot,stamen,stigma,straight,style,symmetrically,testal,thick,tinged,usually,vein,violet,violet-blue,visible,wall,yellow	0.2-0.9,1-4,1-8,1.5-4,15,2,2-3,3-6-foliat,35,4-30,4-6,5-10,abaxially,acumen,acuminate,acute,adaxially,angular,apex,ba,basal,becoming,cente,color,cordate,cuneate,decreasing,digestion,eaf,eed,emoval,enzyme,erect,filament,flower,globo,honeycomb,interjected,leaflet,living,lon,lower,mostly,nearly,nflorescence,nther,obliquely,orolla,pair,pattern,pentagonal,perfect,petiolate,petiolulate,petiolule,purpl,radiating,rarely,reduced,reveal,rhizome,rotate-,rounded,ruit,sessile,seudostipule,size,somewhat,specimen,star,ste,subequal,tem,terete,terminal,tip,trailing,typically,unbranched,unit,vary,white,wid,wide,wider,without,ympodial	abaxial,adaxial,anther,arrangement,branching,characteristic,colour,form,fruit,growth,height,history,inflorescence,leaf,length,life,ovary,petiole,pseudostipule,reproduction,rotate-pentagonal,stem,surface,texture,wet
187	wfo-0001027948	success	186	116	88	98	28	0.473	-15,-6,.5,0-,0.5-2,0.8-,1-1.2,1.2-2.2,1.3-1.8,1.5-4.5,10-14,13,2.5-,3.2-5.2,3.7-4,7,7.5-10,abaxially,abundant,acuminate,adaxially,anther,apex,attenuate,basal,base,berry,calyx,cm,corolla,diameter,directed,edentate,elliptical,erect,filament,flexuous,generally,glabrous,glandular,globose,herb,herbaceous,hollow,ill-smelling,leaf,length,light,lobe,long,longitudinally,many-,margin,midvein,mm,narrowly,non-glandular,occasionally,ovate,ovoid,pair,patent,petiole,pubescent,purple,ridged,seed,seeded,serrulate,simple,slightly,small,stem,straight,striate,style,sub-shrub,tooth,triangular,trichome,unequal,upward,vein,violet,viscid-pubescent,x,Â¼,Â½	-16,0.4,0.5-0.7,0.6,1-2,1.6,1/10,14,2-,2.2-,3-8.2,3.5,5,5-,6-celled,7-15,8-celled,accrescen,ag,aggregate,antrorse,ape,articulate,ature,bicellular,branch,c.,campanulate,cell,connectival,crushed,cuticle,dark,delicate,diamete,difoliate,dorsally,eaf,ellipsoidal,finely,fragrance,free,fruiting,head,hig,inconspicuous,inserted,lamina,long-stalked,longer,longitudinal,lower,narrow,near,odorles,opening,orolla,papillate,pericarp,pore,poricidal,portion,prolongation,pubescence,reduced,ree,ruit,saddle-shape,scarce,scarcely,secondary,seen,separated,short-stalked,shorter,single-celled,sinus,slit,smooth,solitary,spur-like,stalk,stigma,stone,striat,sub-opposite,tem,thecae,thickened,time,tip,tube,twice,unit,vary,ventrifixed,verrucate,ympodial	abaxial,adaxial,arrangement,branching,characteristic,colour,form,fruit,growth,height,history,inflorescence,life,na,ovary,pedicel,peduncle,plant,primary,pseudostipule,rachi,shape,staman,surface,tertiary,texture,unarmed,venation
188	wfo-0001027961	success	177	114	85	92	29	0.48	.5,0.5-1,0.9-1,1-1.5,1-5,1-9,10-50,2-2.5,2.3-2.5,3-3.5,4.5-5,7-9,8-10,?,acute,anther,anthesi,apex,asymmetric,base,berry,branched,broadly,calyx,cm,cordate,corolla,curling,deltate,densely,diameter,elliptic,entire,fading,filament,flower,glabrous,globose,green,growth,immature,inflorescence,lateral,lobe,lobed,many,margin,maturity,mm,obovate,occasionally,often,one,other,pair,pedicel,peduncle,petiole,pinnatifid,primary,probably,pubescent,purple,reddish,shiny,simple,slender,slightly,sparsely,spreading,stem,style,surface,terminal,time,triangular,truncate,twining,vein,vine,violet,white,white-pubescent,woody,x	0.25,0.25-0.5,1,1-3,1-4,2.5-9,5-8,5-merou,6-9,<,abaxially,adaxiall,adaxially,age,always,alyx,apar,ark,articulated,axil,brow,c.,clavate,clear,conical,connivent,distributed,eaf,early,eed,ellipsoid,equalling,exserted,free,fruiting,fusiform,geminat,ilament,irregularly,lamina,lengthening,lon,long,loosely,lower,mature,membranous,midrib,minute,minutely,new,nflorescence,observed,older,orolla,papillo,pendan,perfect,pericarp,pinched,planar,plurifoliate,pore,poricidal,portion,present,pubescen,rotate-stellate,ruit,scar,sleeve,slit,small,spaced,stigma,tem,thin,tip,transition,trichome,tube,tuft,twinin,ud,unequal,uniseriate,unit,upper,vary,way,yellow,ympodial	60-100,abaxial,adaxial,arrangement,branching,brown,characteristic,colour,form,fruit,height,history,leaf,length,life,midvein,na,ovary,perennial,plant,pseudostipule,rachi,seed,shape,staman,tertiary,texture,unarmed,venation
189	wfo-0001027966	success	207	88	59	148	29	0.285	1-2,1-4.2,1-5,1.3-2.2,10,10-30,2.2-2.9,3-4,3-5,3-7,40-80,5-6,6-11,acuminate,anther,apex,attenuate,base,berry,blue-violet,chartaceous,cm,conical,corolla,densely,diameter,elliptic,filament,fruit,glabrous,green,greenish,herb,leaf,light,lobe,long,margin,medium,membranous,minute,mm,mottled,mucilaginous,odd-pinnate,ovate,ovoid,pedicel,peduncle,petiole,plant,pubescent,purple,seed,sessile,slightly,stem,subsessile,whitish	0.4-0.5,0.7-3,0.8,0.8-2.5,1-1.8,1-10,1-3,1.2-4.5,1.5-3,1.5-5.2,2.5-10.5,2.8-9,4,5-10,5-9.5,5-merou,5.5-14,abaxially,absent,acumen,adaxially,ag,along,alyx,apart,apparently,arranged,articulated,asymmetrical,axe,axillary,basiscopic,bead,blade,brownish,bud,capitat,cell,ciliate,commonly,condition,connivent,covering,decreasing,digestion,distal,dorsally,drying,eaf,edge,eed,enzyme,erec,especially,exceeding,flat,flower,folded,forked,fresh,geminat,generally,glabrou,gradually,green-white,hair,hair-like,half,homostylous,honeycomb-shaped,interjected,lanceolate,larger,lateral,leaflet,lengthening,less,like,living,lower,make,middle,moniliform,multiple,narrow,necklace,nflorescence,orbicular,orolla,pair,pale,pentagonal,perfect,petiolule,plurifoliate,pore,poricidal,proximal,rarely,ray,removed,ripe,rotate,ruit,secondary,semierect,seudostipule,shorter,side,size,slit,somewhat,spaced,sparsely,specimen,stamen,ste,stigma,stolon,straight,subequal,subtending,symmetrical,tall,tamen,tem,terminal,testal,thick,throughout,tip,tissue,tri-,tube,tuber,tyle,typically,unit,usually,violet,wall,wet,white,wide,wing,x,yellow,ympodial	abaxial,adaxial,arrangement,branching,calyx,characteristic,colour,form,growth,height,history,inflorescence,length,life,midvein,na,ovary,primary,pseudostipule,rachi,shape,staman,style,surface,tertiary,texture,unarmed,vein,venation
190	wfo-0001028014	success	222	134	110	112	24	0.495	-15,-2.5,-5,-6,0,0.2-1,0.2-1.6,0.25,0.5-1,0.5-2,0.6-0.9,0.7-1,0.9-1.2,1-10,1-4,1.3-2.4,1.8-3,2-3,2-4.5,2-6.5,2.5-4,4.5-7,almost,anther,apex,apically,apparently,around,articulated,base,berry,black,branched,brown,brown-green,calyx,cell,chartaceous,cm,cordate,deltate,densely,diameter,difoliate,edge,erect,eye,filament,flattened-reniform,fruit,glabrescent,glabrous,gray-green,infructescence,lateral,leaf,length,lobe,lobed,long,margin,maturity,mauve,membranous,midvein,mm,moderately,naked,obtuse,orange,outer,outline,ovate,pair,pale,pedicel,peduncle,per,pericarp,petiole,pit,prickle,prickly,primary,purple,raised,red,rough,rounded,seed,shiny,shrub,simple,smooth,spherical,stellate-pubescent,stem,style,surface,terminal,tertiary,unit,vein,venation,visible,visibly,weakly,wide,yellow,yellow-green	-0.5,-1,-1/2,-10,-3,-4,.5,/5,0.1-0.2,0.15,0.15-0.3,0.2,0.2-0.4,0.3-0.4,0.5,0.5-1.5,0.5-3,0.7-1.6,1-,1-2,1-3,1.5,1.5-2,1/4,1/4-2/3,2,2-20,3-10,4-10,5-merous,6-10,6-11,abaxially,acuminat,alyx,ame,apar,apart,bark,blade,broad-deltate,c.,concolorous,connivent,curved,decurrent,discolorous,distance,drying,eaf,eed,elongating,equal,extending,flattened,flower,free,fruiting,geminat,glabrou,gland,globular,gray,herbaceous,lon,longer,lower,mature,midpoint,nflorescence,occasionally,older,one,open,orange-gra,orolla,oung,pendulous,perfec,poricidal,porrect,portion,prickl,ray,reduced,reflexed,ruit,scandent,scar,sessile,shorter,side,slender,sometimes,spaced,spreading,stalk,stalked,stellate,straight,strongly,tamen,tapering,terete,time,tip,trichome,tube,vary,way,winged,ympodial	abaxial,acuminate,adaxial,arrangement,branching,characteristic,colour,corolla,form,geminate,growth,height,history,inflorescence,life,na,ovary,perennial,plant,shape,staman,sympodial,texture,unarmed
191	wfo-0001028017	success	158	117	83	75	34	0.525	-2.5,0.3-1,1-10,1.5-2,15-35,15-50-flower,2,2-3,2-4,2.5-5,3,3-12,3-4,40-50,5-7,5-9,6-8,abaxially,acute,adaxially,apex,apiculate,articulated,basal,base,brown,calyx,cm,cuneate,densely,diameter,eglandular-puberulent,eglandular-pubescent,ellipsoidal,elliptic,entire,flattened,fleshy,flower,forked,fruit,fusiform,glabrous,glandular-,glandular-puberulent,green,greenish,immature,leaving,lobe,long,margin,mm,moderately,near,oblique,obtuse,ovate,pedicel,pedicellar,peduncle,perfect,petiole,pointed,pubescent,rachi,rarely,remnant,ripe,short-acuminate,simple,sometimes,sparsely,style,tip,tree,truncate,unbranched,vein,white,without,x,yellow	1,1-2,1-3,10-22,13-40,3-14,3-foliat,5,6-7,9-11,absen,absent,acuminate,aggregate,apart,ape,axe,beyond,blade,cell,chartaceous,ciliat,clavate,connective,connivent,cream,cylindrical,directed,distally,eaf,eed,eglandular,exceeding,exserted,glandular,hair,introrse,lanceolate,lon,lower,narrowly,nflorescence,nther,orolla,ovoid,pore,puberulen,purple,purplish,radiu,ruit,shorter,slightly,small,spaced,stamen,stellate,stellate-campanulate,stigma,stone,subcoriaceous,tal,tan,tem,thecae,time,tomentose,triangular,truncat,tube,ud,unit,vary,wide,ympodial	abaxial,adaxial,anther,arrangement,branching,characteristic,colour,corolla,filament,form,growth,height,history,inflorescence,leaf,length,life,midvein,na,ovary,perennial,plant,primary,pseudostipule,puberulent,seed,shape,staman,stem,surface,tertiary,texture,unarmed,venation
192	wfo-0001028033	success	157	106	78	79	28	0.497	1.4â1.8,1â4,2â4,3â4,3â5,4â12,4â5,50,6â12,abaxially,acuminate,acute,adaxially,along,anther,apex,attenuate,base,blade,brochidodromous,brown,calyx,chartaceous,ciliate,cm,cylindrical,cyme,darker,decurrent,densely,denser,diameter,discolorous,drying,elliptic,entire,few-branched,filament,flower,fruit,glabrescent,glabrous,greenish,growth,herb,known,lateral,length,light,like,linear-lanceolate,lobe,margin,mm,nearly,onto,order,pedicel,petiole,pubescence,pubescent,sessile,shiny,shrub,simple,slightly,solitary,sparsely,spreading,stem,straight,style,surface,trichome,unbranched,vein,venation,white	.6,1.5,1â5,2â3,2âfoliate,3,3â11,5-merou,5â7,adaxiall,alyx,anthesi,ark,ascending,becoming,branch,capitat,cell,connivent,contiguou,cordate,deeply,directed,eaf,eed,emarginate,equal,eye,florescence,geminat,green,high,hispid-pubescent,introrsely,know,lobed,long,longitudinal,lower,mainly,membranaceous,midrib,naked,new,oblong,older,opening,orolla,ovate-lanceolate,perfect,pore,poricidal,prominent,prostrat,recurved,rhizomatous,ruit,secondary,shin,shorter,slit,stellate,stigma,strongly,subapical,tamen,tem,tube,uniseriate,unit,unknown,upright,vary,visible,wide,woody,yellow,ympodial,Ã	abaxial,adaxial,arrangement,branching,characteristic,colour,contiguous,corolla,form,height,history,inflorescence,leaf,life,midvein,na,ovary,peduncle,plant,primary,pseudostipule,rachi,seed,shape,staman,tertiary,texture,unarmed
193	wfo-0001028067	success	139	106	74	65	32	0.532	0.5-1,0.5-1.5,0.5-2,1,1-11,1-2,1-3,1-7,1.5-2.5,10-25,2,2-2.5,2.5-3,3-5,3-7,5-7,6-12,7-11-compound,7-9,acuminate,acute,apex,articulated,base,calyx,cm,cuneate,cylindrical,dark,diameter,elliptic-fusiform,elliptic-ovate,entire,flattened,flower,fruit,glabrous,hair,leaf,leaving,lobe,long,margin,mm,moderately,nearly,obtuse,often,pedicel,pedicellar,peduncle,petiole,pink,pinnately,puberulent,purple,rachi,rarely,remnant,ripe,shrub,simple,slightly,sparsely,strongly,style,tip,tomentulose,triangular-deltate,truncate,unbranched,unequal,x,yellow	-30,1-10,2-3,3-17,3-4,4-foliat,6-18,7-20,8-13,abaxially,adaxiall,adaxially,aggregate,along,apart,axe,basiscopically,blade,cell,chartaceous,color,compound,connivent,decurrent,directed,distall,eaf,eed,especially,glabrou,lateral,leaflet,lon,lower,midrib,narrowly,nflorescence,nther,orolla,per,pore,puberulen,radiu,ruit,several,smal,spaced,stellate,stigma,stone,subcoriaceous,tal,tem,time,triangular,truncat,tube,unit,unknown,upper,usually,vary,wide,ympodial,zigzag	abaxial,adaxial,anther,arrangement,branching,characteristic,colour,corolla,filament,form,growth,height,history,inflorescence,length,life,midvein,na,ovary,plant,primary,pseudostipule,seed,shape,staman,stem,surface,tertiary,texture,unarmed,vein,venation
194	wfo-0001028069	success	253	100	77	176	23	0.304	0.05-0.1,0.3-0.45,0.3-0.6,0.4-0.8,0.5,0.5-0.7,0.5-1.8,0.6-4,1-2.7,1-3.5,1.5-2.0,1.6-3.2,10-12,2-3-branched,2-locular,3,<,acute,anther,apex,articulated,base,basioscopically,bright,brown,calyx,cm,conical,corolla,decurrent,deep,deeply,densely,diameter,filament,fruit,glandular-villous,globose,green,hair-like,herb,imparipinnate,interrupted,leaf,length,lime,linear,lobe,lobed,margin,midvein,minutely,mm,oblique,obovate,occasionally,orange,outgrowth,ovary,ovate,pale,pedicel,peduncle,perennial,petiole,plant,primary,pseudostipule,pubescent,rounded,simple,stem,straight,style,surface,tertiary,yellow	-0.4,-30,-6,.1,.1-0.2,.2,.5,0.1-0.15,0.1-0.2,0.1-0.3,0.1-0.5,0.1-0.6,0.2-0.3,0.2-0.5,0.3,0.3-0.4,0.3-0.7,0.3-1,0.4,0.4-0.5,0.4-1,0.5-2,0.6-1.1,0.7-1,0.7-1.3,0.7-1.5,0.8-1.2,1-2-celled,1-4.5,1.4,1.5-3.5,10,10-30,12,2-17,2-4,2-7,3-,3-foliate,4-celled,5-22,5-25,6-,abaxially,absen,abundant,accrescent,adjacent,adpressed,along,alternate,always,among,anthesi,apical,appearance,appendage,appressed,axi,ba,basal,becoming,berry,bilaterally,bract,bracteole-like,cell,citru,column,composed,cone-shaped,cordate,cuneate,curving,dense,due,eaf,ebracteate,edicel,eed,eglandular,erect,exserted,flower,forming,fruiting,fusion,giving,glabrescent,gland,gland-tippe,gland-tipped,glandular,gree,half,halfway,head,included,initially,interjected,internode,larger,later,lateral,leaflet,less,like,lon,long,longer,longest,lower,maturity,middl,minute,multicellular,narrowly,nflorescence,often,one,pair,patent,pentagonal,per,petiolule,population,present,procumbent,pubescence,quaternary,rarely,reflexed,robust,ruit,scarcely,scent,secondary,sessile,several,shaggy,short,shorter,silky,single-celled,size,slender,smaller,somewhat,staminal,sterile,stigma,strong,subopposite,symmetric,tangled,tem,terminal,testa,thick,tightly,toward,transparent,trichome,tube,ud,unicellular,uniseriate,unit,usually,varying,viny,wall,weak,wide,winged,ympodial	abaxial,absent,adaxial,arrangement,branching,characteristic,colour,form,growth,height,history,inflorescence,life,middle,na,rachi,seed,shape,staman,texture,unarmed,vein,venation
195	wfo-0001028075	success	196	87	57	139	30	0.291	1-2,1.5-2.5,1.6-2.7,10-35,2-6,3-23.5,4-12,4-7,5-7,5-8,5-9,7-13,7-30,8-12,acuminate,acute,anther,apex,base,berry,chartaceous,ciliate,cm,corolla,dark,diameter,filament,fruit,glabrescent,glabrous,globose,green,greenish,herb,leaf,light,lobe,long,margin,membranous,mm,oblique,obtuse,odd-pinnate,ovoid,pale,pedicel,peduncle,petiole,plant,rounded,seed,style,subcordate,white,whitish,x	.5,1-10,1-2.7,1-3,1.5-7,2-3,2-4.5,2.5-10,3-11,5-12,5-14,5-17,5-merou,abaxially,absent,acuman,acumen,adaxially,ag,along,alyx,apart,apparently,articulated,axe,axillary,blade,borne,broadly,brownish,bud,capitat,cell,condition,connivent,covering,cuneate,decreasing,differentiated,digestion,distal,distally,distinctively,dorsally,dot,drying,eaf,edge,eed,elliptic-lanceolate,end,enzyme,erec,especially,exceeding,flat,flower,folded,forked,fresh,geminat,generally,glabrescen,green-white,hair-like,half,homostylous,honeycomb-shaped,interjected,lanceolate,larger,lateral,leaflet,lengthening,ligulate,living,lower,make,middl,midrib,minutely,much,mucilaginous,narrow,nflorescence,often,orolla,ovate,ovate-elliptic,pair,pentagonal,perfect,petiolule,plurifoliate,pore,poricidal,puberulent,purple,reflexed,removed,rotate,ruit,scattered,seudostipule,singly,size,slightly,slit,sometimes,spaced,specimen,stamen,star,stigma,stolo,straight,subtending,tall,tamen,tem,terminal,testal,thick,throughout,tip,toward,tri-,tube,tuber,typically,unit,usually,vary,wall,wet,wide,wing,yellow,ympodial	2,abaxial,adaxial,arrangement,branching,calyx,characteristic,colour,form,growth,height,history,inflorescence,length,life,midvein,na,ovary,perennial,primary,pseudostipule,shape,staman,stem,surface,tertiary,texture,unarmed,vein,venation
196	wfo-0001028076	success	195	91	61	134	30	0.313	1-1.3,1-2,1.8-2.2,110,12-22,2-5.4,2.2-2.6,2.5-4,4-5,5,5-20,5-6,7-8,acuminate,anther,apex,attenuate,base,berry,chartaceous,cm,conical,corolla,densely,diameter,elliptic,filament,forked,fruit,glabrous,green,greenish,herb,leaf,less,light,lobe,long,margin,medium,membranous,minute,mm,mucilaginous,odd-pinnate,ovate,ovoid,pedicel,peduncle,petiole,plant,pubescent,purple,seed,sessile,slightly,stem,style,subsessile,unwinged,whitish	.5,0.4-0.5,0.5,1-10,1-3,1.2-2.2,13-14,2-12,2-3,2.2-3.7,2.5-3,2.6-3.8,4.5-7,5-6.5,5-merou,?,abaxially,absent,acumen,adaxially,ag,alyx,apart,apparently,articulated,axe,axillary,blade,borne,brownish,bud,capitat,cell,ciliate,condition,connivent,covering,decreasing,digestion,distal,dorsally,drying,eaf,edge,eed,end,enzyme,erec,especially,exceeding,flat,flower,folded,fresh,geminat,generally,glabrou,gradually,green-white,hair,hair-like,half,homostylous,honeycomb-shaped,interjected,lanceolate,larger,lateral,leaflet,lengthening,like,living,lower,make,nflorescence,obtuse,orolla,pair,pentagonal,perfect,petiolule,plurifoliate,pore,poricidal,proximal,pubescen,rarely,ray,removed,ripe,rotate,round,ruit,secondary,semierect,seudostipule,singly,size,slit,spaced,specimen,stamen,ste,stigma,stolo,straight,subequal,subtending,symmetrical,tall,tamen,tem,terminal,testal,thick,thir,throughout,tip,toward,tri-,tube,tuber,typically,unit,usually,vary,wall,wet,white,wide,wing,x,yellow,ympodial	abaxial,adaxial,arrangement,branching,calyx,characteristic,colour,form,growth,height,history,inflorescence,length,life,midvein,na,ovary,perennial,primary,pseudostipule,rachi,shape,staman,surface,tertiary,texture,unarmed,vein,venation,width
197	wfo-0001028105	success	150	110	78	72	32	0.52	.4,.5,0.3-1.5,0.5-1,0.5-2,0.6-1,1-1.2,1-1.5,1.5-1.8,1.5-2,2,2-2.2,3-5-celled,3.5-4,5-7-flowered,6-7,abaxially,acuminate,adaxially,anther,apex,apical,attenuate,axil,base,berry,calyx,cm,corolla,dark,deflexed,dense,distinct,elliptic,erect,filament,filiform,flattened-reniform,glabrous,glandular,globose,green,incrassate,lateral,leaf,lobe,long,main,margin,minutely,mm,olive-green,ovary,pair,pale,pedicel,petiole,pitted,projection,pubescent,quadrate,reddish-brown,scattered,shrub,simple,slightly,small,stem,style,surface,tip,tree,trichome,tuft,uniseriate,vein,white,x	.1,0.5,1-2.5,1.5,1.5-4.5,2-5,3-6,9.5-15,acute,anthesi,apar,axi,ba,bark,bilobed,clavate,conical,dia,differing,difoliate,drying,eaf,edicel,eed,ellipsoid,evenly,exserted,free,fruiting,geminat,greenish-yello,lamina,like,lobed,lon,lower,major,middle,minor,nearly,nflorescence,occasionally,older,opposite,papillo,papillose,planar,pore,poricidal,portion,reflexed,ruit,scar,shaped,size,spaced,sparsely,spreading,stigma,straight,strongly,tall,tear-drop,tub,tube,ud,unit,widest,woody,yellowish,ympodial,young	abaxial,adaxial,alternate,arrangement,branching,characteristic,colour,diameter,form,fruit,greenish-yellow,growth,height,history,inflorescence,length,life,midvein,na,peduncle,perennial,plant,primary,pseudostipule,rachi,seed,shape,staman,tertiary,texture,unarmed,venation
198	wfo-0001028109	success	205	130	108	97	22	0.527	-20,-4,-7,0.4-0.8,0.4-1.5,0.45-0.65,0.5-2.5,0.6-0.8,0.8-1.5,1.5-2.5,1.5-5.5,15-100,2-4,2.3-2.9,2.5-3,2.5-5,20-60,5-13,5-30,8-12,abaxial,acuminate,acute,adaxial,almost,anther,apex,apically,apparently,articulated,base,berry,branching,bright,calyx,chartaceous,cm,cuneate,curved,deltate,densely,diameter,discolorous,drying,dull,elliptic,entire,erect,evenly,filament,flattened-reniform,fruit,gently,glabrescent,glabrous,gray-green,green,green-brown,infructescence,lateral,leaf,length,light,lobe,long,margin,maturity,mauve,mm,moderately,obtuse,orange-brown,pair,pedicel,peduncle,per,petiole,prickly,primary,recurved,red,red-brown,shrub,simple,slender,small,sometimes,spherical,stellate-pubescent,stem,straight,strongly,style,surface,terminal,tertiary,tree,unarmed,unit,usually,vein,venation,visible,weakly,white,wide,yellow,young	.5,/3,0.05-0.15,0.05-0.2,0.1,0.1-0.2,0.3,0.5-1.2,0.7,0.8-1.6,1.5-10,1/8-1/4,10-25,10-30,12-40,2-15,2/3-3/4,3-,3-7,3.5-6,3/4,30-150,4-13,4-5-merous,8-15,8-25,abaxially,acut,alyx,ame,apar,apart,bark,blade,brow,c.,connivent,dimorphic,eaf,eed,elongating,equal,flower,free,fruiting,fully,geminate,glabrou,lobed,long-styled,longer,lower,mature,midpoint,minor,multangulate,nflorescence,occasionally,older,one,open,opening,orolla,oung,perfec,pericarp,perpendicular,plurifoliat,poricidal,porrect,portion,prickl,prickle,ray,reflexed,ruit,scar,secondary,sessile,smooth,spaced,spreading,stalk,stalked,stellate,tamen,tapering,terete,time,tip,trichome,tube,unarme,vary,way,woody,ympodial	arrangement,characteristic,colour,corolla,form,growth,height,history,inflorescence,life,midvein,na,ovary,plant,plurifoliate,pseudostipule,rachi,seed,shape,staman,sympodial,texture
199	wfo-0001028115	success	165	90	55	110	35	0.333	0.7-0.8,1.1-1.8,1.7-2.2,1.8-3.5,2-3.2,5-15,6-10,abaxially,acute,adaxially,anther,apex,attenuate,base,berry,blue,calyx,cm,diameter,ellipsoidal,elliptical,entire,filament,glabrescent,glabrous,globose,herb,length,light,linear,lobe,margin,mm,moderately,narrowly,ovate,pale,petiole,pinnatifid,pinnatipartite,pinnatisect,pubescent,rarely,seed,simple,slender,small,stem,style,trans-ovoidal,triangular,tuberculate,venation,violet,yellow	-1.1,-2.5,-5.2,.2,.6,0.2-0.3,0.42,0.5,0.6-0.7,0.8-,1-2.4,1-3,1.3-1.8,1.4-1.7,12-13.5,2-,2.5-,3-4.5,3-5,3-6.5,4.7-,5-8.5,7-7.5,9-17,abundant,accrescent,acuminat,ag,alternate,amply,annular,antrorse,articulate,basal,blade,campanulate,capitate,coat,connectival,curved,difoliat,dorsal,eaf,eed,embryo,especially,evident,exceeding,fruiting,glandular,growing,half,herbaceous,hig,inflated,long,longer,longitudinal,longitudinally,lower,mixed,much,multi-seeded,near,nerve,non-glandular,oblong,one,opening,opposite,orolla,pair,papery-scarious,papillo,pore,poricidal,portion,prolongation,prostrate,ree,reticulate,ridged,ruit,scarce,segment,similar,slightly,slit,smooth,sometimes,stigma,strongly,styl,subsessil,tem,time,tip,trichome,tube,unequal,unifoliate,uniseriate,unit,vary,wide,wider,width,winged,x,ympodial	0.6,2.5-4.5,4.7-8.5,abaxial,adaxial,arrangement,branching,characteristic,colour,corolla,form,fruit,growth,height,history,inflorescence,leaf,life,midvein,na,ovary,pedicel,peduncle,perennial,plant,primary,pseudostipule,rachi,shape,staman,surface,tertiary,texture,unarmed,vein
200	wfo-0001028131	success	208	115	93	115	22	0.447	.5,0.3-0.7,0.4-0.8,0.5-1.1,0.8-1,0.8-1.1,1-5,1/5,2-2.8,2-4,3-6,4-6,5-6.5,abaxial,absent,adaxial,anther,apex,articulated,attenuate,base,berry,branched,calyx,cell,cm,cream,dark,deltate,densely,diameter,dull,erect,eye,filament,flattened-reniform,flower,fruit,glabrescent,glabrous,green,herb,infructescence,lateral,leaf,length,lobe,lobed,margin,marking,maturity,mauve,midvein,mm,naked,narrow-obovate,narrow-ovate,oblong,obtuse,orange,orange-brown,outline,pair,pale,pedicel,peduncle,per,petiole,pit,primary,purple,raised,red,rounded,shiny,simple,small,smooth,sparsely,spherical,stellate-pubescent,stem,style,surface,tertiary,unarmed,upper,vein,venation,visible,yellow,yellow-green,young	-1.2,.1,/5,0-0.6,0-2,0-3,0-30,0-4,0.05-0.2,0.1-0.15,0.1-0.3,0.2-1.5,0.7-1.1,1-10,1-3,1-4,1.5-3,1.5-5,1.8-2,1.8-2.2,1/4-2/3,2-5,2-6.5,2/3,5-8,5-merous,6-7,7-8,abaxially,acuminat,alyx,apar,apart,apically,apparently,bark,blade,broad-deltate,chartaceous,concolorous,connivent,curved,difoliate,distance,drying,eaf,eed,elongating,epidermi,equal,extending,filiform,flattened,free,fruiting,geminat,gland,lanceolate,lengt,like,long,longer,lower,mature,membranous,midpoint,moderately,nflorescence,often,older,one,open,orolla,oung,pale-brown,pale-gra,pendulous,perfec,pericarp,poricidal,porrect,portion,prickl,prickle,prickly,ray,reduced,reflexed,ruit,scar,sessil,sessile,shorter,side,sometimes,spaced,spreading,stellate,straight,strongly,sunk,tamen,tapering,terete,time,tip,trichome,tube,unarme,unit,vary,way,wide,woody,ympodial	arrangement,branching,characteristic,colour,corolla,form,growth,height,history,inflorescence,life,na,ovary,perennial,plant,pseudostipule,rachi,seed,shape,staman,texture,ye
201	wfo-0001028148	success	157	117	83	74	34	0.529	-6,0.25-0.5,0.5-1.5,0.75-2,1-15,1-3.5,1.5,1.5-2.5,10-30,12-15,2,2-3,2-7,2.5-4,3.5-4,5-20,5-7,acute,angled,apart,apex,apiculate,articulated,base,blue-black,branched,calyx,cm,cylindrical,dark,decurrent,deltate,diameter,elliptic,entire,except,fruit,glabrous,glaucous,globose,hair,highly,less,light-colored,lobe,margin,mature,minute,mm,moderately,narrowly,obtuse,often,pedicel,peduncle,petiole,pink,puberulence,puberulent-pubescent,purple,rachi,rarely,rhizomatous,ridge,ripe,scalloped,shrub,simple,slender,slightly,smooth,sometimes,spaced,sparse,style,surface,tapered,treelet,unbranched,violet,whitish,x,young	.5-4,0.6-3.5,15,20-50,3.5-9,4-10,4.5-10,5,5-10,5-8,6-18,abaxially,absen,adaxially,aggregate,axe,ba,blade,broadly,cell,central,chartaceous,connivent,densely,directed,distal,distall,eaf,eed,especially,fleshy,flower,fresh,long,lower,many-foliat,margi,material,midrib,nflorescence,nther,orange,orolla,ovate,part,perfect,plicae,plicate,pore,puberulent,radiu,rotate-stellate,ruit,smoot,star,stigma,stone,succulent,tal,tem,thickened,time,tip,triangular,truncat,tube,unit,usually,vary,white,wide,winge,yellow,ympodial	0.5-4,abaxial,adaxial,anther,arrangement,branching,characteristic,colour,corolla,filament,form,growth,height,history,inflorescence,leaf,length,life,midvein,na,ovary,plant,primary,pseudostipule,seed,shape,staman,stem,tertiary,texture,unarmed,vein,venation,winged
202	wfo-0001028161	success	124	81	44	80	37	0.355	1-1.3,1-1.5,2.5-3,3-4,3-7,4-5,9-11,acuminate,acute,apex,attenuate,base,berry,brown,calyx,cm,corolla,densely,elliptic,globose,green,incrassate,lanceolate,leaf,margin,minutely,mm,narrowly,ovoid-reniform,pair,pale,pedicel,petiole,pitted,pubescent,reddish-brown,shape,shrub,somewhat,sparsely,stem,surface,vein,x	.5,0.1-0.25,0.25-0.5,0.7-1.7,1-2,1-2.3,1.5-4.5,1/3,2-5-flowered,2-9,6-9,7.5-12,abaxially,adaxially,along,anthesi,arising,ba,bark,branch,branched,cell,closely,congested,consisting,deflexed,dendritic,denser,dia,differing,difoliate,distal,eaf,edicel,eed,exserted,fruiting,geminat,glabrescen,inflorescenc,later,lateral,like,lon,long,main,major,middle,minor,nflorescence,obovoid,often,older,opposite,orbicular,outline,overlappin,probably,pubescence,rest,rounded,ruit,scar,short,simple,sinuate,size,spaced,strongly,tall,tan,tapering,thin,trichome,tub,ud,unit,widest,ympodial,young	abaxial,adaxial,alternate,anther,arrangement,branching,characteristic,colour,diameter,filament,form,fruit,glabrescent,growth,height,hirsute,history,inflorescence,length,life,lobe,midvein,na,ovary,peduncle,perennial,plant,primary,pseudostipule,rachi,seed,staman,style,tertiary,texture,unarmed,venation
203	wfo-0001028164	success	197	126	100	97	26	0.508	-1,-6,0.4-0.8,0.5-0.8,0.5-1,0.7-1.1,0.9-1.6,1-1.5,1-4.5,1.8-2.5,1/3,2.5-4,2.5-4.5,2.8-4,3-17,3.6-4.8,6-8,abaxial,acuminate,acute,anther,apex,apically,apparently,articulated,attenuate,base,berry,branched,bright,calyx,cm,dark,deltate,densely,diameter,dull,elliptic,entire,erect,evenly,eye,filament,flattened-reniform,fruit,glabrescent,glabrous,glandular,gray,green,hair,lateral,leaf,length,lobe,long,margin,maturity,mauve,membranous,midvein,minute,mm,moderately,naked,obtuse,often,orange-brown,pair,pale,pedicel,peduncle,petiole,primary,recurved,red,red-brown,shallowly,shrub,simple,sometimes,sparsely,spherical,stellate-pubescent,stem,style,surface,terete,terminal,tertiary,unarmed,undulate,upper,vein,venation,visible,white,yellow,yellow-green,young	-14,-8,/4,0-20,0.05-0.2,0.05-1.5,0.1,0.3-0.8,0.8-1.5,1,1.5-2.5,1/6-1/4,12-20,2-2.5,3-7,4-13,4-5-merous,4-7,4-8,8-15,8-17,abaxially,almost,alyx,ame,apar,bark,blade,c.,concolorous,connivent,curved,difoliate,drying,eaf,eed,elongating,equal,filiform,flower,free,fruiting,geminat,glabrescen,glabrou,infructescence,less,lobed,long-acuminat,longer,lower,mature,midpoint,multangulate,narrow-deltate,nflorescence,older,one,open,orolla,oung,per,perfec,pericarp,poricidal,porrect,portion,ray,reflexe,ruit,scar,sessile,shorte,shorter,side,smooth,spaced,spreading,stalk,stalked,stellate,straight,tamen,tapering,time,tip,trichome,tube,unarme,unit,variously,vary,way,wide,woody,yellow-gra,ympodial	adaxial,arrangement,branching,characteristic,colour,corolla,form,growth,height,history,inflorescence,life,long-acuminate,na,ovary,perennial,plant,pseudostipule,rachi,seed,shape,staman,texture,width,ye,yellow-gray
204	wfo-0001028180	success	147	103	65	82	38	0.442	0.7-1,1-1.5,1-1.8,1-3,2-3,2.5-3,3-4,4.5-5,5-6,7,8-10,acute,anther,apex,attenuate,bark,base,calyx,closely,cm,corolla,dark,deltate,elliptic,elongate,erect,falcate,filament,four-angled,glabrous,globose,green,irregularly,leaf,lobe,major,margin,minor,minutely,mm,ovary,ovoid-reniform,pair,pale,pedicel,petiole,pinkish-white,pitted,puberulent,pubescent,scar,simple,size,small,spaced,sparsely,stem,style,surface,tan,tree,vein,white,x,yellow-gray	.05,.5,/2,1-1.2,1.5-5,15-28,2-2.2,20-30-flowered,3-10,5-8,abaxially,adaxially,along,anthesi,ba,beginning,berry,c.,capitate,conical,cucullate,darker,deflexed,densely,dia,differing,difoliate,distinctly,drying,eaf,eed,fleshy,free,fruiting,geminat,glabrat,gold,golden,know,larger,lateral,leathery,lobed,lon,long,lower,main,midrib,nearly,nflorescence,obscure,older,onto,opposite,overlappin,papillose,planar,pore,poricidal,portion,ruit,shaped,shiny,somewhat,stigma,straight,styl,tall,tear-drop,thick,tip,trichome,tube,ud,underside,uniseriate,unit,way,winged,woody,ympodial,young	abaxial,adaxial,alternate,angle,arrangement,branching,bud,characteristic,colour,diameter,form,fruit,glabrate,growth,height,history,inflorescence,length,life,midvein,na,orientation,overlap,overlapping,peduncle,perennial,plant,primary,pseudostipule,rachi,seed,shape,spacing,staman,tertiary,texture,unarmed,venation
205	wfo-0001028182	success	150	92	58	92	34	0.387	0-90,0.5-0.6,0.5-1,0.8-1,0.9-1,1-1.5,2-2.5,2-6.5,3-5,4-6,anther,apex,apiculate,arching,bark,base,bending,beneath,branch,calyx,ciliate,cm,cordate,corolla,deflexed,deltoid,filament,filiform,glabrous,inflorescence,keeled,leaf,lobe,long-acuminate,margin,mm,narrowly,ovary,ovate,pair,pedicel,petiole,pubescent,purplish,rounded,scar,shiny,shrub,simple,slender,somewhat,sparsely,stem,style,surface,truncate,vein,white	.5,0.1-0.2,0.5,2,3,5-15-flowered,5-ribbed,6-9,along,anthesi,apart,apiculae,axi,black,blade,brown,capitate,conical,densely,dia,dry,eaf,edicel,eed,ellipsoid,evenly,except,extreme,flower,free,globose,gre,hemiepiphyte,internodal,know,known,later,lateral,lax,less,like,lobed,long,lower,main,material,midrib,minute,minutely,nearly,nflorescence,obovoid,older,opposite,papillo,papillose,planar,pore,poricidal,portion,present,prominent,proximal,reflexed,rib,ruit,sca,shaped,slightly,spaced,sparser,specimen,spindly,stigma,still,strongly,tapering,tear-drop,third,time,tip,trichome,tube,ud,unifoliat,uniseriate,unit,widest,x,ympodial,young,zig-zag	1,abaxial,adaxial,apical,arrangement,branching,characteristic,colour,diameter,form,fruit,grey,growth,height,hemiautotrophic,history,length,life,midvein,na,peduncle,plant,primary,pseudostipule,rachi,seed,shape,staman,sympodial,tertiary,texture,unarmed,unifoliate,venation
206	wfo-0001028183	success	237	133	104	133	29	0.439	-10,-5.3,0.2-0.3,0.2-0.5,0.5-2.5,0.7-1.2,0.7-2,0.8-1.4,0.8-3.1,1.1-1.8,1.2-1.4,1.3-1.7,1.4-2.8,1.5-3.4,1.7-2.7,1/3-1/2,10-15,2-4.2,2-5,2.8-4.2,3.5-6.6,5.2-6.2,6.6-20,8-9.1,9-13,abaxial,abaxially,adaxially,anther,apart,apex,articulated,attenuate,base,branched,calyx,closely,cm,corolla,cuneate,deltoid,diameter,dull,elliptic,entire,filament,flower,fruit,glabrescent,glabrous,globose,granular-punctate,half,lanceolate,leaf,lobe,lobed,lower,many,margin,midrib,mm,narrowly,orangish-tan,pedicel,peduncle,petiole,porrect-stellate,prominent,pseudoterminal,pubescent,purple,rachi,relatively,reportedly,reticulate-punctate,ripe,scabrous,shrub,side,simple,somewhat,soon,spaced,sparingly,spherical,stem,streak,style,sub-lenticular,surface,tan,thin-textured,time,tomentose,translucent,tree,upper,vein,violet,way,white,x,yellowish	.5-3,0.1,0.1-0.2,0.1-0.4,0.1-0.9,0.2-0.4,0.5,0.6,1.3-1.4,1.6-2.3,1.9-3.7,11-30,2.2-5.7,2.5-4.1,2.6-4.4,3.2-,4.5-9,4.6-6.4,5-8,5-8.5,50-400,7.5-23,accrescent,acute,ag,along,alyx,anthesi,apparently,around,axi,axillary,bark,berry,blade,blunt-tipped,branch,brown,bud,capitate,cell,central,chartaceous,cylindrical,dark,dendritic-multangulate,directed,distally,distantly,drying,eaf,earl,edge,eed,elongated,epidermal,especially,evident,except,exserted,farinose,few-rayed,free,fruiting,glabrescen,group,hair,high,inserted,lackin,lateral,lengthening,lon,long,long-decurrent,longitudinal,m.,main,multangulate,nearly,nflorescence,oblong,obovoid,older,open,orolla,ovate-lanceolate,overlapping,perfec,plurifoliate,pore,poricidal,porrect-stellat,present,pubescence,rarely,ruit,runk,sessile,short,short-,slit,small,sparse,splitting,stage,stalk,stamen,stellate,stigma,stipitate-glandular,stout,strongly,subcampanulate,suture,tamen,terete,thick,thin,tip,touching,tube,ud,unarme,unit,usually,vary,whitish,wide,yellow,yellowish-tomentose,ympodial,young	3.2-6.4,adaxial,arrangement,branching,characteristic,colour,form,green,growth,height,history,inflorescence,length,life,midvein,na,ovary,perennial,plant,primary,pseudostipule,seed,shape,staman,tertiary,texture,unarmed,venation,ye
207	wfo-0001028227	success	236	125	98	138	27	0.415	-6.2,0.2-0.3,0.2-0.4,0.7-2.1,0.8-1.4,0.9-1.4,1-1.7,1-2.5,1-4.2,1.2-2,1.3-4,1.4-2.6,1.5-2.3,1.7-2.8,1/2,1/2-3/4,10,11-15,2-12,3-4.9,3.7-6.3,3.7-7,4.8-7.6,6.7-15,8.1-18,abaxial,abaxially,acuminate,acute,adaxially,anther,apex,attenuate,base,berry,branched,brown,brownish,calyx,cm,corolla,cuneate,dark,decurrent,deltoid,diameter,elliptic,entire,filament,fleshy,fruit,glabrescent,granular-tomentose,gray,grayish,green,leaf,less,lobe,long,many,margin,midrib,midvein,mm,oblong-lanceolate,obtuse,orangish-tan,pale,pedicel,peduncle,petiole,pseudoterminal,pubescent,purple,rachi,relatively,reticulate-punctate,ripe,scabridulous,shrub,side,simple,sparsely,stem,style,sublenticular,surface,thin,time,tomentose,tree,vein,velutinous,violet,way,x,yellow	-2/3,.5-4,0-250,0.1,0.2,0.2-0.5,0.3,0.4,0.5,0.8,0.9,0.9-1.2,1,1.1-3.1,1.4,1.9,1.9-4.2,1.9-5.8,10-24,2-3.8,2.5-7.8,2.6-5.9,2.9-4.7,4-13,5-7.5,6-16,8.5-22,accrescent,ag,age,along,alyx,anthesi,apart,apparently,appressed,around,articulated,axillary,bark,becoming,blade,blunt-tippe,blunt-tipped,branch,bud,c.,closely,cylindrical,dendritic-echinoid,directed,distally,drying,eaf,early,echinoi,echinoid,edge,eed,elongate,ength,exserted,farinose,flower,free,fruiting,glabrous,globose,hair,high,inserted,lacking,lanceolate,lateral,lengthening,lobed,lon,longitudinal,lower,m.,main,mostly,multangulate,nflorescence,oblong,obscured,occasionally,often,older,orbicular,orolla,ovate-lanceolate,ovate-orbicula,overlapping,perfec,plurifoliate,pore,poricidal,porrect-stellate,present,prominent,pubescence,quarter,rounded,ruit,runk,sessile,slightly,slit,somewhat,spaced,stalk,stamen,stellate,stigma,stout,subcampanulate,subspherical,sulcate,suture,tamen,thick,thicker,tip,tomentu,touching,tube,ud,unarme,unit,upper,usually,vary,well,wide,yellowish,ympodial,young	adaxial,arrangement,branching,characteristic,colour,form,growth,height,history,inflorescence,length,life,na,ovary,perennial,plant,primary,pseudostipule,seed,shape,staman,subspheical,tertiary,texture,unarmed,venation,ye
208	wfo-0001028228	success	143	103	71	72	32	0.497	.5,0.1-1.7,1-1.5,1.1-1.2,1.2-1.8,1.5-2,10-30-flowered,2,2-8,6-7,6-8,abruptly,acute,anther,apex,base,berry,brown,calyx,clavate,cm,coriaceous,corolla,dark,deflexed,deltoid,dia,dry,elliptic,filament,glabrous,globose,green,greenish-yellow,lateral,leaf,lobe,long,main,margin,material,minutely,mm,narrowing,obovate,occasionally,opposite,ovary,ovoid-reniform,pair,papillose,pedicel,petiole,reticulate,rounded,shining,shrub,simple,slender,small,stem,straight,style,surface,tapering,thick-margined,tree,tube,vein,white,x	0.75,1.1-2.5,1.8-3.4,2-5,2.1-4.2,2.8-6.5,3/4,7.5-12.5,age,anthesi,area,ba,bark,becoming,beginning,beneath,caly,campanulate,closely,difoliate,distal,eaf,edicel,eed,erect,exserted,fragrant,free,fruiting,geminat,impressed,inflorescenc,lobed,lon,lower,major,middle,minor,minute,nflorescence,older,overlapping,ovoid,pale,planar,pore,poricidal,portion,prominent,ruit,scar,shaped,shinin,slightly,spaced,stigma,styl,sweetly,tall,tear-drop,terminal,thickened,tip,ud,unit,usually,way,weight,widest,woody,ympodial,young	abaxial,adaxial,arrangement,branching,characteristic,colour,diameter,form,fruit,greyish,growth,hair,height,hirsute,history,inflorescence,length,life,midvein,na,peduncle,plant,primary,pseudostipule,rachi,seed,shape,staman,tertiary,texture,unarmed,venation
209	wfo-0001028263	success	156	117	83	73	34	0.532	0.25,1-2,1-3,1-4,11-23,2,2.6,3,3.4,4,6,6-8,9,abaxially,acumen,acuminate,acute,adaxially,apex,articulate,atenuate,base,branched,broadly,calyx,cell,cm,conical,cordate,corolla,covering,cuneate,cyme,darker,deep,diameter,dichasial,dichasially,distal,ebracteate,elliptical,exceeding,filament,green,green-white,hair-like,herbaceous,lateral,leaf,light,lobe,long,make,medium,mm,monochasial,mucilaginous,oblique,odd-pinnate,ovate,ovoid,pedicel,peduncle,perennial,petiole,plant,proximal,puberulent,pubescent,rotate,seed,sessile,stamen,stigma,straight,strigose,style,testal,thick,throughout,violet,wall,Â¼	11-13,14-44,2-3,2-4,3-6-foliat,3.5-4.2,4-5,5-7,5-7.5,8-1.,8-14,abaxiall,apical,apically,connate,dehiscent,digestion,diminishing,dorsally,eaf,edge,eed,emoval,enzyme,equal,first,flat,flower,folded,forked,generally,globo,gradually,half,honeycomb,interjected,introrse,leaflet,living,lon,lower,lunat,maturing,nflorescence,nther,often,orolla,pair,pattern,perfect,plan,poricidally,reveal,ruit,seudostipule,short,size,slit,specimen,tal,tem,terminal,throughou,toward,truncate,tuber-bearing,two,typically,unit,vary,wide,yellow,ympodial	abaxial,adaxial,anther,arrangement,branching,characteristic,colour,form,fruit,globose,growth,height,history,inflorescence,length,life,lunate,margin,midvein,na,ovary,primary,pseudostipule,rachi,shape,staman,stem,surface,tertiary,texture,unarmed,vein,venation,wet
210	wfo-0001028280	success	87	78	40	47	38	0.46	.5,0.7-1,1-2,1-2-flowered,2-3,7-8,acuminate,apex,arching,attenuate,base,berry,ciliate,cm,dark,decurrent,elliptic,flattened,glabrous,globose,green,lanceolate,leaf,long,margin,minutely,mm,narrowly,pair,pedicel,petiole,rounded,shrub,simple,stem,surface,tip,ultimate,vein,winged	1.5-2.7,2-2.5,6-9,almost,anthesi,ape,axil,bark,branch,brow,closely,completely,dia,eaf,eed,fruiting,immature,know,known,lateral,lon,lower,main,middle,new,nflorescence,older,onto,opposite,papillae,pendant,present,ruit,scar,sessil,small,somewhat,spaced,tall,ud,unifoliat,unit,widest,woody,x,ympodial,young	abaxial,adaxial,anther,arrangement,branching,brown,calyx,characteristic,colour,corolla,diameter,filament,form,fruit,growth,height,history,inflorescence,length,life,lobe,midvein,na,ovary,peduncle,plant,primary,pseudostipule,rachi,seed,shape,staman,style,tertiary,texture,unarmed,unifoliate,venation
211	wfo-0001028281	success	267	128	110	157	18	0.412	-0.9,-1,-3,-5,0.1-0.15,0.2-0.5,0.2-0.7,0.3-1,0.5-1,0.7-1.2,0.75-1,1-3,1.1-1.4,1.5-2,2-4,2-locular,2.1-3.0,20-30,6,6-15,abaxial,acuminate,acute,adaxial,almost,anther,apex,base,basiscopically,branching,brown,calyx,cell,cm,conical,corolla,dark,deep,densely,diameter,distal,doubly,elliptic,elongate-triangular,entire,extended,filament,flower,form,fruit,glabrous,glandular,globose,golden,green,hair-like,half,head,imparipinnate,inflorescence,interrupted,lateral,leaf,leaflet,like,lobe,long,margin,midvein,mm,multi-cellular,narrowly,oblique,obovate,occasionally,once-branched,orbicular,outgrowth,ovary,ovate,pale,paler,patent,pedicel,peduncle,petiole,primary,proximal,pseudostipule,pubescent,rachi,regularly,serrate,shrub,silky,sometimes,sparsely,stem,stripe,style,surface,terminal,tertiary,testa,trichome,uniseriate,vein,vine,wall,yellow	+,-10,-20,-36,-45,-7,-8,.2,.4,.5,0.05-0.4,0.15-0.2,0.2-0.3,0.3-0.5,0.5-,0.5-0.6,0.5-0.7,0.5-1.1,0.5-1.2,0.7-,0.7-2.5,0.8-1,1,1-,1-1.5,1-5,1.0-1.6,1.1-2.4,1.2-1.5,1.2-1.6,1.4-4,1.5-6,1.7-2.5,10-18,10-30,2-13,2-4-celled,2-6.5,2.5-,3-16,3-5,3-8.5,3-foliate,5-8-celled,7-30,abaxially,absent,alternate,anthesi,apical,appearance,appendage,appressed,arising,articulation,autogamous,axi,bent,berr,blade,bract,bracteate,broadly,capitate,column,composed,covering,darker,decreasing,decurrent,developed,dry,eaf,edicel,eed,eglandular,either,elongate,enclosing,exerted,exserted,fragile,free,fruiting,generally,giving,gland,gree,hal,halfway,included,interjected,internode,large,largest,less,lon,longest,lower,material,medial,minute,mixture,multi-celled,multicellular,nflorescence,node,opposite,other,pair,petiolule,point,population,portion,present,primarily,probably,rest,rotate,ruit,secondary,serrat,sessile,set,shorter,size,small,smaller,smooth,sparser,sprawling,staminal,sterile,stiff,stigma,straight,strongly,subopposite,tem,thick,thin,three,tip,toward,transparent,tube,type,ud,unicellular,unit,usually,weak,weak-walled,well,wide,winged,ympodial	0.7-1.5,arrangement,characteristic,colour,growth,height,history,length,life,na,perennial,plant,seed,shape,staman,texture,unarmed,venation
212	wfo-0001028317	success	204	126	101	103	25	0.495	-1.5,-5,0,0.3-1,0.6-0.8,0.6-1.2,0.6-1.5,0.8-1.1,1-1.3,1-3,1-4,1.4-2,1/5,2-2.8,2-4.5,2.8-3.3,3-4,4-6,5-8,absent,acute,anther,apex,apically,apparently,articulated,base,berry,branched,bright,brown,calyx,chartaceous,cm,cream,cuneate,dark,deltate,densely,diameter,dull,erect,eye,filament,flattened-reniform,fruit,glabrous,gray,green,herb,infructescence,lanceolate,lateral,leaf,length,lobe,lobed,long,lower,margin,marking,maturity,mauve,midvein,mm,moderately,naked,obtuse,orange-brown,ovate,pair,pale,pedicel,peduncle,per,petiole,primary,purple,red,shrub,simple,sometimes,sparsely,spherical,stellate-pubescent,stem,style,surface,terminal,tertiary,truncate,unarmed,upper,vein,venation,visible,white,wide,yellow,yellow-green,young	/5,0-1,0-5,0.1,0.1-0.25,0.1-0.3,0.1-0.4,0.3-0.4,0.5-3.5,0.8-2.5,1.1-1.9,1.8-2.5,1/,1/3-1/4,1/4-2/3,2-4,2.5-6.5,2/3,3-10,3-5,4-5-merous,4-8,6-10,abaxially,acuminat,almost,alyx,apar,apart,bark,blade,broad-deltate,brow,concolorous,curved,difoliate,distance,drying,eaf,eed,elongating,equal,extending,filiform,flower,free,fruiting,geminat,hair,herbaceous,longer,mature,midpoint,minute,nflorescence,oblong,older,one,open,orolla,oung,pendulous,perfec,pericarp,poricidal,porrect,portion,prickl,prickle,prickly,ray,reduced,reflexed,rounded,ruit,scandent,scar,sessile,shorter,side,smooth,spaced,spreading,stalk,stalked,stellate,straight,subsessile,tamen,tapering,terete,time,tip,toward,translucent,trichome,tube,unarme,unit,variously,vary,way,ympodial	1/2,abaxial,acuminate,adaxial,arrangement,branching,characteristic,colour,corolla,form,growth,height,history,inflorescence,life,mentioned,na,ovary,perennial,plant,seed,shape,staman,texture,ye
213	wfo-0001028323	success	164	118	91	73	27	0.555	-2,0.2-0.5,0.2-1,0.6-1,0.9-1.2,1-1.2,1-1.5,1-2,1.5-2.5,2-3,3,3-5,3.5-4,5-6,7.5-9,acute,anther,anthesi,apart,apex,articulated,attenuate,base,berry,blue-green,brown,calyx,cm,conical,corolla,dark,densely,diameter,ellipsoid,elliptic,entire,erect,fading,filament,fleshy,fruiting,glabrescent,glabrous,globose,grey,growth,included,inflorescence,internodal,lanceolate,leaf-opposed,less,lobe,margin,maturity,minutely,mm,ovary,ovoid,pair,pale,pedicel,peduncle,peg,petiole,pitted,primary,pubescent,reddish,remaining,revolute,rounded,scar,shiny,shoot,short,shrub,simple,small,sometimes,somewhat,sparely,sparsely,stem,style,surface,vein,violet,white,woody,x	0.4-1.3,0.5,0.5-1,0.8,1,1.1-4.5,1.5,2-9,3-6,abaxially,abscissio,absent,along,apparently,appressed,ba,bark,c.,capiatate,cell,coriaceous,cup-shaped,deltate,dendritic,drying,eaf,eed,flower,free,glabrescen,lengthening,like,lobed,longer,lower,main,minute,new,nflorescence,occasionally,ovate,papillat,papillose,perfect,pericarp,planar,plurifoliat,pore,poricidal,portion,proceed,ruit,scattered,sinus,soft,soon,splitting,stigma,straight,tearing,testal,thick,thin,tip,trichome,tube,tuft,ud,uniseriate,unit,wall,way,ympodial	abaxial,abscission,adaxial,arrangement,branching,bud,characteristic,colour,form,fruit,height,history,leaf,length,life,midvein,na,plant,pseudostipule,rachi,seed,shape,staman,tertiary,texture,unarmed,venation
214	wfo-0001028329	success	215	157	131	84	26	0.609	.5-3,.75-5.75,0-100,0.2-0.3,0.8-1.1,0.8-1.4,0.9-1.3,1-6,1.1-2.5,1.3-1.8,1.3-2,1.5-2.3,1.5-3.5,1.5-8,12,2-3,2.2-3.9,2.6-5,3-8,4-15,5-10,6-11,6-8,6-9,abaxially,acuminate,acute,adaxially,anther,apart,apex,articulated,asperous,axe,base,becoming,berry,branch,branched,brown,calyx,closely,cm,conical,continued,corolla,deltoid,dendritic-echinoid,diameter,dichotomously,distantly,due,echinoid,entire,filament,finely,fleshy,flower,fruit,glabrous,granular,granular-tomentose,gray,green,growth,hair,honeycombed,lateral,leaf,length,lobe,long-attenuate,margin,midvein,minutely,mm,moderately,mostly,multangulate,obovate,obtuse,occasional,ovate,ovate-elliptic,pale,pedicel,peduncle,petiole,plurifoliate,porrect-stellate,pseudo-terminal,pubescent,rachi,rather,reniform,reticulate-punctate,ripe,sessile,several,short-,short-stalked,shrub,side,simple,small,sometimes,spaced,sparse,sparsely,stellate,stellate-pubescent,stem,style,subglobose,suborbicular,testa,thick,time,tomentose,touching,tree,turning,unarmed,vein,velutinous,vestigial,white,whitish,x,yellow,yellowish	.75-2,/10-3/10,1.0-1.4,1.5-2.75,10-34,2-4,2.75-4.5,3-14,3.75-7,3/4,4-5,7-19,absen,ag,angled,anthesi,apical-lateral,apparently,axillary,ba,bark,blade,blunt-tipped,bud,chartaceous,cylindrical,dehiscing,dendritic-echinoi,distinct,eaf,eed,free,glabrescen,grooved,high,inserted,introrse,large,lengthening,lobed,long,longitudinally,lower,main,multangulat,nflorescence,obelliptic,oblong,obscured,older,orbicular,orolla,perfect,pore,present,receptacle,relatively,ruit,runk,sessil,slightly,slit,stalked,stellat,stellate-rotate,stelliform,stigma,subcapitat,suture,swollen,tamen,thickened,thin,tomentu,toward,tube,unarme,unit,usually,vary,way,wide,ympodial,young	abaxial,adaxial,arrangement,branching,characteristic,colour,form,glabrescent,height,history,inflorescence,life,na,ovary,plant,primary,pseud-terminal,pseudostipule,seed,shape,staman,surface,tertiary,texture,venation,ye
215	wfo-0001028337	success	195	121	97	98	24	0.497	-2.5,-6,.5,0,0.3-0.5,0.4-0.8,0.7-0.9,0.7-1,1-1.8,1-2,1-3,1.5-3,1.8-2,2-2.2,2-4,4-5,5-25,5-6,abaxial,adaxial,anther,apex,apically,apparently,articulated,base,berry,branched,calyx,chartaceous,cm,color,cuneate,dark,deltate,densely,diameter,entire,erect,evenly,eye,filament,flattened-reniform,flower,fruit,glabrous,glaucous,gray-brown,green,green-brown,hair,inflorescence,known,lateral,leaf,length,lobe,long,margin,marking,mature,mauve,minutely,mm,moderately,naked,narrow-oblong,one,open,orange-brown,pedicel,peduncle,per,pericarp,petiole,pitted,primary,rounded,shallowly,shrub,simple,smooth,sparse,spherical,stellate-pubescent,stem,style,surface,terminal,time,toward,unarmed,vein,visible,white,wide,young	-2,-4,.8,/3,0.05-0.15,0.05-1,0.1-0.3,0.4-0.7,1,1.5-4,1/2,1/3-2/3,1/4-1/3,1/8-1/4,11-16,15-50,3-4,5-8,5-merous,6-7,8-10,8-14,abaxially,acut,alyx,apar,apart,ape,bark,blade,conical,connivent,curved,discolorous,drying,eaf,eed,elongating,equal,free,fruiting,fused,gently,glabrescent,glabrou,gray,infructescence,juvenil,juvenile,lobed,long-styled,longer,lower,midpoint,nflorescence,occasionally,older,orolla,oung,pale,perfect,plurifoliat,poricidal,porrect,porrect-lepidote,portion,prickle,prickly,ray,reddish,reflexed,ruit,scar,sessile,shoot,short,short-styled,shorter,slender,small,spaced,staminate,stellate,stout,straight,strongly,tamen,tapering,terete,tip,trichome,tube,unarme,unit,usually,vary,way,ympodial	acute,arrangement,branching,characteristic,colour,corolla,form,growth,height,history,life,midvein,na,ovary,plant,pseudostipule,rachi,seed,shape,staman,tertiary,texture,venation,ye
216	wfo-0001028339	success	195	129	97	98	32	0.497	.5,1-1.2,1-2,1-5,1.1-1.4,1.2-1.5,1.5,1.5-2,1.7-3.2,10-30-flowered,2.5-5,3.5-4,5-7,8-10,8182,acuminate,acute,anther,apex,base,beneath,berry,blue,broadly,brown,calyx,cm,corolla,covered,cuneate,dark,decurrent,deflexed,densely,dia,dried,dry,evenly,filament,filiform,flattened,glabrous,globose,grainy,greyish-brown,growth,lateral,leaf,little,lobe,lobed,long,long-triangular,main,margin,minutely,mm,mustard,nearly,oblique,obscure,ovary,ovate,ovoid-reniform,papillate,papillose,pedicel,petiole,pitted,pulp,schwarz,shrub,simple,slender,slightly,small,somewhat,spaced,specimen,stem,strong,strongly,style,surface,tapering,texture,tip,tree,trichome,tube,vein,venation,white,winged,woody,x,yellow	0.05-0.1,0.8-1.2,1-1.5,10.2-18.5,3.4-5.5,43191,5-angled,5.8-7.9,7-11,across,almost,anthesi,appearance,appearing,appressed,attenuate,bark,becoming,bud,capitate,carinate,carpel,closely,connate,crystalline,cup-shaped,differing,difoliate,distinctly,eaf,edicel,eed,enclosed,epidermi,erect,exserted,fide,first,floccose,flower,free,frui,fruiting,geminat,glabrate,irregular,large-celled,later,leave,like,lon,lower,major,middle,minor,nee,nflorescence,occasionally,older,one,opposite,overlappin,ovoid,papery,planar,pore,poricidal,portion,proximal,red-brown,reflexed,ruit,scar,secondary,septum,shaped,shining,size,sparsely,speckled,stigma,straight,tall,tear-drop,tightly,tub,ud,uniseriate,unit,urceolate,white-lenticellat,white-papillo,white-speckled,wide,widest,yellowish,ympodial,young	abaxial,adaxial,alternate,arrangement,branching,characteristic,colour,diameter,form,fruit,green,greyish,hair,height,hirsute,history,inflorescence,length,life,midvein,na,peduncle,perennial,plant,primary,pseudostipule,rachi,seed,shape,staman,tertiary,unarmed
217	wfo-0001028351	success	175	121	95	80	26	0.543	.2,.8,0,0.1,0.2,0.5,1.0â2.0,1.0â2.5,1.4â1.5,2.0â2.5,2.1â3.5,2/3,3,3.4â5.0,3â4,40,5.0,5.0â5.5,5.5â10.5,5â7,6.5â8.5,6â12,8â15,abaxially,absent,acute,adaxially,along,annual,anther,anthesi,apart,apex,articulated,base,becoming,blue,branching,brown,calyx,cm,colour,densely,diameter,filament,flattened,fruit,glabrous,globose,green,hair,herb,lanceolate,leaf,lobe,lobed,long,lower,margin,midvein,mm,moderately,multicellular,narrowly,occasionally,opposed,ovate,pale,pedicel,peduncle,perennial,petiole,pitted,pubescent,regularly,shallowly,shiny,simple,slender,smaller,spaced,stem,style,surface,truncate,unbranched,unicellular,uniseriate,unknown,velutinous,white,winged,woody,x,â3.0	.8â1.0,0.6,0â,1.0â,1.0â1.6,1.5â4.0,1.6â,10,2,2.0â5.0,2â2.5,2â4,4,5,adaxiall,ag,apical,axe,ba,basal,blade,capitate,cell,chartaceous,clavate,connivent,convex,cylindrical,directed,distally,eaf,eed,equal,erect,fleshy,flower,geminat,glandular,indumentum,lamin,like,lon,longitudinal,m.,nfloresence,number,oblong,obtuse,opening,orolla,pair,pentagonal,perfect,plurifoliate,pore,present,probably,ruit,serrate,shaped,side,slit,sparsely,stigma,stone,straight,tal,tamen,tardily,teardrop,tem,time,tube,unit,vary,wide,wing,ympodial,young,â	abaxial,adaxial,arrangement,characteristic,corolla,form,growth,height,history,inflorescence,length,life,na,ovary,plant,primary,pseudostipule,rachi,seed,shape,staman,tertiary,texture,unarmed,vein,venation
218	wfo-0001028353	success	177	135	108	69	27	0.61	/3,0.2-0.4,0.5,0.9-1.2,1,1-2,1.4-2,2,2-3,2-4,3,3-5,6-8,7,8-10,acute,anther,apex,base,becoming,beneath,berry,bluntly,bright,calyx,campanulate,cell,centre,ciliate,clasping,cm,coarsely,conical,cordate,corolla,curved,dark,deep,deeply,densely,diameter,distally,elliptic,erect,filament,fleshy,flower,fracturing,glabrous,globose,green,greenish,growing,herb,hollow,honey-comb,internodal,leaf,less,like,lobe,long,margin,midrib,mm,nodding,ovary,ovoid,pair,pale,papery,pedicel,peduncle,pericarp,petiole,pitted,plant,plump,point,primary,pubescent,purple,rhomboid,ripe,scattered,sessile,simple,slender,somewhat,sparsely,stem,straight,style,surface,tan,testal,thin,tip,toothed,toward,trichome,truncate,uniseriate,vein,wall,way,x,yellow	.5,0.5-,1-4,1.5-2,1.5-5,4-7,abaxially,accrescent,age,along,anthesi,apart,area,capitate,cup-shaped,decreasing,decumben,difoliate,dry,drying,eaf,edicel,eed,ellipsoid,emarginated,exerted,free,frui,fruiting,geminat,gree,heteromorphic,horn,horned,inserted,lengthening,lon,lower,m.,material,minute,minutely,nflorescence,often,open,outline,papillate,papillose,pore,poricidal,portion,principal,reddish,ruit,scar,sessil,shallow,short,size,sleeve,slightly,slit,stigma,strongly,tube,ud,unit,wrinkled,ympodial	0.5-2,abaxial,adaxial,arrangement,branching,characteristic,colour,form,fruit,growth,height,history,inflorescence,length,life,midvein,na,perennial,pseudostipule,rachi,seed,shape,staman,tertiary,texture,unarmed,venation
219	wfo-0001028390	success	147	101	67	80	34	0.456	0.5,0.5-1,0.5-1.5,0.5-2.5,1-2.5,1-3,1.5-2,10-15,3-4,3-5,4-5,5-7,7-8,9,acute,angled,apex,apiculate,articulated,base,branched,calyx,chartaceous,cm,cuneate,deltate,dendritically,densely,diameter,divided,elliptic,entire,felty-pubescent,forked,glabrous,globose,lobe,margin,midvein,mm,moderately,near,obtuse,often,orange,ovate,pedicel,peduncle,petiole,pseudohair,pubescent,rachi,rarely,shrub,simple,slightly,sparsely,style,subcordate,subcoriaceous,unbranched,unequally,violet,white,white-pubescent,x,yellow	-10,.5-3.3,0,1,1-5,1.5-3.5,1.5-5.5,2,2.5,4-11,6-many-foliat,7,abaxially,absen,adaxiall,adaxially,aggregate,apart,axe,blade,cell,connivent,curled,cylindrical,dendritically-branched,dense,directed,distall,eaf,eed,eglandular,flower,gland,hair,lanceolate,leaving,less,like,lon,long,lower,mixed,mostly,narrowly,nflorescence,nther,occasionally,orolla,peg,perfect,pore,presen,puberulent,pubescen,radiu,ripe,ruit,scar,short,small,spaced,stalked,ste,stellate,stigma,stone,subcapitat,subclavate,tal,tem,time,tip,triangular,truncate,tube,unit,usually,vary,wide,ympodial	abaxial,adaxial,anther,arrangement,branching,characteristic,colour,corolla,filament,form,fruit,growth,height,history,inflorescence,leaf,length,life,na,ovary,perennial,plant,primary,pseudostipule,seed,shape,staman,stem,surface,tertiary,texture,unarmed,vein,venation
220	wfo-0001028405	success	149	68	48	101	20	0.322	0.4-0.5,1-9,1.5-6.5,10-11,2,2-2.5,2-4,3-4,4-6,6-7,8-15,9-15,branched,calyx,cm,conical,corolla,cyme,diameter,dichasial,dichasially,ebracteate,elliptic,elliptic-lanceolate,green,herbaceous,lanceolate,leaf,lobe,mm,monochasial,mucilaginous,oblong,odd-pinnate,ovate-elliptic,ovoid,pedicel,peduncle,perennial,petiole,plant,puberulent,seed,size,straight,style,throughout,yellow	0.5-3,1-4,1.3-8,2-3,3-20,3-6-foliat,3.5-10,3.5-6.5,4-11.5,7-14.5,abaxially,absen,acumen,acute,adaxially,apex,apical,apically,apiculate,articulate,attenuate,base,cell,connate,covering,decurrent,dehiscent,digestion,diminishing,distal,dorsally,eaf,edge,eed,emoval,enzyme,exceeding,filament,flat,flower,folded,forked,generally,globo,gradually,green-white,hair-like,half,honeycomb,interjected,introrse,lateral,leaflet,living,lon,long,lower,lunat,make,maturing,nflorescence,nther,oblique,often,orolla,pair,pattern,perfect,plan,poricidally,proximal,rachi,reveal,ruit,seudostipule,short,short-acuminate,short-petiolate,slit,specimen,stamen,stellate,stigma,subsessile,tal,tem,terminal,testal,thick,throughou,toward,tuber-bearing,typically,unit,vary,wall,whit,wide,without,ympodial,Â¼	anther,arrangement,characteristic,colour,form,fruit,growth,height,history,inflorescence,length,life,lunate,ovary,pseudostipule,shape,stem,surface,texture,white
221	wfo-0001028429	success	162	113	81	81	32	0.5	0.2-0.4,0.8-1.2,1-4,1.5-3,10-11,10-27,2.5-12,2.5-7.5,2.7-3.6,3-6,4-14,6-28,abaxially,acuminate,acute,adaxially,apex,articulate,base,branched,broadly,calyx,cell,cm,cordate,corolla,covering,cuneate,cyme,darker,diameter,dichasial,dichasially,distal,ebracteate,elliptical,filament,glabrescent,glabrous,globose,green,green-white,greenish,hair,hair-like,herbaceous,lateral,leaf,light,lobe,long,long-attenuate,make,medium,mm,monochasial,mucilaginous,narrowly,oblique,odd-pinnate,ovate,ovoid,pedicel,peduncle,perennial,petiole,plant,proximal,scattered,seed,slightly,spot,style,testal,thick,throughout,vein,violet,wall,white,Â¼	0.9-2.3,1-2.5,1.5-4,10.5-21,2-1.,2-3,2-4,2-8,2.5-4,3-6-foliat,5-12,6-18,7-7,abaxiall,acumen,apical,apically,connate,dehiscent,digestion,diminishing,dorsally,eaf,edge,eed,emoval,enzyme,especially,exceeding,flat,flower,folded,forked,generally,globo,gradually,half,honeycomb,interjected,introrse,leaflet,living,lon,lower,lunat,maturing,nflorescence,nther,obovate,often,orolla,pair,pattern,pentagonal,perfect,petiolule,plan,poricidally,reveal,rotate,ruit,seudostipule,short,size,slit,specimen,stamen,stigma,straight,tal,tem,terminal,throughou,toward,tuber-bearing,typically,unit,vary,wide,yellow,ympodial	2,abaxial,adaxial,anther,arrangement,branching,characteristic,colour,form,fruit,growth,height,history,inflorescence,length,life,margin,midvein,na,ovary,primary,pseudostipule,rachi,shape,staman,stem,surface,tertiary,texture,unarmed,venation,wet
222	wfo-0001028436	success	150	100	72	78	28	0.48	.5,0.2-0.4,0.5-1,1-3,1.5,1.5-2,1.5-2.5,10-20,2-3,2-4,2.5-3,4,5-10,5-15,5-8,7,8-12,absent,acute,anther,apex,base,berry,brown,calyx,center,ciliate,decurrent,diameter,dm,dried,edge,elliptic,entire,filament,fine,flower,fruit,glabrous,globose,hair,leaf,linear,linear-lancolate,lobe,margin,mm,moderately,much-branched,nearly,often,parallel,pedicel,peduncle,per,petiole,pubescent,rachi,radiating,raised,ridge,running,shallow,shrub,sparsely,stem,style,surface,unbranched,unifoliate,white,x	0.5,0.8-1.5,1-2,1-2-celled,1st,2nd,5-12,abaxially,abundant,adaxiall,adaxially,along,apically,appearance,appearing,axe,beyond,blade,cell,chartaceous,cm,connected,cordat,deflated,dehiscent,difficult,due,eaf,eed,evaluat,explosively,exserted,flat,frui,fruiting,geniculate,glabrescen,interpetalar,lengt,like,long,lower,lying,membranaceous,nflorescence,notch,oblong,older,orolla,oung,placenta,pointing,presence,pubescen,reaching,rhizomatous,rotate,ruit,small,stamen,stigma,structure,swollen,tal,tamen,taproot,tear,thick,tissue,triangular,tube,two-celled,unit,vary,wid,woody,wrinkled,ympodial	abaxial,adaxial,arrangement,branching,characteristic,colour,corolla,form,growth,height,history,inflorescence,length,life,midvein,na,ovary,plant,primary,pseudostipule,seed,shape,staman,tertiary,texture,unarmed,vein,venation
223	wfo-0001028465	success	159	105	73	86	32	0.459	0.75,1-2,1-4,1.2-2,10,11-23,2-6,2-9.3,2.4-2.8,3-5,3-8,4.5-5.5,5-7,8-10,acuminate,acute,apex,attenuate,base,branched,broadly,calyx,cell,cm,corolla,covering,cuneate,cyme,diameter,dichasial,dichasially,ebracteate,elliptical,filament,globose,green,green-white,hair-like,herbaceous,interpetalar,lateral,leaf,lobe,long,medium,mm,monochasial,mucilaginous,oblique,odd-pinnate,ovoid,pedicel,peduncle,perennial,petiole,petiolule,plant,puberulent,pubescent,purple,rachi,rotate,seed,sessile,spot,straight,strigose,style,testal,thick,throughout,wall,white	1.5-2.9,10-24,2,2-3,2-4,2.5-4,3-4,3-6-foliat,3.8-7,4-1.,4-8,7-15,9-19,abaxially,acumen,adaxially,apical,apically,articulate,connate,decurrent,dehiscent,digestion,diminishing,distal,dorsally,eaf,edge,eed,emoval,enzyme,equal,exceeding,first,flat,flower,folded,forked,generally,globo,gradually,half,honeycomb,interjected,introrse,leaflet,living,lon,lower,lunat,make,maturing,nflorescence,nther,often,orolla,pair,pattern,perfect,plan,poricidally,proximal,rarely,reveal,ruit,seudostipule,short,size,slit,specimen,stamen,stigma,tal,tem,terminal,tissu,toward,tuber-bearing,two,typically,unit,vary,wide,yellow,ympodial,Â¼	abaxial,adaxial,anther,arrangement,branching,characteristic,colour,form,fruit,growth,height,history,inflorescence,length,life,lunate,margin,midvein,na,ovary,primary,pseudostipule,shape,staman,stem,surface,tertiary,texture,tissue,unarmed,vein,venation
224	wfo-0001028468	success	255	190	159	96	31	0.624	-10,-3,.1-0.2,.1-0.4,.2,.2-0.4,.3-0.4,.5,.6-1,0.1,0.2-0.3,0.2-1.5,0.4-1,0.4-4,0.5-2,0.5-3,0.5-3.5,0.6-1.2,0.7-2.5,1,1.2-1.5,1.3-2,1/5-1/2,16,2.2-3,2.5-4,2.8-4.1,2/3-3/4,4-6,5-9,6-10,6-9,abaxially,acute,adaxially,anther,apex,appressed,armed,articulated,attenuate,axe,base,becoming,berry,beyond,blue,broad-based,broadly,brown,calyx,campanulate,chartaceous,clavate,cm,commonly,compressed,corolla,dark,densely,diameter,distally,distantly,dry,equal,exserted,extra-axillary,filament,flattened,flower,foveate,fruit,glabrescent,glabrous,gradually,gray,green,greenish,hair,increasing,lateral,laterally,length,light,lobe,lobed,lower,margin,midpoint,midvein,mixed,mm,moderately,multangulate,narrowly,oblique,oblong-conical,obtuse,orange,overlapping,pair,pale,pedicel,peduncle,petiole,porrect-stellate,prickle,proximal,pubescence,pubescent,purple,rachi,ray,recurved,reduced,relatively,reticulate,rhombic,sessile,shallowly,short,short-,short-stalked,shrub,side,similar,similarly,simple,somewhat,spaced,sparsely,specimen,stalk,stamen,stellate-pubescent,stelliform,stem,straight,style,subcuneate,subelliptic,subglobose,sublenticular,subreniform,subshrub,surface,terete,testa,thick,thick-stalked,thicknes,touching,triangular,unarmed,unbranched,upper,vein,x,yellowish	-1.3,-4,-5.5,-7,.1-0.3,.3,.5-1.5,.5-1.6,/10-1/5,/4-1/3,0.05,0.2-0.6,0.5-3.3,0.5-8,0.6-2,0.8-3.5,1.5-2.2,1.5-3.1,1.6,1/3-1/2,2,2-9,20,3-4,4-9,5-21,accrescent,acuminate,along,apart,ark,blade,bu,bud,c.,cauline,central,compresse,connivent,d.,decreasing,density,directed,distal,eaf,eed,ellipsoid,fruiting,geminat,half,inserted,interpetalar,introrsel,lamin,long,longer,m.,main,minutely,mostly,multangulat,nflorescence,oblong-lanceolate,occasionally,older,orangish,orolla,ovate,ovoid,papillo,per,perfect,pore,rotate-stellate,ruit,slightly,stigma,subacuminate,subcapitate,subchartaceous,subsessile,tal,tamen,time,tissue,toward,tube,unifoliate,unit,usually,vary,way,wide,yellow,ympodial,young	0-1.3,0.3-0.4,0.5-1.5,0.5-1.6,4-5.5,abaxial,adaxial,arrangement,branching,characteristic,colour,form,growth,height,history,inflorescence,lamina,leaf,life,na,ovary,perennial,plant,primary,pseudostipule,seed,shape,staman,tertiary,texture,venation
225	wfo-0001028470	success	185	131	97	88	34	0.524	0.25-0.75,0.9-2.2,0.9-2.3,1-12.3,1-2,1-3,12-44,2-10,2-7,2-8,2.1-3.9,3-10,3-5,4-7,6-33,anther,apart,apex,articulated,attenuate,axillary,base,berry,brownish,bud,cell,chartaceous,cm,condition,corolla,covering,dark,deep,diameter,distal,dot,drying,elliptic,filament,flower,forked,fresh,fruit,generally,glabrescent,glabrous,green,green-white,greenish,hair,hair-like,half,herb,high,lateral,leaf,light,lobe,long,make,medium,mm,mottled,mucilaginous,odd-pinnate,ovate,ovoid,pedicel,peduncle,petiole,petiolulate,plant,plurifoliate,pubescent,purple,ripe,rounded,seed,short,sometimes,spaced,style,subtending,terminal,testal,thick,throughout,tri-,unit,unwinged,usually,wall,wet,white,whitish,wide,wing	0-18,1.5-2.8,1.6-3.2,11.8-21,2-5,3.2-5.5,3.5-16,3.5-7,4-6,5-merou,5.5-11.6,abaxially,acumen,acute,adaxiall,adaxially,ag,alyx,apparently,asymmetric,axe,basiscopic,blade,capitat,clavate,connivent,decreasing,digestion,dorsally,eaf,edge,eed,end,enzyme,erec,exceeding,flat,folded,geminat,glabrou,hal,homostylous,honeycomb-shaped,interjected,lanceolate,leaflet,lengthening,living,lower,nflorescence,one,orbicular,orolla,pair,pentagonal,perfect,placed,pore,poricidal,removed,ruit,scarce,sessile,seudostipule,side,size,slit,specimen,stamen,stigma,stolo,straight,subequal,subglabrou,substellate,tall,tamen,tem,tip,tissue,toward,tube,tuber,typically,vary,x,yellow,ympodial	abaxial,adaxial,arrangement,branching,calyx,characteristic,colour,form,geminate,growth,height,history,inflorescence,length,life,margin,midvein,na,ovary,perennial,primary,pseudostipule,rachi,shape,staman,stem,subglabrous,surface,sympodial,tertiary,texture,unarmed,vein,venation
226	wfo-0001028476	success	246	97	76	170	21	0.309	-6,0.2-0.5,0.25-0.5,0.3-0.4,0.4-0.6,0.5,0.8-1.2,0.8-1.6,1,1-4,1.8-2.5,2.4-3,5-15,7-10,acuminate,acute,anther,apex,articulated,base,branched,bright,brown,calyx,cm,conical,corolla,dark,deeply,diameter,distal,elliptic,filament,fruit,globose,green,hair-like,half,herb,imparipinnate,inflorescence,interrupted,irregularly,lanceolate,leaf,less,lobe,lobed,margin,midvein,minutely,mm,narrowly,obovate,outgrowth,ovary,pale,pedicel,peduncle,perennial,petiole,primary,pseudostipule,puberulent,pubescent,purple,rachi,sparsely,stem,stripe,style,surface,tertiary,truncate,vein,yellow	-1,-16,-20,-8,.05-0.1,.5,0-,0-0.5,0.1-0.15,0.1-0.4,0.15-0.2,0.15-0.4,0.2-0.3,0.2-0.6,0.25-0.4,0.3-0.5,0.3-0.7,0.3-1.2,0.4-0.5,0.4-1.5,0.5-0.6,0.5-1.7,0.7-2.5,1-1.2,1-1.4,1-1.5,1-2,1-2-celled,1-6,1-celled,1.1-1.5,1.1-1.6,1.2-2.5,12-30,2,2-6,2-foliate,2-locular,3-12,3-7,3-foliate,3.5-13,4-celled,6-,8-30,abaxially,absent,abundant,acroscopically,age,almost,along,also,alternate,anthesi,ape,apical,appearance,appendage,axi,basal,basiscopically,becoming,bifurcate,bifurcation,bract,bracteate,capitate,cell,column,curved,decurrent,diamete,eaf,ebracteate,edicel,eed,elongate,entire,especially,exserted,first,flower,fortaleza,fruiting,give,glabrescent,glandular,gradually,gree,hal,head,hyaline,incurved,interjected,internode,largest,lateral,leaflet,like,lon,long,lower,main,maturity,minute,mixed,nflorescence,node,numerous,oblique,occasionally,often,pair,petiolule,population,present,prominent,pubescence,rarely,recurve,reflexed,regularly,rest,rounded,ruit,rÃ­o,scattered,secondary,sessile,set,short,silky,simple,sinus,slightly,smaller,sprawling,spreading,staminal,stellate,sterile,stiff,stigma,straight,subopposite,tall,tem,terminal,testa,thick,tip,toward,trichome,tube,ud,unicellular,uniformly,uniseriate,unit,unpaired,usually,wall,weak-walled,white,wid,wide,winged,woody,ympodial	0.05-0.1,abaxial,adaxial,arrangement,branching,characteristic,colour,form,growth,height,history,length,life,na,plant,seed,shape,staman,texture,unarmed,venation
227	wfo-0001028481	success	194	114	92	102	22	0.474	.5,0.5-1,0.6-1,1-2,1.5,1.8-2.5,1/2-2/3,3,3-4,3-4.5,3-6,8,abaxially,acuminate,acute,adaxially,almost,anther,anthesi,apex,apically,attenuate,base,branch,branched,brown,chartaceous,cm,colour,conical,corolla,cuneate,deltoid,dendritic,dendritic-pubescent,diameter,distributed,drying,elliptic,entire,equal,evenly,filament,flat,flower,glabrous,green,known,leaf,length,liana,like,lobe,long,long-acuminate,main,margin,midvein,mm,narrowly,oblique,occasional,orange-brown,pair,pedicel,peduncle,petiole,primary,pubescent,rachi,raised,reddish,shortly,shrub,slender,sparsely,stem,style,surface,terminal,tertiary,thickly,trichome,unarmed,unknown,vein,venation,visible,white,x,yellowish,young	.1,.3,0-2,0.1-0.2,0.15,0Â°,1-1.4,1-3,1-4,1.5-2,2-3,2.5-3,3-3.5,5.5-7.5,absent,age,along,alyx,apar,apparently,articulated,bark,canaliculate,clavate,clearly,close,cupular,deeply,delineated,density,different,dilated,discolorous,divided,domatia,dorsifixed,dry,eaf,eed,ellipsoi,erect,except,extending,extent,eye,faint,flaking,flexuous,free,increasing,know,lamina,lengthening,less,linear,lobed,lon,longer,longitudinally,lower,m.,mostly,naked,nflorescence,nther,oblong,often,orolla,ovate,perfec,plurifoliat,pore,poricidal,portion,protruding,ray,ribbed,ridged,ruit,scar,see,side,simple,sinus,size,small,smoot,smoothly,spreading,stigma,stump,tearing,tip,together,toward,tube,ud,uneven,unit,vary,wide,ympodial	abaxial,adaxial,arrangement,branching,calyx,characteristic,form,fruit,growth,height,history,inflorescence,life,na,ovary,plant,pseudostipule,seed,shape,staman,texture,ye
228	wfo-0001028482	success	224	143	121	103	22	0.54	.1,.5,0,0.5-1,0.5-5,1-1.5,1-11,1-2,1-4,1.1-5,1.2-1.6,1.5-2,10,2-3,3-4,4-5,7-14,acuminate,acute,adaxially,alternate,angled,anther,anthesi,apex,ascending,asymmetric,base,berry,bifurcate,branched,bright,broadly,brochiodromous,brownish,calyx,channeled,chartaceous,cm,corky,corolla,corrugated,creamy,curved,cymose,deltate,diameter,diffusely,difoliate,dry,drying,elliptic,emarginate,entire,filament,flattened-reniform,fleshy,fresh,fruit,glabrous,globose,golden,green,growth,hard,impressed,internodal,keeled,leaf-opposed,lobe,long,margin,material,maturity,midvein,minutely,mm,nodding,obovate,occasionally,olive,ovary,pair,pale,pedicel,peduncle,per,petiole,pitted,primary,pubescent,revolute,short,simple,slightly,somewhat,stem,stout,straight,style,subcoriaceous,subglobose,subpyramidal,surface,tan,transversely,tree,trichome,truncate,tuberculate,tuft,unifoliate,uniseriate,usually,vein,venation,white,x,yellow,yellowish,young	/3,0.2,0.5,0.7-1.1,00,1.5-3,2-celled,3-12,5-25,6-50,abaxially,age,apiculae,bark,basal,becoming,berr,bifid,bilobed,bud,campanulate,capitate,circinate,closely,constriction,coriaceous,cucullate,deciduous,deflexed,densely,discolorous,distally,distinct,eaf,eed,ellipsoid,embryo,enlarged,exerted,exfoliating,expanding,flower,free,fruiting,geminat,glabrou,glandular,grayish,halfway,heterostylous,incrassate,individual,investing,irregular,lengthening,less,lobed,lower,markedly,materia,midrib,minute,new,nflorescence,overlappin,papillat,pentamerous,pericarp,petal,pore,poricidal,portion,reddish,row,ruit,scandent,scar,shaped,shiny,size,slit,small,sometimes,soon,spaced,sparsely,stigma,tear-drop,tightly,tiny,tip,transparent,tub,tube,twice,two,ud,unit,vegetative,way,woody,ympodial,Âµm	abaxial,adaxial,arrangement,branching,characteristic,colour,form,height,history,inflorescence,leaf,length,life,na,perennial,plant,seed,shape,staman,tertiary,texture,unarmed
229	wfo-0001028487	invalid_json	195	139	102	93	37	0.523	0.3-0.7,0.9-3,1-2,1-3,1.1-1.5,1.4-1.7,10-4.3,10-41,15-28,2-4,2-6,2.5-3.5,3-10,3-5,4-7,5-6,abaxially,acumen,acuminate,acute,adaxially,anther,apart,apex,articulated,asymmetric,attenuate,axillary,base,basiscopic,berry,brownish,bud,cell,central,cm,condition,coriaceous,corolla,covering,dark,deep,diameter,distal,drying,elliptic,filament,flower,forked,fresh,fruit,generally,glabrescent,glabrous,green,green-white,greenish,hair,hair-like,half,herb,high,lateral,leaf,light,lobe,long,make,medium,mm,mucilaginous,odd-pinnate,ovate,ovoid,pedicel,peduncle,petiole,petiolulate,plant,purple,ripe,rounded,scabrous,scarce,seed,short,side,spaced,star,style,subtending,terminal,testal,thick,throughout,tissue,usually,wall,wet,white,whitish,wide	0-9,0.4-1.5,1-3.2,1.7-7,2-4.8,3-19,3-4,3.4-7.8,4.6-13.6,5-merou,7.8-16.4,adaxiall,ag,along,alyx,apparently,arranged,axe,bead,blade,capitat,clavate,connivent,considerably,decreasing,digestion,dorsally,eaf,edge,eed,enzyme,erec,exceeding,flat,folded,geminat,glabrou,hal,homostylous,honeycomb-shaped,interjected,lanceolate,leaflet,lengthening,like,living,lower,moniliform,multiple,narrow,necklace,nflorescence,orbicular,orolla,pair,pentagonal,perfect,plurifoliate,pore,poricidal,removed,ruit,second,sessile,seudostipule,size,slit,smaller,sometimes,specimen,stamen,stigma,stolon,straight,subequal,subglabrou,substellate,tall,tamen,tem,tip,toward,tri-,tube,tuber,typically,unit,unwinged,vary,wing,x,yellow,ympodial	'',[,``,abaxial,adaxial,arrangement,branching,calyx,characteristic,colour,form,growth,height,history,inflorescence,length,life,margin,midvein,na,ovary,primary,pseudostipule,rachi,shape,staman,stem,subglabrous,surface,tertiary,texture,unarmed,value,vein,venation,{,}
230	wfo-0001028489	success	224	169	141	83	28	0.629	-10,-2.5,-4,-5,0-10,0-15,0-20,0-3,0-50,0.3-0.5,0.3-1,0.3-1.2,0.5-1,0.5-1.1,0.5-1.5,0.6-1.2,1-3,1-4,1-7,1.5-4,1.8-2.2,1/3,2-3,2-4,2.1-3,3-7,3.5-6,4-13,5-25,acicular,acute,anther,apart,apex,apically,apparently,articulated,bark,base,berry,beyond,branched,calyx,cell,chartaceous,cm,concolorous,cordate,cream,cuneate,curved,dark,deltate,diameter,drying,dull,elliptic,erect,eye,filament,flattened-reniform,flower,fruit,glabrous,gray,green,hair,infructescence,lateral,leaf,length,lobe,lobed,long,margin,marking,maturity,mauve,membranous,midvein,minute,mm,moderately,naked,obtuse,occasionally,often,one,open,orange,orange-brown,orange-green,outline,ovate,pair,pale,pedicel,peduncle,per,perpendicular,petiole,prickle,prickly,primary,protruding,purple,raised,red-brown,rounded,shiny,shrub,side,simple,slender,smooth,sometimes,sparsely,spherical,stellate,stellate-pubescent,stem,straight,style,surface,tertiary,time,toward,trichome,truncate,unarmed,upper,vein,venation,visible,weakly,white,wide,yellow,yellow-green,yellow-orange,young	-0.6,-6,/4,0.1,0.1-0.6,0.2,0.2-,0.2-0.4,0.2-0.5,0.2-0.6,0.2-0.7,0.3-0.7,0.4-0.8,0.5-0.8,0.7-3,1-6,1.5-3,1.8-4,1.8-5.5,1/3-1/2,1/4-1/2,2-6,4-10,4-8,5-8,5-merous,7.5,abaxially,alyx,apar,ba,blade,broad-deltate,caudat,connivent,densely,difoliate,distance,eaf,eed,elongating,equal,extending,free,fruiting,geminat,herbaceous,less,lon,longer,lower,mature,midpoint,nflorescence,older,orolla,oung,pendulous,perfec,pericarp,poricidal,porrect,portion,ray,ruit,scar,sessile,spaced,spreading,stalk,subsessile,tamen,tapering,terete,tip,tube,unarme,unit,vary,way,white-gra,woody,ympodial	abaxial,adaxial,arrangement,branching,caudate,characteristic,colour,corolla,form,growth,height,history,inflorescence,life,na,ovary,perennial,plant,protrusion,pseudostipule,rachi,seed,shape,spacing,staman,texture,white-gray,width
231	wfo-0001028492	success	130	93	59	71	34	0.454	0.2-2,0.5-1,1-2.5,1-4,1.5-2.5,1.5-3,2-2.5,2-5,3,5-15,5-8,6-11,acute,angled,apex,articulated,axi,base,calyx,cm,colored,dark,deltate,diameter,elliptic-ovate,entire,forked,fruit,glabrous,globose,herb,leaving,lobe,margin,mm,obtuse,pedicel,peduncle,petiole,pubescent,punctate,purple,rachi,rarely,reticulate,ripe,rounded,sand-punctate,scar,shrub,simple,style,subcordate,unbranched,veiny,white,white-punctate,whitish,x	-5-foliat,1-5,1.5-6,1.75-3.5,15-20,2-3,2-4,2.5-9,3-6,4,5-25-flower,6-12,8-15,abaxially,absen,adaxially,aggregate,apart,apiculate,axe,blade,cell,chartaceous,ciliolate,color,connivent,containing,crystal,cylindrical,directed,distall,eaf,eed,except,glabrou,hair,irregularly,long,lower,narrowly,nflorescence,nther,orolla,pore,radiu,ruit,san,somewhat,spaced,sparse,splitting,stellate,stigma,stone,subcoriaceous,succulent,tal,tem,time,tip,triangular,triangular-ovate,truncat,tube,unevenly,unit,unknown,vary,wide,x1-3,ympodial	abaxial,adaxial,anther,arrangement,branching,characteristic,colour,corolla,filament,form,growth,height,history,inflorescence,leaf,length,life,midvein,na,ovary,perennial,plant,primary,pseudostipule,seed,shape,staman,stem,surface,tertiary,texture,unarmed,vein,venation
232	wfo-0001028501	success	195	136	104	91	32	0.533	0-3.2,0.3-0.7,0.8-1.6,0.8-1.7,1,1-2,1-8,1.8-10.7,13-41,2-4,2.8-4.9,3-10,3-5,4-8,8-10,8-34,abaxially,acumen,acuminate,acute,adaxially,anther,apex,articulated,axillary,base,berry,brownish,bud,cell,cm,condition,coriaceous,corolla,covering,dark,decurrent,diameter,distal,drying,elliptic,filament,flower,forked,fresh,fruit,generally,glabrescent,glabrous,green,green-white,greenish,hair,hair-like,half,herb,high,lateral,leaf,light,linear,lobe,long,make,medium,mm,mottled,mucilaginous,narrow,narrowly,odd-pinnate,onto,ovate,ovoid,pedicel,peduncle,petiole,plant,purple,pyriform,rachi,ripe,scarce,seed,sessile,short,simple,sometimes,spot,style,subtending,terminal,testal,thick,throughout,typically,unwinged,usually,wall,wet,white,whitish,wide,wing	0-3,0-4,0.3-3.3,0.6-5.8,1-3,2-5,2.8-18,3-7,3.1-10.4,3.1-12,4.8-18,5-merou,6.6-21.1,adaxiall,ag,along,alyx,apart,apparently,arranged,attenuate,axe,bead,blade,broadly,capitat,clavate,connivent,considerably,decreasing,digestion,dorsally,eaf,edge,eed,enzyme,erec,exceeding,flat,folded,geminat,glabrou,hal,homostylous,honeycomb-shaped,interjected,lanceolate,larger,leaflet,lengthening,like,living,lower,moniliform,multiple,necklace,nflorescence,orbicular,orolla,pair,perfect,plurifoliate,pore,poricidal,present,removed,rotate,ruit,seudostipule,size,slit,spaced,specimen,stamen,stigma,stolon,straight,subglabrou,tall,tamen,tem,tip,toward,tri-,tube,tuber,unit,vary,x,yellow,ympodial	2,abaxial,adaxial,arrangement,branching,calyx,characteristic,colour,form,growth,height,history,inflorescence,length,life,margin,mentioned,midvein,na,ovary,primary,pseudostipule,shape,staman,stem,subglabrous,surface,tertiary,texture,unarmed,vein,venation
233	wfo-0001028502	success	158	101	71	87	30	0.449	0.5-1,1-2,1.5-2,1.5-2.5,1.5-3,1.6-2.4,2-4,2-5,2-7,2-8,3.5-4,5-15,6-8,abaxial,abaxially,acute,adaxially,anther,apex,base,beige,branched,calyx,cm,corolla,deltate,densely,elliptic,fawn,filament,flattened-reniform,flower,glabrous,globose,impressed,incrassate,inflorescence,later,lateral,leaf,light,lobe,long,margin,minutely,mm,ovary,pair,pedicel,petiole,pitted,prominent,pubescent,reddish-brown,scattered,seed,shining,shrub,small,stem,style,surface,terminal,time,tree,tree-like,trichome,vein,warty,white,wide	.5,/2,1.5-6,2-2.5,3.5-15,5-6,?,age,along,anthesi,apar,ba,bark,blade,body,branch,brown,campanulate,cazalet,christmas-tree-like,clavate,closely,cone,congested,constricted,dark,dendritic,denser,dia,eaf,edicel,eed,erect,exserted,fide,flat,fleshy,free,fruiting,glabrat,heteromorphic,included,inflorescenc,lengthening,like,lobed,lon,long-styled,lower,main,matted,middle,narrower,nflorescence,obovate,often,older,packed,papillo,papillose,planar,plurifoliat,pore,poricidal,portion,rest,ruit,scar,short-styled,slit,spaced,stigma,structure,tall,thick,tip,tub,tube,ud,unclear,unevenly,way,widest,within,woody,ympodia,young	4-6,adaxial,arrangement,branching,characteristic,colour,diameter,form,fruit,green,growth,height,history,length,life,midvein,na,peduncle,perennial,plant,plurifoliate,primary,pseudostipule,rachi,shape,staman,tertiary,texture,unarmed,venation
234	wfo-0001028505	invalid_json	168	91	72	96	19	0.429	.01,.1,.3,.5,0.8-1,0.8-1.5,1,1-3,1.2-2.5,10-15,2,2.5-4.5,3.5-5,anther,apex,beneath,berry,broadly,calyx,characteristic,cm,conical,corolla,darker,deflexed,elliptic,erect,filament,fruiting,glabrous,globose,incrassate,lateral,leaf,lobed,main,margin,minor,minutely,mm,narrowly,ovary,ovate,ovoid-reniform,pedicel,petiole,pitted,plant,poricidal,prominent,pubescent,seed,shape,shrub,simple,size,somewhat,stem,stigma,straight,style,surface,tip,trichome,tube,unicellular,uniseriate,unit,vein,white,x,yellowish	/3,0.25-0.5,1/3,10-14-flowered,3-5,7-8,acuminate,acute,anthesi,aspect,ba,barely,bark,basal,base,black,blade,body,branch,bright,bud,deciduous,decurrent,delicate,deltoid,dia,differentiated,differing,difoliate,distance,distinct,dried,dry,drying,eaf,edicel,eed,expanded,exserted,exsertion,f,flattened,free,geminat,gently,greatly,green,grey,live,lobe,lon,long,lower,m.,major,materia,material,member,minute,nflorescence,obovoid,obvious,older,opposite,overlapping,pair,pale,papillose,pore,portion,proximal,purple,reflexed,rounded,ruit,scar,shaped,short,slightly,soon,specimen,strongly,tall,tan,tapering,tear-drop,touching,truncate,ud,usually,way,whit,widest,woody,ympodial,young	'',[,``,branching,colour,diameter,form,fruit,growth,height,inflorescence,length,pubescence,sympodial,texture,type,value,{,}
235	wfo-0001028524	success	236	156	130	106	26	0.551	0-150,0.3,0.3-0.8,0.5-3.5,0.6-1.4,1-5,1.1-1.2,1.2-1.3,1.5-1.6,1.8-2.5,11,2-3.8,2-6,2.8-3.5,3-15,3-4.3,3.4-3.6,4-6,4-8,4.3-6,7-10,7-11,8-13,abaxially,acuminate,acute,adaxially,anther,apart,apex,articulated,base,becoming,berry,branched,brown,calyx,chartaceous,closely,cm,conical,continued,corolla,cream,dark,deltoid,densely,diameter,dm,due,echinoid,entire,exserted,ferrugineous,filament,fleshy,flower,fruit,glabrescent,granular-tomentose,gray,green,greenish,growth,hair,honeycombed,lanceolate,large,lateral,leaf,length,lobe,long,margin,midvein,mixed,mm,multangulate,nearly,obtuse,ovate,pale,partly,pedicel,peduncle,persistent,petiole,plurifoliate,porrect-stellate,probably,pubescent,rachi,rather,relatively,reniform,reticulate-punctate,ripe,rounded,scabridulous,sessile,short,side,simple,slightly,somewhat,spaced,sparingly,stamen,stelliform,stem,stigma,style,subcoriaceous,suborbicular,sulcate,terete,testa,thick-stalked,thin,time,tomentose,translucent,tree,unarmed,vein,velutinous,x,yellow,yellowish,yellowish-green	-2.7,-3,.5-1,/10-3/10,1.5-3,1/3-2/3,10-20,2.5-3.4,2.5-3.8,2.5-4,3-10,3.3-4,6-7,6-9,9-14,accrescent,ag,along,anthesi,apical-lateral,apparently,ascending,axe,axillary,ba,bark,blade,blunt-tipped,branch,bud,capitat,dehiscing,distal,eaf,echinoi,eed,elliptic,extend,few-,few-rayed,first,free,fruiting,glabrescen,glabrous,half,high,indument,inserted,interpetalar,introrse,lacking,lanceolat,late,later,lobed,longitudinal,lower,m.,main,many-rayed,matted,midvei,nflorescence,oblong,obscured,often,older,orbicular,orolla,ovate-lanceolate,overlapping,perfect,pore,present,prominent,pseudo-terminal,ray,ruit,runk,short-stalked,slit,small,sparsely,stalked,stellate,stout-stalked,strongly,subglobose,suture,tamen,thick,thin-stalked,tissue,tomentu,touching,tube,unarme,unit,usually,vary,warty,way,wide,ympodial,young	abaxial,adaxial,arrangement,branching,characteristic,colour,form,height,history,inflorescence,life,na,ovary,perennial,plant,primary,pseud-terminal,pseudostipule,seed,shape,staman,surface,tertiary,texture,true,venation
236	wfo-0001028525	success	257	128	109	148	19	0.424	0.5-1.5,0.5-2.5,1-2,1.1-1.7,1.2-1.6,1.5-3,1/3-3/4,10,10-13,2,2-2.5,3,3-5,3-7,4,4-5,4-7,6,7-13,7.5,acuminate,acute,anther,anthesi,apex,apically,attenuate,base,berry,black,branch,branched,branching,brown,calyx,chartaceous,cm,conical,cordate,corolla,deltoid,dendritic,dendritic-pubescent,densely,developed,diameter,drying,elongated,entire,filament,fine,flat,flower,form,frequently,fruit,glabrous,green-brown,grey,lateral,leaf,liana,light,like,linear,lobe,long,lumpy,margin,mature,mauve,membranous,midvein,mm,orange-brown,ovate,pair,partly,pedicel,peduncle,pericarp,petiole,primary,pubescent,pyriform,rachi,red-brown,rounded,shrub,side,simple,slender,sometimes,spheroidal,stem,style,surface,terminal,tertiary,thin,trichome,truncate,unarmed,vein,venation,weakly,whitish,x,young	.25,.4,0.2-0.3,0.2-0.6,0.5,0Â°,1-1.5,1-2.5,1-4,1.5,1mm,2-3,2.5-5,4-15,7,accrescent,age,almost,along,alternate,alyx,apar,apart,apice,apparently,around,articulated,axil,bark,becoming,brachyblast,broadly,capitate,centre,clavate,clearly,clum,clustered,cup,curved,dark,deeply,delineated,density,detaching,developing,dilated,discolorous,divided,domatia-like,dorsal,dorsifixed,eaf,eed,ellipsoi,equal,erect,eye,fertilisation,fewer,flattened,flexible,flexuous,formed,forming,free,frui,fruiting,glabrescent,increasing,inside,known,lamina,laterally,leave,lengthening,less,lobed,longer,longitudinally,loop,loose,lower,m.,main,minute,much,multicellular-dendritic,naked,narrowly,nflorescence,nther,obconical,oblong,obscuring,often,one,orolla,outside,overlapping,ovoid,pendulous,perfec,plurifoliat,pore,poricidal,portion,prominent,protruding,puberulous,ray,ridged,ruit,scar,scattered,sessile,sinus,size,slightly,small,smaller,smoot,smooth,somewhat,soon,sparsely,spreading,stigma,stripe,structure,stump,tangling,tearing,terete,thick,tip,toward,tube,ud,uneven,unit,vary,visible,well-developed,white,wide,wider,ympodial	abaxial,adaxial,arrangement,characteristic,colour,growth,height,history,inflorescence,length,life,na,ovary,plant,seed,shape,staman,texture,true
237	wfo-0001028528	success	155	111	83	72	28	0.535	.5,0.9-1.2,1.1-1.2,2-4,2.5-3,3.5-4,4-5,6-7,8-9,?,abaxial,acuminate,acute,adaxial,along,anther,anthesi,apex,apical,attenuate,basal,base,berry,blackish,branch,branching,calyx,cm,corolla,decurrent,dendritic,densely,diameter,elliptic,erect,filament,flattened,fork,glabrous,globose,growth,immature,later,leaf,lobe,long,margin,midvein,minutely,mm,mucronate,narrowly,nodding,obovate,occasionally,outline,ovary,pair,pedicel,per,pericarp,petiole,pitted,pubescent,reddish-brown,revolute,round,shiny,shrub,somewhat,sparsely,stem,strongly,style,surface,tapering,terminal,thin,triangular,trichome,vein,violet,x	1-2,1.5,1.8-2,2-3,3.5-6,3/4,4-6,6-10,absent,adaxially,age,ba,bark,becoming,bi-lobed,conical,coriaceous,denser,dichasia,eaf,edicel,eed,ew,except,exserted,flower,free,fruiting,glabrat,glandular,impressed,inserted,leave,like,lobed,lower,m.,minute,nflorescence,older,papillo,petal,planar,plurifoliate,pore,poricidal,portion,prominent,pyramidal,ruit,scar,secondary,short,sleeve,slit-like,stamen,ste,stigma,tall,time,tip,tub,tube,ud,unit,way,white,wide,winged,woody,ympodial,young	alternate,arrangement,characteristic,colour,dichasial,form,fruit,glabrate,green,height,history,inflorescence,length,life,na,peduncle,perennial,plant,primary,pseudostipule,rachi,seed,shape,staman,tertiary,texture,unarmed,venation
238	wfo-0001028529	success	164	137	102	62	35	0.622	0.1,0.5,0.5-2,0.8-1.3,1,1-1.2,1-1.5,1.5,2.5-3,2/3,3-40-flowered,5-6,6-9,acuminate,age,anther,anthesi,apart,apex,apiculate,attenuate,bark,base,becoming,berry,bluish,brown,bud,calyx,capitate,cast,cm,corolla,dark,decurrent,deltoid,dia,erect,evenly,exfoliating,exserted,filament,fruiting,furcate,glabrous,globose,green,hyaline,internodal,lanceolate,leaf,less,lobe,lobed,long,metallic,minutely,mm,narrowly,nearly,oblanceolate,occasionally,older,opposite,ovary,ovoid-reniform,pair,paler,papillose,pedicel,petiole,pitted,planar,reflexed,scar,shape,short,shrub,simple,slender,slightly,small,smooth,somewhat,soon,spaced,stem,stigma,straight,style,subshrub,surface,tapering,tip,tube,vein,way,white,winged,woody,x,yellowish	.2,0.8-3,0.8-3.2,3-5,7-8,8-14,across,acute,beginning,beneath,close,cork,course,deflexe,distal,eaf,edicel,eed,ellipsoi,elliptic,flower,free,growing,heterostylous,hrub,immature,indistinct,inflorescenc,lateral,lenticellat,linear,lon,lower,main,major,middle,minor,minute,much,nflorescence,one,papillae,papillo,pore,poricidal,portion,present,prominent,range,river,ruit,scattered,shaped,size,species,tall,tear-drop,ud,umbonate,variable,widest,young	abaxial,adaxial,arrangement,branching,characteristic,colour,corky,deflexed,diameter,ellipsoid,form,fruit,growth,height,history,inflorescence,length,lenticellate,life,margin,midvein,na,peduncle,plant,position,primary,pseudostipule,rachi,seed,spacing,staman,tertiary,texture,unarmed,venation
239	wfo-0001028532	success	186	106	75	111	31	0.403	0.2-1,1-1.7,1-2,1-3,1.3-8.7,17-42,2-3,2-8,2.2-4.2,3-10,3-7,4-7,5-9,acuminate,acute,anther,apex,attenuate,base,berry,brownish,cell,chartaceous,cm,condition,corolla,covering,dark,deep,diameter,drying,filament,fresh,fruit,glabrous,globose,green,green-white,greenish,hair-like,herb,lanceolate,lateral,leaf,lobe,long,make,medium,mm,mottled,mucilaginous,odd-pinnate,ovate,ovate-lanceolate,ovoid,pedicel,peduncle,petiole,petiolulate,plant,purple,ripe,rounded,seed,sometimes,spot,style,testal,thick,throughout,unwinged,wall,wet,white,whitish	0-19,1-1.6,1-5,1.4-1.6,15-36,2-6,3-5,3.3-4.4,3.9-5,5-merou,5.5-15,6.5-9.2,7.5-15.2,abaxiall,abaxially,acumen,adaxially,ag,along,alyx,apart,apparently,arranged,articulated,asymmetric,axe,axillary,basiscopic,bead,blade,bud,capitat,clavate,connivent,decreasing,digestion,distal,dorsally,eaf,edge,eed,enzyme,erec,exceeding,flat,flower,folded,forked,geminat,generally,glabrou,half,homostylous,honeycomb-shaped,interjected,larger,leaflet,lengthening,like,linear,living,lower,middl,moniliform,multiple,necklace,nflorescence,orbicular,orolla,pair,pentagonal,perfect,plurifoliate,pore,poricidal,removed,rotate,ruit,second,sessile,seudostipule,side,size,slightly,slit,spaced,specimen,stamen,stigma,stolon,straight,subequal,subtending,symmetric,tall,tamen,tem,terminal,tip,tissue,toward,tri-,tube,tuber,typically,unit,usually,vary,x,yellow,ympodial	2,abaxial,adaxial,arrangement,branching,calyx,characteristic,colour,form,growth,height,history,inflorescence,length,life,margin,midvein,na,ovary,primary,pseudostipule,rachi,shape,staman,stem,surface,tertiary,texture,unarmed,vein,venation
240	wfo-0001028547	success	224	124	103	121	21	0.46	.2,.5,.7,.8,0-10,0-30,0-5,1-2,1-2.5,1.2-1.4,1.7-2,2-6,2.5-2.8,2.8-3.2,3-5,4-5,4-6,7-9,abaxial,absent,acute,adaxial,anther,apex,apically,apparently,articulated,base,berry,branched,branching,bright,calyx,cell,cm,cuneate,densely,diameter,dull,elongate,entire,erect,faint,filament,flattened-reniform,flower,fruit,glabrous,inflorescence,infructescence,lateral,leaf,length,lobe,lobed,long,long-acuminate,margin,maturity,mauve,midvein,mm,moderately,narrow-deltate,often,orange,orange-brown,outline,ovate,pair,pedicel,peduncle,per,petiole,pit,prickle,prickly,primary,purple,raised,red,reddish,scandent,shallowly,shrub,simple,small,smooth,somewhat,spherical,stellate-pubescent,stem,style,surface,terminal,tertiary,truncate,vein,venation,wide,yellow,yellow-green,young	-1/2,-13,-3,-6,/2,/5,0,0-1,0-15,0-2,0.05-0.15,0.1-0.2,0.15,0.2-0.35,0.3-0.4,0.5-,0.7-1,0.8-1,1-4,1-5,1.5-2.5,1/3,1/5-1/4,10-12,2-1.5,2-2.5,2-4,3.5-4.5,5-merous,6-8,7-10,abaxially,alyx,apar,apart,ape,appearing,bark,blade,bulbous,chartaceous,conical,connivent,cream,curved,dark,deltate,discolorous,distance,drying,eaf,eed,elongating,equal,extending,flattened,free,fruiting,gently,glabrescent,glabrou,gray-brow,green,lon,long-styled,longer,lower,marking,mature,midpoint,nflorescence,oblong,occasionally,older,one,open,orolla,oung,pale,pendulous,perfect,pericarp,plurifoliat,poricidal,porrect,portion,prickl,ray,reflexed,rounded,ruit,scar,sessile,short-styled,side,slender,sometimes,spaced,spreading,stalk,stalked,staminate,stellate,straight,subsessile,tamen,tapering,terete,thin-acuminat,time,tip,trichome,tube,unit,usually,vary,villous,way,woody,yellow-orange,ympodial	arrangement,characteristic,colour,corolla,form,gray-brown,growth,height,history,life,na,ovary,plant,pseudostipule,rachi,seed,shape,staman,texture,thin-acuminate,unarmed
241	wfo-0001028587	success	178	115	76	102	39	0.427	0.3-1,0.5,0.8-1.6,0.8-1.8,1-1.3,1-2,1-4,2-5,2.5,6-8,8-10,abruptly,acuminate,acute,anther,anthesi,apex,bark,base,berry,brown,ca,calyx,closely,cm,corolla,cracking,deflexed,densely,dia,erect,filament,fruit,fruiting,glabrous,globose,green,greenish-white,keeled,leaf,length,lobe,minutely,mm,narrowing,obovate,opposite,ovary,ovate,ovoid-reniform,pair,pedicel,peeling,per,petiole,pitted,puberulent,pubescent,pubesent,scar,seed,shrub,simple,slender,spaced,sparsely,stem,stiff,style,subumbellate,surface,tube,vein,white,woody,x	.4,.5,.75,0,0.3,0.5-1,0.7-1.2,0.8-2.9,1-1.5,1.3-5.1,1/4,2.1-6.9,3-8,6.5-17.7,8-10-flowered,accrescent,across,baseflower,becoming,chartaceou,coat,cup,degree,different,difoliate,distal,drying,eaf,edicel,eed,ellipsoid,flower,forming,free,geminat,geminate,impressed,lamina,lateral,layer,like,lobed,lon,long,long-styled,lower,main,major,middle,midrib,minor,minute,nearly,nflorescence,obe,obovoid,occasionally,often,older,open,outer,overlappin,paler,papillo,papillose,persistent,pore,poricidal,portion,pubescence,reflexed,ruit,scattered,short,slightly,slit-like,stigma,straight,straw-colored,tall,terminal,thickened,thin,tip,transversel,triangular,trichome,two,type,ud,umbonate,unicellular,uniseriate,unit,upon,upper,usually,variable,wide,widest,ympodial,young	0.4,0.75,1,10,3.5,6,abaxial,adaxial,arrangement,branching,characteristic,chartaceous,colour,deflexion,diameter,form,growth,height,history,inflorescence,life,margin,midvein,na,number,overlapping,peduncle,plant,primary,pseudostipule,rachi,shape,spacing,staman,tertiary,texture,transversely,unarmed,venation
242	wfo-0001028594	success	142	118	86	56	32	0.606	.5,0-100,0.8-1.8,1-1.2,1-1.3,1-2,1-3,1.5-9,12,12-14,2,3-4,3-6,6-7,acuminate,acute,anther,apex,axil,axillary,base,bearing,black,bottle-shaped,calyx,cm,conical,corolla,densely,diameter,drying,elliptic,especially,filament,flattened-reniform,flower,fruit,glabrous,globose,green,hair-like,herb,immature,inflorescence,leaf,length,like,lobe,long,margin,maturity,minutely,mm,obtuse,open,orange-brown,ovary,ovate,pair,pedicel,per,petiole,primary,projection,pubescent,purple,rectangular,reddish,regular,rest,scar,scattered,simple,slightly,smooth,somewhat,sparsely,spreading,style,surface,time,trichome,uniseriate,vein,violet,x	0.3-1.0,1-1.5,3-9,5-6,6-20,abaxially,adaxially,along,anthesi,becoming,berry,capitat,cell,climbing,denser,eaf,edicel,eed,ellipsoid,epidermal,exserted,floo,forest,free,fruiting,glabrat,inflorescenc,lax,lon,lower,minute,nflorescence,noddin,often,papillate,pendent,planar,portion,quit,reflexed,rounded,ruit,side,soft,stigma,strait,strongly,tem,tip,trailing,tub,tube,ud,unifoliat,unit,ympodial	abaxial,adaxial,arrangement,branching,characteristic,colour,form,glabrate,greyish,growth,hair,height,hirsute,history,life,midvein,na,peduncle,perennial,plant,pseudostipule,rachi,seed,shape,staman,stem,tertiary,texture,unarmed,unifoliate,venation,white
243	wfo-0001028660	success	204	131	101	103	30	0.495	0.5-2.8,0.5-5.5,0.8-1,0.9-2.5,1-2,1.5-2.8,1.5-4,2-11,2-9,3-30,3-7,3-9,4-6,5-8,7-10,abaxially,acute,adaxially,anther,apex,articulated,attenuate,axillary,base,berry,blue,broadly,brownish,bud,cell,chartaceous,ciliate,cm,condition,corolla,covering,decurrent,densely,diameter,distal,dot,drying,elliptic,entirely,filament,flower,forked,fresh,fruit,generally,glabrous,globose,green,green-white,greenish,hair,hair-like,half,herb,lateral,like,linear,lobe,long,make,margin,membranous,mm,mucilaginous,narrowly,oblique,obtuse,odd-pinnate,often,ovoid,pedicel,peduncle,petiole,plant,pubescent,purple,ripe,scabrous,scattered,seed,short,sparsely,stem,style,subtending,terminal,testal,thick,throughout,tinged,unwinged,usually,wall,wet,white,whitish	0-5,0.1-0.3,0.2-1.1,0.3-1.1,0.7-4.2,1-10,1.5-7.6,2-5,2-6,20,3-5,3.8-13,5-merou,6,absent,acumen,ag,along,alyx,apart,apparently,axe,blade,borne,capitat,clavate,connivent,decumbent,digestion,dorsally,eaf,edge,eed,end,enzyme,erec,especially,exceeding,except,flat,folded,geminat,glabrou,greatly,homostylous,honeycomb-shaped,interjected,lanceolate,leaflet,lengthening,less,living,lower,middl,midrib,minutely,nflorescence,orbicular,orolla,ovate,pair,pentagonal,perfect,petiolulate,petiolule,plurifoliate,pore,poricidal,proximal,puberulent,rarely,reduced,removed,rotate,ruit,sessile,seudostipule,singly,size,slit,spaced,specimen,stamen,ste,stigma,stolo,straight,subequal,substellate,sunny,tall,tamen,tem,tip,tri-,tube,tuber,typically,unit,vary,x,yellow,ympodial	2,abaxial,adaxial,arrangement,branching,calyx,characteristic,colour,form,growth,height,history,inflorescence,leaf,length,life,middle,midvein,na,ovary,primary,pseudostipule,shape,staman,surface,tertiary,texture,unarmed,vein,venation
244	wfo-0001028667	success	129	117	83	46	34	0.643	-2.6,.5,0.4-0.7,0.7-4,1-1.5,1-6,1.3-2,3,5-20,8-10,acute,aid,apex,appearing,around,articulated,axillary,base,berry,branched,calyx,cell,climbing,clustered,cm,completely,corolla,creamy,curling,deciduous,diameter,dry,elliptic,entire,exfoliating,flattened,flower,glabrous,growth,inflorescence,leaf,like,lobe,long,margin,minutely,mm,narrowly,outer,pale,pedicel,peduncle,per,petiole,pitted,primary,reniform,revolute,shiny,shoot,short,simple,sleeve,slender,small,soon,stem,straw-colored,strongly,support,surface,terminal,tip,triangular,twice,twining,vein,vine,white,woody,wrinkling,x,yellow	1-2-1.5,1-4.5,3-11,5,5-merou,alyx,anthesi,apar,ark,branch,climbin,conical,coriaceous,discolorous,eaf,eed,ellipsoid,exfoliatin,exserted,fide,fragrant,fruiting,irregularly,lower,mentz,midrib,new,nflorescence,occasionally,older,orolla,other,papilla,papillat,pendan,perfect,plurifoliat,scar,slightly,spaced,tem,tube,ud,unit,visible,ympodial	abaxial,adaxial,anther,arrangement,branching,characteristic,colour,filament,form,fruit,green,greyish,hair,height,hirsute,history,length,life,midvein,na,ovary,papillate,perennial,plant,pseudostipule,rachi,seed,shape,staman,style,tertiary,texture,unarmed,venation
245	wfo-0001028688	success	137	85	52	85	33	0.38	.5,0.4-1,0.5,0.5-1,0.9-1,1-1.5,1-5,1.1-1.2,2-3,5-6,acuminate,acute,anther,anthesi,apex,base,calyx,clavate,cm,corolla,deflexed,deltoid,dia,filament,furcate,glabrous,golden,lanceolate,leaf,lobe,mm,near,occasionally,opposite,ovary,overtopping,pedicel,petiole,pilose,pubescent,shoot,shrub,slender,sparsely,stem,straight,style,tapering,tip,tube,vein,white	0.5-0.75,0.5-1.5,1-1.8,1-3,1.4-2.8,2.2-4.8,5-11,across,along,apar,area,bark,beneath,bi-cellular,branch,curl-tipped,deciduous,decreasing,densely,densest,differing,difoliate,eaf,edicel,eed,elliptic,exfoliatin,exserted,free,geminat,globose,interpetalar,irregularly,know,known,like,lobed,lon,long,lower,major,markedly,membraneous,middle,minor,minutely,nearly,nflorescence,often,older,paler,papillose,planar,pore,poricidal,portion,proximal,reddish-brown,ruit,scar,shaped,shiny,sinus,size,slightly,soon,spaced,stigma,styl,tall,tear-drop,terminal,thickened,thin,trichome,tub,ud,uniseriate,unit,usually,wide,widest,x,ympodial,young	abaxial,adaxial,arrangement,branching,characteristic,colour,diameter,form,fruit,growth,height,history,inflorescence,length,life,margin,midvein,na,peduncle,perennial,plant,primary,pseudostipule,rachi,seed,shape,staman,surface,sympodial,tertiary,texture,unarmed,venation
246	wfo-0001028698	success	166	115	83	83	32	0.5	0.3-0.75,1-2,1-4,1-9.8,1.9-4,13-25,2-10,3-5,3.5,5-15,5-6,5-8,6,8-10,acuminate,acute,apex,articulate,base,branched,broadly,calyx,cell,cm,conical,corolla,covering,cyme,dark,diameter,dichasial,dichasially,distal,dot,ebracteate,ellipsoid,elliptical,filament,green,green-white,hair-like,herbaceous,lateral,leaf,light,lobe,long,long-attenuate,make,medium,minute,mm,monochasial,mucilaginous,oblique,odd-pinnate,often,ovate,ovoid,pedicel,peduncle,perennial,petiole,petiolule,plant,proximal,puberulent,pubescent,rachi,raised,seed,sessile,smooth,straight,strigose,style,testal,thick,throughout,violet,wall,white,Â¼	0-1.,1.8-5,2-3,2-4,3-17,3-6-foliat,4-14,6-13,6-27,9-35,abaxiall,abaxially,acumen,adaxially,apical,apically,commonly,connate,cuneate,darker,decurrent,dehiscent,digestion,diminishing,dorsally,eaf,edge,eed,emoval,enzyme,equal,exceeding,first,flat,flower,folded,forked,generally,globo,gradually,half,honeycomb,interjected,introrse,leaflet,living,lon,lower,lunat,maturing,nflorescence,nther,orolla,pair,pattern,pentagonal,perfect,plan,poricidally,rarely,reveal,rotate,ruit,seudostipule,short,size,slit,specimen,stamen,stigma,tal,tem,terminal,toward,tuber-bearing,two,typically,unit,usually,vary,wide,yellow,ympodial	abaxial,adaxial,anther,arrangement,branching,characteristic,colour,form,fruit,growth,height,history,inflorescence,length,life,lunate,margin,midvein,na,ovary,primary,pseudostipule,shape,staman,stem,surface,tertiary,texture,unarmed,vein,venation,wet
247	wfo-0001028716	success	145	109	74	71	35	0.51	.2,.5,0.5,0.6-1.9,0.75,1-2,10-40-flowered,11-16.4,2.5-8,3.6-8.8,7-8,8-9,9-10,acuminate,anther,apart,apex,asymmetric,base,beginning,branched,brown,calyx,cm,corolla,cuneate,dark,decurrent,dia,ellipsoid,elliptic,evenly,filament,filiform,fruit,glabrous,glandular,hirsute,leaf,less,lobe,long,markedly,minutely,mm,much,orbicular,ovary,ovate,pair,papillose,pedicel,petiole,pore,puberulent,pubescent,scar,shape,shaped,shrub,simple,slightly,spaced,sparsely,stem,straight,style,tear-drop,triangular,truncate,vein,white,widening,x	1.9-5.5,2-4,2.2-7.9,5-6,across,anisophyllou,anthesi,appearing,ba,bark,becoming,beneath,bi-cellular,deflexed,differing,difoliate,eaf,edicel,eed,except,fertilization,fifth,free,geminate,inflorescenc,intermediate,know,known,lateral,lengthening,lenticellat,like,lobed,lon,long-triangular,lower,main,major,middle,minor,nearly,nflorescence,node,often,older,one,opposite,pointed,poricidal,portion,prominent,proximal,raised,reflexed,remaining,rounded,ruit,size,stigm,strongly,tall,tip,trichome,tube,two,ud,uniseriate,unit,widest,ympodial,young	abaxial,adaxial,arrangement,asymmetry,branching,bud,characteristic,colour,diameter,form,growth,height,history,inflorescence,length,life,margin,midvein,na,peduncle,plant,primary,pseudostipule,rachi,seed,spacing,staman,stigma,surface,tertiary,texture,unarmed,variation,venation,width
248	wfo-0001028723	success	211	127	106	105	21	0.502	-1.5,0-0.5,0.8-1,0.8-2,1,1-1.8,1-2.2,1-2.5,1/5-1/3,10-16,2-2.7,2-4,3.5-4,4-5,5,5-6,abaxial,abaxially,acute,adaxially,almost,anther,anthesi,apex,apically,articulated,base,brachyblast,branch,branching,brown,calyx,clustered,cm,concolorous,conical,corolla,curved,dark,decurrent,deltoid,dendritic,diameter,dilated,drying,elliptic,entire,except,faint,filament,fine,flat,flexuous,flower,glabrous,gradual,green,leaf,length,less,liana,lobe,long,long-attenuate,margin,membranous,midvein,mm,mostly,obovate,obtuse,occasional,orange-brown,pair,pedicel,peduncle,petiole,primary,pubescent,rachi,raised,ridged,short,shrub,side,simple,slender,sparsely,stem,style,surface,surrounding,terminal,tertiary,tip,transition,trichome,tuft,unarmed,unevenly,vein,venation,white,wrinkled,x,youngest	.3,.5,0.2,0Â°,1-1.5,1/3-1/2,10-15,2-2.5,2.5,3-4,4,5-7,age,alternate,alyx,another,apar,apice,apparently,bark,becoming,branched,broadly,capitate,clearly,common,delineated,densely,density,developed,divided,domatia,dorsifixed,eaf,eed,ellipsoi,equal,ey,formed,free,frequent,increasing,inner,junction,know,known,lengthening,like,lobed,longitudinally,lower,m.,main,middle,minutely,much,multiply,naked,narrowly,nflorescence,nther,obconical,oblong,one,orolla,outer,ovate,overlapping,pale,papillo,perfec,plurifoliat,poorly,pore,poricidal,portion,prominent,protruding,ray,region,regular,ruit,scar,separated,sinus,small,smaller,smooth,spreading,stigma,stump,tearing,tissu,toward,tube,ud,uneven,unit,vary,visible,wide,widely,yellow,ympodial,young	adaxial,arrangement,characteristic,colour,form,fruit,growth,height,history,inflorescence,life,na,ovary,perennial,plant,seed,shape,staman,texture,tissue,ye
249	wfo-0001028736	success	180	143	115	65	28	0.639	0.2-0.4,0.5,0.5-1,0.5-1.5,1,1-1.5,1-2,1-3,1.5,10-15,2-5,2-7,3-5,3-6,3.5-5,4-12,4-6,40-70,5-10,5-15,abaxially,absent,acute,adaxially,anther,apex,apparently,armed,base,berry,brown,calyx,chartaceous,cm,contiguous,created,cylindrical,dark,decurrent,densely,diameter,discolorous,either,extra-axillary,filament,filiform,flattened,flower,fruit,geminate,glabrous,glandular,globose,green,hair,immature,leaf,length,light,like,lobe,long,many,mature,midvein,mm,moderately,mottled,multicellular,narrowly,nearly,netlike,obtuse,occasionally,onto,orange,pedicel,peduncle,per,perfect,petiole,pit,porrect-stellate,prickle,pubescent,rachi,raised,recurved,red,reniform,rhombic,ridge,roselike,shrub,side,slightly,small,spaced,sparsely,stalk,stellate,stem,style,surface,thin-skinned,triangular,unarmed,unbranched,uniseriate,unlobed,vein,white,x,yellow,yellow-white	0.5-1mm,0.5-2,1.5-3,1/6,2-4,3-8,4-9,5-merou,6-13x3-8,6-8,accrescent,adaxiall,alyx,apar,apical,attenuate,axe,beyond,blade,connivent,cordate,cut,difoliate,directed,eaf,eed,exserted,frui,fruiting,glabrou,gree,introsel,less,lobed,lower,m.,major,midpoint,midrib,multiseriate,nflorescence,occasional,orolla,pair,pore,purple,ray,ruit,scanden,simple,sinus,stamen,ste,stigma,tamen,tapering,tem,tube,unequa,unicellular,unit,vary,way,wide,ympodial	abaxial,adaxial,apart,arrangement,branching,characteristic,colour,corolla,form,growth,height,history,inflorescence,life,margin,na,ovary,perennial,plant,primary,pseudostipule,scandent,seed,shape,staman,tertiary,texture,venation
250	wfo-0001028737	invalid_json	151	108	69	82	39	0.457	0.2-0.5,1,1-2.5,1-4,1-6,1.5-3.5,10,12-14,16-30,2-5,2.8-3.5,6,acumen,acuminate,acute,apex,apiculate,articulate,base,branched,calyx,caudate,cell,cm,corolla,covering,cyme,diameter,dichasial,dichasially,distal,ebracteate,elliptic-lanceolate,filament,glabrescent,glandular,globose,green,green-white,hair-like,herbaceous,lanceolate,lateral,leaf,lobe,long,mm,monochasial,mucilaginous,oblique,oblong,odd-pinnate,ovoid,pedicel,peduncle,perennial,petiole,plant,proximal,rachi,seed,stigma,straight,style,testal,thick,throughout,wall,Â¼	0.7-2,2-3,3-4,3-5,3-6-foliat,4-10,4-6.5,4-9,5-6,7-15,abaxially,absen,adaxially,apical,apically,attenuate,connate,decurrent,dehiscent,digestion,diminishing,dorsally,eaf,edge,eed,emoval,enzyme,exceeding,flat,flower,folded,forked,generally,globo,gradually,half,honeycomb,interjected,introrse,larger,leaflet,living,lon,lower,make,maturing,nflorescence,nther,often,orolla,pair,pattern,perfect,pinnatifi,plan,poricidally,reveal,ruit,second,sessile,seudostipule,short,size,slit,specimen,stamen,stellate,strongly,tal,tem,terminal,throughou,toward,tuber-bearing,typically,unit,vary,whit,wide,without,yellow,ympodial	'',[,``,abaxial,adaxial,anther,arrangement,branching,characteristic,colour,form,fruit,growth,height,history,inflorescence,length,life,margin,midvein,na,ovary,pinnatifid,primary,pseudostipule,shape,staman,stem,surface,tertiary,texture,unarmed,value,vein,venation,wet,white,{,}
251	wfo-0001028777	success	205	126	103	102	23	0.502	-4,.5,.9,0-2,0-30,0.4-0.8,0.5-1.3,0.6-1,0.7-1.2,1-2,1-2.5,1.5-3,1.5-4,1.8-2.5,2-,2.5,2.5-5,3,4.5-8,acute,anther,apex,apically,articulated,attenuate,base,berry,branched,calyx,chartaceous,cm,concolorous,curved,dark,deltate,diameter,discolorous,drying,entire,erect,faint,filament,flattened-reniform,fruit,glabrescent,glabrous,green,green-brown,inflorescence,infructescence,leaf,length,lobe,long,margin,marking,maturity,mauve,minute,mm,moderately,obovate,orange,orange-brown,ovate,pair,pale,pedicel,peduncle,per,petiole,primary,red-brown,retuse,rounded,shoot,short,shrub,simple,small,sometimes,sparsely,spherical,stellate-pubescent,stem,stout,style,surface,terete,terminal,tertiary,tree,trichome,truncate,unarmed,vein,venation,visible,white,whole,wide,yellow-green,young	-10,-12,-2.5,-3,.8,0.1-0.2,0.1-0.3,0.2,0.7-1.3,0.8-1,0.8-2.2,1,1-3,1.5,1/4,1/4-1/2,2.5-3,3.5-5,3/4-4/5,4-5-merous,6-10,7-11,8,8-15,abaxially,acuminat,alyx,ame,apar,ape,bark,blade,briefly,c.,connivent,deciduou,eaf,eed,elongating,equal,flower,free,fruiting,glabrescen,lengt,less,lobed,long-styled,longer,lower,mature,midpoint,multangulate,narrow-deltate,nflorescence,occasionally,older,one,open,orolla,oung,perfect,pericarp,plurifoliat,poricidal,porrect,portion,present,ray,recurved,reflexe,reflexed,ruit,scar,sessile,short-styled,shorte,shorter,smooth,somewhat,soon,spaced,spreading,stalk,stalked,staminate,stellate,strongly,tamen,tapering,time,tip,tube,unarme,unit,usually,variously,vary,way,wider,woody,ympodial	abaxial,acuminate,adaxial,arrangement,branching,characteristic,colour,corolla,form,growth,height,history,life,midvein,na,ovary,perennial,plant,seed,shape,staman,texture,ye
252	wfo-0001028791	success	257	109	88	169	21	0.342	0.05-0.2,0.3-0.4,0.3-0.6,0.4-0.65,0.45-0.55,0.8-1.3,1-1.5,1.8-3.3,10,2-7,2-locular,2.8-3.0,5-15,50-80,absent,acuminate,acute,anther,apex,articulated,articulation,base,branched,broadly,brown,calyx,cm,conical,corolla,dark,darker,deciduous,deltate,densely,developed,diameter,dichotomously,elliptic,entire,filament,fruit,glabrous,globose,green,hair-like,imparipinnate,interrupted,leaf,liana,lobe,long,margin,middle,midvein,mm,near,oblique,obovate,occasionally,often,outgrowth,ovary,pale,paler,pedicel,peduncle,petiole,plant,poorly,primary,pseudostipule,pubescent,rachi,seed,slightly,somewhat,sparsely,stem,style,surface,tertiary,truncate,usually,vein,vine,white,woody,yellow	+,-0.6,-1.5,-9,.5,0-6,0.05,0.2-0.3,0.2-0.4,0.2-0.8,0.25-0.3,0.3-0.5,0.3-0.8,0.4-0.5,0.4-0.6,0.4-1.1,0.5,0.6-0.8,0.6-0.9,0.7-1.5,0.8-1,1-2,1-2-celled,1-3,1-3-celled,1-celled,1.5-,1.5-2,1.6-4.5,1.7-2.1,100,2-3,2-3.5,2-7-celled,2.5-4.5,20-to,3-,3-4,4-11.5,4-15,4-5+,4-celled,5-,5-10,5-22,5-plurifoliate,8-10-celled,9-30,9-35,abaxially,absen,abundant,adaxially,addition,ag,along,anthesi,apical,appearance,appendage,basal,basiscopically,beneath,berr,border,breaking,bullate,capitate,cell,clambering,colo.,column,consistently,densest,eaf,ebracteate,edicel,eed,eglandular,elongating,enlarged,even,exserted,extended,flower,free,fruiting,give,glabrescent,glandular,gree,grow,growing,half,halfway,head,interjected,internode,lamina,large,lateral,leaflet,leaving,less,like,lon,lower,many,minutely,mixture,much,multicellular,nflorescence,pair,papillate,per,petiolule,present,protuberance,pubescence,reflexed,rest,rough,round,ruit,sandpapery,scandent,secondary,sessile,short,shorter,silky,simple,single,small,smaller,sometimes,sparse,spreading,stamen,staminal,stellate,sterile,stiff,stigma,straight,tal,tem,terminal,testa,thick,thickened,time,tip,touch,transparent,trichome,tube,ud,unicellular,uniseriate,unit,upper,vegetation,wall,wide,winged,ympodial,â1-2-celled	abaxial,adaxial,arrangement,branching,characteristic,color,colour,form,growth,height,history,inflorescence,length,life,na,perennial,shape,staman,texture,unarmed,venation
253	wfo-0001028798	success	214	129	106	108	23	0.495	0-1,0.2-0.4,0.5-2,0.9-1.2,1-4.5,1-6,1.1-2,1.5-1.8,10,15-19,2-3,2.4-4.4,2.6-4,2/3,3-5,3.3-5.6,5-8,5.25-7.5,7-8,8.5-13,abaxially,acuminate,acute,anther,apart,apex,articulated,attenuate,base,becoming,berry,branched,calyx,chartaceous,cm,conical,continued,corolla,cylindrical,decurrent,densely,diameter,dm,due,entire,exserted,filament,fleshy,flower,fruit,granular,granular-tomentose,green,greenish,growth,hair,lanceolate,lateral,leaf,length,lobe,long,margin,midvein,mixed,mm,multangulate,nearly,oblanceolate,obtuse,pale,pedicel,peduncle,petiole,plurifoliate,porrect-stellate,probably,pseudo-terminal,rachi,rather,ripe,rough,rough-granular,semi-ovate,sessile,short,shrub,side,simple,spaced,sparingly,stalked,stamen,stellate-pubescent,stem,style,subcoriaceous,subglobose,time,tomentose,unarmed,vein,way,x,yellow,yellowish	.5-5,0-60,1-3,1/2-2/3,1/20,2-3.75,2-6,2-7,2.5-3.5,3-4,3.8-4.2,4-5.4,6-10,6-8,8-18,accrescent,adaxially,ag,anthesi,apical-lateral,apparently,axe,axillary,ba,blade,blunt-tipped,boat-shaped,branch,bud,capitat,curved,dehiscing,distal,downward,eaf,echinoi,echinoid,eed,extend,free,fruiting,glabrous,hal,high,included,inserted,introrse,irregularly,lacking,large,less,lined,lobed,longitudinal,lower,m.,main,many,minutely,multangulat,nflorescence,oblanceolat,oblong,obovate,obscured,often,orbicular,orolla,oung,ovate-lanceolate,overlapping,perfect,persistent,persistently,pore,present,prominent,pubescent,quite,ray,rotate-stellate,ruit,short-stalked,slightly,slit,small,somewhat,splitting,stigma,strongly,subcampanulate,sulcate,suture,tamen,thick,tip,tomentu,tomentum,toward,translucent,tube,unarme,unit,unknow,vary,velutinous,wide,ympodial	abaxial,adaxial,arrangement,branching,characteristic,colour,form,height,history,inflorescence,life,na,ovary,perennial,plant,primary,seed,shape,staman,surface,texture,true,unknown
254	wfo-0001028815	success	196	140	109	87	31	0.556	0.4-0.8,0.5-1,1-10,1-2,1-4,1-5,10-15,2-4,2-9,22-35,3-4,3-5,3-7,4-10,5-6,5-7,6-8,7-16,abaxially,acute,adaxially,anther,apart,apex,apparently,articulation,auriculate,base,berry,broadly,brownish,cell,cm,condition,corolla,covering,cuneate,dark,decreasing,diameter,distal,distinct,drying,elliptic,elliptic-lanceolate,exceeding,filament,flower,forked,fresh,fruit,glabrous,globose,green,greenish,hair,hair-like,half,herb,indistinct,interjected,lateral,leaflet,like,lilac-purple,lobe,long,margin,medium,mm,obtuse,odd-pinnate,ovate,ovoid,pair,papillose,pedicel,peduncle,perfect,petiole,petiolulate,plant,pubescent,purple,rachi,red-purple,ripe,rounded,rugose,seed,short,size,slightly,spaced,sparsely,splotched,stamen,stem,stigma,style,terminal,testal,thick,tinged,triangular-lanceolate,usually,wall,whitish,x	1-3.5,14-28,2-4.5,2.5-6.5,5-merou,6-10,acumen,ag,along,alyx,articulated,axe,axillary,basiscopic,blade,bud,capitat,chartaceous,ciliate,connivent,decurrent,developing,digestion,dorsally,eaf,edge,eed,enzyme,especially,flat,folded,geminat,generally,glabrou,green-white,hal,high,homostylous,honeycomb-shaped,lanceolate,lengthening,living,lower,make,membranous,midrib,minutely,mucilaginous,narrowly,nflorescence,onto,orolla,plurifoliate,pointed,pore,poricidal,puberulent,purpl,removed,rotate,ruit,semi-erec,semi-rosette,sessile,seudostipule,side,slit,specimen,ste,straight,subtending,tall,tamen,tem,terminated,throughout,tip,tri-,tube,unit,unwinged,vary,wet,winged,yellow,ympodial,young	2,abaxial,adaxial,arrangement,branching,calyx,capitate,characteristic,colour,form,growth,height,history,inflorescence,leaf,length,life,midvein,na,ovary,perennial,primary,pseudostipule,shape,staman,surface,tertiary,texture,unarmed,vein,venation
255	wfo-0001028876	success	127	87	55	72	32	0.433	.5,0.4-1,1.5-2,2-2.3,3-5,4-5,4-8,5-6,abaxial,acute,anther,apex,attenuate,base,calyx,cm,corolla,dendritic,densely,elliptic,filament,flower,glabrous,golden,internodal,lateral,leaf,lobe,long,long-triangular,main,mm,occasionally,opposite,ovary,pair,pedicel,petiole,pubescent,reddish,rounded,shining,shrub,simple,small,sparsely,stem,style,subshrub,surface,trichome,uniseriate,vein,white,x	/4,0.5-2,1-2,1.5-3,3-8,abaxially,adaxially,along,anthesi,bark,branched,brown,capitate,closely,conical,dark,dia,difoliate,drying,eaf,edicel,eed,ellipsoid,free,geminat,glabrat,hroughout,included,inflorescenc,know,known,lamina,leave,like,lobed,lower,middle,midrib,minutely,nflorescence,nodding,older,overlappin,papillae,papillo,papillose,planar,pore,poricidal,portion,rest,ruti,sagittate,scar,shaped,slender,spaced,speciman,stigma,straight,tall,tear-drop,tip,tub,tube,type,ud,unit,way,widest,ympodial,young	adaxial,alternate,arrangement,branching,characteristic,colour,diameter,form,fruit,geminate,growth,height,history,inflorescence,length,life,margin,midvein,na,peduncle,perennial,plant,primary,pseudostipule,rachi,seed,shape,staman,tertiary,texture,unarmed,venation
256	wfo-0001028883	success	207	136	101	106	35	0.488	2,4,5,50,6,abaxially,absent,acute,adaxially,anther,apex,arched,articulated,ascending,attenuate,base,becoming,berry,blade,calyx,capitate,chartaceous,ciliate,cm,concolorous,coriaceous,cylindrical,cyme,dark,decurrent,deltate,densely,diameter,drying,dull,elliptic,entire,erect,filament,flattened,flower,fruit,glabrescent,glabrous,glandular,globose,green,greenish,growth,herb,hilum,hollow,impressed,lateral,leaf,length,lobe,long,margin,mm,moderately,narrowly,normally,onto,pedicel,peduncle,per,petiole,primarily,prominent,pubescence,pubescent,rachi,rarely,region,reniform,ripe,seed,sessile,shrub,similar,simple,slightly,small,spaced,sparsely,stem,straight,style,subopposite,subsessile,surface,swollen,trichome,unbranched,undulate,vein,venation,white,woody,Ã	0.3â0.6,0.4â1.2,0.5â2,0.6,1,1.5â7,1â2,1â6,2â3,2â5,3â5,4â6,5-merou,6â10,6â12,accrescent,acuminate,adaxiall,almost,along,alyx,antrorse,antrorsely,apar,ark,axi,branch,brochidodromous,brow,capitat,cell,circular,common,completely,connivent,curved,differing,directed,eaf,eed,elliptic-ovate,emarginate,equal,exfoliating,eye,frui,geminate,geniculat,glabrou,head,introrsely,less,light,like,longitudinal,lower,lying,membranaceous,midrib,minor,multicellular,naked,new,nflorescence,notably,oblong,obtuse,often,older,opening,orolla,ovate-lanceolate,parallel,pendan,perfect,plurifoliate,pore,poricidal,present,rounded,ruit,secondary,shap,shiny,single,single-celled,size,slit,sometimes,sparse,spreading,stalk,stellate,stigma,subapical,tall,tamen,tem,uniseriate,unit,vary,visible,whitish,wide,yellow,ympodial	1-2,1-6,2-3,2-5,3-5,4-6,6-10,6-12,abaxial,adaxial,apart,arrangement,branching,brown,characteristic,colour,corolla,form,height,history,inflorescence,life,midvein,na,ovary,pendant,perennial,plant,primary,pseudostipule,shape,staman,tertiary,texture,unarmed
257	wfo-0001028885	success	214	101	79	135	22	0.369	.5,0.7-2,1-1.2,1-2,1.5-3.5,2-2.5,2.3-2.5,2.5-3.5,3-5,3.5-4.5,7-8,7-9,9-11,?,abaxial,acute,adaxial,adaxially,anther,apex,attenuate,base,berry,black,branched,broadly,brown,calyx,cm,corolla,dark,deltate,densely,diameter,elliptic,entire,erect,filament,glabrous,globose,growth,height,immature,inflorescence,lanceolate,lateral,leaf,lobe,long,margin,midvein,mm,narrowly,nodding,pair,pedicel,peduncle,petiole,plant,primary,pubescent,purple,reddish,revolute,ripe,scandent,shrub,simple,slender,sometimes,sparsely,stem,style,surface,terminal,time,vein,vine,woody	-1,0.3-0.5,0.5-1,0.5-5,1-1.5,1-3,1.5-1.7,10-20,2,2-,2/3,3.5-8.5,4-5,5-merou,9-12,ag,along,alyx,anthesi,apart,apiculate,apparently,archin,ark,articulated,basal,blackish,branch,capitate,cell,collapsing,connivent,cup-shaped,dark-pigmented,decurrent,dendriti,distal,dried,drying,eaf,eed,ellipsoid,exserted,extending,fleshy,flower,free,fruiting,furcate,glabrescent,glabrou,glandular,golden,gradually,groove,groupe,ilament,inserted,irregularly,known,lamina,leaving,lengthening,less,like,live,lobed,loosely,lower,material,minute,minutely,mostly,multicellular,narrowing,new,nflorescence,noddin,occasionally,often,older,orolla,papillo,part,peg,perfect,pericarp,pigmentation,plurifoliat,pore,poricidal,portion,quarter,recorded,retaining,rhachi,ruit,scar,scattered,shin,shiny,short,sleeve,slightly,slit,small,smaller,spaced,spheroidal,spreading,stellate,stigma,strongly,tangled,tem,thin,third,tip,trichome,tube,twinin,ud,uniseriate,unit,upper,usually,vary,wall,way,weak,weak-walled,wide,winged,ympodial,Â¾	arching,arrangement,branching,characteristic,colour,form,fruit,history,length,life,na,ovary,perennial,pseudostipule,rachi,seed,shape,staman,tertiary,texture,unarmed,venation
258	wfo-0001028888	invalid_json	207	123	87	120	36	0.42	0-3.5,0.15-0.5,1-2,10-25,2-6,2.3-7,2.5-3.3,3-4,4-7,5-7,6-11,8-11,abaxially,acuminate,acute,adaxially,anther,apex,apiculate,base,berry,broadly,brownish,cell,center,chartaceous,cm,condition,corolla,covered,covering,diameter,dot,drying,elliptic,filament,fresh,fruit,glabrous,globose,green,green-white,greenish,hair,hair-like,herb,lateral,like,lobe,long,make,margin,membranous,mm,mottled,mucilaginous,oblique,odd-pinnate,often,ovate,ovoid,pedicel,peduncle,petiole,plant,pubescent,purple,ripe,rounded,scattered,seed,short,slightly,sparsely,stem,streak,style,subglabrous,testal,thick,throughout,typically,violet,wall,wet,white,whitish	0-5,0-7,1,1-1.5,1-10,1-3,1.5-4,12.5-25,2-5,2.3-5,3-5,3.6-12.5,3.8-8.3,4-25,5-10,5-merou,8-13.5,acumen,ag,along,alyx,apart,apparently,articulated,axe,axillary,blade,bud,capitat,central,ciliate,clavate,connivent,cuneate,digestion,distal,dorsally,eaf,edge,eed,end,enzyme,erec,especially,exceeding,except,flat,flower,folded,forked,geminat,generally,glabrou,glaucous,greatly,hal,half,homostylous,honeycomb-shaped,interjected,lanceolate,leaflet,lengthening,less,living,low,lower,middle,midrib,minutely,nflorescence,one,orbicular,orolla,pair,pentagonal,perfect,petiolulate,petiolule,placed,plurifoliate,pore,poricidal,proximal,puberulent,reduced,removed,ruit,sessile,seudostipule,size,slit,sometimes,spaced,specimen,stamen,ste,stigma,stolo,straight,subequal,substellate,subtending,tall,tamen,tem,terminal,tip,tri-,truncate,tube,tuber,unit,unwinged,usually,vary,wing,x,yellow,ympodial	'',2,[,``,abaxial,adaxial,arrangement,branching,calyx,characteristic,colour,form,growth,height,history,inflorescence,leaf,length,life,midvein,na,ovary,primary,pseudostipule,rachi,shape,staman,surface,tertiary,texture,unarmed,value,vein,venation,{,}
259	wfo-0001028920	success	152	101	67	85	34	0.441	.5,0.2-1,0.5-1,0.8-1.1,1-1.2,1-1.5,1-3,2-2.5,3-15-flowered,3-3.5,5-9,6-6.5,abaxially,acuminate,acute,adaxially,anther,apex,arachnoid,arachnoid-pubescent,attenuate,base,berry,brown,calyx,cm,congested,corolla,dark,deltate,densely,elliptic,filament,glabrate,glabrous,globose,green,leaf,lightly,lobe,long,long-styled,minutely,mm,obovate,ovary,ovoid-reniform,pair,pedicel,petiole,pitted,pubescent,shape,short-styled,shrub,simple,small,sparsely,stem,style,surface,tree,trichome,vein,white,winged,x	.25,1-2.4,1.5-2,2-7,3-4,6-15,anthesi,area,axil,ba,bark,broadly,brownish,closely,conical,cucullate,decurrent,deflexed,dendritic,dense,dia,differing,difoliate,eaf,edicel,eed,ellipsoid,erect,exserted,felty,fleshy,flower,free,fruiting,geminat,gray-brow,later,lateral,lobed,lon,lower,main,major,middle,minor,nearly,nflorescence,obovoid,occasionally,older,opposite,overlappin,papillose,planar,pore,poricidal,portion,present,pubescence,ruit,scar,shaped,size,somewhat,soon,spaced,stigma,strongly,styl,tall,tapering,tear-drop,thick,tip,tub,tube,tuft,ud,unifoliate,uniseriate,unit,widest,woody,ympodial,young	abaxial,adaxial,alternate,arrangement,branching,characteristic,colour,diameter,form,fruit,gray-brown,greyish,growth,height,hirsute,history,inflorescence,length,life,margin,midvein,na,peduncle,perennial,plant,primary,pseudostipule,rachi,seed,staman,tertiary,texture,unarmed,venation
260	wfo-0001028929	success	210	131	111	99	20	0.529	.7,.9,0-1,0-10,0-3,0.1,0.2-0.4,0.4-0.8,0.5-2,0.7-1,0.7-2,0.8-1,2-3,2-4,2-6,2-9,2.2-2.3,2.7-3,3-20,4-6,5-25,5-6,abaxial,acicular,acute,adaxial,anther,apex,apically,apparently,articulated,base,berry,branched,calyx,cell,chartaceous,cm,cuneate,curved,densely,diameter,dull,elliptic,erect,filament,flattened-reniform,flower,fruit,gently,glabrescent,glabrous,hair,inflorescence,lateral,leaf,length,lobe,lobed,long,margin,maturity,midpoint,midvein,minutely,mm,oblong,obovate,obtuse,orange-brown,outline,pair,pale,pedicel,peduncle,per,pericarp,perpendicular,petiole,pit,prickle,prickly,primary,raised,ray,red,red-green,reticulate,scar,shrub,simple,slender,small,smooth,sometimes,spherical,stellate-pubescent,stem,straight,style,surface,tertiary,trichome,unarmed,vein,venation,visible,white,wide,yellow,yellow-green	-2,-2/3,.5,/5,0,0-20,0.15-0.3,0.2-0.3,0.2-0.8,0.3-0.6,0.5-1.5,1,1-1.1,1-3,1.5-2.4,1/2,1/4-1/3,2.5-4,2/3-3/4,3-4,5-7.5,5-merous,6-8,7-9,8-10,abaxially,alyx,apar,apart,ape,bark,blade,concolorous,connivent,difoliate,discolorous,distance,drying,eaf,eed,elongating,equal,extending,foliaceous,free,fruiting,geminat,glabrou,gra,infructescence,lon,long-styled,longer,lower,mature,minute,narrow-deltate,narrow-ovate,nflorescence,obtu,occasionally,older,one,open,orolla,oung,patch,pendulous,perfect,poricidal,porrect,portion,prickl,red-brown,rounded,ruit,sessile,short-styled,side,spaced,spreading,stalk,stalked,staminate,stellate,subsessile,tamen,tapering,terete,time,tip,tube,unit,usually,variously,vary,way,woody,ympodial	arrangement,branching,characteristic,colour,corolla,form,growth,height,history,life,na,ovary,plant,pseudostipule,rachi,seed,shape,spacing,staman,texture
261	wfo-0001028963	success	197	125	97	100	28	0.492	.5,0-0.4,0-2,0.3-0.6,0.3-1,0.45-0.6,0.6-1,0.9-1.5,1.5-2,1/5,2-4,2.4-2.8,3.5-4.2,6-10,acute,anther,apex,apically,apparently,articulated,attenuate,base,berry,bright,broad-deltate,brown,calyx,cell,chartaceous,cm,concolorous,densely,diameter,discolorous,drying,dull,entire,erect,evenly,eye,filament,flattened-reniform,gray-green,green,herb,inflorescence,lanceolate,lateral,leaf,length,light,lobe,long,lower,margin,maturity,mauve,mm,moderately,naked,narrow-cuneate,narrow-elliptic,narrowly,obtuse,orange,outline,pair,pale,pedicel,peduncle,petiole,pit,primary,purple,raised,red,shrub,simple,small,smooth,spherical,stellate-pubescent,stem,style,surface,terete,terminal,tertiary,unarmed,unbranched,upper,vein,venation,visible,winged,yellow-orange,young	/2,0.1,0.1-0.2,0.1-0.25,0.15-0.3,0.3-0.7,0.3-1.5,0.6-0.9,0.8-1.8,1-4,1/,1/4-1/3,1/6,2-2.3,2-3,2-5,2-9,3-4.5,4-10,4-8,5-25,5-merous,7-8,abaxially,alyx,apar,ape,bark,becoming,blade,connivent,curved,cuspidat,deltate,difoliate,eaf,eed,elongating,equal,flower,free,frui,fruiting,geminat,glabrescent,glabrous,gra,herbaceous,infructescence,less,lobed,long-styled,longer,mature,midpoint,nflorescence,occasionally,older,one,open,orolla,oung,pendulous,per,perfect,pericarp,poricidal,porrect,portion,ray,ruit,scar,sessile,short-styled,shorter,slender,slightly,spaced,spreading,stalk,stalked,staminate,stellate,straight,subsessile,tamen,tapering,time,tip,trichome,tube,unarme,unit,usually,variously,vary,way,wide,woody,ympodial	1/2,abaxial,adaxial,arrangement,branching,characteristic,colour,corolla,cuspidate,form,fruit,gray,growth,height,history,life,midvein,na,ovary,perennial,plant,pseudostipule,rachi,seed,shape,staman,texture,true
262	wfo-0001028971	success	225	140	115	110	25	0.511	.1-0.2,0.1-0.4,0.25-0.6,0.3-0.6,0.4-0.9,1-2,1-5,1.5-2.2,1.75-2.5,10-15,2.2-3.5,2.5-3.5,2.5-5,3-14,3-5,3-6,4-5,4-9,5-10,6-16,6-8.5,6-9,7-16,abaxially,acute,acute-,adaxially,anther,apex,appearance,appearing,articulated,base,branched,broadly,calyx,close,cm,coarsely,deltoid,densely,dentate,diameter,erect,essentially,extra-axillary,farinaceous,felty,felty-pubescent,filament,flower,form,frequently,fruit,glabrous,globose,hair,inflorescence,invested,leaf,length,lenticular,lobe,margin,minutely,mixture,mm,narrowly,numerous,obtuse,occasionally,often,orange,outline,ovate,ovate-apiculate,pair,pedicel,peduncle,per,perennial,petiole,pitted,prickly,pubescent,rachi,ray,reniform-ovate,ripe,round-tipped,sericeous,sessile,short,short-stalked,side,simple,spreading-hirsute,spreadingly,stellae,stellate,stellate-pubescent,stem,stipitate,style,surface,tan,thin-textured,trichome,truncate,unbranched,underdeveloped,usually,vein,white,x	-0.8,-1.4,0.1-0.5,0.2-0.5,0.25-1.25,0.4-1.5,0.8-2.5,05-2.5,1.5-4,1/5-1/2,15-30,2-5,2-foliate,2.5-4.5,20-35,5-15,5-8,adaxiall,along,also,apart,armed,ascending,attenuate,axe,ba,bearing,becoming,blade,broad-based,campanulate,capitat,cauline,compressed,connivent,cylindrical,delicate,directed,distal,distall,eaf,eed,elongate,elongate-deltoid,entire,female-sterile,geminat,grading,growt,inserted,interlobal,lanceolate,largest,later,lateral,laterally,least,lignescent,like,linear-lanceolate,lon,long,longer,longest,lower,major,manifestly,maturit,midpoint,midrib,minute,much,multiseriate,nflorescence,one,orolla,other,ovate-lanceolate,persistent,pore,prickle,principal,reduced,ruit,scattered,shorter,similar,sinus,smaller,sometimes,spaced,sparse,stalk,ste,stigma,tal,tamen,tem,termination,time,tooth-like,tube,unit,variable,variously,vary,well-developed,wide,yellow,ympodial	abaxial,adaxial,arrangement,branching,characteristic,colour,corolla,growth,height,history,life,midvein,na,ovary,plant,primary,pseudostipule,seed,shape,staman,tertiary,texture,unarmed,venation,ye
263	wfo-0001028975	success	163	101	72	91	29	0.442	.5,0.1-1,0.5-1,1,1-3,1-5,1.2-1.5,1.5-2,3-10-flowered,3-3.5,6-6.5,8-9,?,acuminate,acute,anther,apex,base,beneath,berry,brown,calyx,cm,conical,corolla,dark,densely,dia,elliptic,filament,fruit,glabrous,globose,golden,green,immature,leaf,length,lobe,long,margin,minutely,mm,narrowly,once-furcate,ovary,ovoid-reniform,pair,pedicel,petiole,pitted,pubescent,shiny,shrub,simple,slender,small,sparsely,stem,straight,style,surface,tapering,tree,triangular,trichome,tube,uniseriate,varying,vein,white,wide	.2,1.5-1.8,2.2-6,3-6.5,5-ribbed,5.5-10,7.5-15,along,anthesi,apart,appearing,area,bark,broad,closely,conically,corky,cup-shaped,decurrent,deflexed,denser,differing,difoliate,eaf,edicel,eed,entire,epidermi,equal,erect,exserted,extension,free,fruiting,geminat,hyaline,large-celled,late,lateral,like,lobed,lon,lower,main,mainly,major,member,mere,middle,minor,nearly,nflorescence,obscured,occasionally,older,one,opposite,papillo,pore,poricidal,portion,prominent,pubescenc,raised,reddi,reflexed,remaining,rib,ruit,scar,shaped,short,sinus,size,slightly,somewhat,spaced,stigma,strongly,tall,tear-drop,tip,tub,ud,unit,upper,widest,woody,x,ympodial,young	abaxial,adaxial,alternate,arrangement,branching,characteristic,colour,diameter,form,growth,height,history,inflorescence,life,midvein,na,peduncle,plant,primary,pseudostipule,rachi,reddish,seed,shape,staman,tertiary,texture,unarmed,venation
264	wfo-0001028980	invalid_json	168	139	116	52	23	0.69	.1,.5,/3,0.5-1.5,1-1.2,1.2-1.8,1.2-3,1.5-1.8,1.5-2,1.5-6,2.5,2.5-5,20-25-flowered,3-4,4-5,5-6,6,6-8,7-12,along,anther,anthesi,apart,axil,bark,base,beginning,black,calyx,capitate,clearly,cm,coarsely,corky,corolla,densely,dia,differentiated,dry,drying,elliptic,expanded,exserted,filament,flattened-reniform,fleshy,fruiting,furcate,glabrate,glabrous,glandular,globose,incrassate,lateral,leaf,like,lobe,long,main,major,margin,material,member,middle,minor,minutely,mm,occasionally,opposite,ovary,ovate,ovoid,pair,paler,pedicel,peduncle,petiole,pit,pitted,planar,pore,poricidal,pubescent,reddish,reflexed,scar,seed,shaped,shining,shrub,simple,size,slightly,small,soon,speciman,stem,stigma,style,surface,tall,tear-drop,thick,tip,tree,trichome,tube,type,uniseriate,usually,vein,way,white,widest,woody,x	.75,3/4,5-8,acuminate,acute,apex,basal,beneath,berry,broadly,conical,cucullate,deflexed,deltoid,differing,difoliate,eaf,edicel,eed,extending,f,free,frui,geminat,green,impressed,inflorescenc,lamina,lenticellat,lobed,lon,lower,m.,nflorescence,older,one,pale,papillose,portion,prominent,ruit,scarious,sharply,sparsely,strongly,tapering,ti,ud,unit,yellowish,ympodial,young	'',[,``,bud,characteristic,colour,diameter,exsertion,form,fruit,growth,height,inflorescence,length,lenticellate,plant,pubescence,shape,texture,value,width,{,}
265	wfo-0001028984	success	180	121	88	92	33	0.489	-14,-3,-6,-65,0.5-,1,1-,1-1.7,1-6,1-9,1.2-4,1.5,10-20,15-35,2,2-,2-2.5,2-3,2-4,20-40,3-10,3-26,3-6,4-30,4-5,4-6,4-6.3,5-10,7-14,acuminate,acute,age,also,apart,apex,articulated,basal,base,broadly,calyx,chartaceous,cm,cordate,densely,diameter,ellipsoid-fusiform,entire,flower,forked,fruit,glabrous,greenish,leaving,lobe,long,margin,mm,moderately,often,ovate,pale,pedicel,pedicellar,peduncle,petiole,pilose,puberulent,puberulent-pubescent,pubescent-pilose,purple,rachi,rarely,remnant,shrub,simple,small,spaced,sparsely,style,subcoriaceous,tip,tree,truncate,turning,unbranched,unknown,x,yellow	-2,-2.5,-9,1-2,1-2.5,12-20,2-16,3-28,4-7,4-foliat,5,8-15,abaxially,abruptly,absen,adaxially,adpressed,aggregate,almost,ape,apical,axe,blade,broad,campanulate,cell,color,concave,connective,dilated,directed,distally,eaf,eed,eglandular,equalling,especially,exceeding,fleshy,gland,glandular-puberulent,globose,hair,lanceolate,laterally,lon,longer,lower,minutely,narrowed,near,nflorescence,nther,obconical,obtuse,orolla,ovoid,papillose,perfect,pilo,pore,possibly,presence,present,pubescent-pilo,radiu,ripe,ruit,shorter,slightly,stamen,stigma,stone,strongly,swelling,tal,tem,thecae,time,tomento,tomentose,toward,triangular,tube,two,ud,unit,unknow,vary,violet,wide,ympodial	abaxial,adaxial,anther,arrangement,branching,characteristic,colour,corolla,filament,form,growth,height,history,inflorescence,leaf,length,life,midvein,na,ovary,plant,primary,pseudostipule,seed,shape,staman,stem,surface,tertiary,texture,unarmed,vein,venation
266	wfo-0001028997	success	136	106	76	60	30	0.559	.5,0.5-0.7,0.5-1,0.8-1.1,1-1.2,1-1.5,20-50-flowered,3-4,3.3.5,4-10,4-4.5,5-6,6-7,abaxially,acute,adaxially,anther,apex,appearing,attenuate,base,berry,branched,calyx,cm,corolla,deflexed,dia,difoliate,dry,drying,elliptic-obovate,erect,filament,filiform,flattened-reniform,glabrous,globose,golden,green,height,incrassate,leaf,lobe,long,many,margin,matte,minutely,mm,mustard,opposite,ovary,pair,pale,pedicel,pericarp,petiole,pitted,quadrate,revolute,shiny,shrub,stem,style,surface,tan,terminal,thick,time,trifoliate,unknown,vein,white,x,yellow	0.5-1.5,2-2.5,2-3.5,4-angled,6-10,anthesi,apar,area,ba,bark,broadened,conical,coriaceous,cucullate,eaf,edicel,eed,elliptic,exserted,fragrant,free,fruiting,geminat,glabrou,greenish-brow,later,lateral,lobed,lon,lower,main,merely,middle,nearly,nflorescence,older,papillose,partially,pore,poricidal,portion,ruit,scar,shaped,spaced,specimen,stigma,strongly,styl,tear-drop,thickened,tip,tub,tube,ud,unevenly,widest,woody,ympodia,young	abaxial,adaxial,arrangement,branching,characteristic,colour,diameter,form,fruit,greenish-brown,growth,history,inflorescence,length,life,midvein,na,peduncle,plant,primary,pseudostipule,rachi,seed,shape,staman,sympodia,tertiary,texture,unarmed,venation
267	wfo-0001029003	invalid_json	207	117	84	123	33	0.406	0.5,1-2,1.2-1.9,1.2-2.5,1.5-2.3,11-32,2.5-10,3,3-20,4-8,5,5-12.5,7-9,9-14,abaxially,acuminate,adaxially,anther,apex,articulated,attenuate,base,berry,blue-violet,brownish,cell,chartaceous,cm,condition,conical,corolla,covering,diameter,drying,filament,fourth,fresh,fruit,glabrous,green,greenish,hair,hair-like,herb,highly,lateral,leaf,light,like,lobe,long,margin,medium,membranous,middle,minute,mm,mottled,obtuse,odd-pinnate,ovoid,pale,pedicel,peduncle,petiole,pigmentation,plant,proximal,pubescent,purple,ripe,rounded,seed,sometimes,sparsely,stem,style,subglabrous,testal,thick,usually,violet,wall,whitish	0-6,0.3-0.5,0.4-3,1,1-10,1-2.5,1-3,1-5,12.2-30,13-36,2-6,2.5-7.5,3-5,3.5-7.5,5-10.5,5-merou,7-15.5,absent,acumen,ag,alyx,apart,apparently,axe,axillary,blade,bud,capitat,ciliate,connivent,decreasing,digestion,distal,dorsally,eaf,edge,eed,elliptic,elongated,end,enzyme,equal,erec,especially,exceeding,flat,flower,folded,forked,geminat,generally,glabrou,gradually,green-white,hal,half,homostylous,honeycomb-shaped,interjected,lanceolate,larger,leaflet,lengthening,living,lower,make,mucilaginous,nflorescence,one,orbicular,orolla,ovate,pair,pentagonal,perfect,petiolule,placed,plurifoliate,pore,poricidal,prostrate,rarely,ray,removed,rotate,ruit,secondary,sessile,seudostipule,size,slightly,slit,spaced,specimen,stamen,ste,stigma,stolo,straight,subcapitate,subequal,subtending,symmetrical,tall,tamen,tem,terminal,throughout,tip,toward,tri-,tube,tuber,typically,unit,vary,wet,white,wide,wing,x,yellow,ympodial	'',[,``,abaxial,adaxial,arrangement,branching,calyx,characteristic,colour,form,growth,height,inflorescence,length,midvein,na,ovary,primary,pseudostipule,rachi,shape,staman,surface,tertiary,texture,unarmed,value,vein,venation,width,{,}
268	wfo-0001029006	success	217	151	125	92	26	0.576	-+,0.2,0.4-2.5,0.5-4,1,1-1.5,1.8-2.2,10,10-20,2-3,2.5,3.5-4,4-6,5,7-8,<,>,acuminate,acute,adaxial,age,along,anther,anthesi,apex,articulated,asymmetrical,axi,axil,base,berry,beyond,blackish,branched,calyx,cell,chartaceous,cm,corolla,deltate,dense,depending,diameter,elliptic,elongate,entire,exserted,extending,filament,filiform,flattened,glabrous,globose,green,groove,growth,inflorescence,keeled,lamina,later,lateral,leaving,lobe,long,many,margin,membranous,midrib,minute,minutely,mm,narrowly,nodding,oblique,occasionally,often,pair,pale,pedicel,peduncle,peg,pentagonal,per,petiole,pitted,primary,puberulent,pubescent,purple,purplish,reddish,reniform,ripe,simple,size,sleeve,small,sometimes,sparsely,spreading,stem,style,surface,tan,terminal,testal,time,tip,trichome,truncate,tube,tuft,twining,uniseriate,usually,variable,variously,vein,vine,violet,white,within,woody,x,young	.5,0.5,0.5-2,1-4,1-5,1.2-1.5,1/3,2-6,5-6,5-merou,50,7-9,abaxially,adaxiall,ag,alyx,apar,area,ark,basal,bilobed,black,bright,broadest,c.,clavat,conical,connivent,deeply,drying,eaf,eed,ellipsoid,flower,free,fruiting,growing,ilament,inflated,intramarginal,irregular,irregularly,lengthening,lobed,loosely,lower,markedly,nearly,new,nflorescence,obvious,older,one,orolla,papillate,part,pendan,perfect,pericarp,pinnatifid,planar,plurifoliat,pore,poricidal,portion,puberulen,reaching,rotate-stellate,ruit,sagittate,scar,shiny,slit,smaller,somewhat,spaced,stigma,strong,strongly,sunligh,tem,thin,tiny,twinin,ud,unit,upper,vary,way,widest,ympodial,zig-zag	abaxial,arrangement,branching,characteristic,colour,form,fruit,height,history,leaf,length,life,midvein,na,ovary,perennial,plant,pseudostipule,rachi,seed,shape,staman,tertiary,texture,unarmed,venation
269	wfo-0001029031	success	213	123	99	114	24	0.465	-11.4,-8,.5-1.2,0-5,0.1-0.5,0.5-1.5,0.5-4,0.6-1.2,0.7-1.1,1-1.5,1-2.5,1-5,1-9.4,1.8-2.7,13.5,2-3,2-3.3,2-5,2.5-5.5,3-10,4-7.5,5-17,6-12,acuminate,acute,angle,anther,apart,apex,articulated,base,becoming,berry,black,bluish,branched,brown,calyx,chartaceous,cm,corolla,cuneate,deltate,densely,diameter,elliptic,elliptic-ovate,entire,erect,filament,fleshy,flower,forked,fruit,glabrescent,glabrous,green,hair,held,lateral,leaf,length,light,like,lobe,margin,midvein,mm,occasionally,pedicel,peduncle,peltate-stellate,petiole,possibly,pseudoterminal,pubescent,rachi,ripening,rounded,rugulose,shrub,side,silvery,simple,small,spaced,sparsely,stellate-pubescent,stem,style,surface,tree,unbranched,vein,white,whitish,x,yellow,yellowish	-12.3,-3.6,.1-0.3,0.5,1-2,1-2.6,1-3,1.3-3.3,1.5-2.8,1.5-3.5,1.8-4,1/3,10,2-10.7,2.5-5.6,20-150,4-5-,6-21,abaxially,absent,accrescent,adaxiall,adaxially,ag,apexacute,apparently,around,axe,ba,bilobe,blade,capitate,center,connivent,covering,curved,cylindrical,denser,directed,distally,eaf,edge,eed,eglandula,eglandular,equal,farinose,flattened,frui,fruiting,fused,geminate,globose,immature,impressed,inserted,lanceolate,large,leaf-opposed,least,long,longitudinal,lower,major,many-foliate,midpoint,nearly,nflorescence,oblong,obtuse,opening,orange,orolla,outline,paired,peltate,perfect,pore,porrect-stellate,prominent,pubescen,pubescence,rarely,ray,reniform,ruit,sessile,short,short-stalked,slightly,slit,smaller,sometimes,somewhat,ste,stellate,stigma,straight,strongly,suborbicular,subtending,tall,tamen,tem,time,tip,trichome,tube,unarme,unit,usually,vary,wide,ympodial	abaxial,adaxial,arrangement,branching,characteristic,colour,form,growth,height,history,inflorescence,life,na,ovary,plant,primary,pseudostipule,seed,shape,staman,tertiary,texture,unarmed,venation
270	wfo-0001029048	success	162	105	77	85	28	0.475	.5,0.5,0.5-1,0.5-1.7,0.8-1,1,1-2,1-8,1.5-2,11,2,3-4,5-8,8-10,acuminate,angle,another,anther,apex,arching,attenuate,base,berry,calyx,cm,corolla,decurrent,elliptic,filament,filiform,glabrous,globose,greenish-white,greenish-yellow,hanging,hispidulous,incrassate,leaf,less,lobe,long,margin,matte,midrib,minutely,mm,obtuse,one,ovary,ovoid-reniform,pair,pale,papillose,parallel,pedicel,petiole,pitted,planar,puberulent,right,rounded,sharply,shrub,slender,slightly,somewhat,stem,straight,style,surface,tan,thread-like,tip,unifoliate,vein,winged,x	.01,.2,/3,14,25,26,3-7,3.5-4,4-6,9-15,anthesi,apar,apparent,basal,bearing,becoming,beneath,bicellular,blade,branch,bright,broadly,conical,dia,eaf,edicel,eed,elongated,except,expanded,f,flower,free,fruiting,geminate,glabrate,golden,greatly,green,greenish-yello,lateral,like,live,lobed,lower,main,middle,minute,much,nflorescence,node,non-reproductive,obovoid,older,opposite,papillo,pore,poricidal,portion,reflexed,ripe,ruit,scar,shaped,small-capitate,spaced,specimen,stigma,tall,tapering,tear-drop,time,translucent,trichome,tube,ud,unevenly,uni-,unit,way,widely,widest,ympodial,young,zig-zag	abaxial,adaxial,arrangement,branching,characteristic,colour,diameter,form,fruit,growth,height,history,inflorescence,length,life,midvein,na,peduncle,perennial,plant,primary,pseudostipule,rachi,seed,shape,staman,texture,unarmed
271	wfo-0001029055	invalid_json	169	107	77	92	30	0.456	0.4-1.5,1-5,1.6-3.5,1.8-3.5,14-50,2-4,2.2-3,4-10,4-6,4-7,5.5-9,8-9,apical,apically,base,branched,calyx,cell,cm,corolla,covering,cyme,dark,dehiscent,diameter,dichasial,dichasially,diminishing,ebracteate,elliptical,exceeding,gland,green,herbaceous,introrse,lateral,leaf,leaflet,long,longitudional,maturing,mm,monochasial,odd-pinnate,often,outline,ovate,ovoid,pedicel,peduncle,pentagonal,perennial,petiole,pilose,plant,poricidally,pubescent,purple,rotate,seed,short,short-stalked,size,slit,sometimes,stamen,stigma,straight,stripe,style,terminal,testal,thick,toward,triangular,wall,wide	1-2.6,1-4,1.7-2.2,2-1.,2-3,2.5-8,3,3-10,3-6,3-6-foliat,5-24,6-14,9-22,abaxially,acumen,acuminate,acute,adaxially,apex,articulate,attenuate,connate,cordate,covered,cuneate,decurrent,densely,digestion,distal,dorsally,eaf,edge,eed,elliptcal,emoval,enzyme,filament,first,flat,flower,folded,forked,generally,globo,green-white,hair,hair-like,half,honeycomb,interjected,living,lobe,lon,long-attenuate,longer,lower,lunat,make,mucilaginous,near,nflorescence,nther,oblique,orolla,pair,pattern,perfect,plan,proximal,rarely,reveal,ruit,second,sessile,seudostipule,short-petiolate,specimen,spreading,tal,tem,throughout,time,tuber-bearing,type,typically,unit,vary,whit,widest,yellow,ympodial,Â¼	'','hair-like,'type,[,],``,abaxial,adaxial,anther,arrangement,characteristic,colour,dehiscence,form,fruit,globose,growth,height,history,inflorescence,length,life,ovary,shape,stem,surface,texture,value,{,}
272	wfo-0001029059	success	199	122	93	106	29	0.467	.5,0.1-0.5,0.1-1,0.2,0.2-0.5,0.5-1,1-1.5,1-3,1-4,1-6,1.2-3,1.3-1.7,1.5-2,1.5-2.8,3-3.5,3.5-6,5-15-flowered,6-10,7-9,acute,along,anther,apex,base,berry,branched,calyx,cm,corolla,cuneate,deltoid,dense,densely,dia,dirty,elliptic,extremely,filament,flattened-reniform,glabrate,glabrous,globose,hispidulous,impressed,incrassate,inflorescence,leaf,lobe,long,major,margin,minute,minutely,mm,oblique,occasionally,often,ovary,pair,pale,partially,pedicel,petiole,pitted,pubescence,pubescent,purplish,ripe,shallowly,shape,shrub,simple,slender,small,sparse,stem,straight,style,surface,tapering,tinge,tree,trichome,tube,unicellular,uniseriate,variable,vein,waxy,white,x,yellowish-green,yellowish-tan	0.5,1-1.2,10-19,2.5,3-6.5,3.5-8,4-10.5,5,anisophyllou,anthesi,apar,ape,apiculae,apiculate,arising,bark,beneath,bout,bud,clavate,closely,coiba,connivent,cordate,covered,de,deep,deflexed,differing,difoliate,eaf,edicel,eed,ellipsoid,expanded,exserted,extending,foetid,free,fruiting,geminate,greatly,interpetalar,isla,lamina,lateral,lobed,lon,longest,lower,main,member,membranous,middle,minor,narrowly,nearly,nflorescence,older,one,opposite,orange,orangish-yellow,orbiculate,paler,panama,papillo,papillose,planar,pointed,population,pore,poricidal,portion,prominent,reddish-gre,rest,rounded,ruit,scar,shaped,sinus,size,somewhat,soon,spaced,specimen,stigma,tall,tear-drop,terminal,thickened,ti,tightly,tip,triangular,ud,underside,unit,usually,wide,widest,woody,yellowish,ympodial,young	abaxial,adaxial,arrangement,branching,characteristic,colour,diameter,form,fruit,growth,height,history,length,life,midvein,na,peduncle,perennial,plant,primary,pseudostipule,rachi,reddish-grey,seed,staman,tertiary,texture,unarmed,venation
273	wfo-0001029072	success	235	124	102	133	22	0.434	.5,0-2,0-4,0.4-0.9,0.5-2,0.8-1.5,00-200,1-1.2,1-25,1.5-2.6,1/3,2-10,2-5,2-7,2.2-2.5,2.2-3.2,2.5-3.5,3-8,3.5-6,4.2-6.5,4.5-9,5-7,7-15,abaxial,abaxially,acute,adaxial,adaxially,anther,apex,apically,apparently,articulated,base,berry,branched,bright,calyx,clearly,cm,cordate,cuneate,deltate,densely,diameter,dirty,dull,erect,filament,flattened-reniform,fruit,green-brown,herb,lateral,leaf,length,lobe,lobed,long,long-styled,lower,margin,maturity,mauve,midvein,mm,moderately,narrow-deltate,orange-brown,ovate,pair,pale,pedicel,peduncle,pendent,per,petiole,plant,prickle,prickly,primary,rounded,short-styled,shrub,simple,sometimes,spherical,stellate-pubescent,stem,style,surface,terminal,tertiary,unarmed,upper,vein,venation,visible,white,whitish,wide,yellow	-1/2,-15,-2.5,/6,0,0-20,0-8,0.1-0.4,0.2-0.3,0.2-0.4,0.3,0.5-3,0.7,0.8,1,1-1.5,1-3,1.5-2.5,1.5-3.2,1/4-1/2,1/4-1/3,12-19,2-8,2.5-3.8,2.5-4.5,20-50,3-10,3-20,3-5,3-50,3/,4-,4-10,5-10,5-50,5-9,5-merous,7-10,8-20,8-27,alyx,ame,andromonoecious,angled,apar,apart,bark,blade,broad-deltate,broadly,c.,chartaceous,conical,connivent,cream,curved,dark,discolorous,distal,distance,drying,eaf,eed,elongated,elongating,equal,extending,flattened,flower,free,fruiting,gently,glabrous,gra,green,hermaphrodite,heterostylous,infructescence,least,longer,longitudinal,lowermost,marking,mature,midpoint,multangulate,nflorescence,obtu,older,one,open,orolla,oung,pendulous,pericarp,plurifoliat,poricidal,porrect,portion,prickl,raised,ray,reflexed,ridge,ruit,scar,sessile,side,smooth,spaced,sparsely,spreading,stalk,stalked,staminat,stellate,stout,straight,strongly,tamen,tapering,time,tip,trichome,tube,unit,variously,vary,way,weakly,woody,ympodial,young	3/4,arrangement,branching,characteristic,colour,corolla,form,growth,height,history,inflorescence,life,na,obtuse,ovary,perennial,pseudostipule,rachi,seed,shape,staman,texture
274	wfo-0001029073	success	211	129	105	106	24	0.498	.5,0.3-1,0.6-2,1-1.5,1.1-1.5,1.5-2,10-16,2,2-3,2-4,4-5,4-6,5-6,5-8,6-9,7-10,8-14,acuminate,acute,anther,anthesi,apex,awn-like,base,berry,brown,calyx,cell,cm,corolla,cream,dark,darker,densely,diameter,elliptic,entire,erect,filament,flattened,flower,glabrous,globose,golden,growth,inflorescence,internodal,lamina,lanceolate,leaf,length,like,linear,lobe,lobed,long,margin,maturity,midvein,minutely,mm,narrowly,oblique,occasionally,opposite,orange,pair,pale,pedicel,peduncle,per,pericarp,petiole,porrect,prickly,primary,pubescent,purple,rectangular,reniform,reticulate,shallowly,shiny,shrub,simple,sinuate,slightly,sparsely,stellate,stem,style,surface,tan,tapering,testal,thin,trichome,truncate,unarmed,vein,visible,wall,whitish,x,yellowish	.7,0.5,0.5-1,0.6-0.7,1-1.2,1-2.5,1-3,1.2-1.6,10-15,2/3,3.5-9,5-merous,abaxially,adaxially,along,another,apart,armed,articulated,away,ba,bark,basal,beneath,broad-based,chartaceous,conical,curved,dense,difoliate,dimorphic,discolorous,drying,eaf,eed,enlarged,equal,except,exserted,four,free,frui,fruiting,geminat,gre,hooked,interpetalar,lengthening,long-styled,lower,midpoint,mixture,multangulate,new,nflorescence,nodding,older,one,paler,papillose,perfect,planar,plurifoliate,pore,poricidal,portion,prickle,pubescence,ray,ruit,scar,sessile,short,short-stalked,shorter,slit,sometimes,somewhat,spaced,splitting,stigma,straight,strongly,styled,three,ti,tip,tissue,triangular,tube,two,ud,underside,unequal,unequally,unisexual,unit,upper,upward,way,wide,woody,yellow,ympodial,zygomorphic,Â½	abaxial,adaxial,arrangement,branching,characteristic,colour,form,fruit,grey,height,history,life,na,ovary,plant,pseudostipule,rachi,seed,shape,staman,tertiary,texture,true,venation
275	wfo-0001029074	success	174	101	76	98	25	0.437	.1,0,0.2-1,0.3-0.8,0.5-1,0.7-0.8,1,1-1.2,1-1.5,1.4-1.8,1.5-2,2-4,3-,3.5-5,5-7,acute,anther,apex,base,berry,black,broadly,calyx,cm,conical,corolla,cuneate,densely,diameter,entire,filament,flattened,glabrous,globose,green,grey,growth,herb,immature,leaf,less,lobe,margin,midvein,minutely,mm,ovary,ovate,pair,pale,pedicel,peduncle,per,petiole,pitted,primary,pubescent,purplish,reniform,ripening,rounded,simple,sparsely,stellate,stellate-pubescent,stem,style,subshrub,surface,triangular,truncate,uniformly,vein,white,x,yellowish	.5,0.3-0.4,0.5-1.2,0.7-0.95,1-,1-2,1.5-4,11,2-2.3,2-5,2-7,3-6,5-6,abaxially,absent,adaxially,age,almost,along,anthesi,apart,apparently,appearing,articulation,bark,basa,capitate,deflexed,denser,eaf,eed,ellipsoid,exerted,expanding,flower,free,frui,fruiting,glabrescen,internodal,lacking,lengthening,lignescent,like,lobed,longest,lower,markedly,midpoint,mixture,new,nflorescence,obscuring,often,older,opposite,papillat,perfect,pericarp,petal,planar,plurifoliat,pore,poricidal,portion,prominent,pulp,ray,reflexed,ruit,sagittate,scar,scattered,sessile,slit,small,somewhat,stalk,stalked,stigma,strongly,swollen,thin,tip,trichome,tub,tube,ud,underside,uniseriate,unit,usually,watery,way,woody,yellow,ympodial,Â¾	abaxial,adaxial,arrangement,branching,characteristic,colour,form,fruit,height,history,inflorescence,length,life,na,plant,plurifoliate,pseudostipule,rachi,seed,shape,staman,tertiary,texture,unarmed,venation
276	wfo-0001029075	success	217	121	93	124	28	0.429	.5,0.8-1.5,1-2,10-20,2-5,2.5-3,30-60,4-10,4-7,4.5-6.5,5-8,6-12,7-9,8-9,abaxially,abruptly,adaxially,anther,apex,apparently,attenuate-acuminate,axillary,base,berry,broadly,brown,brownish,bud,canescent,cm,condition,corolla,cuneate,dark,densely,diameter,distal,dot,drying,elliptic-lanceolate,filament,flecked,flower,forked,fresh,fruit,generally,glabrescent,glabrous,glandular-pilose,glandular-puberulent,gray-green,green,greenish,hair,half,herb,lanceolate,leaf,like,lobe,long-spatulate,margin,mm,narrowed,narrowly,odd-pinnate,ovoid,pedicel,peduncle,perfect,petiole,plant,pointed,pubescent,rachi,rounded,seed,short,small,stem,style,subobtuse,subquadrate,subtending,terminal,usually,white,whitish,whitish-gray,yellow,yellow-green,yellowish-white	.3,0-3,0-8,0.5-0.8,0.8-1.2,1-10,1-2.5,1-3,2-4,2.7-4.2,4-14,4-5,5-10,5-8.5,5-merou,7-17,acumen,ag,along,alyx,apart,articulated,atypically,axe,blade,cell,ciliate,clavifor,connivent,covering,decreasing,decurrent,digestion,dorsally,eaf,edge,eed,end,enzyme,erect,erect-ascendin,especially,etota,exceeding,flat,folded,geminat,glabrou,gradually,greatly,green-white,hair-like,homostylous,honeycomb-shaped,interjected,larger,lateral,leaflet,lengthening,light,living,long,lower,make,middl,midrib,minutely,mucilaginous,nflorescence,orbicular,orne,orolla,ovate,pair,pentagonal,petal,petiolulate,petiolule,plurifoliate,pore,poricidal,puberulent,purple,removed,ruit,sec,sessile,seudostipule,singly,size,slightly,slit,sometimes,spaced,specimen,stamen,ste,stigma,stolo,straight,subequal,substellate,tall,tamen,tem,testal,thick,throughout,tip,toward,tri-,tube,tuber,typically,unit,unwinged,upper,vary,wall,wet,wide,woody,x,ympodial	abaxial,adaxial,arrangement,branching,calyx,characteristic,colour,form,growth,height,history,inflorescence,length,life,midvein,na,ovary,perennial,primary,pseudostipule,shape,staman,surface,tertiary,texture,unarmed,vein,venation
277	wfo-0001029084	invalid_json	192	128	93	99	35	0.484	.5,1-2,1.1-2.2,10-50,2-3.5,3-6,3.5-7.5,4-17,4-7,4.5-10,5,5-7,7-9,8-23,acuminate,anther,apex,apparently,articulated,axillary,base,berry,brownish,bud,cell,chartaceous,cm,condition,conical,corolla,covering,diameter,distal,drying,filament,flower,forked,fresh,fruit,generally,glabrous,green,green-white,greenish,hair-like,half,herb,lateral,leaf,light,lilac,lobe,long,make,margin,middle,minute,mm,mottled,mucilaginous,narrow,odd-pinnate,ovate-lanceolate,ovoid,pedicel,peduncle,perfect,petiole,petiolule,pilose,plant,proximal,pubescent,purple,ripe,seed,sparsely,style,subglabrous,subsessile,subtending,symmetrical,terminal,testal,thick,throughout,unwinged,usually,wall,wet,whitish,wing,x	0.8-2,0.8-2.1,1-10,1-3,1-4,1.5-2.5,2-4,2-5,3.5-8,4.5-6.5,5-merou,6-13,abaxially,absent,acumen,adaxially,ag,along,alyx,apart,arranged,axe,bead,blade,capitat,ciliate,connivent,darker,decreasing,digestion,dorsally,eaf,edge,eed,enzyme,especially,exceeding,flat,folded,geminat,glabrou,gradually,homostylous,honeycomb-shaped,interjected,interpetalar,lanceolate,larger,leaflet,lengthening,like,living,lon,lower,midrib,minutely,moniliform,multiple,necklace,nflorescence,obtuse,orolla,pair,plurifoliate,pore,poricidal,puberulent,ray,removed,rotate,ruit,secondary,semierec,seudostipule,size,slit,spaced,specimen,stamen,stigma,stolon,subequal,subglabrou,tall,tamen,tem,thir,tip,tissue,toward,tri-,tube,tuber,typically,unit,vary,wide,yellow,ympodial	'',2,[,``,abaxial,adaxial,arrangement,branching,calyx,characteristic,colour,form,growth,height,inflorescence,length,midvein,na,ovary,primary,pseudostipule,semierect,shape,staman,stem,surface,tertiary,texture,third,unarmed,value,vein,venation,{,}
278	wfo-0001029088	success	149	119	88	61	31	0.591	.2,.3,0.6â3.2,0.9â1.5,1.3â4.5,1.5â2,15â25,1â1.6,1â3,2.5â4.2,25â30,2â2.5,2â3,3â16,5,5â8,abaxially,acuminate,adaxially,anther,apex,base,bronze-brown,calyx,cm,cordate,cylindrical,densely,diameter,emarginate,entire,extra-axillary,filament,flattened,flower,fruit,glabrous,greenish-brown,hair,half,herbaceous,immature,leaf,lenticular,light,lobe,lower,margin,mature,minutely,mm,moderately,near,obtuse,ovoid-rhomboid,palmate,papillose,pedicel,peduncle,petiole,primary,pubescent,purplish,rachi,reddish-brown,revolute,rounded,rugose,sand-punctate,shortly,simple,slender,slightly,spaced,sparsely,stout,straight,style,surface,tip,truncate,unbranched,vein,venation,vine,white,x,â7	0.1,1.5â3,1â1.2,1â1.5,2-lobe,2.5â20,3.5â7,3.5â8,4â8,5-merous,6-10,<,accrescent,acute,alyx,apar,apicall,axe,berry,blade,c.,capitate,ciliate,climbing,eaf,eed,flavor,fleshy,fragrant,fruiting,glabrou,groun,heavy,juicy,lanceolate,long,m.,membranous,narrowly,nflorescence,nternode,orolla,perfec,plurifoliat,ruit,scent,somewhat,stellate,stigma,strongly,swee,sweet,tamen,tem,terrestrial,truncate-acuminat,tube,unit,vary,wider,ympodial	abaxial,adaxial,apart,arrangement,branching,characteristic,colour,corolla,form,green,greyish,growth,height,hirsute,history,inflorescence,length,life,midvein,na,ovary,perennial,plant,pseudostipule,seed,shape,staman,stem,tertiary,texture,unarmed
279	wfo-0001029089	success	177	115	85	92	30	0.48	.75,0.1-0.25,0.8-1,1,1-1.5,1.5-2,1.5-6,4.5-5,5-20-flowered,5-9,6-7,8-9,abrupt,acute,anther,apex,apiculate,base,beneath,berry,branched,calyx,caniculate,cm,corolla,covered,dark,decurrent,deflexed,densely,dia,drying,elliptic,filament,flattened-reniform,furcate,glabrous,globose,golden,green,incrassate,leaf,lobe,long,margin,material,minutely,mm,occasionally,ovary,pair,papillose,pedicel,persistent,petiole,pinkish,pitted,primary,pubescent,purplish,resinous,rounded,rounded-deltoid,secretion,shiny,shrub,simple,slightly,small,somewhat,stem,straight,style,surface,tan,tapering,tip,tree,tube,uniseriate,usually,vein,white,widening,x	.5,/4,0.5-0.6,0.5-1,0.8-1.2,1/2,10-25,2.5-3.5,5-10,5-6,along,anthesi,apart,axil,ba,bark,beginning,bilobed,bud,campanulate,closely,completely,covering,cracking,differing,difoliate,eaf,edicel,eed,either,enclosed,entire,erect,expand,exserted,free,fruiting,geminat,glabrou,impressed,inflorescenc,lamina,later,lateral,like,lobed,lon,lower,main,major,member,middle,minor,nflorescence,obovoid,older,one,opposite,otherwise,overlapping,papillo,part,peeling,planar,pore,poricidal,portion,prominent,reddish-grey,resinou,ruit,scar,shaped,size,smooth,spaced,stigma,still,tall,tear-drop,trichome,tub,ud,underside,unit,varnish,varnished,way,widest,woody,ympodial,young	abaxial,adaxial,alternate,arrangement,branching,characteristic,colour,diameter,form,fruit,growth,height,history,inflorescence,length,life,midvein,na,peduncle,perennial,plant,pseudostipule,rachi,seed,shape,staman,tertiary,texture,unarmed,venation
280	wfo-0001029091	success	212	111	79	133	32	0.373	-4,-4.5,1-2,1.5-,1.5-2,10,170-210,2-2.5,2-3,2.5-,3-4,4,7-8,acuminate,acute,age,anther,apex,articulation,base,berry,blunt,bluntly,broadly,buff,calyx,cm,colour,corolla,cuneate,cyme,downward,elliptic,filament,flower,flushed,grey,intense,irregular,larger,leaf,light,line,lobe,long,may,minutely,mm,ochre-yellow,ovate,overlain,pale,pattern,pedicel,peduncle,petiolate,petiole,pubescent,rachi,raised,reddish-purple,relatively,reticulate-concentric,ridge,ridged,shortly,shrub,sigmoid,slender,slightly,soft-wooded,speckled,stem,straggly,style,surface,transverse,triangular,violet-purple	-1,-15,0.3-,0.5-0.8,0.5-1,1,1-10,10-20,10-toothed,15-40,2-12,20-30,3,3-,3-11-lobed,46/1,5,5-7,635/1,appearing,aromatic,articulated,aspect,axil,ba,becoming,brownish,campanulate,capitate,cell,clonal,close,common,conspicuous,cut,dark,deeply,develop,developed,dia,discoidal,eed,effect,ellipsoid,emarginated,erect,exceeding,exerted,flattened,floral,fork,forked,fresh,fruiting,general,giving,glandular,globose,globular,gree,growing,hair,half,interacuminal,irregularly,juvenile,lacking,lasting,later,lateral,lavende,lavender,lengthening,linear,linear-lanceolate,long-triangular,lower,mid-vein,mineral,narrowly,nflorescence,oblong,obovate,obscure,occasionally,ovoid,ower,pedicellate,pentagonal,petiol,plurifoliat,point,pore,poricidal,readily,rh,ripe,rounded,ruit,scarcely,separate,several,shallowly,shed,simple,sinus,slit,soft,soon,sparsely,stellate-rotate,stigma,stone,subulate,succulent,swollen,tall,tip,tissue,toward,tub,ud,unit,upper,usually,violet,well,winged,without,woody,x,year,ympodial	abaxial,adaxial,arrangement,branching,characteristic,diameter,form,fruit,green,growth,height,history,inflorescence,length,life,margin,midvein,na,ovary,perennial,plant,plurifoliate,primary,pseudostipule,seed,shape,staman,tertiary,texture,unarmed,vein,venation
281	wfo-0001029101	success	233	135	113	120	22	0.485	-3,.5,0-2,0-20,0-5,0-8,0.4-1.5,0.5-1,00-200,1,1-1.5,1-3,1.3-2,1.5-2.5,1.8-3,10-14,10-20,2-6,2.5-3.5,2.5-6,2.8-3.3,3-4,30-100,5-6,5-7,5.5-8,abaxial,adaxial,anther,apex,apparently,articulated,base,berry,branched,brown-green,calyx,cell,chartaceous,cm,concolorous,cream,cuneate,dark,deltate,diameter,discolorous,drying,dull,elliptic,erect,filament,flattened-reniform,fruit,glabrescent,glabrous,green,infructescence,lateral,leaf,length,lobe,lobed,long,long-styled,margin,marking,maturity,mauve,midvein,mm,moderately,obovate,obtuse,orange-brown,outline,ovate,pair,pale,pedicel,peduncle,per,petiole,pit,plant,prickle,prickly,primary,raised,rarely,rounded,short-styled,shrub,simple,small,smooth,sometimes,sparsely,spherical,stellate-pubescent,stem,straight,style,surface,tertiary,vein,venation,visible,wide,yellow,yellow-green,yellow-orange,young	-15,/3,/4,0-100,0.1,0.1-0.4,0.1-0.5,0.1-0.7,0.1-1,0.2,0.7-,0.8-3.5,1-4,1-8,1.3-2.6,1.4-2.2,1.5-2,1.7,1/5-1/4,2-,2-20,2/3-3/4,3-,3-10,3-7,4-12,4-7,5-,5-20,5-8,5-9,5-merous,6-8,7-13,8-15,abaxially,acute,almost,always,alyx,andromonoecious,apar,apart,apically,bark,blade,broad-deltate,connivent,darker,distal,distance,eaf,eed,elongating,equal,extending,flattened,flower,free,fruiting,green-brow,hermaphrodite,heterostylous,lengt,like,lon,longer,lower,lowermost,mature,midpoint,multangulate,narrow-deltate,nflorescence,oblong,often,older,one,open,orolla,oung,pendulous,pericarp,plurifoliat,poricidal,porrect,portion,present,prickl,ray,reduced,reflexed,rounde,ruit,scar,secondary,sessile,side,spaced,spreading,stalk,stalked,staminat,stellate,suborbicular,tamen,tapering,terete,thick,time,tip,trichome,tube,unit,variously,vary,way,well-developed,woody,ympodial	arrangement,branching,characteristic,colour,corolla,form,growth,height,history,inflorescence,life,na,ovary,perennial,plurifoliate,pseudostipule,rachi,seed,shape,staman,texture,unarmed
282	wfo-0001029106	success	200	119	94	106	25	0.47	.5,0-10,0-2,0-20,0-5,0-6,0.2-1,0.25-0.7,0.5-0.9,1.5-2,2-4,2-8,3-3.5,3-4,acute,anther,apex,apically,apparently,articulated,base,berry,branched,calyx,cell,cm,concolorous,cuneate,deltate,densely,diameter,discolorous,drying,elliptic,erect,eye,filament,fruit,glabrescent,glabrous,lateral,leaf,length,lobe,lobed,long,lower,margin,maturity,mauve,membranous,midvein,mm,naked,obtuse,orange,orange-brown,orbicular,outline,ovate,pair,pale,pedicel,peduncle,per,petiole,pit,prickle,prickly,primary,raised,red,rounded,shiny,shrub,simple,small,smooth,sometimes,sparsely,spherical,stellate-pubescent,stem,style,subentire,surface,tertiary,vein,venation,visible,weakly,white,yellow-orange,yellowish-green	-6,.1,/3,0,0-0.3,0.1,0.2-0.4,0.5,0.5-0.8,0.5-1,0.5-2.5,0.9-1.2,1-1.6,1-2,1-5,1.5-1.8,1.5-3.5,1/4,1/5-1/4,2-3.5,2-5.5,2-6,2.2-3,2/,3-25,4-6,4-8,5-14,5-8,5-merous,6-8,abaxially,acuminat,alyx,ame,apar,apart,appearing,bark,blade,c.,curved,distance,eaf,eed,elongating,equal,extending,flattened,flattened-reniform,flower,free,fruiting,gently,infructescence,light,lon,longer,mature,midpoint,nflorescence,older,one,open,orange-brow,orolla,oung,pendulous,perfec,pericarp,plurifoliat,poricidal,porrect,portion,prickl,ray,reflexed,scandent,scar,sessile,shallow,shorter,side,size,slender,spaced,spreading,stalk,stalked,stellate,straight,tamen,tapering,terete,time,tip,trichome,tube,uit,unit,variously,vary,way,wide,woody,ympodial	2/3,abaxial,acuminate,adaxial,arrangement,branching,characteristic,colour,corolla,form,growth,height,history,inflorescence,life,na,ovary,plant,pseudostipule,rachi,seed,shape,staman,texture,unarmed
283	wfo-0001029112	success	190	91	60	130	31	0.316	0.9-1.7,1-2,1.4-2.5,10-21,2-3.5,2.6-3,2.7-5.7,20,3-7,3.5-4.5,3.5-7,5,5-8,acuminate,anther,apex,base,berry,brownish,cm,condition,conical,corolla,densely,diameter,drying,elliptic-lanceolate,filament,fresh,fruit,glabrous,green,greenish,herb,leaf,light,lobe,margin,minute,mm,mottled,mucilaginous,obtuse,odd-pinnate,ovate,ovoid,pale,pedicel,peduncle,petiole,plant,pubescent,purple,ripe,seed,slightly,style,violet,wet,whitish	0-2,0.5,1-10,1-3,1-4,1.5-1.8,1.5-2,10-17,2.5-4.5,2.7-3.5,2.7-4.2,3-4,3-5,3-6,5-merou,6.5-5.5,9.5-13,abaxially,acumen,adaxially,ag,along,alyx,apart,apparently,arranged,articulated,axe,axillary,bead,blade,bud,capitat,cell,chartaceous,ciliate,connivent,covering,decreasing,digestion,distal,dorsally,eaf,edge,eed,enzyme,equal,especially,exceeding,flat,flower,folded,forked,geminat,generally,glabrou,gradually,green-white,hair,hair-like,half,homostylous,honeycomb-shaped,interjected,lanceolate,larger,lateral,leaflet,lengthening,like,living,long,lower,make,middle,moniliform,multiple,narrow,necklace,nflorescence,orolla,pair,perfect,petiolule,plurifoliate,pore,poricidal,present,pubescen,ray,removed,rotate,ruit,secondary,semierec,seudostipule,size,slit,spaced,specimen,stamen,ste,stigma,stolon,subequal,subtending,symmetrical,tall,tamen,tem,terminal,testal,thick,thir,throughout,tip,toward,tri-,tube,tuber,typically,unit,usually,vary,wall,wide,wing,x,yellow,ympodial	abaxial,adaxial,arrangement,branching,calyx,characteristic,colour,form,growth,height,history,inflorescence,length,life,midvein,na,ovary,perennial,primary,pseudostipule,rachi,shape,staman,stem,surface,tertiary,texture,unarmed,vein,venation,width
284	wfo-0001029120	success	168	106	79	89	27	0.47	.5,0.1-0.5,0.7-1,1-1.5,1.1-1.5,1.1-2,2.5-3.5,3-3.5,5-10-flowered,5-8,6-8,abrupt,acuminate,acute,anther,apex,basal,base,beneath,bud,calyx,cm,corolla,dark,decurrent,deflexed,densely,dia,erose,especially,f,filament,fleshy,glabrous,golden,greenish-brown,hirsute,infloresence,larger,later,leaf,lobe,long,long-triangular,margin,mm,narrowly,ovary,ovate,pair,pale,pedicel,peduncle,petaloid,petiole,prominently,pubescent,raised,rest,shrub,simple,slightly,sparsely,stem,straight,style,surface,tapering,trichome,tube,unbranched,unifoliate,uniseriate,vein,venation,white,widening,yellow,yellow-green	.05,.75,/2,0.5-1.5,2.6-7,6.5-16.5,8511,anthesi,apart,bark,beginning,black,bullate,cell,difoliate,dry,drying,eaf,edicel,eed,epidermi,evenly,fide,free,geminat,globose,inflorescenc,internodal,know,known,lanceolate,large,lateral,lehmann,like,lobed,lon,lower,main,middle,midrib,minor,minutely,narrow,narrower,nearly,nflorescence,occasionally,often,older,opposite,outer,paler,papillose,peduncl,point,pore,poricidal,portion,present,proximal,reproductive,ruit,scar,scattered,shaped,slender,spaced,specimen,speckle,stigma,sympodial,tall,tear-drop,terminal,thickened,tip,tub,ud,unit,upper,urceolate,way,white-papillo,wide,widest,x,ympodial,young	abaxial,adaxial,arrangement,branching,characteristic,colour,diameter,form,fruit,growth,height,history,inflorescence,length,life,midvein,na,plant,primary,pseudostipule,rachi,seed,shape,staman,tertiary,texture,unarmed
285	wfo-0001029121	success	161	107	73	88	34	0.453	0-2,0.2-2,1-4,1-5,1.1-3.9,15-30,2-10,2-13,2-3,2-3-celled,3.8-11,4-10,4-5.5,5-8,acuminate,acute,apex,base,blue,branched,calyx,cell,cm,conical,corolla,covering,cuneate,cyme,deep,diameter,dichasial,dichasially,ebracteate,elliptical,filament,glabrous,green,green-white,hair,hair-like,herbaceous,lateral,leaf,lobe,long,medium,mm,monochasial,mucilaginous,narrowly,oblique,obtuse,odd-pinnate,ovate,ovoid,pedicel,peduncle,perennial,petiole,plant,purple,rounded,scattered,seed,short,short-attenuate,straight,style,testal,thick,tip,tuber-bearing,wall	-6,0,1.2-2.5,1.2-3.3,10,2-,3-5,3-6-foliat,3.6-9,4.5-10.0,5-20,8-16,9-33,abaxiall,abaxially,acumen,adaxially,apical,apically,articulate,attenuate,commonly,connate,dehiscent,digestion,diminishing,distal,dorsally,eaf,edge,eed,emoval,enzyme,exceeding,flat,flower,folded,forked,generally,globo,gradually,half,honeycomb,interjected,introrse,leaflet,living,lon,lower,lunat,make,maturing,nflorescence,nther,often,orolla,pair,pattern,perfect,petiolule,plan,poricidally,proximal,rarely,reveal,rotate,ruit,sessile,seudostipule,size,slit,specimen,stamen,stigma,subequal,tal,tem,terminal,throughou,throughout,toward,typically,unit,vary,wide,yellow,ympodial,Â¼	abaxial,adaxial,anther,arrangement,branching,characteristic,colour,form,fruit,growth,height,hirsute,history,inflorescence,length,life,lunate,margin,midvein,na,ovary,primary,pseudostipule,rachi,shape,staman,stem,surface,tertiary,texture,unarmed,vein,venation,wet
286	wfo-0001029125	success	197	121	87	110	34	0.442	.1,.2,6,abaxial,abaxially,acuminate,acute,adaxial,adaxially,anther,anthesi,apex,appressed,articulated,attenuate,base,berry,black,branching,brownish,calyx,central,cm,concave-reniform,corolla,cuneate,deltate,densely,diameter,end,entire,filament,flower,fruit,glabrous,globose,green,herb,internodal,lateral,leaf,lobe,long,lower,margin,maturity,mm,narrower,oblique,occasionally,one,orange,ovary,ovate-lanceolate,pair,pedicel,peduncle,per,petiole,plant,primary,pubescent,purple,purple-tinged,purplish,ripe,seed,simple,slightly,small,sparsely,spreading,star,stem,straight,style,subshrub,surface,trichome,turning,unequal,uniseriate,vein,white,wide,yellow,Â¼	.0â3.5,.1â1.4,.4,.5â2.0,.6,0.5,0.5â0.6,0.5â1.0,0.8â0.9,0.9,1,1.0â1.2,1.0â1.5,1.0â4.0,1.5â2.0,1.5â3.0,1.7-,1.8â3.5,1â2-celled,2.5â12.0,2/3,20â100,2â3-celled,2â4,3.0â3.4,3.5â4,35â45,3â5,3â5-celled,4â8,5-merous,5â6,6â7,age,along,apar,apparently,arising,ba,beyond,cell,closely,cone,conical,delicate,difoliate,eaf,eed,ellipsoid,especially,exerted,free,fruiting,geminat,growt,hilum,later,lengthening,like,live,lobed,lon,maximum,minutely,nearly,nflorescence,often,outline,pale,papillate,pentagonal,perfect,place,pore,poricidal,portion,positioned,reflexe,reflexed,ridged,ruit,scar,scattered,shiny,shorter,single,slit,spaced,stellate,stemmed,stigma,stone,strongly,sub-lateral,tall,tem,terete,testal,tinged,tip,toward,traingular,tube,ud,unit,usually,whitewith,woody,ympodial,young	0.5-0.6,0.5-1.0,1-2-celled,1.0-1.2,1.0-1.5,1.5-2.0,1.7-3.4,2-3-celled,2-4,20-100,3-5,3.5-4,35-45,4-8,5-6,arrangement,characteristic,colour,form,growth,height,history,inflorescence,length,life,midvein,na,pseudostipule,rachi,shape,staman,texture,triangular,unarmed
287	wfo-0001029150	success	177	106	70	107	36	0.395	.5,0.3,0.3-0.5,0.8-1,1.5,15,3-5,6,acute,adaxially,anther,apex,apiculate,base,branched,calyx,cm,conical,diameter,ellipsoidal,elliptical,enlarged,entire,filament,flattened,flower,fruit,glabrous,larger,leaf,light,lobe,margin,midvein,minutely,mm,moderately,oblique,ovate,pair,pedicel,peduncle,petiole,pinnate,pubescent,rachi,rarely,rounded,rounded-deltoid,rugose,sand-punctate,shortly,simple,slender,slightly,sparsely,stem,style,surface,tan,teardrop-shaped,thick,tip,truncate,vein,venation,vine,white,woody,x	0.3â0.5,0.5â1.1,0.8â1,0.8â1.5,0.8â3.5,1.2â1.5,1.5â2,1.5â2.2,1â1.5,1â11,1â2,1â5,1â6,2.5â3,2.5â5,2.5â8,2â10,2â2.5,2â3,3â10,3â4,3â50,5-merous,7â8,8-shaped,9â12,abaxially,accrescent,across,adaxiall,alyx,apar,apicall,apically,attenuate,axe,berry,blade,c.,canopy,capitat,ciliate,climbing,color,cros,cylindrical,delicate,distant,dried,eaf,eed,except,extra-axillary,fleshy,flush,fruiting,glabrou,inconspicuous,lamina,lanceolate,living,lon,long,lower,m.,material,membranaceous,mor,nearly,nflorescence,nternode,older,opposed,orolla,pale,perfec,pinkish-white,plurifoliat,pointed,reaching,ruit,scar,secondary,section,side,small,somewhat,spaced,specimen,stellate,stigma,strong,tamen,tem,thickened,time,translucent,tree,trichome,tube,understory,unit,vary,vegetation,wide,wiry,ympodial	0.5-1.1,1-1.5,1-5,1.2-1.5,2-10,2.5-3,2.5-5,3,3-10,3-4,9-12,abaxial,adaxial,arrangement,branching,characteristic,colour,corolla,form,growth,height,history,inflorescence,length,life,na,ovary,plant,primary,pseudostipule,seed,shape,staman,tertiary,texture,unarmed
288	wfo-0001029152	success	197	103	76	121	27	0.386	0.5-1,0.8-1,0.9-1.3,1,1-1.5,1-4,1.1-1.3,1.5-2,2-2.5,2-5,2.5-3,3-8-flowered,6-8,acuminate,acute,anther,apex,attenuate,base,berry,brown,calyx,cm,corolla,cuneate,dark,deep,deltoid,densely,elliptic,filament,floccose,fruit,glabrous,globose,green,greyish-red,inflorescence,keeled,leaf,lightly,lobe,long,margin,minutely,mm,obovate,ovary,ovoid-reniform,pair,pale,pedicel,petiole,pitted,plane,plant,prominently,red,reddish,reddish-floccose,shape,shrub,simple,single,slender,small,stem,style,surface,tapering,tree,tube,vein,white,winged,x	.1,.5,0.25-0.5,0.75-1,1-2,1-3,1.5-1.7,2-3,2-4,3-5,4-6,61-25,8.5-16,anthesi,appearanc,appearing,appressed,area,ba,bark,beginning,beneath,blade,branch,broadened,broadly,bud,citronella,closely,completely,conical,corky,deciduous,decurrent,deflexed,dia,differing,difoliate,distal,dry,eaf,edicel,eed,ellipsoi,enclosing,erect,et,exsertion,fide,flattened,flower,fragrance,free,fruiting,geminat,giving,held,hyaline,inflorescenc,large-lenticellate,late,lateral,live,lobed,lon,long-styled,longer,lower,main,major,material,middle,midrib,minor,nearly,nflorescence,often,older,one,opposite,overlapping,papillose,per,planar,pore,poricidal,portion,prominent,quite,red-floccose,reflexed,reminiscent,rounded,ruit,scar,shaped,shiny,short-styled,size,slightly,somewhat,soon,spaced,stigma,straight,styl,tall,tear-drop,terminal,third,tillett,tip,trichome,ud,unit,usually,weak,widest,woody,ympodial,young	1.5-4-6,abaxial,adaxial,arrangement,branching,characteristic,colour,diameter,form,growth,height,history,length,life,midvein,na,peduncle,perennial,primary,pseudostipule,rachi,seed,staman,tertiary,texture,unarmed,venation
289	wfo-0001029156	success	65	60	22	43	38	0.338	1.5-2,6,6-8,apex,cm,diameter,glabrous,growth,liana,margin,minutely,mm,pale,pedicel,pitted,seed,shiny,stem,surface,tan,vine,woody	-3,0.5,1,10-12,2,4-6,<,almost,apparently,bark,berry,cell,center,completely,deeply,eed,epiphytic,exfoliating,fide,flattened,fruiting,golden,lateral,long,markedly,minute,multiseriate,nee,new,noddin,occasionally,older,per,rectangular,reniform,rib-like,shreddy,sinuate,testal,thickening,trichome,wall,wide	abaxial,adaxial,anther,arrangement,base,branching,calyx,characteristic,colour,corolla,filament,form,fruit,height,history,inflorescence,leaf,length,life,lobe,midvein,na,nodding,ovary,peduncle,petiole,plant,primary,pseudostipule,rachi,shape,staman,style,tertiary,texture,unarmed,vein,venation
290	wfo-0001029156	success	65	62	23	42	39	0.354	1.5-2,4-6,6-8,apex,cm,diameter,glabrous,growth,liana,margin,minutely,mm,pale,pedicel,pitted,seed,shiny,stem,surface,tan,vine,woody,x	-3,0.5,1,10-12,2,<,almost,apparently,ark,berry,cell,center,completely,deeply,eed,em,epiphytic,exfoliating,fide,flattened,fruiting,golden,lateral,lon,markedly,minute,multiseriate,nee,new,noddin,occasionally,older,per,rectangular,reniform,rib-like,shreddy,sinuate,testal,thickening,trichome,wall	6,abaxial,adaxial,anther,arrangement,base,branching,calyx,characteristic,colour,corolla,filament,form,fruit,height,history,inflorescence,leaf,length,life,lobe,midvein,na,nodding,ovary,peduncle,petiole,plant,primary,pseudostipule,rachi,shape,staman,style,tertiary,texture,unarmed,vein,venation
291	wfo-0001029163	success	149	104	75	74	29	0.503	0.3-2.5,0.5-1,1,1.5-2.5,1.5-3,10-,2,2-18,2-6,2.5-3,20-30,3-14,3-4,5-8,7-9,abaxial,acuminate,acute,apart,apex,articulated,base,calyx,chartaceous,cm,cuneate,decurrent,deltate,densely,diameter,distally,elliptic,elliptic-ovate,entire,fruit,glabrous,globose,herb,leaving,lenticular,lobe,long,margin,mm,moderately,narrowed,nearly,obtuse,pedicel,pedicellar,peduncle,perennial,petiole,pseudohair,puberulent,puberulent-pubescent,purple,rachi,remnant,shrub,simple,slightly,spaced,sparsely,stem,style,surface,thickened,tip,unbranched,unknown,vein,white,whitish,x	-25,-4,-9,1-2,1.5-2,13-18,2-3,2-7,3-5,4-20,4-5-foliat,4-6,4.5-23,5-12,9-15,abaxially,absen,adaxiall,adaxially,aggregate,axe,band,blade,cell,color,connivent,cylindrical,denser,directed,distall,eaf,eed,eglandular,flower,free,glandular,hair,lanceolate,like,lon,lower,narrowly,nflorescence,nther,orolla,papillose,pore,projection,puberulent-pubescen,pubescence,radiu,ripe,roughened,ruit,scale-like,small,sometimes,stalked,stellate,stigma,stone,subapical,subcoriaceous,tal,tem,time,triangular,truncat,tube,unit,vary,wide,yellow,ympodial	adaxial,anther,arrangement,branching,characteristic,colour,corolla,filament,form,growth,height,history,inflorescence,leaf,length,life,midvein,na,ovary,plant,primary,pseudostipule,seed,shape,staman,tertiary,texture,unarmed,venation
292	wfo-0001029171	success	137	98	64	73	34	0.467	-10,0.5,1-3,1-4.5,1-5,1.5-2,10-25,11-20,2-3,3-4,3.5-6.5,4-5,5-6,5-8,7-9,acuminate,acute,angled,apex,articulated,base,branched,calyx,chartaceous,cm,cuneate,decurrent,deltate,densely,diameter,elliptic,entire,forked,fruit,glabrous,globose,hair,lobe,margin,mm,moderately,obtuse,orange,ovate-elliptic,pedicel,peduncle,petiole,puberulent,pubescent,purple,rachi,rarely,red,ripe,rugose,shrub,simple,slightly,smooth,sometimes,style,unbranched,white,x	-,-15,1.5-7.5,10-35,3.5-18,4-10,6-,8-17,abaxially,abruptly,absen,adaxially,aggregate,also,and/or,apart,axe,ba,blade,cell,connivent,cylindrical,dendritically,dense,directed,distall,eaf,eed,eglandular,except,flower,gland,glandula,glandular,lanceolate,like,long,lower,many-foliat,midrib,narrowed,narrowly,near,nearly,nflorescence,nther,often,orolla,perfect,pore,radiu,ruit,shoot,short-stalked,spaced,sparsely,ste,stellate,stigma,stone,tal,tem,time,tip,triangular,truncat,tube,unit,usually,vary,wide,yellow,ympodial	abaxial,adaxial,anther,arrangement,branching,characteristic,colour,corolla,filament,form,growth,height,history,inflorescence,leaf,length,life,midvein,na,ovary,perennial,plant,primary,pseudostipule,seed,shape,staman,stem,surface,tertiary,texture,unarmed,vein,venation
293	wfo-0001029215	success	49	59	19	30	40	0.388	0.3-0.5,0.5-2.5,1,2.3-2.9,brown,calyx,cm,diameter,elongating,fruit,hair-like,herb,lobe,markedly,mm,outgrowth,pubescent,shrub,surface	-1.8-2.3,.2,0.5-0.7,appearance,border,cell,coarse,eed,entire,fide,give,lateral,long,narrowly,obovate,round,silky,small,smelling,spreadin,strong,tall,testa,thick,wall,weigend,wide,winged,woody,xyledecor	abaxial,adaxial,anther,apex,arrangement,base,branching,characteristic,colour,corolla,filament,form,growth,height,history,inflorescence,leaf,length,life,margin,midvein,na,ovary,pedicel,peduncle,petiole,plant,primary,pseudostipule,rachi,seed,shape,staman,stem,style,tertiary,texture,unarmed,vein,venation
294	wfo-0001029216	success	243	120	98	145	22	0.403	+,0.4-0.5,0.5,0.6-1,1-1.2,1-2,1.2-6,10-14,2,2-locular,2.5-3.3,3,4,absent,acute,and/or,annual,anther,apex,articulated,attenuate,base,basiscopically,biennial,branch,bright,brown,calyx,cell,cm,conical,corolla,crenate,decurrent,deep,dentate,diameter,distal,elliptic,filament,fruit,glandular,globose,green,hair-like,herb,imparipinnate,inflorescence,interrupted,lateral,length,less,like,linear,lobe,long,mainly,margin,maturity,minute,minutely,mm,multilocular,near,oblique,obovate,often,orange,outgrowth,ovary,ovate,pale,pedicel,peduncle,perennial,petiole,plant,primary,pseudostipule,pubescent,rarely,red,shape,short,simple,sparsely,stem,style,surface,tertiary,testa,trichome,uniseriate,usually,varying,villous,wall,yellow	-0.5,-10,-5,.5,.8-1,0.1-0.3,0.1-0.5,0.1-0.6,0.1-0.8,0.2-0.25,0.2-0.3,0.2-0.4,0.2-0.8,0.3-0.4,0.3-0.5,0.3-2,0.4,0.5-0.8,0.5-1.5,0.5-2,0.6-0.8,0.8-2.5,1-3,1-4,1-6,1.5-2.3,1.5-2.5,1.5-3,1/,10,10-,2-4.5,20-35,3-,3-4,3-5,3-7,3-foliate,5,5-15-flower,6-10,7-10,<,absen,accrescent,acroscopically,adpressed,allogamous,always,angeld,anthesi,apical,appearance,appendage,articulation,axi,basal,becoming,capitate,cente,column,composed,cone,cordate,cultivar,deeply,eaf,edicel,eed,entire,erect,exserted,extending,facultatively,fasciated,fruited,fruiting,giving,glabrescent,gland-tipped,gree,half,halfway,included,initially,interjected,internode,lanceolate,large,larger,later,leaflet,lobulate,lon,longer,lower,mixture,multicellular,narrowly,nflorescence,numerous,one,pair,particularly,pentagonal,petiolule,population,present,procumbent,reflexe,ruit,scen,secondary,sessile,shaggy,shaped,silky,sometimes,somewhat,sparse,spreading,staminal,sterile,stigma,straight,strong,strongly,tangled,tem,terminal,thick,thickening,tip,total,toward,truncate,tube,ud,unicellular,unit,variety,viny,wide,winged,ympodial	1/3,abaxial,adaxial,arrangement,branching,characteristic,colour,form,growth,height,history,leaf,life,midvein,na,rachi,seed,staman,texture,unarmed,vein,venation
295	wfo-0001029226	success	206	106	80	126	26	0.388	-9,.5,0-1,1-1.5,1-3,2-6,3-3.5,5-7,7-11,8-13,acuminate,acute,anther,apex,base,berry,branched,bright,calyx,cm,cordate,corolla,deltate,diameter,enation,entire,filament,flattened,glabrous,globose,green,growth,herbaceous,lateral,lavender,leaf,lobe,lobed,lyrate,many,margin,mere,minutely,mm,occasionally,open,pair,pale,papillate,pedicel,peduncle,petiole,pinnatifid,pitted,primary,pubescent,red,reniform,rim,seed,short-glandular,shrub,simple,stem,style,surface,tan,terminal,time,tip,translucent,trichome,truncate,uniformly,uniseriate,vein,vine,weak,white,yellowish	-7,.75,0.5,0.5-5,1-2,1-celled,10-40+,2,2-3,2-9,2.5-10,3-6,30,4,4-6,5-merou,>,ag,alyx,anthesi,apart,apparently,ark,articulated,ba,basal,black,blue,breaking,capitate,cell,completely,congested,conical,connivent,dark,decurrent,densely,distall,divided,dry,eaf,eed,ellipsoid,elongate,exserted,flexuous,flower,free,fruiting,glabrescent,gland,glandular,hairy,ilament,irregularly,juice,lengthening,like,long,longer,loosely,lower,material,mature,membranous,minute,new,nflorescence,often,older,one,orolla,overtopping,papillat,papillo,per,perfect,pinnate,plurifoliat,pore,poricidal,portion,reflexed,remainin,ripe,ruit,sagittate,scar,scarlet,shiny,shorter,sleeve,slender,slit,small,sometimes,spaced,sparsely,spot,sprawling,spreadin,spreading,staining,stellate,stigma,strongly,tangled,tem,testal,thin,third,tube,twinin,ud,unit,usually,vary,wall,way,wide,widest,winged,woody,ympodial,Â¾	abaxial,adaxial,arrangement,branching,characteristic,colour,form,fruit,height,history,inflorescence,length,life,midvein,na,ovary,perennial,plant,pseudostipule,rachi,shape,staman,tertiary,texture,unarmed,venation
296	wfo-0001029236	success	159	110	84	75	26	0.528	.5,0.2-1,0.45-0.5,1-1.5,1-2,1.4-1.7,3,absent,adaxial,anther,anthesi,apex,apically,appearing,base,berry,branching,broadly,calyx,cm,completely,corolla,deflexed,deltate,dendritic,densely,diameter,dichasial,elliptic,filament,flattened,fleshy,fruit,glabrous,globose,grey-brown,growth,lateral,leaf,lenticular,less,lobe,margin,middle,midvein,minutely,mm,narrowly,near,nodding,obscure,occasionally,ovary,overtopping,pale,pedicel,per,pericarp,petiole,pitted,pointed,pubescent,purplish-black,reddish-brown,revolute,scattered,shiny,shoot,short,shrub,simple,slightly,sparsely,stem,strongly,style,surface,terminal,thin,trichome,usually,venation,violet,x	0.2-0.7,0.5,0.5-1.5,0.9-2.3,1/2,2-4,2-5,6-9,abaxially,age,apical,apparently,axi,ba,bark,basal,becoming,bi-lobe,branch,branchlet,compact,conical,coriaceous,cupulate,decurrent,eaf,edicel,eed,erect,ew,except,exserted,flower,free,fruiting,inserted,later,lobed,long,lower,m.,many,nflorescence,obscurely,older,packe,persistent,plurifoliate,pore,poricidal,portion,prominent,purplish,ruit,scar,secondary,sleeve,slit-like,stamen,stigma,tall,tapering,time,tip,trongly,tub,tube,ud,unit,way,wide,winged,woody,ympodial,young	abaxial,alternate,arrangement,characteristic,colour,decument,form,height,history,inflorescence,length,life,na,peduncle,perennial,plant,primary,pseudostipule,rachi,seed,shape,staman,tertiary,texture,unarmed,vein
297	wfo-0001029246	success	209	113	91	118	22	0.435	-1,-1.5,-4,0,0-15,0-5,0.1-0.4,0.7-1.3,0.7-2,0.8-1.1,0.9-1.3,1-1.5,1.5-2.3,1/3,2,2-3,2.8-4,3.5-5,4-6,5-20,7-12,abaxial,acuminate,acute,adaxial,anther,apex,apically,apparently,base,berry,calyx,chartaceous,cm,cuneate,deltate,diameter,dull,elliptic,entire,eye,filament,fruit,glabrous,lateral,leaf,length,less,lobe,lobed,lower,margin,maturity,mauve,midvein,mm,moderately,naked,obtuse,orange-brown,orange-red,pair,pale,pedicel,peduncle,per,petiole,prickle,primary,pubescent,purple,shrub,simple,sometimes,sparsely,spherical,stellate-pubescent,stem,style,surface,tertiary,unarmed,unbranched,upper,usually,vein,venation,visible,white,yellow,yellow-orange	/5,0.1-0.3,0.15-0.3,0.2-1.5,0.3-0.5,0.3-0.8,0.5,0.5-1.5,0.7-1.5,0.8-3,1-1.8,1-10,1-3,1-4,1-5,1-8,1.2-2,1.5-2.5,1.5-6,1.7-6,1.8-3,1/10-1/5,2-3.5,2-5,2.5-3.2,2/3,2/3-3/,3-20,3-5,5-,5-merous,6-10,6-8,8-16,abaxially,acuminat,almost,alyx,apar,apart,articulated,bark,blade,broad-deltate,c.,concolorous,connivent,curved,densely,discolorous,distance,drying,eaf,eed,elongating,equal,erect,extending,flattened,flattened-reniform,flower,free,fruiting,glabrescent,infructescence,lon,long,longer,mature,midpoint,narrow-deltate,narrow-ovate,nflorescence,oblong,older,one,open,orange-brow,orolla,oung,pendulous,perfec,pericarp,plurifoliat,poricidal,porrect,portion,prickl,prickly,procumbent,ray,recurved,rounded,ruit,scar,sessile,side,smooth,spaced,spreading,stellate,stout,straight,strongly,tamen,tapering,terete,time,tip,trichome,tube,unit,vary,way,wide,woody,ympodial,Â¼	2/3-3/4,arrangement,branching,characteristic,colour,corolla,form,growth,height,history,inflorescence,life,na,ovary,perennial,plant,rachi,seed,shape,staman,texture,ye
298	wfo-0001029286	success	224	103	82	142	21	0.366	.5,1-1.5,1-2,1.5-2,1.5-4,1/8,2-3,2.5-3,4-5,4-6,4.5-7,5-6,6-9,7-10,abaxial,abaxially,acute,adaxially,anther,anthesi,apex,apically,apiculate,attenuate,base,branching,broadly,brown,canaliculate,chartaceous,clustered,cm,conical,corolla,cuspidate,deltoid,diameter,dilated,drying,entire,faint,filament,flat,glabrous,green,grey,known,leaf,length,less,liana,light,lilac,lobe,margin,mauve,membranous,midvein,mm,oblong,obovate,pair,pedicel,peduncle,petiole,primary,rachi,raised,rounded,slender,sparsely,stem,style,surface,terminal,tertiary,time,unarmed,vein,venation,x,yellowish	.4,0-0.5,0.1,0.15-0.4,0.4-1.2,0.6-1.2,0.8,0Â°,1.5-8,15-50,3-4,4.5,5,6-8,abscising,age,almost,along,altered,alyx,another,apar,apart,apice,apparently,arising,around,articulated,articulation,axil,bark,becoming,branch,branched,capitate,clearly,closer,concave,concolorous,crenulate,curved,delineated,dendritic,density,distributed,domatia,eaf,eed,equal,except,extending,fertilization,flexuous,flower,formed,forming,free,fresh,glabrescent,globo,hair,increasing,inflorescenc,inside,isolated,junction,know,lamina,lengthening,lobed,long,lower,m.,main,margi,mas,meeting,middle,minutely,much,multicellular,narrowly,nflorescence,nther,obconical,occasional,often,one,orolla,outside,ovate,papillo,perfec,plurifoliat,pore,poricidal,portion,prominent,protruding,rarely,regular,ruit,scar,separated,shallowly,side,simple,smaller,smooth,sometimes,somewhat,soon,specimen,spreading,stigma,stretchy,stump,tangled,tearing,terete,textur,thick,thickened,thinner,tip,tissue,together,toward,translucent,translucent-violet,trichome,tube,tuft,ud,uneven,unit,vary,visible,wide,widely,ympodial,young	adaxial,arrangement,calyx,characteristic,colour,form,fruit,growth,height,history,inflorescence,life,na,ovary,perennial,plant,seed,shape,staman,texture,ye
299	wfo-0001029310	success	216	126	99	117	27	0.458	.5,0-20,0-5,0.6-1.1,00,1-1.5,1.2-1.5,1.8-3,10-15,2-3.5,2-4,20-40,3-4,3.5,4-10,5-12,5-20,5-30,5-6,5-7,7-12,8,acute,anther,apex,apically,apparently,articulated,base,berry,branched,brown,calyx,cm,cordate,dark,diameter,difoliate,dull,elliptic,erect,filament,flattened-reniform,flower,fruit,glabrescent,glabrous,hair,herb,lateral,leaf,length,lobe,lobed,long,long-styled,lower,margin,maturity,mauve,membranous,midvein,mm,moderately,narrow-deltate,one,open,orange-green,ornately,pair,pedicel,peduncle,pendent,per,petiole,pinnatifid,plant,prickle,prickly,primary,short-styled,shrub,simple,sparsely,spherical,stellate-pubescent,stem,style,surface,tertiary,time,toward,truncate,unit,vein,venation,visible,wide,yellow	-16,-25,.1,.6,/4,/6,0.1-0.2,0.2-0.3,0.2-0.8,0.5,0.5-3,1,1-2,1-4,1/,10,10-13,10-20,15-20,2.5-6,2/3-3/4,20-60,200-500,3-5,4-8,45-60,5,5-10,5-8,5-merous,6-8,7-13,abaxially,accrescent,alyx,ame,andromonoecious,apar,apart,bark,beyond,blade,c.,concolorous,conical,connivent,deltate,distal,distance,drying,eaf,eed,elongating,enclosing,equal,extending,filifor,free,fruiting,geminat,gently,gray,hermaphrodite,heterostylous,inflated,infructescence,lobing,lon,longer,lowermost,mature,midpoint,minute,nflorescence,older,orolla,oung,pendulous,pericarp,perpendicular,poricidal,porrect,portion,prickl,ray,recurved,red-brow,retrorse,ruit,scar,secondary,sessile,shorter,side,smooth,sometimes,spaced,spreading,stalk,stalked,staminat,stellate,stout,straight,strongly,tamen,tapering,terete,tip,tissue,trichome,tube,variously,vary,way,woody,ympodial	1/3,abaxial,adaxial,arrangement,branching,characteristic,colour,corolla,filiform,form,geminate,growth,height,history,inflorescence,life,na,ovary,perennial,pseudostipule,rachi,seed,shape,staman,sympodial,texture,unarmed
300	wfo-0001029317	success	151	110	75	76	35	0.497	0.5,0.5-1,0.8-1,1,1-1.5,10-30-flowered,11-14,2-3,7-8,8-9,acuminate,along,anther,anthesi,apex,attenuate,base,beneath,broadly,bud,ca,calyx,channeled,closely,cm,corolla,deflexed,deltoid,densely,erect,exserted,filament,fruiting,glabrous,globose,grayish,immature,inflorescence,leaf,lobe,long,margin,mm,narrowly,occasionally,opposite,ovary,ovate,overlapping,ovoid,pair,pedicel,petiole,prominent,pubescent,rachi,raised,scar,shrub,simple,slender,soon,spaced,sparsely,stem,straight,style,tapering,trichome,tube,uniseriate,vein,white,x,yellowish	.5,0.25,0.5-0.75,1.5-3.5,10-16,2.5-5,6-8,6.5-11,apar,area,barely,brow,cup-like,deciduou,denser,dia,differing,difoliate,dry,eaf,edicel,eed,ellipsoi,epidermi,extreme,free,frui,geminate,glabrate,known,lateral,like,lobed,lon,lower,main,major,middle,minor,minutely,nearly,nflorescence,often,older,one,otherwise,paler,papillose,pore,poricidal,portion,probably,proximal,reflexed,remaining,rest,rounded,ruit,shaped,size,slightly,soft,specimen,stigma,styl,tall,tear-drop,thickened,tip,tuft,ud,unit,visible,widest,ympodial,young	2,5,abaxial,adaxial,apart,arrangement,branching,brown,characteristic,colour,diameter,ellipsoid,form,fruit,growth,height,history,length,life,midvein,na,peduncle,perennial,plant,primary,pseudostipule,seed,shape,spacing,staman,surface,tertiary,texture,unarmed,venation
301	wfo-0001029332	success	197	134	108	89	26	0.548	0-0.5,0-100,0-2,0-20,0-4,0-5,0.5-1,1-2,1-4,1.3-1.5,1.5-2,1/2,1/4,2,2-2.5,2-4,2.5-3.5,2.8-3.7,3-4,3.5-5,4-10,5-6,5-8,8.5-9.5,abaxial,adaxial,anther,apex,apically,apparently,articulated,base,berry,broad-deltate,calyx,chartaceous,cm,concolorous,cordate,curved,densely,diameter,difoliate,distance,drying,erect,extending,filament,flattened-reniform,flower,fruit,glabrous,lateral,leaf,length,lobe,lobed,long,lower,margin,maturity,mauve,midvein,mm,moderately,narrow-deltate,one,open,orange-brown,ovate,pair,pedicel,peduncle,per,petiole,plant,porrect,prickle,prickly,primary,rounded,scandent,shrub,side,simple,slender,spherical,stellate-pubescent,stem,style,subsessile,surface,terete,terminal,tertiary,time,trichome,unbranched,unit,upper,vein,venation,visible,weakly,wide,yellow,yellow-green,yellow-orange	-5,.5,/3,0,0.1,0.1-0.2,0.15-0.2,0.15-0.25,0.8-1,1-1.5,1-3,1/3,1/4-1/3,10-30,2/,2/3-3/4,3-6,4-15,5-merous,6-8,abaxially,alyx,andromonoecious,apar,apart,bark,becoming,blade,conical,connivent,distal,eaf,eed,elongating,equal,flattened,free,fruiting,geminat,glabrescent,gland,globular,grayi,herbaceous,hermaphrodite,heterostylous,infructescence,less,long-acuminat,long-styled,longer,lowermost,mature,midpoint,nflorescence,often,older,orolla,oung,pale,pendulous,pericarp,poricidal,portion,prickl,pubescent,ray,reduced,ruit,scar,sessile,short-styled,shorter,smooth,spaced,spreading,stalk,stalked,staminat,stellate,tamen,tapering,tip,tube,variously,vary,way,woody,ympodial	2/3,arrangement,branching,characteristic,colour,corolla,form,geminate,green,growth,height,history,inflorescence,life,long-acuminate,na,ovary,perennial,pseudostipule,rachi,seed,shape,staman,sympodial,texture,unarmed
302	wfo-0001029333	success	155	101	72	83	29	0.465	.25,.5,0.7-1,1-1.2,1-1.5,1-15,1-3,1-7,1.5-3,10-15-flowered,2-2.5,5-6,9-13,abaxial,abaxially,acuminate,acute,adaxially,anther,apex,auriculate,base,beige,berry,calyx,cm,corolla,dendritic,dia,dry,elliptic-obovate,filament,flattened-reniform,fresh,glabrous,globose,golden,green,incrassate,leaf,lobe,long,long-styled,margin,minutely,mm,obovate,occasionally,ovary,pair,pale,paler,pedicel,petiole,pitted,pubescent,reddish-brown,sessile,shape,shining,short-styled,shrub,simple,somewhat,stem,style,surface,time,triangular,trichome,truncate,vein	/4,0.5,0.5-1,1-2,1.5-2,1.5-2.5,100,17-26,3-7,3-7.5,8-15,along,anisophyllou,anthesi,ba,bark,beneath,broadly,clavate,conical,contracted,deflexed,dendritic-pubescent,densely,denser,differing,difoliate,eaf,edicel,eed,erect,exserted,flower,free,fruiting,geminate,heteromorphic,inflorescenc,lateral,like,lobed,lon,lower,main,major,minor,nflorescence,older,opposite,orbicular,overlappin,papillo,planar,pore,poricidal,portion,present,pubescence,rest,rounded,ruit,scar,shaped,size,slender,small,spaced,sparsely,stigma,strongly,tall,tear-drop,tip,tree,tube,type,ud,unit,way,wide,woody,ympodial,young	adaxial,alternate,arrangement,branching,characteristic,colour,diameter,form,fruit,growth,height,history,inflorescence,length,life,midvein,na,peduncle,perennial,plant,primary,pseudostipule,rachi,seed,staman,tertiary,texture,unarmed,venation
303	wfo-0001029334	invalid_json	211	111	73	138	38	0.346	0.15-0.3,1,1-2,1-3,1-6,1.3-4.5,1.5-6,1.8-2.9,2,2-2.5,2.5-3,3-7,4-5.5,8-30,9-12,acute,almost,anther,apex,articulated,attenuate,base,berry,brownish,cell,chartaceous,cm,condition,cordate,corolla,covering,densely,diameter,drying,filament,fresh,fruit,glabrous,globose,green,greenish,hair-like,herb,lateral,lobe,long,margin,membranous,mm,oblique,odd-pinnate,orbicular,ovate,ovoid,pedicel,peduncle,petiole,plant,puberulent,pubescent,pure,ripe,rounded,seed,stem,style,testal,thick,tinged,violet,wall,white,whitish	.2,0-4,1-10,1.5-3.9,2-4,2-5,2-8,3-5,3.2-5.8,3.3-6.5,4-8.5,5-10,5-merou,7.5-15.5,abaxially,absent,acumen,adaxially,ag,along,alyx,among,apart,apparently,axe,axillary,blade,borne,broadly,bud,capitat,ciliate,clavate,connivent,cuneate,decreasing,decurrent,digestion,distal,dorsally,eaf,edge,eed,elliptic,end,enzyme,erect,especially,exceeding,except,flat,flower,folded,forked,geminat,generally,glabrou,gradually,grassland,greatly,green-white,hair,half,homostylous,honeycomb-shaped,interjected,lanceolate,leaflet,lengthening,like,living,low-growin,lower,make,middl,midrib,minutely,mucilaginous,narrowly,nflorescence,obtuse,often,orolla,pair,perfect,petiolulate,petiolule,plurifoliate,pore,poricidal,proximal,rarely,reduced,removed,ruit,semi-rosette,sessile,seudostipule,shady,short,singly,situation,size,slightly,slit,spaced,specimen,stamen,ste,stellate,stigma,stolo,straight,subequal,subsessile,subtending,sunny,tall,tamen,tem,terminal,throughout,tip,toward,tri-,tube,tuber,typically,unit,unwinged,usually,vary,wet,wide,woodland,x,yellow,ympodial	'',[,``,abaxial,adaxial,arrangement,branching,calyx,characteristic,colour,form,growth,height,history,inflorescence,leaf,length,life,middle,midvein,na,ovary,perennial,primary,pseudostipule,rachi,shape,staman,surface,tertiary,texture,unarmed,value,vein,venation,width,{,}
304	wfo-0001029344	success	147	107	77	70	30	0.524	.5,0.4-1,0.5-1,0.5-1.5,1,1-5,1.5,1.5-3,1.5-4,10-20,10-35,2-7,3-10,4-6,5-15,absent,acute,anther,apex,base,berry,brown,calyx,center,chartaceous,ciliate,cm,densely,diameter,dm,drying,edge,elliptic,elliptic-ovoid,entire,filament,fine,flower,fruit,glabrous,globose,hair,herb,immature,linear-lanceolate,lobe,margin,maturing,membranaceous,mm,moderately,nearly,obtuse,parallel,pedicel,peduncle,per,petiole,pubescent,rachi,radiating,raised,rhizomatous,ridge,rounded,running,semitransparent,shallow,sparsely,straight,style,surface,unbranched,vein,white,x,yellow	0.5-3,1-2,1-3,1-6,2-3,2-3-celled,2-4,5-12,abaxially,abundant,adaxiall,adaxially,along,axe,beyond,blade,connected,cordate,decurrent,dehiscing,denser,difoliate,eaf,eed,emarginat,equal,explosively,exserted,flat,frui,geminat,held,interpetalar,lacking,long,lower,lying,maturit,mesocarp,nflorescence,notch,oblong,obvious,often,one-,orolla,placenta,pressure,pubescen,rotate,ruit,short,slightly,sometimes,stamen,stigma,swollen,tal,tamen,tem,tissue,triangular,tube,two-celled,unit,vary,watery,wid,woody,ympodial	abaxial,adaxial,arrangement,branching,characteristic,colour,corolla,form,geminate,growth,height,history,inflorescence,leaf,length,life,midvein,na,ovary,plant,primary,pseudostipule,seed,shape,staman,stem,tertiary,texture,unarmed,venation
305	wfo-0001029363	success	152	87	57	95	30	0.375	0-0.1,0.2-1.1,0.5-1,1-1.2,2-6,3-7,5-7-flowered,6-7,6-8,7-10,acuminate,acute,anther,apex,base,beneath,berry,calyx,cm,corolla,deflexed,deltoid,elliptic,filament,fruit,glabrous,globose,green,leaf,lobe,long,margin,minutely,mm,narrowly,obtuse,ovary,pair,pale,pedicel,petiole,pubescent,shrub,simple,small,stem,straight,style,surface,tapering,tree,trichome,tuft,uniseriate,vein,white,white-papillose	.25,.75,/4,0.1-0.5,0.5,1,1.5-1.7,1.5-3.5,4-11,anthesi,axil,ba,bark,becoming,beginning,bi-lobed,bud,capitate,closely,coroll,cup-shaped,deep,densely,dia,drying,eaf,edge,edicel,eed,erect,except,exsertion,free,fruiting,greyish,immature,inflorescenc,internodal,known,lamina,larger,later,lateral,lobed,lon,lower,main,maroon,mature,meeting,middle,minute,much,near,nflorescence,occasionally,often,older,opposite,overlapping,paler,papillo,papillose,pore,poricidal,portion,prominent,reflexed,ruit,scar,shiny,slender,slit-like,somewhat,spaced,sparse,sparsely,stigma,tall,terminal,thickened,tip,tube,ud,unifoliat,unit,upon,usually,way,wide,widest,woody,yellowish,ympodial,young	abaxial,adaxial,alternate,arrangement,branching,characteristic,colour,diameter,form,growth,height,history,inflorescence,length,life,midvein,na,peduncle,perennial,plant,primary,pseudostipule,rachi,seed,shape,staman,tertiary,texture,unarmed,venation
306	wfo-0001029364	success	153	95	65	88	30	0.425	-2,-6,0.2-0.5,1-3,1-4,1-5,1.5-2,2,4-9,5-11,5-9,7-9,8-10,8-15,?,acuminate,anther,apex,articulated,base,calyx,chartaceous,cm,corolla,cream,cuneate,cylindrical,diameter,elliptic,entire,extra-axillary,filament,flower,fruit,glabrous,globose,green,greenish,herb,immature,lobe,margin,membranaceous,minutely,mm,moderately,nearly,obtuse,pedicel,peduncle,petiole,puberulent,rachi,shallow,shrub,side,simple,sparsely,spot,style,unbranched,unknown,vein,white,x	-3,.5,1,1-,10-27,191.,2-,2-6,2-foliat,3-4,4-12,5-,6-8,abaxially,according,acute,adaxially,aggregate,apart,around,axe,ba,bitter,blade,blue,cell,center,color,connivent,curled,darker,deep,directed,distall,distally,eaf,ed,fide,finger,free,gland-tipped,glandular-puberulen,hair,inserted,long,lower,major,mesocarp,narrowly,nflorescence,orolla,ovate,part,perfect,pore,presence,present,puberulen,pubescent,radiu,ripe,ruit,rusby,sagittate,short-tomentose,shorter,small,spaced,stellate,stigma,stone,strongly,tal,tamen,tapered,tem,thecae,tightly,time,tomento,triangular,truncat,tube,unit,vary,wide,yellow,ympodial	abaxial,adaxial,arrangement,branching,characteristic,colour,form,glandular-puberulent,growth,height,history,inflorescence,leaf,length,life,midvein,na,ovary,plant,primary,pseudostipule,seed,shape,staman,stem,surface,tertiary,texture,unarmed,venation
307	wfo-0001029368	success	139	82	51	88	31	0.367	.2,.5,0,0.5-2,0.9-1,1.5-1.6,1.5-2,1.5-3,1.5-4,2-5,2.5-4,5-6,acuminate,acute,anther,apex,base,broadly,calyx,cm,corolla,densely,elliptic,few-branched,filament,fruit,glabrous,globose,green,herb,inflorescence,lanceolate,leaf,lobe,long,margin,minutely,mm,ovary,pair,pedicel,petiole,puberulent,shrub,simple,stem,straight,style,vein,white,x	.25,11-13,16-25,?,abaxially,adaxially,along,anthesi,apparently,bark,bearing,berry,bitter,borne,breaking,brow,capitate,closely,coarse,conical,crumpled,cup,deflexed,dia,distal,eaf,edicel,eed,erect,exserted,fide,flattened,flower,free,fruiting,golden,half,indistinct,inflorescenc,internodal,known,lamina,lateral,leaving,like,lower,main,margi,middle,midrib,minute,nflorescence,non-flower,obtuse,older,one,opposite,overlappin,papillo,papillose,parallel,pore,poricidal,portion,reflexed,rest,ruit,scar,shaped,somewhat,spaced,stigma,strongly,tall,tear-drop,tip,trichome,tube,ud,unifoliat,uniseriate,unit,upper,widest,winged,woody,ympodial,young	abaxial,adaxial,alternate,arrangement,branching,brown,characteristic,colour,diameter,form,growth,height,history,length,life,midvein,na,peduncle,perennial,plant,primary,pseudostipule,rachi,seed,shape,staman,surface,tertiary,texture,unarmed,venation
308	wfo-0001029370	success	224	115	92	132	23	0.411	.3,0-35,0.5-1,0.5-2.2,1-2,1.5-6,1.8-2.5,12-17,2.5-3.5,3-4,4-7,5.5-7,7-11,abaxial,adaxial,anther,apex,apically,articulated,basal,base,berry,branched,broad-deltate,calyx,chartaceous,clearly,cm,cordate,cream,dark,densely,diameter,erect,filament,fine,flattened-reniform,flower,fruit,green,greenish,herb,lateral,leaf,length,lobe,lobed,long-styled,lower,margin,marking,maturity,mauve,midvein,mm,moderately,obtuse,orange,orange-brown,ornate,ovate,overlapping,pair,pale,pattern,pedicel,peduncle,petiole,plant,primary,red-brown,reticulate,rounded,shiny,short-styled,shrub,simple,smooth,spherical,stellate-pubescent,stem,style,surface,tertiary,unarmed,vein,venation,visible,white,whitish,yellow,young	-20,-32,.1,.5,/4,0-10,0-100,0-3,0.1,0.1-0.15,0.2,0.3,1,1-3,1-4,1.8-2.8,1/3-1/2,1/4-1/3,10-17,10-40,10-50,15-30,2-10,2-20,2-3,2-6,3.5-4,3.5-8,3/,4-6,4-9,5-10,5-12,5-merous,6-15,7-13,8-14,8-20,8-23,abaxially,acut,almost,alyx,ame,andromonoecious,apar,apart,apparently,bark,blade,c.,conical,connivent,curved,discolorous,distal,distance,drying,eaf,eed,elongate,elongating,equal,extending,fewer,flattened,free,fruiting,fully,gently,glabrescent,glabrous,hermaphrodite,heterostylous,infructescence,long,longer,lowermost,mature,midpoint,mixture,multangulate,nflorescence,often,older,one,open,opening,orolla,oung,pendulous,per,pericarp,perpendicular,plurifoliat,poricidal,porrect,portion,prickl,prickle,prickly,ray,rotate,ruit,scar,sessile,side,slightly,sometimes,spaced,spreading,stalk,stalked,staminat,stout,straight,strongly,tamen,tapering,terete,time,tip,trichome,tube,unit,variously,vary,way,white-gra,wide,woody,ympodial	3/4,acute,arrangement,branching,characteristic,colour,corolla,form,growth,height,history,inflorescence,life,na,ovary,perennial,plurifoliate,pseudostipule,rachi,seed,shape,staman,texture
309	wfo-0001029373	success	199	99	65	134	34	0.327	.3,5,6.8,abaxial,acute,adaxial,anther,apex,articulated,base,berry,broadly,calyx,cm,conical,corolla,curved,deltate,densely,developing,diameter,ellipsoid,entire,filament,flattened-reniform,fruit,glabrous,green,grey-brown,growth,herb,internodal,lateral,leaf,lobe,long,margin,minutely,mm,moderately,obtuse,ovary,ovate-lanceolate,pair,pedicel,peduncle,per,petiole,pitted,plant,primary,pubescent,rounded,shape,simple,stem,straight,style,surface,terete,tip,vein,white,wide,yellowish	.0â1.2,.2,.5,.5â2.0,0.3â0.5,0.4â1.6,0.5â1.2,0.5â1.8,0.6â0.7,1.0â1.2,1.0â1.6,1.2â1.5,1.3â2.2,1.4â3.5,1.5â2.0,1.5â2.5,1.5â2.7,1.8â2.0,1.8â2.3,180Â°,2-celled,2.0â2.5,2.7â3.0,20â30,2â4-celled,3,3.5â4.0,30â40,3â5,4â5,4â6,5-merous,5â6,8â9,abaxially,accrescent,acuminate,adaxially,age,anthesi,apar,appearanc,appressed,arising,bark,basal,bayonet,beyond,bud,capped,cell,clavate,cone,distal,eaf,eed,elongate,enclosed,enclosing,exerted,finger,flower,free,fruiting,fully,geminat,glandular-tipped,globose,hair,half,halfway,hilum,immature,individual,laterally,lengthening,less,like,live,lobed,lon,lower,mature,mesocarp,middle,minute,mouth,new,nflorescence,node,older,outline,papillate,pentagonal,perfect,plurifoliate,pore,poricidal,portion,positioned,reflexed,resembling,root,ruit,scar,seen,seudostipule,shallowly,short,slightly,slit,smoot,spaced,spreading,stellate,stigma,still,tall,tem,testal,thicker-walled,trailing,trichome,tub,tube,ud,uniseriate,unit,upper,woody,yellow,yellow-green,ympodial,â5	.0-1.2,.5-2.0,0.4-1.6,0.5-1.2,0.6-0.7,1.0-1.2,1.2-1.5,1.5-2.5,2.0-2.5,2.7-3.0,20-30,30-40,4-6,5-6,8-9,arrangement,branching,characteristic,colour,form,height,history,inflorescence,length,life,midvein,na,perennial,pseudostipule,rachi,seed,staman,texture,unarmed
310	wfo-0001029402	success	113	79	45	68	34	0.398	0.5-1,0.5-2,11-17,2,2-3,3-5,4-6,4-7,5-25,7-8,7-9,abaxial,acute,apex,articulated,base,branched,calyx,ciliolate,cm,deltate,diameter,elliptic,glabrate,glabrous,leaving,lobe,margin,mm,narrowly,pedicel,peduncle,petiole,pubescent,rachi,scar,shrub,simple,sparsely,style,surface,tapered,unknown,violet,x	1-2.5,15-30,2-10,3-4,3-6,4-8,6-16,7-11,8-15,abaxially,acuminate,adaxially,apart,axe,band,blade,chartaceous,color,connivent,cylindrical,denser,directed,distall,eaf,eed,fleshy,flower,forked,free,glabrou,hair,inrolled,lanceolate,long,lower,many-foliat,moderately,narrowed,nearly,nflorescence,nther,often,orolla,papillose,pore,pubescence,rachise,radiu,roughened,ruit,scale-like,somewhat,spaced,stellate,stigma,tal,tem,thickened,time,tip,triangular,truncat,tube,unit,unknow,vary,wide,ympodial	adaxial,anther,arrangement,branching,characteristic,colour,corolla,filament,form,fruit,green,growth,height,history,inflorescence,leaf,length,life,midvein,na,ovary,perennial,plant,primary,pseudostipule,seed,shape,staman,stem,tertiary,texture,unarmed,vein,venation
311	wfo-0001029404	success	154	101	68	86	33	0.442	-3,0.5-1,1-4,15-25,2-3,2-8,2.5-22,2.5-3,3-4,3-8.5,5-20,5-6,6-8,6-9,acuminate,acute,anther,apex,apiculate,articulated,auriculate,base,branched,calyx,center,chartaceous,cm,cordate,dark,darker,deltate,densely,diameter,ellipsoidal,entire,flattened,fleshy,fruit,glabrous,green,lobe,longitudinal,margin,mm,moderately,mottling,orange,ovate,pedicel,peduncle,petiole,pink,puberulent,pubescent,purple,rachi,shrub,simple,sparsely,star,style,toward,tree,unbranched,vein,white,x,yellow	-1.5,-10,-5,0-60-flower,1,1.5-2,2,2-4,2-5,20-35,3-5,4-foliat,5-10,5-24,6.5-34,8-12,abaxially,absent,adaxially,aggregate,apart,ape,axe,basal,beyond,blade,cell,connective,connivent,cream,cylindrical,directed,distally,eaf,eed,eglandular,exserted,flower,glandular,glandular-puberulen,hair,lanceolate,leaving,lemon,less,light,lon,long,lower,narrowly,nflorescence,nther,obtuse,orang,orolla,ovoid,pedicellar,perfect,pore,presen,radiu,remnant,ripe,ruit,shorter,slightly,small,somewhat,spaced,stellate,stigma,stone,subcoriaceous,tal,tem,thecae,time,tomento,triangular,truncat,tube,ud,unit,vary,wide,ympodial	abaxial,adaxial,arrangement,branching,characteristic,colour,corolla,filament,form,glandular-puberulent,growth,height,history,inflorescence,leaf,length,life,midvein,na,ovary,perennial,plant,primary,pseudostipule,seed,shape,staman,stem,surface,tertiary,texture,unarmed,venation
312	wfo-0001029406	success	136	100	69	67	31	0.507	0.5-1,0.6-1,0.7-1.5,1-1.5,1-10,1-2,1.5-2.2,1.5-2.5,2-3,2.5-3.5,4-6,7-12,abaxially,acute,adaxially,anther,apex,arachnoid,base,berry,broadly,brown,brownish,calyx,cm,corolla,dark,deflexed,deltate,elliptic,filament,glabrous,globose,grayish-brown,grayish-green,green,greenish-white,large,leaf,lenticel,lobe,long,margin,matted,maturity,minutely,mm,occasionally,often,ovary,ovoid,ovoid-reniform,pair,pedicel,petiole,pitted,pubescent,shiny,shrub,small,stem,style,surface,tree,trichome,vein,white,wide,woody	.5,0.3-1,1.5-5,2,2-11,28,3-9,30,4-18,along,anthesi,arachnoid-pubescent,ba,bark,bullate,clavate,conical,conspicuously,deciduous,densely,dia,differing,difoliate,dry,eaf,eed,felt-like,free,fruiting,geminat,impressed,lateral,lilac,lobed,lon,lower,main,major,middle,minor,nearly,older,pale,papillo,papillose,planar,pointed,population,pore,poricidal,portion,ruit,shaped,size,slightly,soon,stigma,tall,tear-drop,tinge,tip,tube,unit,waxy,widest,ympodial,young	abaxial,adaxial,alternate,arrangement,branching,characteristic,colour,diameter,form,fruit,growth,height,history,inflorescence,length,life,midvein,na,peduncle,perennial,plant,primary,pseudostipule,rachi,seed,shape,staman,tertiary,texture,unarmed,venation
313	wfo-0001029407	success	208	126	104	104	22	0.5	-6,.5,0-15,0-2,0-4,0-5,0.4-0.7,0.5-0.7,0.5-1.5,0.5-2,0.6-0.9,1-1.4,1-2,1-4,1.8-2.5,1/5,2.5-3,3-4,3-6,5-7,6-13,6-20,abaxial,acute,adaxial,almost,anther,apex,apically,apparently,articulated,base,berry,bright-red,calyx,cm,cuneate,dark,deltate,densely,diameter,dull,elliptic,entire,erect,evenly,filament,flattened-reniform,flower,fruit,glabrous,green,green-brown,infructescence,lateral,leaf,length,lobe,lobed,long,margin,mature,maturity,mauve,mm,moderately,obtuse,orange,orange-brown,ovate,pair,pale,pedicel,peduncle,per,petiole,prickle,prickly,primary,pubescent,rarely,rounded,shrub,side,simple,sometimes,sparsely,spherical,stellate-pubescent,stem,straw-yellow,style,surface,tertiary,unbranched,upper,vein,venation,visible,white,wide,yellow,yellow-green,young	-10,-2,-25,-4,-7,/3,0,0.1-0.2,0.1-0.25,0.15-0.4,0.2-0.3,0.4-1,0.6,0.7-1.2,1,1-3,1-4.5,1.5,1/3,1/3-1/2,1/8-1/5,2-3,2-4,2-5,3.5-4.5,4-15,4-9,4.5-6,5-merous,7-8,abaxially,acut,alyx,apar,apart,bark,blade,brow,chartaceous,connivent,curved,difoliate,discolorous,drying,eaf,eed,elongating,equal,flattened,free,fruiting,geminat,geminate,glabrescent,gray-greenish,lengt,longer,lower,midpoint,nflorescence,occasionally,older,one,open,orolla,oung,pendulous,perfec,pericarp,poricidal,porrect,portion,prickl,ray,recurved,reflexed,ruit,scar,sessile,shorter,slender,smooth,spaced,spreading,stalk,stalked,stellate,stout,straight,strongly,tamen,tapering,terete,thick,time,tip,trichome,tube,unit,vary,way,weakly,woody,ympodial	arrangement,branching,characteristic,colour,corolla,form,growth,height,history,inflorescence,life,midvein,na,ovary,plant,pseudostipule,rachi,seed,shape,staman,texture,unarmed
314	wfo-0001029408	success	244	119	93	151	26	0.381	-10.5,0,0.2-0.3,0.5-2.5,0.7-1.2,0.9-1.3,0.9-1.6,1-8,1.1-1.5,1.4-1.9,1.6-2.8,1.7-2.4,2-12,2-4,2-5,2.2-3.7,3-5,4-20,4-7.5,5-6.5,7-12,abaxially,acute,adaxially,anther,apex,base,berry,branched,broadly,brown,calyx,cm,conical,corolla,cuneate,dark,deltoid,diameter,elliptic,entire,filament,fleshy,fruit,glabrous,globose,gray,green,growth,honeycombed,lanate,lanceolate,leaf,length,lilac,lobe,long-attenuate,margin,midvein,mm,moderately,mostly,ovate,pale,pedicel,peduncle,petiole,plurifoliate,pubescent,purplish,rachi,rarely,reniform,reticulate-punctate,ripe,short-attenuate,shrub,side,small,stem,style,suborbicular,time,tomentose,tree,unarmed,vein,velutinous,white,whitish,x,yellow,yellowish	-1.5,-4.5,.2-3.5,/10,0-100,0.3-5,1.5-3,1.8-3.5,1/2,1/2-3/4,1/4,11-31,2-3.5,2.5-7,2/3,3.5-5,4-14,5-24,5-6,5-8,5-merou,accrescent,acuminate,adaxiall,ag,alyx,anthesi,apart,apical-lateral,articulated,axe,axillary,ba,barely,bark,becoming,blade,blunt-tipped,branch,bud,capitat,chartaceous,clavate,continued,decurrent,dehiscing,dendritic-echinoi,dendritic-multangulate,densely,develope,directed,distal,distall,due,eaf,echinoi,echinoid,eed,exserted,extend,faintly,few-rayed,flower,free,fruiting,hair,high,homostylous,indument,inserted,interpetalar,introrse,lacking,large,lateral,lobed,long,long-,long-stalked,longitudinal,lower,m.,main,many,mixed,multangulate,near,nearly,nflorescence,oblong,obscured,obtuse,often,older,orbicular,orolla,ovate-lanceolate,overlapping,part,partly,perfect,persistent,pore,porrect-stellate,present,pseudo-terminal,rather,ray,relatively,ribbed,rotate-stellate,ruit,runk,sessile,short-,short-stalked,simple,slightly,slit,sometimes,spaced,stamen,stelliform,stigma,subcampanulate,subovate,suture,tamen,terete,testa,thick,thick-stalked,thick-textured,thin-stalked,tissue,tomentu,tomentum,top,touching,toward,tube,turbinate,unarme,unit,usually,vary,way,well,wide,ympodial,young	abaxial,adaxial,arrangement,branching,characteristic,colour,form,height,history,inflorescence,life,na,ovary,perennial,plant,primary,pseudostipule,pseudoterminally,seed,shape,staman,surface,tertiary,texture,true,venation
315	wfo-0001029417	success	213	162	129	84	33	0.606	.5,0.2-0.6,0.7-3,1,1-10,1-2,1.3-8,1.5-1.8,1.5-8,12,2.5-10,2.8-3.5,3-5,4-7,5-15,6-11,8-9,abaxially,acuminate,acute,adaxially,anther,apart,apex,apiculate,articulated,attenuate,axillary,base,basiscopic,berry,blue,broadly,brownish,bud,cell,central,chartaceous,cm,coarsely,condition,corolla,covering,dark,decurrent,deep,diameter,distal,dot,drying,erect,filament,flower,forked,fresh,fruit,generally,glabrous,globose,green,green-white,greenish,hair,hair-like,half,herb,lateral,like,linear,lobe,long,make,margin,medium,membranous,minute,mm,moderately,mucilaginous,narrowly,non-glandular,odd-pinnate,often,orbicular,ovate,ovoid,pedicel,peduncle,petiole,pilose,plant,plurifoliate,pubescent,purple,rarely,ripe,rounded,scattered,seed,sessile,short,side,slightly,sometimes,spaced,star,stem,style,subtending,terminal,testal,thick,throughout,tinged,tri-,trichome,typically,unit,unwinged,usually,violet,wall,wet,white,whitish,wide,widely,wing,x	0-7,0.4-8,1-1.5,1-4,1-8,1.5-10,2-4,3-14,5-merou,8-15,acumen,ag,along,alyx,apparently,axe,blade,borne,capitat,ciliate,clavate,connivent,decreasing,digestion,dorsally,eaf,edge,eed,end,enzyme,erec,especially,exceeding,flat,folded,geminat,glabrou,greatly,hal,homostylous,honeycomb-shaped,interjected,lanceolate,leaflet,lengthening,living,lower,lunate,midrib,minutely,nflorescence,orolla,pair,pentagonal,perfect,petiolulate,pore,poricidal,puberulent,rapidly,removed,rotate,ruit,seudostipule,short-petiolulate,singly,size,slit,specimen,stamen,ste,stigma,stolo,straight,subequal,tall,tamen,tem,tip,tube,tuber,vary,yellow,ympodial	2,abaxial,adaxial,arrangement,branching,calyx,characteristic,colour,form,geminate,growth,height,history,inflorescence,leaf,length,life,midvein,na,ovary,perennial,primary,pseudostipule,rachi,shape,staman,surface,sympodial,tertiary,texture,unarmed,vein,venation
316	wfo-0001029461	success	217	113	91	126	22	0.419	-1.5,-2,-3,-4.5,.5,0,0.6-1,1-,1-1.6,1-3,1/3,2-2.8,2-3,2.5-3,3-6,4-6.5,4.5-7,5-25,almost,anther,apex,attenuate,base,becoming,berry,black,broad-deltate,brown,calyx,cell,cm,cuneate,densely,diameter,dull,elliptic,evenly,faint,filament,fine,fruit,glabrous,green,infructescence,leaf,length,lobe,lobed,margin,maturity,mauve,midvein,mm,moderately,orange,outline,ovate,pair,pedicel,per,petiole,pit,plant,prickle,prickly,primary,raised,reddish,reduced,rounded,shrub,simple,small,smooth,sometimes,sparsely,spherical,staman,stellate-pubescent,stem,style,subentire,surface,tertiary,unarmed,upper,vein,venation,visible,yellow,young	-14,-3.2,-3/4,-4,-5,0.1,0.1-0.25,0.15-0.25,0.7-1,0.8,0.8-1.5,1-2,1-4,1-6,1.2-1.7,1.2-1.8,1.3-2.2,1.5-,1.5-2,1/3-2/3,1/4,1/4-1/2,2-2.4,2-4,3-20,4-10,4-7,4.7-7.2,5-10,5-merous,7-10,7-12,8-9,abaxially,acuminat,alyx,ame,andromonoecious,apart,apically,bark,blade,breaking,brittle,c.,chartaceous,concolorous,curved,dark,discolorous,distal,distance,drying,eaf,eed,elongating,erect,extending,fifth,flattened,flattened-reniform,flower,four,free,fruiting,glabrescent,gra,hermaphrodite,heterostylous,lengt,long,long-styled,longer,lower,lowermost,mature,midpoint,oblong,obovate,obtuse,older,orolla,oung,pendulous,pericarp,plurifoliat,poricidal,porrect,portion,prickl,ray,reflexed,ruit,sessile,shallow,shiny,short-styled,shorter,side,slender,slightly,spaced,spreading,stalk,stalked,staminat,stellate,straight,strongly,tamen,terete,time,tip,trichome,tube,unarme,unequal,unit,variously,vary,way,weakly,wide,woody,ympodial,zygomorphic	abaxial,adaxial,arrangement,branching,characteristic,colour,corolla,form,growth,height,history,inflorescence,life,na,ovary,peduncle,perennial,pseudostipule,rachi,seed,shape,texture
317	wfo-0001029462	success	166	112	84	82	28	0.506	-2,-30,-4,-5,0.5-1,0.5-2,1,1-3,1-6,1.5,1.5-2,10-,15-25,2-6.5,2.5-3.5,2.5-5.5,20-35,3,3-27,3-6,3-7,4-20,6-9,7-8,acuminate,acute,apex,articulated,basal,base,calyx,chartaceous,cm,cuneate,dark,densely,dentate,diameter,ellipsoidal,elliptic,entire,flattened,flower,fruit,glabrous,green,laterally,leaving,light,lobe,long,longitudinal,margin,membranaceous,mm,moderately,near,obtuse,often,oval,ovate,pedicel,pedicellar,peduncle,petiole,pubescent-pilose,purplish,rachi,remnant,reticulate,rounded,simple,smooth,somewhat,stripe,style,tip,tree,triangular,truncate,unbranched,white,without,x	1-,1-2,1.5-3,1.5-7,10-22,2-3,3-18,3-4,3-5,4-15,4-foliat,5-30,7-19,8-9,abaxially,abruptly,absent,adaxially,aggregate,apart,ape,axe,beyond,blade,broad,campanulate,cell,ciliate,connective,connivent,constricted,curled,cylindrical,directed,eaf,eed,eglandular,equal,exceeding,exserted,hair,lanceolate,lon,lower,m.,minutely,narrowly,nflorescence,nther,occasionally,orolla,ovoid,perfect,pore,puberulent,pubescent,pubescent-pilo,purpl,radiu,ruit,shorter,slightly,small,spaced,sparsely,stamen,stellate-,stigma,stone,tal,tem,thecae,time,tomentose,truncat,tube,ud,unit,vary,wide,yellow,ympodial	abaxial,adaxial,anther,arrangement,branching,characteristic,colour,corolla,filament,form,growth,height,history,inflorescence,leaf,length,life,na,ovary,plant,pseudostipule,seed,shape,staman,stem,surface,texture,unarmed
318	wfo-0001029464	success	235	130	109	126	21	0.464	.9,0-80,0.2-0.5,0.8-2,00-200,1-10,1/4,10-40,2-3,2-3.5,2.2-2.5,2.4-4,2.5-5,2.9-3.2,3-20,3.5-5,4-7,5-17,5.5-6,5.5-7.5,6-15,7-10,abaxial,acute,adaxial,annual,anther,apex,apparently,articulated,base,berry,black,branched,brown,calyx,chartaceous,cm,cordate,curved,dark,deltate,diameter,ellipsoid,erect,filament,flattened-reniform,fruit,glabrescent,glabrous,glaucous,globular,green,herb,lateral,leaf,length,lobe,lobed,long,long-styled,lower,margin,maroon,maturity,mauve,midvein,mm,moderately,mottled,narrow-deltate,oblong,obtuse,orange-brown,ovate,ovoid,pair,pedicel,peduncle,pendent,per,petiole,pink,plant,primary,purple,red-brown,short-styled,simple,sometimes,stellate-pubescent,stem,striped,style,surface,terminal,tertiary,unarmed,upper,usually,variously,vein,venation,visible,white,wide,yellow-green,yellow-orange,young	-2/3,-3,-30,-5,0,0-2,0.2,0.2-0.7,0.3-0.7,0.3-1,0.5,0.5-2,1,1-3,1-8,1.2-3,1.5-2,1/,1/4-1/2,1/4-1/3,10-15,10-23,10-50,12-50,2,2-4,2.5-8,3-5,3-7,4-8,4-8-merous,5-8,8-13,8-15,9-15,abaxially,acicular,alyx,ame,andromonoecious,apar,apart,apically,around,bark,blade,broad,broad-deltate,brow,c.,connivent,cultivar,cup-shaped,difoliate,discolorous,distal,distance,drying,eaf,eed,elongated,elongating,equal,extending,flower,free,fruiting,fully,geminat,green-brown,hair,hermaphrodite,heterostylous,infructescence,less,long-acuminat,longer,lowermost,mature,midpoint,minute,nflorescence,occasionally,often,older,one,open,opening,orolla,oung,pendulous,pericarp,poricidal,porrect,portion,prickl,prickle,prickly,ray,rounded,ruit,scar,sessile,side,smooth,spaced,sparsely,spreading,stalk,stalked,staminat,stellate,straight,tamen,tapering,terete,time,tip,translucent,trichome,tube,unit,vary,way,woody,ympodial	/,1/2,arrangement,branching,characteristic,colour,corolla,form,growth,height,history,inflorescence,life,na,ovary,pseudostipule,rachi,seed,shape,staman,texture
319	wfo-0001029546	success	203	142	110	93	32	0.542	0.3-1,1-2,1-4.5,1.5-6.2,2.2-2.8,3-8,3.5-5,4-10,4.5-7,5-10,5-18,5-8,7-10,8-17,abaxially,acuminate,acute,adaxially,anther,apex,apiculate,articulated,attenuate,axillary,base,berry,blue,broadly,brownish,bud,cell,cm,condition,cordate,corolla,covered,covering,densely,diameter,distal,dot,drying,elliptic,elliptical,filament,flower,forked,frequently,fresh,fruit,generally,glabrous,glandular,globose,green,green-white,greenish,hair,hair-like,half,herb,lateral,leaf,like,lobe,long,longer,lunate,make,mm,mucilaginous,nearly,non-glandular,oblique,odd-pinnate,often,orbicular,ovate,ovoid,pedicel,peduncle,petiole,plant,pubescent,purple,rachi,rarely,regular,ripe,seed,short,simple,slightly,soft,sometimes,stem,style,subtending,terminal,testal,thick,throughout,tinged,trichome,usually,wall,wet,white,whitish,x	0-2,1-10,1-3.2,1-5,1.5-2,1.6-6.5,2-4,2-9,4.5-12.5,5,5-merou,6.3-19.5,8,8-19.5,absent,acumen,adaxiall,ag,alyx,apart,apparently,axe,blade,capitat,chartaceous,clavate,connivent,curved,decreasing,decumben,decurrent,digestion,dorsally,eaf,edge,eed,enzyme,erect,exceeding,flat,folded,geminat,glabrou,greatly,homostylous,honeycomb-shaped,interjected,lanceolate,leaflet,lengthening,living,lower,membranous,middl,minutely,mottle,nflorescence,pair,pentagonal,perfect,petiolule,plurifoliate,pore,poricidal,removed,rotate-pentagonal,ruit,sessile,seudostipule,size,slit,spaced,specimen,stamen,ste,stigma,straight,subequal,tall,tamen,tem,tip,tri-,truncate,tube,typically,unit,unwinged,vary,wide,wing,yellow,ympodial	2,abaxial,adaxial,arrangement,branching,calyx,characteristic,colour,form,growth,height,history,inflorescence,length,life,margin,middle,midvein,mottled,na,ovary,perennial,primary,pseudostipule,shape,staman,surface,tertiary,texture,unarmed,vein,venation
320	wfo-0001029552	success	161	108	79	82	29	0.491	.5,0.1-0.5,0.6-1,1-1.3,1-1.5,1-3,1-5,1.5-2,12,2-2.5,2.5-3,5-10-flowered,6-9,abaxial,abaxially,acuminate,acute,adaxially,along,anther,apex,base,berry,branched,broadly,calyx,cm,corolla,decurrent,deltate,dendritic,densely,dia,elliptic,erect,filament,flattened-reniform,glabrous,globose,green,incrassate,inflorescence,lateral,leaf,lobe,long,long-styled,main,margin,minutely,mm,occasionally,ovary,pair,pale,paler,pedicel,petiole,pitted,pubescent,shape,shining,short-styled,shrub,simple,small,somewhat,sparsely,stem,style,surface,tan,tree,tree-like,trichome,vein,white,wide,yellowish	.25,0.5,1-2,1.5-6.5,10-20,2-9,5.5-8,abruptly,anthesi,area,bark,broadened,clavate,closely,conical,contracted,deflexed,denser,differing,difoliate,drying,eaf,edicel,eed,exserted,flower,free,fruiting,geminat,greyish-brow,heteromorphic,inflorescenc,lamina,later,like,lobed,lon,lower,major,middle,minor,minute,nearly,nflorescence,older,onto,opposite,orbicular,overlappin,papillo,persistent,planar,pore,poricidal,portion,present,reflexed,rest,rounded,ruit,scar,scattered,shaped,size,slender,slightly,spaced,stigma,strongly,swollen,tall,tear-drop,tip,tub,tube,ud,unit,widest,woody,x,ympodial,young	adaxial,alternate,arrangement,branching,characteristic,colour,diameter,form,fruit,greyish-brown,growth,height,history,length,life,midvein,na,peduncle,perennial,plant,primary,pseudostipule,rachi,seed,staman,tertiary,texture,unarmed,venation
321	wfo-0001029584	invalid_json	180	135	99	81	36	0.55	1,1-2,1-6,1.5-6.5,2-3,2-4,3-10,3-7,4-14,4-15,6-7,7-14,8-15,abaxially,acumen,acuminate,acute,adaxially,anther,apex,articulated,asymmetric,axillary,base,basiscopic,brownish,bud,cell,clavate,cm,condition,connivent,coriaceous,corolla,covering,dark,densely,diameter,distal,drying,elliptic,filament,flower,forked,fresh,fruit,generally,glabrescent,glabrous,green,green-white,greenish,hair,hair-like,half,herb,lateral,leaf,light,linear,lobe,long,make,margin,middle,mm,mucilaginous,oblong-lanceolate,odd-pinnate,ovate,ovoid,pedicel,peduncle,petiole,petiolulate,plant,poricidal,proximal,pubescent,purple,seed,short,side,simple,stigma,style,subtending,terminal,testal,thick,throughout,tip,tissue,usually,wall,wet,white,whitish,yellow	0-30,1-3,16.2-33,2.4-6.3,3-5,4-5,4.5-11.5,5-merou,5.3-13.3,6.1-9.4,9.7-23.4,9.8-17,ag,alyx,apart,apparently,attenuate,axe,blade,borne,capitat,considerably,decreasing,dense,digestion,dorsally,eaf,edge,eed,end,enzyme,erry,finer,flat,folded,geminat,hal,homostylous,honeycomb-shaped,interjected,larger,leaflet,lengthening,living,lower,nflorescence,orbicular,orolla,pair,pentagonal,perfect,plurifoliate,pore,present,removed,second,semi-erec,sessile,seudostipule,singly,size,slit,spaced,specimen,stolo,straight,substellate,tall,tamen,tem,toward,tri-,tube,tuber,typically,unit,unknow,unwinged,vary,x,ympodial	'',2,[,``,abaxial,adaxial,arrangement,branching,calyx,capitate,characteristic,colour,form,growth,height,inflorescence,length,midvein,na,ovary,primary,pseudostipule,rachi,shape,staman,stem,surface,tertiary,texture,unarmed,unknown,value,vein,venation,{,}
322	wfo-0001029593	success	181	122	95	86	27	0.525	0.5-1,0.5-5,0.8-1.2,1,1-1.2,1-1.5,1-8,1.6-2.3,100,2-14,2.3-3.0,3-4,35-60,4-6,5-10,5-15,abaxially,acuminate,acute,anther,anthesi,anticlinal,apex,apically,arising,attenuate,axil,axillary,base,basiscopically,bearing,berry,brown,calyx,cm,conical,deltate,densely,diameter,elliptic,enlarged,filament,filiform,flower,fruit,glabrous,globose,green,half,irregular,leaf,lobe,long,lower,markedly,minutely,mm,oblique,obovate,occasionally,once-branched,ovary,ovoid-reniform,pair,papillose,pedicel,per,petiole,pinnate,plant,pointed,primary,projection,pubescence,pubescent,rachi,rest,scar,seed,shape,shrub,simple,sinuous,smooth,somewhat,sparsely,style,surface,thickening,trichome,uniseriate,vein,without,woody,x	-10,0.05,0.8-1,1-2,10-50,2,2-3,2-5,2.3,3.5-8,7-25,7.5-15,9-15,abruptly,adaxially,age,always,basal,broadly,capitate,cateniform,cell,clavat,colony,cone,decurrent,dry,drying,eaf,edicel,eed,entire,epidermal,exserted,extremely,free,fruiting,glabrescent,growing,hollow,included,lamina,large,lateral,leaflet,much,narrowing,nflorescence,noddin,often,onto,open,opposite,perfectly,petiolule,place,poricidal,portion,pubescen,purple,rarely,reflecting,ruit,short-styled,similar,single-stemmed,slightly,small,smaller,stigma,tall,tem,terminal,tip,tub,tube,ud,unifoliat,unit,usually,variable,white,white-lenticellate,wider,winged,ympodial	abaxial,adaxial,arrangement,branching,characteristic,colour,corolla,form,growth,height,history,inflorescence,length,life,margin,midvein,na,nodding,peduncle,perennial,pseudostipule,staman,stem,tertiary,texture,unarmed,venation
323	wfo-0001029601	invalid_json	187	134	95	92	39	0.508	0.2-0.8,0.5-5.8,1-2,1-3,1-4,1-53,2,2-12,2-9,2.3-5.9,3-10,3-7,5-41,6-10,abaxially,acuminate,acute,adaxially,anther,apex,articulated,asymmetric,attenuate,axillary,base,basiscopic,berry,brownish,bud,cell,cm,condition,coriaceous,corolla,covering,dark,diameter,distal,dot,drying,elliptic,filament,flower,forked,fresh,fruit,generally,glabrescent,glabrous,globose,green,green-white,greenish,hair,hair-like,half,herb,lanceolate,lateral,leaf,light,lobe,long,make,middle,mm,mucilaginous,odd-pinnate,ovate,ovoid,pedicel,peduncle,petiole,petiolulate,plant,puberulent,ripe,rounded,seed,short,side,slightly,small,style,subtending,terminal,testal,thick,throughout,tissue,usually,wall,wet,white,whitish	0-37,0.5-8,1.1-2.7,1.2-2.3,1.7-6.5,2-3,2-7,2.2-4.5,2.8-10.5,3-5,4-13.5,5-merou,6.6-22,6.8-14.5,abaxiall,acumen,ag,alyx,apart,apparently,axe,blade,borne,capitat,clavate,connivent,decreasing,digestion,dorsally,eaf,edge,eed,end,enzyme,erec,exceeding,flat,folded,geminat,glabrou,homostylous,honeycomb-shaped,interjected,larger,leaflet,lengthening,linear,living,lower,middl,narrow,nflorescence,orbicular,orolla,pair,pentagonal,perfect,plurifoliate,pore,poricidal,removed,rotate,ruit,sessile,seudostipule,singly,size,slit,spaced,specimen,stamen,stigma,stolo,straight,subequal,subglabrou,tall,tamen,tem,tip,toward,tri-,tube,tuber,typically,unit,unwinged,vary,wing,x,yellow,ympodial	'',[,``,abaxial,adaxial,arrangement,branching,calyx,characteristic,colour,form,growth,height,history,inflorescence,length,life,margin,midvein,na,ovary,perennial,primary,pseudostipule,rachi,shape,staman,stem,subglabrous,surface,tertiary,texture,true,unarmed,value,vein,venation,{,}
324	wfo-0001029621	success	165	105	76	89	29	0.461	0.5-0.75,0.7-1.1,0.8-1,1-1.5,1.5-2,1.5-2.5,1.5-5,2.5-3,3-3.5,3.5-4.5,6-8,7-9,acute,anther,apex,appearing,attenuate,base,becoming,berry,branched,brown,calyx,cm,corolla,dark,decurrent,deltoid,dry,erect,filament,fleshy,fruit,glabrate,glabrous,globose,green,irregularly,lanceolate,later,lateral,leaf,live,lobe,many,margin,material,minutely,mm,oblanceolate,often,ovary,ovoid-reniform,pair,pale,pedicel,pitted,plant,puberulent,ripe,sessile,shrub,stem,straight,style,surface,tan,terminal,thick,time,vein,white,whorl-like,woody,x,yellowish	.1,0.5-1,0.5-1.2,0.5-1.5,0.8-4.5,1-2,1/3,2/3,5-20-flowered,6-20,accrescent,along,anthesi,apar,appressed,area,bark,beneath,borne,caudate,cluster,completely,constricted,course,cup-shaped,densely,dia,distal,eaf,edicel,eed,ellipsoid,elongate,enclosed,exsertio,free,fruiting,geminate,late,like,lobed,lon,long,lower,main,merely,middle,nflorescence,occasionally,older,onto,papillate,papillo,papillose,planar,plurifoliat,pore,poricidal,portion,prominent,quite,rarely,reddish,reddish-gre,river,ruit,scar,shaped,shiny,small,somewhat,spaced,ste,stigma,tall,tapering,tear-drop,tip,trichome,tube,ud,uniseriate,unit,way,widened,widest,yellow,ympodial,young	abaxial,adaxial,arrangement,branching,characteristic,colour,diameter,form,growth,height,history,inflorescence,length,life,midvein,na,peduncle,petiole,primary,pseudostipule,rachi,reddish-grey,seed,shape,staman,tertiary,texture,unarmed,venation
325	wfo-0001029622	success	182	90	61	121	29	0.335	.1,.5,0.5-1,0.6-0.9,0.8-1,1-1.2,1.5,2.5-3,3-4,3-5,30-35,4-6.5,5-6,acute,anther,apex,attenuate,base,brown,calyx,chartaceous,cm,corolla,deflexed,diameter,elliptic,entire,filament,flower,fruit,glabrous,globose,green,inflorescence,leaf,lobe,long-acuminate,long-triangular,margin,mm,narrowly,ovate,pair,pedicel,peduncle,petiole,rachi,raised,reddish,rounded,shiny,shrub,simple,single,slightly,stem,style,tapering,vein,white,x	.2,/3,0.3,0.5,0.5-0.7,1-1.5,1-2.7,1-4,2-11,2-4,2-5,40,45-50,7-11,abaxially,absent,accrescent,adaxially,ag,alyx,anthesi,apparently,appearing,arising,axe,axil,bark,beneath,blade,bud,capitat,connivent,consisting,cylindrical,deciduous,differing,difoliate,dimorphic,eaf,eed,elongate,except,free,fruiting,geminate,glabrou,ilament,immature,included,interlaced,internodal,jointed,known,lamina,lateral,less,lobed,long,longitudinal,m.,main,major,mature,measured,midrib,minor,minute,minutely,nflorescence,obconic,oblong,occasionally,often,older,one,onto,opening,opposite,orolla,oung,ovate-lanceolate,papillose,pendent,pore,portion,present,probably,reflexed,remaining,ruit,sagittate,scar,second,shaped,size,slende,slender,slit,somewhat,stellate,stigma,straight,tal,tear-drop,thin,thus,tip,trichome,tube,tuft,ud,unarme,unifoliat,uniseriate,unit,vary,way,within,yellow,ympodial,young	0,abaxial,adaxial,arrangement,branching,characteristic,colour,form,growth,height,history,length,life,midvein,na,ovary,perennial,plant,primary,pseudostipule,seed,shape,staman,surface,tertiary,texture,unarmed,venation,ye
326	wfo-0001029625	success	168	136	109	59	27	0.649	-15,..,0.5-1,0.5-1.3,0.5-2,0.8-1.4,1-1.5,1-2,1-3,1.2-1.6,2,3,3-,3-3.5,4-4,4-5-celled,4-7-celled,4-9,5,5-10,5-6,5-8,8-13,abaxial,along,anther,base,beneath,branched,brittle,calyx,cell,cm,conical,corolla,darker,deflexed,deltate,densely,denser,diameter,dry,elliptic,filament,flattened,four,fruit,glabrescent,glabrous,gland-tipped,globose,green,greenish,growth,herb,inflorescence,lamina,later,like,lobe,long,margin,markedly,midline,mixed,mm,occasionally,outer,outline,ovary,ovate-reniform,pair,pale,papillate,pedicel,peduncle,per,pericarp,point,pointed,primary,pubescent,purplish,rarely,reddish,regularly,scattered,shrub,single,sinuate,small,smooth,sparsely,stem,striate,stripe,style,surface,tan,testa,thin,time,tinged,trichome,uniseriate,vein,wall,white,young	.1-0.2,.5,0.5-2mm,0.8-1.8,100,2.5-.,3-3,4-10,6-9,9-25,anthesi,apical,bark,branc,branch,brow,capitat,cel,cucullate,deflexe,distinct,eaf,edicel,eed,erect,flower,frui,fruiting,gland,glandular,hyaline,lighter,lobed,lower,middle,minute,narrowly,nearly,new,nflorescence,open,planar,plurifoliat,ruit,scar,single-stemmed,slightly,stigma,strongly,tip,triangular,tube,tuft,ud,unit,weight,without,x,ympodial	adaxial,apex,arrangement,branching,brown,characteristic,colour,form,height,history,leaf,length,life,midvein,na,petiole,plant,plurifoliate,pseudostipule,rachi,seed,shape,staman,tertiary,texture,unarmed,venation
327	wfo-0001029645	success	160	132	101	59	31	0.631	0.2-0.5,0.3-0.5,0.5-7,1-1.5,1-2,1-4,1.5,2.5-4,3-10,3-15,3-7,3.5-4,337,4-8,5-8,6-12,7-12,750,?,abaxially,abundantly,acuminate,adaxially,aggregate,along,anther,apart,apex,articulated,base,blue,brown,calyx,cell,chartaceous,cm,corolla,cuneate,cylindrical,decurrent,deltate,diameter,entire,et,extra-axillary,fide,filament,finger,flattened,flower,fruit,glabrous,gland-tipped,globose,green,greenish,hair,herb,immature,kayap,knapp,line,lobe,margin,membranaceous,mesocarp,minutely,mm,moderately,obtuse,ovate,ovate-elliptic,pedicel,peduncle,perfect,petiole,puberulent,purple,rachi,rarely,red,rugose-verrucate,sand-punctate,side,simple,small,smith,spaced,sparsely,stone,style,subcordate,triangular,truncate,unbranched,vein,veiny,white,wide,x,Â±	-1,.5-1,0.5-2.5,1,1.3-7,1.5-2,2-3-foliat,2-4,2.5-17,4-5,5,acute,around,axe,ba,blade,connivent,directed,distall,distally,eaf,eed,except,free,glabrou,inserted,long,lower,major,nearly,nflorescence,orolla,part,pore,puberulen,radiu,rotate-stellate,ruit,sagittate,short,short-tomentose,shorter,shru,stigma,strongly,tal,tamen,tapered,tem,thecae,tightly,time,tomento,truncat,tube,unit,vary,yellow,ympodial	0.5-1,abaxial,adaxial,arrangement,branching,characteristic,colour,form,growth,height,history,inflorescence,leaf,length,life,midvein,na,ovary,plant,primary,pseudostipule,seed,shape,shrub,staman,stem,surface,tertiary,texture,unarmed,venation
328	wfo-0001029646	invalid_json	141	104	65	76	39	0.461	0.1-0.6,0.5,0.7-2.2,1-4,1.5-2,10-15,2-3,4-5.5,5-15,6-8,acuminate,acute,apex,articulate,attenuate,base,branched,calyx,cell,cm,corolla,covering,cyme,diameter,dichasial,dichasially,distal,ebracteate,elliptic,filament,finely,globose,green,green-white,hair-like,herbaceous,lateral,leaf,lobe,long,mm,monochasial,mucilaginous,mucronate,narrowly,ovate,ovoid,pedicel,peduncle,perennial,petiole,plant,proximal,pubescent,seed,simple,style,testal,thick,throughout,tone,wall,white,yellow-green,Â¼	0.5-0.8,1.5-4.9,3-14,3-6-foliat,7-15,abaxially,acumen,adaxially,apical,apically,commonly,dehiscent,digestion,dorsally,eaf,edge,eed,emoval,enzyme,epiphytic,equaling,flat,flower,folded,forked,free,generally,globo,ground,growing,half,honeycomb,introrse,linear,living,lon,lower,make,maturing,mos,mould,nflorescence,nther,oak,often,orolla,ovat,pattern,perfect,pine,plan,poricidally,rarely,reveal,ruit,seudostipule,short,slit,specimen,stamen,stellate,stigma,straight,tall,tem,throughou,tree,tuber-bearing,typically,unit,vary,viole,wide,without,yellow,ympodial	'',[,``,abaxial,adaxial,anther,arrangement,branching,characteristic,colour,form,fruit,growth,height,history,inflorescence,length,life,margin,midvein,na,ovary,primary,pseudostipule,rachi,shape,staman,stem,surface,tertiary,texture,unarmed,value,vein,venation,violet,wet,{,}
329	wfo-0001029652	success	160	123	91	69	32	0.569	.3,.5,0.5-1,0.5-4,0.75-1,0.8-1,1-3,1.5-2,2-2.5,2.5-3,3.5-4,4-4.5,7-9,abaxially,adaxially,anther,anthesi,apex,apical,arching,attenuate,base,berry,broadly,calyx,cm,corolla,curling,deflexed,deltate,elliptic-ovate,evenly,exserted,filament,filiform,fruiting,glabrous,globose,golden,green,greenish-white,hard,hispid,leaf,lobe,long,long-acuminate,long-styled,margin,maturity,minor,minute,minutely,mm,narrowly,near,occasionally,ovary,ovoid-reniform,pair,pale,pedicel,pericarp,petiole,pitted,pore,poricidal,projection,pubescent,reddish-brown,scar,shaped,short-styled,shrub,simple,slender,spaced,stem,style,surface,swollen,tan,tear-drop,tip,trichome,tube,undulate,uniseriate,vein,white,x	.25,1,1-2,2,2-4,25,3/4,6-15,along,apar,ape,arch,ba,bark,bearing,cone,conical,deciduous,denser,dia,differing,difoliate,drying,eaf,edicel,eed,flower,free,geminat,golden-red,heteromorphic,included,joining,lamina,lateral,like,lobed,lon,lower,main,major,middle,midrib,nflorescence,older,opposite,papillo,papillose,portion,reflexed,ruit,series,size,slende,slightly,soon,sparsely,stigma,tall,thickened,time,tub,ud,unit,way,widest,within,ympodial,young	0.5,abaxial,adaxial,apart,arrangement,branching,bud,characteristic,colour,diameter,form,fruit,growth,height,history,inflorescence,length,life,midvein,na,peduncle,plant,primary,pseudostipule,rachi,seed,shape,staman,tertiary,texture,unarmed,venation
330	wfo-0001029673	success	159	102	76	83	26	0.478	0.5-1,0.7-1.1,0.8-1,1-10,1-2,1-5,1.5-2,10-20,2-2.5,2.5,4-6,abaxial,acuminate,acute,adaxial,anther,apex,appearing,base,berry,black,branch,branching,calyx,cm,corolla,deep,deltoid,dendritic,densely,diameter,elliptic,filament,fork,fruit,glabrous,globose,greyish,greyish-yellow,growth,later,lateral,leaf,length,lenticular,lobe,long,minutely,mm,monochasial,narrowly,occasionally,ovary,overtopping,pair,pedicel,petiole,pitted,pubescent,purple,reddish-brown,shoot,shrub,small,sparsely,stem,style,surface,terminal,tree,triangular,trichome,vein,violet,winged,x	.5,0.75-1,1.2-3.5,1.5-1.8,2-3,2-4,3-5,3/4,5-25,5.5-15,abaxially,absent,accrescent,adaxially,age,along,anthesi,apical,bark,basal,becoming,blade,broadly,clavate,conical,decurrent,deflexed,denser,dichasia,eaf,edicel,eed,ew,exserted,flower,free,fruiting,greyish-yello,individual,inserted,lamina,like,lon,longer,lower,m.,nflorescence,nodding,older,papillo,pericarp,petal,planar,plurifoliate,pore,poricidal,portion,prominent,pyramidal,reflexed,ruit,scar,secondary,sleeve,slightly,slit-like,somewhat,stamen,stigma,strongly,tall,tapering,thin,time,tip,tub,tube,ud,unit,wide,woody,ympodial,young	3.5,arrangement,characteristic,colour,dichasial,form,height,history,inflorescence,life,margin,midvein,na,peduncle,perennial,plant,primary,pseudostipule,rachi,seed,shape,staman,tertiary,texture,unarmed,venation
331	wfo-0001029680	success	212	131	104	108	27	0.491	0.1,0.5â1.5,0.6â1.2,1.0â1.1,1.0â1.5,1.0â1.8,1.1â1.2,1.7â7,1.8â3.8,11â16,11â25,12,1â2,2.2â4.2,3.0â4.2,3.3â5.5,3â6,4.0â6.5,4.5â20,4.5â7.0,4â10,50,5â11,abaxially,acute,adaxially,annual,anther,anthesi,apart,apex,articulated,axillary,base,becoming,bipinnate,blue,borne,branched,brown,calyx,cm,cylindrical,decurrent,diameter,divided,filament,flattened,fleshy,fruit,glabrous,globose,green,herb,leaf,length,light,lobe,long,margin,mm,moderately,oblong,obovate,obtuse,ovate,pair,pale,pedicel,peduncle,pendant,petiole,pinnae,pinnate,pitted,primary,pubescent,purple,rarely,red,ripe,shallowly,shoot,sometimes,spaced,sparsely,stem,straight,style,subglabrous,surface,terminal,tertiary,time,tripinnate,turning,violet,white,winged,woody,x,â10,â12.5,â3	.0,0.4,0.6,0.6â2.0,0.9â1.0,1,1.0,1.4â2.5,1.4â7.5,1.5,1.6â2.7,10,1â3,1â6,1â8,2â20,3â22,4.0â16,4â30,5,5.5â8.5,7â10,8â32,absen,adaxiall,ag,along,appressed,arequipa,arranged,asymmetrically,axe,ba,beyond,blade,cell,clavate,connivent,decreasing,densely,difoliate,eaf,eed,entire,equal,erect,extending,flange,flower,forming,geminat,hair,indistinct,irregularly,lon,longitudinal,lower,m.,midrib,multicellular,narrow,nflorescence,node,occasionally,often,opening,orolla,parallel,pentagonal,perfect,plurifoliate,pore,poricidal,prostrate,rapidly,rotate,ruit,running,secondary,shaped,side,simple,size,specimen,split,stigma,stone,tacna,tal,tamen,tear-drop,tem,tip,tube,unicellular,uniseriate,unit,usually,vary,wide,wing,winge,yellow,ympodial,â19,â3.2,â46,â48	1-2,abaxial,adaxial,arrangement,branching,characteristic,colour,corolla,form,growth,height,history,inflorescence,life,midvein,na,ovary,plant,pseudostipule,rachi,seed,shape,staman,texture,unarmed,vein,venation
332	wfo-0001029704	success	146	106	75	71	31	0.514	0-1.5,1.5,1.5-2.5,1.5-3,1000-1200,2-2.5,2-3,3-5,4,5,7-10,acuman,acuminate,acute,anther,anthesi,apex,base,blue,branch,broadly,brown,calyx,cm,composed,conical,corolla,cuneate,dark,deeply,ellipsoid,extra-axillary,few-flowered,filament,flower,fork,glabrous,globose,green,halfway,leaf,less,lobe,lobed,long,minutely,mm,mottled,obovate,occasionally,one,ovary,pedicel,peduncle,petiole,pinnatisect,pubescent,purple,record,reddish,reticulate,rounded,short,shrub,simple,single,stellate,striped,style,subdiscoidal,surface,trichome,variously,vein,white	-17,-3,.5,0.5,1,1-2,1-4,10-14,140-185,15-25,2-5,3-4-celled,4-7,7-,9-20,along,also,apparently,aspect,axi,berry,c.,cell,cunate,cut,deflexed,dia,diam,eaf,eed,enlarged,erect,especially,exerted,flowering,fruiting,gradually,lanceolate,lengthening,lower,midrib,minute,moderately,nflorescence,obovoid,plurifoliat,pore,poricidal,ruit,shoot,sinus,slit,sombre,sprawling,stigma,stone,stout,straight,subglobo,swollen,tip,tub,tube,twig,ud,unit,variable,within,x,ympodial,young	abaxial,adaxial,arrangement,branching,characteristic,colour,diameter,form,fruit,growth,height,history,inflorescence,length,life,margin,midvein,na,plant,plurifoliate,primary,pseudostipule,rachi,seed,shape,staman,stem,tertiary,texture,unarmed,venation
333	wfo-0001029727	success	260	101	80	180	21	0.308	-3,0-30,0-4,0.4-1,0.7-0.9,1-1.2,1-4,1.6-3,1/3-1/2,1/4,2.8-4,3-6,3-7,4.5,5.5-7,abaxial,acuminate,acute,adaxial,anther,anthesi,apex,apically,articulated,base,berry,calyx,chartaceous,climber,cm,cordate,corolla,densely,diameter,erect,filament,filiform,finely,glabrous,lateral,leaf,length,lobe,lobed,long,lower,margin,mauve,midvein,mm,orange-brown,ovate,pair,pedicel,peduncle,per,petiole,pitted,primary,raised,red-brown,rounded,scandent,seed,shallowly,shape,shrub,simple,stellate-pubescent,stem,style,subentire,surface,terminal,tertiary,unarmed,upper,vein,venation,visible	-1/3,-10,.5,/3,0-15,0-2,0-20,0-40,0-5,0-8,0.1-5,0.15-0.2,0.15-0.3,0.2,0.2-0.5,0.2-2.5,0.3,0.4,0.5,0.5-1.2,0.5-3,0.7-1,1,1-,1-2,1.2-2,1.5-2.3,1.5-2.5,1.5-3,1.5-5.5,1/2-2/3,1/8-1/5,2-5,2.5,2.5-3.2,2.5-5.5,3-11,3/,4-7,4-merou,4-merous,4.5-,5-12,5-8,5-9,6-11,7-10,abaxially,acicular,age,almost,along,alternate,alyx,ame,apar,apart,apparently,bark,blade,branched,bristle,brown,c.,clavate,colourles,connivent,covered,cupular,curved,darker,deltate,deltoid,developing,different,dimorphic,discolorous,divided,drying,eaf,edge,eed,elongating,equal,except,extending,ferrugineous,filiform-acuminat,fissure,flattened-reniform,flower,free,geminate,increasing,inside,lengthening,less,like,lon,longer,m.,mature,middle,midpoint,minor,minutely,mixture,moderately,narrow-deltate,nflorescence,nther,obconical,oblong,occasional,older,one,open,orolla,oung,outside,papillo,papillose,perfec,perfect,pit,plurifoliat,pore,poricidal,porrect,portion,prickl,prickle,prickly,protruding,pubescent,rarely,ray,red-brow,reddish,reduced,regular,scar,series,sessile,short,sinus,size,smooth,sometimes,spaced,spreading,stalk,stalked,stellate,stigma,straight,strongly,tamen,tapering,tearing,terete,time,tip,toward,translucent,transverse,trichome,tube,uneven,unit,variable,variously,vary,violet,way,wide,x,yellowish,ympodial,young	3/4,arrangement,branching,characteristic,colour,false,form,fruit,growth,height,history,inflorescence,life,na,ovary,perennial,plant,pseudostipule,rachi,staman,texture
334	wfo-0001029731	success	246	130	108	138	22	0.439	.5,1,1-2,1-2.5,1.5,1.5-2.5,2-3,2.5,3-4,4,4-5,4-9,6-7,7-11,8-9,acquiring,acuminate,acute,along,anther,apex,apically,basally,base,beak,berry,black,branch,branched,branching,broadly,brown,calyx,cm,conical,coriaceous,corolla,crinkled,cuneate,deltoid,diameter,dilated,distributed,drying,elliptic,entire,epiphyte,erect,evenly,faint,filament,filiform,flattened,fleshy,fruit,glabrous,lateral,leaf,less,liana,like,linear,lobe,long,long-ellipsoid,longitudinal,margin,maturity,mauve,midvein,mm,obovate,obtuse,often,orange-brown,pair,papillae,pedicel,peduncle,pendulous,petiole,primary,pyriform,rachi,revolute,ridge,ridged,rounded,several,slender,sometimes,sparsely,stem,straight,stretched,style,succulent,surface,terminal,thick,tuft,vein,venation,white,wide,woody,x,yellow-green	.6,0.05,0.1-0.8,0.25-0.3,1-1.5,1.5-3,1/3,10-20,1994,2,2-6,2.5-4.5,3,3-10,31,6,abaxially,accrescent,adaxially,age,almost,alyx,anthesi,apar,apparently,arcy,articulated,bark,basal,becoming,boundary,bumpy,clavate,clearly,concolorous,connate,darker,delimited,delineated,dense,development,different,domatia,dorsal,dorsifixed,dry,dull,eaf,early,elongating,enlarge,equal,even,exserted,fine,finely,flaring,flower,free,fruiting,ground,hair,iscoid,lamina,large,later,lengthening,lobed,lon,longitudinally,lower,main,mature,much,narrowly,nflorescence,nther,obconical,oblong,occasionally,orolla,papillose,part,perfec,pericarp,persisting,plurifoliat,pore,poricidal,portion,prominent,protruding,raised,rakotozafy,rarely,reflexed,reported,ribbed,ruit,scar,see,shallowly,shorter,simple,sinus,slightly,small,smaller,smoot,stigma,stump,sunk,tearing,thickened,thinner,though,time,tip,toward,trichome,tub,tube,ud,unit,usually,vary,ventral,visibl,visible,well-developed,widely,wing,winged,wrinkling,yellow,ympodial,young,â	abaxial,adaxial,arrangement,characteristic,colour,form,growth,height,history,inflorescence,length,life,na,ovary,plant,pseudostipule,seed,shape,staman,tertiary,texture,unarmed
335	wfo-0001029741	success	137	94	66	71	28	0.482	.4,.5,0.9-1.2,1-1.5,1-3.5,1.1-1.3,1.5-4,1.5-6,10-50-flowered,?,acute,age,anther,apex,apiculate,attenuate,base,becoming,berry,black,branched,calyx,cm,completely,corolla,dark,deltoid,dia,drying,elliptic,filament,fruit,furcate,glabrous,globose,green,growth,immature,inflorescence,known,leaf,lenticellate,lighter,lobe,long,minutely,mm,opposite,ovary,ovate,papillose,pedicel,petiole,shrub,slender,stem,straight,style,tapering,tree,tube,usually,vein,weak,white,x	0.5-1.5,0.8-3.5,1.5,2-2.5,2.2-9,2.5-7.8,3,9.5-22.5,accrescent,anthesi,ca,caly,capitate,closely,deflexed,differing,difoliate,divisio,dry,eaf,early,edicel,eed,erect,exserted,flower,free,fruiting,geminat,glabrou,lateral,lobed,lon,lower,main,major,middle,minor,nearly,new,nflorescence,overlapping,pair,papillo,planar,pore,poricidal,portion,produced,prominent,proximal,quite,raised,reddish-brown,ruit,scar,shaped,size,slightly,spaced,stigma,tall,tear-drop,tip,ud,unit,variable,widest,wood,woody,ympodial	abaxial,adaxial,arrangement,branching,characteristic,colour,diameter,form,height,history,length,life,margin,midvein,na,peduncle,plant,primary,pseudostipule,rachi,seed,shape,staman,surface,tertiary,texture,unarmed,venation
336	wfo-0001029744	success	113	102	67	46	35	0.593	0.3-0.6,2,5-8,50,8-10-flowered,8-11,abaxially,acute,adaxially,apex,base,blunt,calyx,cm,deltate,dendritic,densely,difoliate,elliptic,entire,extreme,flattened,flexuous,form,fruit,geminate,glabrescent,glabrous,golden,incrassate,lanceolate,leaf,lobe,long-acuminate,margin,minutely,mm,narrowly,node,non-reproductive,oblanceolate,oblique,occasionally,ovoid-reniform,pair,pale,pedicel,petiole,pitted,primary,pubescent,revolute,shape,shrub,simple,slightly,sometimes,somewhat,stem,surface,thin,tip,trichome,unifoliate,vein,white,x	0.5-1,1,1.5,1.5-3.2,2-4,7-15,along,apart,bark,beginning,branch,brow,denser,distinct,eaf,eed,examined,fide,inflorescenc,lamina,leave,looping,lower,major,marginal,mature,minor,nflorescence,older,opposite,pubescence,scar,see,similar,single-celled,small,smaller,smith,spaced,thee,ud,unicellular,uniseriate,unit,ympodial,young	abaxial,adaxial,anther,arrangement,branching,brown,characteristic,colour,corolla,diameter,filament,green,greyish,growth,height,history,inflorescence,length,life,midvein,na,ovary,peduncle,plant,pseudostipule,rachi,seed,staman,style,tertiary,texture,unarmed,venation,yellow,yellow-green
337	wfo-0001029746	success	179	99	74	105	25	0.413	0.3-2,0.7-1,1,1-1.3,1-1.5,2-2.5,2-8,3,3-4,6,8-10,8-11,acuminate,acute,anther,apex,base,berry,brown,calyx,centre,cm,conical,cordate,corolla,dark,darker,densely,diameter,elliptic,entire,filament,flattened,fleshy,fruit,glabrous,glandular,globose,greenish,herb,hollow,inflorescence,internodal,leaf,lobe,margin,mm,narrowly,orange,ovary,ovate,ovoid,pair,pale,pedicel,peduncle,petiole,pitted,primary,principal,pubescent,purple,rachi,red,reddish,shallowly,simple,sparsely,stem,style,subshrub,surface,vein,x	.5,0.5-1,1.2-1.5,1.5,2,2-4,2-7,3-4-pluri-foliate,3-4.5,3-6,4-9,6-7,abaxially,adaxially,age,anthesi,apart,bearing,becoming,blackish,broadly,c.,capitate,cell,ciliate,color,crenate,crowded,cup-shaped,curved,eaf,edicel,eed,ellipsoid,enlarged,erect,exerted,flower,flush,free,fruiting,gland-tipped,growing,heteromorphic,horn,irregularly,lamina,lengthening,less,lon,long,longer,longest,lower,markedly,mature,maturit,mid-length,minutely,mixed,near,nflorescence,nodding,occasionally,papillo,papillose,pericarp,plan,pore,poricidal,portion,pubescen,reflexed,ruit,scar,shortest,single,slender,slightly,slit,somewhat,spaced,sparse,spreading,stigma,straight,strongly,testal,thin,third,tip,triangular,trichome,tube,ud,uniseriate,unit,upper,upward,wall,widely,widest,woody,ympodial,â3	1.5-3,abaxial,adaxial,arrangement,branching,characteristic,colour,form,growth,height,history,length,life,midvein,na,perennial,plant,pseudostipule,seed,shape,staman,tertiary,texture,unarmed,venation
338	wfo-0001029769	success	142	116	81	61	35	0.57	.25,.5,0.5-1.5,1-1.2,1-3,1.5-2.5,2.5-3,3.5-4,30-60-flowered,5-8,6-17,7-8,8-9,abaxially,acuminate,acute,adaxially,along,anther,apex,base,bearing,berry,brown,calyx,cm,corolla,dark,deflexed,deltoid,densely,dia,elliptic,filament,filiform,flower,fresh,glabrous,globose,golden,green,hen,horizontally,leaf,like,lobe,long,main,margin,midrib,minutely,mm,onto,ovary,ovoid-reniform,pair,pedicel,petiole,pitted,puberulent,pubescent,ried,scattered,shrub,simple,smooth,sparsely,stem,style,surface,three,time,tip,trichome,two,uniseriate,vein,white,wide,winged,x	1.5-2,2.5-8,4,4-5,8.5-17,anthesi,apar,ape,archin,ba,bark,branch,brochidodromu,capitate,cerro,conical,curl-tipped,cyathiform,eaf,edicel,eed,exserted,free,fruiting,inglÃ©,internodal,lateral,less,lobed,lon,lower,nearly,nflorescence,older,opposite,papillo,papillose,pore,poricidal,portion,reflexed,ruit,scar,shaped,somewhat,spaced,stigma,straight,swollen,tall,tear-drop,tub,tube,ud,unevenly,unifoliat,unit,widely,woody,ympodial,young	abaxial,adaxial,arching,arrangement,branching,characteristic,colour,diameter,form,fruit,greyish,growth,hair,height,hirsute,history,inflorescence,length,life,midvein,na,peduncle,perennial,plant,primary,pseudostipule,rachi,seed,shape,staman,tertiary,texture,unarmed,unifoliate,venation
339	wfo-0001029780	invalid_json	204	121	88	116	33	0.431	1-2,15-22,15-45,2-2.8,2-3.5,2-5.5,4-6,4.5-6,5-7,8-12,absent,acute,anther,apex,articulated,attenuate,axillary,base,berry,brownish,bud,cell,chartaceous,cm,condition,cordate,corolla,covering,cuneate,dark,densely,diameter,distal,drying,filament,flower,forked,fresh,fruit,generally,glabrous,globose,green,greenish,hair,hair-like,half,herb,high,invested,lateral,length,like,lobe,long,margin,membranous,minute,mm,non-glandular,obtuse,odd-pinnate,ovate,ovoid,pale,pedicel,peduncle,petiole,pinkish,plant,pubescent,seed,short,stem,streak,stripe,style,subtending,terminal,testal,thick,trichome,truncate,usually,wall,white,whitish,yellow	1-1.2,1-10,1.4-1.9,1.5-2,11-24,120-210,2-12,2-2.5,2.4-4.2,20-60,3,3-6,3.5-7.3,5-merou,5.5,5.5-13,50-70,600-950,?,abaxially,acumen,adaxially,ag,along,alyx,apart,apparently,axe,blade,borne,capitat,ciliate,connivent,decumbent,digestion,dorsally,eaf,edge,eed,end,enzyme,erec,especially,exceeding,except,flat,folded,geminat,glabrou,gland,glandular,greatly,green-white,hal,head,homostylous,honeycomb-shaped,interjected,lanceolate,leaflet,lengthening,living,longer,lower,make,midrib,minutely,mucilaginous,nflorescence,often,orbicular,orolla,pair,perfect,petiolulate,petiolule,plurifoliate,pore,poricidal,proximal,puberulent,rarely,reduced,removed,ripe,rotate,ruit,sessile,seudostipule,singly,size,slit,spaced,specimen,stamen,ste,stigma,stolo,straight,subequal,tall,tamen,tem,tetralobulate,throughout,tip,tri-,tube,tuber,typically,unit,unwinged,vary,wet,x,ympodial	'',2,[,``,abaxial,adaxial,arrangement,branching,calyx,characteristic,colour,form,growth,height,inflorescence,leaf,midvein,na,ovary,primary,pseudostipule,rachi,shape,staman,surface,tertiary,texture,unarmed,value,vein,venation,{,}
340	wfo-0001029784	success	237	141	118	119	23	0.498	-12,-5,.2,.5,0.2,0.25-0.3,0.4-0.45,0.5,0.5-1.5,0.6-1,1-1.1,1-1.2,1-4,1.7-2.6,2,2-2.5,2-3-celled,2-locular,2/3,5-10,abaxial,abaxially,acuminate,acute,adaxially,adpressed,along,anther,apex,appearance,arising,articulated,axi,base,brown,calyx,cell,cm,column,corolla,crenate-serrate,dark,densely,diameter,distal,due,eglandular,elliptic,exserted,filament,flower,fruit,giving,glabrescent,glabrous,glandular,globose,golden,green,hair-like,half,head,imparipinnate,included,inflorescence,interrupted,lanceolate,lateral,like,lobe,long,margin,maturing,mm,multicellular,narrowly,obovate,outgrowth,ovary,pale,paler,patent,pedicel,peduncle,perennial,petiole,plant,primary,proximal,pseudostipule,pubescence,pubescent,rarely,ripe,scattered,silky,simple,soft,sparsely,staminal,stem,stout,stripe,style,surface,tertiary,testa,trailing,trichome,truncate,uniseriate,unseriate,vein,velvety,wall,white,winged,yellow	.1,0-4,0.1-,0.1-0.15,0.1-0.5,0.2-,0.2-0.3,0.2-0.5,0.3-0.35,0.3-0.4,0.3-0.5,0.3-1,0.4-,0.4-0.5,0.4-0.6,0.5-,0.7-1.2,0.9-1.2,1,1-,1-1.5,1-2,1-2-celled,1.0-1.3,1.2-2.5,1.5-,1/3,2-,2-4,2-4.5,2-foliate,2.5-3.5,3-,3-5,5-14,5-8,absent,abundant,angled,anthesi,apical,appendage,articulation,basal,basicopically,beneath,berry,bract,broadly,capitate,conical,crenation,decurrent,deeper,developed,distributed,eaf,edicel,eed,enclosing,entire,evenly,fruiting,gree,hal,halfway,herb,interjected,internode,interspersed,irregularly,lamina,larger,leaflet,live,lon,long-acuminate,loosely,lower,markedly,mostly,nflorescence,node,northern,occasionally,often,orbicular,pair,pentagonal,petiolule,population,present,reflexed,robust,ruit,secondary,sessile,smaller,sometimes,somewhat,sparse,spreadin,sterile,stigma,straight,strongly,tem,terminal,thick,tube,ud,undulate,unicellular,unit,usually,wide,woody,x,ympodial	0.1,0.1-0.3,adaxial,arrangement,branching,characteristic,colour,form,growth,height,history,leaf,length,life,midvein,na,rachi,seed,shape,staman,texture,unarmed,venation
341	wfo-0001029785	invalid_json	223	151	119	104	32	0.534	0.1-0.5,0.8-1,1-1.2,1-10,1-2,1-5,1.2-3.2,1.5-3.6,1.8-3.5,10-26,2-4,3-6,3-8,3.5-5,3.8-7.2,5-16,5-9,6,8-11,abaxially,absent,acute,adaxially,along,anther,apart,apex,articulation,attenuate,axillary,base,berry,brownish,bud,cell,chartaceous,cm,commonly,condition,corolla,covering,cuneate,dark,darker,denser,diameter,distal,drying,filament,flower,forked,fresh,fruit,generally,glabrous,globose,green,green-white,greenish,hair,hair-like,half,herb,invested,lateral,leaf,like,lobe,long,make,margin,membranous,middle,minute,mm,mottled,mucilaginous,multiple-celled,non-glandular,oblique,odd-pinnate,outer,ovoid,pedicel,peduncle,petiole,plant,point,pubescent,purple,purple-tinged,quite,ripe,rounded,scale-like,seed,short,slightly,spaced,sparsely,stem,style,subglabrous,subtending,terminal,testal,thick,throughout,typically,unbranched,usually,variable,vein,violet,wall,wet,whitish,wide,x	0-2,0-3,0.3-2.2,0.4-4.9,1.8-7,3-4,4-10.5,5-merou,acumen,ag,alyx,apparently,axe,blade,borne,broadly,capitat,clavate,connivent,cordate,decreasing,decumbent,digestion,dorsally,eaf,edge,eed,elliptic,end,enzyme,erec,especially,exceeding,flat,folded,geminat,glabrou,greatly,homostylous,honeycomb-shaped,interjected,lanceolate,larger,leaflet,lengthening,living,lower,markedly,medium,midrib,minutely,much,nflorescence,obovate,obtuse,one-quarte,orbicular,orolla,ovate,pair,pale,pentagonal,perfect,petiolulate,petiolule,plurifoliate,pore,poricidal,present,puberulent,rarely,removed,rotate,ruit,sessile,seudostipule,shallowly,singly,size,slit,sometimes,specimen,stamen,ste,stigma,stolo,straight,stripe,tall,tamen,tem,tip,toward,tri-,truncate,tube,tuber,unequal,unit,unwinged,vary,white,yellow,ympodial	'',[,``,abaxial,adaxial,arrangement,branching,calyx,characteristic,colour,form,growth,height,inflorescence,length,midvein,na,one-quarter,ovary,primary,pseudostipule,rachi,shape,staman,surface,tertiary,texture,unarmed,value,venation,{,}
342	wfo-0001029789	success	167	116	85	82	31	0.509	0-2,0.2-0.5,1-2,1-3,12,2-25,2-6,2-6.5,2.7-4.7,3-8.5,4-13,5-7,6,6-7,8-9,acuminate,acute,anther,apex,articulated,axillary,base,basiscopic,blue,broadly,bud,chartaceous,cm,corolla,dark,decurrent,diameter,distal,filament,flower,forked,fruit,generally,glabrous,green,hair,half,herb,interjected,leaf,leaflet,light,like,lilac,linear,lobe,long-attenuate,lunate,membranous,minute,mm,mottled,narrowly,odd-pinnate,orbicular,ovary,ovate,pair,pedicel,peduncle,petiole,petiolulate,plant,pubescent,rachi,rarely,sessile,short,side,sparsely,star,style,subglabrous,subtending,terminal,tinged,typically,usually,white,x	0.5-2.8,0.8-3.5,1-10,1.5-2,1.7-8.5,1.8-6.5,2-3,3-5,4-10,5-merou,7-16.6,7-21,abaxially,acumen,adaxiall,adaxially,ag,alyx,apart,apparently,attenuate,axe,blade,capitat,clavate,connivent,decreasing,dorsally,eaf,edge,eed,erec,exceeding,flat,folded,formed,geminat,greatly,hal,homostylous,lanceolate,lant,lateral,lengthening,long,lower,maturing,minutely,never,nflorescence,orolla,pentagonal,perfect,plurifoliate,pore,poricidal,pubescen,purpl,rotate,seudostipule,simple,size,slightly,slit,spaced,stamen,ste,sterile,stigma,straight,subequal,tall,tamen,tem,tip,toward,tri-,tube,unit,vary,yellow,ympodial	abaxial,adaxial,arrangement,branching,calyx,characteristic,colour,form,growth,height,history,inflorescence,length,life,margin,midvein,na,perennial,primary,pseudostipule,purple,seed,shape,staman,stem,surface,tertiary,texture,unarmed,vein,venation
343	wfo-0001029810	success	149	108	77	72	31	0.517	0.5-1,0.5-3,1-1.3,1-1.5,1-10,1-2,1.1-2.3,1.5-3,2.5-3,3-3.5,3-4,5-15-flowered,5-6,8-12,acuminate,acute,adaxially,along,anther,apex,apically,arachnoid,attenuate,base,berry,brown,calyx,cm,congested,corolla,dark,deltate,dendritic,densely,dia,elliptic,filament,glabrous,globose,green,inflorescence,internodal,leaf,like,lobe,long,margin,minutely,mm,narrowly,occasionally,opposite,ovary,ovoid-reniform,pale,pedicel,petiole,pitted,pointed,pubescent,reddish-brown,rest,shining,shrub,simple,small,sparsely,stem,style,surface,tan,tree,trichome,vein,white,wide,yellowish	.25,.5,1-3,2-3,2-5,3-6,4-10,5-16,abaxially,anthesi,ape,bark,capitate,closely,compact,compressed,conical,deflexed,differing,difoliate,drying,eaf,edicel,eed,ellipsoid,exserted,fleshy,free,fruiting,geminat,glabrou,large,later,lateral,lenticel,less,lobed,lon,lower,main,major,middle,minor,nearly,nflorescence,older,overlappin,papillo,papillose,planar,pore,poricidal,portion,ruit,scar,shaped,size,slender,spaced,stigma,tall,tapering,tear-drop,tip,tub,tube,ud,unit,widest,woody,ympodial,young	0.25,abaxial,adaxial,alternate,arrangement,branching,characteristic,colour,diameter,form,fruit,growth,height,history,length,life,midvein,na,peduncle,perennial,plant,primary,pseudostipule,rachi,seed,shape,staman,tertiary,texture,unarmed,venation
344	wfo-0001029811	success	225	123	101	124	22	0.449	-3,0,0-30,0-35,0.3-1,0.5-2,0.8-1.5,1.3-1.7,1.5-6,1/3,13-20,2-2.5,2-5,2.8-3.2,3-5,3-5.5,3.5-4.5,4.5-5,5-17,5-40,7-18,7-9,abaxial,adaxial,anther,apex,apically,apparently,articulated,base,berry,brown,calyx,cell,cm,cordate,cuneate,dark,diameter,elongate,erect,faint,filament,flattened-reniform,fruit,glabrous,glandular,hair,herb,lateral,leaf,length,lobe,lobed,long,long-styled,lower,margin,maturity,mauve,midvein,minute,mm,moderately,narrow-deltate,obtuse,often,orange-brown,outline,ovate,pair,pedicel,peduncle,per,petiole,pit,plant,prickle,primary,raised,short-styled,shrub,simple,small,smooth,sometimes,spherical,stellate-pubescent,stem,style,surface,tertiary,unarmed,unbranched,upper,vein,venation,wide,yellow,yellow-green,young	-6,-merous,.5,/3,0.1-0.3,0.1-0.4,0.2,0.2-0.6,0.3-1.5,1,1-1.5,1-2.5,1-3,1.5-2.5,1/,1/2-2/3,1/3-2/3,10-22,15-23,15-50,2-5.5,2.5-3,20-100,3-7,4-8,5,5-11,5-9,6-12,8-12,8-18,abaxially,acicular,alyx,andromonoecious,apar,apart,bark,blade,broad-deltate,chartaceous,connivent,cream,densely,discolorous,distal,distance,drying,eaf,eed,elongating,equal,extending,eye,fewer,flattened,flower,free,fruiting,green,green-brow,hermaphrodite,heterostylous,inflated,infructescence,less,lobing,long-acuminat,longer,lowermost,marking,mature,midpoint,multangulate,naked,nflorescence,older,one,open,orolla,oung,pale,pendulous,pericarp,perpendicular,plurifoliat,poricidal,porrect,portion,prickl,prickly,ray,ruit,scandent,scar,secondary,sessile,short,shorter,side,slightly,spaced,sparsely,spreading,stalk,stalked,staminat,stellate,stout,straight,tamen,tapering,terete,time,tip,trichome,tube,unit,usually,vary,visible,way,woody,ympodial	1/2,arrangement,branching,characteristic,colour,corolla,form,growth,height,history,inflorescence,life,long-acuminate,na,ovary,perennial,pseudostipule,rachi,seed,shape,staman,texture
345	wfo-0001029978	success	208	133	101	107	32	0.486	0.5-0.6,1-2,1.3-1.5,1.4-1.5,1.5-3.1,11-19,15-27,3-5,3-7,3.2-2.5,3.7-8.1,4-11,4.2-5.2,5,8-10,abaxially,acuminate,adaxially,anther,apex,articulated,asymmetrical,attenuate,axillary,base,basiscopic,berry,brownish,bud,cell,chartaceous,cm,coarsely,commonly,condition,conical,corolla,covering,dark,diameter,distal,drying,elliptic,filament,finely,flower,forked,fresh,fruit,generally,glabrous,green,green-white,greenish,hair,hair-like,half,herb,lateral,leaf,light,like,lobe,long,make,margin,medium,membranous,middle,minute,mm,mottled,mucilaginous,odd-pinnate,ovate,ovoid,pedicel,peduncle,petiole,plant,pubescent,purple,ripe,seed,side,simple,sparsely,stem,style,subsessile,subtending,symmetrical,terminal,testal,thick,throughout,tissue,usually,wall,wet,whitish	0.3-0.4,0.3-0.7,0.7-1.9,0.8,0.9-2.3,1-10,1.8-5,2-4,3.1-6.3,3.5-9.5,4-7,5-16.5,5-merou,acumen,ag,along,alyx,apart,apparently,arranged,axe,bead,blade,capitat,ciliate,clavate,connivent,darker,decreasing,digestion,dorsally,eaf,edge,eed,enzyme,erec,especially,exceeding,flat,folded,fourt,geminat,glabrou,gradually,homostylous,honeycomb-shaped,interjected,lanceolate,larger,leaflet,lengthening,less,living,lower,midrib,minutely,moniliform,multiple,narrow,necklace,nflorescence,orbicular,orolla,pair,pentagonal,perfect,petiolule,plurifoliate,pore,poricidal,puberulent,pubescen,ray,removed,rotate,ruit,secondary,semierect,sessile,seudostipule,size,slightly,slit,spaced,specimen,stamen,ste,stigma,stolon,straight,subequal,tall,tamen,tem,tip,toward,tri-,tube,tuber,typically,unit,vary,wide,wing,x,yellow,ympodial	2,abaxial,adaxial,arrangement,branching,calyx,characteristic,colour,form,fourth,growth,height,history,inflorescence,length,life,midvein,na,ovary,perennial,primary,pseudostipule,rachi,shape,staman,surface,tertiary,texture,unarmed,vein,venation,width
346	wfo-0001029980	success	173	105	78	95	27	0.451	0.1-0.25,0.25-1,0.5-1.2,0.5-2.5,0.5-5,0.7-1.3,0.8-1.2,1-1.5,1.2-2.5,1.5-2,2-5,3-4,5-10,abaxially,acute,adaxially,anther,apex,base,berry,brown,calyx,cm,corolla,curved,dark,decurrent,deflexed,deltoid,elliptic,filament,flattened-reniform,glabrous,globose,gray,green,greenish-white,impressed,leaf,lobe,margin,minutely,mm,one,onto,ovary,ovate,pair,pale,pedicel,petiole,pitted,plant,puberulent,rounded,shape,shiny,shrub,side,simple,slender,slightly,somewhat,stem,straight,style,surface,tan,tapering,trichome,tube,tuft,uniseriate,vein,white,winged,x,yellowish	.1,.5,0.25-0.5,0.5-1,0.9-4.5,1-1.7,1.5-6,2-6,2/3,3-9,5-50-flowered,6.4-17,anthesi,apar,appearing,appressed,axil,ba,bark,black,bright,bud,closely,conical,density,dia,differing,difoliate,dried,drying,eaf,edicel,eed,elevation,especially,exserted,five,free,fruiting,geminat,greatly,high,incrassate,knob,lateral,live,lobed,lon,long,lower,main,major,material,middle,minor,near,nflorescence,node,often,older,opposite,orbicular,overlapping,paler,papillose,pore,poricidal,portion,prominent,proximal,race,reflexed,ruit,scar,shaped,size,small-capitate,soon,spaced,specimen,stigma,tall,tear-drop,tip,ud,unicellular,unit,varying,venezuelan,way,whit,widest,woody,ympodial,young	abaxial,adaxial,arrangement,branching,characteristic,colour,diameter,form,fruit,growth,height,history,inflorescence,length,life,midvein,na,peduncle,primary,pseudostipule,rachi,seed,staman,tertiary,texture,unarmed,venation
347	wfo-0001029989	success	161	95	65	96	30	0.404	.2,.5,0.5-1,1-1.5,1-2.5,1-4,1.3-2.3,10-14,3-5,3-8,4-4.5,5-10-flowered,5-6,abaxial,abaxially,acute,adaxially,anther,apex,base,berry,branched,broadly,calyx,cm,congested,corolla,deltoid,densely,elliptic,filament,flattened,glabrous,globose,gray,green,greenish-black,incrassate,inflorescence,leaf,lenticular,lobe,long,margin,minutely,mm,occasionally,ovary,pair,pedicel,petiole,pitted,pubescent,reddish-brown,shining,short-style,shrub,simple,small,stem,style,surface,tree,vein,white	/2,0.25-0.5,0.5-1.5,1-2,1.5-2.5,2.5-3,3.5-8,7-20,anthesi,bark,branch,brownish-re,capitate,central,closely,collection,conical,deflexed,dendritic,dense,described,dia,difoliate,dimaeter,discussion,drying,due,eaf,edicel,eed,erect,exserted,fleshy,free,fruiting,geminat,golden,heteromorphic,inflorescenc,internodal,lamina,lateral,like,lobed,lon,lower,main,middle,nearly,nflorescence,nodding,northern,older,opposite,overlappin,papillo,peru,peruvian,perÃº,petal,petaloid,planar,population,pore,poricidal,portion,probably,pubescence,reddish,rest,ruit,scar,scattered,see,shaped,somewhat,spaced,sparsely,stigma,tall,tear-drop,tip,tree-like,trichome,tube,ud,unifoliate,unit,way,wide,widest,woody,x,yellow,ympodial,young	adaxial,alternate,arrangement,branching,brownish-red,characteristic,colour,diameter,form,fruit,growth,height,history,length,life,midvein,na,peduncle,perennial,plant,primary,pseudostipule,rachi,seed,shape,staman,tertiary,texture,unarmed,venation
348	wfo-0001030000	success	155	121	85	70	36	0.548	-50,-7,0.5-,0.5-1,0.5-14,0.5-3,1,1-,1-10,1-2,1.5-,1.5-2,10-,15-25,2-2.5,2-5,2.5-,2.5-3,2.5-3.5,25-30,3-4,3.5-5,30-50,4-4.5,4-5,acute,adaxially,also,apex,apiculate,articulated,base,calyx,cm,conspicuous,deltate,densely,dia,diameter,eglandular,ellipsoidal,flattened,flower,fruit,glabrous,globose,green,hair,immature,leaving,lobe,long,margin,mature,mm,moderately,obtuse,occasionally,orange,pedicel,pedicellar,peduncle,perfect,pilose,puberulent,pubescent,purplish,rachi,remnant,scar,shrub,small,sparsely,spotted,style,subcoriaceous,tinge,tip,tomentose,tree,unbranched,white,x,yellow,yellow-brown	-4,-5,-pilose,10-20,2-3,2-4,3-,3-16,4,4-foliat,7-15,abaxially,absent,aggregate,apart,ape,axe,biglandula,cell,chartaceous,ciliat,connective,connivent,coriaceous,creamy-whit,cucullate,dilated,directed,distally,eed,equal,exceeding,laterally,lon,lower,narrowly,nflorescence,nther,oblong,orolla,ovoid,pore,produced,pubescen,radiu,rarely,ruit,shorter,slightly,smal,spaced,stamen,stellate,stigma,stone,strongly,swelling,tal,tem,thecae,triangular,truncate,tube,ud,umbrella-shaped,unit,vary,wide,yellowish,ympodial	4-foliate,abaxial,adaxial,anther,arrangement,branching,characteristic,ciliate,colour,corolla,filament,form,growth,height,history,inflorescence,leaf,length,life,midvein,na,ovary,petiole,plant,primary,pseudostipule,seed,shape,staman,stem,surface,tertiary,texture,unarmed,vein,venation
349	wfo-0001030000	success	178	129	97	81	32	0.545	-50,-7,-pilose,0.5-,0.5-1,0.5-13,0.5-14,0.5-3,1,1-10,1-2,1-5,1.5-,1.5-2,10-,15-25,2-2.5,2.5-,2.5-3.5,25-30,3-4,3.5-5,30-50,4-4.5,4-5,abaxially,acuminate,acute,adaxially,also,apex,apiculate,articulated,basal,base,calyx,cm,conspicuous,cordate,deltate,densely,dia,diameter,eglandular,ellipsoidal,elliptic,entire,flattened,flower,fruit,glabrescent,glabrous,globose,green,hair,immature,leaving,lobe,long,margin,mature,mm,moderately,oblique,obtuse,occasionally,often,orange,ovate,pedicel,pedicellar,peduncle,perfect,petiole,pilose,puberulent,pubescent,purplish,rachi,remnant,scar,shrub,simple,small,sparsely,spotted,style,subcoriaceous,tinge,tip,tree,unbranched,vein,white,x,yellow,yellow-brown	-2,-4,-5,1-,1-1.5,10-20,2-,2-3,2-4,2-5,2.5-3,3-,3-16,4,4-25,4-foliat,5-25,7-15,absent,aggregate,apart,ape,axe,biglandula,blade,cell,chartaceous,ciliat,connective,connivent,coriaceous,creamy-whit,cucullate,dilated,directed,distally,eaf,eed,equal,exceeding,laterally,lon,lower,narrowly,nflorescence,nther,oblong,orolla,ovoid,pilo,pore,produced,pubescen,radiu,rarely,ruit,shorter,slightly,smal,spaced,stamen,stellate,stigma,stone,strongly,swelling,tal,tem,thecae,time,tomentose,triangular,truncate,tube,ud,umbrella-shaped,unit,vary,wide,yellowish,ympodial	abaxial,adaxial,anther,arrangement,branching,characteristic,colour,corolla,filament,form,growth,height,history,inflorescence,leaf,length,life,midvein,na,ovary,plant,primary,pseudostipule,seed,shape,staman,stem,surface,tertiary,texture,unarmed,venation
350	wfo-0001030004	success	177	99	73	104	26	0.412	0-0.5,0-1.5,0.2-1,0.3-1,1.2-2,1.5-2.5,15-20,2-20,3-4,3.5-5,5-25,abaxial,acuminate,acute,adaxially,anther,apex,axillary,base,branched,branching,broadly,calyx,cm,corolla,deltate,densely,elliptic,filament,flattened-reniform,glabrous,globose,green,inflorescence,later,lateral,leaf,lobe,many,margin,minutely,mm,much,obovate,occasionally,ovary,pair,pale,pedicel,petiole,pitted,plant,plurifoliate,pubescent,seed,sessile,shrub,small,sparsely,stem,stout,style,surface,tan,terminal,thick,time,tree,vein,white,winged,yellowish,yellowish-green	.3,0.8-1.1,1-1.5,1-2,15,20-200-flowered,3-3.5,4-15,9-30,abaxially,across,along,always,anthesi,apar,appearanc,barely,bark,basal,berry,blade,body,bushy,capitate,collection,cone,conical,crotaloid,decurrent,dendritic,dense,denser,dia,diamete,distal,drying,eaf,edicel,eed,erect,especially,exserted,flat,fleshy,free,fruiting,giving,greenish-yello,hard,incrassate,juvenile,knob,lamina,large,like,lobed,long,loose,lower,main,middle,nearly,nflorescence,obovoid,often,older,onto,papillate,papillo,pericarp,planar,pore,poricidal,portion,possessing,prominent,pubescence,rest,ruit,scar,shaped,simple,spaced,stigma,strongly,surpassing,tall,tear-drop,thin,tip,translucent,trichome,tub,tube,tuft,ud,unevenly,variously,wide,widest,woody,x,ympodia,young	adaxial,arrangement,characteristic,colour,diameter,form,fruit,greenish-yellow,growth,height,history,length,life,midvein,na,peduncle,perennial,primary,pseudostipule,rachi,shape,staman,tertiary,texture,unarmed,venation
351	wfo-0001030007	success	168	118	88	80	30	0.524	.4,.5,0.2-1,0.5-1,0.8-1,1-1.5,1-15,1-2,1.6-2.2,2-4,3/4,4.5-5,6-10-flowered,7-10,7-9,abrupt,acuminate,acute,along,anther,apex,base,beneath,berry,branched,broadly,brown,calyx,cm,corolla,decurrent,deltoid,densely,dia,dry,elliptic,filament,flattened,glabrous,globose,golden,golden-pubescent,green,lateral,leaf,live,lobe,lobed,long,main,margin,material,midrib,minutely,mm,oblique,occasionally,onto,ovary,pair,pale,pedicel,petiole,pitted,plant,pubescent,reniform,shrub,simple,slender,slightly,small,soft,sparsely,stem,style,surface,tapering,tree,trichome,tube,uniseriate,vein,way,white,widening,winged,x	.05,0.1-0.5,1.5-5,15-20,2-7,3-5,anthesi,apart,ba,bark,becoming,bud,campanulate,clavate,closely,cork,dark,difoliate,edicel,eed,erect,exserted,fleshy,free,fruiting,geminateleaf,glabrate,gre,hooded,impressed,incrassate,inflorescenc,like,lon,longer,lower,major,middle,minor,nflorescence,obovoid,older,one,opposite,outline,papillo,papillose,planar,pore,poricidal,portion,prominent,raised,rest,rounded,ruit,scar,shaped,short,shorter,soon,spaced,specimen,stigma,straight,tall,tear-drop,thick,thickened,tip,trunk,tub,two,type,ud,unit,widest,woody,ympodial,young	abaxial,adaxial,alternate,arrangement,branching,characteristic,colour,diameter,form,fruit,growth,height,history,inflorescence,length,life,midvein,na,peduncle,perennial,primary,pseudostipule,rachi,seed,shape,staman,tertiary,texture,unarmed,venation
352	wfo-0001030010	success	156	108	74	82	34	0.474	.75,0.9-1.1,1-1.3,1-1.5,1-2,1.2-1.5,1.5-2,11-12,2-2.2,2-7,2.5,4-4.5,5-7,acuminate,acute,anther,apex,attenuate,basal,base,berry,brown,calyx,cm,corolla,dark,decurrent,deflexed,deltate,dia,f,filament,fleshy,fruit,furcate,glabrate,glabrous,globose,green,grey,lateral,leaf,lobe,long,main,margin,minutely,mm,nearly,obovate,often,opposite,ovary,ovoid-reniform,pair,pedicel,petiole,pitted,rather,shrub,simple,slightly,small,smooth,stem,style,surface,tapering,tree,tube,vein,white,winged,x	.5,/4,0.5-5,0.7-1,10-15,10-50-flowered,20-40,3-5,7-10,anthesi,appearing,area,bark,beneath,bud,closely,cyathiform,deciduous,differing,difoliate,distal,dry,eaf,edicel,eed,ellipsoid,exserted,free,fruiting,geminat,hooded,lobed,lon,lower,m.,major,materia,material,middle,midrib,minor,minute,near,nflorescence,occasionally,older,one,orange,overlappin,papillose,persistent,planar,pore,poricidal,portion,prominent,puberulent,reddish,ruit,scar,shaped,shin,size,soon,spaced,stigma,straight,styl,tall,tear-drop,tiny,tip,trichome,trunk,ud,uniseriate,unit,way,widest,woody,ympodial,young	abaxial,adaxial,alternate,arrangement,branching,characteristic,colour,diameter,form,greyish,growth,hair,height,hirsute,history,inflorescence,length,life,midvein,na,peduncle,perennial,plant,primary,pseudostipule,rachi,seed,shape,shiny,staman,tertiary,texture,unarmed,venation
353	wfo-0001030023	success	171	123	88	83	35	0.515	0-100+,0.5-1,1,1-,1-8,1.5-7,10-25,11-40+,13-20,2,2-3,2.5-3.5,20-30,3-4.5,3-5,4,4-10,4-12,5,5-,5-6,6-7,7-9,abaxially,acute,adaxially,apart,apex,apiculate,articulated,basal,base,branched,calyx,cm,cordate,cuneate,deeply,densely,diameter,ellipsoidal,elliptic,entire,finely,flattened,fleshy,flower,fruit,glabrous,glandular-puberulent,globose,greenish-white,highly,leaving,lobe,long,margin,mm,moderately,near,oblique,obtuse,occasionally,often,ovate,pedicel,pedicellar,peduncle,petiole,present,probably,puberulent,pubescent,purplish-,rachi,remnant,short-acuminate,simple,spaced,sparsely,style,tip,tree,truncate,unknown,vein,x,yellowish	-,1-2,1.5-2,10-,12-18,30-50+,4-foliat,5-16,6-26,aggregate,ape,axe,beyond,blade,capitat,cell,ciliate,color,connective,connivent,cylindrical,denser,dilated,directed,distally,eaf,eed,especially,exceeding,except,exserted,forked,glandular-puberulen,hair,lanceolate,lon,loosely,lower,main,membranaceous,narrow,narrowly,nflorescence,nther,oblong,orolla,peltiform,perfect,pore,presen,prominent,pubescen,pubescence,pubescent-pilo,radiu,ripe,ruit,shorter,slightly,small,somewhat,stamen,stellate,stigma,stone,subcoriaceous,swelling,tal,tem,thecae,time,triangular,tube,ud,unbranched,unit,unknow,usually,vary,villous,wide,ympodial,young	abaxial,adaxial,anther,arrangement,branching,characteristic,colour,corolla,filament,form,green,growth,height,history,inflorescence,leaf,length,life,midvein,na,ovary,perennial,plant,primary,pseudostipule,pubescent-pilose,seed,shape,staman,stem,surface,tertiary,texture,unarmed,venation
354	wfo-0001030032	success	250	126	107	143	19	0.428	0.2-0.5,0.25-0.4,0.5-0.6,0.5-1.5,0.8-1.0,0.8-1.1,1-1.3,1-1.5,1-2-celled,1.5-2,2-3-locular,2-4,2-5,2.4-3.5,3.0-3.5,3.5-12,30,4-5,4.3-5.0,60-80,8-10,8-10-celled,8-20,acuminate,acute,adaxial,anther,apex,articulated,articulation,base,branched,bright,brown,calyx,cm,completely,conical,corolla,decurrent,deltate,densely,desne,diameter,elliptic,entire,filament,fruit,glabrous,golden,green,greenish-brown,hair-like,imparipinnate,interrupted,irregularly,leaf,length,like,lobe,long,many,margin,middle,midvein,mm,oblanceolate,obovate,often,orbicular,outgrowth,ovary,pale,paler,pedicel,peduncle,petiole,pithy,primary,pseudostipule,pubescent,rachi,seed,simple,soft,splitting,stem,style,surface,swollen,tangled,tertiary,thick,time,trichome,truncate,uniseriate,vein,venation,vine,wall,weaker-walled,white,wide,woody,yellow,Â½-3/4	+,.05,.5,0.1-0.4,0.1-0.5,0.2,0.2-0.3,0.4-1.5,0.5,0.5-0.7,0.5-1,0.5-2,0.6-1.1,0.7-0.8,1-3,1-celled,1.5-2.5,11-20,13-35,2,2-10,2-3.5,2-60,2-lobed,3,3-5,4-6-celled,4-celled,5-plurifoliate,6-11,7-16,7.5-10,abaxially,absent,abundant,adaxially,along,also,anthesi,apical,appearance,appendage,basal,basally,basiscopically,bent,border,branche,breaking,capitate,cell,clambering,column,conspicuou,dark,densest,dry,eaf,ebracteate,edicel,eed,exserted,flower,free,fruiting,give,glandular,gree,halfway,hea,head,herbarium,interjected,internode,lamina,large,larger,lateral,leaflet,leave,longest,lower,markedly,mixed,moderately,much,multicellular,nflorescence,node,oblique,occasionally,older,onto,opposite,pair,patent,petiolule,present,pubescence,reflexed,rest,rotate,rotate-stellate,rough,round,ruit,secondary,set,shorter,silky,slightly,smaller,sometimes,somewhat,sparsely,sparser,specimen,spreading,stamen,staminal,sterile,stigma,straight,subopposite,tall,tem,terminal,testa,thickened,tiny,tip,touch,transparent,tube,ud,unicellular,unit,usually,vegetatio,well-developed,winged,ympodial,younger	abaxial,arrangement,branching,characteristic,colour,conspicuous,form,growth,height,history,inflorescence,life,na,perennial,plant,shape,staman,texture,unarmed
355	wfo-0001030048	success	156	109	78	78	31	0.5	0.5-1.5,1-1.5,1-2,1.2-2,1.3-1.6,10-16,2-3,2-5,3-5,4-4.5,5-10-flowered,5-8,abaxial,abaxially,acute,adaxially,anther,apex,apically,arachnoid,base,berry,bi-colored,blue,broadly,brown,calyx,cm,corolla,decurrent,deltate,densely,difoliate,elliptic,filament,glabrate,glabrous,globose,golden,green,greyish,impressed,leaf,lobe,long,margin,matted,minutely,mm,onto,ovary,ovoid-reniform,pair,pale,pedicel,petiole,pitted,pointed,pubescent,reddish-brown,shiny,shrub,simple,small,somewhat,sparsely,stem,strongly,style,surface,tan,thickened,tree,trichome,trifoliate,unit,vein,white	.5,1.5-3.5,1.5-7,3-3.5,4-15,5973,along,anthesi,ape,apparently,bark,becoming,bi-lobed,clavate,closely,completely,conical,covered,deflexed,dia,drying,eaf,edicel,eed,ellipsoid,exserted,felt-like,fide,fleshy,four-angle,free,fruiting,geminat,inflorescenc,internodal,lamina,lateral,lightly,like,lobed,lon,lower,main,middle,nearly,nflorescence,occasionally,older,opposite,overlappin,papillo,papillose,planar,pore,poricidal,portion,prominent,rather,rest,ruit,scar,shaped,solomon,spaced,stigma,tall,tear-drop,thick,tip,tub,tube,ud,wide,widest,woody,yellowish,ympodial,young	0.5,adaxial,arrangement,branching,characteristic,colour,diameter,form,fruit,growth,height,history,inflorescence,length,life,midvein,na,peduncle,perennial,plant,primary,pseudostipule,rachi,seed,shape,staman,sympodial,tertiary,texture,unarmed,venation
356	wfo-0001030053	success	141	117	86	55	31	0.61	0.5,0.5-1,1-1.3,1.3-3.5,1.8-2,100,2-2.5,2.5-3,3.5-4,7-9,<,abruptly,abscission,acuminate,acute,aiding,anthesi,apex,apiculae,around,articulated,base,branched,brown,calyx,cm,completely,corolla,decurrent,diameter,elliptic,entire,filiform,fine,flattened,flower,glabrous,greenish,growth,hyaline,inflorescence,irregularly,leaving,lobe,lobed,long,many,margin,minutely,mm,pair,pale,parallel,pedicel,peduncle,peg,pendant,petiole,pitted,primary,reniform,rim,shallowly,simple,sleeve,slightly,small,spreading,stem,strongly,support,surface,terminal,time,tiny,truncate,tube,twining,usually,vein,venation,vine,white,woody,x,yellowish	1-13,1.5-5.5,10-20,4-,5,5-merou,7-11,alyx,apart,apical,ark,berry,bfeore,branch,cell,climbin,coriaceous,cyathiform,eaf,eed,exserted,far,fide,fragrant,frui,fruiting,lower,mentz,near,new,nflorescence,nipple,older,orolla,papilla,papillo,per,perfect,plurifoliat,rectangular,revolute,scar,secondary,shin,shining,shiny,spaced,spreadin,tem,testal,tip,turbinate,ud,unit,ympodial	abaxial,adaxial,anther,arrangement,branching,characteristic,climbing,colour,filament,form,fruit,green,height,history,leaf,length,life,midvein,na,ovary,perennial,plant,pseudostipule,rachi,seed,shape,staman,style,tertiary,texture,unarmed
357	wfo-0001030057	success	141	117	82	59	35	0.582	-2,2-3-celled,2-4,2-4.5,2-6,20-30,20-80,8,abaxially,absent,acuminate,acute,adaxially,apex,articulated,axillary,base,berry,brownish,bud,cell,chartaceous,cm,condition,cordate,covering,cuneate,diameter,distal,drying,elliptic,extremely,flower,forked,fresh,fruit,generally,globose,green,green-white,greenish,hair,hair-like,half,herb,high,lateral,leaf,like,long,lunate,make,membranous,mm,mucilaginous,narrow,odd-pinnate,ovate,ovoid,pedicel,peduncle,petiole,plant,pubescent,scale-like,seed,short,small,stem,subglabrous,subtending,terminal,testal,thick,throughout,truncate,unwinged,usually,wall,wet,whitish,wing	1-10,1-2,2.1-4.1,3-5,3.5-8,4-10,4.3-8.2,5.5-12,7-14,8-19,apart,apparently,axe,blade,borne,broadly,decreasing,digestion,eaf,eed,end,enzyme,erec,geminat,glabrou,greatly,honeycomb-shaped,interjected,larger,leaflet,living,mottled,nflorescence,pair,perfect,petiolule,plurifoliate,purple,removed,ruit,seudostipule,singly,size,sometimes,spaced,specimen,ste,stolo,suborbicular,tall,tem,thir,toward,tri-,tuber,typically,unit,x,ympodial	abaxial,adaxial,anther,arrangement,branching,calyx,characteristic,colour,corolla,filament,form,growth,height,history,inflorescence,length,life,lobe,margin,midvein,na,ovary,primary,pseudostipule,rachi,shape,staman,style,surface,tertiary,texture,third,unarmed,vein,venation
358	wfo-0001030057	success	197	122	91	106	31	0.462	-10,-2,.5-3.5,1-2,2-3-celled,2-4,2-4.5,2-6,20-30,20-80,5-10,5-6,8,abaxially,acuminate,acute,adaxially,anther,apex,articulated,axillary,base,berry,brownish,bud,cell,chartaceous,cm,condition,cordate,corolla,covering,cuneate,diameter,distal,drying,elliptic,filament,flower,forked,fresh,fruit,generally,glabrous,globose,green,greenish,hair,hair-like,half,herb,high,lateral,leaf,like,linear,lobe,long,margin,membranous,mm,narrow,odd-pinnate,ovate,ovate-lanceolate,ovoid,pedicel,peduncle,petiole,plant,plurifoliate,pubescent,seed,short,stem,style,subglabrous,subtending,terminal,testal,thick,tri-,truncate,unit,unwinged,usually,wall,white,whitish,wing,x	1-10,2-3,2-5,2.1-4.1,3-5,3.5-8,4-10,4.3-8.2,5-merou,5.5-12,7-14,8-19,absent,acumen,ag,along,alyx,apart,apparently,axe,blade,borne,broadly,ciliate,connivent,decreasing,digestion,dorsally,eaf,edge,eed,end,enzyme,erec,especially,exceeding,extremely,flat,folded,geminat,glabrou,globo,greatly,green-white,greenish-yellow,homostylous,honeycomb-shaped,interjected,lanceolate,larger,leaflet,lengthening,living,lower,lunate,make,middle,midrib,minutely,mottled,mucilaginous,nflorescence,orolla,pair,pentagonal,perfect,petal,petiolule,pore,poricidal,puberulent,purple,removed,rotate,ruit,scale-like,seudostipule,singly,size,slit,small,sometimes,spaced,specimen,stamen,star,ste,stigma,stolo,straight,striped,suborbicular,tall,tamen,tem,thir,throughout,tip,toward,tube,tuber,typically,vary,wet,yellow,ympodial	abaxial,adaxial,arrangement,branching,calyx,characteristic,colour,form,growth,height,history,inflorescence,length,life,midvein,na,ovary,perennial,primary,pseudostipule,rachi,shape,staman,surface,sympodial,tertiary,texture,third,unarmed,vein,venation
359	wfo-0001030080	success	186	127	96	90	31	0.516	0.3-7,0.4-1.5,0.5-4,1-2,1.5-2,1.5-2.5,2-3,2.1-7.1,3-10,3-5,4-12,4-7,5-7,8-16,8-23,acuminate,anther,apart,apex,apparently,articulated,axe,axillary,base,berry,brownish,bud,cell,cm,condition,coriaceous,corolla,covering,cuneate,dark,decurrent,diameter,distal,dot,drying,elliptic,filament,flower,forked,fresh,fruit,generally,glabrescent,glabrous,green,green-white,greenish,hair,hair-like,half,herb,high,lanceolate,lateral,leaf,light,lobe,long,make,medium,mm,mottled,mucilaginous,odd-pinnate,onto,ovate,ovoid,pedicel,peduncle,perfect,petiole,plant,purple,pyriform,rachi,seed,sometimes,spaced,style,subtending,terminal,testal,thick,throughout,tiny,usually,wall,wet,white,whitish,winged	1-3,1.8-4.5,1999,2-4,3.3-7.7,5-13.5,5-merou,5.5-9.9,6.5-18.6,9.9-33,abaxiall,abaxially,absent,acumen,adaxially,ag,along,alyx,arranged,bead,blade,capitat,ccording,clavate,connivent,decreasing,digestion,dorsally,eaf,edge,eed,enzyme,erec,exceeding,flat,folded,geminat,glabrou,hal,homostylous,honeycomb-shaped,inconspicuous,interjected,larger,leaflet,lengthening,like,linear,living,lower,moniliform,multiple,necklace,nflorescence,ochoa,orolla,pair,plurifoliate,pore,poricidal,removed,second,seudostipule,size,slightly,slit,specimen,stamen,stellate,stigma,stolon,straight,strongly,subequal,tall,tamen,tem,tip,toward,tri-,tube,tuber,typically,unit,unknown,vary,width,x,yellow,ympodial	2,abaxial,adaxial,arrangement,branching,calyx,characteristic,colour,form,growth,height,history,inflorescence,length,life,margin,midvein,na,ovary,perennial,primary,pseudostipule,shape,staman,stem,surface,tertiary,texture,unarmed,vein,venation
360	wfo-0001030081	success	157	124	91	66	33	0.58	.5,0.5-1,0.5-1.5,0.5-2.5,1,1-4,1-5,1.5,1.5-3,10-20,10-35,2-7,2-foliate,3-10,3-6,4-6,5-12,5-15,absent,acute,anther,apex,axe,base,berry,beyond,brown,calyx,center,chartaceous,ciliate,cm,decurrent,densely,diameter,dm,drying,edge,elliptic,elliptic-ovoid,entire,equal,exserted,few-branched,filament,fine,flower,fruit,geniculate,glabrous,globose,hair,herb,immature,linear-lanceolate,lobe,long,margin,maturing,membranaceous,mm,moderately,nearly,obtuse,often,parallel,pedicel,peduncle,per,petiole,pubescent,rachi,radiating,raised,ridge,rounded,running,semitransparent,shallow,single-,sparsely,stamen,style,surface,unbranched,unit,usually,vein,white,x,yellow	0.25-0.5,1-2,1-2-celled,1-3,1.5-7,1st,2-4,2nd,abaxially,abundant,adaxiall,adaxially,along,apically,blade,cell,connected,cordate,dehiscing,denser,eaf,eed,emarginat,explosively,flat,frui,geminat,held,interpetalar,longer,lower,lying,maturit,mesocarp,nfloresence,notch,oblong,one,orolla,other,placenta,pointing,pressure,pubescen,rarely,rotate,ruit,short,slightly,small,sometimes,stigma,straight,swollen,tal,tamen,tem,tissue,triangular,tube,two-celled,vary,watery,wid,woody,ympodial	abaxial,adaxial,arrangement,branching,characteristic,colour,corolla,form,geminate,green,growth,height,history,inflorescence,leaf,length,life,midvein,na,ovary,perennial,plant,primary,pseudostipule,seed,shape,staman,stem,sympodial,tertiary,texture,unarmed,venation
361	wfo-0001030083	success	146	133	95	51	38	0.651	.5,.75,0.25-0.5,0.5-1,0.5-2,0.8-1,0.8-3,1-1.5,1-2,1.5-3,2,2-3,2-5-flowered,4-6,9-11,accrescent,anther,apex,bark,base,beginning,berry,broadly,calyx,closely,cm,corolla,cup-shaped,decurrent,deeply,deltoid,dia,dry,drying,elliptic,fleshy,flower,fruit,fruiting,glabrous,globose,green,greenish-white,hyaline,leaf,lobe,long,long-acuminate,long-styled,minutely,mm,narrowly,near,onto,ovary,ovate,overlapping,ovoid-reniform,pair,pale,papillose,pedicel,petiole,pitted,pore,prominent,raised,red-papillose,reddish-gold,scar,shallowly,shaped,short-styled,shrub,simple,slender,small-capitate,somewhat,spaced,specimen,stem,stigma,straight,strongly,style,surface,tan,tapering,tear-drop,translucent,tube,vein,white,winged,x	0.1,10-30,3-4,3/4,4-15,acute,anthesi,dar,deciduous,deflexed,eaf,edicel,eed,elongate,exserted,greyish-re,inflorescenc,internodal,lateral,lobed,lon,lower,main,membranous,middle,nflorescence,older,opposite,paler,papillae,poricidal,proximal,reflexed,ruit,single-stemmed,slightly,soon,tall,terminal,thickened,thin,tip,tub,ud,unifoliat,unit,way,widest,woody,ympodial,young	abaxial,accrescence,adaxial,arrangement,branching,bud,characteristic,colour,dark,diameter,filament,form,greyish-red,growth,height,history,inflorescence,length,life,margin,midvein,na,peduncle,plant,primary,pseudostipule,rachi,seed,shape,spacing,staman,tertiary,texture,unarmed,unifoliate,venation,width,winging
362	wfo-0001030093	success	181	116	84	97	32	0.464	0.1-0.3,0.2-1,0.5-1.1,0.75-1,1-1.5,1-12,1-5,2-2.5,3-4,4-6,7-9,8-9,acuminate,acute,anther,apex,attenuate,base,becoming,beneath,berry,branched,brownish-tan,calyx,case,cm,continues,corolla,cuneate,deltoid,densely,elliptic,erect,especially,filament,glabrous,globose,golden,green,greenish-white,growth,hirsutulous,hyaline,impressed,lateral,leaf,lobe,margin,minutely,mm,obovate,occasionally,often,opposite,ovary,ovoid-reniform,pair,pale,paler,pedicel,petiole,pitted,plant,population,puberulent,pubescent,shiny,shoot,shrub,simple,slightly,small,southern,stem,style,surface,terminal,tiny,tree,trichome,uniseriate,vein,white,x	.2,.5,0,0.2,0.2-0.5,0.6-1.5,1.3-4.5,2.5-11,3.5-12,5-50-flowered,5-8,7-30,anthesi,apar,bark,campanulate,clavate,closely,collection,commonly,deflexed,dia,differing,difoliate,eaf,edicel,eed,ellipsoid,evenly,except,expanded,exserted,flower,forest,free,fruiting,furcate,geminat,greyish-brow,guyanese,inundated,like,lobed,lon,long,long-styled,lower,main,major,many,member,middle,minor,narrowly,nearly,new,nflorescence,older,one,onto,open,orbicular,papillo,persisting,pore,poricidal,portion,present,quite,reflexed,remaining,ruit,scar,shaped,short-styled,size,slender,soon,spaced,stigma,straight,tall,tapering,tear-drop,thickened,time,tip,tub,tube,ud,underside,unit,widest,woody,yellowish,ympodial,young	1.5-4,abaxial,adaxial,arrangement,branching,characteristic,colour,diameter,difuoliate,form,fruit,geminate,greyish-brown,height,history,inflorescence,length,life,midvein,na,peduncle,perennial,primary,pseudostipule,rachi,seed,shape,staman,tertiary,texture,unarmed,venation
363	wfo-0001030145	success	153	122	86	67	36	0.562	-3,0.2-2,0.3-,0.5,0.5-1,1,1-1.5,1-2,1-2.5,1-3,1-5,1.5,1.5-2,1.5-4.5,10-12,2-3,3-10,3-4,3-5,6-40,8-11,abaxially,acute,adaxially,also,apart,apex,articulated,basal,base,calyx,chartaceous,cm,compound,cuneate,cylindrical,deltate,densely,diameter,ellipsoidal,entire,flower,forked,fruit,glabrous,glandular,globose,hair,herb,leaf,leaving,less,lobe,long,margin,mm,moderately,narrowly,near,obtuse,ovate-elliptic,pedicel,pedicellar,peduncle,petiole,pilose,puberulent,rachi,remnant,shrub,simple,sinuate,slender,slightly,spaced,sparsely,style,subcordate,subcoriaceous,ternately,triangular,truncate,unbranched,unknown,violet,x	-2,0.5-4,1.5-7,2-4,2.5-6.5,3,4-5,4-8,4-foliat,absent,adpressed,aggregate,ape,axe,beyond,blade,campanulate,cell,color,connective,directed,distally,dunal,eaf,eed,elliptic,elliptic-ovate,exceeding,exserted,fide,fleshy,lanceolate,larger,lateral,leaflet,lon,lower,nflorescence,nther,orolla,pore,presen,puberulen,radiu,reddish,ripe,ruit,shorter,somewhat,stamen,stigma,stone,tal,tem,terminal,thecae,time,tomento,toward,truncat,tube,ud,unit,vary,wide,yellow,ympodial	abaxial,adaxial,anther,arrangement,branching,characteristic,colour,corolla,filament,form,green,greyish,growth,height,hirsute,history,inflorescence,length,life,midvein,na,ovary,plant,primary,pseudostipule,seed,shape,staman,stem,surface,tertiary,texture,unarmed,vein,venation,white
364	wfo-0001030146	success	210	101	80	130	21	0.381	0.5â1,0.6â2,0.9â1,1.2â1.5,1.5â2,16â20,2.5â9,3â4,3â6,40â50,5â8,9â9.5,abaxial,acuminate,acute,adaxial,anther,anthesi,apex,base,berry,branched,branching,brown,brownish,calyx,cm,corolla,dark,deeply,deltate,densely,diameter,elliptic,entire,filament,glabrous,globose,golden,green,growth,impressed,inflorescence,leaf,length,lobe,many,margin,minutely,mm,narrowly,nodding,olive,pair,pale,pedicel,peduncle,per,petiole,pitted,plant,primary,pubescent,reddish,revolute,shiny,simple,small,stem,stout,style,surface,tan,terminal,time,tree,treelet,vein,white,â18	.1,.2,.5,0.2â0.4,0.5,0.6â0.7,1â1.1,1â1.5,20,20â30,2â5,4â30,4â4.5,5-merou,6.5â16,60+,6â7,8â15,>,abaxially,absent,ag,almost,along,alyx,apar,appearing,ark,articulated,axe,beig,beneath,bright,c.,capitate,cell,center,closely,connivent,coriaceous,covered,cup-shaped,dense,dichasia,discolorous,drying,eaf,echinoid,edge,eed,ellipsoidal,elongate,erec,exserted,flattened-reniform,flower,free,fresh,fruiting,fused,gradually,halfway,ilament,lamina,layer,lengthening,less,like,lobed,long,loosely,lower,midpoint,multangulate,narrowing,new,nflorescence,older,orolla,papillose,part,peltate,perfect,pericarp,persistent,plurifoliate,pore,poricidal,portion,projection,pubescence,ray,reflexed,regularly,rhachi,ripe,ruit,scar,scurfy,sessile,short-stalked,slit,spaced,sparsely,stellate,stigma,strongly,subtended,tall,tangled,tem,testal,thin,tiny,tip,trichome,tube,ud,undersurface,unevenly,unit,upper,vary,varying,visible,way,wide,woody,yellow,ympodial	arrangement,characteristic,colour,form,fruit,height,history,life,midvein,na,ovary,pseudostipule,rachi,seed,shape,staman,tertiary,texture,unarmed,venation,ye
365	wfo-0001030147	invalid_json	158	109	71	87	38	0.449	0.5-2,1-4,1-5,15-30,2-10,2-10.5,2-13,2-3,2-5,4-5.5,4.5-10,5-8,acuminate,acute,apex,articulate,base,blue,branched,calyx,cell,cm,conical,corolla,covering,cuneate,cyme,deep,diameter,dichasial,dichasially,distal,ebracteate,elliptical,filament,finely,green,green-white,hair-like,herbaceous,lateral,leaf,lobe,long,long-attenuate,medium,mm,monochasial,mucilaginous,narrowly,oblique,obtuse,odd-pinnate,ovate,ovoid,pedicel,peduncle,perennial,petiole,plant,proximal,pubescent,purple,rounded,seed,style,testal,thick,tip,wall,Â¼	-8,0-5,1.0-2.0,1.0-2.2,10-19,14-35,2,2.5-7.5,3-,3-6-foliat,4-3.,4.2-7.5,5-7,8-38,abaxiall,abaxially,acumen,adaxially,apical,apically,attenuate,connate,dehiscent,digestion,diminishing,dorsally,eaf,edge,eed,emoval,enzyme,exceeding,flat,flower,folded,forked,generally,globo,gradually,half,honeycomb,interjected,introrse,leaflet,living,lon,lower,lunat,make,maturing,nflorescence,nther,often,orolla,pair,pattern,perfect,petiolule,plan,poricidally,reveal,rotate,ruit,sessile,seudostipule,short,size,slit,specimen,stamen,stigma,straight,subequal,subsessile,tal,tem,terminal,throughou,throughout,toward,tuber-bearing,typically,unit,vary,wide,yellow,ympodial	'',[,``,abaxial,adaxial,anther,arrangement,branching,characteristic,colour,form,fruit,growth,height,history,inflorescence,length,life,margin,midvein,na,ovary,primary,pseudostipule,rachi,shape,staman,stem,surface,tertiary,texture,unarmed,value,vein,venation,wet,{,}
366	wfo-0001030151	success	175	129	97	78	32	0.554	-50,0.2-0.5,0.5,0.5-1,1-1.5,1-17,1-3,1-5,1.5-2.5,10-25,15-35,2-11,2-6,2-7-compound,20-30,3-5,4-5,5-6,6-9,acuminate,acute,adaxial,apart,apex,apiculate,articulated,basal,base,blotch,calyx,chartaceous,cm,cordate,cuneate,decurrent,deltate,diameter,elliptic,entire,except,flower,fruit,glabrate,glabrous,glandular-puberulent,globose,hair,leaf,leaving,less,lilac-tinged,line,lobe,long,longitudinal,margin,membranaceous,mm,near,oblique,oblong,obovate,obtuse,often,pedicel,pedicellar,peduncle,perfect,petiole,pinnately,probably,puberulent,pyriform,rachi,remnant,ripe,sand-punctate,shallowly,simple,slender,slightly,sometimes,spaced,sparsely,stripe,style,surface,tip,tree,truncate,unbranched,vein,veiny,white,x,yellow,yellow-green	-3,0.3-0.5,1,1-2,1.5-2,10-20,2-25,2-3,3-14,3.5-32,4-foliat,?,abaxially,absent,abundantly,adaxially,aggregate,ape,around,axe,beyond,blade,cell,channe,ciliat,compound,connate,connective,cylindrical,directed,distally,eaf,eed,eglandular,exceeding,exserted,glandular,lanceolate,leaflet,lon,lower,narrowly,nflorescence,nther,orolla,pore,presence,purplish,radiu,ring,ruit,sand-punctat,scattered,short,shorter,small,somewhat,stalked,stamen,stellate,stigma,stone,tal,tem,thecae,time,toward,triangular,truncat,tube,ud,unit,unknow,vary,white-puberulent,whitish,wide,ympodial	abaxial,anther,arrangement,branching,channel,characteristic,colour,corolla,filament,form,green,growth,height,history,inflorescence,length,life,midvein,na,ovary,perennial,plant,primary,pseudostipule,seed,shape,staman,stem,tertiary,texture,unarmed,venation
367	wfo-0001030153	success	147	110	84	63	26	0.571	.1,.2,0.2-1,0.8-0.9,1-1.2,1-1.5,1-2,1.3-1.5,1.3-1.9,1.5-2,2-8,2.5-4,3-4,3-5,5-6,6-8,acuminate,acute,anther,anthesi,apex,apiculate,apparently,attenuate,base,berry,branched,brittle,calyx,cm,conical,corolla,dark,deltate,diameter,distinct,domatia,dry,elliptic,entire,filament,glabrous,globose,green,growth,impressed,internodal,lanceolate,less,lobe,margin,membranous,mm,narrowly,nodding,older,ovary,pair,paler,pedicel,peduncle,petiole,pit-like,primary,rachi,revolute,ripe,simple,slightly,small,specimen,stem,style,surface,terminal,thin,time,tree,treelet,vein,white,x,yellowish,young	/3,0.8-1.3,1-10,1-2.5,2-lobed,3-50,3.5-10.5,abaxially,absent,adaxially,age,apart,ape,axil,bark,broadly,caly,campanulate,clavate,densely,dot,eaf,ellipsoid,enlarged,erect,exerted,flower,free,fruiting,glabrou,irregularly,known,lengthening,lobed,lower,markedly,minutely,new,nflorescence,occasionally,ot,papillat,papillate,perfect,plane,plurifoliat,pore,poricidal,portion,resinous,ruit,scar,slit,spaced,stigma,straight,strongly,tip,tube,ud,unit,way,ympodial	abaxial,adaxial,arrangement,branching,characteristic,colour,form,fruit,height,history,inflorescence,leaf,length,life,midvein,na,perennial,plant,pseudostipule,seed,shape,staman,tertiary,texture,unarmed,venation
368	wfo-0001030167	success	141	109	64	77	45	0.454	.8,.9,0.6,12,acuminate,along,anther,apex,base,calyx,chartaceous,ciliate,clavate,cm,contiguously,densely,diameter,entire,extra-axillary,filament,flattened,flower,fruit,glabrous,green,herbaceous,lanceolate,lobe,margin,membranaceous,minutely,mm,near,nearly,obtuse,ovate,ovoid,pair,pedicel,peduncle,petal,petiole,pinnate,pointed,rachi,rounded,sand-punctate,simple,slender,slightly,somewhat,spaced,sparsely,style,thinly,tip,unbranched,unknown,vein,venation,vine,weakly,white,x	0.1â0.2,0.5â0.6,0.5â0.7,0.6â0.8,0.7â1.2,0.8â1,1.2â2.5,1.5â2,1.5â7,14â19,15â20,17â58,1â1.2,1â1.5,2â3,2â4.5,4.5â8,4â10,4â4.5,4â5,4â7,5-merous,8â10,abaxially,accrescent,acute,adaxially,alyx,apar,apically,axe,berry,blade,branch,c.,ciliat,climbing,eaf,eed,enlarged,fertile,fruiting,gap,glabrou,immature,less,long,lower,m.,maturity,membranous,moderately,nflorescence,nternode,orolla,penden,perfec,plurifoliat,reflexed,ruit,scar,secondary,seen,stellate,stigma,subequal,symmetrical,tamen,tem,time,truncat,tube,unit,vary,vegetation,wide,ympodial	0.1-0.2,0.5-0.6,0.7-1.2,0.8-1,1-1.2,1-1.5,1.5-2,1.5-7,15-20,2-4.5,4-4.5,4-7,8-10,abaxial,adaxial,apart,arrangement,branching,characteristic,colour,corolla,form,growth,height,history,inflorescence,leaf,length,life,midvein,na,ovary,perennial,plant,plurifoliate,primary,pseudostipule,seed,shape,staman,stem,surface,tertiary,texture,unarmed
369	wfo-0001030176	success	171	110	79	92	31	0.462	-6.25,.2,.7,.75-1.5,0.4-1.5,0.5-2,0.6-0.9,0.7-1.4,0.7â0.8,1.2,1.6,2.25-3.25,2â3,3-5,3-lobed,3.75-5,6-8,6â8,acute,anther,apex,attenuate,base,bilobed,broadly,calyx,chartaceous,ciliate,cm,depressed-globose,diameter,downward,especially,extra-axillary,few-branched,filament,flattened-reniform,flower,fruit,glabrous,herb,hold,lanceolate-oblong,light,lobe,long,margin,midrib,mm,near,nearly,node,numerous,often,ovate,pale,pedicel,peduncle,petiole,plant,pubescent,rachi,rarely,recurved,ripe,simple,slightly,sometimes,sparsely,style,unbranched,vein,violet,white,winged,x,yellow,yellow-orange,young	-1.4,-4.25,0.5,1,1-2,1-5,1.2-2.5,1.5-2,1.5-2.5,1/3,1/6,2-3,2-foliate,2.5,2.5â7.5,2.5â9,4-9,5-merou,abaxially,accrescent,adaxiall,adaxially,alyx,angulate,apart,apparently,articulated,asymmetrically,axe,ba,basal,berry,bi-lobed,blade,branch,broad,capitat,connivent,contact,covering,cylindrical,decumbent,dehiscent,eaf,eed,erec,forming,fruiting,geminat,hair,hermaphroditic,interlobal,juic,lance-ovate,lateral,line,lon,longitudinall,lower,major,mesocarp,minutely,nflorescence,oblong,orolla,partially,patch,perfect,pore,prostrate,recurve,rooting,rotate-stellate,round,ruit,sinus,soil,somewhat,spaced,stigma,tamen,tem,terminal,time,tip,triangular,tube,unit,vary,white-puberulent,wide,ympodial	abaxial,adaxial,arrangement,branching,characteristic,colour,corolla,form,green,growth,height,history,inflorescence,leaf,length,life,midvein,na,ovary,perennial,primary,pseudostipule,seed,shape,staman,stem,surface,tertiary,texture,unarmed,venation
370	wfo-0001030180	success	135	95	62	73	33	0.459	.5,0.5-1,1-1.5,1.1-1.2,3-8,4.5-5,6,8-10,?,abruptly,anther,apex,apiculate,appearing,attenuate,base,berry,calyx,cm,corolla,decurrent,deltoid,filament,fruit,furcate,glabrous,globose,green,height,immature,lateral,leaf,linear,lobe,long-acuminate,main,minutely,mm,narrowing,occasionally,opposite,ovary,pair,papillose,pedicel,petiole,puberulent,rounded,shrub,sparsely,stem,style,surface,terminal,tip,tube,unknown,vein,white,widely,winged,x	.1,.75,0.05-1,0.8-2,0.9-1.8,10-30-flowered,3-4,8.5-23,accrescent,anthesi,apart,bark,becoming,clavate,clu,dark,deflexe,dia,eaf,edicel,eed,ellipsoid,erect,exserted,free,fruiting,glabrate,inflorescenc,interpetalar,known,lenticellat,lobed,lon,long,lower,middle,minute,nearly,nflorescence,older,overlapping,papillate,peduncl,planar,plurifoliat,pore,poricidal,portion,prominent,proximal,raised,ruit,scar,shaped,sinus,slender,slightly,soon,spaced,stigma,straight,tear-drop,thin,trichome,ud,unevenly,uniseriate,unit,widest,woody,yellowish,ympodial,young	abaxial,adaxial,arrangement,branching,characteristic,colour,diameter,form,greyish,growth,hair,hirsute,history,inflorescence,length,life,margin,midvein,na,peduncle,perennial,plant,plurifoliate,primary,pseudostipule,rachi,seed,shape,staman,tertiary,texture,unarmed,venation
371	wfo-0001030189	success	188	115	90	98	25	0.479	0-1,0-30,0.5-1.6,0.9-1.1,1,1-1.5,1-2,1.3-4.2,1/3,2-5.5,2.5-4,3-4,3.2-4.5,4-5.5,5-10,5-6,6-12,anther,apex,apparently,articulated,base,berry,branched,calyx,chartaceous,cm,concolorous,cordate,densely,diameter,drying,dull,elliptic,entire,erect,evenly,faint,filament,flattened-reniform,fruit,glabrescent,gray,green,infructescence,lateral,leaf,length,lobe,long,lower,margin,maturity,mauve,mm,moderately,oblong,obtuse,orange,ovate,pair,pedicel,peduncle,per,petiole,primary,purple,red,rounded,shrub,simple,sometimes,sparsely,spherical,stellate-pubescent,stem,style,surface,terete,terminal,tertiary,unarmed,upper,vein,venation,visible,wide,yellow,yellow-green,young	-1/2,-4,.2,/3,0-15,0.1,0.1-0.2,0.2-0.3,0.2-0.5,1-3-cellular,1-4-cellula,1-4-cellular,1.1-2.7,1.5-2,1.5-4.5,1.5-5,1/,1/6-1/3,2,2-3,4-13,5-,5-merous,6-10,8,8-10,8-18,abaxially,acut,alyx,apar,apically,appressed,bark,blade,connivent,curved,deltate,eaf,eed,elongating,equal,flower,foliaceous,free,frui,fruiting,glabrescen,glabrous,gland-tipped,lobed,longer,mature,midpoint,nflorescence,often,older,one,open,orolla,oung,perfec,pericarp,plurifoliat,poricidal,porrect,portion,ray,recurved,red-brow,reflexed,ruit,scandent,scar,sessile,shorter,slender,smooth,somewhat,spaced,spreading,stalk,stalked,stellate,strongly,tamen,tapering,time,tip,trichome,tube,unarme,unit,variously,vary,way,woody,ympodial	1/4,abaxial,adaxial,arrangement,branching,characteristic,colour,corolla,form,growth,height,history,inflorescence,life,midvein,na,ovary,plant,rachi,red-brown,seed,shape,staman,texture,ye
372	wfo-0001030219	success	191	106	59	132	47	0.309	1.5,3,60,abaxially,acute,adaxially,anther,anthesi,apex,articulated,base,black,blue,branched,brown,calyx,cm,decurrent,deeply,densely,diameter,elliptic,filament,flattened,fruit,glabrous,globose,green,incised,lanceolate,leaf,lilac,lobe,margin,marking,mm,moderately,oblong,olive,ovate,pale,paler,pedicel,peduncle,perennial,petiole,pitted,pubescent,purple,shallowly,shrub,sparsely,style,surface,time,velutinous,winged,woody,x	0.1â0.3,0.2â2.3,0.4â1.0,0.5,0.5â,0.7â1.1,0.8â3.0,0â,1.0â1.2,1.0â1.5,1.0â2.0,1.0â2.2,1.3â2.9,1.4â2.8,1.6â,10,15,1â2.5,2.0â2.5,2.0â3.2,2.0â5.5,2.4â6.0,2â,2â2.5,2â3,2â4.5,4.5â5.5,4.8â11.5,4â5,4â7,5,5â,5â8,6â,6â10,6â8,7â11,8â18,9â10,9â12,abaxiall,acut,adaxiall,adnate,ag,along,anisophyllous,apart,apical,apparently,appearing,arising,arranged,axe,ba,basal,blade,bractâlike,cell,chartaceous,clavat,concave,connivent,convex,cylindrical,decreasing,diamete,difoliate,directed,distally,eaf,eed,equal,erect,flower,geminat,glabrescent,hair,indistinct,internode,long,longitudinal,lower,multicellular,nflorescence,number,opening,opposed,oppositely,orolla,pair,pentagonal,perfect,pore,present,procumbent,rapidly,redâpurple,regularly,rounded,ruit,serrate,sessile,sid,side,simple,size,smaller,spaced,split,stigma,stone,straight,stripe,strongly,tal,tamen,tem,tube,two,unicellular,uniseriate,unit,vary,white,wide,wing,yellow,ympodial,â3.0,â7.0,â9.5	0.1-0.3,0.2-2.3,0.5-,1.0-1.2,1.0-2.2,1.3-2.9,1.6-3.2,2-2.5,2.0-2.5,2.0-5.5,4-7,4.5-5.5,5-8,7.0,9-10,9.5,abaxial,adaxial,arrangement,branching,characteristic,colour,corolla,form,growth,height,history,inflorescence,length,life,midvein,na,opposite,ovary,plant,primary,pseudostipule,rachi,seed,shape,staman,stem,tertiary,texture,unarmed,vein,venation
373	wfo-0001030225	success	155	111	73	82	38	0.471	-11,-30,-4,-45,-7,.5-2.5,0,0-20,1,1-4,1-6,1.5-2.5,10-15,10-30,2,2-2.5,3-11-compound,3-4,3-5,4-5,acuminate,acute,apex,articulated,basal,base,calyx,cm,cordate,cuneate,deltate,densely,diameter,elliptic-ovate,entire,fleshy,flower,forked,fruit,glabrate,glabrous,globose,leaf,leaving,less,lobe,long,margin,mm,moderately,obtuse,pedicel,peduncle,petiole,pinnately,possibly,prominent,puberulent,purple,rachi,scar,shallowly,shrub,simple,small,sparsely,style,succulent,tip,tree,unbranched,unknown,x	-1.5,.5,0-5,1.5,2-18,2-3,2-6,3-20,3-foliat,8-15,abaxially,absent,adaxially,apart,ape,apical,apically,ature,axe,beyond,bilobed,blade,campanulate,color,compound,conivent,connective,coriaceous,cylindrical,dilated,directed,distally,eaf,eed,equal,especially,exceeding,expanded,exserted,gland,immature,laterally,leaflet,lower,minutely,narrowly,nflorescence,nther,oblong,one,orolla,papillose,perfect,pore,puberulen,radiu,see,seen,slightly,somewhat,spaced,stalked,stamen,stellate,stigma,strongly,tal,tem,thecae,time,tomento,toward,triangular,truncate,tube,two,ud,unit,unknow,vary,wide,ympodial	abaxial,adaxial,anther,arrangement,branching,characteristic,colour,corolla,filament,form,green,greyish,growth,hair,height,hirsute,history,inflorescence,length,life,midvein,na,ovary,perennial,plant,primary,pseudostipule,seed,shape,staman,stem,surface,tertiary,texture,unarmed,vein,venation,white
374	wfo-0001030250	success	169	83	53	116	30	0.314	0.5-1,1-3,1.1-1.2,1.4-1.5,1.7-7,2.5-3.25,3.5-4,5-6,6-8,anther,apex,base,berry,brown,calyx,cm,corolla,dark,decurrent,elliptic-ovate,filament,glabrous,globose,green,greenish-white,greenish-yellow,inflorescence,leaf,lobe,long-acuminate,minutely,mm,opposite,orbiculate,ovary,ovoid-reniform,pair,pale,pedicel,petiole,pitted,sea-green,seed,shape,shrub,simple,stem,style,surface,tan,translucent-green,vein,white-lenticellate	.5,/4,0-seeded,1-1.5,1.1-3.5,1.25-1.5,1.9-2.6,11.2-22,11.3,2-2.5,2.1-6,25,3-5,3.4-6.6,4-7,5-50-flowered,across,anthesi,apart,appearing,arching,attenuate,bark,beginning,beneath,broadly,bullate,capitate,carinate-hooded,conical,consisting,cuneate,cup-shaped,curved,deflexed,dia,differing,difoliate,dry,eaf,edicel,eed,elliptic,exerted,five,free,fresh,fruiting,geminat,glabrou,horizontally,inflorescenc,irregularly,lateral,lobed,lon,long,lower,main,major,maturity,middle,minor,n,nflorescence,node,occasionally,older,one,orbicular,paler,papillo,papillose,pendulous,pit,pore,poricidal,portion,projection,prominent,proximal,raised,reflexed,rim,ruit,scar,shallow,shaped,size,slender,slightly,smooth,soon,spaced,specimen,spreading,stigma,straight,tall,tapering,tear-drop,tip,translucent,tube,two,ud,unit,usually,way,white-lenticellat,wide,widest,winged,woody,x,ympodial	0.5,1.5,abaxial,adaxial,arrangement,branching,characteristic,colour,diameter,form,fruit,growth,height,history,length,life,margin,midvein,na,peduncle,perennial,plant,primary,pseudostipule,rachi,staman,tertiary,texture,unarmed,venation
375	wfo-0001030271	success	195	123	90	105	33	0.462	0.15-0.75,0.7-9.5,1-2,1-2.5,1-3,1-7,1.4-2.1,15-61,2-6,2.4-5.6,3-10,4-22,4-7,5-8,acute,anther,apex,articulated,attenuate,axillary,base,berry,blue,brownish,bud,cell,cm,coloration,completely,condition,coriaceous,corolla,covering,dark,deep,diameter,distal,drying,elliptic,filament,flower,forked,fresh,fruit,generally,glabrous,green,green-white,greenish,hair-like,half,herb,lanceolate,lateral,leaf,light,lilac,lobe,long,make,medium,mm,mottled,mucilaginous,odd-pinnate,ovate,ovoid,pedicel,peduncle,petiole,petiolulate,plant,purple,ripe,rounded,seed,slightly,spot,style,subtending,terminal,testal,thick,throughout,usually,vein,wall,wet,white,whitish	0-2,0.5-1.2,0.9-2.5,0.9-3.6,1-4,1-6,1.9-6.6,2-2.7,2-3,2-4,3-5,3.4-7.5,5-merou,5.6-12.3,6-15,abaxially,acumen,adaxiall,adaxially,ag,along,alyx,apart,apparently,arranged,asymmetric,axe,basiscopic,bead,blade,capitat,clavate,connivent,considerably,decreasing,digestion,dorsally,eaf,edge,eed,enzyme,erect,exceeding,flat,folded,geminat,glabrou,habi,homostylous,honeycomb-shaped,interjected,larger,leaflet,lengthening,like,linear,living,lower,middl,moniliform,multiple,necklace,nflorescence,orbicular,orolla,pair,pentagonal,perfect,plurifoliate,pore,poricidal,removed,rosette,rotate,ruit,sessile,seudostipule,side,size,slit,sometimes,spaced,specimen,stamen,stigma,stolon,straight,symmetric,tall,tamen,tem,tip,tissue,toward,tri-,tube,tuber,typically,unit,unwinged,vary,wide,x,yellow,ympodial	2,abaxial,adaxial,arrangement,branching,calyx,characteristic,colour,form,growth,height,history,inflorescence,length,life,margin,middle,midvein,na,ovary,perennial,primary,pseudostipule,rachi,shape,staman,stem,surface,tertiary,texture,true,unarmed,venation
376	wfo-0001030272	success	179	111	85	94	26	0.475	-6,0.5-1,0.5-1.5,0.5-2,0.65-1,0.7-2.5,0.8-1.5,1,1.2-1.8,1/3,2.5-3,2.8-3.5,3.5-5,4-6,acute,almost,anther,apex,apically,articulated,base,berry,bright,calyx,cm,deltate,diameter,elliptic,entire,erect,evenly,filament,flattened-reniform,fruit,glabrescent,glabrous,glandular,green,hair,lateral,leaf,length,less,lobe,long-attenuate,margin,maturity,mauve,membranous,minute,mm,moderately,near,obtuse,orange-brown,pair,pedicel,peduncle,petiole,primary,red,red-brown,rounded,shallowly,shrub,simple,slender,sometimes,spherical,stellate-pubescent,stem,straight,style,surface,terminal,tertiary,trichome,unarmed,unbranched,undulate,upper,vein,venation,visible,young	.3,.5,/4,0-20,0.05-0.1,0.05-1.5,0.6-0.9,1-1.5,1-2.8,1.5-2.5,1.5-3,1/3-2/3,10-20,2-2.5,2-6.5,2.5-3.5,3-8,4-10,4-15,4-8,5-7,5-merous,abaxially,acut,alyx,ame,apar,apparently,ba,bark,blade,c.,concolorous,connivent,densely,difoliate,drying,eaf,eed,elongating,equal,flower,free,fruiting,geminat,glabrescen,gland,gra,infructescence,lobed,long,longer,lower,mature,midpoint,multangulate,narrow-deltate,nflorescence,older,one,open,orolla,oung,per,perfec,pericarp,poricidal,porrect,portion,ray,reduced,reflexe,ruit,scar,sessile,shorte,smooth,spaced,sparsely,spreading,stellate,tamen,tapering,terete,time,tip,tube,unarme,unit,vary,way,wide,woody,ympodial	abaxial,adaxial,arrangement,branching,characteristic,colour,corolla,form,gray,growth,height,history,inflorescence,life,midvein,na,ovary,perennial,plant,pseudostipule,rachi,seed,shape,staman,texture,true
377	wfo-0001030287	success	150	101	65	85	36	0.433	-11,0-15,0.5-1,1-10,1-2,1-2.5,1-3,1-4,1-5.5,1.5-2.5,2,2-,2-5,3-9,4-5,4.5-6,8-13,acute,apex,articulated,base,bluish,calyx,chartaceous,cm,compound,deltate,densely,diameter,ellipsoidal,elliptic-ovate,entire,flattened,forked,glabrous,herb,leaf,lilac,lobe,margin,mm,moderately,obtuse,ovoid,pedicel,peduncle,petiole,pinnately,puberulent,pubescent,purple,rachi,rugulose,shrub,simple,slightly,strongly,style,subcordate,subcoriaceous,tip,truncate,unbranched,unknown,x	-40,-foliat,-many,.5-2.5,1,1-15,1.5-10,1966,2-10,2-12,2.5-4,3,4-6,5-10,?,abaxially,adaxiall,adaxially,aggregate,apart,axe,basiscopically,blade,branched,cell,color,connivent,cylindrical,decurrent,dendritic,dendritic-pubescen,dendritically,directed,distall,down,eaf,eed,eglandular,fide,flower,gland,glandular,hair,lanceolate,lateral,leaflet,leaving,lon,long,long-stalked,lower,membranaceous,narrowly,nflorescence,nther,oblong,often,orolla,pedicellar,pore,presen,radiu,ruit,scar,scattered,smith,spaced,sparsely,sparser,stalked,stellate,stigma,stone,subcapitat,tal,tem,time,triangular,tube,unit,upper,vary,wide,yellow,ympodial	abaxial,adaxial,anther,arrangement,branching,characteristic,colour,corolla,dendritic-pubescent,filament,form,fruit,green,growth,height,history,inflorescence,length,life,midvein,na,ovary,perennial,plant,primary,pseudostipule,seed,shape,staman,stem,surface,tertiary,texture,unarmed,vein,venation
378	wfo-0001030300	success	235	102	82	153	20	0.349	-1,-7,0.4-0.5,0.5,0.5-1,0.5-4,0.6-0.8,0.7-0.8,0.9-1,1,1-2,1-4,1.4-2.4,2-2.1,2-locular,3/4,9-12,adaxial,almost,anther,apex,articulated,basal,base,broadly,brown,calyx,cm,cordate,corolla,crenate,densely,diameter,elliptical,entire,filament,finely,fruit,glabrous,globose,golden,green,herb,imparipinnate,inflorescence,interrupted,irregularly,less,like,lobe,margin,midvein,mm,obovate,occasionally,once-branched,orbicular,ovary,pale,pedicel,peduncle,perennial,petiole,plant,primary,pseudostipule,pubescent,rest,rounded,silky,simple,sparsely,spathulate,stem,style,surface,tertiary,triangular,vein,yellow,yellowish,yellowish-green	-0.9,.5,0.1,0.1-0.15,0.15-1,0.2,0.2-0.5,0.2-1.5,0.4-1.5,0.4-4.5,0.5-0.6,0.5-5,0.6-0.7,0.7-1.2,0.7-1.5,0.8-1,0.8-3,0.8-4,1-1.3,1-2-celled,1-6,1-celled,1.2-,1.5-,1.5-2.5,2-2.5,2-3,2-4,2-foliate,2.2-7.5,3.5-13,4-11,4-celled,6-15,6-8-celled,abaxially,absent,abundant,acute,adaxially,although,always,anthesi,apical,appearance,appendage,articulation,ba,bent,beyond,bifid,bract,bracteate,brittle,capitate,cell,coherent,column,crenat,curved,deltate,developed,diamete,distal,eaf,edicel,eed,eglandular,ellipsoidal,elongate,even,exserted,face,flower,frequently,fruiting,give,glandular,glutinous-viscose,gree,hair-like,halfway,head,interjected,internode,introrse,lamina,large,larger,lateral,leaflet,leave,lon,long,longer,markedly,minute,moderately,multicellular,narrowly,nflorescence,node,oblique,outgrowth,pair,papillae,partially,pentagonal,petal,petiolule,pith,population,pore,present,pubescence,reflexed,ruit,secondary,slightly,spreadin,spreading,staminal,sterile,stigma,straight,strongly,tall,tem,terminal,testa,thick,tip,trichome,tube,two,ud,underlying,unicellular,uniseriate,unit,united,upper,usually,velvety,wall,weak,well,wide,wider,winged,woody,ympodial,zygomorphic	abaxial,arrangement,branching,characteristic,colour,form,growth,height,history,leaf,length,life,na,rachi,seed,shape,staman,texture,unarmed,venation
379	wfo-0001030311	success	182	114	68	114	46	0.374	.2,.5,0.1,5-pinnate,<,acuminate,acute,adaxial,anther,apex,base,brown,calyx,chartaceous,clavate,cm,color,deltoid,densely,diameter,entire,extra-axillary,filament,flattened,flower,fruit,glabrous,granular,green,half,herbaceous,lenticular,lobe,lower,margin,membranaceous,midvein,minutely,mm,oblique,obtuse,orangish,ovoid-rhomboid,papillose,pedicel,peduncle,petiole,pubescent,purplish,rachi,rounded,sand-punctate,short,slender,slightly,sparsely,stem,style,surface,tan,thickened,tip,trichome,unbranched,vein,vine,white,x	.5â1.8,0.1â0.2,0.3â1.5,0.4â2,0.5â0.8,0.5â1,0.5â2,0.5â2.5,0.6â1,0.6â2.4,0.8â1.2,0.8â4,0.8â4.5,1.2â7,1.5â2,1.5â3,1.5â5.5,1.5â6,1.5â8,1.8â2,15â22,1â1.2,1â1.5,1â2,1â2.5,1â3,2.2â2.5,2.2â3,2.5â9,2â10,2â2.5,2â6,3â5,3â7,5â10,abaxially,accrescent,adaxially,along,alyx,apar,apical,appearance,axe,basal,berry,blade,c.,capitat,ciliat,ciliate,cordate,cuneate,dense,distal,eaf,eed,elliptical,especially,falcate,fallen,fruiting,giving,glabrou,groov,groove,ground,hair,lanceolate,lateral,leaflet,like,log,lon,long,m.,membranous,nflorescence,nternode,obovate,occasionally,orolla,pair,petiolulate,petiolule,plurifoliat,present,proximal,pubescence,rhomboid,ruit,scattered,sessile,shortly,side,smaller,spaced,stellate,stigma,strongly,tamen,tem,terrestrial,thick,thinner,trailing,tube,unit,upper,vary,wide,wide-diameter,widely,ympodial	0.5-0.8,0.5-1,0.6-1,0.8-1.2,1-1.2,1-1.5,1-2.5,1-3,1.5-2,1.5-5.5,1.8-2,15-22,2-2.5,2-6,2.2-2.5,2.2-3,3-5,5-10,abaxial,arrangement,branching,characteristic,colour,corolla,form,growth,height,history,inflorescence,leaf,length,life,na,ovary,perennial,plant,plurifoliate,primary,pseudostipule,seed,shape,staman,tertiary,texture,unarmed,venation
380	wfo-0001030311	success	203	120	92	111	28	0.453	.2,.5,0.1,0.5-0.8,0.5-1,0.6-1,0.8-1.2,1-1.2,1-1.5,1-2.5,1-3,1.5-2,1.5-5.5,1.8-2,15-22,2-10,2-2.5,2-6,2.2-2.5,2.2-3,3-5,5-10,5-pinnate,<,abaxially,acuminate,acute,adaxial,adaxially,anther,apart,apex,articulated,base,brown,chartaceous,clavate,cm,color,cordate,deltoid,densely,diameter,entire,especially,filament,flattened,flower,fruit,glabrous,granular,green,groove,hair,half,herb,lenticular,lobe,lower,margin,membranaceous,midvein,minutely,mm,oblique,obtuse,orangish,ovoid-rhomboid,papillose,pedicel,peduncle,petiole,pubescent,purplish,rachi,rounded,short,simple,slender,slightly,spaced,sparsely,stem,style,surface,tan,thickened,tip,unbranched,vein,white,x	.5-1.8,0-2.5,0.4-2,0.5-2,0.6-2.4,0.8-4,0.8-4.5,1.2-7,1.5-3,1.5-6,1.5-8,2224,3-7,5-merou,8031,[,],absen,absent,accrescent,ag,aggregate,along,alyx,apical,apparently,appearance,axe,ba,basal,basally,blade,capitat,cell,ciliat,ciliate,connivent,cuneate,dense,dig,directed,distal,distally,eaf,eed,elliptical,equal,falcate,fallen,formation,g,geminat,gh,giving,groov,ground,interjected,large,lateral,leaflet,like,log,lon,long,longitudinal,m.,nflorescence,node,oblong,obovate,occasionally,opening,orolla,pair,perfect,petiolulate,petiolule,pittier,plurifoliate,pore,present,proximal,rhomboid,rooting,ruit,scattered,sessile,shortly,side,sinple,slit,smaller,stellate,stigma,stone,strongly,tamayo,tamen,tem,thick,thinner,trailing,tube,uniseriate,unit,upper,vary,wide,widely,yellow,ympodial	abaxial,arrangement,branching,calyx,characteristic,colour,corolla,form,growth,height,history,inflorescence,leaf,length,life,na,ovary,perennial,plant,primary,pseudostipule,seed,shape,staman,tertiary,texture,unarmed,venation
381	wfo-0001030335	success	153	119	86	67	33	0.562	.1,.25,.5,0-5,0.25-0.5,0.5-1,0.7-1,1-1.5,1-2,1-3-flowered,1.1-1.4,1.1.5,2-2.5,2-5,2.5-3,5-6,5-7,acuminate,acute,along,anther,apex,base,beneath,berry,calyx,cm,corolla,dark,decurrent,deltoid,densely,dia,dry,elliptic,erect,filament,filiform,flattened,gently,giving,glabrous,globose,green,greyish-red,horizontally,lateral,leaf,lightly,like,lobe,long,main,material,minutely,mm,narrowly,onto,ovary,ovoid-reniform,pair,pale,pedicel,petiole,pitted,puberulent,pubescent,ripe,shrub,simple,sparsely,spreading,stem,straight,style,surface,tan,tapering,trichome,tube,uniseriate,vein,white,winged,x,yellowish-green	.75,0.05-0.2,0.1-0.5,2-2.2,2-4.5,3/4,7-13,anthesi,aspec,ba,bark,bi-lobed,branch,bud,conical,deciduous,deflexed,eaf,edicel,eed,except,expanded,exserted,free,fruiting,geminate,lamina,lenticellate,lobed,lon,lower,middle,minute,nflorescence,obovoid,occasionally,often,older,opposite,papillo,papillose,pore,poricidal,portion,prominent,puberulen,raised,reflexed,ruit,shaped,slightly,soon,stigma,strongly,tall,tear-drop,tip,ud,underside,unifoliat,unit,way,widest,woody,yellow,ympodial,young	abaxial,adaxial,arrangement,aspect,branching,characteristic,colour,diameter,form,fruit,growth,height,history,inflorescence,length,life,margin,midvein,na,peduncle,perennial,plant,primary,pseudostipule,rachi,seed,shape,staman,tertiary,texture,unarmed,unifoliate,venation
382	wfo-0001030336	success	266	115	93	173	22	0.35	0.2-1,0.5,0.5-0.7,0.6-0.8,0.8-1.3,1-1.5,1-3,1.7-2.3,1.8-3.0,2/3,3-5,4-10,acute,almost,anther,apex,articulated,basal,base,basiscopically,bifurcate,bluntly,bright,brown,calyx,cell,cm,conical,corolla,crenate,dark,decurrent,deeply,densely,diameter,elliptic,entire,filament,flushed,fruit,globose,grayish,green,greenish,hair-like,half,herb,imparipinnate,inflorescence,interrupted,lanceolate,lateral,leaf,less,lobe,lobed,margin,markedly,midvein,minutely,mm,oblique,obovate,occasionally,once-branched,orbicular,outgrowth,ovary,pale,pedicel,peduncle,perennial,petiole,primary,proximal,pseudostipule,puberulent,pubescent,purple,rachi,rounded,stem,style,surface,ten,tertiary,testa,truncate,uniformly,velvety,wall,white,yellow	-1.5,-10,-19,-2,.5,0-,0.1-0.3,0.1-0.5,0.1-0.7,0.1-1,0.15-0.2,0.15-0.9,0.2,0.2-0.25,0.2-0.8,0.2-1.5,0.3-0.4,0.3-1.1,0.5-1,0.5-1.5,0.6-1.5,0.8-0.9,0.8-1.2,0.8-3,1,1-1.4,1-celled,1.0-1.4,1.5-,1.5-2,1.5-3.5,1.5-5,1.6-7,1/4-1/3,10,2-4,2-9,2-foliate,2-locular,4,4-,4-celled,6,8-16,8-20,8-celled,absent,adpressed,amongst,anthesi,apical,appearance,appearing,appendage,articulation,bent,berry,bract,bracteate,branch,capitate,clavat,coat,column,completely,cordate,curved,darker,developed,diamete,distal,divided,eaf,edicel,eed,eglandular,elongate,entir,erect,essentially,exserted,extremely,first,flower,fruiting,giving,glandula,glandular,halfway,head,interjected,internode,investing,large,larger,largest,leaflet,leave,like,lon,long,longer,loosely,lower,maturity,mere,middl,minute,mixed,mostly,narrowing,narrowly,nflorescence,node,often,pair,papillate,part,petiolule,population,present,range,reflexed,rest,rotate,ruit,scattered,secondary,sessile,shaggy,shorter,shrub,silky,simple,sinus,slightly,small,soft,sometimes,southern,sparse,spreadin,spreading,staminal,stellate,sterile,stigma,straight,stripe,strongly,surrounding,tall,tem,terminal,thick,tip,trichome,tube,two,ud,unicellular,uniseriate,unit,united,upper,usually,way,weak-walled,wide,winged,woody,ympodial,young	abaxial,adaxial,arrangement,branching,characteristic,colour,form,growth,height,history,length,life,middle,na,plant,seed,shape,staman,texture,unarmed,vein,venation
383	wfo-0001030342	success	155	87	65	90	22	0.419	.2,.5,0.5â1,0.8â1.5,1-6.5,1.5,1.5â13,1.5â2,1.5â5,10â25,1â1.5,1â2.5,2â2.5,2â4,3-pinnate,3â12,4â5,4â8,anther,apex,brown,calyx,chartaceous,cm,deltoid,dense,diameter,extra-axillary,filament,flattened,fruit,glabrous,greenish,herbaceous,leaf,lenticular,light,lobe,membranous,mm,ovoid-rhomboid,pedicel,peduncle,petiole,pointed,pubescent,rachi,rarely,sand-punctate,scattered,slender,smooth,spaced,sparsely,stem,style,surface,trichome,truncate,unbranched,vine,white,widely,x,yellowish	0.1â0.2,0.3â1.2,0.5â3,0.5â5,0.8â4,1-5,1.2â3,1.5â7.5,1â1.2,1â3,1â5.5,1â6,1â7,2â,3,5-merous,6â7,abaxially,abundant,accrescent,acuminate,acute,adaxially,along,alyx,apar,apical,apiculate,axe,base,berry,blade,broadly,c.,capitat,ciliat,cordate,cuneate,cylindrical,eaf,eed,elliptical,entire,flower,fruiting,glabrou,lanceolate,lateral,leaflet,like,lon,long,lower,m.,margin,minutely,mottled,nflorescence,nternode,oblique,obtuse,often,orolla,perfec,petiolule,plurifoliat,proximal,pubescen,revolute,rhomboid,rounded,ruit,side,slightly,stellate,stigma,tamen,tem,terrestria,tip,truncate-acuminat,tube,undulate,unit,vary,vein,wide,wide-diameter,ympodial,â7	abaxial,adaxial,apart,arrangement,characteristic,colour,corolla,form,green,growth,height,history,inflorescence,internode,length,life,ovary,plant,seed,shape,staman,texture
384	wfo-0001030342	success	153	109	79	74	30	0.516	-7,.2,.5,0.5-1,0.5-3,0.5-5,1-1.5,1-5,1-6.5,1.5-13,1.5-2,1.5-5,10-25,2-,2-2.5,3,3-pinnate,4-5,4-8,acuminate,acute,adaxially,anther,apart,apex,apiculate,articulated,base,brown,calyx,chartaceous,cm,cordate,cuneate,cylindrical,deltoid,diameter,entire,extra-axillary,filament,flower,fruit,glabrous,hair,herb,leaf,lenticular,light,lobe,margin,membraceous,minutely,mm,oblique,obtuse,pedicel,peduncle,petiole,pubescent,rachi,rarely,revolute,scattered,simple,slender,smooth,spaced,style,surface,terrestrial,trailing,truncate,unbranched,undulate,uniseriate,vein,white,widely,x	0.8-4,1-1.2,1-3,1-5.5,1-6,1-7,1.2-3,1.5-7.5,2-3,3-12,5-merou,6-7,abaxially,absent,abundant,accrescent,ag,along,alyx,apical,apparently,axe,ba,basally,blade,broadly,capitat,ciliat,connivent,directed,distally,eaf,eed,elliptical,equal,fruiting,geminat,interjected,lanceolate,lateral,leaflet,long,longitudinal,lower,nflorescence,node,oblong,opening,orolla,perfect,petiolule,plurifoliate,pore,proximal,pubescen,rhomboid,rooting,rounded,sagittate,side,slightly,slit,stellate,stigma,tamen,tem,tip,truncate-acuminat,tube,unit,vary,wide,yellow,ympodial	abaxial,adaxial,arrangement,branching,characteristic,colour,corolla,form,green,growth,height,history,inflorescence,length,life,midvein,na,ovary,perennial,plant,primary,pseudostipule,seed,shape,staman,stem,tertiary,texture,unarmed,venation
385	wfo-0001030353	success	227	123	104	123	19	0.458	.7,0,0-15,0-2,0-6,0.5-0.9,0.8-1.2,1-6,1.8-3,1/3,1/5,2.8-3.7,3-4,3.5-4,4-,4-4.5,5,5-6,7-10,abaxial,acute,adaxial,anther,apex,apically,apparently,articulated,base,berry,brown,c.,calyx,chartaceous,cm,cuneate,densely,diameter,discolorous,drying,ellipsoid,elliptic,erect,evenly,filament,flattened-reniform,fruit,glabrous,green,lateral,leaf,length,lobe,lobed,long,long-styled,longer,lower,margin,maturity,mauve,midvein,mm,moderately,narrow-deltate,orange-brown,pair,pedicel,peduncle,per,petiole,plant,pointed,prickle,prickly,primary,reddish-green,shape,short-styled,shrub,simple,small,sparsely,stellate-pubescent,stem,strongly,style,subentire,surface,terminal,tertiary,time,tree,unarmed,unbranched,upper,vein,venation,visible,weakly,white-gray,wide,wo,yellow,young	-0.2,-1.5,-1/2,-2,-3,-5,-6,-merous,.1,.2,.5,0.1-0.2,0.1-0.3,0.15-0.3,0.5,0.8,1,1-2,1-3,1-7,1.2-1.8,1.8-2.2,1/,1/2-2/3,1/6,1/6-1/4,10-15,11-16,2-10,2-7,2.5-4,20-200,3-5.5,4-5,6,6-15,6-8,8-15,abaxially,almost,alyx,andromonoecious,apar,apart,apiculat,bark,blade,broad-deltate,conical,connivent,curved,deltate,development,distal,distance,eaf,eed,elongating,equal,extending,flattened,flower,free,fruiting,glabrescent,half,hermaphrodite,heterostylous,infructescence,less,lowermost,mature,midpoint,multangulate,nflorescence,older,one,open,orolla,oung,patch,pendulous,pericarp,plurifoliat,poricidal,porrect,portion,ray,red-brown,reflexed,retaining,rounded,ruit,scar,sessile,shorter,side,smooth,sometimes,somewhat,spaced,spreading,stalk,stalked,staminat,stellate,stout,straight,tamen,tapering,terete,throughout,tip,trichome,tube,unarme,unit,vary,warty,way,whit,woody,ympodial	apiculate,arrangement,branching,characteristic,colour,corolla,form,growth,height,history,inflorescence,life,na,ovary,pseudostipule,rachi,seed,staman,texture
386	wfo-0001030407	success	182	113	82	100	31	0.451	.5,1-2,12-14,12-15,2-5,2-7,3-6.5,3-9,30-60,4-5,5,6-7,7-8,acuminate,anther,apex,apparently,articulated,axe,axillary,base,berry,brownish,bud,cell,chartaceous,cm,condition,conical,corolla,covering,densely,diameter,distal,drying,elliptic-lanceolate,filament,flower,forked,fresh,fruit,generally,glabrous,green,greenish,hair-like,half,herb,lateral,leaf,light,lobe,long,margin,middle,minute,mm,mottled,obtuse,odd-pinnate,ovate,ovoid,pedicel,peduncle,perfect,petiole,plant,proximal,pubescent,purple,ripe,round,seed,style,subtending,terminal,testal,thick,unwinged,usually,wall,whitish	.2,0.7-3.2,1-10,1-3,1-4,1.5-5,2-2.5,2-6.7,3-10.5,3-4,3.5-9.5,5-merou,6.5-18.5,abaxially,absent,acumen,adaxially,ag,alyx,apart,blade,capitat,ciliate,connivent,decreasing,digestion,dorsally,eaf,edge,eed,end,enzyme,especially,exceeding,flat,folded,geminat,glabrou,gradually,green-white,hair,homostylous,honeycomb-shaped,interjected,lanceolate,larger,leaflet,lengthening,like,living,lower,make,mucilaginous,nflorescence,one,orolla,pair,pentagonal,petiolule,placed,plurifoliate,pore,poricidal,pubescen,ray,removed,ruit,secondary,semierec,seudostipule,size,slit,spaced,specimen,stamen,ste,stigma,stolo,subequal,subsessile,symmetrical,tall,tamen,tem,thir,throughout,tip,toward,tri-,tube,tuber,typically,unit,vary,wet,white,wide,x,yellow,ympodial	abaxial,adaxial,arrangement,branching,calyx,characteristic,colour,form,growth,height,history,inflorescence,length,life,midvein,na,ovary,primary,pseudostipule,rachi,shape,staman,stem,surface,tertiary,texture,third,true,unarmed,vein,venation
387	wfo-0001030420	success	170	118	86	84	32	0.506	-2,-20,-30,-pubescent,0.5-,0.5-1,0.5-4,0.5-8,1,1-1.5,1-2,1-3,1-4,1-6,1.5-3,1.5-5,10-,15-25,2-3,2-5,4-7,5-,5-15,6-7,7-22,acuminate,acute,also,apex,basal,base,calyx,chartaceous,cm,color,cordate,deltate,densely,diameter,eglandular,ellipsoidal,elliptic-ovate,elongated,entire,flower,forked,fruit,glabrate,glabrous,glandular-,glandular-puberulent,hair,leaf,lobe,lobed,long,margin,mm,moderately,often,ovate,pedicel,peduncle,petiole,pilose,pinnately,puberulent,pubescent,pubescent-pilose,purple,rachi,rarely,ripe,shrub,simple,small,sparsely,style,subcoriaceous,tip,tree,truncate,unbranched,unknown,vein,x	-35,-4,-9,1-,1-7.5,1/2,10-25,2-,2-14.5,2-6,2-9,3-7,3-lobed,4-foliat,5-6,7-19,7/8,abaxially,absent,adaxially,aggregate,apart,ape,articulated,axe,beyond,blade,cell,connective,connivent,cylindrical,dark,directed,distally,divided,eaf,eed,eglandular-pilo,eglandular-puberulent,equal,exserted,lanceolate,leaving,lon,lower,midrib,narrowly,nearly,nflorescence,nther,obtuse,orolla,pedicellar,perfect,pore,presen,puberulent-pubescent,pubescent-pilo,radiu,remnant,ruit,shorter,sinus,spaced,stamen,stellate,stigma,stone,tal,tem,thecae,time,tomento,triangular,truncat,tube,ud,unit,unlobed,vary,wide,yello,yellow,ympodial	abaxial,adaxial,anther,arrangement,branching,characteristic,colour,corolla,eglandular-pilose,filament,form,growth,height,history,inflorescence,length,life,midvein,na,ovary,plant,primary,pseudostipule,seed,shape,staman,stem,surface,tertiary,texture,unarmed,venation
388	wfo-0001030426	success	158	84	63	95	21	0.399	-30,0.4-0.7,1-4,1-4.2,1.5-6.5,10,15-25,2,2.5-4,2.5-6,3-6,4-10,6-8,9,apiculate,branched,calyx,caudate,cell,cm,corolla,covering,cyme,diameter,dichasial,dichasially,ebracteate,elliptic-lanceolate,filament,glandular,globose,green,green-white,hair-like,heart-shaped,herbaceous,lanceolate,lateral,leaf,linear,lobe,long,mm,monochasial,mucilaginous,oblong,odd-pinnate,ovoid,pedicel,peduncle,perennial,petiole,pilose,plant,seed,spot,straight,stripe,style,testal,thick,wall,white	0.3-7,0.3-8,1.5-3,1.7-3.2,2-3,3-12,3-4,3-6-foliat,4-6.5,6-11.5,abaxially,absen,acumen,acute,adaxially,apex,apical,apically,articulate,base,connate,decurrent,dehiscent,digestion,diminishing,distal,dorsally,eaf,edge,eed,emoval,enzyme,exceeding,flat,flower,folded,forked,generally,globo,gradually,half,honeycomb,interjected,introrse,larger,leaflet,linear-lanceolate,linear-oblong,living,lon,lower,make,maturing,nflorescence,nther,oblique,obtuse,often,orolla,pair,pattern,perfect,pinnatifi,plan,poricidally,proximal,rachi,reveal,rounded,ruit,second,sessile,seudostipule,short,size,slit,specimen,stamen,stellate,stigma,tal,tem,terminal,throughout,toward,tuber-bearing,typically,unit,vary,whit,wide,without,yellow,ympodial,Â¼	anther,arrangement,characteristic,colour,form,fruit,growth,height,history,inflorescence,length,life,na,ovary,pinnatifid,pseudostipule,shape,staman,stem,surface,texture
389	wfo-0001030430	success	171	128	98	73	30	0.573	.2,.5,0.5,0.5â12,0.6â1.0,0â20,1.0â1.5,1.0â2.0,1.4â1.5,1.5â1.7,1.6â1.8,12â20,1â3,2.0â3.0,2.0â4.2,2â3,3.0â4.5,30â200,3â17,3â4,3â5,3â8,5â10,5â6,abundant,acute,anther,anthesi,apart,apex,articulated,axillary,base,blade,blue,borne,branched,brittle,brown,calyx,cell,cm,cylindrical,decurrent,densely,diameter,elliptic,erect,few-seeded,filament,flattened,fleshy,fruit,glabrous,globose,green,hair,indumentum,leaf,lobe,lobed,long,margin,mm,moderately,multicellular,occasionally,ovate,pair,pale,pedicel,peduncle,perennial,petiole,pitted,present,pubescent,purple,regularly,rounded,shallowly,shoot,shrub,simple,spaced,stone,straight,style,subglabrous,surface,terminal,time,unifoliate,uniseriate,violet,white,woody,x	0.25,0.3,0.4,0.6,0.6â0.8,0.8â3.0,0.8â5.6,0.9â1.0,1.0â1.2,1.2â2.0,1.3â8.0,1.8â5.0,12â30,1â9,3â24,5,5.5â12,6â10,abaxially,adaxiall,adaxially,ag,apical,appressed,axe,ba,basal,bud,capitate,chartaceous,clavate,connivent,convex,dentate,diamete,eaf,eed,equal,especially,flower,geminat,lon,longitudinal,lower,m.,nflorescence,oblong,opening,orolla,pentagonal,perfect,pore,poricidal,ruit,serrate,shaped,side,slit,stigma,tal,tamen,tear-drop,tem,tip,toward,tube,unit,vary,wide,yellow,ympodial,â2.7,â40	abaxial,adaxial,arrangement,branching,characteristic,colour,corolla,form,growth,height,history,inflorescence,length,life,midvein,na,ovary,plant,primary,pseudostipule,rachi,seed,shape,staman,stem,tertiary,texture,unarmed,vein,venation
390	wfo-0001030441	success	178	123	96	82	27	0.539	+,.5,0.5,0.5-1,0.5-3,1,1-1.4,1-2-celled,10-40,2,2-10,2-5.5,3-4,5-7,5-7.5,6-11,<,acuminate,acute,along,anther,apex,attenuate,base,berry,branched,bright,calyx,cell,cm,corolla,decurrent,deltate,diameter,elliptic,entire,eye,filament,flattened,flexuous,flower,glabrous,glandular,globose,green,growth,hair,juicy,lateral,lobe,long,making,many,margin,membranous,midvein,minutely,mm,narrowly,occasionally,onto,open,pair,pale,pedicel,peduncle,pericarp,petiole,plant,primary,pubescent,red,reniform,ripe,shiny,shrub,simple,slightly,spot,stem,style,surface,terminal,thin,time,triangular,trichome,undulate,uniseriate,usually,vein,vine,violet,wall,white,yellow	0.5-0.75,1-1.5,1.2-1.4,1.5-2,2-3,2.5,30,4-5,5-14,5-6,5-merou,>,ag,alyx,anthesi,apart,ark,articulated,brow,c.,capitate,closely,distall,eaf,eed,ellipsoid,exerted,free,fruiting,glabrou,glandula,ilament,impressed,irregularly,leaving,lengthening,lobed,lon,lower,markedly,new,nflorescence,older,orolla,otherwise,papillat,papillose,peg,per,perfect,plurifoliat,pore,poricidal,portion,reflexed,ridged,ruit,scandent,scar,short,shrubby,slit,small,somewhat,spaced,spreadin,spreading,stellate,stigma,strongly,tem,tip,trailing,tube,ud,unit,upper,vary,way,wide,woody,ympodial	abaxial,adaxial,arrangement,branching,brown,characteristic,colour,form,fruit,height,history,inflorescence,leaf,length,life,na,ovary,perennial,pseudostipule,rachi,seed,shape,staman,tertiary,texture,unarmed,venation
391	wfo-0001030444	success	196	79	54	142	25	0.276	0.15-0.8,0.8-2,1-10,1-2,11-45,2-8,2.4-3.8,3-10,3-5,4-17,4-7,anther,articulated,berry,blue,ciliate,cm,coriaceous,corolla,dark,deep,diameter,distal,elliptic,filament,forked,fruit,glabrous,green,greenish,half,herb,high,honeycomb-shaped,lanceolate,leaf,light,lilac,lobe,margin,medium,mm,odd-pinnate,ovate,ovoid,pedicel,peduncle,petiole,plant,purple,seed,style,terminal,whitish	0-24,1,1-4,1-5,1.1-2.7,1.2-1.8,2-3,2-6,2.3-3.6,3.7-6.8,4-39,5-merou,5.3-9,6.1-12.8,7.1-17.5,9.4-20.1,abaxiall,abaxially,acumen,acuminate,acute,adaxially,ag,along,alyx,apart,apex,apparently,arranged,asymmetric,attenuate,axe,axillary,base,basiscopic,bead,blade,brownish,bud,capitat,cell,clavate,condition,connivent,covering,decreasing,digestion,dorsally,dot,drying,eaf,edge,eed,enzyme,erec,exceeding,flat,flower,folded,fresh,geminat,general,generally,glabrou,green-white,hair-like,hal,homostylous,interjected,larger,lateral,leaflet,lengthening,like,linear,living,long,lower,make,moniliform,mucilaginous,multiple,narrow,necklace,nflorescence,orbicular,orolla,pair,pentagonal,perfect,petiolulate,plurifoliate,pore,poricidal,removed,ripe,rotate,rough,rounded,ruit,sessile,seudostipule,shortly,side,size,slit,sometimes,spaced,specimen,stamen,stigma,stolon,straight,subequal,subtending,symmetric,tall,tamen,tem,testal,thick,throughout,tip,tissue,touch,toward,tri-,tube,tuber,typically,unit,unwinged,usually,vary,wall,wet,white,wide,wing,x,yellow,ympodial	2,abaxial,adaxial,arrangement,branching,calyx,characteristic,colour,form,growth,height,history,inflorescence,length,life,ovary,perennial,pseudostipule,shape,staman,stem,surface,texture,unarmed,ye
392	wfo-0001030445	success	226	115	93	133	22	0.412	0.2-0.4,0.2-0.5,0.6-2.2,0.6-3.5,1-1.3,1-7,1.3-2,1.5-2.1,1.6-2,1.7-2.4,10-14,10-16,14,2.2-2.9,2.2-3.5,2.4-4.7,3.5-4.2,4.1-8.7,4.2-10,5-125,5.2-7.1,6.1-9.1,7.5-16,abaxial,abaxially,acuminate,acute,along,anther,apex,around,base,black,blade,branched,calyx,cm,corolla,decurrent,deltoid-reniform,diameter,drying,elliptic,elliptical,entire,ferruginous,ferruginous-tomentose,filament,flower,fruit,glabrous,globose,green,greyish-tan,hair,leaf,lobe,long,many,margin,midrib,midvein,mm,oblong-lanceolate,obtuse,orangish-tan,pedicel,peduncle,petiole,porrect-stellate,pseudoterminal,pubescent,rachi,reniform,reticulate-punctate,semi-spherical,sessile,shrub,side,simple,small,somewhat,stem,style,surface,time,tomentose,tree,vein,white,x,yellowish,yellowish-tan	.1,.5,/5-2/3,0.1-0.7,0.2,0.2-0.7,0.3,0.4,0.5,0.7,0.8,1,1.1-4.3,1.3,1.3-1.8,1.8-3.5,15-35,2.1-5.2,3-5.4,3.1-5,3.4-5.6,5-merou,5.9-15,5.9-8.3,8.1-10,8.2-18,accrescent,adaxially,ag,alyx,apart,appressed,articulated,axillary,bark,berry,blunt-tippe,blunt-tipped,branch,brown,brownish-yellow,bud,bulbous-based,capitate,concentrated,cylindrical,directed,distally,eaf,earl,edge,eed,elongated,erect,exserted,ferruginous-granular,free,fruiting,geminate,glabrate,glabrescen,high,homostylous,inserted,intermediate,lackin,lateral,lengthening,lobed,lon,longitudinal,lower,m.,main,mostly,multangulat,multangulate,nflorescence,oblong,obovate,obscured,older,open,orange,orbicular,orolla,ovate,ovate-lanceolate,plurifoliate,pore,poricidal,porrect-stellat,pubescence,ray,relatively,resorption,rounded,ruit,runk,slightly,slit,soon,spaced,sparse,sparsely,splitting,stalk,stamen,stellate,stigma,stout,subcampanulate,sulcate,suture,tamen,thick,thick-textured,thicknes,thin,thin-,tip,tissue,tomentum,tube,unarme,unit,vary,vestigial-rayed,way,wide,yellow,ympodial,young	adaxial,arrangement,branching,characteristic,colour,form,growth,height,history,inflorescence,length,life,ovary,perennial,plant,primary,seed,shape,staman,texture,unarmed,ye
393	wfo-0001030447	success	276	146	125	151	21	0.453	.2,.3,.5,/5,0,0.5,0.5-0.65,0.5-10,0.5-3,0.7-1,0.8-3.5,1-1.5,1-2,1-5,1.8-2.5,1/3-2/3,2-4,2.2-2.8,3,3-4.5,3-5,4-8,6.5-9,7-8,8,abaxially,acute,adaxially,anther,apex,apically,apparently,armed,articulated,base,berry,calyx,cell,chartaceous,cm,corolla,cuneate,curved,deltate,development,diameter,discolorous,drying,filament,fine,flat,flattened-reniform,flower,fruit,gently,glabrescent,glabrous,globose,infructescence,lateral,leaf,length,less,lobe,lobed,long,long-styled,lower,margin,maturity,midvein,mm,moderately,oblique,oblong,often,opening,orange,orange-brown,orange-red,outline,ovate,pair,pale,pedicel,peduncle,per,petiole,pit,prickle,primary,purple,rachi,raised,red-brown,rounded,shallowly,shrub,side,simple,slender,small,sometimes,sparsely,spherical,stellate,stellate-pubescent,stem,straight,straw-yellow,style,surface,tertiary,throughout,unarmed,unbranched,usually,vein,venation,visible,weakly,white,x,yellow,Ã	0.1,0.1-0.3,0.15-0.3,0.2,0.2-0.4,0.4-0.7,0.4-0.9,0.8-1.7,1,1-10,1-2.5,1-3,1-6,1.5,1.5-2.5,1.5-7,1/3,1/3-1/2,1/4-1/3,2.5-10,2.5-6.5,30-45Â°,5,5-15,5-merou,6,6-10,6-16,6-7,6-8,6-9,accrescent,age,always,alyx,apar,apart,apical,axe,bark,beyond,blade,branche,broad-deltate,c.,characteristically,clavate,covering,cupular,dark,densely,difoliate,distance,divided,eaf,eed,elongating,equal,erect,exserted,extending,filiform,finely,finger-hair,flattened,free,fruiting,geminat,herbaceous,irregula,irregular,lengthening,long-ovoi,longer,longitudinal,mature,midpoint,minute,mostly,narrow-deltate,nflorescence,obconical,obtuse,older,one,open,orange-translucent,orolla,oung,papillo,pendulous,perfect,pericarp,persisting,point,pore,poricidal,porrect,portion,pronounced,prostrate,pubescent,ray,reduced,rest,ri,ridge,ridged,ruit,scar,sessile,shallow,shiny,short-styled,shorter,shortly,sinus,slit,smooth,somewhat,spaced,sparse,spreading,stalk,stalked,stigma,stout,stump,subsessile,tamen,tapering,terete,terminal,thick,thin,time,tip,toward,translucent,trichome,tube,ud,unequal,unit,variously,vary,wide,widest,woody,yellow-orange,ympodial	.2-2.8,abaxial,adaxial,arrangement,branched,branching,characteristic,colour,form,growth,height,history,inflorescence,life,ovary,perennial,plant,seed,shape,staman,texture
394	wfo-0001030453	success	127	106	69	58	37	0.543	.25,.5,/4,0.25-0.5,0.8-1.5,1-1.3,1-1.5,1.5-1.6,1.5-2.5,3-3.5,9-12,acuminate,acute,anther,apex,arachnoid,arachnoid-pubescent,attenuate,bark,base,broadly,calyx,clavate,cm,corolla,cup-shaped,dark,deflexed,deltate,ellipsoid,elliptic,exserted,filament,glabrous,later,leaf,less,lobe,margin,minutely,mm,narrowly,occasionally,ovary,pair,papillose,pedicel,petiole,planar,pore,pubescent,reddish,rounded,shaped,shiny,shrub,simple,sparsely,stem,stigma,straight,strongly,style,surface,tear-drop,tube,vein,way,white	4-5,9-14,abaxially,adaxially,along,anthesi,axi,closely,delicate,dendritic,densely,dia,divided,eaf,edicel,eed,especially,fine,flat,floccose,free,glabrate,know,known,lateral,lon,long,lower,main,middle,midrib,minute,near,nearly,nflorescence,older,opposite,overlappin,papillat,poricidal,portion,reddish-brow,ruit,scar,slender,soon,spaced,tall,tip,trichome,tub,ud,unifoliat,unit,wide,widest,ympodial,young	0.25,abaxial,adaxial,arrangement,branching,bud,characteristic,colour,deflexion,diameter,division,exsertion,form,fruit,growth,height,history,inflorescence,length,life,midvein,na,papillate,peduncle,plant,primary,pseudostipule,rachi,reddish-brown,seed,shape,staman,tertiary,texture,unarmed,unifoliate,venation
395	wfo-0001030486	success	141	86	56	85	30	0.397	.5,1-1.5,1-5,1.1-1.4,1.5-2,1.7-2,10-12,2-3,3-3.5,4-4.5,4.5-5,6-7,acute,anther,apex,base,brown,calyx,cm,corolla,dark,deltate,dry,drying,elliptic,filament,fleshy,fresh,glabrous,globose,green,leaf,lobe,margin,material,minutely,mm,ovary,ovoid-reniform,pair,pedicel,petiole,pitted,shrub,simple,small,stem,style,surface,tan,tapering,treelet,vein,white,x,yellow-green	0.8-2.2,1/2,1/4,10-14.5,2-5.5,3-5,3/4,4-6.5,5-8-flowered,abaxially,adaxially,anthesi,ba,bark,basal,beneath,berry,clavate,closely,clustered,completely,conical,deflexed,dia,differing,difoliate,distal,eaf,edicel,eed,ellipsoid,erect,exserted,f,free,fruiting,geminat,inflorescenc,internodal,later,lateral,lobed,lon,long,lower,m.,main,major,middle,minor,nflorescence,older,opposite,overlapping,pale,papillo,papillose,planar,pore,poricidal,portion,reddish,ruit,scar,shaped,shin,size,slightly,spaced,stigma,stout,tall,tear-drop,thickened,tip,tub,tube,ud,unit,usually,way,widest,woody,ympodial,young	abaxial,adaxial,alternate,arrangement,branching,characteristic,colour,diameter,form,fruit,growth,height,history,inflorescence,length,life,midvein,na,peduncle,plant,primary,pseudostipule,rachi,seed,shape,staman,tertiary,texture,unarmed,venation
396	wfo-0001030489	success	196	141	115	81	26	0.587	-6.5,.5-2.8,0.25-0.4,0.5-3,0.6-0.9,0.75-0.9,0.9-1.1,1.1-1.3,1.2-1.5,1.2-1.6,1.6-2.1,1.7-2,1.9-2.6,2.1-2.9,3-6,3-8,4-8,4.5-9,5,5-6,7-15,abaxially,abruptly,acute,anther,apart,apex,appressed-pubescent,articulated,attenuate,base,becoming,berry,branched,broadly,brown,calyx,chartaceous,closely,cm,conical,continued,corolla,deltoid,densely,diameter,dichotomously,due,echinoid,elliptic,entire,filament,fleshy,flower,fruit,greenish,growth,hair,honeycombed,lateral,leaf,length,lobe,long,long-acuminate,margin,midvein,minutely,mm,mostly,multangulate,narrowly,obtuse,ovate,ovate-lanceolate,pedicel,peduncle,petiole,porrect-stellate,probably,pseudo-terminal,puberulent,pubescent,pulverulent,rachi,reniform,reticulate-punctate,ripe,sessile,several,short,short-stalked,shrub,side,simple,slender,small,smooth,spaced,sparingly,stellate-pubescent,stem,style,subglobose,suborbicular,testa,time,tomentose,tree,unarmed,vein,white,x,yellow,yellowish	.5-3,.75-5.25,1-1.3,1-3,1-3.75,1.75-2,1/3-1/2,1/5-1/2,100,12-24,6-8,absen,acuminate,adaxiall,adaxially,ag,anthesi,apical-lateral,apparently,appressed,axe,axillary,ba,bark,blade,blunt-tipped,branch,bud,cinereous,cylindrical,dehiscing,eaf,echinoi,eed,elongate,free,glabrate,glabrous,globose,high,inserted,introrse,large,lobed,long-exserted,longitudinal,lower,main,minute,nflorescence,oblong,older,orolla,pale,perfect,plurifoliate,pore,pulverulen,ruit,runk,slit,somewhat,sparse,stellate-rotate,stigma,subcampanulate,subcapitat,tamen,terete,thick,toward,tube,turn,unarme,unit,usually,vary,way,wide,ympodial,young	abaxial,adaxial,arrangement,branching,characteristic,colour,form,green,height,history,inflorescence,life,na,ovary,perennial,plant,primary,pseudostipule,seed,shape,staman,surface,tertiary,texture,venation,ye
397	wfo-0001030509	success	220	126	105	115	21	0.477	-10,-2,0,0-100,0-3,0-5,0.3-2.5,0.8-1.2,1-1.5,1-2,1.3-2,1/4,2-2.5,2-4.2,2-4.5,2-6,2.8-3,3-4,4.5-12,4.5-8,8-16,anther,apex,apically,apparently,articulated,base,berry,calyx,cm,cordate,cream,cuneate,dark,densely,diameter,entire,erect,eye,filament,flattened-reniform,flower,fruit,glabrous,green,half,herb,inflated,lateral,leaf,length,lobe,lobed,long,lower,margin,marking,maturity,mauve,midvein,mm,moderately,naked,narrow-deltate,narrow-oblong,obtuse,occasional,orange,orange-brown,ovate,pair,pale,pedicel,peduncle,per,petiole,plant,prickle,prickly,primary,purple,rounded,shrub,simple,sometimes,spherical,stellate-pubescent,stem,style,surface,terminal,tertiary,trichome,unarmed,unbranched,upper,usually,vein,venation,visible,weakly,wide,yellow,yellow-green,young	-6,/3,0-0.3,0-15,0.1,0.1-0.2,0.1-0.25,0.1-0.3,0.2,0.5-1.5,0.6-1,0.8-4,1,1-3,1-4,1-6,1.5-2,1.7-2,1/,1/3-2/3,2-3,2/3-3/4,3-10,4.5-10,5-10,5-merous,7-15,7-9,abaxially,alyx,andromonoecious,apar,apart,apical,bark,becoming,blade,broad-deltate,brow,chartaceous,connivent,curved,difoliate,discolorous,distal,distance,drying,eaf,eed,elongating,equal,extending,free,fruiting,geminat,glabrescent,gland,globular,gray,herbaceous,hermaphrodite,heterostylous,infructescence,long-acuminat,long-styled,longer,lowermost,mature,midpoint,nflorescence,occasionally,often,older,one,open,orolla,oung,pendulous,pericarp,perpendicular,poricidal,porrect,portion,ray,reduced,ruit,scar,short-styled,shorte,shorter,side,slender,smooth,spaced,sparsely,spreading,stalk,stalked,staminat,stellate,straight,subsessile,tamen,tapering,terete,time,tip,tube,unarme,unit,variously,vary,way,woody,ympodial	abaxial,adaxial,arrangement,branching,characteristic,colour,corolla,form,growth,height,history,inflorescence,life,long-acuminate,na,ovary,perennial,seed,shape,staman,texture
398	wfo-0001030516	invalid_json	172	96	68	104	28	0.395	0.4-1.5,1-7,1.1-4.1,1.5-2,1.8-2.4,3-6,3-8,4-22,4-6,4-7,4.2-10.7,8-9,acute,branched,calyx,cell,cm,corolla,covered,covering,cyme,darker,densely,diameter,dichasial,dichasially,ebracteate,elliptical,gland,green,hair,herbaceous,interjected,lateral,leaf,leaflet,light,lobe,long,long-attenuate,mm,monochasial,odd-pinnate,ovate,ovoid,pair,pedicel,peduncle,pentagonal,perennial,petiole,pilose,plant,puberulent,pubescent,rotate,seed,short-stalked,sometimes,spreading,stripe,style,terminal,testal,thick,tuber-bearing,wall,yellow	1-2.5,1-4,1.1-3.5,1.7,2-12,2-2.,2-3,2-4,3-6-foliat,3-9.8,4-4,6-15,9-22,9-32,abaxially,acumen,acuminate,adaxially,apex,apical,apically,articulate,base,connate,cordate,cuneate,decurrent,dehiscent,digestion,diminished,distal,dorsally,eaf,edge,eed,emoval,enzyme,exceeding,filament,first,flat,flower,folded,forked,generally,globo,globose,gradually,green-white,hair-like,half,honeycomb,introrse,less,living,lon,longer,lower,lunat,make,maturing,mucilaginous,nflorescence,nther,oblique,often,orolla,outline,pattern,perfect,plan,poricidally,proximal,rarely,reveal,ruit,second,sessile,seudostipule,short,short-petiolate,size,slightly,slit,specimen,stamen,stigma,straight,tal,tem,throughout,time,toward,triangular,triangulat,type,typically,unit,vary,whit,wide,ympodial,Â¼,â	'','hair-like,'type,2-21,[,],``,abaxial,adaxial,anther,arrangement,characteristic,colour,form,fruit,growth,height,inflorescence,length,ovary,shape,stem,surface,texture,value,width,{,}
399	wfo-0001030551	success	167	111	75	92	36	0.449	-30,0-2,0.5-1,0.6-1.5,1-10,1-2,1-2.5,1-3.5,1-4,1-5,1.5-2.5,10-20,10-40,2,2-3,2.5-5,20-25,4-,4-5,9-20,acuminate,acute,also,apex,articulated,basal,base,blue,calyx,chartaceous,cm,cordate,densely,diameter,entire,fading,flower,fruit,glandular-puberulent,globose,leaving,lobe,long,margin,mm,moderately,oblong-fusiform,obtuse,often,ovate,ovate-elliptic,pedicel,pedicellar,peduncle,perfect,petiole,pilose,puberulent,puberulent-pubescent,pubescent-pilose,rachi,remnant,shrub,simple,sparsely,style,subcoriaceous,tip,triangular-elliptic,truncate,unbranched,unknown,violet,x,yellowish	-12,-5,1,1-,1.5-,13.,2-6,2.5-4,3-,3-12,3-5,3-8,4-7,4-foliat,5-17,5-6,abaxially,abruptly,absent,adaxially,adpressed,aggregate,apart,ape,axe,beyond,bilobe,blade,broad,campanulate,cell,clavate,color,concave,connective,dia,dilated,directed,distally,eaf,ed,ellipsoidal,equal,et,exceeding,exserted,fleshy,glabrous,hair,lanceolate,laterally,lon,lower,martinelli,narrow,narrowed,narrowly,nflorescence,nther,orolla,ovoid,papillose,pore,puberulen,pubescent-pilo,radiu,ripe,round,ruit,seen,shorter,slightly,small,spaced,stamen,stellate,stigma,stone,tal,tem,thecae,time,tomento,triangular,tube,ud,unit,unknow,vary,wide,widening,ympodial	3-7,4-6,abaxial,adaxial,anther,arrangement,branching,characteristic,colour,corolla,filament,form,growth,height,history,inflorescence,leaf,length,life,midvein,na,ovary,perennial,plant,primary,pseudostipule,seed,shape,staman,stem,surface,tertiary,texture,unarmed,vein,venation
400	wfo-0001030570	success	173	119	86	87	33	0.497	-1,.3-0.5,0.3-0.5,0.5-,1,1-1.5,1-4,1-8,1.5,10-25,15-35,2-2.5,2-3,2-5,2-7,2-7-lobed,2-8,20-30,3-5,3-6,3.5-5,4-5,4-7,abaxially,acuminate,acute,adaxially,apex,apiculate,basal,base,calyx,cm,color,cordate,diameter,ellipsoidal,entire,flattened,fleshy,flower,forked,fruit,glabrous,glandular-puberulent,globose,green,leaf,lobe,lobed,long,margin,mm,obtuse,occasionally,often,pedicel,peduncle,petiole,pilose,pinnately,pubescent,punctate,purplish,rachi,rarely,ripe,rounded,rugose,simple,somewhat,sparsely,style,subcoriaceous,submarginally,tip,tree,truncate,unbranched,unequal,unknown,unlobed,vein,white,x,yellow	0-,0.5-1,1-,1-2,1-3,1-5,1.5-2.5,1/2,10-17,15-20,2-4,2.5-22,3-10,4-25,4-foliat,4/5,5-,8-,absent,aggregate,apart,ape,articulated,axe,beyond,blade,campanulate,cell,connective,connivent,cylindrical,dilated,directed,distally,divided,eaf,eed,eglandular,elliptic-oblong,exceeding,exserted,glabrat,hair,lanceolate,leaving,lon,lower,midrib,narrowly,near,nflorescence,nther,orolla,ovate,ovoid,pedicellar,perfect,pilo,pore,presen,purpl,radiu,remnant,ruit,shorter,sinus,slightly,small,sometimes,spaced,stamen,stellate,stigma,stone,tal,tem,thecae,time,tomento,triangular,truncat,tube,ud,unit,vary,wide,ympodial	abaxial,adaxial,anther,arrangement,branching,characteristic,colour,corolla,filament,form,glabrate,growth,height,history,inflorescence,length,life,midvein,na,ovary,perennial,plant,primary,pseudostipule,seed,shape,staman,stem,surface,tertiary,texture,unarmed,venation
401	wfo-0001030581	success	187	103	70	117	33	0.374	.5,abaxial,acute,adaxial,anther,apex,articulated,base,berry,black,calyx,central,cm,conical,corolla,decurrent,densely,diameter,elliptic,entire,filament,flattened-reniform,fruit,glabrous,globose,green,growth,herb,inflorescence,intermodal,lateral,leaf,lobe,long,margin,maturity,minutely,mm,occasionally,once-branched,ovary,ovate,pair,pedicel,peduncle,per,petiole,pitted,plant,portion,primary,pubescent,purplish,rachi,ripe,rounded,shallow,simple,sparsely,spreading,stem,straight,style,surface,turning,vein,white,wide,yellow,yellowish	.3,0.2â0.8,0.4â0.6,0.4â1.6,0.5,0.5â0.7,0.5â2.5,0.6â0.7,0.7â0.8,0.9â1,1,1-4-celled,1.2â1.5,1.8â8,1â2,1â2-celled,1â2.5,1â4-celled,2,20â50,2â3-celled,35â45,3â4,3â5,4.5â12,4â7,4â9,5-merous,5â6,5â8,9,abaxially,adaxially,aggregate,along,angle,angled,anthesi,apar,appressed,basal,becoming,beyond,branched,bright,capitate,cell,clustered,cone,denser,difoliate,drop,eaf,eed,ellipsoid,exserted,florescence,flower,free,fruiting,geminat,halfway,individual,lacking,later,leave,less,like,live,lobed,lon,lower,markedly,minute,narrowly,near,new,often,outline,papillate,pentagonal,perfect,reflexe,reflexed,remaining,ridge,ruit,scar,shiny,shorter,slightly,somewhat,spaced,sprawlin,stellate,stigma,stone,strongly,tall,tangled,tem,terete,testal,third,translucent,trichome,tube,ud,uniseriate,unit,upper,usually,winged,woody,ympodial,â15,â5	0.4-0.6,0.4-1.6,0.5-0.7,0.5-2.5,0.6-0.7,0.9-1,1.2-1.5,20-50,3-4,35-45,5,5-6,5-8,arrangement,branching,characteristic,colour,form,height,history,length,life,midvein,na,perennial,pseudostipule,seed,shape,staman,tertiary,texture,unarmed,venation
402	wfo-0001030583	success	166	99	74	92	25	0.446	.5,0.2-1,0.3-1,0.5-1,1,1-1.5,1-2,1.5-4,2.5,2.5-3,3-4,4-6,5-6,abaxial,acute,anther,apex,base,berry,calyx,cm,corolla,crisped,cultivar,deep,densely,dry,elliptic,filament,flattened-reniform,form,fruit,glabrous,globose,golden,green,immature,incrassate,irregular,lateral,leaf,lobe,long,long-triangular,main,margin,midvein,minutely,mm,narrowly,occasionally,often,orange-red,ovary,pair,pale,pedicel,petiole,pitted,plant,pubescent,ripe,rounded,shrub,simple,spathulate,stem,style,surface,tan,vein,white,x,yellow	.2,0.1-0.5,0.4-2.7,0.7-4.5,0.8-1,0.9-3.5,1-8,1/2,2.5-9,3/4,5-7,6-7,abaxially,adaxially,along,anthesi,ba,bark,brow,cell,closely,conical,corky,cultivated,dark,deflexed,dendritic,dia,differing,difoliate,eaf,edicel,eed,ellipsoid,enlarged,erect,especially,flower,free,frui,fruiting,geminat,included,leave,like,live,lobed,lon,long-rectangular,lower,major,minor,nflorescence,older,opposite,outline,overlapping,papery,papillo,papillose,pericarp,planar,pore,poricidal,portion,prostrate,rest,ruit,scar,shaped,size,small,small-capitate,soon,spaced,specimen,stigma,stout,tall,tear-drop,testal,thin,tip,trichome,tube,ud,uniseriate,unit,way,woody,ympodial,young	adaxial,arrangement,branching,brown,characteristic,colour,diameter,growth,height,history,inflorescence,length,life,na,peduncle,primary,pseudostipule,rachi,seed,shape,staman,tertiary,texture,unarmed,venation
403	wfo-0001030605	success	144	109	80	64	29	0.556	.5,0.1,0.3-0.5,1,1-4,1.5-2,1.7,12-19-flowered,2,2-3,2.5,7,abaxially,acute,adaxially,almost,anther,apex,attenuate,base,berry,branched,brown,calyx,cinereous,cm,commonly,coriaceous,corolla,cylindrical,dark,dendritic-echinoid,dia,difoliate,dry,entire,filament,glabrate,glabrous,globose,green,growth,inflorescence,leaf,less,lobe,long,margin,material,minutely,mm,nearly,obovate,obtuse,olive,ovary,ovate,ovoid-reniform,pedicel,peduncle,petiole,pitted,pubescent,rarely,revolute,rounded,shiny,shrub,simple,slightly,smooth,sparsely,style,surface,trichome,unifoliate,vein,white,woody,x	.4,1.5-5.5,1/3-1/2,5-12.5,along,anthesi,apart,ape,apical,area,beginning,beneath,branch,conical,covered,deflexed,densely,drying,eaf,edicel,eed,ellipsoid,exerted,free,fruiting,geminat,gold,inflorescenc,internodal,light,lobed,lower,midrib,new,nflorescence,occasionally,opposite,otherwise,overlapping,papillate,papillosefruit,pore,poricidal,portion,reflexed,scar,scattered,shaped,slender,somewhat,soon,sparesly,stigma,tear-drop,thickened,tinged,tip,tub,tube,ud,unit,way,yellow,ympodial	abaxial,adaxial,arrangement,branching,characteristic,colour,diameter,form,fruit,geminate,height,history,length,life,midvein,na,perennial,plant,primary,pseudostipule,rachi,seed,shape,staman,stem,tertiary,texture,unarmed,venation
404	wfo-0001030624	success	170	95	61	109	34	0.359	.5,0.5,0.5-1,0.9-1,1.2-1.8,1.2-2,1.5-2,2-10,2-3,3-3.5,3.5-4,7-9,acute,anther,apex,apiculate,attenuate,base,berry,calyx,cm,corolla,elliptic,filament,flattened-reniform,glabrous,globose,green,greyish,hyaline,leaf,lobe,long,longitudinally,margin,minutely,mm,narrowly,ovary,pair,pedicel,petiole,pitted,shining,shrub,slender,small,square,stem,straight,style,surface,tapering,tree,tube,vein,white,x,yellowish,yellowish-green,yellowish-grey	.25,0.5-1.5,1-3,2,2.5-5.5,25-40-flowered,3,4.5-8,6-13,anthesi,apart,appearing,axil,ba,bark,beginning,branch,caly,cell,clavate,decurrent,deflexed,dia,differing,difoliate,dimorphic,distal,dry,eaf,edicel,eed,ellipsoid,end,erect,except,expanded,exserted,extreme,falcate,free,fruiting,furcate,geminat,glabrate,glandular,incrassate,inflorescenc,large,later,lateral,like,lobed,lon,lower,main,major,material,middle,midrib,minor,near,nearly,nflorescence,occasionally,older,one,opposite,outer,pale,papillose,planar,pore,poricidal,portion,prominent,puberulent,raised,remaining,round,rugo,ruit,scar,short,simple,size,slightly,somewhat,soon,spaced,stigma,tall,thickened,three,ti,tip,trichome,trunk,tuft,two,ud,unevenly,uniseriate,unit,wall,widest,woody,yellow,ympodial,young	abaxial,adaxial,alternate,arrangement,branching,characteristic,colour,diameter,form,fruit,growth,hair,height,hirsute,history,inflorescence,length,life,midvein,na,peduncle,perennial,plant,primary,pseudostipule,rachi,rugose,seed,shape,staman,tertiary,texture,unarmed,venation
405	wfo-0001030638	success	177	108	82	95	26	0.463	0.1,0.5-0.7,0.5-1,0.5-1.5,0.5-2,0.7-1.5,1-1.2,1-2,1.4-1.7,1.5-2,1.6-2.2,2-7-flowered,3-10,4-6,8,8-11,8-9,acute,anther,apex,apically,axil,base,beneath,berry,blade,branched,broadly,bud,calyx,cm,corolla,deltoid,elliptic,exfoliating,extending,filament,flattened,fruit,glabrous,glandular,globose,green,impressed,inflorescence,lamina,leaf,less,like,lobe,long,margin,mm,obovate,occasionally,ovary,pair,pale,papillose,pedicel,persistent,petiole,red,roundish,rugose,seed,shape,shrub,simple,size,stem,stigma,style,surface,thick,transversely,tree,trichome,usually,vein,white,x	0.5,1-1.5,2-3,2-5,2.5-4,3-13,along,anthesi,appear,appearing,axi,ba,bark,beginning,closely,conspicuously,corky,cucullate,cup-shaped,deflexed,densely,dia,differing,difoliate,dry,eaf,eed,entire,erect,fleshy,free,fruiting,geminat,geminate,glabrate,gre,irregular,known,large,later,lateral,lobed,lon,lower,main,major,material,middle,minor,minutely,near,nearly,nflorescence,often,older,one,open,opposite,overlapping,ovoi,paler,papillae,papillo,planar,pore,poricidal,portion,present,prominent,rather,red-glandular,reddish,rest,ruit,scar,shaped,soon,spaced,speciman,straight,tall,tapering,tear-drop,terminal,thickened,thickening,tip,tube,uniseriate,unit,wall,widest,woody,ympodial,young	abaxial,adaxial,arrangement,branching,characteristic,colour,diameter,form,grey,growth,height,history,length,life,midvein,na,peduncle,plant,primary,pseudostipule,rachi,staman,tertiary,texture,unarmed,venation
406	wfo-0001030661	success	183	115	88	95	27	0.481	-24,.5,0,0.5-0.6,0.5-0.75,0.5-2,0.7-0.8,1-1.3,1-1.4,1-1.5,1.5-2,1.5-7,12-16,2-2.5,3-3.5,4-15,5-5.5,acute,anther,anthesi,apex,articulated,attenuate,base,berry,branched,brown,calyx,cm,corolla,deltate,densely,diameter,elliptic,entire,filament,flattened,glabrous,globose,growth,inflorescence,lateral,leaf,lobe,long,many,margin,mature,membranous,minutely,mm,narrowly,nodding,occasionally,onto,pair,pedicel,peduncle,per,petiole,pitted,primary,pubescent,red,reddish,reniform,scattered,shrub,simple,sleeve,slender,small,sparsely,stem,strongly,style,surface,terminal,time,tinged,tree,trichome,uniseriate,vein,violet,white,winged,x	.2,1-,1-.,1-1.2,1.2-7,2-,3-20,3-4,4-6,5-10,5-merou,50-100+,ag,along,alyx,ark,branch,brow,capitate,cell,clustered,conical,connivent,dar,denser,drying,eaf,eed,ellipsoid,em,erec,erect,exserted,extending,flower,free,fruiting,glabrescent,glabrou,group,ilament,insertion,lamina,lengthening,lobed,lon,loosely,lower,midrib,minute,near,never,new,nflorescence,older,orolla,otherwise,pale,papillo,perfect,pericarp,planar,platform,plurifoliat,point,pore,poricidal,portion,rectangular,ruit,scar,shiny,slightly,slit,spreading,stellate,stigma,tangled,testal,thin,tip,tube,twinin,ud,unit,upper,usually,vary,way,woody,yellow,yellowish,ympodial,Â½,Â¾	1-5,abaxial,adaxial,arrangement,branching,characteristic,colour,form,fruit,height,history,length,life,midvein,na,ovary,perennial,plant,pseudostipule,rachi,seed,shape,staman,tertiary,texture,unarmed,venation
407	wfo-0001030676	success	220	154	131	89	23	0.595	-1.6,-3.9,0-100,0.4,0.6-1.2,1,1-1.2,1-3,1.1-1.4,1.1-1.9,1.2-1.3,1.7-2,11-14,14-17,16,2.1-2.3,2.1-2.6,2.2-5.7,2.4-3.1,3-6,4-6,4-6.5,7-10,7-8,7-9,8-10,abaxially,abruptly,acute,adaxially,angled,anther,apart,apex,appressed-tomentose,articulated,base,becoming,berry,branch,branched,brown,calyx,closely,cm,conical,continued,corolla,cylindrical,deltoid,densely,diameter,dichotomously,due,echinoid,entire,except,filament,finely,fleshy,flower,fruit,glabrescent,glabrous,granular-tomentose,green,greenish,grooved,growth,hair,honeycombed,initially,lateral,leaf,length,lobe,longitudinally,margin,midvein,minute,minutely,mm,moderately,mostly,multangulate,nearly,oblique,oblong-elliptic,obtuse,often,openly,ovate,pedicel,peduncle,petiole,probably,pseudo-terminal,pubescent,pulverulent,rachi,reniform,reticulate-punctate,ripe,scabrous,scattered,sessile,short-attenuate,short-stalked,shrub,side,simple,small,spaced,stellate,stellate-pubescent,stem,style,subglobose,suborbicular,terete,testa,tip,tree,tuft,vein,velutinous,white,whitish,x,yellow,yellowish	-2.5,-8.5,/10-1/5,1.3-1.5,1/4,19-35,2.5-5.5,2.75-3.25,3-3.5,3-5,8-12,along,anthesi,apical-lateral,apparently,appearing,axillary,ba,bark,blade,blunt-tipped,bud,chartaceous,crown,dehiscing,eaf,echinoi,eed,elongate,exserted,flat-topped,forming,free,glabrescen,globose,high,horizontal,inserted,introrse,lackin,lamina,large,lengthen,lined,lobed,long,longitudinal,lower,main,midvei,nflorescence,oblong,occasional,older,opening,orolla,ovate-lanceolate,parallel,perfect,plurifoliate,pore,rather,ray,ridged,ruit,runk,slit,somewhat,sparsely,spreading,stigma,strongly,subcampanulate,subcapitat,tamen,tending,thick,thin,time,tomentose,tube,unarme,unit,usually,vary,way,wide,ympodial,young	abaxial,adaxial,arrangement,branching,characteristic,colour,form,height,history,inflorescence,life,na,ovary,plant,primary,pseudostipule,seed,shape,staman,surface,texture,unarmed,ye
408	wfo-0001030686	success	182	104	84	98	20	0.462	1-1.1,1-1.2,1-1.5,1-2,1.2-1.5,1.5-4.5,1.6-3,15,2-2.5,2-3,2.5-4,2.5-8,3-3.5,5-25,5-30,5-6,8-9,abruptly,acuminate,acute,anther,apex,base,berry,black,branched,brown,calyx,cm,conical,corolla,dark,densely,diameter,elliptic,entire,filament,flattened,flower,form,fruit,globose,height,internodal,leaf,leaf-opposed,lepidote,lilac,lobe,margin,maturity,midvein,mm,oblique,orange,ovary,pair,pale,paler,pedicel,peduncle,petiole,pitted,plant,primary,pubescent,purple,rachi,scarious,seed,shallowly,shiny,simple,sparsely,stem,style,surface,time,tree,uniformly,usually,vein,x,yellow	.2,.5,.5-1,0.5-1,1.5-2,1972,2-6.5,5-12,?,abaxially,aborted,adam,adaxially,age,anthesi,apart,bark,basal,beneath,bifid,breast,brittle,bu,c.,centre,closely,cup-shaped,darker,deeply,denser,different,difoliate,discolorous,dry,drying,eaf,edicel,eed,empty,erect,exerted,fide,fragrant,free,fruiting,geminat,glabrescen,glabrous,golden,half,heteromorphic,lamina,lengthening,less,lobed,long,lower,many,midrib,minutely,nflorescence,noddin,older,overlapping,papillae,papillose,pericarp,planar,pore,poricidal,portion,pubescen,ruit,scar,shallow,short,slightly,slit,somewhat,space,spaced,spreading,stellate,stigma,strongly,styl,thin,tip,tissue,trichome,tube,ud,unit,visible,way,woody,ympodial,â	abaxial,adaxial,arrangement,branching,characteristic,colour,growth,history,inflorescence,length,life,na,perennial,pseudostipule,shape,staman,tertiary,texture,unarmed,venation
409	wfo-0001030709	success	217	123	103	114	20	0.475	-2,0,0-,0-20,0-30,0.7-1,1-1.2,1-1.6,1-4.5,1.3-1.4,1.6-2.1,1.9-2.8,1/4,2-5,2-8,2.3-3,5-10,5-20,5-6,6-7,7-9,8-11,abaxially,acuminate,acute,adaxially,almost,anther,apex,apically,apparently,articulated,base,berry,branched,calyx,cm,cordate,diameter,dull,edge,elliptic,erect,filament,finely,flattened-reniform,flower,fruit,increasing,inflorescence,infructescence,lateral,leaf,length,lobe,lobed,long,margin,maturity,mauve,middle,midvein,mm,moderately,narrow-deltate,orange-brown,pair,pedicel,peduncle,per,petiole,pit,pitted,prickle,prickly,primary,purple,red-green,seed,shrub,simple,size,smooth,sparsely,spherical,stellate-pubescent,stem,style,surface,terete,terminal,tertiary,toward,truncate,unarmed,upper,usually,vein,venation,visible,wide,yellow,yellow-green	-5,-9,0.1-0.2,0.15-0.5,0.2-0.5,0.3-1.5,0.4,0.8-4,0.9-1.5,1-6,1.4-2,1/2-2/3,1/3-1/2,1/4-1/3,10-14,10-50,2-4,2-6,2/3-3/4,3-,4-5-merous,5-7,5-9,6-10,6-21,6-8,7-8,8-15,alyx,ame,apar,apart,ape,bark,blade,bright,broad-deltate,brow,c.,chartaceous,conical,connivent,cuspidate,deltate,discolorous,distance,drying,eaf,eed,elongating,equal,extending,free,fruiting,glabrescent,glabrous,lanceolate,lengt,lobing,lon,long-acuminat,longer,lower,mature,midpoint,nflorescence,occasionally,often,older,one,open,orolla,oung,pendulous,perfect,pericarp,perpendicular,plurifoliat,poricidal,porrect,portion,prickl,ray,red-orange,reflexed,retrorse,rounded,ruit,scar,secondary,short-styled,shorter,side,slender,sometimes,spaced,spreading,stalk,stalked,stellate,straight,tamen,tapering,time,tip,trichome,tube,unit,variously,vary,way,weakly,woody,ympodial	abaxial,adaxial,arrangement,branching,characteristic,colour,corolla,form,growth,height,history,life,long-acuminate,na,ovary,plant,rachi,shape,staman,texture
410	wfo-0001030714	success	178	141	117	61	24	0.657	-3,.5,0.1-0.3,0.5,0.5-0.8,0.5-1.9,0.7-0.8,1-1.2,1-1.5,1-2.5,1.2-1.5,1.2-4,1.5-2,1/3,2-2.5,2-2.6,3-3.5,5-100,5-6,7-17,abaxial,abaxially,acuminate,acute,adaxially,aid,along,anther,anthesi,apex,articulating,basal,base,beneath,berry,blue,blue-black,branching,calyx,cm,conical,cordate,corolla,dark,densely,diameter,elliptic,entire,especially,except,filament,flattened,flower,fruit,glabrous,globose,gradually,greyish,growth,herbaceous,joined,leaf-opposed,leaving,liana,like,lobe,long,many,margin,membranous,midrib,minute,minutely,mm,narrowly,nodding,ob-ellipsoid,ob-elliptic,oblique,occasionally,ovary,overall,pair,pale,pedicel,peduncle,peg,petiole,pitted,primary,prominent,pubescent,quadrate,reniform,ripe,shape,simple,slightly,sparsely,stem,style,submarginal,surface,tapering,terminal,thickened,time,trichome,truncate,twining,uniseriate,vein,vine,violet,woody,x,yellow	.2,/3,0.3-0.4,0.8-1,1-1.3,1.4-3.5,20,3-7,>,age,apar,bark,becoming,campanulate,clavate,climbin,cup,denser,eaf,eed,ellipsoid,exserted,fide,free,grading,gree,howard,lengthening,lobed,lower,narrow,new,nflorescence,node,older,paler,papillat,papillate,pedice,per,perfect,planar,plurifoliat,pore,poricidal,portion,ruit,scar,slit,spaced,stellate,stigma,strongly,tip,tub,tube,ud,unit,way,widely,ympodial	adaxial,arrangement,characteristic,climbing,colour,form,green,height,history,inflorescence,leaf,length,life,midvein,na,plant,pseudostipule,rachi,seed,staman,tertiary,texture,unarmed,venation
411	wfo-0001030733	success	130	114	75	55	39	0.577	1-1.2,1-1.5,1-2,1.7-2.7,2-2.5,3-4,3-5,4.5-5,5-8-flowered,6-7,6-9,?,abaxially,acuminate,acute,adaxially,anther,anthesi,apex,bark,base,berry,bi-lobed,brown,calyx,capitate,cm,corolla,dark,decurrent,deltate,densely,ellipsoid,elliptic,exserted,filament,fruiting,glabrous,globose,green,later,leaf,lobe,long,margin,minutely,mm,moderately,narrowly,onto,ovary,ovoid-reniform,pair,pedicel,petiole,planar,pore,pubescent,shaped,shrub,simple,smooth,somewhat,sparsely,stem,stigma,strongly,style,surface,tear-drop,treelet,tube,vein,white,x	.5,/4,0.5-1,1.5-5,4-15,along,ape,broadly,clearly,closely,conical,coriaceous,denser,dia,eaf,eed,elongate,embryo,erect,free,grayish-brow,lamina,lateral,like,lobed,lon,lower,main,middle,nflorescence,older,opposite,overlappin,papillo,poricidal,portion,rounded,ruit,scar,spaced,tall,testa,thick,tip,trichome,ud,unifoliat,uniseriate,unit,visible,way,widest,woody,ympodial,young	0.5,1.5,2,abaxial,adaxial,arrangement,branching,bud,characteristic,colour,diameter,exsertion,form,fruit,glabrousnes,grayish-brown,growth,height,history,inflorescence,length,life,midvein,na,papillose,peduncle,perennial,plant,primary,pseudostipule,rachi,seed,shape,staman,tertiary,texture,unarmed,unifoliate,venation
412	wfo-0001030772	success	155	95	65	90	30	0.419	-2,0.2-0.8,0.25-0.5,0.5-1,0.75-1,0.9-1,1-2,1-2.5,1.5-2,3-3.5,3-5,5-6,8-10,acuminate,anther,apex,attenuate,base,berry,bud,calyx,cm,corolla,dark,deflexed,elliptic,filament,fruit,gently,glabrous,globose,green,grey,impressed,large,leaf,lobe,long-acuminate,long-triangular,margin,minutely,mm,occasionally,ovary,ovoid-reniform,pair,pale,paler,papillose,pedicel,petiole,pitted,shape,shining,shrub,simple,stem,straight,style,surface,tan,tapering,vein,white,x	.05,.2,.25,.5,0.9-3.1,1.2-5,1.4-1.6,2-7,4.2-6.5,5-10-flowered,9-15,acute,anthesi,archin,ba,bark,becoming,beginning,beneath,branch,capitate,closely,dia,differing,difoliate,eaf,edicel,eed,ellipsoid,erect,extreme,free,fruiting,geminat,inflorescenc,later,lateral,lenticellate,lobed,lon,long,lower,main,major,methyl,middle,minor,nearly,nflorescence,node,older,one,opposite,overlapping,papillo,per,pore,poricidal,portion,prominent,reflexed,ripe,rounded,ruit,salicylate,scar,shaped,size,slender,slightly,smelling,soon,spaced,stigma,strongly,swollen,tall,tear-drop,tip,trichome,tube,ud,uniseriate,unit,usually,widest,wintergreen,woody,ympodial,young	abaxial,adaxial,alternate,arching,arrangement,branching,characteristic,colour,diameter,form,growth,height,history,inflorescence,length,life,midvein,na,peduncle,perennial,plant,primary,pseudostipule,rachi,seed,staman,tertiary,texture,unarmed,venation
413	wfo-0001030781	invalid_json	213	135	103	110	32	0.484	0.5-6,1-2,1-4,1.6-2.2,10-40,15-35,2.5-14,2.5-3.5,3-4,5-6,5-7,5-8,6-7,7.5-9,abaxially,adaxially,anther,apex,apiculate,articulated,base,berry,brown,brownish,cell,chartaceous,cm,condition,corolla,covering,dark,decurrent,deep,densely,diameter,distal,dot,drying,filament,finely,fresh,fruit,glabrous,glandular,globose,gray-green,green,green-white,greenish,hair,hair-like,half,herb,high,lateral,leaf,light,like,lobe,long,make,margin,membranous,mm,mucilaginous,obovate,odd-pinnate,ovate,ovate-lanceolate,ovoid,papillose,pedicel,peduncle,petiole,pilose,plant,pointed,pubescent,purple,rachi,rarely,rounded,scattered,seed,simple,slightly,small,sometimes,somewhat,sparsely,stem,style,subovoid,testal,thick,throughout,typically,unwinged,violet,wall,wet,white,whitish	0-5,0.2-4,0.5-8,1-1.5,1-10,1-12,1-8,1.5-12,1.5-2,1.5-9,2-20,2-3,3-6,4-15,5-merou,abruptly,acumen,ag,along,alyx,apart,apparently,axe,axillary,blade,borne,broadly,bud,caly,capitat,ciliate,connivent,cuneate,decreasing,digestion,dorsally,eaf,edge,eed,elliptic,end,enzyme,erect,especially,exceeding,flat,flower,folded,forked,geminat,generally,glabrou,gradually,homostylous,honeycomb-shaped,interjected,lanceolate,larger,leaflet,lengthening,living,low-growin,lower,midrib,minutely,narrowed,nflorescence,orbicular,orolla,pair,pentagonal,perfect,petiolulate,plurifoliate,pore,poricidal,puberulent,removed,rotate-pentagonal,ruit,sessile,seudostipule,short,singly,size,slit,spaced,specimen,stamen,ste,stigma,stolo,straight,subtending,tall,tamen,tem,terminal,tip,toward,tri-,tube,tuber,unit,usually,vary,wide,x,yellow,ympodial	'',2,[,``,abaxial,adaxial,arrangement,branching,calyx,characteristic,colour,form,growth,height,inflorescence,length,midvein,na,ovary,primary,pseudostipule,shape,staman,surface,tertiary,texture,unarmed,value,vein,venation,{,}
414	wfo-0001030782	success	198	124	94	104	30	0.475	0-1,0.4-1.5,1-2,1-3,1.5-2,1.5-7.5,13-22,15,2,2.2-4,3-10,4-6,5-20,6-8,abaxially,acumen,acuminate,acute,adaxially,anther,apex,attenuate,axillary,base,berry,broadly,brownish,bud,cell,cm,condition,coriaceous,corolla,covering,dark,deep,diameter,distal,drying,elliptic,filament,forked,fresh,fruit,generally,glabrescent,glabrous,globose,green,green-white,greenish,hair,hair-like,half,herb,lateral,leaf,light,lilac,lobe,long,make,medium,mm,mottled,mucilaginous,odd-pinnate,ovate,ovoid,pedicel,peduncle,petiole,petiolulate,plant,purple,rachi,ripe,rounded,scarce,seed,sessile,short,style,subtending,terminal,testal,thick,throughout,usually,wall,wet,white,whitish,winged	0-7,1-5,1-6,1.2-3.9,1.3-1.6,1.6-4.6,11-47,12-30,2-3,2.4-11.5,3-5,4-11.6,4.6-26,5-merou,7-15.6,abaxiall,ag,along,alyx,apart,apparently,arranged,articulated,asymmetric,axe,basiscopic,bead,blade,capitat,clavate,connivent,cuneate,decreasing,digestion,dorsally,eaf,edge,eed,enzyme,exceeding,flat,flower,folded,geminat,glabrou,hal,high,homostylous,honeycomb-shaped,inconspicuous,interjected,lanceolate,leaflet,lengthening,like,living,lower,moniliform,multiple,necklace,nflorescence,orbicular,orolla,pair,pentagonal,perfect,plurifoliate,pore,poricidal,prominently,removed,rotate,ruit,second,seudostipule,side,size,slit,smaller,sometimes,spaced,specimen,stamen,stigma,stolon,straight,subequal,tal,tamen,tem,tip,tissue,totally,toward,tri-,tube,tuber,typically,unit,vary,wide,x,yellow,ympodial	abaxial,adaxial,arrangement,branching,calyx,characteristic,colour,form,growth,height,history,inflorescence,length,life,margin,midvein,na,ovary,perennial,primary,pseudostipule,shape,staman,stem,surface,tertiary,texture,unarmed,vein,venation
415	wfo-0001030802	success	171	109	79	92	30	0.462	.5,.5mm,0.5-1,0.7-1cm,0.75-1,1,1-1.1,1-1.2,1-1.5,2-2.5,2-3,2.5-3,3-3.5x,3-4,4-5mm,4-6,5-10-flowered,abrupt,acuminate,acute,anther,apex,base,berry,brown,calyx,cm,cordate,corolla,deeply,deflexed,densely,dia,difoliate,evenly,filament,flattened-reniform,fruit,glabrous,glandular,globose,heart-shaped,internodal,leaf,length,lobe,long,long-triangular,margin,midvein,minutely,mm,ovary,ovoid,pair,pale,pedicel,petiole,pitted,plant,pubescent,red,shrub,simple,slender,somewhat,stem,straight,style,subshrub,surface,tapering,tube,unifoliate,vein,white,x,yellow,yellowish	.3,0,0.25-0.4,0.5-0.75,0.5-1.5,0.9-1,2-5,3-6,abaxially,adaxially,along,anthesi,appearing,bark,basal,becoming,beginning,beneath,bud,campanulate,cucullate,denser,dry,eaf,edicel,eed,ellipsoid,except,exerted,exudate,filiform,free,fruiting,geminat,gland,glandurla,halfway,hanging,incrassate,inflorescenc,invest,irregularly,lamina,later,lateral,line,live,lobed,lower,m.,main,markedly,material,near,nflorescence,obconic,older,palmate,papillate,papillose,per,persistently,pore,poricidal,portion,prominent,pubescen,raised,reddish,ruit,scar,shaped,single-celled,soon,spaced,specimen,stigm,stigma,strongly,tear-drop,tip,tipped,trichoem,trichome,ud,uniseriate,unit,variable,widely,woody,ympodial,young	abaxial,adaxial,arrangement,branching,characteristic,colour,diameter,form,green,greyish,growth,hair,height,hirsute,history,inflorescence,life,na,peduncle,perennial,primary,pseudostipule,rachi,seed,shape,staman,tertiary,texture,unarmed,venation
416	wfo-0001030809	success	154	93	55	99	38	0.357	0.5-1,1-1.5,1.2-1.4,1.4-1.5,1.5-3.5,4.5-5,6-8,8,acute,anther,apex,base,berry,branched,broadly,calyx,cm,corolla,curl-tipped,curved,deltoid,densely,ellipsoid,elliptic,filament,fruit,glabrous,globose,golden,green,hidden,leaf,lobe,mm,ovary,ovate,pedicel,petiole,pubescent,scar,several,simple,slightly,stem,stigma,straight,style,time,tomentose,tree,triangular,trichome,vein,white,yellow-brown	.5,0.2,1-1.25,1.5-2.4,2-2.5,2.3-5.5,20-60-flowered,5-8,9.9-12,across,along,also,anthesi,apar,appearing,bark,beneath,caly,campanulate,clavate,dark-papillo,deciduous,deflexed,dense,dia,difoliate,distally,eaf,edicel,eed,erect,especially,evenly,exserted,falcate,free,fruiting,geminat,hair,interpetalar,known,large,lateral,leave,like,lobed,lon,long,long-papillose,lower,main,major,markedly,mature,membranous,middle,midrib,minor,minutely,nearly,nflorescence,older,one,opposite,overtopping,planar,pore,poricidal,portion,present,round,ruit,scattered,shinin,shining,shoot,sinus,size,slender,small,soon,spaced,tall,tapering,terminal,three,tip,tube,two,ud,underside,unequal,uniseriate,unit,wide,widest,x,ympodial,young	1,2,abaxial,adaxial,alternate,apart,arrangement,branching,bud,characteristic,colour,dark-papillose,diameter,form,growth,height,history,inflorescence,length,life,margin,midvein,na,peduncle,perennial,plant,primary,pseudostipule,rachi,seed,shape,spacing,staman,surface,tertiary,texture,unarmed,venation
417	wfo-0001030810	success	191	136	81	110	55	0.424	0.2,0.4,abaxially,accrescent,acute,adaxially,anther,anthesi,apart,apex,articulated,axillary,base,bipinnate,blue,borne,branched,brown,calyx,cell,cm,colour,dark,densely,diameter,divided,elliptic,filament,flattened,fleshy,flower,fruit,glabrous,globose,green,greyish,hair,indumentum,leaf,leafy,lobe,long,margin,midvein,mm,moderately,multicellular,oblong,older,opposed,pair,pale,pedicel,peduncle,petiole,pinnae,pinnate,pitted,primary,pubescent,rounded,shallowly,shiny,shoot,shrub,simple,spaced,sparsely,stem,stone,style,subglabrous,surface,time,tomentose,uniseriate,unknown,violet,white,woody,x	0.2â0.3,0.3,0.5â,0.5â0.8,0.6â1.0,0.7â1.4,0.8â5.5,0.95â2.0,0â,1,1.0â1.5,1.0â2.0,1.0â3.0,1.1â2.0,1.1â2.2,1.2â1.5,1.5â1.9,1â2,1â3,1â5,2.9â4.5,20â100,2â3,2â4,3.0â5.0,3.3â5.5,3.3â8.5,3.5â4.6,3â19,4â14,4â5,4â7,5,5â15,5â30,5â32,6â10,6â22,7â10,7â11,8â10,absen,adaxiall,ag,along,axe,ba,blade,chartaceous,clavate,connivent,cylindrical,decreasing,denser,eaf,eed,elliptical,equal,erect,especially,geminat,half,hig,irregular,lon,longitudinal,lower,m.,midrib,narrow,nflorescence,obtu,occasionally,opening,orolla,oung,pentagonal,perfect,plurifoliate,pore,poricidal,rarely,reflexed,ruit,secondary,shaped,side,size,slit,sometimes,stigma,straight,tamen,tardily,tear-drop,tip,tube,unicellular,unit,vary,wide,wing,yellow,ympodial,â2.5,â3,â3.4,â4.5,â5.0,â8	0.2-0.3,0.6-1.0,0.7-1.4,1-2,1.0-1.5,1.0-3.0,1.1-2.0,1.1-2.2,1.2-1.5,1.5-1.9,2.9-4.5,20-100,3,3.0-5.0,3.3-5.5,3.4,3.5-4.6,4-14,4-5,4-7,5-15,5-32,5.0,6-22,7-10,8-10,abaxial,absent,adaxial,arrangement,branching,characteristic,corolla,form,growth,height,history,inflorescence,length,life,na,ovary,perennial,plant,pseudostipule,rachi,seed,shape,staman,tertiary,texture,unarmed,vein,venation,young
418	wfo-0001030822	success	146	85	57	89	28	0.39	.2,0-0.5,0.5-1.5,0.8-1,0.9-1,1-1.5,1.5-2,2-2.5,2-5,3-3.5,5-6,8-9,acute,anther,apex,attenuate,base,berry,broadly,calyx,cm,completely,corolla,decurrent,deltate,elliptic-obovate,filament,filiform,flattened-reniform,glabrous,globose,green,inflorescence,leaf,lobe,margin,minutely,mm,ovary,pair,pale,pedicel,petiole,pitted,revolute,shiny,shrub,simple,stem,style,surface,tan,tapering,vein,white,x,yellowish-brown	0.1-0.2,0.4,0.4-1,1-1.2,11-15.5,2-3.8,3-5,3.5-7,5-7,abaxially,adaxially,anthesi,ba,beneath,clavate,closely,clustered,cucullat,cucullate,cup,deflexed,dia,differing,difoliate,eaf,edicel,eed,erect,exserted,fleshy,flower,free,fruiting,geminat,incrassate,inflorescenc,internodal,later,lateral,lobed,lon,long,long-ellipsoid,lower,main,major,middle,minor,minute,near,nearly,nflorescence,occasionally,older,onto,open,opposite,papillo,papillose,perhaps,planar,pore,poricidal,portion,present,red-papillose,ruit,scar,shaped,size,slightly,somewhat,spaced,sparsely,stigma,strongly,tall,tear-drop,tip,tube,ud,unit,usually,widest,winged,woody,yellowish,ympodial,young	abaxial,adaxial,arrangement,branching,characteristic,colour,diameter,form,fruit,growth,height,history,length,life,midvein,na,peduncle,plant,primary,pseudostipule,rachi,seed,shape,staman,tertiary,texture,unarmed,venation
419	wfo-0001030871	success	248	164	140	108	24	0.565	.2-3,0-120,0.2-0.4,0.3-4,0.4-1.8,0.6-1.5,0.7-1.3,0.7-2.5,1-1.3,1-18,1.3-2,1.3-3,1.8-2.6,1/2-3/4,11,2-8,2.8-4.5,3-32,3-4.4,3-6,30,4.5-6.5,5-33,7-12,9-13,abaxially,abruptly,acuminate,acute,adaxial,adaxially,anther,apart,apex,appressed,articulated,attenuate,base,becoming,branched,brown,calyx,chartaceous,closely,cm,conical,continued,corolla,dark,deltoid,dendritic-echinoid,densely,diameter,directed,due,echinoid,entire,equal,erect,filament,flower,fruit,glabrescent,granular-tomentose,grayish,green,greenish,growth,hair,held,honeycombed,lateral,leaf,length,lobe,long,long-stalked,longer,margin,midvein,mixed,mm,mostly,multangulate,narrowly,nodding,obtuse,occasionally,often,orbicular,ovate,pale,partly,pedicel,peduncle,petiole,plurifoliate,probably,pubescent,purple,rachi,ray,reflexed,reniform,reticulate-punctate,ripe,scabridulous,sessile,short,short-stalked,shrub,side,sometimes,spaced,sparingly,stamen,stellate-tomentose,stem,style,subglobose,suborbicular,sulcate,terete,terminal,testa,time,tomentose,toward,tree,unarmed,usually,vein,velutinous,violet,way,white,x,yellow,yellowish,young	.8-3.5,.9-1.2,/30-1/5,1.4-2.7,1.5-3,1.5-6,1.8-3.5,1/2,1/4,1/4-1/3,2-3,3-5,3.5-14,4.8-9.5,5-7,6-40,accrescent,ag,along,anthesi,apical-lateral,apparently,appressed-tomentose,axe,axillary,ba,bark,berry,blade,blunt-tipped,branch,bud,campanulate,capitat,decurrent,dehiscing,dendritic-echinoi,dendritic-multangulate,distal,eaf,earl,early,echinoi,eed,elliptic,elongate,evident,exserted,extend,fleshy,free,fruiting,glabrescen,glabrous,high,inserted,introrse,large,lobed,long-,longitudinal,lower,m.,main,minute,multangulat,nearly,nflorescence,oblong,older,open,orbicula,orolla,ovate-lanceolate,overlapping,perfect,plait,pore,porrect-stellate,present,prominent,rather,relatively,rotate-stellate,ruit,runk,short-,simple,slit,small,somewhat,soon,sparsely,splitting,stigma,striate,strongly,suture,tamen,thick,thick-stalked,thin-stalked,tube,unarme,unit,vary,wide,ympodial	abaxial,arrangement,branching,characteristic,colour,form,height,history,inflorescence,life,na,ovary,perennial,plant,primary,pseudostipule,seed,shape,staman,surface,tertiary,texture,true,venation
420	wfo-0001030872	success	166	110	80	86	30	0.482	.5,0.5-1,0.8-1,1-1.2,1-1.5,1.2-1.5,1.5-2,1.5-5,2-5,3-7,4-6,4-6-flowered,5-6,5.5-7,acuminate,acute,adaxial,anther,apex,base,berry,calyx,cm,corolla,dark,deflexed,deltoid,densely,dia,dry,elliptic,erect,filament,fleshy,glabrate,glabrous,globose,green,known,leaf,lobe,long,major,margin,minutely,mm,oblique,opposite,ovary,ovate,pair,paler,papillose,pedicel,petiole,primary,puberulent,red-glandular-puberulent,reddish-glandular,relative,shining,shorter,simple,size,slightly,small,soon,specimen,stem,straight,strongly,style,tapering,thickened,tree,treelet,tube,white,x,young	0.5,0.8-2,1-2,1.2-3,12-18,6-12.5,age,along,anthesi,appearing,area,bark,beginning,black,broadly,brown,caly,center,closed,closely,completely,consisting,corky,crateriform,cucullate,darker,difoliate,eaf,edicel,eed,ellipsoid-ovoid,exserted,free,fruiting,full,geminat,hooded,incurved,inflorescenc,large,lenticel,lenticellate,less,like,live,lobed,lon,lower,material,middle,minor,nearly,nerve,nflorescence,older,one,overlapping,pale,petal,planar,pore,poricidal,portion,prominent,proximal,raised,rather,reddish-glandular-puberulent,rest,ridge,rounded,ruit,scar,shaped,side,spaced,stigma,styl,tall,tear-drop,tip,ud,unit,widest,woody,ympodial	abaxial,alternate,arrangement,branching,characteristic,colour,diameter,form,fruit,growth,height,history,inflorescence,length,life,midvein,na,peduncle,plant,pseudostipule,rachi,seed,shape,staman,surface,tertiary,texture,unarmed,vein,venation
421	wfo-0001030882	success	144	85	57	87	28	0.396	.5,0.5-0.75,0.5-1,0.5-1.1,0.8-1.1,0.9-1.1,1-1.3,1-1.5,1-4,2,3-3.5,8-12,acuminate,anther,apex,attenuate,base,calyx,cm,corolla,crenulate,deltoid,elliptic,filament,fruit,glabrous,globose,green,leaf,lightly,lobe,margin,minutely,mm,narrowly,occasionally,opposite,ovary,ovoid-reniform,pair,pale,papillose,pedicel,petiole,pitted,short,shrub,simple,small,stem,style,surface,tan,tree,vein,white,x	.1,0.75-1,0.8-2.4,1.6-2,2-5.4,2-6,2.2-4.6,3/4,6.5-15.6,?,accrescent,anthesi,bark,beginning,beneath,berry,capitate,closely,conical,deflexed,dia,differing,difoliate,eaf,edicel,eed,erect,exserted,extreme,free,fruiting,geminat,inflorescenc,lateral,lobed,lon,long,lower,main,major,middle,minor,nearly,nflorescence,older,one,overlapping,ovoid,paler,papillo,peelin,planar,pore,poricidal,portion,prominent,raised,ruguse,ruit,scar,shaped,size,slender,slightly,soon,spaced,stigma,straight,tall,tapering,tear-drop,terminal,thick,thickened,tip,transversely,truncate,tub,tube,ud,unit,way,widest,woody,yellowish,ympodial,young	abaxial,adaxial,arrangement,branching,characteristic,colour,diameter,form,growth,height,history,inflorescence,length,life,midvein,na,peduncle,plant,primary,pseudostipule,rachi,seed,shape,staman,tertiary,texture,unarmed,venation
422	wfo-0001030883	success	179	96	68	111	28	0.38	0.5-3,0.5-5,1-1.1,1-1.2,1-1.3,1-1.5,1-4,1.5-3.5,10-18,2-5,3-3.5,5-6,acuminate,acute,anther,apex,approximatately,base,berry,brown,calyx,cm,corolla,dark,deflexed,elliptic,filament,finely,fruit,furcate,glabrous,globose,green,inflorescence,leaf,lobe,massive,minutely,mm,narrowly,oblique,occasionally,opposite,ovary,ovate,ovoid-reniform,pair,pale,pedicel,perpendicular,petiole,pitted,plant,puberulent,russet,seed,shrub,stem,stout,straight,strongly,style,surface,tan,time,triangular,vein,white	-3,.05,.1,.5,1.5-2,18-44.5,20-50-flowered,3-4,3/4,9.5-27.5,accrescent,across,anthesi,apart,appearing,arching,bark,becoming,branched,bu,cell,clavate,collapsed,collection,dia,differing,difoliate,dry,eaf,edicel,eed,epidermal,erect,evenly,fleshy,free,fruiting,geminat,geminate,glandular,hard,hollow,imbedded,laminar,large,later,lateral,lenticellat,less,like,little,live,living,lobed,lon,long,long-acuminate,lower,main,malodorous,markedly,material,middle,midrib,minute,nflorescence,older,papillate,papillo,papillose,petaloid,placenta,pore,poricidal,portion,present,proximal,pulp,quite,rather,reflexed,reticulate,ruit,scar,shaped,size,slender,slightly,sometimes,soon,spaced,stigma,tall,tapering,tear-drop,thick,tip,trichome,tube,two,ud,uniseriate,unit,upper,wall,way,widest,woody,x,ympodial,young	0.1,2-3,abaxial,adaxial,arrangement,branching,characteristic,colour,diameter,form,growth,height,history,length,life,margin,midvein,na,peduncle,primary,pseudostipule,rachi,shape,staman,tertiary,texture,unarmed,venation
423	wfo-0001030884	success	218	97	75	143	22	0.344	0.4-3,0.5-1.2,0.8-1,1-1.5,1.5-2,1.5-2.5,2-5,4-5,4.5-5,5-6,5.5-7,9-11,abaxial,abruptly,acute,adaxial,anther,apex,base,berry,brown,calyx,cm,conical,dark,decurrent,densely,diameter,elliptic,filament,glabrous,gray-tinged,green,greenish,growth,inflorescence,lateral,leaf,length,lobe,lobed,long-triangular,margin,mature,mm,moderately,occasionally,ovary,ovoid-reniform,pair,pale,pedicel,peduncle,petiole,plant,prickly,primary,pubescent,red,reddish,shallowly,shrub,simple,slender,sparsely,spherical,spreading,stem,style,surface,tannish,unarmed,vein,white,winged	.2,.5,.7,0.3,0.3-0.5,0.5,0.9-5,1,1-1.2,1-3,1.5,10,100,2,4-13,5,5-30,5-merous,6-10,6-25,6-8,7-8,>,abaxially,adaxiall,along,also,alyx,andromonoeciou,anthesi,apar,arme,articulated,bark,basal,blade,broad-based,c.,capitate,connivent,curved,di-,differing,directed,discolorous,distal,eaf,eed,equal,extend,extending,flower,flowering,free,fruiting,geminate,glandular,gree,half,herbaceous,heterostylous,infructescence,leafy,like,long,long-stalked,long-styled,lower,magnification,midpoint,midrib,minute,minutely,mixture,new,nflorescence,node,older,one,onto,open,orolla,oung,outlin,papillat,per,pore,poricidal,porrect,portion,present,prickle,principal,ray,reflexe,reflexed,regularly,rest,ruit,sagittate,scar,scattered,sessile,shap,short,short-stalked,short-styled,similar,size,spaced,stellate,stellate-pubescent,stiff,stigma,still,strongly,tall,tamen,tapering,time,tip,treelet,trichome,trifoliate,tube,unicellular,uniformly,uniseriate,unit,upward,usually,vary,varying,visible,way,weakly,wide,wing,without,woody,yellow,ympodial,young	armed,arrangement,branching,characteristic,colour,corolla,form,fruit,height,history,life,midvein,na,perennial,pseudostipule,rachi,seed,shape,staman,tertiary,texture,venation
424	wfo-0001030899	success	146	103	70	76	33	0.479	.5-2,0.3-0.5,0.5-1,1,1-2,1-6,10-20,2,2-3,2-3.5,3-12,3-4,3-5,3.5-4,4-5,5-10,5-6.5,acuminate,acute,apex,articulated,basal,base,bronze,calyx,cm,cordate,coriaceous,deeply,densely,diameter,ellipsoidal,end,entire,flattened,flower,fruit,glabrous,glandular-puberulent,green,inside,leaving,less,lobe,long,margin,mm,mucronate,outside,ovate,pedicel,pedicellar,peduncle,perfect,petiole,puberulent,pubescent,purple,rachi,remnant,shrub,simple,splotch,stripe,style,triangular,unbranched,vein,x,yellow	-45,0.5,1-1.5,1-3,1.5-2,10-13,2.5-3.5,20-25,3-foliate,6.5-31,7-27,8-11,?,abaxially,absent,adaxially,aggregate,apart,ape,axe,beyond,blade,cell,chartaceous,connective,connivent,desc,dilated,directed,distally,eaf,eed,ex,exceeding,exserted,extrorse,globose,light,lon,lower,narrowly,nflorescence,nther,obconical,oblong,obtuse,orang,orolla,ovoid,peltifor,pore,presen,puberulen,radiu,ruit,shorter,slightly,spaced,stamen,stellate,stigma,stone,strongly,tal,tem,thecae,time,tomento,tube,ud,unit,upward,vary,white,wide,ympodial	abaxial,adaxial,anther,arrangement,branching,characteristic,colour,corolla,filament,form,growth,height,history,inflorescence,leaf,length,life,midvein,na,ovary,perennial,plant,primary,pseudostipule,seed,shape,staman,stem,surface,tertiary,texture,unarmed,venation
425	wfo-0001030902	success	159	111	76	83	35	0.478	-2,0-15,0.6-1.5,1-2,1-6,1.5-13,1.5-2.5,10-15,2,2-3,2-5,2.5,2.5-4,3-20,3.5-4,4,4-7,5-7,5-9,acuminate,acute,angled,apex,apiculate,articulated,basal,base,branched,brown-pilose,calyx,cm,cordate,dark,deltate,densely,diameter,eglandular,ellipsoidal,entire,flattened,fleshy,forked,fruit,glabrescent,glabrous,globose,hair,leaving,lobe,long,margin,mature,mm,obtuse,occasionally,orange,ovate,pedicel,pedicellar,peduncle,petiole,purple,rachi,rarely,reddish,remnant,simple,sparsely,style,tip,tree,truncate,unbranched,vein,x,yellow	-20,-5,1.5-,1.5-2,15-50,3-13,3-4,30-50,4-22,4-6,4-foliat,6-24,8-14,abaxially,absent,adaxially,aggregate,along,apart,ape,apically,axe,beyond,blade,brow,cell,connective,connivent,cylindrical,dilated,directed,distally,eaf,eed,equalling,exceeding,except,exserted,flower,glabrat,glandular,glandular-puberulen,laterally,lon,lower,narrowly,nflorescence,nther,oblong,orolla,perfect,pinkish,pore,presen,present,puberulence,purplish,radiu,ruit,shorter,slightly,small,somewhat,spaced,sparse,stamen,stellate,stigma,stone,subcapitat,subcoriaceous,tal,tem,thecae,time,tomento,triangular,tube,ud,unit,vary,wide,ympodial	abaxial,adaxial,anther,arrangement,branching,characteristic,colour,corolla,filament,form,glabrate,glandular-puberulent,green,growth,height,history,inflorescence,leaf,length,life,midvein,na,ovary,plant,primary,pseudostipule,seed,shape,staman,stem,surface,tertiary,texture,unarmed,venation
426	wfo-0001030914	success	186	111	80	106	31	0.43	0-0.25,0.5-1,0.7-1,1-1.5,1-2,1.2-1.5,1.5-3,2-10,2-2.5,2.5-3,3-4,7-10,7-8,acute,anther,apex,attenuate,base,beneath,berry,calyx,cm,constriction,corolla,dark,decurrent,deflexed,deltoid,densely,elliptic,filament,furcate,glabrate,glabrous,globose,golden,green,inflorescence,leaf,lemon-yellow,length,lobe,long-styled,many,margin,minutely,mm,obovate,ovary,ovoid-reniform,pair,pale,pedicel,petiole,pitted,plant,puberulent,pubescent,reddish-brown,ripe,shape,short-styled,shrub,simple,small,stem,straight,style,surface,tan,tapering,time,tree,trichome,tube,uniseriate,vein,white,winged,x	.1,.5,/4,0.1-0.5,0.8-1,0.8-1.3,1.5-2,1.5-8,2.5-11,3.5-17,5-17,5-25-flowered,9-35,along,anthesi,bark,blade,bud,campanulate,capitate,closely,dia,differing,difoliate,distal,dry,eaf,edicel,eed,ellipsoid,equal,erect,even,evenly,exserted,flower,free,fruiting,geminat,greyish-brow,individual,later,lateral,like,live,lobed,lon,long,lower,main,major,middle,minor,narowly,nflorescence,occasionally,often,older,one,onto,opposite,otherwise,overlappin,papillo,papillose,planar,pore,poricidal,portion,prominent,quite,raised,rest,rounded,ruit,scar,shaped,size,slender,slightly,sometimes,soon,spaced,sparsely,specimen,stigma,tall,tear-drop,thick,third,ti,tip,trunk,tub,ud,unit,usually,variable,way,weight,widest,within,woody,yellow,ympodial,young	abaxial,adaxial,alternate,arrangement,branching,characteristic,colour,diameter,form,fruit,greyish,growth,hair,height,hirsute,history,life,midvein,na,peduncle,perennial,primary,pseudostipule,rachi,seed,staman,tertiary,texture,unarmed,unripe,venation
427	wfo-0001030918	success	230	116	93	137	23	0.404	-3.2,-40,-5,0-25,0.3-1.5,0.6-2.5,0.7-1.7,1,1-1.5,1.5-2.5,1/3,2-25,2.8-3,3-4,3.5-6,5-8,5.5-7,abaxial,acute,adaxial,anther,apex,apically,articulated,base,berry,calyx,cell,chartaceous,cm,cuneate,curved,dark,densely,diameter,dull,elliptic,erect,faint,filament,fruit,glabrous,green-brown,lateral,leaf,length,lobe,lobed,lower,margin,mauve,midvein,mm,moderately,narrow-deltate,obtuse,orange,orange-brown,outline,pair,pale,pedicel,peduncle,per,petiole,pit,prickly,primary,purple,raised,red,red-brown,scandent,seed,shrub,simple,slender,small,smooth,sparsely,spherical,stellate-pubescent,stem,style,surface,terminal,tertiary,upper,vein,venation,visible,weakly,yellow	-12,-2.3,-4,-4.5,-6,-9,.5,.7,0-10,0-20,0-4,0-6,0.1,0.1-0.25,0.2-0.4,0.25-0.45,0.5-0.7,0.5-2,0.5-2.5,0.6,0.7-1.2,1-1.8,1-2,1-4,1.5-2,1.5-5.5,1/2-2/3,1/2-3/4,1/3-,1/3-1/2,1/4-1/3,2-10,2-2.5,2-3,2-4,2-7,2-8,2/,3-15,3-6.5,3-7,4-7,5-7,5-merous,6-8,7-10,abaxially,acicular,alyx,ame,apar,apart,apparently,bark,blade,branched,brow,c.,caudat,connivent,deltate,difoliate,discolorous,distance,drying,eaf,elongated,elongating,equal,evenly,extending,flattened,flattened-reniform,flower,free,fruiting,geminat,glabrescent,green,infructescence,lobing,long,longer,mature,maturity,midpoint,mixture,nflorescence,oblong,occasionally,older,one,open,orolla,oung,pendulous,perfec,pericarp,perpendicular,poricidal,porrect,portion,prickl,prickle,pubescent,ray,reduced,reflexed,ruit,scar,secondary,sessile,side,sometimes,somewhat,spaced,spreading,stalk,stalked,stellate,straight,strongly,tamen,tapering,terete,time,tip,trichome,tube,unit,usually,vary,way,wide,woody,ympodial,young	2/3,arrangement,branching,caudate,characteristic,colour,corolla,form,growth,height,history,inflorescence,life,na,ovary,perennial,plant,pseudostipule,rachi,shape,staman,texture,unarmed
428	wfo-0001030943	success	167	124	98	69	26	0.587	.5,0,0.5-1,0.5-3,1-1.2,1-1.5,1.1,1.8-2.2,10-25,12-15,2-6,3,4-4.5,4-5,4-6,7-8,8-10,abaxial,abaxially,acuminate,acute,adaxial,adaxially,anther,anthesi,apex,apical,basal,base,becoming,berry,black,branch,branching,calyx,cm,corolla,decurrent,deflexed,dendritic,densely,diameter,drying,echinoid,elliptic,fide,filament,flattened,flower,glabrous,globose,golden,golden-yellow,growth,horizontal,im,large,lateral,leaf,lenticular,lobe,long,minutely,mm,narrowly,outline,ovary,overtopping,pair,pearce,pedicel,per,pericarp,petiole,pitted,pubescent,purplish-black,reddish-brown,scattered,secondary,shoot,shrub,small,sparsely,stem,style,surface,tapering,terminal,thin,time,tree,tree-like,triangular,trichome,vein,violet,x	1.5-2,1/2,3-4,3/4,7-13.5,absent,age,along,bark,belo,bi-lobed,conical,cupulate,dark,denser,eaf,edicel,eed,elongate,erect,ew,exserted,free,fruiting,glabrat,inserted,lobed,lon,lower,m.,main,minute,monochasia,nflorescence,nodding,often,older,pale,papillo,planar,plurifoliate,pore,poricidal,portion,raised,ruit,scar,showy,sleeve,slightly,slit-like,somewhat,stamen,stigma,strongly,tall,tip,tub,tube,ud,unit,upper,way,wide,woody,yellow,yellowish-white,ympodial,young	arrangement,characteristic,colour,form,fruit,height,history,inflorescence,length,life,margin,midvein,monochasial,na,peduncle,plant,primary,pseudostipule,rachi,seed,shape,staman,tertiary,texture,unarmed,venation
429	wfo-0001030959	success	164	94	69	95	25	0.421	.8,0.5-1.5,0.7-1.2,1.2-1.8,1.5-3.5,10-15,2.5-5,5-6,6-8,almost,anther,apex,apically,armed,articulated,base,branched,brown,brown-green,cm,color,cuneate,deltate,densely,diameter,elliptic,erect,filament,fresh,glabrescent,glabrous,glandular,hair,inflorescence,known,lateral,leaf,length,lobe,long-acuminate,margin,membranous,minute,mm,pair,pedicel,peduncle,petiole,prickle,prickly,primary,scrambling,several,shrub,simple,stem,straw,style,subentire,surface,terete,tertiary,toward,unarmed,usually,vein,venation,visible,yellow	.05,.2,/5,0.5,1-10,1-2,1-7,1.5-2,1/5-1/10,2-4,2.5-4,2.5-4.5,4-6,4-8,5-9,5-merous,9-12,abaxially,alyx,ame,apar,apart,apparently,bark,blade,c.,concolorous,connivent,curved,difoliate,distributed,drying,eaf,eed,equal,evenly,flower,free,geminat,gently,glabrou,green-brow,know,less,like,lobed,long,long-acuminat,longer,lower,midpoint,narrow-deltate,nflorescence,numerous,older,one,open,orolla,oung,part,perfec,perpendicular,poricidal,porrect,portion,present,prickl,prominent,ray,ruit,scar,secondary,sessile,short,side,slender,spaced,sparsely,spreading,stellate,stellate-pubescent,straight,tamen,tapering,time,tip,trichome,tube,unit,vary,way,whole,wide,ympodial,youngest	abaxial,adaxial,arrangement,branching,calyx,characteristic,colour,corolla,form,fruit,growth,height,history,life,midvein,na,ovary,perennial,plant,pseudostipule,rachi,seed,shape,staman,texture
430	wfo-0001030982	success	215	103	82	133	21	0.381	-2-2.5,.1,0.05-0.5,0.1-0.15,0.2-3,0.5-1,1,1-1.5,1.5,1.5-2,1.5-3,4-12,4-5,6-8,acuminate,acute,anther,apex,base,berry,broadly,brown,brownish,calyx,cm,conical,corolla,cuneate,dark,deltate,diameter,dry,drying,elliptic,entire,filament,flattened-reniform,form,fresh,fruit,glabrous,globose,green,growth,leaf,lobe,margin,material,maturity,midvein,minutely,mm,ovary,ovate,pair,pale,papillose,pedicel,peduncle,petiole,pitted,plant,primary,pubescent,reddish,reflexed,rhizomatous,seed,simple,sinuate,slightly,sparsely,stem,strongly,style,subshrub,surface,vein,weakly,white,x,yellowish	.2,.5,0.05,0.1,0.3-2,0.5,0.5-0.9,0.5-3,1-8,2/3,3-21,3-8,abaxially,adaxially,age,angular,anisophyllous,anthesi,ape,appressed,ba,beneath,bud,caducous,capitate,central,channelled,chartaceous,ciliate,closely,conic,cream,cucullate,curved,deflexed,differing,difoliate,distall,distally,distichou,eaf,edicel,eed,ellipsoid,enlarged,exerted,extension,external,fleshy,flower,foliage,free,fruiting,geminate,glabrescent,glandular,glandular-papillose,golden-green,greenish,hilum,impressed,inconspicuously,internal,isostylous,larger,later,lengthening,less,like,live,lobed,long,lower,major,materia,minor,mostly,near,new,nflorescence,oblique,obovate,occasionally,often,olive,one,opposite,overlappin,packed,papillae,papillat,papillate,planar,pore,poricidal,portion,projection,prominent,prominently,puberulent,rest,revolute,ruit,sagittate,scar,separated,shoot,sigmoidally,situated,size,slit,somewhat,stamen,stigma,straight,stripe,testa,tetramerous,tightly,time,tip,transverse,trichome,tub,tube,ud,uniseriate,unit,vegetative,veined,way,ympodial,young	abaxial,adaxial,arrangement,branching,characteristic,colour,distichous,height,history,inflorescence,length,life,na,pseudostipule,rachi,shape,staman,tertiary,texture,unarmed,venation
431	wfo-0001030989	success	177	120	90	87	30	0.508	.5,0.5-1,1-1.5,1-2,12-15,3-20,3-4,3-7.5,4-5,5,6-6.5,9-10,abaxially,acuminate,adaxially,anther,apex,apparently,articulated,axe,axillary,base,berry,brownish,bud,cell,chartaceous,cm,condition,conical,corolla,covering,densely,diameter,distal,drying,filament,flower,forked,fresh,fruit,generally,glabrous,green,green-white,greenish,hair,hair-like,half,herb,lateral,leaf,light,like,lobe,long,make,margin,minute,mm,mucilaginous,obtuse,odd-pinnate,ovate-lanceolate,ovoid,pedicel,peduncle,perfect,petiole,plant,proximal,pubescent,ripe,seed,sparsely,stem,style,subtending,terminal,testal,thick,throughout,triangular,unwinged,usually,violet,wall,wet,whitish,wide	1-10,15-27.5,2-3.5,3-5.5,4-7,4-8,5-merou,5.5-7.9,6-13,ag,alyx,apart,blade,capitat,ciliate,connivent,decreasing,digestion,dorsally,eaf,edge,eed,end,enzyme,erec,especially,flat,folded,geminat,glabrou,gradually,homostylous,honeycomb-shaped,interjected,lanceolate,larger,leaflet,lengthening,living,lower,nflorescence,occurring,orbicular,orolla,ovate,pair,pale,petiolule,plurifoliate,pore,poricidal,present,pubescen,ray,removed,rotate,ruit,secondary,semierect,seudostipule,singly,size,slit,spaced,specimen,ste,stigma,stolo,subequal,subsessile,symmetrical,tall,tamen,tem,thir,tip,toward,tri-,tube,tuber,typically,unit,vary,wider,x,yellow,ympodial	abaxial,adaxial,arrangement,branching,calyx,capitate,characteristic,colour,form,growth,height,history,inflorescence,length,life,midvein,na,ovary,primary,pseudostipule,rachi,shape,staman,surface,tertiary,texture,third,unarmed,vein,venation
432	wfo-0001030991	success	204	120	94	110	26	0.461	.5,0,0.5-1,0.5-1.5,0.7-1.2,1-1.5,1-1.6,1-2.2,1.5,10-20,2.5-3,2/3,3-,3-5-lobed,5-5.5,9-11,absent,acuminate,acute,along,anther,anthesi,apex,apparently,appressed,ascending,attenuate,basal,base,berry,brown,calyx,cm,corolla,diameter,elliptic,entire,filament,filiform,flattened,glabrous,globose,grey,growth,herb,inflorescence,lanceolate,lateral,leaf,leaf-opposed,like,lobe,long-triangular,margin,minutely,mm,narrowly,nodding,occasionally,pair,pedicel,peduncle,per,petiole,pinnatifid,pitted,primary,pubescent,red,reniform,rest,ripe,scattered,short,shrub,simple,small,sparsely,stem,style,suffrutescent,surface,terminal,trichome,uniformly,uniseriate,variably,vein,violet,weak,white,winged,x,yellowish	0.1,0.2,0.2-0.7,0.3-0.4,0.5,0.5-0.7,0.5-3.5,0.6-0.8,1-2.5,1-7,2-plurifoliat,2.5-10,4-10,5-merou,<,abaxially,adaxiall,adaxially,ag,alyx,angled,arising,ark,articulated,bulbous,capitate,cell,color,conical,connivent,densely,different,distally,drying,eaf,eed,ellipsoid,ellipsoidal,elongate,enlarged,exerted,eye,flower,free,frui,fruiting,furcate,fusiform,glabrescen,ilament,incised,leave,lengthening,less,lobed,loosely,lower,midrib,minute,nearly,new,nflorescence,often,older,orolla,outline,packed,papillo,part,particularly,pendant,perfect,pericarp,platfor,pointing,pore,poricidal,portion,pseudoumbel,rectangular,reflexed,rootstoc,ruit,scar,shallowly,shiny,sleeve,slightly,slit,somewhat,spreading,stellate,stigma,strongly,tangled,tem,testal,thin,tightly,tip,tube,twinin,ud,unit,upper,vary,weight,woody,ympodial,young	abaxial,adaxial,arrangement,branching,characteristic,colour,form,fruit,glabrescent,height,history,length,life,midvein,na,ovary,plant,pseudostipule,rachi,seed,shape,staman,tertiary,texture,unarmed,venation
433	wfo-0001031005	success	231	131	114	117	17	0.494	.5,/3-1/2,0.8,0.9,1-1.5,1-2,1-2.5,1-3,2-3.2,2.5,3-10,3-4,3-6.5,4-6,5-7,abaxial,abaxially,acuminate,acute,adaxially,almost,along,anther,anthesi,apex,apically,attenuate,base,berry,black,blue,brachyblast,branch,branched,branching,brown,calyx,chartaceous,clustered,cm,conical,corolla,curved,deltoid,dendritic,denser,diameter,dilated,drying,elliptic,elongated,entire,evenly,filament,fine,flat,flower,form,fruit,glabrous,greenish,known,lateral,leaf,length,liana,like,lobe,long,margin,membranous,midvein,mm,network,obovate,occasional,occasionally,older,orange-brown,ovoid,pair,pedicel,peduncle,petiole,primary,prominent,pubescent,purple,rachi,raised,ridged,seed,short,side,slender,sometimes,somewhat,sparsely,stem,style,surface,terminal,tertiary,thick-chartaceous,tip,toward,trichome,unarmed,usually,vein,venation,visible,white,x	.4,0-0.5,0.1,0.3-0.5,0.5-1.5,1,1.5-2.5,1.5-4,10,2.3-3,2.5-4,5,5-8,5Â°,6-12,accrescent,age,alyx,apar,apparently,articulated,bark,capitate,clearly,clum,common,concolorous,cupular,dark,datum,deeply,delineated,dendritic-pubescent,density,detaching,developing,discolorous,divided,domatia,eaf,ellipsoi,equal,extending,eye,fertilisation,flattened,flexuous,forming,free,fruiting,immature,increasing,inside,junction,leave,lengthening,linear,lobed,longitudinally,loop,lower,m.,main,minute,much,naked,nflorescence,nther,oblong,obscure,often,onl,orolla,ou,outside,ovate,pendulous,perfec,pericarp,plurifoliat,pointed,pore,poricidal,portion,protruding,ray,region,rest,ruit,scar,secondary,simple,smaller,smoot,smooth,soon,spread,spreading,standing,stigma,strongly,stump,surrounding,tangling,tearing,terete,thin,tube,ud,uneven,unit,vary,weakly,well-developed,wide,ympodial,young	adaxial,arrangement,characteristic,colour,growth,height,history,inflorescence,life,na,ovary,perennial,plant,shape,staman,texture,ye
434	wfo-0001031007	success	207	142	118	89	24	0.57	.5,0.5,0.5-1,0.75-1.5,1,1-1.2,1-1.5,1-3.5,1.2-1.5,1.5-2,1.9-3,11-14,15,3-4,4-6,4.5-5,5.5-6,50-100,6,7-10,acute,along,anther,anthesi,apex,articulated,base,beginning,berry,black,branched,branching,broad,broadly,brown,calyx,cell,cm,corolla,cuneate,dark,deltate,dendritic,diameter,drying,dull,elliptic,entire,extending,filament,flattened-reniform,flower,fruit,glabrous,globose,growth,herbarium,inflorescence,irregularly,lamina,lax,leaving,lilac,lobe,long,loose,lower,many,margin,matte,midvein,minutely,mm,narrowly,near,occasionally,often,outline,pedicel,peduncle,peg,per,pericarp,petiole,pitted,primary,prominent,pubescent,reddish,revolute,round-rectangular,shiny,shrub,simple,sleeve,slender,sparsely,specimen,splitting,spreading,stem,stout,style,surface,tangled,terminal,testal,thin,time,tiny,tip,trichome,twining,usually,vein,vine,woody,x	0.2,0.5-10,1.3-,1.6-2,1/3,2.5-,2.5-5,4-7,5,5-12,5-merou,8-10,<,abaxiall,abruptly,ag,alfway,almost,alyx,apar,apparently,ark,becoming,bifid,c.,campanulate,capitate,chartaceous,clustered,completely,connivent,cup-shaped,densely,dilated,eaf,eed,ellipsoid,exserted,fleshy,free,fruiting,geminat,glabrescen,glabrou,ilament,impressed,intramarginal,junction,lengthening,lobed,looping,loosely,m.,markedly,multi-celled,narrowing,new,nflorescence,nodding,older,orolla,pale,papillat,papillate,perfect,planar,plurifoliate,pore,poricidal,portion,rat,ruit,sagittate,scar,slightly,slit,spaced,stellate,stellate-pentagonal,stigma,strongly,tube,ud,unit,upper,vary,way,yellow,ympodial	abaxial,adaxial,arrangement,characteristic,colour,form,height,history,leaf,length,life,na,ovary,perennial,plant,pseudostipule,rachi,seed,shape,staman,tertiary,texture,unarmed,venation
435	wfo-0001031007	success	206	150	120	86	30	0.583	.5,0.5,0.5-1,0.75-1.5,1,1-1.2,1-1.5,1-3.5,1.2-1.5,1.5-2,1.9-3,11-14,15,3-4,4-6,4.5-5,5.5-6,50-100,6,7-10,acute,adaxial,along,anther,anthesi,apex,articulated,base,beginning,berry,black,branched,branching,broad,broadly,brown,calyx,cell,cm,corolla,cuneate,dark,deltate,dendritic,diameter,drying,dull,elliptic,entire,extending,filament,flattened,flower,fruit,glabrous,globose,growth,herbarium,inflorescence,irregularly,lamina,lax,leaving,lilac,lobe,long,loose,lower,many,margin,matte,midvein,minutely,mm,narrowly,near,occasionally,often,outline,pedicel,peduncle,peg,per,pericarp,petiole,pitted,primary,prominent,pubescent,reddish,reniform,revolute,round-rectangular,shiny,shrub,simple,sleeve,slender,sparsely,specimen,splitting,spreading,stem,stout,style,surface,tall,tangled,terminal,testal,thin,time,tiny,tip,trichome,usually,vein,vine,wide,woody	0.2,0.5-10,1.3-,1.6-2,1/3,2.5-,2.5-5,4-7,5,5-12,5-merou,8-10,<,abaxially,abruptly,ag,alfway,almost,alyx,apar,apparently,bark,becoming,bifid,c.,campanulate,capitate,chartaceous,clustered,completely,cup-shaped,densely,dilated,eaf,eed,ellipsoid,exserted,fleshy,free,fruiting,glabrescen,glabrou,ilament,impressed,intramarginal,junction,lengthening,lobed,looping,m.,markedly,multi-celled,narrowing,new,nflorescence,nodding,older,orolla,pale,papillat,papillate,perfect,planar,plurifoliat,pore,poricidal,portion,rat,ruit,sagittate,scar,slightly,slit,spaced,stellate,stellate-rotate,stigma,strongly,tube,twinin,ud,unit,upper,vary,way,ympodial	abaxial,arrangement,characteristic,colour,form,glabrescent,green,greyish,hair,height,hirsute,history,leaf,length,life,na,ovary,perennial,plant,pseudostipule,rachi,seed,shape,staman,tertiary,texture,twining,unarmed,venation,white
436	wfo-0001031036	success	150	101	72	78	29	0.48	.2,.25,.5,0.5-1,0.8-1,0.8-1.2,1-1.3,1-2.5,1.2-1.5,1.5-3,10-20-flowered,2-2.5,3-4,5-6,7-8,acuminate,acute,anther,apex,base,berry,broadly,brown,calyx,cm,corolla,crisped,dark,decurrent,dia,dry,elliptic,enlarged,erect,filament,filiform,flattened-reniform,fleshy,fresh,glabrous,globose,green,greenish-white,knob-like,leaf,lobe,long,margin,material,minutely,mm,oblique,ovary,pair,pedicel,perhaps,petiole,pitted,shiny,shrub,simple,slightly,spathulate,stem,style,surface,tapering,thickened,tube,vein,winged,x	12-15,2.2-3.7,3-5,3.5-5.5,4.5-6.5,abaxially,adaxially,along,angle,anthesi,arising,axil,ba,becoming,bi-lobed,closely,conical,deflexed,differing,difoliate,drying,eaf,edicel,eed,ellipsoid,exserted,free,fruiting,geminat,lamina,lateral,lobed,lon,lower,main,major,middle,minor,nearly,nflorescence,older,onto,opposite,overlappin,papillo,papillose,planar,pointed,pore,poricidal,portion,rounded,ruit,sagittate,scar,shaped,short,sinus,size,soon,spaced,stigma,strongly,tall,tear-drop,tip,trichome,tub,ud,uniseriate,unit,usually,white,widest,woody,yellowish,ympodial,young	abaxial,adaxial,arrangement,branching,characteristic,colour,diameter,form,fruit,growth,height,history,inflorescence,length,life,midvein,na,peduncle,plant,primary,pseudostipule,rachi,seed,shape,staman,tertiary,texture,unarmed,venation
437	wfo-0001031064	success	179	122	94	85	28	0.525	.0-2.5,.5,.5-1,0.5,0.5-0.7,0.5-0.8,1-1.2,1-2,1-3,1.2,1.5-2,10-12,2.5-3,3,3.5-4,5-6,abaxially,acuminate,anther,anticlinal,apex,arising,attenuate,axil,base,bearing,berry,bright,broader,calyx,cm,completely,conical,corolla,deltate,densely,diameter,distal,elongate,filament,fleshy,flower,fruit,fruiting,glabrous,green,half,highly,inflorescence,irregular,lateral,leaf,leaflet,like,lobe,lost,lower,margin,minutely,mm,nodding,obovate,occasionally,ovary,ovoid-reniform,pedicel,petiole,petiolule,pinnate,projection,pubescent,purple,rachi,scattered,short-pubescent,shrub,simple,single,sinuous,somewhat,sparsely,stem,style,surface,terminal,thickening,translucent,trichome,uniseriate,vein,white,winged,without,x	.05,0,0-15,1,1.7-4.2,10-12.5,10-17,2,3-5.5,3-7,4-5-celled,5-10.5,6-16,7-16,8-10-celled,acroscopic,adaxially,along,anthesi,basal,blade,cell,clavat,commentary,conspicuous,dark,denser,dr.,eaf,edicel,eed,epidermal,erec,exserted,free,globose,irregularly,lamina,leave,lenticel,lightly,lobed,lon,long,minute,narrower,near,nearly,nflorescence,node,often,open,ovate,pair,papillate,per,planar,poricidal,portion,prominent,pubescen,rugose,ruit,scar,see,side,sinus,slender,smaller,splitting,stigma,strongly,swollen,tal,tem,time,tip,tub,tube,ud,unifoliat,unit,usually,wand-like,ympodial	abaxial,adaxial,arrangement,branching,characteristic,colour,erect,form,growth,height,history,length,life,midvein,na,peduncle,perennial,plant,primary,pseudostipule,seed,shape,staman,tertiary,texture,unarmed,venation,ye
438	wfo-0001031071	success	186	95	73	113	22	0.392	0.2-0.8,1-1.5,1-2,2-8,2.1-3,2.4-3.4,3-10,3-6,4-25,4-6,6-8,7-8,8-28,anther,axillary,berry,blue,brownish,bud,cm,color,condition,coriaceous,corolla,dark,deep,diameter,distal,drying,elliptic,filament,flower,forked,fresh,fruit,generally,glabrous,globose,green,green-white,greenish,half,herb,lanceolate,leaf,lilac,lobe,long,medium,mm,mottled,mucilaginous,narrowly,odd-pinnate,ovate,ovoid,pedicel,peduncle,plant,purple,ripe,seed,spot,star,style,subtending,terminal,throughout,usually,wet,white,whitish,winged	0-10,0.4-2,1-3,1-7,1.5-2.2,2-3,2-5,3-5,3.8-5.4,5-9.4,5-merou,5.7-8.8,7-16.5,abaxiall,abaxially,acumen,acute,adaxially,ag,along,alyx,apart,apex,apparently,arranged,articulated,asymmetric,attenuate,axe,base,basiscopic,bead,blade,capitat,cell,clavate,connivent,covering,decreasing,digestion,dorsally,eaf,edge,eed,enzyme,erec,exceeding,flat,folded,geminat,glabrou,hair-like,homostylous,honeycomb-shaped,interjected,lateral,leaflet,lengthening,like,living,lower,make,middl,moniliform,multiple,necklace,nflorescence,orbicular,orolla,pair,pentagonal,perfect,petiole,petiolulate,plurifoliate,pore,poricidal,removed,rotate,round,ruit,sessile,seudostipule,short,side,size,slightly,slit,spaced,specimen,stamen,stigma,stolon,straight,subequal,tall,tamen,tem,testal,thick,tip,tissue,toward,tri-,tube,tuber,typically,unit,vary,wall,x,yellow,ympodial	2,abaxial,adaxial,arrangement,calyx,characteristic,colour,form,growth,height,history,inflorescence,length,life,ovary,perennial,pseudostipule,shape,staman,stem,surface,texture
439	wfo-0001031097	success	174	93	72	102	21	0.414	0.45,1-4,1-4.5,1.6-5.5,1.8-2.5,13-30,2-3.3,2-4,3-5,3.7-8.4,4-6,5-12,8-11,abaxially,adaxially,branched,calyx,cell,cm,corolla,covering,cyme,darker,deep,diameter,dichasial,dichasially,dotted,ebracteate,elliptical,filament,green,green-white,hair-like,herbaceous,lateral,leaf,leaflet,light,lighter,long,medium,mm,monochasial,mottled,mucilaginous,obovate,odd-pinnate,ovate,ovoid,pair,pedicel,peduncle,perennial,petiole,plant,puberulent,pubescent,purple,seed,straight,strigose,style,terminal,testal,thick,throughout,tuber-bearing,violet,violet-blue,wall,wide	0.5,1,1-3,1.5,1.8-2.6,2-3,3-6-foliat,3.5-6,4-7,5-11,5-9,9-21,abaxial,acumen,acuminate,acute,along,apex,apical,apically,articulate,base,connate,cuneate,decurrent,dehiscent,digestion,diminishing,distal,dorsally,eaf,edge,eed,emoval,enzyme,exceeding,flat,flower,folded,forked,frequently,generally,globo,gree,half,highly,honeycomb,interjected,interpetalar,introrse,living,lobe,lon,lower,lunat,make,margin,maturing,narrow,nflorescence,noticeably,nther,oblique,often,orolla,pattern,pentagonal,perfect,petal,petiolulate,petiolule,plan,poricidally,proximal,rachi,rapidly,rarely,reveal,rotate,ruit,sessile,seudostipule,short,side,size,slit,sometimes,specimen,stamen,stigma,tal,tem,tissu,toward,typically,unit,vary,vbase,without,yellow,ympodial,Â¼	anther,arrangement,characteristic,colour,form,fruit,growth,height,history,inflorescence,length,life,na,ovary,shape,staman,stem,surface,texture,wet,width
440	wfo-0001031101	success	197	129	105	92	24	0.533	-20,-5,-8,0.5-0.8,0.5-3,0.8-,1-2,1-2.3,1.3-2,1.4-1.7,1/4-1/2,2-2.8,2-4,2-6,2.5-3.8,3-15,3-8,3.5-4.5,5-6,abaxial,acuminate,adaxial,almost,anther,apex,apical,apically,apparently,articulated,base,berry,branched,bright,calyx,cm,concolorous,diameter,drying,dull,entire,erect,evenly,filament,filiform,flattened-reniform,glabrescent,glabrous,glandular,green,green-brown,hair,lateral,leaf,length,lobe,long,long-acute,margin,maturity,mauve,membranous,minute,mm,moderately,narrow-deltate,near,obtuse,often,orange-brown,orange-red,ovate,pair,pale,pedicel,peduncle,per,petiole,primary,red,resembling,rounded,scandent,shrub,simple,sparsely,spherical,stellate-pubescent,stem,straight,style,surface,terete,terminal,tertiary,trichome,umbel,unarmed,vein,venation,visible,white,wide,yellow,yellow-green,young	-1,-16,-30,/2,/2-equal,0.05-0.2,0.1-0.2,0.1-0.3,0.3-0.5,0.6-0.8,0.7-0.8,1-,1-3,1.3-2.5,1.5-3,1/3-1/2,10-30,2-5,2.5-,2.5-3.5,3-10,4-10,4-5-merous,4-7,4.5-9,5-20,6-10,8-15,abaxially,alyx,ame,apar,ba,bark,blade,c.,connivent,deltate,difoliate,eaf,eed,elongating,equal,flower,free,frui,fruiting,geminat,herbaceous,infructescence,lobed,long-acuminat,longer,lower,mature,midpoint,multangulate,nflorescence,older,one,open,orolla,oung,pendulous,perfec,pericarp,poricidal,porrect,portion,ray,red-brow,ruit,scar,sessile,smooth,spaced,spreading,stalk,stalked,stellate,stellate-pubescen,tamen,tapering,time,tip,tube,unarme,unit,variously,vary,way,ympodial	arrangement,branching,characteristic,colour,corolla,form,fruit,growth,height,history,inflorescence,life,long-acuminate,midvein,na,ovary,plant,pseudostipule,rachi,red-brown,seed,shape,staman,texture
441	wfo-0001031114	success	208	131	103	105	28	0.495	.2,.5,0.5,0.5-1,0.7-1.5,0.8-1.2,1-10,1-2,1-7,1.5-4,10-15,2-3,2-4,2/3,25-50,3-4,4-10,4-5,4.5-6,6-7,abaxially,acuminate,acute,adaxially,anther,apex,base,becoming,berry,blade,branched,brown,calyx,chartaceous,cm,dark,deltate,densely,diameter,distal,echinoid,elliptic-ovate,entire,erect,especially,filament,first,flattened,fleshy,flower,fruit,glabrous,globose,green,hair,impressed,leaf,leaf-opposed,light,like,lobe,long,major,margin,minor,mm,nodding,obtuse,outline,ovate,pedicel,peduncle,petiole,prominent,pubescent,purple,rachi,reniform,ripe,rounded,rugulose,shrub,side,simple,small,sparsely,stellate,stellate-pubescent,stem,strongly,style,subcoriaceous,subcuneate,surface,thickened,toward,tree,truncate,vein,white,white-pubescent,x,yellowish	.1,0-0.3,0.3-0.5,1-1.5,1-4.5,1-8,1.5-2.5,2-17,2-7,2.5-3,3-10,3-5,3-7,4-8,5-10,5-8,5-merou,7-15,absen,accrescent,adaxiall,ag,alyx,apart,apparently,articulated,axe,ba,capitat,connivent,covering,cylindrical,differentiated,directed,discolorous,distally,dried,eaf,eed,equal,free,frui,fruiting,geminate,highly,homostylous,interpetalar,introrsely,juic,lacking,large,long-stalked,longitudinal,lower,membanaceous,midpoint,multangulate,nearly,nflorescence,oblong,often,one,opening,orolla,paired,part,perfect,pericarp,plurifoliate,pore,porrect,ray,ruit,sessile,short,short-,short-stalked,slightly,slit,somewhat,spaced,stalk,ste,stigma,straight,subcucullate,subtending,tall,tamen,tem,thin,time,tip,tissue,triangular,tube,unarme,unit,vary,white-stellate,whitish,wide,without,yellow,ympodial	abaxial,adaxial,arrangement,branching,characteristic,colour,corolla,form,growth,height,history,inflorescence,length,life,midvein,na,ovary,perennial,plant,primary,seed,shape,staman,tertiary,texture,true,unarmed,venation
442	wfo-0001031116	success	191	139	116	75	23	0.607	-10,.5,.8,0,0.3-0.5,0.7-1,1-5,1/2,2-5,2.7-3.2,3.5-4,30-100,30-50,4-7,5,8-11,9-13,abaxial,acuminate,adaxial,almost,anther,apex,apically,apparently,articulated,attenuate,base,berry,branching,bristle,broad-deltate,calyx,caudate,cm,collapsed,diameter,dirty-white,discolorous,drying,dull,elliptic,erect,evenly,filament,flattened-reniform,flower,fragile,fruit,glabrescent,glabrous,glaucous-green,green,infructescence,lateral,leaf,length,lobe,long,lower,margin,maturity,mauve,membranous,mm,moderately,multangulate,obovate,obtuse,one,open,orange-brown,orange-red,pair,pedicel,peduncle,per,pericarp,petiole,primary,recurved,red-brown,rounded,secondary,sessile,sharply,shortly,shrub,simple,slender,small,smooth,soft,sometimes,sparsely,spherical,stalked,stellate-pubescent,stem,straight,style,subentire,surface,tertiary,time,tree,trichome,unarmed,upper,vein,venation,visible,weakly,wide,yellow,young	.2,/4,0.05-0.15,0.1,0.4-0.7,0.7-0.9,1,1/3-2/,1/6-1/4,10-14,15-25,4-10,5-15,5-merous,abaxially,alyx,ame,apar,apart,arachnoid,bark,blade,brow,c.,clearly,connivent,densely,eaf,eed,elongated,elongating,epidermi,equal,flat,flexuous,free,fruiting,hair,less,lobed,longer,mature,midpoint,minute,narrow-deltate,nflorescence,obtu,often,older,orolla,oung,perfec,perpendicular,plurifoliat,poricidal,portion,ray,reflexed,ruit,scar,single,spaced,stalk,stellate,tamen,tapering,terete,tip,tube,unarme,unit,vary,way,woody,ympodial	1/3-2/3,arrangement,characteristic,colour,corolla,form,growth,height,history,inflorescence,life,midvein,na,ovary,perennial,plant,pseudostipule,rachi,seed,shape,staman,texture,true
443	wfo-0001031128	success	213	135	114	99	21	0.535	-10,-100,-4.5,-6.5,0,0-30,0.5-0.7,0.5-0.8,0.5-1.5,0.6-1,0.8-1.7,1-,1.5-3,1.5-3.5,2-5,2.3-,20-60,3-4,3.5-4.5,8-12,abaxial,acute,almost,anther,apex,apically,apparently,articulated,base,berry,branched,branching,bristle,calyx,cm,concolorous,cuneate,deltate,densely,diameter,drying,dull,elliptic,entire,erect,evenly,eye,filament,filiform,flattened-reniform,fruit,glabrescent,glabrous,glandular,green,hair,inflorescence,lateral,leaf,length,lobe,lobed,long,long-acuminate,lower,margin,maturity,mauve,membranous,minute,mm,moderately,naked,near,often,orange-brown,pair,pale,pedicel,peduncle,per,petiole,primary,purple-black,recurved,red,red-brown,shallowly,short-attenuate,shrub,simple,soft,spherical,stellate,stellate-pubescent,stem,straight,style,surface,terete,terminal,tertiary,trichome,unarmed,undulate,vein,venation,visible,weakly,white,wide,yellow,yellow-green,young	/4,0.05-0.2,0.05-0.25,0.2,0.2-0.4,0.3-0.8,0.5-5,1,1-1.6,1.2-2,1/,1/6-1/3,10-20,10-35,2-9.5,2.5-10,2.5-3.5,20-50,4-5-merous,4-7,5-,5-15,5-19,5-30,8-23,abaxially,alyx,apar,apart,ape,bark,blade,brown,connivent,eaf,eed,elongated,elongating,equal,flexuous,flower,free,fruiting,gland,gra,infructescence,less,lon,long-acuminat,longer,mature,midpoint,multangualte,multangulate,narrow-deltate,nflorescence,occasionally,older,one,open,orolla,oung,perfect,pericarp,perpendicular,plurifoliat,poricidal,portion,ray,reduced,reflexed,ruit,scar,secondary,sessile,short-styled,side,single,smooth,spaced,spreading,stalk,stalked,staminate,tamen,tapering,time,tip,tube,unarme,unit,usually,variously,vary,way,whitish,woody,yellow-brown,ympodial	1/3,adaxial,arrangement,characteristic,colour,corolla,form,growth,height,history,life,midvein,na,ovary,plant,pseudostipule,rachi,seed,shape,staman,texture
444	wfo-0001031135	invalid_json	189	143	107	82	36	0.566	0-2,0.7-2,1-,1-1.5,1-10,1-3,1-4,1.5-2,1.5-3,1.5-9,10-20,2,2-,2-2.5,2-3,2-3.5,2-4,3-10,3-4,3-5,4-5,5-30,5-9-pinnate,7-15,abaxially,acuminate,acute,adaxially,also,apart,apex,articulated,basal,base,basiscopically,calyx,chartaceous,cm,compound,cordate,cuneate,darker,decurrent,deflexed,deltate,densely,diameter,eglandular-pubescent,ellipsoidal,elliptic,entire,fading,flattened,flower,frequently,fruit,fusiform,glandular-,green,lateral,leaf,leaflet,leaving,light,lobe,lobed,long,longitudinal,margin,mm,moderately,oblique,often,ovate,ovoid,pedicel,pedicellar,peduncle,perfect,petiole,pilose,pink,pinnately,pinnatifid,puberulent,pubescent,purple,rachi,remnant,ripe,shrub,simple,spaced,sparsely,stripe,style,tip,tree,truncate,unbranched,unlobed,upper,white,whitish,x,yellow-green,yellowish	-7,0.5-2,1-2.5,2-23,2-5,2.5-28,3.5-12,4-foliat,5-11,absent,adpressed,aggregate,along,ape,axe,beyond,biglandula,blade,broad,campanulate,cell,color,connective,coriaceous,cylindrical,dilated,directed,distally,eaf,eed,ellipsoida,equal,especially,exceeding,exserted,glabrous,hair,interstitial,irregularly,laterally,lon,lower,midrib,narrowed,nflorescence,nther,obconical,oblong,obtuse,occasionally,orolla,papillose,peltiform,pilo,pore,present,radiu,ruit,shorter,slightly,small,smaller,stamen,stigma,stone,strongly,subcoriaceous,tal,tem,thecae,time,tomento,toward,triangular,tube,ud,unit,unknow,vary,violet,wide,ympodial	'',[,``,abaxial,adaxial,anther,arrangement,branching,characteristic,colour,corolla,filament,form,growth,height,inflorescence,length,midvein,na,ovary,plant,primary,pseudostipule,seed,shape,staman,stem,surface,tertiary,texture,unarmed,value,vein,venation,{,}
445	wfo-0001031144	success	231	129	100	131	29	0.433	.5,0.2,0.8-1.4,1-1.5,1-4,1.1-2.5,2-3,2.5-3,2/3,25,3-7,4-4.5,4-6,6,7-10,<,acuminate,acute,adaxially,anther,apex,apiculae,articulated,asymmetric,base,berry,bright,broadly,brown,calyx,cm,commonly,cordate,corolla,diameter,elliptic,entire,filament,flattened-reniform,form,glabrous,globose,groove,growth,inflorescence,later,lateral,leaf,less,lobe,lobed,long,margin,mere,minutely,mm,oblique,occasionally,pair,pale,pedicel,peduncle,petiole,pinnately,pinnatifid,pitted,primary,pubescent,red,reddish,rim,seed,shiny,simple,slightly,sparsely,stellate-rotate,stem,style,surface,tan,terete,terminal,tiny,triangular,trichome,truncate,tuft,twining,uniseriate,usually,vein,vine,violet,way,white,woody,x,yellowish,Â½	-11,-13,.2,0.5,1-,100,2,2-,2-6,2-9,3-4.5,3.5-10,4,4-20,5,5-9,5-merou,ag,alyx,anthesi,apart,apicula,appearing,ark,around,away,axi,basal,basiscopically,blac,branch,branche,brow,capitate,cell,closer,connivent,corresponding,cupped,curved,densely,divaricate,drying,eaf,eed,ellipsoid,elongate,elongating,exserted,extending,flattened,flower,four,free,fruiting,geminat,ilament,inflated,irregularly,lamina,larger,leaflet,leaving,lengthening,like,longer,longest,loosely,lower,many,markedly,membranous,minute,near,new,nflorescence,number,often,older,one,open,orolla,outline,papillo,peg,pendant,pentagonal,per,perfect,pericarp,plurifoliate,pore,poricidal,portion,progress,quite,ripe,ruit,scar,sleeve,slit,small,smaller,sometimes,spaced,spreading,stigma,strongly,tangle,tem,testal,thin,third,tip,together,tube,twinin,two,ud,unequal,unit,upper,variable,vary,wall,weight,widest,wing,wood,yellow,ympodial	60-100,abaxial,adaxial,arrangement,branching,characteristic,colour,fruit,green,greyish,hair,height,hirsute,history,length,life,midvein,na,ovary,perennial,plant,pseudostipule,rachi,shape,staman,tertiary,texture,unarmed,venation
446	wfo-0001031152	success	232	162	139	93	23	0.599	-10,.4,0-100,0.2-0.3,0.2-1.5,0.3-1.3,0.3-3,1-1.5,1-3,1-6,1.1-2.2,1.1-3,1.2-1.8,1.3-4,1.4-2.6,1/2-3/4,11,2.7-3.7,3.7-7,4-19,4-6,4-8,6.5-10,8-20,9-13,abaxially,acuminate,acute,adaxially,anther,apart,apex,articulated,attenuate,basal,base,becoming,berry,branched,brown,bullate,calyx,closely,cm,conical,continued,corolla,decurrent,deltoid,densely,diameter,directed,due,entire,exserted,filament,fleshy,flower,fruit,globose,granular-tomentose,green,greenish,growth,hair,honeycombed,lanceolate,lateral,lavender,leaf,length,lilac,lobe,long,long-,longer,margin,midvein,mixed,mm,mostly,multangulate,narrowly,nearly,oblanceolate,obtuse,openly,pale,pedicel,peduncle,persistently,petiole,pitted,porrect-stellate,probably,pubescent,rachi,rather,ray,reddish,reddish-brown,relatively,reniform,reticulate-punctate,ripe,scabrous,sessile,short-,shrub,side,simple,spaced,sparingly,sparsely,stamen,stellate-pubescent,stelliform,stem,style,suborbicular,surface,terete,terminal,testa,thick-stalked,thin,thin-,time,tomentose,toward,tree,unarmed,variously,vein,violet,x,yellow,yellowish,young	-1.5,-5.5,/100-1/16,1.5-3,1.5-3.5,1/2-2/3,13-27,2-5,2.5-7.5,2.7-4.5,2.7-6,2.8-4,4-7,5-6,accrescent,ag,along,anthesi,apical-lateral,apparently,axe,axillary,ba,blade,blister,blunt-tipped,branch,bud,capitat,chartaceous,dehiscing,eaf,earl,eed,evident,extend,few-rayed,free,fruiting,glabrescen,glabrous,high,inserted,introrse,lackin,large,less,lobed,longitudinal,lower,m.,main,moderately,multangulat,nflorescence,oblong,occasionally,one,open,orbicular,orolla,ovate,partly,perfect,plurifoliate,pore,rotate-stellate,ruit,runk,short-stalked,slightly,slit,somewhat,soon,splitting,stigma,stipitate-glandular,stout-stalked,strongly,suture,swelling,tamen,thick,thin-stalked,touching,tube,unarme,unit,usually,vary,way,wide,ympodial	abaxial,adaxial,arrangement,characteristic,colour,form,glabrescent,height,history,inflorescence,life,na,ovary,perennial,plant,primary,pseudostipule,seed,shape,staman,tertiary,texture,venation
447	wfo-0001031202	success	198	126	97	101	29	0.49	0-0.5,0-1,0.6-1.1,0.8-1,1-1.5,1.5-2.5,2-3,2-8,2.5-3.5,2.5-4,3.5-4,6-25,9-11,abrupt,acute,along,anther,apex,apiculate,base,beneath,berry,broadly,calyx,cm,complex,cordate,corolla,decurrent,deflexed,deltoid,densely,erect,filament,fleshy,flower,fruit,furcate,glabrous,globose,golden,green,inflorescence,later,lateral,leaf,lobe,long-styled,many,margin,minute,minutely,mm,narrowing,obovate,occasionally,often,opposite,ovary,overtopping,ovoid-reniform,pair,pale,pedicel,petiole,pitted,plant,puberulent,pubescent,reddish-brown,sessile,shape,shoot,short-styled,shrub,slender,slightly,small,sparsely,stem,straight,style,surface,tan,tapering,terminal,time,tip,tree,trichome,tube,uniseriate,variable,vein,white,winged,x	.1,.5,0.1-0.3,0.5,0.5-1,1-1.7,1-5,1.5-2,1.5-9,15-40,2.5-13,2/3,20-100-flowered,9-20,accrescent,anthesi,apart,axi,bark,bud,capitate,completely,condition,corky,cup-shaped,dia,differing,difoliate,distal,dry,due,eaf,edicel,eed,enclosed,exserted,extremely,free,frui,fruiting,geminat,glabrate,greenish-white,greyi,hard,irregularly,large,like,live,lobed,lon,long,long-ellipsoid,longer,lower,main,major,material,middle,minor,nflorescence,occasional,older,one,orbicular,paler,papillo,papillose,planar,pore,poricidal,portion,prominent,quite,raised,rounded,ruit,scar,scattered,shaped,size,spaced,specimen,stigma,tall,tear-drop,thick,thickened,thicker,third,tub,ud,unit,usually,way,weight,whitish,widest,woody,ympodial,young	abaxial,adaxial,arrangement,branching,characteristic,colour,diameter,form,greyish,growth,hair,height,hirsute,history,length,life,midvein,na,peduncle,perennial,primary,pseudostipule,rachi,seed,staman,tertiary,texture,unarmed,venation
448	wfo-0001031207	success	219	111	87	132	24	0.397	0-20,0.25-0.5,0.5-1,0.6-1.2,0.85-1.4,1.4-2,1/4-1/3,2.8-3,3-5,3.5-7,5-8,anther,apex,apparently,articulated,base,berry,branched,calyx,cell,cm,cordate,densely,diameter,dull,erect,evenly,eye,filament,fruit,glabrous,gray,green,herb,lateral,leaf,length,lobe,lobed,lower,margin,maturity,mauve,midvein,mm,moderately,naked,narrow-deltate,oblong,obtuse,orange-brown,outline,ovate,pair,pale,pedicel,peduncle,per,petiole,pit,prickly,primary,raised,red,scandent,shrub,simple,small,smooth,sometimes,spherical,stellate-pubescent,stem,style,subentire,surface,terminal,tertiary,unarmed,upper,vein,venation,visible,white,yellow,yellow-green,young	-0.4,-1/2,-11,-4,-5,-7,-8,.1,/5,0,0-0.5,0-10,0.1-0.2,0.1-0.3,0.1-0.5,0.2,0.2-0.3,0.3-0.5,0.6-0.9,0.7-2,0.8,0.9-1.6,1,1-3,1-4,1-5,1.5-5,1/,1/3,1/3-equal,2-3,2-4,2.1-2.3,2.5-,5-merous,6-8,6.5-8,9,abaxially,acuminat,acute,alyx,ame,apar,apart,apically,bark,blade,bristle,bristly,broad-deltate,brow,c.,chartaceous,concolorous,curved,dark,difoliate,discolorous,distance,drying,eaf,eed,elongated,elongating,equal,extending,filiform,flattened-reniform,flower,free,fruiting,geminat,gently,glabrescent,herbaceous,infructescence,lanceolate,less,like,long,longer,mature,midpoint,multangulate,nflorescence,occasionally,older,one,open,orolla,oung,pendulous,perfec,pericarp,perpendicular,persistent,poricidal,porrect,portion,prickl,prickle,ray,reflexed,rounded,ruit,scar,sessile,shorter,side,spaced,spreading,stalk,stalked,stellate,straight,tamen,tapering,terete,time,tip,toward,trichome,tube,unit,usually,variously,vary,way,weakly,wide,ympodial	0-8,1/4,abaxial,adaxial,arrangement,branching,characteristic,colour,corolla,form,growth,height,history,inflorescence,life,na,ovary,plant,pseudostipule,rachi,seed,shape,staman,texture
449	wfo-0001031218	success	154	117	81	73	36	0.526	-5,0.5-1,1-2,1-3,1-4,15-25,2-2.5,2-22,2-3,3,3-14,3-5,4-7,4-8,40,40-100+,5.5-7,6-10,6-7,6-9,abaxially,acuminate,adaxially,apart,apex,apiculate,articulated,basal,base,branched,calyx,cm,cordate,dark,densely,diameter,eglandular-pilose,ellipsoidal,entire,flattened,flower,fruit,glabrous,glandular-puberulent,globose,greenish-purple,lavender,leaving,lobe,long,margin,minutely,mm,mottled,oblique,obtuse,orange,ovate,ovate-elliptic,ovoid,pedicel,pedicellar,peduncle,perfect,petiole,puberulent,pubescent,rachi,remnant,ripe,simple,sometimes,spaced,sparsely,style,succulent,tip,tree,violet,x,yellow	0.5,10-19,2.5-3,4-28,4-5,4-foliat,5-37,5-7,8-17,8-20,acute,aggregate,ape,axe,beyond,blade,cell,connective,connivent,coriaceous,cylindrical,directed,distally,eaf,eed,eglandular,equal,especially,exceeding,exserted,glabrou,glandular,hair,introrse,lanceolate,less,lon,lower,moderately,narrowly,nflorescence,nther,orolla,papillo,pore,presen,present,purpl,purple,radiu,ruit,shorter,slightly,small,stamen,stellate,stigma,stone,subcoriaceous,tal,tem,thecae,time,tomento,toward,triangular,truncat,tube,ud,unit,vary,wide,ympodial	abaxial,adaxial,anther,arrangement,branching,characteristic,colour,corolla,filament,form,green,growth,height,history,inflorescence,leaf,length,life,midvein,na,ovary,papillose,perennial,plant,primary,pseudostipule,seed,shape,staman,stem,surface,tertiary,texture,unarmed,vein,venation
450	wfo-0001031225	success	163	91	64	99	27	0.393	.5,0.7-6,0.75-1,0.8-1,1-1.5,1-5,2,2.5-3,5-6,6-8,7-9,acute,along,anther,apex,base,berry,calyx,characteristic,cm,corolla,decurrent,deltoid,elliptic,filament,furcate,glabrate,glabrous,globose,green,growth,inflorescence,leaf,lobe,margin,minutely,mm,often,ovary,ovate,ovoid-reniform,pair,pale,pedicel,petiole,pitted,plant,pubescent,shape,shrub,slender,slightly,small,stem,straight,style,surface,tan,tapering,tree,tube,vein,white,x	.25,/3,0.1-0.75,0.2,0.2-0.75,0.5,0.5-1,1-1.7,1-3,1.5-5,3-9,3/4,5-50-flowered,9-16,anthesi,apart,bark,beginning,broadly,bud,closely,conspicuous,cup-shaped,darker,dia,differentiated,differing,difoliate,dry,eaf,edicel,eed,ellipsoid,erect,exserted,flattene,fragrant,free,fruiting,geminat,greyish-brow,inflorescenc,lateral,less,like,live,lobed,lon,long,lower,main,major,middle,minor,minute,much,narrowly,nflorescence,older,one,opposite,outline,papillo,papillose,pore,poricidal,portion,prominent,proximal,raised,red-papillose,reflexed,rest,rhomboidal,rounded,ruit,scar,shaped,size,soon,spaced,specimen,stigma,strongly,sweetly,swelling,tall,tear-drop,tip,trichome,ud,unevenly,uniseriate,unit,way,widest,woody,ympodial,young	abaxial,adaxial,alternate,arrangement,branching,colour,diameter,form,fruit,greyish-brown,height,history,length,life,midvein,na,peduncle,perennial,primary,pseudostipule,rachi,seed,staman,tertiary,texture,unarmed,venation
451	wfo-0001031231	success	175	107	77	98	30	0.44	-2,.5,0.5-1.5,1-1.5,1-2,1.5-2,2-3,2.5-3,25-35,3-4,37/2,37/3,5-7,8-10,acuminate,acute,almost,anther,apex,axillary,base,blunt,branch,branched,brown,calyx,campanula,cm,colour,corolla,dark,discoidal,entire,equal,except,filament,fork,glabrous,globose,green,greyish,hair,juvenile,leaf,len,less,lobe,long,marbled,margin,mature,mauve,minute,mm,occasionally,ovary,pedicel,peduncle,petal,pinnatisect,plant,purple,rh,ripening,rounded,rugose-ruminate,seed,shrub,simple,soft,sometimes,style,surface,tinged,tip,violet,wooded	1-3,1-4,13,2-4,4-8,80-110,absent,acumen,adherent,along,anthesi,aromatic,aspect,axi,basal,becoming,berry,beyond,bluntly,campanulate,cell,clonal,cluster,declinate,developed,dia,eaf,eed,ellipsoid,elliptic,erect,exceeding,exerted,expanded,facetted,fleshy,flower,flowering,folded,general,glandular,gree,habit,herbarium,interacuminal,lanceolate,lasting,lengthening,lon,loosely,lower,midrib,nflorescence,oblong,often,pedice,pedicellate,pentagonal,plurifoliat,pore,poricidal,projecting,rarely,readily,recurve,ripe,rotate,ruit,sessile,several,shallow,shed,short,sinus,slightly,slit,small,specimen,stigma,stone,stonrgly,stout,succulent,tissue,toward,translucent,triangular,tub,ud,unit,usually,variable,vigorous,well,without,x,year,ympodial	abaxial,adaxial,arrangement,branching,characteristic,diameter,form,fruit,growth,height,history,inflorescence,length,life,midvein,na,perennial,petiole,plurifoliate,primary,pseudostipule,rachi,shape,staman,stem,tertiary,texture,unarmed,vein,venation
452	wfo-0001031252	success	170	99	72	98	27	0.424	0.2-1.5,0.3-1.1,1-2,1.3-1.9,1.75-5.2,16-33,2-3,2.8-3.6,3-10,3-6,5-8,5.5-6.5,7-18,acute,anther,apex,attenuate,base,berry,brownish,cell,ciliate,cm,condition,coriaceous,corolla,covering,cuneate,dark,deep,diameter,drying,elliptic,entire,filament,fresh,fruit,glabrous,globose,green,greenish,hair-like,herb,lanceolate,lateral,light,lobe,long,margin,medium,mm,mottled,ovate,ovoid,pedicel,peduncle,petiole,plant,purple,rounded,seed,serrate,simple,sometimes,stripe,style,testal,thick,unwinged,wall,white,whitish	0.4-3,1-3,12-20,2.5-7,3-5,5-17,5-9,5-merou,abaxially,absent,acumen,adaxiall,adaxially,ag,along,alyx,apart,apparently,arranged,articulated,axe,axillary,bead,blade,bud,capitat,clavate,connivent,digestion,distal,dorsally,eaf,edge,eed,enzyme,erec,exceeding,flat,flower,folded,forked,geminat,generally,glabrou,green-white,hal,half,high,homostylous,honeycomb-shaped,interjected,leaflet,lengthening,like,linear,living,lower,make,moniliform,mucilaginous,multiple,necklace,nflorescence,orolla,perfect,plurifoliate,pore,poricidal,removed,ripe,rotate,ruit,seudostipule,slit,spaced,specimen,stamen,stigma,stolon,straight,subtending,tall,tamen,tem,terminal,throughout,tip,tri-,tube,tuber,typically,unit,usually,vary,wet,x,yellow,ympodial	2,abaxial,adaxial,arrangement,branching,calyx,characteristic,colour,form,growth,height,history,inflorescence,leaf,length,life,na,ovary,perennial,pseudostipule,rachi,shape,staman,stem,surface,texture,unarmed
453	wfo-0001031257	success	206	106	76	130	30	0.369	-12,-5,-6,0.7-1,0.75-2.5,1-1.2,1-1.3,1.1-1.2,1.5-1.7,11.5-15,2-4.5,3.5-,3.5-5.7,4-4.5,5-8.5,7.5-9,acuminate,anther,anthesi,apex,ascending,attenuate,basal,base,berry,blue-violet,bud,calyx,cm,coarsely,corolla,cuneate,dark,dentate,diameter,filament,glabrous,globose,half,herb,honey-combed,leaf,length,light,little,lobe,long,longer,margin,midvein,mm,narrowly,non-glandular,ovate,petiole,pubescent,purple,ring,robust,seed,serrate,shrub,simple,stem,striate,style,subglobose,trans-ovoidal,triangular,trichome,tube,vein,white,within,x,yellow	-22.5,0,0.4,0.5,0.5-0.8,1.5,1.5-2,1/10,10-16,2-,3,4-10,4.5-,5,5-,6-12,6-celled,7-,8,8-celled,abaxially,abundant,accrescen,adaxially,ag,aggregate,antrorse,bicellular,branch,broad,campanulate,cell,coat,connectival,cotyledon,curved,cuticle,deep,densely,diamete,difoliate,directed,dorsally,eaf,edentate,eed,ellipsoidal,elliptical,embryo,endosperm,epidermal,erect,finely,flexuous,foliage,free,fruiting,geminat,glandular,hair-like,head,herbaceous,high,hollow,inconspicuous,inserted,lamina,lateral,like,lon,long-stalked,longitudinal,longitudinally,lower,many-seeded,odorles,opening,orolla,outward,pair,papillate,patent,pericarp,pore,poricidal,portion,prolongation,rarely,reduced,ree,rest,ridged,ruit,saddle-shape,scarce,scarcely,secondary,separated,short-stalked,shorter,single-celled,sinus,slightly,slit,small,smooth,solitary,somewhat,spur-like,stalk,stigma,stone,strand,tem,thecae,thickened,thickening,time,tip,tooth,unequal,unit,upward,vary,ventrifixed,verrucate,viscid,viscid-pubescen,wall,ympodial	abaxial,adaxial,arrangement,branching,characteristic,colour,form,fruit,growth,height,history,inflorescence,life,na,ovary,pedicel,peduncle,perennial,plant,primary,pseudostipule,rachi,shape,staman,surface,tertiary,texture,unarmed,venation,viscid-pubescent
454	wfo-0001031270	success	234	112	91	143	21	0.389	+,0.4-1.5,0.5-1,1-1.2,1-4,10-12,100,2-3,2-4,2.5-3,5-15,5-6,6-17,6-50,9-10,>,abaxial,acute,adaxial,anther,apex,base,berry,bipinnatifid,bright,brown,calyx,cm,conical,deeply,densely,depressed-spherical,diameter,elliptic,filament,flower,glabrous,glandular-pubescent,growth,heavily,herb,inflorescence,lateral,leaf,leaf-opposed,length,lobe,lobed,long-styled,margin,membranous,midvein,minutely,mm,narrowly,obovate,ovoid,pair,pale,pedicel,peduncle,per,petiole,pinnatifid,pitted,plant,prickly,primary,pubescent,rachi,red,reddish,reniform,rounded,shallowly,short-styled,shrub,simple,small,sparsely,spherical,stem,straw-colored,style,surface,tan,terete,truncate,vein,white,yellowish	.5,1,1-3,1.2-1.6,1.5,1.5-2,1/3,10,2-2.5,2-20,2-7,3-10,3-20,3-5,4-5,5,5-10,5-merous,7-12,8,abaxially,accrescent,adaxiall,along,alyx,anthesi,apart,arme,articulated,associated,bark,basal,beginning,blade,brow,c.,capitate,cell,celled,clavate,colored,connivent,consistently,curved,differentiated,difoliate,directed,distal,eed,ellipti,entire,equal,erect,few-rayed,free,frui,fruiting,geminat,gland,glandular,green,heterostylous,infructescence,investing,later,leafy,like,live,lon,long,longer,loosely,lower,midpoint,minute,mixture,multangulate,multiseriate,new,nflorescence,occasionally,often,older,orolla,oung,outline,papillo,pericarp,pore,poricidal,portion,prickle,ray,reflexed,rest,ripe,ruit,scar,scattered,secondary,sessile,shallow,shining,short-stalked,single,sinuate,size,slender,slightly,spreading,stalk,staminat,stellate,stigma,straight,strongly,tall,tamen,tapering,testal,thin,thus,tightly,tip,tissue,trichome,tube,uniseriate,unit,upward,usually,vary,varying,way,well,wice,wid,wide,wing,woody,yellow,ympodial,Â½	armed,arrangement,branching,characteristic,colour,corolla,form,fruit,height,history,life,na,ovary,pseudostipule,seed,shape,staman,tertiary,texture,unarmed,venation
455	wfo-0001031283	success	52	76	34	18	42	0.654	0.4-0.5,0.5-0.7,0.7,2.2-2.8,30-40,acute,apex,appearance,base,brown,calyx,cell,cm,diameter,fruit,give,hair-like,lateral,lobe,mm,narrowly,obovate,outgrowth,pale,pubescent,shrub,silky,somewhat,sprawling,surface,testa,wall,winged,woody	-0.25,.7-2.3,0.1-0.15,eed,elongating,erect,fide,lo,long,markedly,moore,pleasant,small,smelling,spreadin,tall,thick,wide	1.7-2.3,abaxial,adaxial,anther,arrangement,branching,characteristic,colour,corolla,filament,form,growth,height,history,inflorescence,leaf,length,life,margin,midvein,na,ovary,pedicel,peduncle,petiole,plant,primary,pseudostipule,rachi,seed,shape,spreading,staman,stem,style,tertiary,texture,thicknes,unarmed,vein,venation,width
456	wfo-0001031287	success	147	102	71	76	31	0.483	.5,0.5-1.5,0.9-1,1,1-1.2,1-1.5,1-5,1.5-2,2-2.5,3-4,4-5,4-6,4.5-5,6-10-flowered,6-7,abaxially,acute,adaxially,anther,apex,attenuate,base,berry,calyx,cm,corolla,deltate,dendritic,densely,dia,elliptic,erect,filament,fleshy,glabrous,globose,green,greenish-white,knob,leaf,lobe,long,margin,minutely,mm,onto,ovary,ovoid-reniform,pair,pale,papillose,pedicel,petiole,pitted,pubescent,red-papillose,rounded,shrub,simple,small,stem,style,surface,tan,thick,trichome,tuft,vein,white,winged,x	1-1.3,1.5-5.5,3-5,5-14,anthesi,apar,ape,axil,bark,bearing,bi-lobed,branch,conical,connective,coriaceous,dark,deflexed,difoliate,divergently,eaf,edicel,eed,ellipsoid,elongate,enlarged,exserted,free,frui,fruiting,geminate,internodal,lamina,later,lateral,lobed,lon,lower,main,many,membranous,middle,nearly,nflorescence,occasionally,older,papillo,planar,plurifoliate,pointed,pore,poricidal,portion,reddish-brow,reflexed,ruit,scar,shaped,shoot,short,sinus,somewhat,spaced,stigma,strongly,tear-drop,thin,tip,tub,tube,ud,unevenly,unit,widest,woody,ympodial,young	abaxial,adaxial,arrangement,branching,characteristic,colour,diameter,form,fruit,greyish,growth,height,history,inflorescence,length,life,midvein,na,peduncle,perennial,plant,primary,pseudostipule,rachi,seed,shape,staman,tertiary,texture,unarmed,venation
457	wfo-0001031300	success	219	124	98	121	26	0.447	0-20,0.2-0.4,0.2-0.5,0.3,0.5-0.9,0.5-18,0.5-2,0.7-0.9,0.8-1.5,1-2,2-4,2.2-2.7,2.5-3.2,3-4,5-15,acute,anther,apex,apically,articulated,attenuate,base,berry,branched,brown-green,calyx,cell,chartaceous,cm,creeping,curved,deltate,densely,diameter,difoliate,dull,erect,eye,filament,filiform,fruit,glabrous,gray-green,lateral,leaf,length,lobe,lobed,margin,maturity,membranous,midvein,mm,moderately,naked,near,oblanceolate,orange,orange-brown,outline,pair,pale,pedicel,peduncle,per,petiole,pit,prickle,prickly,primary,pubescent,raised,rarely,red,rounded,shrub,simple,small,smooth,sparsely,spherical,stellate,stellate-pubescent,stem,style,surface,tertiary,trichome,unit,vein,venation,visible,weakly,white,winged,yellow,yellow-green,yellow-orange	-2.2,-4,-5,-6,.5,/4,0-15,0-3,0-8,0.1,0.1-0.5,0.1-0.6,0.15-0.7,0.2-0.7,0.2-1,0.3-0.6,0.3-1.3,0.5-1.5,0.6-0.8,0.6-1,0.6-1.2,0.7-1.2,1-4,1-5,1.2-1.7,1.3-2,1.5-3.5,1/2-3/4,1/3-1/2,1/6-1/4,10-30,2-,2-3,2-5.5,2-6,2.2-2.3,3-,4,4.5-6,5-merous,6-8,abaxially,absent,also,alyx,apar,apart,apparently,ba,bark,blade,brow,bulbous,caudat,concolorous,connivent,distance,drying,eaf,eed,elongating,equal,extending,flattened,flattened-reniform,flower,free,fruiting,geminat,geniculate,glabrescent,hair,herbaceous,highly,infructescence,lon,long,longer,lower,mature,midpoint,minute,nflorescence,oblong,obtuse,older,one,open,orange-green,orolla,oung,pendulous,perfec,pericarp,poricidal,porrect,portion,prickl,ray,reduced,ruit,scar,sessile,side,spaced,spreading,stalk,stalked,tamen,tapering,terete,thin,time,tip,tube,uniradiate,vary,way,wide,wider,ympodial	abaxial,adaxial,arrangement,branching,caudate,characteristic,colour,corolla,form,geminate,growth,height,history,inflorescence,life,na,ovary,plant,pseudostipule,rachi,seed,shape,staman,sympodial,texture,unarmed
458	wfo-0001031310	success	203	136	107	96	29	0.527	.5,0-3,1-10,1-3,1-6,1.5-4,15-40,2-3,4-10,4.5-4.8,5-6,5-7,6-7,abaxially,acuminate,adaxially,anther,apart,apex,articulated,axillary,base,berry,blue,blue-purple,brown,brownish,bud,cell,chartaceous,cm,condition,conspicuously,corolla,covering,decurrent,diameter,distal,drying,filament,flower,forked,fresh,fruit,generally,glabrous,globose,green,green-white,greenish,hair,hair-like,half,high,lateral,leaf,less,light,like,lobe,long,make,margin,membranous,mm,mottled,mucilaginous,multicellular,obtuse,odd-pinnate,ovate,ovate-elliptic,ovate-lanceolate,ovoid,pale,pedicel,peduncle,petiole,pilose,plant,pubescent,purple,rachi,rosette-forming,seed,shortly,simple,slightly,sometimes,somewhat,spaced,sparsely,stem,streak,style,subrosette-forming,subtending,terminal,testal,thick,throughout,unwinged,usually,wall,wet,white,whitish	0-4,0.5-3,1-2,1-5.5,2.5-5.5,2.5-8.5,3-10,4-12,5-merou,5.5-21,absent,acumen,ag,along,alyx,apparently,attenuate,axe,blade,borne,broadly,caly,ciliate,connivent,cuneate,decreasing,digestion,dorsally,eaf,edge,eed,elliptic,end,enzyme,erect-decumben,especially,exceeding,extremely,flat,folded,geminat,glabrou,gradually,herb,homostylous,honeycomb-shaped,interjected,lanceolate,larger,leaflet,lengthening,living,lower,midrib,minutely,narrowly,nflorescence,orolla,pair,perfect,petiolule,plurifoliate,pointed,pore,poricidal,puberulent,removed,rotate,ruit,seudostipule,singly,size,slit,small,specimen,stamen,ste,stigma,stolo,straight,subellipsoi,tall,tamen,tem,tip,tissue,toward,tri-,tube,tuber,typically,unit,vary,x,yellow,ympodial	abaxial,adaxial,arrangement,branching,calyx,characteristic,colour,erect-decumbent,form,growth,height,history,inflorescence,length,life,midvein,na,ovary,perennial,primary,pseudostipule,shape,staman,surface,tertiary,texture,unarmed,vein,venation
459	wfo-0001031316	success	207	137	113	94	24	0.546	-2,0.3-1,0.5-2,0.8-1.8,0.9-1.3,1-5,1.5-2,1.5-3.5,2-20,2-3,3-8,3.5-3.8,3.8-5,4-7,5-10,5-6,5-8,6-20,abaxial,acuminate,acute,adaxial,almost,anther,apex,apically,apparently,articulated,base,berry,blue-mauve,branched,bright,calyx,cm,colored,concolorous,contrast,cream,curved,dark,densely,diameter,difoliate,discolorous,drying,dull,entire,erect,eye,filament,flattened-reniform,flower,fruit,glabrescent,glabrous,gray,green,lateral,leaf,length,lobe,long,margin,marking,maturity,membranous,mm,moderately,naked,narrow-deltate,obtuse,one,open,orange,orange-brown,ovate,pair,pale,pedicel,peduncle,per,petiole,primary,purple,red-brown,shrub,simple,slender,sometimes,spherical,stellate-pubescent,stem,strongly,style,surface,terete,terminal,tertiary,time,unarmed,unit,usually,vein,venation,visible,white,white-green,whitish,wide,yellow,yellow-green,young	.1,/3,0.05-0.1,0.05-0.15,0.1-0.2,0.4-0.6,0.4-0.8,0.6-1,0.8-1.2,1.2-2.1,1.3-3.5,1.5-,1.5-5,1/3-1/2,1/3-2/3,2-4,2.5-8,3-10,4,4-9,5-15,5-merous,8-11,8-12,8-25,abaxially,alyx,ame,apar,bark,becoming,blade,broad,c.,connivent,eaf,eed,elongating,fifth,foliaceou,four,free,fruiting,geminat,glabrou,hair,held,herbaceous,infructescence,inward,lobed,long-acuminat,longer,lower,lowermost,mature,midpoint,minute,multangulate,nflorescence,older,orolla,oung,pendulous,perfec,pericarp,poricidal,porrect,portion,ray,red-brow,reflexed,ruit,scar,sessile,smooth,spaced,sparsely,spreading,stalk,stalked,stellate,stellate-pubescen,tamen,tapering,tip,trichome,tube,unarme,unequal,variously,vary,way,ympodial	arrangement,branching,characteristic,colour,corolla,form,geminate,growth,height,history,inflorescence,life,long-acuminate,midvein,na,ovary,perennial,plant,seed,shape,staman,sympodial,texture,ye
460	wfo-0001031333	success	194	104	75	119	29	0.387	+,.5,0.5,1-1.5,1-4,1-5,1.2-2,1.5-2,2,2.5-3,2.7-7,3-4,5-7,7-9,<,?,acuminate,acute,anther,apex,base,berry,branched,broadly,brown,calyx,cm,densely,diameter,elliptic,entire,filament,flattened,glabrous,globose,golden,green,greenish,growth,immature,inflorescence,lobe,many,margin,mere,mm,narrowly,ovate,pair,pale,pedicel,peduncle,petiole,primary,pubescent,reniform,simple,sparsely,stem,style,surface,terminal,time,truncate,twining,undulation,unevenly,vein,venation,vine,white,whitish,woody,x,yellowish	0.1-0.5,1.5,1.5-1.7,1/2,2-3,3/4,30-40,5-8,5-merou,50,7-10,>,abaxially,adaxiall,adaxially,adjacent,ag,almost,alyx,anthesi,apart,appearing,ark,articulated,bilobed,branche,capitate,cell,clustered,collection,composed,conical,crea,cupped,denser,eaf,eed,ellipsoidal,exserted,flower,free,fruting,glabrescen,glabrescent,half,high,ilament,lamina,leaving,lengthening,less,like,lobed,long,lower,m.,matte,membranous,minute,minutely,near,new,nflorescence,nodding,occasionally,older,orolla,outline,papillat,peg,penden,pentagonal,per,perfect,pericarp,pitted,planar,plurifoliat,pore,poricidal,portion,pubescent-papillate,quadrate,rest,rhachi,ruit,scar,sinus,slightly,slit,small,somewhat,soon,splitting,ste,stellate,stigma,striped,strongly,tangled,tem,testal,thickened,thin,tip,trailing,triangular,trichome,tube,ud,undersurface,unequal,uniseriate,unit,upper,vary,way,yellow,ympodial	abaxial,adaxial,arrangement,branching,characteristic,colour,corolla,cream,form,fruit,height,history,leaf,length,life,midvein,na,ovary,perennial,plant,pseudostipule,rachi,seed,shape,staman,tertiary,texture,unarmed,unknown
461	wfo-0001031333	success	194	99	71	123	28	0.366	+,.5,0.5,1-1.5,1-4,1.5-2,2.5-3,2.7-7,3-4,5-7,7-9,<,?,acuminate,acute,anther,apex,base,berry,branched,broadly,brown,calyx,cm,corolla,densely,diameter,elliptic,entire,filament,flattened,glabrous,globose,golden,green,greenish,growth,immature,inflorescence,lobe,many,margin,mere,minutely,mm,narrowly,ovate,pair,pale,pedicel,peduncle,petiole,pitted,primary,pubescent,reniform,simple,sparsely,stem,style,surface,terminal,time,truncate,undulation,unevenly,vein,venation,vine,white,woody	0.1-0.5,1-5,1-5-2,1.5,1.5-1.7,1/2,2,2-3,3,3/4,30-40,5-8,5-merou,50,7-10,>,abaxially,adaxiall,adaxially,adjacent,ag,almost,alyx,anthesi,apart,appearing,articulated,bark,bilobed,branche,capitate,cell,clustered,composed,conical,cream,cupped,denser,eaf,eed,ellipsoid,exserted,flower,free,fruiting,glabrescen,glabrescent,half,high,ilament,lamina,leaving,lengthening,less,like,lobed,long,lower,m.,matte,membranous,minute,near,new,nflorescence,nodding,occasionally,older,orolla,outline,papillat,peg,penden,per,perfect,pericarp,planar,plurifoliat,pore,poricidal,portion,pubescent-papillate,quadrate,rest,rhachi,rotate-stellate,ruit,scar,sinus,slightly,slit,small,somewhat,soon,spaced,splitting,stellate,stigma,striped,strongly,tangled,testal,thickened,thin,tip,trailing,triangular,trichome,tub,tube,twinin,ud,undersurface,unequal,uniseriate,unit,upper,vary,way,whitish,wide,yellowish,ympodial	abaxial,adaxial,arrangement,branching,characteristic,colour,form,fruit,greyish,height,history,leaf,length,life,midvein,na,ovary,perennial,plant,pseudostipule,rachi,seed,shape,staman,tertiary,texture,unarmed,unknown
462	wfo-0001031359	success	166	104	71	95	33	0.428	.02,.25,0.5-1,0.5-6,0.75-1,1-4,1.1-1.6,1.2-1.6,1.2-2.5,1.3-1.6,1.5-2,2.5-3,3-3.5,5-30-flowered,5-7,6-7,acuminate,anther,apex,apiculate,attenuate,base,berry,broadly,brown,calyx,cm,corolla,dark,dia,dull,elliptic,filament,flattened-reniform,glabrous,globose,green,leaf,live,lobe,long,margin,minutely,mm,narrowly,nearly,outline,ovary,pair,papillose,pedicel,petiole,pit,pitted,plant,ripe,round,shiny,shrub,simple,stem,straight,style,surface,tan,triangular,vein,white,x,yellow,yellow-orange	.5,/4,1.6-2.8,1.9-2.3,12-21,3.6-8.8,5-angled,5.3-7.5,angle,anthesi,apart,appearing,axil,ba,bark,beginning,beneath,bi-lobed,curled,deflexed,differing,difoliate,distal,dried,eaf,edicel,eed,evenly,extending,free,fruiting,geminat,incrassate,inflorescenc,internodal,interpetalar,lamina,lateral,lobed,lon,lower,main,major,membraneous,middle,minor,near,nflorescence,obovoid,occasionally,often,older,one,opposite,originating,paler,papillae,papillo,planar,pore,poricidal,portion,reflexed,ridged,ruit,rusty,scar,shaped,sinus,size,slender,slightly,somewhat,spaced,specimen,stigma,strongly,tall,tapering,tear-drop,tip,trichome,tub,tube,tuft,ud,undulate,uniseriate,unit,way,white-lenticellat,widest,woody,ympodial,young	abaxial,adaxial,alternate,arrangement,branching,characteristic,colour,diameter,form,fruit,greyish,growth,hair,height,hirsute,history,inflorescence,length,life,midvein,na,peduncle,perennial,primary,pseudostipule,rachi,seed,shape,staman,tertiary,texture,unarmed,venation
463	wfo-0001031362	success	138	108	75	63	33	0.543	.2,.3,.5,0.5-1,1-1.1,1-1.5,1-3-flowered,1-4,1.5-2,2-2.5,3-4,3-6,?,abaxially,acute,adaxially,anther,apex,attenuate,base,berry,brown,calyx,cell,closely,cm,corolla,dendritic,densely,dia,filament,flattened-reniform,glabrous,globose,golden,incrassate,lanceolate,lateral,leaf,like,lobe,long,long-triangular,main,margin,minutely,mm,orange-red,outline,ovary,packed,pair,pale,pedicel,petiole,pitted,pubescent,pubesent,rectangular,red,rest,rounded,shrub,simple,somewhat,sparsely,stem,style,subshrub,surface,tan,trichome,vein,white,x	0.4-0.5,0.7-1,1-3,along,anthesi,appearance,bark,branch,bushy,conical,denser,eaf,edicel,eed,ellipsoid,erect,exceeding,exserted,flattened,free,fruiting,giving,golden-brow,inflorescenc,internodal,lamina,lobed,lon,lower,middle,nearly,nflorescence,nodding,older,opposite,overlappin,papillo,papillose,pericarp,planar,plurifoliat,pore,poricidal,portion,ruit,scar,shaped,shiny,slender,small-capitate,spaced,stigma,straight,tear-drop,thin,tip,tube,ud,unit,widest,woody,ympodial,young	abaxial,adaxial,arrangement,branching,characteristic,colour,diameter,form,fruit,golden-brown,green,growth,height,history,inflorescence,length,life,midvein,na,peduncle,perennial,plant,plurifoliate,primary,pseudostipule,rachi,seed,shape,staman,tertiary,texture,unarmed,venation
464	wfo-0001031400	success	161	103	80	81	23	0.497	0.25-0.8,0.7-6,0.8-1.1,1,1-4,1.2-2,1.5-5,10-11,2,2-5,4-6.5,4-7,6-23,7-28,abaxial,acumen,acute,apiculate,articulate,branched,calyx,cell,cm,corolla,covering,cyme,dark,deeply,diameter,dichasial,dichasially,distal,ebracteate,exceeding,filament,generally,globose,green,green-white,hair-like,half,herbaceous,lateral,leaf,linear,linear-lanceolate,lobe,long,make,mm,monochasial,mucilaginous,oblong,odd-pinnate,ovoid,pedicel,peduncle,perennial,petiole,plant,proximal,puberulent,rachi,seed,side,stamen,stigma,straight,stripe,style,subglabrous,testal,thick,throughout,tip,tone,violet,wall,white,Â¼	-3,0.4-1.7,0.6-1.8,1-,2-3,2-9,3-6-foliat,4-,4-13,4-17,5-12.5,7-25,abaxially,abruptly,absen,adaxially,apex,apical,apically,base,connate,cuneate,decurrent,dehiscent,digestion,diminishing,dorsally,eaf,edge,eed,emoval,enzyme,flat,flower,folded,forked,forming,globo,honeycomb,interjected,introrse,leaflet,living,lon,lower,lunat,maturing,nflorescence,nther,oblique,occasionally,often,orolla,pair,pattern,perfect,plan,poricidally,reveal,ruit,sessile,seudostipule,short,size,slit,specimen,stellate,structure,tal,tem,terminal,toward,trilobe,tuber-bearing,typically,unit,vary,wide,without,yellow,ympodial	adaxial,anther,arrangement,characteristic,colour,form,fruit,growth,height,history,inflorescence,length,life,lunate,na,ovary,pseudostipule,shape,staman,stem,surface,texture,wet
465	wfo-0001031401	success	182	118	92	90	26	0.505	0.6-1.2,1,1-1.4,1-6,1.5-2,2-2.4,2-5,3.5-4,7-9,abaxial,abaxially,acute,adaxial,anther,apex,appearing,attenuate,base,berry,black,branch,branching,brown,calyx,cm,corolla,dark,deltoid,dendritic,densely,diameter,dichasial,drying,ecuadorian,elliptic,filament,finely,flattened,fork,fruit,glabrous,globose,golden,growth,lateral,leaf,lenticular,lobe,long-triangular,matted,minutely,mm,narrowly,near,new,occasionally,often,outline,ovary,overtopping,pair,pedicel,petiole,pitted,puberulent,pubescent,purplish-black,reddish-brown,rounded,roundish,shiny,shoot,short,shrub,small,sometimes,somewhat,sparsely,specimen,stem,strongly,style,surface,terminal,tree,tree-like,trichome,usually,vein,violet,white,winged	0.5,0.8-1.2,1-1.5,1.1-3,1/2,2.5-4,3,3/4,5,5-7,5-9,8-10,adaxially,age,along,anthesi,apical,axi,bark,basal,becoming,bi-lobed,blade,clearly,conical,deciduous,deflexed,denser,differentiated,eaf,ecuador,edicel,eed,ew,exserted,flower,free,fruiting,golden-yellow,impressed,inserted,less,lobed,long,lower,m.,mesophyll,monochasia,nflorescence,noddin,nodding,node,older,papillo,per,pericarp,planar,plurifoliate,pore,poricidal,portion,prominently,pubescen,pyramidal,raised,ruit,scar,secondary,sleev,slit-like,stamen,ste,stigma,tall,tapering,thin,time,tip,tub,tube,ud,unit,visible,way,wide,woody,x,yellow,ympodial,young	arrangement,characteristic,colour,form,height,history,inflorescence,length,life,margin,midvein,monochasial,na,peduncle,perennial,plant,primary,pseudostipule,rachi,seed,shape,staman,tertiary,texture,unarmed,venation
466	wfo-0001031480	success	237	130	112	125	18	0.473	0-1,0-2,0-30,0.5-2,0.8-1,1-1.3,1-1.5,1-2,1-3,1.8-3,1/3,2-2.7,2-3,4-5,4-6,6-8,abaxial,acute,adaxial,anther,apex,apically,apparently,articulated,base,berry,branched,branching,bright,calyx,cell,cm,cream,cuneate,dark,deltate,densely,diameter,dull,ellipsoid,entire,erect,eye,faint,filament,fruit,glabrous,glandular,green,hair,lateral,leaf,length,lobe,lobed,margin,marking,maturity,mauve,midvein,minutely,mm,moderately,naked,near,obtuse,orange-brown,outline,ovate,pair,pale,pedicel,peduncle,per,petiole,pit,plant,prickle,prickly,primary,pubescent,purple,raised,red,red-brown,red-green,red-yellow-green,reticulate,scandent,shallowly,shrub,simple,small,smooth,sparsely,spherical,stellate-pubescent,stem,style,surface,terminal,tertiary,thick-chartaceous,trichome,truncate,unarmed,upper,vein,venation,visible,yellow,young	-0.25,-2,/3,0,0-0.5,0-5,0.1,0.1-0.3,0.1-0.4,0.15-0.3,0.2-0.35,0.4,0.4-0.8,0.5-,0.6-0.8,0.7,0.8,1-4,1.5-2.2,1.7-2.2,1/2,1/4,1/6-1/5,2-,2-5,2-6,3,3-10,3-6,3-7,3.5-7,5-8,5-merous,6-13,6-30,7-8,8-12,abaxially,acuminat,alyx,andromonoecious,apar,apart,ba,bark,blade,broad-deltate,curved,difoliate,discolorous,distal,distance,drying,eaf,eed,elongate,elongating,equal,extending,flattened,flattened-reniform,flower,free,fruiting,geminat,glabrescent,hermaphrodite,heterostylous,inconspicuous,infructescence,long,long-styled,longer,lower,lowermost,mature,midpoint,nflorescence,often,older,one,open,orolla,oung,pendulous,pericarp,persistent,poricidal,porrect,portion,ray,red-brow,reduced,rounded,ruit,scar,sessile,short-styled,shorter,side,slender,slightly,somewhat,spaced,spreading,stalk,stalked,staminat,stellate,straight,tamen,tapering,terete,time,tip,tube,unarme,unit,variously,vary,way,weakly,wide,woody,ympodial	2-30,acuminate,arrangement,characteristic,colour,corolla,form,growth,height,history,inflorescence,life,na,ovary,seed,shape,staman,texture
467	wfo-0001031483	success	154	96	64	90	32	0.416	.5,0.5,0.5-2,1-2,2-2.5,3-4,3-8-flowered,6-10,7-10,across,acuminate,acute,almost,anther,apex,attenuate,base,berry,ca,calyx,cm,corky,corolla,deltoid,dia,difoliate,dry,filament,filiform,fresh,glabrous,green,indistinct,leaf,lenticellate,linear,lobe,long,mm,oblanceolate,obovate,ovary,ovoid-reniform,pair,pale,pedicel,petiole,shape,short-triangular,shrub,simple,slender,stem,straight,style,subshrub,tan,tapering,tube,turbinate,unit,vein,white,x	/2,0,1,1.1-2.5,1.2-1.4,1.7-5.5,1/3,11-20.5,2-3,2.5-3.2,anew,anthesi,apart,ba,bearing,beginning,beneath,blade,caly,clavate,continuous,cork,decurrent,deflexed,distal,eaf,edicel,eed,end,evenly,exserted,flower,free,fruiting,fusiform,geminat,indistinc,internode,larger,lateral,lea,less,lobed,lower,main,major,markedly,minor,minutely,nflorescence,oblong,obovoid,often,opposite,orbiculate,paler,papillo,papillose,per,planar,pointed,pore,poricidal,portion,prominent,quite,raised,rounded,ruit,scar,shaped,short,slightly,somewhat,soon,spaced,stigma,strongly,tall,tear-drop,third,tip,ud,variable,way,widest,wing,winged,woody,ympodial	abaxial,adaxial,arrangement,branching,characteristic,colour,diameter,form,fruit,geminate,growth,height,history,inflorescence,length,life,margin,midvein,na,peduncle,plant,primary,pseudostipule,rachi,seed,staman,surface,sympodial,tertiary,texture,unarmed,venation
468	wfo-0001031492	success	175	118	89	86	29	0.509	0.5,0.7-1.3,0.9-1.1,08,1-1.3,1-1.5,1.3-2,1.5-1.8,2-10,2-3,20,3-4,3-5,4-10,4-4.5,6-8,8-11,abaxially,acuminate,acute,age,anther,apex,attenuate,axe,bark,base,berry,bitter,branching,calyx,cm,corolla,dark,decurrent,deltoid,densely,diameter,drying,elliptic,filament,flattened,fruit,fruiting,glabrous,globose,grey,growth,juice,leaf,lenticular,lightly,lobe,long,medium,minutely,mm,narrowly,ovary,pair,pedicel,petiole,pitted,predominantly,prominent,pubescent,purplish-black,pyramidal,rather,reddish-brown,scar,shiny,short,shrub,size,somewhat,sparsely,stem,sticky,style,surface,terminal,tree,trichome,vein,violet,winged,woody,x	.5,/4,1.5-2.5,10-15,2-5,8-9,absent,adaxially,anthesi,apical,appearing,ba,basal,becoming,beneath,bi-lobed,conical,dbh,deciduous,dendritic,denser,distinguishable,dull,eaf,echinoid,edicel,eed,erect,ew,exserted,flower,free,golden,inserted,lamina,lateral,lobed,lower,m.,monochasia,nflorescence,nodding,occasionally,older,overtopping,papillo,per,pericarp,planar,plurifoliate,pore,poricidal,portion,remaining,ruit,scarcely,scattered,secondary,shoot,sleeve,slightly,slit-like,sometimes,stamen,ste,stigma,strongly,sunken,tall,tapering,thin,time,tip,tree-like,tub,tube,ud,undersurface,unit,upper,upturned,way,wide,ympodial,young,younger	abaxial,adaxial,arrangement,characteristic,colour,deciduousnes,form,height,history,inflorescence,length,life,margin,midvein,monochasial,na,peduncle,perennial,plant,primary,pseudostipule,rachi,seed,shape,staman,tertiary,texture,unarmed,venation
469	wfo-0001031503	success	142	111	77	65	34	0.542	-10,-15,-7,0.3-3,0.5-1,0.5-4,1-2.5,1-3,1-5,1.5-2,1.5-3,1.5-8,2-3,3-4,3-5,3-6,6-7,7-10,abruptly,acuminate,acute,angled,apex,articulated,base,branched,calyx,chartaceous,cm,cuneate,decurrent,deltate,densely,diameter,distally,eglandular,elliptic,entire,forked,glabrous,gland,globose,hair,lobe,margin,mm,moderately,narrowed,obtuse,occasionally,often,orange,ovate,pedicel,peduncle,petiole,puberulent,pubescent,rachi,rarely,reddish,ripe,rounded,rugose-pubescent,shrub,simple,slightly,sparsely,stalked,style,tip,truncate,unbranched,unequal,vein,white,x	-25,-30,-6,1-,1-7,1.5-7,1.7-3.5,10-19,2.5-10,3-15,5613,6-many-foliat,7-15,abaxially,absen,adaxially,aggregate,apart,axe,ba,blade,cell,connivent,curled,cylindrical,directed,distall,eaf,eed,except,fide,flower,lanceolate,long,lower,mostly,narrowly,nflorescence,nther,orolla,perfect,pore,present,radiu,ruit,spaced,stellate,stigma,stone,subcapitat,subclavate,tal,tem,time,toward,triangular,tube,uniseriate,unit,usually,vary,venturi,wide,yellow,ympodial	abaxial,adaxial,anther,arrangement,branching,characteristic,colour,corolla,filament,form,fruit,growth,height,history,inflorescence,leaf,length,life,midvein,na,ovary,perennial,plant,primary,pseudostipule,seed,shape,staman,stem,surface,tertiary,texture,unarmed,venation
470	wfo-0001031586	success	167	99	69	98	30	0.413	-2,0.1-1,0.5-0.8,0.5-1,1-1.2,1-1.5,1-2,1.4-2.5,1.5-2,2,2-2.5,5-10,5-6,7-10-flowered,abrupt,acute,anther,apex,attenuate,base,bright,calyx,cm,completely,corolla,cream-colored,deltate,dia,elliptic,filament,fleshy,glabrous,green,greenish,inflorescence,leaf,lobe,long,margin,mm,older,onto,ovary,pair,pale,pedicel,petiole,prominent,remaining,ridged,rounded,scar,shiny,shrub,simple,slender,somewhat,stem,style,surface,tapering,thick,truncate,tube,vein,white,x,yellow,yellowish	.25,1,1.3-5,3-11,absent,anthesi,apart,apparently,appearing,bark,becoming,beneath,borne,branch,broadly,bud,campanulate,capitate,closer,conical,cucullate,deflexed,differing,difoliate,distance,drying,eaf,edicel,eed,ellipsoid,exerted,exfoliatin,flower,free,fresh,geminate,globose,gree,inflorescenc,know,known,later,lateral,leave,lobed,lower,main,major,material,may,minor,minutely,mucro,near,nearly,new,nflorescence,notched,occasionally,olive,one,open,opposite,overtopping,paler,papillate,papillose,planar,pore,poricidal,portion,present,raised,ruit,shap,shaped,shin,size,small,sometimes,soon,spaced,sparsely,stigma,straight,swollen,tall,tear-drop,thickened,tip,trichome,trunk,ud,uniseriate,unit,widely,ympodial,young	abaxial,adaxial,alternate,arrangement,branching,characteristic,colour,diameter,form,fruit,growth,height,history,length,life,midvein,na,peduncle,perennial,plant,primary,pseudostipule,rachi,seed,shape,staman,tertiary,texture,unarmed,venation
471	wfo-0001031587	success	142	91	58	84	33	0.408	0.8-1,1.5-2,1.7-2,12-16,17-30,2,2-2.5,3-4,5,6-7,7-9,acute,anther,apex,attenuate,base,bi-lobed,calyx,clavate,closely,cm,corolla,densely,elliptic-ovoid,filament,glabrous,globose,inflorescence,irregular,leaf,lobe,minutely,mm,ovary,pair,pale,parallel,pedicel,petiole,pore,poricidal,pubescent,reddish-grey,scar,shape,shaped,spaced,stem,stigma,style,surface,tear-drop,tree,tube,vein,white,winged,x	.5,1-1.5,10-15,2-9-celled,2/3,6-8,abaxially,adaxially,along,anthesi,apart,axi,bark,broadly,cone,conical,decurrent,deflexed,deltate,dendritic,denser,dia,differing,drying,eaf,edicel,eed,elliptic,erect,evenly,exserted,fide,fleshy,free,furcate,golden-red,included,know,known,lamina,later,lateral,like,lobed,long,loose,lower,lowered,main,major,middle,minor,mostly,oblique,ocasionally,occasional,older,overlappin,papillate,papillo,perpendicular,persisten,portion,rarely,rect,rest,ruit,simple,size,soft,somewhat,steinbach,tall,thick,thickened,tip,trichome,tub,ud,uniseriate,verrucose,way,widest,young	1,abaxial,adaxial,arrangement,branching,bud,characteristic,colour,diameter,form,fruit,growth,height,history,length,life,margin,midvein,na,papillose,peduncle,plant,primary,pseudostipule,rachi,seed,spacing,staman,tertiary,texture,unarmed,venation,width
472	wfo-0001031589	success	222	142	117	105	25	0.527	0-10,0-3,0-30,0.1-0.5,0.2-0.5,0.4,0.5-1,0.55-0.7,0.9-1.3,1-1.8,1.2-1.5,1.7-2.5,1.8-2.9,1/3,2-3.5,2.8-4,3-5,3/4,4-6.5,8-30,acute,anther,apex,apically,apparently,articulated,attenuate,base,berry,bright,brown-green,calyx,cell,chartaceous,cm,concolorous,cream,dark,deltate,densely,diameter,difoliate,discolorous,drying,dull,elliptic,erect,eye,filament,flattened-reniform,flower,fruit,glabrescent,glabrous,gray-green,green,lateral,leaf,length,lobe,lobed,long,long-obovate,lower,margin,marking,maturity,mauve,membranous,midvein,mm,moderately,naked,narrow-cuneate,occasionally,often,orange-brown,outline,pair,pale,pedicel,per,petiole,pit,plant,prickle,prickly,primary,raised,rounded,shiny,shrub,simple,small,smooth,solitary,sparsely,spherical,stellate-pubescent,stem,style,subentire,surface,tertiary,unit,upper,vein,venation,visible,weakly,white,whole,wide,yellow,yellow-green,yellow-orange,young	-0.5,-15,-6,-6.5,.5,/6,0,0-1,0.1,0.15-0.3,0.2-0.4,0.2-3,0.6-1.2,0.7,0.8-2.3,0.9-1.6,1,1-5,1.5-5,1/3-1/2,1/3-1/4,10-30,2-,2-10,2.5-4.5,2.5-6,3-4,4/5,5-8,5-merous,6-8,8-14,abaxially,alyx,ame,apart,bark,blade,broadly,brow,c.,caudat,connivent,density,distance,eed,elongating,equal,extending,free,fruiting,geminat,higher,infructescence,lengt,lon,longer,mature,midpoint,multangulate,narrow,nflorescence,oblong,obovate,older,orange-green,orolla,oung,part,pendulous,perfec,pericarp,poricidal,porrect,portion,prickl,ray,reflexed,ruit,scandent,sessile,shorter,side,sometimes,somewhat,spaced,spreading,stalk,stalked,stellate,stout,straight,subsessile,tamen,tapering,terete,time,tip,trichome,tube,vary,way,winged,woody,ympodial	abaxial,adaxial,arrangement,branching,caudate,characteristic,colour,corolla,form,geminate,growth,height,history,inflorescence,life,na,ovary,peduncle,perennial,seed,shape,staman,sympodial,texture,unarmed
473	wfo-0001031609	success	154	111	79	75	32	0.513	0.4-3,0.5-3,1-10,1-6,1.3-3,1.5-2,1.5-3,10-25,2-,2-3,2.5-4,3-5,3-9-lobed,4,4-5,4-6,5-25,abaxially,acute,adaxially,apex,around,articulated,base,branch,brownish,calyx,cm,conspicuous,contiguous,cuneate,deltate,dia,diameter,emerging,entire,flattened,fleshy,forked,fruit,glabrous,globose,green,inflorescence,leaf,leaving,lobe,lobed,margin,mm,nearly,obovate,obtuse,occasionally,orange,pedicel,pedicellar,peduncle,petiole,pinnately,point,puberulent,rachi,reticulate,ripe,scar,shallowly,shrub,simple,small,style,succulent,tree,triangular,two,unbranched,unlobed,x,yellow	.5,/4,0-30,0.5-1,2,20-25,3-24,3-foliat,4.5-60,5/6,8-20,absen,absent,aggregate,ape,apiculate,axe,barely,beyond,bilobe,blade,brow,campanulate,cell,connective,connivent,dark,dilated,directed,distally,divided,eaf,eed,ellipsoidal,elliptic,elliptic-ovate,equal,exceeding,exserted,flower,glabrou,laterally,long,lower,midrib,minutely,nflorescence,nther,obconical,orolla,papillose,pore,radiu,rounded,ruit,sinus,stamen,stellate,stigma,stone,strongly,succulen,tal,tem,thecae,time,tip,tomento,truncate,tube,ud,unit,vary,wide,ympodial	abaxial,adaxial,anther,arrangement,branching,characteristic,colour,corolla,filament,form,growth,height,history,length,life,midvein,na,ovary,perennial,plant,primary,pseudostipule,seed,shape,staman,stem,surface,tertiary,texture,unarmed,vein,venation
474	wfo-0001031615	success	154	86	55	99	31	0.357	.5,0.9-1.1,1-1.6,1.3-1.8,1.5,1.5-5,5-6,8-10,acuminate,acute,anther,apex,attenuate,base,berry,brown,calyx,cm,corolla,deep,deltoid,elliptic,filament,flattened-reniform,fruit,furcate,glabrous,globose,green,inflorescence,leaf,lobe,margin,minutely,mm,occasionally,ovary,pair,pedicel,petiole,pitted,shrub,simple,small,stem,straight,style,subumbellate,surface,tapering,tree,vein,white,winged,x	0,0.5,0.5-1,0.8-1,11-15.5,2-3,2-4.2,3.8-6.1,4-6.5,5-20-flowered,6-8,anthesi,arising,axil,ba,bark,becoming,bilobed,caly,capitate,closely,dark,dark-papillo,decurrent,deflexed,dia,differing,difoliate,distal,eaf,edicel,eed,expanded,exserted,free,fruiting,geminat,glandular,impressed,incrassate,interpetalar,lamina,lateral,less,lobed,lon,long,lower,main,major,maroo,middle,minor,minute,nearly,nflorescence,older,one,opposite,overlappin,packed,paler,papillae,papillose,per,pore,poricidal,portion,prominent,reflexed,ruit,scar,scarcely,shaped,shiny,sinus,size,slender,slightly,somewhat,stigma,tall,tear-drop,terminal,thickened,thin,tip,trichome,tube,tuft,ud,unicellular,uniseriate,unit,urceolate,widest,woody,ympodial,young	abaxial,adaxial,alternate,arrangement,branching,characteristic,colour,diameter,form,growth,height,hirsute,history,length,life,maroon,midvein,na,peduncle,perennial,plant,primary,pseudostipule,rachi,seed,shape,staman,tertiary,texture,unarmed,venation
475	wfo-0001031618	success	184	105	72	112	33	0.391	-2,0-3,1-1.5,1.5-2,2-2.5,2-3,3-4,4-5,5,90-110,acute,anther,apex,axil,base,becoming,branch,broadly,calyx,cm,corolla,cuneate,cyme,darker,discoidal,equal,filament,finely,glabrous,green,greyish,hair,lasting,lavender-purple,leaf,less,lobe,lobed,long,marbled,maturity,mm,obovoid,ovary,ovoid,pale,pedicel,peduncle,petiole,pinatisect,purple,reddish-brown,reticulate,ripe,rounded,rugose,scorpioid,several,shrub,simple,somewhat,stem,stripe,succulent,surface,tapering,terete,tinged,triangular,unequal,variable,year	0.5-1.5,1-7,1.5-3.5,10-18,10-lobed,13,3,3-8,40-60,5-12,acuman,almost,also,anthesi,appearance,appearing,aspect,berry,beyond,blunt,bluntly,c.,capitate,cell,clonal,cluster,column,conical,covering,cut,developed,dia,eaf,eed,ellipsoid,elliptic,emarginate,enlarged,erect,except,exerted,extending,facetted,fleshy,floral,flower,fork,forked,frui,general,giving,glandular,greatly,gree,growing,habit,half,interacuminal,lanceolate,lengthening,lon,loosely,lower,mauve,may,mid-vein,midrib,minute,narrowly,nflorescence,oblong,occasional,occur,often,ovate-lanceolate,pal,pedicellate,petal,plurifoliat,point,pore,poricidal,rarely,rhachi,rotate,ruit,sessile,shallowly,side,single,sinus,slit,soft-wooded,sometimes,specimen,stigma,stone,stout,strongly,styl,tip,tissue,tub,ud,unit,vigorous,way,well,x,ympodial,young,younger	abaxial,adaxial,arrangement,branching,characteristic,colour,diameter,form,fruit,growth,height,hirsute,history,inflorescence,length,life,margin,midvein,na,plant,primary,pseudostipule,rachi,seed,shape,staman,style,tertiary,texture,unarmed,vein,venation,white
476	wfo-0001031646	success	171	114	85	86	29	0.497	-7,-pinnate,.2,.5,0.2-0.8,0.5-2,0.8-1.5,1-1.8,1-10,1-6,1.2-2.5,15-25,2-10,2-3,2.5-10,3.5-4,4-5,5,5-6,5-7,7-8,8-15,acuminate,acute,anther,apart,apex,articulated,base,blue,branched,brown,calyx,chartaceous,cm,cuneate,cylindrical,densely,diameter,ellipsoidal,elliptic-lanceolate,entire,filament,flattened,flower,fruit,glabrous,globose,green,high,highly,hyaline,immature,leaf,light,lobe,long,margin,mature,mm,oblique,obliquely,ovate-lanceolate,pedicel,peduncle,petiole,pubescent,rachi,red,rounded,rugulose,scandent,shortly,shrub,smooth,spaced,stem,stout,style,surface,tawny,tip,vine,violet,x	1.5-3.5,1.5-4,18-38,1962,2-2.5,20,4-18,4-20,4-8,4-foliate,5-7.5,5-merou,abaxially,absen,absent,accrescent,acut,adaxially,aggregate,alyx,apical,apparently,axe,ba,basally,berry,blade,cell,ciliat,climbing,connivent,correll,covered,darker,decreasing,directed,distall,eaf,eed,elliptic,equal,fide,fruiting,geminat,glandular,hair,homostylous,interjected,lateral,leaflet,lower,maroon,multicellular,nflorescence,oblong,obtuse,orolla,ovate-lanceolat,part,perfect,petiolule,pore,present,pubescen,pubescence,rotate-pentagonal,ruit,seudostipule,simple,size,slightly,small,spreading,stigma,stone,tamen,tem,toward,tree,truncat,tube,uniseriate,unit,vary,yellow,ympodial	abaxial,adaxial,arrangement,branching,characteristic,colour,corolla,form,growth,height,history,inflorescence,length,life,midvein,na,ovary,perennial,plant,primary,pseudostipule,seed,shape,staman,tertiary,texture,unarmed,vein,venation
477	wfo-0001031651	success	201	114	90	111	24	0.448	.7,0.3-0.8,0.3-1.5,0.6-1,0.7-1,1-1.7,1/5,2-3.5,3-5,4-5,4-6,abaxial,absent,acute,adaxial,anther,apex,apically,apparently,articulated,base,berry,branched,brown,calyx,cell,cm,cordate,deltate,densely,diameter,dull,elliptic,entire,erect,eye,faint,filament,flattened-reniform,fruit,glabrous,gray,herb,lateral,leaf,length,lobe,lower,margin,maturity,mm,naked,obtuse,orange-brown,outline,ovate,pair,pedicel,peduncle,petiole,pit,prickly,primary,purple,raised,red,red-green,rounded,shrub,simple,small,smooth,sometimes,spherical,stellate-pubescent,stem,style,subentire,surface,terminal,tertiary,unarmed,upper,vein,venation,visible,weakly,white,yellow,yellow-green	-2,-3,-3.5,.1,.6,/3,/5,0-20,0.1,0.1-0.15,0.1-0.2,0.1-0.25,0.15-0.2,0.2-0.5,0.3-0.5,0.6-1.3,1,1-2,1-4,1.2-2,1.2-3,1.3-1.6,1.5-2,1/6-1/4,2-10,2-3,2/3-3/,4.5-7,5-merous,abaxially,acuminat,alyx,ame,apar,apart,bark,blade,c.,chartaceous,concolorous,curved,dark,difoliate,discolorous,drying,eaf,eed,elongating,equal,filiform,flower,free,fruiting,geminat,glabrescent,gra,herbaceous,infructescence,lanceolate,lobed,long,longer,mature,midpoint,nflorescence,oblong,older,one,open,orolla,oung,pendulous,per,perfec,pericarp,persistent,poricidal,porrect,portion,prickl,prickle,ray,reflexed,ruit,scandent,scar,shorter,spaced,spreading,stalk,stalked,stellate,straight,subsessile,tamen,tapering,terete,thick,thick-stalked,time,tip,toward,trichome,tube,unarme,unit,variously,vary,way,wide,ympodial	2/3-3/4,acuminate,arrangement,branching,characteristic,colour,corolla,form,growth,height,history,inflorescence,life,midvein,na,ovary,perennial,plant,pseudostipule,rachi,seed,shape,staman,texture
478	wfo-0001031656	success	154	88	58	96	30	0.377	0.5,0.5-1,1-1.5,1-2.5,1.2-1.5,1.5-2,1.5-5,3-3.5,5-7,5-ribbed,6-8,acuminate,acute,anther,apex,base,berry,calyx,cm,corolla,ellipsoid,elliptic,filament,fleshy,fruit,glabrous,globose,green,greyish,leaf,lobe,long-acuminate,margin,matte,mm,oblique,opposite,ovary,ovate,pair,pedicel,petiole,plant,rather,reddish,rounded,sessile,shiny,shrub,stem,straight,strongly,style,surface,thick,transversely,vein,white	.5,/4,1-2,10-20,2.5-3.5,3-5,4-9,also,anthesi,arising,ba,bark,bright,capitate,closely,cork,densely,dia,differing,difoliate,directly,drying,eaf,edicel,eed,enclosing,erect,extremely,flower,free,fruiting,geminat,hooded,known,lateral,live,lobed,lon,long,lower,main,major,mature,middle,minor,minute,minutely,nflorescence,node,often,older,one,pale,paler,papillo,papillose,peelin,persistent,planar,pore,poricidal,portion,prominent,proximal,red-papillose,reflexed,rib,ridged,ruit,scar,shaped,size,slightly,somewhat,spaced,specimen,stigma,swollen,tall,tear-drop,terminal,thickened,tip,top,tube,ud,unit,upper,visible,way,wide,widest,woody,x,ympodial,young	abaxial,adaxial,alternate,arrangement,branching,characteristic,colour,diameter,form,growth,height,history,inflorescence,length,life,midvein,na,peduncle,peeling,perennial,primary,pseudostipule,rachi,seed,shape,staman,tertiary,texture,unarmed,venation
479	wfo-0001031667	success	153	72	52	101	20	0.34	0.6-1,1-1.5,1.4-3,10-13,12-35,2-5,2.5-5,3-13,5-9,8-13,branched,calyx,cell,cm,corolla,covering,cyme,dark,diameter,dichasial,dichasially,ebracteate,elliptic-lanceolate,globose,green,hair-like,herbaceous,lanceolate,lateral,leaf,lobe,long,mm,monochasial,mucilaginous,oblong,odd-pinnate,ovoid,pedicel,peduncle,perennial,petiole,pilose,plant,seed,spot,stripe,style,testal,thick,wall,white	0.6-1.5,1-4,1.5-2,2-3,2-6,3-5,3-6-foliat,3-8,4-1.,5-15,6-10,8-15,abaxially,abruptly,acumen,acuminate,acute,adaxially,apex,apical,apically,apiculate,articulate,base,caudate,connate,cordate,cuneate,dehiscent,digestion,diminishing,distal,dorsally,eaf,edge,eed,emoval,enzyme,exceeding,filament,flat,flower,folded,forked,generally,globo,green-white,half,honeycomb,interjected,introrse,irregularly,leaflet,living,lobed,lon,lower,lunat,make,maturing,nflorescence,nther,oblique,often,orolla,pair,pattern,perfect,petiolate,petiolule,plan,poricidally,proximal,reveal,rounded,ruit,sessile,seudostipule,short,size,slit,specimen,stamen,stellate,stigma,straight,tal,tem,terminal,throughout,toward,tuber-bearing,typically,unit,vary,whit,wide,without,yellow,ympodial,Â¼	anther,arrangement,characteristic,colour,form,fruit,growth,height,history,inflorescence,length,life,lunate,ovary,pseudostipule,shape,stem,surface,texture,wet
480	wfo-0001031672	success	157	109	76	81	33	0.484	0,0-2,0.3-0.5,0.5-1.5,1,1-1.5,1-10,1-5,1.5-2,1.5-2.5,1.5-3.5,1.5-5,10-20,15-50,4,4.5-5,6,9-lobed,acuminate,acute,apex,apiculate,articulated,basal,base,calyx,chartaceous,cm,cordate,densely,diameter,entire,flattened,fleshy,flower,fruit,glabrous,glandular-puberulent,globose,green,greenish-brown,leaf,leaving,lobe,lobed,long,margin,mature,mm,moderately,near,obtuse,occasionally,ovate,ovoid,pedicel,pedicellar,peduncle,petiole,pilose,pinnately,puberulent,rachi,remant,rounded,simple,sparsely,style,subcoriaceous,tip,tree,truncate,unbranched,whitish,x,yellow	0.5,0.5-1,1-,1-2,15-20,2-12,2-28,3-4-foliat,3/4,4-34,4/5,5-6,abaxially,absent,adaxially,aggregate,apart,ape,aublet,axe,beyond,blade,cell,ciliat,connective,cylindrical,directed,distally,divided,eaf,eed,exceeding,exserted,fide,hair,lanceolate,lon,lower,membranaceous,midrib,narrowly,nflorescence,nther,often,one,orolla,perfect,pilo,pore,presen,present,pubescent,purple,radiu,represented,ruit,shorter,sinus,slightly,small,spaced,stamen,stellate,stigma,stone,tal,tem,thecae,time,toward,triangular,truncat,tube,ud,unit,unlobed,vary,white,wide,yello,ympodial	abaxial,adaxial,anther,arrangement,branching,characteristic,colour,corolla,filament,form,growth,height,history,inflorescence,length,life,midvein,na,ovary,perennial,plant,primary,pseudostipule,seed,shape,staman,stem,surface,tertiary,texture,unarmed,vein,venation
481	wfo-0001031684	success	161	112	78	83	34	0.484	.25,0.4-1.5,0.5-0.7,0.5-0.8,0.5-1,0.7-1,0.75-1,1-1.2,1-5,2,3-30,5-7,acuminate,acute,anther,apex,base,berry,black,branched,calyx,cm,corolla,decurrent,deflexed,densely,dia,difoliate,drying,elliptic,filament,filiform,geminate,glabrous,globose,green,inflorescence,internodal,irregularly,lateral,leaf,like,lobe,long,long-triangular,main,minutely,mm,occasionally,opposite,ovary,ovoid-reniform,pair,pale,pedicel,petiole,pitted,pubescent,rest,shrub,slender,slightly,small,sparsely,stem,style,surface,tan,tapering,tree,trichome,tube,unifoliate,uniseriate,vein,white,winged,x	.5,.75,/4,0.1,10-100,2-9,3-3.5,4-17,along,anthesi,apar,bark,bearing,beneath,borne,causing,clavate,curly,denser,differing,eaf,edicel,eed,elongated,except,expanded,exserted,extremely,flower,free,fruiting,gre,greatly,less,lobed,lon,lower,major,middle,midrib,minor,nflorescence,obconic,older,one,papillo,papillose,persistently,planar,pore,poricidal,portion,present,previously,pulled,raised,reflexe,reflexed,ruit,scar,shaped,short,single,siz,size,soon,spaced,stigma,straight,tall,tear-drop,time,tip,tipped,ud,unevenly,unit,varying,way,widely,widest,ympodial,young	abaxial,adaxial,arrangement,branching,characteristic,colour,diameter,form,fruit,grey,greyish,growth,hair,height,hirsute,history,length,life,margin,midvein,na,peduncle,perennial,plant,primary,pseudostipule,rachi,seed,shape,staman,tertiary,texture,unarmed,venation
482	wfo-0001031695	success	185	121	87	98	34	0.47	0.5-1,0.5-2,1-2,1-9,1.5-8,10-35,2-3,2-4,2-5,2.5-5,20-30,3-17,3-7,4-10,4-5,4-6,5-7,6-10,abruptly,acuminate,acute,also,apex,articulated,basal,base,branched,calyx,chartaceous,cm,color,cordate,dark,deep,densely,diameter,eglandular-pilose,ellipsoidal,entire,flattened,flower,fruit,glabrate,glabrous,glandular-puberulent,green,greenish,immature,lavender,leaf,leaving,lobe,lobed,long,margin,mm,moderately,mottled,oblique,oblong,obtuse,occasionally,ovate,pedicel,pedicellar,peduncle,petiole,pilose,pilose-hirsute,puberulent,puberulent-pubescent,pubescent,purple,rachi,remnant,ripe,shrub,simple,sometimes,sparsely,stripe,style,subcoriaceous,tree,unbranched,unknown,x	1,1-3,1.5-2,1/2,1/3,10-,10-15,15-20,3-,3-10,3-19,30-40,4-foliat,5,5-20,6-20,6-8,7-,?,abaxially,adaxially,aggregate,apart,ape,apically,apiculate,axe,beyond,blade,broadened,campanulate,capitat,cell,connective,connivent,cylindrical,d,dilated,directed,divided,eaf,eed,eglandular,exceeding,exserted,fleshy,glabrescent,hair,hard,lanceolate,lateral,laterally,lilac,lon,lower,midrib,narrowly,nflorescence,nther,often,orolla,ovoid,perfect,pilo,pilose-hirsut,pore,presen,present,purplish,radiu,rounded,ruit,shorter,sinus,slight,slightly,small,somewhat,spaced,stamen,stigma,stone,swelling,tal,tem,thecae,time,tip,tomento,triangular,tube,unequal,unit,unlobed,vary,wide,yellow,ympodial	10-20,abaxial,adaxial,anther,arrangement,branching,characteristic,colour,corolla,filament,form,growth,height,history,inflorescence,length,life,midvein,na,ovary,perennial,plant,primary,pseudostipule,seed,shape,staman,stem,surface,tertiary,texture,unarmed,vein,venation
483	wfo-0001031698	success	58	66	25	33	41	0.431	2-2.5,2.5,4-4.5,base,cm,dull,elliptic,glabrous,green,leaf,margin,minutely,mm,pale,pedicel,pitted,reddish-brown,repandly,rugose,shrub,stem,strongly,surface,winged,woody	'',2.5-3,``,ape,bark,branch,decurrent,deflexed,dia,difoliate,eaf,eed,fide,flattened,fruiting,geminat,incrassate,long,maguire,older,otherwise,paler,papillae,persistin,reniform,stout,tall,unit,wing,x,yellowish,ympodial,young	abaxial,adaxial,anther,apex,arrangement,branching,calyx,characteristic,colour,corolla,decument,diameter,filament,form,fruit,geminate,growth,height,history,inflorescence,length,life,lobe,midvein,na,ovary,peduncle,petiole,plant,primary,pseudostipule,rachi,seed,shape,staman,style,tertiary,texture,unarmed,vein,venation
484	wfo-0001031707	success	178	130	100	78	30	0.562	1-1.3,1-1.5,1.2-1.8,1.2-2,1.5-2,1.5-6,1/3,16-20,2,2-4,2-6,24,4-5,4-6,6-7,80-140,abaxially,acuminate,acute,adaxially,almost,along,anther,apex,apical,apically,attenuate,axil,axillary,base,basiscopically,bearing,berry,brown,calyx,cm,conical,corolla,dense,densely,diameter,distal,distinct,elliptic,enlarged,erect,filament,flap-like,flattened,flower,glabrous,globose,green,greenish,lanceolate,leaf,less,lobe,long,margin,mm,narrowly,oblique,obovate,occasionally,open,ovary,pair,pedicel,per,petiole,pink,pinnate,plant,pointed,primary,pubescent,quadrate,raised,reddish,regular,round,scar,scattered,simple,slightly,spaced,sparsely,style,surface,thickening,time,trichome,uniseriate,vein,vine,white,widely,woody,x	-3,.5,/4,0.5-1,1-1.2,1-3,1.5-1.7,2-10,2-3,3,5-10-celled,8-12,9-15,absent,anthesi,basal,c.,capitate,cateniform,cell,clavat,climbing,conspicuously,cucullate,drying,eaf,edicel,eed,endrophilum,epidermal,exserted,flat,fleshy,four-lobed,free,fruiting,high,horizonta,inflorescenc,lateral,leaflet,like,lobed,lon,lower,minutely,narrower,nflorescence,papillate,penden,petiolule,planar,poricidal,portion,quite,rest,ruit,sagittate,smaller,smooth,somewhat,stigma,stout,strongly,tem,terminal,ternate,tip,tub,tube,type,ud,unifoliat,unit,usually,way,white-lenticellate,ympodial	0.5,8,abaxial,adaxial,arrangement,branching,characteristic,colour,form,fruit,growth,height,history,horizontal,inflorescence,length,life,midvein,na,peduncle,pseudostipule,rachi,seed,shape,staman,stem,tertiary,texture,unarmed,venation
485	wfo-0001031723	success	228	144	124	104	20	0.544	-1.5,-15,-2,-5,-8,0,0.4,0.4-,0.4-1,0.55-0.9,0.6-1,0.7-1,1-,1-2,1-2.5,1-3,1.2-2,15-45,2-,2-3.5,2.5-4.5,2.5-5,4-11,4-6,5-40,abaxial,abaxially,acuminate,acute,adaxial,anther,apex,apically,apparently,articulated,base,berry,branched,branching,brown,calyx,chartaceous,cm,cuneate,curved,dark,deltate,diameter,discolorous,drying,dull,elongated,entire,erect,evenly,eye,filament,filiform,flattened-reniform,fruit,gently,glabrous,glandular,green,hair,infructescence,lateral,leaf,length,lobe,long,margin,marking,maturity,mauve,midpoint,minute,mm,moderately,naked,near,obtuse,orange,orange-brown,ovate,pair,pale,pedicel,peduncle,per,petiole,prickle,prickly,primary,recurved,red,rounded,secondary,shrub,simple,sometimes,sparsely,spherical,stellate-pubescent,stem,straight,strongly,style,subentire,surface,terminal,tertiary,trichome,unarmed,vein,venation,visible,weakly,white,whitish,wide,yellow,yellow-green,young	-1/2,-16,-6,-6.5,-merous,0.05-0.2,0.1-0.2,0.1-0.3,0.1-0.5,0.15,0.2-1,0.4-0.9,0.8-1.5,1-5,1.5-,1.5-10,1.5-2.5,1/3-1/2,1/4-1/3,1/6-,10-30,2-5.5,2-7,2/3,2/3-3/4,3-10,3-15,4-,4-10,4-20,4-5,5-9,8-20,acut,alyx,ame,apar,apart,ba,bark,blade,brow,c.,conical,connivent,densely,eaf,eed,elongating,equal,finely,flower,free,fruiting,glabrescent,gland,gland-tipped,gray,herbaceous,inflated,lobed,longer,lower,mature,multangulate,narrow-deltate,nflorescence,older,one,open,orolla,oung,perfec,pericarp,perpendicular,plurifoliat,poricidal,porrect,portion,ray,reflexed,ruit,scar,sessile,smooth,spaced,spreading,stalk,stalked,stellate,tamen,tapering,terete,time,tip,tube,unarme,unit,usually,variously,vary,way,woody,ympodial	arrangement,characteristic,colour,corolla,form,growth,height,history,inflorescence,life,midvein,na,ovary,plant,pseudostipule,rachi,seed,shape,staman,texture
486	wfo-0001031729	success	161	101	69	92	32	0.429	-2,0.5-1,0.6-,1-1.5,1-2,1-2.5,1.5-2,12-13,2-2.5,2-3,2.5-5,3-4,5-6,5-7,abruptly,acuminate,anther,apex,apiculate-deltate,attenuate,base,branched,calyx,cm,conical,corolla,dark,darker,deltate,diameter,elliptic,filament,flattened,fruit,glabrous,globose,green,greenish,lobe,long,minutely,mm,mottling,obovate,occasionally,ovary,ovate-reniform,pair,pale,papillate,papillose,pedicel,peduncle,petiole,pink,primary,purplish,quadrate,reddish,shrub,somewhat,stem,stripe,surface,tan,time,vein,white,x	-0.5,-45,..,0.5,0.5-4,1.0-1.3,1.5,10-20,11-30,2.5-,3-celled,3.5-4,4.1-16,5-,50,8-9,along,anthesi,apicula,beneath,branc,branch,brittle,brow,c.,cell,cucullate,curve,dry,drying,eaf,edicel,eed,elongate,erec,flattened-capitat,flower,fruiting,glandular,gradually,later,less,lobed,lower,markedly,membranous,middle,minute,narrowly,nearly,never,nflorescence,noddin,open,outer,outline,papillae,per,pericarp,planar,plurifoliat,point,pointed,regularly,ruit,scar,scattered,short,single,single-stemmed,sinuate,small,smooth,stigma,striate,testa,thin,thing,tip,toward,triangular,trichome,tube,tuft,ud,unit,usually,wall,wand-like,widening,ympodial,young	abaxial,adaxial,alternate,arrangement,branching,characteristic,colour,form,growth,height,history,inflorescence,leaf,length,life,margin,midvein,na,nodding,perennial,plant,plurifoliate,pseudostipule,rachi,seed,shape,staman,style,tertiary,texture,unarmed,venation
487	wfo-0001031738	success	231	110	88	143	22	0.381	-5,0.7-1,0.7-1.1,1-1.5,1-4,1.4-1.7,1.5-4,1/3,10-15,15-40,2.3-3,3-4,3.5-4.5,4-6,5-8,abaxial,abaxially,acute,adaxial,adaxially,anther,apex,apically,articulated,auriculate,base,berry,branched,calyx,chartaceous,cm,cordate,dark,densely,diameter,dull,erect,filament,flattened-reniform,frequently,fruit,glabrous,gray,lateral,leaf,length,lobe,lobed,lower,margin,midvein,mm,narrow-deltate,orange,orange-brown,ovate,pair,pale,pedicel,peduncle,petiole,plant,poorly,prickly,primary,pubescent,shrub,simple,small,sparsely,spherical,stellate-pubescent,stem,style,surface,terminal,tertiary,tree,unarmed,upper,vein,venation,visible,weakly,white,yellow,yellow-green,yellowish	-15,-6,-merous,.5,0,0-2,0-3,0.1-0.25,0.2-0.3,0.25-0.8,0.3-1,0.9-2.1,1-1.8,1-3,1.5-,1/,1/2-2/3,1/3-2/3,1/4-1/3,1/6-1/4,2-,2-4,20-200,3-6,3-7,3.5-3.8,4,4-10,4-5,4-8,5,6-15,7-12,7-12.5,8-10,8-18,acuminat,almost,always,alyx,andromonoecious,apar,apart,apparently,bark,blade,cell,connivent,curved,deltate,discolorous,distal,distance,drying,eaf,eed,elongating,equal,evenly,extending,flattened,flower,free,fruiting,glabrescent,green,held,hermaphrodite,heterostylous,infructescence,inside,lobing,long,long-styled,longer,lowermost,mature,maturity,midpoint,multangulate,nflorescence,oblong,obovate,often,older,one,open,orolla,oung,outline,per,pericarp,pit,plurifoliat,poricidal,porrect,portion,prickl,prickle,prominent,raised,ray,reflexed,resin,rounded,ruit,scar,secondary,sessile,short-styled,shorter,side,smooth,sometimes,spaced,spreading,stalk,stalked,staminat,stellate,sticky,stout,straight,strongly,tamen,tapering,terete,time,tip,trichome,truncate,tube,unit,usually,variously,vary,way,white-brow,wide,woody,yellow-orange,ympodial,young	1/4,acuminate,arrangement,branching,characteristic,colour,corolla,form,growth,height,history,inflorescence,life,na,ovary,perennial,pseudostipule,rachi,seed,shape,staman,texture
488	wfo-0001031752	success	172	137	103	69	34	0.599	-10,-100,-44,-6,0.5-1,0.5-1.5,1,1-1.5,1-3,1-4,1.5-10.5,1.5-2,1.5-3,1.5-3.5,15-25,15-40,2-2.5,2-3,2-5,20-35,3-4,3-7,3.5-5,5-6,5-8,9-16,acuminate,acute,apart,apex,apiculate,articulated,basal,base,calyx,chartaceous,cm,cuneate,darker,deltate,densely,diameter,ellipsoidal,elliptic,entire,flattened,fleshy,flower,fruit,fusiform,glabrate,glabrescent,glabrous,gland,glandular-puberulent,green,immature,leaving,less,light,lobe,long,margin,mm,moderately,near,oblong,often,older,ovate,pedicel,pedicellar,peduncle,perfect,petiole,pink,puberulent,pubescent,purplish,rachi,remnant,ripe,rounded,rugose,shrub,simple,small,spaced,sparsely,stalked,stripe,style,subcordate,subcoriaceous,tip,tree,truncate,unbranched,white,wide,x,yellow,young	-3,-47,-pubescent,1-,1-2,1.5-2.5,3-11.5,3-4-foliat,3.5-15,5-23,8-15,abaxially,adaxially,aggregate,ape,axe,beyond,blade,cell,ciliat,ciliate,connective,connivent,cylindrical,directed,distally,eaf,eed,equal,exceeding,exserted,glandular-puberulen,lanceolate,linear,lon,lower,membranaceous,narrowly,nearly,nflorescence,nther,obtuse,olde,orolla,ovoid,pore,presen,present,purpl,radiu,ruit,slightly,stamen,stellate,stigma,stone,swelling,tal,tem,thecae,time,tomentose,triangular,truncat,tube,ud,unit,vary,ympodial	abaxial,adaxial,anther,arrangement,branching,characteristic,colour,corolla,filament,form,growth,height,history,inflorescence,leaf,length,life,midvein,na,ovary,perennial,plant,primary,pseudostipule,seed,shape,staman,stem,surface,tertiary,texture,unarmed,vein,venation
489	wfo-0001031756	success	186	103	74	112	29	0.398	-1,.5,0,0-2,0.4-1.6,0.5-1,0.8-1,1-1.8,1-4,1.5-2,1.8-2.5,3-5,4-5,anther,apex,apically,articulated,base,berry,calyx,cm,color,cordate,curved,deltate,densely,diameter,entire,erect,evenly,filament,finely,flattened-reniform,fruit,glabrous,gray,green,known,leaf,lobe,margin,mature,mauve,mm,orange-brown,ovate,pair,pale,pedicel,peduncle,petiole,pitted,prickly,primary,red-brown,rounded,scandent,shoot,short,shrub,simple,slender,spherical,stellate-pubescent,stem,style,surface,terminal,truncate,unarmed,vein,white,yellow-green,young	-5,.1,.8,/2,0-5,0.02-0.2,0.1,0.15-0.25,0.2,0.5-1.3,0.6-1.2,0.6-1.6,0.7-1.7,00,1-2,1-3,1.5-3.5,1/2,1/3,10,2-6,3-15,3-7,4.5,5-merous,6-9,7-10,9-14,abaxially,accrescent,acut,alyx,apar,apart,apparently,bark,blade,branched,broad-deltate,chartaceous,concolorous,conical,connivent,drying,eaf,eed,elongating,enclosing,equal,eye,flower,free,fruiting,fully,glabrescent,glabrou,herbaceous,inflated,infructescence,invested,lobed,long,longer,lower,midpoint,moderately,naked,nflorescence,older,one,open,orolla,oung,pendulous,per,perfec,pericarp,perpendicular,plurifoliat,poricidal,porrect,portion,prickl,prickle,ray,ruit,scar,sessile,shorter,small,smooth,spaced,sparsely,spreading,stalk,stalked,stellate,straight,tamen,tapering,terete,time,tip,trichome,tube,unit,variously,vary,visible,way,wide,ympodial	abaxial,acute,adaxial,arrangement,branching,characteristic,colour,corolla,form,growth,height,history,inflorescence,length,life,mentioned,midvein,na,ovary,perennial,plant,pseudostipule,rachi,seed,shape,staman,tertiary,texture,venation
490	wfo-0001031786	success	209	127	103	106	24	0.493	.5,0-20,0.2-2.5,0.5-1.5,0.7-1.6,0.8-1.2,1-4,1.2-1.6,1.5-2.5,2-3,2.5-3.5,3-4,4-5,6-8,acute,anther,apex,apically,apparently,articulated,base,becoming,berry,branched,calyx,cell,chartaceous,cm,cuneate,curved,dark,deep,deltate,diameter,elliptic,erect,evenly,eye,filament,filiform,flattened-reniform,fruit,glabrescent,glabrous,gray,green,herb,infructescence,lateral,leaf,length,lobe,lobed,long,margin,maturity,mauve,membranous,midvein,minute,mm,naked,orange,orange-brown,outline,ovate,pair,pale,pedicel,peduncle,per,petiole,pit,prickly,primary,raised,red,red-brown,shiny,shrub,simple,small,smooth,sometimes,sparsely,spherical,stellate-pubescent,stem,style,surface,tertiary,trichome,truncate,unarmed,unit,vein,venation,visible,weakly,white,wide,yellow-orange,young	-5,.4,/2,/3,0,0-2,0-3,0-5,0.1,0.1-0.4,0.2-0.3,0.25-0.5,0.7-1,0.7-4,0.8,1,1-2,1-3,1-6,1.5-1.9,1/3-1/2,2-13,2-7,2-8,3-5.5,5-7,5-merous,8-12,abaxially,acut,almost,alyx,ame,apar,apart,bark,blade,c.,clavat,concolorous,connivent,densely,distance,drying,eaf,eed,elongating,equal,extending,flattened,flower,free,fruiting,gray-brow,herbaceous,inconspicuous,lon,longer,lower,mature,midpoint,nflorescence,obtuse,older,one,open,orolla,oung,pendulous,perfec,pericarp,plurifoliat,poricidal,porrect,portion,prickl,prickle,ray,reflexed,rounded,ruit,scandent,scar,sessile,shorter,side,slightly,spaced,spreading,stalk,stalked,stellate,stigma,straight,tamen,tapering,terete,thick,time,tip,tube,variously,vary,way,woody,ympodial	abaxial,adaxial,arrangement,branching,characteristic,colour,corolla,form,growth,height,history,inflorescence,life,na,ovary,perennial,plant,plurifoliate,rachi,seed,shape,staman,sympodial,texture
491	wfo-0001031793	success	188	112	90	98	22	0.479	-4,.5,1-1.5,1-2,1-8,1.5-4,10-15,15-20,2-3,2-5,acumen,acuminate,aging,almost,anther,apex,armed,articulated,base,berry,black,branched,broadly,brown,brownish,calyx,cm,cuneate,densely,diameter,elliptic,erect,evident,extra-axillary,filament,flattened,flower,forked,fruit,glandular,globose,hair,inflorescence,leaf,linear,lobe,long,many,margin,mm,mucilaginous,oblique,often,orange-yellow,orbicular-ovate,pedicel,peduncle,per,petiole,prickle,pubescent,rachi,reddish,reduced,reticulation,rounded,rusty,scarcely,scattered,shallow,shrub,simple,small,sparsely,stellate,stellate-pubescent,stem,style,surface,testa,tip,tree,triangular,trichome,unarmed,unbranched,well-developed,white,yellow,yellow-brown	0,1,1-3,1.5-2,1/3,1/4,1/5,13-20,20,26,3-4,3-8,3/4,4,40,5-merous,7,8-11,absent,abundant,accrescent,acute,adult,alyx,apparently,aspect,axe,ba,bilobe,blade,branche,broad,capitate,central,chartaceous,cut,difoliate,distal,eaf,eed,elongatin,erec,extreme,ferrugineous,fruiting,geminat,general,homostylou,interpetalar,larger,lobing,lon,lower,main,maturing,midpoint,midrib,minutely,mostly,nflorescence,oblong-lanceolate,obtuse,older,orolla,ovate,perfect,pore,porocidal,porrect,principal,ruit,sessile,side,similar,single,sinus,size,smaller,stellate-pubescen,stigma,stipitate,stout,tall,tamen,tem,thickened,tissue,triangular-acuminat,tube,unit,upward,usually,uvenile,vary,way,woody,x,ympodial	abaxial,adaxial,arrangement,branching,characteristic,colour,corolla,form,growth,height,history,length,life,na,ovary,perennial,plant,pseudostipule,seed,shape,staman,texture
492	wfo-0001031829	success	138	76	46	92	30	0.333	.25,0.7-1,1-2,1.3-1.5,1.5-2,1.5-2.5,2-4,4-4.5,7-10,acute,adaxial,anther,apex,base,branched,calyx,cm,corolla,elliptic,filament,globose,green,greenish-brown,growth,inflorescence,leaf,lobe,margin,mm,occasionally,ovary,pair,pedicel,petiole,pubescent,quadrate,revolute,shrub,simple,sparsely,stem,style,surface,vein,white,x	.5,0.5-2.1,1,1.5-3.5,1.5-4.5,3-5-flowered,3/4,4-8.5,abaxially,absent,adaxially,along,anthesi,ape,apiculae,bae,bark,berry,broadly,capitate,conical,crystalline,deflexed,densely,denser,dia,differing,difoliate,drying,eaf,edicel,eed,epidermi,erect,exserted,free,fruiting,geminat,glabrat,glabrous,immature,known,large-celled,lateral,leathery,like,lobed,lon,long,lower,main,major,minor,minute,minutely,nflorescence,often,older,opposite,overlappin,packed,papillo,papillose,planar,pore,poricidal,portion,ruit,scar,shaped,size,soft,somewhat,stigma,tall,tapering,tear-drop,thick,tip,trichome,tub,tube,tuft,ud,uniseriate,unit,waxy,way,woody,yellowish,ympodial,young	abaxial,alternate,arrangement,branching,characteristic,colour,diameter,form,fruit,glabrate,height,hirsute,history,length,life,midvein,na,peduncle,perennial,plant,primary,pseudostipule,rachi,seed,shape,staman,tertiary,texture,unarmed,venation
493	wfo-0001031832	success	232	135	114	118	21	0.491	0.1-0.3,0.2-1.5,0.3-0.8,0.3-3,0.7-1.5,0.7-1.6,0.7-2,0.8-1.2,1-12,1.1-2.4,1.2-1.6,1.2-2,1.3-4.2,14,2-3.6,2-6,2.5-6.5,3-6.5,3-7,4-20,5.5-10,7-10,9,abaxially,acuminate,acute,adaxially,anther,apart,apex,articulated,attenuate,basal,base,becoming,berry,branched,brown,brownish,bullate,calyx,closely,cm,conical,continued,corolla,dark,deltoid,diameter,due,entire,exserted,ferrugineous,filament,fleshy,flower,fruit,glabrous,globose,granular-tomentose,green,greenish,growth,hair,half,honeycombed,lanceolate,lateral,leaf,length,lobe,margin,midvein,mm,mostly,oblanceolate,obtuse,pale,pedicel,peduncle,petiole,pitted,probably,pubescent,rachi,reniform,reticulate-punctate,ripe,rough,scabrous,shrub,side,simple,smooth,spaced,sparingly,stamen,stem,stipitate-glandular,style,suborbicular,surface,terete,terminal,testa,time,tree,unarmed,vein,violet,white,x,yellow,yellowish	-8,.5-1,/50-1/10,0-150,0.2-0.6,1.2-2.5,1.5-4,1.7-4,1.8-4,1/2-3/4,2-4,2.8-4.8,3.5-7,4-7,5-21,8-25,accrescent,ag,anthesi,apical-lateral,apice,apparently,axe,axillary,ba,bark,blade,blister,blunt-tipped,branch,bud,capitat,chartaceous,connate,decurrent,dehiscing,directed,eaf,eed,evident,extend,few-rayed,forming,free,fruiting,glabrescen,glabrescent,high,indument,inserted,introrse,lackin,large,line,lobed,long,long-,longer,longitudinal,lower,m.,main,minute,mixed,multangulate,nearly,nflorescence,oblong,obovoid,occasionally,older,orbicular,orolla,ovate,partly,perfect,persistent,plurifoliate,pore,porrect-stellat,porrect-stellate,pubescence,rather,ray,relatively,rotate-stellate,ruit,runk,sessile,short-,short-stalked,slit,sometimes,somewhat,soon,sparse,splitting,stellate-pubescent,stigma,subcampanulate,suture,swelling,tamen,thick,thick-stalked,toward,translucent,tube,unarme,unit,usually,vary,way,weakly,whitish,wide,ympodial,young	abaxial,adaxial,arrangement,branching,characteristic,colour,form,height,history,inflorescence,life,na,ovary,plant,primary,pseudostipule,seed,shape,staman,texture,ye
494	wfo-0001031834	invalid_json_followup	150	94	58	92	36	0.387	0.5,0.5-3,0.5-3.5,0.6-1.4,0.8-1,0.8-1.3,1,1.5,1.6-2,6-7,acuminate,acute,anther,apex,base,calyx,cm,corolla,decurrent,deltoid,few-flowered,filament,flattened-reniform,fruit,glabrous,globose,green,greenish-yellow,leaf,less,lobe,margin,minutely,mm,ovary,ovate,pale,pedicel,petiole,pitted,pubescent,scabrous,short,shrub,simple,slender,sparsely,stem,straight,style,surface,tan,tapering,tufted,vein,white,x,yellow	.5,0.5-1,0.9-1.4,1.5-4,1.9-6.5,2.9-7,2/3,6.5-14,accrescent,across,anthesi,apar,apically,apiculate,appear,attenuate,berry,bi-cellular,borne,campanulate,covered,deciduou,deciduous,deflexed,depression,dia,difoliate,eaf,edicel,eed,expanded,eye,free,fruiting,geminat,glabrou,hook,hooked,incrassate,lamina,larger,leaving,like,lobed,lon,long,lower,major,markedly,middle,minor,minute,mound-like,multicellular,naked,nflorescence,often,opposite,papillo,papillose,persistent,planar,pore,poricidal,portion,proximal,ruit,scar,shaped,slightly,small,soon,spaced,speck,stigma,tall,tear-drop,tip,trichome,tube,ud,unevenly,uni-,uniseriate,unit,upper,usually,way,widest,woody,ympodial,young	'',[,``,abaxial,adaxial,alternate,arrangement,branching,characteristic,colour,diameter,form,growth,height,history,inflorescence,length,life,midvein,na,peduncle,perennial,plant,primary,pseudostipule,rachi,seed,shape,staman,tertiary,texture,unarmed,value,venation,{,}
495	wfo-0001031842	success	161	112	80	81	32	0.497	.4,.5,0.1-0.5,0.6-1,0.7-1,1,1-1.5,1-1.8,10-12,10-20,10-30-flowered,2-10,2-3,2.5-3,3-8,4.5-6,7-9,acute,anther,apex,attenuate,axil,base,bearing,beneath,berry,brown,calyx,cm,corolla,cusp,dark,deeply,dia,dry,elliptic,filament,flattened-reniform,glabrous,globose,green,incrassate,lateral,leaf,lobe,long,main,margin,mm,ovary,pair,pale,paler,pedicel,petiole,pitted,pubescent,quadrate,shiny,shrub,simple,slender,sparsely,specimen,stem,straight,style,surface,tapering,terminal,time,tree,trichome,tube,tuft,uniseriate,vein,white,woody,x	.1,.75,0.5-1,0.5-2,1-3.5,1.5-2,2.5-6,3/4,9-15,anthesi,apart,ba,bark,beginning,bi-lobed,capitate,cup-shaped,decurrent,deflexed,densely,differing,difoliate,eaf,edicel,eed,ellipsoid,exserte,exsertion,free,fruiting,geminat,inflorescenc,irregularly,later,leaf-opposed,lobed,lon,lower,major,middle,minor,minutely,near,new,nflorescence,often,older,one,onto,opposite,overtopping,papillo,papillose,pore,poricidal,portion,prominent,reddish,reddish-resinous,reflexed,ruit,scar,shaped,shoot,size,somewhat,soon,spaced,stigma,strongly,tall,tear-drop,tip,ud,unit,way,widest,yellowish,yellowish-whit,ympodial,young	abaxial,adaxial,alternate,arrangement,branching,characteristic,colour,diameter,form,fruit,growth,height,history,inflorescence,length,life,midvein,na,peduncle,perennial,plant,primary,pseudostipule,rachi,seed,shape,staman,tertiary,texture,unarmed,venation,yellowish-white
496	wfo-0001031843	success	245	144	124	121	20	0.506	.5,0.6-1.2,0.8-2,1-2,1-7,1.2-2,1.2-2.2,1.5,1.5-2,1mm,2-3,2.5,3-4,3-7,4-12,5-12,6-9,abaxially,acuminate,adaxially,along,anther,apex,apically,attenuate,basal,base,berry,black,branch,branched,branching,broadly,brown,calyx,canaliculate,caudate,cm,collapsing,completely,conical,corolla,cuspidate,dark,deeply,deltoid,diameter,dilated,discoid,distributed,drying,dull,equal,even,evenly,filament,fine,flat,flower,glabrous,green,honeycomb,leaf,length,liana,like,lobe,long,main,margin,midvein,mm,network,oblique,oblong,obovate,orange,orange-brown,orange-yellow,outline,pair,part,partly,pattern,pedicel,peduncle,pericarp,petiole,pitted,primary,pubescent,rachi,raised,rarely,red,reddish,reveal,rounded,seed,shiny,shortly,shrub,side,slender,slightly,sometimes,sparsely,spheroidal,stem,style,surface,terminal,tertiary,thick-chartaceous,thin,trichome,twice,unarmed,vein,venation,violet,visible,x,young	.2,.3,.6,0-4,0.2-2,0.4-0.5,0.5-1,0.5-1.5,0.7-1.2,0.7-2,1.8-2.5,1/6-1/4,2-4,45-60Â°,5-10,accrescent,age,almost,always,alyx,anthesi,apar,apice,apparently,appressed,around,articulated,bark,becoming,capitate,clearly,cupular,curved,delineated,dendritic,density,detaching,discolorous,domatia,eaf,eed,ellipsoi,entire,erect,eye,fertilisation,finely,flexuous,forming,free,fruiting,hand,inner,largely,leave,len,lengthening,lignified,lobed,longitudinally,loop,looping,lower,m.,much,multiseriate,naked,never,nflorescence,nther,obscure,older,opening,orolla,ovate,papillo,pendulous,perfec,pit,plurifoliat,pore,poricidal,portion,present,prominent,pronounced,protruding,recurve,ribbed,ridged,ruit,scar,see,shallowly,simple,sinus,small,smaller,smooth,soon,spreading,stigma,straight,strongly,stump,surfac,tearing,thickened,tip,tube,tuft,ud,unit,variable,vary,weakly,white,wide,wider,without,ympodial	abaxial,adaxial,arrangement,characteristic,colour,form,fruit,growth,height,history,inflorescence,life,na,ovary,plant,pseudostipule,shape,staman,texture,ye
497	wfo-0001031852	success	155	97	65	90	32	0.419	-8,0.1-1,1-4,1-4.2,1-9,1.4-3,12-35,4-,4-10,4-5,4-6,7-,9-11,acuminate,acute,apex,articulate,base,branched,calyx,cell,cm,conical,corolla,covering,cyme,diameter,dichasial,dichasially,ebracteate,elliptic,elliptic-lanceolate,filament,green,green-white,hair-like,herbaceous,lanceolate,lateral,leaf,light,lobe,long,mm,monochasial,mucilaginous,oblique,oblong,odd-pinnate,ovate-elliptic,ovoid,pedicel,peduncle,perennial,petiole,plant,pubescent,rachi,seed,style,testal,thick,throughout,wall,white	0.5-1.3,0.5-3,1-,1.3-2.5,1.5-3,2-3,2-5.5,2.6-9.5,3-4,3-6-foliat,3-9,3.5-10,5-15,abaxially,abruptly,absen,acumen,adaxially,apical,apically,apiculate,attenuate,connate,decurrent,dehiscent,digestion,diminishing,distal,dorsally,eaf,edge,eed,emoval,enzyme,exceeding,flat,flower,folded,forked,generally,globo,half,honeycomb,interjected,introrse,leaflet,living,lon,lower,lunat,make,maturing,nflorescence,nther,often,orolla,pair,pattern,perfect,plan,poricidally,proximal,reveal,ruit,sessile,seudostipule,short,shortly,size,slit,specimen,stamen,stellate,stigma,straight,tal,tem,terminal,throughou,toward,tuber-bearing,typically,unit,vary,white-crea,wide,without,yellow,ympodial,Â¼	abaxial,adaxial,anther,arrangement,branching,characteristic,colour,form,fruit,growth,height,history,inflorescence,length,life,margin,midvein,na,ovary,primary,pseudostipule,shape,staman,stem,surface,tertiary,texture,unarmed,vein,venation,wet,white-cream
498	wfo-0001031864	success	140	107	76	64	31	0.543	.2,.25,.5,0.5-13.5,0.5-4,0.7-0.8,0.8-1,1-1.2,1-1.8,1-2,1.5-2.5,15-60,2-3,3-3.5,3-pinnate,5-15,7.5-8,abaxially,acute,adaxially,anther,apex,base,calyx,chartaceous,clavate,cm,color,cuneate,deltoid,dense,diameter,emarginate,entire,extra-axillary,filament,flattened,fleshy,flower,fruit,glabrous,herbaceous,lenticular,lobe,margin,middle,mm,moderately,oblique,ovoid-deltoid,papillose,pedicel,peduncle,petiole,pointed,pubescence,pubescent,rachi,rounded,sand-punctate,short,slender,slightly,spaced,sparsely,stem,style,surface,tip,truncate,unbranched,unknown,vein,vine,violet,x	0.2-0.5,0.4-3,0.6-3.5,0.6-4,1-3,1-5,1-6.5,1.2-1.5,1.5,1.5-10,2,2.5-6,5-9,5-merous,accrescent,acuminate,alyx,apar,apical,apiculate,axe,berry,blade,c.,capitat,ciliate,densely,eaf,eed,fine,fruiting,glabrou,hair,lateral,leaflet,like,lon,long,lower,m.,minutely,near,nflorescence,nternode,orolla,perfec,petiolule,plurifoliat,pubescenc,rotate,ruit,scattered,stigma,tamen,tem,terrestria,trichome,tube,typical,unit,vary,wide-diameter,widely,ympodial	abaxial,adaxial,apart,arrangement,branching,characteristic,colour,corolla,form,green,growth,height,history,inflorescence,leaf,length,life,midvein,na,ovary,plant,primary,pseudostipule,seed,shape,staman,terrestrial,tertiary,texture,unarmed,venation
499	wfo-0001031864	success	148	111	78	70	33	0.527	.2,.25,.5,0.5-13.5,0.5-4,1-1.2,1-1.8,1-2,1.5-2.5,15-60,2-3,3-3.5,3-5-celled,3-pinnate,5-15,7.5-8,abaxially,adaxially,anther,apart,apex,apiculate,articulated,base,blue-purple,calyx,center,ciliate,clavate,cm,color,cuneate,deltoid,dense,densely,diameter,entire,extra-axillary,filament,fine,fleshy,flower,fruit,glabrous,hair,herb,lenticular,lobe,long,margin,minutely,mm,oblique,papillose,pedicel,peduncle,pubescence,pubescent,rachi,rounded,scattered,short,slender,somewhat,spaced,sparsely,style,surface,terrestrial,thick,trailing,truncate,unbranched,uniseriate,unknown,widely,woody,x	0.4-3,0.6-3.5,0.6-4,1-3,1-5,1-6.5,1.2-1.5,1.5,2,2.5-6,5-9,5-merou,absent,accrescent,acuminate,acute,ag,alyx,apical,apparently,axe,ba,basally,blade,capitat,connivent,cordate,directed,distally,eaf,eed,emarginate,equal,etiole,fruiting,geminat,interjected,large,lateral,leaflet,longitudinal,lower,m.,near,nflorescence,node,oblong,opening,orolla,perfect,petiolule,plurifoliate,pore,pubescenc,rooting,rotate,simple,slightly,slit,stigma,tamen,tem,tip,tube,unit,vary,weakly,wiry,yellow,ympodial	abaxial,adaxial,arrangement,branching,characteristic,colour,corolla,form,green,growth,height,history,inflorescence,leaf,length,life,midvein,na,ovary,perennial,petiole,plant,primary,pseudostipule,seed,shape,staman,stem,tertiary,texture,unarmed,vein,venation
500	wfo-0001031871	success	185	132	99	86	33	0.535	0.4-2,0.6-1.2,1-2,1.5-11,1.5-2.1,14-22,2-4,3-10,3-4,3-5,3.5-4,33-40,4-6,6-12,6-7,7-9,abaxially,acumen,acute,adaxially,anther,apart,apex,articulated,attenuate,axillary,base,berry,brownish,bud,cell,chartaceous,cm,condition,corolla,covering,dark,deep,diameter,distal,dot,drying,elliptic,filament,flower,forked,fresh,fruit,generally,glabrous,globose,green,green-white,greenish,hair,hair-like,half,herb,high,lanceolate,lateral,linear,lobe,long,make,medium,mm,mottled,mucilaginous,narrowly,odd-pinnate,ovate,ovoid,pedicel,peduncle,petiole,petiolulate,plant,pubescent,purple,ripe,rounded,seed,short,spaced,style,subglabrous,subtending,terminal,testal,thick,throughout,tiny,usually,wall,wet,white,whitish,winged	1.4-2.1,1.5-2,1.6-2.7,2-3,2.9-6,36-44,4-7,5-merou,5.4-12.3,6.5-20.5,7.5-23,adaxiall,ag,alyx,apparently,asymmetric,axe,basiscopic,blade,capitat,clavate,connivent,digestion,dorsally,eaf,edge,eed,end,enzyme,erec,exceeding,flat,folded,geminat,glabrou,hal,homostylous,honeycomb-shaped,interjected,leaflet,lengthening,living,lower,nflorescence,one,orbicular,orolla,pair,perfect,placed,plurifoliate,pore,poricidal,removed,rotate,round,ruit,sessile,seudostipule,side,size,slit,sometimes,specimen,stamen,stigma,stolo,straight,subequal,subglabrou,symmetric,tall,tamen,tem,tip,tissue,tri-,tube,tuber,typically,unit,vary,wide,x,yellow,ympodial	2,abaxial,adaxial,arrangement,branching,calyx,characteristic,colour,form,growth,height,history,inflorescence,leaf,length,life,margin,midvein,na,ovary,perennial,primary,pseudostipule,rachi,shape,staman,stem,surface,tertiary,texture,unarmed,vein,venation
501	wfo-0001031876	success	140	89	58	82	31	0.414	.1,.5,0-flowered,0.5,0.8-1,1-1.5,1.5-2.2,3,5,acute,anther,apex,base,berry,calyx,cm,corolla,decurrent,elliptic,filament,glabrous,globose,green,irregularity,known,leaf,less,lightly,lobe,long,long-acuminate,margin,melastomataceae,minute,mm,oblanceolate,oblique,often,ovary,pair,pedicel,petiole,present,primary,resemble,shrub,simple,slender,slightly,stem,straight,style,tapering,tube,vein,venation,white,winged	1,1-1.6,1-4,27-35,9-15,?,across,anthesi,apiculate,arc,arising,ba,bark,bearing,beneath,bright,closely,convergence,corky,cup-like,dia,differing,eaf,edicel,eed,erect,family,flower,free,fruiting,glabrou,granular,greenish-yellow,immature,lateral,lenticellat,lobed,lower,main,major,member,middle,minutely,nearly,nflorescence,opposite,otherwise,overlappin,papillose,parallel,perpendicular,persistent,point,pore,poricidal,portion,prominent,raised,recurved,reflexed,ruit,running,scar,secondary,shaped,spaced,stigma,styl,tall,tear-drop,time,tip,ud,unifoliat,unit,wide,widest,woody,x,yellow,ympodial,young	-1.6,abaxial,adaxial,arrangement,branching,characteristic,colour,diameter,form,fruit,growth,height,hirsute,history,inflorescence,length,life,midvein,na,peduncle,plant,pseudostipule,rachi,seed,shape,staman,surface,tertiary,texture,unarmed,unifoliate
502	wfo-0001031877	success	216	117	92	124	25	0.426	0.3-1,0.3-1.2,0.5,0.6-1.2,1-1.5,1-3,1.5,1.5-1.9,1.5-2,2,2.5,3-5,3.5-4,6-8,abaxially,abruptly,acuminate,acute,adaxially,anther,apex,basally,base,berry,bright,brown,calyx,cm,corolla,deltate,densely,diameter,ellipsoid,entire,filament,flattened,fruit,furcate,glabrous,globose,greenish,growth,hastate,lateral,line,lobe,lobed,long-acuminate,margin,midvein,minutely,mm,occasionally,often,pair,pale,papillate,pedicel,peduncle,petiole,pitted,plant,plump,primary,pubescent,purple,red,reddish,reniform,ripe,scrambler,seed,simple,slender,slightly,sometimes,sparsely,stem,style,surface,terminal,tinged,tip,triangular,trichome,truncate,uniseriate,usually,vein,vine,white,x	+,.3,.5,0.2,0.3-,0.5-1,0.8-0.9,1,1-3.5,1-4,1.1-,1.8-5,2-,3-6,5-merou,6-10,adaxiall,ag,along,alyx,angled,anthesi,apar,apparently,ark,articulated,ascending,basal,capitate,cell,clavate,conical,connivent,deep,deflexed,distal,dried,eaf,eed,ellipsoidal,enlarged,erect,especially,exposed,exserted,eye,fleshy,flower,free,fruiting,green,ilament,impressed,internal,irregularly,lamina,later,lengthening,like,linear,long,loosely,lower,material,mature,minute,nearly,new,nflorescence,older,orolla,outline,papillo,parallel,part,per,perfect,pericarp,plurifoliat,pointing,pore,poricidal,portion,prominently,pubescence,purplish,rectangular,reflexed,rest,rounded,ruit,scar,semi-woody,shiny,short,shorte,silky,sinuate,sleeve,slit,somewhat,spaced,spreadin,stellate,stigma,strongly,subshru,tem,testal,thin,tube,twinin,ud,uniformly,unit,upper,vary,visible,wall,weak,woody,yello,ympodial,young	abaxial,adaxial,arrangement,branching,characteristic,colour,form,height,history,inflorescence,leaf,length,life,na,ovary,perennial,pseudostipule,rachi,shape,staman,tertiary,texture,unarmed,venation,yellow
503	wfo-0001031880	invalid_json	180	116	89	91	27	0.494	0.5-2,0.7-0.8,1,1-1.3,1-1.5,1.5,2,2-3,2.5-8,3-3.5,3-foliate,3-lobed,4,5-6,6-9,7-9,abaxially,acuminate,acute,adaxially,anther,apex,base,berry,brown,calyx,cell,cm,conical,cordate,corolla,crenate,dark,densely,diameter,elliptic,entire,filament,flattened,fleshy,flower,fruit,glabrous,glandular,globose,green,herb,inflorescence,internodal,irregularly,leaf,lobe,long,margin,mature,mm,narrowly,orange,ovary,ovoid,pair,pale,pedicel,peduncle,petiole,pitted,primary,pubescent,purple,rachi,red,reddish,shallowly,simple,sparsely,stem,straight,style,subshrub,surface,testal,toothed,trichome,truncate,uniseriate,vein,wall,x,â5	.5,0.5-1,1-2,2-4,2-9,3-4-pluri-foliate,4-8,5,age,anthesi,apart,basal,bearing,becoming,broadly,c.,capitate,ciliate,color,crowded,cup-shaped,curved,eaf,edicel,eed,ellipsoid,enlarged,erect,exerted,flush,free,fruiting,gland,gland-tipped,growing,heteromorphic,hollow,horn,lamina,lengthening,less,lon,longest,lower,markedly,maturit,mid-length,middle,minutely,near,nflorescence,nodding,ovate,papillo,papillose,pericarp,plan,pore,poricidal,portion,pubescen,reflexed,ruit,scar,shortest,single,slender,slightly,slit,sometimes,spaced,sparse,spreading,stigma,strongly,terminal,thin,tip,triangular,tube,ud,unicellula,unit,unlobed,upper,upward,widely,widest,woody,yellow,ympodial	'',[,``,abaxial,adaxial,arrangement,branching,characteristic,colour,form,growth,height,length,midvein,na,plant,pseudostipule,seed,shape,staman,tertiary,texture,unarmed,value,venation,{,}
504	wfo-0001031881	success	168	106	77	91	29	0.458	.5,0.5-0.7,0.5-1,1-1.3,1-1.5,1-7,1.2-6,1.5-2.5,1/3,10-12,2,3.5-4,5-6,acute,anther,apex,attenuate,base,beneath,branched,broadly,brown,calyx,cm,corolla,dark,decurrent,deflexed,deltoid,densely,dia,distal,elliptic,erect,filament,fruit,glabrous,globose,golden,golden-puberulent,golden-pubescent,green,inflorescence,leaf,lightly,lobe,long,margin,minutely,mm,obovate,opposite,ovary,ovoid-reniform,pair,papillose,pedicel,petiole,pitted,puberulent,pubescent,rounded,shape,shrub,small,soon,sparsely,stem,style,surface,tip,tree,usually,vein,white,winged,x	0.1-0.5,0.2,0.2-0.6,0.4-1,10-30,2-9,3-19,3/4,7-14,absent,along,anthesi,apar,apparent,axil,ba,bark,branch,bud,campanulate,capitate,constriction,differing,difoliate,dry,drying,eaf,edicel,eed,either,ellipsoid,evenly,exserted,fleshy,free,fruiting,geminat,greyish-brow,incrassate,inflorescenc,junction,lateral,like,lobed,lon,lower,main,major,material,maturity,middle,midrib,minor,minute,nflorescence,occasionally,older,one,orbicular,papillo,planar,pore,poricidal,portion,puberulen,rest,ruit,scar,shaped,simple,size,slender,slightly,somewhat,spaced,stigma,straight,strong,tall,tapering,tear-drop,trichome,tube,ud,uniseriate,unit,way,widest,woody,ympodial,young	abaxial,adaxial,alternate,arrangement,branching,characteristic,colour,diameter,form,greyish-brown,growth,height,history,length,life,midvein,na,peduncle,perennial,plant,primary,pseudostipule,rachi,seed,staman,tertiary,texture,unarmed,venation
505	wfo-0001031886	success	169	106	78	91	28	0.462	-4,-9,0.5-1,1-1.5,1-4,1.2-2.5,2,2-2.5,2-5,2.0-2.5,3.0,5-6,6-8,9-10,acuminate,along,anther,apex,arising,attenuate,axil,axillary,base,berry,bright,broadly,brown,calyx,cm,completely,conical,corolla,deltate,diameter,elliptic,filament,fleshy,fruit,glabrous,green,greenish,half,lobe,lower,margin,minutely,mm,occasionally,ovary,ovoid-reniform,pair,papillate,papillose,pedicel,petiole,pinnate,portion,primary,purple,rachi,raised,rugose,seed,shape,shrub,simple,single,somewhat,style,surface,tip,triangular,trichome,uniseriate,vein,white,woody,x	-1.2,-25,.5,0,0.1,1.5-2,10-40,2-3,2-4,20-30,3-6,4,4-15,5-10,5-ridged,6-20,abaxially,abruptly,absent,adaxially,anthesi,anticlinal,basal,beak,bearing,bud,capitate,cell,clavat,commonly,distinctly,dry,eaf,earl,edicel,eed,either,em,epidermal,equal,erec,exserted,flower,free,fruiting,irregular,lanceolate,lateral,le,leaflet,lobed,long,narrowed,near,nearly,nflorescence,noddin,node,oblique,open-conical,papillae,per,petiolule,poricidal,projection,reddish,reflexed,ripe,ruit,scar,scattered,similar,sinuous,smaller,smelling,sparse,specimen,stigma,strongly,terminal,thickening,time,tub,tube,ud,unifoliat,unit,usually,wintergreen,without,ympodial	1,abaxial,adaxial,arrangement,branching,characteristic,colour,form,growth,height,history,inflorescence,leaf,length,life,midvein,na,nodding,peduncle,plant,pseudostipule,staman,stem,tertiary,texture,unarmed,unifoliate,venation
506	wfo-0001031895	success	160	98	71	89	27	0.444	-1.5,1-1.5,1.5-3,2-2.5,2.5-3,3-4,3.5-6,4,4-5,5,5-6,6-7,6-9,acute,anther,apex,attenuate,base,beneath,berry,bluish,calyx,cm,completely,conical,corolla,dark,deltate,diameter,elliptic,entire,erect,filament,fleshy,glabrous,globose,green,growth,less,lobe,margin,matte,minutely,mm,occasionally,once-branched,ovary,overlapping,ovoid,pair,pale,papillate,pedicel,peduncle,petiole,pitted,primary,reniform,revolute,shiny,shrub,simple,slightly,stem,stout,style,surface,tan,vein,violet,x	0.5,0.5-1,0.5-2,1.5-2,1.5-6,3-10,3-8,4.5-16.5,5-8,age,anthesi,apparently,articulating,bark,blac,broadly,campanulate,capitate,cell,cup-shaped,densely,drying,eaf,eed,ellipsoid,emarginated,enlarging,erec,exerted,exfoliating,expand,flower,fragrant,free,fruiting,glabrou,immature,inflorescenc,intensely,irregular,leaf-opposed,leafy,leaving,lengthening,lobed,lower,new,nflorescence,older,papillat,part,patch,peeling,peg,perfect,pericarp,planar,plurifoliat,pore,poricidal,portion,reddish,ruit,scar,shoot,short,sinuate,slender,slit,small,somewhat,stigma,straight,strongly,terminal,testal,thick,thin,tip,tree,tub,tube,ud,unit,way,white,woody,ympodial,Â¼-1/2	abaxial,adaxial,arrangement,branching,characteristic,colour,form,fruit,height,history,inflorescence,leaf,length,life,midvein,na,perennial,plant,pseudostipule,rachi,seed,shape,staman,tertiary,texture,unarmed,venation
507	wfo-0001031897	success	264	155	136	128	19	0.515	.5,0.1-0.5,0.15,0.4-1.1,0Â°,1.1,1.3-2,1.7-3,2-4,2/3,4-5,5-6,6-9,abaxial,abaxially,absent,acute,adaxial,adaxially,along,anther,anthesi,apex,apically,appearing,attenuate,axillary,base,bendy,berry,black,brachyblast,branch,brown,calyx,chartaceous,clustered,cm,condensed,conical,coriaceous,corolla,cuneate,dark,densely,developed,diameter,dilated,distributed,dry,drying,dull,elliptic,entire,epiphyte,erect,even,evenly,except,extending,faint,filament,filiform,foliaceous,fruit,glabrous,green,grey,hair,known,lamina,lanceolate,lateral,leaf,least,light,linear,lobe,long,longitudinal,margin,mauve,membranous,midvein,mm,multicellular,oblong,obtuse,occasionally,one,orange,orange-brown,ovate,ovoid,pair,partly,pedicel,peduncle,pericarp,petiole,plant,pointed,primary,pubescent,raised,rarely,reddish,revolute,ridge,ridged,shoot,short,shrub,simple,slender,slightly,sometimes,sparse,sparsely,stem,style,sunk,surface,terminal,tertiary,thick,thin,unarmed,usually,vein,venation,visible,weakly,white,x,young	.1,.8,0-1,0.2-0.4,0.5-1,0.5-3,0.6,0.8-1.5,1,1-1.5,1-2,1-2.5,1.5,1.5-8,13,462.,8,accrescent,age,almost,alyx,apar,apparently,appendage,arising,aristate,articulated,bark,boiteau,branched,cell,clavate,clearly,concolorous,connate,covering,curved,datum,dehiscing,delineated,dendritic,dense,developing,development,divided,domatia,dorsal,dorsifixed,eaf,earliest,ed,enlarged,equal,eye,fine,flower,free,fruiting,immature,indistinc,inner,inside,larger,lengthening,like,lobed,longitudinally,looped,lower,m.,main,margi,minute,minutely,multiseriate,naked,never,nflorescence,nther,obconical,oblon,occasional,orolla,outside,overlapping,papillose,part,pendulous,perfec,persisting,plurifoliat,pore,poricidal,portion,prominent,pronounced,protruding,reach,ribbed,ruit,scar,secondary,see,seen,side,sinus,smaller,smoot,smooth,stigma,stump,subulate,tearing,terete,tip,toward,trichome,tube,ud,unbranched,unicellular,unit,vary,well-developed,wide,winged,wrinkle,ympodial	arrangement,branching,characteristic,colour,form,growth,height,history,inflorescence,length,life,na,ovary,rachi,seed,shape,staman,texture,true
508	wfo-0001032157	success	136	97	67	69	30	0.493	.5,0.5-1,0.6-1,0.75-1,1-3,2-3,2.2,5-15-flowered,5-9,7-9,acute,anther,apex,base,beneath,berry,calyx,cm,completely,corolla,crystalline,decurrent,deflexed,deltoid,dia,dry,elliptic,filament,glabrous,globose,golden,green,lateral,leaf,live,lobe,long,main,margin,minutely,mm,ovary,ovoid-reniform,pair,paler,papillose,pedicel,petiole,pitted,plant,reddish,rounded,shiny,shrub,simple,slender,stem,straight,style,surface,tapering,tip,tube,vein,white,x,yellowish	.75,0.25,1.9-2.2,2-5,3-6,5-8,9-17,anthesi,apart,bark,becoming,beginning,bi-lobed,caly,differing,difoliate,eaf,edicel,eed,evenly,exserted,free,frui,fruiting,geminat,glabrou,incrassate,inflorescenc,less,living,lobed,lon,longitudinal,lower,major,middle,minor,nearly,nflorescence,obscure,older,one,opposite,papillo,peeling,persistent,pore,poricidal,portion,raised,reflexed,ruit,scar,shaped,size,slightly,soon,spaced,stigma,strip,tall,tear-drop,translucen,ud,unit,widest,woody,ympodial,young	abaxial,adaxial,alternate,arrangement,branching,characteristic,colour,diameter,form,fruit,growth,height,history,inflorescence,length,life,midvein,na,peduncle,perennial,primary,pseudostipule,rachi,seed,shape,staman,tertiary,texture,unarmed,venation
509	wfo-0001032161	success	146	96	66	80	30	0.452	0.4-1.2,0.5-1,0.75-1,0.8-1,1-3,1.2-1.3,2-7,2-8-flowered,2.5-3,3.5-4,acute,adaxially,anther,apex,base,berry,calyx,cm,corolla,deltate,dendritic,densely,drying,elliptic,filament,filiform,glabrous,globose,golden,green,inflorescence,internodal,leaf,lobe,many,margin,minutely,mm,mustard,opposite,ovary,ovoid-reniform,pale,pedicel,petiole,pitted,plant,pubescent,quadrate,revolute,shoot,short,shrub,simple,sparsely,stem,style,sulcate,surface,tan,thin,trichome,vein,white,yellow,yellowish	.5,0.7-4,1-1.5,1-11,1.4-2,?,abaxially,adaxiall,anthesi,apical,area,ba,bark,beneath,branched,brownish-blac,closely,color,conical,coriaceous,dark,deflexed,delicate,dia,difoliate,eaf,edicel,eed,ellipsoid,exserted,free,fruiting,giving,hanging,lamina,later,like,lobed,long,lower,merely,middle,minute,nearly,nflorescence,obovate,occasionally,older,overlappin,papillose,pericarp,persistent,plurifoliate,pore,poricidal,portion,projection,reflexed,rest,ruit,scar,shaped,shiny,spaced,stigma,strongly,styl,tall,tear-drop,tip,tub,tube,ud,uniseriate,unit,usually,widest,x,ympodial,young	0.5,6,abaxial,adaxial,alternate,arrangement,branching,characteristic,colour,diameter,form,fruit,growth,height,history,length,life,midvein,na,peduncle,primary,pseudostipule,rachi,seed,shape,staman,tertiary,texture,unarmed,venation
510	wfo-0001032165	success	197	93	67	130	26	0.34	0.25-0.5,0.3-1,0.75-1,1-1.2,1-1.5,1-2,2-2.5,2.5-3.5,3-6,5-6,5-7,abaxial,acute,adaxial,anther,apex,base,berry,broadly,brown,calyx,cm,corolla,dark,deltoid,densely,elliptic,erect,filament,glabrous,globose,golden,golden-pubescent,green,inflorescence,leaf,lobe,margin,minutely,mm,obovate,occasionally,once-furcate,ovary,ovoid-reniform,pair,pale,pedicel,petiole,pitted,plant,puberulent,purplish,ripe,shape,simple,stem,style,surface,tapering,tinged,tree,vein,white,winged,x,young	.25,.5,0.1,0.1-0.3,1.5-4,10-25,3-4,3.5-8.5,4-6,5-15,5-30-flowered,5-9.5,8-9,along,anthesi,apparent,appearing,ba,bark,beginning,beneath,bud,capitate,center,closely,continued,cucullate,cup-shaped,deciduous,decurrent,denser,dia,differing,difoliate,distal,dry,due,dull,eaf,edged,edicel,eed,ellipsoid,end,entire,even,expansion,exserted,exsertion,free,fruiting,geminat,golden-puberulent,greyish-brown,immature,inflorescenc,later,lateral,less,like,live,lobed,lon,long,lower,main,major,markedly,medial,middle,midrib,minor,minute,near,nearly,nflorescence,node,older,one,onto,opposite,orbicular,overlapping,paler,papillo,papillose,planar,pore,poricidal,portion,presence,prominent,rather,rest,ridge,rounded,ruit,scar,shaepd,single,size,slender,slightly,slow,small,smoot,spaced,specimen,stigma,stout,straight,stripe,strongly,swollen,tall,tear-drop,terminal,thickened,time,tip,trichome,tub,tube,ud,uniseriate,unit,widest,woody,yellowish,ympodial	alternate,arrangement,branching,characteristic,colour,diameter,form,fruit,growth,height,history,length,life,midvein,na,peduncle,perennial,primary,pseudostipule,rachi,seed,staman,tertiary,texture,unarmed,venation
511	wfo-0001032167	success	163	116	87	76	29	0.534	.5,0.5-1,0.5-1.5,0.5-2.5,1-2,1-2.5,1-3,1-5,1.5,10-35,12-20,2-4,2-7,2-foliate,3-6,3-7,4-6,5-15,7-10,absent,acute,anther,apex,base,berry,brown,calyx,cell,chartaceous,ciliate,cm,decurrent,densely,diameter,dm,drying,elliptic,elliptic-ovoid,entire,few-,filament,flower,forming,fruit,glabrous,globose,growth,hair,herb,immature,linear-lanceolate,lobe,lowermost,many-branched,margin,maturing,membranaceous,mm,moderately,nearly,netlike,obtuse,often,pedicel,peduncle,per,petiole,projection,pubescent,purple,rachi,raised,rounded,seed,semitransparent,staman,style,surface,unbranched,unit,upper,usually,vein,wall,white,x,yellow	0.75-3,1,1-2-celled,1-7,10-20,4-10,abaxially,abundant,adaxiall,adaxially,along,appressed,axe,blade,closely,common,connected,cordate,curved,dehiscing,dense,denser,eaf,eed,emarginat,explosively,flat,flattened,frui,geminat,geniculate,growt,held,interpetalar,larger,long,longer,lower,lying,maturit,mesocarp,near,new,nfloresence,notch,oblong,older,one-celled,orolla,placenta,pressure,pubescen,rotate,ruit,shorter,slightly,small,smaller,sometimes,sparsely,stamen,stigma,straight,tal,tamen,tem,tissue,triangular,tube,twisted,two-celled,vary,watery,wid,woody,ympodial	abaxial,adaxial,arrangement,branching,characteristic,colour,corolla,form,geminate,height,history,inflorescence,leaf,length,life,midvein,na,ovary,perennial,plant,primary,pseudostipule,shape,stem,sympodial,tertiary,texture,unarmed,venation
512	wfo-0001032176	success	177	101	73	104	28	0.412	.5,0.5,0.5-0.7,0.5-0.75,0.8-6,1-1.2,1-10,1.5-1.6,1.5-2.5,1/2,2-3,3-3.5,3-4,6,6-10,7,anther,apex,apical,arising,attenuate,axil,axillary,base,berry,branched,calyx,cm,conical,corolla,densely,diameter,elliptic,filament,glabrous,green,greenish,grey-brown,greyish,herb,leaf,lobe,long-papillose,lower,margin,mm,obtuse,occasionally,onto,ovary,ovoid-reniform,pale,pedicel,petiole,pinnate,projection,pubescent,quadrate,rachi,rounded,seed,separate,single,sinuous,sparsely,stem,style,thickening,vein,white,winged,without,x	0,0.42,0.5-1,0.8-1,1.5-6,100,2.5-10,3-15,3-7,5-6-celled,adaxially,adhering,along,anthesi,apart,attaining,basal,beak,becoming,capitat,cateniform,cell,containing,copiously,creeping,cucullate,denser,drying,eaf,edicel,eed,ellipsoid,epidermal,equal,especially,exserted,fallen,filiform,flower,free,fruiting,globose,hangin,inflorescenc,lateral,leaflet,lengt,lengthening,like,lobed,log,long,minute,minutely,nearly,nflorescence,nodding,node,obovate,often,open,pair,papillose,per,petiolule,pore,poricidal,portion,reflexed,rest,rooting,ruit,scar,simple,size,slightly,slit,smaller,somewhat,soon,spaced,stigma,strait,strongly,tem,terminal,tightly,time,tip,tree,trichome,truncate,trunk,tub,tube,ud,ultimate,unevenly,unifoliat,uniseriate,unit,wall,whit,ympodial	abaxial,adaxial,arrangement,branching,characteristic,colour,form,fruit,growth,height,history,inflorescence,length,life,midvein,na,peduncle,perennial,plant,primary,pseudostipule,shape,staman,surface,tertiary,texture,unarmed,venation
513	wfo-0001032187	success	139	110	75	64	35	0.54	-4,-4.2,-5,-9,0.5,0.5-,0.5â1,0.6â1.3,1.1â3.2,1.6â2.1,1.8â2,100,22,3.1â3.5,3â3.2,3â4,5â7,7â11,9,acuminate,acute,adherent,anther,apex,base,berry,broadly,brown,brownish,cm,corolla,dark,dull,eglandular,elliptic,entire,equal,erect,filament,glabrescent,globose,green,hair,herb,hooked,leaf,light,lobe,margin,mature,mm,numerous,occasionally,ovate,pedicel,peduncle,per,petiolate,petiole,plant,purple,simple,sometimes,spreading,stem,straight,style,sub-glabrous,texture,tinged,triangular,truncate,yellowish,Â±,Â±1	-11,-2.1,0.1â1.4,1.3â1.8,1.8â2.8,1â1.7,24.6â26.3,2â9,5-merous,alyx,angular,ape,appressed,aromatic,blade,branch,changing,consisting,cyme,di-foliate,dia,eaf,eed,flowered,forked,fully,geminat,granule,hite,hydrated,long,lower,many,marked,nflorescence,obovate,penden,pentagonal,perfec,persistent,pollen,predominantly,presen,protruding,rarely,ridge,ruit,running,sclerotic,short,small,soft,sparse,stage,stellate,tooth,unit,well,widest,wing,yellow,ympodial,Âµm,Ã	abaxial,adaxial,arrangement,branching,calyx,characteristic,colour,diameter,form,fruit,glabrous,greyish,growth,height,hirsute,history,inflorescence,length,life,midvein,na,ovary,pendent,primary,pseudostipule,rachi,seed,shape,staman,surface,tertiary,unarmed,vein,venation,white
514	wfo-0001032206	success	216	127	103	113	24	0.477	-2,0.8â1.2,00â200,1,1.1â1.2,1.5â2.5,11â22,1â2.3,1â3,2.5â3.3,2.7â3.5,2â2.5,3.5â9,3â4,4.5â5.8,4â6,5â6,5â9,7â10,abaxially,acute,adaxially,anther,apex,apparently,approximately,armed,articulated,base,berry,branched,calyx,clearly,cm,cream,cuneate,dark,deltate,diameter,elliptic,erect,filament,flattened-reniform,foliaceous,fruit,glabrescent,glabrous,green,green-brown,infructescence,lateral,leaf,length,lobe,lobed,long,long-styled,margin,marking,maturity,mauve,midvein,mm,moderately,obtuse,orange-brown,ovate,pair,pale,pedicel,peduncle,pendent,per,petiole,plant,primary,purple,rarely,ray,short-styled,shrub,sometimes,spherical,stellate,stellate-pubescent,stem,style,surface,tertiary,toward,trichome,truncate,unarmed,usually,vein,venation,visible,weakly,white,wide,yellow,yellow-orange,young	-0.8,-20,-5,..,.2,.5,0,0.2,0.2â0.4,0.2â0.5,0.5â1,0â20,0â30,0â5,1.2â2.2,1.5â2,1/3,1/4â1/2,1/4â1/3,1/6,10â80,1â2,1â4,2â3,2â8,30â80,5-merous,5â15,5â20,5â8,6â10,6â15,6â8,8â20,accrescent,alyx,andromonoecious,apar,apart,apically,bark,blade,bluntly,broad-deltate,brow,chartaceous,concolorous,connivent,covering,curved,discolorous,distal,distance,drying,eaf,eed,equal,extending,flattened,flower,free,fruiting,functionally,gently,hermaphroditic,heterostylous,lengt,lobing,longer,lowermost,mal,mature,midpoint,nflorescence,often,older,one,open,orolla,ower,pendulous,pericarp,plurifoliat,poricidal,porrect,portion,prickle,reflexed,scar,secondary,sessile,side,slender,smooth,spaced,sparsely,spreading,stalk,stalked,stout,straight,tamen,tapering,time,tip,tube,uit,ung,unit,variously,vary,woody,ympodial	0.5â1.5,abaxial,adaxial,arrangement,branching,characteristic,colour,corolla,form,growth,height,history,inflorescence,life,na,ovary,perennial,plurifoliate,pseudostipule,rachi,seed,shape,staman,texture
515	wfo-0001032209	success	257	127	104	153	23	0.405	-30+,0.5-1,1-1.5,1-2-celled,1-6,1.5-6,10-13,2-3,2-3-lobed,2-5,2/3,20-30,3-7,4-20,5-8,6-8,acute,adaxial,along,anther,apex,appearing,arching,basal,base,berry,blue,branched,broadly,brown,calyx,cell,cm,colour,conical,conspicuously,cordate,corolla,dark,dendritic,densely,diameter,ecuador,elliptic,entire,evenly,filament,flattened-reniform,glabrous,globose,growth,hairy,inflorescence,lamina,lateral,leaf,length,like,lobe,margin,metallic,midvein,minutely,mm,narrowly,occasionally,ovate,pair,pedicel,peduncle,per,petiole,pinnately,pinnatifid,primary,puberulent,pubescent,purple,red,reddish,rest,several,shiny,simple,sometimes,somewhat,stem,style,surface,terminal,testa,time,tiny,trichome,truncate,uniseriate,vein,vine,violet,w,wall,white,woody,x	-11,-20,.5,0.3,0.5,1,1-2,1.5,1.5-,1.5-2,1.5-2.5,100,12-16,2,2.5-,3-9,4,5-merou,6-15,absent,ag,alyx,anthesi,apart,apiculae,apparently,ark,articulated,axi,berr,bilobed,branch,bu,canopy,capitate,cast,chartaceous,climbing,connivent,coriaceous,cucullat,deeply,deltate,denser,distally,distinct,dried,eaf,early,eed,ellipsoid,enlarged,equal,erect,especially,exerted,finely,fleshy,flower,flowering,free,fruiting,geminat,giving,glabrescen,groove,hanging,hastate,held,hollow,ilament,keeled,large,leathery,leaving,lengthening,less,lobed,long,longer,longest,lower,markedly,material,mean,mere,middle,midrib,minute,mixture,near,nearly,new,nflorescence,nipple,often,older,one,orolla,papillae,papillat,papillate,part,particularly,peg,pentagonal,perfect,pericarp,planar,plurifoliate,pointed,pore,poricidal,portion,probably,pubescence,rhachi,rim,ripe,ruit,sagittate,scar,sleeve,slit,small,spaced,sparser,spreading,stellate,stigma,stout,tapering,tem,testal,thin,third,tightly,tip,tube,twinin,twining,ud,unequal,unit,upper,usually,variable,vary,weight,widest,within,yellow,ympodial	60-100,abaxial,arrangement,branching,characteristic,form,fruit,height,history,life,na,ovary,perennial,plant,pseudostipule,rachi,seed,shape,staman,tertiary,texture,unarmed,venation
516	wfo-0001032232	success	137	103	73	64	30	0.533	.5,0.1,0.25,0.6-3,0.8-1,1-3,2-2.6,20-100-flowered,5-6,abruptly,anther,apex,attenuate,base,berry,calyx,cm,corolla,decurrent,deflexed,dia,distally,elliptic,erose,filament,filiform,glabrous,globose,green,greenish-brown,immature,irregular,leaf,less,light,lobe,long,long-acuminate,margin,minute,minutely,mm,narrowly,occasionally,onto,ovary,ovoid-reniform,pair,pale,papillose,pedicel,petiole,pitted,prominent,raised,revolute,rounded,shrub,simple,slightly,somewhat,sparsely,stem,straight,style,subshrub,surface,tube,umbonate,undulate,vein,widening,winged	0.5,0.5-1,1.8-2,18.8-27.5,2,3/4,4.8-7.3,?,age,anthesi,ba,bark,becoming,clavate,closely,cup-shaped,dark-papillose,eaf,edicel,eed,erect,evenly,exfoliatin,flower,free,fruiting,lateral,lenticellate,lightly,lobed,lower,main,middle,midrib,nflorescence,node,opposite,overlappin,packed,paler,papillo,pore,poricidal,portion,reflexed,ruit,scar,shaped,short-styled,stigma,tall,tear-drop,ti,tip,translucent,tub,ud,unifoliat,unit,way,wide,widest,woody,ympodial	abaxial,adaxial,arrangement,branching,characteristic,colour,diameter,form,fruit,growth,height,history,inflorescence,length,life,midvein,na,peduncle,plant,primary,pseudostipule,rachi,seed,shape,staman,tertiary,texture,unarmed,unifoliate,venation
517	wfo-0001032233	success	160	115	82	78	33	0.512	0.3-2,1-1.5,1-2,1-3,1.5-2.5,10-15,157,2-15,2-3,2-5.5,2-6,2.5-4,20-100+,3-15,3-4,3-5,3.5-4,4-5,5-6,acuminate,acute,adaxial,almost,apex,articulated,basal,base,branched,calyx,chartaceous,cm,cordate,dark,densely,diameter,ellipsoidal,entire,flattened,fleischmann,fleshy,flower,fruit,glabrate,glabrescent,glabrous,glandular-puberulent,green,leaving,lobe,long,longitudinal,margin,mm,moderately,obtuse,orange,ovate,ovoid,pedicel,pedicellar,peduncle,petiole,puberulent,pubescent,purple,remnant,shallowly,simple,slightly,sparsely,stripe,style,subcoriaceous,tip,tree,triangular,truncate,unbranched,vein,x,yellow,yellow-green	0-2,2-4,25-40,3-4.5,4-18,4-7,4-foliat,5-16,6-25,8-12,abaxially,absen,absent,adaxially,aggregate,apart,ape,axe,bent,beyond,biglandula,blade,brow,cell,connective,connivent,convex,coriaceous,cylindrical,dilated,directed,distally,eaf,eed,equal,especially,exceeding,exserted,globose,laterally,lon,lower,narrowly,nflorescence,nther,oblong,orolla,perfect,pore,present,projection,puberulen,rachise,radiu,ruit,shorter,small,somewhat,spaced,stamen,stellate,stigma,stone,subpeltiform,tal,tem,thecae,time,tomento,toward,tube,ud,unit,vary,white,wide,yellow-orange,ympodial	abaxial,anther,arrangement,branching,characteristic,colour,corolla,filament,form,growth,height,history,inflorescence,leaf,length,life,midvein,na,ovary,perennial,plant,primary,pseudostipule,rachi,seed,shape,staman,stem,surface,tertiary,texture,unarmed,venation
518	wfo-0001032259	success	202	124	103	99	21	0.51	.5,0-2,0-20,0-4,0.45-0.6,0.5-0.8,0.5-1.5,0.7-1.1,0.9-1.2,1-2.5,1.5-4.5,10-30,15-40,2-2.5,2.2-3,20-60,3-4,4-5,5.5-8,abaxial,abaxially,acute,adaxial,almost,anther,apex,apically,apparently,articulated,base,becoming,berry,branched,brown,brownish,calyx,cm,cordate,cuneate,dark,deltate,densely,diameter,difoliate,dull,evenly,filament,flattened-reniform,flower,fruit,geminate,glabrous,green,infructescence,lateral,leaf,length,lobe,lobed,long,lower,margin,maturity,mauve,midvein,mm,orange,orange-brown,ovate,pair,pedicel,peduncle,per,petiole,prickle,prickly,primary,pubescent,recurved,red,shrub,simple,sparsely,spherical,stellate,stellate-pubescent,stem,style,surface,terminal,tertiary,toward,trichome,unarmed,unit,vein,venation,visible,white,wide,yellow,yellow-green,young	-4,/3,/4,0,0-10,0-5,0.1-0.2,0.1-0.3,0.15-0.3,0.8-1.3,1-1.8,1-2,1/2,1/3,1/4-1/3,1/6-1/5,2-4,2-5,3/,4,4-6,4-9,5,5-30,5-merous,7-16,7-8,9-22,acut,alyx,apar,apart,bark,blade,broad-deltate,chartaceous,conical,connivent,discolorous,distance,drying,eaf,eed,elongating,equal,erect,extending,flattened,free,fruiting,fully,glabrescent,gland,green-brow,hair,longer,mature,midpoint,minute,moderately,nflorescence,older,one,open,opening,orolla,oung,pendulous,perfec,pericarp,poricidal,porrect,portion,prickl,ray,reduced,rounded,ruit,scar,sessile,shorter,side,slender,smooth,sometimes,spaced,spreading,straight,strongly,tamen,tapering,terete,time,tip,tube,vary,way,woody,ympodial	3/4,arrangement,branching,characteristic,colour,corolla,form,growth,height,history,inflorescence,life,na,ovary,perennial,plant,seed,shape,staman,sympodial,texture
519	wfo-0001032260	success	216	141	115	101	26	0.532	-1.5,-10,-8,0-,0-10,0-20,0-5,0-8,0.1-0.3,0.1-0.4,0.2-0.5,0.5-2,0.6-0.8,0.7-1.5,0.8-1.1,1-1.7,1-3,1-5,1-6,10-30,2,2-20,2.5-3,2.5-3.5,3-5,3-9,6-10,abaxial,acuminate,acute,adaxial,anther,apex,apically,apparently,articulated,base,berry,branched,calyx,cell,cm,cuneate,curved,deltate,densely,diameter,dull,elliptic,erect,eye,filament,flattened,flattened-reniform,fruit,glabrous,glaucous,green-brown,infructescence,lateral,leaf,length,lobe,lobed,long,margin,maturity,mauve,midpoint,midvein,mm,naked,orange-brown,outline,ovate,pair,pale,pedicel,peduncle,per,petiole,pit,porrect,prickle,prickly,primary,pubescent,purple,raised,ray,red,rounded,sessile,shallowly,shrub,simple,small,sparsely,spherical,stalk,stalked,stellate-pubescent,stem,style,subentire,surface,terminal,tertiary,trichome,vein,venation,visible,wide,yellow,yellow-green	-0.5,-3,.1,/5,0-0.5,0.1,0.15-0.3,0.2,0.4,0.5-0.8,0.5-5,0.7,1.2-1.7,1.5-4,1/2,1/3,1/3-1/2,1/3-1/5,2-4,2-5,2.5,3-10,3-8,4-,5-,5-20,5-merous,6-8,7-15,abaxially,acuminat,alyx,apar,apart,bark,blade,broad-deltate,chartaceous,connivent,difoliate,discolorous,distance,drying,eaf,eed,elongating,equal,extending,flower,free,fruiting,geminat,glabrescent,glabrou,gland,globular,gray-brow,lon,long-styled,longer,lower,mature,moderately,narrow-ovate,nflorescence,older,one,open,orolla,oung,pendulous,perfec,pericarp,poricidal,portion,prickl,reduced,reflexed,ruit,scandent,scar,shorter,side,slender,smooth,spaced,spreading,stellate,strongly,tamen,tapering,terete,time,tip,tube,unit,variously,vary,way,woody,ympodial	arrangement,branching,characteristic,colour,corolla,form,greyish,growth,hair,height,hirsute,history,inflorescence,life,na,ovary,plant,pseudostipule,rachi,seed,shape,staman,texture,unarmed,white,width
520	wfo-0001032264	success	183	125	92	91	33	0.503	0.25-0.75,0.5-1,0.6-2.2,0.8-10,1-1.5,1.2-2,1.5-1.8,10-22,2-50-flowered,3,3-15,4.5-5,acuminate,acute,anther,apex,apiculate,bark,base,branched,broadly,bud,calyx,cell-layer,closely,cm,corolla,deflexed,densely,elliptic,epidermal,exserted,filament,flattened-reniform,flower,glabrous,globose,green,hair,incrassate,inflorescence,layer,leaf,lobe,long,margin,minutely,mm,narrowly,occasionally,one,opposite,ovary,overlapping,ovoid,pair,pale,pedicel,peeling,petiole,pitted,plant,pubescent,red-papillose,reddish-tan,revolute,rounded-deltoid,scar,several,sheet,shrub,simple,slender,soon,spaced,sparsely,stem,straight,style,surface,tapering,thick,time,transversely,tree,trichome,tube,uniseriate,vein,white,x,yellowish-brown	.2,.5,0.25-0.5,0.8-4,1.8-3,2-6,3-9,5-9,6-17,along,anthesi,apar,appearing,ba,berry,bullate,cell,cup-like,curling,deciduous,dia,differing,difoliate,dry,eaf,edicel,eed,fleshy,free,fruiting,geminat,gnarled,greyi,habitat,lamina,large,larger,lateral,like,live,lobed,lon,lower,main,major,material,middle,minor,minute,multiseriate,nearly,nflorescence,often,older,papillo,papillose,parallel,planar,pointed,pore,poricidal,portion,primarily,prominent,quite,raised,reddish,ruit,scattered,shaped,sheltered,short,size,small-capitate,small-celled,somewhat,stigma,tall,tear-drop,tip,trunk,ud,unit,upper,weak,whitish,wide,widest,woody,ympodial,young	0.2,4,4-8,abaxial,adaxial,arrangement,branching,characteristic,colour,diameter,exsertion,form,fruit,greyish,growth,height,history,length,life,midvein,na,number,peduncle,primary,pseudostipule,rachi,seed,shape,staman,tertiary,texture,unarmed,venation
521	wfo-0001032274	success	192	112	87	105	25	0.453	0,0.15-0.2,0.5-0.7,0.5-1,0.5-1.5,0.7-1.8,1-1.2,1-1.5,1-3,2,2-7,3-4,5-7,acuminate,acute,anther,anthesi,apex,apparently,arching,axillary,base,berry,brown,calyx,cm,corolla,deltate,densely,diameter,elliptic,entire,filament,filiform,flattened-reniform,glabrous,globose,green,grey,growth,inflorescence,lanceolate,leaf,lobe,long,margin,minutely,mm,nodding,occasionally,often,once-branched,pair,pedicel,peduncle,per,pericarp,petiole,pitted,plurifoliate,primary,pubescent,purple,quadrate,red,reddish,ripe,rounded,shape,shiny,shoot,short,shrub,simple,sometimes,sparsely,stem,style,surface,terminal,thin,tinged,truncate,vein,violet,white,x	.5,0.5,0.9-1,1.5-2,2-3.5,3-10,3-5,3-6,3/4,5-merou,<,ag,alyx,apiculate,appearance,ark,articulated,ba,basal,borne,branch,capitate,cell,clustered,conical,connivent,dendritic,distal,eaf,eed,ellipsoid,exserted,fleshy,flower,free,fruiting,geminat,glabrou,group,highly,ilament,irregular,lax,lengthening,less,like,lobed,loosely,lower,markedly,membranous,minute,new,nflorescence,non-reproductive,obtusely,older,one,orolla,pale,papillo,peg,pendan,perfect,platfor,platform,pore,poricidal,portion,puberulent,reflexed,reproductive,ridge,ridged,ruit,scar,size,sleeve,slit,small,somewhat,square,stellate,stigma,strongly,suckering,tem,testal,tip,trichome,tube,twinin,two,ud,uniseriate,unit,upper,usually,variable,vary,visible,way,woody,yellow,ympodial	abaxial,adaxial,arrangement,branching,characteristic,colour,form,fruit,height,history,length,life,midvein,na,ovary,plant,pseudostipule,rachi,seed,staman,tertiary,texture,twining,unarmed,venation
522	wfo-0001032276	success	152	121	84	68	37	0.553	-,0.25-1.5,0.3-1,0.5-0.75,0.8-1,1,1-1.5,1-2,1.8-2,2-2.5,3-3.5,3-6-flowered,5-7,7-8,acute,anther,apart,apex,attenuate,bark,base,broadly,brown,calyx,cm,corolla,cup-shaped,dark,deflexed,deltoid,densely,dia,ellipsoid,elliptic,evenly,filament,filiform,fruiting,glabrous,globose,green,later,leaf,lobe,long,long-pubescent,margin,minutely,mm,narrowly,obovoid,ovary,ovoid-reniform,pair,pale,pedicel,petiole,pitted,plant,pubescent,raised,scar,shaped,shrub,simple,slightly,somewhat,spaced,sparsely,stem,style,surface,tapering,tear-drop,triangular,unifoliate,vein,white,widely,winged,woody,x,yellow,young	.25,.5,0.5-1,2.5-4,9-18,along,anthesi,ba,beneath,blade,capitat,converging,curly-tipped,decurrent,dry,eaf,edicel,eed,except,exserted,free,geminate,greyish-gree,lamina,lateral,like,lobed,lower,main,material,middle,minute,nearly,nflorescence,node,non-reproductive,occasionally,older,onto,opposite,papillose,perhaps,pore,poricidal,portion,prominent,raise,reflexed,remaining,rest,ruit,short,slender,soon,stigma,straight,straw-colored,strongly,tall,tip,trichome,tub,tube,ud,uniseriate,unit,widest,ympodial	0.25,0.5,2,3,8,abaxial,adaxial,arrangement,branching,bud,capitate,characteristic,colour,decurren,diameter,form,fruit,greyish-green,growth,height,history,inflorescence,length,life,midvein,na,peduncle,primary,pseudostipule,rachi,seed,shape,staman,tertiary,texture,unarmed,venation
523	wfo-0001032277	success	163	106	76	87	30	0.466	.5,0.2-0.6,0.8-3,1-1.1,1-1.5,1-2,1.5-1.8,10-14,2-2.5,2-4,2-6-flowered,3-3.5,5-6,8-9,acute,anther,apex,base,beneath,berry,branched,bright,calyx,cm,coriaceous,corolla,deltoid,densely,elliptic,filament,flattened-reniform,fruit,glabrous,globose,green,immature,impressed,inflorescence,lateral,lax,leaf,lobe,long,main,margin,minutely,mm,ovary,pair,pale,pedicel,petiole,pitted,prominent,pubescent,raised,revolute,ripe,rounded,shrub,simple,slender,sparsely,stem,straight,style,surface,translucent,trichome,uniseriate,vein,virgately,white,x,yellow,yellowish-tan	0.1-0.5,0.75-1,1-1.2,1-5,1/2,3-9,along,anthesi,apiculate,appear,appearing,area,auriculate,ba,bark,blade,blunt,closely,cup-shaped,dia,drooping,dry,eaf,edicel,eed,ellipsoid,erect,exserted,free,fruiting,geminat,gre,incrassate,indentation,internodal,like,lobed,lower,mature,middle,nflorescence,number,obscured,occasionally,older,opposite,overlapping,paler,papillae,papillose,partially,pore,poricidal,portion,puberulent,pubescenc,reddish,remaining,rest,round,ruit,scar,slende,small,spaced,specimen,spicy-fragrant,stigma,strict,strongly,styl,tall,tapering,tip,truncate,trunk,tub,tube,two,ud,unit,varying,way,widest,woody,ympodial,young	abaxial,adaxial,alternate,arrangement,branching,characteristic,colour,diameter,form,grey,growth,height,history,length,life,midvein,na,peduncle,perennial,plant,primary,pseudostipule,rachi,seed,shape,staman,tertiary,texture,unarmed,venation
524	wfo-0001032304	success	249	171	149	100	22	0.598	.9-1.4,0-120,0.2-0.3,0.3-1.5,0.5-3,0.5-4.5,0.9-1.3,1.1-2,1.2-2.3,1.2-3,1.3-2.1,1.5-3.2,1.6-1.9,1/2,1/8,10,18,2-5,2.5-19.5,2/3-3/4,3-15,3-20,3-6,3.2-3.8,3.2-5.5,4-7.5,7.5-12,9-13,abaxially,acuminate,acute,adaxially,anther,apart,apex,articulated,base,becoming,berry,blackish,branched,broadly,brown,brownish,calyx,closely,cm,conical,continued,corolla,dark,deltoid,dendritic,dendritic-echinoid,densely,diameter,directed,distal,due,echinoid,elliptic,entire,exserted,filament,fleshy,flower,fruit,glabrescent,granular-tomentose,green,greenish,growth,hair,honeycombed,lateral,leaf,length,lobe,long,long-,long-attenuate,long-stalked,many,many-rayed,margin,midvein,mixed,mm,mostly,multangulate,obtuse,occasionally,ovate,pale,partly,pedicel,peduncle,petiole,plant,plurifoliate,porrect-stellate,probably,pseudo-terminal,pubescent,rachi,rarely,rather,ray,reniform,reticulate-punctate,ripe,scabridulous,seed,sessile,short-,short-stalked,shrub,side,simple,small,spaced,sparingly,stamen,stellate-tomentose,stem,style,subglobose,suborbicular,terete,testa,thick-stalked,thin-,time,tomentose,toward,tree,triangular-ovate,tube,unarmed,vein,velutinous,violet,way,white,whitish,x,yellow,yellowish,young	-3,.6-1.2,/20,1,1-3.5,1.8-4,1/3-1/2,1/5,2-4,2-4.2,21,3-10,3-4.5,44,5-6,5.5-9,7-27,accrescent,ag,along,anthesi,apical-lateral,apparently,appressed-tomentose,ascending,axe,axillary,ba,bark,blade,blunt-tipped,branch,bud,campanulate,capitat,chartaceous,decurrent,dehiscing,dendritic-echinoi,eaf,echinoi,especially,extend,few-,few-rayed,free,fruiting,glabrescen,glabrous,high,inserted,introrse,juvenile,large,least,lobed,longitudinal,lower,m.,main,multangulat,nflorescence,oblong,obscured,often,older,opaque,orbicular,orolla,ovat,ovate-lanceolate,overlapping,perfect,pore,present,relatively,rotate-stellate,ruit,runk,short,slit,somewhat,spreading,stigma,strongly,sulcate,suture,tamen,thick,thin,thin-stalked,tomentu,touching,unarme,unit,usually,vary,wide,within,ympodial	abaxial,adaxial,arrangement,branching,characteristic,colour,form,height,history,inflorescence,life,na,ovary,primary,pseudostipule,shape,staman,surface,tertiary,texture,venation,ye
525	wfo-0001032307	success	153	100	74	79	26	0.484	0.2-0.5,0.4-1.3,1-1.5,1-2,1.5-2,1.5-5,10-20,2-5,2.5-12,2.5-3,2.5-3.5,3.5-4,4-8,5-25-flowered,abaxial,acute,adaxial,anther,apex,base,berry,branched,calyx,cm,corolla,deltate,dendritic,densely,dia,elliptic,erect,filament,flattened-reniform,glabrous,globose,green,growth,incrassate,inflorescence,later,lateral,leaf,lobe,long,many,margin,minutely,mm,ovary,pair,pale,pedicel,petiole,pitted,plant,prominent,pubescent,reddish,reddish-brown,shrub,small,sparsely,stem,style,surface,tan,terminal,time,tree,trichome,truncate,vein,white,wide	.5,/3,30,5-12,7-18,?,along,anthesi,apar,bark,blade,body,branch,brow,campanulate,capitate,christmas-tree-like,congested,dark,eaf,edicel,eed,either,ellipsoid,elongate,exserted,flat,fleshy,free,fruiting,glabrate,immature,inflorescenc,like,lobed,lon,loose,lower,main,middle,minute,new,nflorescence,older,papillae,papillo,petal,planar,plurifoliat,pore,poricidal,portion,rest,ruit,scar,shaped,spaced,stigma,stout,strongly,tall,tear-drop,thick,thickened,tip,tree-like,tub,tube,type,ud,unevenly,upper,variable,way,widest,within,woody,ympodia,young	arrangement,branching,characteristic,colour,diameter,form,fruit,height,history,length,life,midvein,na,peduncle,perennial,plurifoliate,primary,pseudostipule,rachi,seed,shape,staman,tertiary,texture,unarmed,venation
526	wfo-0001032308	success	190	112	82	108	30	0.432	0.7-1.2,1-2,1.5-2.5,1.8-2.5,1.9-3,2,2-4,2-6,3-10,3-6,4-7,5-7,6,8-9,acumen,acute,anther,apex,axillary,base,berry,brownish,bud,cm,condition,cordate,corolla,deep,diameter,distal,drying,filament,flower,forked,fresh,fruit,generally,glabrous,globose,green,green-white,greenish,half,invested,irregular,lobe,long,margin,medium,mm,mucilaginous,non-glandular,odd-pinnate,orbicular,ovate,ovoid,pedicel,peduncle,petiole,petiolule,plant,pubescent,pure,ripe,rounded,seed,sessile,shape,short,slightly,stem,style,subtending,sympodial,terminal,throughout,trichome,typically,usually,wet,white,whitish	0-3,0.2-2.1,0.3-5,0.7-1,1-10,12-16,2-3,3.8-5,4-8,4.8-7.7,5-merou,6-11,abaxially,absent,adaxially,ag,along,alyx,apart,apparently,articulated,axe,blade,broadly,capitat,cell,chartaceous,ciliate,clavate,connivent,covering,cuneate,digestion,dorsally,dot,eaf,edge,eed,elliptic,enzyme,especially,exceeding,flat,folded,geminat,glabrou,greatly,hair,hair-like,hal,homostylous,honeycomb-shaped,interjected,lanceolate,larger,lateral,leaflet,leave,lengthening,like,living,lobed,lower,make,membranous,midrib,minute,minutely,much,narrowly,nflorescence,obtuse,often,orolla,pair,pentagonal,perfect,petiolulate,plurifoliate,pore,poricidal,puberulent,removed,ruit,scattered,seudostipule,slit,spaced,specimen,stamen,ste,stigma,straight,substellate,tamen,testal,thick,tip,tri-,truncate,tube,unit,vary,varying,wall,wide,x,yellow	60-100,abaxial,adaxial,arrangement,branching,calyx,characteristic,colour,form,growth,height,history,inflorescence,leaf,length,life,midvein,na,ovary,perennial,primary,pseudostipule,rachi,staman,surface,tertiary,texture,unarmed,vein,venation
527	wfo-0001032335	success	215	99	76	139	23	0.353	0.2â0.3,0.5â1,12â15,1â1.2,1â1.5,1â3,2.5â3,2â5,4â14,5â6,6â6.5,abaxial,abaxially,acuminate,acute,adaxial,anther,anthesi,apex,attenuate,base,berry,branched,branching,bright,calyx,chartaceous,cm,corolla,deltate,densely,diameter,elliptic,entire,filament,flattened-reniform,globose,gold,golden-yellow,growth,inflorescence,length,lobe,many,margin,membranous,minutely,mm,narrowly,nodding,orange,pair,pale,pedicel,peduncle,petiole,pitted,plane,primary,pubescent,reddish,shrub,silvery,simple,small,somewhat,stem,stout,style,surface,terminal,time,tree,vein,white,â4	'',.2,.5,0,0.05,0.2,0.4,0.5,0.9â1,1.5â2,100,100+,10â12,15,16,2â10,2â2.5,3361,4â5,4â6-rayed,5-merou,6â19,7â10,>,ag,along,alyx,apar,appearing,ark,articulated,axe,beneath,boh,c.,capitate,cell,center,closely,connivent,covered,cup-shaped,dichasia,discolorous,drying,eaf,eed,ellipsoidal,elongate,equal,erec,evenly,exserted,fide,flower,free,fruiting,fused,glabrous,golden-brow,gradually,half,ilament,impressed,lamina,lengthening,less,like,lobed,long,loosely,lower,markedly,midpoint,minute,moderately,multangulate,narrowing,near,new,nflorescence,older,onto,orolla,papillo,part,peltate,per,perfect,pericarp,persistent,plurifoliate,pore,poricidal,porrect,porrect-stellate,portion,pubescence,ray,reflexed,regularly,ripe,ruit,scar,scurfy,sessile,shiny,short,short-stalked,slightly,slit,sometimes,spaced,sparsely,square,stellate,stigma,strongly,stub,tal,tem,testal,thin,tip,trichome,tube,ud,unevenly,unit,upper,vary,varying,visible,way,wide,woody,yellow,ympodial,âstellate	arrangement,characteristic,colour,dichasial,form,fruit,height,history,leaf,life,midvein,na,ovary,plant,pseudostipule,rachi,seed,shape,staman,tertiary,texture,unarmed,venation
528	wfo-0001032337	success	225	142	115	110	27	0.511	0.4-1.5,0.5-3.5,1-2,1.2-2.8,1.6-4,2,2-3.5,2.3-11.5,3-8,3.6-5,4-17,4-6,8-10,9-21,abaxially,acuminate,acute,adaxially,anther,apex,apiculate,apparently,attenuate,axillary,base,basiscopic,berry,broadly,brownish,bud,canescent,cell,chartaceous,cm,condition,corolla,covering,cuneate,darker,decurrent,deep,densely,diameter,distal,dot,drying,elliptic,filament,flower,forked,fresh,fruit,generally,glabrous,globose,green,green-white,greenish,hair,hair-like,half,herb,lateral,leaf,light,like,lobe,long,make,margin,membranous,mm,mottled,mucilaginous,oblique,obtuse,odd-pinnate,often,ovate,ovoid,pedicel,peduncle,perfect,petiole,plant,pubescent,purple,rarely,ray,ripe,rounded,scattered,seed,short,side,sometimes,sparsely,stem,style,subglabrous,subtending,terminal,tertiary,testal,thick,throughout,tissue,typically,usually,violet,violet-purple,wall,wet,white,whitish	0,1,1-10,1-4,1.4-2,1.5,10,2-14,2-4,2-4.5,2-7,2.3-4.8,3-4,4-9,4.5-14.5,5-11,5-merou,8-17,9-29,acumen,ag,along,alyx,apart,articulated,axe,blade,borne,capitat,ciliate,clavate,connivent,cordate,digestion,dorsally,eaf,edge,eed,end,enzyme,erec,especially,exceeding,except,flat,folded,frequently,geminat,glabrou,greatly,homostylous,honeycomb-shaped,interjected,lanceolate,leaflet,lengthening,living,lower,middl,midrib,minutely,nflorescence,orbicular,orolla,pair,paired,pentagonal,petiolulate,petiolule,plurifoliate,pore,poricidal,proximal,puberulent,reduced,removed,rotate,ruit,sessile,seudostipule,singly,size,slightly,slit,small,spaced,specimen,stamen,ste,stigma,stolo,straight,subequal,subsessile,tall,tamen,tem,tip,tri-,tube,tuber,unit,unpaired,unwinged,vary,wide,wing,x,yellow,ympodial	abaxial,adaxial,arrangement,branching,calyx,characteristic,colour,form,growth,height,history,inflorescence,length,life,midvein,na,ovary,primary,pseudostipule,rachi,shape,staman,surface,texture,unarmed,vein,venation
529	wfo-0001032344	success	157	89	71	86	18	0.452	0.2-0.5,1-4,1.5-4.5,1.5-6,10-29,2-2.8,3-5,3-8.5,3-9,3.5-6.5,4-8,5-10,acute,bluish,branched,broadly,calyx,cell,cm,corolla,covering,cyme,dark,diameter,dichasial,dichasially,dot,ebracteate,elliptical,globose,green,green-white,hair-like,herbaceous,lateral,leaf,leaflet,lobe,long,long-attenuate,medium,mm,monochasial,mucilaginous,odd-pinnate,often,ovate,ovoid,pair,pedicel,peduncle,perennial,petiole,plant,puberulent,pubescent,purple,rotate,rotate-pentagonal,seed,smooth,style,terminal,testal,thick,throughout,tuber-bearing,violet,wall,white,yellow	1-1.3,1-3,1.6-2.4,2-3,2.2-4,2.8,3-6-foliat,3-7,4-11,6-15,9.5-21,abaxially,abruptly,absent,acumen,acuminate,adaxially,apex,apical,apically,articulate,base,belo,connate,cuneate,decurrent,dehiscent,digestion,diminishing,distal,dorsally,eaf,edge,eed,emoval,enzyme,exceeding,filament,flower,forked,generally,globo,half,honeycomb,inrolled,interjected,introrse,layeral,living,lon,lower,lunat,make,maturing,nflorescence,nther,oblique,orolla,pattern,perfect,petiolule,plan,poricidally,proximal,reveal,ruit,scarce,sessile,seudostipule,short,size,slit,sometimes,specimen,stamen,stigma,straight,tal,tem,toward,typically,unit,vary,wide,ympodial,Â¼	anther,arrangement,characteristic,colour,form,fruit,growth,height,history,inflorescence,length,life,ovary,shape,stem,surface,texture,width
530	wfo-0001032354	success	171	98	67	104	31	0.392	0,0-5,1-2,1-5,2-2.5,2.5-3,3-4,38/2,acute,anther,apex,aster,axillary,base,becoming,branch,branched,broadly,brown,calyx,cm,coarsely,colour,corolla,cuneate,decurrent,deep,discoidal,filament,fork,glabrous,globose,green,greenish-ivory,greyish,leaf,lobe,maturity,minutely,mm,obovate,occasionally,ovary,ovoid,pedicel,peduncle,pinnatisect,puberulent,pubescent,rh,rounded,rugose-reticulate,shape,shrub,simple,soft,somewhat,spreading,stem,straight,style,surface,vein,violet,wide,wooded,woody	0.3,0.5-1,0.8-1,0.8-1.2,1-10,1-3,10-lobed,2,25,250-400,29,4-6,40-75,5-10,5-15,acuminate,almost,angular,anthesi,aspect,axi,berry,bilobed,c.,campanulate,capitate,cell,creating,cut,deeply,dia,distal,eaf,eed,effect,ellipsoid,except,exerted,facetted,fleshy,flower,general,glandular,gre,gree,hair,halfway,lanceolat,large,lasting,lengthening,linear,lobed,lower,midrib,minute,narrow,nflorescence,obovoid,oval,ovate,pair,pale,pebble-shaped,pedicellate,plurifoliat,pore,poricidal,rather,rotate,ruit,secondary,seedling,several,shoot,single,sinus,size,slightly,slit,small,smaller,smel,sparse,stellate,stigma,stone,strongly,tall,tip,trichome,tub,ud,uniseriate,unit,unpleasant,usually,variable,wing,within,x,year,ympodial,young	abaxial,adaxial,apcuminate,arrangement,branching,characteristic,diameter,form,fruit,growth,height,history,inflorescence,length,life,margin,midvein,na,perennial,petiole,plant,plurifoliate,primary,pseudostipule,rachi,seed,staman,tertiary,texture,unarmed,venation
531	wfo-0001032358	success	216	97	74	142	23	0.343	0,0.2-4,0.5-3,0.7-1,1-2,13-20,2-3,2-5,3-10,3-4,4-4.5,4-7,4-8,4.5-5,acute,anther,apex,armed,base,berry,branched,calyx,cm,cordate,corolla,diameter,entire,filament,fruit,furcate,glabrous,globose,green,growth,inflorescence,internodal,leaf,linear,lobe,margin,membranous,midvein,minutely,mm,occasionally,orangish,ovate,pair,pale,pedicel,peduncle,per,petiole,pitted,prickly,primary,pubescent,purple,red,ripening,shrub,simple,sinuate,slightly,staman,stellate,stem,style,surface,tan,time,vein,x,yellowish	.1,.2,.3,.4,.5,/2,0.6-0.8,0.6-1,1-1.6,1.3-1.7,1.5-2,1.5-2.5,1/4-1/2,12-20,15-40,2,2-10,2-4,2.2-7.5,3.5-13,4-merous,abaxially,abscissio,adaxially,along,another,anthesi,apart,appearing,away,bark,basal,based,broad,brown,bulbous,capitate,cell,center,cupuliform,curved,densely,difoliate,dorsal,drying,eaf,eed,equal,erect,expanding,exserted,flattened,flower,free,frui,fruiting,geminate,glabrescen,glabrescent,heteromorphic,interpetalar,irregular,irregularly,lamina,left,lengthening,like,lobed,long,longer,lower,lowermost,margined,markedly,maturity,midpoint,midrib,new,nflorescence,nodding,often,older,one,ovoid,paler,papillat,papillate,part,peg,perfect,pericarp,persistent,planar,pore,poricidal,porrect,portion,present,prickle,ray,reniform,rhachi,rotate-stellate,ruffly,ruit,scar,sessile,shiny,short,short-stalked,sinus,slit,small,sometimes,somewhat,space,spaced,sparsely,spreading,stigma,strongly,thick,thin,three,tip,trichome,tub,tube,tuberculate,two,type,ud,unevenly,unisexual,unit,upper,usually,way,whitish,widely,ympodial,zygomorphic	abaxial,adaxial,arrangement,branching,characteristic,colour,form,height,history,length,life,na,ovary,perennial,plant,pseudostipule,rachi,seed,shape,tertiary,texture,unarmed,venation
532	wfo-0001032367	success	231	105	73	158	32	0.316	0-0.3,0.7-1.1,100-300,2-4,abaxial,acute,adaxial,anther,apex,axi,base,berry,calyx,cm,congested,conical,cordate,dark,densely,diameter,filament,flattened-reniform,glabrous,glandular-puberulent,globose,green,greenish,immature,inflorescence,lateral,leaf,length,light,lobe,lobed,margin,maturity,membranous,minute,mm,mottled,nearly,obtuse,ovary,ovate,pale,pedicel,peduncle,per,petiole,prickle,puberulent,pubescence,pubescent,red-brown,sessile,shrub,similar,simple,spreading,stem,style,suborbicular,surface,tightly,tip,triangular,truncate,unarmed,unbranched,vein,white,yellow	-3,.2,.4,0.2â0.35,0.4-0.5,0.4â0.5,0.4â0.6,0.4â1,0.5â0.8,0.5â2,0.6,0.6â0.8,0.8,0.8â2,1-2,1-2.1,1.2,1â1.5,1â1.8,2,2-3-celled,2.2â2.5,2.2â2.8,2.5â3,2â2.5,3-5,3-celled,3.2â4,3â10,3â5,3â6,4,4â6.5,5-merous,5.5â6.9,5â18,6-8,6.8â8.2,7â10,8,abaxially,accrescent,acicular,adaxiall,adaxially,also,alyx,anthesi,arme,around,ba,blade,branch,broad-based,capitate,connivent,copious,cream,curved,deciduous,difoliate,directed,distall,eaf,eed,enlarged,entire,equal,erect,expand,fertile,flower,free,fruiting,geminat,geminate,gland-tipped,grading,hair,herbarium,heterostylous,hyaline,infructescence,lanceolate,largest,layer,least,long,long-styled,longer,lower,lowermost,major,many,mesocarp,midpoint,minutely,mixed,mixture,moderately,narrowly,nflorescence,often,one,orolla,oung,pair,papillat,pore,poricidal,portion,prickly,rarely,ray,recurved,rest,ruit,scarcely,scattered,secondary,shallow,short-styled,shorter,size,slender,small,smaller,somewhat,sparsely,specimen,spongy,spreadin,staminat,ste,stellate,stigma,straight,tall,tamen,tapering,terete,thick,time,tooth,trichome,tube,twice,uniformly,uniseriate,unit,usually,variable,vary,whitish,wide,ympodial,â15,â5	0.5-2,0.8-2,1-1.8,2.2-2.8,3-6,5.5-6.9,6.8-8.2,armed,arrangement,branching,characteristic,colour,corolla,form,fruit,growth,height,history,life,midvein,na,perennial,plant,primary,pseudostipule,rachi,seed,shape,staman,tertiary,texture,venation
533	wfo-0001032407	invalid_json	216	142	115	101	27	0.532	0.3-0.6,0.5-3,0.8,1-2,1-2.4,1.4-2.7,1.5-2.2,10-27,2-10.5,2.5-9,3-15,4-11,4-48,4-7,5,7-9,8-10,abaxially,acuminate,adaxially,anther,apex,articulated,asymmetrical,attenuate,axillary,base,basiscopic,berry,brownish,bud,cell,chartaceous,cm,coarsely,commonly,condition,conical,corolla,covering,dark,densely,diameter,distal,drying,elliptic,elongated,filament,finely,flower,forked,fresh,fruit,generally,glabrous,green,green-white,greenish,hair,hair-like,half,herb,lateral,leaf,less,light,like,lobe,long,make,margin,membranous,middle,minute,mm,mottled,mucilaginous,narrow,obtuse,odd-pinnate,ovate,ovoid,pedicel,peduncle,petiole,plant,proximal,puberulent,pubescent,purple,rarely,ripe,round,seed,semierect,side,simple,sparsely,stem,style,subtending,symmetrical,terminal,testal,thick,throughout,tissue,usually,wall,wet,white,whitish,wide,wing,x	0-4,0.3-8,0.4-4,0.8-0.3,1-10,1-5,1.2-7,10-19.5,12,2-4,2.5-10.5,3.1-13.5,30,38,5-23,5-30,5-merou,6,absent,acumen,ag,along,alyx,apart,apparently,arranged,axe,bead,blade,capitat,ciliate,clavate,connivent,decreasing,digestion,eaf,edge,eed,enzyme,erec,especially,exceeding,folded,geminat,glabrou,gradually,homostylous,honeycomb-shaped,interjected,lanceolate,larger,leaflet,lengthening,living,lower,medium,minutely,moniliform,multiple,necklace,nflorescence,orbicular,orolla,pair,pentagonal,perfect,petiolule,plurifoliate,pore,poricidal,pubescen,ray,removed,rotate,ruit,secondary,sessile,seudostipule,size,slit,spaced,specimen,stamen,ste,stigma,stolon,straight,subequal,tall,tamen,tem,tip,tri-,tube,tuber,typically,unit,unwinged,vary,yellow,ympodial	'',2,[,``,arrangement,branching,calyx,characteristic,colour,erect,form,growth,height,inflorescence,length,ovary,pseudostipule,shape,staman,surface,texture,unarmed,value,width,{,},Â¼
534	wfo-0001032465	success	233	108	83	150	25	0.356	1-1.5,1.2-1.5,1.5-1.8,1.5-2,2-2.5,3-3.5,3-4,4,5-7,5-8,abaxial,acuminate,acute,anther,anthesi,apex,base,berry,black,branched,brown,calyx,cm,cordate,corolla,deeply,deltate,densely,diameter,elliptic,entire,filament,filiform,flattened,glabrous,globose,green,greenish,growth,inflorescence,later,lateral,leaf,length,lobe,lobed,margin,minutely,mm,narrowly,nodding,ovate,pair,pedicel,peduncle,petiole,pinnate,pinnatifid,primary,puberulent,pubescent,purplish,reddish,reniform,reticulate,revolute,seed,shape,simple,sparsely,stem,style,surface,terminal,time,truncate,variously,vein,vine,violet,white,woody,x	+,-10,-11,-14,-9,.2,.5,0,0.2,0.5-,0.5-2,1-,1-1.7,1-celled,1.5,1.5-5,1/3,2,2.5-5.5,25,3-5,3-8,3-9,5,5-merou,9,ag,alyx,angled,apar,apically,appearing,ark,articulated,axi,basal,capitate,cell,ciliate,clasping,commonly,conical,connivent,coriaceous,de,decreasing,deep,deeper,distal,drying,eaf,edge,eed,ellipsoid,elongate,erect,exserte,flower,free,fringe,fruiting,glabrescen,gland,glandular,glandular-tipped,growing,half,ilament,included,irregular,irregularly,janeiro,larger,leaving,lengthening,like,long,loosely,lower,mature,membranous,minute,new,nflorescence,occasionally,often,older,orolla,outline,paired,papillate,papillo,peg,pendan,pentagonal,per,perfect,pericarp,planar,plurifoliat,pore,poricidal,portion,rio,ripe,ruit,scar,scattered,shallow,shiny,similar,sinus,size,sleeve,slit,somewhat,spaced,splitting,stellate-rotate,stigma,strongly,subshrub,tem,testal,thicker,thin,tiny,tip,toward,transparent,trichome,tube,tuft,twinin,twining,ud,unicellular,uniseriate,unit,upper,usually,vary,varying,wall,way,widest,yellowish,ympodial,young,Â½	0.2-5,0.5-11,adaxial,arrangement,branching,characteristic,colour,form,fruit,height,history,life,midvein,na,ovary,perennial,plant,pseudostipule,rachi,staman,tertiary,texture,unarmed,unknown,venation
535	wfo-0001032494	invalid_json	163	101	69	94	32	0.423	.4,.5,0.8-1,0.9-1.2,1.45-1.5,1.5,1.5-8,2.5,2.5-8,8-11,acuminate,anther,apex,attenuate,base,berry,brown,calyx,cm,corolla,decurrent,filament,flattened-reniform,fruit,furcate,glabrous,globose,greenish-yellow,leaf,light,lobe,margin,minutely,mm,narrowly,occasionally,opposite,ovary,ovate,pair,pale,papillose,pedicel,petiole,pitted,prominent,raised,revolute,shrub,simple,slender,small,stem,straight,style,surface,tapering,tree,triangular,trichome,tube,uniseriate,vein,venation,white,whitish-green,winged,x,yellow	.1,0.6-1,0.75-1,1-1.5,1.1-1.2,1.6-2,1.8-4.5,16.5-20.5,2.3-2.5,3-4,3.4-14.5,3/4,4-8,5-40,5-6.4,accrescent,anthesi,apart,appearing,axil,ba,bark,beginning,beneath,bullate,clavate,deflexed,dia,differing,difoliate,dry,eaf,edicel,eed,equal,evenly,except,expanded,exserted,flowered,free,fruiting,geminat,geminate,incrassate,inflorescenc,lateral,lax,lenticellat,lobed,lon,long,lower,main,major,material,middle,minor,nearly,nflorescence,node,orange,ovoid,papillae,papillo,planar,pore,poricidal,portion,proximal,pubescent,quite,ridge,ruit,scar,shaped,size,slightly,somewhat,spaced,stigma,tall,tan,tear-drop,tip,two-winged,ud,unit,upper,way,widest,woody,ympodial,zig-zag	'',[,],``,abaxial,adaxial,arrangement,branching,characteristic,colour,diameter,form,growth,height,inflorescence,length,midvein,na,peduncle,plant,primary,pseudostipule,rachi,seed,shape,staman,tertiary,texture,unarmed,value,{,}
536	wfo-0001032507	success	206	124	86	120	38	0.417	0.5,2,6,abaxial,abaxially,acuminate,acute,adaxially,anther,anthesi,apex,apiculate,armed,articulated,base,berry,blue,branched,brown,calyx,cell,chartaceous,cm,compound,corolla,curved,diameter,distinct,elliptic,entire,fertile,filament,flattened-reniform,flower,glabrous,globose,green,hair,herbaceous,leaflet,light,lobe,margin,minutely,mm,occasionally,often,ovate,pedicel,peduncle,pentagonal,perennial,petiole,pinnate,pinnately,pinnatifid,pitted,plant,present,prickle,puberulent,pulp,purple,quadrate,rachi,rarely,reddish,rounded,shape,side,simple,slender,stem,strongly,style,surface,terminal,testal,tip,unbranched,variously,vein,vine,white,woody,Ã	.2,.5,/4,0.25,0.3,0.7-1.2,0.8,1,1.2-1.7,1.3,1.5â2,1.5â7,10â20,15â20,1â1.5,1â10,2.5â4,2.5â6,20â30,2â9,3â5,3â7,4â10,5â10,5â20,5â8,8â15,absent,abundant,adaxiall,adjacent,ag,alyx,becoming,blade,broadly,bud,campanulate,collection,confluent,connivent,cream,deep,deltate,distally,dr.,eaf,eed,either,ellipsoid,elongating,equal,exserted,fifth,flowering,four,fruiting,herbarium,highly,individual,internode,interpetalar,larger,lateral,lengthening,lobed,long,longer,lower,major,material,midrib,narrowly,nearly,nflorescence,oblong,observe,one,orolla,pale,papery,pericarp,pistillate,plurifoliat,pore,poricidal,purplish,ranging,recurve,regularly,rotate-pentagonal,rugose,ruit,single,sinus,slightly,slit,sometimes,spreading,staminate,stigma,stout,straight,tamen,tear,time,tissue,tube,unequal,unit,unlobed,usually,variable,vary,way,wide,widest,wood,yellowish,ympodial	0.25-0.8,1.5-2,1.5-7,15-20,2-9,2.5-6,3-7,4,4-10,5-10,5-20,5-8,adaxial,arrangement,branching,characteristic,colour,form,fruit,growth,height,history,inflorescence,leaf,length,life,midvein,na,ovary,plurifoliate,primary,pseudostipule,seed,staman,tertiary,texture,unarmed,venation
537	wfo-0001032523	success	200	113	90	110	23	0.45	-5,.2,.5,0-3,0.6-0.7,1-1.5,1-2,1-3,1.5-3,10-50,2.7-3,3-4,3.5-4,6-8,abaxial,acuminate,acute,adaxial,anther,apex,apically,apparently,articulated,base,berry,branching,calyx,cm,cuneate,curved,deltate,diameter,dull,elliptic,entire,erect,evenly,filament,filiform,flattened-reniform,fruit,gently,glabrescent,glabrous,green,lateral,leaf,length,lobe,margin,maturity,mauve,membranous,mm,moderately,orange,orange-brown,ovate,pair,pale,pedicel,peduncle,petiole,prickle,prickly,primary,recurved,red,red-brown,shrub,simple,sometimes,sparsely,spherical,stellate-pubescent,stem,straight,style,subentire,surface,terminal,tertiary,unarmed,unit,vein,venation,visible,weakly,yellow,young	-2,/4,0-0.15,0-10,0-12,0-15,0.1-0.2,0.2,0.2-0.4,0.3-0.5,0.4-1,0.4-1.5,0.5-1,0.6-0.8,1-8,1.3-1.6,1/3-1/2,1/4-1/3,15-30,2,2-2.4,2-2.5,2-4,2-5.5,2.5-6,3-15,4-5-merous,4-7,5-12,5-20,6-10,6-20,abaxially,acuminat,alyx,ame,apar,apart,bark,blade,brow,c.,conical,connivent,discolorous,drying,eaf,eed,elongating,equal,flower,free,fruiting,glabrou,hair,herbaceous,inflated,infructescence,lobed,lon,long,longer,lower,mature,midpoint,minute,multangulate,narrow-deltate,nflorescence,older,one,open,orolla,oung,per,perfec,pericarp,perpendicular,plurifoliat,poricidal,porrect,portion,ray,reflexed,ruit,scandent,scar,secondary,sessile,smooth,spaced,spreading,stalk,stalked,stellate,strongly,tamen,tapering,terete,time,tip,trichome,tube,unarme,variously,vary,way,wide,woody,ympodial	arrangement,characteristic,colour,corolla,form,growth,height,history,inflorescence,life,midvein,na,ovary,perennial,plant,plurifoliate,pseudostipule,rachi,seed,shape,staman,sympodial,texture
538	wfo-0001032524	success	205	106	76	129	30	0.371	1-2,1-2.5,1.5-4,12-13,2-5,25-90,3-5,3.5-4.5,4.5-8,5-6,7-35,7-8,acute,anther,apex,articulated,attenuate,axillary,base,berry,brownish,bud,cm,condition,corolla,cuneate,densely,diameter,distal,drying,elliptic,filament,flower,forked,fresh,fruit,generally,glabrous,globose,grayish-green,green,greenish,hair,hair-like,half,herb,length,light,like,lilac,lobe,long,margin,middle,mm,narrowly,obtuse,odd-pinnate,ovate,ovoid,pedicel,peduncle,petiole,plant,pubescent,purple,ripe,rounded,seed,stem,style,subtending,terminal,usually,violet,whitish	1-10,1.5-2,10-35,120-210,14-50,2-3,2.5-8,3-4,3-8.5,4,4-5,4.5-5,5-9,5-merou,50-70,6-13,6-16.5,?,abaxially,acumen,adaxially,ag,along,alyx,apart,apparently,arranged,ascending,axe,bead,blade,capitat,cell,chartaceous,ciliate,clavate,connivent,covering,different,digestion,dorsally,eaf,edge,eed,enzyme,erec,especially,exceeding,except,flat,folded,geminat,glabrou,greatly,green-white,hal,head,homostylous,honeycomb-shaped,interjected,lanceolate,lateral,leaflet,lengthening,living,lower,make,membranous,midrib,minutely,moniliform,mucilaginous,multicellular,multiple,necklace,nflorescence,non-glandular,often,orolla,pair,pentagonal,perfect,petiolulate,petiolule,plurifoliate,pore,poricidal,proximal,puberulent,reduced,removed,rotate,ruit,sessile,seudostipule,short,silky,silvery-white,size,slit,spaced,specimen,stamen,ste,stigma,stolon,straight,subequal,tall,tamen,tem,testal,tetralobulate,thick,throughout,tip,tri-,trichome,tube,tuber,typically,unit,unwinged,vary,wall,wet,x,yellow,ympodial	2,abaxial,adaxial,arrangement,branching,calyx,characteristic,colour,form,growth,height,history,inflorescence,leaf,life,midvein,na,ovary,primary,pseudostipule,rachi,shape,staman,surface,tertiary,texture,true,unarmed,vein,venation
539	wfo-0001032532	success	161	94	68	93	26	0.422	0.3-2.5,1-4,1.5-2.6,15-30,2-10,2-13,2-3,2.8-3.6,2.8-9.5,3-10,4-5.5,4.5,6,acute,base,branched,calyx,cell,cm,conical,corolla,covering,cyme,deep,diameter,dichasial,dichasially,ebracteate,elliptical,exceeding,filament,finely,green,green-white,hair-like,herbaceous,honeycomb,lateral,leaf,light,long,medium,mm,monochasial,mucilaginous,narrowly,obtuse,odd-pinnate,ovate,ovoid,pattern,pedicel,peduncle,perennial,petiole,plant,pubescent,purple,seed,stamen,stigma,straight,style,testal,thick,throughout,tip,wall	0-.,1-1.5,1.5-3.2,1.5-4.3,13-52,2,2-,3-5,3-6-foliat,3.4-12.2,3.7-10,6-22,8-38,abaxiall,abaxially,absent,acumen,acuminate,adaxially,apex,apical,apically,articulate,attenuate,coarsel,connate,cuneate,dehiscent,digestion,diminishing,distal,dorsally,eaf,edge,eed,emoval,enzyme,flat,flower,folded,forked,generally,globo,gradually,half,interjected,introrse,leaflet,living,lobe,lon,long-attenuate,lower,lunat,make,maturing,minute,nflorescence,nther,oblique,often,orolla,pair,perfect,petiolule,plan,poricidally,proximal,reveal,rotate,rounded,ruit,sessile,seudostipule,short,size,slit,specimen,subequal,subsessile,tal,tem,terminal,throughou,toward,tuber-bearing,typically,unit,vary,wide,yellow,ympodial,Â¼	abaxial,adaxial,anther,arrangement,characteristic,coarsely,colour,form,fruit,globose,growth,height,history,inflorescence,length,life,lunate,na,ovary,pseudostipule,shape,staman,stem,surface,texture,wet
540	wfo-0001032536	success	254	116	96	158	20	0.378	1-2.5,1.3-2.2,10,10-20,13-24,14-16,2-3,20-22,3-3.5,4-6,4-9,5.5-8,7-10,abaxial,acute,adaxial,age,almost,anther,apex,armed,base,berry,bright,bristle,bristly,brown,calyx,chartaceous,cm,conical,dark,deeply,densely,depressed,diameter,difoliate,elliptic,entire,fading,filament,flattened,fruit,glabrous,glandular,globose,grayish,growth,inflorescence,leaf,length,lobe,lobed,margin,maturity,membranous,midvein,minute,minutely,mixture,mm,multiseriate,narrowly,oblique,olive-green,once-branched,ovary,papillae,papillate,pedicel,peduncle,petiole,plant,porrect,primary,pubescent,purple,reddish,reniform,rough,simple,somewhat,sparsely,stellate,stem,style,surface,tree,triangular,trichome,truncate,unarmed,unit,vein,white,yellow-green	-3,/3,0.5,1,1-2,1.5,10-30,10-50,100,2.5-3,20-25,20-50,3,3-6,4-8,5,5-6,5-8,5-merous,<,>,abaxially,abruptly,adaxiall,adaxially,along,alyx,angle,anthesi,apar,appressed,around,articulated,axi,bark,basal-most,berr,blade,broad-based,broadly,capitate,caudat,caudate,cell,clavate,clearly,coriaceous,cu,curved,dbh,deltate,denser,directed,diverging,eaf,eed,enlarged,equal,evenly,flower,free,fruiting,geminate,glabrescent,glandular-puberulent,halfway,hanging,heterostylous,inflorescenc,infructesecnce,interpetalar,irregularly,juvenile,lamina,lateral,leaf-opposed,leaving,like,long,long-stalked,long-styled,lower,mature,midpoint,midrib,mixed,multangulate,narrowing,near,new,nflorescence,number,occasionally,occurring,odor,older,open,orolla,oung,papillat,part,pentagonal,per,pericarp,pore,poricidal,portion,potato,prickl,prickle,prickly,prominent,protuberance,rarely,ray,reproductive,ruit,scar,scattered,shallowly,short-,short-styled,slender,slightly,small,smooth,soft,spaced,spreading,stalk,staminate,stellate-pubescent,stigma,strongly,tall,tamen,tapering,terete,terminal,thick,time,tip,tissue,trunk,tube,unequal,upward,urceolate,usually,vary,visible,way,wide,wood,woody,yellowish,ympodial,younger	arrangement,branching,characteristic,colour,corolla,form,height,history,life,na,perennial,pseudostipule,rachi,seed,shape,staman,sympodial,tertiary,texture,venation
541	wfo-0001032542	success	161	102	75	86	27	0.466	0.5-1,0.7-1,1-1.3,1-1.5,1-2,1-5,10-15-flowered,2-3,2-3.5,3-4,4-7,4.5-5,5-8,abaxial,abaxially,acuminate,acute,adaxially,anther,apex,attenuate,base,berry,bluish-green,bright,brown,calyx,cm,corolla,dark,deltate,dendritic,densely,elliptic-obovate,filament,flattened-reniform,glabrous,globose,golden,green,growth,incrassate,inflorescence,lamina,lateral,leaf,lobe,main,margin,minute,minutely,mm,narrowly,ovary,pair,pedicel,petiole,pitted,pubescent,reddish-brown,shape,shining,shrub,simple,small,sparsely,stem,style,surface,treelet,triangular,trichome,vein,yellow-green,yellowish	.25,.25-0.5,.5,.5-1,/4,1.5-3.5,10-28,2.5-5,3-5,4-9.5,along,anthesi,apical,axi,ba,bark,basal,beginning,capitate,closely,compact,conical,deflexed,di,dia,differing,difoliate,distal,dry,eaf,edicel,eed,either,elliptic,erect,exserted,free,fruiting,geminat,inflorescenc,later,less,like,lobed,lon,long,loose,lower,major,minor,near,new,nflorescence,older,opposite,overlapping,papillo,persisten,planar,pore,poricidal,portion,rounded,ruit,scar,shaped,size,slender,slightly,somewhat,spaced,stigma,strongly,swollen,tear-drop,tip,tub,tube,ud,unit,way,wide,woody,x,ympodial,young	adaxial,alternate,arrangement,branching,characteristic,colour,diameter,form,fruit,height,history,length,life,midvein,na,peduncle,perennial,plant,primary,pseudostipule,rachi,seed,staman,tertiary,texture,unarmed,venation
542	wfo-0001032564	success	160	130	97	63	33	0.606	.1,.5,0.25-0.5,0.3-1,0.75-1,1-1.2,1-1.3,1-1.5,1-2,1.5,2-2.5,4-5,4-6-flowered,6-7,8-9,along,anther,apart,apex,arched,bark,base,becoming,beneath,berry,branch,broadly,brown,bud,calyx,cm,corolla,dark,deflexed,deltoid,densely,dia,dry,elliptic,exserted,extreme,filiform,flattened,fresh,fruiting,glabrate,glabrous,globose,golden,green,greenish-white,greyish-red,later,leaf,lobe,long,long-acuminate,margin,material,minutely,mm,narrowly,ovary,ovate,ovoid-reniform,pair,pedicel,petiole,pitted,prominent,puberulent,raised,ripe,rounded,scar,shiny,shrub,simple,slightly,soon,stem,straight,style,surface,tan,tapering,thread-like,tip,trichome,truncate,unifoliate,uniseriate,vein,winged,x,yellowish-green,young	.05,.05-0.1,1.3-2.5,5.5-9,anthesi,apar,aspec,ba,clavate,conical,converging,eaf,edicel,eed,except,expanded,flower,geminate,giving,halfway,lamina,lateral,like,lobed,lower,main,member,middle,minute,nearly,nflorescence,node,non-reproductive,obovoi,often,older,one,open,opposite,papillo,papillose,planar,point,pore,poricidal,projection,proximal,reflexed,ruit,shaped,small,stigma,strongly,tall,tear-drop,time,tiny,tube,ud,unit,widest,woody,ympodial	abaxial,adaxial,arrangement,branching,characteristic,colour,diameter,exsertion,filament,form,fruit,growth,height,history,inflorescence,length,life,midvein,na,obovoid,peduncle,plant,primary,pseudostipule,rachi,seed,shape,spacing,staman,tertiary,texture,unarmed,venation
543	wfo-0001032569	success	164	102	71	93	31	0.433	0.5-10,0.8-1,1-1.2,1-1.5,1-2,1-4,1.2-5,1.5-2,1.7-2,2-3,5-6,7-9,acute,anther,apex,base,berry,branched,brown,bullate,calyx,cm,corolla,corrugated,dark,decurrent,dendritic,densely,dry,elliptic,erect,filament,flattened,glabrous,globose,green,inflorescence,irregularly,lateral,leaf,lobe,main,margin,minutely,mm,occasionally,onto,opposite,ovary,ovate,pair,papillose,pedicel,petiole,pitted,pubescent,reniform,shrub,simple,sparsely,splitting,stem,strongly,style,surface,thick,triangular,trichome,vein,white,x	.5,/3,1.5,2-4,4-18,4-8,5-60-flowered,7-27,abaxially,adaxially,along,anthesi,apparently,appearing,axi,bark,bearing,bilobed,broadly,cell,closely,conical,deflexed,dense,denser,dia,differing,difoliate,drying,eaf,edicel,eed,ellipsoid,exserted,fleshy,free,fruiting,geminate,golden,gra,incrassate,later,lea,like,lobed,lon,long,los,lower,major,matted,mature,middle,minor,moderately,nflorescence,obscured,open,otherwise,paler,papillo,pericar,planar,pore,poricidal,portion,present,pubecsence,rich,ruit,scar,shaped,size,somewhat,spaced,stigma,stone,tall,tear-drop,time,tip,tub,tube,tuft,ud,unifoliate,unit,waxy,way,widest,woody,ympodial,young	0.5,abaxial,adaxial,arrangement,branching,characteristic,colour,diameter,form,fruit,gray,growth,height,history,length,life,midvein,na,peduncle,perennial,plant,primary,pseudostipule,rachi,seed,shape,staman,tertiary,texture,unarmed,venation
544	wfo-0001032576	success	229	149	124	105	25	0.541	-10,-2,0,0-3,0-5,0.3-0.7,0.5-1,0.5-1.5,0.5-4,0.8-1.2,1-4,1.5-2,1.5-2.3,1.8-2.5,1/3,2-4,2-5,4,4-6,4-6.5,5-30,acute,anther,apex,apically,apparently,articulated,base,berry,branched,branching,bright,brown,brown-green,calyx,cell,chartaceous,cm,concolorous,cuneate,deltate,densely,diameter,difoliate,drying,dull,ellipsoid,entire,erect,evenly,eye,faint,filament,flattened-reniform,fruit,glabrescent,glabrous,glandular,gray,green,hair,herb,lanceolate,lateral,leaf,length,lobe,lobed,long,margin,maturity,membranous,midvein,minutely,mm,moderately,naked,near,obtuse,often,orange-brown,outline,ovate,pair,pale,pedicel,peduncle,per,petiole,pit,prickle,prickly,primary,purple,raised,red,red-green,reticulate,shiny,shrub,simple,small,sparsely,spherical,stellate-pubescent,stem,style,surface,terminal,tertiary,trichome,unarmed,unit,upper,usually,vein,venation,visible,white,wide,yellow,yellow-green,yellow-orange,young	-12,-2/3,/4,/5,0-1.5,0-30,0.1,0.1-0.15,0.1-0.2,0.1-0.25,0.3-0.5,0.5-2,0.8-1.4,0.8-2,1-3,1.2-1.8,1.5-7.5,1/2,1/3-1/6,2-10,2-3,2.5-3,2.5-4,3-14,4-,4-5-merous,6-8,7-8,abaxially,acuminat,alyx,apar,apart,ascendant,ba,bark,blade,brow,conical,curved,distance,eaf,eed,elongating,equal,extending,flattened,flower,free,fruiting,geminat,gland,globular,herbaceous,infructescence,longer,lower,mature,midpoint,narrow-deltate,narrow-ovate,nflorescence,obovate,older,one,open,orolla,oung,perfec,pericarp,poricidal,porrect,portion,prickl,ray,reduced,reflexed,rounded,ruit,scandent,scar,sessile,short,shorter,side,slender,slightly,smooth,sometimes,spaced,spreading,stalk,stalked,stellate,straight,tamen,tapering,time,tip,tube,variously,vary,way,woody,ympodial	abaxial,acuminate,adaxial,arrangement,characteristic,colour,corolla,form,geminate,growth,height,history,inflorescence,life,na,ovary,perennial,plant,pseudostipule,rachi,seed,shape,staman,sympodial,texture
545	wfo-0001032595	success	200	149	116	84	33	0.58	-20,-25,-pilose,0-,0.5-1,0.5-3.5,1-2,1-3,1-6,1-6.5,1.5-2,1.5-2.5,1.5-4.5,1.5-5,12-16,15-25,15-40,2-3,2-4,25-40,3-10,3-12,3-4,3-5,4-5,4-7,5-6,6-7,abaxially,acuminate,acute,adaxially,along,also,anther,apart,apex,apiculate,articulated,axe,basal,base,branch,branched,brownish-purple,calyx,cm,cordate,deeply,deltate,densely,denser,diameter,dull,eglandular,ellipsoidal,entire,filament,finely,flattened,flower,fork,forked,fruit,fusiform,glabrous,glandular,greenish,hair,leaf-opposed,leaving,lobe,long,margin,mature,mm,moderately,near,oblique,often,ovate,pale,pedicel,pedicellar,peduncle,per,perfect,petiole,pilose,pseudohair,puberulent,pubescent,rachi,rarely,remnant,reniform,rugulose,shallow,shrub,side,simple,small,spaced,sparsely,style,subcoriaceous,tip,toward,tree,truncate,unbranched,vein,violet,white,x,yellow	1,1-2.5,2.3-24,3-4-foliate,4-25,5-merou,9-14,accrescen,aggregate,alyx,ape,apical,blade,brownish,cell,ciliat,connective,connivent,coriaceous,cream,crow,cucullate,dense,dilated,directed,distally,eaf,eed,equal,exceeding,free,fruiting,geminate,gland,homostylous,lanceolate,larg,lon,longitudinal,loosely,lower,m.,major,midrib,narrowly,nflorescence,opening,orolla,ovoid,part,pilo,pore,produced,prominent,purple,purplish,ruit,shorter,single,slightly,slit,spreading,stamen,stellate,stigma,stone,strongly,swelling,tall,tamen,tem,thecae,time,tomentose,triangular,trunk,tube,two,ud,umbrella-shaped,unit,vary,wide,ympodial	5,abaxial,adaxial,arrangement,branching,characteristic,colour,corolla,form,green,growth,height,history,inflorescence,leaf,length,life,midvein,na,ovary,perennial,plant,primary,pseudostipule,seed,shape,staman,stem,surface,tertiary,texture,unarmed,venation
